SEASON_ID,Player_ID,Game_ID,GAME_DATE,MATCHUP,WL,MIN,FGM,FGA,FG_PCT,FG3M,FG3A,FG3_PCT,FTM,FTA,FT_PCT,OREB,DREB,Rebounds,Assists,STL,BLK,TOV,PF,Points,PLUS_MINUS,VIDEO_AVAILABLE,PlayerName,Team,Home,Away,Value,Prop,Pts+Rebs+Asts,Pts+Rebs,Pts+Asts,Rebs+Asts
22023,1630173,22300557,"JAN 15, 2024",NYK vs. ORL,L,20,2,4,0.5,0,0,0.0,2,2,1.0,3,2,5,1,0,1,1,0,6,-4,1,Precious Achiuwa,NYK,NYK,ORL,,,12,11,7,6
22023,1630173,22300544,"JAN 13, 2024",NYK @ MEM,W,6,0,0,0.0,0,0,0.0,0,0,0.0,1,0,1,0,0,1,1,0,0,5,1,Precious Achiuwa,NYK,MEM,NYK,,,1,1,0,1
22023,1630173,22300530,"JAN 11, 2024",NYK @ DAL,L,16,3,3,1.0,0,0,0.0,1,2,0.5,1,5,6,0,1,0,2,4,7,3,1,Precious Achiuwa,NYK,DAL,NYK,,,13,13,7,6
22023,1630173,22300514,"JAN 09, 2024",NYK vs. POR,W,20,1,9,0.111,0,3,0.0,0,0,0.0,5,4,9,1,1,1,1,0,2,-3,1,Precious Achiuwa,NYK,NYK,POR,,,12,11,3,10
22023,1630173,22300494,"JAN 06, 2024",NYK @ WAS,W,8,1,1,1.0,0,0,0.0,0,0,0.0,0,0,0,0,0,0,0,1,2,-11,1,Precious Achiuwa,NYK,WAS,NYK,,,2,2,2,0
22023,1630173,22300483,"JAN 05, 2024",NYK @ PHI,W,13,2,3,0.667,1,2,0.5,0,0,0.0,2,1,3,0,0,1,1,0,5,10,1,Precious Achiuwa,NYK,PHI,NYK,,,8,8,5,3
22023,1630173,22300468,"JAN 03, 2024",NYK vs. CHI,W,11,2,2,1.0,0,0,0.0,0,0,0.0,2,1,3,1,0,1,0,2,4,-16,1,Precious Achiuwa,NYK,NYK,CHI,,,8,7,5,4
22023,1630173,22300451,"JAN 01, 2024",NYK vs. MIN,W,9,0,2,0.0,0,0,0.0,0,0,0.0,1,2,3,0,0,0,0,2,0,-3,1,Precious Achiuwa,NYK,NYK,MIN,,,3,3,0,3
22023,1630173,22300432,"DEC 29, 2023",TOR @ BOS,L,2,0,1,0.0,0,0,0.0,0,0,0.0,0,2,2,0,0,0,0,0,0,1,1,Precious Achiuwa,TOR,BOS,TOR,,,2,2,0,2
22023,1630173,22300416,"DEC 27, 2023",TOR @ WAS,W,11,1,2,0.5,0,0,0.0,1,2,0.5,0,1,1,0,1,1,1,0,3,5,1,Precious Achiuwa,TOR,WAS,TOR,,,4,4,3,1
22023,1630173,22300395,"DEC 23, 2023",TOR vs. UTA,L,21,3,7,0.429,0,3,0.0,2,2,1.0,1,1,2,1,0,2,0,1,8,-3,1,Precious Achiuwa,TOR,TOR,UTA,,,11,10,9,3
22023,1630173,22300382,"DEC 22, 2023",TOR @ PHI,L,16,2,9,0.222,0,2,0.0,0,2,0.0,3,3,6,1,2,0,1,2,4,-1,1,Precious Achiuwa,TOR,PHI,TOR,,,11,10,5,7
22023,1630173,22300369,"DEC 20, 2023",TOR vs. DEN,L,25,6,10,0.6,1,2,0.5,0,1,0.0,4,1,5,1,1,1,1,2,13,6,1,Precious Achiuwa,TOR,TOR,DEN,,,19,18,14,6
22023,1630173,22300354,"DEC 18, 2023",TOR vs. CHA,W,18,5,9,0.556,0,1,0.0,2,4,0.5,5,2,7,1,1,0,0,1,12,12,1,Precious Achiuwa,TOR,TOR,CHA,,,20,19,13,8
22023,1630173,22300330,"DEC 15, 2023",TOR vs. ATL,L,17,4,7,0.571,0,2,0.0,1,2,0.5,0,2,2,5,0,0,0,1,9,-9,1,Precious Achiuwa,TOR,TOR,ATL,,,16,11,14,7
22023,1630173,22300313,"DEC 13, 2023",TOR vs. ATL,W,17,2,5,0.4,1,3,0.333,2,2,1.0,1,6,7,1,1,2,2,0,7,-5,1,Precious Achiuwa,TOR,TOR,ATL,,,15,14,8,8
22023,1630173,22300297,"DEC 11, 2023",TOR @ NYK,L,21,3,8,0.375,1,4,0.25,2,2,1.0,0,5,5,3,1,0,1,4,9,-1,1,Precious Achiuwa,TOR,NYK,TOR,,,17,14,12,8
22023,1630173,22301216,"DEC 08, 2023",TOR @ CHA,L,22,7,10,0.7,3,4,0.75,0,0,0.0,4,6,10,1,0,0,4,4,17,5,1,Precious Achiuwa,TOR,CHA,TOR,,,28,27,18,11
22023,1630173,22301207,"DEC 06, 2023",TOR vs. MIA,L,13,4,7,0.571,1,3,0.333,0,0,0.0,0,3,3,2,1,0,1,0,9,-4,1,Precious Achiuwa,TOR,TOR,MIA,,,14,12,11,5
22023,1630173,22300276,"DEC 01, 2023",TOR vs. NYK,L,17,4,11,0.364,0,1,0.0,0,0,0.0,5,1,6,1,0,0,1,2,8,-22,1,Precious Achiuwa,TOR,TOR,NYK,,,15,14,9,7
22023,1630173,22300260,"NOV 29, 2023",TOR vs. PHX,W,18,5,10,0.5,1,1,1.0,3,4,0.75,6,4,10,1,2,0,1,2,14,6,1,Precious Achiuwa,TOR,TOR,PHX,,,25,24,15,11
22023,1630173,22300054,"NOV 28, 2023",TOR @ BKN,L,10,0,4,0.0,0,2,0.0,1,4,0.25,1,2,3,1,1,0,1,3,1,-2,1,Precious Achiuwa,TOR,BKN,TOR,,,5,4,2,4
22023,1630173,22300251,"NOV 26, 2023",TOR @ CLE,L,13,1,4,0.25,1,2,0.5,1,4,0.25,0,2,2,1,1,0,0,0,4,-15,1,Precious Achiuwa,TOR,CLE,TOR,,,7,6,5,3
22023,1630173,22300046,"NOV 24, 2023",TOR vs. CHI,W,18,3,4,0.75,0,0,0.0,2,2,1.0,3,4,7,4,0,3,2,0,8,-2,1,Precious Achiuwa,TOR,TOR,CHI,,,19,15,12,11
22023,1630173,22300038,"NOV 21, 2023",TOR @ ORL,L,15,2,4,0.5,0,1,0.0,1,2,0.5,2,4,6,4,1,0,3,3,5,-9,1,Precious Achiuwa,TOR,ORL,TOR,,,15,11,9,10
22023,1630173,22300211,"NOV 19, 2023",TOR vs. DET,W,19,5,10,0.5,2,4,0.5,0,2,0.0,3,3,6,5,0,0,0,1,12,17,1,Precious Achiuwa,TOR,TOR,DET,,,23,18,17,11
22023,1630173,22300031,"NOV 17, 2023",TOR vs. BOS,L,24,2,4,0.5,0,2,0.0,1,2,0.5,0,9,9,1,2,0,1,1,5,-2,1,Precious Achiuwa,TOR,TOR,BOS,,,15,14,6,10
22023,1630173,22300195,"NOV 15, 2023",TOR vs. MIL,L,17,4,7,0.571,1,2,0.5,2,2,1.0,3,1,4,0,0,2,1,3,11,-3,1,Precious Achiuwa,TOR,TOR,MIL,,,15,15,11,4
22023,1630173,22300189,"NOV 13, 2023",TOR vs. WAS,W,19,5,8,0.625,0,1,0.0,0,0,0.0,1,3,4,1,1,0,2,1,10,8,1,Precious Achiuwa,TOR,TOR,WAS,,,15,14,11,5
22023,1630173,22300174,"NOV 11, 2023",TOR @ BOS,L,19,1,5,0.2,0,2,0.0,0,0,0.0,0,5,5,5,0,0,0,1,2,-12,1,Precious Achiuwa,TOR,BOS,TOR,,,12,7,7,10
22023,1630173,22300092,"OCT 28, 2023",TOR vs. PHI,L,18,3,10,0.3,0,1,0.0,0,0,0.0,3,4,7,3,0,1,1,1,6,5,1,Precious Achiuwa,TOR,TOR,PHI,,,16,13,9,10
22023,1630173,22300082,"OCT 27, 2023",TOR @ CHI,L,23,2,5,0.4,1,3,0.333,3,3,1.0,2,7,9,1,0,0,3,6,8,-22,1,Precious Achiuwa,TOR,CHI,TOR,,,18,17,9,10
22023,1630173,22300069,"OCT 25, 2023",TOR vs. MIN,W,24,4,9,0.444,0,1,0.0,0,0,0.0,3,5,8,0,0,0,2,1,8,-5,1,Precious Achiuwa,TOR,TOR,MIN,,,16,16,8,8
22023,1628389,22300562,"JAN 15, 2024",MIA @ BKN,W,44,5,17,0.294,0,1,0.0,1,2,0.5,2,18,20,4,1,1,2,2,11,-3,1,Bam Adebayo,MIA,BKN,MIA,,,35,31,15,24
22023,1628389,22300551,"JAN 14, 2024",MIA vs. CHA,W,35,9,17,0.529,0,1,0.0,6,8,0.75,0,10,10,7,0,1,2,3,24,5,1,Bam Adebayo,MIA,MIA,CHA,,,41,34,31,17
22023,1628389,22300535,"JAN 12, 2024",MIA vs. ORL,W,39,8,17,0.471,0,0,0.0,5,6,0.833,4,7,11,7,0,1,4,3,21,17,1,Bam Adebayo,MIA,MIA,ORL,,,39,32,28,18
22023,1628389,22300522,"JAN 10, 2024",MIA vs. OKC,L,37,9,16,0.563,0,0,0.0,7,7,1.0,5,6,11,6,0,2,1,1,25,-6,1,Bam Adebayo,MIA,MIA,OKC,,,42,36,31,17
22023,1628389,22300509,"JAN 08, 2024",MIA vs. HOU,W,32,9,12,0.75,0,0,0.0,4,7,0.571,1,11,12,3,1,0,3,4,22,12,1,Bam Adebayo,MIA,MIA,HOU,,,37,34,25,15
22023,1628389,22300489,"JAN 05, 2024",MIA @ PHX,L,36,11,19,0.579,0,0,0.0,6,7,0.857,2,8,10,1,0,1,1,2,28,-16,1,Bam Adebayo,MIA,PHX,MIA,,,39,38,29,11
22023,1628389,22300475,"JAN 03, 2024",MIA @ LAL,W,38,5,14,0.357,0,1,0.0,5,6,0.833,3,4,7,5,3,0,2,4,15,12,1,Bam Adebayo,MIA,LAL,MIA,,,27,22,20,12
22023,1628389,22300458,"JAN 01, 2024",MIA @ LAC,L,36,6,17,0.353,0,2,0.0,9,13,0.692,3,12,15,4,0,0,3,3,21,-12,1,Bam Adebayo,MIA,LAC,MIA,,,40,36,25,19
22023,1628389,22300439,"DEC 30, 2023",MIA @ UTA,L,37,7,13,0.538,0,0,0.0,14,20,0.7,3,13,16,3,3,3,4,1,28,-3,1,Bam Adebayo,MIA,UTA,MIA,,,47,44,31,19
22023,1628389,22300426,"DEC 28, 2023",MIA @ GSW,W,36,7,13,0.538,0,0,0.0,3,4,0.75,2,9,11,4,0,0,0,2,17,8,1,Bam Adebayo,MIA,GSW,MIA,,,32,28,21,15
22023,1628389,22300404,"DEC 25, 2023",MIA vs. PHI,W,36,9,15,0.6,0,0,0.0,8,12,0.667,3,12,15,5,0,3,4,1,26,0,1,Bam Adebayo,MIA,MIA,PHI,,,46,41,31,20
22023,1628389,22300384,"DEC 22, 2023",MIA vs. ATL,W,38,5,14,0.357,0,1,0.0,8,10,0.8,2,9,11,6,2,0,6,2,18,10,1,Bam Adebayo,MIA,MIA,ATL,,,35,29,24,17
22023,1628389,22300366,"DEC 20, 2023",MIA @ ORL,W,30,7,15,0.467,0,0,0.0,4,5,0.8,0,7,7,2,1,0,1,4,18,-6,1,Bam Adebayo,MIA,ORL,MIA,,,27,25,20,9
22023,1628389,22300353,"DEC 18, 2023",MIA vs. MIN,L,36,10,22,0.455,0,0,0.0,2,3,0.667,3,3,6,6,1,1,4,3,22,-3,1,Bam Adebayo,MIA,MIA,MIN,,,34,28,28,12
22023,1628389,22300267,"NOV 30, 2023",MIA vs. IND,W,12,3,9,0.333,0,0,0.0,1,2,0.5,0,4,4,2,0,0,0,1,7,-2,1,Bam Adebayo,MIA,MIA,IND,,,13,11,9,6
22023,1628389,22300056,"NOV 28, 2023",MIA vs. MIL,L,42,13,27,0.481,0,0,0.0,5,7,0.714,2,8,10,5,0,2,2,3,31,-16,1,Bam Adebayo,MIA,MIA,MIL,,,46,41,36,15
22023,1628389,22300045,"NOV 24, 2023",MIA @ NYK,L,35,8,16,0.5,0,1,0.0,5,6,0.833,2,10,12,2,2,0,2,4,21,0,1,Bam Adebayo,MIA,NYK,MIA,,,35,33,23,14
22023,1628389,22300220,"NOV 20, 2023",MIA @ CHI,W,30,8,14,0.571,0,0,0.0,7,9,0.778,3,8,11,6,1,0,1,3,23,7,1,Bam Adebayo,MIA,CHI,MIA,,,40,34,29,17
22023,1628389,22300204,"NOV 18, 2023",MIA @ CHI,L,36,8,12,0.667,0,0,0.0,8,8,1.0,1,9,10,5,0,0,3,3,24,-1,1,Bam Adebayo,MIA,CHI,MIA,,,39,34,29,15
22023,1628389,22300200,"NOV 16, 2023",MIA vs. BKN,W,34,8,15,0.533,0,0,0.0,4,4,1.0,2,5,7,4,2,0,2,2,20,-6,1,Bam Adebayo,MIA,MIA,BKN,,,31,27,24,11
22023,1628389,22300017,"NOV 14, 2023",MIA @ CHA,W,36,8,16,0.5,0,0,0.0,5,6,0.833,0,11,11,4,3,1,1,3,21,1,1,Bam Adebayo,MIA,CHA,MIA,,,36,32,25,15
22023,1628389,22300184,"NOV 12, 2023",MIA @ SAS,W,34,10,20,0.5,0,0,0.0,4,5,0.8,4,7,11,6,3,0,0,0,24,-10,1,Bam Adebayo,MIA,SAS,MIA,,,41,35,30,17
22023,1628389,22300175,"NOV 11, 2023",MIA @ ATL,W,39,9,12,0.75,0,0,0.0,8,8,1.0,4,13,17,4,2,2,3,2,26,-5,1,Bam Adebayo,MIA,ATL,MIA,,,47,43,30,21
22023,1628389,22300164,"NOV 08, 2023",MIA @ MEM,W,36,8,15,0.533,0,0,0.0,14,16,0.875,0,11,11,1,1,3,4,5,30,15,1,Bam Adebayo,MIA,MEM,MIA,,,42,41,31,12
22023,1628389,22300150,"NOV 06, 2023",MIA vs. LAL,W,38,9,20,0.45,1,1,1.0,3,5,0.6,5,14,19,10,2,2,4,2,22,5,1,Bam Adebayo,MIA,MIA,LAL,,,51,41,32,29
22023,1628389,22300003,"NOV 03, 2023",MIA vs. WAS,W,30,8,15,0.533,0,0,0.0,2,2,1.0,0,4,4,3,0,0,4,3,18,6,1,Bam Adebayo,MIA,MIA,WAS,,,25,22,21,7
22023,1628389,22300119,"NOV 01, 2023",MIA vs. BKN,L,33,8,12,0.667,0,0,0.0,5,5,1.0,4,10,14,3,2,2,4,0,21,5,1,Bam Adebayo,MIA,MIA,BKN,,,38,35,24,17
22023,1628389,22300093,"OCT 28, 2023",MIA @ MIN,L,33,7,14,0.5,0,1,0.0,5,10,0.5,1,2,3,2,0,0,4,4,19,-10,1,Bam Adebayo,MIA,MIN,MIA,,,24,22,21,5
22023,1628389,22300080,"OCT 27, 2023",MIA @ BOS,L,35,10,23,0.435,0,0,0.0,7,9,0.778,3,4,7,2,1,2,3,1,27,0,1,Bam Adebayo,MIA,BOS,MIA,,,36,34,29,9
22023,1628389,22300068,"OCT 25, 2023",MIA vs. DET,W,32,7,13,0.538,0,0,0.0,8,10,0.8,2,6,8,3,0,2,2,3,22,-4,1,Bam Adebayo,MIA,MIA,DET,,,33,30,25,11
22023,1630534,22300564,"JAN 15, 2024",UTA vs. IND,W,24,1,4,0.25,0,1,0.0,2,2,1.0,0,4,4,0,0,1,1,2,4,5,1,Ochai Agbaji,UTA,UTA,IND,,,8,8,4,4
22023,1630534,22300549,"JAN 13, 2024",UTA vs. LAL,W,18,1,5,0.2,0,2,0.0,0,0,0.0,1,3,4,0,0,1,0,0,2,-9,1,Ochai Agbaji,UTA,UTA,LAL,,,6,6,2,4
22023,1630534,22300540,"JAN 12, 2024",UTA vs. TOR,W,22,3,8,0.375,2,7,0.286,0,0,0.0,1,4,5,1,0,2,0,1,8,17,1,Ochai Agbaji,UTA,UTA,TOR,,,14,13,9,6
22023,1630534,22300524,"JAN 10, 2024",UTA vs. DEN,W,13,0,2,0.0,0,1,0.0,0,0,0.0,1,3,4,1,1,2,0,1,0,1,1,Ochai Agbaji,UTA,UTA,DEN,,,5,4,1,5
22023,1630534,22300510,"JAN 08, 2024",UTA @ MIL,W,15,1,2,0.5,0,1,0.0,0,0,0.0,0,1,1,0,0,0,0,1,2,11,1,Ochai Agbaji,UTA,MIL,UTA,,,3,3,2,1
22023,1630534,22300495,"JAN 06, 2024",UTA @ PHI,W,13,0,2,0.0,0,2,0.0,0,0,0.0,1,2,3,1,0,0,1,1,0,3,1,Ochai Agbaji,UTA,PHI,UTA,,,4,3,1,4
22023,1630534,22300479,"JAN 05, 2024",UTA @ BOS,L,22,2,5,0.4,0,3,0.0,1,1,1.0,1,3,4,1,0,0,2,4,5,-12,1,Ochai Agbaji,UTA,BOS,UTA,,,10,9,6,5
22023,1630534,22300474,"JAN 03, 2024",UTA vs. DET,W,13,1,1,1.0,1,1,1.0,0,0,0.0,0,1,1,2,2,0,1,2,3,-6,1,Ochai Agbaji,UTA,UTA,DET,,,6,4,5,3
22023,1630534,22300457,"JAN 01, 2024",UTA vs. DAL,W,19,1,6,0.167,0,5,0.0,0,0,0.0,1,1,2,0,0,0,1,1,2,10,1,Ochai Agbaji,UTA,UTA,DAL,,,4,4,2,2
22023,1630534,22300439,"DEC 30, 2023",UTA vs. MIA,W,15,0,4,0.0,0,3,0.0,0,2,0.0,0,0,0,0,0,1,0,1,0,1,1,Ochai Agbaji,UTA,UTA,MIA,,,0,0,0,0
22023,1630534,22300424,"DEC 28, 2023",UTA @ NOP,L,16,1,2,0.5,0,0,0.0,0,0,0.0,0,1,1,2,0,0,2,0,2,-4,1,Ochai Agbaji,UTA,NOP,UTA,,,5,3,4,3
22023,1630534,22300412,"DEC 26, 2023",UTA @ SAS,W,19,4,6,0.667,2,4,0.5,0,0,0.0,1,3,4,1,0,0,0,0,10,18,1,Ochai Agbaji,UTA,SAS,UTA,,,15,14,11,5
22023,1630534,22300395,"DEC 23, 2023",UTA @ TOR,W,24,3,5,0.6,1,3,0.333,2,2,1.0,0,3,3,0,0,1,1,2,9,8,1,Ochai Agbaji,UTA,TOR,UTA,,,12,12,9,3
22023,1630534,22300374,"DEC 21, 2023",UTA @ DET,W,33,7,12,0.583,2,6,0.333,2,2,1.0,0,2,2,0,2,0,0,4,18,10,1,Ochai Agbaji,UTA,DET,UTA,,,20,20,18,2
22023,1630534,22300364,"DEC 20, 2023",UTA @ CLE,L,16,1,1,1.0,1,1,1.0,0,0,0.0,1,2,3,1,0,1,0,1,3,-17,1,Ochai Agbaji,UTA,CLE,UTA,,,7,6,4,4
22023,1630534,22300357,"DEC 18, 2023",UTA vs. BKN,W,23,6,10,0.6,1,5,0.2,0,0,0.0,1,2,3,2,1,1,2,1,13,13,1,Ochai Agbaji,UTA,UTA,BKN,,,18,16,15,5
22023,1630534,22300342,"DEC 16, 2023",UTA @ SAC,L,23,2,7,0.286,1,3,0.333,0,0,0.0,3,1,4,0,1,0,0,2,5,2,1,Ochai Agbaji,UTA,SAC,UTA,,,9,9,5,4
22023,1630534,22300323,"DEC 14, 2023",UTA @ POR,W,26,7,12,0.583,2,6,0.333,0,0,0.0,0,3,3,2,0,0,1,3,16,-17,1,Ochai Agbaji,UTA,POR,UTA,,,21,19,18,5
22023,1630534,22300318,"DEC 13, 2023",UTA vs. NYK,W,30,2,12,0.167,1,5,0.2,0,0,0.0,3,1,4,2,0,0,0,2,5,16,1,Ochai Agbaji,UTA,UTA,NYK,,,11,9,7,6
22023,1630534,22300302,"DEC 11, 2023",UTA @ OKC,L,22,1,4,0.25,0,1,0.0,0,0,0.0,0,1,1,2,3,1,1,1,2,-19,1,Ochai Agbaji,UTA,OKC,UTA,,,5,3,4,3
22023,1630534,22301225,"DEC 08, 2023",UTA vs. LAC,L,17,2,4,0.5,1,2,0.5,0,0,0.0,0,1,1,0,0,0,1,2,5,5,1,Ochai Agbaji,UTA,UTA,LAC,,,6,6,5,1
22023,1630534,22301213,"DEC 06, 2023",UTA @ DAL,L,30,7,14,0.5,5,10,0.5,2,2,1.0,0,0,0,0,2,0,0,1,21,-47,1,Ochai Agbaji,UTA,DAL,UTA,,,21,21,21,0
22023,1630534,22300289,"DEC 02, 2023",UTA vs. POR,W,26,3,4,0.75,0,0,0.0,0,0,0.0,0,2,2,0,0,0,2,2,6,8,1,Ochai Agbaji,UTA,UTA,POR,,,8,8,6,2
22023,1630534,22300270,"NOV 30, 2023",UTA @ MIN,L,36,5,10,0.5,3,6,0.5,0,0,0.0,3,3,6,3,4,0,1,1,13,-3,1,Ochai Agbaji,UTA,MIN,UTA,,,22,19,16,9
22023,1630534,22300261,"NOV 29, 2023",UTA @ MEM,L,21,2,5,0.4,1,4,0.25,0,0,0.0,1,3,4,3,0,0,1,1,5,-1,1,Ochai Agbaji,UTA,MEM,UTA,,,12,9,8,7
22023,1630534,22300256,"NOV 27, 2023",UTA vs. NOP,W,16,4,7,0.571,3,6,0.5,1,1,1.0,0,0,0,0,0,0,0,1,12,5,1,Ochai Agbaji,UTA,UTA,NOP,,,12,12,12,0
22023,1630534,22300243,"NOV 25, 2023",UTA vs. NOP,W,22,3,8,0.375,2,7,0.286,1,1,1.0,0,1,1,3,3,0,1,1,9,5,1,Ochai Agbaji,UTA,UTA,NOP,,,13,10,12,4
22023,1630534,22300237,"NOV 22, 2023",UTA @ POR,L,14,4,4,1.0,1,1,1.0,0,0,0.0,0,0,0,1,0,1,1,0,9,-9,1,Ochai Agbaji,UTA,POR,UTA,,,10,9,10,1
22023,1630534,22300042,"NOV 21, 2023",UTA @ LAL,L,17,0,5,0.0,0,3,0.0,0,0,0.0,1,2,3,0,0,0,1,2,0,-16,1,Ochai Agbaji,UTA,LAL,UTA,,,3,3,0,3
22023,1630534,22300214,"NOV 19, 2023",UTA vs. PHX,L,34,1,1,1.0,1,1,1.0,0,0,0.0,2,1,3,1,1,1,1,4,3,-14,1,Ochai Agbaji,UTA,UTA,PHX,,,7,6,4,4
22023,1630534,22300035,"NOV 17, 2023",UTA vs. PHX,L,25,3,4,0.75,2,2,1.0,0,0,0.0,2,3,5,0,0,3,0,3,8,4,1,Ochai Agbaji,UTA,UTA,PHX,,,13,13,8,5
22023,1630534,22300023,"NOV 14, 2023",UTA vs. POR,W,26,2,7,0.286,0,2,0.0,2,2,1.0,4,4,8,1,2,1,0,1,6,5,1,Ochai Agbaji,UTA,UTA,POR,,,15,14,7,9
22023,1630534,22300012,"NOV 10, 2023",UTA @ MEM,W,30,6,8,0.75,3,5,0.6,0,0,0.0,1,5,6,1,1,2,1,3,15,3,1,Ochai Agbaji,UTA,MEM,UTA,,,22,21,16,7
22023,1630534,22300158,"NOV 08, 2023",UTA @ IND,L,26,1,3,0.333,1,3,0.333,0,0,0.0,1,3,4,1,0,1,3,0,3,-3,1,Ochai Agbaji,UTA,IND,UTA,,,8,7,4,5
22023,1630534,22300152,"NOV 06, 2023",UTA @ CHI,L,11,1,3,0.333,1,2,0.5,0,0,0.0,0,1,1,1,0,1,1,2,3,-15,1,Ochai Agbaji,UTA,CHI,UTA,,,5,4,4,2
22023,1630534,22300138,"NOV 04, 2023",UTA @ MIN,L,17,3,5,0.6,2,4,0.5,0,1,0.0,2,0,2,1,0,0,0,1,8,-4,1,Ochai Agbaji,UTA,MIN,UTA,,,11,10,9,3
22023,1630534,22300130,"NOV 02, 2023",UTA vs. ORL,L,8,1,2,0.5,0,1,0.0,0,0,0.0,0,0,0,1,0,0,0,2,2,-1,1,Ochai Agbaji,UTA,UTA,ORL,,,3,2,3,1
22023,1630534,22300125,"NOV 01, 2023",UTA vs. MEM,W,18,2,5,0.4,2,5,0.4,0,1,0.0,0,3,3,1,0,0,2,0,6,5,1,Ochai Agbaji,UTA,UTA,MEM,,,10,9,7,4
22023,1630534,22300110,"OCT 30, 2023",UTA @ DEN,L,15,0,5,0.0,0,2,0.0,0,0,0.0,1,1,2,2,0,0,0,0,0,-1,1,Ochai Agbaji,UTA,DEN,UTA,,,4,2,2,4
22023,1630534,22300094,"OCT 28, 2023",UTA @ PHX,L,6,0,1,0.0,0,1,0.0,0,0,0.0,0,0,0,0,0,1,0,0,0,-3,1,Ochai Agbaji,UTA,PHX,UTA,,,0,0,0,0
22023,1630534,22300085,"OCT 27, 2023",UTA vs. LAC,W,12,1,3,0.333,0,2,0.0,0,0,0.0,0,1,1,2,1,1,0,3,2,-2,1,Ochai Agbaji,UTA,UTA,LAC,,,5,3,4,3
22023,1630534,22300072,"OCT 25, 2023",UTA vs. SAC,L,19,2,6,0.333,1,2,0.5,0,0,0.0,0,3,3,0,0,0,0,2,5,-11,1,Ochai Agbaji,UTA,UTA,SAC,,,8,8,5,3
22023,1630583,22300560,"JAN 15, 2024",MEM vs. GSW,W,17,3,6,0.5,1,4,0.25,4,5,0.8,0,6,6,1,0,3,1,2,11,-6,1,Santi Aldama,MEM,MEM,GSW,,,18,17,12,7
22023,1630583,22300503,"JAN 07, 2024",MEM @ PHX,W,16,2,11,0.182,1,7,0.143,2,3,0.667,2,5,7,1,1,1,4,2,7,-5,1,Santi Aldama,MEM,PHX,MEM,,,15,14,8,8
22023,1630583,22300491,"JAN 05, 2024",MEM @ LAL,W,9,0,0,0.0,0,0,0.0,0,0,0.0,0,0,0,0,1,0,1,0,0,-3,1,Santi Aldama,MEM,LAL,MEM,,,0,0,0,0
22023,1630583,22300470,"JAN 03, 2024",MEM vs. TOR,L,22,2,6,0.333,2,4,0.5,1,2,0.5,1,7,8,3,1,0,1,4,7,2,1,Santi Aldama,MEM,MEM,TOR,,,18,15,10,11
22023,1630583,22300460,"JAN 02, 2024",MEM vs. SAS,W,28,5,6,0.833,1,2,0.5,2,2,1.0,2,9,11,0,0,1,0,1,13,12,1,Santi Aldama,MEM,MEM,SAS,,,24,24,13,11
22023,1630583,22300449,"DEC 31, 2023",MEM vs. SAC,L,14,2,6,0.333,1,5,0.2,0,2,0.0,0,2,2,1,0,0,0,0,5,-13,1,Santi Aldama,MEM,MEM,SAC,,,8,7,6,3
22023,1630583,22300438,"DEC 29, 2023",MEM @ LAC,L,22,5,7,0.714,2,3,0.667,0,0,0.0,1,4,5,1,1,0,0,1,12,0,1,Santi Aldama,MEM,LAC,MEM,,,18,17,13,6
22023,1630583,22300410,"DEC 26, 2023",MEM @ NOP,W,9,0,2,0.0,0,2,0.0,0,0,0.0,0,2,2,0,0,1,0,2,0,-8,1,Santi Aldama,MEM,NOP,MEM,,,2,2,0,2
22023,1630583,22300393,"DEC 23, 2023",MEM @ ATL,W,27,2,7,0.286,1,4,0.25,1,2,0.5,0,4,4,3,0,1,1,0,6,3,1,Santi Aldama,MEM,ATL,MEM,,,13,10,9,7
22023,1630583,22300377,"DEC 21, 2023",MEM vs. IND,W,25,5,7,0.714,3,5,0.6,0,0,0.0,0,3,3,2,1,0,2,0,13,24,1,Santi Aldama,MEM,MEM,IND,,,18,16,15,5
22023,1630583,22300360,"DEC 19, 2023",MEM @ NOP,W,16,3,4,0.75,2,2,1.0,0,0,0.0,2,1,3,0,1,1,0,1,8,-5,1,Santi Aldama,MEM,NOP,MEM,,,11,11,8,3
22023,1630583,22300355,"DEC 18, 2023",MEM @ OKC,L,20,2,10,0.2,2,7,0.286,3,4,0.75,2,7,9,1,0,0,1,1,9,-21,1,Santi Aldama,MEM,OKC,MEM,,,19,18,10,10
22023,1630583,22300332,"DEC 15, 2023",MEM vs. HOU,L,26,4,8,0.5,2,4,0.5,1,2,0.5,2,2,4,0,0,0,2,3,11,-12,1,Santi Aldama,MEM,MEM,HOU,,,15,15,11,4
22023,1630583,22300314,"DEC 13, 2023",MEM @ HOU,L,16,3,4,0.75,1,2,0.5,0,0,0.0,0,5,5,1,0,2,1,4,7,-11,1,Santi Aldama,MEM,HOU,MEM,,,13,12,8,6
22023,1630583,22300299,"DEC 11, 2023",MEM vs. DAL,L,20,2,6,0.333,2,5,0.4,0,0,0.0,0,2,2,3,2,1,1,2,6,-1,1,Santi Aldama,MEM,MEM,DAL,,,11,8,9,5
22023,1630583,22301221,"DEC 08, 2023",MEM vs. MIN,L,24,2,8,0.25,1,3,0.333,4,6,0.667,4,6,10,6,0,1,0,1,9,-11,1,Santi Aldama,MEM,MEM,MIN,,,25,19,15,16
22023,1630583,22301206,"DEC 06, 2023",MEM @ DET,W,26,3,9,0.333,1,3,0.333,0,0,0.0,3,0,3,3,1,1,1,0,7,14,1,Santi Aldama,MEM,DET,MEM,,,13,10,10,6
22023,1630583,22300288,"DEC 02, 2023",MEM @ PHX,L,31,3,10,0.3,1,6,0.167,0,0,0.0,0,7,7,1,3,1,1,5,7,-5,1,Santi Aldama,MEM,PHX,MEM,,,15,14,8,8
22023,1630583,22300277,"DEC 01, 2023",MEM @ DAL,W,33,7,10,0.7,1,4,0.25,2,2,1.0,5,7,12,3,1,1,1,1,17,17,1,Santi Aldama,MEM,DAL,MEM,,,32,29,20,15
22023,1630583,22300261,"NOV 29, 2023",MEM vs. UTA,W,25,4,9,0.444,1,4,0.25,2,4,0.5,2,2,4,1,1,1,1,1,11,7,1,Santi Aldama,MEM,MEM,UTA,,,16,15,12,5
22023,1630583,22300249,"NOV 26, 2023",MEM vs. MIN,L,27,6,15,0.4,1,7,0.143,1,2,0.5,2,5,7,2,0,0,1,0,14,-15,1,Santi Aldama,MEM,MEM,MIN,,,23,21,16,9
22023,1630583,22300044,"NOV 24, 2023",MEM vs. PHX,L,36,9,20,0.45,3,10,0.3,0,0,0.0,1,4,5,0,0,0,0,2,21,-18,1,Santi Aldama,MEM,MEM,PHX,,,26,26,21,5
22023,1630583,22300231,"NOV 22, 2023",MEM @ HOU,L,22,2,5,0.4,1,3,0.333,3,3,1.0,0,2,2,0,0,1,0,5,8,-4,1,Santi Aldama,MEM,HOU,MEM,,,10,10,8,2
22023,1630583,22300213,"NOV 19, 2023",MEM vs. BOS,L,39,11,27,0.407,6,15,0.4,0,0,0.0,4,8,12,6,2,0,1,2,28,4,1,Santi Aldama,MEM,MEM,BOS,,,46,40,34,18
22023,1630583,22300206,"NOV 18, 2023",MEM @ SAS,W,36,7,15,0.467,1,5,0.2,2,3,0.667,2,8,10,3,1,1,3,2,17,19,1,Santi Aldama,MEM,SAS,MEM,,,30,27,20,13
22023,1630583,22300026,"NOV 14, 2023",MEM @ LAL,L,25,9,15,0.6,3,8,0.375,3,5,0.6,0,5,5,4,0,2,3,0,24,-12,1,Santi Aldama,MEM,LAL,MEM,,,33,29,28,9
22023,1630583,22300179,"NOV 12, 2023",MEM @ LAC,W,21,4,8,0.5,1,4,0.25,0,0,0.0,0,3,3,2,0,1,2,1,9,-3,1,Santi Aldama,MEM,LAC,MEM,,,14,12,11,5
22023,1630583,22300012,"NOV 10, 2023",MEM vs. UTA,L,13,2,3,0.667,1,1,1.0,1,2,0.5,0,2,2,0,0,0,0,1,6,2,1,Santi Aldama,MEM,MEM,UTA,,,8,8,6,2
22023,1630583,22300164,"NOV 08, 2023",MEM vs. MIA,L,26,5,14,0.357,2,4,0.5,0,2,0.0,2,6,8,0,2,1,1,4,12,8,1,Santi Aldama,MEM,MEM,MIA,,,20,20,12,8
22023,1630583,22300144,"NOV 05, 2023",MEM @ POR,W,20,3,8,0.375,1,3,0.333,0,0,0.0,1,4,5,3,0,0,2,0,7,-4,1,Santi Aldama,MEM,POR,MEM,,,15,12,10,8
22023,1629638,22300553,"JAN 14, 2024",MIN vs. LAC,W,20,2,6,0.333,2,5,0.4,0,0,0.0,0,0,0,1,0,1,0,4,6,-4,1,Nickeil Alexander-Walker,MIN,MIN,LAC,,,7,6,7,1
22023,1629638,22300538,"JAN 12, 2024",MIN vs. POR,W,19,1,3,0.333,0,2,0.0,0,0,0.0,0,2,2,3,2,0,2,1,2,1,1,Nickeil Alexander-Walker,MIN,MIN,POR,,,7,4,5,5
22023,1629638,22300517,"JAN 10, 2024",MIN @ BOS,L,40,5,8,0.625,3,5,0.6,2,2,1.0,2,2,4,3,1,1,1,4,15,-4,1,Nickeil Alexander-Walker,MIN,BOS,MIN,,,22,19,18,7
22023,1629638,22300513,"JAN 09, 2024",MIN @ ORL,W,18,0,5,0.0,0,4,0.0,0,0,0.0,0,2,2,3,0,1,2,1,0,11,1,Nickeil Alexander-Walker,MIN,ORL,MIN,,,5,2,3,5
22023,1629638,22300501,"JAN 07, 2024",MIN @ DAL,L,13,1,5,0.2,1,4,0.25,0,0,0.0,1,0,1,1,0,0,0,0,3,-6,1,Nickeil Alexander-Walker,MIN,DAL,MIN,,,5,4,4,2
22023,1629638,22300485,"JAN 05, 2024",MIN @ HOU,W,18,4,6,0.667,2,4,0.5,1,2,0.5,1,2,3,3,2,2,0,2,11,17,1,Nickeil Alexander-Walker,MIN,HOU,MIN,,,17,14,14,6
22023,1629638,22300471,"JAN 03, 2024",MIN vs. NOP,L,19,1,3,0.333,0,2,0.0,2,2,1.0,0,0,0,1,0,0,1,0,4,-5,1,Nickeil Alexander-Walker,MIN,MIN,NOP,,,5,4,5,1
22023,1629638,22300451,"JAN 01, 2024",MIN @ NYK,L,17,1,3,0.333,1,2,0.5,0,0,0.0,0,0,0,2,0,0,0,2,3,4,1,Nickeil Alexander-Walker,MIN,NYK,MIN,,,5,3,5,2
22023,1629638,22300443,"DEC 30, 2023",MIN vs. LAL,W,16,2,4,0.5,2,4,0.5,0,0,0.0,0,2,2,2,1,0,2,4,6,-1,1,Nickeil Alexander-Walker,MIN,MIN,LAL,,,10,8,8,4
22023,1629638,22300423,"DEC 28, 2023",MIN vs. DAL,W,24,1,3,0.333,1,3,0.333,0,0,0.0,0,0,0,3,4,1,0,0,3,-3,1,Nickeil Alexander-Walker,MIN,MIN,DAL,,,6,3,6,3
22023,1629638,22300411,"DEC 26, 2023",MIN @ OKC,L,19,3,3,1.0,2,2,1.0,0,0,0.0,1,0,1,3,1,0,0,3,8,-13,1,Nickeil Alexander-Walker,MIN,OKC,MIN,,,12,9,11,4
22023,1629638,22300400,"DEC 23, 2023",MIN @ SAC,W,23,1,4,0.25,0,2,0.0,0,0,0.0,0,0,0,0,0,0,0,2,2,-1,1,Nickeil Alexander-Walker,MIN,SAC,MIN,,,2,2,2,0
22023,1629638,22300380,"DEC 21, 2023",MIN vs. LAL,W,15,2,6,0.333,1,5,0.2,0,0,0.0,0,1,1,3,3,0,1,2,5,6,1,Nickeil Alexander-Walker,MIN,MIN,LAL,,,9,6,8,4
22023,1629638,22300367,"DEC 20, 2023",MIN @ PHI,L,16,2,3,0.667,0,1,0.0,0,0,0.0,0,2,2,2,0,1,0,1,4,-23,1,Nickeil Alexander-Walker,MIN,PHI,MIN,,,8,6,6,4
22023,1629638,22300353,"DEC 18, 2023",MIN @ MIA,W,22,2,5,0.4,2,4,0.5,2,2,1.0,1,0,1,3,1,0,0,2,8,13,1,Nickeil Alexander-Walker,MIN,MIA,MIN,,,12,9,11,4
22023,1629638,22300338,"DEC 16, 2023",MIN vs. IND,W,26,1,6,0.167,1,2,0.5,0,0,0.0,0,2,2,1,1,0,1,0,3,2,1,Nickeil Alexander-Walker,MIN,MIN,IND,,,6,5,4,3
22023,1629638,22300321,"DEC 14, 2023",MIN @ DAL,W,20,5,6,0.833,3,4,0.75,0,0,0.0,1,0,1,1,0,1,1,2,13,20,1,Nickeil Alexander-Walker,MIN,DAL,MIN,,,15,14,14,2
22023,1629638,22300301,"DEC 11, 2023",MIN @ NOP,L,24,2,7,0.286,1,4,0.25,2,2,1.0,0,1,1,5,1,1,3,4,7,-13,1,Nickeil Alexander-Walker,MIN,NOP,MIN,,,13,8,12,6
22023,1629638,22301221,"DEC 08, 2023",MIN @ MEM,W,34,4,9,0.444,4,8,0.5,2,2,1.0,2,0,2,2,0,1,2,2,14,23,1,Nickeil Alexander-Walker,MIN,MEM,MIN,,,18,16,16,4
22023,1629638,22301210,"DEC 06, 2023",MIN vs. SAS,W,20,3,8,0.375,1,6,0.167,0,0,0.0,0,2,2,0,0,0,1,1,7,2,1,Nickeil Alexander-Walker,MIN,MIN,SAS,,,9,9,7,2
22023,1629638,22300281,"DEC 02, 2023",MIN @ CHA,W,30,2,5,0.4,0,2,0.0,2,2,1.0,0,2,2,2,0,0,1,1,6,-7,1,Nickeil Alexander-Walker,MIN,CHA,MIN,,,10,8,8,4
22023,1629638,22300270,"NOV 30, 2023",MIN vs. UTA,W,36,8,16,0.5,4,8,0.5,0,0,0.0,2,3,5,7,5,2,4,4,20,15,1,Nickeil Alexander-Walker,MIN,MIN,UTA,,,32,25,27,12
22023,1629638,22300058,"NOV 28, 2023",MIN vs. OKC,W,26,1,7,0.143,1,5,0.2,0,0,0.0,1,1,2,1,0,0,2,2,3,-4,1,Nickeil Alexander-Walker,MIN,MIN,OKC,,,6,5,4,3
22023,1629638,22300249,"NOV 26, 2023",MIN @ MEM,W,34,3,7,0.429,2,6,0.333,1,3,0.333,0,1,1,3,1,0,1,2,9,17,1,Nickeil Alexander-Walker,MIN,MEM,MIN,,,13,10,12,4
22023,1629638,22300050,"NOV 24, 2023",MIN vs. SAC,L,22,2,8,0.25,2,7,0.286,0,0,0.0,1,0,1,2,2,1,0,4,6,-12,1,Nickeil Alexander-Walker,MIN,MIN,SAC,,,9,7,8,3
22023,1629638,22300232,"NOV 22, 2023",MIN vs. PHI,W,29,3,6,0.5,1,4,0.25,0,0,0.0,2,4,6,4,0,1,0,4,7,22,1,Nickeil Alexander-Walker,MIN,MIN,PHI,,,17,13,11,10
22023,1629638,22300221,"NOV 20, 2023",MIN vs. NYK,W,33,4,8,0.5,3,6,0.5,0,0,0.0,1,2,3,3,0,0,0,2,11,15,1,Nickeil Alexander-Walker,MIN,MIN,NYK,,,17,14,14,6
22023,1629638,22300203,"NOV 18, 2023",MIN @ NOP,W,18,4,7,0.571,2,4,0.5,0,0,0.0,0,1,1,3,1,1,2,2,10,6,1,Nickeil Alexander-Walker,MIN,NOP,MIN,,,14,11,13,4
22023,1629638,22300197,"NOV 15, 2023",MIN @ PHX,L,23,3,6,0.5,2,5,0.4,0,0,0.0,0,0,0,0,0,1,0,1,8,-5,1,Nickeil Alexander-Walker,MIN,PHX,MIN,,,8,8,8,0
22023,1629638,22300025,"NOV 14, 2023",MIN @ GSW,W,25,2,5,0.4,1,4,0.25,0,0,0.0,0,0,0,1,1,1,2,1,5,-16,1,Nickeil Alexander-Walker,MIN,GSW,MIN,,,6,5,6,1
22023,1629638,22300186,"NOV 12, 2023",MIN @ GSW,W,17,4,6,0.667,2,3,0.667,0,0,0.0,0,2,2,1,2,0,0,2,10,0,1,Nickeil Alexander-Walker,MIN,GSW,MIN,,,13,12,11,3
22023,1629638,22300013,"NOV 10, 2023",MIN @ SAS,W,19,3,4,0.75,1,1,1.0,2,2,1.0,0,3,3,4,0,1,0,0,9,11,1,Nickeil Alexander-Walker,MIN,SAS,MIN,,,16,12,13,7
22023,1629638,22300166,"NOV 08, 2023",MIN vs. NOP,W,18,0,1,0.0,0,1,0.0,0,0,0.0,0,4,4,8,1,0,2,0,0,-13,1,Nickeil Alexander-Walker,MIN,MIN,NOP,,,12,4,8,12
22023,1629638,22300154,"NOV 06, 2023",MIN vs. BOS,W,20,3,6,0.5,2,4,0.5,0,1,0.0,0,1,1,3,1,0,1,3,8,13,1,Nickeil Alexander-Walker,MIN,MIN,BOS,,,12,9,11,4
22023,1629638,22300138,"NOV 04, 2023",MIN vs. UTA,W,18,0,3,0.0,0,1,0.0,0,1,0.0,1,2,3,1,2,3,0,0,0,1,1,Nickeil Alexander-Walker,MIN,MIN,UTA,,,4,3,1,4
22023,1629638,22300123,"NOV 01, 2023",MIN vs. DEN,W,21,2,6,0.333,1,2,0.5,0,0,0.0,0,0,0,1,0,1,0,2,5,2,1,Nickeil Alexander-Walker,MIN,MIN,DEN,,,6,5,6,1
22023,1629638,22300104,"OCT 30, 2023",MIN @ ATL,L,13,1,3,0.333,1,3,0.333,0,2,0.0,0,0,0,2,0,0,1,1,3,-9,1,Nickeil Alexander-Walker,MIN,ATL,MIN,,,5,3,5,2
22023,1629638,22300093,"OCT 28, 2023",MIN vs. MIA,W,23,2,8,0.25,1,6,0.167,0,0,0.0,0,3,3,3,1,2,3,3,5,8,1,Nickeil Alexander-Walker,MIN,MIN,MIA,,,11,8,8,6
22023,1629638,22300069,"OCT 25, 2023",MIN @ TOR,L,23,1,5,0.2,0,3,0.0,0,0,0.0,0,4,4,2,1,0,1,3,2,-17,1,Nickeil Alexander-Walker,MIN,TOR,MIN,,,8,6,4,6
22023,1628960,22300554,"JAN 14, 2024",PHX @ POR,W,33,4,6,0.667,4,6,0.667,8,8,1.0,1,3,4,1,0,2,4,2,20,13,1,Grayson Allen,PHX,POR,PHX,12.5,Points,25,24,21,5
22023,1628960,22300554,"JAN 14, 2024",PHX @ POR,W,33,4,6,0.667,4,6,0.667,8,8,1.0,1,3,4,1,0,2,4,2,20,13,1,Grayson Allen,PHX,POR,PHX,19.5,Pts+Rebs+Asts,25,24,21,5
22023,1628960,22300554,"JAN 14, 2024",PHX @ POR,W,33,4,6,0.667,4,6,0.667,8,8,1.0,1,3,4,1,0,2,4,2,20,13,1,Grayson Allen,PHX,POR,PHX,24.0,Fantasy Score,25,24,21,5
22023,1628960,22300554,"JAN 14, 2024",PHX @ POR,W,33,4,6,0.667,4,6,0.667,8,8,1.0,1,3,4,1,0,2,4,2,20,13,1,Grayson Allen,PHX,POR,PHX,16.5,Pts+Rebs,25,24,21,5
22023,1628960,22300554,"JAN 14, 2024",PHX @ POR,W,33,4,6,0.667,4,6,0.667,8,8,1.0,1,3,4,1,0,2,4,2,20,13,1,Grayson Allen,PHX,POR,PHX,15.5,Pts+Asts,25,24,21,5
22023,1628960,22300554,"JAN 14, 2024",PHX @ POR,W,33,4,6,0.667,4,6,0.667,8,8,1.0,1,3,4,1,0,2,4,2,20,13,1,Grayson Allen,PHX,POR,PHX,2.5,3-PT Made,25,24,21,5
22023,1628960,22300554,"JAN 14, 2024",PHX @ POR,W,33,4,6,0.667,4,6,0.667,8,8,1.0,1,3,4,1,0,2,4,2,20,13,1,Grayson Allen,PHX,POR,PHX,0.5,Blocked Shots,25,24,21,5
22023,1628960,22300554,"JAN 14, 2024",PHX @ POR,W,33,4,6,0.667,4,6,0.667,8,8,1.0,1,3,4,1,0,2,4,2,20,13,1,Grayson Allen,PHX,POR,PHX,1.5,Blks+Stls,25,24,21,5
22023,1628960,22300531,"JAN 11, 2024",PHX @ LAL,W,30,2,8,0.25,1,6,0.167,0,0,0.0,1,4,5,3,0,0,0,3,5,32,1,Grayson Allen,PHX,LAL,PHX,12.5,Points,13,10,8,8
22023,1628960,22300531,"JAN 11, 2024",PHX @ LAL,W,30,2,8,0.25,1,6,0.167,0,0,0.0,1,4,5,3,0,0,0,3,5,32,1,Grayson Allen,PHX,LAL,PHX,19.5,Pts+Rebs+Asts,13,10,8,8
22023,1628960,22300531,"JAN 11, 2024",PHX @ LAL,W,30,2,8,0.25,1,6,0.167,0,0,0.0,1,4,5,3,0,0,0,3,5,32,1,Grayson Allen,PHX,LAL,PHX,24.0,Fantasy Score,13,10,8,8
22023,1628960,22300531,"JAN 11, 2024",PHX @ LAL,W,30,2,8,0.25,1,6,0.167,0,0,0.0,1,4,5,3,0,0,0,3,5,32,1,Grayson Allen,PHX,LAL,PHX,16.5,Pts+Rebs,13,10,8,8
22023,1628960,22300531,"JAN 11, 2024",PHX @ LAL,W,30,2,8,0.25,1,6,0.167,0,0,0.0,1,4,5,3,0,0,0,3,5,32,1,Grayson Allen,PHX,LAL,PHX,15.5,Pts+Asts,13,10,8,8
22023,1628960,22300531,"JAN 11, 2024",PHX @ LAL,W,30,2,8,0.25,1,6,0.167,0,0,0.0,1,4,5,3,0,0,0,3,5,32,1,Grayson Allen,PHX,LAL,PHX,2.5,3-PT Made,13,10,8,8
22023,1628960,22300531,"JAN 11, 2024",PHX @ LAL,W,30,2,8,0.25,1,6,0.167,0,0,0.0,1,4,5,3,0,0,0,3,5,32,1,Grayson Allen,PHX,LAL,PHX,0.5,Blocked Shots,13,10,8,8
22023,1628960,22300531,"JAN 11, 2024",PHX @ LAL,W,30,2,8,0.25,1,6,0.167,0,0,0.0,1,4,5,3,0,0,0,3,5,32,1,Grayson Allen,PHX,LAL,PHX,1.5,Blks+Stls,13,10,8,8
22023,1628960,22300511,"JAN 08, 2024",PHX @ LAC,L,31,1,3,0.333,1,3,0.333,5,5,1.0,0,3,3,2,0,0,1,1,8,-22,1,Grayson Allen,PHX,LAC,PHX,12.5,Points,13,11,10,5
22023,1628960,22300511,"JAN 08, 2024",PHX @ LAC,L,31,1,3,0.333,1,3,0.333,5,5,1.0,0,3,3,2,0,0,1,1,8,-22,1,Grayson Allen,PHX,LAC,PHX,19.5,Pts+Rebs+Asts,13,11,10,5
22023,1628960,22300511,"JAN 08, 2024",PHX @ LAC,L,31,1,3,0.333,1,3,0.333,5,5,1.0,0,3,3,2,0,0,1,1,8,-22,1,Grayson Allen,PHX,LAC,PHX,24.0,Fantasy Score,13,11,10,5
22023,1628960,22300511,"JAN 08, 2024",PHX @ LAC,L,31,1,3,0.333,1,3,0.333,5,5,1.0,0,3,3,2,0,0,1,1,8,-22,1,Grayson Allen,PHX,LAC,PHX,16.5,Pts+Rebs,13,11,10,5
22023,1628960,22300511,"JAN 08, 2024",PHX @ LAC,L,31,1,3,0.333,1,3,0.333,5,5,1.0,0,3,3,2,0,0,1,1,8,-22,1,Grayson Allen,PHX,LAC,PHX,15.5,Pts+Asts,13,11,10,5
22023,1628960,22300511,"JAN 08, 2024",PHX @ LAC,L,31,1,3,0.333,1,3,0.333,5,5,1.0,0,3,3,2,0,0,1,1,8,-22,1,Grayson Allen,PHX,LAC,PHX,2.5,3-PT Made,13,11,10,5
22023,1628960,22300511,"JAN 08, 2024",PHX @ LAC,L,31,1,3,0.333,1,3,0.333,5,5,1.0,0,3,3,2,0,0,1,1,8,-22,1,Grayson Allen,PHX,LAC,PHX,0.5,Blocked Shots,13,11,10,5
22023,1628960,22300511,"JAN 08, 2024",PHX @ LAC,L,31,1,3,0.333,1,3,0.333,5,5,1.0,0,3,3,2,0,0,1,1,8,-22,1,Grayson Allen,PHX,LAC,PHX,1.5,Blks+Stls,13,11,10,5
22023,1628960,22300503,"JAN 07, 2024",PHX vs. MEM,L,39,6,15,0.4,4,8,0.5,0,0,0.0,0,2,2,3,0,2,3,2,16,0,1,Grayson Allen,PHX,PHX,MEM,12.5,Points,21,18,19,5
22023,1628960,22300503,"JAN 07, 2024",PHX vs. MEM,L,39,6,15,0.4,4,8,0.5,0,0,0.0,0,2,2,3,0,2,3,2,16,0,1,Grayson Allen,PHX,PHX,MEM,19.5,Pts+Rebs+Asts,21,18,19,5
22023,1628960,22300503,"JAN 07, 2024",PHX vs. MEM,L,39,6,15,0.4,4,8,0.5,0,0,0.0,0,2,2,3,0,2,3,2,16,0,1,Grayson Allen,PHX,PHX,MEM,24.0,Fantasy Score,21,18,19,5
22023,1628960,22300503,"JAN 07, 2024",PHX vs. MEM,L,39,6,15,0.4,4,8,0.5,0,0,0.0,0,2,2,3,0,2,3,2,16,0,1,Grayson Allen,PHX,PHX,MEM,16.5,Pts+Rebs,21,18,19,5
22023,1628960,22300503,"JAN 07, 2024",PHX vs. MEM,L,39,6,15,0.4,4,8,0.5,0,0,0.0,0,2,2,3,0,2,3,2,16,0,1,Grayson Allen,PHX,PHX,MEM,15.5,Pts+Asts,21,18,19,5
22023,1628960,22300503,"JAN 07, 2024",PHX vs. MEM,L,39,6,15,0.4,4,8,0.5,0,0,0.0,0,2,2,3,0,2,3,2,16,0,1,Grayson Allen,PHX,PHX,MEM,2.5,3-PT Made,21,18,19,5
22023,1628960,22300503,"JAN 07, 2024",PHX vs. MEM,L,39,6,15,0.4,4,8,0.5,0,0,0.0,0,2,2,3,0,2,3,2,16,0,1,Grayson Allen,PHX,PHX,MEM,0.5,Blocked Shots,21,18,19,5
22023,1628960,22300503,"JAN 07, 2024",PHX vs. MEM,L,39,6,15,0.4,4,8,0.5,0,0,0.0,0,2,2,3,0,2,3,2,16,0,1,Grayson Allen,PHX,PHX,MEM,1.5,Blks+Stls,21,18,19,5
22023,1628960,22300489,"JAN 05, 2024",PHX vs. MIA,W,37,11,19,0.579,9,14,0.643,0,0,0.0,1,3,4,4,0,2,2,4,31,13,1,Grayson Allen,PHX,PHX,MIA,12.5,Points,39,35,35,8
22023,1628960,22300489,"JAN 05, 2024",PHX vs. MIA,W,37,11,19,0.579,9,14,0.643,0,0,0.0,1,3,4,4,0,2,2,4,31,13,1,Grayson Allen,PHX,PHX,MIA,19.5,Pts+Rebs+Asts,39,35,35,8
22023,1628960,22300489,"JAN 05, 2024",PHX vs. MIA,W,37,11,19,0.579,9,14,0.643,0,0,0.0,1,3,4,4,0,2,2,4,31,13,1,Grayson Allen,PHX,PHX,MIA,24.0,Fantasy Score,39,35,35,8
22023,1628960,22300489,"JAN 05, 2024",PHX vs. MIA,W,37,11,19,0.579,9,14,0.643,0,0,0.0,1,3,4,4,0,2,2,4,31,13,1,Grayson Allen,PHX,PHX,MIA,16.5,Pts+Rebs,39,35,35,8
22023,1628960,22300489,"JAN 05, 2024",PHX vs. MIA,W,37,11,19,0.579,9,14,0.643,0,0,0.0,1,3,4,4,0,2,2,4,31,13,1,Grayson Allen,PHX,PHX,MIA,15.5,Pts+Asts,39,35,35,8
22023,1628960,22300489,"JAN 05, 2024",PHX vs. MIA,W,37,11,19,0.579,9,14,0.643,0,0,0.0,1,3,4,4,0,2,2,4,31,13,1,Grayson Allen,PHX,PHX,MIA,2.5,3-PT Made,39,35,35,8
22023,1628960,22300489,"JAN 05, 2024",PHX vs. MIA,W,37,11,19,0.579,9,14,0.643,0,0,0.0,1,3,4,4,0,2,2,4,31,13,1,Grayson Allen,PHX,PHX,MIA,0.5,Blocked Shots,39,35,35,8
22023,1628960,22300489,"JAN 05, 2024",PHX vs. MIA,W,37,11,19,0.579,9,14,0.643,0,0,0.0,1,3,4,4,0,2,2,4,31,13,1,Grayson Allen,PHX,PHX,MIA,1.5,Blks+Stls,39,35,35,8
22023,1628960,22300473,"JAN 03, 2024",PHX vs. LAC,L,32,4,9,0.444,2,4,0.5,0,1,0.0,1,3,4,3,2,0,1,2,10,-19,1,Grayson Allen,PHX,PHX,LAC,12.5,Points,17,14,13,7
22023,1628960,22300473,"JAN 03, 2024",PHX vs. LAC,L,32,4,9,0.444,2,4,0.5,0,1,0.0,1,3,4,3,2,0,1,2,10,-19,1,Grayson Allen,PHX,PHX,LAC,19.5,Pts+Rebs+Asts,17,14,13,7
22023,1628960,22300473,"JAN 03, 2024",PHX vs. LAC,L,32,4,9,0.444,2,4,0.5,0,1,0.0,1,3,4,3,2,0,1,2,10,-19,1,Grayson Allen,PHX,PHX,LAC,24.0,Fantasy Score,17,14,13,7
22023,1628960,22300473,"JAN 03, 2024",PHX vs. LAC,L,32,4,9,0.444,2,4,0.5,0,1,0.0,1,3,4,3,2,0,1,2,10,-19,1,Grayson Allen,PHX,PHX,LAC,16.5,Pts+Rebs,17,14,13,7
22023,1628960,22300473,"JAN 03, 2024",PHX vs. LAC,L,32,4,9,0.444,2,4,0.5,0,1,0.0,1,3,4,3,2,0,1,2,10,-19,1,Grayson Allen,PHX,PHX,LAC,15.5,Pts+Asts,17,14,13,7
22023,1628960,22300473,"JAN 03, 2024",PHX vs. LAC,L,32,4,9,0.444,2,4,0.5,0,1,0.0,1,3,4,3,2,0,1,2,10,-19,1,Grayson Allen,PHX,PHX,LAC,2.5,3-PT Made,17,14,13,7
22023,1628960,22300473,"JAN 03, 2024",PHX vs. LAC,L,32,4,9,0.444,2,4,0.5,0,1,0.0,1,3,4,3,2,0,1,2,10,-19,1,Grayson Allen,PHX,PHX,LAC,0.5,Blocked Shots,17,14,13,7
22023,1628960,22300473,"JAN 03, 2024",PHX vs. LAC,L,32,4,9,0.444,2,4,0.5,0,1,0.0,1,3,4,3,2,0,1,2,10,-19,1,Grayson Allen,PHX,PHX,LAC,1.5,Blks+Stls,17,14,13,7
22023,1628960,22300456,"JAN 01, 2024",PHX vs. POR,W,28,4,7,0.571,2,5,0.4,2,2,1.0,0,2,2,4,2,1,1,1,12,16,1,Grayson Allen,PHX,PHX,POR,12.5,Points,18,14,16,6
22023,1628960,22300456,"JAN 01, 2024",PHX vs. POR,W,28,4,7,0.571,2,5,0.4,2,2,1.0,0,2,2,4,2,1,1,1,12,16,1,Grayson Allen,PHX,PHX,POR,19.5,Pts+Rebs+Asts,18,14,16,6
22023,1628960,22300456,"JAN 01, 2024",PHX vs. POR,W,28,4,7,0.571,2,5,0.4,2,2,1.0,0,2,2,4,2,1,1,1,12,16,1,Grayson Allen,PHX,PHX,POR,24.0,Fantasy Score,18,14,16,6
22023,1628960,22300456,"JAN 01, 2024",PHX vs. POR,W,28,4,7,0.571,2,5,0.4,2,2,1.0,0,2,2,4,2,1,1,1,12,16,1,Grayson Allen,PHX,PHX,POR,16.5,Pts+Rebs,18,14,16,6
22023,1628960,22300456,"JAN 01, 2024",PHX vs. POR,W,28,4,7,0.571,2,5,0.4,2,2,1.0,0,2,2,4,2,1,1,1,12,16,1,Grayson Allen,PHX,PHX,POR,15.5,Pts+Asts,18,14,16,6
22023,1628960,22300456,"JAN 01, 2024",PHX vs. POR,W,28,4,7,0.571,2,5,0.4,2,2,1.0,0,2,2,4,2,1,1,1,12,16,1,Grayson Allen,PHX,PHX,POR,2.5,3-PT Made,18,14,16,6
22023,1628960,22300456,"JAN 01, 2024",PHX vs. POR,W,28,4,7,0.571,2,5,0.4,2,2,1.0,0,2,2,4,2,1,1,1,12,16,1,Grayson Allen,PHX,PHX,POR,0.5,Blocked Shots,18,14,16,6
22023,1628960,22300456,"JAN 01, 2024",PHX vs. POR,W,28,4,7,0.571,2,5,0.4,2,2,1.0,0,2,2,4,2,1,1,1,12,16,1,Grayson Allen,PHX,PHX,POR,1.5,Blks+Stls,18,14,16,6
22023,1628960,22300450,"DEC 31, 2023",PHX vs. ORL,W,35,4,8,0.5,2,4,0.5,0,0,0.0,0,2,2,4,2,1,1,0,10,14,1,Grayson Allen,PHX,PHX,ORL,12.5,Points,16,12,14,6
22023,1628960,22300450,"DEC 31, 2023",PHX vs. ORL,W,35,4,8,0.5,2,4,0.5,0,0,0.0,0,2,2,4,2,1,1,0,10,14,1,Grayson Allen,PHX,PHX,ORL,19.5,Pts+Rebs+Asts,16,12,14,6
22023,1628960,22300450,"DEC 31, 2023",PHX vs. ORL,W,35,4,8,0.5,2,4,0.5,0,0,0.0,0,2,2,4,2,1,1,0,10,14,1,Grayson Allen,PHX,PHX,ORL,24.0,Fantasy Score,16,12,14,6
22023,1628960,22300450,"DEC 31, 2023",PHX vs. ORL,W,35,4,8,0.5,2,4,0.5,0,0,0.0,0,2,2,4,2,1,1,0,10,14,1,Grayson Allen,PHX,PHX,ORL,16.5,Pts+Rebs,16,12,14,6
22023,1628960,22300450,"DEC 31, 2023",PHX vs. ORL,W,35,4,8,0.5,2,4,0.5,0,0,0.0,0,2,2,4,2,1,1,0,10,14,1,Grayson Allen,PHX,PHX,ORL,15.5,Pts+Asts,16,12,14,6
22023,1628960,22300450,"DEC 31, 2023",PHX vs. ORL,W,35,4,8,0.5,2,4,0.5,0,0,0.0,0,2,2,4,2,1,1,0,10,14,1,Grayson Allen,PHX,PHX,ORL,2.5,3-PT Made,16,12,14,6
22023,1628960,22300450,"DEC 31, 2023",PHX vs. ORL,W,35,4,8,0.5,2,4,0.5,0,0,0.0,0,2,2,4,2,1,1,0,10,14,1,Grayson Allen,PHX,PHX,ORL,0.5,Blocked Shots,16,12,14,6
22023,1628960,22300450,"DEC 31, 2023",PHX vs. ORL,W,35,4,8,0.5,2,4,0.5,0,0,0.0,0,2,2,4,2,1,1,0,10,14,1,Grayson Allen,PHX,PHX,ORL,1.5,Blks+Stls,16,12,14,6
22023,1628960,22300436,"DEC 29, 2023",PHX vs. CHA,W,33,6,8,0.75,2,4,0.5,2,2,1.0,1,3,4,3,0,1,1,2,16,15,1,Grayson Allen,PHX,PHX,CHA,12.5,Points,23,20,19,7
22023,1628960,22300436,"DEC 29, 2023",PHX vs. CHA,W,33,6,8,0.75,2,4,0.5,2,2,1.0,1,3,4,3,0,1,1,2,16,15,1,Grayson Allen,PHX,PHX,CHA,19.5,Pts+Rebs+Asts,23,20,19,7
22023,1628960,22300436,"DEC 29, 2023",PHX vs. CHA,W,33,6,8,0.75,2,4,0.5,2,2,1.0,1,3,4,3,0,1,1,2,16,15,1,Grayson Allen,PHX,PHX,CHA,24.0,Fantasy Score,23,20,19,7
22023,1628960,22300436,"DEC 29, 2023",PHX vs. CHA,W,33,6,8,0.75,2,4,0.5,2,2,1.0,1,3,4,3,0,1,1,2,16,15,1,Grayson Allen,PHX,PHX,CHA,16.5,Pts+Rebs,23,20,19,7
22023,1628960,22300436,"DEC 29, 2023",PHX vs. CHA,W,33,6,8,0.75,2,4,0.5,2,2,1.0,1,3,4,3,0,1,1,2,16,15,1,Grayson Allen,PHX,PHX,CHA,15.5,Pts+Asts,23,20,19,7
22023,1628960,22300436,"DEC 29, 2023",PHX vs. CHA,W,33,6,8,0.75,2,4,0.5,2,2,1.0,1,3,4,3,0,1,1,2,16,15,1,Grayson Allen,PHX,PHX,CHA,2.5,3-PT Made,23,20,19,7
22023,1628960,22300436,"DEC 29, 2023",PHX vs. CHA,W,33,6,8,0.75,2,4,0.5,2,2,1.0,1,3,4,3,0,1,1,2,16,15,1,Grayson Allen,PHX,PHX,CHA,0.5,Blocked Shots,23,20,19,7
22023,1628960,22300436,"DEC 29, 2023",PHX vs. CHA,W,33,6,8,0.75,2,4,0.5,2,2,1.0,1,3,4,3,0,1,1,2,16,15,1,Grayson Allen,PHX,PHX,CHA,1.5,Blks+Stls,23,20,19,7
22023,1628960,22300418,"DEC 27, 2023",PHX @ HOU,W,33,5,7,0.714,2,4,0.5,4,4,1.0,1,3,4,3,0,1,3,1,16,15,1,Grayson Allen,PHX,HOU,PHX,12.5,Points,23,20,19,7
22023,1628960,22300418,"DEC 27, 2023",PHX @ HOU,W,33,5,7,0.714,2,4,0.5,4,4,1.0,1,3,4,3,0,1,3,1,16,15,1,Grayson Allen,PHX,HOU,PHX,19.5,Pts+Rebs+Asts,23,20,19,7
22023,1628960,22300418,"DEC 27, 2023",PHX @ HOU,W,33,5,7,0.714,2,4,0.5,4,4,1.0,1,3,4,3,0,1,3,1,16,15,1,Grayson Allen,PHX,HOU,PHX,24.0,Fantasy Score,23,20,19,7
22023,1628960,22300418,"DEC 27, 2023",PHX @ HOU,W,33,5,7,0.714,2,4,0.5,4,4,1.0,1,3,4,3,0,1,3,1,16,15,1,Grayson Allen,PHX,HOU,PHX,16.5,Pts+Rebs,23,20,19,7
22023,1628960,22300418,"DEC 27, 2023",PHX @ HOU,W,33,5,7,0.714,2,4,0.5,4,4,1.0,1,3,4,3,0,1,3,1,16,15,1,Grayson Allen,PHX,HOU,PHX,15.5,Pts+Asts,23,20,19,7
22023,1628960,22300418,"DEC 27, 2023",PHX @ HOU,W,33,5,7,0.714,2,4,0.5,4,4,1.0,1,3,4,3,0,1,3,1,16,15,1,Grayson Allen,PHX,HOU,PHX,2.5,3-PT Made,23,20,19,7
22023,1628960,22300418,"DEC 27, 2023",PHX @ HOU,W,33,5,7,0.714,2,4,0.5,4,4,1.0,1,3,4,3,0,1,3,1,16,15,1,Grayson Allen,PHX,HOU,PHX,0.5,Blocked Shots,23,20,19,7
22023,1628960,22300418,"DEC 27, 2023",PHX @ HOU,W,33,5,7,0.714,2,4,0.5,4,4,1.0,1,3,4,3,0,1,3,1,16,15,1,Grayson Allen,PHX,HOU,PHX,1.5,Blks+Stls,23,20,19,7
22023,1628960,22300405,"DEC 25, 2023",PHX vs. DAL,L,39,12,22,0.545,8,17,0.471,0,0,0.0,1,3,4,4,1,0,2,4,32,-5,1,Grayson Allen,PHX,PHX,DAL,12.5,Points,40,36,36,8
22023,1628960,22300405,"DEC 25, 2023",PHX vs. DAL,L,39,12,22,0.545,8,17,0.471,0,0,0.0,1,3,4,4,1,0,2,4,32,-5,1,Grayson Allen,PHX,PHX,DAL,19.5,Pts+Rebs+Asts,40,36,36,8
22023,1628960,22300405,"DEC 25, 2023",PHX vs. DAL,L,39,12,22,0.545,8,17,0.471,0,0,0.0,1,3,4,4,1,0,2,4,32,-5,1,Grayson Allen,PHX,PHX,DAL,24.0,Fantasy Score,40,36,36,8
22023,1628960,22300405,"DEC 25, 2023",PHX vs. DAL,L,39,12,22,0.545,8,17,0.471,0,0,0.0,1,3,4,4,1,0,2,4,32,-5,1,Grayson Allen,PHX,PHX,DAL,16.5,Pts+Rebs,40,36,36,8
22023,1628960,22300405,"DEC 25, 2023",PHX vs. DAL,L,39,12,22,0.545,8,17,0.471,0,0,0.0,1,3,4,4,1,0,2,4,32,-5,1,Grayson Allen,PHX,PHX,DAL,15.5,Pts+Asts,40,36,36,8
22023,1628960,22300405,"DEC 25, 2023",PHX vs. DAL,L,39,12,22,0.545,8,17,0.471,0,0,0.0,1,3,4,4,1,0,2,4,32,-5,1,Grayson Allen,PHX,PHX,DAL,2.5,3-PT Made,40,36,36,8
22023,1628960,22300405,"DEC 25, 2023",PHX vs. DAL,L,39,12,22,0.545,8,17,0.471,0,0,0.0,1,3,4,4,1,0,2,4,32,-5,1,Grayson Allen,PHX,PHX,DAL,0.5,Blocked Shots,40,36,36,8
22023,1628960,22300405,"DEC 25, 2023",PHX vs. DAL,L,39,12,22,0.545,8,17,0.471,0,0,0.0,1,3,4,4,1,0,2,4,32,-5,1,Grayson Allen,PHX,PHX,DAL,1.5,Blks+Stls,40,36,36,8
22023,1628960,22300387,"DEC 22, 2023",PHX @ SAC,L,30,4,10,0.4,3,6,0.5,0,0,0.0,2,2,4,2,3,1,1,1,11,-20,1,Grayson Allen,PHX,SAC,PHX,12.5,Points,17,15,13,6
22023,1628960,22300387,"DEC 22, 2023",PHX @ SAC,L,30,4,10,0.4,3,6,0.5,0,0,0.0,2,2,4,2,3,1,1,1,11,-20,1,Grayson Allen,PHX,SAC,PHX,19.5,Pts+Rebs+Asts,17,15,13,6
22023,1628960,22300387,"DEC 22, 2023",PHX @ SAC,L,30,4,10,0.4,3,6,0.5,0,0,0.0,2,2,4,2,3,1,1,1,11,-20,1,Grayson Allen,PHX,SAC,PHX,24.0,Fantasy Score,17,15,13,6
22023,1628960,22300387,"DEC 22, 2023",PHX @ SAC,L,30,4,10,0.4,3,6,0.5,0,0,0.0,2,2,4,2,3,1,1,1,11,-20,1,Grayson Allen,PHX,SAC,PHX,16.5,Pts+Rebs,17,15,13,6
22023,1628960,22300387,"DEC 22, 2023",PHX @ SAC,L,30,4,10,0.4,3,6,0.5,0,0,0.0,2,2,4,2,3,1,1,1,11,-20,1,Grayson Allen,PHX,SAC,PHX,15.5,Pts+Asts,17,15,13,6
22023,1628960,22300387,"DEC 22, 2023",PHX @ SAC,L,30,4,10,0.4,3,6,0.5,0,0,0.0,2,2,4,2,3,1,1,1,11,-20,1,Grayson Allen,PHX,SAC,PHX,2.5,3-PT Made,17,15,13,6
22023,1628960,22300387,"DEC 22, 2023",PHX @ SAC,L,30,4,10,0.4,3,6,0.5,0,0,0.0,2,2,4,2,3,1,1,1,11,-20,1,Grayson Allen,PHX,SAC,PHX,0.5,Blocked Shots,17,15,13,6
22023,1628960,22300387,"DEC 22, 2023",PHX @ SAC,L,30,4,10,0.4,3,6,0.5,0,0,0.0,2,2,4,2,3,1,1,1,11,-20,1,Grayson Allen,PHX,SAC,PHX,1.5,Blks+Stls,17,15,13,6
22023,1628960,22300363,"DEC 19, 2023",PHX @ POR,L,33,5,10,0.5,1,5,0.2,0,1,0.0,2,7,9,0,2,0,0,3,11,-8,1,Grayson Allen,PHX,POR,PHX,12.5,Points,20,20,11,9
22023,1628960,22300363,"DEC 19, 2023",PHX @ POR,L,33,5,10,0.5,1,5,0.2,0,1,0.0,2,7,9,0,2,0,0,3,11,-8,1,Grayson Allen,PHX,POR,PHX,19.5,Pts+Rebs+Asts,20,20,11,9
22023,1628960,22300363,"DEC 19, 2023",PHX @ POR,L,33,5,10,0.5,1,5,0.2,0,1,0.0,2,7,9,0,2,0,0,3,11,-8,1,Grayson Allen,PHX,POR,PHX,24.0,Fantasy Score,20,20,11,9
22023,1628960,22300363,"DEC 19, 2023",PHX @ POR,L,33,5,10,0.5,1,5,0.2,0,1,0.0,2,7,9,0,2,0,0,3,11,-8,1,Grayson Allen,PHX,POR,PHX,16.5,Pts+Rebs,20,20,11,9
22023,1628960,22300363,"DEC 19, 2023",PHX @ POR,L,33,5,10,0.5,1,5,0.2,0,1,0.0,2,7,9,0,2,0,0,3,11,-8,1,Grayson Allen,PHX,POR,PHX,15.5,Pts+Asts,20,20,11,9
22023,1628960,22300363,"DEC 19, 2023",PHX @ POR,L,33,5,10,0.5,1,5,0.2,0,1,0.0,2,7,9,0,2,0,0,3,11,-8,1,Grayson Allen,PHX,POR,PHX,2.5,3-PT Made,20,20,11,9
22023,1628960,22300363,"DEC 19, 2023",PHX @ POR,L,33,5,10,0.5,1,5,0.2,0,1,0.0,2,7,9,0,2,0,0,3,11,-8,1,Grayson Allen,PHX,POR,PHX,0.5,Blocked Shots,20,20,11,9
22023,1628960,22300363,"DEC 19, 2023",PHX @ POR,L,33,5,10,0.5,1,5,0.2,0,1,0.0,2,7,9,0,2,0,0,3,11,-8,1,Grayson Allen,PHX,POR,PHX,1.5,Blks+Stls,20,20,11,9
22023,1628960,22300347,"DEC 17, 2023",PHX vs. WAS,W,33,2,8,0.25,1,6,0.167,6,6,1.0,1,3,4,3,2,2,1,2,11,-4,1,Grayson Allen,PHX,PHX,WAS,12.5,Points,18,15,14,7
22023,1628960,22300347,"DEC 17, 2023",PHX vs. WAS,W,33,2,8,0.25,1,6,0.167,6,6,1.0,1,3,4,3,2,2,1,2,11,-4,1,Grayson Allen,PHX,PHX,WAS,19.5,Pts+Rebs+Asts,18,15,14,7
22023,1628960,22300347,"DEC 17, 2023",PHX vs. WAS,W,33,2,8,0.25,1,6,0.167,6,6,1.0,1,3,4,3,2,2,1,2,11,-4,1,Grayson Allen,PHX,PHX,WAS,24.0,Fantasy Score,18,15,14,7
22023,1628960,22300347,"DEC 17, 2023",PHX vs. WAS,W,33,2,8,0.25,1,6,0.167,6,6,1.0,1,3,4,3,2,2,1,2,11,-4,1,Grayson Allen,PHX,PHX,WAS,16.5,Pts+Rebs,18,15,14,7
22023,1628960,22300347,"DEC 17, 2023",PHX vs. WAS,W,33,2,8,0.25,1,6,0.167,6,6,1.0,1,3,4,3,2,2,1,2,11,-4,1,Grayson Allen,PHX,PHX,WAS,15.5,Pts+Asts,18,15,14,7
22023,1628960,22300347,"DEC 17, 2023",PHX vs. WAS,W,33,2,8,0.25,1,6,0.167,6,6,1.0,1,3,4,3,2,2,1,2,11,-4,1,Grayson Allen,PHX,PHX,WAS,2.5,3-PT Made,18,15,14,7
22023,1628960,22300347,"DEC 17, 2023",PHX vs. WAS,W,33,2,8,0.25,1,6,0.167,6,6,1.0,1,3,4,3,2,2,1,2,11,-4,1,Grayson Allen,PHX,PHX,WAS,0.5,Blocked Shots,18,15,14,7
22023,1628960,22300347,"DEC 17, 2023",PHX vs. WAS,W,33,2,8,0.25,1,6,0.167,6,6,1.0,1,3,4,3,2,2,1,2,11,-4,1,Grayson Allen,PHX,PHX,WAS,1.5,Blks+Stls,18,15,14,7
22023,1628960,22300333,"DEC 15, 2023",PHX vs. NYK,L,36,5,5,1.0,2,2,1.0,1,1,1.0,2,0,2,1,2,1,2,4,13,-14,1,Grayson Allen,PHX,PHX,NYK,12.5,Points,16,15,14,3
22023,1628960,22300333,"DEC 15, 2023",PHX vs. NYK,L,36,5,5,1.0,2,2,1.0,1,1,1.0,2,0,2,1,2,1,2,4,13,-14,1,Grayson Allen,PHX,PHX,NYK,19.5,Pts+Rebs+Asts,16,15,14,3
22023,1628960,22300333,"DEC 15, 2023",PHX vs. NYK,L,36,5,5,1.0,2,2,1.0,1,1,1.0,2,0,2,1,2,1,2,4,13,-14,1,Grayson Allen,PHX,PHX,NYK,24.0,Fantasy Score,16,15,14,3
22023,1628960,22300333,"DEC 15, 2023",PHX vs. NYK,L,36,5,5,1.0,2,2,1.0,1,1,1.0,2,0,2,1,2,1,2,4,13,-14,1,Grayson Allen,PHX,PHX,NYK,16.5,Pts+Rebs,16,15,14,3
22023,1628960,22300333,"DEC 15, 2023",PHX vs. NYK,L,36,5,5,1.0,2,2,1.0,1,1,1.0,2,0,2,1,2,1,2,4,13,-14,1,Grayson Allen,PHX,PHX,NYK,15.5,Pts+Asts,16,15,14,3
22023,1628960,22300333,"DEC 15, 2023",PHX vs. NYK,L,36,5,5,1.0,2,2,1.0,1,1,1.0,2,0,2,1,2,1,2,4,13,-14,1,Grayson Allen,PHX,PHX,NYK,2.5,3-PT Made,16,15,14,3
22023,1628960,22300333,"DEC 15, 2023",PHX vs. NYK,L,36,5,5,1.0,2,2,1.0,1,1,1.0,2,0,2,1,2,1,2,4,13,-14,1,Grayson Allen,PHX,PHX,NYK,0.5,Blocked Shots,16,15,14,3
22023,1628960,22300333,"DEC 15, 2023",PHX vs. NYK,L,36,5,5,1.0,2,2,1.0,1,1,1.0,2,0,2,1,2,1,2,4,13,-14,1,Grayson Allen,PHX,PHX,NYK,1.5,Blks+Stls,16,15,14,3
22023,1628960,22301203,"DEC 05, 2023",PHX @ LAL,L,39,6,14,0.429,4,8,0.5,5,5,1.0,0,2,2,2,2,1,0,2,21,-7,1,Grayson Allen,PHX,LAL,PHX,12.5,Points,25,23,23,4
22023,1628960,22301203,"DEC 05, 2023",PHX @ LAL,L,39,6,14,0.429,4,8,0.5,5,5,1.0,0,2,2,2,2,1,0,2,21,-7,1,Grayson Allen,PHX,LAL,PHX,19.5,Pts+Rebs+Asts,25,23,23,4
22023,1628960,22301203,"DEC 05, 2023",PHX @ LAL,L,39,6,14,0.429,4,8,0.5,5,5,1.0,0,2,2,2,2,1,0,2,21,-7,1,Grayson Allen,PHX,LAL,PHX,24.0,Fantasy Score,25,23,23,4
22023,1628960,22301203,"DEC 05, 2023",PHX @ LAL,L,39,6,14,0.429,4,8,0.5,5,5,1.0,0,2,2,2,2,1,0,2,21,-7,1,Grayson Allen,PHX,LAL,PHX,16.5,Pts+Rebs,25,23,23,4
22023,1628960,22301203,"DEC 05, 2023",PHX @ LAL,L,39,6,14,0.429,4,8,0.5,5,5,1.0,0,2,2,2,2,1,0,2,21,-7,1,Grayson Allen,PHX,LAL,PHX,15.5,Pts+Asts,25,23,23,4
22023,1628960,22301203,"DEC 05, 2023",PHX @ LAL,L,39,6,14,0.429,4,8,0.5,5,5,1.0,0,2,2,2,2,1,0,2,21,-7,1,Grayson Allen,PHX,LAL,PHX,2.5,3-PT Made,25,23,23,4
22023,1628960,22301203,"DEC 05, 2023",PHX @ LAL,L,39,6,14,0.429,4,8,0.5,5,5,1.0,0,2,2,2,2,1,0,2,21,-7,1,Grayson Allen,PHX,LAL,PHX,0.5,Blocked Shots,25,23,23,4
22023,1628960,22301203,"DEC 05, 2023",PHX @ LAL,L,39,6,14,0.429,4,8,0.5,5,5,1.0,0,2,2,2,2,1,0,2,21,-7,1,Grayson Allen,PHX,LAL,PHX,1.5,Blks+Stls,25,23,23,4
22023,1628960,22300288,"DEC 02, 2023",PHX vs. MEM,W,33,1,4,0.25,1,2,0.5,6,6,1.0,1,1,2,4,1,0,2,1,9,8,1,Grayson Allen,PHX,PHX,MEM,12.5,Points,15,11,13,6
22023,1628960,22300288,"DEC 02, 2023",PHX vs. MEM,W,33,1,4,0.25,1,2,0.5,6,6,1.0,1,1,2,4,1,0,2,1,9,8,1,Grayson Allen,PHX,PHX,MEM,19.5,Pts+Rebs+Asts,15,11,13,6
22023,1628960,22300288,"DEC 02, 2023",PHX vs. MEM,W,33,1,4,0.25,1,2,0.5,6,6,1.0,1,1,2,4,1,0,2,1,9,8,1,Grayson Allen,PHX,PHX,MEM,24.0,Fantasy Score,15,11,13,6
22023,1628960,22300288,"DEC 02, 2023",PHX vs. MEM,W,33,1,4,0.25,1,2,0.5,6,6,1.0,1,1,2,4,1,0,2,1,9,8,1,Grayson Allen,PHX,PHX,MEM,16.5,Pts+Rebs,15,11,13,6
22023,1628960,22300288,"DEC 02, 2023",PHX vs. MEM,W,33,1,4,0.25,1,2,0.5,6,6,1.0,1,1,2,4,1,0,2,1,9,8,1,Grayson Allen,PHX,PHX,MEM,15.5,Pts+Asts,15,11,13,6
22023,1628960,22300288,"DEC 02, 2023",PHX vs. MEM,W,33,1,4,0.25,1,2,0.5,6,6,1.0,1,1,2,4,1,0,2,1,9,8,1,Grayson Allen,PHX,PHX,MEM,2.5,3-PT Made,15,11,13,6
22023,1628960,22300288,"DEC 02, 2023",PHX vs. MEM,W,33,1,4,0.25,1,2,0.5,6,6,1.0,1,1,2,4,1,0,2,1,9,8,1,Grayson Allen,PHX,PHX,MEM,0.5,Blocked Shots,15,11,13,6
22023,1628960,22300288,"DEC 02, 2023",PHX vs. MEM,W,33,1,4,0.25,1,2,0.5,6,6,1.0,1,1,2,4,1,0,2,1,9,8,1,Grayson Allen,PHX,PHX,MEM,1.5,Blks+Stls,15,11,13,6
22023,1628960,22300279,"DEC 01, 2023",PHX vs. DEN,L,37,5,9,0.556,1,4,0.25,2,2,1.0,0,10,10,3,1,0,0,2,13,-4,1,Grayson Allen,PHX,PHX,DEN,12.5,Points,26,23,16,13
22023,1628960,22300279,"DEC 01, 2023",PHX vs. DEN,L,37,5,9,0.556,1,4,0.25,2,2,1.0,0,10,10,3,1,0,0,2,13,-4,1,Grayson Allen,PHX,PHX,DEN,19.5,Pts+Rebs+Asts,26,23,16,13
22023,1628960,22300279,"DEC 01, 2023",PHX vs. DEN,L,37,5,9,0.556,1,4,0.25,2,2,1.0,0,10,10,3,1,0,0,2,13,-4,1,Grayson Allen,PHX,PHX,DEN,24.0,Fantasy Score,26,23,16,13
22023,1628960,22300279,"DEC 01, 2023",PHX vs. DEN,L,37,5,9,0.556,1,4,0.25,2,2,1.0,0,10,10,3,1,0,0,2,13,-4,1,Grayson Allen,PHX,PHX,DEN,16.5,Pts+Rebs,26,23,16,13
22023,1628960,22300279,"DEC 01, 2023",PHX vs. DEN,L,37,5,9,0.556,1,4,0.25,2,2,1.0,0,10,10,3,1,0,0,2,13,-4,1,Grayson Allen,PHX,PHX,DEN,15.5,Pts+Asts,26,23,16,13
22023,1628960,22300279,"DEC 01, 2023",PHX vs. DEN,L,37,5,9,0.556,1,4,0.25,2,2,1.0,0,10,10,3,1,0,0,2,13,-4,1,Grayson Allen,PHX,PHX,DEN,2.5,3-PT Made,26,23,16,13
22023,1628960,22300279,"DEC 01, 2023",PHX vs. DEN,L,37,5,9,0.556,1,4,0.25,2,2,1.0,0,10,10,3,1,0,0,2,13,-4,1,Grayson Allen,PHX,PHX,DEN,0.5,Blocked Shots,26,23,16,13
22023,1628960,22300279,"DEC 01, 2023",PHX vs. DEN,L,37,5,9,0.556,1,4,0.25,2,2,1.0,0,10,10,3,1,0,0,2,13,-4,1,Grayson Allen,PHX,PHX,DEN,1.5,Blks+Stls,26,23,16,13
22023,1628960,22300044,"NOV 24, 2023",PHX @ MEM,W,37,5,9,0.556,2,4,0.5,2,3,0.667,0,2,2,3,0,1,1,2,14,1,1,Grayson Allen,PHX,MEM,PHX,12.5,Points,19,16,17,5
22023,1628960,22300044,"NOV 24, 2023",PHX @ MEM,W,37,5,9,0.556,2,4,0.5,2,3,0.667,0,2,2,3,0,1,1,2,14,1,1,Grayson Allen,PHX,MEM,PHX,19.5,Pts+Rebs+Asts,19,16,17,5
22023,1628960,22300044,"NOV 24, 2023",PHX @ MEM,W,37,5,9,0.556,2,4,0.5,2,3,0.667,0,2,2,3,0,1,1,2,14,1,1,Grayson Allen,PHX,MEM,PHX,24.0,Fantasy Score,19,16,17,5
22023,1628960,22300044,"NOV 24, 2023",PHX @ MEM,W,37,5,9,0.556,2,4,0.5,2,3,0.667,0,2,2,3,0,1,1,2,14,1,1,Grayson Allen,PHX,MEM,PHX,16.5,Pts+Rebs,19,16,17,5
22023,1628960,22300044,"NOV 24, 2023",PHX @ MEM,W,37,5,9,0.556,2,4,0.5,2,3,0.667,0,2,2,3,0,1,1,2,14,1,1,Grayson Allen,PHX,MEM,PHX,15.5,Pts+Asts,19,16,17,5
22023,1628960,22300044,"NOV 24, 2023",PHX @ MEM,W,37,5,9,0.556,2,4,0.5,2,3,0.667,0,2,2,3,0,1,1,2,14,1,1,Grayson Allen,PHX,MEM,PHX,2.5,3-PT Made,19,16,17,5
22023,1628960,22300044,"NOV 24, 2023",PHX @ MEM,W,37,5,9,0.556,2,4,0.5,2,3,0.667,0,2,2,3,0,1,1,2,14,1,1,Grayson Allen,PHX,MEM,PHX,0.5,Blocked Shots,19,16,17,5
22023,1628960,22300044,"NOV 24, 2023",PHX @ MEM,W,37,5,9,0.556,2,4,0.5,2,3,0.667,0,2,2,3,0,1,1,2,14,1,1,Grayson Allen,PHX,MEM,PHX,1.5,Blks+Stls,19,16,17,5
22023,1628960,22300236,"NOV 22, 2023",PHX vs. GSW,W,34,1,4,0.25,1,4,0.25,6,8,0.75,1,2,3,3,1,0,2,5,9,13,1,Grayson Allen,PHX,PHX,GSW,12.5,Points,15,12,12,6
22023,1628960,22300236,"NOV 22, 2023",PHX vs. GSW,W,34,1,4,0.25,1,4,0.25,6,8,0.75,1,2,3,3,1,0,2,5,9,13,1,Grayson Allen,PHX,PHX,GSW,19.5,Pts+Rebs+Asts,15,12,12,6
22023,1628960,22300236,"NOV 22, 2023",PHX vs. GSW,W,34,1,4,0.25,1,4,0.25,6,8,0.75,1,2,3,3,1,0,2,5,9,13,1,Grayson Allen,PHX,PHX,GSW,24.0,Fantasy Score,15,12,12,6
22023,1628960,22300236,"NOV 22, 2023",PHX vs. GSW,W,34,1,4,0.25,1,4,0.25,6,8,0.75,1,2,3,3,1,0,2,5,9,13,1,Grayson Allen,PHX,PHX,GSW,16.5,Pts+Rebs,15,12,12,6
22023,1628960,22300236,"NOV 22, 2023",PHX vs. GSW,W,34,1,4,0.25,1,4,0.25,6,8,0.75,1,2,3,3,1,0,2,5,9,13,1,Grayson Allen,PHX,PHX,GSW,15.5,Pts+Asts,15,12,12,6
22023,1628960,22300236,"NOV 22, 2023",PHX vs. GSW,W,34,1,4,0.25,1,4,0.25,6,8,0.75,1,2,3,3,1,0,2,5,9,13,1,Grayson Allen,PHX,PHX,GSW,2.5,3-PT Made,15,12,12,6
22023,1628960,22300236,"NOV 22, 2023",PHX vs. GSW,W,34,1,4,0.25,1,4,0.25,6,8,0.75,1,2,3,3,1,0,2,5,9,13,1,Grayson Allen,PHX,PHX,GSW,0.5,Blocked Shots,15,12,12,6
22023,1628960,22300236,"NOV 22, 2023",PHX vs. GSW,W,34,1,4,0.25,1,4,0.25,6,8,0.75,1,2,3,3,1,0,2,5,9,13,1,Grayson Allen,PHX,PHX,GSW,1.5,Blks+Stls,15,12,12,6
22023,1628960,22300041,"NOV 21, 2023",PHX vs. POR,W,35,4,5,0.8,0,1,0.0,0,0,0.0,0,6,6,5,2,0,1,1,8,6,1,Grayson Allen,PHX,PHX,POR,12.5,Points,19,14,13,11
22023,1628960,22300041,"NOV 21, 2023",PHX vs. POR,W,35,4,5,0.8,0,1,0.0,0,0,0.0,0,6,6,5,2,0,1,1,8,6,1,Grayson Allen,PHX,PHX,POR,19.5,Pts+Rebs+Asts,19,14,13,11
22023,1628960,22300041,"NOV 21, 2023",PHX vs. POR,W,35,4,5,0.8,0,1,0.0,0,0,0.0,0,6,6,5,2,0,1,1,8,6,1,Grayson Allen,PHX,PHX,POR,24.0,Fantasy Score,19,14,13,11
22023,1628960,22300041,"NOV 21, 2023",PHX vs. POR,W,35,4,5,0.8,0,1,0.0,0,0,0.0,0,6,6,5,2,0,1,1,8,6,1,Grayson Allen,PHX,PHX,POR,16.5,Pts+Rebs,19,14,13,11
22023,1628960,22300041,"NOV 21, 2023",PHX vs. POR,W,35,4,5,0.8,0,1,0.0,0,0,0.0,0,6,6,5,2,0,1,1,8,6,1,Grayson Allen,PHX,PHX,POR,15.5,Pts+Asts,19,14,13,11
22023,1628960,22300041,"NOV 21, 2023",PHX vs. POR,W,35,4,5,0.8,0,1,0.0,0,0,0.0,0,6,6,5,2,0,1,1,8,6,1,Grayson Allen,PHX,PHX,POR,2.5,3-PT Made,19,14,13,11
22023,1628960,22300041,"NOV 21, 2023",PHX vs. POR,W,35,4,5,0.8,0,1,0.0,0,0,0.0,0,6,6,5,2,0,1,1,8,6,1,Grayson Allen,PHX,PHX,POR,0.5,Blocked Shots,19,14,13,11
22023,1628960,22300041,"NOV 21, 2023",PHX vs. POR,W,35,4,5,0.8,0,1,0.0,0,0,0.0,0,6,6,5,2,0,1,1,8,6,1,Grayson Allen,PHX,PHX,POR,1.5,Blks+Stls,19,14,13,11
22023,1628960,22300214,"NOV 19, 2023",PHX @ UTA,W,43,5,8,0.625,3,6,0.5,1,2,0.5,0,4,4,3,1,1,2,4,14,12,1,Grayson Allen,PHX,UTA,PHX,12.5,Points,21,18,17,7
22023,1628960,22300214,"NOV 19, 2023",PHX @ UTA,W,43,5,8,0.625,3,6,0.5,1,2,0.5,0,4,4,3,1,1,2,4,14,12,1,Grayson Allen,PHX,UTA,PHX,19.5,Pts+Rebs+Asts,21,18,17,7
22023,1628960,22300214,"NOV 19, 2023",PHX @ UTA,W,43,5,8,0.625,3,6,0.5,1,2,0.5,0,4,4,3,1,1,2,4,14,12,1,Grayson Allen,PHX,UTA,PHX,24.0,Fantasy Score,21,18,17,7
22023,1628960,22300214,"NOV 19, 2023",PHX @ UTA,W,43,5,8,0.625,3,6,0.5,1,2,0.5,0,4,4,3,1,1,2,4,14,12,1,Grayson Allen,PHX,UTA,PHX,16.5,Pts+Rebs,21,18,17,7
22023,1628960,22300214,"NOV 19, 2023",PHX @ UTA,W,43,5,8,0.625,3,6,0.5,1,2,0.5,0,4,4,3,1,1,2,4,14,12,1,Grayson Allen,PHX,UTA,PHX,15.5,Pts+Asts,21,18,17,7
22023,1628960,22300214,"NOV 19, 2023",PHX @ UTA,W,43,5,8,0.625,3,6,0.5,1,2,0.5,0,4,4,3,1,1,2,4,14,12,1,Grayson Allen,PHX,UTA,PHX,2.5,3-PT Made,21,18,17,7
22023,1628960,22300214,"NOV 19, 2023",PHX @ UTA,W,43,5,8,0.625,3,6,0.5,1,2,0.5,0,4,4,3,1,1,2,4,14,12,1,Grayson Allen,PHX,UTA,PHX,0.5,Blocked Shots,21,18,17,7
22023,1628960,22300214,"NOV 19, 2023",PHX @ UTA,W,43,5,8,0.625,3,6,0.5,1,2,0.5,0,4,4,3,1,1,2,4,14,12,1,Grayson Allen,PHX,UTA,PHX,1.5,Blks+Stls,21,18,17,7
22023,1628960,22300035,"NOV 17, 2023",PHX @ UTA,W,30,3,8,0.375,2,4,0.5,2,2,1.0,0,1,1,1,0,0,0,1,10,-8,1,Grayson Allen,PHX,UTA,PHX,12.5,Points,12,11,11,2
22023,1628960,22300035,"NOV 17, 2023",PHX @ UTA,W,30,3,8,0.375,2,4,0.5,2,2,1.0,0,1,1,1,0,0,0,1,10,-8,1,Grayson Allen,PHX,UTA,PHX,19.5,Pts+Rebs+Asts,12,11,11,2
22023,1628960,22300035,"NOV 17, 2023",PHX @ UTA,W,30,3,8,0.375,2,4,0.5,2,2,1.0,0,1,1,1,0,0,0,1,10,-8,1,Grayson Allen,PHX,UTA,PHX,24.0,Fantasy Score,12,11,11,2
22023,1628960,22300035,"NOV 17, 2023",PHX @ UTA,W,30,3,8,0.375,2,4,0.5,2,2,1.0,0,1,1,1,0,0,0,1,10,-8,1,Grayson Allen,PHX,UTA,PHX,16.5,Pts+Rebs,12,11,11,2
22023,1628960,22300035,"NOV 17, 2023",PHX @ UTA,W,30,3,8,0.375,2,4,0.5,2,2,1.0,0,1,1,1,0,0,0,1,10,-8,1,Grayson Allen,PHX,UTA,PHX,15.5,Pts+Asts,12,11,11,2
22023,1628960,22300035,"NOV 17, 2023",PHX @ UTA,W,30,3,8,0.375,2,4,0.5,2,2,1.0,0,1,1,1,0,0,0,1,10,-8,1,Grayson Allen,PHX,UTA,PHX,2.5,3-PT Made,12,11,11,2
22023,1628960,22300035,"NOV 17, 2023",PHX @ UTA,W,30,3,8,0.375,2,4,0.5,2,2,1.0,0,1,1,1,0,0,0,1,10,-8,1,Grayson Allen,PHX,UTA,PHX,0.5,Blocked Shots,12,11,11,2
22023,1628960,22300035,"NOV 17, 2023",PHX @ UTA,W,30,3,8,0.375,2,4,0.5,2,2,1.0,0,1,1,1,0,0,0,1,10,-8,1,Grayson Allen,PHX,UTA,PHX,1.5,Blks+Stls,12,11,11,2
22023,1628960,22300197,"NOV 15, 2023",PHX vs. MIN,W,28,5,9,0.556,3,5,0.6,1,1,1.0,0,3,3,2,0,1,2,1,14,22,1,Grayson Allen,PHX,PHX,MIN,12.5,Points,19,17,16,5
22023,1628960,22300197,"NOV 15, 2023",PHX vs. MIN,W,28,5,9,0.556,3,5,0.6,1,1,1.0,0,3,3,2,0,1,2,1,14,22,1,Grayson Allen,PHX,PHX,MIN,19.5,Pts+Rebs+Asts,19,17,16,5
22023,1628960,22300197,"NOV 15, 2023",PHX vs. MIN,W,28,5,9,0.556,3,5,0.6,1,1,1.0,0,3,3,2,0,1,2,1,14,22,1,Grayson Allen,PHX,PHX,MIN,24.0,Fantasy Score,19,17,16,5
22023,1628960,22300197,"NOV 15, 2023",PHX vs. MIN,W,28,5,9,0.556,3,5,0.6,1,1,1.0,0,3,3,2,0,1,2,1,14,22,1,Grayson Allen,PHX,PHX,MIN,16.5,Pts+Rebs,19,17,16,5
22023,1628960,22300197,"NOV 15, 2023",PHX vs. MIN,W,28,5,9,0.556,3,5,0.6,1,1,1.0,0,3,3,2,0,1,2,1,14,22,1,Grayson Allen,PHX,PHX,MIN,15.5,Pts+Asts,19,17,16,5
22023,1628960,22300197,"NOV 15, 2023",PHX vs. MIN,W,28,5,9,0.556,3,5,0.6,1,1,1.0,0,3,3,2,0,1,2,1,14,22,1,Grayson Allen,PHX,PHX,MIN,2.5,3-PT Made,19,17,16,5
22023,1628960,22300197,"NOV 15, 2023",PHX vs. MIN,W,28,5,9,0.556,3,5,0.6,1,1,1.0,0,3,3,2,0,1,2,1,14,22,1,Grayson Allen,PHX,PHX,MIN,0.5,Blocked Shots,19,17,16,5
22023,1628960,22300197,"NOV 15, 2023",PHX vs. MIN,W,28,5,9,0.556,3,5,0.6,1,1,1.0,0,3,3,2,0,1,2,1,14,22,1,Grayson Allen,PHX,PHX,MIN,1.5,Blks+Stls,19,17,16,5
22023,1628960,22300185,"NOV 12, 2023",PHX vs. OKC,L,32,2,8,0.25,1,3,0.333,2,2,1.0,2,4,6,1,1,1,2,2,7,-19,1,Grayson Allen,PHX,PHX,OKC,12.5,Points,14,13,8,7
22023,1628960,22300185,"NOV 12, 2023",PHX vs. OKC,L,32,2,8,0.25,1,3,0.333,2,2,1.0,2,4,6,1,1,1,2,2,7,-19,1,Grayson Allen,PHX,PHX,OKC,19.5,Pts+Rebs+Asts,14,13,8,7
22023,1628960,22300185,"NOV 12, 2023",PHX vs. OKC,L,32,2,8,0.25,1,3,0.333,2,2,1.0,2,4,6,1,1,1,2,2,7,-19,1,Grayson Allen,PHX,PHX,OKC,24.0,Fantasy Score,14,13,8,7
22023,1628960,22300185,"NOV 12, 2023",PHX vs. OKC,L,32,2,8,0.25,1,3,0.333,2,2,1.0,2,4,6,1,1,1,2,2,7,-19,1,Grayson Allen,PHX,PHX,OKC,16.5,Pts+Rebs,14,13,8,7
22023,1628960,22300185,"NOV 12, 2023",PHX vs. OKC,L,32,2,8,0.25,1,3,0.333,2,2,1.0,2,4,6,1,1,1,2,2,7,-19,1,Grayson Allen,PHX,PHX,OKC,15.5,Pts+Asts,14,13,8,7
22023,1628960,22300185,"NOV 12, 2023",PHX vs. OKC,L,32,2,8,0.25,1,3,0.333,2,2,1.0,2,4,6,1,1,1,2,2,7,-19,1,Grayson Allen,PHX,PHX,OKC,2.5,3-PT Made,14,13,8,7
22023,1628960,22300185,"NOV 12, 2023",PHX vs. OKC,L,32,2,8,0.25,1,3,0.333,2,2,1.0,2,4,6,1,1,1,2,2,7,-19,1,Grayson Allen,PHX,PHX,OKC,0.5,Blocked Shots,14,13,8,7
22023,1628960,22300185,"NOV 12, 2023",PHX vs. OKC,L,32,2,8,0.25,1,3,0.333,2,2,1.0,2,4,6,1,1,1,2,2,7,-19,1,Grayson Allen,PHX,PHX,OKC,1.5,Blks+Stls,14,13,8,7
22023,1628960,22300015,"NOV 10, 2023",PHX vs. LAL,L,32,4,8,0.5,1,4,0.25,0,0,0.0,2,7,9,4,1,0,2,6,9,-5,1,Grayson Allen,PHX,PHX,LAL,12.5,Points,22,18,13,13
22023,1628960,22300015,"NOV 10, 2023",PHX vs. LAL,L,32,4,8,0.5,1,4,0.25,0,0,0.0,2,7,9,4,1,0,2,6,9,-5,1,Grayson Allen,PHX,PHX,LAL,19.5,Pts+Rebs+Asts,22,18,13,13
22023,1628960,22300015,"NOV 10, 2023",PHX vs. LAL,L,32,4,8,0.5,1,4,0.25,0,0,0.0,2,7,9,4,1,0,2,6,9,-5,1,Grayson Allen,PHX,PHX,LAL,24.0,Fantasy Score,22,18,13,13
22023,1628960,22300015,"NOV 10, 2023",PHX vs. LAL,L,32,4,8,0.5,1,4,0.25,0,0,0.0,2,7,9,4,1,0,2,6,9,-5,1,Grayson Allen,PHX,PHX,LAL,16.5,Pts+Rebs,22,18,13,13
22023,1628960,22300015,"NOV 10, 2023",PHX vs. LAL,L,32,4,8,0.5,1,4,0.25,0,0,0.0,2,7,9,4,1,0,2,6,9,-5,1,Grayson Allen,PHX,PHX,LAL,15.5,Pts+Asts,22,18,13,13
22023,1628960,22300015,"NOV 10, 2023",PHX vs. LAL,L,32,4,8,0.5,1,4,0.25,0,0,0.0,2,7,9,4,1,0,2,6,9,-5,1,Grayson Allen,PHX,PHX,LAL,2.5,3-PT Made,22,18,13,13
22023,1628960,22300015,"NOV 10, 2023",PHX vs. LAL,L,32,4,8,0.5,1,4,0.25,0,0,0.0,2,7,9,4,1,0,2,6,9,-5,1,Grayson Allen,PHX,PHX,LAL,0.5,Blocked Shots,22,18,13,13
22023,1628960,22300015,"NOV 10, 2023",PHX vs. LAL,L,32,4,8,0.5,1,4,0.25,0,0,0.0,2,7,9,4,1,0,2,6,9,-5,1,Grayson Allen,PHX,PHX,LAL,1.5,Blks+Stls,22,18,13,13
22023,1628960,22300162,"NOV 08, 2023",PHX @ CHI,W,37,9,16,0.563,8,13,0.615,0,0,0.0,0,8,8,4,1,2,1,3,26,8,1,Grayson Allen,PHX,CHI,PHX,12.5,Points,38,34,30,12
22023,1628960,22300162,"NOV 08, 2023",PHX @ CHI,W,37,9,16,0.563,8,13,0.615,0,0,0.0,0,8,8,4,1,2,1,3,26,8,1,Grayson Allen,PHX,CHI,PHX,19.5,Pts+Rebs+Asts,38,34,30,12
22023,1628960,22300162,"NOV 08, 2023",PHX @ CHI,W,37,9,16,0.563,8,13,0.615,0,0,0.0,0,8,8,4,1,2,1,3,26,8,1,Grayson Allen,PHX,CHI,PHX,24.0,Fantasy Score,38,34,30,12
22023,1628960,22300162,"NOV 08, 2023",PHX @ CHI,W,37,9,16,0.563,8,13,0.615,0,0,0.0,0,8,8,4,1,2,1,3,26,8,1,Grayson Allen,PHX,CHI,PHX,16.5,Pts+Rebs,38,34,30,12
22023,1628960,22300162,"NOV 08, 2023",PHX @ CHI,W,37,9,16,0.563,8,13,0.615,0,0,0.0,0,8,8,4,1,2,1,3,26,8,1,Grayson Allen,PHX,CHI,PHX,15.5,Pts+Asts,38,34,30,12
22023,1628960,22300162,"NOV 08, 2023",PHX @ CHI,W,37,9,16,0.563,8,13,0.615,0,0,0.0,0,8,8,4,1,2,1,3,26,8,1,Grayson Allen,PHX,CHI,PHX,2.5,3-PT Made,38,34,30,12
22023,1628960,22300162,"NOV 08, 2023",PHX @ CHI,W,37,9,16,0.563,8,13,0.615,0,0,0.0,0,8,8,4,1,2,1,3,26,8,1,Grayson Allen,PHX,CHI,PHX,0.5,Blocked Shots,38,34,30,12
22023,1628960,22300162,"NOV 08, 2023",PHX @ CHI,W,37,9,16,0.563,8,13,0.615,0,0,0.0,0,8,8,4,1,2,1,3,26,8,1,Grayson Allen,PHX,CHI,PHX,1.5,Blks+Stls,38,34,30,12
22023,1628960,22300140,"NOV 05, 2023",PHX @ DET,W,30,6,12,0.5,1,3,0.333,1,1,1.0,1,3,4,2,0,0,4,1,14,6,1,Grayson Allen,PHX,DET,PHX,12.5,Points,20,18,16,6
22023,1628960,22300140,"NOV 05, 2023",PHX @ DET,W,30,6,12,0.5,1,3,0.333,1,1,1.0,1,3,4,2,0,0,4,1,14,6,1,Grayson Allen,PHX,DET,PHX,19.5,Pts+Rebs+Asts,20,18,16,6
22023,1628960,22300140,"NOV 05, 2023",PHX @ DET,W,30,6,12,0.5,1,3,0.333,1,1,1.0,1,3,4,2,0,0,4,1,14,6,1,Grayson Allen,PHX,DET,PHX,24.0,Fantasy Score,20,18,16,6
22023,1628960,22300140,"NOV 05, 2023",PHX @ DET,W,30,6,12,0.5,1,3,0.333,1,1,1.0,1,3,4,2,0,0,4,1,14,6,1,Grayson Allen,PHX,DET,PHX,16.5,Pts+Rebs,20,18,16,6
22023,1628960,22300140,"NOV 05, 2023",PHX @ DET,W,30,6,12,0.5,1,3,0.333,1,1,1.0,1,3,4,2,0,0,4,1,14,6,1,Grayson Allen,PHX,DET,PHX,15.5,Pts+Asts,20,18,16,6
22023,1628960,22300140,"NOV 05, 2023",PHX @ DET,W,30,6,12,0.5,1,3,0.333,1,1,1.0,1,3,4,2,0,0,4,1,14,6,1,Grayson Allen,PHX,DET,PHX,2.5,3-PT Made,20,18,16,6
22023,1628960,22300140,"NOV 05, 2023",PHX @ DET,W,30,6,12,0.5,1,3,0.333,1,1,1.0,1,3,4,2,0,0,4,1,14,6,1,Grayson Allen,PHX,DET,PHX,0.5,Blocked Shots,20,18,16,6
22023,1628960,22300140,"NOV 05, 2023",PHX @ DET,W,30,6,12,0.5,1,3,0.333,1,1,1.0,1,3,4,2,0,0,4,1,14,6,1,Grayson Allen,PHX,DET,PHX,1.5,Blks+Stls,20,18,16,6
22023,1628960,22300132,"NOV 04, 2023",PHX @ PHI,L,27,3,7,0.429,2,5,0.4,0,0,0.0,1,2,3,2,0,0,1,3,8,0,1,Grayson Allen,PHX,PHI,PHX,12.5,Points,13,11,10,5
22023,1628960,22300132,"NOV 04, 2023",PHX @ PHI,L,27,3,7,0.429,2,5,0.4,0,0,0.0,1,2,3,2,0,0,1,3,8,0,1,Grayson Allen,PHX,PHI,PHX,19.5,Pts+Rebs+Asts,13,11,10,5
22023,1628960,22300132,"NOV 04, 2023",PHX @ PHI,L,27,3,7,0.429,2,5,0.4,0,0,0.0,1,2,3,2,0,0,1,3,8,0,1,Grayson Allen,PHX,PHI,PHX,24.0,Fantasy Score,13,11,10,5
22023,1628960,22300132,"NOV 04, 2023",PHX @ PHI,L,27,3,7,0.429,2,5,0.4,0,0,0.0,1,2,3,2,0,0,1,3,8,0,1,Grayson Allen,PHX,PHI,PHX,16.5,Pts+Rebs,13,11,10,5
22023,1628960,22300132,"NOV 04, 2023",PHX @ PHI,L,27,3,7,0.429,2,5,0.4,0,0,0.0,1,2,3,2,0,0,1,3,8,0,1,Grayson Allen,PHX,PHI,PHX,15.5,Pts+Asts,13,11,10,5
22023,1628960,22300132,"NOV 04, 2023",PHX @ PHI,L,27,3,7,0.429,2,5,0.4,0,0,0.0,1,2,3,2,0,0,1,3,8,0,1,Grayson Allen,PHX,PHI,PHX,2.5,3-PT Made,13,11,10,5
22023,1628960,22300132,"NOV 04, 2023",PHX @ PHI,L,27,3,7,0.429,2,5,0.4,0,0,0.0,1,2,3,2,0,0,1,3,8,0,1,Grayson Allen,PHX,PHI,PHX,0.5,Blocked Shots,13,11,10,5
22023,1628960,22300132,"NOV 04, 2023",PHX @ PHI,L,27,3,7,0.429,2,5,0.4,0,0,0.0,1,2,3,2,0,0,1,3,8,0,1,Grayson Allen,PHX,PHI,PHX,1.5,Blks+Stls,13,11,10,5
22023,1628960,22300131,"NOV 02, 2023",PHX vs. SAS,L,33,6,10,0.6,4,5,0.8,0,0,0.0,1,1,2,4,0,0,2,1,16,-10,1,Grayson Allen,PHX,PHX,SAS,12.5,Points,22,18,20,6
22023,1628960,22300131,"NOV 02, 2023",PHX vs. SAS,L,33,6,10,0.6,4,5,0.8,0,0,0.0,1,1,2,4,0,0,2,1,16,-10,1,Grayson Allen,PHX,PHX,SAS,19.5,Pts+Rebs+Asts,22,18,20,6
22023,1628960,22300131,"NOV 02, 2023",PHX vs. SAS,L,33,6,10,0.6,4,5,0.8,0,0,0.0,1,1,2,4,0,0,2,1,16,-10,1,Grayson Allen,PHX,PHX,SAS,24.0,Fantasy Score,22,18,20,6
22023,1628960,22300131,"NOV 02, 2023",PHX vs. SAS,L,33,6,10,0.6,4,5,0.8,0,0,0.0,1,1,2,4,0,0,2,1,16,-10,1,Grayson Allen,PHX,PHX,SAS,16.5,Pts+Rebs,22,18,20,6
22023,1628960,22300131,"NOV 02, 2023",PHX vs. SAS,L,33,6,10,0.6,4,5,0.8,0,0,0.0,1,1,2,4,0,0,2,1,16,-10,1,Grayson Allen,PHX,PHX,SAS,15.5,Pts+Asts,22,18,20,6
22023,1628960,22300131,"NOV 02, 2023",PHX vs. SAS,L,33,6,10,0.6,4,5,0.8,0,0,0.0,1,1,2,4,0,0,2,1,16,-10,1,Grayson Allen,PHX,PHX,SAS,2.5,3-PT Made,22,18,20,6
22023,1628960,22300131,"NOV 02, 2023",PHX vs. SAS,L,33,6,10,0.6,4,5,0.8,0,0,0.0,1,1,2,4,0,0,2,1,16,-10,1,Grayson Allen,PHX,PHX,SAS,0.5,Blocked Shots,22,18,20,6
22023,1628960,22300131,"NOV 02, 2023",PHX vs. SAS,L,33,6,10,0.6,4,5,0.8,0,0,0.0,1,1,2,4,0,0,2,1,16,-10,1,Grayson Allen,PHX,PHX,SAS,1.5,Blks+Stls,22,18,20,6
22023,1628960,22300113,"OCT 31, 2023",PHX vs. SAS,L,37,5,9,0.556,5,7,0.714,4,4,1.0,1,6,7,3,0,1,2,2,19,-12,1,Grayson Allen,PHX,PHX,SAS,12.5,Points,29,26,22,10
22023,1628960,22300113,"OCT 31, 2023",PHX vs. SAS,L,37,5,9,0.556,5,7,0.714,4,4,1.0,1,6,7,3,0,1,2,2,19,-12,1,Grayson Allen,PHX,PHX,SAS,19.5,Pts+Rebs+Asts,29,26,22,10
22023,1628960,22300113,"OCT 31, 2023",PHX vs. SAS,L,37,5,9,0.556,5,7,0.714,4,4,1.0,1,6,7,3,0,1,2,2,19,-12,1,Grayson Allen,PHX,PHX,SAS,24.0,Fantasy Score,29,26,22,10
22023,1628960,22300113,"OCT 31, 2023",PHX vs. SAS,L,37,5,9,0.556,5,7,0.714,4,4,1.0,1,6,7,3,0,1,2,2,19,-12,1,Grayson Allen,PHX,PHX,SAS,16.5,Pts+Rebs,29,26,22,10
22023,1628960,22300113,"OCT 31, 2023",PHX vs. SAS,L,37,5,9,0.556,5,7,0.714,4,4,1.0,1,6,7,3,0,1,2,2,19,-12,1,Grayson Allen,PHX,PHX,SAS,15.5,Pts+Asts,29,26,22,10
22023,1628960,22300113,"OCT 31, 2023",PHX vs. SAS,L,37,5,9,0.556,5,7,0.714,4,4,1.0,1,6,7,3,0,1,2,2,19,-12,1,Grayson Allen,PHX,PHX,SAS,2.5,3-PT Made,29,26,22,10
22023,1628960,22300113,"OCT 31, 2023",PHX vs. SAS,L,37,5,9,0.556,5,7,0.714,4,4,1.0,1,6,7,3,0,1,2,2,19,-12,1,Grayson Allen,PHX,PHX,SAS,0.5,Blocked Shots,29,26,22,10
22023,1628960,22300113,"OCT 31, 2023",PHX vs. SAS,L,37,5,9,0.556,5,7,0.714,4,4,1.0,1,6,7,3,0,1,2,2,19,-12,1,Grayson Allen,PHX,PHX,SAS,1.5,Blks+Stls,29,26,22,10
22023,1628960,22300094,"OCT 28, 2023",PHX vs. UTA,W,31,6,10,0.6,3,7,0.429,2,2,1.0,0,4,4,3,2,0,3,2,17,22,1,Grayson Allen,PHX,PHX,UTA,12.5,Points,24,21,20,7
22023,1628960,22300094,"OCT 28, 2023",PHX vs. UTA,W,31,6,10,0.6,3,7,0.429,2,2,1.0,0,4,4,3,2,0,3,2,17,22,1,Grayson Allen,PHX,PHX,UTA,19.5,Pts+Rebs+Asts,24,21,20,7
22023,1628960,22300094,"OCT 28, 2023",PHX vs. UTA,W,31,6,10,0.6,3,7,0.429,2,2,1.0,0,4,4,3,2,0,3,2,17,22,1,Grayson Allen,PHX,PHX,UTA,24.0,Fantasy Score,24,21,20,7
22023,1628960,22300094,"OCT 28, 2023",PHX vs. UTA,W,31,6,10,0.6,3,7,0.429,2,2,1.0,0,4,4,3,2,0,3,2,17,22,1,Grayson Allen,PHX,PHX,UTA,16.5,Pts+Rebs,24,21,20,7
22023,1628960,22300094,"OCT 28, 2023",PHX vs. UTA,W,31,6,10,0.6,3,7,0.429,2,2,1.0,0,4,4,3,2,0,3,2,17,22,1,Grayson Allen,PHX,PHX,UTA,15.5,Pts+Asts,24,21,20,7
22023,1628960,22300094,"OCT 28, 2023",PHX vs. UTA,W,31,6,10,0.6,3,7,0.429,2,2,1.0,0,4,4,3,2,0,3,2,17,22,1,Grayson Allen,PHX,PHX,UTA,2.5,3-PT Made,24,21,20,7
22023,1628960,22300094,"OCT 28, 2023",PHX vs. UTA,W,31,6,10,0.6,3,7,0.429,2,2,1.0,0,4,4,3,2,0,3,2,17,22,1,Grayson Allen,PHX,PHX,UTA,0.5,Blocked Shots,24,21,20,7
22023,1628960,22300094,"OCT 28, 2023",PHX vs. UTA,W,31,6,10,0.6,3,7,0.429,2,2,1.0,0,4,4,3,2,0,3,2,17,22,1,Grayson Allen,PHX,PHX,UTA,1.5,Blks+Stls,24,21,20,7
22023,1628960,22300076,"OCT 26, 2023",PHX @ LAL,L,35,2,6,0.333,2,4,0.5,0,0,0.0,1,5,6,4,0,0,0,3,6,0,1,Grayson Allen,PHX,LAL,PHX,12.5,Points,16,12,10,10
22023,1628960,22300076,"OCT 26, 2023",PHX @ LAL,L,35,2,6,0.333,2,4,0.5,0,0,0.0,1,5,6,4,0,0,0,3,6,0,1,Grayson Allen,PHX,LAL,PHX,19.5,Pts+Rebs+Asts,16,12,10,10
22023,1628960,22300076,"OCT 26, 2023",PHX @ LAL,L,35,2,6,0.333,2,4,0.5,0,0,0.0,1,5,6,4,0,0,0,3,6,0,1,Grayson Allen,PHX,LAL,PHX,24.0,Fantasy Score,16,12,10,10
22023,1628960,22300076,"OCT 26, 2023",PHX @ LAL,L,35,2,6,0.333,2,4,0.5,0,0,0.0,1,5,6,4,0,0,0,3,6,0,1,Grayson Allen,PHX,LAL,PHX,16.5,Pts+Rebs,16,12,10,10
22023,1628960,22300076,"OCT 26, 2023",PHX @ LAL,L,35,2,6,0.333,2,4,0.5,0,0,0.0,1,5,6,4,0,0,0,3,6,0,1,Grayson Allen,PHX,LAL,PHX,15.5,Pts+Asts,16,12,10,10
22023,1628960,22300076,"OCT 26, 2023",PHX @ LAL,L,35,2,6,0.333,2,4,0.5,0,0,0.0,1,5,6,4,0,0,0,3,6,0,1,Grayson Allen,PHX,LAL,PHX,2.5,3-PT Made,16,12,10,10
22023,1628960,22300076,"OCT 26, 2023",PHX @ LAL,L,35,2,6,0.333,2,4,0.5,0,0,0.0,1,5,6,4,0,0,0,3,6,0,1,Grayson Allen,PHX,LAL,PHX,0.5,Blocked Shots,16,12,10,10
22023,1628960,22300076,"OCT 26, 2023",PHX @ LAL,L,35,2,6,0.333,2,4,0.5,0,0,0.0,1,5,6,4,0,0,0,3,6,0,1,Grayson Allen,PHX,LAL,PHX,1.5,Blks+Stls,16,12,10,10
22023,1628960,22300062,"OCT 24, 2023",PHX @ GSW,W,21,0,6,0.0,0,5,0.0,0,0,0.0,3,1,4,2,0,0,1,2,0,-4,1,Grayson Allen,PHX,GSW,PHX,12.5,Points,6,4,2,6
22023,1628960,22300062,"OCT 24, 2023",PHX @ GSW,W,21,0,6,0.0,0,5,0.0,0,0,0.0,3,1,4,2,0,0,1,2,0,-4,1,Grayson Allen,PHX,GSW,PHX,19.5,Pts+Rebs+Asts,6,4,2,6
22023,1628960,22300062,"OCT 24, 2023",PHX @ GSW,W,21,0,6,0.0,0,5,0.0,0,0,0.0,3,1,4,2,0,0,1,2,0,-4,1,Grayson Allen,PHX,GSW,PHX,24.0,Fantasy Score,6,4,2,6
22023,1628960,22300062,"OCT 24, 2023",PHX @ GSW,W,21,0,6,0.0,0,5,0.0,0,0,0.0,3,1,4,2,0,0,1,2,0,-4,1,Grayson Allen,PHX,GSW,PHX,16.5,Pts+Rebs,6,4,2,6
22023,1628960,22300062,"OCT 24, 2023",PHX @ GSW,W,21,0,6,0.0,0,5,0.0,0,0,0.0,3,1,4,2,0,0,1,2,0,-4,1,Grayson Allen,PHX,GSW,PHX,15.5,Pts+Asts,6,4,2,6
22023,1628960,22300062,"OCT 24, 2023",PHX @ GSW,W,21,0,6,0.0,0,5,0.0,0,0,0.0,3,1,4,2,0,0,1,2,0,-4,1,Grayson Allen,PHX,GSW,PHX,2.5,3-PT Made,6,4,2,6
22023,1628960,22300062,"OCT 24, 2023",PHX @ GSW,W,21,0,6,0.0,0,5,0.0,0,0,0.0,3,1,4,2,0,0,1,2,0,-4,1,Grayson Allen,PHX,GSW,PHX,0.5,Blocked Shots,6,4,2,6
22023,1628960,22300062,"OCT 24, 2023",PHX @ GSW,W,21,0,6,0.0,0,5,0.0,0,0,0.0,3,1,4,2,0,0,1,2,0,-4,1,Grayson Allen,PHX,GSW,PHX,1.5,Blks+Stls,6,4,2,6
22023,1628386,22300561,"JAN 15, 2024",CLE vs. CHI,W,34,4,5,0.8,0,0,0.0,2,2,1.0,5,9,14,3,2,1,2,1,10,32,1,Jarrett Allen,CLE,CLE,CHI,,,27,24,13,17
22023,1628386,22300527,"JAN 11, 2024",CLE vs. BKN,W,38,3,5,0.6,0,0,0.0,6,6,1.0,3,9,12,4,2,4,1,5,12,6,1,Jarrett Allen,CLE,CLE,BKN,,,28,24,16,16
22023,1628386,22300497,"JAN 07, 2024",CLE vs. SAS,W,31,11,19,0.579,0,0,0.0,7,7,1.0,5,11,16,2,1,1,1,3,29,-10,1,Jarrett Allen,CLE,CLE,SAS,,,47,45,31,18
22023,1628386,22300482,"JAN 05, 2024",CLE vs. WAS,W,29,5,7,0.714,0,0,0.0,2,2,1.0,6,6,12,3,2,1,4,2,12,16,1,Jarrett Allen,CLE,CLE,WAS,,,27,24,15,15
22023,1628386,22300465,"JAN 03, 2024",CLE vs. WAS,W,29,7,10,0.7,0,0,0.0,3,4,0.75,7,12,19,7,0,2,1,0,17,27,1,Jarrett Allen,CLE,CLE,WAS,,,43,36,24,26
22023,1628386,22300452,"JAN 01, 2024",CLE @ TOR,L,34,5,11,0.455,0,0,0.0,6,8,0.75,3,8,11,4,1,0,0,4,16,-3,1,Jarrett Allen,CLE,TOR,CLE,,,31,27,20,15
22023,1628386,22300433,"DEC 29, 2023",CLE vs. MIL,L,40,15,17,0.882,0,0,0.0,0,0,0.0,3,9,12,6,0,2,0,2,30,-12,1,Jarrett Allen,CLE,CLE,MIL,,,48,42,36,18
22023,1628386,22300420,"DEC 27, 2023",CLE @ DAL,W,35,9,17,0.529,0,0,0.0,6,6,1.0,9,14,23,6,2,0,4,1,24,14,1,Jarrett Allen,CLE,DAL,CLE,,,53,47,30,29
22023,1628386,22300396,"DEC 23, 2023",CLE @ CHI,W,35,6,9,0.667,0,1,0.0,7,10,0.7,8,9,17,7,1,1,0,0,19,6,1,Jarrett Allen,CLE,CHI,CLE,,,43,36,26,24
22023,1628386,22300375,"DEC 21, 2023",CLE vs. NOP,L,27,7,8,0.875,0,0,0.0,0,0,0.0,1,6,7,3,1,0,1,0,14,-6,1,Jarrett Allen,CLE,CLE,NOP,,,24,21,17,10
22023,1628386,22300364,"DEC 20, 2023",CLE vs. UTA,W,30,8,13,0.615,0,0,0.0,1,2,0.5,3,5,8,3,2,0,2,1,17,-4,1,Jarrett Allen,CLE,CLE,UTA,,,28,25,20,11
22023,1628386,22300349,"DEC 18, 2023",CLE vs. HOU,W,29,3,7,0.429,0,0,0.0,4,7,0.571,2,4,6,2,0,2,1,5,10,-4,1,Jarrett Allen,CLE,CLE,HOU,,,18,16,12,8
22023,1628386,22300336,"DEC 16, 2023",CLE vs. ATL,W,35,12,14,0.857,0,0,0.0,1,1,1.0,4,10,14,1,2,1,4,1,25,5,1,Jarrett Allen,CLE,CLE,ATL,,,40,39,26,15
22023,1628386,22300319,"DEC 14, 2023",CLE @ BOS,L,39,4,7,0.571,0,0,0.0,0,0,0.0,1,9,10,3,0,0,3,1,8,-1,1,Jarrett Allen,CLE,BOS,CLE,,,21,18,11,13
22023,1628386,22300305,"DEC 12, 2023",CLE @ BOS,L,37,6,9,0.667,0,0,0.0,2,5,0.4,2,3,5,5,3,2,2,4,14,4,1,Jarrett Allen,CLE,BOS,CLE,,,24,19,19,10
22023,1628386,22300294,"DEC 11, 2023",CLE @ ORL,L,15,2,3,0.667,0,0,0.0,0,0,0.0,2,5,7,1,1,0,1,6,4,-15,1,Jarrett Allen,CLE,ORL,CLE,,,12,11,5,8
22023,1628386,22301220,"DEC 08, 2023",CLE @ MIA,W,25,3,9,0.333,0,0,0.0,0,2,0.0,2,7,9,1,1,0,0,2,6,-2,1,Jarrett Allen,CLE,MIA,CLE,,,16,15,7,10
22023,1628386,22301205,"DEC 06, 2023",CLE vs. ORL,W,19,4,5,0.8,0,0,0.0,0,0,0.0,2,9,11,2,1,0,4,5,8,2,1,Jarrett Allen,CLE,CLE,ORL,,,21,19,10,13
22023,1628386,22300283,"DEC 02, 2023",CLE @ DET,W,34,8,9,0.889,0,0,0.0,3,5,0.6,5,6,11,3,1,0,2,2,19,4,1,Jarrett Allen,CLE,DET,CLE,,,33,30,22,14
22023,1628386,22300265,"NOV 30, 2023",CLE vs. POR,L,38,6,9,0.667,0,0,0.0,0,0,0.0,6,4,10,2,0,2,1,3,12,-3,1,Jarrett Allen,CLE,CLE,POR,,,24,22,14,12
22023,1628386,22300055,"NOV 28, 2023",CLE vs. ATL,W,30,5,6,0.833,0,0,0.0,1,1,1.0,1,7,8,2,0,0,0,4,11,16,1,Jarrett Allen,CLE,CLE,ATL,,,21,19,13,10
22023,1628386,22300251,"NOV 26, 2023",CLE vs. TOR,W,27,9,10,0.9,0,0,0.0,0,0,0.0,3,1,4,3,0,2,2,4,18,-13,1,Jarrett Allen,CLE,CLE,TOR,,,25,22,21,7
22023,1628386,22300242,"NOV 25, 2023",CLE vs. LAL,L,37,9,12,0.75,0,0,0.0,3,4,0.75,5,9,14,3,3,2,2,3,21,-3,1,Jarrett Allen,CLE,CLE,LAL,,,38,35,24,17
22023,1628386,22300229,"NOV 22, 2023",CLE vs. MIA,L,23,1,2,0.5,0,0,0.0,2,2,1.0,0,4,4,2,0,0,3,2,4,-24,1,Jarrett Allen,CLE,CLE,MIA,,,10,8,6,6
22023,1628386,22300040,"NOV 21, 2023",CLE @ PHI,W,35,12,20,0.6,0,0,0.0,2,2,1.0,6,7,13,3,0,0,2,4,26,-6,1,Jarrett Allen,CLE,PHI,CLE,,,42,39,29,16
22023,1628386,22300210,"NOV 19, 2023",CLE vs. DEN,W,29,6,10,0.6,0,0,0.0,3,6,0.5,2,3,5,5,1,0,2,3,15,42,1,Jarrett Allen,CLE,CLE,DEN,,,25,20,20,10
22023,1628386,22300030,"NOV 17, 2023",CLE vs. DET,W,32,4,8,0.5,0,0,0.0,2,3,0.667,1,6,7,2,0,5,2,1,10,5,1,Jarrett Allen,CLE,CLE,DET,,,19,17,12,9
22023,1628386,22300199,"NOV 15, 2023",CLE @ POR,W,29,3,3,1.0,0,0,0.0,5,6,0.833,1,8,9,1,0,3,3,3,11,0,1,Jarrett Allen,CLE,POR,CLE,,,21,20,12,10
22023,1628386,22300191,"NOV 13, 2023",CLE @ SAC,L,22,5,6,0.833,0,0,0.0,2,3,0.667,4,5,9,1,0,0,2,2,12,-25,1,Jarrett Allen,CLE,SAC,CLE,,,22,21,13,10
22023,1628386,22300176,"NOV 11, 2023",CLE @ GSW,W,28,2,6,0.333,0,0,0.0,8,9,0.889,3,2,5,4,0,0,1,4,12,13,1,Jarrett Allen,CLE,GSW,CLE,,,21,17,16,9
22023,1628386,22300167,"NOV 08, 2023",CLE @ OKC,L,26,4,6,0.667,0,0,0.0,6,9,0.667,4,2,6,1,2,1,1,0,14,-4,1,Jarrett Allen,CLE,OKC,CLE,,,21,20,15,7
22023,1628386,22300142,"NOV 05, 2023",CLE vs. GSW,W,28,5,7,0.714,0,0,0.0,2,2,1.0,5,4,9,3,0,0,2,1,12,9,1,Jarrett Allen,CLE,CLE,GSW,,,24,21,15,12
22023,1628386,22300001,"NOV 03, 2023",CLE @ IND,L,21,4,6,0.667,0,0,0.0,2,3,0.667,2,5,7,0,1,2,1,4,10,-1,1,Jarrett Allen,CLE,IND,CLE,,,17,17,10,7
22023,1630631,22300547,"JAN 13, 2024",NOP @ DAL,W,26,5,12,0.417,3,8,0.375,1,2,0.5,0,2,2,4,1,0,0,2,14,8,1,Jose Alvarado,NOP,DAL,NOP,,,20,16,18,6
22023,1630631,22300539,"JAN 12, 2024",NOP @ DEN,L,17,3,7,0.429,2,3,0.667,2,2,1.0,1,0,1,1,1,0,1,0,10,-2,1,Jose Alvarado,NOP,DEN,NOP,,,12,11,11,2
22023,1630631,22300486,"JAN 05, 2024",NOP vs. LAC,L,19,1,7,0.143,0,2,0.0,0,0,0.0,0,1,1,2,0,1,0,0,2,-9,1,Jose Alvarado,NOP,NOP,LAC,,,5,3,4,3
22023,1630631,22300471,"JAN 03, 2024",NOP @ MIN,W,27,3,8,0.375,2,6,0.333,0,0,0.0,1,2,3,3,0,1,1,3,8,2,1,Jose Alvarado,NOP,MIN,NOP,,,14,11,11,6
22023,1630631,22300461,"JAN 02, 2024",NOP vs. BKN,W,22,4,9,0.444,3,6,0.5,2,3,0.667,1,2,3,2,2,0,1,2,13,16,1,Jose Alvarado,NOP,NOP,BKN,,,18,16,15,5
22023,1630631,22300446,"DEC 31, 2023",NOP vs. LAL,W,20,3,8,0.375,2,5,0.4,0,0,0.0,0,3,3,1,4,2,1,1,8,8,1,Jose Alvarado,NOP,NOP,LAL,,,12,11,9,4
22023,1630631,22300424,"DEC 28, 2023",NOP vs. UTA,W,12,3,4,0.75,1,2,0.5,0,0,0.0,0,0,0,0,0,0,1,2,7,1,1,Jose Alvarado,NOP,NOP,UTA,,,7,7,7,0
22023,1630631,22300410,"DEC 26, 2023",NOP vs. MEM,L,12,3,8,0.375,1,4,0.25,1,2,0.5,1,2,3,2,1,0,0,0,8,10,1,Jose Alvarado,NOP,NOP,MEM,,,13,11,10,5
22023,1630631,22300392,"DEC 23, 2023",NOP vs. HOU,L,10,2,4,0.5,0,2,0.0,0,0,0.0,0,2,2,0,0,1,1,3,4,2,1,Jose Alvarado,NOP,NOP,HOU,,,6,6,4,2
22023,1630631,22300375,"DEC 21, 2023",NOP @ CLE,W,18,1,1,1.0,0,0,0.0,0,0,0.0,1,1,2,3,0,0,0,2,2,16,1,Jose Alvarado,NOP,CLE,NOP,,,7,4,5,5
22023,1630631,22300360,"DEC 19, 2023",NOP vs. MEM,L,8,1,4,0.25,0,2,0.0,0,0,0.0,1,1,2,0,0,0,0,1,2,-9,1,Jose Alvarado,NOP,NOP,MEM,,,4,4,2,2
22023,1630631,22300345,"DEC 17, 2023",NOP @ SAS,W,22,5,7,0.714,3,5,0.6,3,4,0.75,0,3,3,4,1,0,1,0,16,15,1,Jose Alvarado,NOP,SAS,NOP,,,23,19,20,7
22023,1630631,22300326,"DEC 15, 2023",NOP @ CHA,W,21,1,6,0.167,1,3,0.333,5,6,0.833,1,7,8,1,1,1,1,3,8,9,1,Jose Alvarado,NOP,CHA,NOP,,,17,16,9,9
22023,1630631,22300311,"DEC 13, 2023",NOP @ WAS,W,18,2,3,0.667,2,3,0.667,1,2,0.5,0,2,2,1,2,0,2,2,7,15,1,Jose Alvarado,NOP,WAS,NOP,,,10,9,8,3
22023,1630631,22300301,"DEC 11, 2023",NOP vs. MIN,W,15,0,5,0.0,0,3,0.0,0,0,0.0,1,1,2,3,1,1,1,3,0,-11,1,Jose Alvarado,NOP,NOP,MIN,,,5,2,3,5
22023,1630631,22301230,"DEC 07, 2023",NOP @ LAL,L,20,3,7,0.429,2,3,0.667,0,0,0.0,0,2,2,4,2,0,1,1,8,-13,1,Jose Alvarado,NOP,LAL,NOP,,,14,10,12,6
22023,1630631,22301204,"DEC 04, 2023",NOP @ SAC,W,18,3,4,0.75,2,3,0.667,1,2,0.5,0,3,3,2,2,2,1,1,9,19,1,Jose Alvarado,NOP,SAC,NOP,,,14,12,11,5
22023,1630631,22300285,"DEC 02, 2023",NOP @ CHI,L,18,3,8,0.375,2,5,0.4,0,0,0.0,0,1,1,2,0,0,1,0,8,-7,1,Jose Alvarado,NOP,CHI,NOP,,,11,9,10,3
22023,1630631,22300262,"NOV 29, 2023",NOP vs. PHI,W,9,2,5,0.4,1,2,0.5,0,0,0.0,2,0,2,1,1,0,2,1,5,-12,1,Jose Alvarado,NOP,NOP,PHI,,,8,7,6,3
22023,1630631,22300256,"NOV 27, 2023",NOP @ UTA,L,14,2,3,0.667,0,0,0.0,0,0,0.0,0,1,1,2,0,0,0,2,4,3,1,Jose Alvarado,NOP,UTA,NOP,,,7,5,6,3
22023,1630631,22300243,"NOV 25, 2023",NOP @ UTA,L,23,5,11,0.455,3,6,0.5,0,0,0.0,1,3,4,3,2,1,0,4,13,11,1,Jose Alvarado,NOP,UTA,NOP,,,20,17,16,7
22023,1630631,22300052,"NOV 24, 2023",NOP @ LAC,W,16,1,6,0.167,0,2,0.0,2,2,1.0,1,4,5,1,1,0,1,0,4,-12,1,Jose Alvarado,NOP,LAC,NOP,,,10,9,5,6
22023,1630631,22300233,"NOV 22, 2023",NOP vs. SAC,W,19,4,9,0.444,2,6,0.333,0,4,0.0,0,1,1,2,3,0,1,2,10,9,1,Jose Alvarado,NOP,NOP,SAC,,,13,11,12,3
22023,1630631,22300222,"NOV 20, 2023",NOP vs. SAC,W,15,2,5,0.4,1,3,0.333,0,0,0.0,0,0,0,3,0,0,2,0,5,8,1,Jose Alvarado,NOP,NOP,SAC,,,8,5,8,3
22023,203937,22300553,"JAN 14, 2024",MIN vs. LAC,W,27,4,6,0.667,1,1,1.0,1,3,0.333,0,1,1,3,1,0,0,4,10,-6,1,Kyle Anderson,MIN,MIN,LAC,,,14,11,13,4
22023,203937,22300538,"JAN 12, 2024",MIN vs. POR,W,15,1,2,0.5,0,0,0.0,0,0,0.0,0,2,2,1,0,0,2,2,2,-4,1,Kyle Anderson,MIN,MIN,POR,,,5,4,3,3
22023,203937,22300517,"JAN 10, 2024",MIN @ BOS,L,39,7,12,0.583,0,0,0.0,3,4,0.75,2,6,8,5,1,1,0,5,17,-11,1,Kyle Anderson,MIN,BOS,MIN,,,30,25,22,13
22023,203937,22300513,"JAN 09, 2024",MIN @ ORL,W,21,4,6,0.667,0,1,0.0,3,4,0.75,0,1,1,3,0,0,0,1,11,5,1,Kyle Anderson,MIN,ORL,MIN,,,15,12,14,4
22023,203937,22300501,"JAN 07, 2024",MIN @ DAL,L,20,1,1,1.0,0,0,0.0,2,2,1.0,1,1,2,4,0,0,1,3,4,-6,1,Kyle Anderson,MIN,DAL,MIN,,,10,6,8,6
22023,203937,22300485,"JAN 05, 2024",MIN @ HOU,W,18,1,4,0.25,0,0,0.0,0,0,0.0,1,6,7,5,3,0,2,3,2,16,1,Kyle Anderson,MIN,HOU,MIN,,,14,9,7,12
22023,203937,22300471,"JAN 03, 2024",MIN vs. NOP,L,13,0,2,0.0,0,0,0.0,1,2,0.5,1,3,4,0,2,0,0,0,1,0,1,Kyle Anderson,MIN,MIN,NOP,,,5,5,1,4
22023,203937,22300451,"JAN 01, 2024",MIN @ NYK,L,17,1,1,1.0,0,0,0.0,0,2,0.0,0,2,2,3,2,0,3,0,2,-2,1,Kyle Anderson,MIN,NYK,MIN,,,7,4,5,5
22023,203937,22300443,"DEC 30, 2023",MIN vs. LAL,W,24,2,4,0.5,0,1,0.0,0,0,0.0,0,3,3,7,0,1,1,0,4,-8,1,Kyle Anderson,MIN,MIN,LAL,,,14,7,11,10
22023,203937,22300423,"DEC 28, 2023",MIN vs. DAL,W,27,3,8,0.375,1,1,1.0,1,2,0.5,1,9,10,3,0,0,3,0,8,-11,1,Kyle Anderson,MIN,MIN,DAL,,,21,18,11,13
22023,203937,22300411,"DEC 26, 2023",MIN @ OKC,L,23,2,4,0.5,0,1,0.0,3,3,1.0,0,0,0,1,0,0,2,1,7,-10,1,Kyle Anderson,MIN,OKC,MIN,,,8,7,8,1
22023,203937,22300400,"DEC 23, 2023",MIN @ SAC,W,29,4,9,0.444,0,0,0.0,2,2,1.0,1,4,5,5,0,1,2,4,10,9,1,Kyle Anderson,MIN,SAC,MIN,,,20,15,15,10
22023,203937,22300380,"DEC 21, 2023",MIN vs. LAL,W,23,4,7,0.571,0,2,0.0,1,1,1.0,2,3,5,4,1,1,1,0,9,8,1,Kyle Anderson,MIN,MIN,LAL,,,18,14,13,9
22023,203937,22300367,"DEC 20, 2023",MIN @ PHI,L,13,1,5,0.2,0,0,0.0,0,0,0.0,0,0,0,1,0,0,2,0,2,-10,1,Kyle Anderson,MIN,PHI,MIN,,,3,2,3,1
22023,203937,22300353,"DEC 18, 2023",MIN @ MIA,W,22,2,4,0.5,0,0,0.0,1,2,0.5,0,1,1,5,1,1,1,2,5,1,1,Kyle Anderson,MIN,MIA,MIN,,,11,6,10,6
22023,203937,22300338,"DEC 16, 2023",MIN vs. IND,W,23,2,4,0.5,0,0,0.0,0,0,0.0,1,3,4,10,0,0,2,4,4,6,1,Kyle Anderson,MIN,MIN,IND,,,18,8,14,14
22023,203937,22300321,"DEC 14, 2023",MIN @ DAL,W,18,3,7,0.429,0,1,0.0,0,0,0.0,0,2,2,2,2,1,1,2,6,4,1,Kyle Anderson,MIN,DAL,MIN,,,10,8,8,4
22023,203937,22300301,"DEC 11, 2023",MIN @ NOP,L,19,3,6,0.5,0,0,0.0,0,0,0.0,1,3,4,3,2,0,0,1,6,7,1,Kyle Anderson,MIN,NOP,MIN,,,13,10,9,7
22023,203937,22301221,"DEC 08, 2023",MIN @ MEM,W,22,2,11,0.182,0,6,0.0,3,4,0.75,1,5,6,5,0,0,2,0,7,-3,1,Kyle Anderson,MIN,MEM,MIN,,,18,13,12,11
22023,203937,22301210,"DEC 06, 2023",MIN vs. SAS,W,22,2,6,0.333,0,0,0.0,3,4,0.75,0,1,1,2,0,4,0,2,7,-7,1,Kyle Anderson,MIN,MIN,SAS,,,10,8,9,3
22023,203937,22300281,"DEC 02, 2023",MIN @ CHA,W,26,2,6,0.333,0,0,0.0,7,7,1.0,2,4,6,4,2,0,2,3,11,2,1,Kyle Anderson,MIN,CHA,MIN,,,21,17,15,10
22023,203937,22300270,"NOV 30, 2023",MIN vs. UTA,W,19,2,7,0.286,0,1,0.0,0,0,0.0,0,1,1,6,0,0,0,0,4,-6,1,Kyle Anderson,MIN,MIN,UTA,,,11,5,10,7
22023,203937,22300058,"NOV 28, 2023",MIN vs. OKC,W,23,2,6,0.333,0,0,0.0,3,4,0.75,2,3,5,2,0,1,4,1,7,-7,1,Kyle Anderson,MIN,MIN,OKC,,,14,12,9,7
22023,203937,22300249,"NOV 26, 2023",MIN @ MEM,W,23,3,7,0.429,0,1,0.0,0,0,0.0,1,5,6,3,0,1,0,3,6,13,1,Kyle Anderson,MIN,MEM,MIN,,,15,12,9,9
22023,203937,22300050,"NOV 24, 2023",MIN vs. SAC,L,18,1,2,0.5,0,0,0.0,2,2,1.0,0,1,1,4,0,0,0,1,4,-24,1,Kyle Anderson,MIN,MIN,SAC,,,9,5,8,5
22023,203937,22300232,"NOV 22, 2023",MIN vs. PHI,W,28,3,6,0.5,0,0,0.0,1,4,0.25,1,4,5,3,0,1,2,1,7,3,1,Kyle Anderson,MIN,MIN,PHI,,,15,12,10,8
22023,203937,22300221,"NOV 20, 2023",MIN vs. NYK,W,23,3,4,0.75,0,0,0.0,3,5,0.6,0,2,2,5,1,2,1,2,9,3,1,Kyle Anderson,MIN,MIN,NYK,,,16,11,14,7
22023,203937,22300203,"NOV 18, 2023",MIN @ NOP,W,26,4,7,0.571,0,0,0.0,1,2,0.5,1,4,5,5,1,2,1,0,9,5,1,Kyle Anderson,MIN,NOP,MIN,,,19,14,14,10
22023,203937,22300197,"NOV 15, 2023",MIN @ PHX,L,21,2,5,0.4,0,0,0.0,2,2,1.0,1,1,2,3,2,1,1,0,6,-13,1,Kyle Anderson,MIN,PHX,MIN,,,11,8,9,5
22023,203937,22300025,"NOV 14, 2023",MIN @ GSW,W,27,3,9,0.333,0,2,0.0,2,2,1.0,1,3,4,3,0,1,2,4,8,11,1,Kyle Anderson,MIN,GSW,MIN,,,15,12,11,7
22023,203937,22300186,"NOV 12, 2023",MIN @ GSW,W,17,4,4,1.0,0,0,0.0,0,2,0.0,0,4,4,1,1,0,3,1,8,-13,1,Kyle Anderson,MIN,GSW,MIN,,,13,12,9,5
22023,203937,22300013,"NOV 10, 2023",MIN @ SAS,W,26,2,2,1.0,0,0,0.0,2,4,0.5,0,5,5,4,1,0,4,1,6,9,1,Kyle Anderson,MIN,SAS,MIN,,,15,11,10,9
22023,203937,22300166,"NOV 08, 2023",MIN vs. NOP,W,25,2,3,0.667,1,2,0.5,1,2,0.5,0,2,2,5,1,2,2,2,6,16,1,Kyle Anderson,MIN,MIN,NOP,,,13,8,11,7
22023,203937,22300154,"NOV 06, 2023",MIN vs. BOS,W,25,1,6,0.167,0,2,0.0,1,2,0.5,2,3,5,6,0,1,4,4,3,6,1,Kyle Anderson,MIN,MIN,BOS,,,14,8,9,11
22023,203937,22300138,"NOV 04, 2023",MIN vs. UTA,W,27,5,6,0.833,0,0,0.0,2,2,1.0,1,2,3,6,1,2,0,3,12,11,1,Kyle Anderson,MIN,MIN,UTA,,,21,15,18,9
22023,203937,22300123,"NOV 01, 2023",MIN vs. DEN,W,25,4,6,0.667,1,1,1.0,0,0,0.0,0,3,3,2,0,0,0,0,9,-1,1,Kyle Anderson,MIN,MIN,DEN,,,14,12,11,5
22023,203937,22300104,"OCT 30, 2023",MIN @ ATL,L,25,2,5,0.4,0,2,0.0,0,0,0.0,1,1,2,5,2,1,2,1,4,-8,1,Kyle Anderson,MIN,ATL,MIN,,,11,6,9,7
22023,203937,22300093,"OCT 28, 2023",MIN vs. MIA,W,23,5,6,0.833,0,0,0.0,2,2,1.0,0,2,2,4,2,0,2,1,12,7,1,Kyle Anderson,MIN,MIN,MIA,,,18,14,16,6
22023,203937,22300069,"OCT 25, 2023",MIN @ TOR,L,30,3,9,0.333,0,1,0.0,1,2,0.5,2,7,9,5,2,0,1,0,7,15,1,Kyle Anderson,MIN,TOR,MIN,,,21,16,12,14
22023,203507,22300552,"JAN 14, 2024",MIL vs. SAC,W,40,9,16,0.563,0,2,0.0,9,14,0.643,1,9,10,10,3,0,4,4,27,-13,1,Giannis Antetokounmpo,MIL,MIL,SAC,,,47,37,37,20
22023,203507,22300545,"JAN 13, 2024",MIL vs. GSW,W,37,13,22,0.591,1,3,0.333,6,8,0.75,3,6,9,5,0,0,4,3,33,1,1,Giannis Antetokounmpo,MIL,MIL,GSW,,,47,42,38,14
22023,203507,22300528,"JAN 11, 2024",MIL vs. BOS,W,26,10,13,0.769,0,0,0.0,4,5,0.8,5,7,12,6,1,1,4,2,24,38,1,Giannis Antetokounmpo,MIL,MIL,BOS,,,42,36,30,18
22023,203507,22300510,"JAN 08, 2024",MIL vs. UTA,L,38,10,20,0.5,0,2,0.0,5,9,0.556,4,6,10,11,0,0,4,5,25,-14,1,Giannis Antetokounmpo,MIL,MIL,UTA,,,46,35,36,21
22023,203507,22300496,"JAN 06, 2024",MIL @ HOU,L,39,16,25,0.64,1,2,0.5,15,21,0.714,3,14,17,2,0,1,2,4,48,-1,1,Giannis Antetokounmpo,MIL,HOU,MIL,,,67,65,50,19
22023,203507,22300477,"JAN 04, 2024",MIL @ SAS,W,40,19,28,0.679,2,3,0.667,4,6,0.667,3,11,14,7,2,1,1,3,44,11,1,Giannis Antetokounmpo,MIL,SAS,MIL,,,65,58,51,21
22023,203507,22300466,"JAN 03, 2024",MIL @ IND,L,36,8,13,0.615,1,2,0.5,9,13,0.692,0,11,11,8,3,1,3,2,26,-12,1,Giannis Antetokounmpo,MIL,IND,MIL,,,45,37,34,19
22023,203507,22300454,"JAN 01, 2024",MIL vs. IND,L,37,11,20,0.55,0,3,0.0,8,11,0.727,3,15,18,11,1,2,4,3,30,3,1,Giannis Antetokounmpo,MIL,MIL,IND,,,59,48,41,29
22023,203507,22300433,"DEC 29, 2023",MIL @ CLE,W,37,14,22,0.636,0,1,0.0,6,7,0.857,2,14,16,5,1,0,3,2,34,12,1,Giannis Antetokounmpo,MIL,CLE,MIL,,,55,50,39,21
22023,203507,22300417,"DEC 27, 2023",MIL @ BKN,W,30,10,12,0.833,0,0,0.0,12,17,0.706,2,8,10,8,0,2,2,2,32,8,1,Giannis Antetokounmpo,MIL,BKN,MIL,,,50,42,40,18
22023,203507,22300401,"DEC 25, 2023",MIL @ NYK,L,39,13,24,0.542,1,2,0.5,5,9,0.556,5,8,13,6,1,2,2,4,32,-5,1,Giannis Antetokounmpo,MIL,NYK,MIL,,,51,45,38,19
22023,203507,22300388,"DEC 23, 2023",MIL @ NYK,W,32,11,17,0.647,0,0,0.0,6,8,0.75,2,5,7,7,1,1,5,4,28,3,1,Giannis Antetokounmpo,MIL,NYK,MIL,,,42,35,35,14
22023,203507,22300378,"DEC 21, 2023",MIL vs. ORL,W,37,11,25,0.44,0,3,0.0,15,19,0.789,2,8,10,6,0,2,5,4,37,9,1,Giannis Antetokounmpo,MIL,MIL,ORL,,,53,47,43,16
22023,203507,22300361,"DEC 19, 2023",MIL vs. SAS,W,34,4,12,0.333,0,2,0.0,3,6,0.5,2,12,14,16,2,1,3,1,11,13,1,Giannis Antetokounmpo,MIL,MIL,SAS,,,41,25,27,30
22023,203507,22300346,"DEC 17, 2023",MIL vs. HOU,W,39,10,22,0.455,1,3,0.333,5,11,0.455,6,11,17,3,0,0,6,3,26,11,1,Giannis Antetokounmpo,MIL,MIL,HOU,,,46,43,29,20
22023,203507,22300334,"DEC 16, 2023",MIL vs. DET,W,26,7,9,0.778,0,0,0.0,8,13,0.615,1,7,8,6,1,0,0,1,22,22,1,Giannis Antetokounmpo,MIL,MIL,DET,,,36,30,28,14
22023,203507,22300315,"DEC 13, 2023",MIL vs. IND,W,37,20,28,0.714,0,3,0.0,24,32,0.75,3,11,14,3,4,1,4,1,64,29,1,Giannis Antetokounmpo,MIL,MIL,IND,,,81,78,67,17
22023,203507,22300300,"DEC 11, 2023",MIL vs. CHI,W,41,9,13,0.692,0,0,0.0,14,18,0.778,1,11,12,6,2,0,2,2,32,13,1,Giannis Antetokounmpo,MIL,MIL,CHI,,,50,44,38,18
22023,203507,22301229,"DEC 07, 2023",MIL vs. IND,L,41,13,19,0.684,0,1,0.0,11,13,0.846,1,9,10,2,0,2,1,3,37,-5,1,Giannis Antetokounmpo,MIL,MIL,IND,,,49,47,39,12
22023,203507,22301201,"DEC 05, 2023",MIL vs. NYK,W,34,15,22,0.682,1,1,1.0,4,9,0.444,3,5,8,10,3,0,4,3,35,19,1,Giannis Antetokounmpo,MIL,MIL,NYK,,,53,43,45,18
22023,203507,22300286,"DEC 02, 2023",MIL vs. ATL,W,36,14,20,0.7,0,1,0.0,4,5,0.8,2,9,11,10,2,1,5,1,32,8,1,Giannis Antetokounmpo,MIL,MIL,ATL,,,53,43,42,21
22023,203507,22300269,"NOV 30, 2023",MIL @ CHI,L,39,11,17,0.647,0,1,0.0,4,4,1.0,6,8,14,5,2,5,5,5,26,-8,1,Giannis Antetokounmpo,MIL,CHI,MIL,,,45,40,31,19
22023,203507,22300056,"NOV 28, 2023",MIL @ MIA,W,40,11,16,0.688,1,2,0.5,10,13,0.769,2,8,10,5,3,1,4,3,33,18,1,Giannis Antetokounmpo,MIL,MIA,MIL,,,48,43,38,15
22023,203507,22300245,"NOV 26, 2023",MIL vs. POR,W,39,11,21,0.524,0,1,0.0,11,18,0.611,6,10,16,6,1,3,4,5,33,9,1,Giannis Antetokounmpo,MIL,MIL,POR,,,55,49,39,22
22023,203507,22300049,"NOV 24, 2023",MIL vs. WAS,W,37,11,19,0.579,0,0,0.0,9,12,0.75,3,6,9,3,3,1,3,2,31,-10,1,Giannis Antetokounmpo,MIL,MIL,WAS,,,43,40,34,12
22023,203507,22300228,"NOV 22, 2023",MIL @ BOS,L,37,7,20,0.35,0,3,0.0,7,10,0.7,3,10,13,5,2,0,3,4,21,6,1,Giannis Antetokounmpo,MIL,BOS,MIL,,,39,34,26,18
22023,203507,22300219,"NOV 20, 2023",MIL @ WAS,W,34,20,23,0.87,0,0,0.0,2,6,0.333,6,7,13,8,1,1,5,2,42,10,1,Giannis Antetokounmpo,MIL,WAS,MIL,,,63,55,50,21
22023,203507,22300205,"NOV 18, 2023",MIL vs. DAL,W,38,18,26,0.692,1,3,0.333,3,5,0.6,2,13,15,7,2,1,3,3,40,-7,1,Giannis Antetokounmpo,MIL,MIL,DAL,,,62,55,47,22
22023,203507,22300027,"NOV 17, 2023",MIL @ CHA,W,28,6,10,0.6,0,0,0.0,4,7,0.571,0,8,8,9,1,0,4,5,16,6,1,Giannis Antetokounmpo,MIL,CHA,MIL,,,33,24,25,17
22023,203507,22300190,"NOV 13, 2023",MIL vs. CHI,W,35,13,22,0.591,1,3,0.333,8,14,0.571,3,8,11,2,0,0,3,4,35,13,1,Giannis Antetokounmpo,MIL,MIL,CHI,,,48,46,37,13
22023,203507,22300173,"NOV 11, 2023",MIL @ ORL,L,37,15,22,0.682,0,1,0.0,5,12,0.417,2,8,10,7,4,2,6,4,35,-11,1,Giannis Antetokounmpo,MIL,ORL,MIL,,,52,45,42,17
22023,203507,22300171,"NOV 09, 2023",MIL @ IND,L,36,19,25,0.76,0,1,0.0,16,18,0.889,2,10,12,3,0,0,8,4,54,6,1,Giannis Antetokounmpo,MIL,IND,MIL,,,69,66,57,15
22023,203507,22300165,"NOV 08, 2023",MIL vs. DET,W,22,6,16,0.375,0,2,0.0,3,6,0.5,0,9,9,5,0,3,1,1,15,5,1,Giannis Antetokounmpo,MIL,MIL,DET,,,29,24,20,14
22023,203507,22300149,"NOV 06, 2023",MIL @ BKN,W,35,15,27,0.556,1,7,0.143,5,6,0.833,2,10,12,3,1,2,3,1,36,15,1,Giannis Antetokounmpo,MIL,BKN,MIL,,,51,48,39,15
22023,203507,22300002,"NOV 03, 2023",MIL vs. NYK,W,36,6,10,0.6,3,3,1.0,7,13,0.538,1,7,8,6,0,1,7,3,22,13,1,Giannis Antetokounmpo,MIL,MIL,NYK,,,36,30,28,14
22023,203507,22300116,"NOV 01, 2023",MIL @ TOR,L,28,5,11,0.455,0,0,0.0,6,9,0.667,3,1,4,2,1,0,3,3,16,-10,1,Giannis Antetokounmpo,MIL,TOR,MIL,,,22,20,18,6
22023,203507,22300107,"OCT 30, 2023",MIL vs. MIA,W,32,12,21,0.571,1,3,0.333,8,11,0.727,1,6,7,2,0,1,2,3,33,18,1,Giannis Antetokounmpo,MIL,MIL,MIA,,,42,40,35,9
22023,203507,22300097,"OCT 29, 2023",MIL vs. ATL,L,29,9,14,0.643,0,1,0.0,8,10,0.8,5,6,11,3,1,2,3,2,26,-11,1,Giannis Antetokounmpo,MIL,MIL,ATL,,,40,37,29,14
22023,203507,22300075,"OCT 26, 2023",MIL vs. PHI,W,35,10,21,0.476,0,3,0.0,3,9,0.333,4,8,12,3,2,2,7,4,23,-13,1,Giannis Antetokounmpo,MIL,MIL,PHI,,,38,35,26,15
22023,203648,22300528,"JAN 11, 2024",MIL vs. BOS,W,9,3,5,0.6,0,0,0.0,0,0,0.0,1,0,1,1,0,1,2,4,6,-2,1,Thanasis Antetokounmpo,MIL,MIL,BOS,,,8,7,7,2
22023,203648,22300510,"JAN 08, 2024",MIL vs. UTA,L,1,0,0,0.0,0,0,0.0,0,0,0.0,0,0,0,0,0,0,0,0,0,0,1,Thanasis Antetokounmpo,MIL,MIL,UTA,,,0,0,0,0
22023,203648,22300466,"JAN 03, 2024",MIL @ IND,L,2,0,0,0.0,0,0,0.0,0,0,0.0,0,1,1,0,0,0,0,2,0,5,1,Thanasis Antetokounmpo,MIL,IND,MIL,,,1,1,0,1
22023,203648,22300417,"DEC 27, 2023",MIL @ BKN,W,1,0,0,0.0,0,0,0.0,0,0,0.0,0,0,0,2,0,0,0,0,0,6,1,Thanasis Antetokounmpo,MIL,BKN,MIL,,,2,0,2,2
22023,203648,22300361,"DEC 19, 2023",MIL vs. SAS,W,1,0,0,0.0,0,0,0.0,0,0,0.0,0,0,0,1,0,0,0,0,0,-2,1,Thanasis Antetokounmpo,MIL,MIL,SAS,,,1,0,1,1
22023,203648,22300346,"DEC 17, 2023",MIL vs. HOU,W,0,0,0,0.0,0,0,0.0,0,0,0.0,0,0,0,0,0,0,0,0,0,-3,1,Thanasis Antetokounmpo,MIL,MIL,HOU,,,0,0,0,0
22023,203648,22300334,"DEC 16, 2023",MIL vs. DET,W,5,0,0,0.0,0,0,0.0,0,0,0.0,0,1,1,0,0,0,0,0,0,-4,1,Thanasis Antetokounmpo,MIL,MIL,DET,,,1,1,0,1
22023,203648,22300315,"DEC 13, 2023",MIL vs. IND,W,1,0,0,0.0,0,0,0.0,0,0,0.0,0,0,0,0,0,0,1,0,0,-9,1,Thanasis Antetokounmpo,MIL,MIL,IND,,,0,0,0,0
22023,203648,22301201,"DEC 05, 2023",MIL vs. NYK,W,2,1,1,1.0,0,0,0.0,0,0,0.0,1,0,1,0,1,0,0,0,2,4,1,Thanasis Antetokounmpo,MIL,MIL,NYK,,,3,3,2,1
22023,203648,22300245,"NOV 26, 2023",MIL vs. POR,W,4,0,0,0.0,0,0,0.0,0,0,0.0,0,2,2,0,0,0,0,0,0,-2,1,Thanasis Antetokounmpo,MIL,MIL,POR,,,2,2,0,2
22023,203648,22300219,"NOV 20, 2023",MIL @ WAS,W,1,0,0,0.0,0,0,0.0,0,0,0.0,0,0,0,0,0,0,0,0,0,-5,1,Thanasis Antetokounmpo,MIL,WAS,MIL,,,0,0,0,0
22023,203648,22300027,"NOV 17, 2023",MIL @ CHA,W,3,1,1,1.0,0,0,0.0,0,0,0.0,0,0,0,0,0,0,0,0,2,11,1,Thanasis Antetokounmpo,MIL,CHA,MIL,,,2,2,2,0
22023,203648,22300195,"NOV 15, 2023",MIL @ TOR,W,15,1,5,0.2,0,0,0.0,0,0,0.0,2,0,2,0,0,0,0,3,2,-13,1,Thanasis Antetokounmpo,MIL,TOR,MIL,,,4,4,2,2
22023,203648,22300173,"NOV 11, 2023",MIL @ ORL,L,10,0,0,0.0,0,0,0.0,0,0,0.0,0,0,0,2,0,1,1,2,0,6,1,Thanasis Antetokounmpo,MIL,ORL,MIL,,,2,0,2,2
22023,203648,22300116,"NOV 01, 2023",MIL @ TOR,L,4,0,1,0.0,0,0,0.0,0,0,0.0,0,0,0,0,0,0,0,0,0,4,1,Thanasis Antetokounmpo,MIL,TOR,MIL,,,0,0,0,0
22023,203648,22300097,"OCT 29, 2023",MIL vs. ATL,L,8,1,1,1.0,0,0,0.0,0,0,0.0,0,0,0,2,1,0,3,2,2,14,1,Thanasis Antetokounmpo,MIL,MIL,ATL,,,4,2,4,2
22023,1630175,22300557,"JAN 15, 2024",ORL @ NYK,W,26,6,12,0.5,0,3,0.0,3,4,0.75,2,2,4,5,2,0,2,2,15,18,1,Cole Anthony,ORL,NYK,ORL,,,24,19,20,9
22023,1630175,22300546,"JAN 13, 2024",ORL @ OKC,L,25,6,11,0.545,1,3,0.333,1,2,0.5,2,2,4,2,1,1,2,4,14,-6,1,Cole Anthony,ORL,OKC,ORL,,,20,18,16,6
22023,1630175,22300535,"JAN 12, 2024",ORL @ MIA,L,27,2,8,0.25,0,2,0.0,1,2,0.5,1,2,3,0,2,1,0,1,5,2,1,Cole Anthony,ORL,MIA,ORL,,,8,8,5,3
22023,1630175,22300513,"JAN 09, 2024",ORL vs. MIN,L,7,1,4,0.25,0,1,0.0,0,0,0.0,1,0,1,0,0,0,0,2,2,2,1,Cole Anthony,ORL,ORL,MIN,,,3,3,2,1
22023,1630175,22300499,"JAN 07, 2024",ORL vs. ATL,W,31,3,13,0.231,0,3,0.0,4,4,1.0,0,9,9,5,0,0,4,5,10,-17,1,Cole Anthony,ORL,ORL,ATL,,,24,19,15,14
22023,1630175,22300488,"JAN 05, 2024",ORL @ DEN,W,31,8,15,0.533,3,8,0.375,4,4,1.0,0,2,2,4,1,0,3,2,23,2,1,Cole Anthony,ORL,DEN,ORL,,,29,25,27,6
22023,1630175,22300463,"JAN 02, 2024",ORL @ GSW,L,26,3,8,0.375,1,2,0.5,1,1,1.0,3,1,4,2,0,1,2,4,8,-4,1,Cole Anthony,ORL,GSW,ORL,,,14,12,10,6
22023,1630175,22300450,"DEC 31, 2023",ORL @ PHX,L,18,4,7,0.571,2,4,0.5,3,3,1.0,1,4,5,0,1,0,2,0,13,8,1,Cole Anthony,ORL,PHX,ORL,,,18,18,13,5
22023,1630175,22300429,"DEC 29, 2023",ORL vs. NYK,W,23,3,8,0.375,0,3,0.0,3,4,0.75,0,2,2,5,2,0,1,2,9,6,1,Cole Anthony,ORL,ORL,NYK,,,16,11,14,7
22023,1630175,22300415,"DEC 27, 2023",ORL vs. PHI,L,23,2,7,0.286,1,4,0.25,0,1,0.0,2,4,6,1,0,1,4,1,5,-14,1,Cole Anthony,ORL,ORL,PHI,,,12,11,6,7
22023,1630175,22300407,"DEC 26, 2023",ORL @ WAS,W,23,4,11,0.364,1,3,0.333,2,2,1.0,0,3,3,4,1,0,1,2,11,5,1,Cole Anthony,ORL,WAS,ORL,,,18,14,15,7
22023,1630175,22300391,"DEC 23, 2023",ORL @ IND,W,24,4,11,0.364,2,6,0.333,2,4,0.5,1,5,6,3,1,0,0,3,12,7,1,Cole Anthony,ORL,IND,ORL,,,21,18,15,9
22023,1630175,22300378,"DEC 21, 2023",ORL @ MIL,L,33,7,17,0.412,1,6,0.167,3,3,1.0,4,7,11,6,2,0,0,2,18,16,1,Cole Anthony,ORL,MIL,ORL,,,35,29,24,17
22023,1630175,22300366,"DEC 20, 2023",ORL vs. MIA,L,25,8,13,0.615,2,5,0.4,2,2,1.0,1,3,4,3,1,1,3,4,20,-6,1,Cole Anthony,ORL,ORL,MIA,,,27,24,23,7
22023,1630175,22300344,"DEC 17, 2023",ORL @ BOS,L,19,2,8,0.25,0,2,0.0,2,2,1.0,1,0,1,4,0,0,1,0,6,-14,1,Cole Anthony,ORL,BOS,ORL,,,11,7,10,5
22023,1630175,22300329,"DEC 15, 2023",ORL @ BOS,L,20,5,8,0.625,2,3,0.667,5,6,0.833,0,0,0,4,1,0,1,3,17,-12,1,Cole Anthony,ORL,BOS,ORL,,,21,17,21,4
22023,1630175,22300294,"DEC 11, 2023",ORL vs. CLE,W,18,3,6,0.5,1,1,1.0,1,2,0.5,1,1,2,4,0,0,0,3,8,-2,1,Cole Anthony,ORL,ORL,CLE,,,14,10,12,6
22023,1630175,22301217,"DEC 08, 2023",ORL vs. DET,W,24,6,12,0.5,1,3,0.333,3,3,1.0,0,3,3,6,0,0,1,4,16,23,1,Cole Anthony,ORL,ORL,DET,,,25,19,22,9
22023,1630175,22301205,"DEC 06, 2023",ORL @ CLE,L,32,8,14,0.571,1,4,0.25,2,3,0.667,1,6,7,2,1,2,2,3,19,-5,1,Cole Anthony,ORL,CLE,ORL,,,28,26,21,9
22023,1630175,22300282,"DEC 02, 2023",ORL @ BKN,L,31,8,17,0.471,2,6,0.333,2,2,1.0,1,5,6,1,0,1,1,3,20,-32,1,Cole Anthony,ORL,BKN,ORL,,,27,26,21,7
22023,1630175,22300274,"DEC 01, 2023",ORL vs. WAS,W,17,1,3,0.333,0,0,0.0,2,2,1.0,0,1,1,2,2,1,1,5,4,-4,1,Cole Anthony,ORL,ORL,WAS,,,7,5,6,3
22023,1630175,22300259,"NOV 29, 2023",ORL vs. WAS,W,26,9,16,0.563,3,5,0.6,4,5,0.8,3,3,6,5,0,2,1,4,25,14,1,Cole Anthony,ORL,ORL,WAS,,,36,31,30,11
22023,1630175,22300248,"NOV 26, 2023",ORL vs. CHA,W,32,9,16,0.563,1,3,0.333,11,12,0.917,1,6,7,7,2,1,2,3,30,15,1,Cole Anthony,ORL,ORL,CHA,,,44,37,37,14
22023,1630175,22300043,"NOV 24, 2023",ORL vs. BOS,W,29,6,17,0.353,2,4,0.5,2,4,0.5,1,2,3,6,2,1,3,4,16,17,1,Cole Anthony,ORL,ORL,BOS,,,25,19,22,9
22023,1630175,22300226,"NOV 22, 2023",ORL vs. DEN,W,29,6,11,0.545,1,4,0.25,7,8,0.875,3,2,5,0,0,0,0,3,20,2,1,Cole Anthony,ORL,ORL,DEN,,,25,25,20,5
22023,1630175,22300038,"NOV 21, 2023",ORL vs. TOR,W,29,5,10,0.5,2,4,0.5,3,3,1.0,2,3,5,10,0,0,2,3,15,8,1,Cole Anthony,ORL,ORL,TOR,,,30,20,25,15
22023,1630175,22300209,"NOV 19, 2023",ORL @ IND,W,25,5,12,0.417,1,3,0.333,4,4,1.0,0,5,5,3,0,1,4,4,15,11,1,Cole Anthony,ORL,IND,ORL,,,23,20,18,8
22023,1630175,22300033,"NOV 17, 2023",ORL @ CHI,W,37,3,12,0.25,1,5,0.2,4,4,1.0,2,6,8,7,1,0,2,4,11,7,1,Cole Anthony,ORL,CHI,ORL,,,26,19,18,15
22023,1630175,22300196,"NOV 15, 2023",ORL @ CHI,W,22,6,11,0.545,2,3,0.667,2,2,1.0,1,4,5,3,1,0,3,5,16,4,1,Cole Anthony,ORL,CHI,ORL,,,24,21,19,8
22023,1630175,22300020,"NOV 14, 2023",ORL @ BKN,L,28,2,10,0.2,2,8,0.25,4,4,1.0,3,3,6,2,0,0,4,0,10,1,1,Cole Anthony,ORL,BKN,ORL,,,18,16,12,8
22023,1630175,22300173,"NOV 11, 2023",ORL vs. MIL,W,14,0,3,0.0,0,1,0.0,4,4,1.0,0,2,2,3,1,0,3,2,4,14,1,Cole Anthony,ORL,ORL,MIL,,,9,6,7,5
22023,1630175,22300172,"NOV 09, 2023",ORL vs. ATL,L,23,1,7,0.143,0,4,0.0,5,6,0.833,1,1,2,2,0,0,3,3,7,-3,1,Cole Anthony,ORL,ORL,ATL,,,11,9,9,4
22023,1630175,22300147,"NOV 06, 2023",ORL vs. DAL,L,30,7,13,0.538,2,5,0.4,3,5,0.6,0,2,2,5,1,2,3,3,19,-14,1,Cole Anthony,ORL,ORL,DAL,,,26,21,24,7
22023,1630175,22300134,"NOV 04, 2023",ORL vs. LAL,W,23,4,9,0.444,3,5,0.6,3,3,1.0,3,2,5,1,0,0,3,1,14,-6,1,Cole Anthony,ORL,ORL,LAL,,,20,19,15,6
22023,1630175,22300130,"NOV 02, 2023",ORL @ UTA,W,31,5,10,0.5,2,4,0.5,6,6,1.0,0,7,7,7,2,0,3,3,18,-7,1,Cole Anthony,ORL,UTA,ORL,,,32,25,25,14
22023,1630175,22300114,"OCT 31, 2023",ORL @ LAC,L,18,3,6,0.5,0,2,0.0,4,6,0.667,0,2,2,1,0,0,1,3,10,-18,1,Cole Anthony,ORL,LAC,ORL,,,13,12,11,3
22023,1630175,22300111,"OCT 30, 2023",ORL @ LAL,L,21,4,12,0.333,1,3,0.333,3,4,0.75,0,3,3,2,3,0,1,2,12,-9,1,Cole Anthony,ORL,LAL,ORL,,,17,15,14,5
22023,1630175,22300086,"OCT 27, 2023",ORL @ POR,W,28,6,15,0.4,3,7,0.429,3,6,0.5,1,3,4,2,0,1,1,3,18,-9,1,Cole Anthony,ORL,POR,ORL,,,24,22,20,6
22023,1630175,22300066,"OCT 25, 2023",ORL vs. HOU,W,24,8,12,0.667,1,2,0.5,3,3,1.0,1,7,8,2,0,0,0,2,20,17,1,Cole Anthony,ORL,ORL,HOU,,,30,28,22,10
22023,1628384,22300557,"JAN 15, 2024",NYK vs. ORL,L,44,5,11,0.455,3,4,0.75,4,4,1.0,1,1,2,4,0,0,2,2,17,2,1,OG Anunoby,NYK,NYK,ORL,,,23,19,21,6
22023,1628384,22300544,"JAN 13, 2024",NYK @ MEM,W,32,7,15,0.467,1,4,0.25,3,4,0.75,2,3,5,2,1,4,4,1,18,7,1,OG Anunoby,NYK,MEM,NYK,,,25,23,20,7
22023,1628384,22300530,"JAN 11, 2024",NYK @ DAL,L,39,4,10,0.4,1,6,0.167,1,1,1.0,1,5,6,2,0,2,1,1,10,14,1,OG Anunoby,NYK,DAL,NYK,,,18,16,12,8
22023,1628384,22300514,"JAN 09, 2024",NYK vs. POR,W,29,9,12,0.75,4,6,0.667,1,2,0.5,2,2,4,0,1,1,1,3,23,26,1,OG Anunoby,NYK,NYK,POR,,,27,27,23,4
22023,1628384,22300494,"JAN 06, 2024",NYK @ WAS,W,31,4,7,0.571,1,3,0.333,0,0,0.0,2,3,5,2,1,0,1,3,9,11,1,OG Anunoby,NYK,WAS,NYK,,,16,14,11,7
22023,1628384,22300483,"JAN 05, 2024",NYK @ PHI,W,37,3,11,0.273,1,3,0.333,4,4,1.0,1,1,2,0,1,0,0,3,11,20,1,OG Anunoby,NYK,PHI,NYK,,,13,13,11,2
22023,1628384,22300468,"JAN 03, 2024",NYK vs. CHI,W,34,5,9,0.556,1,4,0.25,0,0,0.0,2,6,8,2,2,0,1,2,11,35,1,OG Anunoby,NYK,NYK,CHI,,,21,19,13,10
22023,1628384,22300451,"JAN 01, 2024",NYK vs. MIN,W,35,7,12,0.583,3,6,0.5,0,0,0.0,3,3,6,1,2,0,1,6,17,19,1,OG Anunoby,NYK,NYK,MIN,,,24,23,18,7
22023,1628384,22300432,"DEC 29, 2023",TOR @ BOS,L,37,5,8,0.625,2,4,0.5,0,0,0.0,0,2,2,2,2,0,1,1,12,4,1,OG Anunoby,TOR,BOS,TOR,,,16,14,14,4
22023,1628384,22300416,"DEC 27, 2023",TOR @ WAS,W,29,11,16,0.688,3,7,0.429,1,2,0.5,2,4,6,2,0,0,1,1,26,24,1,OG Anunoby,TOR,WAS,TOR,,,34,32,28,8
22023,1628384,22300395,"DEC 23, 2023",TOR vs. UTA,L,36,8,13,0.615,2,3,0.667,1,1,1.0,1,1,2,4,2,0,0,1,19,-4,1,OG Anunoby,TOR,TOR,UTA,,,25,21,23,6
22023,1628384,22300382,"DEC 22, 2023",TOR @ PHI,L,35,4,9,0.444,0,4,0.0,4,4,1.0,0,4,4,6,1,0,2,4,12,-11,1,OG Anunoby,TOR,PHI,TOR,,,22,16,18,10
22023,1628384,22300369,"DEC 20, 2023",TOR vs. DEN,L,40,4,9,0.444,1,4,0.25,0,0,0.0,0,1,1,3,0,0,1,2,9,-5,1,OG Anunoby,TOR,TOR,DEN,,,13,10,12,4
22023,1628384,22300354,"DEC 18, 2023",TOR vs. CHA,W,32,2,10,0.2,0,5,0.0,1,1,1.0,0,2,2,2,1,0,2,3,5,3,1,OG Anunoby,TOR,TOR,CHA,,,9,7,7,4
22023,1628384,22300330,"DEC 15, 2023",TOR vs. ATL,L,33,3,8,0.375,1,4,0.25,0,0,0.0,0,2,2,4,0,0,2,0,7,-19,1,OG Anunoby,TOR,TOR,ATL,,,13,9,11,6
22023,1628384,22300313,"DEC 13, 2023",TOR vs. ATL,W,37,10,13,0.769,2,5,0.4,0,0,0.0,2,3,5,3,1,0,2,4,22,17,1,OG Anunoby,TOR,TOR,ATL,,,30,27,25,8
22023,1628384,22300297,"DEC 11, 2023",TOR @ NYK,L,37,11,20,0.55,5,11,0.455,2,2,1.0,1,4,5,2,1,0,2,3,29,-6,1,OG Anunoby,TOR,NYK,TOR,,,36,34,31,7
22023,1628384,22301216,"DEC 08, 2023",TOR @ CHA,L,36,3,12,0.25,0,6,0.0,5,5,1.0,0,3,3,4,1,0,0,3,11,0,1,OG Anunoby,TOR,CHA,TOR,,,18,14,15,7
22023,1628384,22301207,"DEC 06, 2023",TOR vs. MIA,L,39,8,13,0.615,5,10,0.5,2,2,1.0,1,7,8,6,1,1,2,2,23,-9,1,OG Anunoby,TOR,TOR,MIA,,,37,31,29,14
22023,1628384,22300276,"DEC 01, 2023",TOR vs. NYK,L,27,4,13,0.308,1,6,0.167,0,0,0.0,1,4,5,3,1,2,3,5,9,-4,1,OG Anunoby,TOR,TOR,NYK,,,17,14,12,8
22023,1628384,22300260,"NOV 29, 2023",TOR vs. PHX,W,34,5,10,0.5,3,5,0.6,0,1,0.0,0,3,3,1,3,1,0,3,13,1,1,OG Anunoby,TOR,TOR,PHX,,,17,16,14,4
22023,1628384,22300054,"NOV 28, 2023",TOR @ BKN,L,37,4,12,0.333,2,6,0.333,0,0,0.0,2,1,3,2,0,0,2,3,10,-14,1,OG Anunoby,TOR,BKN,TOR,,,15,13,12,5
22023,1628384,22300251,"NOV 26, 2023",TOR @ CLE,L,34,4,12,0.333,2,5,0.4,1,3,0.333,5,2,7,1,0,1,1,1,11,11,1,OG Anunoby,TOR,CLE,TOR,,,19,18,12,8
22023,1628384,22300046,"NOV 24, 2023",TOR vs. CHI,W,34,10,14,0.714,5,7,0.714,1,2,0.5,1,5,6,3,1,0,2,2,26,9,1,OG Anunoby,TOR,TOR,CHI,,,35,32,29,9
22023,1628384,22300230,"NOV 22, 2023",TOR @ IND,W,36,5,12,0.417,1,4,0.25,2,2,1.0,2,2,4,3,1,0,2,3,13,-6,1,OG Anunoby,TOR,IND,TOR,,,20,17,16,7
22023,1628384,22300038,"NOV 21, 2023",TOR @ ORL,L,30,4,8,0.5,3,5,0.6,0,0,0.0,0,1,1,4,0,3,4,0,11,-15,1,OG Anunoby,TOR,ORL,TOR,,,16,12,15,5
22023,1628384,22300211,"NOV 19, 2023",TOR vs. DET,W,27,2,11,0.182,1,6,0.167,4,6,0.667,1,4,5,3,2,0,1,3,9,15,1,OG Anunoby,TOR,TOR,DET,,,17,14,12,8
22023,1628384,22300174,"NOV 11, 2023",TOR @ BOS,L,28,3,13,0.231,2,8,0.25,0,0,0.0,1,2,3,2,1,0,0,0,8,-26,1,OG Anunoby,TOR,BOS,TOR,,,13,11,10,5
22023,1628384,22300168,"NOV 08, 2023",TOR @ DAL,W,36,9,17,0.529,3,8,0.375,5,6,0.833,1,4,5,2,0,0,2,4,26,9,1,OG Anunoby,TOR,DAL,TOR,,,33,31,28,7
22023,1628384,22300141,"NOV 05, 2023",TOR @ SAS,W,38,8,16,0.5,7,13,0.538,1,4,0.25,2,4,6,4,2,0,1,3,24,8,1,OG Anunoby,TOR,SAS,TOR,,,34,30,28,10
22023,1628384,22300128,"NOV 02, 2023",TOR @ PHI,L,33,7,12,0.583,2,4,0.5,0,0,0.0,1,3,4,1,0,1,3,2,16,5,1,OG Anunoby,TOR,PHI,TOR,,,21,20,17,5
22023,1628384,22300116,"NOV 01, 2023",TOR vs. MIL,W,25,7,7,1.0,1,1,1.0,1,2,0.5,0,2,2,3,1,0,2,5,16,16,1,OG Anunoby,TOR,TOR,MIL,,,21,18,19,5
22023,1628384,22300105,"OCT 30, 2023",TOR vs. POR,L,30,4,12,0.333,2,9,0.222,0,0,0.0,0,3,3,1,2,1,2,0,10,0,1,OG Anunoby,TOR,TOR,POR,,,14,13,11,4
22023,1628384,22300082,"OCT 27, 2023",TOR @ CHI,L,28,5,8,0.625,1,4,0.25,0,1,0.0,0,3,3,0,2,0,1,2,11,28,1,OG Anunoby,TOR,CHI,TOR,,,14,14,11,3
22023,1628384,22300069,"OCT 25, 2023",TOR vs. MIN,W,34,7,13,0.538,4,9,0.444,2,2,1.0,0,6,6,1,2,3,2,2,20,6,1,OG Anunoby,TOR,TOR,MIN,,,27,26,21,7
22023,1627853,22300514,"JAN 09, 2024",NYK vs. POR,W,6,0,1,0.0,0,1,0.0,0,0,0.0,0,0,0,0,0,0,0,2,0,1,1,Ryan Arcidiacono,NYK,NYK,POR,,,0,0,0,0
22023,1627853,22300483,"JAN 05, 2024",NYK @ PHI,W,4,0,1,0.0,0,1,0.0,0,0,0.0,0,1,1,0,0,0,0,1,0,2,1,Ryan Arcidiacono,NYK,PHI,NYK,,,1,1,0,1
22023,1627853,22300468,"JAN 03, 2024",NYK vs. CHI,W,1,0,0,0.0,0,0,0.0,0,0,0.0,0,0,0,0,0,0,0,0,0,0,1,Ryan Arcidiacono,NYK,NYK,CHI,,,0,0,0,0
22023,1627853,22300441,"DEC 30, 2023",NYK @ IND,L,1,0,0,0.0,0,0,0.0,0,0,0.0,0,0,0,0,0,0,0,0,0,3,1,Ryan Arcidiacono,NYK,IND,NYK,,,0,0,0,0
22023,1627853,22300388,"DEC 23, 2023",NYK vs. MIL,L,1,0,0,0.0,0,0,0.0,0,0,0.0,0,0,0,0,0,0,0,1,0,-3,1,Ryan Arcidiacono,NYK,NYK,MIL,,,0,0,0,0
22023,1627853,22300368,"DEC 20, 2023",NYK @ BKN,W,2,0,1,0.0,0,1,0.0,0,0,0.0,0,1,1,1,0,0,0,0,0,-2,1,Ryan Arcidiacono,NYK,BKN,NYK,,,2,1,1,2
22023,1627853,22300343,"DEC 16, 2023",NYK @ LAC,L,3,0,1,0.0,0,1,0.0,0,0,0.0,0,0,0,0,0,0,0,0,0,10,1,Ryan Arcidiacono,NYK,LAC,NYK,,,0,0,0,0
22023,1627853,22300333,"DEC 15, 2023",NYK @ PHX,W,1,0,0,0.0,0,0,0.0,0,0,0.0,0,1,1,1,0,0,0,0,0,-1,1,Ryan Arcidiacono,NYK,PHX,NYK,,,2,1,1,2
22023,1627853,22301201,"DEC 05, 2023",NYK @ MIL,L,2,0,0,0.0,0,0,0.0,0,0,0.0,0,1,1,1,1,0,0,0,0,-4,1,Ryan Arcidiacono,NYK,MIL,NYK,,,2,1,1,2
22023,1627853,22300221,"NOV 20, 2023",NYK @ MIN,L,3,0,0,0.0,0,0,0.0,0,0,0.0,0,1,1,0,0,0,0,0,0,0,1,Ryan Arcidiacono,NYK,MIN,NYK,,,1,1,0,1
22023,1627853,22300028,"NOV 17, 2023",NYK @ WAS,W,1,0,0,0.0,0,0,0.0,0,0,0.0,0,0,0,0,0,0,0,0,0,1,1,Ryan Arcidiacono,NYK,WAS,NYK,,,0,0,0,0
22023,1627853,22300177,"NOV 12, 2023",NYK vs. CHA,W,3,0,1,0.0,0,1,0.0,0,0,0.0,0,0,0,0,0,0,0,0,0,-4,1,Ryan Arcidiacono,NYK,NYK,CHA,,,0,0,0,0
22023,1627853,22300161,"NOV 08, 2023",NYK vs. SAS,W,2,0,0,0.0,0,0,0.0,0,0,0.0,0,0,0,0,0,0,0,0,0,-2,1,Ryan Arcidiacono,NYK,NYK,SAS,,,0,0,0,0
22023,1627853,22300112,"OCT 31, 2023",NYK @ CLE,W,2,0,0,0.0,0,0,0.0,0,0,0.0,0,1,1,0,0,0,0,0,0,1,1,Ryan Arcidiacono,NYK,CLE,NYK,,,1,1,0,1
22023,1630166,22300558,"JAN 15, 2024",WAS vs. DET,L,28,4,8,0.5,1,2,0.5,3,4,0.75,0,2,2,4,0,2,3,1,12,-2,1,Deni Avdija,WAS,WAS,DET,,,18,14,16,6
22023,1630166,22300543,"JAN 13, 2024",WAS @ ATL,W,37,7,12,0.583,1,2,0.5,4,5,0.8,1,13,14,9,1,1,3,5,19,11,1,Deni Avdija,WAS,ATL,WAS,,,42,33,28,23
22023,1630166,22300520,"JAN 10, 2024",WAS @ IND,L,25,4,10,0.4,1,3,0.333,6,7,0.857,0,5,5,1,1,0,1,5,15,2,1,Deni Avdija,WAS,IND,WAS,,,21,20,16,6
22023,1630166,22300508,"JAN 08, 2024",WAS vs. OKC,L,33,5,8,0.625,2,3,0.667,5,6,0.833,0,4,4,4,1,0,4,4,17,-20,1,Deni Avdija,WAS,WAS,OKC,,,25,21,21,8
22023,1630166,22300494,"JAN 06, 2024",WAS vs. NYK,L,33,9,13,0.692,2,4,0.5,3,5,0.6,3,7,10,6,2,0,4,5,23,-7,1,Deni Avdija,WAS,WAS,NYK,,,39,33,29,16
22023,1630166,22300482,"JAN 05, 2024",WAS @ CLE,L,26,5,8,0.625,0,1,0.0,3,4,0.75,0,5,5,4,2,1,3,4,13,-22,1,Deni Avdija,WAS,CLE,WAS,,,22,18,17,9
22023,1630166,22300465,"JAN 03, 2024",WAS @ CLE,L,21,3,11,0.273,1,3,0.333,0,0,0.0,2,4,6,4,1,0,3,1,7,-17,1,Deni Avdija,WAS,CLE,WAS,,,17,13,11,10
22023,1630166,22300445,"DEC 31, 2023",WAS vs. ATL,L,31,5,9,0.556,2,6,0.333,5,8,0.625,1,11,12,2,1,1,3,5,17,14,1,Deni Avdija,WAS,WAS,ATL,,,31,29,19,14
22023,1630166,22300430,"DEC 29, 2023",WAS vs. BKN,W,34,9,18,0.5,3,5,0.6,0,4,0.0,2,11,13,6,1,1,1,2,21,13,1,Deni Avdija,WAS,WAS,BKN,,,40,34,27,19
22023,1630166,22300416,"DEC 27, 2023",WAS vs. TOR,L,24,5,8,0.625,1,1,1.0,1,2,0.5,0,2,2,1,2,0,0,1,12,-12,1,Deni Avdija,WAS,WAS,TOR,,,15,14,13,3
22023,1630166,22300407,"DEC 26, 2023",WAS vs. ORL,L,23,1,7,0.143,0,4,0.0,0,0,0.0,0,5,5,3,3,1,2,1,2,-10,1,Deni Avdija,WAS,WAS,ORL,,,10,7,5,8
22023,1630166,22300386,"DEC 22, 2023",WAS @ GSW,L,20,2,5,0.4,0,0,0.0,3,3,1.0,2,2,4,4,1,0,0,1,7,0,1,Deni Avdija,WAS,GSW,WAS,,,15,11,11,8
22023,1630166,22300381,"DEC 21, 2023",WAS @ POR,W,35,4,7,0.571,0,1,0.0,5,7,0.714,2,9,11,6,1,0,2,1,13,9,1,Deni Avdija,WAS,POR,WAS,,,30,24,19,17
22023,1630166,22300358,"DEC 18, 2023",WAS @ SAC,L,23,3,8,0.375,1,3,0.333,2,4,0.5,0,5,5,3,1,0,2,5,9,-23,1,Deni Avdija,WAS,SAC,WAS,,,17,14,12,8
22023,1630166,22300347,"DEC 17, 2023",WAS @ PHX,L,32,2,6,0.333,0,1,0.0,3,4,0.75,0,6,6,2,0,0,2,5,7,7,1,Deni Avdija,WAS,PHX,WAS,,,15,13,9,8
22023,1630166,22300328,"DEC 15, 2023",WAS vs. IND,W,25,2,9,0.222,0,0,0.0,2,2,1.0,1,5,6,4,0,0,1,0,6,1,1,Deni Avdija,WAS,WAS,IND,,,16,12,10,10
22023,1630166,22300311,"DEC 13, 2023",WAS vs. NOP,L,30,4,8,0.5,1,3,0.333,4,4,1.0,0,5,5,7,0,0,2,1,13,-4,1,Deni Avdija,WAS,WAS,NOP,,,25,18,20,12
22023,1630166,22300295,"DEC 11, 2023",WAS @ PHI,L,26,3,8,0.375,1,3,0.333,2,2,1.0,2,4,6,3,1,0,3,1,9,-31,1,Deni Avdija,WAS,PHI,WAS,,,18,15,12,9
22023,1630166,22301219,"DEC 08, 2023",WAS @ BKN,L,27,6,9,0.667,1,4,0.25,2,3,0.667,0,7,7,4,1,2,0,1,15,-6,1,Deni Avdija,WAS,BKN,WAS,,,26,22,19,11
22023,1630166,22301208,"DEC 06, 2023",WAS vs. PHI,L,31,4,10,0.4,0,4,0.0,0,0,0.0,0,8,8,8,0,1,2,2,8,6,1,Deni Avdija,WAS,WAS,PHI,,,24,16,16,16
22023,1630166,22300274,"DEC 01, 2023",WAS @ ORL,L,20,2,7,0.286,0,2,0.0,2,2,1.0,0,3,3,5,0,0,0,1,6,-5,1,Deni Avdija,WAS,ORL,WAS,,,14,9,11,8
22023,1630166,22300259,"NOV 29, 2023",WAS @ ORL,L,28,9,12,0.75,1,2,0.5,3,4,0.75,3,1,4,5,2,0,0,1,22,-9,1,Deni Avdija,WAS,ORL,WAS,,,31,26,27,9
22023,1630166,22300253,"NOV 27, 2023",WAS @ DET,W,26,6,9,0.667,1,3,0.333,3,3,1.0,0,6,6,5,0,0,3,3,16,1,1,Deni Avdija,WAS,DET,WAS,,,27,22,21,11
22023,1630166,22300241,"NOV 25, 2023",WAS vs. ATL,L,17,3,8,0.375,1,4,0.25,2,2,1.0,1,5,6,2,0,0,3,2,9,-17,1,Deni Avdija,WAS,WAS,ATL,,,17,15,11,8
22023,1630166,22300049,"NOV 24, 2023",WAS @ MIL,L,28,1,6,0.167,0,0,0.0,0,0,0.0,2,3,5,5,0,0,0,3,2,-2,1,Deni Avdija,WAS,MIL,WAS,,,12,7,7,10
22023,1630166,22300225,"NOV 22, 2023",WAS @ CHA,L,28,5,9,0.556,1,2,0.5,2,2,1.0,2,3,5,1,0,0,1,0,13,3,1,Deni Avdija,WAS,CHA,WAS,,,19,18,14,6
22023,1630166,22300219,"NOV 20, 2023",WAS vs. MIL,L,31,3,5,0.6,0,1,0.0,1,2,0.5,1,3,4,2,0,1,0,3,7,-28,1,Deni Avdija,WAS,WAS,MIL,,,13,11,9,6
22023,1630166,22300028,"NOV 17, 2023",WAS vs. NYK,L,32,7,11,0.636,2,4,0.5,2,2,1.0,0,4,4,2,1,1,3,4,18,-6,1,Deni Avdija,WAS,WAS,NYK,,,24,22,20,6
22023,1630166,22300192,"NOV 15, 2023",WAS vs. DAL,L,24,5,6,0.833,3,4,0.75,2,2,1.0,1,2,3,4,3,0,0,4,15,1,1,Deni Avdija,WAS,WAS,DAL,,,22,18,19,7
22023,1630166,22300189,"NOV 13, 2023",WAS @ TOR,L,30,4,7,0.571,1,1,1.0,0,0,0.0,1,7,8,6,0,0,4,2,9,-2,1,Deni Avdija,WAS,TOR,WAS,,,23,17,15,14
22023,1630166,22300178,"NOV 12, 2023",WAS @ BKN,L,38,6,18,0.333,1,8,0.125,1,2,0.5,2,7,9,3,3,0,2,2,14,-1,1,Deni Avdija,WAS,BKN,WAS,,,26,23,17,12
22023,1630166,22300009,"NOV 10, 2023",WAS vs. CHA,L,31,5,9,0.556,1,4,0.25,0,0,0.0,1,5,6,5,1,1,3,2,11,9,1,Deni Avdija,WAS,WAS,CHA,,,22,17,16,11
22023,1630166,22300157,"NOV 08, 2023",WAS @ CHA,W,28,3,10,0.3,0,1,0.0,3,3,1.0,1,2,3,5,0,1,1,4,9,-5,1,Deni Avdija,WAS,CHA,WAS,,,17,12,14,8
22023,1630166,22300148,"NOV 06, 2023",WAS @ PHI,L,28,5,8,0.625,2,4,0.5,4,4,1.0,1,4,5,6,1,0,1,1,16,-11,1,Deni Avdija,WAS,PHI,WAS,,,27,21,22,11
22023,1630166,22300003,"NOV 03, 2023",WAS @ MIA,L,24,6,8,0.75,1,2,0.5,1,2,0.5,0,4,4,3,0,0,2,1,14,-14,1,Deni Avdija,WAS,MIA,WAS,,,21,18,17,7
22023,1630166,22300117,"NOV 01, 2023",WAS @ ATL,L,24,10,16,0.625,2,4,0.5,0,1,0.0,3,2,5,3,2,1,1,5,22,3,1,Deni Avdija,WAS,ATL,WAS,,,30,27,25,8
22023,1630166,22300103,"OCT 30, 2023",WAS vs. BOS,L,22,4,10,0.4,1,3,0.333,2,2,1.0,2,5,7,1,1,0,0,4,11,-26,1,Deni Avdija,WAS,WAS,BOS,,,19,18,12,8
22023,1630166,22300089,"OCT 28, 2023",WAS vs. MEM,W,27,4,8,0.5,2,3,0.667,0,0,0.0,2,4,6,2,2,0,1,2,10,9,1,Deni Avdija,WAS,WAS,MEM,,,18,16,12,8
22023,1630166,22300064,"OCT 25, 2023",WAS @ IND,L,21,4,8,0.5,0,0,0.0,1,2,0.5,2,5,7,5,1,0,2,0,9,-15,1,Deni Avdija,WAS,IND,WAS,,,21,16,14,12
22023,1629028,22300399,"DEC 23, 2023",POR @ GSW,L,29,6,12,0.5,0,0,0.0,1,3,0.333,1,5,6,2,3,0,1,2,13,2,1,Deandre Ayton,POR,GSW,POR,,,21,19,15,8
22023,1629028,22300381,"DEC 21, 2023",POR vs. WAS,L,35,10,21,0.476,0,0,0.0,3,4,0.75,10,6,16,2,0,1,5,3,23,-8,1,Deandre Ayton,POR,POR,WAS,,,41,39,25,18
22023,1629028,22300363,"DEC 19, 2023",POR vs. PHX,W,40,6,18,0.333,0,0,0.0,4,4,1.0,4,11,15,3,0,0,3,3,16,7,1,Deandre Ayton,POR,POR,PHX,,,34,31,19,18
22023,1629028,22300348,"DEC 17, 2023",POR vs. GSW,L,33,4,8,0.5,0,0,0.0,0,0,0.0,3,5,8,1,0,1,1,0,8,-3,1,Deandre Ayton,POR,POR,GSW,,,17,16,9,9
22023,1629028,22300341,"DEC 16, 2023",POR vs. DAL,L,27,3,5,0.6,0,0,0.0,1,2,0.5,3,7,10,2,2,0,1,3,7,1,1,Deandre Ayton,POR,POR,DAL,,,19,17,9,12
22023,1629028,22300323,"DEC 14, 2023",POR vs. UTA,L,21,6,13,0.462,0,0,0.0,2,2,1.0,5,4,9,0,1,1,4,2,14,-13,1,Deandre Ayton,POR,POR,UTA,,,23,23,14,9
22023,1629028,22300289,"DEC 02, 2023",POR @ UTA,L,35,4,8,0.5,0,0,0.0,2,2,1.0,1,10,11,0,0,0,0,3,10,-8,1,Deandre Ayton,POR,UTA,POR,,,21,21,10,11
22023,1629028,22300265,"NOV 30, 2023",POR @ CLE,W,30,5,9,0.556,0,0,0.0,0,0,0.0,2,4,6,3,0,0,3,2,10,-6,1,Deandre Ayton,POR,CLE,POR,,,19,16,13,9
22023,1629028,22300254,"NOV 27, 2023",POR @ IND,W,38,9,13,0.692,0,0,0.0,4,4,1.0,3,10,13,1,1,0,4,1,22,3,1,Deandre Ayton,POR,IND,POR,,,36,35,23,14
22023,1629028,22300245,"NOV 26, 2023",POR @ MIL,L,32,5,6,0.833,0,0,0.0,4,6,0.667,4,9,13,2,1,2,0,3,14,-13,1,Deandre Ayton,POR,MIL,POR,,,29,27,16,15
22023,1629028,22300041,"NOV 21, 2023",POR @ PHX,L,31,9,14,0.643,0,0,0.0,0,0,0.0,6,2,8,4,1,1,2,1,18,-33,1,Deandre Ayton,POR,PHX,POR,,,30,26,22,12
22023,1629028,22300215,"NOV 19, 2023",POR vs. OKC,L,24,5,7,0.714,0,0,0.0,1,2,0.5,2,3,5,2,1,1,2,0,11,-26,1,Deandre Ayton,POR,POR,OKC,,,18,16,13,7
22023,1629028,22300036,"NOV 17, 2023",POR vs. LAL,L,38,8,14,0.571,0,0,0.0,1,2,0.5,7,5,12,2,2,0,4,4,17,-7,1,Deandre Ayton,POR,POR,LAL,,,31,29,19,14
22023,1629028,22300199,"NOV 15, 2023",POR vs. CLE,L,26,3,10,0.3,0,0,0.0,0,0,0.0,2,4,6,0,0,0,2,3,6,-14,1,Deandre Ayton,POR,POR,CLE,,,12,12,6,6
22023,1629028,22300023,"NOV 14, 2023",POR @ UTA,L,34,10,17,0.588,0,0,0.0,2,2,1.0,5,5,10,3,0,0,2,1,22,-5,1,Deandre Ayton,POR,UTA,POR,,,35,32,25,13
22023,1629028,22300187,"NOV 12, 2023",POR @ LAL,L,34,6,10,0.6,0,0,0.0,0,0,0.0,0,7,7,0,0,2,2,2,12,-17,1,Deandre Ayton,POR,LAL,POR,,,19,19,12,7
22023,1629028,22300170,"NOV 08, 2023",POR @ SAC,L,41,9,14,0.643,0,0,0.0,0,0,0.0,1,9,10,2,0,0,2,5,18,7,1,Deandre Ayton,POR,SAC,POR,,,30,28,20,12
22023,1629028,22300144,"NOV 05, 2023",POR vs. MEM,L,35,3,9,0.333,0,0,0.0,0,0,0.0,2,9,11,0,2,1,3,4,6,-18,1,Deandre Ayton,POR,POR,MEM,,,17,17,6,11
22023,1629028,22300007,"NOV 03, 2023",POR vs. MEM,W,36,7,11,0.636,0,0,0.0,2,2,1.0,4,8,12,2,3,1,1,4,16,10,1,Deandre Ayton,POR,POR,MEM,,,30,28,18,14
22023,1629028,22300115,"NOV 01, 2023",POR @ DET,W,34,8,13,0.615,0,0,0.0,0,0,0.0,1,10,11,1,5,1,2,0,16,5,1,Deandre Ayton,POR,DET,POR,,,28,27,17,12
22023,1629028,22300105,"OCT 30, 2023",POR @ TOR,W,32,5,9,0.556,0,0,0.0,0,0,0.0,7,16,23,2,1,2,1,1,10,7,1,Deandre Ayton,POR,TOR,POR,,,35,33,12,25
22023,1629028,22300098,"OCT 29, 2023",POR @ PHI,L,21,3,7,0.429,0,0,0.0,1,1,1.0,2,7,9,2,2,1,0,3,7,-15,1,Deandre Ayton,POR,PHI,POR,,,18,16,9,11
22023,1629028,22300086,"OCT 27, 2023",POR vs. ORL,L,30,7,9,0.778,0,0,0.0,0,0,0.0,4,11,15,1,0,0,2,4,14,6,1,Deandre Ayton,POR,POR,ORL,,,30,29,15,16
22023,1629028,22300074,"OCT 25, 2023",POR @ LAC,L,23,2,4,0.5,0,0,0.0,0,0,0.0,3,9,12,1,3,1,3,5,4,-5,1,Deandre Ayton,POR,LAC,POR,,,17,16,5,13
22023,1628962,22300531,"JAN 11, 2024",PHX @ LAL,W,5,1,1,1.0,0,0,0.0,0,0,0.0,1,0,1,0,0,0,0,2,2,-6,1,Udoka Azubuike,PHX,LAL,PHX,,,3,3,2,1
22023,1628962,22300473,"JAN 03, 2024",PHX vs. LAC,L,2,0,0,0.0,0,0,0.0,0,0,0.0,0,0,0,0,0,0,0,0,0,-3,1,Udoka Azubuike,PHX,PHX,LAC,,,0,0,0,0
22023,1628962,22300456,"JAN 01, 2024",PHX vs. POR,W,4,0,2,0.0,0,0,0.0,0,2,0.0,0,2,2,0,0,0,0,0,0,-2,1,Udoka Azubuike,PHX,PHX,POR,,,2,2,0,2
22023,1628962,22300450,"DEC 31, 2023",PHX vs. ORL,W,8,0,0,0.0,0,0,0.0,0,0,0.0,0,1,1,0,0,1,1,1,0,-13,1,Udoka Azubuike,PHX,PHX,ORL,,,1,1,0,1
22023,1628962,22300436,"DEC 29, 2023",PHX vs. CHA,W,6,0,0,0.0,0,0,0.0,0,0,0.0,0,0,0,0,0,2,1,1,0,3,1,Udoka Azubuike,PHX,PHX,CHA,,,0,0,0,0
22023,1628962,22300418,"DEC 27, 2023",PHX @ HOU,W,19,5,7,0.714,0,0,0.0,1,3,0.333,3,2,5,0,0,2,0,4,11,15,1,Udoka Azubuike,PHX,HOU,PHX,,,16,16,11,5
22023,1628962,22300405,"DEC 25, 2023",PHX vs. DAL,L,4,2,2,1.0,0,0,0.0,0,0,0.0,0,0,0,0,0,0,0,0,4,2,1,Udoka Azubuike,PHX,PHX,DAL,,,4,4,4,0
22023,1628962,22300387,"DEC 22, 2023",PHX @ SAC,L,22,5,5,1.0,0,0,0.0,1,2,0.5,5,6,11,2,0,1,1,4,11,1,1,Udoka Azubuike,PHX,SAC,PHX,,,24,22,13,13
22023,1628962,22300140,"NOV 05, 2023",PHX @ DET,W,3,0,0,0.0,0,0,0.0,0,0,0.0,0,1,1,0,0,0,0,1,0,-5,1,Udoka Azubuike,PHX,DET,PHX,,,1,1,0,1
22023,1628962,22300094,"OCT 28, 2023",PHX vs. UTA,W,6,1,1,1.0,0,0,0.0,0,0,0.0,0,3,3,0,0,0,0,0,2,-4,1,Udoka Azubuike,PHX,PHX,UTA,,,5,5,2,3
22023,1628963,22300534,"JAN 12, 2024",DET vs. HOU,L,12,4,6,0.667,0,0,0.0,3,4,0.75,1,3,4,1,1,0,0,2,11,-2,1,Marvin Bagley III,DET,DET,HOU,,,16,15,12,5
22023,1628963,22300453,"JAN 01, 2024",DET @ HOU,L,9,1,2,0.5,0,0,0.0,0,0,0.0,0,0,0,2,1,0,0,0,2,1,1,Marvin Bagley III,DET,HOU,DET,,,4,2,4,2
22023,1628963,22300394,"DEC 23, 2023",DET @ BKN,L,15,2,4,0.5,0,0,0.0,1,2,0.5,2,3,5,0,0,0,1,0,5,-9,1,Marvin Bagley III,DET,BKN,DET,,,10,10,5,5
22023,1628963,22300374,"DEC 21, 2023",DET vs. UTA,L,31,10,12,0.833,0,1,0.0,2,2,1.0,2,3,5,0,0,0,0,3,22,6,1,Marvin Bagley III,DET,DET,UTA,,,27,27,22,5
22023,1628963,22300352,"DEC 18, 2023",DET @ ATL,L,23,7,12,0.583,0,0,0.0,3,4,0.75,1,0,1,0,0,0,2,2,17,-10,1,Marvin Bagley III,DET,ATL,DET,,,18,18,17,1
22023,1628963,22300334,"DEC 16, 2023",DET @ MIL,L,22,6,11,0.545,0,0,0.0,0,1,0.0,3,4,7,1,1,2,0,3,12,-17,1,Marvin Bagley III,DET,MIL,DET,,,20,19,13,8
22023,1628963,22301217,"DEC 08, 2023",DET @ ORL,L,23,4,7,0.571,0,0,0.0,1,2,0.5,2,3,5,0,0,0,4,1,9,-19,1,Marvin Bagley III,DET,ORL,DET,,,14,14,9,5
22023,1628963,22300283,"DEC 02, 2023",DET vs. CLE,L,7,0,1,0.0,0,0,0.0,0,0,0.0,1,2,3,0,1,0,0,1,0,-11,1,Marvin Bagley III,DET,DET,CLE,,,3,3,0,3
22023,1628963,22300268,"NOV 30, 2023",DET @ NYK,L,14,3,6,0.5,0,0,0.0,2,2,1.0,3,0,3,1,0,1,1,1,8,-7,1,Marvin Bagley III,DET,NYK,DET,,,12,11,9,4
22023,1628963,22300258,"NOV 29, 2023",DET vs. LAL,L,14,2,4,0.5,0,0,0.0,0,2,0.0,1,1,2,0,0,0,0,0,4,-4,1,Marvin Bagley III,DET,DET,LAL,,,6,6,4,2
22023,1628963,22300047,"NOV 24, 2023",DET @ IND,L,14,3,6,0.5,0,0,0.0,0,0,0.0,3,3,6,2,0,3,1,1,6,-8,1,Marvin Bagley III,DET,IND,DET,,,14,12,8,8
22023,1628963,22300218,"NOV 20, 2023",DET vs. DEN,L,26,7,13,0.538,0,0,0.0,4,5,0.8,3,5,8,1,0,0,1,4,18,8,1,Marvin Bagley III,DET,DET,DEN,,,27,26,19,9
22023,1628963,22300211,"NOV 19, 2023",DET @ TOR,L,15,3,4,0.75,0,0,0.0,0,0,0.0,1,1,2,3,0,0,0,0,6,-21,1,Marvin Bagley III,DET,TOR,DET,,,11,8,9,5
22023,1628963,22300030,"NOV 17, 2023",DET @ CLE,L,16,3,5,0.6,0,0,0.0,2,2,1.0,1,2,3,1,1,1,1,0,8,-17,1,Marvin Bagley III,DET,CLE,DET,,,12,11,9,4
22023,1628963,22300018,"NOV 14, 2023",DET vs. ATL,L,30,9,12,0.75,0,0,0.0,4,4,1.0,6,5,11,1,0,1,4,2,22,4,1,Marvin Bagley III,DET,DET,ATL,,,34,33,23,12
22023,1628963,22300181,"NOV 12, 2023",DET @ CHI,L,23,6,12,0.5,0,1,0.0,2,2,1.0,2,3,5,1,0,1,3,1,14,-8,1,Marvin Bagley III,DET,CHI,DET,,,20,19,15,6
22023,1628963,22300008,"NOV 10, 2023",DET vs. PHI,L,13,3,4,0.75,0,0,0.0,0,0,0.0,2,3,5,1,0,0,1,2,6,2,1,Marvin Bagley III,DET,DET,PHI,,,12,11,7,6
22023,1628963,22300165,"NOV 08, 2023",DET @ MIL,L,20,5,6,0.833,0,0,0.0,2,2,1.0,2,0,2,2,0,1,1,4,12,1,1,Marvin Bagley III,DET,MIL,DET,,,16,14,14,4
22023,1628963,22300145,"NOV 06, 2023",DET vs. GSW,L,24,4,8,0.5,0,0,0.0,2,2,1.0,0,2,2,1,0,0,1,1,10,1,1,Marvin Bagley III,DET,DET,GSW,,,13,12,11,3
22023,1628963,22300140,"NOV 05, 2023",DET vs. PHX,L,11,3,5,0.6,0,0,0.0,5,5,1.0,1,1,2,1,0,0,1,5,11,7,1,Marvin Bagley III,DET,DET,PHX,,,14,13,12,3
22023,1628963,22300129,"NOV 02, 2023",DET @ NOP,L,13,3,7,0.429,0,0,0.0,0,0,0.0,4,5,9,0,0,1,1,0,6,5,1,Marvin Bagley III,DET,NOP,DET,,,15,15,6,9
22023,1628963,22300115,"NOV 01, 2023",DET vs. POR,L,33,3,10,0.3,0,2,0.0,4,5,0.8,0,6,6,3,0,2,5,3,10,8,1,Marvin Bagley III,DET,DET,POR,,,19,16,13,9
22023,1628963,22300109,"OCT 30, 2023",DET @ OKC,L,24,3,4,0.75,0,0,0.0,7,8,0.875,1,3,4,1,0,0,0,1,13,0,1,Marvin Bagley III,DET,OKC,DET,,,18,17,14,5
22023,1628963,22300088,"OCT 28, 2023",DET vs. CHI,W,15,5,8,0.625,1,1,1.0,0,0,0.0,2,4,6,0,0,0,0,2,11,10,1,Marvin Bagley III,DET,DET,CHI,,,17,17,11,6
22023,1628963,22300077,"OCT 27, 2023",DET @ CHA,W,13,5,9,0.556,0,1,0.0,4,5,0.8,0,4,4,1,0,0,0,0,14,7,1,Marvin Bagley III,DET,CHA,DET,,,19,18,15,5
22023,1628963,22300068,"OCT 25, 2023",DET @ MIA,L,16,3,3,1.0,0,0,0.0,2,2,1.0,2,6,8,3,0,1,1,1,8,3,1,Marvin Bagley III,DET,MIA,DET,,,19,16,11,11
22023,1641735,22300335,"DEC 16, 2023",CHA vs. PHI,L,7,1,3,0.333,0,2,0.0,1,2,0.5,0,0,0,0,0,0,1,0,3,-6,1,Amari Bailey,CHA,CHA,PHI,,,3,3,3,0
22023,1641735,22300177,"NOV 12, 2023",CHA @ NYK,L,3,1,3,0.333,0,0,0.0,0,0,0.0,2,0,2,0,0,0,0,0,2,7,1,Amari Bailey,CHA,NYK,CHA,,,4,4,2,2
22023,1631116,22300558,"JAN 15, 2024",WAS vs. DET,L,13,3,3,1.0,3,3,1.0,0,0,0.0,0,3,3,1,1,0,0,2,9,8,1,Patrick Baldwin Jr.,WAS,WAS,DET,,,13,12,10,4
22023,1631116,22300543,"JAN 13, 2024",WAS @ ATL,W,18,3,8,0.375,0,3,0.0,2,4,0.5,3,6,9,0,0,1,2,5,8,2,1,Patrick Baldwin Jr.,WAS,ATL,WAS,,,17,17,8,9
22023,1631116,22300416,"DEC 27, 2023",WAS vs. TOR,L,6,0,2,0.0,0,2,0.0,0,0,0.0,0,0,0,0,0,0,0,1,0,-4,1,Patrick Baldwin Jr.,WAS,WAS,TOR,,,0,0,0,0
22023,1631116,22300386,"DEC 22, 2023",WAS @ GSW,L,7,0,1,0.0,0,0,0.0,0,0,0.0,0,1,1,0,0,0,0,0,0,10,1,Patrick Baldwin Jr.,WAS,GSW,WAS,,,1,1,0,1
22023,1631116,22300328,"DEC 15, 2023",WAS vs. IND,W,3,1,2,0.5,0,0,0.0,0,0,0.0,0,1,1,0,0,0,1,0,2,-8,1,Patrick Baldwin Jr.,WAS,WAS,IND,,,3,3,2,1
22023,1631116,22300311,"DEC 13, 2023",WAS vs. NOP,L,4,1,1,1.0,1,1,1.0,2,2,1.0,0,0,0,1,0,0,0,1,5,8,1,Patrick Baldwin Jr.,WAS,WAS,NOP,,,6,5,6,1
22023,1631116,22300295,"DEC 11, 2023",WAS @ PHI,L,17,3,5,0.6,2,3,0.667,2,2,1.0,0,4,4,1,0,0,0,2,10,-10,1,Patrick Baldwin Jr.,WAS,PHI,WAS,,,15,14,11,5
22023,1631116,22301219,"DEC 08, 2023",WAS @ BKN,L,4,0,3,0.0,0,0,0.0,0,0,0.0,2,2,4,0,0,1,0,0,0,-2,1,Patrick Baldwin Jr.,WAS,BKN,WAS,,,4,4,0,4
22023,1631116,22300192,"NOV 15, 2023",WAS vs. DAL,L,2,0,0,0.0,0,0,0.0,0,0,0.0,0,1,1,0,0,0,0,1,0,5,1,Patrick Baldwin Jr.,WAS,WAS,DAL,,,1,1,0,1
22023,1631116,22300103,"OCT 30, 2023",WAS vs. BOS,L,6,0,1,0.0,0,1,0.0,0,0,0.0,0,0,0,1,0,0,0,0,0,4,1,Patrick Baldwin Jr.,WAS,WAS,BOS,,,1,0,1,1
22023,1631116,22300064,"OCT 25, 2023",WAS @ IND,L,3,0,1,0.0,0,0,0.0,0,0,0.0,0,0,0,0,0,0,0,0,0,2,1,Patrick Baldwin Jr.,WAS,IND,WAS,,,0,0,0,0
22023,1630163,22300551,"JAN 14, 2024",CHA @ MIA,L,30,9,24,0.375,3,13,0.231,0,0,0.0,2,8,10,5,3,0,2,3,21,8,1,LaMelo Ball,CHA,MIA,CHA,,,36,31,26,15
22023,1630163,22300541,"JAN 12, 2024",CHA @ SAS,L,27,5,14,0.357,3,9,0.333,15,16,0.938,0,3,3,5,5,0,6,4,28,-16,1,LaMelo Ball,CHA,SAS,CHA,,,36,31,33,8
22023,1630163,22300248,"NOV 26, 2023",CHA @ ORL,L,15,3,6,0.5,1,3,0.333,0,0,0.0,0,1,1,2,0,0,1,0,7,-2,1,LaMelo Ball,CHA,ORL,CHA,,,10,8,9,3
22023,1630163,22300225,"NOV 22, 2023",CHA vs. WAS,W,40,13,31,0.419,6,16,0.375,2,3,0.667,2,6,8,13,1,0,4,2,34,4,1,LaMelo Ball,CHA,CHA,WAS,,,55,42,47,21
22023,1630163,22300217,"NOV 20, 2023",CHA vs. BOS,W,41,15,27,0.556,5,11,0.455,1,1,1.0,2,7,9,8,2,1,5,5,36,3,1,LaMelo Ball,CHA,CHA,BOS,,,53,45,44,17
22023,1630163,22300202,"NOV 18, 2023",CHA vs. NYK,L,36,12,22,0.545,8,13,0.615,2,2,1.0,0,5,5,9,1,0,3,3,34,-16,1,LaMelo Ball,CHA,CHA,NYK,,,48,39,43,14
22023,1630163,22300027,"NOV 17, 2023",CHA vs. MIL,L,35,12,28,0.429,2,9,0.222,11,12,0.917,0,5,5,5,1,0,6,2,37,-18,1,LaMelo Ball,CHA,CHA,MIL,,,47,42,42,10
22023,1630163,22300017,"NOV 14, 2023",CHA vs. MIA,L,39,9,26,0.346,4,10,0.4,6,6,1.0,2,4,6,11,3,0,8,5,28,2,1,LaMelo Ball,CHA,CHA,MIA,,,45,34,39,17
22023,1630163,22300177,"NOV 12, 2023",CHA @ NYK,L,33,13,20,0.65,4,8,0.5,2,2,1.0,3,4,7,6,1,1,2,2,32,-32,1,LaMelo Ball,CHA,NYK,CHA,,,45,39,38,13
22023,1630163,22300009,"NOV 10, 2023",CHA @ WAS,W,38,9,19,0.474,4,8,0.5,3,4,0.75,3,3,6,6,2,0,2,5,25,0,1,LaMelo Ball,CHA,WAS,CHA,,,37,31,31,12
22023,1630163,22300157,"NOV 08, 2023",CHA vs. WAS,L,36,13,22,0.591,3,9,0.333,5,7,0.714,3,1,4,7,1,0,6,3,34,-3,1,LaMelo Ball,CHA,CHA,WAS,,,45,38,41,11
22023,1630163,22300143,"NOV 05, 2023",CHA @ DAL,L,39,11,23,0.478,5,10,0.5,3,3,1.0,2,8,10,13,1,1,3,6,30,1,1,LaMelo Ball,CHA,DAL,CHA,,,53,40,43,23
22023,1630163,22300133,"NOV 04, 2023",CHA @ IND,W,31,4,15,0.267,2,7,0.286,1,1,1.0,1,1,2,11,2,0,6,5,11,-15,1,LaMelo Ball,CHA,IND,CHA,,,24,13,22,13
22023,1630163,22300122,"NOV 01, 2023",CHA @ HOU,L,33,7,15,0.467,2,6,0.333,3,4,0.75,1,0,1,5,1,0,3,4,19,-14,1,LaMelo Ball,CHA,HOU,CHA,,,25,20,24,6
22023,1630163,22300101,"OCT 30, 2023",CHA vs. BKN,L,22,3,12,0.25,0,6,0.0,2,2,1.0,0,3,3,8,2,0,3,6,8,-3,1,LaMelo Ball,CHA,CHA,BKN,,,19,11,16,11
22023,1630163,22300077,"OCT 27, 2023",CHA vs. DET,L,33,4,17,0.235,2,7,0.286,10,12,0.833,3,6,9,9,2,1,4,1,20,-7,1,LaMelo Ball,CHA,CHA,DET,,,38,29,29,18
22023,1630163,22300063,"OCT 25, 2023",CHA vs. ATL,W,31,4,15,0.267,4,11,0.364,3,4,0.75,1,5,6,10,1,0,3,3,15,7,1,LaMelo Ball,CHA,CHA,ATL,,,31,21,25,16
22023,1628964,22300532,"JAN 12, 2024",PHI vs. SAC,W,20,4,6,0.667,2,2,1.0,1,2,0.5,2,1,3,0,1,4,2,1,11,9,1,Mo Bamba,PHI,PHI,SAC,,,14,14,11,3
22023,1628964,22300521,"JAN 10, 2024",PHI @ ATL,L,14,2,4,0.5,0,1,0.0,1,2,0.5,4,2,6,2,1,3,1,3,5,-5,1,Mo Bamba,PHI,ATL,PHI,,,13,11,7,8
22023,1628964,22300495,"JAN 06, 2024",PHI vs. UTA,L,17,3,9,0.333,0,2,0.0,0,1,0.0,3,2,5,1,1,1,0,4,6,-2,1,Mo Bamba,PHI,PHI,UTA,,,12,11,7,6
22023,1628964,22300483,"JAN 05, 2024",PHI vs. NYK,L,5,1,1,1.0,0,0,0.0,0,0,0.0,0,2,2,1,2,0,0,0,2,-2,1,Mo Bamba,PHI,PHI,NYK,,,5,4,3,3
22023,1628964,22300459,"JAN 02, 2024",PHI vs. CHI,W,7,0,1,0.0,0,0,0.0,0,0,0.0,0,2,2,0,1,0,2,3,0,-12,1,Mo Bamba,PHI,PHI,CHI,,,2,2,0,2
22023,1628964,22300442,"DEC 30, 2023",PHI @ CHI,L,13,2,3,0.667,0,0,0.0,1,1,1.0,2,3,5,2,0,0,1,0,5,9,1,Mo Bamba,PHI,CHI,PHI,,,12,10,7,7
22023,1628964,22300434,"DEC 29, 2023",PHI @ HOU,W,5,0,1,0.0,0,0,0.0,2,2,1.0,2,0,2,0,0,0,0,1,2,-3,1,Mo Bamba,PHI,HOU,PHI,,,4,4,2,2
22023,1628964,22300415,"DEC 27, 2023",PHI @ ORL,W,16,0,1,0.0,0,0,0.0,0,0,0.0,2,5,7,1,1,1,1,2,0,13,1,Mo Bamba,PHI,ORL,PHI,,,8,7,1,8
22023,1628964,22300404,"DEC 25, 2023",PHI @ MIA,L,26,7,8,0.875,3,3,1.0,1,2,0.5,1,5,6,2,2,0,1,2,18,-13,1,Mo Bamba,PHI,MIA,PHI,,,26,24,20,8
22023,1628964,22300367,"DEC 20, 2023",PHI vs. MIN,W,2,0,0,0.0,0,0,0.0,0,0,0.0,0,0,0,0,0,0,0,0,0,2,1,Mo Bamba,PHI,PHI,MIN,,,0,0,0,0
22023,1628964,22300335,"DEC 16, 2023",PHI @ CHA,W,7,3,3,1.0,1,1,1.0,0,1,0.0,0,1,1,1,0,0,0,2,7,4,1,Mo Bamba,PHI,CHA,PHI,,,9,8,8,2
22023,1628964,22300327,"DEC 15, 2023",PHI vs. DET,W,9,1,2,0.5,1,1,1.0,0,0,0.0,1,3,4,0,0,1,0,2,3,-4,1,Mo Bamba,PHI,PHI,DET,,,7,7,3,4
22023,1628964,22300310,"DEC 13, 2023",PHI @ DET,W,3,1,1,1.0,0,0,0.0,0,0,0.0,0,0,0,0,0,0,0,0,2,-5,1,Mo Bamba,PHI,DET,PHI,,,2,2,2,0
22023,1628964,22300295,"DEC 11, 2023",PHI vs. WAS,W,8,2,6,0.333,0,1,0.0,2,2,1.0,3,3,6,2,0,2,0,1,6,5,1,Mo Bamba,PHI,PHI,WAS,,,14,12,8,8
22023,1628964,22301218,"DEC 08, 2023",PHI vs. ATL,W,5,0,1,0.0,0,0,0.0,0,0,0.0,1,2,3,0,0,0,1,1,0,-1,1,Mo Bamba,PHI,PHI,ATL,,,3,3,0,3
22023,1628964,22300275,"DEC 01, 2023",PHI @ BOS,L,20,4,7,0.571,2,4,0.5,1,2,0.5,5,1,6,1,0,1,2,1,11,3,1,Mo Bamba,PHI,BOS,PHI,,,18,17,12,7
22023,1628964,22300262,"NOV 29, 2023",PHI @ NOP,L,14,3,7,0.429,0,1,0.0,0,1,0.0,3,1,4,0,0,4,1,3,6,5,1,Mo Bamba,PHI,NOP,PHI,,,10,10,6,4
22023,1628964,22300255,"NOV 27, 2023",PHI vs. LAL,W,5,3,4,0.75,1,1,1.0,0,0,0.0,1,2,3,0,0,0,0,0,7,13,1,Mo Bamba,PHI,PHI,LAL,,,10,10,7,3
22023,1628964,22300232,"NOV 22, 2023",PHI @ MIN,L,6,1,2,0.5,0,1,0.0,2,2,1.0,1,1,2,0,0,0,0,0,4,8,1,Mo Bamba,PHI,MIN,PHI,,,6,6,4,2
22023,1628964,22300208,"NOV 19, 2023",PHI @ BKN,W,3,2,2,1.0,0,0,0.0,1,1,1.0,0,0,0,0,1,0,0,0,5,3,1,Mo Bamba,PHI,BKN,PHI,,,5,5,5,0
22023,1628964,22300148,"NOV 06, 2023",PHI vs. WAS,W,4,0,0,0.0,0,0,0.0,2,2,1.0,0,2,2,0,0,1,2,1,2,-6,1,Mo Bamba,PHI,PHI,WAS,,,4,4,2,2
22023,1628964,22300132,"NOV 04, 2023",PHI vs. PHX,W,2,0,2,0.0,0,0,0.0,0,0,0.0,2,0,2,0,0,0,0,1,0,-5,1,Mo Bamba,PHI,PHI,PHX,,,2,2,0,2
22023,1628964,22300128,"NOV 02, 2023",PHI vs. TOR,W,1,0,0,0.0,0,0,0.0,0,0,0.0,0,2,2,0,0,0,1,1,0,-2,1,Mo Bamba,PHI,PHI,TOR,,,2,2,0,2
22023,1628964,22300098,"OCT 29, 2023",PHI vs. POR,W,2,0,0,0.0,0,0,0.0,0,0,0.0,0,0,0,0,0,1,0,0,0,0,1,Mo Bamba,PHI,PHI,POR,,,0,0,0,0
22023,1631094,22300557,"JAN 15, 2024",ORL @ NYK,W,33,9,19,0.474,0,2,0.0,2,5,0.4,1,5,6,3,0,0,2,1,20,-12,1,Paolo Banchero,ORL,NYK,ORL,,,29,26,23,9
22023,1631094,22300546,"JAN 13, 2024",ORL @ OKC,L,36,8,19,0.421,0,4,0.0,4,7,0.571,2,7,9,8,0,2,2,4,20,-7,1,Paolo Banchero,ORL,OKC,ORL,,,37,29,28,17
22023,1631094,22300535,"JAN 12, 2024",ORL @ MIA,L,36,10,26,0.385,1,7,0.143,4,6,0.667,3,5,8,6,0,0,4,2,25,10,1,Paolo Banchero,ORL,MIA,ORL,,,39,33,31,14
22023,1631094,22300513,"JAN 09, 2024",ORL vs. MIN,L,35,8,22,0.364,1,4,0.25,1,4,0.25,0,2,2,3,3,1,4,4,18,-30,1,Paolo Banchero,ORL,ORL,MIN,,,23,20,21,5
22023,1631094,22300499,"JAN 07, 2024",ORL vs. ATL,W,45,13,29,0.448,4,7,0.571,5,7,0.714,1,9,10,4,3,1,2,2,35,18,1,Paolo Banchero,ORL,ORL,ATL,,,49,45,39,14
22023,1631094,22300488,"JAN 05, 2024",ORL @ DEN,W,41,8,21,0.381,1,4,0.25,15,19,0.789,1,9,10,11,3,0,5,2,32,2,1,Paolo Banchero,ORL,DEN,ORL,,,53,42,43,21
22023,1631094,22300476,"JAN 03, 2024",ORL @ SAC,L,45,13,25,0.52,6,9,0.667,11,14,0.786,1,3,4,5,0,0,8,4,43,-2,1,Paolo Banchero,ORL,SAC,ORL,,,52,47,48,9
22023,1631094,22300463,"JAN 02, 2024",ORL @ GSW,L,34,8,20,0.4,3,8,0.375,8,11,0.727,4,8,12,6,2,1,5,4,27,-8,1,Paolo Banchero,ORL,GSW,ORL,,,45,39,33,18
22023,1631094,22300450,"DEC 31, 2023",ORL @ PHX,L,37,12,23,0.522,2,6,0.333,2,2,1.0,0,9,9,7,0,1,3,1,28,-6,1,Paolo Banchero,ORL,PHX,ORL,,,44,37,35,16
22023,1631094,22300429,"DEC 29, 2023",ORL vs. NYK,W,36,9,19,0.474,2,6,0.333,9,12,0.75,1,9,10,4,1,1,2,3,29,4,1,Paolo Banchero,ORL,ORL,NYK,,,43,39,33,14
22023,1631094,22300415,"DEC 27, 2023",ORL vs. PHI,L,38,6,21,0.286,1,8,0.125,6,7,0.857,0,9,9,4,1,1,1,0,19,-18,1,Paolo Banchero,ORL,ORL,PHI,,,32,28,23,13
22023,1631094,22300407,"DEC 26, 2023",ORL @ WAS,W,38,10,22,0.455,0,1,0.0,4,8,0.5,1,2,3,8,1,1,3,1,24,0,1,Paolo Banchero,ORL,WAS,ORL,,,35,27,32,11
22023,1631094,22300391,"DEC 23, 2023",ORL @ IND,W,36,11,20,0.55,0,0,0.0,12,16,0.75,1,6,7,4,1,0,3,1,34,-2,1,Paolo Banchero,ORL,IND,ORL,,,45,41,38,11
22023,1631094,22300378,"DEC 21, 2023",ORL @ MIL,L,34,6,17,0.353,3,5,0.6,8,10,0.8,0,7,7,4,0,1,2,4,23,-10,1,Paolo Banchero,ORL,MIL,ORL,,,34,30,27,11
22023,1631094,22300366,"DEC 20, 2023",ORL vs. MIA,L,34,2,12,0.167,0,3,0.0,6,8,0.75,0,8,8,8,1,0,3,1,10,-22,1,Paolo Banchero,ORL,ORL,MIA,,,26,18,18,16
22023,1631094,22300344,"DEC 17, 2023",ORL @ BOS,L,36,14,30,0.467,4,10,0.4,4,6,0.667,2,8,10,1,2,0,4,0,36,-11,1,Paolo Banchero,ORL,BOS,ORL,,,47,46,37,11
22023,1631094,22300329,"DEC 15, 2023",ORL @ BOS,L,32,5,17,0.294,1,4,0.25,3,6,0.5,1,3,4,5,0,1,5,1,14,-13,1,Paolo Banchero,ORL,BOS,ORL,,,23,18,19,9
22023,1631094,22300294,"DEC 11, 2023",ORL vs. CLE,W,36,9,21,0.429,0,3,0.0,2,3,0.667,4,6,10,4,1,0,8,0,20,6,1,Paolo Banchero,ORL,ORL,CLE,,,34,30,24,14
22023,1631094,22301217,"DEC 08, 2023",ORL vs. DET,W,30,9,17,0.529,0,3,0.0,6,7,0.857,0,4,4,2,2,0,0,3,24,25,1,Paolo Banchero,ORL,ORL,DET,,,30,28,26,6
22023,1631094,22301205,"DEC 06, 2023",ORL @ CLE,L,38,16,26,0.615,1,5,0.2,9,12,0.75,1,5,6,1,0,2,3,3,42,2,1,Paolo Banchero,ORL,CLE,ORL,,,49,48,43,7
22023,1631094,22300282,"DEC 02, 2023",ORL @ BKN,L,34,6,15,0.4,0,2,0.0,7,9,0.778,1,9,10,8,1,0,1,3,19,-16,1,Paolo Banchero,ORL,BKN,ORL,,,37,29,27,18
22023,1631094,22300274,"DEC 01, 2023",ORL vs. WAS,W,38,11,20,0.55,3,4,0.75,3,3,1.0,3,10,13,7,0,0,2,2,28,1,1,Paolo Banchero,ORL,ORL,WAS,,,48,41,35,20
22023,1631094,22300259,"NOV 29, 2023",ORL vs. WAS,W,27,2,8,0.25,0,0,0.0,2,3,0.667,1,3,4,4,0,0,4,2,6,8,1,Paolo Banchero,ORL,ORL,WAS,,,14,10,10,8
22023,1631094,22300248,"NOV 26, 2023",ORL vs. CHA,W,37,9,18,0.5,2,5,0.4,3,6,0.5,0,7,7,8,2,0,2,2,23,8,1,Paolo Banchero,ORL,ORL,CHA,,,38,30,31,15
22023,1631094,22300043,"NOV 24, 2023",ORL vs. BOS,W,35,10,16,0.625,2,6,0.333,1,2,0.5,1,6,7,5,0,0,3,4,23,7,1,Paolo Banchero,ORL,ORL,BOS,,,35,30,28,12
22023,1631094,22300226,"NOV 22, 2023",ORL vs. DEN,W,35,8,14,0.571,4,5,0.8,3,5,0.6,1,2,3,4,1,3,3,1,23,-4,1,Paolo Banchero,ORL,ORL,DEN,,,30,26,27,7
22023,1631094,22300038,"NOV 21, 2023",ORL vs. TOR,W,32,10,20,0.5,2,3,0.667,3,3,1.0,1,4,5,3,0,1,3,2,25,14,1,Paolo Banchero,ORL,ORL,TOR,,,33,30,28,8
22023,1631094,22300209,"NOV 19, 2023",ORL @ IND,W,27,9,14,0.643,0,0,0.0,6,7,0.857,1,2,3,0,1,2,1,1,24,28,1,Paolo Banchero,ORL,IND,ORL,,,27,27,24,3
22023,1631094,22300033,"NOV 17, 2023",ORL @ CHI,W,32,6,14,0.429,0,1,0.0,1,4,0.25,3,5,8,4,0,1,7,3,13,0,1,Paolo Banchero,ORL,CHI,ORL,,,25,21,17,12
22023,1631094,22300196,"NOV 15, 2023",ORL @ CHI,W,33,4,12,0.333,2,4,0.5,7,10,0.7,1,8,9,3,1,0,1,0,17,-8,1,Paolo Banchero,ORL,CHI,ORL,,,29,26,20,12
22023,1631094,22300020,"NOV 14, 2023",ORL @ BKN,L,35,6,15,0.4,4,7,0.571,3,6,0.5,0,6,6,3,2,1,2,0,19,-16,1,Paolo Banchero,ORL,BKN,ORL,,,28,25,22,9
22023,1631094,22300173,"NOV 11, 2023",ORL vs. MIL,W,38,10,22,0.455,2,5,0.4,4,5,0.8,3,9,12,5,1,0,3,2,26,10,1,Paolo Banchero,ORL,ORL,MIL,,,43,38,31,17
22023,1631094,22300172,"NOV 09, 2023",ORL vs. ATL,L,34,7,14,0.5,1,3,0.333,2,4,0.5,4,4,8,4,1,0,5,4,17,-5,1,Paolo Banchero,ORL,ORL,ATL,,,29,25,21,12
22023,1631094,22300147,"NOV 06, 2023",ORL vs. DAL,L,37,8,18,0.444,0,1,0.0,6,6,1.0,1,4,5,6,0,0,6,5,22,-15,1,Paolo Banchero,ORL,ORL,DAL,,,33,27,28,11
22023,1631094,22300134,"NOV 04, 2023",ORL vs. LAL,W,34,9,15,0.6,2,4,0.5,5,7,0.714,1,6,7,10,1,1,4,2,25,23,1,Paolo Banchero,ORL,ORL,LAL,,,42,32,35,17
22023,1631094,22300130,"NOV 02, 2023",ORL @ UTA,W,36,9,13,0.692,1,2,0.5,11,15,0.733,2,7,9,5,3,2,6,4,30,-5,1,Paolo Banchero,ORL,UTA,ORL,,,44,39,35,14
22023,1631094,22300114,"OCT 31, 2023",ORL @ LAC,L,32,5,13,0.385,1,3,0.333,4,8,0.5,0,4,4,4,4,0,3,3,15,-15,1,Paolo Banchero,ORL,LAC,ORL,,,23,19,19,8
22023,1631094,22300111,"OCT 30, 2023",ORL @ LAL,L,30,4,14,0.286,1,5,0.2,0,2,0.0,1,4,5,5,0,0,2,3,9,-12,1,Paolo Banchero,ORL,LAL,ORL,,,19,14,14,10
22023,1631094,22300086,"OCT 27, 2023",ORL @ POR,W,35,5,12,0.417,0,0,0.0,4,9,0.444,2,5,7,4,2,0,3,1,14,2,1,Paolo Banchero,ORL,POR,ORL,,,25,21,18,11
22023,1631094,22300066,"OCT 25, 2023",ORL vs. HOU,W,28,3,6,0.5,0,1,0.0,6,7,0.857,0,5,5,5,1,0,1,2,12,11,1,Paolo Banchero,ORL,ORL,HOU,,,22,17,17,10
22023,1630217,22300537,"JAN 12, 2024",MEM vs. LAC,L,23,3,11,0.273,3,6,0.5,6,7,0.857,0,1,1,3,1,0,0,3,15,-6,1,Desmond Bane,MEM,MEM,LAC,,,19,16,18,4
22023,1630217,22300515,"JAN 09, 2024",MEM @ DAL,W,39,11,27,0.407,2,9,0.222,8,9,0.889,2,7,9,4,0,0,2,3,32,17,1,Desmond Bane,MEM,DAL,MEM,,,45,41,36,13
22023,1630217,22300503,"JAN 07, 2024",MEM @ PHX,W,37,8,14,0.571,2,7,0.286,5,5,1.0,2,3,5,5,1,1,3,3,23,-13,1,Desmond Bane,MEM,PHX,MEM,,,33,28,28,10
22023,1630217,22300491,"JAN 05, 2024",MEM @ LAL,W,37,8,14,0.571,5,8,0.625,3,4,0.75,0,5,5,13,1,0,3,2,24,11,1,Desmond Bane,MEM,LAL,MEM,,,42,29,37,18
22023,1630217,22300470,"JAN 03, 2024",MEM vs. TOR,L,38,9,18,0.5,2,6,0.333,2,2,1.0,2,2,4,8,0,0,0,4,22,5,1,Desmond Bane,MEM,MEM,TOR,,,34,26,30,12
22023,1630217,22300460,"JAN 02, 2024",MEM vs. SAS,W,34,11,17,0.647,2,6,0.333,0,0,0.0,0,3,3,2,0,0,3,1,24,3,1,Desmond Bane,MEM,MEM,SAS,,,29,27,26,5
22023,1630217,22300449,"DEC 31, 2023",MEM vs. SAC,L,35,6,14,0.429,3,7,0.429,2,3,0.667,0,7,7,6,0,0,2,2,17,-18,1,Desmond Bane,MEM,MEM,SAC,,,30,24,23,13
22023,1630217,22300438,"DEC 29, 2023",MEM @ LAC,L,37,7,11,0.636,2,5,0.4,2,2,1.0,0,7,7,5,2,0,2,3,18,-6,1,Desmond Bane,MEM,LAC,MEM,,,30,25,23,12
22023,1630217,22300425,"DEC 28, 2023",MEM @ DEN,L,25,9,13,0.692,3,5,0.6,2,2,1.0,0,1,1,2,1,0,2,3,23,-27,1,Desmond Bane,MEM,DEN,MEM,,,26,24,25,3
22023,1630217,22300410,"DEC 26, 2023",MEM @ NOP,W,40,9,22,0.409,5,14,0.357,4,5,0.8,1,4,5,7,0,1,1,5,27,3,1,Desmond Bane,MEM,NOP,MEM,,,39,32,34,12
22023,1630217,22300393,"DEC 23, 2023",MEM @ ATL,W,36,13,25,0.52,5,14,0.357,6,6,1.0,0,6,6,6,1,1,2,0,37,-5,1,Desmond Bane,MEM,ATL,MEM,,,49,43,43,12
22023,1630217,22300377,"DEC 21, 2023",MEM vs. IND,W,36,11,26,0.423,5,12,0.417,4,5,0.8,0,6,6,7,1,0,2,1,31,-7,1,Desmond Bane,MEM,MEM,IND,,,44,37,38,13
22023,1630217,22300360,"DEC 19, 2023",MEM @ NOP,W,35,8,19,0.421,3,9,0.333,2,2,1.0,1,0,1,4,0,0,4,1,21,5,1,Desmond Bane,MEM,NOP,MEM,,,26,22,25,5
22023,1630217,22300355,"DEC 18, 2023",MEM @ OKC,L,28,6,14,0.429,4,9,0.444,1,2,0.5,0,1,1,5,0,1,5,1,17,-18,1,Desmond Bane,MEM,OKC,MEM,,,23,18,22,6
22023,1630217,22300332,"DEC 15, 2023",MEM vs. HOU,L,40,11,25,0.44,4,12,0.333,2,3,0.667,6,7,13,3,2,0,4,4,28,1,1,Desmond Bane,MEM,MEM,HOU,,,44,41,31,16
22023,1630217,22300299,"DEC 11, 2023",MEM vs. DAL,L,39,11,20,0.55,3,9,0.333,3,3,1.0,1,2,3,8,1,0,5,4,28,1,1,Desmond Bane,MEM,MEM,DAL,,,39,31,36,11
22023,1630217,22301221,"DEC 08, 2023",MEM vs. MIN,L,37,6,13,0.462,4,6,0.667,0,0,0.0,0,2,2,1,0,1,4,5,16,-23,1,Desmond Bane,MEM,MEM,MIN,,,19,18,17,3
22023,1630217,22301206,"DEC 06, 2023",MEM @ DET,W,36,19,31,0.613,4,8,0.5,7,7,1.0,1,5,6,8,1,2,3,2,49,-1,1,Desmond Bane,MEM,DET,MEM,,,63,55,57,14
22023,1630217,22300288,"DEC 02, 2023",MEM @ PHX,L,30,10,17,0.588,3,6,0.5,4,5,0.8,1,2,3,5,2,1,2,5,27,-3,1,Desmond Bane,MEM,PHX,MEM,,,35,30,32,8
22023,1630217,22300277,"DEC 01, 2023",MEM @ DAL,W,34,11,20,0.55,4,6,0.667,4,6,0.667,2,2,4,5,1,2,4,2,30,13,1,Desmond Bane,MEM,DAL,MEM,,,39,34,35,9
22023,1630217,22300261,"NOV 29, 2023",MEM vs. UTA,W,36,7,17,0.412,3,11,0.273,0,0,0.0,1,6,7,9,3,0,3,2,17,6,1,Desmond Bane,MEM,MEM,UTA,,,33,24,26,16
22023,1630217,22300249,"NOV 26, 2023",MEM vs. MIN,L,34,5,16,0.313,3,9,0.333,0,0,0.0,1,1,2,4,0,0,5,3,13,-17,1,Desmond Bane,MEM,MEM,MIN,,,19,15,17,6
22023,1630217,22300044,"NOV 24, 2023",MEM vs. PHX,L,34,3,12,0.25,0,5,0.0,0,0,0.0,0,5,5,10,1,0,3,3,6,-10,1,Desmond Bane,MEM,MEM,PHX,,,21,11,16,15
22023,1630217,22300231,"NOV 22, 2023",MEM @ HOU,L,26,6,12,0.5,2,6,0.333,9,10,0.9,1,6,7,4,1,0,2,4,23,-15,1,Desmond Bane,MEM,HOU,MEM,,,34,30,27,11
22023,1630217,22300213,"NOV 19, 2023",MEM vs. BOS,L,37,11,27,0.407,7,14,0.5,1,1,1.0,2,0,2,8,1,0,2,2,30,1,1,Desmond Bane,MEM,MEM,BOS,,,40,32,38,10
22023,1630217,22300206,"NOV 18, 2023",MEM @ SAS,W,34,8,15,0.533,3,6,0.5,7,7,1.0,3,2,5,4,1,0,2,5,26,4,1,Desmond Bane,MEM,SAS,MEM,,,35,31,30,9
22023,1630217,22300026,"NOV 14, 2023",MEM @ LAL,L,27,5,10,0.5,2,6,0.333,3,3,1.0,0,1,1,5,0,0,2,1,15,-24,1,Desmond Bane,MEM,LAL,MEM,,,21,16,20,6
22023,1630217,22300179,"NOV 12, 2023",MEM @ LAC,W,35,10,24,0.417,3,11,0.273,4,6,0.667,1,3,4,6,0,1,4,4,27,11,1,Desmond Bane,MEM,LAC,MEM,,,37,31,33,10
22023,1630217,22300012,"NOV 10, 2023",MEM vs. UTA,L,38,14,28,0.5,7,13,0.538,2,3,0.667,0,4,4,8,1,2,3,3,37,1,1,Desmond Bane,MEM,MEM,UTA,,,49,41,45,12
22023,1630217,22300164,"NOV 08, 2023",MEM vs. MIA,L,36,4,16,0.25,2,8,0.25,5,6,0.833,0,5,5,3,1,2,1,3,15,-18,1,Desmond Bane,MEM,MEM,MIA,,,23,20,18,8
22023,1630217,22300144,"NOV 05, 2023",MEM @ POR,W,34,13,27,0.481,3,9,0.333,1,1,1.0,0,8,8,5,1,0,3,5,30,8,1,Desmond Bane,MEM,POR,MEM,,,43,38,35,13
22023,1630217,22300007,"NOV 03, 2023",MEM @ POR,L,45,13,26,0.5,3,9,0.333,4,5,0.8,1,7,8,7,4,3,3,5,33,11,1,Desmond Bane,MEM,POR,MEM,,,48,41,40,15
22023,1630217,22300125,"NOV 01, 2023",MEM @ UTA,L,27,7,19,0.368,4,12,0.333,3,3,1.0,1,2,3,0,1,0,2,1,21,-25,1,Desmond Bane,MEM,UTA,MEM,,,24,24,21,3
22023,1630217,22300106,"OCT 30, 2023",MEM vs. DAL,L,37,12,17,0.706,3,7,0.429,3,4,0.75,2,4,6,3,3,0,2,3,30,0,1,Desmond Bane,MEM,MEM,DAL,,,39,36,33,9
22023,1630217,22300089,"OCT 28, 2023",MEM @ WAS,L,34,10,20,0.5,4,10,0.4,2,2,1.0,1,1,2,5,1,1,5,4,26,-11,1,Desmond Bane,MEM,WAS,MEM,,,33,28,31,7
22023,1630217,22300078,"OCT 27, 2023",MEM vs. DEN,L,32,4,17,0.235,1,10,0.1,6,6,1.0,1,2,3,3,2,0,2,3,15,-8,1,Desmond Bane,MEM,MEM,DEN,,,21,18,18,6
22023,1630217,22300071,"OCT 25, 2023",MEM vs. NOP,L,36,11,22,0.5,5,10,0.5,4,5,0.8,0,5,5,5,2,1,2,1,31,6,1,Desmond Bane,MEM,MEM,NOP,,,41,36,36,10
22023,1630625,22300528,"JAN 11, 2024",BOS @ MIL,L,18,1,5,0.2,1,2,0.5,1,2,0.5,0,1,1,3,2,1,0,1,4,7,1,Dalano Banton,BOS,MIL,BOS,,,8,5,7,4
22023,1630625,22300507,"JAN 08, 2024",BOS @ IND,L,4,0,0,0.0,0,0,0.0,0,0,0.0,0,0,0,0,0,0,1,3,0,2,1,Dalano Banton,BOS,IND,BOS,,,0,0,0,0
22023,1630625,22300493,"JAN 06, 2024",BOS @ IND,W,1,0,0,0.0,0,0,0.0,0,0,0.0,0,0,0,0,0,0,0,0,0,0,1,Dalano Banton,BOS,IND,BOS,,,0,0,0,0
22023,1630625,22300479,"JAN 05, 2024",BOS vs. UTA,W,6,1,2,0.5,0,1,0.0,3,4,0.75,0,1,1,1,0,0,0,1,5,3,1,Dalano Banton,BOS,BOS,UTA,,,7,6,6,2
22023,1630625,22300448,"DEC 31, 2023",BOS @ SAS,W,11,0,2,0.0,0,0,0.0,4,4,1.0,1,3,4,1,0,0,2,2,4,-3,1,Dalano Banton,BOS,SAS,BOS,,,9,8,5,5
22023,1630625,22300432,"DEC 29, 2023",BOS vs. TOR,W,2,1,1,1.0,0,0,0.0,0,0,0.0,0,0,0,0,0,0,1,0,2,-4,1,Dalano Banton,BOS,BOS,TOR,,,2,2,2,0
22023,1630625,22300389,"DEC 23, 2023",BOS @ LAC,W,4,1,1,1.0,0,0,0.0,0,0,0.0,0,0,0,1,0,0,0,0,2,6,1,Dalano Banton,BOS,LAC,BOS,,,3,2,3,1
22023,1630625,22300344,"DEC 17, 2023",BOS vs. ORL,W,2,1,2,0.5,0,1,0.0,0,0,0.0,0,0,0,0,0,0,0,0,2,-4,1,Dalano Banton,BOS,BOS,ORL,,,2,2,2,0
22023,1630625,22301227,"DEC 08, 2023",BOS vs. NYK,W,0,0,0,0.0,0,0,0.0,0,0,0.0,0,0,0,0,0,0,0,0,0,-2,1,Dalano Banton,BOS,BOS,NYK,,,0,0,0,0
22023,1630625,22301202,"DEC 04, 2023",BOS @ IND,L,11,0,1,0.0,0,0,0.0,0,0,0.0,1,3,4,1,0,0,3,1,0,-2,1,Dalano Banton,BOS,IND,BOS,,,5,4,1,5
22023,1630625,22300275,"DEC 01, 2023",BOS vs. PHI,W,10,2,4,0.5,0,1,0.0,0,1,0.0,3,2,5,1,0,1,0,1,4,1,1,Dalano Banton,BOS,BOS,PHI,,,10,9,5,6
22023,1630625,22300053,"NOV 28, 2023",BOS vs. CHI,W,15,2,3,0.667,1,2,0.5,0,0,0.0,0,0,0,0,0,1,0,1,5,10,1,Dalano Banton,BOS,BOS,CHI,,,5,5,5,0
22023,1630625,22300246,"NOV 26, 2023",BOS vs. ATL,W,19,3,5,0.6,0,1,0.0,2,2,1.0,2,3,5,1,0,0,1,4,8,-4,1,Dalano Banton,BOS,BOS,ATL,,,14,13,9,6
22023,1630625,22300043,"NOV 24, 2023",BOS @ ORL,L,1,0,1,0.0,0,0,0.0,0,0,0.0,0,0,0,0,0,0,0,0,0,-2,1,Dalano Banton,BOS,ORL,BOS,,,0,0,0,0
22023,1630625,22300194,"NOV 15, 2023",BOS @ PHI,W,8,1,4,0.25,0,1,0.0,0,0,0.0,1,4,5,0,1,0,0,2,2,8,1,Dalano Banton,BOS,PHI,BOS,,,7,7,2,5
22023,1630625,22300174,"NOV 11, 2023",BOS vs. TOR,W,6,0,1,0.0,0,1,0.0,0,0,0.0,0,0,0,0,0,0,0,0,0,-2,1,Dalano Banton,BOS,BOS,TOR,,,0,0,0,0
22023,1630625,22300010,"NOV 10, 2023",BOS vs. BKN,W,4,0,1,0.0,0,0,0.0,0,0,0.0,1,0,1,0,0,0,0,0,0,-6,1,Dalano Banton,BOS,BOS,BKN,,,1,1,0,1
22023,1630625,22300118,"NOV 01, 2023",BOS vs. IND,W,8,4,4,1.0,0,0,0.0,3,3,1.0,0,3,3,1,1,0,0,2,11,3,1,Dalano Banton,BOS,BOS,IND,,,15,14,12,4
22023,1630625,22300103,"OCT 30, 2023",BOS @ WAS,W,10,1,3,0.333,0,1,0.0,0,0,0.0,2,0,2,1,0,0,1,1,2,-17,1,Dalano Banton,BOS,WAS,BOS,,,5,4,3,3
22023,1631230,22300559,"JAN 15, 2024",SAS @ ATL,L,17,1,4,0.25,0,0,0.0,2,4,0.5,0,7,7,1,1,0,0,2,4,-6,1,Dominick Barlow,SAS,ATL,SAS,,,12,11,5,8
22023,1631230,22300548,"JAN 13, 2024",SAS vs. CHI,L,22,2,5,0.4,0,0,0.0,1,2,0.5,4,2,6,3,1,1,0,1,5,5,1,Dominick Barlow,SAS,SAS,CHI,,,14,11,8,9
22023,1631230,22300541,"JAN 12, 2024",SAS vs. CHA,W,17,1,4,0.25,0,0,0.0,3,6,0.5,2,4,6,1,0,3,0,2,5,11,1,Dominick Barlow,SAS,SAS,CHA,,,12,11,6,7
22023,1631230,22300519,"JAN 10, 2024",SAS @ DET,W,24,5,8,0.625,0,0,0.0,1,1,1.0,3,5,8,4,0,2,0,3,11,10,1,Dominick Barlow,SAS,DET,SAS,,,23,19,15,12
22023,1631230,22300497,"JAN 07, 2024",SAS @ CLE,L,22,3,5,0.6,0,0,0.0,0,0,0.0,2,4,6,2,1,1,1,3,6,-17,1,Dominick Barlow,SAS,CLE,SAS,,,14,12,8,8
22023,1631230,22300477,"JAN 04, 2024",SAS vs. MIL,L,15,3,3,1.0,0,0,0.0,0,0,0.0,0,1,1,4,1,2,0,1,6,5,1,Dominick Barlow,SAS,SAS,MIL,,,11,7,10,5
22023,1631230,22300460,"JAN 02, 2024",SAS @ MEM,L,14,2,6,0.333,0,0,0.0,0,0,0.0,4,3,7,2,0,0,2,4,4,-6,1,Dominick Barlow,SAS,MEM,SAS,,,13,11,6,9
22023,1631230,22300448,"DEC 31, 2023",SAS vs. BOS,L,13,3,6,0.5,1,1,1.0,1,2,0.5,2,3,5,1,2,0,0,2,8,3,1,Dominick Barlow,SAS,SAS,BOS,,,14,13,9,6
22023,1631230,22300437,"DEC 29, 2023",SAS @ POR,L,14,1,6,0.167,0,1,0.0,0,0,0.0,1,1,2,0,1,0,0,2,2,-9,1,Dominick Barlow,SAS,POR,SAS,,,4,4,2,2
22023,1631230,22300361,"DEC 19, 2023",SAS @ MIL,L,11,0,2,0.0,0,2,0.0,2,2,1.0,0,3,3,0,0,0,0,2,2,0,1,Dominick Barlow,SAS,MIL,SAS,,,5,5,2,3
22023,1631230,22300278,"DEC 01, 2023",SAS @ NOP,L,3,1,1,1.0,0,0,0.0,0,0,0.0,0,0,0,0,0,0,0,0,2,1,1,Dominick Barlow,SAS,NOP,SAS,,,2,2,2,0
22023,1631230,22300235,"NOV 22, 2023",SAS vs. LAC,L,9,0,1,0.0,0,0,0.0,0,0,0.0,0,2,2,0,1,0,0,1,0,-4,1,Dominick Barlow,SAS,SAS,LAC,,,2,2,0,2
22023,1631230,22300206,"NOV 18, 2023",SAS vs. MEM,L,3,0,0,0.0,0,0,0.0,0,0,0.0,0,1,1,0,0,0,0,0,0,6,1,Dominick Barlow,SAS,SAS,MEM,,,1,1,0,1
22023,1631230,22300021,"NOV 14, 2023",SAS @ OKC,L,5,0,0,0.0,0,0,0.0,0,0,0.0,0,1,1,0,0,0,0,0,0,2,1,Dominick Barlow,SAS,OKC,SAS,,,1,1,0,1
22023,1631230,22300161,"NOV 08, 2023",SAS @ NYK,L,3,1,1,1.0,0,0,0.0,0,2,0.0,0,1,1,0,0,0,0,0,2,0,1,Dominick Barlow,SAS,NYK,SAS,,,3,3,2,1
22023,1631230,22300146,"NOV 06, 2023",SAS @ IND,L,8,1,4,0.25,0,0,0.0,2,2,1.0,0,0,0,0,0,0,0,1,4,-1,1,Dominick Barlow,SAS,IND,SAS,,,4,4,4,0
22023,1631230,22300099,"OCT 29, 2023",SAS @ LAC,L,5,0,0,0.0,0,0,0.0,0,0,0.0,0,0,0,0,0,0,0,0,0,-10,1,Dominick Barlow,SAS,LAC,SAS,,,0,0,0,0
22023,203084,22300552,"JAN 14, 2024",SAC @ MIL,L,32,6,9,0.667,1,4,0.25,1,1,1.0,0,1,1,1,1,0,0,0,14,-1,1,Harrison Barnes,SAC,MIL,SAC,9.5,Points,16,15,15,2
22023,203084,22300552,"JAN 14, 2024",SAC @ MIL,L,32,6,9,0.667,1,4,0.25,1,1,1.0,0,1,1,1,1,0,0,0,14,-1,1,Harrison Barnes,SAC,MIL,SAC,2.5,Rebounds,16,15,15,2
22023,203084,22300552,"JAN 14, 2024",SAC @ MIL,L,32,6,9,0.667,1,4,0.25,1,1,1.0,0,1,1,1,1,0,0,0,14,-1,1,Harrison Barnes,SAC,MIL,SAC,1.5,Free Throws Made,16,15,15,2
22023,203084,22300552,"JAN 14, 2024",SAC @ MIL,L,32,6,9,0.667,1,4,0.25,1,1,1.0,0,1,1,1,1,0,0,0,14,-1,1,Harrison Barnes,SAC,MIL,SAC,13.0,Pts+Rebs,16,15,15,2
22023,203084,22300552,"JAN 14, 2024",SAC @ MIL,L,32,6,9,0.667,1,4,0.25,1,1,1.0,0,1,1,1,1,0,0,0,14,-1,1,Harrison Barnes,SAC,MIL,SAC,10.5,Pts+Asts,16,15,15,2
22023,203084,22300552,"JAN 14, 2024",SAC @ MIL,L,32,6,9,0.667,1,4,0.25,1,1,1.0,0,1,1,1,1,0,0,0,14,-1,1,Harrison Barnes,SAC,MIL,SAC,0.5,Turnovers,16,15,15,2
22023,203084,22300532,"JAN 12, 2024",SAC @ PHI,L,21,1,5,0.2,0,4,0.0,2,2,1.0,2,0,2,0,1,0,1,1,4,-11,1,Harrison Barnes,SAC,PHI,SAC,9.5,Points,6,6,4,2
22023,203084,22300532,"JAN 12, 2024",SAC @ PHI,L,21,1,5,0.2,0,4,0.0,2,2,1.0,2,0,2,0,1,0,1,1,4,-11,1,Harrison Barnes,SAC,PHI,SAC,2.5,Rebounds,6,6,4,2
22023,203084,22300532,"JAN 12, 2024",SAC @ PHI,L,21,1,5,0.2,0,4,0.0,2,2,1.0,2,0,2,0,1,0,1,1,4,-11,1,Harrison Barnes,SAC,PHI,SAC,1.5,Free Throws Made,6,6,4,2
22023,203084,22300532,"JAN 12, 2024",SAC @ PHI,L,21,1,5,0.2,0,4,0.0,2,2,1.0,2,0,2,0,1,0,1,1,4,-11,1,Harrison Barnes,SAC,PHI,SAC,13.0,Pts+Rebs,6,6,4,2
22023,203084,22300532,"JAN 12, 2024",SAC @ PHI,L,21,1,5,0.2,0,4,0.0,2,2,1.0,2,0,2,0,1,0,1,1,4,-11,1,Harrison Barnes,SAC,PHI,SAC,10.5,Pts+Asts,6,6,4,2
22023,203084,22300532,"JAN 12, 2024",SAC @ PHI,L,21,1,5,0.2,0,4,0.0,2,2,1.0,2,0,2,0,1,0,1,1,4,-11,1,Harrison Barnes,SAC,PHI,SAC,0.5,Turnovers,6,6,4,2
22023,203084,22300518,"JAN 10, 2024",SAC @ CHA,W,22,2,4,0.5,2,4,0.5,0,0,0.0,1,1,2,1,0,0,1,0,6,-3,1,Harrison Barnes,SAC,CHA,SAC,9.5,Points,9,8,7,3
22023,203084,22300518,"JAN 10, 2024",SAC @ CHA,W,22,2,4,0.5,2,4,0.5,0,0,0.0,1,1,2,1,0,0,1,0,6,-3,1,Harrison Barnes,SAC,CHA,SAC,2.5,Rebounds,9,8,7,3
22023,203084,22300518,"JAN 10, 2024",SAC @ CHA,W,22,2,4,0.5,2,4,0.5,0,0,0.0,1,1,2,1,0,0,1,0,6,-3,1,Harrison Barnes,SAC,CHA,SAC,1.5,Free Throws Made,9,8,7,3
22023,203084,22300518,"JAN 10, 2024",SAC @ CHA,W,22,2,4,0.5,2,4,0.5,0,0,0.0,1,1,2,1,0,0,1,0,6,-3,1,Harrison Barnes,SAC,CHA,SAC,13.0,Pts+Rebs,9,8,7,3
22023,203084,22300518,"JAN 10, 2024",SAC @ CHA,W,22,2,4,0.5,2,4,0.5,0,0,0.0,1,1,2,1,0,0,1,0,6,-3,1,Harrison Barnes,SAC,CHA,SAC,10.5,Pts+Asts,9,8,7,3
22023,203084,22300518,"JAN 10, 2024",SAC @ CHA,W,22,2,4,0.5,2,4,0.5,0,0,0.0,1,1,2,1,0,0,1,0,6,-3,1,Harrison Barnes,SAC,CHA,SAC,0.5,Turnovers,9,8,7,3
22023,203084,22300512,"JAN 09, 2024",SAC @ DET,W,14,0,1,0.0,0,0,0.0,0,2,0.0,0,1,1,1,0,0,0,0,0,-9,1,Harrison Barnes,SAC,DET,SAC,9.5,Points,2,1,1,2
22023,203084,22300512,"JAN 09, 2024",SAC @ DET,W,14,0,1,0.0,0,0,0.0,0,2,0.0,0,1,1,1,0,0,0,0,0,-9,1,Harrison Barnes,SAC,DET,SAC,2.5,Rebounds,2,1,1,2
22023,203084,22300512,"JAN 09, 2024",SAC @ DET,W,14,0,1,0.0,0,0,0.0,0,2,0.0,0,1,1,1,0,0,0,0,0,-9,1,Harrison Barnes,SAC,DET,SAC,1.5,Free Throws Made,2,1,1,2
22023,203084,22300512,"JAN 09, 2024",SAC @ DET,W,14,0,1,0.0,0,0,0.0,0,2,0.0,0,1,1,1,0,0,0,0,0,-9,1,Harrison Barnes,SAC,DET,SAC,13.0,Pts+Rebs,2,1,1,2
22023,203084,22300512,"JAN 09, 2024",SAC @ DET,W,14,0,1,0.0,0,0,0.0,0,2,0.0,0,1,1,1,0,0,0,0,0,-9,1,Harrison Barnes,SAC,DET,SAC,10.5,Pts+Asts,2,1,1,2
22023,203084,22300512,"JAN 09, 2024",SAC @ DET,W,14,0,1,0.0,0,0,0.0,0,2,0.0,0,1,1,1,0,0,0,0,0,-9,1,Harrison Barnes,SAC,DET,SAC,0.5,Turnovers,2,1,1,2
22023,203084,22300500,"JAN 07, 2024",SAC vs. NOP,L,22,4,9,0.444,2,5,0.4,0,0,0.0,1,0,1,0,1,0,0,1,10,-13,1,Harrison Barnes,SAC,SAC,NOP,9.5,Points,11,11,10,1
22023,203084,22300500,"JAN 07, 2024",SAC vs. NOP,L,22,4,9,0.444,2,5,0.4,0,0,0.0,1,0,1,0,1,0,0,1,10,-13,1,Harrison Barnes,SAC,SAC,NOP,2.5,Rebounds,11,11,10,1
22023,203084,22300500,"JAN 07, 2024",SAC vs. NOP,L,22,4,9,0.444,2,5,0.4,0,0,0.0,1,0,1,0,1,0,0,1,10,-13,1,Harrison Barnes,SAC,SAC,NOP,1.5,Free Throws Made,11,11,10,1
22023,203084,22300500,"JAN 07, 2024",SAC vs. NOP,L,22,4,9,0.444,2,5,0.4,0,0,0.0,1,0,1,0,1,0,0,1,10,-13,1,Harrison Barnes,SAC,SAC,NOP,13.0,Pts+Rebs,11,11,10,1
22023,203084,22300500,"JAN 07, 2024",SAC vs. NOP,L,22,4,9,0.444,2,5,0.4,0,0,0.0,1,0,1,0,1,0,0,1,10,-13,1,Harrison Barnes,SAC,SAC,NOP,10.5,Pts+Asts,11,11,10,1
22023,203084,22300500,"JAN 07, 2024",SAC vs. NOP,L,22,4,9,0.444,2,5,0.4,0,0,0.0,1,0,1,0,1,0,0,1,10,-13,1,Harrison Barnes,SAC,SAC,NOP,0.5,Turnovers,11,11,10,1
22023,203084,22300492,"JAN 05, 2024",SAC vs. TOR,W,34,5,12,0.417,5,8,0.625,1,2,0.5,3,1,4,2,0,0,1,3,16,2,1,Harrison Barnes,SAC,SAC,TOR,9.5,Points,22,20,18,6
22023,203084,22300492,"JAN 05, 2024",SAC vs. TOR,W,34,5,12,0.417,5,8,0.625,1,2,0.5,3,1,4,2,0,0,1,3,16,2,1,Harrison Barnes,SAC,SAC,TOR,2.5,Rebounds,22,20,18,6
22023,203084,22300492,"JAN 05, 2024",SAC vs. TOR,W,34,5,12,0.417,5,8,0.625,1,2,0.5,3,1,4,2,0,0,1,3,16,2,1,Harrison Barnes,SAC,SAC,TOR,1.5,Free Throws Made,22,20,18,6
22023,203084,22300492,"JAN 05, 2024",SAC vs. TOR,W,34,5,12,0.417,5,8,0.625,1,2,0.5,3,1,4,2,0,0,1,3,16,2,1,Harrison Barnes,SAC,SAC,TOR,13.0,Pts+Rebs,22,20,18,6
22023,203084,22300492,"JAN 05, 2024",SAC vs. TOR,W,34,5,12,0.417,5,8,0.625,1,2,0.5,3,1,4,2,0,0,1,3,16,2,1,Harrison Barnes,SAC,SAC,TOR,10.5,Pts+Asts,22,20,18,6
22023,203084,22300492,"JAN 05, 2024",SAC vs. TOR,W,34,5,12,0.417,5,8,0.625,1,2,0.5,3,1,4,2,0,0,1,3,16,2,1,Harrison Barnes,SAC,SAC,TOR,0.5,Turnovers,22,20,18,6
22023,203084,22300476,"JAN 03, 2024",SAC vs. ORL,W,36,5,9,0.556,4,6,0.667,3,5,0.6,1,2,3,1,1,0,0,4,17,1,1,Harrison Barnes,SAC,SAC,ORL,9.5,Points,21,20,18,4
22023,203084,22300476,"JAN 03, 2024",SAC vs. ORL,W,36,5,9,0.556,4,6,0.667,3,5,0.6,1,2,3,1,1,0,0,4,17,1,1,Harrison Barnes,SAC,SAC,ORL,2.5,Rebounds,21,20,18,4
22023,203084,22300476,"JAN 03, 2024",SAC vs. ORL,W,36,5,9,0.556,4,6,0.667,3,5,0.6,1,2,3,1,1,0,0,4,17,1,1,Harrison Barnes,SAC,SAC,ORL,1.5,Free Throws Made,21,20,18,4
22023,203084,22300476,"JAN 03, 2024",SAC vs. ORL,W,36,5,9,0.556,4,6,0.667,3,5,0.6,1,2,3,1,1,0,0,4,17,1,1,Harrison Barnes,SAC,SAC,ORL,13.0,Pts+Rebs,21,20,18,4
22023,203084,22300476,"JAN 03, 2024",SAC vs. ORL,W,36,5,9,0.556,4,6,0.667,3,5,0.6,1,2,3,1,1,0,0,4,17,1,1,Harrison Barnes,SAC,SAC,ORL,10.5,Pts+Asts,21,20,18,4
22023,203084,22300476,"JAN 03, 2024",SAC vs. ORL,W,36,5,9,0.556,4,6,0.667,3,5,0.6,1,2,3,1,1,0,0,4,17,1,1,Harrison Barnes,SAC,SAC,ORL,0.5,Turnovers,21,20,18,4
22023,203084,22300464,"JAN 02, 2024",SAC vs. CHA,L,24,1,2,0.5,1,2,0.5,0,0,0.0,0,1,1,1,2,0,1,2,3,1,1,Harrison Barnes,SAC,SAC,CHA,9.5,Points,5,4,4,2
22023,203084,22300464,"JAN 02, 2024",SAC vs. CHA,L,24,1,2,0.5,1,2,0.5,0,0,0.0,0,1,1,1,2,0,1,2,3,1,1,Harrison Barnes,SAC,SAC,CHA,2.5,Rebounds,5,4,4,2
22023,203084,22300464,"JAN 02, 2024",SAC vs. CHA,L,24,1,2,0.5,1,2,0.5,0,0,0.0,0,1,1,1,2,0,1,2,3,1,1,Harrison Barnes,SAC,SAC,CHA,1.5,Free Throws Made,5,4,4,2
22023,203084,22300464,"JAN 02, 2024",SAC vs. CHA,L,24,1,2,0.5,1,2,0.5,0,0,0.0,0,1,1,1,2,0,1,2,3,1,1,Harrison Barnes,SAC,SAC,CHA,13.0,Pts+Rebs,5,4,4,2
22023,203084,22300464,"JAN 02, 2024",SAC vs. CHA,L,24,1,2,0.5,1,2,0.5,0,0,0.0,0,1,1,1,2,0,1,2,3,1,1,Harrison Barnes,SAC,SAC,CHA,10.5,Pts+Asts,5,4,4,2
22023,203084,22300464,"JAN 02, 2024",SAC vs. CHA,L,24,1,2,0.5,1,2,0.5,0,0,0.0,0,1,1,1,2,0,1,2,3,1,1,Harrison Barnes,SAC,SAC,CHA,0.5,Turnovers,5,4,4,2
22023,203084,22300449,"DEC 31, 2023",SAC @ MEM,W,20,4,8,0.5,2,5,0.4,1,1,1.0,0,2,2,0,0,1,1,2,11,8,1,Harrison Barnes,SAC,MEM,SAC,9.5,Points,13,13,11,2
22023,203084,22300449,"DEC 31, 2023",SAC @ MEM,W,20,4,8,0.5,2,5,0.4,1,1,1.0,0,2,2,0,0,1,1,2,11,8,1,Harrison Barnes,SAC,MEM,SAC,2.5,Rebounds,13,13,11,2
22023,203084,22300449,"DEC 31, 2023",SAC @ MEM,W,20,4,8,0.5,2,5,0.4,1,1,1.0,0,2,2,0,0,1,1,2,11,8,1,Harrison Barnes,SAC,MEM,SAC,1.5,Free Throws Made,13,13,11,2
22023,203084,22300449,"DEC 31, 2023",SAC @ MEM,W,20,4,8,0.5,2,5,0.4,1,1,1.0,0,2,2,0,0,1,1,2,11,8,1,Harrison Barnes,SAC,MEM,SAC,13.0,Pts+Rebs,13,13,11,2
22023,203084,22300449,"DEC 31, 2023",SAC @ MEM,W,20,4,8,0.5,2,5,0.4,1,1,1.0,0,2,2,0,0,1,1,2,11,8,1,Harrison Barnes,SAC,MEM,SAC,10.5,Pts+Asts,13,13,11,2
22023,203084,22300449,"DEC 31, 2023",SAC @ MEM,W,20,4,8,0.5,2,5,0.4,1,1,1.0,0,2,2,0,0,1,1,2,11,8,1,Harrison Barnes,SAC,MEM,SAC,0.5,Turnovers,13,13,11,2
22023,203084,22300431,"DEC 29, 2023",SAC @ ATL,W,12,0,2,0.0,0,2,0.0,2,2,1.0,0,0,0,0,0,0,0,1,2,-4,1,Harrison Barnes,SAC,ATL,SAC,9.5,Points,2,2,2,0
22023,203084,22300431,"DEC 29, 2023",SAC @ ATL,W,12,0,2,0.0,0,2,0.0,2,2,1.0,0,0,0,0,0,0,0,1,2,-4,1,Harrison Barnes,SAC,ATL,SAC,2.5,Rebounds,2,2,2,0
22023,203084,22300431,"DEC 29, 2023",SAC @ ATL,W,12,0,2,0.0,0,2,0.0,2,2,1.0,0,0,0,0,0,0,0,1,2,-4,1,Harrison Barnes,SAC,ATL,SAC,1.5,Free Throws Made,2,2,2,0
22023,203084,22300431,"DEC 29, 2023",SAC @ ATL,W,12,0,2,0.0,0,2,0.0,2,2,1.0,0,0,0,0,0,0,0,1,2,-4,1,Harrison Barnes,SAC,ATL,SAC,13.0,Pts+Rebs,2,2,2,0
22023,203084,22300431,"DEC 29, 2023",SAC @ ATL,W,12,0,2,0.0,0,2,0.0,2,2,1.0,0,0,0,0,0,0,0,1,2,-4,1,Harrison Barnes,SAC,ATL,SAC,10.5,Pts+Asts,2,2,2,0
22023,203084,22300431,"DEC 29, 2023",SAC @ ATL,W,12,0,2,0.0,0,2,0.0,2,2,1.0,0,0,0,0,0,0,0,1,2,-4,1,Harrison Barnes,SAC,ATL,SAC,0.5,Turnovers,2,2,2,0
22023,203084,22300413,"DEC 26, 2023",SAC @ POR,L,36,3,8,0.375,0,3,0.0,3,3,1.0,2,3,5,1,1,0,2,2,9,-9,1,Harrison Barnes,SAC,POR,SAC,9.5,Points,15,14,10,6
22023,203084,22300413,"DEC 26, 2023",SAC @ POR,L,36,3,8,0.375,0,3,0.0,3,3,1.0,2,3,5,1,1,0,2,2,9,-9,1,Harrison Barnes,SAC,POR,SAC,2.5,Rebounds,15,14,10,6
22023,203084,22300413,"DEC 26, 2023",SAC @ POR,L,36,3,8,0.375,0,3,0.0,3,3,1.0,2,3,5,1,1,0,2,2,9,-9,1,Harrison Barnes,SAC,POR,SAC,1.5,Free Throws Made,15,14,10,6
22023,203084,22300413,"DEC 26, 2023",SAC @ POR,L,36,3,8,0.375,0,3,0.0,3,3,1.0,2,3,5,1,1,0,2,2,9,-9,1,Harrison Barnes,SAC,POR,SAC,13.0,Pts+Rebs,15,14,10,6
22023,203084,22300413,"DEC 26, 2023",SAC @ POR,L,36,3,8,0.375,0,3,0.0,3,3,1.0,2,3,5,1,1,0,2,2,9,-9,1,Harrison Barnes,SAC,POR,SAC,10.5,Pts+Asts,15,14,10,6
22023,203084,22300413,"DEC 26, 2023",SAC @ POR,L,36,3,8,0.375,0,3,0.0,3,3,1.0,2,3,5,1,1,0,2,2,9,-9,1,Harrison Barnes,SAC,POR,SAC,0.5,Turnovers,15,14,10,6
22023,203084,22300400,"DEC 23, 2023",SAC vs. MIN,L,31,3,6,0.5,0,2,0.0,6,6,1.0,0,3,3,1,0,0,0,3,12,-12,1,Harrison Barnes,SAC,SAC,MIN,9.5,Points,16,15,13,4
22023,203084,22300400,"DEC 23, 2023",SAC vs. MIN,L,31,3,6,0.5,0,2,0.0,6,6,1.0,0,3,3,1,0,0,0,3,12,-12,1,Harrison Barnes,SAC,SAC,MIN,2.5,Rebounds,16,15,13,4
22023,203084,22300400,"DEC 23, 2023",SAC vs. MIN,L,31,3,6,0.5,0,2,0.0,6,6,1.0,0,3,3,1,0,0,0,3,12,-12,1,Harrison Barnes,SAC,SAC,MIN,1.5,Free Throws Made,16,15,13,4
22023,203084,22300400,"DEC 23, 2023",SAC vs. MIN,L,31,3,6,0.5,0,2,0.0,6,6,1.0,0,3,3,1,0,0,0,3,12,-12,1,Harrison Barnes,SAC,SAC,MIN,13.0,Pts+Rebs,16,15,13,4
22023,203084,22300400,"DEC 23, 2023",SAC vs. MIN,L,31,3,6,0.5,0,2,0.0,6,6,1.0,0,3,3,1,0,0,0,3,12,-12,1,Harrison Barnes,SAC,SAC,MIN,10.5,Pts+Asts,16,15,13,4
22023,203084,22300400,"DEC 23, 2023",SAC vs. MIN,L,31,3,6,0.5,0,2,0.0,6,6,1.0,0,3,3,1,0,0,0,3,12,-12,1,Harrison Barnes,SAC,SAC,MIN,0.5,Turnovers,16,15,13,4
22023,203084,22300387,"DEC 22, 2023",SAC vs. PHX,W,37,5,10,0.5,4,8,0.5,5,6,0.833,0,1,1,0,2,1,0,2,19,16,1,Harrison Barnes,SAC,SAC,PHX,9.5,Points,20,20,19,1
22023,203084,22300387,"DEC 22, 2023",SAC vs. PHX,W,37,5,10,0.5,4,8,0.5,5,6,0.833,0,1,1,0,2,1,0,2,19,16,1,Harrison Barnes,SAC,SAC,PHX,2.5,Rebounds,20,20,19,1
22023,203084,22300387,"DEC 22, 2023",SAC vs. PHX,W,37,5,10,0.5,4,8,0.5,5,6,0.833,0,1,1,0,2,1,0,2,19,16,1,Harrison Barnes,SAC,SAC,PHX,1.5,Free Throws Made,20,20,19,1
22023,203084,22300387,"DEC 22, 2023",SAC vs. PHX,W,37,5,10,0.5,4,8,0.5,5,6,0.833,0,1,1,0,2,1,0,2,19,16,1,Harrison Barnes,SAC,SAC,PHX,13.0,Pts+Rebs,20,20,19,1
22023,203084,22300387,"DEC 22, 2023",SAC vs. PHX,W,37,5,10,0.5,4,8,0.5,5,6,0.833,0,1,1,0,2,1,0,2,19,16,1,Harrison Barnes,SAC,SAC,PHX,10.5,Pts+Asts,20,20,19,1
22023,203084,22300387,"DEC 22, 2023",SAC vs. PHX,W,37,5,10,0.5,4,8,0.5,5,6,0.833,0,1,1,0,2,1,0,2,19,16,1,Harrison Barnes,SAC,SAC,PHX,0.5,Turnovers,20,20,19,1
22023,203084,22300373,"DEC 20, 2023",SAC vs. BOS,L,30,3,5,0.6,2,2,1.0,2,4,0.5,1,3,4,3,0,0,0,1,10,-21,1,Harrison Barnes,SAC,SAC,BOS,9.5,Points,17,14,13,7
22023,203084,22300373,"DEC 20, 2023",SAC vs. BOS,L,30,3,5,0.6,2,2,1.0,2,4,0.5,1,3,4,3,0,0,0,1,10,-21,1,Harrison Barnes,SAC,SAC,BOS,2.5,Rebounds,17,14,13,7
22023,203084,22300373,"DEC 20, 2023",SAC vs. BOS,L,30,3,5,0.6,2,2,1.0,2,4,0.5,1,3,4,3,0,0,0,1,10,-21,1,Harrison Barnes,SAC,SAC,BOS,1.5,Free Throws Made,17,14,13,7
22023,203084,22300373,"DEC 20, 2023",SAC vs. BOS,L,30,3,5,0.6,2,2,1.0,2,4,0.5,1,3,4,3,0,0,0,1,10,-21,1,Harrison Barnes,SAC,SAC,BOS,13.0,Pts+Rebs,17,14,13,7
22023,203084,22300373,"DEC 20, 2023",SAC vs. BOS,L,30,3,5,0.6,2,2,1.0,2,4,0.5,1,3,4,3,0,0,0,1,10,-21,1,Harrison Barnes,SAC,SAC,BOS,10.5,Pts+Asts,17,14,13,7
22023,203084,22300373,"DEC 20, 2023",SAC vs. BOS,L,30,3,5,0.6,2,2,1.0,2,4,0.5,1,3,4,3,0,0,0,1,10,-21,1,Harrison Barnes,SAC,SAC,BOS,0.5,Turnovers,17,14,13,7
22023,203084,22300358,"DEC 18, 2023",SAC vs. WAS,W,34,8,11,0.727,2,4,0.5,1,1,1.0,0,0,0,0,1,0,1,1,19,22,1,Harrison Barnes,SAC,SAC,WAS,9.5,Points,19,19,19,0
22023,203084,22300358,"DEC 18, 2023",SAC vs. WAS,W,34,8,11,0.727,2,4,0.5,1,1,1.0,0,0,0,0,1,0,1,1,19,22,1,Harrison Barnes,SAC,SAC,WAS,2.5,Rebounds,19,19,19,0
22023,203084,22300358,"DEC 18, 2023",SAC vs. WAS,W,34,8,11,0.727,2,4,0.5,1,1,1.0,0,0,0,0,1,0,1,1,19,22,1,Harrison Barnes,SAC,SAC,WAS,1.5,Free Throws Made,19,19,19,0
22023,203084,22300358,"DEC 18, 2023",SAC vs. WAS,W,34,8,11,0.727,2,4,0.5,1,1,1.0,0,0,0,0,1,0,1,1,19,22,1,Harrison Barnes,SAC,SAC,WAS,13.0,Pts+Rebs,19,19,19,0
22023,203084,22300358,"DEC 18, 2023",SAC vs. WAS,W,34,8,11,0.727,2,4,0.5,1,1,1.0,0,0,0,0,1,0,1,1,19,22,1,Harrison Barnes,SAC,SAC,WAS,10.5,Pts+Asts,19,19,19,0
22023,203084,22300358,"DEC 18, 2023",SAC vs. WAS,W,34,8,11,0.727,2,4,0.5,1,1,1.0,0,0,0,0,1,0,1,1,19,22,1,Harrison Barnes,SAC,SAC,WAS,0.5,Turnovers,19,19,19,0
22023,203084,22300342,"DEC 16, 2023",SAC vs. UTA,W,33,6,11,0.545,3,5,0.6,1,1,1.0,2,2,4,2,1,0,0,1,16,5,1,Harrison Barnes,SAC,SAC,UTA,9.5,Points,22,20,18,6
22023,203084,22300342,"DEC 16, 2023",SAC vs. UTA,W,33,6,11,0.545,3,5,0.6,1,1,1.0,2,2,4,2,1,0,0,1,16,5,1,Harrison Barnes,SAC,SAC,UTA,2.5,Rebounds,22,20,18,6
22023,203084,22300342,"DEC 16, 2023",SAC vs. UTA,W,33,6,11,0.545,3,5,0.6,1,1,1.0,2,2,4,2,1,0,0,1,16,5,1,Harrison Barnes,SAC,SAC,UTA,1.5,Free Throws Made,22,20,18,6
22023,203084,22300342,"DEC 16, 2023",SAC vs. UTA,W,33,6,11,0.545,3,5,0.6,1,1,1.0,2,2,4,2,1,0,0,1,16,5,1,Harrison Barnes,SAC,SAC,UTA,13.0,Pts+Rebs,22,20,18,6
22023,203084,22300342,"DEC 16, 2023",SAC vs. UTA,W,33,6,11,0.545,3,5,0.6,1,1,1.0,2,2,4,2,1,0,0,1,16,5,1,Harrison Barnes,SAC,SAC,UTA,10.5,Pts+Asts,22,20,18,6
22023,203084,22300342,"DEC 16, 2023",SAC vs. UTA,W,33,6,11,0.545,3,5,0.6,1,1,1.0,2,2,4,2,1,0,0,1,16,5,1,Harrison Barnes,SAC,SAC,UTA,0.5,Turnovers,22,20,18,6
22023,203084,22300324,"DEC 14, 2023",SAC vs. OKC,W,21,2,7,0.286,1,4,0.25,0,0,0.0,2,1,3,2,0,0,2,1,5,-9,1,Harrison Barnes,SAC,SAC,OKC,9.5,Points,10,8,7,5
22023,203084,22300324,"DEC 14, 2023",SAC vs. OKC,W,21,2,7,0.286,1,4,0.25,0,0,0.0,2,1,3,2,0,0,2,1,5,-9,1,Harrison Barnes,SAC,SAC,OKC,2.5,Rebounds,10,8,7,5
22023,203084,22300324,"DEC 14, 2023",SAC vs. OKC,W,21,2,7,0.286,1,4,0.25,0,0,0.0,2,1,3,2,0,0,2,1,5,-9,1,Harrison Barnes,SAC,SAC,OKC,1.5,Free Throws Made,10,8,7,5
22023,203084,22300324,"DEC 14, 2023",SAC vs. OKC,W,21,2,7,0.286,1,4,0.25,0,0,0.0,2,1,3,2,0,0,2,1,5,-9,1,Harrison Barnes,SAC,SAC,OKC,13.0,Pts+Rebs,10,8,7,5
22023,203084,22300324,"DEC 14, 2023",SAC vs. OKC,W,21,2,7,0.286,1,4,0.25,0,0,0.0,2,1,3,2,0,0,2,1,5,-9,1,Harrison Barnes,SAC,SAC,OKC,10.5,Pts+Asts,10,8,7,5
22023,203084,22300324,"DEC 14, 2023",SAC vs. OKC,W,21,2,7,0.286,1,4,0.25,0,0,0.0,2,1,3,2,0,0,2,1,5,-9,1,Harrison Barnes,SAC,SAC,OKC,0.5,Turnovers,10,8,7,5
22023,203084,22300309,"DEC 12, 2023",SAC @ LAC,L,19,1,3,0.333,0,2,0.0,0,0,0.0,0,1,1,1,0,0,0,2,2,-13,1,Harrison Barnes,SAC,LAC,SAC,9.5,Points,4,3,3,2
22023,203084,22300309,"DEC 12, 2023",SAC @ LAC,L,19,1,3,0.333,0,2,0.0,0,0,0.0,0,1,1,1,0,0,0,2,2,-13,1,Harrison Barnes,SAC,LAC,SAC,2.5,Rebounds,4,3,3,2
22023,203084,22300309,"DEC 12, 2023",SAC @ LAC,L,19,1,3,0.333,0,2,0.0,0,0,0.0,0,1,1,1,0,0,0,2,2,-13,1,Harrison Barnes,SAC,LAC,SAC,1.5,Free Throws Made,4,3,3,2
22023,203084,22300309,"DEC 12, 2023",SAC @ LAC,L,19,1,3,0.333,0,2,0.0,0,0,0.0,0,1,1,1,0,0,0,2,2,-13,1,Harrison Barnes,SAC,LAC,SAC,13.0,Pts+Rebs,4,3,3,2
22023,203084,22300309,"DEC 12, 2023",SAC @ LAC,L,19,1,3,0.333,0,2,0.0,0,0,0.0,0,1,1,1,0,0,0,2,2,-13,1,Harrison Barnes,SAC,LAC,SAC,10.5,Pts+Asts,4,3,3,2
22023,203084,22300309,"DEC 12, 2023",SAC @ LAC,L,19,1,3,0.333,0,2,0.0,0,0,0.0,0,1,1,1,0,0,0,2,2,-13,1,Harrison Barnes,SAC,LAC,SAC,0.5,Turnovers,4,3,3,2
22023,203084,22300303,"DEC 11, 2023",SAC vs. BKN,W,27,5,7,0.714,3,4,0.75,1,1,1.0,0,2,2,1,0,1,1,1,14,22,1,Harrison Barnes,SAC,SAC,BKN,9.5,Points,17,16,15,3
22023,203084,22300303,"DEC 11, 2023",SAC vs. BKN,W,27,5,7,0.714,3,4,0.75,1,1,1.0,0,2,2,1,0,1,1,1,14,22,1,Harrison Barnes,SAC,SAC,BKN,2.5,Rebounds,17,16,15,3
22023,203084,22300303,"DEC 11, 2023",SAC vs. BKN,W,27,5,7,0.714,3,4,0.75,1,1,1.0,0,2,2,1,0,1,1,1,14,22,1,Harrison Barnes,SAC,SAC,BKN,1.5,Free Throws Made,17,16,15,3
22023,203084,22300303,"DEC 11, 2023",SAC vs. BKN,W,27,5,7,0.714,3,4,0.75,1,1,1.0,0,2,2,1,0,1,1,1,14,22,1,Harrison Barnes,SAC,SAC,BKN,13.0,Pts+Rebs,17,16,15,3
22023,203084,22300303,"DEC 11, 2023",SAC vs. BKN,W,27,5,7,0.714,3,4,0.75,1,1,1.0,0,2,2,1,0,1,1,1,14,22,1,Harrison Barnes,SAC,SAC,BKN,10.5,Pts+Asts,17,16,15,3
22023,203084,22300303,"DEC 11, 2023",SAC vs. BKN,W,27,5,7,0.714,3,4,0.75,1,1,1.0,0,2,2,1,0,1,1,1,14,22,1,Harrison Barnes,SAC,SAC,BKN,0.5,Turnovers,17,16,15,3
22023,203084,22301228,"DEC 08, 2023",SAC @ PHX,W,32,3,11,0.273,1,4,0.25,2,3,0.667,4,4,8,2,1,0,0,0,9,8,1,Harrison Barnes,SAC,PHX,SAC,9.5,Points,19,17,11,10
22023,203084,22301228,"DEC 08, 2023",SAC @ PHX,W,32,3,11,0.273,1,4,0.25,2,3,0.667,4,4,8,2,1,0,0,0,9,8,1,Harrison Barnes,SAC,PHX,SAC,2.5,Rebounds,19,17,11,10
22023,203084,22301228,"DEC 08, 2023",SAC @ PHX,W,32,3,11,0.273,1,4,0.25,2,3,0.667,4,4,8,2,1,0,0,0,9,8,1,Harrison Barnes,SAC,PHX,SAC,1.5,Free Throws Made,19,17,11,10
22023,203084,22301228,"DEC 08, 2023",SAC @ PHX,W,32,3,11,0.273,1,4,0.25,2,3,0.667,4,4,8,2,1,0,0,0,9,8,1,Harrison Barnes,SAC,PHX,SAC,13.0,Pts+Rebs,19,17,11,10
22023,203084,22301228,"DEC 08, 2023",SAC @ PHX,W,32,3,11,0.273,1,4,0.25,2,3,0.667,4,4,8,2,1,0,0,0,9,8,1,Harrison Barnes,SAC,PHX,SAC,10.5,Pts+Asts,19,17,11,10
22023,203084,22301228,"DEC 08, 2023",SAC @ PHX,W,32,3,11,0.273,1,4,0.25,2,3,0.667,4,4,8,2,1,0,0,0,9,8,1,Harrison Barnes,SAC,PHX,SAC,0.5,Turnovers,19,17,11,10
22023,203084,22301204,"DEC 04, 2023",SAC vs. NOP,L,34,1,3,0.333,1,3,0.333,1,2,0.5,1,3,4,1,1,1,2,0,4,-11,1,Harrison Barnes,SAC,SAC,NOP,9.5,Points,9,8,5,5
22023,203084,22301204,"DEC 04, 2023",SAC vs. NOP,L,34,1,3,0.333,1,3,0.333,1,2,0.5,1,3,4,1,1,1,2,0,4,-11,1,Harrison Barnes,SAC,SAC,NOP,2.5,Rebounds,9,8,5,5
22023,203084,22301204,"DEC 04, 2023",SAC vs. NOP,L,34,1,3,0.333,1,3,0.333,1,2,0.5,1,3,4,1,1,1,2,0,4,-11,1,Harrison Barnes,SAC,SAC,NOP,1.5,Free Throws Made,9,8,5,5
22023,203084,22301204,"DEC 04, 2023",SAC vs. NOP,L,34,1,3,0.333,1,3,0.333,1,2,0.5,1,3,4,1,1,1,2,0,4,-11,1,Harrison Barnes,SAC,SAC,NOP,13.0,Pts+Rebs,9,8,5,5
22023,203084,22301204,"DEC 04, 2023",SAC vs. NOP,L,34,1,3,0.333,1,3,0.333,1,2,0.5,1,3,4,1,1,1,2,0,4,-11,1,Harrison Barnes,SAC,SAC,NOP,10.5,Pts+Asts,9,8,5,5
22023,203084,22301204,"DEC 04, 2023",SAC vs. NOP,L,34,1,3,0.333,1,3,0.333,1,2,0.5,1,3,4,1,1,1,2,0,4,-11,1,Harrison Barnes,SAC,SAC,NOP,0.5,Turnovers,9,8,5,5
22023,203084,22300290,"DEC 02, 2023",SAC vs. DEN,W,33,5,9,0.556,1,2,0.5,0,0,0.0,2,1,3,0,0,0,0,1,11,11,1,Harrison Barnes,SAC,SAC,DEN,9.5,Points,14,14,11,3
22023,203084,22300290,"DEC 02, 2023",SAC vs. DEN,W,33,5,9,0.556,1,2,0.5,0,0,0.0,2,1,3,0,0,0,0,1,11,11,1,Harrison Barnes,SAC,SAC,DEN,2.5,Rebounds,14,14,11,3
22023,203084,22300290,"DEC 02, 2023",SAC vs. DEN,W,33,5,9,0.556,1,2,0.5,0,0,0.0,2,1,3,0,0,0,0,1,11,11,1,Harrison Barnes,SAC,SAC,DEN,1.5,Free Throws Made,14,14,11,3
22023,203084,22300290,"DEC 02, 2023",SAC vs. DEN,W,33,5,9,0.556,1,2,0.5,0,0,0.0,2,1,3,0,0,0,0,1,11,11,1,Harrison Barnes,SAC,SAC,DEN,13.0,Pts+Rebs,14,14,11,3
22023,203084,22300290,"DEC 02, 2023",SAC vs. DEN,W,33,5,9,0.556,1,2,0.5,0,0,0.0,2,1,3,0,0,0,0,1,11,11,1,Harrison Barnes,SAC,SAC,DEN,10.5,Pts+Asts,14,14,11,3
22023,203084,22300290,"DEC 02, 2023",SAC vs. DEN,W,33,5,9,0.556,1,2,0.5,0,0,0.0,2,1,3,0,0,0,0,1,11,11,1,Harrison Barnes,SAC,SAC,DEN,0.5,Turnovers,14,14,11,3
22023,203084,22300264,"NOV 29, 2023",SAC vs. LAC,L,34,3,7,0.429,1,3,0.333,2,2,1.0,1,4,5,4,1,0,0,3,9,-9,1,Harrison Barnes,SAC,SAC,LAC,9.5,Points,18,14,13,9
22023,203084,22300264,"NOV 29, 2023",SAC vs. LAC,L,34,3,7,0.429,1,3,0.333,2,2,1.0,1,4,5,4,1,0,0,3,9,-9,1,Harrison Barnes,SAC,SAC,LAC,2.5,Rebounds,18,14,13,9
22023,203084,22300264,"NOV 29, 2023",SAC vs. LAC,L,34,3,7,0.429,1,3,0.333,2,2,1.0,1,4,5,4,1,0,0,3,9,-9,1,Harrison Barnes,SAC,SAC,LAC,1.5,Free Throws Made,18,14,13,9
22023,203084,22300264,"NOV 29, 2023",SAC vs. LAC,L,34,3,7,0.429,1,3,0.333,2,2,1.0,1,4,5,4,1,0,0,3,9,-9,1,Harrison Barnes,SAC,SAC,LAC,13.0,Pts+Rebs,18,14,13,9
22023,203084,22300264,"NOV 29, 2023",SAC vs. LAC,L,34,3,7,0.429,1,3,0.333,2,2,1.0,1,4,5,4,1,0,0,3,9,-9,1,Harrison Barnes,SAC,SAC,LAC,10.5,Pts+Asts,18,14,13,9
22023,203084,22300264,"NOV 29, 2023",SAC vs. LAC,L,34,3,7,0.429,1,3,0.333,2,2,1.0,1,4,5,4,1,0,0,3,9,-9,1,Harrison Barnes,SAC,SAC,LAC,0.5,Turnovers,18,14,13,9
22023,203084,22300060,"NOV 28, 2023",SAC vs. GSW,W,26,5,8,0.625,2,5,0.4,0,0,0.0,0,4,4,1,1,1,1,1,12,-10,1,Harrison Barnes,SAC,SAC,GSW,9.5,Points,17,16,13,5
22023,203084,22300060,"NOV 28, 2023",SAC vs. GSW,W,26,5,8,0.625,2,5,0.4,0,0,0.0,0,4,4,1,1,1,1,1,12,-10,1,Harrison Barnes,SAC,SAC,GSW,2.5,Rebounds,17,16,13,5
22023,203084,22300060,"NOV 28, 2023",SAC vs. GSW,W,26,5,8,0.625,2,5,0.4,0,0,0.0,0,4,4,1,1,1,1,1,12,-10,1,Harrison Barnes,SAC,SAC,GSW,1.5,Free Throws Made,17,16,13,5
22023,203084,22300060,"NOV 28, 2023",SAC vs. GSW,W,26,5,8,0.625,2,5,0.4,0,0,0.0,0,4,4,1,1,1,1,1,12,-10,1,Harrison Barnes,SAC,SAC,GSW,13.0,Pts+Rebs,17,16,13,5
22023,203084,22300060,"NOV 28, 2023",SAC vs. GSW,W,26,5,8,0.625,2,5,0.4,0,0,0.0,0,4,4,1,1,1,1,1,12,-10,1,Harrison Barnes,SAC,SAC,GSW,10.5,Pts+Asts,17,16,13,5
22023,203084,22300060,"NOV 28, 2023",SAC vs. GSW,W,26,5,8,0.625,2,5,0.4,0,0,0.0,0,4,4,1,1,1,1,1,12,-10,1,Harrison Barnes,SAC,SAC,GSW,0.5,Turnovers,17,16,13,5
22023,203084,22300050,"NOV 24, 2023",SAC @ MIN,W,33,7,11,0.636,2,4,0.5,2,2,1.0,0,4,4,2,1,0,2,0,18,5,1,Harrison Barnes,SAC,MIN,SAC,9.5,Points,24,22,20,6
22023,203084,22300050,"NOV 24, 2023",SAC @ MIN,W,33,7,11,0.636,2,4,0.5,2,2,1.0,0,4,4,2,1,0,2,0,18,5,1,Harrison Barnes,SAC,MIN,SAC,2.5,Rebounds,24,22,20,6
22023,203084,22300050,"NOV 24, 2023",SAC @ MIN,W,33,7,11,0.636,2,4,0.5,2,2,1.0,0,4,4,2,1,0,2,0,18,5,1,Harrison Barnes,SAC,MIN,SAC,1.5,Free Throws Made,24,22,20,6
22023,203084,22300050,"NOV 24, 2023",SAC @ MIN,W,33,7,11,0.636,2,4,0.5,2,2,1.0,0,4,4,2,1,0,2,0,18,5,1,Harrison Barnes,SAC,MIN,SAC,13.0,Pts+Rebs,24,22,20,6
22023,203084,22300050,"NOV 24, 2023",SAC @ MIN,W,33,7,11,0.636,2,4,0.5,2,2,1.0,0,4,4,2,1,0,2,0,18,5,1,Harrison Barnes,SAC,MIN,SAC,10.5,Pts+Asts,24,22,20,6
22023,203084,22300050,"NOV 24, 2023",SAC @ MIN,W,33,7,11,0.636,2,4,0.5,2,2,1.0,0,4,4,2,1,0,2,0,18,5,1,Harrison Barnes,SAC,MIN,SAC,0.5,Turnovers,24,22,20,6
22023,203084,22300233,"NOV 22, 2023",SAC @ NOP,L,41,6,13,0.462,4,9,0.444,6,6,1.0,2,1,3,0,0,0,0,2,22,-6,1,Harrison Barnes,SAC,NOP,SAC,9.5,Points,25,25,22,3
22023,203084,22300233,"NOV 22, 2023",SAC @ NOP,L,41,6,13,0.462,4,9,0.444,6,6,1.0,2,1,3,0,0,0,0,2,22,-6,1,Harrison Barnes,SAC,NOP,SAC,2.5,Rebounds,25,25,22,3
22023,203084,22300233,"NOV 22, 2023",SAC @ NOP,L,41,6,13,0.462,4,9,0.444,6,6,1.0,2,1,3,0,0,0,0,2,22,-6,1,Harrison Barnes,SAC,NOP,SAC,1.5,Free Throws Made,25,25,22,3
22023,203084,22300233,"NOV 22, 2023",SAC @ NOP,L,41,6,13,0.462,4,9,0.444,6,6,1.0,2,1,3,0,0,0,0,2,22,-6,1,Harrison Barnes,SAC,NOP,SAC,13.0,Pts+Rebs,25,25,22,3
22023,203084,22300233,"NOV 22, 2023",SAC @ NOP,L,41,6,13,0.462,4,9,0.444,6,6,1.0,2,1,3,0,0,0,0,2,22,-6,1,Harrison Barnes,SAC,NOP,SAC,10.5,Pts+Asts,25,25,22,3
22023,203084,22300233,"NOV 22, 2023",SAC @ NOP,L,41,6,13,0.462,4,9,0.444,6,6,1.0,2,1,3,0,0,0,0,2,22,-6,1,Harrison Barnes,SAC,NOP,SAC,0.5,Turnovers,25,25,22,3
22023,203084,22300222,"NOV 20, 2023",SAC @ NOP,L,30,4,9,0.444,3,6,0.5,5,6,0.833,0,4,4,0,1,0,0,0,16,-23,1,Harrison Barnes,SAC,NOP,SAC,9.5,Points,20,20,16,4
22023,203084,22300222,"NOV 20, 2023",SAC @ NOP,L,30,4,9,0.444,3,6,0.5,5,6,0.833,0,4,4,0,1,0,0,0,16,-23,1,Harrison Barnes,SAC,NOP,SAC,2.5,Rebounds,20,20,16,4
22023,203084,22300222,"NOV 20, 2023",SAC @ NOP,L,30,4,9,0.444,3,6,0.5,5,6,0.833,0,4,4,0,1,0,0,0,16,-23,1,Harrison Barnes,SAC,NOP,SAC,1.5,Free Throws Made,20,20,16,4
22023,203084,22300222,"NOV 20, 2023",SAC @ NOP,L,30,4,9,0.444,3,6,0.5,5,6,0.833,0,4,4,0,1,0,0,0,16,-23,1,Harrison Barnes,SAC,NOP,SAC,13.0,Pts+Rebs,20,20,16,4
22023,203084,22300222,"NOV 20, 2023",SAC @ NOP,L,30,4,9,0.444,3,6,0.5,5,6,0.833,0,4,4,0,1,0,0,0,16,-23,1,Harrison Barnes,SAC,NOP,SAC,10.5,Pts+Asts,20,20,16,4
22023,203084,22300222,"NOV 20, 2023",SAC @ NOP,L,30,4,9,0.444,3,6,0.5,5,6,0.833,0,4,4,0,1,0,0,0,16,-23,1,Harrison Barnes,SAC,NOP,SAC,0.5,Turnovers,20,20,16,4
22023,203084,22300212,"NOV 19, 2023",SAC @ DAL,W,34,4,11,0.364,1,7,0.143,3,3,1.0,2,2,4,6,1,0,3,1,12,17,1,Harrison Barnes,SAC,DAL,SAC,9.5,Points,22,16,18,10
22023,203084,22300212,"NOV 19, 2023",SAC @ DAL,W,34,4,11,0.364,1,7,0.143,3,3,1.0,2,2,4,6,1,0,3,1,12,17,1,Harrison Barnes,SAC,DAL,SAC,2.5,Rebounds,22,16,18,10
22023,203084,22300212,"NOV 19, 2023",SAC @ DAL,W,34,4,11,0.364,1,7,0.143,3,3,1.0,2,2,4,6,1,0,3,1,12,17,1,Harrison Barnes,SAC,DAL,SAC,1.5,Free Throws Made,22,16,18,10
22023,203084,22300212,"NOV 19, 2023",SAC @ DAL,W,34,4,11,0.364,1,7,0.143,3,3,1.0,2,2,4,6,1,0,3,1,12,17,1,Harrison Barnes,SAC,DAL,SAC,13.0,Pts+Rebs,22,16,18,10
22023,203084,22300212,"NOV 19, 2023",SAC @ DAL,W,34,4,11,0.364,1,7,0.143,3,3,1.0,2,2,4,6,1,0,3,1,12,17,1,Harrison Barnes,SAC,DAL,SAC,10.5,Pts+Asts,22,16,18,10
22023,203084,22300212,"NOV 19, 2023",SAC @ DAL,W,34,4,11,0.364,1,7,0.143,3,3,1.0,2,2,4,6,1,0,3,1,12,17,1,Harrison Barnes,SAC,DAL,SAC,0.5,Turnovers,22,16,18,10
22023,203084,22300032,"NOV 17, 2023",SAC @ SAS,W,26,2,7,0.286,1,6,0.167,2,3,0.667,0,2,2,1,1,0,1,2,7,5,1,Harrison Barnes,SAC,SAS,SAC,9.5,Points,10,9,8,3
22023,203084,22300032,"NOV 17, 2023",SAC @ SAS,W,26,2,7,0.286,1,6,0.167,2,3,0.667,0,2,2,1,1,0,1,2,7,5,1,Harrison Barnes,SAC,SAS,SAC,2.5,Rebounds,10,9,8,3
22023,203084,22300032,"NOV 17, 2023",SAC @ SAS,W,26,2,7,0.286,1,6,0.167,2,3,0.667,0,2,2,1,1,0,1,2,7,5,1,Harrison Barnes,SAC,SAS,SAC,1.5,Free Throws Made,10,9,8,3
22023,203084,22300032,"NOV 17, 2023",SAC @ SAS,W,26,2,7,0.286,1,6,0.167,2,3,0.667,0,2,2,1,1,0,1,2,7,5,1,Harrison Barnes,SAC,SAS,SAC,13.0,Pts+Rebs,10,9,8,3
22023,203084,22300032,"NOV 17, 2023",SAC @ SAS,W,26,2,7,0.286,1,6,0.167,2,3,0.667,0,2,2,1,1,0,1,2,7,5,1,Harrison Barnes,SAC,SAS,SAC,10.5,Pts+Asts,10,9,8,3
22023,203084,22300032,"NOV 17, 2023",SAC @ SAS,W,26,2,7,0.286,1,6,0.167,2,3,0.667,0,2,2,1,1,0,1,2,7,5,1,Harrison Barnes,SAC,SAS,SAC,0.5,Turnovers,10,9,8,3
22023,203084,22300198,"NOV 15, 2023",SAC @ LAL,W,39,5,10,0.5,3,6,0.5,0,0,0.0,0,1,1,2,4,0,2,3,13,16,1,Harrison Barnes,SAC,LAL,SAC,9.5,Points,16,14,15,3
22023,203084,22300198,"NOV 15, 2023",SAC @ LAL,W,39,5,10,0.5,3,6,0.5,0,0,0.0,0,1,1,2,4,0,2,3,13,16,1,Harrison Barnes,SAC,LAL,SAC,2.5,Rebounds,16,14,15,3
22023,203084,22300198,"NOV 15, 2023",SAC @ LAL,W,39,5,10,0.5,3,6,0.5,0,0,0.0,0,1,1,2,4,0,2,3,13,16,1,Harrison Barnes,SAC,LAL,SAC,1.5,Free Throws Made,16,14,15,3
22023,203084,22300198,"NOV 15, 2023",SAC @ LAL,W,39,5,10,0.5,3,6,0.5,0,0,0.0,0,1,1,2,4,0,2,3,13,16,1,Harrison Barnes,SAC,LAL,SAC,13.0,Pts+Rebs,16,14,15,3
22023,203084,22300198,"NOV 15, 2023",SAC @ LAL,W,39,5,10,0.5,3,6,0.5,0,0,0.0,0,1,1,2,4,0,2,3,13,16,1,Harrison Barnes,SAC,LAL,SAC,10.5,Pts+Asts,16,14,15,3
22023,203084,22300198,"NOV 15, 2023",SAC @ LAL,W,39,5,10,0.5,3,6,0.5,0,0,0.0,0,1,1,2,4,0,2,3,13,16,1,Harrison Barnes,SAC,LAL,SAC,0.5,Turnovers,16,14,15,3
22023,203084,22300191,"NOV 13, 2023",SAC vs. CLE,W,22,2,4,0.5,0,2,0.0,0,0,0.0,2,3,5,3,0,0,1,0,4,8,1,Harrison Barnes,SAC,SAC,CLE,9.5,Points,12,9,7,8
22023,203084,22300191,"NOV 13, 2023",SAC vs. CLE,W,22,2,4,0.5,0,2,0.0,0,0,0.0,2,3,5,3,0,0,1,0,4,8,1,Harrison Barnes,SAC,SAC,CLE,2.5,Rebounds,12,9,7,8
22023,203084,22300191,"NOV 13, 2023",SAC vs. CLE,W,22,2,4,0.5,0,2,0.0,0,0,0.0,2,3,5,3,0,0,1,0,4,8,1,Harrison Barnes,SAC,SAC,CLE,1.5,Free Throws Made,12,9,7,8
22023,203084,22300191,"NOV 13, 2023",SAC vs. CLE,W,22,2,4,0.5,0,2,0.0,0,0,0.0,2,3,5,3,0,0,1,0,4,8,1,Harrison Barnes,SAC,SAC,CLE,13.0,Pts+Rebs,12,9,7,8
22023,203084,22300191,"NOV 13, 2023",SAC vs. CLE,W,22,2,4,0.5,0,2,0.0,0,0,0.0,2,3,5,3,0,0,1,0,4,8,1,Harrison Barnes,SAC,SAC,CLE,10.5,Pts+Asts,12,9,7,8
22023,203084,22300191,"NOV 13, 2023",SAC vs. CLE,W,22,2,4,0.5,0,2,0.0,0,0,0.0,2,3,5,3,0,0,1,0,4,8,1,Harrison Barnes,SAC,SAC,CLE,0.5,Turnovers,12,9,7,8
22023,203084,22300016,"NOV 10, 2023",SAC vs. OKC,W,26,1,8,0.125,0,4,0.0,2,2,1.0,2,2,4,1,0,0,1,1,4,7,1,Harrison Barnes,SAC,SAC,OKC,9.5,Points,9,8,5,5
22023,203084,22300016,"NOV 10, 2023",SAC vs. OKC,W,26,1,8,0.125,0,4,0.0,2,2,1.0,2,2,4,1,0,0,1,1,4,7,1,Harrison Barnes,SAC,SAC,OKC,2.5,Rebounds,9,8,5,5
22023,203084,22300016,"NOV 10, 2023",SAC vs. OKC,W,26,1,8,0.125,0,4,0.0,2,2,1.0,2,2,4,1,0,0,1,1,4,7,1,Harrison Barnes,SAC,SAC,OKC,1.5,Free Throws Made,9,8,5,5
22023,203084,22300016,"NOV 10, 2023",SAC vs. OKC,W,26,1,8,0.125,0,4,0.0,2,2,1.0,2,2,4,1,0,0,1,1,4,7,1,Harrison Barnes,SAC,SAC,OKC,13.0,Pts+Rebs,9,8,5,5
22023,203084,22300016,"NOV 10, 2023",SAC vs. OKC,W,26,1,8,0.125,0,4,0.0,2,2,1.0,2,2,4,1,0,0,1,1,4,7,1,Harrison Barnes,SAC,SAC,OKC,10.5,Pts+Asts,9,8,5,5
22023,203084,22300016,"NOV 10, 2023",SAC vs. OKC,W,26,1,8,0.125,0,4,0.0,2,2,1.0,2,2,4,1,0,0,1,1,4,7,1,Harrison Barnes,SAC,SAC,OKC,0.5,Turnovers,9,8,5,5
22023,203084,22300170,"NOV 08, 2023",SAC vs. POR,W,36,5,8,0.625,2,5,0.4,0,0,0.0,1,4,5,0,1,0,1,3,12,-1,1,Harrison Barnes,SAC,SAC,POR,9.5,Points,17,17,12,5
22023,203084,22300170,"NOV 08, 2023",SAC vs. POR,W,36,5,8,0.625,2,5,0.4,0,0,0.0,1,4,5,0,1,0,1,3,12,-1,1,Harrison Barnes,SAC,SAC,POR,2.5,Rebounds,17,17,12,5
22023,203084,22300170,"NOV 08, 2023",SAC vs. POR,W,36,5,8,0.625,2,5,0.4,0,0,0.0,1,4,5,0,1,0,1,3,12,-1,1,Harrison Barnes,SAC,SAC,POR,1.5,Free Throws Made,17,17,12,5
22023,203084,22300170,"NOV 08, 2023",SAC vs. POR,W,36,5,8,0.625,2,5,0.4,0,0,0.0,1,4,5,0,1,0,1,3,12,-1,1,Harrison Barnes,SAC,SAC,POR,13.0,Pts+Rebs,17,17,12,5
22023,203084,22300170,"NOV 08, 2023",SAC vs. POR,W,36,5,8,0.625,2,5,0.4,0,0,0.0,1,4,5,0,1,0,1,3,12,-1,1,Harrison Barnes,SAC,SAC,POR,10.5,Pts+Asts,17,17,12,5
22023,203084,22300170,"NOV 08, 2023",SAC vs. POR,W,36,5,8,0.625,2,5,0.4,0,0,0.0,1,4,5,0,1,0,1,3,12,-1,1,Harrison Barnes,SAC,SAC,POR,0.5,Turnovers,17,17,12,5
22023,203084,22300153,"NOV 06, 2023",SAC @ HOU,L,22,1,6,0.167,0,4,0.0,1,2,0.5,0,0,0,1,0,0,0,0,3,-21,1,Harrison Barnes,SAC,HOU,SAC,9.5,Points,4,3,4,1
22023,203084,22300153,"NOV 06, 2023",SAC @ HOU,L,22,1,6,0.167,0,4,0.0,1,2,0.5,0,0,0,1,0,0,0,0,3,-21,1,Harrison Barnes,SAC,HOU,SAC,2.5,Rebounds,4,3,4,1
22023,203084,22300153,"NOV 06, 2023",SAC @ HOU,L,22,1,6,0.167,0,4,0.0,1,2,0.5,0,0,0,1,0,0,0,0,3,-21,1,Harrison Barnes,SAC,HOU,SAC,1.5,Free Throws Made,4,3,4,1
22023,203084,22300153,"NOV 06, 2023",SAC @ HOU,L,22,1,6,0.167,0,4,0.0,1,2,0.5,0,0,0,1,0,0,0,0,3,-21,1,Harrison Barnes,SAC,HOU,SAC,13.0,Pts+Rebs,4,3,4,1
22023,203084,22300153,"NOV 06, 2023",SAC @ HOU,L,22,1,6,0.167,0,4,0.0,1,2,0.5,0,0,0,1,0,0,0,0,3,-21,1,Harrison Barnes,SAC,HOU,SAC,10.5,Pts+Asts,4,3,4,1
22023,203084,22300153,"NOV 06, 2023",SAC @ HOU,L,22,1,6,0.167,0,4,0.0,1,2,0.5,0,0,0,1,0,0,0,0,3,-21,1,Harrison Barnes,SAC,HOU,SAC,0.5,Turnovers,4,3,4,1
22023,203084,22300137,"NOV 04, 2023",SAC @ HOU,L,32,3,7,0.429,3,4,0.75,4,5,0.8,0,3,3,0,0,0,0,0,13,-19,1,Harrison Barnes,SAC,HOU,SAC,9.5,Points,16,16,13,3
22023,203084,22300137,"NOV 04, 2023",SAC @ HOU,L,32,3,7,0.429,3,4,0.75,4,5,0.8,0,3,3,0,0,0,0,0,13,-19,1,Harrison Barnes,SAC,HOU,SAC,2.5,Rebounds,16,16,13,3
22023,203084,22300137,"NOV 04, 2023",SAC @ HOU,L,32,3,7,0.429,3,4,0.75,4,5,0.8,0,3,3,0,0,0,0,0,13,-19,1,Harrison Barnes,SAC,HOU,SAC,1.5,Free Throws Made,16,16,13,3
22023,203084,22300137,"NOV 04, 2023",SAC @ HOU,L,32,3,7,0.429,3,4,0.75,4,5,0.8,0,3,3,0,0,0,0,0,13,-19,1,Harrison Barnes,SAC,HOU,SAC,13.0,Pts+Rebs,16,16,13,3
22023,203084,22300137,"NOV 04, 2023",SAC @ HOU,L,32,3,7,0.429,3,4,0.75,4,5,0.8,0,3,3,0,0,0,0,0,13,-19,1,Harrison Barnes,SAC,HOU,SAC,10.5,Pts+Asts,16,16,13,3
22023,203084,22300137,"NOV 04, 2023",SAC @ HOU,L,32,3,7,0.429,3,4,0.75,4,5,0.8,0,3,3,0,0,0,0,0,13,-19,1,Harrison Barnes,SAC,HOU,SAC,0.5,Turnovers,16,16,13,3
22023,203084,22300126,"NOV 01, 2023",SAC @ GSW,L,31,4,8,0.5,4,7,0.571,2,2,1.0,1,0,1,1,1,0,1,0,14,2,1,Harrison Barnes,SAC,GSW,SAC,9.5,Points,16,15,15,2
22023,203084,22300126,"NOV 01, 2023",SAC @ GSW,L,31,4,8,0.5,4,7,0.571,2,2,1.0,1,0,1,1,1,0,1,0,14,2,1,Harrison Barnes,SAC,GSW,SAC,2.5,Rebounds,16,15,15,2
22023,203084,22300126,"NOV 01, 2023",SAC @ GSW,L,31,4,8,0.5,4,7,0.571,2,2,1.0,1,0,1,1,1,0,1,0,14,2,1,Harrison Barnes,SAC,GSW,SAC,1.5,Free Throws Made,16,15,15,2
22023,203084,22300126,"NOV 01, 2023",SAC @ GSW,L,31,4,8,0.5,4,7,0.571,2,2,1.0,1,0,1,1,1,0,1,0,14,2,1,Harrison Barnes,SAC,GSW,SAC,13.0,Pts+Rebs,16,15,15,2
22023,203084,22300126,"NOV 01, 2023",SAC @ GSW,L,31,4,8,0.5,4,7,0.571,2,2,1.0,1,0,1,1,1,0,1,0,14,2,1,Harrison Barnes,SAC,GSW,SAC,10.5,Pts+Asts,16,15,15,2
22023,203084,22300126,"NOV 01, 2023",SAC @ GSW,L,31,4,8,0.5,4,7,0.571,2,2,1.0,1,0,1,1,1,0,1,0,14,2,1,Harrison Barnes,SAC,GSW,SAC,0.5,Turnovers,16,15,15,2
22023,203084,22300100,"OCT 29, 2023",SAC vs. LAL,W,39,3,9,0.333,0,4,0.0,2,2,1.0,0,2,2,2,0,1,0,1,8,-4,1,Harrison Barnes,SAC,SAC,LAL,9.5,Points,12,10,10,4
22023,203084,22300100,"OCT 29, 2023",SAC vs. LAL,W,39,3,9,0.333,0,4,0.0,2,2,1.0,0,2,2,2,0,1,0,1,8,-4,1,Harrison Barnes,SAC,SAC,LAL,2.5,Rebounds,12,10,10,4
22023,203084,22300100,"OCT 29, 2023",SAC vs. LAL,W,39,3,9,0.333,0,4,0.0,2,2,1.0,0,2,2,2,0,1,0,1,8,-4,1,Harrison Barnes,SAC,SAC,LAL,1.5,Free Throws Made,12,10,10,4
22023,203084,22300100,"OCT 29, 2023",SAC vs. LAL,W,39,3,9,0.333,0,4,0.0,2,2,1.0,0,2,2,2,0,1,0,1,8,-4,1,Harrison Barnes,SAC,SAC,LAL,13.0,Pts+Rebs,12,10,10,4
22023,203084,22300100,"OCT 29, 2023",SAC vs. LAL,W,39,3,9,0.333,0,4,0.0,2,2,1.0,0,2,2,2,0,1,0,1,8,-4,1,Harrison Barnes,SAC,SAC,LAL,10.5,Pts+Asts,12,10,10,4
22023,203084,22300100,"OCT 29, 2023",SAC vs. LAL,W,39,3,9,0.333,0,4,0.0,2,2,1.0,0,2,2,2,0,1,0,1,8,-4,1,Harrison Barnes,SAC,SAC,LAL,0.5,Turnovers,12,10,10,4
22023,203084,22300087,"OCT 27, 2023",SAC vs. GSW,L,30,4,5,0.8,1,2,0.5,1,4,0.25,1,3,4,1,1,0,0,1,10,-9,1,Harrison Barnes,SAC,SAC,GSW,9.5,Points,15,14,11,5
22023,203084,22300087,"OCT 27, 2023",SAC vs. GSW,L,30,4,5,0.8,1,2,0.5,1,4,0.25,1,3,4,1,1,0,0,1,10,-9,1,Harrison Barnes,SAC,SAC,GSW,2.5,Rebounds,15,14,11,5
22023,203084,22300087,"OCT 27, 2023",SAC vs. GSW,L,30,4,5,0.8,1,2,0.5,1,4,0.25,1,3,4,1,1,0,0,1,10,-9,1,Harrison Barnes,SAC,SAC,GSW,1.5,Free Throws Made,15,14,11,5
22023,203084,22300087,"OCT 27, 2023",SAC vs. GSW,L,30,4,5,0.8,1,2,0.5,1,4,0.25,1,3,4,1,1,0,0,1,10,-9,1,Harrison Barnes,SAC,SAC,GSW,13.0,Pts+Rebs,15,14,11,5
22023,203084,22300087,"OCT 27, 2023",SAC vs. GSW,L,30,4,5,0.8,1,2,0.5,1,4,0.25,1,3,4,1,1,0,0,1,10,-9,1,Harrison Barnes,SAC,SAC,GSW,10.5,Pts+Asts,15,14,11,5
22023,203084,22300087,"OCT 27, 2023",SAC vs. GSW,L,30,4,5,0.8,1,2,0.5,1,4,0.25,1,3,4,1,1,0,0,1,10,-9,1,Harrison Barnes,SAC,SAC,GSW,0.5,Turnovers,15,14,11,5
22023,203084,22300072,"OCT 25, 2023",SAC @ UTA,W,33,11,16,0.688,5,7,0.714,6,6,1.0,0,4,4,2,1,0,1,2,33,10,1,Harrison Barnes,SAC,UTA,SAC,9.5,Points,39,37,35,6
22023,203084,22300072,"OCT 25, 2023",SAC @ UTA,W,33,11,16,0.688,5,7,0.714,6,6,1.0,0,4,4,2,1,0,1,2,33,10,1,Harrison Barnes,SAC,UTA,SAC,2.5,Rebounds,39,37,35,6
22023,203084,22300072,"OCT 25, 2023",SAC @ UTA,W,33,11,16,0.688,5,7,0.714,6,6,1.0,0,4,4,2,1,0,1,2,33,10,1,Harrison Barnes,SAC,UTA,SAC,1.5,Free Throws Made,39,37,35,6
22023,203084,22300072,"OCT 25, 2023",SAC @ UTA,W,33,11,16,0.688,5,7,0.714,6,6,1.0,0,4,4,2,1,0,1,2,33,10,1,Harrison Barnes,SAC,UTA,SAC,13.0,Pts+Rebs,39,37,35,6
22023,203084,22300072,"OCT 25, 2023",SAC @ UTA,W,33,11,16,0.688,5,7,0.714,6,6,1.0,0,4,4,2,1,0,1,2,33,10,1,Harrison Barnes,SAC,UTA,SAC,10.5,Pts+Asts,39,37,35,6
22023,203084,22300072,"OCT 25, 2023",SAC @ UTA,W,33,11,16,0.688,5,7,0.714,6,6,1.0,0,4,4,2,1,0,1,2,33,10,1,Harrison Barnes,SAC,UTA,SAC,0.5,Turnovers,39,37,35,6
22023,1630567,22300563,"JAN 15, 2024",TOR vs. BOS,L,41,5,12,0.417,0,2,0.0,0,0,0.0,2,11,13,2,2,0,4,2,10,-1,1,Scottie Barnes,TOR,TOR,BOS,,,25,23,12,15
22023,1630567,22300540,"JAN 12, 2024",TOR @ UTA,L,28,6,13,0.462,2,4,0.5,5,11,0.455,1,2,3,3,0,3,3,3,19,-21,1,Scottie Barnes,TOR,UTA,TOR,,,25,22,22,6
22023,1630567,22300526,"JAN 10, 2024",TOR @ LAC,L,34,5,10,0.5,1,5,0.2,1,3,0.333,0,7,7,6,0,2,2,1,12,-9,1,Scottie Barnes,TOR,LAC,TOR,,,25,19,18,13
22023,1630567,22300516,"JAN 09, 2024",TOR @ LAL,L,40,11,20,0.55,3,7,0.429,1,2,0.5,1,2,3,6,0,2,2,6,26,0,1,Scottie Barnes,TOR,LAL,TOR,,,35,29,32,9
22023,1630567,22300504,"JAN 07, 2024",TOR @ GSW,W,24,3,11,0.273,0,4,0.0,0,0,0.0,1,1,2,3,1,1,2,1,6,3,1,Scottie Barnes,TOR,GSW,TOR,,,11,8,9,5
22023,1630567,22300492,"JAN 05, 2024",TOR @ SAC,L,35,8,15,0.533,4,8,0.5,0,0,0.0,0,4,4,6,1,2,5,2,20,-23,1,Scottie Barnes,TOR,SAC,TOR,,,30,24,26,10
22023,1630567,22300470,"JAN 03, 2024",TOR @ MEM,W,40,7,14,0.5,2,5,0.4,4,4,1.0,0,2,2,8,1,0,1,2,20,2,1,Scottie Barnes,TOR,MEM,TOR,,,30,22,28,10
22023,1630567,22300452,"JAN 01, 2024",TOR vs. CLE,W,36,7,17,0.412,1,5,0.2,5,7,0.714,1,5,6,5,1,1,0,3,20,-5,1,Scottie Barnes,TOR,TOR,CLE,,,31,26,25,11
22023,1630567,22300440,"DEC 30, 2023",TOR @ DET,L,36,8,20,0.4,1,5,0.2,5,5,1.0,2,7,9,2,2,1,1,4,22,1,1,Scottie Barnes,TOR,DET,TOR,,,33,31,24,11
22023,1630567,22300432,"DEC 29, 2023",TOR @ BOS,L,38,10,24,0.417,7,15,0.467,3,4,0.75,3,7,10,5,1,3,2,2,30,-3,1,Scottie Barnes,TOR,BOS,TOR,,,45,40,35,15
22023,1630567,22300416,"DEC 27, 2023",TOR @ WAS,W,33,8,16,0.5,4,8,0.5,0,0,0.0,5,7,12,8,3,2,2,0,20,10,1,Scottie Barnes,TOR,WAS,TOR,,,40,32,28,20
22023,1630567,22300395,"DEC 23, 2023",TOR vs. UTA,L,38,12,23,0.522,4,8,0.5,4,4,1.0,3,11,14,7,0,1,4,4,32,-6,1,Scottie Barnes,TOR,TOR,UTA,,,53,46,39,21
22023,1630567,22300382,"DEC 22, 2023",TOR @ PHI,L,35,3,11,0.273,2,7,0.286,4,4,1.0,1,6,7,7,1,4,3,0,12,-1,1,Scottie Barnes,TOR,PHI,TOR,,,26,19,19,14
22023,1630567,22300369,"DEC 20, 2023",TOR vs. DEN,L,33,13,22,0.591,1,5,0.2,3,4,0.75,1,9,10,5,0,1,2,0,30,-4,1,Scottie Barnes,TOR,TOR,DEN,,,45,40,35,15
22023,1630567,22300354,"DEC 18, 2023",TOR vs. CHA,W,39,7,14,0.5,1,2,0.5,7,7,1.0,5,12,17,7,0,3,5,3,22,22,1,Scottie Barnes,TOR,TOR,CHA,,,46,39,29,24
22023,1630567,22300330,"DEC 15, 2023",TOR vs. ATL,L,34,9,15,0.6,1,5,0.2,4,8,0.5,1,3,4,8,1,2,3,2,23,-19,1,Scottie Barnes,TOR,TOR,ATL,,,35,27,31,12
22023,1630567,22300313,"DEC 13, 2023",TOR vs. ATL,W,34,11,14,0.786,3,4,0.75,2,3,0.667,1,9,10,6,0,1,3,3,27,7,1,Scottie Barnes,TOR,TOR,ATL,,,43,37,33,16
22023,1630567,22300297,"DEC 11, 2023",TOR @ NYK,L,38,7,13,0.538,3,8,0.375,3,3,1.0,4,2,6,5,2,0,1,1,20,-10,1,Scottie Barnes,TOR,NYK,TOR,,,31,26,25,11
22023,1630567,22301216,"DEC 08, 2023",TOR @ CHA,L,36,12,18,0.667,3,6,0.5,4,8,0.5,4,6,10,10,2,1,5,1,31,1,1,Scottie Barnes,TOR,CHA,TOR,,,51,41,41,20
22023,1630567,22301207,"DEC 06, 2023",TOR vs. MIA,L,34,5,17,0.294,2,7,0.286,0,0,0.0,3,8,11,5,0,1,3,2,12,-25,1,Scottie Barnes,TOR,TOR,MIA,,,28,23,17,16
22023,1630567,22300276,"DEC 01, 2023",TOR vs. NYK,L,37,13,19,0.684,3,7,0.429,0,1,0.0,3,6,9,4,5,1,2,2,29,-7,1,Scottie Barnes,TOR,TOR,NYK,,,42,38,33,13
22023,1630567,22300260,"NOV 29, 2023",TOR vs. PHX,W,38,7,15,0.467,1,3,0.333,8,8,1.0,2,5,7,4,0,3,0,4,23,14,1,Scottie Barnes,TOR,TOR,PHX,,,34,30,27,11
22023,1630567,22300054,"NOV 28, 2023",TOR @ BKN,L,36,5,19,0.263,3,7,0.429,4,5,0.8,4,7,11,6,3,0,1,4,17,-22,1,Scottie Barnes,TOR,BKN,TOR,,,34,28,23,17
22023,1630567,22300251,"NOV 26, 2023",TOR @ CLE,L,33,5,14,0.357,1,4,0.25,4,5,0.8,1,7,8,3,1,1,2,1,15,-20,1,Scottie Barnes,TOR,CLE,TOR,,,26,23,18,11
22023,1630567,22300046,"NOV 24, 2023",TOR vs. CHI,W,33,5,11,0.455,2,5,0.4,1,2,0.5,5,5,10,6,1,2,1,1,13,19,1,Scottie Barnes,TOR,TOR,CHI,,,29,23,19,16
22023,1630567,22300230,"NOV 22, 2023",TOR @ IND,W,39,7,17,0.412,2,6,0.333,4,5,0.8,3,9,12,4,4,0,3,0,20,-10,1,Scottie Barnes,TOR,IND,TOR,,,36,32,24,16
22023,1630567,22300038,"NOV 21, 2023",TOR @ ORL,L,30,5,11,0.455,1,4,0.25,3,4,0.75,0,8,8,4,3,0,5,1,14,-22,1,Scottie Barnes,TOR,ORL,TOR,,,26,22,18,12
22023,1630567,22300211,"NOV 19, 2023",TOR vs. DET,W,25,7,11,0.636,3,4,0.75,0,0,0.0,2,5,7,9,0,0,3,1,17,37,1,Scottie Barnes,TOR,TOR,DET,,,33,24,26,16
22023,1630567,22300031,"NOV 17, 2023",TOR vs. BOS,L,32,5,13,0.385,2,6,0.333,2,3,0.667,0,3,3,6,0,1,1,2,14,-3,1,Scottie Barnes,TOR,TOR,BOS,,,23,17,20,9
22023,1630567,22300195,"NOV 15, 2023",TOR vs. MIL,L,31,11,19,0.579,3,3,1.0,4,5,0.8,5,4,9,7,1,0,3,2,29,-24,1,Scottie Barnes,TOR,TOR,MIL,,,45,38,36,16
22023,1630567,22300189,"NOV 13, 2023",TOR vs. WAS,W,38,8,17,0.471,0,2,0.0,3,4,0.75,3,6,9,4,5,0,1,3,19,-3,1,Scottie Barnes,TOR,TOR,WAS,,,32,28,23,13
22023,1630567,22300174,"NOV 11, 2023",TOR @ BOS,L,29,4,15,0.267,2,9,0.222,0,0,0.0,1,4,5,4,1,1,1,1,10,-28,1,Scottie Barnes,TOR,BOS,TOR,,,19,15,14,9
22023,1630567,22300168,"NOV 08, 2023",TOR @ DAL,W,39,4,15,0.267,0,4,0.0,6,8,0.75,6,8,14,7,4,2,0,2,14,9,1,Scottie Barnes,TOR,DAL,TOR,,,35,28,21,21
22023,1630567,22300141,"NOV 05, 2023",TOR @ SAS,W,42,9,20,0.45,5,10,0.5,7,11,0.636,4,7,11,6,3,3,3,1,30,14,1,Scottie Barnes,TOR,SAS,TOR,,,47,41,36,17
22023,1630567,22300128,"NOV 02, 2023",TOR @ PHI,L,35,9,16,0.563,2,7,0.286,4,4,1.0,2,6,8,8,0,0,1,4,24,-11,1,Scottie Barnes,TOR,PHI,TOR,,,40,32,32,16
22023,1630567,22300116,"NOV 01, 2023",TOR vs. MIL,W,29,8,16,0.5,4,6,0.667,1,1,1.0,5,7,12,5,1,2,3,1,21,14,1,Scottie Barnes,TOR,TOR,MIL,,,38,33,26,17
22023,1630567,22300105,"OCT 30, 2023",TOR vs. POR,L,37,8,19,0.421,1,4,0.25,3,3,1.0,4,8,12,2,2,1,4,3,20,1,1,Scottie Barnes,TOR,TOR,POR,,,34,32,22,14
22023,1630567,22300092,"OCT 28, 2023",TOR vs. PHI,L,37,11,16,0.688,2,5,0.4,0,0,0.0,1,7,8,5,0,2,1,3,24,-6,1,Scottie Barnes,TOR,TOR,PHI,,,37,32,29,13
22023,1630567,22300082,"OCT 27, 2023",TOR @ CHI,L,39,9,14,0.643,1,2,0.5,3,4,0.75,1,9,10,10,0,2,7,5,22,15,1,Scottie Barnes,TOR,CHI,TOR,,,42,32,32,20
22023,1630567,22300069,"OCT 25, 2023",TOR vs. MIN,W,37,6,16,0.375,1,4,0.25,4,6,0.667,1,7,8,5,2,5,4,1,17,2,1,Scottie Barnes,TOR,TOR,MIN,,,30,25,22,13
22023,1629628,22300563,"JAN 15, 2024",TOR vs. BOS,L,36,11,19,0.579,0,4,0.0,2,3,0.667,0,9,9,4,0,0,0,4,24,-4,1,RJ Barrett,TOR,TOR,BOS,,,37,33,28,13
22023,1629628,22300540,"JAN 12, 2024",TOR @ UTA,L,30,2,9,0.222,0,2,0.0,0,0,0.0,0,7,7,2,1,3,2,4,4,-16,1,RJ Barrett,TOR,UTA,TOR,,,13,11,6,9
22023,1629628,22300526,"JAN 10, 2024",TOR @ LAC,L,37,10,16,0.625,4,6,0.667,0,0,0.0,1,4,5,4,0,0,4,4,24,0,1,RJ Barrett,TOR,LAC,TOR,,,33,29,28,9
22023,1629628,22300516,"JAN 09, 2024",TOR @ LAL,L,35,10,13,0.769,1,3,0.333,2,3,0.667,1,9,10,5,2,0,3,4,23,10,1,RJ Barrett,TOR,LAL,TOR,,,38,33,28,15
22023,1629628,22300504,"JAN 07, 2024",TOR @ GSW,W,36,13,20,0.65,5,8,0.625,6,8,0.75,0,6,6,6,1,0,0,3,37,26,1,RJ Barrett,TOR,GSW,TOR,,,49,43,43,12
22023,1629628,22300492,"JAN 05, 2024",TOR @ SAC,L,27,4,8,0.5,2,4,0.5,4,4,1.0,1,3,4,2,0,1,0,2,14,-19,1,RJ Barrett,TOR,SAC,TOR,,,20,18,16,6
22023,1629628,22300470,"JAN 03, 2024",TOR @ MEM,W,33,5,12,0.417,2,5,0.4,2,3,0.667,0,7,7,3,1,0,3,3,14,-2,1,RJ Barrett,TOR,MEM,TOR,,,24,21,17,10
22023,1629628,22300452,"JAN 01, 2024",TOR vs. CLE,W,29,6,12,0.5,1,2,0.5,6,8,0.75,3,6,9,1,0,0,5,5,19,-7,1,RJ Barrett,TOR,TOR,CLE,,,29,28,20,10
22023,1629628,22300429,"DEC 29, 2023",NYK @ ORL,L,37,7,17,0.412,1,5,0.2,4,5,0.8,2,4,6,2,1,0,2,4,19,-22,1,RJ Barrett,NYK,ORL,NYK,,,27,25,21,8
22023,1629628,22300419,"DEC 27, 2023",NYK @ OKC,L,30,5,14,0.357,1,7,0.143,3,6,0.5,0,4,4,4,0,0,5,5,14,-9,1,RJ Barrett,NYK,OKC,NYK,,,22,18,18,8
22023,1629628,22300401,"DEC 25, 2023",NYK vs. MIL,W,28,8,14,0.571,2,5,0.4,3,4,0.75,1,5,6,1,1,0,3,3,21,-6,1,RJ Barrett,NYK,NYK,MIL,,,28,27,22,7
22023,1629628,22300388,"DEC 23, 2023",NYK vs. MIL,L,29,5,17,0.294,2,5,0.4,1,2,0.5,1,6,7,1,0,1,1,1,13,-8,1,RJ Barrett,NYK,NYK,MIL,,,21,20,14,8
22023,1629628,22300368,"DEC 20, 2023",NYK @ BKN,W,27,5,11,0.455,0,1,0.0,4,4,1.0,0,5,5,2,1,1,2,2,14,13,1,RJ Barrett,NYK,BKN,NYK,,,21,19,16,7
22023,1629628,22300359,"DEC 18, 2023",NYK @ LAL,W,30,3,10,0.3,0,2,0.0,6,6,1.0,1,4,5,4,0,1,1,2,12,-7,1,RJ Barrett,NYK,LAL,NYK,,,21,17,16,9
22023,1629628,22300343,"DEC 16, 2023",NYK @ LAC,L,28,7,15,0.467,2,7,0.286,2,2,1.0,1,4,5,0,0,1,1,1,18,-30,1,RJ Barrett,NYK,LAC,NYK,,,23,23,18,5
22023,1629628,22300333,"DEC 15, 2023",NYK @ PHX,W,29,6,10,0.6,1,2,0.5,8,8,1.0,1,1,2,3,0,1,1,2,21,0,1,RJ Barrett,NYK,PHX,NYK,,,26,23,24,5
22023,1629628,22300318,"DEC 13, 2023",NYK @ UTA,L,24,3,16,0.188,0,7,0.0,3,4,0.75,1,5,6,2,0,0,0,2,9,-4,1,RJ Barrett,NYK,UTA,NYK,,,17,15,11,8
22023,1629628,22300297,"DEC 11, 2023",NYK vs. TOR,W,32,11,21,0.524,3,8,0.375,2,4,0.5,0,3,3,2,1,1,1,1,27,1,1,RJ Barrett,NYK,NYK,TOR,,,32,30,29,5
22023,1629628,22301227,"DEC 08, 2023",NYK @ BOS,L,31,9,16,0.563,2,5,0.4,3,4,0.75,1,2,3,3,1,0,0,0,23,-12,1,RJ Barrett,NYK,BOS,NYK,,,29,26,26,6
22023,1629628,22301201,"DEC 05, 2023",NYK @ MIL,L,31,7,18,0.389,1,4,0.25,8,8,1.0,3,5,8,1,0,0,2,0,23,-6,1,RJ Barrett,NYK,MIL,NYK,,,32,31,24,9
22023,1629628,22300276,"DEC 01, 2023",NYK @ TOR,W,27,6,18,0.333,1,6,0.167,2,3,0.667,1,3,4,6,0,0,2,1,15,-5,1,RJ Barrett,NYK,TOR,NYK,,,25,19,21,10
22023,1629628,22300268,"NOV 30, 2023",NYK vs. DET,W,24,5,12,0.417,1,6,0.167,4,6,0.667,0,1,1,2,0,0,2,2,15,-5,1,RJ Barrett,NYK,NYK,DET,,,18,16,17,3
22023,1629628,22300057,"NOV 28, 2023",NYK vs. CHA,W,28,3,13,0.231,1,4,0.25,9,9,1.0,0,3,3,2,1,0,1,1,16,0,1,RJ Barrett,NYK,NYK,CHA,,,21,19,18,5
22023,1629628,22300247,"NOV 26, 2023",NYK vs. PHX,L,31,3,11,0.273,0,2,0.0,3,4,0.75,0,2,2,1,0,1,0,3,9,-5,1,RJ Barrett,NYK,NYK,PHX,,,12,11,10,3
22023,1629628,22300045,"NOV 24, 2023",NYK vs. MIA,W,34,7,14,0.5,1,5,0.2,3,3,1.0,0,7,7,1,0,0,3,2,18,9,1,RJ Barrett,NYK,NYK,MIA,,,26,25,19,8
22023,1629628,22300221,"NOV 20, 2023",NYK @ MIN,L,22,4,13,0.308,3,4,0.75,3,4,0.75,2,5,7,1,1,0,4,5,14,-14,1,RJ Barrett,NYK,MIN,NYK,,,22,21,15,8
22023,1629628,22300202,"NOV 18, 2023",NYK @ CHA,W,26,5,15,0.333,1,5,0.2,4,5,0.8,0,3,3,3,1,0,1,0,15,16,1,RJ Barrett,NYK,CHA,NYK,,,21,18,18,6
22023,1629628,22300177,"NOV 12, 2023",NYK vs. CHA,W,31,9,16,0.563,4,6,0.667,2,3,0.667,0,4,4,2,1,1,1,1,24,26,1,RJ Barrett,NYK,NYK,CHA,,,30,28,26,6
22023,1629628,22300161,"NOV 08, 2023",NYK vs. SAS,W,32,8,17,0.471,5,9,0.556,3,3,1.0,0,2,2,6,1,0,0,2,24,26,1,RJ Barrett,NYK,NYK,SAS,,,32,26,30,8
22023,1629628,22300151,"NOV 06, 2023",NYK vs. LAC,W,31,9,16,0.563,2,4,0.5,6,6,1.0,1,5,6,4,0,0,5,1,26,13,1,RJ Barrett,NYK,NYK,LAC,,,36,32,30,10
22023,1629628,22300112,"OCT 31, 2023",NYK @ CLE,W,25,5,13,0.385,3,5,0.6,3,4,0.75,1,2,3,0,0,0,1,2,16,14,1,RJ Barrett,NYK,CLE,NYK,,,19,19,16,3
22023,1629628,22300090,"OCT 28, 2023",NYK @ NOP,L,30,7,16,0.438,1,6,0.167,3,4,0.75,0,3,3,2,0,1,3,0,18,-15,1,RJ Barrett,NYK,NOP,NYK,,,23,21,20,5
22023,1629628,22300079,"OCT 27, 2023",NYK @ ATL,W,34,9,15,0.6,3,5,0.6,5,6,0.833,1,2,3,6,1,0,3,2,26,6,1,RJ Barrett,NYK,ATL,NYK,,,35,29,32,9
22023,1629628,22300065,"OCT 25, 2023",NYK vs. BOS,L,36,8,20,0.4,2,5,0.4,6,7,0.857,1,2,3,2,1,0,2,0,24,6,1,RJ Barrett,NYK,NYK,BOS,,,29,27,26,5
22023,1629646,22300278,"DEC 01, 2023",SAS @ NOP,L,19,4,4,1.0,0,0,0.0,0,0,0.0,1,10,11,3,0,3,1,4,8,5,1,Charles Bassey,SAS,NOP,SAS,,,22,19,11,14
22023,1629646,22300272,"NOV 30, 2023",SAS vs. ATL,L,4,0,0,0.0,0,0,0.0,0,0,0.0,1,0,1,0,0,2,0,3,0,3,1,Charles Bassey,SAS,SAS,ATL,,,1,1,0,1
22023,1629646,22300252,"NOV 26, 2023",SAS @ DEN,L,15,3,5,0.6,0,0,0.0,3,3,1.0,2,4,6,2,0,1,1,3,9,-7,1,Charles Bassey,SAS,DEN,SAS,,,17,15,11,8
22023,1629646,22300051,"NOV 24, 2023",SAS @ GSW,L,7,0,0,0.0,0,0,0.0,0,0,0.0,0,0,0,2,0,1,0,0,0,0,1,Charles Bassey,SAS,GSW,SAS,,,2,0,2,2
22023,1629646,22300235,"NOV 22, 2023",SAS vs. LAC,L,2,0,0,0.0,0,0,0.0,0,0,0.0,0,0,0,0,0,0,3,0,0,-7,1,Charles Bassey,SAS,SAS,LAC,,,0,0,0,0
22023,1629646,22300223,"NOV 20, 2023",SAS vs. LAC,L,18,1,3,0.333,0,0,0.0,0,0,0.0,4,8,12,3,0,4,3,2,2,3,1,Charles Bassey,SAS,SAS,LAC,,,17,14,5,15
22023,1629646,22300206,"NOV 18, 2023",SAS vs. MEM,L,4,0,0,0.0,0,0,0.0,0,0,0.0,0,1,1,0,0,0,1,3,0,1,1,Charles Bassey,SAS,SAS,MEM,,,1,1,0,1
22023,1629646,22300032,"NOV 17, 2023",SAS vs. SAC,L,2,1,1,1.0,0,0,0.0,0,0,0.0,0,1,1,0,0,0,0,0,2,-6,1,Charles Bassey,SAS,SAS,SAC,,,3,3,2,1
22023,1629646,22300021,"NOV 14, 2023",SAS @ OKC,L,17,3,5,0.6,0,0,0.0,0,0,0.0,2,5,7,1,0,0,0,1,6,-3,1,Charles Bassey,SAS,OKC,SAS,,,14,13,7,8
22023,1629646,22300184,"NOV 12, 2023",SAS vs. MIA,L,6,1,2,0.5,0,0,0.0,1,2,0.5,3,2,5,1,1,0,1,2,3,-4,1,Charles Bassey,SAS,SAS,MIA,,,9,8,4,6
22023,1629646,22300013,"NOV 10, 2023",SAS vs. MIN,L,11,1,3,0.333,0,1,0.0,0,0,0.0,2,4,6,2,0,2,0,1,2,-4,1,Charles Bassey,SAS,SAS,MIN,,,10,8,4,8
22023,1629646,22300161,"NOV 08, 2023",SAS @ NYK,L,15,3,3,1.0,0,0,0.0,0,0,0.0,1,3,4,1,1,2,0,1,6,-4,1,Charles Bassey,SAS,NYK,SAS,,,11,10,7,5
22023,1629646,22300146,"NOV 06, 2023",SAS @ IND,L,17,5,5,1.0,0,0,0.0,0,0,0.0,2,1,3,1,3,0,1,3,10,-26,1,Charles Bassey,SAS,IND,SAS,,,14,13,11,4
22023,1629646,22300141,"NOV 05, 2023",SAS vs. TOR,L,9,1,1,1.0,0,0,0.0,0,0,0.0,1,1,2,0,0,0,1,1,2,8,1,Charles Bassey,SAS,SAS,TOR,,,4,4,2,2
22023,1629646,22300131,"NOV 02, 2023",SAS @ PHX,W,6,1,1,1.0,0,0,0.0,1,1,1.0,0,1,1,1,1,0,1,0,3,8,1,Charles Bassey,SAS,PHX,SAS,,,5,4,4,2
22023,1629646,22300113,"OCT 31, 2023",SAS @ PHX,W,15,1,2,0.5,0,0,0.0,0,0,0.0,1,2,3,1,0,1,1,4,2,-13,1,Charles Bassey,SAS,PHX,SAS,,,6,5,3,4
22023,1629646,22300099,"OCT 29, 2023",SAS @ LAC,L,16,3,4,0.75,0,0,0.0,0,0,0.0,1,4,5,1,1,1,0,2,6,9,1,Charles Bassey,SAS,LAC,SAS,,,12,11,7,6
22023,1629646,22300083,"OCT 27, 2023",SAS vs. HOU,W,7,0,0,0.0,0,0,0.0,0,0,0.0,1,2,3,0,0,0,0,1,0,-3,1,Charles Bassey,SAS,SAS,HOU,,,3,3,0,3
22023,1629646,22300073,"OCT 25, 2023",SAS vs. DAL,L,13,1,1,1.0,0,0,0.0,0,0,0.0,1,4,5,2,1,0,1,0,2,-6,1,Charles Bassey,SAS,SAS,DAL,,,9,7,4,7
22023,1641734,22300420,"DEC 27, 2023",CLE @ DAL,W,6,0,3,0.0,0,3,0.0,0,0,0.0,0,1,1,3,0,0,0,2,0,11,1,Emoni Bates,CLE,DAL,CLE,,,4,1,3,4
22023,1641734,22300396,"DEC 23, 2023",CLE @ CHI,W,9,1,2,0.5,1,2,0.5,0,0,0.0,0,0,0,0,0,1,0,0,3,-2,1,Emoni Bates,CLE,CHI,CLE,,,3,3,3,0
22023,1641734,22300375,"DEC 21, 2023",CLE vs. NOP,L,9,1,5,0.2,1,3,0.333,0,0,0.0,0,0,0,1,0,0,0,1,3,-9,1,Emoni Bates,CLE,CLE,NOP,,,4,3,4,1
22023,1641734,22300229,"NOV 22, 2023",CLE vs. MIA,L,16,1,5,0.2,1,5,0.2,0,0,0.0,0,1,1,1,1,0,0,1,3,-12,1,Emoni Bates,CLE,CLE,MIA,,,5,4,4,2
22023,1641734,22300210,"NOV 19, 2023",CLE vs. DEN,W,4,0,1,0.0,0,1,0.0,0,0,0.0,0,1,1,0,0,0,0,0,0,-12,1,Emoni Bates,CLE,CLE,DEN,,,1,1,0,1
22023,1641734,22300030,"NOV 17, 2023",CLE vs. DET,W,1,0,0,0.0,0,0,0.0,0,0,0.0,0,0,0,0,0,0,0,0,0,-2,1,Emoni Bates,CLE,CLE,DET,,,0,0,0,0
22023,1641734,22300199,"NOV 15, 2023",CLE @ POR,W,2,0,0,0.0,0,0,0.0,0,0,0.0,0,1,1,0,0,0,0,0,0,0,1,Emoni Bates,CLE,POR,CLE,,,1,1,0,1
22023,1641734,22300176,"NOV 11, 2023",CLE @ GSW,W,1,0,0,0.0,0,0,0.0,0,0,0.0,0,0,0,0,0,0,0,0,0,-6,1,Emoni Bates,CLE,GSW,CLE,,,0,0,0,0
22023,1641734,22300112,"OCT 31, 2023",CLE vs. NYK,L,23,3,8,0.375,2,5,0.4,1,2,0.5,1,5,6,1,0,1,1,1,9,-9,1,Emoni Bates,CLE,CLE,NYK,,,16,15,10,7
22023,1641734,22300091,"OCT 28, 2023",CLE vs. IND,L,7,0,1,0.0,0,1,0.0,0,0,0.0,0,0,0,0,0,0,0,0,0,-15,1,Emoni Bates,CLE,CLE,IND,,,0,0,0,0
22023,1628966,22300554,"JAN 14, 2024",PHX @ POR,W,13,2,3,0.667,0,1,0.0,0,0,0.0,1,1,2,3,0,0,0,1,4,5,1,Keita Bates-Diop,PHX,POR,PHX,,,9,6,7,5
22023,1628966,22300531,"JAN 11, 2024",PHX @ LAL,W,5,1,3,0.333,0,1,0.0,0,0,0.0,0,0,0,0,0,0,0,0,2,-7,1,Keita Bates-Diop,PHX,LAL,PHX,,,2,2,2,0
22023,1628966,22300511,"JAN 08, 2024",PHX @ LAC,L,2,1,1,1.0,1,1,1.0,0,0,0.0,0,0,0,0,0,0,0,1,3,3,1,Keita Bates-Diop,PHX,LAC,PHX,,,3,3,3,0
22023,1628966,22300503,"JAN 07, 2024",PHX vs. MEM,L,14,1,3,0.333,1,3,0.333,0,0,0.0,1,2,3,1,0,0,0,3,3,-15,1,Keita Bates-Diop,PHX,PHX,MEM,,,7,6,4,4
22023,1628966,22300489,"JAN 05, 2024",PHX vs. MIA,W,19,0,6,0.0,0,3,0.0,0,0,0.0,1,3,4,0,3,0,0,1,0,-6,1,Keita Bates-Diop,PHX,PHX,MIA,,,4,4,0,4
22023,1628966,22300473,"JAN 03, 2024",PHX vs. LAC,L,21,1,3,0.333,1,2,0.5,2,2,1.0,0,0,0,3,1,0,0,3,5,-2,1,Keita Bates-Diop,PHX,PHX,LAC,,,8,5,8,3
22023,1628966,22300456,"JAN 01, 2024",PHX vs. POR,W,17,1,1,1.0,1,1,1.0,0,0,0.0,0,3,3,1,2,0,0,1,3,15,1,Keita Bates-Diop,PHX,PHX,POR,,,7,6,4,4
22023,1628966,22300333,"DEC 15, 2023",PHX vs. NYK,L,14,2,5,0.4,0,1,0.0,0,0,0.0,0,3,3,0,0,0,0,0,4,-13,1,Keita Bates-Diop,PHX,PHX,NYK,,,7,7,4,3
22023,1628966,22300317,"DEC 13, 2023",PHX vs. BKN,L,12,1,3,0.333,0,1,0.0,0,0,0.0,0,2,2,1,0,0,1,1,2,1,1,Keita Bates-Diop,PHX,PHX,BKN,,,5,4,3,3
22023,1628966,22300308,"DEC 12, 2023",PHX vs. GSW,W,6,0,2,0.0,0,2,0.0,0,0,0.0,0,0,0,0,0,0,1,0,0,5,1,Keita Bates-Diop,PHX,PHX,GSW,,,0,0,0,0
22023,1628966,22301228,"DEC 08, 2023",PHX vs. SAC,L,17,2,6,0.333,1,3,0.333,0,2,0.0,1,3,4,2,0,0,0,0,5,-8,1,Keita Bates-Diop,PHX,PHX,SAC,,,11,9,7,6
22023,1628966,22301203,"DEC 05, 2023",PHX @ LAL,L,6,1,3,0.333,0,1,0.0,0,0,0.0,1,0,1,1,0,1,0,0,2,2,1,Keita Bates-Diop,PHX,LAL,PHX,,,4,3,3,2
22023,1628966,22300288,"DEC 02, 2023",PHX vs. MEM,W,18,3,6,0.5,1,2,0.5,1,1,1.0,0,3,3,0,1,0,1,0,8,-10,1,Keita Bates-Diop,PHX,PHX,MEM,,,11,11,8,3
22023,1628966,22300279,"DEC 01, 2023",PHX vs. DEN,L,17,0,1,0.0,0,0,0.0,4,4,1.0,0,1,1,1,0,0,0,0,4,-10,1,Keita Bates-Diop,PHX,PHX,DEN,,,6,5,5,2
22023,1628966,22300260,"NOV 29, 2023",PHX @ TOR,L,13,3,5,0.6,0,1,0.0,3,3,1.0,2,1,3,0,0,0,0,0,9,-7,1,Keita Bates-Diop,PHX,TOR,PHX,,,12,12,9,3
22023,1628966,22300247,"NOV 26, 2023",PHX @ NYK,W,28,3,11,0.273,0,5,0.0,3,3,1.0,2,5,7,2,2,1,1,3,9,0,1,Keita Bates-Diop,PHX,NYK,PHX,,,18,16,11,9
22023,1628966,22300044,"NOV 24, 2023",PHX @ MEM,W,24,2,5,0.4,0,1,0.0,2,2,1.0,1,3,4,1,1,2,0,0,6,8,1,Keita Bates-Diop,PHX,MEM,PHX,,,11,10,7,5
22023,1628966,22300236,"NOV 22, 2023",PHX vs. GSW,W,13,1,2,0.5,1,1,1.0,0,2,0.0,1,2,3,0,1,0,1,1,3,1,1,Keita Bates-Diop,PHX,PHX,GSW,,,6,6,3,3
22023,1628966,22300041,"NOV 21, 2023",PHX vs. POR,W,10,0,1,0.0,0,0,0.0,1,2,0.5,0,1,1,0,0,0,0,0,1,-7,1,Keita Bates-Diop,PHX,PHX,POR,,,2,2,1,1
22023,1628966,22300214,"NOV 19, 2023",PHX @ UTA,W,23,2,6,0.333,1,4,0.25,1,1,1.0,1,0,1,1,1,2,0,3,6,-5,1,Keita Bates-Diop,PHX,UTA,PHX,,,8,7,7,2
22023,1628966,22300035,"NOV 17, 2023",PHX @ UTA,W,20,2,4,0.5,0,0,0.0,3,3,1.0,1,2,3,0,2,3,0,4,7,9,1,Keita Bates-Diop,PHX,UTA,PHX,,,10,10,7,3
22023,1628966,22300197,"NOV 15, 2023",PHX vs. MIN,W,13,1,1,1.0,0,0,0.0,0,0,0.0,1,1,2,1,0,0,0,1,2,-9,1,Keita Bates-Diop,PHX,PHX,MIN,,,5,4,3,3
22023,1628966,22300185,"NOV 12, 2023",PHX vs. OKC,L,27,3,9,0.333,0,1,0.0,0,0,0.0,4,4,8,2,0,0,1,3,6,-4,1,Keita Bates-Diop,PHX,PHX,OKC,,,16,14,8,10
22023,1628966,22300015,"NOV 10, 2023",PHX vs. LAL,L,30,4,11,0.364,1,6,0.167,2,2,1.0,2,3,5,0,2,0,0,0,11,-6,1,Keita Bates-Diop,PHX,PHX,LAL,,,16,16,11,5
22023,1628966,22300162,"NOV 08, 2023",PHX @ CHI,W,31,2,4,0.5,2,4,0.5,1,2,0.5,1,4,5,3,1,3,0,3,7,19,1,Keita Bates-Diop,PHX,CHI,PHX,,,15,12,10,8
22023,1628966,22300140,"NOV 05, 2023",PHX @ DET,W,20,0,3,0.0,0,1,0.0,0,0,0.0,2,4,6,1,0,1,0,0,0,1,1,Keita Bates-Diop,PHX,DET,PHX,,,7,6,1,7
22023,1628966,22300132,"NOV 04, 2023",PHX @ PHI,L,24,3,6,0.5,2,3,0.667,0,1,0.0,0,3,3,2,1,2,0,0,8,-2,1,Keita Bates-Diop,PHX,PHI,PHX,,,13,11,10,5
22023,1628966,22300131,"NOV 02, 2023",PHX vs. SAS,L,18,5,7,0.714,1,3,0.333,2,4,0.5,0,2,2,0,0,0,0,1,13,7,1,Keita Bates-Diop,PHX,PHX,SAS,,,15,15,13,2
22023,1628966,22300094,"OCT 28, 2023",PHX vs. UTA,W,6,1,2,0.5,0,0,0.0,0,0,0.0,0,1,1,1,0,0,0,0,2,-4,1,Keita Bates-Diop,PHX,PHX,UTA,,,4,3,3,2
22023,201587,22300555,"JAN 15, 2024",PHI vs. HOU,W,28,2,7,0.286,1,3,0.333,0,0,0.0,2,3,5,3,2,1,0,2,5,0,1,Nicolas Batum,PHI,PHI,HOU,,,13,10,8,8
22023,201587,22300532,"JAN 12, 2024",PHI vs. SAC,W,25,5,5,1.0,4,4,1.0,0,0,0.0,3,2,5,3,0,0,0,2,14,2,1,Nicolas Batum,PHI,PHI,SAC,,,22,19,17,8
22023,201587,22300521,"JAN 10, 2024",PHI @ ATL,L,37,2,4,0.5,1,2,0.5,1,2,0.5,2,2,4,2,0,3,1,4,6,2,1,Nicolas Batum,PHI,ATL,PHI,,,12,10,8,6
22023,201587,22300495,"JAN 06, 2024",PHI vs. UTA,L,26,1,6,0.167,0,5,0.0,0,0,0.0,1,3,4,4,4,2,2,3,2,-13,1,Nicolas Batum,PHI,PHI,UTA,,,10,6,6,8
22023,201587,22300483,"JAN 05, 2024",PHI vs. NYK,L,21,0,2,0.0,0,1,0.0,0,0,0.0,1,3,4,1,0,1,2,2,0,-6,1,Nicolas Batum,PHI,PHI,NYK,,,5,4,1,5
22023,201587,22300459,"JAN 02, 2024",PHI vs. CHI,W,22,2,4,0.5,1,3,0.333,1,1,1.0,2,1,3,2,0,1,1,2,6,18,1,Nicolas Batum,PHI,PHI,CHI,,,11,9,8,5
22023,201587,22300442,"DEC 30, 2023",PHI @ CHI,L,19,3,6,0.5,3,5,0.6,0,0,0.0,0,3,3,2,0,0,1,1,9,-1,1,Nicolas Batum,PHI,CHI,PHI,,,14,12,11,5
22023,201587,22300351,"DEC 18, 2023",PHI vs. CHI,L,27,1,4,0.25,1,4,0.25,0,0,0.0,1,3,4,3,0,0,2,0,3,7,1,Nicolas Batum,PHI,PHI,CHI,,,10,7,6,7
22023,201587,22300335,"DEC 16, 2023",PHI @ CHA,W,20,1,3,0.333,1,2,0.5,0,0,0.0,0,3,3,3,0,0,0,2,3,24,1,Nicolas Batum,PHI,CHA,PHI,,,9,6,6,6
22023,201587,22300327,"DEC 15, 2023",PHI vs. DET,W,22,2,4,0.5,0,1,0.0,0,0,0.0,2,3,5,4,2,0,0,0,4,30,1,Nicolas Batum,PHI,PHI,DET,,,13,9,8,9
22023,201587,22300310,"DEC 13, 2023",PHI @ DET,W,20,2,2,1.0,1,1,1.0,0,0,0.0,0,1,1,2,0,0,0,3,5,6,1,Nicolas Batum,PHI,DET,PHI,,,8,6,7,3
22023,201587,22300295,"DEC 11, 2023",PHI vs. WAS,W,20,2,5,0.4,0,3,0.0,0,0,0.0,0,2,2,1,1,2,0,0,4,12,1,Nicolas Batum,PHI,PHI,WAS,,,7,6,5,3
22023,201587,22301218,"DEC 08, 2023",PHI vs. ATL,W,29,3,4,0.75,2,3,0.667,0,0,0.0,2,2,4,4,0,0,0,1,8,3,1,Nicolas Batum,PHI,PHI,ATL,,,16,12,12,8
22023,201587,22301208,"DEC 06, 2023",PHI @ WAS,W,33,2,4,0.5,1,3,0.333,4,7,0.571,1,5,6,5,0,0,0,2,9,7,1,Nicolas Batum,PHI,WAS,PHI,,,20,15,14,11
22023,201587,22300262,"NOV 29, 2023",PHI @ NOP,L,14,1,1,1.0,1,1,1.0,0,0,0.0,0,1,1,0,0,0,1,1,3,-21,1,Nicolas Batum,PHI,NOP,PHI,,,4,4,3,1
22023,201587,22300255,"NOV 27, 2023",PHI vs. LAL,W,29,4,7,0.571,2,3,0.667,0,0,0.0,3,4,7,4,3,0,0,3,10,30,1,Nicolas Batum,PHI,PHI,LAL,,,21,17,14,11
22023,201587,22300239,"NOV 25, 2023",PHI @ OKC,W,32,4,7,0.571,3,6,0.5,3,4,0.75,4,3,7,3,0,2,1,0,14,14,1,Nicolas Batum,PHI,OKC,PHI,,,24,21,17,10
22023,201587,22300232,"NOV 22, 2023",PHI @ MIN,L,24,2,4,0.5,2,4,0.5,0,0,0.0,0,3,3,0,0,1,1,2,6,-23,1,Nicolas Batum,PHI,MIN,PHI,,,9,9,6,3
22023,201587,22300040,"NOV 21, 2023",PHI vs. CLE,L,27,2,5,0.4,1,4,0.25,0,0,0.0,0,4,4,2,0,0,2,5,5,-3,1,Nicolas Batum,PHI,PHI,CLE,,,11,9,7,6
22023,201587,22300208,"NOV 19, 2023",PHI @ BKN,W,24,1,1,1.0,1,1,1.0,0,0,0.0,0,3,3,3,0,0,0,2,3,25,1,Nicolas Batum,PHI,BKN,PHI,,,9,6,6,6
22023,201587,22300180,"NOV 12, 2023",PHI vs. IND,W,33,3,5,0.6,3,5,0.6,0,0,0.0,2,5,7,0,1,3,1,2,9,1,1,Nicolas Batum,PHI,PHI,IND,,,16,16,9,7
22023,201587,22300008,"NOV 10, 2023",PHI @ DET,W,26,1,2,0.5,1,2,0.5,0,0,0.0,1,2,3,3,1,0,0,4,3,13,1,Nicolas Batum,PHI,DET,PHI,,,9,6,6,6
22023,201587,22300159,"NOV 08, 2023",PHI vs. BOS,W,26,2,3,0.667,1,2,0.5,0,0,0.0,2,2,4,1,0,1,0,2,5,7,1,Nicolas Batum,PHI,PHI,BOS,,,10,9,6,5
22023,201587,22300148,"NOV 06, 2023",PHI vs. WAS,W,17,4,5,0.8,3,4,0.75,0,0,0.0,0,2,2,0,1,0,0,1,11,28,1,Nicolas Batum,PHI,PHI,WAS,,,13,13,11,2
22023,201587,22300099,"OCT 29, 2023",LAC vs. SAS,W,15,0,4,0.0,0,4,0.0,0,0,0.0,0,2,2,1,1,0,1,1,0,6,1,Nicolas Batum,LAC,LAC,SAS,,,3,2,1,3
22023,201587,22300085,"OCT 27, 2023",LAC @ UTA,L,30,3,4,0.75,2,3,0.667,0,0,0.0,0,2,2,3,1,3,0,4,8,-4,1,Nicolas Batum,LAC,UTA,LAC,,,13,10,11,5
22023,201587,22300074,"OCT 25, 2023",LAC vs. POR,W,9,0,0,0.0,0,0,0.0,0,0,0.0,0,3,3,1,1,1,0,0,0,-2,1,Nicolas Batum,LAC,LAC,POR,,,4,3,1,4
22023,203078,22300554,"JAN 14, 2024",PHX @ POR,W,37,9,13,0.692,4,6,0.667,1,3,0.333,0,4,4,5,2,0,4,4,23,4,1,Bradley Beal,PHX,POR,PHX,20.5,Points,32,27,28,9
22023,203078,22300554,"JAN 14, 2024",PHX @ POR,W,37,9,13,0.692,4,6,0.667,1,3,0.333,0,4,4,5,2,0,4,4,23,4,1,Bradley Beal,PHX,POR,PHX,4.5,Rebounds,32,27,28,9
22023,203078,22300554,"JAN 14, 2024",PHX @ POR,W,37,9,13,0.692,4,6,0.667,1,3,0.333,0,4,4,5,2,0,4,4,23,4,1,Bradley Beal,PHX,POR,PHX,30.5,Pts+Rebs+Asts,32,27,28,9
22023,203078,22300554,"JAN 14, 2024",PHX @ POR,W,37,9,13,0.692,4,6,0.667,1,3,0.333,0,4,4,5,2,0,4,4,23,4,1,Bradley Beal,PHX,POR,PHX,35.0,Fantasy Score,32,27,28,9
22023,203078,22300554,"JAN 14, 2024",PHX @ POR,W,37,9,13,0.692,4,6,0.667,1,3,0.333,0,4,4,5,2,0,4,4,23,4,1,Bradley Beal,PHX,POR,PHX,15.5,FG Attempted,32,27,28,9
22023,203078,22300554,"JAN 14, 2024",PHX @ POR,W,37,9,13,0.692,4,6,0.667,1,3,0.333,0,4,4,5,2,0,4,4,23,4,1,Bradley Beal,PHX,POR,PHX,25.5,Pts+Rebs,32,27,28,9
22023,203078,22300554,"JAN 14, 2024",PHX @ POR,W,37,9,13,0.692,4,6,0.667,1,3,0.333,0,4,4,5,2,0,4,4,23,4,1,Bradley Beal,PHX,POR,PHX,25.5,Pts+Asts,32,27,28,9
22023,203078,22300554,"JAN 14, 2024",PHX @ POR,W,37,9,13,0.692,4,6,0.667,1,3,0.333,0,4,4,5,2,0,4,4,23,4,1,Bradley Beal,PHX,POR,PHX,9.5,Rebs+Asts,32,27,28,9
22023,203078,22300554,"JAN 14, 2024",PHX @ POR,W,37,9,13,0.692,4,6,0.667,1,3,0.333,0,4,4,5,2,0,4,4,23,4,1,Bradley Beal,PHX,POR,PHX,1.5,Blks+Stls,32,27,28,9
22023,203078,22300531,"JAN 11, 2024",PHX @ LAL,W,32,14,21,0.667,8,10,0.8,1,1,1.0,2,4,6,4,1,0,3,3,37,25,1,Bradley Beal,PHX,LAL,PHX,20.5,Points,47,43,41,10
22023,203078,22300531,"JAN 11, 2024",PHX @ LAL,W,32,14,21,0.667,8,10,0.8,1,1,1.0,2,4,6,4,1,0,3,3,37,25,1,Bradley Beal,PHX,LAL,PHX,4.5,Rebounds,47,43,41,10
22023,203078,22300531,"JAN 11, 2024",PHX @ LAL,W,32,14,21,0.667,8,10,0.8,1,1,1.0,2,4,6,4,1,0,3,3,37,25,1,Bradley Beal,PHX,LAL,PHX,30.5,Pts+Rebs+Asts,47,43,41,10
22023,203078,22300531,"JAN 11, 2024",PHX @ LAL,W,32,14,21,0.667,8,10,0.8,1,1,1.0,2,4,6,4,1,0,3,3,37,25,1,Bradley Beal,PHX,LAL,PHX,35.0,Fantasy Score,47,43,41,10
22023,203078,22300531,"JAN 11, 2024",PHX @ LAL,W,32,14,21,0.667,8,10,0.8,1,1,1.0,2,4,6,4,1,0,3,3,37,25,1,Bradley Beal,PHX,LAL,PHX,15.5,FG Attempted,47,43,41,10
22023,203078,22300531,"JAN 11, 2024",PHX @ LAL,W,32,14,21,0.667,8,10,0.8,1,1,1.0,2,4,6,4,1,0,3,3,37,25,1,Bradley Beal,PHX,LAL,PHX,25.5,Pts+Rebs,47,43,41,10
22023,203078,22300531,"JAN 11, 2024",PHX @ LAL,W,32,14,21,0.667,8,10,0.8,1,1,1.0,2,4,6,4,1,0,3,3,37,25,1,Bradley Beal,PHX,LAL,PHX,25.5,Pts+Asts,47,43,41,10
22023,203078,22300531,"JAN 11, 2024",PHX @ LAL,W,32,14,21,0.667,8,10,0.8,1,1,1.0,2,4,6,4,1,0,3,3,37,25,1,Bradley Beal,PHX,LAL,PHX,9.5,Rebs+Asts,47,43,41,10
22023,203078,22300531,"JAN 11, 2024",PHX @ LAL,W,32,14,21,0.667,8,10,0.8,1,1,1.0,2,4,6,4,1,0,3,3,37,25,1,Bradley Beal,PHX,LAL,PHX,1.5,Blks+Stls,47,43,41,10
22023,203078,22300511,"JAN 08, 2024",PHX @ LAC,L,35,7,15,0.467,0,2,0.0,1,2,0.5,0,3,3,2,2,0,2,4,15,-7,1,Bradley Beal,PHX,LAC,PHX,20.5,Points,20,18,17,5
22023,203078,22300511,"JAN 08, 2024",PHX @ LAC,L,35,7,15,0.467,0,2,0.0,1,2,0.5,0,3,3,2,2,0,2,4,15,-7,1,Bradley Beal,PHX,LAC,PHX,4.5,Rebounds,20,18,17,5
22023,203078,22300511,"JAN 08, 2024",PHX @ LAC,L,35,7,15,0.467,0,2,0.0,1,2,0.5,0,3,3,2,2,0,2,4,15,-7,1,Bradley Beal,PHX,LAC,PHX,30.5,Pts+Rebs+Asts,20,18,17,5
22023,203078,22300511,"JAN 08, 2024",PHX @ LAC,L,35,7,15,0.467,0,2,0.0,1,2,0.5,0,3,3,2,2,0,2,4,15,-7,1,Bradley Beal,PHX,LAC,PHX,35.0,Fantasy Score,20,18,17,5
22023,203078,22300511,"JAN 08, 2024",PHX @ LAC,L,35,7,15,0.467,0,2,0.0,1,2,0.5,0,3,3,2,2,0,2,4,15,-7,1,Bradley Beal,PHX,LAC,PHX,15.5,FG Attempted,20,18,17,5
22023,203078,22300511,"JAN 08, 2024",PHX @ LAC,L,35,7,15,0.467,0,2,0.0,1,2,0.5,0,3,3,2,2,0,2,4,15,-7,1,Bradley Beal,PHX,LAC,PHX,25.5,Pts+Rebs,20,18,17,5
22023,203078,22300511,"JAN 08, 2024",PHX @ LAC,L,35,7,15,0.467,0,2,0.0,1,2,0.5,0,3,3,2,2,0,2,4,15,-7,1,Bradley Beal,PHX,LAC,PHX,25.5,Pts+Asts,20,18,17,5
22023,203078,22300511,"JAN 08, 2024",PHX @ LAC,L,35,7,15,0.467,0,2,0.0,1,2,0.5,0,3,3,2,2,0,2,4,15,-7,1,Bradley Beal,PHX,LAC,PHX,9.5,Rebs+Asts,20,18,17,5
22023,203078,22300511,"JAN 08, 2024",PHX @ LAC,L,35,7,15,0.467,0,2,0.0,1,2,0.5,0,3,3,2,2,0,2,4,15,-7,1,Bradley Beal,PHX,LAC,PHX,1.5,Blks+Stls,20,18,17,5
22023,203078,22300503,"JAN 07, 2024",PHX vs. MEM,L,37,5,12,0.417,0,1,0.0,2,4,0.5,3,3,6,5,0,0,1,3,12,-8,1,Bradley Beal,PHX,PHX,MEM,20.5,Points,23,18,17,11
22023,203078,22300503,"JAN 07, 2024",PHX vs. MEM,L,37,5,12,0.417,0,1,0.0,2,4,0.5,3,3,6,5,0,0,1,3,12,-8,1,Bradley Beal,PHX,PHX,MEM,4.5,Rebounds,23,18,17,11
22023,203078,22300503,"JAN 07, 2024",PHX vs. MEM,L,37,5,12,0.417,0,1,0.0,2,4,0.5,3,3,6,5,0,0,1,3,12,-8,1,Bradley Beal,PHX,PHX,MEM,30.5,Pts+Rebs+Asts,23,18,17,11
22023,203078,22300503,"JAN 07, 2024",PHX vs. MEM,L,37,5,12,0.417,0,1,0.0,2,4,0.5,3,3,6,5,0,0,1,3,12,-8,1,Bradley Beal,PHX,PHX,MEM,35.0,Fantasy Score,23,18,17,11
22023,203078,22300503,"JAN 07, 2024",PHX vs. MEM,L,37,5,12,0.417,0,1,0.0,2,4,0.5,3,3,6,5,0,0,1,3,12,-8,1,Bradley Beal,PHX,PHX,MEM,15.5,FG Attempted,23,18,17,11
22023,203078,22300503,"JAN 07, 2024",PHX vs. MEM,L,37,5,12,0.417,0,1,0.0,2,4,0.5,3,3,6,5,0,0,1,3,12,-8,1,Bradley Beal,PHX,PHX,MEM,25.5,Pts+Rebs,23,18,17,11
22023,203078,22300503,"JAN 07, 2024",PHX vs. MEM,L,37,5,12,0.417,0,1,0.0,2,4,0.5,3,3,6,5,0,0,1,3,12,-8,1,Bradley Beal,PHX,PHX,MEM,25.5,Pts+Asts,23,18,17,11
22023,203078,22300503,"JAN 07, 2024",PHX vs. MEM,L,37,5,12,0.417,0,1,0.0,2,4,0.5,3,3,6,5,0,0,1,3,12,-8,1,Bradley Beal,PHX,PHX,MEM,9.5,Rebs+Asts,23,18,17,11
22023,203078,22300503,"JAN 07, 2024",PHX vs. MEM,L,37,5,12,0.417,0,1,0.0,2,4,0.5,3,3,6,5,0,0,1,3,12,-8,1,Bradley Beal,PHX,PHX,MEM,1.5,Blks+Stls,23,18,17,11
22023,203078,22300489,"JAN 05, 2024",PHX vs. MIA,W,37,11,18,0.611,2,6,0.333,1,1,1.0,1,7,8,9,0,0,2,2,25,27,1,Bradley Beal,PHX,PHX,MIA,20.5,Points,42,33,34,17
22023,203078,22300489,"JAN 05, 2024",PHX vs. MIA,W,37,11,18,0.611,2,6,0.333,1,1,1.0,1,7,8,9,0,0,2,2,25,27,1,Bradley Beal,PHX,PHX,MIA,4.5,Rebounds,42,33,34,17
22023,203078,22300489,"JAN 05, 2024",PHX vs. MIA,W,37,11,18,0.611,2,6,0.333,1,1,1.0,1,7,8,9,0,0,2,2,25,27,1,Bradley Beal,PHX,PHX,MIA,30.5,Pts+Rebs+Asts,42,33,34,17
22023,203078,22300489,"JAN 05, 2024",PHX vs. MIA,W,37,11,18,0.611,2,6,0.333,1,1,1.0,1,7,8,9,0,0,2,2,25,27,1,Bradley Beal,PHX,PHX,MIA,35.0,Fantasy Score,42,33,34,17
22023,203078,22300489,"JAN 05, 2024",PHX vs. MIA,W,37,11,18,0.611,2,6,0.333,1,1,1.0,1,7,8,9,0,0,2,2,25,27,1,Bradley Beal,PHX,PHX,MIA,15.5,FG Attempted,42,33,34,17
22023,203078,22300489,"JAN 05, 2024",PHX vs. MIA,W,37,11,18,0.611,2,6,0.333,1,1,1.0,1,7,8,9,0,0,2,2,25,27,1,Bradley Beal,PHX,PHX,MIA,25.5,Pts+Rebs,42,33,34,17
22023,203078,22300489,"JAN 05, 2024",PHX vs. MIA,W,37,11,18,0.611,2,6,0.333,1,1,1.0,1,7,8,9,0,0,2,2,25,27,1,Bradley Beal,PHX,PHX,MIA,25.5,Pts+Asts,42,33,34,17
22023,203078,22300489,"JAN 05, 2024",PHX vs. MIA,W,37,11,18,0.611,2,6,0.333,1,1,1.0,1,7,8,9,0,0,2,2,25,27,1,Bradley Beal,PHX,PHX,MIA,9.5,Rebs+Asts,42,33,34,17
22023,203078,22300489,"JAN 05, 2024",PHX vs. MIA,W,37,11,18,0.611,2,6,0.333,1,1,1.0,1,7,8,9,0,0,2,2,25,27,1,Bradley Beal,PHX,PHX,MIA,1.5,Blks+Stls,42,33,34,17
22023,203078,22300473,"JAN 03, 2024",PHX vs. LAC,L,41,7,20,0.35,0,6,0.0,7,7,1.0,2,3,5,4,1,1,3,5,21,-7,1,Bradley Beal,PHX,PHX,LAC,20.5,Points,30,26,25,9
22023,203078,22300473,"JAN 03, 2024",PHX vs. LAC,L,41,7,20,0.35,0,6,0.0,7,7,1.0,2,3,5,4,1,1,3,5,21,-7,1,Bradley Beal,PHX,PHX,LAC,4.5,Rebounds,30,26,25,9
22023,203078,22300473,"JAN 03, 2024",PHX vs. LAC,L,41,7,20,0.35,0,6,0.0,7,7,1.0,2,3,5,4,1,1,3,5,21,-7,1,Bradley Beal,PHX,PHX,LAC,30.5,Pts+Rebs+Asts,30,26,25,9
22023,203078,22300473,"JAN 03, 2024",PHX vs. LAC,L,41,7,20,0.35,0,6,0.0,7,7,1.0,2,3,5,4,1,1,3,5,21,-7,1,Bradley Beal,PHX,PHX,LAC,35.0,Fantasy Score,30,26,25,9
22023,203078,22300473,"JAN 03, 2024",PHX vs. LAC,L,41,7,20,0.35,0,6,0.0,7,7,1.0,2,3,5,4,1,1,3,5,21,-7,1,Bradley Beal,PHX,PHX,LAC,15.5,FG Attempted,30,26,25,9
22023,203078,22300473,"JAN 03, 2024",PHX vs. LAC,L,41,7,20,0.35,0,6,0.0,7,7,1.0,2,3,5,4,1,1,3,5,21,-7,1,Bradley Beal,PHX,PHX,LAC,25.5,Pts+Rebs,30,26,25,9
22023,203078,22300473,"JAN 03, 2024",PHX vs. LAC,L,41,7,20,0.35,0,6,0.0,7,7,1.0,2,3,5,4,1,1,3,5,21,-7,1,Bradley Beal,PHX,PHX,LAC,25.5,Pts+Asts,30,26,25,9
22023,203078,22300473,"JAN 03, 2024",PHX vs. LAC,L,41,7,20,0.35,0,6,0.0,7,7,1.0,2,3,5,4,1,1,3,5,21,-7,1,Bradley Beal,PHX,PHX,LAC,9.5,Rebs+Asts,30,26,25,9
22023,203078,22300473,"JAN 03, 2024",PHX vs. LAC,L,41,7,20,0.35,0,6,0.0,7,7,1.0,2,3,5,4,1,1,3,5,21,-7,1,Bradley Beal,PHX,PHX,LAC,1.5,Blks+Stls,30,26,25,9
22023,203078,22300456,"JAN 01, 2024",PHX vs. POR,W,34,8,16,0.5,1,3,0.333,4,4,1.0,0,4,4,1,1,1,4,2,21,22,1,Bradley Beal,PHX,PHX,POR,20.5,Points,26,25,22,5
22023,203078,22300456,"JAN 01, 2024",PHX vs. POR,W,34,8,16,0.5,1,3,0.333,4,4,1.0,0,4,4,1,1,1,4,2,21,22,1,Bradley Beal,PHX,PHX,POR,4.5,Rebounds,26,25,22,5
22023,203078,22300456,"JAN 01, 2024",PHX vs. POR,W,34,8,16,0.5,1,3,0.333,4,4,1.0,0,4,4,1,1,1,4,2,21,22,1,Bradley Beal,PHX,PHX,POR,30.5,Pts+Rebs+Asts,26,25,22,5
22023,203078,22300456,"JAN 01, 2024",PHX vs. POR,W,34,8,16,0.5,1,3,0.333,4,4,1.0,0,4,4,1,1,1,4,2,21,22,1,Bradley Beal,PHX,PHX,POR,35.0,Fantasy Score,26,25,22,5
22023,203078,22300456,"JAN 01, 2024",PHX vs. POR,W,34,8,16,0.5,1,3,0.333,4,4,1.0,0,4,4,1,1,1,4,2,21,22,1,Bradley Beal,PHX,PHX,POR,15.5,FG Attempted,26,25,22,5
22023,203078,22300456,"JAN 01, 2024",PHX vs. POR,W,34,8,16,0.5,1,3,0.333,4,4,1.0,0,4,4,1,1,1,4,2,21,22,1,Bradley Beal,PHX,PHX,POR,25.5,Pts+Rebs,26,25,22,5
22023,203078,22300456,"JAN 01, 2024",PHX vs. POR,W,34,8,16,0.5,1,3,0.333,4,4,1.0,0,4,4,1,1,1,4,2,21,22,1,Bradley Beal,PHX,PHX,POR,25.5,Pts+Asts,26,25,22,5
22023,203078,22300456,"JAN 01, 2024",PHX vs. POR,W,34,8,16,0.5,1,3,0.333,4,4,1.0,0,4,4,1,1,1,4,2,21,22,1,Bradley Beal,PHX,PHX,POR,9.5,Rebs+Asts,26,25,22,5
22023,203078,22300456,"JAN 01, 2024",PHX vs. POR,W,34,8,16,0.5,1,3,0.333,4,4,1.0,0,4,4,1,1,1,4,2,21,22,1,Bradley Beal,PHX,PHX,POR,1.5,Blks+Stls,26,25,22,5
22023,203078,22300450,"DEC 31, 2023",PHX vs. ORL,W,35,10,13,0.769,1,2,0.5,4,4,1.0,0,1,1,2,1,1,1,1,25,-1,1,Bradley Beal,PHX,PHX,ORL,20.5,Points,28,26,27,3
22023,203078,22300450,"DEC 31, 2023",PHX vs. ORL,W,35,10,13,0.769,1,2,0.5,4,4,1.0,0,1,1,2,1,1,1,1,25,-1,1,Bradley Beal,PHX,PHX,ORL,4.5,Rebounds,28,26,27,3
22023,203078,22300450,"DEC 31, 2023",PHX vs. ORL,W,35,10,13,0.769,1,2,0.5,4,4,1.0,0,1,1,2,1,1,1,1,25,-1,1,Bradley Beal,PHX,PHX,ORL,30.5,Pts+Rebs+Asts,28,26,27,3
22023,203078,22300450,"DEC 31, 2023",PHX vs. ORL,W,35,10,13,0.769,1,2,0.5,4,4,1.0,0,1,1,2,1,1,1,1,25,-1,1,Bradley Beal,PHX,PHX,ORL,35.0,Fantasy Score,28,26,27,3
22023,203078,22300450,"DEC 31, 2023",PHX vs. ORL,W,35,10,13,0.769,1,2,0.5,4,4,1.0,0,1,1,2,1,1,1,1,25,-1,1,Bradley Beal,PHX,PHX,ORL,15.5,FG Attempted,28,26,27,3
22023,203078,22300450,"DEC 31, 2023",PHX vs. ORL,W,35,10,13,0.769,1,2,0.5,4,4,1.0,0,1,1,2,1,1,1,1,25,-1,1,Bradley Beal,PHX,PHX,ORL,25.5,Pts+Rebs,28,26,27,3
22023,203078,22300450,"DEC 31, 2023",PHX vs. ORL,W,35,10,13,0.769,1,2,0.5,4,4,1.0,0,1,1,2,1,1,1,1,25,-1,1,Bradley Beal,PHX,PHX,ORL,25.5,Pts+Asts,28,26,27,3
22023,203078,22300450,"DEC 31, 2023",PHX vs. ORL,W,35,10,13,0.769,1,2,0.5,4,4,1.0,0,1,1,2,1,1,1,1,25,-1,1,Bradley Beal,PHX,PHX,ORL,9.5,Rebs+Asts,28,26,27,3
22023,203078,22300450,"DEC 31, 2023",PHX vs. ORL,W,35,10,13,0.769,1,2,0.5,4,4,1.0,0,1,1,2,1,1,1,1,25,-1,1,Bradley Beal,PHX,PHX,ORL,1.5,Blks+Stls,28,26,27,3
22023,203078,22300436,"DEC 29, 2023",PHX vs. CHA,W,30,3,8,0.375,0,2,0.0,0,0,0.0,0,3,3,7,0,1,2,2,6,-1,1,Bradley Beal,PHX,PHX,CHA,20.5,Points,16,9,13,10
22023,203078,22300436,"DEC 29, 2023",PHX vs. CHA,W,30,3,8,0.375,0,2,0.0,0,0,0.0,0,3,3,7,0,1,2,2,6,-1,1,Bradley Beal,PHX,PHX,CHA,4.5,Rebounds,16,9,13,10
22023,203078,22300436,"DEC 29, 2023",PHX vs. CHA,W,30,3,8,0.375,0,2,0.0,0,0,0.0,0,3,3,7,0,1,2,2,6,-1,1,Bradley Beal,PHX,PHX,CHA,30.5,Pts+Rebs+Asts,16,9,13,10
22023,203078,22300436,"DEC 29, 2023",PHX vs. CHA,W,30,3,8,0.375,0,2,0.0,0,0,0.0,0,3,3,7,0,1,2,2,6,-1,1,Bradley Beal,PHX,PHX,CHA,35.0,Fantasy Score,16,9,13,10
22023,203078,22300436,"DEC 29, 2023",PHX vs. CHA,W,30,3,8,0.375,0,2,0.0,0,0,0.0,0,3,3,7,0,1,2,2,6,-1,1,Bradley Beal,PHX,PHX,CHA,15.5,FG Attempted,16,9,13,10
22023,203078,22300436,"DEC 29, 2023",PHX vs. CHA,W,30,3,8,0.375,0,2,0.0,0,0,0.0,0,3,3,7,0,1,2,2,6,-1,1,Bradley Beal,PHX,PHX,CHA,25.5,Pts+Rebs,16,9,13,10
22023,203078,22300436,"DEC 29, 2023",PHX vs. CHA,W,30,3,8,0.375,0,2,0.0,0,0,0.0,0,3,3,7,0,1,2,2,6,-1,1,Bradley Beal,PHX,PHX,CHA,25.5,Pts+Asts,16,9,13,10
22023,203078,22300436,"DEC 29, 2023",PHX vs. CHA,W,30,3,8,0.375,0,2,0.0,0,0,0.0,0,3,3,7,0,1,2,2,6,-1,1,Bradley Beal,PHX,PHX,CHA,9.5,Rebs+Asts,16,9,13,10
22023,203078,22300436,"DEC 29, 2023",PHX vs. CHA,W,30,3,8,0.375,0,2,0.0,0,0,0.0,0,3,3,7,0,1,2,2,6,-1,1,Bradley Beal,PHX,PHX,CHA,1.5,Blks+Stls,16,9,13,10
22023,203078,22300333,"DEC 15, 2023",PHX vs. NYK,L,5,2,2,1.0,1,1,1.0,1,1,1.0,0,0,0,1,0,0,0,0,6,3,1,Bradley Beal,PHX,PHX,NYK,20.5,Points,7,6,7,1
22023,203078,22300333,"DEC 15, 2023",PHX vs. NYK,L,5,2,2,1.0,1,1,1.0,1,1,1.0,0,0,0,1,0,0,0,0,6,3,1,Bradley Beal,PHX,PHX,NYK,4.5,Rebounds,7,6,7,1
22023,203078,22300333,"DEC 15, 2023",PHX vs. NYK,L,5,2,2,1.0,1,1,1.0,1,1,1.0,0,0,0,1,0,0,0,0,6,3,1,Bradley Beal,PHX,PHX,NYK,30.5,Pts+Rebs+Asts,7,6,7,1
22023,203078,22300333,"DEC 15, 2023",PHX vs. NYK,L,5,2,2,1.0,1,1,1.0,1,1,1.0,0,0,0,1,0,0,0,0,6,3,1,Bradley Beal,PHX,PHX,NYK,35.0,Fantasy Score,7,6,7,1
22023,203078,22300333,"DEC 15, 2023",PHX vs. NYK,L,5,2,2,1.0,1,1,1.0,1,1,1.0,0,0,0,1,0,0,0,0,6,3,1,Bradley Beal,PHX,PHX,NYK,15.5,FG Attempted,7,6,7,1
22023,203078,22300333,"DEC 15, 2023",PHX vs. NYK,L,5,2,2,1.0,1,1,1.0,1,1,1.0,0,0,0,1,0,0,0,0,6,3,1,Bradley Beal,PHX,PHX,NYK,25.5,Pts+Rebs,7,6,7,1
22023,203078,22300333,"DEC 15, 2023",PHX vs. NYK,L,5,2,2,1.0,1,1,1.0,1,1,1.0,0,0,0,1,0,0,0,0,6,3,1,Bradley Beal,PHX,PHX,NYK,25.5,Pts+Asts,7,6,7,1
22023,203078,22300333,"DEC 15, 2023",PHX vs. NYK,L,5,2,2,1.0,1,1,1.0,1,1,1.0,0,0,0,1,0,0,0,0,6,3,1,Bradley Beal,PHX,PHX,NYK,9.5,Rebs+Asts,7,6,7,1
22023,203078,22300333,"DEC 15, 2023",PHX vs. NYK,L,5,2,2,1.0,1,1,1.0,1,1,1.0,0,0,0,1,0,0,0,0,6,3,1,Bradley Beal,PHX,PHX,NYK,1.5,Blks+Stls,7,6,7,1
22023,203078,22300317,"DEC 13, 2023",PHX vs. BKN,L,34,6,9,0.667,2,2,1.0,0,0,0.0,0,1,1,4,1,0,2,1,14,-11,1,Bradley Beal,PHX,PHX,BKN,20.5,Points,19,15,18,5
22023,203078,22300317,"DEC 13, 2023",PHX vs. BKN,L,34,6,9,0.667,2,2,1.0,0,0,0.0,0,1,1,4,1,0,2,1,14,-11,1,Bradley Beal,PHX,PHX,BKN,4.5,Rebounds,19,15,18,5
22023,203078,22300317,"DEC 13, 2023",PHX vs. BKN,L,34,6,9,0.667,2,2,1.0,0,0,0.0,0,1,1,4,1,0,2,1,14,-11,1,Bradley Beal,PHX,PHX,BKN,30.5,Pts+Rebs+Asts,19,15,18,5
22023,203078,22300317,"DEC 13, 2023",PHX vs. BKN,L,34,6,9,0.667,2,2,1.0,0,0,0.0,0,1,1,4,1,0,2,1,14,-11,1,Bradley Beal,PHX,PHX,BKN,35.0,Fantasy Score,19,15,18,5
22023,203078,22300317,"DEC 13, 2023",PHX vs. BKN,L,34,6,9,0.667,2,2,1.0,0,0,0.0,0,1,1,4,1,0,2,1,14,-11,1,Bradley Beal,PHX,PHX,BKN,15.5,FG Attempted,19,15,18,5
22023,203078,22300317,"DEC 13, 2023",PHX vs. BKN,L,34,6,9,0.667,2,2,1.0,0,0,0.0,0,1,1,4,1,0,2,1,14,-11,1,Bradley Beal,PHX,PHX,BKN,25.5,Pts+Rebs,19,15,18,5
22023,203078,22300317,"DEC 13, 2023",PHX vs. BKN,L,34,6,9,0.667,2,2,1.0,0,0,0.0,0,1,1,4,1,0,2,1,14,-11,1,Bradley Beal,PHX,PHX,BKN,25.5,Pts+Asts,19,15,18,5
22023,203078,22300317,"DEC 13, 2023",PHX vs. BKN,L,34,6,9,0.667,2,2,1.0,0,0,0.0,0,1,1,4,1,0,2,1,14,-11,1,Bradley Beal,PHX,PHX,BKN,9.5,Rebs+Asts,19,15,18,5
22023,203078,22300317,"DEC 13, 2023",PHX vs. BKN,L,34,6,9,0.667,2,2,1.0,0,0,0.0,0,1,1,4,1,0,2,1,14,-11,1,Bradley Beal,PHX,PHX,BKN,1.5,Blks+Stls,19,15,18,5
22023,203078,22300308,"DEC 12, 2023",PHX vs. GSW,W,27,5,12,0.417,1,3,0.333,5,7,0.714,0,3,3,3,1,1,3,3,16,-15,1,Bradley Beal,PHX,PHX,GSW,20.5,Points,22,19,19,6
22023,203078,22300308,"DEC 12, 2023",PHX vs. GSW,W,27,5,12,0.417,1,3,0.333,5,7,0.714,0,3,3,3,1,1,3,3,16,-15,1,Bradley Beal,PHX,PHX,GSW,4.5,Rebounds,22,19,19,6
22023,203078,22300308,"DEC 12, 2023",PHX vs. GSW,W,27,5,12,0.417,1,3,0.333,5,7,0.714,0,3,3,3,1,1,3,3,16,-15,1,Bradley Beal,PHX,PHX,GSW,30.5,Pts+Rebs+Asts,22,19,19,6
22023,203078,22300308,"DEC 12, 2023",PHX vs. GSW,W,27,5,12,0.417,1,3,0.333,5,7,0.714,0,3,3,3,1,1,3,3,16,-15,1,Bradley Beal,PHX,PHX,GSW,35.0,Fantasy Score,22,19,19,6
22023,203078,22300308,"DEC 12, 2023",PHX vs. GSW,W,27,5,12,0.417,1,3,0.333,5,7,0.714,0,3,3,3,1,1,3,3,16,-15,1,Bradley Beal,PHX,PHX,GSW,15.5,FG Attempted,22,19,19,6
22023,203078,22300308,"DEC 12, 2023",PHX vs. GSW,W,27,5,12,0.417,1,3,0.333,5,7,0.714,0,3,3,3,1,1,3,3,16,-15,1,Bradley Beal,PHX,PHX,GSW,25.5,Pts+Rebs,22,19,19,6
22023,203078,22300308,"DEC 12, 2023",PHX vs. GSW,W,27,5,12,0.417,1,3,0.333,5,7,0.714,0,3,3,3,1,1,3,3,16,-15,1,Bradley Beal,PHX,PHX,GSW,25.5,Pts+Asts,22,19,19,6
22023,203078,22300308,"DEC 12, 2023",PHX vs. GSW,W,27,5,12,0.417,1,3,0.333,5,7,0.714,0,3,3,3,1,1,3,3,16,-15,1,Bradley Beal,PHX,PHX,GSW,9.5,Rebs+Asts,22,19,19,6
22023,203078,22300308,"DEC 12, 2023",PHX vs. GSW,W,27,5,12,0.417,1,3,0.333,5,7,0.714,0,3,3,3,1,1,3,3,16,-15,1,Bradley Beal,PHX,PHX,GSW,1.5,Blks+Stls,22,19,19,6
22023,203078,22300185,"NOV 12, 2023",PHX vs. OKC,L,30,6,17,0.353,0,5,0.0,3,6,0.5,1,7,8,5,0,0,5,5,15,-18,1,Bradley Beal,PHX,PHX,OKC,20.5,Points,28,23,20,13
22023,203078,22300185,"NOV 12, 2023",PHX vs. OKC,L,30,6,17,0.353,0,5,0.0,3,6,0.5,1,7,8,5,0,0,5,5,15,-18,1,Bradley Beal,PHX,PHX,OKC,4.5,Rebounds,28,23,20,13
22023,203078,22300185,"NOV 12, 2023",PHX vs. OKC,L,30,6,17,0.353,0,5,0.0,3,6,0.5,1,7,8,5,0,0,5,5,15,-18,1,Bradley Beal,PHX,PHX,OKC,30.5,Pts+Rebs+Asts,28,23,20,13
22023,203078,22300185,"NOV 12, 2023",PHX vs. OKC,L,30,6,17,0.353,0,5,0.0,3,6,0.5,1,7,8,5,0,0,5,5,15,-18,1,Bradley Beal,PHX,PHX,OKC,35.0,Fantasy Score,28,23,20,13
22023,203078,22300185,"NOV 12, 2023",PHX vs. OKC,L,30,6,17,0.353,0,5,0.0,3,6,0.5,1,7,8,5,0,0,5,5,15,-18,1,Bradley Beal,PHX,PHX,OKC,15.5,FG Attempted,28,23,20,13
22023,203078,22300185,"NOV 12, 2023",PHX vs. OKC,L,30,6,17,0.353,0,5,0.0,3,6,0.5,1,7,8,5,0,0,5,5,15,-18,1,Bradley Beal,PHX,PHX,OKC,25.5,Pts+Rebs,28,23,20,13
22023,203078,22300185,"NOV 12, 2023",PHX vs. OKC,L,30,6,17,0.353,0,5,0.0,3,6,0.5,1,7,8,5,0,0,5,5,15,-18,1,Bradley Beal,PHX,PHX,OKC,25.5,Pts+Asts,28,23,20,13
22023,203078,22300185,"NOV 12, 2023",PHX vs. OKC,L,30,6,17,0.353,0,5,0.0,3,6,0.5,1,7,8,5,0,0,5,5,15,-18,1,Bradley Beal,PHX,PHX,OKC,9.5,Rebs+Asts,28,23,20,13
22023,203078,22300185,"NOV 12, 2023",PHX vs. OKC,L,30,6,17,0.353,0,5,0.0,3,6,0.5,1,7,8,5,0,0,5,5,15,-18,1,Bradley Beal,PHX,PHX,OKC,1.5,Blks+Stls,28,23,20,13
22023,203078,22300015,"NOV 10, 2023",PHX vs. LAL,L,32,9,17,0.529,2,4,0.5,4,6,0.667,2,2,4,2,2,0,2,4,24,-14,1,Bradley Beal,PHX,PHX,LAL,20.5,Points,30,28,26,6
22023,203078,22300015,"NOV 10, 2023",PHX vs. LAL,L,32,9,17,0.529,2,4,0.5,4,6,0.667,2,2,4,2,2,0,2,4,24,-14,1,Bradley Beal,PHX,PHX,LAL,4.5,Rebounds,30,28,26,6
22023,203078,22300015,"NOV 10, 2023",PHX vs. LAL,L,32,9,17,0.529,2,4,0.5,4,6,0.667,2,2,4,2,2,0,2,4,24,-14,1,Bradley Beal,PHX,PHX,LAL,30.5,Pts+Rebs+Asts,30,28,26,6
22023,203078,22300015,"NOV 10, 2023",PHX vs. LAL,L,32,9,17,0.529,2,4,0.5,4,6,0.667,2,2,4,2,2,0,2,4,24,-14,1,Bradley Beal,PHX,PHX,LAL,35.0,Fantasy Score,30,28,26,6
22023,203078,22300015,"NOV 10, 2023",PHX vs. LAL,L,32,9,17,0.529,2,4,0.5,4,6,0.667,2,2,4,2,2,0,2,4,24,-14,1,Bradley Beal,PHX,PHX,LAL,15.5,FG Attempted,30,28,26,6
22023,203078,22300015,"NOV 10, 2023",PHX vs. LAL,L,32,9,17,0.529,2,4,0.5,4,6,0.667,2,2,4,2,2,0,2,4,24,-14,1,Bradley Beal,PHX,PHX,LAL,25.5,Pts+Rebs,30,28,26,6
22023,203078,22300015,"NOV 10, 2023",PHX vs. LAL,L,32,9,17,0.529,2,4,0.5,4,6,0.667,2,2,4,2,2,0,2,4,24,-14,1,Bradley Beal,PHX,PHX,LAL,25.5,Pts+Asts,30,28,26,6
22023,203078,22300015,"NOV 10, 2023",PHX vs. LAL,L,32,9,17,0.529,2,4,0.5,4,6,0.667,2,2,4,2,2,0,2,4,24,-14,1,Bradley Beal,PHX,PHX,LAL,9.5,Rebs+Asts,30,28,26,6
22023,203078,22300015,"NOV 10, 2023",PHX vs. LAL,L,32,9,17,0.529,2,4,0.5,4,6,0.667,2,2,4,2,2,0,2,4,24,-14,1,Bradley Beal,PHX,PHX,LAL,1.5,Blks+Stls,30,28,26,6
22023,203078,22300162,"NOV 08, 2023",PHX @ CHI,W,24,3,12,0.25,3,6,0.5,4,4,1.0,0,4,4,4,0,1,2,0,13,16,1,Bradley Beal,PHX,CHI,PHX,20.5,Points,21,17,17,8
22023,203078,22300162,"NOV 08, 2023",PHX @ CHI,W,24,3,12,0.25,3,6,0.5,4,4,1.0,0,4,4,4,0,1,2,0,13,16,1,Bradley Beal,PHX,CHI,PHX,4.5,Rebounds,21,17,17,8
22023,203078,22300162,"NOV 08, 2023",PHX @ CHI,W,24,3,12,0.25,3,6,0.5,4,4,1.0,0,4,4,4,0,1,2,0,13,16,1,Bradley Beal,PHX,CHI,PHX,30.5,Pts+Rebs+Asts,21,17,17,8
22023,203078,22300162,"NOV 08, 2023",PHX @ CHI,W,24,3,12,0.25,3,6,0.5,4,4,1.0,0,4,4,4,0,1,2,0,13,16,1,Bradley Beal,PHX,CHI,PHX,35.0,Fantasy Score,21,17,17,8
22023,203078,22300162,"NOV 08, 2023",PHX @ CHI,W,24,3,12,0.25,3,6,0.5,4,4,1.0,0,4,4,4,0,1,2,0,13,16,1,Bradley Beal,PHX,CHI,PHX,15.5,FG Attempted,21,17,17,8
22023,203078,22300162,"NOV 08, 2023",PHX @ CHI,W,24,3,12,0.25,3,6,0.5,4,4,1.0,0,4,4,4,0,1,2,0,13,16,1,Bradley Beal,PHX,CHI,PHX,25.5,Pts+Rebs,21,17,17,8
22023,203078,22300162,"NOV 08, 2023",PHX @ CHI,W,24,3,12,0.25,3,6,0.5,4,4,1.0,0,4,4,4,0,1,2,0,13,16,1,Bradley Beal,PHX,CHI,PHX,25.5,Pts+Asts,21,17,17,8
22023,203078,22300162,"NOV 08, 2023",PHX @ CHI,W,24,3,12,0.25,3,6,0.5,4,4,1.0,0,4,4,4,0,1,2,0,13,16,1,Bradley Beal,PHX,CHI,PHX,9.5,Rebs+Asts,21,17,17,8
22023,203078,22300162,"NOV 08, 2023",PHX @ CHI,W,24,3,12,0.25,3,6,0.5,4,4,1.0,0,4,4,4,0,1,2,0,13,16,1,Bradley Beal,PHX,CHI,PHX,1.5,Blks+Stls,21,17,17,8
22023,1627736,22300552,"JAN 14, 2024",MIL vs. SAC,W,45,7,12,0.583,5,9,0.556,4,4,1.0,0,4,4,5,1,0,1,5,23,-1,1,Malik Beasley,MIL,MIL,SAC,,,32,27,28,9
22023,1627736,22300545,"JAN 13, 2024",MIL vs. GSW,W,29,4,8,0.5,3,6,0.5,0,0,0.0,2,2,4,1,2,0,1,1,11,14,1,Malik Beasley,MIL,MIL,GSW,,,16,15,12,5
22023,1627736,22300528,"JAN 11, 2024",MIL vs. BOS,W,27,6,11,0.545,4,8,0.5,0,0,0.0,1,3,4,0,0,0,0,0,16,18,1,Malik Beasley,MIL,MIL,BOS,,,20,20,16,4
22023,1627736,22300510,"JAN 08, 2024",MIL vs. UTA,L,24,6,12,0.5,5,8,0.625,0,0,0.0,1,3,4,2,1,1,0,1,17,-12,1,Malik Beasley,MIL,MIL,UTA,,,23,21,19,6
22023,1627736,22300496,"JAN 06, 2024",MIL @ HOU,L,16,1,1,1.0,1,1,1.0,0,0,0.0,0,1,1,0,0,0,2,2,3,-10,1,Malik Beasley,MIL,HOU,MIL,,,4,4,3,1
22023,1627736,22300477,"JAN 04, 2024",MIL @ SAS,W,27,4,6,0.667,2,4,0.5,0,0,0.0,0,2,2,0,0,0,2,0,10,4,1,Malik Beasley,MIL,SAS,MIL,,,12,12,10,2
22023,1627736,22300466,"JAN 03, 2024",MIL @ IND,L,23,3,8,0.375,2,5,0.4,0,0,0.0,0,1,1,1,0,0,0,4,8,-17,1,Malik Beasley,MIL,IND,MIL,,,10,9,9,2
22023,1627736,22300454,"JAN 01, 2024",MIL vs. IND,L,37,4,8,0.5,4,8,0.5,0,0,0.0,0,4,4,0,0,0,0,5,12,5,1,Malik Beasley,MIL,MIL,IND,,,16,16,12,4
22023,1627736,22300433,"DEC 29, 2023",MIL @ CLE,W,35,5,9,0.556,5,8,0.625,0,0,0.0,0,5,5,0,0,0,3,1,15,12,1,Malik Beasley,MIL,CLE,MIL,,,20,20,15,5
22023,1627736,22300417,"DEC 27, 2023",MIL @ BKN,W,22,6,9,0.667,5,8,0.625,0,0,0.0,1,0,1,1,1,0,0,0,17,-7,1,Malik Beasley,MIL,BKN,MIL,,,19,18,18,2
22023,1627736,22300401,"DEC 25, 2023",MIL @ NYK,L,19,0,2,0.0,0,1,0.0,0,0,0.0,0,3,3,2,0,0,0,2,0,-10,1,Malik Beasley,MIL,NYK,MIL,,,5,3,2,5
22023,1627736,22300388,"DEC 23, 2023",MIL @ NYK,W,31,7,13,0.538,5,9,0.556,0,0,0.0,1,5,6,1,0,0,0,3,19,19,1,Malik Beasley,MIL,NYK,MIL,,,26,25,20,7
22023,1627736,22300378,"DEC 21, 2023",MIL vs. ORL,W,28,3,8,0.375,2,4,0.5,0,0,0.0,1,4,5,2,0,0,0,1,8,15,1,Malik Beasley,MIL,MIL,ORL,,,15,13,10,7
22023,1627736,22300361,"DEC 19, 2023",MIL vs. SAS,W,28,3,7,0.429,1,5,0.2,0,0,0.0,1,3,4,2,1,0,0,1,7,14,1,Malik Beasley,MIL,MIL,SAS,,,13,11,9,6
22023,1627736,22300315,"DEC 13, 2023",MIL vs. IND,W,36,3,7,0.429,1,4,0.25,0,0,0.0,4,2,6,2,2,1,0,3,7,20,1,Malik Beasley,MIL,MIL,IND,,,15,13,9,8
22023,1627736,22300300,"DEC 11, 2023",MIL vs. CHI,W,40,7,11,0.636,5,8,0.625,0,0,0.0,0,4,4,2,1,0,0,2,19,6,1,Malik Beasley,MIL,MIL,CHI,,,25,23,21,6
22023,1627736,22301229,"DEC 07, 2023",MIL vs. IND,L,36,3,9,0.333,1,4,0.25,0,0,0.0,1,2,3,1,0,0,0,2,7,6,1,Malik Beasley,MIL,MIL,IND,,,11,10,8,4
22023,1627736,22301201,"DEC 05, 2023",MIL vs. NYK,W,33,6,11,0.545,6,10,0.6,0,0,0.0,0,3,3,0,0,0,0,4,18,16,1,Malik Beasley,MIL,MIL,NYK,,,21,21,18,3
22023,1627736,22300286,"DEC 02, 2023",MIL vs. ATL,W,39,6,11,0.545,4,7,0.571,0,0,0.0,1,3,4,3,1,0,2,1,16,2,1,Malik Beasley,MIL,MIL,ATL,,,23,20,19,7
22023,1627736,22300269,"NOV 30, 2023",MIL @ CHI,L,41,7,19,0.368,5,15,0.333,0,0,0.0,0,3,3,3,2,0,1,2,19,1,1,Malik Beasley,MIL,CHI,MIL,,,25,22,22,6
22023,1627736,22300056,"NOV 28, 2023",MIL @ MIA,W,38,6,11,0.545,4,8,0.5,0,0,0.0,0,10,10,1,0,2,0,1,16,15,1,Malik Beasley,MIL,MIA,MIL,,,27,26,17,11
22023,1627736,22300245,"NOV 26, 2023",MIL vs. POR,W,36,5,14,0.357,4,11,0.364,0,0,0.0,1,5,6,0,3,0,2,1,14,16,1,Malik Beasley,MIL,MIL,POR,,,20,20,14,6
22023,1627736,22300049,"NOV 24, 2023",MIL vs. WAS,W,27,4,8,0.5,1,4,0.25,0,0,0.0,4,7,11,1,0,1,2,3,9,4,1,Malik Beasley,MIL,MIL,WAS,,,21,20,10,12
22023,1627736,22300228,"NOV 22, 2023",MIL @ BOS,L,23,2,3,0.667,2,3,0.667,0,0,0.0,0,3,3,3,2,0,1,1,6,3,1,Malik Beasley,MIL,BOS,MIL,,,12,9,9,6
22023,1627736,22300219,"NOV 20, 2023",MIL @ WAS,W,33,5,9,0.556,3,5,0.6,3,3,1.0,1,4,5,2,0,0,0,0,16,20,1,Malik Beasley,MIL,WAS,MIL,,,23,21,18,7
22023,1627736,22300205,"NOV 18, 2023",MIL vs. DAL,W,34,3,9,0.333,1,6,0.167,0,0,0.0,0,6,6,0,1,0,0,3,7,5,1,Malik Beasley,MIL,MIL,DAL,,,13,13,7,6
22023,1627736,22300027,"NOV 17, 2023",MIL @ CHA,W,30,7,12,0.583,6,10,0.6,0,0,0.0,0,2,2,3,0,0,0,4,20,31,1,Malik Beasley,MIL,CHA,MIL,,,25,22,23,5
22023,1627736,22300195,"NOV 15, 2023",MIL @ TOR,W,31,11,14,0.786,8,11,0.727,0,0,0.0,0,4,4,0,1,0,0,2,30,34,1,Malik Beasley,MIL,TOR,MIL,,,34,34,30,4
22023,1627736,22300190,"NOV 13, 2023",MIL vs. CHI,W,21,3,6,0.5,3,6,0.5,0,0,0.0,1,1,2,0,0,0,0,3,9,-9,1,Malik Beasley,MIL,MIL,CHI,,,11,11,9,2
22023,1627736,22300173,"NOV 11, 2023",MIL @ ORL,L,20,0,4,0.0,0,3,0.0,0,0,0.0,0,2,2,1,0,0,1,3,0,-6,1,Malik Beasley,MIL,ORL,MIL,,,3,2,1,3
22023,1627736,22300171,"NOV 09, 2023",MIL @ IND,L,29,4,10,0.4,3,6,0.5,2,2,1.0,1,3,4,2,1,0,0,2,13,-10,1,Malik Beasley,MIL,IND,MIL,,,19,17,15,6
22023,1627736,22300165,"NOV 08, 2023",MIL vs. DET,W,25,4,6,0.667,1,2,0.5,1,1,1.0,2,4,6,2,1,0,0,0,10,24,1,Malik Beasley,MIL,MIL,DET,,,18,16,12,8
22023,1627736,22300149,"NOV 06, 2023",MIL @ BKN,W,14,1,5,0.2,1,5,0.2,0,0,0.0,0,6,6,0,0,0,1,2,3,-9,1,Malik Beasley,MIL,BKN,MIL,,,9,9,3,6
22023,1627736,22300002,"NOV 03, 2023",MIL vs. NYK,W,22,0,2,0.0,0,1,0.0,0,0,0.0,0,3,3,3,0,0,0,2,0,6,1,Malik Beasley,MIL,MIL,NYK,,,6,3,3,6
22023,1627736,22300116,"NOV 01, 2023",MIL @ TOR,L,25,7,10,0.7,6,9,0.667,0,0,0.0,0,2,2,0,2,0,0,2,20,-23,1,Malik Beasley,MIL,TOR,MIL,,,22,22,20,2
22023,1627736,22300107,"OCT 30, 2023",MIL vs. MIA,W,32,2,8,0.25,1,6,0.167,0,2,0.0,0,3,3,2,2,0,2,3,5,-10,1,Malik Beasley,MIL,MIL,MIA,,,10,8,7,5
22023,1627736,22300097,"OCT 29, 2023",MIL vs. ATL,L,32,6,12,0.5,4,10,0.4,2,4,0.5,1,3,4,1,2,0,2,3,18,-26,1,Malik Beasley,MIL,MIL,ATL,,,23,22,19,5
22023,1627736,22300075,"OCT 26, 2023",MIL vs. PHI,W,31,2,4,0.5,1,1,1.0,0,0,0.0,0,4,4,3,2,0,2,1,5,-5,1,Malik Beasley,MIL,MIL,PHI,,,12,9,8,7
22023,1630699,22300528,"JAN 11, 2024",MIL vs. BOS,W,12,0,2,0.0,0,2,0.0,0,0,0.0,0,1,1,0,0,1,1,0,0,-8,1,MarJon Beauchamp,MIL,MIL,BOS,,,1,1,0,1
22023,1630699,22300510,"JAN 08, 2024",MIL vs. UTA,L,14,1,6,0.167,1,4,0.25,0,0,0.0,0,2,2,3,2,0,0,1,3,4,1,MarJon Beauchamp,MIL,MIL,UTA,,,8,5,6,5
22023,1630699,22300496,"JAN 06, 2024",MIL @ HOU,L,23,2,4,0.5,1,3,0.333,0,0,0.0,1,3,4,3,0,1,1,1,5,2,1,MarJon Beauchamp,MIL,HOU,MIL,,,12,9,8,7
22023,1630699,22300477,"JAN 04, 2024",MIL @ SAS,W,17,3,8,0.375,2,4,0.5,0,0,0.0,2,1,3,0,0,0,1,1,8,-7,1,MarJon Beauchamp,MIL,SAS,MIL,,,11,11,8,3
22023,1630699,22300466,"JAN 03, 2024",MIL @ IND,L,21,6,9,0.667,0,3,0.0,0,0,0.0,1,2,3,1,0,0,1,1,12,-1,1,MarJon Beauchamp,MIL,IND,MIL,,,16,15,13,4
22023,1630699,22300433,"DEC 29, 2023",MIL @ CLE,W,11,2,3,0.667,1,2,0.5,0,0,0.0,1,0,1,0,0,0,0,2,5,1,1,MarJon Beauchamp,MIL,CLE,MIL,,,6,6,5,1
22023,1630699,22300417,"DEC 27, 2023",MIL @ BKN,W,21,4,6,0.667,2,3,0.667,1,2,0.5,0,5,5,2,1,0,0,2,11,21,1,MarJon Beauchamp,MIL,BKN,MIL,,,18,16,13,7
22023,1630699,22300401,"DEC 25, 2023",MIL @ NYK,L,6,0,0,0.0,0,0,0.0,0,0,0.0,0,1,1,0,1,0,0,0,0,4,1,MarJon Beauchamp,MIL,NYK,MIL,,,1,1,0,1
22023,1630699,22300388,"DEC 23, 2023",MIL @ NYK,W,0,0,0,0.0,0,0,0.0,0,0,0.0,0,1,1,0,0,0,0,0,0,0,1,MarJon Beauchamp,MIL,NYK,MIL,,,1,1,0,1
22023,1630699,22300378,"DEC 21, 2023",MIL vs. ORL,W,11,2,3,0.667,1,2,0.5,0,0,0.0,0,3,3,0,0,0,2,2,5,-4,1,MarJon Beauchamp,MIL,MIL,ORL,,,8,8,5,3
22023,1630699,22300361,"DEC 19, 2023",MIL vs. SAS,W,6,0,0,0.0,0,0,0.0,0,0,0.0,0,1,1,0,0,0,0,0,0,-6,1,MarJon Beauchamp,MIL,MIL,SAS,,,1,1,0,1
22023,1630699,22300346,"DEC 17, 2023",MIL vs. HOU,W,13,0,0,0.0,0,0,0.0,0,0,0.0,0,1,1,0,0,0,0,2,0,2,1,MarJon Beauchamp,MIL,MIL,HOU,,,1,1,0,1
22023,1630699,22300334,"DEC 16, 2023",MIL vs. DET,W,33,4,8,0.5,1,2,0.5,2,2,1.0,1,5,6,1,2,0,3,0,11,12,1,MarJon Beauchamp,MIL,MIL,DET,,,18,17,12,7
22023,1630699,22300315,"DEC 13, 2023",MIL vs. IND,W,15,3,4,0.75,0,0,0.0,0,0,0.0,0,3,3,0,0,0,3,2,6,-3,1,MarJon Beauchamp,MIL,MIL,IND,,,9,9,6,3
22023,1630699,22300300,"DEC 11, 2023",MIL vs. CHI,W,14,1,2,0.5,0,1,0.0,0,0,0.0,0,0,0,0,0,0,0,1,2,6,1,MarJon Beauchamp,MIL,MIL,CHI,,,2,2,2,0
22023,1630699,22301229,"DEC 07, 2023",MIL vs. IND,L,15,2,3,0.667,0,0,0.0,1,4,0.25,3,3,6,0,0,1,0,0,5,-17,1,MarJon Beauchamp,MIL,MIL,IND,,,11,11,5,6
22023,1630699,22301201,"DEC 05, 2023",MIL vs. NYK,W,19,2,3,0.667,2,2,1.0,0,0,0.0,0,2,2,1,1,0,0,1,6,9,1,MarJon Beauchamp,MIL,MIL,NYK,,,9,8,7,3
22023,1630699,22300286,"DEC 02, 2023",MIL vs. ATL,W,17,1,2,0.5,1,1,1.0,0,0,0.0,0,1,1,2,0,1,0,3,3,14,1,MarJon Beauchamp,MIL,MIL,ATL,,,6,4,5,3
22023,1630699,22300269,"NOV 30, 2023",MIL @ CHI,L,22,3,7,0.429,1,4,0.25,0,0,0.0,0,3,3,0,0,0,2,1,7,11,1,MarJon Beauchamp,MIL,CHI,MIL,,,10,10,7,3
22023,1630699,22300056,"NOV 28, 2023",MIL @ MIA,W,9,0,2,0.0,0,0,0.0,0,0,0.0,1,3,4,1,0,0,1,4,0,0,1,MarJon Beauchamp,MIL,MIA,MIL,,,5,4,1,5
22023,1630699,22300245,"NOV 26, 2023",MIL vs. POR,W,9,0,0,0.0,0,0,0.0,0,0,0.0,0,1,1,1,0,1,1,2,0,-1,1,MarJon Beauchamp,MIL,MIL,POR,,,2,1,1,2
22023,1630699,22300049,"NOV 24, 2023",MIL vs. WAS,W,13,0,4,0.0,0,2,0.0,3,4,0.75,0,3,3,2,0,0,0,2,3,8,1,MarJon Beauchamp,MIL,MIL,WAS,,,8,6,5,5
22023,1630699,22300228,"NOV 22, 2023",MIL @ BOS,L,22,2,5,0.4,1,2,0.5,0,0,0.0,1,2,3,0,1,0,0,1,5,-7,1,MarJon Beauchamp,MIL,BOS,MIL,,,8,8,5,3
22023,1630699,22300195,"NOV 15, 2023",MIL @ TOR,W,10,2,3,0.667,0,0,0.0,0,0,0.0,0,0,0,1,1,0,0,2,4,2,1,MarJon Beauchamp,MIL,TOR,MIL,,,5,4,5,1
22023,1630699,22300190,"NOV 13, 2023",MIL vs. CHI,W,20,3,7,0.429,2,4,0.5,0,0,0.0,1,4,5,2,1,1,1,1,8,7,1,MarJon Beauchamp,MIL,MIL,CHI,,,15,13,10,7
22023,1630699,22300173,"NOV 11, 2023",MIL @ ORL,L,20,2,7,0.286,0,2,0.0,1,3,0.333,1,3,4,0,0,0,3,2,5,-19,1,MarJon Beauchamp,MIL,ORL,MIL,,,9,9,5,4
22023,1630699,22300171,"NOV 09, 2023",MIL @ IND,L,13,2,4,0.5,1,2,0.5,0,0,0.0,1,3,4,2,0,0,0,0,5,6,1,MarJon Beauchamp,MIL,IND,MIL,,,11,9,7,6
22023,1630699,22300165,"NOV 08, 2023",MIL vs. DET,W,27,4,8,0.5,0,3,0.0,2,2,1.0,1,1,2,1,0,0,1,4,10,-25,1,MarJon Beauchamp,MIL,MIL,DET,,,13,12,11,3
22023,1630699,22300149,"NOV 06, 2023",MIL @ BKN,W,16,1,2,0.5,1,1,1.0,0,0,0.0,1,0,1,2,1,0,1,0,3,18,1,MarJon Beauchamp,MIL,BKN,MIL,,,6,4,5,3
22023,1630699,22300002,"NOV 03, 2023",MIL vs. NYK,W,13,5,7,0.714,3,5,0.6,0,1,0.0,1,1,2,2,0,0,0,2,13,5,1,MarJon Beauchamp,MIL,MIL,NYK,,,17,15,15,4
22023,1630699,22300116,"NOV 01, 2023",MIL @ TOR,L,16,2,5,0.4,2,5,0.4,2,2,1.0,0,2,2,0,0,0,0,0,8,5,1,MarJon Beauchamp,MIL,TOR,MIL,,,10,10,8,2
22023,1630699,22300097,"OCT 29, 2023",MIL vs. ATL,L,16,3,5,0.6,2,2,1.0,0,0,0.0,1,0,1,0,0,0,1,3,8,-2,1,MarJon Beauchamp,MIL,MIL,ATL,,,9,9,8,1
22023,1630699,22300075,"OCT 26, 2023",MIL vs. PHI,W,16,2,3,0.667,0,1,0.0,0,0,0.0,1,1,2,0,0,0,0,3,4,-3,1,MarJon Beauchamp,MIL,MIL,PHI,,,6,6,4,2
22023,202722,22300481,"JAN 05, 2024",OKC @ BKN,L,1,0,1,0.0,0,1,0.0,0,0,0.0,0,0,0,0,0,0,0,0,0,0,1,Davis Bertans,OKC,BKN,OKC,,,0,0,0,0
22023,202722,22300419,"DEC 27, 2023",OKC vs. NYK,W,1,1,2,0.5,1,1,1.0,0,0,0.0,1,0,1,0,0,0,0,0,3,1,1,Davis Bertans,OKC,OKC,NYK,,,4,4,3,1
22023,202722,22300397,"DEC 23, 2023",OKC vs. LAL,L,10,1,2,0.5,1,2,0.5,0,0,0.0,0,1,1,1,0,0,0,0,3,5,1,Davis Bertans,OKC,OKC,LAL,,,5,4,4,2
22023,202722,22300324,"DEC 14, 2023",OKC @ SAC,L,5,0,1,0.0,0,1,0.0,0,0,0.0,1,2,3,1,0,0,1,1,0,-3,1,Davis Bertans,OKC,SAC,OKC,,,4,3,1,4
22023,202722,22300302,"DEC 11, 2023",OKC vs. UTA,W,9,1,2,0.5,1,2,0.5,0,0,0.0,0,0,0,1,0,1,0,1,3,-17,1,Davis Bertans,OKC,OKC,UTA,,,4,3,4,1
22023,202722,22301222,"DEC 08, 2023",OKC vs. GSW,W,0,0,0,0.0,0,0,0.0,0,0,0.0,0,0,0,0,0,0,0,0,0,2,1,Davis Bertans,OKC,OKC,GSW,,,0,0,0,0
22023,202722,22300287,"DEC 02, 2023",OKC @ DAL,W,11,3,3,1.0,3,3,1.0,6,6,1.0,0,1,1,1,1,0,0,3,15,16,1,Davis Bertans,OKC,DAL,OKC,,,17,16,16,2
22023,202722,22300239,"NOV 25, 2023",OKC vs. PHI,L,10,1,3,0.333,1,2,0.5,2,3,0.667,0,1,1,1,0,0,0,2,5,9,1,Davis Bertans,OKC,OKC,PHI,,,7,6,6,2
22023,202722,22300215,"NOV 19, 2023",OKC @ POR,W,11,1,5,0.2,1,5,0.2,0,0,0.0,0,2,2,2,0,1,0,0,3,11,1,Davis Bertans,OKC,POR,OKC,,,7,5,5,4
22023,202722,22300185,"NOV 12, 2023",OKC @ PHX,W,3,0,0,0.0,0,0,0.0,0,0,0.0,0,0,0,0,0,0,0,0,0,-5,1,Davis Bertans,OKC,PHX,OKC,,,0,0,0,0
22023,202722,22300167,"NOV 08, 2023",OKC vs. CLE,W,10,0,3,0.0,0,3,0.0,3,3,1.0,0,0,0,1,1,0,0,2,3,4,1,Davis Bertans,OKC,OKC,CLE,,,4,3,4,1
22023,202722,22300109,"OCT 30, 2023",OKC vs. DET,W,13,1,2,0.5,1,2,0.5,3,3,1.0,0,1,1,0,0,0,0,1,6,8,1,Davis Bertans,OKC,OKC,DET,,,7,7,6,1
22023,201976,22300555,"JAN 15, 2024",PHI vs. HOU,W,29,3,8,0.375,1,4,0.25,4,6,0.667,0,5,5,6,1,1,3,2,11,15,1,Patrick Beverley,PHI,PHI,HOU,,,22,16,17,11
22023,201976,22300532,"JAN 12, 2024",PHI vs. SAC,W,27,2,8,0.25,0,4,0.0,0,0,0.0,0,9,9,7,0,0,3,2,4,13,1,Patrick Beverley,PHI,PHI,SAC,,,20,13,11,16
22023,201976,22300521,"JAN 10, 2024",PHI @ ATL,L,13,3,4,0.75,1,2,0.5,2,2,1.0,1,2,3,2,0,0,1,2,9,-15,1,Patrick Beverley,PHI,ATL,PHI,,,14,12,11,5
22023,201976,22300495,"JAN 06, 2024",PHI vs. UTA,L,34,5,13,0.385,2,6,0.333,0,0,0.0,2,2,4,7,0,0,0,0,12,-2,1,Patrick Beverley,PHI,PHI,UTA,,,23,16,19,11
22023,201976,22300483,"JAN 05, 2024",PHI vs. NYK,L,14,0,1,0.0,0,1,0.0,2,2,1.0,0,2,2,0,1,0,2,2,2,-12,1,Patrick Beverley,PHI,PHI,NYK,,,4,4,2,2
22023,201976,22300459,"JAN 02, 2024",PHI vs. CHI,W,14,1,1,1.0,1,1,1.0,0,0,0.0,0,1,1,2,0,0,1,1,3,15,1,Patrick Beverley,PHI,PHI,CHI,,,6,4,5,3
22023,201976,22300442,"DEC 30, 2023",PHI @ CHI,L,24,1,4,0.25,0,2,0.0,2,2,1.0,0,2,2,3,1,2,1,4,4,-7,1,Patrick Beverley,PHI,CHI,PHI,,,9,6,7,5
22023,201976,22300434,"DEC 29, 2023",PHI @ HOU,W,20,3,4,0.75,1,1,1.0,2,2,1.0,2,1,3,3,0,0,0,1,9,7,1,Patrick Beverley,PHI,HOU,PHI,,,15,12,12,6
22023,201976,22300415,"DEC 27, 2023",PHI @ ORL,W,17,4,7,0.571,0,1,0.0,2,2,1.0,0,4,4,2,1,1,1,2,10,3,1,Patrick Beverley,PHI,ORL,PHI,,,16,14,12,6
22023,201976,22300404,"DEC 25, 2023",PHI @ MIA,L,13,2,4,0.5,1,3,0.333,4,4,1.0,0,3,3,0,0,0,2,2,9,-18,1,Patrick Beverley,PHI,MIA,PHI,,,12,12,9,3
22023,201976,22300367,"DEC 20, 2023",PHI vs. MIN,W,18,2,5,0.4,1,2,0.5,0,0,0.0,0,3,3,3,0,1,0,0,5,7,1,Patrick Beverley,PHI,PHI,MIN,,,11,8,8,6
22023,201976,22300351,"DEC 18, 2023",PHI vs. CHI,L,19,2,6,0.333,0,2,0.0,0,0,0.0,0,3,3,1,0,0,1,1,4,-15,1,Patrick Beverley,PHI,PHI,CHI,,,8,7,5,4
22023,201976,22300335,"DEC 16, 2023",PHI @ CHA,W,8,0,1,0.0,0,1,0.0,3,4,0.75,0,0,0,2,0,0,0,1,3,14,1,Patrick Beverley,PHI,CHA,PHI,,,5,3,5,2
22023,201976,22300327,"DEC 15, 2023",PHI vs. DET,W,12,0,1,0.0,0,0,0.0,1,2,0.5,0,0,0,0,3,0,0,0,1,-6,1,Patrick Beverley,PHI,PHI,DET,,,1,1,1,0
22023,201976,22300310,"DEC 13, 2023",PHI @ DET,W,13,1,3,0.333,1,2,0.5,0,2,0.0,0,1,1,1,0,0,0,2,3,17,1,Patrick Beverley,PHI,DET,PHI,,,5,4,4,2
22023,201976,22300295,"DEC 11, 2023",PHI vs. WAS,W,11,4,6,0.667,3,4,0.75,1,1,1.0,1,1,2,2,0,0,0,2,12,22,1,Patrick Beverley,PHI,PHI,WAS,,,16,14,14,4
22023,201976,22301218,"DEC 08, 2023",PHI vs. ATL,W,18,2,6,0.333,0,3,0.0,1,1,1.0,1,0,1,1,0,0,1,0,5,4,1,Patrick Beverley,PHI,PHI,ATL,,,7,6,6,2
22023,201976,22301208,"DEC 06, 2023",PHI @ WAS,W,21,2,7,0.286,1,5,0.2,0,0,0.0,0,4,4,4,1,0,2,0,5,-7,1,Patrick Beverley,PHI,WAS,PHI,,,13,9,9,8
22023,201976,22300275,"DEC 01, 2023",PHI @ BOS,L,38,10,15,0.667,3,5,0.6,3,5,0.6,2,6,8,7,2,0,3,4,26,-12,1,Patrick Beverley,PHI,BOS,PHI,,,41,34,33,15
22023,201976,22300262,"NOV 29, 2023",PHI @ NOP,L,21,3,4,0.75,1,1,1.0,4,4,1.0,0,1,1,7,1,0,0,1,11,3,1,Patrick Beverley,PHI,NOP,PHI,,,19,12,18,8
22023,201976,22300255,"NOV 27, 2023",PHI vs. LAL,W,24,4,9,0.444,4,8,0.5,0,0,0.0,2,4,6,3,0,0,1,2,12,26,1,Patrick Beverley,PHI,PHI,LAL,,,21,18,15,9
22023,201976,22300239,"NOV 25, 2023",PHI @ OKC,W,21,2,5,0.4,1,3,0.333,1,2,0.5,2,2,4,4,0,0,0,1,6,-10,1,Patrick Beverley,PHI,OKC,PHI,,,14,10,10,8
22023,201976,22300232,"NOV 22, 2023",PHI @ MIN,L,16,1,2,0.5,0,1,0.0,0,0,0.0,0,0,0,2,0,0,2,2,2,-16,1,Patrick Beverley,PHI,MIN,PHI,,,4,2,4,2
22023,201976,22300040,"NOV 21, 2023",PHI vs. CLE,L,21,1,2,0.5,0,1,0.0,0,0,0.0,1,3,4,0,2,1,1,3,2,11,1,Patrick Beverley,PHI,PHI,CLE,,,6,6,2,4
22023,201976,22300208,"NOV 19, 2023",PHI @ BKN,W,12,1,4,0.25,0,1,0.0,0,0,0.0,0,1,1,2,0,0,1,1,2,1,1,Patrick Beverley,PHI,BKN,PHI,,,5,3,4,3
22023,201976,22300029,"NOV 17, 2023",PHI @ ATL,W,14,0,1,0.0,0,1,0.0,2,2,1.0,0,2,2,1,0,0,0,3,2,16,1,Patrick Beverley,PHI,ATL,PHI,,,5,4,3,3
22023,201976,22300194,"NOV 15, 2023",PHI vs. BOS,L,10,0,4,0.0,0,2,0.0,0,2,0.0,0,1,1,1,0,0,0,1,0,-17,1,Patrick Beverley,PHI,PHI,BOS,,,2,1,1,2
22023,201976,22300019,"NOV 14, 2023",PHI vs. IND,L,28,1,3,0.333,0,2,0.0,0,0,0.0,0,5,5,2,0,0,0,5,2,-9,1,Patrick Beverley,PHI,PHI,IND,,,9,7,4,7
22023,201976,22300180,"NOV 12, 2023",PHI vs. IND,W,17,1,4,0.25,1,4,0.25,0,0,0.0,1,1,2,1,1,0,0,3,3,3,1,Patrick Beverley,PHI,PHI,IND,,,6,5,4,3
22023,201976,22300008,"NOV 10, 2023",PHI @ DET,W,5,0,1,0.0,0,0,0.0,0,0,0.0,0,0,0,1,0,0,0,0,0,-8,1,Patrick Beverley,PHI,DET,PHI,,,1,0,1,1
22023,201976,22300159,"NOV 08, 2023",PHI vs. BOS,W,15,1,2,0.5,0,1,0.0,0,0,0.0,0,5,5,4,0,0,0,2,2,4,1,Patrick Beverley,PHI,PHI,BOS,,,11,7,6,9
22023,201976,22300148,"NOV 06, 2023",PHI vs. WAS,W,12,2,3,0.667,1,2,0.5,1,1,1.0,2,2,4,5,1,1,1,0,6,27,1,Patrick Beverley,PHI,PHI,WAS,,,15,10,11,9
22023,201976,22300132,"NOV 04, 2023",PHI vs. PHX,W,12,0,1,0.0,0,1,0.0,0,0,0.0,1,3,4,1,0,0,0,1,0,-2,1,Patrick Beverley,PHI,PHI,PHX,,,5,4,1,5
22023,201976,22300128,"NOV 02, 2023",PHI vs. TOR,W,28,1,6,0.167,0,3,0.0,0,0,0.0,3,2,5,1,2,1,2,3,2,10,1,Patrick Beverley,PHI,PHI,TOR,,,8,7,3,6
22023,201976,22300098,"OCT 29, 2023",PHI vs. POR,W,20,2,3,0.667,0,0,0.0,0,0,0.0,1,1,2,2,1,3,1,3,4,8,1,Patrick Beverley,PHI,PHI,POR,,,8,6,6,4
22023,201976,22300092,"OCT 28, 2023",PHI @ TOR,W,17,1,2,0.5,0,0,0.0,0,0,0.0,3,2,5,2,0,0,1,2,2,10,1,Patrick Beverley,PHI,TOR,PHI,,,9,7,4,7
22023,201976,22300075,"OCT 26, 2023",PHI @ MIL,L,14,1,1,1.0,0,0,0.0,0,0,0.0,0,2,2,2,0,0,0,2,2,6,1,Patrick Beverley,PHI,MIL,PHI,,,6,4,4,4
22023,1630180,22300559,"JAN 15, 2024",ATL vs. SAS,W,33,3,9,0.333,1,7,0.143,3,4,0.75,4,1,5,2,0,0,0,3,10,0,1,Saddiq Bey,ATL,ATL,SAS,,,17,15,12,7
22023,1630180,22300543,"JAN 13, 2024",ATL vs. WAS,L,27,5,13,0.385,2,7,0.286,4,4,1.0,6,1,7,0,4,0,1,1,16,-15,1,Saddiq Bey,ATL,ATL,WAS,,,23,23,16,7
22023,1630180,22300533,"JAN 12, 2024",ATL vs. IND,L,31,3,10,0.3,3,7,0.429,8,9,0.889,1,3,4,2,1,0,0,1,17,1,1,Saddiq Bey,ATL,ATL,IND,,,23,21,19,6
22023,1630180,22300521,"JAN 10, 2024",ATL vs. PHI,W,37,6,16,0.375,1,6,0.167,2,3,0.667,6,4,10,1,0,0,1,1,15,-4,1,Saddiq Bey,ATL,ATL,PHI,,,26,25,16,11
22023,1630180,22300499,"JAN 07, 2024",ATL @ ORL,L,38,5,10,0.5,2,4,0.5,4,5,0.8,1,6,7,2,1,0,0,1,16,-17,1,Saddiq Bey,ATL,ORL,ATL,,,25,23,18,9
22023,1630180,22300480,"JAN 05, 2024",ATL @ IND,L,30,2,7,0.286,1,6,0.167,4,4,1.0,3,1,4,2,0,0,1,1,9,-22,1,Saddiq Bey,ATL,IND,ATL,,,15,13,11,6
22023,1630180,22300467,"JAN 03, 2024",ATL vs. OKC,W,36,3,12,0.25,2,8,0.25,2,2,1.0,2,6,8,2,0,1,0,2,10,6,1,Saddiq Bey,ATL,ATL,OKC,,,20,18,12,10
22023,1630180,22300445,"DEC 31, 2023",ATL @ WAS,W,32,4,10,0.4,2,5,0.4,1,3,0.333,3,8,11,0,0,1,1,3,11,-2,1,Saddiq Bey,ATL,WAS,ATL,,,22,22,11,11
22023,1630180,22300431,"DEC 29, 2023",ATL vs. SAC,L,32,4,14,0.286,3,8,0.375,4,4,1.0,5,2,7,4,1,0,1,2,15,5,1,Saddiq Bey,ATL,ATL,SAC,,,26,22,19,11
22023,1630180,22300408,"DEC 26, 2023",ATL @ CHI,L,34,5,10,0.5,2,6,0.333,1,1,1.0,4,4,8,0,1,0,0,1,13,-7,1,Saddiq Bey,ATL,CHI,ATL,,,21,21,13,8
22023,1630180,22300393,"DEC 23, 2023",ATL vs. MEM,L,38,4,11,0.364,3,9,0.333,3,4,0.75,1,5,6,2,2,0,1,2,14,-7,1,Saddiq Bey,ATL,ATL,MEM,,,22,20,16,8
22023,1630180,22300384,"DEC 22, 2023",ATL @ MIA,L,40,6,14,0.429,2,8,0.25,2,2,1.0,2,8,10,2,2,0,2,2,16,-12,1,Saddiq Bey,ATL,MIA,ATL,,,28,26,18,12
22023,1630180,22300371,"DEC 20, 2023",ATL @ HOU,W,32,3,11,0.273,2,6,0.333,1,1,1.0,4,5,9,0,0,0,1,1,9,16,1,Saddiq Bey,ATL,HOU,ATL,,,18,18,9,9
22023,1630180,22300352,"DEC 18, 2023",ATL vs. DET,W,42,8,15,0.533,2,7,0.286,3,5,0.6,2,2,4,1,2,0,1,1,21,9,1,Saddiq Bey,ATL,ATL,DET,,,26,25,22,5
22023,1630180,22300336,"DEC 16, 2023",ATL @ CLE,L,36,1,9,0.111,1,7,0.143,2,2,1.0,1,5,6,0,2,0,2,0,5,-10,1,Saddiq Bey,ATL,CLE,ATL,,,11,11,5,6
22023,1630180,22300330,"DEC 15, 2023",ATL @ TOR,W,37,4,12,0.333,2,8,0.25,0,0,0.0,3,7,10,4,0,0,1,3,10,24,1,Saddiq Bey,ATL,TOR,ATL,,,24,20,14,14
22023,1630180,22300313,"DEC 13, 2023",ATL @ TOR,L,38,5,14,0.357,0,5,0.0,2,3,0.667,3,7,10,2,2,0,1,1,12,-3,1,Saddiq Bey,ATL,TOR,ATL,,,24,22,14,12
22023,1630180,22300296,"DEC 11, 2023",ATL vs. DEN,L,40,6,11,0.545,1,4,0.25,3,4,0.75,1,3,4,2,1,1,0,2,16,-8,1,Saddiq Bey,ATL,ATL,DEN,,,22,20,18,6
22023,1630180,22301218,"DEC 08, 2023",ATL @ PHI,L,38,6,20,0.3,3,9,0.333,1,1,1.0,5,3,8,1,0,0,0,1,16,2,1,Saddiq Bey,ATL,PHI,ATL,,,25,24,17,9
22023,1630180,22301209,"DEC 06, 2023",ATL vs. BKN,L,37,7,13,0.538,3,6,0.5,4,4,1.0,4,3,7,1,1,0,3,1,21,9,1,Saddiq Bey,ATL,ATL,BKN,,,29,28,22,8
22023,1630180,22300286,"DEC 02, 2023",ATL @ MIL,L,36,5,7,0.714,4,6,0.667,3,4,0.75,3,6,9,1,0,0,0,2,17,-3,1,Saddiq Bey,ATL,MIL,ATL,,,27,26,18,10
22023,1630180,22300272,"NOV 30, 2023",ATL @ SAS,W,34,5,8,0.625,3,4,0.75,0,0,0.0,2,2,4,0,3,0,1,3,13,0,1,Saddiq Bey,ATL,SAS,ATL,,,17,17,13,4
22023,1630180,22300055,"NOV 28, 2023",ATL @ CLE,L,32,5,8,0.625,2,4,0.5,2,2,1.0,1,3,4,3,2,0,0,4,14,-22,1,Saddiq Bey,ATL,CLE,ATL,,,21,18,17,7
22023,1630180,22300246,"NOV 26, 2023",ATL @ BOS,L,29,3,7,0.429,1,5,0.2,0,0,0.0,3,5,8,1,0,0,0,3,7,-16,1,Saddiq Bey,ATL,BOS,ATL,,,16,15,8,9
22023,1630180,22300241,"NOV 25, 2023",ATL @ WAS,W,32,6,14,0.429,0,4,0.0,1,2,0.5,3,6,9,1,1,0,1,1,13,30,1,Saddiq Bey,ATL,WAS,ATL,,,23,22,14,10
22023,1630180,22300227,"NOV 22, 2023",ATL vs. BKN,W,25,4,8,0.5,1,3,0.333,3,3,1.0,0,2,2,1,2,0,2,2,12,9,1,Saddiq Bey,ATL,ATL,BKN,,,15,14,13,3
22023,1630180,22300039,"NOV 21, 2023",ATL vs. IND,L,31,4,7,0.571,2,4,0.5,2,5,0.4,1,9,10,2,0,0,0,0,12,4,1,Saddiq Bey,ATL,ATL,IND,,,24,22,14,12
22023,1630180,22300029,"NOV 17, 2023",ATL vs. PHI,L,31,6,9,0.667,2,4,0.5,3,4,0.75,3,4,7,1,1,0,2,1,17,-5,1,Saddiq Bey,ATL,ATL,PHI,,,25,24,18,8
22023,1630180,22300193,"NOV 15, 2023",ATL vs. NYK,L,28,7,10,0.7,2,5,0.4,0,0,0.0,1,1,2,2,2,0,2,3,16,20,1,Saddiq Bey,ATL,ATL,NYK,,,20,18,18,4
22023,1630180,22300018,"NOV 14, 2023",ATL @ DET,W,27,6,13,0.462,2,7,0.286,5,6,0.833,1,3,4,2,2,1,1,0,19,5,1,Saddiq Bey,ATL,DET,ATL,,,25,23,21,6
22023,1630180,22300175,"NOV 11, 2023",ATL vs. MIA,L,24,3,9,0.333,2,7,0.286,0,0,0.0,3,5,8,0,0,0,4,0,8,-10,1,Saddiq Bey,ATL,ATL,MIA,,,16,16,8,8
22023,1630180,22300172,"NOV 09, 2023",ATL @ ORL,W,29,1,4,0.25,0,0,0.0,0,0,0.0,1,2,3,0,1,0,1,3,2,-8,1,Saddiq Bey,ATL,ORL,ATL,,,5,5,2,3
22023,1630180,22300155,"NOV 06, 2023",ATL @ OKC,L,26,6,11,0.545,3,6,0.5,0,0,0.0,4,4,8,2,0,0,2,1,15,6,1,Saddiq Bey,ATL,OKC,ATL,,,25,23,17,10
22023,1630180,22300135,"NOV 04, 2023",ATL @ NOP,W,26,5,13,0.385,2,7,0.286,0,0,0.0,4,1,5,2,1,0,0,2,12,4,1,Saddiq Bey,ATL,NOP,ATL,,,19,17,14,7
22023,1630180,22300117,"NOV 01, 2023",ATL vs. WAS,W,32,4,10,0.4,2,7,0.286,4,4,1.0,1,6,7,0,1,0,1,1,14,10,1,Saddiq Bey,ATL,ATL,WAS,,,21,21,14,7
22023,1630180,22300104,"OCT 30, 2023",ATL vs. MIN,W,25,4,5,0.8,3,3,1.0,0,0,0.0,0,6,6,1,0,1,1,2,11,17,1,Saddiq Bey,ATL,ATL,MIN,,,18,17,12,7
22023,1630180,22300097,"OCT 29, 2023",ATL @ MIL,W,31,4,9,0.444,1,3,0.333,4,5,0.8,3,6,9,3,0,0,1,0,13,23,1,Saddiq Bey,ATL,MIL,ATL,,,25,22,16,12
22023,1630180,22300079,"OCT 27, 2023",ATL vs. NYK,L,26,2,4,0.5,1,2,0.5,0,0,0.0,0,1,1,1,0,1,1,2,5,-6,1,Saddiq Bey,ATL,ATL,NYK,,,7,6,6,2
22023,1630180,22300063,"OCT 25, 2023",ATL @ CHA,L,29,6,12,0.5,1,4,0.25,2,2,1.0,3,2,5,0,5,0,2,1,15,-2,1,Saddiq Bey,ATL,CHA,ATL,,,20,20,15,5
22023,1629048,22300557,"JAN 15, 2024",ORL @ NYK,W,29,1,3,0.333,0,0,0.0,1,2,0.5,4,7,11,3,0,0,0,3,3,-10,1,Goga Bitadze,ORL,NYK,ORL,,,17,14,6,14
22023,1629048,22300546,"JAN 13, 2024",ORL @ OKC,L,22,4,6,0.667,0,1,0.0,0,0,0.0,2,7,9,2,2,0,1,2,8,-1,1,Goga Bitadze,ORL,OKC,ORL,,,19,17,10,11
22023,1629048,22300535,"JAN 12, 2024",ORL @ MIA,L,19,1,1,1.0,0,0,0.0,0,2,0.0,0,9,9,1,1,1,0,1,2,-10,1,Goga Bitadze,ORL,MIA,ORL,,,12,11,3,10
22023,1629048,22300513,"JAN 09, 2024",ORL vs. MIN,L,17,1,3,0.333,0,0,0.0,0,0,0.0,4,2,6,1,1,2,1,4,2,-8,1,Goga Bitadze,ORL,ORL,MIN,,,9,8,3,7
22023,1629048,22300499,"JAN 07, 2024",ORL vs. ATL,W,28,5,6,0.833,0,0,0.0,1,2,0.5,7,7,14,3,0,2,0,4,11,14,1,Goga Bitadze,ORL,ORL,ATL,,,28,25,14,17
22023,1629048,22300476,"JAN 03, 2024",ORL @ SAC,L,28,2,5,0.4,0,1,0.0,2,2,1.0,1,5,6,2,1,3,1,3,6,-15,1,Goga Bitadze,ORL,SAC,ORL,,,14,12,8,8
22023,1629048,22300463,"JAN 02, 2024",ORL @ GSW,L,26,6,6,1.0,1,1,1.0,0,0,0.0,3,4,7,1,1,1,0,3,13,-15,1,Goga Bitadze,ORL,GSW,ORL,,,21,20,14,8
22023,1629048,22300450,"DEC 31, 2023",ORL @ PHX,L,22,3,5,0.6,0,0,0.0,0,0,0.0,4,3,7,1,0,1,2,4,6,-15,1,Goga Bitadze,ORL,PHX,ORL,,,14,13,7,8
22023,1629048,22300429,"DEC 29, 2023",ORL vs. NYK,W,30,4,8,0.5,0,0,0.0,5,8,0.625,3,4,7,0,1,2,2,3,13,16,1,Goga Bitadze,ORL,ORL,NYK,,,20,20,13,7
22023,1629048,22300415,"DEC 27, 2023",ORL vs. PHI,L,9,1,1,1.0,0,0,0.0,0,0,0.0,0,1,1,0,0,4,0,0,2,-13,1,Goga Bitadze,ORL,ORL,PHI,,,3,3,2,1
22023,1629048,22300407,"DEC 26, 2023",ORL @ WAS,W,12,4,5,0.8,0,0,0.0,2,2,1.0,4,3,7,3,0,1,0,0,10,-1,1,Goga Bitadze,ORL,WAS,ORL,,,20,17,13,10
22023,1629048,22300391,"DEC 23, 2023",ORL @ IND,W,11,0,0,0.0,0,0,0.0,1,2,0.5,1,0,1,2,2,1,2,1,1,11,1,Goga Bitadze,ORL,IND,ORL,,,4,2,3,3
22023,1629048,22300366,"DEC 20, 2023",ORL vs. MIA,L,12,2,3,0.667,0,0,0.0,0,0,0.0,3,3,6,1,0,2,1,0,4,0,1,Goga Bitadze,ORL,ORL,MIA,,,11,10,5,7
22023,1629048,22300344,"DEC 17, 2023",ORL @ BOS,L,26,2,6,0.333,0,0,0.0,0,0,0.0,2,6,8,1,2,3,1,3,4,1,1,Goga Bitadze,ORL,BOS,ORL,,,13,12,5,9
22023,1629048,22300329,"DEC 15, 2023",ORL @ BOS,L,27,7,8,0.875,0,0,0.0,1,2,0.5,5,6,11,1,0,0,4,2,15,-1,1,Goga Bitadze,ORL,BOS,ORL,,,27,26,16,12
22023,1629048,22300294,"DEC 11, 2023",ORL vs. CLE,W,29,6,8,0.75,0,0,0.0,3,4,0.75,3,4,7,2,0,4,0,3,15,8,1,Goga Bitadze,ORL,ORL,CLE,,,24,22,17,9
22023,1629048,22301217,"DEC 08, 2023",ORL vs. DET,W,28,6,7,0.857,0,0,0.0,1,1,1.0,4,4,8,2,0,4,1,1,13,26,1,Goga Bitadze,ORL,ORL,DET,,,23,21,15,10
22023,1629048,22301205,"DEC 06, 2023",ORL @ CLE,L,25,3,4,0.75,0,1,0.0,0,1,0.0,0,3,3,3,0,1,0,3,6,-1,1,Goga Bitadze,ORL,CLE,ORL,,,12,9,9,6
22023,1629048,22300282,"DEC 02, 2023",ORL @ BKN,L,15,1,6,0.167,0,0,0.0,1,2,0.5,3,2,5,0,0,1,0,2,3,-4,1,Goga Bitadze,ORL,BKN,ORL,,,8,8,3,5
22023,1629048,22300274,"DEC 01, 2023",ORL vs. WAS,W,24,1,1,1.0,1,1,1.0,0,0,0.0,1,4,5,4,0,2,3,4,3,2,1,Goga Bitadze,ORL,ORL,WAS,,,12,8,7,9
22023,1629048,22300259,"NOV 29, 2023",ORL vs. WAS,W,24,2,5,0.4,0,0,0.0,4,4,1.0,1,6,7,2,0,1,1,1,8,7,1,Goga Bitadze,ORL,ORL,WAS,,,17,15,10,9
22023,1629048,22300248,"NOV 26, 2023",ORL vs. CHA,W,20,5,7,0.714,0,0,0.0,1,1,1.0,2,5,7,3,1,0,2,4,11,-1,1,Goga Bitadze,ORL,ORL,CHA,,,21,18,14,10
22023,1629048,22300043,"NOV 24, 2023",ORL vs. BOS,W,19,3,5,0.6,0,0,0.0,0,0,0.0,2,3,5,3,1,1,0,5,6,-2,1,Goga Bitadze,ORL,ORL,BOS,,,14,11,9,8
22023,1629048,22300226,"NOV 22, 2023",ORL vs. DEN,W,32,2,5,0.4,0,0,0.0,2,2,1.0,3,9,12,2,0,1,1,2,6,2,1,Goga Bitadze,ORL,ORL,DEN,,,20,18,8,14
22023,1629048,22300038,"NOV 21, 2023",ORL vs. TOR,W,31,2,6,0.333,0,0,0.0,1,4,0.25,3,4,7,6,2,5,1,1,5,9,1,Goga Bitadze,ORL,ORL,TOR,,,18,12,11,13
22023,1629048,22300209,"NOV 19, 2023",ORL @ IND,W,22,3,5,0.6,0,0,0.0,2,2,1.0,1,7,8,2,0,4,0,2,8,21,1,Goga Bitadze,ORL,IND,ORL,,,18,16,10,10
22023,1629048,22300033,"NOV 17, 2023",ORL @ CHI,W,21,0,1,0.0,0,0,0.0,2,4,0.5,0,4,4,0,1,2,1,4,2,2,1,Goga Bitadze,ORL,CHI,ORL,,,6,6,2,4
22023,1629048,22300196,"NOV 15, 2023",ORL @ CHI,W,26,6,10,0.6,0,0,0.0,3,4,0.75,6,5,11,2,2,1,0,5,15,6,1,Goga Bitadze,ORL,CHI,ORL,,,28,26,17,13
22023,1629048,22300020,"NOV 14, 2023",ORL @ BKN,L,24,6,7,0.857,0,1,0.0,2,2,1.0,1,2,3,1,2,0,0,4,14,-14,1,Goga Bitadze,ORL,BKN,ORL,,,18,17,15,4
22023,1629048,22300173,"NOV 11, 2023",ORL vs. MIL,W,21,1,5,0.2,0,0,0.0,0,0,0.0,5,4,9,2,2,0,1,2,2,4,1,Goga Bitadze,ORL,ORL,MIL,,,13,11,4,11
22023,1629048,22300172,"NOV 09, 2023",ORL vs. ATL,L,21,5,7,0.714,0,0,0.0,2,4,0.5,2,3,5,0,0,2,1,2,12,7,1,Goga Bitadze,ORL,ORL,ATL,,,17,17,12,5
22023,1629048,22300147,"NOV 06, 2023",ORL vs. DAL,L,22,3,5,0.6,0,1,0.0,1,1,1.0,2,4,6,0,2,1,1,3,7,0,1,Goga Bitadze,ORL,ORL,DAL,,,13,13,7,6
22023,1629048,22300134,"NOV 04, 2023",ORL vs. LAL,W,26,3,6,0.5,0,1,0.0,4,4,1.0,4,6,10,2,0,5,0,2,10,27,1,Goga Bitadze,ORL,ORL,LAL,,,22,20,12,12
22023,1629048,22300114,"OCT 31, 2023",ORL @ LAC,L,4,0,0,0.0,0,0,0.0,1,2,0.5,1,0,1,3,0,0,0,0,1,-1,1,Goga Bitadze,ORL,LAC,ORL,,,5,2,4,4
22023,1629048,22300111,"OCT 30, 2023",ORL @ LAL,L,1,0,0,0.0,0,0,0.0,0,0,0.0,0,0,0,0,0,0,0,0,0,5,1,Goga Bitadze,ORL,LAL,ORL,,,0,0,0,0
22023,1629048,22300066,"OCT 25, 2023",ORL vs. HOU,W,5,2,2,1.0,0,0,0.0,3,4,0.75,1,2,3,0,1,0,1,1,7,9,1,Goga Bitadze,ORL,ORL,HOU,,,10,10,7,3
22023,1641931,22300139,"NOV 04, 2023",CHI @ DEN,L,3,0,0,0.0,0,0,0.0,0,0,0.0,0,0,0,0,0,0,0,0,0,-2,1,Onuralp Bitim,CHI,DEN,CHI,,,0,0,0,0
22023,202687,22300515,"JAN 09, 2024",MEM @ DAL,W,18,1,2,0.5,0,0,0.0,0,0,0.0,1,1,2,4,0,0,2,2,2,3,1,Bismack Biyombo,MEM,DAL,MEM,,,8,4,6,6
22023,202687,22300503,"JAN 07, 2024",MEM @ PHX,W,26,0,2,0.0,0,0,0.0,1,2,0.5,1,5,6,2,0,3,2,3,1,-5,1,Bismack Biyombo,MEM,PHX,MEM,,,9,7,3,8
22023,202687,22300491,"JAN 05, 2024",MEM @ LAL,W,31,3,3,1.0,0,0,0.0,0,0,0.0,1,9,10,1,0,0,2,2,6,17,1,Bismack Biyombo,MEM,LAL,MEM,,,17,16,7,11
22023,202687,22300460,"JAN 02, 2024",MEM vs. SAS,W,28,2,4,0.5,0,0,0.0,0,0,0.0,2,6,8,1,1,3,2,4,4,8,1,Bismack Biyombo,MEM,MEM,SAS,,,13,12,5,9
22023,202687,22300449,"DEC 31, 2023",MEM vs. SAC,L,22,0,0,0.0,0,0,0.0,0,0,0.0,0,6,6,0,0,1,0,1,0,-14,1,Bismack Biyombo,MEM,MEM,SAC,,,6,6,0,6
22023,202687,22300438,"DEC 29, 2023",MEM @ LAC,L,8,1,2,0.5,0,0,0.0,0,0,0.0,0,2,2,0,1,0,1,1,2,-4,1,Bismack Biyombo,MEM,LAC,MEM,,,4,4,2,2
22023,202687,22300425,"DEC 28, 2023",MEM @ DEN,L,22,1,4,0.25,0,0,0.0,0,0,0.0,1,4,5,1,0,1,2,3,2,-28,1,Bismack Biyombo,MEM,DEN,MEM,,,8,7,3,6
22023,202687,22300410,"DEC 26, 2023",MEM @ NOP,W,25,4,5,0.8,0,0,0.0,0,0,0.0,0,7,7,1,0,2,0,4,8,-4,1,Bismack Biyombo,MEM,NOP,MEM,,,16,15,9,8
22023,202687,22300393,"DEC 23, 2023",MEM @ ATL,W,29,3,6,0.5,0,0,0.0,2,6,0.333,7,4,11,3,1,0,1,2,8,4,1,Bismack Biyombo,MEM,ATL,MEM,,,22,19,11,14
22023,202687,22300377,"DEC 21, 2023",MEM vs. IND,W,17,1,4,0.25,0,0,0.0,0,1,0.0,1,2,3,1,0,1,0,2,2,0,1,Bismack Biyombo,MEM,MEM,IND,,,6,5,3,4
22023,202687,22300360,"DEC 19, 2023",MEM @ NOP,W,22,4,5,0.8,0,0,0.0,0,0,0.0,0,2,2,0,1,1,1,3,8,3,1,Bismack Biyombo,MEM,NOP,MEM,,,10,10,8,2
22023,202687,22300332,"DEC 15, 2023",MEM vs. HOU,L,33,5,9,0.556,0,0,0.0,0,1,0.0,1,8,9,1,0,1,2,2,10,3,1,Bismack Biyombo,MEM,MEM,HOU,,,20,19,11,10
22023,202687,22300314,"DEC 13, 2023",MEM @ HOU,L,24,1,2,0.5,0,0,0.0,1,6,0.167,1,5,6,1,0,0,2,5,3,-2,1,Bismack Biyombo,MEM,HOU,MEM,,,10,9,4,7
22023,202687,22300299,"DEC 11, 2023",MEM vs. DAL,L,12,1,1,1.0,0,0,0.0,0,0,0.0,1,1,2,1,0,1,2,1,2,-10,1,Bismack Biyombo,MEM,MEM,DAL,,,5,4,3,3
22023,202687,22301221,"DEC 08, 2023",MEM vs. MIN,L,20,1,2,0.5,0,0,0.0,0,0,0.0,0,3,3,2,0,0,0,4,2,-12,1,Bismack Biyombo,MEM,MEM,MIN,,,7,5,4,5
22023,202687,22301206,"DEC 06, 2023",MEM @ DET,W,26,1,3,0.333,0,0,0.0,0,0,0.0,2,9,11,4,0,1,2,2,2,-1,1,Bismack Biyombo,MEM,DET,MEM,,,17,13,6,15
22023,202687,22300288,"DEC 02, 2023",MEM @ PHX,L,17,1,5,0.2,0,0,0.0,0,0,0.0,2,3,5,1,0,3,2,4,2,-3,1,Bismack Biyombo,MEM,PHX,MEM,,,8,7,3,6
22023,202687,22300277,"DEC 01, 2023",MEM @ DAL,W,23,2,3,0.667,0,0,0.0,0,0,0.0,1,5,6,4,0,2,2,2,4,10,1,Bismack Biyombo,MEM,DAL,MEM,,,14,10,8,10
22023,202687,22300261,"NOV 29, 2023",MEM vs. UTA,W,30,3,3,1.0,0,0,0.0,0,0,0.0,0,6,6,2,1,3,5,3,6,5,1,Bismack Biyombo,MEM,MEM,UTA,,,14,12,8,8
22023,202687,22300249,"NOV 26, 2023",MEM vs. MIN,L,30,2,3,0.667,0,0,0.0,6,10,0.6,2,3,5,3,1,0,1,1,10,-16,1,Bismack Biyombo,MEM,MEM,MIN,,,18,15,13,8
22023,202687,22300044,"NOV 24, 2023",MEM vs. PHX,L,29,3,5,0.6,0,0,0.0,0,0,0.0,1,3,4,1,0,1,1,3,6,-9,1,Bismack Biyombo,MEM,MEM,PHX,,,11,10,7,5
22023,202687,22300231,"NOV 22, 2023",MEM @ HOU,L,31,2,4,0.5,0,0,0.0,1,2,0.5,0,5,5,2,1,2,1,0,5,-10,1,Bismack Biyombo,MEM,HOU,MEM,,,12,10,7,7
22023,202687,22300213,"NOV 19, 2023",MEM vs. BOS,L,14,1,2,0.5,0,0,0.0,0,0,0.0,1,1,2,0,0,1,0,5,2,0,1,Bismack Biyombo,MEM,MEM,BOS,,,4,4,2,2
22023,202687,22300206,"NOV 18, 2023",MEM @ SAS,W,31,7,9,0.778,0,0,0.0,0,1,0.0,1,8,9,4,0,0,1,4,14,6,1,Bismack Biyombo,MEM,SAS,MEM,,,27,23,18,13
22023,202687,22300026,"NOV 14, 2023",MEM @ LAL,L,23,0,5,0.0,0,0,0.0,0,0,0.0,6,2,8,4,0,2,0,3,0,-21,1,Bismack Biyombo,MEM,LAL,MEM,,,12,8,4,12
22023,202687,22300179,"NOV 12, 2023",MEM @ LAC,W,36,5,6,0.833,0,0,0.0,3,7,0.429,4,8,12,3,1,2,1,3,13,20,1,Bismack Biyombo,MEM,LAC,MEM,,,28,25,16,15
22023,202687,22300012,"NOV 10, 2023",MEM vs. UTA,L,34,5,10,0.5,0,0,0.0,5,6,0.833,9,6,15,0,1,0,0,4,15,-5,1,Bismack Biyombo,MEM,MEM,UTA,,,30,30,15,15
22023,202687,22300164,"NOV 08, 2023",MEM vs. MIA,L,30,4,4,1.0,0,0,0.0,1,2,0.5,6,4,10,0,1,0,1,4,9,-17,1,Bismack Biyombo,MEM,MEM,MIA,,,19,19,9,10
22023,202687,22300144,"NOV 05, 2023",MEM @ POR,W,26,3,6,0.5,0,0,0.0,2,2,1.0,5,6,11,4,0,3,2,5,8,18,1,Bismack Biyombo,MEM,POR,MEM,,,23,19,12,15
22023,202687,22300007,"NOV 03, 2023",MEM @ POR,L,0,0,0,0.0,0,0,0.0,0,0,0.0,0,0,0,0,0,0,0,0,0,0,1,Bismack Biyombo,MEM,POR,MEM,,,0,0,0,0
22023,1641710,22300546,"JAN 13, 2024",ORL @ OKC,L,33,5,8,0.625,0,1,0.0,3,6,0.5,0,4,4,1,1,1,1,2,13,-9,1,Anthony Black,ORL,OKC,ORL,,,18,17,14,5
22023,1641710,22300535,"JAN 12, 2024",ORL @ MIA,L,9,0,1,0.0,0,0,0.0,1,2,0.5,0,3,3,1,1,0,0,0,1,4,1,Anthony Black,ORL,MIA,ORL,,,5,4,2,4
22023,1641710,22300513,"JAN 09, 2024",ORL vs. MIN,L,21,1,4,0.25,1,3,0.333,0,0,0.0,0,1,1,4,3,1,2,2,3,0,1,Anthony Black,ORL,ORL,MIN,,,8,4,7,5
22023,1641710,22300499,"JAN 07, 2024",ORL vs. ATL,W,12,0,2,0.0,0,1,0.0,0,0,0.0,0,0,0,0,1,0,1,1,0,-10,1,Anthony Black,ORL,ORL,ATL,,,0,0,0,0
22023,1641710,22300488,"JAN 05, 2024",ORL @ DEN,W,5,0,1,0.0,0,0,0.0,0,0,0.0,0,0,0,1,0,0,0,1,0,-6,1,Anthony Black,ORL,DEN,ORL,,,1,0,1,1
22023,1641710,22300476,"JAN 03, 2024",ORL @ SAC,L,25,4,7,0.571,1,1,1.0,0,0,0.0,1,1,2,4,0,0,1,1,9,-1,1,Anthony Black,ORL,SAC,ORL,,,15,11,13,6
22023,1641710,22300463,"JAN 02, 2024",ORL @ GSW,L,13,0,2,0.0,0,1,0.0,0,0,0.0,0,0,0,0,1,0,1,2,0,-1,1,Anthony Black,ORL,GSW,ORL,,,0,0,0,0
22023,1641710,22300450,"DEC 31, 2023",ORL @ PHX,L,22,1,3,0.333,0,1,0.0,0,0,0.0,0,2,2,0,0,0,2,2,2,-19,1,Anthony Black,ORL,PHX,ORL,,,4,4,2,2
22023,1641710,22300429,"DEC 29, 2023",ORL vs. NYK,W,29,2,2,1.0,0,0,0.0,0,0,0.0,2,4,6,5,2,0,1,4,4,0,1,Anthony Black,ORL,ORL,NYK,,,15,10,9,11
22023,1641710,22300415,"DEC 27, 2023",ORL vs. PHI,L,23,1,6,0.167,1,3,0.333,0,0,0.0,1,3,4,4,1,1,0,2,3,-3,1,Anthony Black,ORL,ORL,PHI,,,11,7,7,8
22023,1641710,22300407,"DEC 26, 2023",ORL @ WAS,W,33,9,13,0.692,4,6,0.667,1,1,1.0,1,5,6,1,4,0,5,4,23,-2,1,Anthony Black,ORL,WAS,ORL,,,30,29,24,7
22023,1641710,22300391,"DEC 23, 2023",ORL @ IND,W,28,2,3,0.667,0,0,0.0,4,4,1.0,0,3,3,2,1,1,2,2,8,-3,1,Anthony Black,ORL,IND,ORL,,,13,11,10,5
22023,1641710,22300378,"DEC 21, 2023",ORL @ MIL,L,20,0,0,0.0,0,0,0.0,1,2,0.5,0,2,2,1,1,2,1,2,1,-20,1,Anthony Black,ORL,MIL,ORL,,,4,3,2,3
22023,1641710,22300366,"DEC 20, 2023",ORL vs. MIA,L,22,2,4,0.5,0,1,0.0,0,0,0.0,1,1,2,4,0,0,0,3,4,2,1,Anthony Black,ORL,ORL,MIA,,,10,6,8,6
22023,1641710,22300344,"DEC 17, 2023",ORL @ BOS,L,17,2,5,0.4,1,3,0.333,0,3,0.0,1,1,2,3,1,0,0,1,5,17,1,Anthony Black,ORL,BOS,ORL,,,10,7,8,5
22023,1641710,22300329,"DEC 15, 2023",ORL @ BOS,L,28,5,8,0.625,3,5,0.6,0,0,0.0,3,6,9,4,0,0,0,2,13,0,1,Anthony Black,ORL,BOS,ORL,,,26,22,17,13
22023,1641710,22300294,"DEC 11, 2023",ORL vs. CLE,W,19,0,2,0.0,0,1,0.0,0,0,0.0,0,1,1,0,3,1,1,3,0,12,1,Anthony Black,ORL,ORL,CLE,,,1,1,0,1
22023,1641710,22301217,"DEC 08, 2023",ORL vs. DET,W,25,2,4,0.5,0,1,0.0,2,4,0.5,1,4,5,3,0,0,1,2,6,7,1,Anthony Black,ORL,ORL,DET,,,14,11,9,8
22023,1641710,22301205,"DEC 06, 2023",ORL @ CLE,L,15,5,5,1.0,0,0,0.0,1,1,1.0,0,0,0,0,0,0,0,1,11,-7,1,Anthony Black,ORL,CLE,ORL,,,11,11,11,0
22023,1641710,22300282,"DEC 02, 2023",ORL @ BKN,L,19,1,1,1.0,0,0,0.0,0,0,0.0,0,3,3,1,0,0,0,3,2,-5,1,Anthony Black,ORL,BKN,ORL,,,6,5,3,4
22023,1641710,22300274,"DEC 01, 2023",ORL vs. WAS,W,23,2,4,0.5,1,1,1.0,1,2,0.5,0,2,2,3,0,1,1,3,6,-5,1,Anthony Black,ORL,ORL,WAS,,,11,8,9,5
22023,1641710,22300259,"NOV 29, 2023",ORL vs. WAS,W,27,3,5,0.6,1,2,0.5,0,0,0.0,0,5,5,3,0,1,2,1,7,4,1,Anthony Black,ORL,ORL,WAS,,,15,12,10,8
22023,1641710,22300248,"NOV 26, 2023",ORL vs. CHA,W,15,1,4,0.25,0,1,0.0,0,0,0.0,0,0,0,3,0,0,0,3,2,-2,1,Anthony Black,ORL,ORL,CHA,,,5,2,5,3
22023,1641710,22300043,"NOV 24, 2023",ORL vs. BOS,W,6,0,1,0.0,0,0,0.0,0,0,0.0,0,1,1,0,0,0,1,1,0,-6,1,Anthony Black,ORL,ORL,BOS,,,1,1,0,1
22023,1641710,22300226,"NOV 22, 2023",ORL vs. DEN,W,15,0,1,0.0,0,0,0.0,0,0,0.0,0,1,1,1,0,0,3,2,0,4,1,Anthony Black,ORL,ORL,DEN,,,2,1,1,2
22023,1641710,22300038,"NOV 21, 2023",ORL vs. TOR,W,23,2,7,0.286,0,3,0.0,1,2,0.5,2,3,5,1,1,0,0,3,5,7,1,Anthony Black,ORL,ORL,TOR,,,11,10,6,6
22023,1641710,22300209,"NOV 19, 2023",ORL @ IND,W,24,1,5,0.2,0,2,0.0,5,6,0.833,0,5,5,1,0,2,2,5,7,-6,1,Anthony Black,ORL,IND,ORL,,,13,12,8,6
22023,1641710,22300033,"NOV 17, 2023",ORL @ CHI,W,11,1,2,0.5,0,0,0.0,0,1,0.0,0,0,0,0,0,0,3,0,2,-4,1,Anthony Black,ORL,CHI,ORL,,,2,2,2,0
22023,1641710,22300196,"NOV 15, 2023",ORL @ CHI,W,27,3,8,0.375,0,2,0.0,1,2,0.5,2,2,4,2,0,0,2,3,7,-2,1,Anthony Black,ORL,CHI,ORL,,,13,11,9,6
22023,1641710,22300020,"NOV 14, 2023",ORL @ BKN,L,19,1,4,0.25,0,3,0.0,0,0,0.0,0,0,0,1,0,0,1,2,2,-4,1,Anthony Black,ORL,BKN,ORL,,,3,2,3,1
22023,1641710,22300173,"NOV 11, 2023",ORL vs. MIL,W,28,1,3,0.333,0,1,0.0,0,0,0.0,0,0,0,3,0,0,1,2,2,6,1,Anthony Black,ORL,ORL,MIL,,,5,2,5,3
22023,1641710,22300172,"NOV 09, 2023",ORL vs. ATL,L,17,3,4,0.75,1,2,0.5,2,2,1.0,2,1,3,1,1,1,1,3,9,-3,1,Anthony Black,ORL,ORL,ATL,,,13,12,10,4
22023,1641710,22300147,"NOV 06, 2023",ORL vs. DAL,L,33,3,7,0.429,2,4,0.5,0,0,0.0,2,3,5,2,0,0,1,2,8,-13,1,Anthony Black,ORL,ORL,DAL,,,15,13,10,7
22023,1641710,22300134,"NOV 04, 2023",ORL vs. LAL,W,30,4,6,0.667,2,3,0.667,1,1,1.0,1,3,4,2,1,0,0,2,11,32,1,Anthony Black,ORL,ORL,LAL,,,17,15,13,6
22023,1641710,22300130,"NOV 02, 2023",ORL @ UTA,W,16,4,4,1.0,0,0,0.0,1,3,0.333,1,2,3,1,2,0,1,2,9,6,1,Anthony Black,ORL,UTA,ORL,,,13,12,10,4
22023,1641710,22300114,"OCT 31, 2023",ORL @ LAC,L,4,0,0,0.0,0,0,0.0,0,0,0.0,0,0,0,1,0,0,0,1,0,-1,1,Anthony Black,ORL,LAC,ORL,,,1,0,1,1
22023,1641710,22300066,"OCT 25, 2023",ORL vs. HOU,W,5,2,2,1.0,0,0,0.0,1,1,1.0,0,0,0,1,0,2,0,0,5,9,1,Anthony Black,ORL,ORL,HOU,,,6,5,6,1
22023,1641778,22300551,"JAN 14, 2024",CHA @ MIA,L,2,0,0,0.0,0,0,0.0,0,0,0.0,0,0,0,0,0,0,0,0,0,1,1,Leaky Black,CHA,MIA,CHA,,,0,0,0,0
22023,1641778,22300541,"JAN 12, 2024",CHA @ SAS,L,7,1,2,0.5,0,1,0.0,0,0,0.0,0,0,0,0,0,0,0,1,2,-9,1,Leaky Black,CHA,SAS,CHA,,,2,2,2,0
22023,1641778,22300518,"JAN 10, 2024",CHA vs. SAC,L,6,0,0,0.0,0,0,0.0,0,0,0.0,0,0,0,0,0,0,0,0,0,0,1,Leaky Black,CHA,CHA,SAC,,,0,0,0,0
22023,1641778,22300365,"DEC 20, 2023",CHA @ IND,L,4,0,0,0.0,0,0,0.0,0,0,0.0,0,0,0,0,0,0,0,0,0,-3,1,Leaky Black,CHA,IND,CHA,,,0,0,0,0
22023,1641778,22300354,"DEC 18, 2023",CHA @ TOR,L,11,2,2,1.0,0,0,0.0,0,0,0.0,2,2,4,1,0,0,0,1,4,-12,1,Leaky Black,CHA,TOR,CHA,,,9,8,5,5
22023,1641778,22300335,"DEC 16, 2023",CHA vs. PHI,L,7,1,1,1.0,0,0,0.0,0,0,0.0,0,1,1,2,1,1,1,0,2,-6,1,Leaky Black,CHA,CHA,PHI,,,5,3,4,3
22023,1641778,22300057,"NOV 28, 2023",CHA @ NYK,L,5,0,0,0.0,0,0,0.0,0,0,0.0,0,0,0,0,1,0,0,0,0,-1,1,Leaky Black,CHA,NYK,CHA,,,0,0,0,0
22023,1641778,22300017,"NOV 14, 2023",CHA vs. MIA,L,3,0,2,0.0,0,1,0.0,0,0,0.0,0,0,0,0,0,0,0,0,0,-4,1,Leaky Black,CHA,CHA,MIA,,,0,0,0,0
22023,1641778,22300177,"NOV 12, 2023",CHA @ NYK,L,6,2,2,1.0,1,1,1.0,0,0,0.0,0,2,2,0,0,1,0,1,5,13,1,Leaky Black,CHA,NYK,CHA,,,7,7,5,2
22023,1641778,22300157,"NOV 08, 2023",CHA vs. WAS,L,4,0,1,0.0,0,0,0.0,0,0,0.0,0,0,0,1,0,1,0,0,0,4,1,Leaky Black,CHA,CHA,WAS,,,1,0,1,1
22023,203992,22300559,"JAN 15, 2024",ATL vs. SAS,W,26,2,10,0.2,1,6,0.167,0,0,0.0,0,2,2,1,1,0,3,2,5,4,1,Bogdan Bogdanovic,ATL,ATL,SAS,,,8,7,6,3
22023,203992,22300543,"JAN 13, 2024",ATL vs. WAS,L,24,5,13,0.385,3,8,0.375,1,1,1.0,1,2,3,2,3,0,0,2,14,-20,1,Bogdan Bogdanovic,ATL,ATL,WAS,,,19,17,16,5
22023,203992,22300533,"JAN 12, 2024",ATL vs. IND,L,25,3,12,0.25,2,5,0.4,2,2,1.0,3,2,5,2,3,0,2,2,10,-24,1,Bogdan Bogdanovic,ATL,ATL,IND,,,17,15,12,7
22023,203992,22300521,"JAN 10, 2024",ATL vs. PHI,W,28,7,16,0.438,1,8,0.125,0,1,0.0,0,2,2,4,2,0,1,1,15,12,1,Bogdan Bogdanovic,ATL,ATL,PHI,,,21,17,19,6
22023,203992,22300499,"JAN 07, 2024",ATL @ ORL,L,26,7,17,0.412,4,9,0.444,0,0,0.0,1,2,3,1,4,0,0,5,18,13,1,Bogdan Bogdanovic,ATL,ORL,ATL,,,22,21,19,4
22023,203992,22300480,"JAN 05, 2024",ATL @ IND,L,23,3,14,0.214,1,9,0.111,9,10,0.9,0,4,4,3,2,0,3,2,16,-18,1,Bogdan Bogdanovic,ATL,IND,ATL,,,23,20,19,7
22023,203992,22300467,"JAN 03, 2024",ATL vs. OKC,W,28,7,16,0.438,5,11,0.455,4,4,1.0,0,1,1,4,1,0,0,2,23,11,1,Bogdan Bogdanovic,ATL,ATL,OKC,,,28,24,27,5
22023,203992,22300445,"DEC 31, 2023",ATL @ WAS,W,27,5,19,0.263,1,8,0.125,1,1,1.0,0,1,1,1,0,0,0,1,12,24,1,Bogdan Bogdanovic,ATL,WAS,ATL,,,14,13,13,2
22023,203992,22300431,"DEC 29, 2023",ATL vs. SAC,L,27,4,14,0.286,2,10,0.2,2,2,1.0,2,2,4,5,0,0,1,1,12,-14,1,Bogdan Bogdanovic,ATL,ATL,SAC,,,21,16,17,9
22023,203992,22300408,"DEC 26, 2023",ATL @ CHI,L,31,8,21,0.381,3,12,0.25,3,3,1.0,1,2,3,1,0,0,0,2,22,3,1,Bogdan Bogdanovic,ATL,CHI,ATL,,,26,25,23,4
22023,203992,22300393,"DEC 23, 2023",ATL vs. MEM,L,34,6,15,0.4,2,8,0.25,2,3,0.667,1,3,4,3,0,0,0,2,16,-1,1,Bogdan Bogdanovic,ATL,ATL,MEM,,,23,20,19,7
22023,203992,22300384,"DEC 22, 2023",ATL @ MIA,L,35,8,24,0.333,6,18,0.333,1,2,0.5,1,1,2,5,1,0,0,3,23,-8,1,Bogdan Bogdanovic,ATL,MIA,ATL,,,30,25,28,7
22023,203992,22300371,"DEC 20, 2023",ATL @ HOU,W,30,8,14,0.571,4,8,0.5,2,2,1.0,0,4,4,5,1,1,0,3,22,14,1,Bogdan Bogdanovic,ATL,HOU,ATL,,,31,26,27,9
22023,203992,22300330,"DEC 15, 2023",ATL @ TOR,W,33,7,16,0.438,3,7,0.429,3,3,1.0,0,3,3,6,0,0,0,2,20,21,1,Bogdan Bogdanovic,ATL,TOR,ATL,,,29,23,26,9
22023,203992,22300313,"DEC 13, 2023",ATL @ TOR,L,32,7,13,0.538,4,7,0.571,2,3,0.667,1,2,3,5,4,0,1,4,20,5,1,Bogdan Bogdanovic,ATL,TOR,ATL,,,28,23,25,8
22023,203992,22300296,"DEC 11, 2023",ATL vs. DEN,L,36,14,24,0.583,10,17,0.588,2,2,1.0,1,2,3,3,2,0,1,4,40,-2,1,Bogdan Bogdanovic,ATL,ATL,DEN,,,46,43,43,6
22023,203992,22301218,"DEC 08, 2023",ATL @ PHI,L,39,7,17,0.412,3,11,0.273,3,3,1.0,1,8,9,2,1,0,2,5,20,-3,1,Bogdan Bogdanovic,ATL,PHI,ATL,,,31,29,22,11
22023,203992,22301209,"DEC 06, 2023",ATL vs. BKN,L,27,7,14,0.5,4,9,0.444,2,2,1.0,0,4,4,1,0,0,0,2,20,-6,1,Bogdan Bogdanovic,ATL,ATL,BKN,,,25,24,21,5
22023,203992,22300286,"DEC 02, 2023",ATL @ MIL,L,25,6,18,0.333,2,7,0.286,0,0,0.0,0,3,3,0,2,1,0,2,14,-7,1,Bogdan Bogdanovic,ATL,MIL,ATL,,,17,17,14,3
22023,203992,22300272,"NOV 30, 2023",ATL @ SAS,W,32,5,10,0.5,2,4,0.5,2,2,1.0,0,2,2,3,2,0,1,4,14,12,1,Bogdan Bogdanovic,ATL,SAS,ATL,,,19,16,17,5
22023,203992,22300055,"NOV 28, 2023",ATL @ CLE,L,31,6,16,0.375,4,10,0.4,2,2,1.0,1,5,6,1,2,0,1,2,18,-3,1,Bogdan Bogdanovic,ATL,CLE,ATL,,,25,24,19,7
22023,203992,22300246,"NOV 26, 2023",ATL @ BOS,L,32,8,12,0.667,7,10,0.7,0,0,0.0,1,6,7,0,1,0,4,3,23,-1,1,Bogdan Bogdanovic,ATL,BOS,ATL,,,30,30,23,7
22023,203992,22300241,"NOV 25, 2023",ATL @ WAS,W,21,6,9,0.667,3,3,1.0,0,1,0.0,0,3,3,1,1,0,2,3,15,13,1,Bogdan Bogdanovic,ATL,WAS,ATL,,,19,18,16,4
22023,203992,22300227,"NOV 22, 2023",ATL vs. BKN,W,26,5,15,0.333,3,11,0.273,1,1,1.0,1,3,4,3,1,1,1,4,14,17,1,Bogdan Bogdanovic,ATL,ATL,BKN,,,21,18,17,7
22023,203992,22300039,"NOV 21, 2023",ATL vs. IND,L,26,10,15,0.667,2,5,0.4,4,4,1.0,0,2,2,0,0,0,0,4,26,-2,1,Bogdan Bogdanovic,ATL,ATL,IND,,,28,28,26,2
22023,203992,22300029,"NOV 17, 2023",ATL vs. PHI,L,24,4,12,0.333,3,8,0.375,2,3,0.667,0,2,2,3,3,0,3,3,13,-14,1,Bogdan Bogdanovic,ATL,ATL,PHI,,,18,15,16,5
22023,203992,22300193,"NOV 15, 2023",ATL vs. NYK,L,29,8,15,0.533,4,11,0.364,8,8,1.0,1,2,3,3,2,1,1,4,28,11,1,Bogdan Bogdanovic,ATL,ATL,NYK,,,34,31,31,6
22023,203992,22300018,"NOV 14, 2023",ATL @ DET,W,34,7,17,0.412,3,11,0.273,0,0,0.0,0,3,3,3,0,1,3,0,17,5,1,Bogdan Bogdanovic,ATL,DET,ATL,,,23,20,20,6
22023,203992,22300175,"NOV 11, 2023",ATL vs. MIA,L,29,5,13,0.385,5,12,0.417,0,0,0.0,0,3,3,1,0,0,2,4,15,-3,1,Bogdan Bogdanovic,ATL,ATL,MIA,,,19,18,16,4
22023,203992,22300172,"NOV 09, 2023",ATL @ ORL,W,29,6,11,0.545,3,6,0.5,0,0,0.0,0,4,4,3,3,0,1,3,15,-4,1,Bogdan Bogdanovic,ATL,ORL,ATL,,,22,19,18,7
22023,203992,22300155,"NOV 06, 2023",ATL @ OKC,L,27,7,14,0.5,3,8,0.375,0,0,0.0,0,2,2,3,2,0,0,1,17,3,1,Bogdan Bogdanovic,ATL,OKC,ATL,,,22,19,20,5
22023,203992,22300135,"NOV 04, 2023",ATL @ NOP,W,21,4,14,0.286,2,10,0.2,0,0,0.0,3,2,5,2,1,2,0,1,10,7,1,Bogdan Bogdanovic,ATL,NOP,ATL,,,17,15,12,7
22023,203992,22300117,"NOV 01, 2023",ATL vs. WAS,W,23,4,10,0.4,1,5,0.2,3,3,1.0,0,3,3,1,1,1,1,2,12,8,1,Bogdan Bogdanovic,ATL,ATL,WAS,,,16,15,13,4
22023,203992,22300104,"OCT 30, 2023",ATL vs. MIN,W,20,3,10,0.3,2,7,0.286,0,0,0.0,0,1,1,4,1,0,1,1,8,3,1,Bogdan Bogdanovic,ATL,ATL,MIN,,,13,9,12,5
22023,203992,22300097,"OCT 29, 2023",ATL @ MIL,W,26,6,10,0.6,4,7,0.571,1,1,1.0,0,1,1,6,2,0,2,1,17,12,1,Bogdan Bogdanovic,ATL,MIL,ATL,,,24,18,23,7
22023,203992,22300079,"OCT 27, 2023",ATL vs. NYK,L,26,6,11,0.545,4,9,0.444,0,0,0.0,0,1,1,3,1,0,2,3,16,0,1,Bogdan Bogdanovic,ATL,ATL,NYK,,,20,17,19,4
22023,203992,22300063,"OCT 25, 2023",ATL @ CHA,L,24,3,9,0.333,1,5,0.2,0,0,0.0,0,4,4,4,3,0,0,1,7,6,1,Bogdan Bogdanovic,ATL,CHA,ATL,,,15,11,11,8
22023,202711,22300519,"JAN 10, 2024",DET vs. SAS,L,33,8,13,0.615,3,5,0.6,0,0,0.0,0,2,2,2,1,0,4,1,19,-16,1,Bojan Bogdanovic,DET,DET,SAS,,,23,21,21,4
22023,202711,22300512,"JAN 09, 2024",DET vs. SAC,L,33,10,14,0.714,4,7,0.571,2,3,0.667,1,4,5,2,3,0,3,1,26,-19,1,Bojan Bogdanovic,DET,DET,SAC,,,33,31,28,7
22023,202711,22300502,"JAN 07, 2024",DET @ DEN,L,27,6,12,0.5,2,4,0.5,0,0,0.0,0,1,1,1,3,0,3,2,14,-4,1,Bojan Bogdanovic,DET,DEN,DET,,,16,15,15,2
22023,202711,22300490,"JAN 05, 2024",DET @ GSW,L,36,5,19,0.263,2,8,0.25,0,0,0.0,2,3,5,3,2,0,1,0,12,-7,1,Bojan Bogdanovic,DET,GSW,DET,,,20,17,15,8
22023,202711,22300474,"JAN 03, 2024",DET @ UTA,L,43,13,26,0.5,8,15,0.533,2,2,1.0,1,6,7,5,1,0,1,6,36,-5,1,Bojan Bogdanovic,DET,UTA,DET,,,48,43,41,12
22023,202711,22300453,"JAN 01, 2024",DET @ HOU,L,27,4,11,0.364,3,6,0.5,3,4,0.75,1,1,2,2,0,0,4,0,14,-21,1,Bojan Bogdanovic,DET,HOU,DET,,,18,16,16,4
22023,202711,22300440,"DEC 30, 2023",DET vs. TOR,W,37,7,14,0.5,2,6,0.333,3,5,0.6,0,7,7,3,0,0,4,2,19,-4,1,Bojan Bogdanovic,DET,DET,TOR,,,29,26,22,10
22023,202711,22300421,"DEC 28, 2023",DET @ BOS,L,44,8,21,0.381,1,7,0.143,0,0,0.0,2,10,12,6,0,0,2,3,17,-6,1,Bojan Bogdanovic,DET,BOS,DET,,,35,29,23,18
22023,202711,22300406,"DEC 26, 2023",DET vs. BKN,L,39,9,19,0.474,3,9,0.333,2,3,0.667,0,3,3,2,0,0,4,6,23,-3,1,Bojan Bogdanovic,DET,DET,BKN,,,28,26,25,5
22023,202711,22300394,"DEC 23, 2023",DET @ BKN,L,39,5,13,0.385,2,7,0.286,7,9,0.778,2,6,8,4,2,0,4,4,19,0,1,Bojan Bogdanovic,DET,BKN,DET,,,31,27,23,12
22023,202711,22300374,"DEC 21, 2023",DET vs. UTA,L,35,3,12,0.25,2,7,0.286,0,0,0.0,0,1,1,1,0,1,1,4,8,-1,1,Bojan Bogdanovic,DET,DET,UTA,,,10,9,9,2
22023,202711,22300352,"DEC 18, 2023",DET @ ATL,L,39,9,17,0.529,5,9,0.556,2,3,0.667,1,1,2,2,0,0,2,3,25,4,1,Bojan Bogdanovic,DET,ATL,DET,,,29,27,27,4
22023,202711,22300334,"DEC 16, 2023",DET @ MIL,L,31,8,15,0.533,2,6,0.333,6,6,1.0,1,1,2,2,0,0,2,3,24,-16,1,Bojan Bogdanovic,DET,MIL,DET,,,28,26,26,4
22023,202711,22300327,"DEC 15, 2023",DET @ PHI,L,26,6,12,0.5,2,5,0.4,3,4,0.75,1,2,3,2,0,0,3,1,17,-28,1,Bojan Bogdanovic,DET,PHI,DET,,,22,20,19,5
22023,202711,22300310,"DEC 13, 2023",DET vs. PHI,L,33,11,19,0.579,5,9,0.556,6,8,0.75,0,1,1,2,1,0,1,1,33,-10,1,Bojan Bogdanovic,DET,DET,PHI,,,36,34,35,3
22023,202711,22300293,"DEC 11, 2023",DET vs. IND,L,34,5,14,0.357,3,9,0.333,4,7,0.571,0,1,1,2,3,0,2,2,17,-12,1,Bojan Bogdanovic,DET,DET,IND,,,20,18,19,3
22023,202711,22301217,"DEC 08, 2023",DET @ ORL,L,29,4,10,0.4,1,3,0.333,0,1,0.0,0,3,3,1,1,0,2,1,9,-18,1,Bojan Bogdanovic,DET,ORL,DET,,,13,12,10,4
22023,202711,22301206,"DEC 06, 2023",DET vs. MEM,L,32,8,15,0.533,4,8,0.5,2,2,1.0,0,4,4,7,3,0,2,0,22,-1,1,Bojan Bogdanovic,DET,DET,MEM,,,33,26,29,11
22023,202711,22300283,"DEC 02, 2023",DET vs. CLE,L,27,7,15,0.467,3,10,0.3,5,6,0.833,1,1,2,2,1,0,1,1,22,-8,1,Bojan Bogdanovic,DET,DET,CLE,,,26,24,24,4
22023,1629626,22300531,"JAN 11, 2024",PHX @ LAL,W,17,2,3,0.667,0,0,0.0,2,2,1.0,2,4,6,2,2,2,0,1,6,9,1,Bol Bol,PHX,LAL,PHX,,,14,12,8,8
22023,1629626,22300489,"JAN 05, 2024",PHX vs. MIA,W,10,2,2,1.0,0,0,0.0,0,1,0.0,1,2,3,1,0,1,0,1,4,0,1,Bol Bol,PHX,PHX,MIA,,,8,7,5,4
22023,1629626,22300473,"JAN 03, 2024",PHX vs. LAC,L,19,6,7,0.857,2,2,1.0,0,0,0.0,3,2,5,2,1,0,2,2,14,9,1,Bol Bol,PHX,PHX,LAC,,,21,19,16,7
22023,1629626,22300456,"JAN 01, 2024",PHX vs. POR,W,20,4,6,0.667,1,2,0.5,2,2,1.0,2,7,9,1,0,0,2,5,11,10,1,Bol Bol,PHX,PHX,POR,,,21,20,12,10
22023,1629626,22300418,"DEC 27, 2023",PHX @ HOU,W,2,0,0,0.0,0,0,0.0,0,0,0.0,0,0,0,0,0,2,0,0,0,-2,1,Bol Bol,PHX,HOU,PHX,,,0,0,0,0
22023,1629626,22300387,"DEC 22, 2023",PHX @ SAC,L,3,1,2,0.5,0,0,0.0,0,0,0.0,1,0,1,0,0,0,0,0,2,4,1,Bol Bol,PHX,SAC,PHX,,,3,3,2,1
22023,1629626,22300333,"DEC 15, 2023",PHX vs. NYK,L,2,1,1,1.0,0,0,0.0,0,0,0.0,0,0,0,0,0,0,0,0,2,2,1,Bol Bol,PHX,PHX,NYK,,,2,2,2,0
22023,1629626,22300308,"DEC 12, 2023",PHX vs. GSW,W,5,0,1,0.0,0,1,0.0,0,0,0.0,0,2,2,0,0,0,0,1,0,-16,1,Bol Bol,PHX,PHX,GSW,,,2,2,0,2
22023,1629626,22301228,"DEC 08, 2023",PHX vs. SAC,L,1,0,0,0.0,0,0,0.0,0,0,0.0,0,0,0,0,0,0,0,0,0,4,1,Bol Bol,PHX,PHX,SAC,,,0,0,0,0
22023,1629626,22300162,"NOV 08, 2023",PHX @ CHI,W,0,0,0,0.0,0,0,0.0,0,0,0.0,0,0,0,0,0,0,0,0,0,0,1,Bol Bol,PHX,CHI,PHX,,,0,0,0,0
22023,1629626,22300140,"NOV 05, 2023",PHX @ DET,W,3,1,1,1.0,0,0,0.0,0,0,0.0,0,0,0,0,0,0,0,0,2,-5,1,Bol Bol,PHX,DET,PHX,,,2,2,2,0
22023,1629626,22300094,"OCT 28, 2023",PHX vs. UTA,W,4,0,0,0.0,0,0,0.0,0,0,0.0,0,1,1,0,0,1,2,0,0,-4,1,Bol Bol,PHX,PHX,UTA,,,1,1,0,1
22023,1629716,22300346,"DEC 17, 2023",MIL vs. HOU,W,0,0,0,0.0,0,0,0.0,0,0,0.0,0,0,0,0,0,0,0,0,0,-3,1,Marques Bolden,MIL,MIL,HOU,,,0,0,0,0
22023,1629716,22300027,"NOV 17, 2023",MIL @ CHA,W,3,0,0,0.0,0,0,0.0,0,0,0.0,0,2,2,0,0,0,0,1,0,11,1,Marques Bolden,MIL,CHA,MIL,,,2,2,0,2
22023,1626164,22300554,"JAN 14, 2024",PHX @ POR,W,39,14,22,0.636,1,6,0.167,5,5,1.0,0,6,6,7,0,0,0,2,34,17,1,Devin Booker,PHX,POR,PHX,26.5,Points,47,40,41,13
22023,1626164,22300554,"JAN 14, 2024",PHX @ POR,W,39,14,22,0.636,1,6,0.167,5,5,1.0,0,6,6,7,0,0,0,2,34,17,1,Devin Booker,PHX,POR,PHX,4.5,Rebounds,47,40,41,13
22023,1626164,22300554,"JAN 14, 2024",PHX @ POR,W,39,14,22,0.636,1,6,0.167,5,5,1.0,0,6,6,7,0,0,0,2,34,17,1,Devin Booker,PHX,POR,PHX,39.5,Pts+Rebs+Asts,47,40,41,13
22023,1626164,22300554,"JAN 14, 2024",PHX @ POR,W,39,14,22,0.636,1,6,0.167,5,5,1.0,0,6,6,7,0,0,0,2,34,17,1,Devin Booker,PHX,POR,PHX,7.0,Assists,47,40,41,13
22023,1626164,22300554,"JAN 14, 2024",PHX @ POR,W,39,14,22,0.636,1,6,0.167,5,5,1.0,0,6,6,7,0,0,0,2,34,17,1,Devin Booker,PHX,POR,PHX,44.5,Fantasy Score,47,40,41,13
22023,1626164,22300554,"JAN 14, 2024",PHX @ POR,W,39,14,22,0.636,1,6,0.167,5,5,1.0,0,6,6,7,0,0,0,2,34,17,1,Devin Booker,PHX,POR,PHX,6.0,3-PT Attempted,47,40,41,13
22023,1626164,22300554,"JAN 14, 2024",PHX @ POR,W,39,14,22,0.636,1,6,0.167,5,5,1.0,0,6,6,7,0,0,0,2,34,17,1,Devin Booker,PHX,POR,PHX,5.0,Free Throws Made,47,40,41,13
22023,1626164,22300554,"JAN 14, 2024",PHX @ POR,W,39,14,22,0.636,1,6,0.167,5,5,1.0,0,6,6,7,0,0,0,2,34,17,1,Devin Booker,PHX,POR,PHX,19.0,FG Attempted,47,40,41,13
22023,1626164,22300554,"JAN 14, 2024",PHX @ POR,W,39,14,22,0.636,1,6,0.167,5,5,1.0,0,6,6,7,0,0,0,2,34,17,1,Devin Booker,PHX,POR,PHX,31.5,Pts+Rebs,47,40,41,13
22023,1626164,22300554,"JAN 14, 2024",PHX @ POR,W,39,14,22,0.636,1,6,0.167,5,5,1.0,0,6,6,7,0,0,0,2,34,17,1,Devin Booker,PHX,POR,PHX,34.5,Pts+Asts,47,40,41,13
22023,1626164,22300554,"JAN 14, 2024",PHX @ POR,W,39,14,22,0.636,1,6,0.167,5,5,1.0,0,6,6,7,0,0,0,2,34,17,1,Devin Booker,PHX,POR,PHX,12.0,Rebs+Asts,47,40,41,13
22023,1626164,22300554,"JAN 14, 2024",PHX @ POR,W,39,14,22,0.636,1,6,0.167,5,5,1.0,0,6,6,7,0,0,0,2,34,17,1,Devin Booker,PHX,POR,PHX,2.5,Turnovers,47,40,41,13
22023,1626164,22300531,"JAN 11, 2024",PHX @ LAL,W,34,11,22,0.5,2,6,0.333,7,7,1.0,0,5,5,5,3,0,3,2,31,20,1,Devin Booker,PHX,LAL,PHX,26.5,Points,41,36,36,10
22023,1626164,22300531,"JAN 11, 2024",PHX @ LAL,W,34,11,22,0.5,2,6,0.333,7,7,1.0,0,5,5,5,3,0,3,2,31,20,1,Devin Booker,PHX,LAL,PHX,4.5,Rebounds,41,36,36,10
22023,1626164,22300531,"JAN 11, 2024",PHX @ LAL,W,34,11,22,0.5,2,6,0.333,7,7,1.0,0,5,5,5,3,0,3,2,31,20,1,Devin Booker,PHX,LAL,PHX,39.5,Pts+Rebs+Asts,41,36,36,10
22023,1626164,22300531,"JAN 11, 2024",PHX @ LAL,W,34,11,22,0.5,2,6,0.333,7,7,1.0,0,5,5,5,3,0,3,2,31,20,1,Devin Booker,PHX,LAL,PHX,7.0,Assists,41,36,36,10
22023,1626164,22300531,"JAN 11, 2024",PHX @ LAL,W,34,11,22,0.5,2,6,0.333,7,7,1.0,0,5,5,5,3,0,3,2,31,20,1,Devin Booker,PHX,LAL,PHX,44.5,Fantasy Score,41,36,36,10
22023,1626164,22300531,"JAN 11, 2024",PHX @ LAL,W,34,11,22,0.5,2,6,0.333,7,7,1.0,0,5,5,5,3,0,3,2,31,20,1,Devin Booker,PHX,LAL,PHX,6.0,3-PT Attempted,41,36,36,10
22023,1626164,22300531,"JAN 11, 2024",PHX @ LAL,W,34,11,22,0.5,2,6,0.333,7,7,1.0,0,5,5,5,3,0,3,2,31,20,1,Devin Booker,PHX,LAL,PHX,5.0,Free Throws Made,41,36,36,10
22023,1626164,22300531,"JAN 11, 2024",PHX @ LAL,W,34,11,22,0.5,2,6,0.333,7,7,1.0,0,5,5,5,3,0,3,2,31,20,1,Devin Booker,PHX,LAL,PHX,19.0,FG Attempted,41,36,36,10
22023,1626164,22300531,"JAN 11, 2024",PHX @ LAL,W,34,11,22,0.5,2,6,0.333,7,7,1.0,0,5,5,5,3,0,3,2,31,20,1,Devin Booker,PHX,LAL,PHX,31.5,Pts+Rebs,41,36,36,10
22023,1626164,22300531,"JAN 11, 2024",PHX @ LAL,W,34,11,22,0.5,2,6,0.333,7,7,1.0,0,5,5,5,3,0,3,2,31,20,1,Devin Booker,PHX,LAL,PHX,34.5,Pts+Asts,41,36,36,10
22023,1626164,22300531,"JAN 11, 2024",PHX @ LAL,W,34,11,22,0.5,2,6,0.333,7,7,1.0,0,5,5,5,3,0,3,2,31,20,1,Devin Booker,PHX,LAL,PHX,12.0,Rebs+Asts,41,36,36,10
22023,1626164,22300531,"JAN 11, 2024",PHX @ LAL,W,34,11,22,0.5,2,6,0.333,7,7,1.0,0,5,5,5,3,0,3,2,31,20,1,Devin Booker,PHX,LAL,PHX,2.5,Turnovers,41,36,36,10
22023,1626164,22300511,"JAN 08, 2024",PHX @ LAC,L,34,8,14,0.571,2,6,0.333,2,2,1.0,0,0,0,5,0,0,6,4,20,-31,1,Devin Booker,PHX,LAC,PHX,26.5,Points,25,20,25,5
22023,1626164,22300511,"JAN 08, 2024",PHX @ LAC,L,34,8,14,0.571,2,6,0.333,2,2,1.0,0,0,0,5,0,0,6,4,20,-31,1,Devin Booker,PHX,LAC,PHX,4.5,Rebounds,25,20,25,5
22023,1626164,22300511,"JAN 08, 2024",PHX @ LAC,L,34,8,14,0.571,2,6,0.333,2,2,1.0,0,0,0,5,0,0,6,4,20,-31,1,Devin Booker,PHX,LAC,PHX,39.5,Pts+Rebs+Asts,25,20,25,5
22023,1626164,22300511,"JAN 08, 2024",PHX @ LAC,L,34,8,14,0.571,2,6,0.333,2,2,1.0,0,0,0,5,0,0,6,4,20,-31,1,Devin Booker,PHX,LAC,PHX,7.0,Assists,25,20,25,5
22023,1626164,22300511,"JAN 08, 2024",PHX @ LAC,L,34,8,14,0.571,2,6,0.333,2,2,1.0,0,0,0,5,0,0,6,4,20,-31,1,Devin Booker,PHX,LAC,PHX,44.5,Fantasy Score,25,20,25,5
22023,1626164,22300511,"JAN 08, 2024",PHX @ LAC,L,34,8,14,0.571,2,6,0.333,2,2,1.0,0,0,0,5,0,0,6,4,20,-31,1,Devin Booker,PHX,LAC,PHX,6.0,3-PT Attempted,25,20,25,5
22023,1626164,22300511,"JAN 08, 2024",PHX @ LAC,L,34,8,14,0.571,2,6,0.333,2,2,1.0,0,0,0,5,0,0,6,4,20,-31,1,Devin Booker,PHX,LAC,PHX,5.0,Free Throws Made,25,20,25,5
22023,1626164,22300511,"JAN 08, 2024",PHX @ LAC,L,34,8,14,0.571,2,6,0.333,2,2,1.0,0,0,0,5,0,0,6,4,20,-31,1,Devin Booker,PHX,LAC,PHX,19.0,FG Attempted,25,20,25,5
22023,1626164,22300511,"JAN 08, 2024",PHX @ LAC,L,34,8,14,0.571,2,6,0.333,2,2,1.0,0,0,0,5,0,0,6,4,20,-31,1,Devin Booker,PHX,LAC,PHX,31.5,Pts+Rebs,25,20,25,5
22023,1626164,22300511,"JAN 08, 2024",PHX @ LAC,L,34,8,14,0.571,2,6,0.333,2,2,1.0,0,0,0,5,0,0,6,4,20,-31,1,Devin Booker,PHX,LAC,PHX,34.5,Pts+Asts,25,20,25,5
22023,1626164,22300511,"JAN 08, 2024",PHX @ LAC,L,34,8,14,0.571,2,6,0.333,2,2,1.0,0,0,0,5,0,0,6,4,20,-31,1,Devin Booker,PHX,LAC,PHX,12.0,Rebs+Asts,25,20,25,5
22023,1626164,22300511,"JAN 08, 2024",PHX @ LAC,L,34,8,14,0.571,2,6,0.333,2,2,1.0,0,0,0,5,0,0,6,4,20,-31,1,Devin Booker,PHX,LAC,PHX,2.5,Turnovers,25,20,25,5
22023,1626164,22300503,"JAN 07, 2024",PHX vs. MEM,L,37,9,17,0.529,2,6,0.333,4,5,0.8,0,0,0,8,2,1,2,4,24,11,1,Devin Booker,PHX,PHX,MEM,26.5,Points,32,24,32,8
22023,1626164,22300503,"JAN 07, 2024",PHX vs. MEM,L,37,9,17,0.529,2,6,0.333,4,5,0.8,0,0,0,8,2,1,2,4,24,11,1,Devin Booker,PHX,PHX,MEM,4.5,Rebounds,32,24,32,8
22023,1626164,22300503,"JAN 07, 2024",PHX vs. MEM,L,37,9,17,0.529,2,6,0.333,4,5,0.8,0,0,0,8,2,1,2,4,24,11,1,Devin Booker,PHX,PHX,MEM,39.5,Pts+Rebs+Asts,32,24,32,8
22023,1626164,22300503,"JAN 07, 2024",PHX vs. MEM,L,37,9,17,0.529,2,6,0.333,4,5,0.8,0,0,0,8,2,1,2,4,24,11,1,Devin Booker,PHX,PHX,MEM,7.0,Assists,32,24,32,8
22023,1626164,22300503,"JAN 07, 2024",PHX vs. MEM,L,37,9,17,0.529,2,6,0.333,4,5,0.8,0,0,0,8,2,1,2,4,24,11,1,Devin Booker,PHX,PHX,MEM,44.5,Fantasy Score,32,24,32,8
22023,1626164,22300503,"JAN 07, 2024",PHX vs. MEM,L,37,9,17,0.529,2,6,0.333,4,5,0.8,0,0,0,8,2,1,2,4,24,11,1,Devin Booker,PHX,PHX,MEM,6.0,3-PT Attempted,32,24,32,8
22023,1626164,22300503,"JAN 07, 2024",PHX vs. MEM,L,37,9,17,0.529,2,6,0.333,4,5,0.8,0,0,0,8,2,1,2,4,24,11,1,Devin Booker,PHX,PHX,MEM,5.0,Free Throws Made,32,24,32,8
22023,1626164,22300503,"JAN 07, 2024",PHX vs. MEM,L,37,9,17,0.529,2,6,0.333,4,5,0.8,0,0,0,8,2,1,2,4,24,11,1,Devin Booker,PHX,PHX,MEM,19.0,FG Attempted,32,24,32,8
22023,1626164,22300503,"JAN 07, 2024",PHX vs. MEM,L,37,9,17,0.529,2,6,0.333,4,5,0.8,0,0,0,8,2,1,2,4,24,11,1,Devin Booker,PHX,PHX,MEM,31.5,Pts+Rebs,32,24,32,8
22023,1626164,22300503,"JAN 07, 2024",PHX vs. MEM,L,37,9,17,0.529,2,6,0.333,4,5,0.8,0,0,0,8,2,1,2,4,24,11,1,Devin Booker,PHX,PHX,MEM,34.5,Pts+Asts,32,24,32,8
22023,1626164,22300503,"JAN 07, 2024",PHX vs. MEM,L,37,9,17,0.529,2,6,0.333,4,5,0.8,0,0,0,8,2,1,2,4,24,11,1,Devin Booker,PHX,PHX,MEM,12.0,Rebs+Asts,32,24,32,8
22023,1626164,22300503,"JAN 07, 2024",PHX vs. MEM,L,37,9,17,0.529,2,6,0.333,4,5,0.8,0,0,0,8,2,1,2,4,24,11,1,Devin Booker,PHX,PHX,MEM,2.5,Turnovers,32,24,32,8
22023,1626164,22300489,"JAN 05, 2024",PHX vs. MIA,W,35,9,19,0.474,2,7,0.286,0,0,0.0,0,5,5,10,2,0,3,2,20,25,1,Devin Booker,PHX,PHX,MIA,26.5,Points,35,25,30,15
22023,1626164,22300489,"JAN 05, 2024",PHX vs. MIA,W,35,9,19,0.474,2,7,0.286,0,0,0.0,0,5,5,10,2,0,3,2,20,25,1,Devin Booker,PHX,PHX,MIA,4.5,Rebounds,35,25,30,15
22023,1626164,22300489,"JAN 05, 2024",PHX vs. MIA,W,35,9,19,0.474,2,7,0.286,0,0,0.0,0,5,5,10,2,0,3,2,20,25,1,Devin Booker,PHX,PHX,MIA,39.5,Pts+Rebs+Asts,35,25,30,15
22023,1626164,22300489,"JAN 05, 2024",PHX vs. MIA,W,35,9,19,0.474,2,7,0.286,0,0,0.0,0,5,5,10,2,0,3,2,20,25,1,Devin Booker,PHX,PHX,MIA,7.0,Assists,35,25,30,15
22023,1626164,22300489,"JAN 05, 2024",PHX vs. MIA,W,35,9,19,0.474,2,7,0.286,0,0,0.0,0,5,5,10,2,0,3,2,20,25,1,Devin Booker,PHX,PHX,MIA,44.5,Fantasy Score,35,25,30,15
22023,1626164,22300489,"JAN 05, 2024",PHX vs. MIA,W,35,9,19,0.474,2,7,0.286,0,0,0.0,0,5,5,10,2,0,3,2,20,25,1,Devin Booker,PHX,PHX,MIA,6.0,3-PT Attempted,35,25,30,15
22023,1626164,22300489,"JAN 05, 2024",PHX vs. MIA,W,35,9,19,0.474,2,7,0.286,0,0,0.0,0,5,5,10,2,0,3,2,20,25,1,Devin Booker,PHX,PHX,MIA,5.0,Free Throws Made,35,25,30,15
22023,1626164,22300489,"JAN 05, 2024",PHX vs. MIA,W,35,9,19,0.474,2,7,0.286,0,0,0.0,0,5,5,10,2,0,3,2,20,25,1,Devin Booker,PHX,PHX,MIA,19.0,FG Attempted,35,25,30,15
22023,1626164,22300489,"JAN 05, 2024",PHX vs. MIA,W,35,9,19,0.474,2,7,0.286,0,0,0.0,0,5,5,10,2,0,3,2,20,25,1,Devin Booker,PHX,PHX,MIA,31.5,Pts+Rebs,35,25,30,15
22023,1626164,22300489,"JAN 05, 2024",PHX vs. MIA,W,35,9,19,0.474,2,7,0.286,0,0,0.0,0,5,5,10,2,0,3,2,20,25,1,Devin Booker,PHX,PHX,MIA,34.5,Pts+Asts,35,25,30,15
22023,1626164,22300489,"JAN 05, 2024",PHX vs. MIA,W,35,9,19,0.474,2,7,0.286,0,0,0.0,0,5,5,10,2,0,3,2,20,25,1,Devin Booker,PHX,PHX,MIA,12.0,Rebs+Asts,35,25,30,15
22023,1626164,22300489,"JAN 05, 2024",PHX vs. MIA,W,35,9,19,0.474,2,7,0.286,0,0,0.0,0,5,5,10,2,0,3,2,20,25,1,Devin Booker,PHX,PHX,MIA,2.5,Turnovers,35,25,30,15
22023,1626164,22300473,"JAN 03, 2024",PHX vs. LAC,L,37,11,15,0.733,5,8,0.625,8,9,0.889,0,2,2,6,0,0,6,4,35,-12,1,Devin Booker,PHX,PHX,LAC,26.5,Points,43,37,41,8
22023,1626164,22300473,"JAN 03, 2024",PHX vs. LAC,L,37,11,15,0.733,5,8,0.625,8,9,0.889,0,2,2,6,0,0,6,4,35,-12,1,Devin Booker,PHX,PHX,LAC,4.5,Rebounds,43,37,41,8
22023,1626164,22300473,"JAN 03, 2024",PHX vs. LAC,L,37,11,15,0.733,5,8,0.625,8,9,0.889,0,2,2,6,0,0,6,4,35,-12,1,Devin Booker,PHX,PHX,LAC,39.5,Pts+Rebs+Asts,43,37,41,8
22023,1626164,22300473,"JAN 03, 2024",PHX vs. LAC,L,37,11,15,0.733,5,8,0.625,8,9,0.889,0,2,2,6,0,0,6,4,35,-12,1,Devin Booker,PHX,PHX,LAC,7.0,Assists,43,37,41,8
22023,1626164,22300473,"JAN 03, 2024",PHX vs. LAC,L,37,11,15,0.733,5,8,0.625,8,9,0.889,0,2,2,6,0,0,6,4,35,-12,1,Devin Booker,PHX,PHX,LAC,44.5,Fantasy Score,43,37,41,8
22023,1626164,22300473,"JAN 03, 2024",PHX vs. LAC,L,37,11,15,0.733,5,8,0.625,8,9,0.889,0,2,2,6,0,0,6,4,35,-12,1,Devin Booker,PHX,PHX,LAC,6.0,3-PT Attempted,43,37,41,8
22023,1626164,22300473,"JAN 03, 2024",PHX vs. LAC,L,37,11,15,0.733,5,8,0.625,8,9,0.889,0,2,2,6,0,0,6,4,35,-12,1,Devin Booker,PHX,PHX,LAC,5.0,Free Throws Made,43,37,41,8
22023,1626164,22300473,"JAN 03, 2024",PHX vs. LAC,L,37,11,15,0.733,5,8,0.625,8,9,0.889,0,2,2,6,0,0,6,4,35,-12,1,Devin Booker,PHX,PHX,LAC,19.0,FG Attempted,43,37,41,8
22023,1626164,22300473,"JAN 03, 2024",PHX vs. LAC,L,37,11,15,0.733,5,8,0.625,8,9,0.889,0,2,2,6,0,0,6,4,35,-12,1,Devin Booker,PHX,PHX,LAC,31.5,Pts+Rebs,43,37,41,8
22023,1626164,22300473,"JAN 03, 2024",PHX vs. LAC,L,37,11,15,0.733,5,8,0.625,8,9,0.889,0,2,2,6,0,0,6,4,35,-12,1,Devin Booker,PHX,PHX,LAC,34.5,Pts+Asts,43,37,41,8
22023,1626164,22300473,"JAN 03, 2024",PHX vs. LAC,L,37,11,15,0.733,5,8,0.625,8,9,0.889,0,2,2,6,0,0,6,4,35,-12,1,Devin Booker,PHX,PHX,LAC,12.0,Rebs+Asts,43,37,41,8
22023,1626164,22300473,"JAN 03, 2024",PHX vs. LAC,L,37,11,15,0.733,5,8,0.625,8,9,0.889,0,2,2,6,0,0,6,4,35,-12,1,Devin Booker,PHX,PHX,LAC,2.5,Turnovers,43,37,41,8
22023,1626164,22300456,"JAN 01, 2024",PHX vs. POR,W,31,4,16,0.25,1,4,0.25,1,2,0.5,3,5,8,6,1,0,2,2,10,12,1,Devin Booker,PHX,PHX,POR,26.5,Points,24,18,16,14
22023,1626164,22300456,"JAN 01, 2024",PHX vs. POR,W,31,4,16,0.25,1,4,0.25,1,2,0.5,3,5,8,6,1,0,2,2,10,12,1,Devin Booker,PHX,PHX,POR,4.5,Rebounds,24,18,16,14
22023,1626164,22300456,"JAN 01, 2024",PHX vs. POR,W,31,4,16,0.25,1,4,0.25,1,2,0.5,3,5,8,6,1,0,2,2,10,12,1,Devin Booker,PHX,PHX,POR,39.5,Pts+Rebs+Asts,24,18,16,14
22023,1626164,22300456,"JAN 01, 2024",PHX vs. POR,W,31,4,16,0.25,1,4,0.25,1,2,0.5,3,5,8,6,1,0,2,2,10,12,1,Devin Booker,PHX,PHX,POR,7.0,Assists,24,18,16,14
22023,1626164,22300456,"JAN 01, 2024",PHX vs. POR,W,31,4,16,0.25,1,4,0.25,1,2,0.5,3,5,8,6,1,0,2,2,10,12,1,Devin Booker,PHX,PHX,POR,44.5,Fantasy Score,24,18,16,14
22023,1626164,22300456,"JAN 01, 2024",PHX vs. POR,W,31,4,16,0.25,1,4,0.25,1,2,0.5,3,5,8,6,1,0,2,2,10,12,1,Devin Booker,PHX,PHX,POR,6.0,3-PT Attempted,24,18,16,14
22023,1626164,22300456,"JAN 01, 2024",PHX vs. POR,W,31,4,16,0.25,1,4,0.25,1,2,0.5,3,5,8,6,1,0,2,2,10,12,1,Devin Booker,PHX,PHX,POR,5.0,Free Throws Made,24,18,16,14
22023,1626164,22300456,"JAN 01, 2024",PHX vs. POR,W,31,4,16,0.25,1,4,0.25,1,2,0.5,3,5,8,6,1,0,2,2,10,12,1,Devin Booker,PHX,PHX,POR,19.0,FG Attempted,24,18,16,14
22023,1626164,22300456,"JAN 01, 2024",PHX vs. POR,W,31,4,16,0.25,1,4,0.25,1,2,0.5,3,5,8,6,1,0,2,2,10,12,1,Devin Booker,PHX,PHX,POR,31.5,Pts+Rebs,24,18,16,14
22023,1626164,22300456,"JAN 01, 2024",PHX vs. POR,W,31,4,16,0.25,1,4,0.25,1,2,0.5,3,5,8,6,1,0,2,2,10,12,1,Devin Booker,PHX,PHX,POR,34.5,Pts+Asts,24,18,16,14
22023,1626164,22300456,"JAN 01, 2024",PHX vs. POR,W,31,4,16,0.25,1,4,0.25,1,2,0.5,3,5,8,6,1,0,2,2,10,12,1,Devin Booker,PHX,PHX,POR,12.0,Rebs+Asts,24,18,16,14
22023,1626164,22300456,"JAN 01, 2024",PHX vs. POR,W,31,4,16,0.25,1,4,0.25,1,2,0.5,3,5,8,6,1,0,2,2,10,12,1,Devin Booker,PHX,PHX,POR,2.5,Turnovers,24,18,16,14
22023,1626164,22300450,"DEC 31, 2023",PHX vs. ORL,W,37,7,17,0.412,3,8,0.375,4,5,0.8,0,4,4,5,3,0,1,3,21,13,1,Devin Booker,PHX,PHX,ORL,26.5,Points,30,25,26,9
22023,1626164,22300450,"DEC 31, 2023",PHX vs. ORL,W,37,7,17,0.412,3,8,0.375,4,5,0.8,0,4,4,5,3,0,1,3,21,13,1,Devin Booker,PHX,PHX,ORL,4.5,Rebounds,30,25,26,9
22023,1626164,22300450,"DEC 31, 2023",PHX vs. ORL,W,37,7,17,0.412,3,8,0.375,4,5,0.8,0,4,4,5,3,0,1,3,21,13,1,Devin Booker,PHX,PHX,ORL,39.5,Pts+Rebs+Asts,30,25,26,9
22023,1626164,22300450,"DEC 31, 2023",PHX vs. ORL,W,37,7,17,0.412,3,8,0.375,4,5,0.8,0,4,4,5,3,0,1,3,21,13,1,Devin Booker,PHX,PHX,ORL,7.0,Assists,30,25,26,9
22023,1626164,22300450,"DEC 31, 2023",PHX vs. ORL,W,37,7,17,0.412,3,8,0.375,4,5,0.8,0,4,4,5,3,0,1,3,21,13,1,Devin Booker,PHX,PHX,ORL,44.5,Fantasy Score,30,25,26,9
22023,1626164,22300450,"DEC 31, 2023",PHX vs. ORL,W,37,7,17,0.412,3,8,0.375,4,5,0.8,0,4,4,5,3,0,1,3,21,13,1,Devin Booker,PHX,PHX,ORL,6.0,3-PT Attempted,30,25,26,9
22023,1626164,22300450,"DEC 31, 2023",PHX vs. ORL,W,37,7,17,0.412,3,8,0.375,4,5,0.8,0,4,4,5,3,0,1,3,21,13,1,Devin Booker,PHX,PHX,ORL,5.0,Free Throws Made,30,25,26,9
22023,1626164,22300450,"DEC 31, 2023",PHX vs. ORL,W,37,7,17,0.412,3,8,0.375,4,5,0.8,0,4,4,5,3,0,1,3,21,13,1,Devin Booker,PHX,PHX,ORL,19.0,FG Attempted,30,25,26,9
22023,1626164,22300450,"DEC 31, 2023",PHX vs. ORL,W,37,7,17,0.412,3,8,0.375,4,5,0.8,0,4,4,5,3,0,1,3,21,13,1,Devin Booker,PHX,PHX,ORL,31.5,Pts+Rebs,30,25,26,9
22023,1626164,22300450,"DEC 31, 2023",PHX vs. ORL,W,37,7,17,0.412,3,8,0.375,4,5,0.8,0,4,4,5,3,0,1,3,21,13,1,Devin Booker,PHX,PHX,ORL,34.5,Pts+Asts,30,25,26,9
22023,1626164,22300450,"DEC 31, 2023",PHX vs. ORL,W,37,7,17,0.412,3,8,0.375,4,5,0.8,0,4,4,5,3,0,1,3,21,13,1,Devin Booker,PHX,PHX,ORL,12.0,Rebs+Asts,30,25,26,9
22023,1626164,22300450,"DEC 31, 2023",PHX vs. ORL,W,37,7,17,0.412,3,8,0.375,4,5,0.8,0,4,4,5,3,0,1,3,21,13,1,Devin Booker,PHX,PHX,ORL,2.5,Turnovers,30,25,26,9
22023,1626164,22300436,"DEC 29, 2023",PHX vs. CHA,W,37,10,18,0.556,5,7,0.714,10,10,1.0,0,4,4,7,0,1,2,4,35,11,1,Devin Booker,PHX,PHX,CHA,26.5,Points,46,39,42,11
22023,1626164,22300436,"DEC 29, 2023",PHX vs. CHA,W,37,10,18,0.556,5,7,0.714,10,10,1.0,0,4,4,7,0,1,2,4,35,11,1,Devin Booker,PHX,PHX,CHA,4.5,Rebounds,46,39,42,11
22023,1626164,22300436,"DEC 29, 2023",PHX vs. CHA,W,37,10,18,0.556,5,7,0.714,10,10,1.0,0,4,4,7,0,1,2,4,35,11,1,Devin Booker,PHX,PHX,CHA,39.5,Pts+Rebs+Asts,46,39,42,11
22023,1626164,22300436,"DEC 29, 2023",PHX vs. CHA,W,37,10,18,0.556,5,7,0.714,10,10,1.0,0,4,4,7,0,1,2,4,35,11,1,Devin Booker,PHX,PHX,CHA,7.0,Assists,46,39,42,11
22023,1626164,22300436,"DEC 29, 2023",PHX vs. CHA,W,37,10,18,0.556,5,7,0.714,10,10,1.0,0,4,4,7,0,1,2,4,35,11,1,Devin Booker,PHX,PHX,CHA,44.5,Fantasy Score,46,39,42,11
22023,1626164,22300436,"DEC 29, 2023",PHX vs. CHA,W,37,10,18,0.556,5,7,0.714,10,10,1.0,0,4,4,7,0,1,2,4,35,11,1,Devin Booker,PHX,PHX,CHA,6.0,3-PT Attempted,46,39,42,11
22023,1626164,22300436,"DEC 29, 2023",PHX vs. CHA,W,37,10,18,0.556,5,7,0.714,10,10,1.0,0,4,4,7,0,1,2,4,35,11,1,Devin Booker,PHX,PHX,CHA,5.0,Free Throws Made,46,39,42,11
22023,1626164,22300436,"DEC 29, 2023",PHX vs. CHA,W,37,10,18,0.556,5,7,0.714,10,10,1.0,0,4,4,7,0,1,2,4,35,11,1,Devin Booker,PHX,PHX,CHA,19.0,FG Attempted,46,39,42,11
22023,1626164,22300436,"DEC 29, 2023",PHX vs. CHA,W,37,10,18,0.556,5,7,0.714,10,10,1.0,0,4,4,7,0,1,2,4,35,11,1,Devin Booker,PHX,PHX,CHA,31.5,Pts+Rebs,46,39,42,11
22023,1626164,22300436,"DEC 29, 2023",PHX vs. CHA,W,37,10,18,0.556,5,7,0.714,10,10,1.0,0,4,4,7,0,1,2,4,35,11,1,Devin Booker,PHX,PHX,CHA,34.5,Pts+Asts,46,39,42,11
22023,1626164,22300436,"DEC 29, 2023",PHX vs. CHA,W,37,10,18,0.556,5,7,0.714,10,10,1.0,0,4,4,7,0,1,2,4,35,11,1,Devin Booker,PHX,PHX,CHA,12.0,Rebs+Asts,46,39,42,11
22023,1626164,22300436,"DEC 29, 2023",PHX vs. CHA,W,37,10,18,0.556,5,7,0.714,10,10,1.0,0,4,4,7,0,1,2,4,35,11,1,Devin Booker,PHX,PHX,CHA,2.5,Turnovers,46,39,42,11
22023,1626164,22300418,"DEC 27, 2023",PHX @ HOU,W,36,9,19,0.474,1,6,0.167,1,1,1.0,1,3,4,7,2,0,4,2,20,13,1,Devin Booker,PHX,HOU,PHX,26.5,Points,31,24,27,11
22023,1626164,22300418,"DEC 27, 2023",PHX @ HOU,W,36,9,19,0.474,1,6,0.167,1,1,1.0,1,3,4,7,2,0,4,2,20,13,1,Devin Booker,PHX,HOU,PHX,4.5,Rebounds,31,24,27,11
22023,1626164,22300418,"DEC 27, 2023",PHX @ HOU,W,36,9,19,0.474,1,6,0.167,1,1,1.0,1,3,4,7,2,0,4,2,20,13,1,Devin Booker,PHX,HOU,PHX,39.5,Pts+Rebs+Asts,31,24,27,11
22023,1626164,22300418,"DEC 27, 2023",PHX @ HOU,W,36,9,19,0.474,1,6,0.167,1,1,1.0,1,3,4,7,2,0,4,2,20,13,1,Devin Booker,PHX,HOU,PHX,7.0,Assists,31,24,27,11
22023,1626164,22300418,"DEC 27, 2023",PHX @ HOU,W,36,9,19,0.474,1,6,0.167,1,1,1.0,1,3,4,7,2,0,4,2,20,13,1,Devin Booker,PHX,HOU,PHX,44.5,Fantasy Score,31,24,27,11
22023,1626164,22300418,"DEC 27, 2023",PHX @ HOU,W,36,9,19,0.474,1,6,0.167,1,1,1.0,1,3,4,7,2,0,4,2,20,13,1,Devin Booker,PHX,HOU,PHX,6.0,3-PT Attempted,31,24,27,11
22023,1626164,22300418,"DEC 27, 2023",PHX @ HOU,W,36,9,19,0.474,1,6,0.167,1,1,1.0,1,3,4,7,2,0,4,2,20,13,1,Devin Booker,PHX,HOU,PHX,5.0,Free Throws Made,31,24,27,11
22023,1626164,22300418,"DEC 27, 2023",PHX @ HOU,W,36,9,19,0.474,1,6,0.167,1,1,1.0,1,3,4,7,2,0,4,2,20,13,1,Devin Booker,PHX,HOU,PHX,19.0,FG Attempted,31,24,27,11
22023,1626164,22300418,"DEC 27, 2023",PHX @ HOU,W,36,9,19,0.474,1,6,0.167,1,1,1.0,1,3,4,7,2,0,4,2,20,13,1,Devin Booker,PHX,HOU,PHX,31.5,Pts+Rebs,31,24,27,11
22023,1626164,22300418,"DEC 27, 2023",PHX @ HOU,W,36,9,19,0.474,1,6,0.167,1,1,1.0,1,3,4,7,2,0,4,2,20,13,1,Devin Booker,PHX,HOU,PHX,34.5,Pts+Asts,31,24,27,11
22023,1626164,22300418,"DEC 27, 2023",PHX @ HOU,W,36,9,19,0.474,1,6,0.167,1,1,1.0,1,3,4,7,2,0,4,2,20,13,1,Devin Booker,PHX,HOU,PHX,12.0,Rebs+Asts,31,24,27,11
22023,1626164,22300418,"DEC 27, 2023",PHX @ HOU,W,36,9,19,0.474,1,6,0.167,1,1,1.0,1,3,4,7,2,0,4,2,20,13,1,Devin Booker,PHX,HOU,PHX,2.5,Turnovers,31,24,27,11
22023,1626164,22300405,"DEC 25, 2023",PHX vs. DAL,L,40,6,14,0.429,1,4,0.25,7,10,0.7,0,3,3,10,1,1,3,5,20,-18,1,Devin Booker,PHX,PHX,DAL,26.5,Points,33,23,30,13
22023,1626164,22300405,"DEC 25, 2023",PHX vs. DAL,L,40,6,14,0.429,1,4,0.25,7,10,0.7,0,3,3,10,1,1,3,5,20,-18,1,Devin Booker,PHX,PHX,DAL,4.5,Rebounds,33,23,30,13
22023,1626164,22300405,"DEC 25, 2023",PHX vs. DAL,L,40,6,14,0.429,1,4,0.25,7,10,0.7,0,3,3,10,1,1,3,5,20,-18,1,Devin Booker,PHX,PHX,DAL,39.5,Pts+Rebs+Asts,33,23,30,13
22023,1626164,22300405,"DEC 25, 2023",PHX vs. DAL,L,40,6,14,0.429,1,4,0.25,7,10,0.7,0,3,3,10,1,1,3,5,20,-18,1,Devin Booker,PHX,PHX,DAL,7.0,Assists,33,23,30,13
22023,1626164,22300405,"DEC 25, 2023",PHX vs. DAL,L,40,6,14,0.429,1,4,0.25,7,10,0.7,0,3,3,10,1,1,3,5,20,-18,1,Devin Booker,PHX,PHX,DAL,44.5,Fantasy Score,33,23,30,13
22023,1626164,22300405,"DEC 25, 2023",PHX vs. DAL,L,40,6,14,0.429,1,4,0.25,7,10,0.7,0,3,3,10,1,1,3,5,20,-18,1,Devin Booker,PHX,PHX,DAL,6.0,3-PT Attempted,33,23,30,13
22023,1626164,22300405,"DEC 25, 2023",PHX vs. DAL,L,40,6,14,0.429,1,4,0.25,7,10,0.7,0,3,3,10,1,1,3,5,20,-18,1,Devin Booker,PHX,PHX,DAL,5.0,Free Throws Made,33,23,30,13
22023,1626164,22300405,"DEC 25, 2023",PHX vs. DAL,L,40,6,14,0.429,1,4,0.25,7,10,0.7,0,3,3,10,1,1,3,5,20,-18,1,Devin Booker,PHX,PHX,DAL,19.0,FG Attempted,33,23,30,13
22023,1626164,22300405,"DEC 25, 2023",PHX vs. DAL,L,40,6,14,0.429,1,4,0.25,7,10,0.7,0,3,3,10,1,1,3,5,20,-18,1,Devin Booker,PHX,PHX,DAL,31.5,Pts+Rebs,33,23,30,13
22023,1626164,22300405,"DEC 25, 2023",PHX vs. DAL,L,40,6,14,0.429,1,4,0.25,7,10,0.7,0,3,3,10,1,1,3,5,20,-18,1,Devin Booker,PHX,PHX,DAL,34.5,Pts+Asts,33,23,30,13
22023,1626164,22300405,"DEC 25, 2023",PHX vs. DAL,L,40,6,14,0.429,1,4,0.25,7,10,0.7,0,3,3,10,1,1,3,5,20,-18,1,Devin Booker,PHX,PHX,DAL,12.0,Rebs+Asts,33,23,30,13
22023,1626164,22300405,"DEC 25, 2023",PHX vs. DAL,L,40,6,14,0.429,1,4,0.25,7,10,0.7,0,3,3,10,1,1,3,5,20,-18,1,Devin Booker,PHX,PHX,DAL,2.5,Turnovers,33,23,30,13
22023,1626164,22300387,"DEC 22, 2023",PHX @ SAC,L,36,9,20,0.45,0,3,0.0,6,9,0.667,2,2,4,7,0,0,0,1,24,-24,1,Devin Booker,PHX,SAC,PHX,26.5,Points,35,28,31,11
22023,1626164,22300387,"DEC 22, 2023",PHX @ SAC,L,36,9,20,0.45,0,3,0.0,6,9,0.667,2,2,4,7,0,0,0,1,24,-24,1,Devin Booker,PHX,SAC,PHX,4.5,Rebounds,35,28,31,11
22023,1626164,22300387,"DEC 22, 2023",PHX @ SAC,L,36,9,20,0.45,0,3,0.0,6,9,0.667,2,2,4,7,0,0,0,1,24,-24,1,Devin Booker,PHX,SAC,PHX,39.5,Pts+Rebs+Asts,35,28,31,11
22023,1626164,22300387,"DEC 22, 2023",PHX @ SAC,L,36,9,20,0.45,0,3,0.0,6,9,0.667,2,2,4,7,0,0,0,1,24,-24,1,Devin Booker,PHX,SAC,PHX,7.0,Assists,35,28,31,11
22023,1626164,22300387,"DEC 22, 2023",PHX @ SAC,L,36,9,20,0.45,0,3,0.0,6,9,0.667,2,2,4,7,0,0,0,1,24,-24,1,Devin Booker,PHX,SAC,PHX,44.5,Fantasy Score,35,28,31,11
22023,1626164,22300387,"DEC 22, 2023",PHX @ SAC,L,36,9,20,0.45,0,3,0.0,6,9,0.667,2,2,4,7,0,0,0,1,24,-24,1,Devin Booker,PHX,SAC,PHX,6.0,3-PT Attempted,35,28,31,11
22023,1626164,22300387,"DEC 22, 2023",PHX @ SAC,L,36,9,20,0.45,0,3,0.0,6,9,0.667,2,2,4,7,0,0,0,1,24,-24,1,Devin Booker,PHX,SAC,PHX,5.0,Free Throws Made,35,28,31,11
22023,1626164,22300387,"DEC 22, 2023",PHX @ SAC,L,36,9,20,0.45,0,3,0.0,6,9,0.667,2,2,4,7,0,0,0,1,24,-24,1,Devin Booker,PHX,SAC,PHX,19.0,FG Attempted,35,28,31,11
22023,1626164,22300387,"DEC 22, 2023",PHX @ SAC,L,36,9,20,0.45,0,3,0.0,6,9,0.667,2,2,4,7,0,0,0,1,24,-24,1,Devin Booker,PHX,SAC,PHX,31.5,Pts+Rebs,35,28,31,11
22023,1626164,22300387,"DEC 22, 2023",PHX @ SAC,L,36,9,20,0.45,0,3,0.0,6,9,0.667,2,2,4,7,0,0,0,1,24,-24,1,Devin Booker,PHX,SAC,PHX,34.5,Pts+Asts,35,28,31,11
22023,1626164,22300387,"DEC 22, 2023",PHX @ SAC,L,36,9,20,0.45,0,3,0.0,6,9,0.667,2,2,4,7,0,0,0,1,24,-24,1,Devin Booker,PHX,SAC,PHX,12.0,Rebs+Asts,35,28,31,11
22023,1626164,22300387,"DEC 22, 2023",PHX @ SAC,L,36,9,20,0.45,0,3,0.0,6,9,0.667,2,2,4,7,0,0,0,1,24,-24,1,Devin Booker,PHX,SAC,PHX,2.5,Turnovers,35,28,31,11
22023,1626164,22300363,"DEC 19, 2023",PHX @ POR,L,38,11,25,0.44,1,5,0.2,3,4,0.75,0,3,3,7,0,0,1,3,26,-9,1,Devin Booker,PHX,POR,PHX,26.5,Points,36,29,33,10
22023,1626164,22300363,"DEC 19, 2023",PHX @ POR,L,38,11,25,0.44,1,5,0.2,3,4,0.75,0,3,3,7,0,0,1,3,26,-9,1,Devin Booker,PHX,POR,PHX,4.5,Rebounds,36,29,33,10
22023,1626164,22300363,"DEC 19, 2023",PHX @ POR,L,38,11,25,0.44,1,5,0.2,3,4,0.75,0,3,3,7,0,0,1,3,26,-9,1,Devin Booker,PHX,POR,PHX,39.5,Pts+Rebs+Asts,36,29,33,10
22023,1626164,22300363,"DEC 19, 2023",PHX @ POR,L,38,11,25,0.44,1,5,0.2,3,4,0.75,0,3,3,7,0,0,1,3,26,-9,1,Devin Booker,PHX,POR,PHX,7.0,Assists,36,29,33,10
22023,1626164,22300363,"DEC 19, 2023",PHX @ POR,L,38,11,25,0.44,1,5,0.2,3,4,0.75,0,3,3,7,0,0,1,3,26,-9,1,Devin Booker,PHX,POR,PHX,44.5,Fantasy Score,36,29,33,10
22023,1626164,22300363,"DEC 19, 2023",PHX @ POR,L,38,11,25,0.44,1,5,0.2,3,4,0.75,0,3,3,7,0,0,1,3,26,-9,1,Devin Booker,PHX,POR,PHX,6.0,3-PT Attempted,36,29,33,10
22023,1626164,22300363,"DEC 19, 2023",PHX @ POR,L,38,11,25,0.44,1,5,0.2,3,4,0.75,0,3,3,7,0,0,1,3,26,-9,1,Devin Booker,PHX,POR,PHX,5.0,Free Throws Made,36,29,33,10
22023,1626164,22300363,"DEC 19, 2023",PHX @ POR,L,38,11,25,0.44,1,5,0.2,3,4,0.75,0,3,3,7,0,0,1,3,26,-9,1,Devin Booker,PHX,POR,PHX,19.0,FG Attempted,36,29,33,10
22023,1626164,22300363,"DEC 19, 2023",PHX @ POR,L,38,11,25,0.44,1,5,0.2,3,4,0.75,0,3,3,7,0,0,1,3,26,-9,1,Devin Booker,PHX,POR,PHX,31.5,Pts+Rebs,36,29,33,10
22023,1626164,22300363,"DEC 19, 2023",PHX @ POR,L,38,11,25,0.44,1,5,0.2,3,4,0.75,0,3,3,7,0,0,1,3,26,-9,1,Devin Booker,PHX,POR,PHX,34.5,Pts+Asts,36,29,33,10
22023,1626164,22300363,"DEC 19, 2023",PHX @ POR,L,38,11,25,0.44,1,5,0.2,3,4,0.75,0,3,3,7,0,0,1,3,26,-9,1,Devin Booker,PHX,POR,PHX,12.0,Rebs+Asts,36,29,33,10
22023,1626164,22300363,"DEC 19, 2023",PHX @ POR,L,38,11,25,0.44,1,5,0.2,3,4,0.75,0,3,3,7,0,0,1,3,26,-9,1,Devin Booker,PHX,POR,PHX,2.5,Turnovers,36,29,33,10
22023,1626164,22300347,"DEC 17, 2023",PHX vs. WAS,W,41,10,24,0.417,3,11,0.273,4,5,0.8,0,4,4,8,1,1,5,4,27,2,1,Devin Booker,PHX,PHX,WAS,26.5,Points,39,31,35,12
22023,1626164,22300347,"DEC 17, 2023",PHX vs. WAS,W,41,10,24,0.417,3,11,0.273,4,5,0.8,0,4,4,8,1,1,5,4,27,2,1,Devin Booker,PHX,PHX,WAS,4.5,Rebounds,39,31,35,12
22023,1626164,22300347,"DEC 17, 2023",PHX vs. WAS,W,41,10,24,0.417,3,11,0.273,4,5,0.8,0,4,4,8,1,1,5,4,27,2,1,Devin Booker,PHX,PHX,WAS,39.5,Pts+Rebs+Asts,39,31,35,12
22023,1626164,22300347,"DEC 17, 2023",PHX vs. WAS,W,41,10,24,0.417,3,11,0.273,4,5,0.8,0,4,4,8,1,1,5,4,27,2,1,Devin Booker,PHX,PHX,WAS,7.0,Assists,39,31,35,12
22023,1626164,22300347,"DEC 17, 2023",PHX vs. WAS,W,41,10,24,0.417,3,11,0.273,4,5,0.8,0,4,4,8,1,1,5,4,27,2,1,Devin Booker,PHX,PHX,WAS,44.5,Fantasy Score,39,31,35,12
22023,1626164,22300347,"DEC 17, 2023",PHX vs. WAS,W,41,10,24,0.417,3,11,0.273,4,5,0.8,0,4,4,8,1,1,5,4,27,2,1,Devin Booker,PHX,PHX,WAS,6.0,3-PT Attempted,39,31,35,12
22023,1626164,22300347,"DEC 17, 2023",PHX vs. WAS,W,41,10,24,0.417,3,11,0.273,4,5,0.8,0,4,4,8,1,1,5,4,27,2,1,Devin Booker,PHX,PHX,WAS,5.0,Free Throws Made,39,31,35,12
22023,1626164,22300347,"DEC 17, 2023",PHX vs. WAS,W,41,10,24,0.417,3,11,0.273,4,5,0.8,0,4,4,8,1,1,5,4,27,2,1,Devin Booker,PHX,PHX,WAS,19.0,FG Attempted,39,31,35,12
22023,1626164,22300347,"DEC 17, 2023",PHX vs. WAS,W,41,10,24,0.417,3,11,0.273,4,5,0.8,0,4,4,8,1,1,5,4,27,2,1,Devin Booker,PHX,PHX,WAS,31.5,Pts+Rebs,39,31,35,12
22023,1626164,22300347,"DEC 17, 2023",PHX vs. WAS,W,41,10,24,0.417,3,11,0.273,4,5,0.8,0,4,4,8,1,1,5,4,27,2,1,Devin Booker,PHX,PHX,WAS,34.5,Pts+Asts,39,31,35,12
22023,1626164,22300347,"DEC 17, 2023",PHX vs. WAS,W,41,10,24,0.417,3,11,0.273,4,5,0.8,0,4,4,8,1,1,5,4,27,2,1,Devin Booker,PHX,PHX,WAS,12.0,Rebs+Asts,39,31,35,12
22023,1626164,22300347,"DEC 17, 2023",PHX vs. WAS,W,41,10,24,0.417,3,11,0.273,4,5,0.8,0,4,4,8,1,1,5,4,27,2,1,Devin Booker,PHX,PHX,WAS,2.5,Turnovers,39,31,35,12
22023,1626164,22300333,"DEC 15, 2023",PHX vs. NYK,L,37,11,26,0.423,1,5,0.2,5,6,0.833,1,1,2,9,0,0,3,4,28,-18,1,Devin Booker,PHX,PHX,NYK,26.5,Points,39,30,37,11
22023,1626164,22300333,"DEC 15, 2023",PHX vs. NYK,L,37,11,26,0.423,1,5,0.2,5,6,0.833,1,1,2,9,0,0,3,4,28,-18,1,Devin Booker,PHX,PHX,NYK,4.5,Rebounds,39,30,37,11
22023,1626164,22300333,"DEC 15, 2023",PHX vs. NYK,L,37,11,26,0.423,1,5,0.2,5,6,0.833,1,1,2,9,0,0,3,4,28,-18,1,Devin Booker,PHX,PHX,NYK,39.5,Pts+Rebs+Asts,39,30,37,11
22023,1626164,22300333,"DEC 15, 2023",PHX vs. NYK,L,37,11,26,0.423,1,5,0.2,5,6,0.833,1,1,2,9,0,0,3,4,28,-18,1,Devin Booker,PHX,PHX,NYK,7.0,Assists,39,30,37,11
22023,1626164,22300333,"DEC 15, 2023",PHX vs. NYK,L,37,11,26,0.423,1,5,0.2,5,6,0.833,1,1,2,9,0,0,3,4,28,-18,1,Devin Booker,PHX,PHX,NYK,44.5,Fantasy Score,39,30,37,11
22023,1626164,22300333,"DEC 15, 2023",PHX vs. NYK,L,37,11,26,0.423,1,5,0.2,5,6,0.833,1,1,2,9,0,0,3,4,28,-18,1,Devin Booker,PHX,PHX,NYK,6.0,3-PT Attempted,39,30,37,11
22023,1626164,22300333,"DEC 15, 2023",PHX vs. NYK,L,37,11,26,0.423,1,5,0.2,5,6,0.833,1,1,2,9,0,0,3,4,28,-18,1,Devin Booker,PHX,PHX,NYK,5.0,Free Throws Made,39,30,37,11
22023,1626164,22300333,"DEC 15, 2023",PHX vs. NYK,L,37,11,26,0.423,1,5,0.2,5,6,0.833,1,1,2,9,0,0,3,4,28,-18,1,Devin Booker,PHX,PHX,NYK,19.0,FG Attempted,39,30,37,11
22023,1626164,22300333,"DEC 15, 2023",PHX vs. NYK,L,37,11,26,0.423,1,5,0.2,5,6,0.833,1,1,2,9,0,0,3,4,28,-18,1,Devin Booker,PHX,PHX,NYK,31.5,Pts+Rebs,39,30,37,11
22023,1626164,22300333,"DEC 15, 2023",PHX vs. NYK,L,37,11,26,0.423,1,5,0.2,5,6,0.833,1,1,2,9,0,0,3,4,28,-18,1,Devin Booker,PHX,PHX,NYK,34.5,Pts+Asts,39,30,37,11
22023,1626164,22300333,"DEC 15, 2023",PHX vs. NYK,L,37,11,26,0.423,1,5,0.2,5,6,0.833,1,1,2,9,0,0,3,4,28,-18,1,Devin Booker,PHX,PHX,NYK,12.0,Rebs+Asts,39,30,37,11
22023,1626164,22300333,"DEC 15, 2023",PHX vs. NYK,L,37,11,26,0.423,1,5,0.2,5,6,0.833,1,1,2,9,0,0,3,4,28,-18,1,Devin Booker,PHX,PHX,NYK,2.5,Turnovers,39,30,37,11
22023,1626164,22300317,"DEC 13, 2023",PHX vs. BKN,L,40,9,15,0.6,2,6,0.333,14,15,0.933,1,5,6,12,0,0,2,5,34,16,1,Devin Booker,PHX,PHX,BKN,26.5,Points,52,40,46,18
22023,1626164,22300317,"DEC 13, 2023",PHX vs. BKN,L,40,9,15,0.6,2,6,0.333,14,15,0.933,1,5,6,12,0,0,2,5,34,16,1,Devin Booker,PHX,PHX,BKN,4.5,Rebounds,52,40,46,18
22023,1626164,22300317,"DEC 13, 2023",PHX vs. BKN,L,40,9,15,0.6,2,6,0.333,14,15,0.933,1,5,6,12,0,0,2,5,34,16,1,Devin Booker,PHX,PHX,BKN,39.5,Pts+Rebs+Asts,52,40,46,18
22023,1626164,22300317,"DEC 13, 2023",PHX vs. BKN,L,40,9,15,0.6,2,6,0.333,14,15,0.933,1,5,6,12,0,0,2,5,34,16,1,Devin Booker,PHX,PHX,BKN,7.0,Assists,52,40,46,18
22023,1626164,22300317,"DEC 13, 2023",PHX vs. BKN,L,40,9,15,0.6,2,6,0.333,14,15,0.933,1,5,6,12,0,0,2,5,34,16,1,Devin Booker,PHX,PHX,BKN,44.5,Fantasy Score,52,40,46,18
22023,1626164,22300317,"DEC 13, 2023",PHX vs. BKN,L,40,9,15,0.6,2,6,0.333,14,15,0.933,1,5,6,12,0,0,2,5,34,16,1,Devin Booker,PHX,PHX,BKN,6.0,3-PT Attempted,52,40,46,18
22023,1626164,22300317,"DEC 13, 2023",PHX vs. BKN,L,40,9,15,0.6,2,6,0.333,14,15,0.933,1,5,6,12,0,0,2,5,34,16,1,Devin Booker,PHX,PHX,BKN,5.0,Free Throws Made,52,40,46,18
22023,1626164,22300317,"DEC 13, 2023",PHX vs. BKN,L,40,9,15,0.6,2,6,0.333,14,15,0.933,1,5,6,12,0,0,2,5,34,16,1,Devin Booker,PHX,PHX,BKN,19.0,FG Attempted,52,40,46,18
22023,1626164,22300317,"DEC 13, 2023",PHX vs. BKN,L,40,9,15,0.6,2,6,0.333,14,15,0.933,1,5,6,12,0,0,2,5,34,16,1,Devin Booker,PHX,PHX,BKN,31.5,Pts+Rebs,52,40,46,18
22023,1626164,22300317,"DEC 13, 2023",PHX vs. BKN,L,40,9,15,0.6,2,6,0.333,14,15,0.933,1,5,6,12,0,0,2,5,34,16,1,Devin Booker,PHX,PHX,BKN,34.5,Pts+Asts,52,40,46,18
22023,1626164,22300317,"DEC 13, 2023",PHX vs. BKN,L,40,9,15,0.6,2,6,0.333,14,15,0.933,1,5,6,12,0,0,2,5,34,16,1,Devin Booker,PHX,PHX,BKN,12.0,Rebs+Asts,52,40,46,18
22023,1626164,22300317,"DEC 13, 2023",PHX vs. BKN,L,40,9,15,0.6,2,6,0.333,14,15,0.933,1,5,6,12,0,0,2,5,34,16,1,Devin Booker,PHX,PHX,BKN,2.5,Turnovers,52,40,46,18
22023,1626164,22300308,"DEC 12, 2023",PHX vs. GSW,W,36,12,23,0.522,3,6,0.5,5,5,1.0,1,3,4,7,1,1,2,5,32,15,1,Devin Booker,PHX,PHX,GSW,26.5,Points,43,36,39,11
22023,1626164,22300308,"DEC 12, 2023",PHX vs. GSW,W,36,12,23,0.522,3,6,0.5,5,5,1.0,1,3,4,7,1,1,2,5,32,15,1,Devin Booker,PHX,PHX,GSW,4.5,Rebounds,43,36,39,11
22023,1626164,22300308,"DEC 12, 2023",PHX vs. GSW,W,36,12,23,0.522,3,6,0.5,5,5,1.0,1,3,4,7,1,1,2,5,32,15,1,Devin Booker,PHX,PHX,GSW,39.5,Pts+Rebs+Asts,43,36,39,11
22023,1626164,22300308,"DEC 12, 2023",PHX vs. GSW,W,36,12,23,0.522,3,6,0.5,5,5,1.0,1,3,4,7,1,1,2,5,32,15,1,Devin Booker,PHX,PHX,GSW,7.0,Assists,43,36,39,11
22023,1626164,22300308,"DEC 12, 2023",PHX vs. GSW,W,36,12,23,0.522,3,6,0.5,5,5,1.0,1,3,4,7,1,1,2,5,32,15,1,Devin Booker,PHX,PHX,GSW,44.5,Fantasy Score,43,36,39,11
22023,1626164,22300308,"DEC 12, 2023",PHX vs. GSW,W,36,12,23,0.522,3,6,0.5,5,5,1.0,1,3,4,7,1,1,2,5,32,15,1,Devin Booker,PHX,PHX,GSW,6.0,3-PT Attempted,43,36,39,11
22023,1626164,22300308,"DEC 12, 2023",PHX vs. GSW,W,36,12,23,0.522,3,6,0.5,5,5,1.0,1,3,4,7,1,1,2,5,32,15,1,Devin Booker,PHX,PHX,GSW,5.0,Free Throws Made,43,36,39,11
22023,1626164,22300308,"DEC 12, 2023",PHX vs. GSW,W,36,12,23,0.522,3,6,0.5,5,5,1.0,1,3,4,7,1,1,2,5,32,15,1,Devin Booker,PHX,PHX,GSW,19.0,FG Attempted,43,36,39,11
22023,1626164,22300308,"DEC 12, 2023",PHX vs. GSW,W,36,12,23,0.522,3,6,0.5,5,5,1.0,1,3,4,7,1,1,2,5,32,15,1,Devin Booker,PHX,PHX,GSW,31.5,Pts+Rebs,43,36,39,11
22023,1626164,22300308,"DEC 12, 2023",PHX vs. GSW,W,36,12,23,0.522,3,6,0.5,5,5,1.0,1,3,4,7,1,1,2,5,32,15,1,Devin Booker,PHX,PHX,GSW,34.5,Pts+Asts,43,36,39,11
22023,1626164,22300308,"DEC 12, 2023",PHX vs. GSW,W,36,12,23,0.522,3,6,0.5,5,5,1.0,1,3,4,7,1,1,2,5,32,15,1,Devin Booker,PHX,PHX,GSW,12.0,Rebs+Asts,43,36,39,11
22023,1626164,22300308,"DEC 12, 2023",PHX vs. GSW,W,36,12,23,0.522,3,6,0.5,5,5,1.0,1,3,4,7,1,1,2,5,32,15,1,Devin Booker,PHX,PHX,GSW,2.5,Turnovers,43,36,39,11
22023,1626164,22301228,"DEC 08, 2023",PHX vs. SAC,L,38,10,14,0.714,2,2,1.0,6,9,0.667,0,7,7,7,1,0,3,4,28,-6,1,Devin Booker,PHX,PHX,SAC,26.5,Points,42,35,35,14
22023,1626164,22301228,"DEC 08, 2023",PHX vs. SAC,L,38,10,14,0.714,2,2,1.0,6,9,0.667,0,7,7,7,1,0,3,4,28,-6,1,Devin Booker,PHX,PHX,SAC,4.5,Rebounds,42,35,35,14
22023,1626164,22301228,"DEC 08, 2023",PHX vs. SAC,L,38,10,14,0.714,2,2,1.0,6,9,0.667,0,7,7,7,1,0,3,4,28,-6,1,Devin Booker,PHX,PHX,SAC,39.5,Pts+Rebs+Asts,42,35,35,14
22023,1626164,22301228,"DEC 08, 2023",PHX vs. SAC,L,38,10,14,0.714,2,2,1.0,6,9,0.667,0,7,7,7,1,0,3,4,28,-6,1,Devin Booker,PHX,PHX,SAC,7.0,Assists,42,35,35,14
22023,1626164,22301228,"DEC 08, 2023",PHX vs. SAC,L,38,10,14,0.714,2,2,1.0,6,9,0.667,0,7,7,7,1,0,3,4,28,-6,1,Devin Booker,PHX,PHX,SAC,44.5,Fantasy Score,42,35,35,14
22023,1626164,22301228,"DEC 08, 2023",PHX vs. SAC,L,38,10,14,0.714,2,2,1.0,6,9,0.667,0,7,7,7,1,0,3,4,28,-6,1,Devin Booker,PHX,PHX,SAC,6.0,3-PT Attempted,42,35,35,14
22023,1626164,22301228,"DEC 08, 2023",PHX vs. SAC,L,38,10,14,0.714,2,2,1.0,6,9,0.667,0,7,7,7,1,0,3,4,28,-6,1,Devin Booker,PHX,PHX,SAC,5.0,Free Throws Made,42,35,35,14
22023,1626164,22301228,"DEC 08, 2023",PHX vs. SAC,L,38,10,14,0.714,2,2,1.0,6,9,0.667,0,7,7,7,1,0,3,4,28,-6,1,Devin Booker,PHX,PHX,SAC,19.0,FG Attempted,42,35,35,14
22023,1626164,22301228,"DEC 08, 2023",PHX vs. SAC,L,38,10,14,0.714,2,2,1.0,6,9,0.667,0,7,7,7,1,0,3,4,28,-6,1,Devin Booker,PHX,PHX,SAC,31.5,Pts+Rebs,42,35,35,14
22023,1626164,22301228,"DEC 08, 2023",PHX vs. SAC,L,38,10,14,0.714,2,2,1.0,6,9,0.667,0,7,7,7,1,0,3,4,28,-6,1,Devin Booker,PHX,PHX,SAC,34.5,Pts+Asts,42,35,35,14
22023,1626164,22301228,"DEC 08, 2023",PHX vs. SAC,L,38,10,14,0.714,2,2,1.0,6,9,0.667,0,7,7,7,1,0,3,4,28,-6,1,Devin Booker,PHX,PHX,SAC,12.0,Rebs+Asts,42,35,35,14
22023,1626164,22301228,"DEC 08, 2023",PHX vs. SAC,L,38,10,14,0.714,2,2,1.0,6,9,0.667,0,7,7,7,1,0,3,4,28,-6,1,Devin Booker,PHX,PHX,SAC,2.5,Turnovers,42,35,35,14
22023,1626164,22301203,"DEC 05, 2023",PHX @ LAL,L,37,6,16,0.375,1,1,1.0,8,8,1.0,2,9,11,6,1,1,7,5,21,2,1,Devin Booker,PHX,LAL,PHX,26.5,Points,38,32,27,17
22023,1626164,22301203,"DEC 05, 2023",PHX @ LAL,L,37,6,16,0.375,1,1,1.0,8,8,1.0,2,9,11,6,1,1,7,5,21,2,1,Devin Booker,PHX,LAL,PHX,4.5,Rebounds,38,32,27,17
22023,1626164,22301203,"DEC 05, 2023",PHX @ LAL,L,37,6,16,0.375,1,1,1.0,8,8,1.0,2,9,11,6,1,1,7,5,21,2,1,Devin Booker,PHX,LAL,PHX,39.5,Pts+Rebs+Asts,38,32,27,17
22023,1626164,22301203,"DEC 05, 2023",PHX @ LAL,L,37,6,16,0.375,1,1,1.0,8,8,1.0,2,9,11,6,1,1,7,5,21,2,1,Devin Booker,PHX,LAL,PHX,7.0,Assists,38,32,27,17
22023,1626164,22301203,"DEC 05, 2023",PHX @ LAL,L,37,6,16,0.375,1,1,1.0,8,8,1.0,2,9,11,6,1,1,7,5,21,2,1,Devin Booker,PHX,LAL,PHX,44.5,Fantasy Score,38,32,27,17
22023,1626164,22301203,"DEC 05, 2023",PHX @ LAL,L,37,6,16,0.375,1,1,1.0,8,8,1.0,2,9,11,6,1,1,7,5,21,2,1,Devin Booker,PHX,LAL,PHX,6.0,3-PT Attempted,38,32,27,17
22023,1626164,22301203,"DEC 05, 2023",PHX @ LAL,L,37,6,16,0.375,1,1,1.0,8,8,1.0,2,9,11,6,1,1,7,5,21,2,1,Devin Booker,PHX,LAL,PHX,5.0,Free Throws Made,38,32,27,17
22023,1626164,22301203,"DEC 05, 2023",PHX @ LAL,L,37,6,16,0.375,1,1,1.0,8,8,1.0,2,9,11,6,1,1,7,5,21,2,1,Devin Booker,PHX,LAL,PHX,19.0,FG Attempted,38,32,27,17
22023,1626164,22301203,"DEC 05, 2023",PHX @ LAL,L,37,6,16,0.375,1,1,1.0,8,8,1.0,2,9,11,6,1,1,7,5,21,2,1,Devin Booker,PHX,LAL,PHX,31.5,Pts+Rebs,38,32,27,17
22023,1626164,22301203,"DEC 05, 2023",PHX @ LAL,L,37,6,16,0.375,1,1,1.0,8,8,1.0,2,9,11,6,1,1,7,5,21,2,1,Devin Booker,PHX,LAL,PHX,34.5,Pts+Asts,38,32,27,17
22023,1626164,22301203,"DEC 05, 2023",PHX @ LAL,L,37,6,16,0.375,1,1,1.0,8,8,1.0,2,9,11,6,1,1,7,5,21,2,1,Devin Booker,PHX,LAL,PHX,12.0,Rebs+Asts,38,32,27,17
22023,1626164,22301203,"DEC 05, 2023",PHX @ LAL,L,37,6,16,0.375,1,1,1.0,8,8,1.0,2,9,11,6,1,1,7,5,21,2,1,Devin Booker,PHX,LAL,PHX,2.5,Turnovers,38,32,27,17
22023,1626164,22300288,"DEC 02, 2023",PHX vs. MEM,W,37,9,21,0.429,3,8,0.375,13,13,1.0,1,9,10,7,1,0,2,2,34,9,1,Devin Booker,PHX,PHX,MEM,26.5,Points,51,44,41,17
22023,1626164,22300288,"DEC 02, 2023",PHX vs. MEM,W,37,9,21,0.429,3,8,0.375,13,13,1.0,1,9,10,7,1,0,2,2,34,9,1,Devin Booker,PHX,PHX,MEM,4.5,Rebounds,51,44,41,17
22023,1626164,22300288,"DEC 02, 2023",PHX vs. MEM,W,37,9,21,0.429,3,8,0.375,13,13,1.0,1,9,10,7,1,0,2,2,34,9,1,Devin Booker,PHX,PHX,MEM,39.5,Pts+Rebs+Asts,51,44,41,17
22023,1626164,22300288,"DEC 02, 2023",PHX vs. MEM,W,37,9,21,0.429,3,8,0.375,13,13,1.0,1,9,10,7,1,0,2,2,34,9,1,Devin Booker,PHX,PHX,MEM,7.0,Assists,51,44,41,17
22023,1626164,22300288,"DEC 02, 2023",PHX vs. MEM,W,37,9,21,0.429,3,8,0.375,13,13,1.0,1,9,10,7,1,0,2,2,34,9,1,Devin Booker,PHX,PHX,MEM,44.5,Fantasy Score,51,44,41,17
22023,1626164,22300288,"DEC 02, 2023",PHX vs. MEM,W,37,9,21,0.429,3,8,0.375,13,13,1.0,1,9,10,7,1,0,2,2,34,9,1,Devin Booker,PHX,PHX,MEM,6.0,3-PT Attempted,51,44,41,17
22023,1626164,22300288,"DEC 02, 2023",PHX vs. MEM,W,37,9,21,0.429,3,8,0.375,13,13,1.0,1,9,10,7,1,0,2,2,34,9,1,Devin Booker,PHX,PHX,MEM,5.0,Free Throws Made,51,44,41,17
22023,1626164,22300288,"DEC 02, 2023",PHX vs. MEM,W,37,9,21,0.429,3,8,0.375,13,13,1.0,1,9,10,7,1,0,2,2,34,9,1,Devin Booker,PHX,PHX,MEM,19.0,FG Attempted,51,44,41,17
22023,1626164,22300288,"DEC 02, 2023",PHX vs. MEM,W,37,9,21,0.429,3,8,0.375,13,13,1.0,1,9,10,7,1,0,2,2,34,9,1,Devin Booker,PHX,PHX,MEM,31.5,Pts+Rebs,51,44,41,17
22023,1626164,22300288,"DEC 02, 2023",PHX vs. MEM,W,37,9,21,0.429,3,8,0.375,13,13,1.0,1,9,10,7,1,0,2,2,34,9,1,Devin Booker,PHX,PHX,MEM,34.5,Pts+Asts,51,44,41,17
22023,1626164,22300288,"DEC 02, 2023",PHX vs. MEM,W,37,9,21,0.429,3,8,0.375,13,13,1.0,1,9,10,7,1,0,2,2,34,9,1,Devin Booker,PHX,PHX,MEM,12.0,Rebs+Asts,51,44,41,17
22023,1626164,22300288,"DEC 02, 2023",PHX vs. MEM,W,37,9,21,0.429,3,8,0.375,13,13,1.0,1,9,10,7,1,0,2,2,34,9,1,Devin Booker,PHX,PHX,MEM,2.5,Turnovers,51,44,41,17
22023,1626164,22300260,"NOV 29, 2023",PHX @ TOR,L,33,2,12,0.167,0,4,0.0,4,4,1.0,0,5,5,5,0,0,2,3,8,-15,1,Devin Booker,PHX,TOR,PHX,26.5,Points,18,13,13,10
22023,1626164,22300260,"NOV 29, 2023",PHX @ TOR,L,33,2,12,0.167,0,4,0.0,4,4,1.0,0,5,5,5,0,0,2,3,8,-15,1,Devin Booker,PHX,TOR,PHX,4.5,Rebounds,18,13,13,10
22023,1626164,22300260,"NOV 29, 2023",PHX @ TOR,L,33,2,12,0.167,0,4,0.0,4,4,1.0,0,5,5,5,0,0,2,3,8,-15,1,Devin Booker,PHX,TOR,PHX,39.5,Pts+Rebs+Asts,18,13,13,10
22023,1626164,22300260,"NOV 29, 2023",PHX @ TOR,L,33,2,12,0.167,0,4,0.0,4,4,1.0,0,5,5,5,0,0,2,3,8,-15,1,Devin Booker,PHX,TOR,PHX,7.0,Assists,18,13,13,10
22023,1626164,22300260,"NOV 29, 2023",PHX @ TOR,L,33,2,12,0.167,0,4,0.0,4,4,1.0,0,5,5,5,0,0,2,3,8,-15,1,Devin Booker,PHX,TOR,PHX,44.5,Fantasy Score,18,13,13,10
22023,1626164,22300260,"NOV 29, 2023",PHX @ TOR,L,33,2,12,0.167,0,4,0.0,4,4,1.0,0,5,5,5,0,0,2,3,8,-15,1,Devin Booker,PHX,TOR,PHX,6.0,3-PT Attempted,18,13,13,10
22023,1626164,22300260,"NOV 29, 2023",PHX @ TOR,L,33,2,12,0.167,0,4,0.0,4,4,1.0,0,5,5,5,0,0,2,3,8,-15,1,Devin Booker,PHX,TOR,PHX,5.0,Free Throws Made,18,13,13,10
22023,1626164,22300260,"NOV 29, 2023",PHX @ TOR,L,33,2,12,0.167,0,4,0.0,4,4,1.0,0,5,5,5,0,0,2,3,8,-15,1,Devin Booker,PHX,TOR,PHX,19.0,FG Attempted,18,13,13,10
22023,1626164,22300260,"NOV 29, 2023",PHX @ TOR,L,33,2,12,0.167,0,4,0.0,4,4,1.0,0,5,5,5,0,0,2,3,8,-15,1,Devin Booker,PHX,TOR,PHX,31.5,Pts+Rebs,18,13,13,10
22023,1626164,22300260,"NOV 29, 2023",PHX @ TOR,L,33,2,12,0.167,0,4,0.0,4,4,1.0,0,5,5,5,0,0,2,3,8,-15,1,Devin Booker,PHX,TOR,PHX,34.5,Pts+Asts,18,13,13,10
22023,1626164,22300260,"NOV 29, 2023",PHX @ TOR,L,33,2,12,0.167,0,4,0.0,4,4,1.0,0,5,5,5,0,0,2,3,8,-15,1,Devin Booker,PHX,TOR,PHX,12.0,Rebs+Asts,18,13,13,10
22023,1626164,22300260,"NOV 29, 2023",PHX @ TOR,L,33,2,12,0.167,0,4,0.0,4,4,1.0,0,5,5,5,0,0,2,3,8,-15,1,Devin Booker,PHX,TOR,PHX,2.5,Turnovers,18,13,13,10
22023,1626164,22300247,"NOV 26, 2023",PHX @ NYK,W,38,10,25,0.4,1,4,0.25,7,8,0.875,2,3,5,11,0,2,2,3,28,15,1,Devin Booker,PHX,NYK,PHX,26.5,Points,44,33,39,16
22023,1626164,22300247,"NOV 26, 2023",PHX @ NYK,W,38,10,25,0.4,1,4,0.25,7,8,0.875,2,3,5,11,0,2,2,3,28,15,1,Devin Booker,PHX,NYK,PHX,4.5,Rebounds,44,33,39,16
22023,1626164,22300247,"NOV 26, 2023",PHX @ NYK,W,38,10,25,0.4,1,4,0.25,7,8,0.875,2,3,5,11,0,2,2,3,28,15,1,Devin Booker,PHX,NYK,PHX,39.5,Pts+Rebs+Asts,44,33,39,16
22023,1626164,22300247,"NOV 26, 2023",PHX @ NYK,W,38,10,25,0.4,1,4,0.25,7,8,0.875,2,3,5,11,0,2,2,3,28,15,1,Devin Booker,PHX,NYK,PHX,7.0,Assists,44,33,39,16
22023,1626164,22300247,"NOV 26, 2023",PHX @ NYK,W,38,10,25,0.4,1,4,0.25,7,8,0.875,2,3,5,11,0,2,2,3,28,15,1,Devin Booker,PHX,NYK,PHX,44.5,Fantasy Score,44,33,39,16
22023,1626164,22300247,"NOV 26, 2023",PHX @ NYK,W,38,10,25,0.4,1,4,0.25,7,8,0.875,2,3,5,11,0,2,2,3,28,15,1,Devin Booker,PHX,NYK,PHX,6.0,3-PT Attempted,44,33,39,16
22023,1626164,22300247,"NOV 26, 2023",PHX @ NYK,W,38,10,25,0.4,1,4,0.25,7,8,0.875,2,3,5,11,0,2,2,3,28,15,1,Devin Booker,PHX,NYK,PHX,5.0,Free Throws Made,44,33,39,16
22023,1626164,22300247,"NOV 26, 2023",PHX @ NYK,W,38,10,25,0.4,1,4,0.25,7,8,0.875,2,3,5,11,0,2,2,3,28,15,1,Devin Booker,PHX,NYK,PHX,19.0,FG Attempted,44,33,39,16
22023,1626164,22300247,"NOV 26, 2023",PHX @ NYK,W,38,10,25,0.4,1,4,0.25,7,8,0.875,2,3,5,11,0,2,2,3,28,15,1,Devin Booker,PHX,NYK,PHX,31.5,Pts+Rebs,44,33,39,16
22023,1626164,22300247,"NOV 26, 2023",PHX @ NYK,W,38,10,25,0.4,1,4,0.25,7,8,0.875,2,3,5,11,0,2,2,3,28,15,1,Devin Booker,PHX,NYK,PHX,34.5,Pts+Asts,44,33,39,16
22023,1626164,22300247,"NOV 26, 2023",PHX @ NYK,W,38,10,25,0.4,1,4,0.25,7,8,0.875,2,3,5,11,0,2,2,3,28,15,1,Devin Booker,PHX,NYK,PHX,12.0,Rebs+Asts,44,33,39,16
22023,1626164,22300247,"NOV 26, 2023",PHX @ NYK,W,38,10,25,0.4,1,4,0.25,7,8,0.875,2,3,5,11,0,2,2,3,28,15,1,Devin Booker,PHX,NYK,PHX,2.5,Turnovers,44,33,39,16
22023,1626164,22300044,"NOV 24, 2023",PHX @ MEM,W,33,15,21,0.714,3,4,0.75,7,9,0.778,1,4,5,4,4,1,5,3,40,28,1,Devin Booker,PHX,MEM,PHX,26.5,Points,49,45,44,9
22023,1626164,22300044,"NOV 24, 2023",PHX @ MEM,W,33,15,21,0.714,3,4,0.75,7,9,0.778,1,4,5,4,4,1,5,3,40,28,1,Devin Booker,PHX,MEM,PHX,4.5,Rebounds,49,45,44,9
22023,1626164,22300044,"NOV 24, 2023",PHX @ MEM,W,33,15,21,0.714,3,4,0.75,7,9,0.778,1,4,5,4,4,1,5,3,40,28,1,Devin Booker,PHX,MEM,PHX,39.5,Pts+Rebs+Asts,49,45,44,9
22023,1626164,22300044,"NOV 24, 2023",PHX @ MEM,W,33,15,21,0.714,3,4,0.75,7,9,0.778,1,4,5,4,4,1,5,3,40,28,1,Devin Booker,PHX,MEM,PHX,7.0,Assists,49,45,44,9
22023,1626164,22300044,"NOV 24, 2023",PHX @ MEM,W,33,15,21,0.714,3,4,0.75,7,9,0.778,1,4,5,4,4,1,5,3,40,28,1,Devin Booker,PHX,MEM,PHX,44.5,Fantasy Score,49,45,44,9
22023,1626164,22300044,"NOV 24, 2023",PHX @ MEM,W,33,15,21,0.714,3,4,0.75,7,9,0.778,1,4,5,4,4,1,5,3,40,28,1,Devin Booker,PHX,MEM,PHX,6.0,3-PT Attempted,49,45,44,9
22023,1626164,22300044,"NOV 24, 2023",PHX @ MEM,W,33,15,21,0.714,3,4,0.75,7,9,0.778,1,4,5,4,4,1,5,3,40,28,1,Devin Booker,PHX,MEM,PHX,5.0,Free Throws Made,49,45,44,9
22023,1626164,22300044,"NOV 24, 2023",PHX @ MEM,W,33,15,21,0.714,3,4,0.75,7,9,0.778,1,4,5,4,4,1,5,3,40,28,1,Devin Booker,PHX,MEM,PHX,19.0,FG Attempted,49,45,44,9
22023,1626164,22300044,"NOV 24, 2023",PHX @ MEM,W,33,15,21,0.714,3,4,0.75,7,9,0.778,1,4,5,4,4,1,5,3,40,28,1,Devin Booker,PHX,MEM,PHX,31.5,Pts+Rebs,49,45,44,9
22023,1626164,22300044,"NOV 24, 2023",PHX @ MEM,W,33,15,21,0.714,3,4,0.75,7,9,0.778,1,4,5,4,4,1,5,3,40,28,1,Devin Booker,PHX,MEM,PHX,34.5,Pts+Asts,49,45,44,9
22023,1626164,22300044,"NOV 24, 2023",PHX @ MEM,W,33,15,21,0.714,3,4,0.75,7,9,0.778,1,4,5,4,4,1,5,3,40,28,1,Devin Booker,PHX,MEM,PHX,12.0,Rebs+Asts,49,45,44,9
22023,1626164,22300044,"NOV 24, 2023",PHX @ MEM,W,33,15,21,0.714,3,4,0.75,7,9,0.778,1,4,5,4,4,1,5,3,40,28,1,Devin Booker,PHX,MEM,PHX,2.5,Turnovers,49,45,44,9
22023,1626164,22300236,"NOV 22, 2023",PHX vs. GSW,W,31,5,15,0.333,2,3,0.667,13,14,0.929,3,5,8,10,1,0,3,2,25,23,1,Devin Booker,PHX,PHX,GSW,26.5,Points,43,33,35,18
22023,1626164,22300236,"NOV 22, 2023",PHX vs. GSW,W,31,5,15,0.333,2,3,0.667,13,14,0.929,3,5,8,10,1,0,3,2,25,23,1,Devin Booker,PHX,PHX,GSW,4.5,Rebounds,43,33,35,18
22023,1626164,22300236,"NOV 22, 2023",PHX vs. GSW,W,31,5,15,0.333,2,3,0.667,13,14,0.929,3,5,8,10,1,0,3,2,25,23,1,Devin Booker,PHX,PHX,GSW,39.5,Pts+Rebs+Asts,43,33,35,18
22023,1626164,22300236,"NOV 22, 2023",PHX vs. GSW,W,31,5,15,0.333,2,3,0.667,13,14,0.929,3,5,8,10,1,0,3,2,25,23,1,Devin Booker,PHX,PHX,GSW,7.0,Assists,43,33,35,18
22023,1626164,22300236,"NOV 22, 2023",PHX vs. GSW,W,31,5,15,0.333,2,3,0.667,13,14,0.929,3,5,8,10,1,0,3,2,25,23,1,Devin Booker,PHX,PHX,GSW,44.5,Fantasy Score,43,33,35,18
22023,1626164,22300236,"NOV 22, 2023",PHX vs. GSW,W,31,5,15,0.333,2,3,0.667,13,14,0.929,3,5,8,10,1,0,3,2,25,23,1,Devin Booker,PHX,PHX,GSW,6.0,3-PT Attempted,43,33,35,18
22023,1626164,22300236,"NOV 22, 2023",PHX vs. GSW,W,31,5,15,0.333,2,3,0.667,13,14,0.929,3,5,8,10,1,0,3,2,25,23,1,Devin Booker,PHX,PHX,GSW,5.0,Free Throws Made,43,33,35,18
22023,1626164,22300236,"NOV 22, 2023",PHX vs. GSW,W,31,5,15,0.333,2,3,0.667,13,14,0.929,3,5,8,10,1,0,3,2,25,23,1,Devin Booker,PHX,PHX,GSW,19.0,FG Attempted,43,33,35,18
22023,1626164,22300236,"NOV 22, 2023",PHX vs. GSW,W,31,5,15,0.333,2,3,0.667,13,14,0.929,3,5,8,10,1,0,3,2,25,23,1,Devin Booker,PHX,PHX,GSW,31.5,Pts+Rebs,43,33,35,18
22023,1626164,22300236,"NOV 22, 2023",PHX vs. GSW,W,31,5,15,0.333,2,3,0.667,13,14,0.929,3,5,8,10,1,0,3,2,25,23,1,Devin Booker,PHX,PHX,GSW,34.5,Pts+Asts,43,33,35,18
22023,1626164,22300236,"NOV 22, 2023",PHX vs. GSW,W,31,5,15,0.333,2,3,0.667,13,14,0.929,3,5,8,10,1,0,3,2,25,23,1,Devin Booker,PHX,PHX,GSW,12.0,Rebs+Asts,43,33,35,18
22023,1626164,22300236,"NOV 22, 2023",PHX vs. GSW,W,31,5,15,0.333,2,3,0.667,13,14,0.929,3,5,8,10,1,0,3,2,25,23,1,Devin Booker,PHX,PHX,GSW,2.5,Turnovers,43,33,35,18
22023,1626164,22300041,"NOV 21, 2023",PHX vs. POR,W,33,9,20,0.45,0,3,0.0,10,10,1.0,0,3,3,6,1,1,1,1,28,18,1,Devin Booker,PHX,PHX,POR,26.5,Points,37,31,34,9
22023,1626164,22300041,"NOV 21, 2023",PHX vs. POR,W,33,9,20,0.45,0,3,0.0,10,10,1.0,0,3,3,6,1,1,1,1,28,18,1,Devin Booker,PHX,PHX,POR,4.5,Rebounds,37,31,34,9
22023,1626164,22300041,"NOV 21, 2023",PHX vs. POR,W,33,9,20,0.45,0,3,0.0,10,10,1.0,0,3,3,6,1,1,1,1,28,18,1,Devin Booker,PHX,PHX,POR,39.5,Pts+Rebs+Asts,37,31,34,9
22023,1626164,22300041,"NOV 21, 2023",PHX vs. POR,W,33,9,20,0.45,0,3,0.0,10,10,1.0,0,3,3,6,1,1,1,1,28,18,1,Devin Booker,PHX,PHX,POR,7.0,Assists,37,31,34,9
22023,1626164,22300041,"NOV 21, 2023",PHX vs. POR,W,33,9,20,0.45,0,3,0.0,10,10,1.0,0,3,3,6,1,1,1,1,28,18,1,Devin Booker,PHX,PHX,POR,44.5,Fantasy Score,37,31,34,9
22023,1626164,22300041,"NOV 21, 2023",PHX vs. POR,W,33,9,20,0.45,0,3,0.0,10,10,1.0,0,3,3,6,1,1,1,1,28,18,1,Devin Booker,PHX,PHX,POR,6.0,3-PT Attempted,37,31,34,9
22023,1626164,22300041,"NOV 21, 2023",PHX vs. POR,W,33,9,20,0.45,0,3,0.0,10,10,1.0,0,3,3,6,1,1,1,1,28,18,1,Devin Booker,PHX,PHX,POR,5.0,Free Throws Made,37,31,34,9
22023,1626164,22300041,"NOV 21, 2023",PHX vs. POR,W,33,9,20,0.45,0,3,0.0,10,10,1.0,0,3,3,6,1,1,1,1,28,18,1,Devin Booker,PHX,PHX,POR,19.0,FG Attempted,37,31,34,9
22023,1626164,22300041,"NOV 21, 2023",PHX vs. POR,W,33,9,20,0.45,0,3,0.0,10,10,1.0,0,3,3,6,1,1,1,1,28,18,1,Devin Booker,PHX,PHX,POR,31.5,Pts+Rebs,37,31,34,9
22023,1626164,22300041,"NOV 21, 2023",PHX vs. POR,W,33,9,20,0.45,0,3,0.0,10,10,1.0,0,3,3,6,1,1,1,1,28,18,1,Devin Booker,PHX,PHX,POR,34.5,Pts+Asts,37,31,34,9
22023,1626164,22300041,"NOV 21, 2023",PHX vs. POR,W,33,9,20,0.45,0,3,0.0,10,10,1.0,0,3,3,6,1,1,1,1,28,18,1,Devin Booker,PHX,PHX,POR,12.0,Rebs+Asts,37,31,34,9
22023,1626164,22300041,"NOV 21, 2023",PHX vs. POR,W,33,9,20,0.45,0,3,0.0,10,10,1.0,0,3,3,6,1,1,1,1,28,18,1,Devin Booker,PHX,PHX,POR,2.5,Turnovers,37,31,34,9
22023,1626164,22300214,"NOV 19, 2023",PHX @ UTA,W,40,8,21,0.381,2,7,0.286,8,8,1.0,1,4,5,8,0,1,3,5,26,2,1,Devin Booker,PHX,UTA,PHX,26.5,Points,39,31,34,13
22023,1626164,22300214,"NOV 19, 2023",PHX @ UTA,W,40,8,21,0.381,2,7,0.286,8,8,1.0,1,4,5,8,0,1,3,5,26,2,1,Devin Booker,PHX,UTA,PHX,4.5,Rebounds,39,31,34,13
22023,1626164,22300214,"NOV 19, 2023",PHX @ UTA,W,40,8,21,0.381,2,7,0.286,8,8,1.0,1,4,5,8,0,1,3,5,26,2,1,Devin Booker,PHX,UTA,PHX,39.5,Pts+Rebs+Asts,39,31,34,13
22023,1626164,22300214,"NOV 19, 2023",PHX @ UTA,W,40,8,21,0.381,2,7,0.286,8,8,1.0,1,4,5,8,0,1,3,5,26,2,1,Devin Booker,PHX,UTA,PHX,7.0,Assists,39,31,34,13
22023,1626164,22300214,"NOV 19, 2023",PHX @ UTA,W,40,8,21,0.381,2,7,0.286,8,8,1.0,1,4,5,8,0,1,3,5,26,2,1,Devin Booker,PHX,UTA,PHX,44.5,Fantasy Score,39,31,34,13
22023,1626164,22300214,"NOV 19, 2023",PHX @ UTA,W,40,8,21,0.381,2,7,0.286,8,8,1.0,1,4,5,8,0,1,3,5,26,2,1,Devin Booker,PHX,UTA,PHX,6.0,3-PT Attempted,39,31,34,13
22023,1626164,22300214,"NOV 19, 2023",PHX @ UTA,W,40,8,21,0.381,2,7,0.286,8,8,1.0,1,4,5,8,0,1,3,5,26,2,1,Devin Booker,PHX,UTA,PHX,5.0,Free Throws Made,39,31,34,13
22023,1626164,22300214,"NOV 19, 2023",PHX @ UTA,W,40,8,21,0.381,2,7,0.286,8,8,1.0,1,4,5,8,0,1,3,5,26,2,1,Devin Booker,PHX,UTA,PHX,19.0,FG Attempted,39,31,34,13
22023,1626164,22300214,"NOV 19, 2023",PHX @ UTA,W,40,8,21,0.381,2,7,0.286,8,8,1.0,1,4,5,8,0,1,3,5,26,2,1,Devin Booker,PHX,UTA,PHX,31.5,Pts+Rebs,39,31,34,13
22023,1626164,22300214,"NOV 19, 2023",PHX @ UTA,W,40,8,21,0.381,2,7,0.286,8,8,1.0,1,4,5,8,0,1,3,5,26,2,1,Devin Booker,PHX,UTA,PHX,34.5,Pts+Asts,39,31,34,13
22023,1626164,22300214,"NOV 19, 2023",PHX @ UTA,W,40,8,21,0.381,2,7,0.286,8,8,1.0,1,4,5,8,0,1,3,5,26,2,1,Devin Booker,PHX,UTA,PHX,12.0,Rebs+Asts,39,31,34,13
22023,1626164,22300214,"NOV 19, 2023",PHX @ UTA,W,40,8,21,0.381,2,7,0.286,8,8,1.0,1,4,5,8,0,1,3,5,26,2,1,Devin Booker,PHX,UTA,PHX,2.5,Turnovers,39,31,34,13
22023,1626164,22300035,"NOV 17, 2023",PHX @ UTA,W,32,7,15,0.467,2,3,0.667,8,10,0.8,0,4,4,15,0,0,1,3,24,9,1,Devin Booker,PHX,UTA,PHX,26.5,Points,43,28,39,19
22023,1626164,22300035,"NOV 17, 2023",PHX @ UTA,W,32,7,15,0.467,2,3,0.667,8,10,0.8,0,4,4,15,0,0,1,3,24,9,1,Devin Booker,PHX,UTA,PHX,4.5,Rebounds,43,28,39,19
22023,1626164,22300035,"NOV 17, 2023",PHX @ UTA,W,32,7,15,0.467,2,3,0.667,8,10,0.8,0,4,4,15,0,0,1,3,24,9,1,Devin Booker,PHX,UTA,PHX,39.5,Pts+Rebs+Asts,43,28,39,19
22023,1626164,22300035,"NOV 17, 2023",PHX @ UTA,W,32,7,15,0.467,2,3,0.667,8,10,0.8,0,4,4,15,0,0,1,3,24,9,1,Devin Booker,PHX,UTA,PHX,7.0,Assists,43,28,39,19
22023,1626164,22300035,"NOV 17, 2023",PHX @ UTA,W,32,7,15,0.467,2,3,0.667,8,10,0.8,0,4,4,15,0,0,1,3,24,9,1,Devin Booker,PHX,UTA,PHX,44.5,Fantasy Score,43,28,39,19
22023,1626164,22300035,"NOV 17, 2023",PHX @ UTA,W,32,7,15,0.467,2,3,0.667,8,10,0.8,0,4,4,15,0,0,1,3,24,9,1,Devin Booker,PHX,UTA,PHX,6.0,3-PT Attempted,43,28,39,19
22023,1626164,22300035,"NOV 17, 2023",PHX @ UTA,W,32,7,15,0.467,2,3,0.667,8,10,0.8,0,4,4,15,0,0,1,3,24,9,1,Devin Booker,PHX,UTA,PHX,5.0,Free Throws Made,43,28,39,19
22023,1626164,22300035,"NOV 17, 2023",PHX @ UTA,W,32,7,15,0.467,2,3,0.667,8,10,0.8,0,4,4,15,0,0,1,3,24,9,1,Devin Booker,PHX,UTA,PHX,19.0,FG Attempted,43,28,39,19
22023,1626164,22300035,"NOV 17, 2023",PHX @ UTA,W,32,7,15,0.467,2,3,0.667,8,10,0.8,0,4,4,15,0,0,1,3,24,9,1,Devin Booker,PHX,UTA,PHX,31.5,Pts+Rebs,43,28,39,19
22023,1626164,22300035,"NOV 17, 2023",PHX @ UTA,W,32,7,15,0.467,2,3,0.667,8,10,0.8,0,4,4,15,0,0,1,3,24,9,1,Devin Booker,PHX,UTA,PHX,34.5,Pts+Asts,43,28,39,19
22023,1626164,22300035,"NOV 17, 2023",PHX @ UTA,W,32,7,15,0.467,2,3,0.667,8,10,0.8,0,4,4,15,0,0,1,3,24,9,1,Devin Booker,PHX,UTA,PHX,12.0,Rebs+Asts,43,28,39,19
22023,1626164,22300035,"NOV 17, 2023",PHX @ UTA,W,32,7,15,0.467,2,3,0.667,8,10,0.8,0,4,4,15,0,0,1,3,24,9,1,Devin Booker,PHX,UTA,PHX,2.5,Turnovers,43,28,39,19
22023,1626164,22300197,"NOV 15, 2023",PHX vs. MIN,W,26,12,22,0.545,2,7,0.286,5,5,1.0,1,3,4,5,0,0,2,2,31,0,1,Devin Booker,PHX,PHX,MIN,26.5,Points,40,35,36,9
22023,1626164,22300197,"NOV 15, 2023",PHX vs. MIN,W,26,12,22,0.545,2,7,0.286,5,5,1.0,1,3,4,5,0,0,2,2,31,0,1,Devin Booker,PHX,PHX,MIN,4.5,Rebounds,40,35,36,9
22023,1626164,22300197,"NOV 15, 2023",PHX vs. MIN,W,26,12,22,0.545,2,7,0.286,5,5,1.0,1,3,4,5,0,0,2,2,31,0,1,Devin Booker,PHX,PHX,MIN,39.5,Pts+Rebs+Asts,40,35,36,9
22023,1626164,22300197,"NOV 15, 2023",PHX vs. MIN,W,26,12,22,0.545,2,7,0.286,5,5,1.0,1,3,4,5,0,0,2,2,31,0,1,Devin Booker,PHX,PHX,MIN,7.0,Assists,40,35,36,9
22023,1626164,22300197,"NOV 15, 2023",PHX vs. MIN,W,26,12,22,0.545,2,7,0.286,5,5,1.0,1,3,4,5,0,0,2,2,31,0,1,Devin Booker,PHX,PHX,MIN,44.5,Fantasy Score,40,35,36,9
22023,1626164,22300197,"NOV 15, 2023",PHX vs. MIN,W,26,12,22,0.545,2,7,0.286,5,5,1.0,1,3,4,5,0,0,2,2,31,0,1,Devin Booker,PHX,PHX,MIN,6.0,3-PT Attempted,40,35,36,9
22023,1626164,22300197,"NOV 15, 2023",PHX vs. MIN,W,26,12,22,0.545,2,7,0.286,5,5,1.0,1,3,4,5,0,0,2,2,31,0,1,Devin Booker,PHX,PHX,MIN,5.0,Free Throws Made,40,35,36,9
22023,1626164,22300197,"NOV 15, 2023",PHX vs. MIN,W,26,12,22,0.545,2,7,0.286,5,5,1.0,1,3,4,5,0,0,2,2,31,0,1,Devin Booker,PHX,PHX,MIN,19.0,FG Attempted,40,35,36,9
22023,1626164,22300197,"NOV 15, 2023",PHX vs. MIN,W,26,12,22,0.545,2,7,0.286,5,5,1.0,1,3,4,5,0,0,2,2,31,0,1,Devin Booker,PHX,PHX,MIN,31.5,Pts+Rebs,40,35,36,9
22023,1626164,22300197,"NOV 15, 2023",PHX vs. MIN,W,26,12,22,0.545,2,7,0.286,5,5,1.0,1,3,4,5,0,0,2,2,31,0,1,Devin Booker,PHX,PHX,MIN,34.5,Pts+Asts,40,35,36,9
22023,1626164,22300197,"NOV 15, 2023",PHX vs. MIN,W,26,12,22,0.545,2,7,0.286,5,5,1.0,1,3,4,5,0,0,2,2,31,0,1,Devin Booker,PHX,PHX,MIN,12.0,Rebs+Asts,40,35,36,9
22023,1626164,22300197,"NOV 15, 2023",PHX vs. MIN,W,26,12,22,0.545,2,7,0.286,5,5,1.0,1,3,4,5,0,0,2,2,31,0,1,Devin Booker,PHX,PHX,MIN,2.5,Turnovers,40,35,36,9
22023,1626164,22300131,"NOV 02, 2023",PHX vs. SAS,L,35,10,19,0.526,5,7,0.714,6,6,1.0,1,8,9,13,0,0,5,4,31,-2,1,Devin Booker,PHX,PHX,SAS,26.5,Points,53,40,44,22
22023,1626164,22300131,"NOV 02, 2023",PHX vs. SAS,L,35,10,19,0.526,5,7,0.714,6,6,1.0,1,8,9,13,0,0,5,4,31,-2,1,Devin Booker,PHX,PHX,SAS,4.5,Rebounds,53,40,44,22
22023,1626164,22300131,"NOV 02, 2023",PHX vs. SAS,L,35,10,19,0.526,5,7,0.714,6,6,1.0,1,8,9,13,0,0,5,4,31,-2,1,Devin Booker,PHX,PHX,SAS,39.5,Pts+Rebs+Asts,53,40,44,22
22023,1626164,22300131,"NOV 02, 2023",PHX vs. SAS,L,35,10,19,0.526,5,7,0.714,6,6,1.0,1,8,9,13,0,0,5,4,31,-2,1,Devin Booker,PHX,PHX,SAS,7.0,Assists,53,40,44,22
22023,1626164,22300131,"NOV 02, 2023",PHX vs. SAS,L,35,10,19,0.526,5,7,0.714,6,6,1.0,1,8,9,13,0,0,5,4,31,-2,1,Devin Booker,PHX,PHX,SAS,44.5,Fantasy Score,53,40,44,22
22023,1626164,22300131,"NOV 02, 2023",PHX vs. SAS,L,35,10,19,0.526,5,7,0.714,6,6,1.0,1,8,9,13,0,0,5,4,31,-2,1,Devin Booker,PHX,PHX,SAS,6.0,3-PT Attempted,53,40,44,22
22023,1626164,22300131,"NOV 02, 2023",PHX vs. SAS,L,35,10,19,0.526,5,7,0.714,6,6,1.0,1,8,9,13,0,0,5,4,31,-2,1,Devin Booker,PHX,PHX,SAS,5.0,Free Throws Made,53,40,44,22
22023,1626164,22300131,"NOV 02, 2023",PHX vs. SAS,L,35,10,19,0.526,5,7,0.714,6,6,1.0,1,8,9,13,0,0,5,4,31,-2,1,Devin Booker,PHX,PHX,SAS,19.0,FG Attempted,53,40,44,22
22023,1626164,22300131,"NOV 02, 2023",PHX vs. SAS,L,35,10,19,0.526,5,7,0.714,6,6,1.0,1,8,9,13,0,0,5,4,31,-2,1,Devin Booker,PHX,PHX,SAS,31.5,Pts+Rebs,53,40,44,22
22023,1626164,22300131,"NOV 02, 2023",PHX vs. SAS,L,35,10,19,0.526,5,7,0.714,6,6,1.0,1,8,9,13,0,0,5,4,31,-2,1,Devin Booker,PHX,PHX,SAS,34.5,Pts+Asts,53,40,44,22
22023,1626164,22300131,"NOV 02, 2023",PHX vs. SAS,L,35,10,19,0.526,5,7,0.714,6,6,1.0,1,8,9,13,0,0,5,4,31,-2,1,Devin Booker,PHX,PHX,SAS,12.0,Rebs+Asts,53,40,44,22
22023,1626164,22300131,"NOV 02, 2023",PHX vs. SAS,L,35,10,19,0.526,5,7,0.714,6,6,1.0,1,8,9,13,0,0,5,4,31,-2,1,Devin Booker,PHX,PHX,SAS,2.5,Turnovers,53,40,44,22
22023,1626164,22300062,"OCT 24, 2023",PHX @ GSW,W,37,13,21,0.619,3,8,0.375,3,3,1.0,1,5,6,8,1,0,6,4,32,5,1,Devin Booker,PHX,GSW,PHX,26.5,Points,46,38,40,14
22023,1626164,22300062,"OCT 24, 2023",PHX @ GSW,W,37,13,21,0.619,3,8,0.375,3,3,1.0,1,5,6,8,1,0,6,4,32,5,1,Devin Booker,PHX,GSW,PHX,4.5,Rebounds,46,38,40,14
22023,1626164,22300062,"OCT 24, 2023",PHX @ GSW,W,37,13,21,0.619,3,8,0.375,3,3,1.0,1,5,6,8,1,0,6,4,32,5,1,Devin Booker,PHX,GSW,PHX,39.5,Pts+Rebs+Asts,46,38,40,14
22023,1626164,22300062,"OCT 24, 2023",PHX @ GSW,W,37,13,21,0.619,3,8,0.375,3,3,1.0,1,5,6,8,1,0,6,4,32,5,1,Devin Booker,PHX,GSW,PHX,7.0,Assists,46,38,40,14
22023,1626164,22300062,"OCT 24, 2023",PHX @ GSW,W,37,13,21,0.619,3,8,0.375,3,3,1.0,1,5,6,8,1,0,6,4,32,5,1,Devin Booker,PHX,GSW,PHX,44.5,Fantasy Score,46,38,40,14
22023,1626164,22300062,"OCT 24, 2023",PHX @ GSW,W,37,13,21,0.619,3,8,0.375,3,3,1.0,1,5,6,8,1,0,6,4,32,5,1,Devin Booker,PHX,GSW,PHX,6.0,3-PT Attempted,46,38,40,14
22023,1626164,22300062,"OCT 24, 2023",PHX @ GSW,W,37,13,21,0.619,3,8,0.375,3,3,1.0,1,5,6,8,1,0,6,4,32,5,1,Devin Booker,PHX,GSW,PHX,5.0,Free Throws Made,46,38,40,14
22023,1626164,22300062,"OCT 24, 2023",PHX @ GSW,W,37,13,21,0.619,3,8,0.375,3,3,1.0,1,5,6,8,1,0,6,4,32,5,1,Devin Booker,PHX,GSW,PHX,19.0,FG Attempted,46,38,40,14
22023,1626164,22300062,"OCT 24, 2023",PHX @ GSW,W,37,13,21,0.619,3,8,0.375,3,3,1.0,1,5,6,8,1,0,6,4,32,5,1,Devin Booker,PHX,GSW,PHX,31.5,Pts+Rebs,46,38,40,14
22023,1626164,22300062,"OCT 24, 2023",PHX @ GSW,W,37,13,21,0.619,3,8,0.375,3,3,1.0,1,5,6,8,1,0,6,4,32,5,1,Devin Booker,PHX,GSW,PHX,34.5,Pts+Asts,46,38,40,14
22023,1626164,22300062,"OCT 24, 2023",PHX @ GSW,W,37,13,21,0.619,3,8,0.375,3,3,1.0,1,5,6,8,1,0,6,4,32,5,1,Devin Booker,PHX,GSW,PHX,12.0,Rebs+Asts,46,38,40,14
22023,1626164,22300062,"OCT 24, 2023",PHX @ GSW,W,37,13,21,0.619,3,8,0.375,3,3,1.0,1,5,6,8,1,0,6,4,32,5,1,Devin Booker,PHX,GSW,PHX,2.5,Turnovers,46,38,40,14
22023,1630527,22300537,"JAN 12, 2024",LAC @ MEM,W,4,0,3,0.0,0,1,0.0,0,0,0.0,0,0,0,0,0,0,0,2,0,-11,1,Brandon Boston Jr.,LAC,MEM,LAC,,,0,0,0,0
22023,1630527,22300511,"JAN 08, 2024",LAC vs. PHX,W,5,2,2,1.0,1,1,1.0,0,0,0.0,0,0,0,0,0,0,1,2,5,2,1,Brandon Boston Jr.,LAC,LAC,PHX,,,5,5,5,0
22023,1630527,22300486,"JAN 05, 2024",LAC @ NOP,W,6,1,3,0.333,0,0,0.0,0,0,0.0,1,1,2,1,0,0,1,1,2,-12,1,Brandon Boston Jr.,LAC,NOP,LAC,,,5,4,3,3
22023,1630527,22300458,"JAN 01, 2024",LAC vs. MIA,W,3,0,1,0.0,0,0,0.0,0,0,0.0,0,0,0,0,0,0,0,0,0,-3,1,Brandon Boston Jr.,LAC,LAC,MIA,,,0,0,0,0
22023,1630527,22300389,"DEC 23, 2023",LAC vs. BOS,L,13,3,6,0.5,1,4,0.25,6,6,1.0,1,2,3,0,0,0,0,1,13,-4,1,Brandon Boston Jr.,LAC,LAC,BOS,,,16,16,13,3
22023,1630527,22300379,"DEC 21, 2023",LAC @ OKC,L,16,3,10,0.3,1,5,0.2,0,0,0.0,1,0,1,1,1,0,0,1,7,-4,1,Brandon Boston Jr.,LAC,OKC,LAC,,,9,8,8,2
22023,1630527,22300350,"DEC 18, 2023",LAC @ IND,W,6,3,4,0.75,0,0,0.0,0,0,0.0,0,0,0,0,0,0,1,2,6,-5,1,Brandon Boston Jr.,LAC,IND,LAC,,,6,6,6,0
22023,1630527,22300343,"DEC 16, 2023",LAC vs. NYK,W,5,1,3,0.333,1,3,0.333,0,0,0.0,0,2,2,2,0,0,0,1,3,-2,1,Brandon Boston Jr.,LAC,LAC,NYK,,,7,5,5,4
22023,1628449,22300563,"JAN 15, 2024",TOR vs. BOS,L,14,1,6,0.167,0,4,0.0,2,2,1.0,1,1,2,0,0,0,0,1,4,-8,1,Chris Boucher,TOR,TOR,BOS,,,6,6,4,2
22023,1628449,22300540,"JAN 12, 2024",TOR @ UTA,L,12,2,4,0.5,1,3,0.333,2,2,1.0,0,0,0,0,0,0,1,1,7,-12,1,Chris Boucher,TOR,UTA,TOR,,,7,7,7,0
22023,1628449,22300526,"JAN 10, 2024",TOR @ LAC,L,11,1,3,0.333,0,1,0.0,1,1,1.0,0,1,1,0,0,0,0,0,3,-10,1,Chris Boucher,TOR,LAC,TOR,,,4,4,3,1
22023,1628449,22300516,"JAN 09, 2024",TOR @ LAL,L,14,1,3,0.333,0,2,0.0,0,0,0.0,0,7,7,1,2,0,3,1,2,-4,1,Chris Boucher,TOR,LAL,TOR,,,10,9,3,8
22023,1628449,22300504,"JAN 07, 2024",TOR @ GSW,W,16,7,7,1.0,3,3,1.0,0,0,0.0,2,7,9,1,1,1,0,0,17,17,1,Chris Boucher,TOR,GSW,TOR,,,27,26,18,10
22023,1628449,22300492,"JAN 05, 2024",TOR @ SAC,L,28,5,9,0.556,1,5,0.2,3,5,0.6,3,6,9,1,1,1,0,2,14,1,1,Chris Boucher,TOR,SAC,TOR,,,24,23,15,10
22023,1628449,22300470,"JAN 03, 2024",TOR @ MEM,W,13,2,2,1.0,0,0,0.0,0,0,0.0,3,5,8,2,0,0,1,0,4,10,1,Chris Boucher,TOR,MEM,TOR,,,14,12,6,10
22023,1628449,22300452,"JAN 01, 2024",TOR vs. CLE,W,11,0,0,0.0,0,0,0.0,0,0,0.0,0,1,1,0,0,0,0,0,0,1,1,Chris Boucher,TOR,TOR,CLE,,,1,1,0,1
22023,1628449,22300440,"DEC 30, 2023",TOR @ DET,L,17,0,1,0.0,0,1,0.0,4,6,0.667,0,2,2,0,0,0,0,2,4,-3,1,Chris Boucher,TOR,DET,TOR,,,6,6,4,2
22023,1628449,22300432,"DEC 29, 2023",TOR @ BOS,L,7,1,3,0.333,1,3,0.333,0,0,0.0,0,3,3,0,0,0,0,1,3,-8,1,Chris Boucher,TOR,BOS,TOR,,,6,6,3,3
22023,1628449,22300416,"DEC 27, 2023",TOR @ WAS,W,12,2,5,0.4,2,4,0.5,0,0,0.0,1,3,4,0,0,0,0,3,6,7,1,Chris Boucher,TOR,WAS,TOR,,,10,10,6,4
22023,1628449,22300395,"DEC 23, 2023",TOR vs. UTA,L,13,3,3,1.0,1,1,1.0,2,3,0.667,1,2,3,1,1,0,0,2,9,-11,1,Chris Boucher,TOR,TOR,UTA,,,13,12,10,4
22023,1628449,22300369,"DEC 20, 2023",TOR vs. DEN,L,12,2,3,0.667,1,1,1.0,0,0,0.0,2,5,7,0,0,1,1,1,5,8,1,Chris Boucher,TOR,TOR,DEN,,,12,12,5,7
22023,1628449,22300354,"DEC 18, 2023",TOR vs. CHA,W,15,3,6,0.5,0,1,0.0,1,2,0.5,1,2,3,0,0,1,0,1,7,7,1,Chris Boucher,TOR,TOR,CHA,,,10,10,7,3
22023,1628449,22300330,"DEC 15, 2023",TOR vs. ATL,L,15,2,4,0.5,1,3,0.333,2,5,0.4,0,3,3,0,1,2,1,1,7,-7,1,Chris Boucher,TOR,TOR,ATL,,,10,10,7,3
22023,1628449,22300313,"DEC 13, 2023",TOR vs. ATL,W,10,1,2,0.5,0,1,0.0,0,0,0.0,0,0,0,0,0,2,0,0,2,-10,1,Chris Boucher,TOR,TOR,ATL,,,2,2,2,0
22023,1628449,22300297,"DEC 11, 2023",TOR @ NYK,L,10,2,8,0.25,0,4,0.0,1,1,1.0,2,1,3,0,0,0,1,1,5,-8,1,Chris Boucher,TOR,NYK,TOR,,,8,8,5,3
22023,1628449,22301216,"DEC 08, 2023",TOR @ CHA,L,13,4,9,0.444,0,3,0.0,1,1,1.0,1,2,3,0,0,1,1,4,9,11,1,Chris Boucher,TOR,CHA,TOR,,,12,12,9,3
22023,1628449,22301207,"DEC 06, 2023",TOR vs. MIA,L,10,0,2,0.0,0,1,0.0,0,0,0.0,0,4,4,0,0,0,1,0,0,2,1,Chris Boucher,TOR,TOR,MIA,,,4,4,0,4
22023,1628449,22300276,"DEC 01, 2023",TOR vs. NYK,L,19,4,10,0.4,1,4,0.25,2,3,0.667,2,1,3,2,1,0,0,0,11,5,1,Chris Boucher,TOR,TOR,NYK,,,16,14,13,5
22023,1628449,22300260,"NOV 29, 2023",TOR vs. PHX,W,3,0,0,0.0,0,0,0.0,0,0,0.0,0,0,0,0,0,0,0,0,0,0,1,Chris Boucher,TOR,TOR,PHX,,,0,0,0,0
22023,1628449,22300054,"NOV 28, 2023",TOR @ BKN,L,12,5,7,0.714,3,4,0.75,0,0,0.0,1,0,1,0,1,0,0,0,13,8,1,Chris Boucher,TOR,BKN,TOR,,,14,14,13,1
22023,1628449,22300251,"NOV 26, 2023",TOR @ CLE,L,10,1,2,0.5,0,0,0.0,3,4,0.75,2,2,4,0,1,0,1,0,5,-9,1,Chris Boucher,TOR,CLE,TOR,,,9,9,5,4
22023,1628449,22300046,"NOV 24, 2023",TOR vs. CHI,W,10,1,3,0.333,0,1,0.0,2,2,1.0,0,1,1,0,1,0,0,1,4,-1,1,Chris Boucher,TOR,TOR,CHI,,,5,5,4,1
22023,1628449,22300230,"NOV 22, 2023",TOR @ IND,W,10,1,3,0.333,0,1,0.0,4,4,1.0,1,0,1,0,0,0,0,2,6,6,1,Chris Boucher,TOR,IND,TOR,,,7,7,6,1
22023,1628449,22300038,"NOV 21, 2023",TOR @ ORL,L,18,1,4,0.25,1,3,0.333,0,0,0.0,0,2,2,0,0,1,0,3,3,-12,1,Chris Boucher,TOR,ORL,TOR,,,5,5,3,2
22023,1628449,22300211,"NOV 19, 2023",TOR vs. DET,W,18,5,7,0.714,3,4,0.75,1,3,0.333,1,5,6,1,1,1,0,4,14,10,1,Chris Boucher,TOR,TOR,DET,,,21,20,15,7
22023,1628449,22300031,"NOV 17, 2023",TOR vs. BOS,L,18,2,6,0.333,1,2,0.5,1,2,0.5,1,3,4,0,0,0,0,0,6,-10,1,Chris Boucher,TOR,TOR,BOS,,,10,10,6,4
22023,1628449,22300195,"NOV 15, 2023",TOR vs. MIL,L,20,2,8,0.25,1,3,0.333,4,4,1.0,5,4,9,0,0,1,1,1,9,6,1,Chris Boucher,TOR,TOR,MIL,,,18,18,9,9
22023,1628449,22300189,"NOV 13, 2023",TOR vs. WAS,W,21,3,6,0.5,1,2,0.5,0,0,0.0,2,5,7,2,0,3,0,1,7,14,1,Chris Boucher,TOR,TOR,WAS,,,16,14,9,9
22023,1628449,22300174,"NOV 11, 2023",TOR @ BOS,L,22,2,4,0.5,2,3,0.667,0,0,0.0,0,5,5,1,0,0,0,2,6,-9,1,Chris Boucher,TOR,BOS,TOR,,,12,11,7,6
22023,1628449,22300168,"NOV 08, 2023",TOR @ DAL,W,15,4,4,1.0,1,1,1.0,1,2,0.5,1,1,2,0,0,1,1,5,10,4,1,Chris Boucher,TOR,DAL,TOR,,,12,12,10,2
22023,1628449,22300128,"NOV 02, 2023",TOR @ PHI,L,13,2,4,0.5,0,2,0.0,2,2,1.0,2,2,4,0,0,1,1,3,6,-5,1,Chris Boucher,TOR,PHI,TOR,,,10,10,6,4
22023,1628449,22300116,"NOV 01, 2023",TOR vs. MIL,W,13,2,4,0.5,0,1,0.0,2,2,1.0,1,4,5,1,1,0,0,3,6,-10,1,Chris Boucher,TOR,TOR,MIL,,,12,11,7,6
22023,1628449,22300105,"OCT 30, 2023",TOR vs. POR,L,17,1,4,0.25,0,0,0.0,2,2,1.0,3,4,7,1,0,1,1,2,4,-3,1,Chris Boucher,TOR,TOR,POR,,,12,11,5,8
22023,1628449,22300092,"OCT 28, 2023",TOR vs. PHI,L,12,1,6,0.167,0,2,0.0,3,3,1.0,1,3,4,0,1,0,1,2,5,-2,1,Chris Boucher,TOR,TOR,PHI,,,9,9,5,4
22023,1628449,22300082,"OCT 27, 2023",TOR @ CHI,L,17,3,4,0.75,0,0,0.0,4,5,0.8,1,5,6,0,0,0,1,3,10,22,1,Chris Boucher,TOR,CHI,TOR,,,16,16,10,6
22023,1630547,22300551,"JAN 14, 2024",CHA @ MIA,L,2,0,1,0.0,0,0,0.0,1,2,0.5,0,0,0,0,0,0,0,0,1,1,1,James Bouknight,CHA,MIA,CHA,,,1,1,1,0
22023,1630547,22300541,"JAN 12, 2024",CHA @ SAS,L,6,0,2,0.0,0,2,0.0,0,0,0.0,0,1,1,0,0,1,0,0,0,-9,1,James Bouknight,CHA,SAS,CHA,,,1,1,0,1
22023,1630547,22300518,"JAN 10, 2024",CHA vs. SAC,L,20,3,8,0.375,2,6,0.333,0,0,0.0,0,0,0,1,0,0,0,0,8,-10,1,James Bouknight,CHA,CHA,SAC,,,9,8,9,1
22023,1630547,22300506,"JAN 08, 2024",CHA vs. CHI,L,4,1,1,1.0,1,1,1.0,0,0,0.0,0,2,2,2,0,0,0,1,3,-2,1,James Bouknight,CHA,CHA,CHI,,,7,5,5,4
22023,1630547,22300455,"JAN 01, 2024",CHA @ DEN,L,4,0,1,0.0,0,0,0.0,0,0,0.0,0,0,0,2,0,0,0,0,0,6,1,James Bouknight,CHA,DEN,CHA,,,2,0,2,2
22023,1630547,22300428,"DEC 28, 2023",CHA @ LAL,L,6,2,3,0.667,1,1,1.0,0,0,0.0,0,2,2,1,0,0,0,0,5,6,1,James Bouknight,CHA,LAL,CHA,,,8,7,6,3
22023,1630547,22300365,"DEC 20, 2023",CHA @ IND,L,6,1,3,0.333,1,3,0.333,0,0,0.0,0,2,2,0,0,0,1,0,3,-5,1,James Bouknight,CHA,IND,CHA,,,5,5,3,2
22023,1630547,22300335,"DEC 16, 2023",CHA vs. PHI,L,7,3,5,0.6,3,5,0.6,0,0,0.0,0,1,1,0,0,0,0,1,9,-6,1,James Bouknight,CHA,CHA,PHI,,,10,10,9,1
22023,1630547,22300057,"NOV 28, 2023",CHA @ NYK,L,5,2,3,0.667,1,2,0.5,0,0,0.0,1,0,1,0,0,0,0,0,5,-1,1,James Bouknight,CHA,NYK,CHA,,,6,6,5,1
22023,1631103,22300559,"JAN 15, 2024",SAS @ ATL,L,10,2,4,0.5,0,1,0.0,0,0,0.0,0,0,0,0,0,0,0,1,4,-21,1,Malaki Branham,SAS,ATL,SAS,,,4,4,4,0
22023,1631103,22300548,"JAN 13, 2024",SAS vs. CHI,L,22,6,15,0.4,2,8,0.25,0,0,0.0,0,1,1,1,3,0,1,0,14,3,1,Malaki Branham,SAS,SAS,CHI,,,16,15,15,2
22023,1631103,22300541,"JAN 12, 2024",SAS vs. CHA,W,20,3,7,0.429,2,3,0.667,0,0,0.0,0,2,2,4,0,0,2,0,8,19,1,Malaki Branham,SAS,SAS,CHA,,,14,10,12,6
22023,1631103,22300519,"JAN 10, 2024",SAS @ DET,W,21,2,7,0.286,1,3,0.333,2,2,1.0,1,1,2,3,0,0,1,2,7,5,1,Malaki Branham,SAS,DET,SAS,,,12,9,10,5
22023,1631103,22300497,"JAN 07, 2024",SAS @ CLE,L,15,1,5,0.2,0,3,0.0,0,0,0.0,0,1,1,2,0,0,1,2,2,-20,1,Malaki Branham,SAS,CLE,SAS,,,5,3,4,3
22023,1631103,22300460,"JAN 02, 2024",SAS @ MEM,L,7,1,5,0.2,0,0,0.0,0,0,0.0,0,1,1,1,0,0,0,1,2,-3,1,Malaki Branham,SAS,MEM,SAS,,,4,3,3,2
22023,1631103,22300448,"DEC 31, 2023",SAS vs. BOS,L,23,4,9,0.444,1,5,0.2,2,3,0.667,0,1,1,0,0,0,1,0,11,-25,1,Malaki Branham,SAS,SAS,BOS,,,12,12,11,1
22023,1631103,22300437,"DEC 29, 2023",SAS @ POR,L,29,5,12,0.417,1,3,0.333,0,0,0.0,3,3,6,3,1,0,3,1,11,-24,1,Malaki Branham,SAS,POR,SAS,,,20,17,14,9
22023,1631103,22300427,"DEC 28, 2023",SAS @ POR,W,29,4,10,0.4,3,6,0.5,2,2,1.0,2,3,5,4,1,0,2,5,13,4,1,Malaki Branham,SAS,POR,SAS,,,22,18,17,9
22023,1631103,22300412,"DEC 26, 2023",SAS vs. UTA,L,17,0,3,0.0,0,0,0.0,0,0,0.0,0,4,4,4,0,0,2,1,0,9,1,Malaki Branham,SAS,SAS,UTA,,,8,4,4,8
22023,1631103,22300398,"DEC 23, 2023",SAS @ DAL,L,24,5,11,0.455,1,4,0.25,1,1,1.0,0,3,3,4,0,0,1,2,12,-22,1,Malaki Branham,SAS,DAL,SAS,,,19,15,16,7
22023,1631103,22300376,"DEC 21, 2023",SAS @ CHI,L,29,6,11,0.545,1,4,0.25,0,0,0.0,0,6,6,2,0,0,3,1,13,-4,1,Malaki Branham,SAS,CHI,SAS,,,21,19,15,8
22023,1631103,22300361,"DEC 19, 2023",SAS @ MIL,L,27,5,11,0.455,2,4,0.5,0,0,0.0,0,2,2,3,0,0,1,1,12,0,1,Malaki Branham,SAS,MIL,SAS,,,17,14,15,5
22023,1631103,22300345,"DEC 17, 2023",SAS vs. NOP,L,30,4,8,0.5,1,3,0.333,2,2,1.0,0,2,2,2,0,0,2,1,11,-23,1,Malaki Branham,SAS,SAS,NOP,,,15,13,13,4
22023,1631103,22300331,"DEC 15, 2023",SAS vs. LAL,W,33,5,8,0.625,2,3,0.667,0,0,0.0,0,4,4,8,1,1,0,3,12,18,1,Malaki Branham,SAS,SAS,LAL,,,24,16,20,12
22023,1631103,22300316,"DEC 13, 2023",SAS vs. LAL,L,28,8,13,0.615,2,5,0.4,1,1,1.0,0,3,3,0,1,0,3,1,19,3,1,Malaki Branham,SAS,SAS,LAL,,,22,22,19,3
22023,1631103,22300298,"DEC 11, 2023",SAS @ HOU,L,34,6,13,0.462,0,3,0.0,1,1,1.0,0,6,6,7,1,0,3,0,13,-10,1,Malaki Branham,SAS,HOU,SAS,,,26,19,20,13
22023,1631103,22301223,"DEC 08, 2023",SAS vs. CHI,L,23,3,6,0.5,2,4,0.5,2,2,1.0,0,0,0,2,0,1,0,2,10,-17,1,Malaki Branham,SAS,SAS,CHI,,,12,10,12,2
22023,1631103,22301210,"DEC 06, 2023",SAS @ MIN,L,10,0,2,0.0,0,1,0.0,0,0,0.0,2,0,2,0,0,0,0,2,0,-7,1,Malaki Branham,SAS,MIN,SAS,,,2,2,0,2
22023,1631103,22300278,"DEC 01, 2023",SAS @ NOP,L,22,4,7,0.571,2,3,0.667,0,0,0.0,0,2,2,0,0,0,3,1,10,2,1,Malaki Branham,SAS,NOP,SAS,,,12,12,10,2
22023,1631103,22300272,"NOV 30, 2023",SAS vs. ATL,L,17,1,5,0.2,0,2,0.0,0,0,0.0,0,3,3,3,0,1,3,1,2,7,1,Malaki Branham,SAS,SAS,ATL,,,8,5,5,6
22023,1631103,22300252,"NOV 26, 2023",SAS @ DEN,L,25,6,11,0.545,3,5,0.6,0,0,0.0,1,1,2,3,1,0,0,3,15,-15,1,Malaki Branham,SAS,DEN,SAS,,,20,17,18,5
22023,1631103,22300051,"NOV 24, 2023",SAS @ GSW,L,19,3,9,0.333,0,5,0.0,0,0,0.0,0,0,0,1,1,0,1,2,6,-8,1,Malaki Branham,SAS,GSW,SAS,,,7,6,7,1
22023,1631103,22300235,"NOV 22, 2023",SAS vs. LAC,L,21,0,6,0.0,0,3,0.0,0,0,0.0,1,0,1,1,0,0,0,0,0,-4,1,Malaki Branham,SAS,SAS,LAC,,,2,1,1,2
22023,1631103,22300223,"NOV 20, 2023",SAS vs. LAC,L,21,4,6,0.667,2,3,0.667,0,0,0.0,0,0,0,1,0,0,2,2,10,-19,1,Malaki Branham,SAS,SAS,LAC,,,11,10,11,1
22023,1631103,22300206,"NOV 18, 2023",SAS vs. MEM,L,18,2,6,0.333,0,3,0.0,0,0,0.0,0,1,1,3,0,0,2,2,4,2,1,Malaki Branham,SAS,SAS,MEM,,,8,5,7,4
22023,1631103,22300032,"NOV 17, 2023",SAS vs. SAC,L,28,4,10,0.4,0,3,0.0,2,2,1.0,0,0,0,5,0,0,0,1,10,-18,1,Malaki Branham,SAS,SAS,SAC,,,15,10,15,5
22023,1631103,22300021,"NOV 14, 2023",SAS @ OKC,L,26,5,13,0.385,0,4,0.0,1,2,0.5,1,1,2,0,1,0,3,2,11,-23,1,Malaki Branham,SAS,OKC,SAS,,,13,13,11,2
22023,1631103,22300184,"NOV 12, 2023",SAS vs. MIA,L,20,4,7,0.571,4,5,0.8,1,1,1.0,0,1,1,7,0,0,1,2,13,0,1,Malaki Branham,SAS,SAS,MIA,,,21,14,20,8
22023,1631103,22300013,"NOV 10, 2023",SAS vs. MIN,L,16,3,11,0.273,0,4,0.0,0,0,0.0,0,2,2,1,2,0,0,0,6,-13,1,Malaki Branham,SAS,SAS,MIN,,,9,8,7,3
22023,1631103,22300161,"NOV 08, 2023",SAS @ NYK,L,24,6,9,0.667,2,2,1.0,0,0,0.0,0,0,0,1,0,0,1,2,14,-9,1,Malaki Branham,SAS,NYK,SAS,,,15,14,15,1
22023,1631103,22300146,"NOV 06, 2023",SAS @ IND,L,28,3,6,0.5,0,2,0.0,2,2,1.0,0,0,0,2,0,0,0,0,8,-28,1,Malaki Branham,SAS,IND,SAS,,,10,8,10,2
22023,1631103,22300141,"NOV 05, 2023",SAS vs. TOR,L,25,8,9,0.889,0,0,0.0,0,0,0.0,1,5,6,2,0,0,1,4,16,2,1,Malaki Branham,SAS,SAS,TOR,,,24,22,18,8
22023,1631103,22300131,"NOV 02, 2023",SAS @ PHX,W,20,1,7,0.143,1,6,0.167,0,0,0.0,0,1,1,3,0,1,0,1,3,5,1,Malaki Branham,SAS,PHX,SAS,,,7,4,6,4
22023,1631103,22300113,"OCT 31, 2023",SAS @ PHX,W,9,1,7,0.143,1,4,0.25,0,0,0.0,0,0,0,0,1,0,1,0,3,2,1,Malaki Branham,SAS,PHX,SAS,,,3,3,3,0
22023,1631103,22300099,"OCT 29, 2023",SAS @ LAC,L,21,3,12,0.25,2,4,0.5,1,1,1.0,0,1,1,2,1,0,2,1,9,-10,1,Malaki Branham,SAS,LAC,SAS,,,12,10,11,3
22023,1631103,22300083,"OCT 27, 2023",SAS vs. HOU,W,14,4,7,0.571,1,1,1.0,0,0,0.0,0,2,2,4,0,0,1,0,9,7,1,Malaki Branham,SAS,SAS,HOU,,,15,11,13,6
22023,1631103,22300073,"OCT 25, 2023",SAS vs. DAL,L,18,3,7,0.429,0,3,0.0,1,1,1.0,0,2,2,2,1,0,1,1,7,-2,1,Malaki Branham,SAS,SAS,DAL,,,11,9,9,4
22023,1631128,22300550,"JAN 14, 2024",DEN vs. IND,W,15,1,5,0.2,0,1,0.0,0,2,0.0,0,2,2,0,0,0,0,1,2,-5,1,Christian Braun,DEN,DEN,IND,0.5,Blks+Stls,4,4,2,2
22023,1631128,22300550,"JAN 14, 2024",DEN vs. IND,W,15,1,5,0.2,0,1,0.0,0,2,0.0,0,2,2,0,0,0,0,1,2,-5,1,Christian Braun,DEN,DEN,IND,0.5,Turnovers,4,4,2,2
22023,1631128,22300539,"JAN 12, 2024",DEN vs. NOP,W,17,1,4,0.25,1,4,0.25,1,2,0.5,1,5,6,0,0,0,3,2,4,7,1,Christian Braun,DEN,DEN,NOP,0.5,Blks+Stls,10,10,4,6
22023,1631128,22300539,"JAN 12, 2024",DEN vs. NOP,W,17,1,4,0.25,1,4,0.25,1,2,0.5,1,5,6,0,0,0,3,2,4,7,1,Christian Braun,DEN,DEN,NOP,0.5,Turnovers,10,10,4,6
22023,1631128,22300524,"JAN 10, 2024",DEN @ UTA,L,17,2,4,0.5,1,2,0.5,0,0,0.0,0,3,3,1,1,0,1,1,5,-5,1,Christian Braun,DEN,UTA,DEN,0.5,Blks+Stls,9,8,6,4
22023,1631128,22300524,"JAN 10, 2024",DEN @ UTA,L,17,2,4,0.5,1,2,0.5,0,0,0.0,0,3,3,1,1,0,1,1,5,-5,1,Christian Braun,DEN,UTA,DEN,0.5,Turnovers,9,8,6,4
22023,1631128,22300502,"JAN 07, 2024",DEN vs. DET,W,21,3,5,0.6,0,1,0.0,1,2,0.5,0,3,3,1,0,1,0,0,7,6,1,Christian Braun,DEN,DEN,DET,0.5,Blks+Stls,11,10,8,4
22023,1631128,22300502,"JAN 07, 2024",DEN vs. DET,W,21,3,5,0.6,0,1,0.0,1,2,0.5,0,3,3,1,0,1,0,0,7,6,1,Christian Braun,DEN,DEN,DET,0.5,Turnovers,11,10,8,4
22023,1631128,22300488,"JAN 05, 2024",DEN vs. ORL,L,16,2,4,0.5,1,3,0.333,1,2,0.5,1,3,4,0,0,0,1,0,6,-2,1,Christian Braun,DEN,DEN,ORL,0.5,Blks+Stls,10,10,6,4
22023,1631128,22300488,"JAN 05, 2024",DEN vs. ORL,L,16,2,4,0.5,1,3,0.333,1,2,0.5,1,3,4,0,0,0,1,0,6,-2,1,Christian Braun,DEN,DEN,ORL,0.5,Turnovers,10,10,6,4
22023,1631128,22300478,"JAN 04, 2024",DEN @ GSW,W,18,1,4,0.25,0,2,0.0,0,0,0.0,0,0,0,1,1,1,1,3,2,-5,1,Christian Braun,DEN,GSW,DEN,0.5,Blks+Stls,3,2,3,1
22023,1631128,22300478,"JAN 04, 2024",DEN @ GSW,W,18,1,4,0.25,0,2,0.0,0,0,0.0,0,0,0,1,1,1,1,3,2,-5,1,Christian Braun,DEN,GSW,DEN,0.5,Turnovers,3,2,3,1
22023,1631128,22300455,"JAN 01, 2024",DEN vs. CHA,W,24,3,6,0.5,1,3,0.333,2,3,0.667,1,3,4,2,1,2,1,1,9,-11,1,Christian Braun,DEN,DEN,CHA,0.5,Blks+Stls,15,13,11,6
22023,1631128,22300455,"JAN 01, 2024",DEN vs. CHA,W,24,3,6,0.5,1,3,0.333,2,3,0.667,1,3,4,2,1,2,1,1,9,-11,1,Christian Braun,DEN,DEN,CHA,0.5,Turnovers,15,13,11,6
22023,1631128,22300435,"DEC 29, 2023",DEN vs. OKC,L,17,0,3,0.0,0,2,0.0,4,4,1.0,0,3,3,1,0,0,1,1,4,-6,1,Christian Braun,DEN,DEN,OKC,0.5,Blks+Stls,8,7,5,4
22023,1631128,22300435,"DEC 29, 2023",DEN vs. OKC,L,17,0,3,0.0,0,2,0.0,4,4,1.0,0,3,3,1,0,0,1,1,4,-6,1,Christian Braun,DEN,DEN,OKC,0.5,Turnovers,8,7,5,4
22023,1631128,22300425,"DEC 28, 2023",DEN vs. MEM,W,23,4,8,0.5,1,2,0.5,2,4,0.5,0,3,3,4,1,0,0,0,11,13,1,Christian Braun,DEN,DEN,MEM,0.5,Blks+Stls,18,14,15,7
22023,1631128,22300425,"DEC 28, 2023",DEN vs. MEM,W,23,4,8,0.5,1,2,0.5,2,4,0.5,0,3,3,4,1,0,0,0,11,13,1,Christian Braun,DEN,DEN,MEM,0.5,Turnovers,18,14,15,7
22023,1631128,22300402,"DEC 25, 2023",DEN vs. GSW,W,11,2,4,0.5,2,2,1.0,0,2,0.0,0,0,0,1,0,0,1,3,6,-22,1,Christian Braun,DEN,DEN,GSW,0.5,Blks+Stls,7,6,7,1
22023,1631128,22300402,"DEC 25, 2023",DEN vs. GSW,W,11,2,4,0.5,2,2,1.0,0,2,0.0,0,0,0,1,0,0,1,3,6,-22,1,Christian Braun,DEN,DEN,GSW,0.5,Turnovers,7,6,7,1
22023,1631128,22300390,"DEC 23, 2023",DEN @ CHA,W,18,3,7,0.429,2,3,0.667,3,3,1.0,2,5,7,1,0,2,1,1,11,-8,1,Christian Braun,DEN,CHA,DEN,0.5,Blks+Stls,19,18,12,8
22023,1631128,22300390,"DEC 23, 2023",DEN @ CHA,W,18,3,7,0.429,2,3,0.667,3,3,1.0,2,5,7,1,0,2,1,1,11,-8,1,Christian Braun,DEN,CHA,DEN,0.5,Turnovers,19,18,12,8
22023,1631128,22300383,"DEC 22, 2023",DEN @ BKN,W,16,0,3,0.0,0,1,0.0,2,2,1.0,0,0,0,1,0,0,0,1,2,-12,1,Christian Braun,DEN,BKN,DEN,0.5,Blks+Stls,3,2,3,1
22023,1631128,22300383,"DEC 22, 2023",DEN @ BKN,W,16,0,3,0.0,0,1,0.0,2,2,1.0,0,0,0,1,0,0,0,1,2,-12,1,Christian Braun,DEN,BKN,DEN,0.5,Turnovers,3,2,3,1
22023,1631128,22300369,"DEC 20, 2023",DEN @ TOR,W,17,1,4,0.25,1,2,0.5,0,0,0.0,1,2,3,2,1,0,0,0,3,-6,1,Christian Braun,DEN,TOR,DEN,0.5,Blks+Stls,8,6,5,5
22023,1631128,22300369,"DEC 20, 2023",DEN @ TOR,W,17,1,4,0.25,1,2,0.5,0,0,0.0,1,2,3,2,1,0,0,0,3,-6,1,Christian Braun,DEN,TOR,DEN,0.5,Turnovers,8,6,5,5
22023,1631128,22300356,"DEC 18, 2023",DEN vs. DAL,W,20,2,4,0.5,0,1,0.0,2,3,0.667,0,4,4,1,0,0,1,4,6,19,1,Christian Braun,DEN,DEN,DAL,0.5,Blks+Stls,11,10,7,5
22023,1631128,22300356,"DEC 18, 2023",DEN vs. DAL,W,20,2,4,0.5,0,1,0.0,2,3,0.667,0,4,4,1,0,0,1,4,6,19,1,Christian Braun,DEN,DEN,DAL,0.5,Turnovers,11,10,7,5
22023,1631128,22300340,"DEC 16, 2023",DEN vs. OKC,L,25,5,10,0.5,2,5,0.4,2,2,1.0,0,2,2,1,1,0,1,3,14,1,1,Christian Braun,DEN,DEN,OKC,0.5,Blks+Stls,17,16,15,3
22023,1631128,22300340,"DEC 16, 2023",DEN vs. OKC,L,25,5,10,0.5,2,5,0.4,2,2,1.0,0,2,2,1,1,0,1,3,14,1,1,Christian Braun,DEN,DEN,OKC,0.5,Turnovers,17,16,15,3
22023,1631128,22300322,"DEC 14, 2023",DEN vs. BKN,W,24,4,10,0.4,1,3,0.333,1,1,1.0,1,3,4,2,0,2,1,0,10,7,1,Christian Braun,DEN,DEN,BKN,0.5,Blks+Stls,16,14,12,6
22023,1631128,22300322,"DEC 14, 2023",DEN vs. BKN,W,24,4,10,0.4,1,3,0.333,1,1,1.0,1,3,4,2,0,2,1,0,10,7,1,Christian Braun,DEN,DEN,BKN,0.5,Turnovers,16,14,12,6
22023,1631128,22300307,"DEC 12, 2023",DEN @ CHI,W,23,4,6,0.667,2,4,0.5,3,4,0.75,1,1,2,2,0,1,3,1,13,-16,1,Christian Braun,DEN,CHI,DEN,0.5,Blks+Stls,17,15,15,4
22023,1631128,22300307,"DEC 12, 2023",DEN @ CHI,W,23,4,6,0.667,2,4,0.5,3,4,0.75,1,1,2,2,0,1,3,1,13,-16,1,Christian Braun,DEN,CHI,DEN,0.5,Turnovers,17,15,15,4
22023,1631128,22300296,"DEC 11, 2023",DEN @ ATL,W,11,2,3,0.667,0,0,0.0,2,2,1.0,0,2,2,1,0,0,0,2,6,-2,1,Christian Braun,DEN,ATL,DEN,0.5,Blks+Stls,9,8,7,3
22023,1631128,22300296,"DEC 11, 2023",DEN @ ATL,W,11,2,3,0.667,0,0,0.0,2,2,1.0,0,2,2,1,0,0,0,2,6,-2,1,Christian Braun,DEN,ATL,DEN,0.5,Turnovers,9,8,7,3
22023,1631128,22301224,"DEC 08, 2023",DEN vs. HOU,L,14,1,4,0.25,0,2,0.0,0,0,0.0,0,1,1,1,2,0,1,3,2,-9,1,Christian Braun,DEN,DEN,HOU,0.5,Blks+Stls,4,3,3,2
22023,1631128,22301224,"DEC 08, 2023",DEN vs. HOU,L,14,1,4,0.25,0,2,0.0,0,0,0.0,0,1,1,1,2,0,1,3,2,-9,1,Christian Braun,DEN,DEN,HOU,0.5,Turnovers,4,3,3,2
22023,1631128,22301215,"DEC 06, 2023",DEN @ LAC,L,16,4,6,0.667,0,1,0.0,0,0,0.0,1,4,5,0,0,1,0,3,8,-17,1,Christian Braun,DEN,LAC,DEN,0.5,Blks+Stls,13,13,8,5
22023,1631128,22301215,"DEC 06, 2023",DEN @ LAC,L,16,4,6,0.667,0,1,0.0,0,0,0.0,1,4,5,0,0,1,0,3,8,-17,1,Christian Braun,DEN,LAC,DEN,0.5,Turnovers,13,13,8,5
22023,1631128,22300290,"DEC 02, 2023",DEN @ SAC,L,17,5,10,0.5,1,2,0.5,0,0,0.0,0,3,3,2,1,1,1,1,11,0,1,Christian Braun,DEN,SAC,DEN,0.5,Blks+Stls,16,14,13,5
22023,1631128,22300290,"DEC 02, 2023",DEN @ SAC,L,17,5,10,0.5,1,2,0.5,0,0,0.0,0,3,3,2,1,1,1,1,11,0,1,Christian Braun,DEN,SAC,DEN,0.5,Turnovers,16,14,13,5
22023,1631128,22300279,"DEC 01, 2023",DEN @ PHX,W,22,4,6,0.667,0,0,0.0,0,0,0.0,1,3,4,4,1,0,1,0,8,5,1,Christian Braun,DEN,PHX,DEN,0.5,Blks+Stls,16,12,12,8
22023,1631128,22300279,"DEC 01, 2023",DEN @ PHX,W,22,4,6,0.667,0,0,0.0,0,0,0.0,1,3,4,4,1,0,1,0,8,5,1,Christian Braun,DEN,PHX,DEN,0.5,Turnovers,16,12,12,8
22023,1631128,22300263,"NOV 29, 2023",DEN vs. HOU,W,19,4,7,0.571,1,2,0.5,2,2,1.0,1,2,3,1,0,0,2,2,11,0,1,Christian Braun,DEN,DEN,HOU,0.5,Blks+Stls,15,14,12,4
22023,1631128,22300263,"NOV 29, 2023",DEN vs. HOU,W,19,4,7,0.571,1,2,0.5,2,2,1.0,1,2,3,1,0,0,2,2,11,0,1,Christian Braun,DEN,DEN,HOU,0.5,Turnovers,15,14,12,4
22023,1631128,22300257,"NOV 27, 2023",DEN @ LAC,W,12,0,4,0.0,0,1,0.0,0,0,0.0,1,1,2,2,0,0,0,4,0,-19,1,Christian Braun,DEN,LAC,DEN,0.5,Blks+Stls,4,2,2,4
22023,1631128,22300257,"NOV 27, 2023",DEN @ LAC,W,12,0,4,0.0,0,1,0.0,0,0,0.0,1,1,2,2,0,0,0,4,0,-19,1,Christian Braun,DEN,LAC,DEN,0.5,Turnovers,4,2,2,4
22023,1631128,22300252,"NOV 26, 2023",DEN vs. SAS,W,25,1,5,0.2,0,1,0.0,3,4,0.75,1,3,4,4,0,0,0,1,5,0,1,Christian Braun,DEN,DEN,SAS,0.5,Blks+Stls,13,9,9,8
22023,1631128,22300252,"NOV 26, 2023",DEN vs. SAS,W,25,1,5,0.2,0,1,0.0,3,4,0.75,1,3,4,4,0,0,0,1,5,0,1,Christian Braun,DEN,DEN,SAS,0.5,Turnovers,13,9,9,8
22023,1631128,22300048,"NOV 24, 2023",DEN @ HOU,L,26,3,9,0.333,0,0,0.0,1,1,1.0,0,3,3,0,0,0,0,1,7,-2,1,Christian Braun,DEN,HOU,DEN,0.5,Blks+Stls,10,10,7,3
22023,1631128,22300048,"NOV 24, 2023",DEN @ HOU,L,26,3,9,0.333,0,0,0.0,1,1,1.0,0,3,3,0,0,0,0,1,7,-2,1,Christian Braun,DEN,HOU,DEN,0.5,Turnovers,10,10,7,3
22023,1631128,22300226,"NOV 22, 2023",DEN @ ORL,L,21,4,7,0.571,2,2,1.0,3,3,1.0,1,6,7,1,0,0,3,4,13,-13,1,Christian Braun,DEN,ORL,DEN,0.5,Blks+Stls,21,20,14,8
22023,1631128,22300226,"NOV 22, 2023",DEN @ ORL,L,21,4,7,0.571,2,2,1.0,3,3,1.0,1,6,7,1,0,0,3,4,13,-13,1,Christian Braun,DEN,ORL,DEN,0.5,Turnovers,21,20,14,8
22023,1631128,22300218,"NOV 20, 2023",DEN @ DET,W,32,5,10,0.5,2,2,1.0,3,4,0.75,1,5,6,2,1,1,2,2,15,21,1,Christian Braun,DEN,DET,DEN,0.5,Blks+Stls,23,21,17,8
22023,1631128,22300218,"NOV 20, 2023",DEN @ DET,W,32,5,10,0.5,2,2,1.0,3,4,0.75,1,5,6,2,1,1,2,2,15,21,1,Christian Braun,DEN,DET,DEN,0.5,Turnovers,23,21,17,8
22023,1631128,22300210,"NOV 19, 2023",DEN @ CLE,L,25,6,11,0.545,1,1,1.0,0,0,0.0,0,2,2,0,0,0,0,1,13,3,1,Christian Braun,DEN,CLE,DEN,0.5,Blks+Stls,15,15,13,2
22023,1631128,22300210,"NOV 19, 2023",DEN @ CLE,L,25,6,11,0.545,1,1,1.0,0,0,0.0,0,2,2,0,0,0,0,1,13,3,1,Christian Braun,DEN,CLE,DEN,0.5,Turnovers,15,15,13,2
22023,1631128,22300034,"NOV 17, 2023",DEN @ NOP,L,30,11,19,0.579,3,5,0.6,0,1,0.0,2,7,9,3,0,0,0,1,25,3,1,Christian Braun,DEN,NOP,DEN,0.5,Blks+Stls,37,34,28,12
22023,1631128,22300034,"NOV 17, 2023",DEN @ NOP,L,30,11,19,0.579,3,5,0.6,0,1,0.0,2,7,9,3,0,0,0,1,25,3,1,Christian Braun,DEN,NOP,DEN,0.5,Turnovers,37,34,28,12
22023,1631128,22300024,"NOV 14, 2023",DEN vs. LAC,W,20,5,6,0.833,0,0,0.0,0,0,0.0,0,1,1,1,0,0,0,3,10,-3,1,Christian Braun,DEN,DEN,LAC,0.5,Blks+Stls,12,11,11,2
22023,1631128,22300024,"NOV 14, 2023",DEN vs. LAC,W,20,5,6,0.833,0,0,0.0,0,0,0.0,0,1,1,1,0,0,0,3,10,-3,1,Christian Braun,DEN,DEN,LAC,0.5,Turnovers,12,11,11,2
22023,1631128,22300182,"NOV 12, 2023",DEN @ HOU,L,14,0,4,0.0,0,2,0.0,0,0,0.0,1,0,1,0,0,0,1,1,0,-11,1,Christian Braun,DEN,HOU,DEN,0.5,Blks+Stls,1,1,0,1
22023,1631128,22300182,"NOV 12, 2023",DEN @ HOU,L,14,0,4,0.0,0,2,0.0,0,0,0.0,1,0,1,0,0,0,1,1,0,-11,1,Christian Braun,DEN,HOU,DEN,0.5,Turnovers,1,1,0,1
22023,1631128,22300169,"NOV 08, 2023",DEN vs. GSW,W,16,1,3,0.333,1,2,0.5,1,2,0.5,0,2,2,2,0,0,0,1,4,-8,1,Christian Braun,DEN,DEN,GSW,0.5,Blks+Stls,8,6,6,4
22023,1631128,22300169,"NOV 08, 2023",DEN vs. GSW,W,16,1,3,0.333,1,2,0.5,1,2,0.5,0,2,2,2,0,0,0,1,4,-8,1,Christian Braun,DEN,DEN,GSW,0.5,Turnovers,8,6,6,4
22023,1631128,22300156,"NOV 06, 2023",DEN vs. NOP,W,18,1,5,0.2,0,1,0.0,4,6,0.667,0,0,0,1,0,0,0,1,6,4,1,Christian Braun,DEN,DEN,NOP,0.5,Blks+Stls,7,6,7,1
22023,1631128,22300156,"NOV 06, 2023",DEN vs. NOP,W,18,1,5,0.2,0,1,0.0,4,6,0.667,0,0,0,1,0,0,0,1,6,4,1,Christian Braun,DEN,DEN,NOP,0.5,Turnovers,7,6,7,1
22023,1631128,22300139,"NOV 04, 2023",DEN vs. CHI,W,18,4,8,0.5,1,3,0.333,1,2,0.5,1,4,5,4,1,0,0,1,10,-3,1,Christian Braun,DEN,DEN,CHI,0.5,Blks+Stls,19,15,14,9
22023,1631128,22300139,"NOV 04, 2023",DEN vs. CHI,W,18,4,8,0.5,1,3,0.333,1,2,0.5,1,4,5,4,1,0,0,1,10,-3,1,Christian Braun,DEN,DEN,CHI,0.5,Turnovers,19,15,14,9
22023,1631128,22300006,"NOV 03, 2023",DEN vs. DAL,W,15,3,4,0.75,0,0,0.0,3,3,1.0,2,3,5,0,1,0,1,3,9,-5,1,Christian Braun,DEN,DEN,DAL,0.5,Blks+Stls,14,14,9,5
22023,1631128,22300006,"NOV 03, 2023",DEN vs. DAL,W,15,3,4,0.75,0,0,0.0,3,3,1.0,2,3,5,0,1,0,1,3,9,-5,1,Christian Braun,DEN,DEN,DAL,0.5,Turnovers,14,14,9,5
22023,1631128,22300123,"NOV 01, 2023",DEN @ MIN,L,20,4,8,0.5,0,1,0.0,0,0,0.0,3,6,9,2,0,1,1,3,8,-3,1,Christian Braun,DEN,MIN,DEN,0.5,Blks+Stls,19,17,10,11
22023,1631128,22300123,"NOV 01, 2023",DEN @ MIN,L,20,4,8,0.5,0,1,0.0,0,0,0.0,3,6,9,2,0,1,1,3,8,-3,1,Christian Braun,DEN,MIN,DEN,0.5,Turnovers,19,17,10,11
22023,1631128,22300110,"OCT 30, 2023",DEN vs. UTA,W,30,4,8,0.5,1,2,0.5,0,0,0.0,1,7,8,2,1,0,1,0,9,6,1,Christian Braun,DEN,DEN,UTA,0.5,Blks+Stls,19,17,11,10
22023,1631128,22300110,"OCT 30, 2023",DEN vs. UTA,W,30,4,8,0.5,1,2,0.5,0,0,0.0,1,7,8,2,1,0,1,0,9,6,1,Christian Braun,DEN,DEN,UTA,0.5,Turnovers,19,17,11,10
22023,1631128,22300095,"OCT 29, 2023",DEN @ OKC,W,21,4,9,0.444,0,2,0.0,5,5,1.0,1,6,7,7,1,1,0,2,13,25,1,Christian Braun,DEN,OKC,DEN,0.5,Blks+Stls,27,20,20,14
22023,1631128,22300095,"OCT 29, 2023",DEN @ OKC,W,21,4,9,0.444,0,2,0.0,5,5,1.0,1,6,7,7,1,1,0,2,13,25,1,Christian Braun,DEN,OKC,DEN,0.5,Turnovers,27,20,20,14
22023,1631128,22300078,"OCT 27, 2023",DEN @ MEM,W,19,2,6,0.333,1,4,0.25,0,2,0.0,1,3,4,2,1,0,1,1,5,0,1,Christian Braun,DEN,MEM,DEN,0.5,Blks+Stls,11,9,7,6
22023,1631128,22300078,"OCT 27, 2023",DEN @ MEM,W,19,2,6,0.333,1,4,0.25,0,2,0.0,1,3,4,2,1,0,1,1,5,0,1,Christian Braun,DEN,MEM,DEN,0.5,Turnovers,11,9,7,6
22023,1631128,22300061,"OCT 24, 2023",DEN vs. LAL,W,19,2,5,0.4,0,1,0.0,1,2,0.5,1,2,3,2,0,1,1,1,5,5,1,Christian Braun,DEN,DEN,LAL,0.5,Blks+Stls,10,8,7,5
22023,1631128,22300061,"OCT 24, 2023",DEN vs. LAL,W,19,2,5,0.4,0,1,0.0,1,2,0.5,1,2,3,2,0,1,1,1,5,5,1,Christian Braun,DEN,DEN,LAL,0.5,Turnovers,10,8,7,5
22023,1628969,22300562,"JAN 15, 2024",BKN vs. MIA,L,44,10,23,0.435,2,10,0.2,4,4,1.0,2,7,9,6,2,2,1,1,26,-1,1,Mikal Bridges,BKN,BKN,MIA,,,41,35,32,15
22023,1628969,22300527,"JAN 11, 2024",BKN @ CLE,L,39,6,18,0.333,2,6,0.333,12,13,0.923,0,6,6,1,1,0,4,3,26,-6,1,Mikal Bridges,BKN,CLE,BKN,,,33,32,27,7
22023,1628969,22300498,"JAN 07, 2024",BKN vs. POR,L,44,15,26,0.577,4,8,0.5,8,8,1.0,0,4,4,3,0,0,3,0,42,-2,1,Mikal Bridges,BKN,BKN,POR,,,49,46,45,7
22023,1628969,22300481,"JAN 05, 2024",BKN vs. OKC,W,39,5,13,0.385,0,5,0.0,7,8,0.875,1,7,8,3,0,1,4,4,17,5,1,Mikal Bridges,BKN,BKN,OKC,,,28,25,20,11
22023,1628969,22300469,"JAN 03, 2024",BKN @ HOU,L,36,5,18,0.278,3,12,0.25,2,3,0.667,0,4,4,3,1,1,1,1,15,-19,1,Mikal Bridges,BKN,HOU,BKN,,,22,19,18,7
22023,1628969,22300461,"JAN 02, 2024",BKN @ NOP,L,29,4,11,0.364,2,5,0.4,3,3,1.0,2,1,3,2,0,0,4,0,13,-24,1,Mikal Bridges,BKN,NOP,BKN,,,18,16,15,5
22023,1628969,22300447,"DEC 31, 2023",BKN @ OKC,L,37,8,20,0.4,3,10,0.3,3,3,1.0,0,7,7,7,1,0,0,1,22,-8,1,Mikal Bridges,BKN,OKC,BKN,,,36,29,29,14
22023,1628969,22300430,"DEC 29, 2023",BKN @ WAS,L,36,6,14,0.429,2,6,0.333,5,7,0.714,0,5,5,1,1,1,2,2,19,11,1,Mikal Bridges,BKN,WAS,BKN,,,25,24,20,6
22023,1628969,22300417,"DEC 27, 2023",BKN vs. MIL,L,12,3,4,0.75,0,1,0.0,0,0,0.0,0,3,3,1,1,0,1,0,6,-1,1,Mikal Bridges,BKN,BKN,MIL,,,10,9,7,4
22023,1628969,22300406,"DEC 26, 2023",BKN @ DET,W,40,6,14,0.429,0,1,0.0,9,15,0.6,0,4,4,3,0,0,3,2,21,0,1,Mikal Bridges,BKN,DET,BKN,,,28,25,24,7
22023,1628969,22300394,"DEC 23, 2023",BKN vs. DET,W,33,9,17,0.529,1,4,0.25,10,10,1.0,2,4,6,7,1,1,1,2,29,8,1,Mikal Bridges,BKN,BKN,DET,,,42,35,36,13
22023,1628969,22300383,"DEC 22, 2023",BKN vs. DEN,L,29,7,16,0.438,0,3,0.0,0,1,0.0,2,1,3,6,0,0,3,2,14,-13,1,Mikal Bridges,BKN,BKN,DEN,,,23,17,20,9
22023,1628969,22300368,"DEC 20, 2023",BKN vs. NYK,L,33,4,21,0.19,1,8,0.125,6,6,1.0,2,3,5,2,2,0,2,0,15,-17,1,Mikal Bridges,BKN,BKN,NYK,,,22,20,17,7
22023,1628969,22300357,"DEC 18, 2023",BKN @ UTA,L,35,4,16,0.25,3,8,0.375,2,5,0.4,0,1,1,5,0,0,2,3,13,-19,1,Mikal Bridges,BKN,UTA,BKN,,,19,14,18,6
22023,1628969,22300339,"DEC 16, 2023",BKN @ GSW,L,40,6,17,0.353,3,4,0.75,3,3,1.0,1,5,6,2,1,0,2,1,18,-2,1,Mikal Bridges,BKN,GSW,BKN,,,26,24,20,8
22023,1628969,22300322,"DEC 14, 2023",BKN @ DEN,L,25,3,8,0.375,2,6,0.333,1,2,0.5,0,0,0,1,1,0,4,0,9,-13,1,Mikal Bridges,BKN,DEN,BKN,,,10,9,10,1
22023,1628969,22300317,"DEC 13, 2023",BKN @ PHX,W,39,7,19,0.368,3,9,0.333,4,5,0.8,0,3,3,2,1,0,0,3,21,0,1,Mikal Bridges,BKN,PHX,BKN,,,26,24,23,5
22023,1628969,22300303,"DEC 11, 2023",BKN @ SAC,L,37,6,13,0.462,3,5,0.6,7,7,1.0,2,3,5,5,0,0,5,1,22,-13,1,Mikal Bridges,BKN,SAC,BKN,,,32,27,27,10
22023,1628969,22301219,"DEC 08, 2023",BKN vs. WAS,W,30,9,15,0.6,2,3,0.667,1,1,1.0,1,3,4,3,0,2,2,0,21,24,1,Mikal Bridges,BKN,BKN,WAS,,,28,25,24,7
22023,1628969,22301209,"DEC 06, 2023",BKN @ ATL,W,35,12,19,0.632,3,4,0.75,5,5,1.0,0,5,5,6,0,1,1,2,32,1,1,Mikal Bridges,BKN,ATL,BKN,,,43,37,38,11
22023,1628969,22300282,"DEC 02, 2023",BKN vs. ORL,W,35,12,20,0.6,3,6,0.5,15,18,0.833,1,4,5,3,1,3,3,3,42,26,1,Mikal Bridges,BKN,BKN,ORL,,,50,47,45,8
22023,1628969,22300266,"NOV 30, 2023",BKN vs. CHA,L,38,9,22,0.409,2,5,0.4,2,3,0.667,0,9,9,4,2,0,2,1,22,7,1,Mikal Bridges,BKN,BKN,CHA,,,35,31,26,13
22023,1628969,22300054,"NOV 28, 2023",BKN vs. TOR,W,38,9,17,0.529,1,3,0.333,3,3,1.0,1,9,10,5,0,0,5,3,22,15,1,Mikal Bridges,BKN,BKN,TOR,,,37,32,27,15
22023,1628969,22300250,"NOV 26, 2023",BKN vs. CHI,W,36,5,7,0.714,4,6,0.667,1,2,0.5,0,2,2,6,0,0,2,0,15,-7,1,Mikal Bridges,BKN,BKN,CHI,,,23,17,21,8
22023,1628969,22300240,"NOV 25, 2023",BKN vs. MIA,W,33,8,19,0.421,3,6,0.5,5,5,1.0,1,5,6,3,2,1,3,2,24,16,1,Mikal Bridges,BKN,BKN,MIA,,,33,30,27,9
22023,1628969,22300227,"NOV 22, 2023",BKN @ ATL,L,44,16,31,0.516,2,6,0.333,11,12,0.917,3,7,10,4,2,0,1,2,45,-12,1,Mikal Bridges,BKN,ATL,BKN,,,59,55,49,14
22023,1628969,22300208,"NOV 19, 2023",BKN vs. PHI,L,29,8,12,0.667,2,2,1.0,0,0,0.0,0,1,1,3,0,0,2,0,18,-14,1,Mikal Bridges,BKN,BKN,PHI,,,22,19,21,4
22023,1628969,22300200,"NOV 16, 2023",BKN @ MIA,L,35,6,15,0.4,2,6,0.333,9,10,0.9,1,6,7,5,0,0,3,2,23,5,1,Mikal Bridges,BKN,MIA,BKN,,,35,30,28,12
22023,1628969,22300020,"NOV 14, 2023",BKN vs. ORL,W,32,9,17,0.529,3,5,0.6,0,1,0.0,1,4,5,4,4,0,6,2,21,12,1,Mikal Bridges,BKN,BKN,ORL,,,30,26,25,9
22023,1628969,22300178,"NOV 12, 2023",BKN vs. WAS,W,34,11,29,0.379,2,14,0.143,3,5,0.6,4,9,13,2,1,0,4,0,27,17,1,Mikal Bridges,BKN,BKN,WAS,,,42,40,29,15
22023,1628969,22300010,"NOV 10, 2023",BKN @ BOS,L,28,4,11,0.364,1,6,0.167,3,3,1.0,0,5,5,1,0,0,2,2,12,-14,1,Mikal Bridges,BKN,BOS,BKN,,,18,17,13,6
22023,1628969,22300160,"NOV 08, 2023",BKN vs. LAC,W,34,4,11,0.364,1,4,0.25,1,2,0.5,1,7,8,7,2,2,3,1,10,1,1,Mikal Bridges,BKN,BKN,LAC,,,25,18,17,15
22023,1628969,22300149,"NOV 06, 2023",BKN vs. MIL,L,39,12,21,0.571,1,5,0.2,6,7,0.857,1,4,5,4,1,1,1,2,31,7,1,Mikal Bridges,BKN,BKN,MIL,,,40,36,35,9
22023,1628969,22300136,"NOV 04, 2023",BKN vs. BOS,L,38,7,20,0.35,4,11,0.364,1,1,1.0,2,4,6,4,1,1,0,4,19,-9,1,Mikal Bridges,BKN,BKN,BOS,,,29,25,23,10
22023,1628969,22300004,"NOV 03, 2023",BKN @ CHI,W,33,8,17,0.471,3,8,0.375,1,2,0.5,0,2,2,3,0,0,0,0,20,-5,1,Mikal Bridges,BKN,CHI,BKN,,,25,22,23,5
22023,1628969,22300119,"NOV 01, 2023",BKN @ MIA,W,31,7,16,0.438,2,7,0.286,5,5,1.0,2,5,7,5,1,0,2,1,21,-14,1,Mikal Bridges,BKN,MIA,BKN,,,33,28,26,12
22023,1628969,22300101,"OCT 30, 2023",BKN @ CHA,W,38,10,13,0.769,1,3,0.333,3,3,1.0,1,6,7,4,1,1,5,3,24,10,1,Mikal Bridges,BKN,CHA,BKN,,,35,31,28,11
22023,1628969,22300084,"OCT 27, 2023",BKN @ DAL,L,35,6,17,0.353,3,7,0.429,3,3,1.0,1,3,4,3,0,0,1,2,18,-12,1,Mikal Bridges,BKN,DAL,BKN,,,25,22,21,7
22023,1628969,22300067,"OCT 25, 2023",BKN vs. CLE,L,35,6,12,0.5,0,2,0.0,8,9,0.889,2,4,6,4,3,0,3,4,20,-3,1,Mikal Bridges,BKN,BKN,CLE,,,30,26,24,10
22023,1628970,22300551,"JAN 14, 2024",CHA @ MIA,L,38,8,17,0.471,1,7,0.143,3,3,1.0,1,6,7,1,1,0,3,0,20,-16,1,Miles Bridges,CHA,MIA,CHA,,,28,27,21,8
22023,1628970,22300541,"JAN 12, 2024",CHA @ SAS,L,33,4,13,0.308,1,4,0.25,5,5,1.0,1,8,9,0,1,0,1,1,14,-32,1,Miles Bridges,CHA,SAS,CHA,,,23,23,14,9
22023,1628970,22300518,"JAN 10, 2024",CHA vs. SAC,L,34,10,21,0.476,4,8,0.5,0,0,0.0,1,6,7,6,1,0,3,1,24,-7,1,Miles Bridges,CHA,CHA,SAC,,,37,31,30,13
22023,1628970,22300506,"JAN 08, 2024",CHA vs. CHI,L,40,9,18,0.5,4,8,0.5,2,3,0.667,2,6,8,5,1,2,5,3,24,-2,1,Miles Bridges,CHA,CHA,CHI,,,37,32,29,13
22023,1628970,22300484,"JAN 05, 2024",CHA @ CHI,L,42,12,18,0.667,3,7,0.429,1,2,0.5,0,5,5,2,0,0,2,1,28,-9,1,Miles Bridges,CHA,CHI,CHA,,,35,33,30,7
22023,1628970,22300464,"JAN 02, 2024",CHA @ SAC,W,40,9,18,0.5,3,6,0.5,6,6,1.0,0,5,5,3,1,2,3,0,27,9,1,Miles Bridges,CHA,SAC,CHA,,,35,32,30,8
22023,1628970,22300455,"JAN 01, 2024",CHA @ DEN,L,36,10,14,0.714,3,5,0.6,3,5,0.6,0,9,9,5,1,0,2,1,26,-23,1,Miles Bridges,CHA,DEN,CHA,,,40,35,31,14
22023,1628970,22300436,"DEC 29, 2023",CHA @ PHX,L,37,4,16,0.25,1,7,0.143,2,2,1.0,0,7,7,6,1,0,3,2,11,0,1,Miles Bridges,CHA,PHX,CHA,,,24,18,17,13
22023,1628970,22300428,"DEC 28, 2023",CHA @ LAL,L,33,7,20,0.35,4,10,0.4,2,2,1.0,1,4,5,5,0,1,3,3,20,-33,1,Miles Bridges,CHA,LAL,CHA,,,30,25,25,10
22023,1628970,22300414,"DEC 26, 2023",CHA @ LAC,L,38,9,23,0.391,3,10,0.3,0,0,0.0,1,10,11,5,0,2,2,5,21,4,1,Miles Bridges,CHA,LAC,CHA,,,37,32,26,16
22023,1628970,22300390,"DEC 23, 2023",CHA vs. DEN,L,38,8,23,0.348,2,12,0.167,4,4,1.0,2,5,7,2,2,3,1,2,22,-5,1,Miles Bridges,CHA,CHA,DEN,,,31,29,24,9
22023,1628970,22300365,"DEC 20, 2023",CHA @ IND,L,37,8,17,0.471,0,2,0.0,3,4,0.75,1,3,4,3,3,0,0,2,19,-15,1,Miles Bridges,CHA,IND,CHA,,,26,23,22,7
22023,1628970,22300335,"DEC 16, 2023",CHA vs. PHI,L,31,3,14,0.214,1,7,0.143,2,2,1.0,0,10,10,0,0,0,1,1,9,-56,1,Miles Bridges,CHA,CHA,PHI,,,19,19,9,10
22023,1628970,22300326,"DEC 15, 2023",CHA vs. NOP,L,39,10,24,0.417,2,8,0.25,5,6,0.833,2,8,10,2,1,0,3,5,27,-11,1,Miles Bridges,CHA,CHA,NOP,,,39,37,29,12
22023,1628970,22300312,"DEC 13, 2023",CHA @ MIA,L,34,9,19,0.474,1,8,0.125,0,0,0.0,1,4,5,4,2,0,4,2,19,3,1,Miles Bridges,CHA,MIA,CHA,,,28,24,23,9
22023,1628970,22300292,"DEC 11, 2023",CHA vs. MIA,L,34,7,14,0.5,2,6,0.333,2,2,1.0,1,3,4,1,0,0,2,3,18,3,1,Miles Bridges,CHA,CHA,MIA,,,23,22,19,5
22023,1628970,22301216,"DEC 08, 2023",CHA vs. TOR,W,38,8,15,0.533,3,6,0.5,3,3,1.0,0,8,8,3,2,0,1,0,22,2,1,Miles Bridges,CHA,CHA,TOR,,,33,30,25,11
22023,1628970,22301211,"DEC 06, 2023",CHA @ CHI,L,40,7,15,0.467,2,8,0.25,0,0,0.0,2,6,8,2,3,0,1,3,16,-6,1,Miles Bridges,CHA,CHI,CHA,,,26,24,18,10
22023,1628970,22300281,"DEC 02, 2023",CHA vs. MIN,L,36,8,18,0.444,2,5,0.4,4,4,1.0,1,2,3,4,1,0,1,5,22,-7,1,Miles Bridges,CHA,CHA,MIN,,,29,25,26,7
22023,1628970,22300266,"NOV 30, 2023",CHA @ BKN,W,38,9,15,0.6,3,4,0.75,2,2,1.0,1,4,5,2,0,0,0,2,23,4,1,Miles Bridges,CHA,BKN,CHA,,,30,28,25,7
22023,1628970,22300057,"NOV 28, 2023",CHA @ NYK,L,32,5,12,0.417,2,3,0.667,1,2,0.5,0,4,4,2,2,1,2,2,13,-22,1,Miles Bridges,CHA,NYK,CHA,,,19,17,15,6
22023,1628970,22300248,"NOV 26, 2023",CHA @ ORL,L,37,9,17,0.529,1,4,0.25,4,6,0.667,3,7,10,2,1,1,3,2,23,-6,1,Miles Bridges,CHA,ORL,CHA,,,35,33,25,12
22023,1628970,22300225,"NOV 22, 2023",CHA vs. WAS,W,37,11,18,0.611,3,7,0.429,8,10,0.8,2,8,10,0,2,0,3,2,33,-1,1,Miles Bridges,CHA,CHA,WAS,,,43,43,33,10
22023,1628970,22300217,"NOV 20, 2023",CHA vs. BOS,W,45,3,13,0.231,2,7,0.286,6,6,1.0,0,15,15,5,1,0,1,1,14,-6,1,Miles Bridges,CHA,CHA,BOS,,,34,29,19,20
22023,1628970,22300202,"NOV 18, 2023",CHA vs. NYK,L,32,8,12,0.667,1,1,1.0,2,3,0.667,0,4,4,3,1,1,1,2,19,2,1,Miles Bridges,CHA,CHA,NYK,,,26,23,22,7
22023,1628970,22300027,"NOV 17, 2023",CHA vs. MIL,L,33,6,13,0.462,2,5,0.4,3,3,1.0,0,5,5,4,2,0,2,1,17,-10,1,Miles Bridges,CHA,CHA,MIL,,,26,22,21,9
22023,1629052,22300563,"JAN 15, 2024",BOS @ TOR,W,7,2,4,0.5,1,1,1.0,2,2,1.0,2,1,3,0,0,0,0,1,7,5,1,Oshae Brissett,BOS,TOR,BOS,,,10,10,7,3
22023,1629052,22300542,"JAN 13, 2024",BOS vs. HOU,W,9,2,2,1.0,1,1,1.0,0,0,0.0,0,3,3,2,1,0,0,1,5,-1,1,Oshae Brissett,BOS,BOS,HOU,,,10,8,7,5
22023,1629052,22300528,"JAN 11, 2024",BOS @ MIL,L,17,4,8,0.5,0,3,0.0,5,6,0.833,0,2,2,1,0,0,0,0,13,-1,1,Oshae Brissett,BOS,MIL,BOS,,,16,15,14,3
22023,1629052,22300517,"JAN 10, 2024",BOS vs. MIN,W,5,0,0,0.0,0,0,0.0,0,0,0.0,0,2,2,0,0,0,0,1,0,-6,1,Oshae Brissett,BOS,BOS,MIN,,,2,2,0,2
22023,1629052,22300507,"JAN 08, 2024",BOS @ IND,L,16,1,4,0.25,1,4,0.25,3,6,0.5,2,4,6,0,2,0,0,3,6,5,1,Oshae Brissett,BOS,IND,BOS,,,12,12,6,6
22023,1629052,22300493,"JAN 06, 2024",BOS @ IND,W,20,3,9,0.333,1,3,0.333,1,1,1.0,5,3,8,0,0,1,0,3,8,4,1,Oshae Brissett,BOS,IND,BOS,,,16,16,8,8
22023,1629052,22300479,"JAN 05, 2024",BOS vs. UTA,W,17,2,5,0.4,0,2,0.0,2,2,1.0,1,2,3,2,2,0,0,3,6,1,1,Oshae Brissett,BOS,BOS,UTA,,,11,9,8,5
22023,1629052,22300448,"DEC 31, 2023",BOS @ SAS,W,21,2,5,0.4,0,0,0.0,0,1,0.0,3,3,6,0,2,0,0,2,4,9,1,Oshae Brissett,BOS,SAS,BOS,,,10,10,4,6
22023,1629052,22300432,"DEC 29, 2023",BOS vs. TOR,W,15,1,3,0.333,0,1,0.0,0,0,0.0,2,5,7,1,0,0,1,0,2,3,1,Oshae Brissett,BOS,BOS,TOR,,,10,9,3,8
22023,1629052,22300421,"DEC 28, 2023",BOS vs. DET,W,6,0,0,0.0,0,0,0.0,0,0,0.0,1,0,1,0,0,0,0,0,0,9,1,Oshae Brissett,BOS,BOS,DET,,,1,1,0,1
22023,1629052,22300389,"DEC 23, 2023",BOS @ LAC,W,18,4,5,0.8,3,4,0.75,1,2,0.5,1,2,3,1,0,0,0,0,12,12,1,Oshae Brissett,BOS,LAC,BOS,,,16,15,13,4
22023,1629052,22300373,"DEC 20, 2023",BOS @ SAC,W,17,1,1,1.0,1,1,1.0,0,0,0.0,2,3,5,2,0,0,0,0,3,4,1,Oshae Brissett,BOS,SAC,BOS,,,10,8,5,7
22023,1629052,22300362,"DEC 19, 2023",BOS @ GSW,L,5,3,3,1.0,0,0,0.0,0,0,0.0,0,0,0,0,1,0,0,0,6,1,1,Oshae Brissett,BOS,GSW,BOS,,,6,6,6,0
22023,1629052,22300344,"DEC 17, 2023",BOS vs. ORL,W,2,0,0,0.0,0,0,0.0,0,0,0.0,0,2,2,0,0,0,0,0,0,-4,1,Oshae Brissett,BOS,BOS,ORL,,,2,2,0,2
22023,1629052,22300329,"DEC 15, 2023",BOS vs. ORL,W,16,4,4,1.0,1,1,1.0,2,2,1.0,1,0,1,1,0,0,2,4,11,-3,1,Oshae Brissett,BOS,BOS,ORL,,,13,12,12,2
22023,1629052,22301227,"DEC 08, 2023",BOS vs. NYK,W,0,0,0,0.0,0,0,0.0,0,0,0.0,0,0,0,0,0,0,0,0,0,-2,1,Oshae Brissett,BOS,BOS,NYK,,,0,0,0,0
22023,1629052,22300043,"NOV 24, 2023",BOS @ ORL,L,5,0,0,0.0,0,0,0.0,0,2,0.0,0,0,0,0,0,0,0,2,0,-11,1,Oshae Brissett,BOS,ORL,BOS,,,0,0,0,0
22023,1629052,22300217,"NOV 20, 2023",BOS @ CHA,L,17,0,0,0.0,0,0,0.0,1,2,0.5,2,5,7,1,0,0,0,2,1,17,1,Oshae Brissett,BOS,CHA,BOS,,,9,8,2,8
22023,1629052,22300174,"NOV 11, 2023",BOS vs. TOR,W,5,0,0,0.0,0,0,0.0,0,0,0.0,0,0,0,0,0,0,0,0,0,-7,1,Oshae Brissett,BOS,BOS,TOR,,,0,0,0,0
22023,1629052,22300010,"NOV 10, 2023",BOS vs. BKN,W,8,0,3,0.0,0,2,0.0,2,4,0.5,1,2,3,0,1,0,0,2,2,-6,1,Oshae Brissett,BOS,BOS,BKN,,,5,5,2,3
22023,1629052,22300136,"NOV 04, 2023",BOS @ BKN,W,11,1,4,0.25,1,4,0.25,2,2,1.0,1,2,3,1,0,0,0,0,5,-13,1,Oshae Brissett,BOS,BKN,BOS,,,9,8,6,4
22023,1629052,22300118,"NOV 01, 2023",BOS vs. IND,W,20,1,4,0.25,0,1,0.0,2,2,1.0,0,1,1,0,2,0,0,0,4,21,1,Oshae Brissett,BOS,BOS,IND,,,5,5,4,1
22023,1629052,22300103,"OCT 30, 2023",BOS @ WAS,W,10,0,4,0.0,0,2,0.0,0,0,0.0,1,1,2,1,1,0,0,2,0,-10,1,Oshae Brissett,BOS,WAS,BOS,,,3,2,1,3
22023,1629052,22300080,"OCT 27, 2023",BOS vs. MIA,W,14,1,2,0.5,0,0,0.0,0,0,0.0,3,2,5,0,0,0,2,1,2,7,1,Oshae Brissett,BOS,BOS,MIA,,,7,7,2,5
22023,1627763,22300538,"JAN 12, 2024",POR @ MIN,L,26,2,7,0.286,2,5,0.4,3,4,0.75,0,2,2,3,0,0,1,1,9,-9,1,Malcolm Brogdon,POR,MIN,POR,,,14,11,12,5
22023,1627763,22300514,"JAN 09, 2024",POR @ NYK,L,13,1,5,0.2,0,0,0.0,0,0,0.0,0,1,1,0,0,0,1,2,2,-13,1,Malcolm Brogdon,POR,NYK,POR,,,3,3,2,1
22023,1627763,22300498,"JAN 07, 2024",POR @ BKN,W,22,5,8,0.625,4,6,0.667,4,4,1.0,1,2,3,2,0,0,0,0,18,17,1,Malcolm Brogdon,POR,BKN,POR,,,23,21,20,5
22023,1627763,22300487,"JAN 05, 2024",POR @ DAL,L,16,2,8,0.25,0,4,0.0,0,2,0.0,0,3,3,3,1,0,3,0,4,-16,1,Malcolm Brogdon,POR,DAL,POR,,,10,7,7,6
22023,1627763,22300472,"JAN 03, 2024",POR @ DAL,L,17,2,6,0.333,0,3,0.0,1,1,1.0,0,2,2,2,0,0,0,1,5,-12,1,Malcolm Brogdon,POR,DAL,POR,,,9,7,7,4
22023,1627763,22300456,"JAN 01, 2024",POR @ PHX,L,21,3,8,0.375,2,4,0.5,2,2,1.0,0,2,2,5,0,0,2,0,10,-5,1,Malcolm Brogdon,POR,PHX,POR,,,17,12,15,7
22023,1627763,22300437,"DEC 29, 2023",POR vs. SAS,W,37,9,18,0.5,5,7,0.714,4,4,1.0,0,1,1,7,1,0,1,2,27,16,1,Malcolm Brogdon,POR,POR,SAS,,,35,28,34,8
22023,1627763,22300427,"DEC 28, 2023",POR vs. SAS,L,37,10,19,0.526,6,8,0.75,3,5,0.6,1,5,6,6,1,0,1,1,29,-10,1,Malcolm Brogdon,POR,POR,SAS,,,41,35,35,12
22023,1627763,22300413,"DEC 26, 2023",POR vs. SAC,W,30,7,13,0.538,3,8,0.375,2,2,1.0,0,5,5,6,0,0,0,1,19,13,1,Malcolm Brogdon,POR,POR,SAC,,,30,24,25,11
22023,1627763,22300399,"DEC 23, 2023",POR @ GSW,L,37,8,14,0.571,1,4,0.25,0,0,0.0,2,4,6,12,3,1,2,2,17,-4,1,Malcolm Brogdon,POR,GSW,POR,,,35,23,29,18
22023,1627763,22300381,"DEC 21, 2023",POR vs. WAS,L,28,3,8,0.375,1,3,0.333,0,0,0.0,0,2,2,4,1,0,1,3,7,-16,1,Malcolm Brogdon,POR,POR,WAS,,,13,9,11,6
22023,1627763,22300363,"DEC 19, 2023",POR vs. PHX,W,32,5,10,0.5,4,9,0.444,0,0,0.0,0,4,4,4,0,0,1,0,14,9,1,Malcolm Brogdon,POR,POR,PHX,,,22,18,18,8
22023,1627763,22300348,"DEC 17, 2023",POR vs. GSW,L,27,3,8,0.375,2,5,0.4,0,0,0.0,0,1,1,5,0,0,0,1,8,-2,1,Malcolm Brogdon,POR,POR,GSW,,,14,9,13,6
22023,1627763,22300341,"DEC 16, 2023",POR vs. DAL,L,24,4,7,0.571,1,4,0.25,0,0,0.0,0,2,2,2,1,0,1,4,9,-23,1,Malcolm Brogdon,POR,POR,DAL,,,13,11,11,4
22023,1627763,22300323,"DEC 14, 2023",POR vs. UTA,L,14,3,6,0.5,3,6,0.5,0,2,0.0,0,0,0,1,0,0,0,0,9,-8,1,Malcolm Brogdon,POR,POR,UTA,,,10,9,10,1
22023,1627763,22301214,"DEC 06, 2023",POR @ GSW,L,13,0,3,0.0,0,1,0.0,0,0,0.0,0,1,1,2,0,0,1,1,0,5,1,Malcolm Brogdon,POR,GSW,POR,,,3,1,2,3
22023,1627763,22300289,"DEC 02, 2023",POR @ UTA,L,38,8,17,0.471,5,9,0.556,4,6,0.667,1,2,3,6,2,1,3,0,25,-2,1,Malcolm Brogdon,POR,UTA,POR,,,34,28,31,9
22023,1627763,22300265,"NOV 30, 2023",POR @ CLE,W,31,3,7,0.429,1,3,0.333,4,4,1.0,2,1,3,7,2,1,5,0,11,-9,1,Malcolm Brogdon,POR,CLE,POR,,,21,14,18,10
22023,1627763,22300254,"NOV 27, 2023",POR @ IND,W,36,9,20,0.45,1,3,0.333,5,6,0.833,0,2,2,7,0,0,1,1,24,-6,1,Malcolm Brogdon,POR,IND,POR,,,33,26,31,9
22023,1627763,22300245,"NOV 26, 2023",POR @ MIL,L,34,7,23,0.304,2,6,0.333,2,3,0.667,2,6,8,12,2,1,2,4,18,-6,1,Malcolm Brogdon,POR,MIL,POR,,,38,26,30,20
22023,1627763,22300237,"NOV 22, 2023",POR vs. UTA,W,24,9,16,0.563,1,5,0.2,1,1,1.0,1,3,4,8,1,0,0,0,20,12,1,Malcolm Brogdon,POR,POR,UTA,,,32,24,28,12
22023,1627763,22300041,"NOV 21, 2023",POR @ PHX,L,25,6,14,0.429,4,5,0.8,3,4,0.75,1,0,1,5,0,0,2,2,19,-3,1,Malcolm Brogdon,POR,PHX,POR,,,25,20,24,6
22023,1627763,22300170,"NOV 08, 2023",POR @ SAC,L,5,2,3,0.667,1,2,0.5,0,0,0.0,0,1,1,1,0,0,0,1,5,1,1,Malcolm Brogdon,POR,SAC,POR,,,7,6,6,2
22023,1627763,22300144,"NOV 05, 2023",POR vs. MEM,L,39,6,20,0.3,2,8,0.25,4,4,1.0,3,4,7,11,1,0,1,2,18,-17,1,Malcolm Brogdon,POR,POR,MEM,,,36,25,29,18
22023,1627763,22300007,"NOV 03, 2023",POR vs. MEM,W,44,6,19,0.316,2,9,0.222,10,12,0.833,0,7,7,10,3,0,4,1,24,14,1,Malcolm Brogdon,POR,POR,MEM,,,41,31,34,17
22023,1627763,22300115,"NOV 01, 2023",POR @ DET,W,25,5,11,0.455,1,4,0.25,3,4,0.75,1,5,6,6,1,0,2,1,14,17,1,Malcolm Brogdon,POR,DET,POR,,,26,20,20,12
22023,1627763,22300105,"OCT 30, 2023",POR @ TOR,W,29,9,21,0.429,3,7,0.429,0,1,0.0,1,2,3,5,0,0,1,2,21,9,1,Malcolm Brogdon,POR,TOR,POR,,,29,24,26,8
22023,1627763,22300098,"OCT 29, 2023",POR @ PHI,L,26,7,16,0.438,2,6,0.333,2,2,1.0,1,4,5,5,1,0,2,2,18,-6,1,Malcolm Brogdon,POR,PHI,POR,,,28,23,23,10
22023,1627763,22300086,"OCT 27, 2023",POR vs. ORL,L,31,6,15,0.4,2,6,0.333,4,6,0.667,2,5,7,1,0,0,2,2,18,-4,1,Malcolm Brogdon,POR,POR,ORL,,,26,25,19,8
22023,1627763,22300074,"OCT 25, 2023",POR @ LAC,L,23,8,16,0.5,3,5,0.6,1,1,1.0,0,2,2,5,0,0,1,0,20,-5,1,Malcolm Brogdon,POR,LAC,POR,,,27,22,25,7
22023,1629717,22300469,"JAN 03, 2024",BKN @ HOU,L,3,0,0,0.0,0,0,0.0,0,0,0.0,0,1,1,0,0,0,0,0,0,4,1,Armoni Brooks,BKN,HOU,BKN,,,1,1,0,1
22023,1629717,22300461,"JAN 02, 2024",BKN @ NOP,L,8,2,5,0.4,1,4,0.25,0,0,0.0,1,0,1,0,0,0,0,1,5,0,1,Armoni Brooks,BKN,NOP,BKN,,,6,6,5,1
22023,1629717,22300417,"DEC 27, 2023",BKN vs. MIL,L,29,4,14,0.286,3,9,0.333,1,2,0.5,2,2,4,2,1,0,2,1,12,-12,1,Armoni Brooks,BKN,BKN,MIL,,,18,16,14,6
22023,1629717,22300322,"DEC 14, 2023",BKN @ DEN,L,15,2,9,0.222,2,6,0.333,0,0,0.0,2,0,2,2,0,1,0,0,6,1,1,Armoni Brooks,BKN,DEN,BKN,,,10,8,8,4
22023,1629717,22300303,"DEC 11, 2023",BKN @ SAC,L,4,1,1,1.0,0,0,0.0,0,0,0.0,0,0,0,1,0,0,0,0,2,4,1,Armoni Brooks,BKN,SAC,BKN,,,3,2,3,1
22023,1629717,22300250,"NOV 26, 2023",BKN vs. CHI,W,4,0,2,0.0,0,2,0.0,0,0,0.0,0,1,1,0,0,0,0,1,0,-2,1,Armoni Brooks,BKN,BKN,CHI,,,1,1,0,1
22023,1629717,22300240,"NOV 25, 2023",BKN vs. MIA,W,4,0,3,0.0,0,2,0.0,0,0,0.0,1,2,3,0,0,0,0,0,0,-3,1,Armoni Brooks,BKN,BKN,MIA,,,3,3,0,3
22023,1629717,22300010,"NOV 10, 2023",BKN @ BOS,L,19,0,5,0.0,0,3,0.0,0,0,0.0,1,3,4,0,0,0,1,0,0,4,1,Armoni Brooks,BKN,BOS,BKN,,,4,4,0,4
22023,1629717,22300136,"NOV 04, 2023",BKN vs. BOS,L,1,0,0,0.0,0,0,0.0,0,0,0.0,0,0,0,0,0,0,0,0,0,2,1,Armoni Brooks,BKN,BKN,BOS,,,0,0,0,0
22023,1629717,22300119,"NOV 01, 2023",BKN @ MIA,W,16,6,7,0.857,5,6,0.833,0,0,0.0,0,2,2,0,0,0,0,0,17,30,1,Armoni Brooks,BKN,MIA,BKN,,,19,19,17,2
22023,1628415,22300555,"JAN 15, 2024",HOU @ PHI,L,31,7,9,0.778,2,3,0.667,2,4,0.5,2,4,6,0,2,0,0,2,18,-6,1,Dillon Brooks,HOU,PHI,HOU,,,24,24,18,6
22023,1628415,22300542,"JAN 13, 2024",HOU @ BOS,L,25,3,8,0.375,0,1,0.0,6,6,1.0,1,0,1,0,1,0,0,4,12,-20,1,Dillon Brooks,HOU,BOS,HOU,,,13,13,12,1
22023,1628415,22300409,"DEC 26, 2023",HOU vs. IND,L,22,4,9,0.444,0,1,0.0,1,1,1.0,1,0,1,1,1,0,0,0,9,-15,1,Dillon Brooks,HOU,HOU,IND,,,11,10,10,2
22023,1628415,22300392,"DEC 23, 2023",HOU @ NOP,W,28,2,7,0.286,1,4,0.25,0,0,0.0,0,5,5,5,1,0,1,3,5,6,1,Dillon Brooks,HOU,NOP,HOU,,,15,10,10,10
22023,1628415,22300385,"DEC 22, 2023",HOU vs. DAL,W,22,4,9,0.444,2,5,0.4,0,0,0.0,0,3,3,1,0,0,2,2,10,35,1,Dillon Brooks,HOU,HOU,DAL,,,14,13,11,4
22023,1628415,22300371,"DEC 20, 2023",HOU vs. ATL,L,30,7,9,0.778,5,6,0.833,0,0,0.0,0,2,2,1,2,0,0,5,19,1,1,Dillon Brooks,HOU,HOU,ATL,,,22,21,20,3
22023,1628415,22300349,"DEC 18, 2023",HOU @ CLE,L,38,6,12,0.5,3,7,0.429,1,2,0.5,1,2,3,2,0,0,0,3,16,0,1,Dillon Brooks,HOU,CLE,HOU,,,21,19,18,5
22023,1628415,22300346,"DEC 17, 2023",HOU @ MIL,L,35,7,12,0.583,2,4,0.5,2,2,1.0,1,3,4,1,2,0,2,4,18,-15,1,Dillon Brooks,HOU,MIL,HOU,,,23,22,19,5
22023,1628415,22300332,"DEC 15, 2023",HOU @ MEM,W,40,10,20,0.5,3,9,0.333,3,4,0.75,1,6,7,1,1,0,2,3,26,3,1,Dillon Brooks,HOU,MEM,HOU,,,34,33,27,8
22023,1628415,22300314,"DEC 13, 2023",HOU vs. MEM,W,28,4,8,0.5,1,3,0.333,2,2,1.0,0,2,2,1,0,0,4,6,11,12,1,Dillon Brooks,HOU,HOU,MEM,,,14,13,12,3
22023,1628415,22300298,"DEC 11, 2023",HOU vs. SAS,W,30,1,12,0.083,0,6,0.0,0,0,0.0,1,4,5,2,0,0,2,3,2,7,1,Dillon Brooks,HOU,HOU,SAS,,,9,7,4,7
22023,1628415,22301224,"DEC 08, 2023",HOU @ DEN,W,33,6,12,0.5,4,10,0.4,0,0,0.0,1,4,5,1,2,0,3,5,16,2,1,Dillon Brooks,HOU,DEN,HOU,,,22,21,17,6
22023,1628415,22301212,"DEC 06, 2023",HOU vs. OKC,W,40,9,17,0.529,2,7,0.286,3,3,1.0,2,2,4,2,1,0,3,2,23,3,1,Dillon Brooks,HOU,HOU,OKC,,,29,27,25,6
22023,1628415,22300291,"DEC 02, 2023",HOU @ LAL,L,33,4,9,0.444,2,4,0.5,0,0,0.0,1,1,2,1,0,0,1,4,10,-14,1,Dillon Brooks,HOU,LAL,HOU,,,13,12,11,3
22023,1628415,22300263,"NOV 29, 2023",HOU @ DEN,L,23,4,7,0.571,1,4,0.25,2,3,0.667,1,0,1,2,0,0,4,4,11,-22,1,Dillon Brooks,HOU,DEN,HOU,,,14,12,13,3
22023,1628415,22300059,"NOV 28, 2023",HOU @ DAL,L,28,7,13,0.538,1,4,0.25,1,2,0.5,0,1,1,1,0,0,1,6,16,-12,1,Dillon Brooks,HOU,DAL,HOU,,,18,17,17,2
22023,1628415,22300048,"NOV 24, 2023",HOU vs. DEN,W,30,2,8,0.25,2,3,0.667,2,2,1.0,1,0,1,2,0,0,2,4,8,8,1,Dillon Brooks,HOU,HOU,DEN,,,11,9,10,3
22023,1628415,22300231,"NOV 22, 2023",HOU vs. MEM,W,27,4,14,0.286,0,5,0.0,5,5,1.0,1,4,5,1,1,0,1,4,13,-2,1,Dillon Brooks,HOU,HOU,MEM,,,19,18,14,6
22023,1628415,22300224,"NOV 20, 2023",HOU @ GSW,L,31,6,13,0.462,2,5,0.4,2,2,1.0,2,2,4,2,0,0,1,5,16,3,1,Dillon Brooks,HOU,GSW,HOU,,,22,20,18,6
22023,1628415,22300216,"NOV 19, 2023",HOU @ LAL,L,41,9,21,0.429,6,11,0.545,0,0,0.0,1,0,1,2,4,0,2,5,24,3,1,Dillon Brooks,HOU,LAL,HOU,,,27,25,26,3
22023,1628415,22300037,"NOV 17, 2023",HOU @ LAC,L,31,2,6,0.333,0,2,0.0,0,1,0.0,1,3,4,1,1,0,0,6,4,-16,1,Dillon Brooks,HOU,LAC,HOU,,,9,8,5,5
22023,1628415,22300182,"NOV 12, 2023",HOU vs. DEN,W,29,3,6,0.5,1,3,0.333,3,4,0.75,0,4,4,2,0,0,3,4,10,-9,1,Dillon Brooks,HOU,HOU,DEN,,,16,14,12,6
22023,1628415,22300011,"NOV 10, 2023",HOU vs. NOP,W,21,3,7,0.429,1,1,1.0,3,5,0.6,0,2,2,2,2,1,0,5,10,12,1,Dillon Brooks,HOU,HOU,NOP,,,14,12,12,4
22023,1628415,22300163,"NOV 08, 2023",HOU vs. LAL,W,25,2,6,0.333,1,3,0.333,0,0,0.0,0,4,4,1,0,0,2,4,5,18,1,Dillon Brooks,HOU,HOU,LAL,,,10,9,6,5
22023,1628415,22300153,"NOV 06, 2023",HOU vs. SAC,W,28,3,6,0.5,1,3,0.333,2,2,1.0,0,6,6,1,0,0,1,1,9,34,1,Dillon Brooks,HOU,HOU,SAC,,,16,15,10,7
22023,1628415,22300137,"NOV 04, 2023",HOU vs. SAC,W,38,9,14,0.643,2,4,0.5,6,6,1.0,3,6,9,1,1,0,1,0,26,25,1,Dillon Brooks,HOU,HOU,SAC,,,36,35,27,10
22023,1628415,22300122,"NOV 01, 2023",HOU vs. CHA,W,38,7,9,0.778,3,3,1.0,3,4,0.75,1,2,3,5,5,0,7,4,20,-3,1,Dillon Brooks,HOU,HOU,CHA,,,28,23,25,8
22023,1628415,22300096,"OCT 29, 2023",HOU vs. GSW,L,34,4,10,0.4,2,5,0.4,2,2,1.0,0,4,4,2,0,0,0,5,12,2,1,Dillon Brooks,HOU,HOU,GSW,,,18,16,14,6
22023,1628415,22300083,"OCT 27, 2023",HOU @ SAS,L,39,7,13,0.538,1,2,0.5,2,2,1.0,0,2,2,2,1,0,2,4,17,4,1,Dillon Brooks,HOU,SAS,HOU,,,21,19,19,4
22023,1628415,22300066,"OCT 25, 2023",HOU @ ORL,L,26,5,7,0.714,4,6,0.667,0,0,0.0,0,4,4,2,1,0,2,4,14,-15,1,Dillon Brooks,HOU,ORL,HOU,,,20,18,16,6
22023,1628971,22300550,"JAN 14, 2024",IND @ DEN,L,33,8,16,0.5,1,2,0.5,1,3,0.333,5,5,10,6,3,0,2,3,18,-13,1,Bruce Brown,IND,DEN,IND,,,34,28,24,16
22023,1628971,22300533,"JAN 12, 2024",IND @ ATL,W,21,5,9,0.556,2,3,0.667,0,0,0.0,0,1,1,4,0,0,2,0,12,8,1,Bruce Brown,IND,ATL,IND,,,17,13,16,5
22023,1628971,22300520,"JAN 10, 2024",IND vs. WAS,W,27,5,11,0.455,1,2,0.5,5,5,1.0,0,9,9,6,1,1,0,2,16,-3,1,Bruce Brown,IND,IND,WAS,,,31,25,22,15
22023,1628971,22300507,"JAN 08, 2024",IND vs. BOS,W,21,1,6,0.167,1,1,1.0,4,4,1.0,0,2,2,2,1,0,0,1,7,1,1,Bruce Brown,IND,IND,BOS,,,11,9,9,4
22023,1628971,22300480,"JAN 05, 2024",IND vs. ATL,W,22,8,9,0.889,1,1,1.0,0,0,0.0,0,3,3,2,0,0,2,1,17,25,1,Bruce Brown,IND,IND,ATL,,,22,20,19,5
22023,1628971,22300466,"JAN 03, 2024",IND vs. MIL,W,28,5,7,0.714,0,1,0.0,5,6,0.833,0,5,5,2,0,0,4,6,15,4,1,Bruce Brown,IND,IND,MIL,,,22,20,17,7
22023,1628971,22300377,"DEC 21, 2023",IND @ MEM,L,28,1,4,0.25,0,1,0.0,2,2,1.0,1,3,4,2,0,1,0,4,4,-6,1,Bruce Brown,IND,MEM,IND,,,10,8,6,6
22023,1628971,22300365,"DEC 20, 2023",IND vs. CHA,W,28,3,6,0.5,0,1,0.0,0,0,0.0,0,5,5,6,0,0,0,3,6,34,1,Bruce Brown,IND,IND,CHA,,,17,11,12,11
22023,1628971,22300350,"DEC 18, 2023",IND vs. LAC,L,20,4,11,0.364,0,4,0.0,3,3,1.0,3,1,4,3,1,0,2,4,11,-26,1,Bruce Brown,IND,IND,LAC,,,18,15,14,7
22023,1628971,22300338,"DEC 16, 2023",IND @ MIN,L,27,8,14,0.571,1,3,0.333,0,0,0.0,1,4,5,2,0,1,3,1,17,-20,1,Bruce Brown,IND,MIN,IND,,,24,22,19,7
22023,1628971,22300328,"DEC 15, 2023",IND @ WAS,L,23,2,7,0.286,0,2,0.0,0,0,0.0,0,2,2,1,1,0,1,4,4,-5,1,Bruce Brown,IND,WAS,IND,,,7,6,5,3
22023,1628971,22300315,"DEC 13, 2023",IND @ MIL,L,27,4,10,0.4,0,3,0.0,1,4,0.25,3,5,8,9,2,0,1,2,9,2,1,Bruce Brown,IND,MIL,IND,,,26,17,18,17
22023,1628971,22300293,"DEC 11, 2023",IND @ DET,W,37,4,11,0.364,0,4,0.0,3,4,0.75,3,6,9,0,2,0,1,3,11,8,1,Bruce Brown,IND,DET,IND,,,20,20,11,9
22023,1628971,22301229,"DEC 07, 2023",IND @ MIL,W,28,3,9,0.333,0,1,0.0,4,4,1.0,0,3,3,1,1,0,1,2,10,-5,1,Bruce Brown,IND,MIL,IND,,,14,13,11,4
22023,1628971,22301202,"DEC 04, 2023",IND vs. BOS,W,36,3,10,0.3,1,3,0.333,6,7,0.857,0,8,8,4,3,0,3,4,13,2,1,Bruce Brown,IND,IND,BOS,,,25,21,17,12
22023,1628971,22300284,"DEC 02, 2023",IND @ MIA,W,37,11,16,0.688,4,6,0.667,4,5,0.8,0,4,4,2,0,0,1,0,30,20,1,Bruce Brown,IND,MIA,IND,,,36,34,32,6
22023,1628971,22300267,"NOV 30, 2023",IND @ MIA,L,32,5,9,0.556,0,2,0.0,5,7,0.714,1,5,6,3,0,0,0,1,15,-6,1,Bruce Brown,IND,MIA,IND,,,24,21,18,9
22023,1628971,22300254,"NOV 27, 2023",IND vs. POR,L,33,5,10,0.5,1,5,0.2,0,0,0.0,0,3,3,3,2,0,2,4,11,2,1,Bruce Brown,IND,IND,POR,,,17,14,14,6
22023,1628971,22300047,"NOV 24, 2023",IND vs. DET,W,37,3,10,0.3,0,3,0.0,4,5,0.8,0,4,4,5,3,0,0,3,10,26,1,Bruce Brown,IND,IND,DET,,,19,14,15,9
22023,1628971,22300230,"NOV 22, 2023",IND vs. TOR,L,34,5,9,0.556,1,4,0.25,3,3,1.0,0,4,4,3,2,0,3,4,14,8,1,Bruce Brown,IND,IND,TOR,,,21,18,17,7
22023,1628971,22300039,"NOV 21, 2023",IND @ ATL,W,30,5,10,0.5,2,5,0.4,1,2,0.5,0,0,0,3,2,0,2,4,13,-1,1,Bruce Brown,IND,ATL,IND,,,16,13,16,3
22023,1628971,22300209,"NOV 19, 2023",IND vs. ORL,L,22,4,7,0.571,1,2,0.5,2,2,1.0,0,5,5,1,0,1,1,3,11,-20,1,Bruce Brown,IND,IND,ORL,,,17,16,12,6
22023,1628971,22300019,"NOV 14, 2023",IND @ PHI,W,36,5,11,0.455,0,2,0.0,4,4,1.0,0,5,5,3,1,0,0,4,14,9,1,Bruce Brown,IND,PHI,IND,,,22,19,17,8
22023,1628971,22300180,"NOV 12, 2023",IND @ PHI,L,31,3,5,0.6,0,1,0.0,3,4,0.75,2,2,4,3,0,2,0,1,9,-6,1,Bruce Brown,IND,PHI,IND,,,16,13,12,7
22023,1628971,22300171,"NOV 09, 2023",IND vs. MIL,W,38,3,9,0.333,1,4,0.25,4,4,1.0,2,7,9,7,2,1,2,0,11,15,1,Bruce Brown,IND,IND,MIL,,,27,20,18,16
22023,1628971,22300158,"NOV 08, 2023",IND vs. UTA,W,32,4,11,0.364,1,4,0.25,0,0,0.0,0,4,4,0,2,1,2,2,9,13,1,Bruce Brown,IND,IND,UTA,,,13,13,9,4
22023,1628971,22300146,"NOV 06, 2023",IND vs. SAS,W,24,3,7,0.429,1,3,0.333,0,0,0.0,0,5,5,4,0,0,0,1,7,21,1,Bruce Brown,IND,IND,SAS,,,16,12,11,9
22023,1628971,22300133,"NOV 04, 2023",IND vs. CHA,L,32,3,8,0.375,1,4,0.25,0,0,0.0,0,1,1,6,2,0,0,3,7,7,1,Bruce Brown,IND,IND,CHA,,,14,8,13,7
22023,1628971,22300001,"NOV 03, 2023",IND vs. CLE,W,37,8,15,0.533,3,6,0.5,0,0,0.0,1,6,7,2,0,0,2,2,19,9,1,Bruce Brown,IND,IND,CLE,,,28,26,21,9
22023,1628971,22300118,"NOV 01, 2023",IND @ BOS,L,21,1,6,0.167,0,3,0.0,1,2,0.5,0,1,1,1,1,0,0,1,3,-25,1,Bruce Brown,IND,BOS,IND,,,5,4,4,2
22023,1628971,22300102,"OCT 30, 2023",IND vs. CHI,L,37,6,12,0.5,3,6,0.5,0,0,0.0,2,5,7,1,1,0,3,2,15,-13,1,Bruce Brown,IND,IND,CHI,,,23,22,16,8
22023,1628971,22300091,"OCT 28, 2023",IND @ CLE,W,32,3,8,0.375,0,1,0.0,0,0,0.0,0,4,4,2,1,0,0,3,6,0,1,Bruce Brown,IND,CLE,IND,,,12,10,8,6
22023,1628971,22300064,"OCT 25, 2023",IND vs. WAS,W,27,8,11,0.727,6,8,0.75,2,2,1.0,1,2,3,1,1,0,1,3,24,15,1,Bruce Brown,IND,IND,WAS,,,28,27,25,4
22023,1627759,22300542,"JAN 13, 2024",BOS vs. HOU,W,28,11,15,0.733,4,6,0.667,6,10,0.6,1,5,6,2,2,2,3,5,32,19,1,Jaylen Brown,BOS,BOS,HOU,,,40,38,34,8
22023,1627759,22300528,"JAN 11, 2024",BOS @ MIL,L,18,5,14,0.357,0,1,0.0,0,0,0.0,1,3,4,3,0,0,0,1,10,-17,1,Jaylen Brown,BOS,MIL,BOS,,,17,14,13,7
22023,1627759,22300517,"JAN 10, 2024",BOS vs. MIN,W,43,9,16,0.563,4,7,0.571,13,13,1.0,1,10,11,3,2,1,2,1,35,10,1,Jaylen Brown,BOS,BOS,MIN,,,49,46,38,14
22023,1627759,22300507,"JAN 08, 2024",BOS @ IND,L,38,17,26,0.654,3,4,0.75,3,5,0.6,1,4,5,2,0,0,5,2,40,-1,1,Jaylen Brown,BOS,IND,BOS,,,47,45,42,7
22023,1627759,22300493,"JAN 06, 2024",BOS @ IND,W,36,13,20,0.65,1,4,0.25,4,8,0.5,1,3,4,1,0,1,3,0,31,7,1,Jaylen Brown,BOS,IND,BOS,,,36,35,32,5
22023,1627759,22300479,"JAN 05, 2024",BOS vs. UTA,W,27,5,12,0.417,2,4,0.5,1,2,0.5,0,3,3,5,1,1,3,2,13,18,1,Jaylen Brown,BOS,BOS,UTA,,,21,16,18,8
22023,1627759,22300462,"JAN 02, 2024",BOS @ OKC,L,38,4,18,0.222,0,8,0.0,7,8,0.875,2,4,6,3,0,0,4,5,15,-1,1,Jaylen Brown,BOS,OKC,BOS,,,24,21,18,9
22023,1627759,22300448,"DEC 31, 2023",BOS @ SAS,W,26,9,13,0.692,2,2,1.0,4,6,0.667,1,5,6,3,2,0,2,0,24,26,1,Jaylen Brown,BOS,SAS,BOS,,,33,30,27,9
22023,1627759,22300432,"DEC 29, 2023",BOS vs. TOR,W,41,11,16,0.688,5,6,0.833,4,5,0.8,1,9,10,6,0,0,7,4,31,12,1,Jaylen Brown,BOS,BOS,TOR,,,47,41,37,16
22023,1627759,22300403,"DEC 25, 2023",BOS @ LAL,W,33,7,17,0.412,1,5,0.2,4,7,0.571,3,2,5,2,3,0,2,3,19,9,1,Jaylen Brown,BOS,LAL,BOS,,,26,24,21,7
22023,1627759,22300389,"DEC 23, 2023",BOS @ LAC,W,29,9,17,0.529,3,6,0.5,3,4,0.75,3,3,6,2,1,0,3,2,24,29,1,Jaylen Brown,BOS,LAC,BOS,,,32,30,26,8
22023,1627759,22300373,"DEC 20, 2023",BOS @ SAC,W,29,11,21,0.524,0,3,0.0,6,7,0.857,1,4,5,6,0,0,0,2,28,22,1,Jaylen Brown,BOS,SAC,BOS,,,39,33,34,11
22023,1627759,22300362,"DEC 19, 2023",BOS @ GSW,L,41,10,22,0.455,1,4,0.25,7,8,0.875,3,5,8,7,0,1,4,2,28,-3,1,Jaylen Brown,BOS,GSW,BOS,,,43,36,35,15
22023,1627759,22300344,"DEC 17, 2023",BOS vs. ORL,W,34,12,20,0.6,5,8,0.625,2,2,1.0,1,4,5,6,1,1,2,4,31,11,1,Jaylen Brown,BOS,BOS,ORL,,,42,36,37,11
22023,1627759,22300329,"DEC 15, 2023",BOS vs. ORL,W,30,8,15,0.533,0,5,0.0,2,3,0.667,0,3,3,4,0,1,2,0,18,20,1,Jaylen Brown,BOS,BOS,ORL,,,25,21,22,7
22023,1627759,22300319,"DEC 14, 2023",BOS vs. CLE,W,36,10,20,0.5,2,5,0.4,0,0,0.0,2,3,5,5,2,0,2,3,22,4,1,Jaylen Brown,BOS,BOS,CLE,,,32,27,27,10
22023,1627759,22300305,"DEC 12, 2023",BOS vs. CLE,W,35,10,17,0.588,1,5,0.2,4,4,1.0,1,1,2,4,1,1,3,1,25,-6,1,Jaylen Brown,BOS,BOS,CLE,,,31,27,29,6
22023,1627759,22301227,"DEC 08, 2023",BOS vs. NYK,W,27,7,13,0.538,2,5,0.4,1,1,1.0,0,0,0,4,1,1,2,5,17,17,1,Jaylen Brown,BOS,BOS,NYK,,,21,17,21,4
22023,1627759,22301202,"DEC 04, 2023",BOS @ IND,L,31,14,23,0.609,2,7,0.286,0,1,0.0,2,7,9,0,1,2,3,6,30,-10,1,Jaylen Brown,BOS,IND,BOS,,,39,39,30,9
22023,1627759,22300275,"DEC 01, 2023",BOS vs. PHI,W,35,8,20,0.4,1,4,0.25,3,4,0.75,1,3,4,0,4,2,3,3,20,10,1,Jaylen Brown,BOS,BOS,PHI,,,24,24,20,4
22023,1627759,22300053,"NOV 28, 2023",BOS vs. CHI,W,35,12,23,0.522,3,8,0.375,3,5,0.6,2,6,8,6,0,1,3,1,30,22,1,Jaylen Brown,BOS,BOS,CHI,,,44,38,36,14
22023,1627759,22300246,"NOV 26, 2023",BOS vs. ATL,W,36,9,19,0.474,2,7,0.286,1,2,0.5,1,6,7,3,1,0,2,4,21,5,1,Jaylen Brown,BOS,BOS,ATL,,,31,28,24,10
22023,1627759,22300043,"NOV 24, 2023",BOS @ ORL,L,39,6,22,0.273,2,8,0.25,4,7,0.571,0,3,3,2,3,1,3,3,18,1,1,Jaylen Brown,BOS,ORL,BOS,,,23,21,20,5
22023,1627759,22300228,"NOV 22, 2023",BOS vs. MIL,W,35,10,16,0.625,3,5,0.6,3,3,1.0,0,2,2,8,1,0,1,1,26,-3,1,Jaylen Brown,BOS,BOS,MIL,,,36,28,34,10
22023,1627759,22300217,"NOV 20, 2023",BOS @ CHA,L,34,5,17,0.294,0,5,0.0,3,4,0.75,1,3,4,3,0,0,2,5,13,-23,1,Jaylen Brown,BOS,CHA,BOS,,,20,17,16,7
22023,1627759,22300213,"NOV 19, 2023",BOS @ MEM,W,34,5,16,0.313,1,7,0.143,1,2,0.5,0,6,6,3,2,2,2,4,12,1,1,Jaylen Brown,BOS,MEM,BOS,,,21,18,15,9
22023,1627759,22300031,"NOV 17, 2023",BOS @ TOR,W,36,9,14,0.643,3,5,0.6,2,3,0.667,0,3,3,4,1,1,3,2,23,4,1,Jaylen Brown,BOS,TOR,BOS,,,30,26,27,7
22023,1627759,22300188,"NOV 13, 2023",BOS vs. NYK,W,36,7,18,0.389,2,9,0.222,6,6,1.0,1,4,5,6,1,1,3,3,22,17,1,Jaylen Brown,BOS,BOS,NYK,,,33,27,28,11
22023,1627759,22300174,"NOV 11, 2023",BOS vs. TOR,W,32,12,20,0.6,3,8,0.375,2,3,0.667,1,4,5,2,0,0,2,1,29,9,1,Jaylen Brown,BOS,BOS,TOR,,,36,34,31,7
22023,1627759,22300010,"NOV 10, 2023",BOS vs. BKN,W,29,10,19,0.526,5,9,0.556,3,5,0.6,0,3,3,5,1,0,3,0,28,6,1,Jaylen Brown,BOS,BOS,BKN,,,36,31,33,8
22023,1627759,22300159,"NOV 08, 2023",BOS @ PHI,L,36,4,13,0.308,2,7,0.286,1,2,0.5,0,2,2,2,1,1,4,2,11,-3,1,Jaylen Brown,BOS,PHI,BOS,,,15,13,13,4
22023,1627759,22300154,"NOV 06, 2023",BOS @ MIN,L,39,10,21,0.476,3,8,0.375,3,4,0.75,0,7,7,4,1,0,3,5,26,-16,1,Jaylen Brown,BOS,MIN,BOS,,,37,33,30,11
22023,1627759,22300136,"NOV 04, 2023",BOS @ BKN,W,35,7,22,0.318,2,11,0.182,7,8,0.875,0,5,5,4,0,1,2,4,23,6,1,Jaylen Brown,BOS,BKN,BOS,,,32,28,27,9
22023,1627759,22300118,"NOV 01, 2023",BOS vs. IND,W,25,7,15,0.467,0,1,0.0,2,2,1.0,1,6,7,1,0,0,2,3,16,22,1,Jaylen Brown,BOS,BOS,IND,,,24,23,17,8
22023,1627759,22300103,"OCT 30, 2023",BOS @ WAS,W,32,13,24,0.542,8,13,0.615,2,4,0.5,0,6,6,2,3,1,0,3,36,32,1,Jaylen Brown,BOS,WAS,BOS,,,44,42,38,8
22023,1627759,22300080,"OCT 27, 2023",BOS vs. MIA,W,34,11,22,0.5,3,7,0.429,2,4,0.5,2,4,6,1,2,0,4,1,27,3,1,Jaylen Brown,BOS,BOS,MIA,,,34,33,28,7
22023,1627759,22300065,"OCT 25, 2023",BOS @ NYK,W,38,4,11,0.364,0,4,0.0,3,4,0.75,0,6,6,5,1,0,2,5,11,8,1,Jaylen Brown,BOS,NYK,BOS,,,22,17,16,11
22023,1631112,22300564,"JAN 15, 2024",IND @ UTA,L,12,2,5,0.4,0,1,0.0,4,6,0.667,2,0,2,1,0,0,0,3,8,-1,1,Kendall Brown,IND,UTA,IND,,,11,10,9,3
22023,1631112,22300533,"JAN 12, 2024",IND @ ATL,W,4,0,0,0.0,0,0,0.0,0,0,0.0,0,0,0,0,0,0,0,1,0,-2,1,Kendall Brown,IND,ATL,IND,,,0,0,0,0
22023,1631112,22300493,"JAN 06, 2024",IND vs. BOS,L,1,0,0,0.0,0,0,0.0,0,0,0.0,0,0,0,0,0,0,0,0,0,0,1,Kendall Brown,IND,IND,BOS,,,0,0,0,0
22023,1641738,22300537,"JAN 12, 2024",LAC @ MEM,W,4,0,1,0.0,0,0,0.0,0,0,0.0,0,0,0,1,0,0,0,0,0,-11,1,Kobe Brown,LAC,MEM,LAC,,,1,0,1,1
22023,1641738,22300511,"JAN 08, 2024",LAC vs. PHX,W,5,0,0,0.0,0,0,0.0,0,0,0.0,0,0,0,0,1,0,0,1,0,2,1,Kobe Brown,LAC,LAC,PHX,,,0,0,0,0
22023,1641738,22300486,"JAN 05, 2024",LAC @ NOP,W,6,0,1,0.0,0,1,0.0,0,0,0.0,0,0,0,0,0,0,0,0,0,-12,1,Kobe Brown,LAC,NOP,LAC,,,0,0,0,0
22023,1641738,22300458,"JAN 01, 2024",LAC vs. MIA,W,3,0,0,0.0,0,0,0.0,0,0,0.0,0,0,0,0,0,0,1,0,0,-3,1,Kobe Brown,LAC,LAC,MIA,,,0,0,0,0
22023,1641738,22300438,"DEC 29, 2023",LAC vs. MEM,W,15,3,5,0.6,1,3,0.333,0,0,0.0,0,4,4,0,0,0,0,2,7,1,1,Kobe Brown,LAC,LAC,MEM,,,11,11,7,4
22023,1641738,22300414,"DEC 26, 2023",LAC vs. CHA,W,17,1,4,0.25,0,2,0.0,0,0,0.0,0,0,0,2,2,0,0,0,2,-5,1,Kobe Brown,LAC,LAC,CHA,,,4,2,4,2
22023,1641738,22300389,"DEC 23, 2023",LAC vs. BOS,L,25,2,2,1.0,2,2,1.0,0,0,0.0,0,2,2,4,1,0,0,3,6,-18,1,Kobe Brown,LAC,LAC,BOS,,,12,8,10,6
22023,1641738,22300379,"DEC 21, 2023",LAC @ OKC,L,10,1,3,0.333,0,2,0.0,0,0,0.0,0,0,0,0,0,0,0,1,2,1,1,Kobe Brown,LAC,OKC,LAC,,,2,2,2,0
22023,1641738,22300350,"DEC 18, 2023",LAC @ IND,W,6,0,2,0.0,0,1,0.0,0,0,0.0,0,1,1,1,0,0,1,1,0,-5,1,Kobe Brown,LAC,IND,LAC,,,2,1,1,2
22023,1641738,22300343,"DEC 16, 2023",LAC vs. NYK,W,5,2,3,0.667,2,3,0.667,0,0,0.0,0,0,0,0,0,0,0,0,6,-2,1,Kobe Brown,LAC,LAC,NYK,,,6,6,6,0
22023,1641738,22300325,"DEC 14, 2023",LAC vs. GSW,W,7,1,1,1.0,0,0,0.0,0,0,0.0,0,0,0,0,1,0,0,2,2,14,1,Kobe Brown,LAC,LAC,GSW,,,2,2,2,0
22023,1641738,22300309,"DEC 12, 2023",LAC vs. SAC,W,24,3,5,0.6,1,3,0.333,0,0,0.0,1,5,6,0,0,1,1,5,7,-3,1,Kobe Brown,LAC,LAC,SAC,,,13,13,7,6
22023,1641738,22300304,"DEC 11, 2023",LAC vs. POR,W,5,0,1,0.0,0,1,0.0,0,0,0.0,0,0,0,0,0,0,0,1,0,-5,1,Kobe Brown,LAC,LAC,POR,,,0,0,0,0
22023,1641738,22301225,"DEC 08, 2023",LAC @ UTA,W,14,0,2,0.0,0,0,0.0,1,2,0.5,2,1,3,1,0,1,0,3,1,-7,1,Kobe Brown,LAC,UTA,LAC,,,5,4,2,4
22023,1641738,22301215,"DEC 06, 2023",LAC vs. DEN,W,17,1,4,0.25,1,3,0.333,0,0,0.0,0,4,4,1,0,0,0,4,3,17,1,Kobe Brown,LAC,LAC,DEN,,,8,7,4,5
22023,1641738,22300280,"DEC 02, 2023",LAC vs. GSW,W,11,0,3,0.0,0,3,0.0,0,0,0.0,0,1,1,3,0,0,0,1,0,-6,1,Kobe Brown,LAC,LAC,GSW,,,4,1,3,4
22023,1641738,22300273,"NOV 30, 2023",LAC @ GSW,L,6,0,1,0.0,0,1,0.0,0,0,0.0,0,1,1,0,0,0,0,2,0,-6,1,Kobe Brown,LAC,GSW,LAC,,,1,1,0,1
22023,1641738,22300264,"NOV 29, 2023",LAC @ SAC,W,11,1,2,0.5,1,2,0.5,0,0,0.0,0,2,2,0,0,0,0,3,3,-3,1,Kobe Brown,LAC,SAC,LAC,,,5,5,3,2
22023,1641738,22300244,"NOV 25, 2023",LAC vs. DAL,W,5,0,2,0.0,0,1,0.0,0,0,0.0,1,2,3,0,0,0,0,0,0,-1,1,Kobe Brown,LAC,LAC,DAL,,,3,3,0,3
22023,1641738,22300014,"NOV 10, 2023",LAC @ DAL,L,13,3,4,0.75,1,1,1.0,0,0,0.0,1,0,1,0,0,0,1,2,7,10,1,Kobe Brown,LAC,DAL,LAC,,,8,8,7,1
22023,1641738,22300151,"NOV 06, 2023",LAC @ NYK,L,4,0,1,0.0,0,1,0.0,0,0,0.0,0,0,0,0,0,0,0,0,0,2,1,Kobe Brown,LAC,NYK,LAC,,,0,0,0,0
22023,1641738,22300127,"NOV 01, 2023",LAC @ LAL,L,6,0,1,0.0,0,1,0.0,0,0,0.0,0,0,0,0,0,0,0,0,0,-7,1,Kobe Brown,LAC,LAL,LAC,,,0,0,0,0
22023,1641738,22300114,"OCT 31, 2023",LAC vs. ORL,W,19,3,4,0.75,1,2,0.5,0,0,0.0,1,2,3,1,0,1,0,4,7,11,1,Kobe Brown,LAC,LAC,ORL,,,11,10,8,4
22023,1641738,22300099,"OCT 29, 2023",LAC vs. SAS,W,5,1,2,0.5,1,2,0.5,0,0,0.0,0,4,4,1,1,0,0,1,3,10,1,Kobe Brown,LAC,LAC,SAS,,,8,7,4,5
22023,1641738,22300074,"OCT 25, 2023",LAC vs. POR,W,5,0,2,0.0,0,1,0.0,0,0,0.0,0,0,0,0,0,0,0,1,0,-12,1,Kobe Brown,LAC,LAC,POR,,,0,0,0,0
22023,1629650,22300456,"JAN 01, 2024",POR @ PHX,L,16,1,2,0.5,0,0,0.0,0,0,0.0,0,6,6,1,0,1,2,2,2,-5,1,Moses Brown,POR,PHX,POR,,,9,8,3,7
22023,1629650,22300437,"DEC 29, 2023",POR vs. SAS,W,4,0,0,0.0,0,0,0.0,0,0,0.0,0,4,4,0,0,0,0,1,0,-2,1,Moses Brown,POR,POR,SAS,,,4,4,0,4
22023,1629650,22300427,"DEC 28, 2023",POR vs. SAS,L,14,2,6,0.333,0,0,0.0,0,0,0.0,5,2,7,0,0,0,0,3,4,-8,1,Moses Brown,POR,POR,SAS,,,11,11,4,7
22023,1629650,22300413,"DEC 26, 2023",POR vs. SAC,W,14,0,1,0.0,0,0,0.0,0,2,0.0,5,6,11,0,1,1,1,3,0,-5,1,Moses Brown,POR,POR,SAC,,,11,11,0,11
22023,1629650,22300323,"DEC 14, 2023",POR vs. UTA,L,5,0,0,0.0,0,0,0.0,0,0,0.0,0,1,1,0,0,0,0,0,0,-6,1,Moses Brown,POR,POR,UTA,,,1,1,0,1
22023,1629650,22300304,"DEC 11, 2023",POR @ LAC,L,16,3,7,0.429,0,0,0.0,0,0,0.0,4,8,12,0,0,0,1,1,6,1,1,Moses Brown,POR,LAC,POR,,,18,18,6,12
22023,1629650,22300041,"NOV 21, 2023",POR @ PHX,L,2,0,1,0.0,0,0,0.0,0,0,0.0,1,0,1,0,0,0,0,0,0,3,1,Moses Brown,POR,PHX,POR,,,1,1,0,1
22023,1629650,22300215,"NOV 19, 2023",POR vs. OKC,L,7,1,1,1.0,0,0,0.0,0,0,0.0,1,0,1,0,1,0,0,0,2,-4,1,Moses Brown,POR,POR,OKC,,,3,3,2,1
22023,1629650,22300170,"NOV 08, 2023",POR @ SAC,L,5,2,3,0.667,0,0,0.0,0,2,0.0,2,1,3,1,0,1,0,1,4,-8,1,Moses Brown,POR,SAC,POR,,,8,7,5,4
22023,1630535,22300487,"JAN 05, 2024",DAL vs. POR,W,12,3,5,0.6,1,2,0.5,0,0,0.0,1,1,2,1,0,3,1,2,7,5,1,Greg Brown III,DAL,DAL,POR,,,10,9,8,3
22023,1630535,22300398,"DEC 23, 2023",DAL vs. SAS,W,5,0,1,0.0,0,0,0.0,0,0,0.0,0,0,0,0,0,1,2,1,0,-15,1,Greg Brown III,DAL,DAL,SAS,,,0,0,0,0
22023,1630535,22300385,"DEC 22, 2023",DAL @ HOU,L,12,0,3,0.0,0,1,0.0,3,4,0.75,1,4,5,2,0,0,0,1,3,-1,1,Greg Brown III,DAL,HOU,DAL,,,10,8,5,7
22023,1630535,22300356,"DEC 18, 2023",DAL @ DEN,L,9,2,2,1.0,0,0,0.0,1,5,0.2,1,1,2,0,0,0,1,1,5,1,1,Greg Brown III,DAL,DEN,DAL,,,7,7,5,2
22023,1630535,22300341,"DEC 16, 2023",DAL @ POR,W,1,0,0,0.0,0,0,0.0,0,0,0.0,0,0,0,0,0,0,0,0,0,0,1,Greg Brown III,DAL,POR,DAL,,,0,0,0,0
22023,1630535,22300321,"DEC 14, 2023",DAL vs. MIN,L,2,0,0,0.0,0,0,0.0,0,0,0.0,0,0,0,1,0,0,0,0,0,1,1,Greg Brown III,DAL,DAL,MIN,,,1,0,1,1
22023,1629718,22300441,"DEC 30, 2023",NYK @ IND,L,1,1,2,0.5,1,1,1.0,0,0,0.0,0,0,0,0,0,0,0,0,3,3,1,Charlie Brown Jr.,NYK,IND,NYK,,,3,3,3,0
22023,1629718,22300388,"DEC 23, 2023",NYK vs. MIL,L,1,0,1,0.0,0,1,0.0,0,0,0.0,0,0,0,0,0,0,0,0,0,-3,1,Charlie Brown Jr.,NYK,NYK,MIL,,,0,0,0,0
22023,1629718,22301201,"DEC 05, 2023",NYK @ MIL,L,2,0,1,0.0,0,1,0.0,0,0,0.0,0,0,0,0,0,0,2,0,0,-4,1,Charlie Brown Jr.,NYK,MIL,NYK,,,0,0,0,0
22023,1628972,22300538,"JAN 12, 2024",MIN vs. POR,W,9,2,5,0.4,2,5,0.4,0,0,0.0,1,1,2,3,0,0,3,1,6,-10,1,Troy Brown Jr.,MIN,MIN,POR,,,11,8,9,5
22023,1628972,22300517,"JAN 10, 2024",MIN @ BOS,L,8,1,3,0.333,0,2,0.0,0,0,0.0,0,1,1,1,0,0,0,0,2,-7,1,Troy Brown Jr.,MIN,BOS,MIN,,,4,3,3,2
22023,1628972,22300513,"JAN 09, 2024",MIN @ ORL,W,2,0,2,0.0,0,2,0.0,0,0,0.0,0,1,1,1,0,0,0,0,0,-2,1,Troy Brown Jr.,MIN,ORL,MIN,,,2,1,1,2
22023,1628972,22300485,"JAN 05, 2024",MIN @ HOU,W,3,1,2,0.5,1,2,0.5,0,0,0.0,0,1,1,1,0,0,0,0,3,0,1,Troy Brown Jr.,MIN,HOU,MIN,,,5,4,4,2
22023,1628972,22300471,"JAN 03, 2024",MIN vs. NOP,L,3,1,2,0.5,1,2,0.5,0,0,0.0,0,0,0,1,0,0,0,0,3,8,1,Troy Brown Jr.,MIN,MIN,NOP,,,4,3,4,1
22023,1628972,22300451,"JAN 01, 2024",MIN @ NYK,L,6,0,0,0.0,0,0,0.0,0,0,0.0,0,1,1,0,0,0,1,1,0,-15,1,Troy Brown Jr.,MIN,NYK,MIN,,,1,1,0,1
22023,1628972,22300443,"DEC 30, 2023",MIN vs. LAL,W,8,1,3,0.333,1,2,0.5,0,0,0.0,0,3,3,0,1,0,0,0,3,2,1,Troy Brown Jr.,MIN,MIN,LAL,,,6,6,3,3
22023,1628972,22300423,"DEC 28, 2023",MIN vs. DAL,W,6,1,1,1.0,0,0,0.0,0,0,0.0,0,0,0,0,1,0,0,0,2,-5,1,Troy Brown Jr.,MIN,MIN,DAL,,,2,2,2,0
22023,1628972,22300411,"DEC 26, 2023",MIN @ OKC,L,2,0,1,0.0,0,1,0.0,0,0,0.0,0,0,0,1,0,0,0,0,0,-4,1,Troy Brown Jr.,MIN,OKC,MIN,,,1,0,1,1
22023,1628972,22300400,"DEC 23, 2023",MIN @ SAC,W,3,0,0,0.0,0,0,0.0,0,0,0.0,0,1,1,0,0,0,0,3,0,-3,1,Troy Brown Jr.,MIN,SAC,MIN,,,1,1,0,1
22023,1628972,22300380,"DEC 21, 2023",MIN vs. LAL,W,6,0,1,0.0,0,1,0.0,2,2,1.0,0,1,1,0,0,0,0,2,2,3,1,Troy Brown Jr.,MIN,MIN,LAL,,,3,3,2,1
22023,1628972,22300367,"DEC 20, 2023",MIN @ PHI,L,10,2,4,0.5,1,2,0.5,0,0,0.0,1,1,2,1,0,0,3,0,5,-11,1,Troy Brown Jr.,MIN,PHI,MIN,,,8,7,6,3
22023,1628972,22300353,"DEC 18, 2023",MIN @ MIA,W,5,1,1,1.0,1,1,1.0,0,0,0.0,0,1,1,1,0,0,1,0,3,-8,1,Troy Brown Jr.,MIN,MIA,MIN,,,5,4,4,2
22023,1628972,22300338,"DEC 16, 2023",MIN vs. IND,W,16,4,6,0.667,3,5,0.6,0,0,0.0,0,1,1,4,0,0,1,1,11,5,1,Troy Brown Jr.,MIN,MIN,IND,,,16,12,15,5
22023,1628972,22300321,"DEC 14, 2023",MIN @ DAL,W,15,2,4,0.5,1,3,0.333,0,0,0.0,0,1,1,1,0,0,0,0,5,-2,1,Troy Brown Jr.,MIN,DAL,MIN,,,7,6,6,2
22023,1628972,22300301,"DEC 11, 2023",MIN @ NOP,L,27,2,9,0.222,1,7,0.143,0,0,0.0,0,6,6,2,0,0,0,1,5,-15,1,Troy Brown Jr.,MIN,NOP,MIN,,,13,11,7,8
22023,1628972,22301221,"DEC 08, 2023",MIN @ MEM,W,30,8,10,0.8,4,6,0.667,0,0,0.0,1,3,4,4,1,0,1,2,20,18,1,Troy Brown Jr.,MIN,MEM,MIN,,,28,24,24,8
22023,1628972,22301210,"DEC 06, 2023",MIN vs. SAS,W,25,3,9,0.333,2,8,0.25,0,0,0.0,0,1,1,2,0,1,1,1,8,7,1,Troy Brown Jr.,MIN,MIN,SAS,,,11,9,10,3
22023,1628972,22300281,"DEC 02, 2023",MIN @ CHA,W,32,3,7,0.429,3,6,0.5,0,0,0.0,1,2,3,1,1,0,1,4,9,15,1,Troy Brown Jr.,MIN,CHA,MIN,,,13,12,10,4
22023,1628972,22300270,"NOV 30, 2023",MIN vs. UTA,W,29,3,6,0.5,2,3,0.667,0,0,0.0,0,3,3,2,1,0,1,0,8,20,1,Troy Brown Jr.,MIN,MIN,UTA,,,13,11,10,5
22023,1628972,22300058,"NOV 28, 2023",MIN vs. OKC,W,21,5,6,0.833,3,4,0.75,4,6,0.667,0,3,3,0,0,0,1,2,17,1,1,Troy Brown Jr.,MIN,MIN,OKC,,,20,20,17,3
22023,1628972,22300249,"NOV 26, 2023",MIN @ MEM,W,18,2,4,0.5,2,4,0.5,0,0,0.0,2,2,4,1,0,0,1,1,6,5,1,Troy Brown Jr.,MIN,MEM,MIN,,,11,10,7,5
22023,1628972,22300050,"NOV 24, 2023",MIN vs. SAC,L,25,4,8,0.5,1,5,0.2,1,2,0.5,3,4,7,0,0,1,0,1,10,9,1,Troy Brown Jr.,MIN,MIN,SAC,,,17,17,10,7
22023,1628972,22300232,"NOV 22, 2023",MIN vs. PHI,W,7,0,1,0.0,0,0,0.0,0,0,0.0,1,0,1,0,0,0,0,0,0,-6,1,Troy Brown Jr.,MIN,MIN,PHI,,,1,1,0,1
22023,1628972,22300221,"NOV 20, 2023",MIN vs. NYK,W,17,1,5,0.2,1,3,0.333,2,2,1.0,1,4,5,2,0,0,0,2,5,2,1,Troy Brown Jr.,MIN,MIN,NYK,,,12,10,7,7
22023,1628972,22300197,"NOV 15, 2023",MIN @ PHX,L,14,0,3,0.0,0,2,0.0,4,4,1.0,1,3,4,1,1,0,0,1,4,6,1,Troy Brown Jr.,MIN,PHX,MIN,,,9,8,5,5
22023,1628972,22300025,"NOV 14, 2023",MIN @ GSW,W,10,0,1,0.0,0,1,0.0,0,0,0.0,1,1,2,1,1,0,0,0,0,-1,1,Troy Brown Jr.,MIN,GSW,MIN,,,3,2,1,3
22023,1628972,22300186,"NOV 12, 2023",MIN @ GSW,W,1,0,0,0.0,0,0,0.0,2,2,1.0,0,0,0,0,0,0,0,0,2,-4,1,Troy Brown Jr.,MIN,GSW,MIN,,,2,2,2,0
22023,1628972,22300166,"NOV 08, 2023",MIN vs. NOP,W,5,2,5,0.4,0,1,0.0,0,0,0.0,1,0,1,0,0,0,0,0,4,-6,1,Troy Brown Jr.,MIN,MIN,NOP,,,5,5,4,1
22023,1628972,22300138,"NOV 04, 2023",MIN vs. UTA,W,4,1,1,1.0,0,0,0.0,0,0,0.0,0,2,2,0,0,0,0,0,2,5,1,Troy Brown Jr.,MIN,MIN,UTA,,,4,4,2,2
22023,1628972,22300123,"NOV 01, 2023",MIN vs. DEN,W,5,0,1,0.0,0,1,0.0,4,4,1.0,0,4,4,1,0,0,1,0,4,0,1,Troy Brown Jr.,MIN,MIN,DEN,,,9,8,5,5
22023,1628972,22300093,"OCT 28, 2023",MIN vs. MIA,W,15,0,2,0.0,0,2,0.0,0,0,0.0,0,2,2,1,1,0,2,1,0,-5,1,Troy Brown Jr.,MIN,MIN,MIA,,,3,2,1,3
22023,1628972,22300069,"OCT 25, 2023",MIN @ TOR,L,5,0,0,0.0,0,0,0.0,0,0,0.0,0,1,1,0,0,0,0,0,0,1,1,Troy Brown Jr.,MIN,TOR,MIN,,,1,1,0,1
22023,1628973,22300530,"JAN 11, 2024",NYK @ DAL,L,39,10,22,0.455,2,6,0.333,8,9,0.889,0,2,2,8,1,0,4,3,30,8,1,Jalen Brunson,NYK,DAL,NYK,,,40,32,38,10
22023,1628973,22300514,"JAN 09, 2024",NYK vs. POR,W,26,3,11,0.273,1,7,0.143,5,6,0.833,1,2,3,7,0,0,0,0,12,29,1,Jalen Brunson,NYK,NYK,POR,,,22,15,19,10
22023,1628973,22300494,"JAN 06, 2024",NYK @ WAS,W,35,10,18,0.556,4,8,0.5,9,9,1.0,0,3,3,8,0,0,2,2,33,20,1,Jalen Brunson,NYK,WAS,NYK,,,44,36,41,11
22023,1628973,22300483,"JAN 05, 2024",NYK @ PHI,W,32,11,20,0.55,4,9,0.444,3,3,1.0,0,3,3,2,1,1,0,1,29,14,1,Jalen Brunson,NYK,PHI,NYK,,,34,32,31,5
22023,1628973,22300468,"JAN 03, 2024",NYK vs. CHI,W,38,13,22,0.591,4,9,0.444,1,1,1.0,0,3,3,13,0,0,4,3,31,31,1,Jalen Brunson,NYK,NYK,CHI,,,47,34,44,16
22023,1628973,22300451,"JAN 01, 2024",NYK vs. MIN,W,41,5,23,0.217,1,9,0.111,5,5,1.0,0,4,4,14,1,0,2,4,16,16,1,Jalen Brunson,NYK,NYK,MIN,,,34,20,30,18
22023,1628973,22300441,"DEC 30, 2023",NYK @ IND,L,41,9,22,0.409,4,8,0.5,6,9,0.667,0,1,1,6,0,1,4,3,28,-17,1,Jalen Brunson,NYK,IND,NYK,,,35,29,34,7
22023,1628973,22300429,"DEC 29, 2023",NYK @ ORL,L,34,4,15,0.267,0,4,0.0,12,12,1.0,0,7,7,8,0,1,3,2,20,-10,1,Jalen Brunson,NYK,ORL,NYK,,,35,27,28,15
22023,1628973,22300419,"DEC 27, 2023",NYK @ OKC,L,37,9,19,0.474,1,5,0.2,5,5,1.0,2,2,4,7,2,1,5,4,24,-9,1,Jalen Brunson,NYK,OKC,NYK,,,35,28,31,11
22023,1628973,22300401,"DEC 25, 2023",NYK vs. MIL,W,37,15,28,0.536,1,3,0.333,7,9,0.778,1,3,4,6,1,0,0,0,38,6,1,Jalen Brunson,NYK,NYK,MIL,,,48,42,44,10
22023,1628973,22300388,"DEC 23, 2023",NYK vs. MIL,L,37,15,26,0.577,3,5,0.6,3,3,1.0,0,3,3,7,0,1,3,2,36,-16,1,Jalen Brunson,NYK,NYK,MIL,,,46,39,43,10
22023,1628973,22300368,"DEC 20, 2023",NYK @ BKN,W,32,6,15,0.4,1,3,0.333,3,4,0.75,1,6,7,8,1,0,3,0,16,18,1,Jalen Brunson,NYK,BKN,NYK,,,31,23,24,15
22023,1628973,22300359,"DEC 18, 2023",NYK @ LAL,W,37,10,21,0.476,3,6,0.5,6,6,1.0,1,3,4,3,1,1,4,0,29,1,1,Jalen Brunson,NYK,LAL,NYK,,,36,33,32,7
22023,1628973,22300343,"DEC 16, 2023",NYK @ LAC,L,34,7,17,0.412,2,5,0.4,6,6,1.0,2,5,7,6,0,0,2,2,22,-25,1,Jalen Brunson,NYK,LAC,NYK,,,35,29,28,13
22023,1628973,22300333,"DEC 15, 2023",NYK @ PHX,W,35,17,23,0.739,9,9,1.0,7,9,0.778,1,5,6,9,5,0,2,0,50,7,1,Jalen Brunson,NYK,PHX,NYK,,,65,56,59,15
22023,1628973,22300318,"DEC 13, 2023",NYK @ UTA,L,39,6,19,0.316,0,6,0.0,11,16,0.688,2,5,7,8,2,0,3,4,23,9,1,Jalen Brunson,NYK,UTA,NYK,,,38,30,31,15
22023,1628973,22300297,"DEC 11, 2023",NYK vs. TOR,W,38,7,12,0.583,3,5,0.6,4,6,0.667,0,2,2,9,1,0,7,5,21,1,1,Jalen Brunson,NYK,NYK,TOR,,,32,23,30,11
22023,1628973,22301227,"DEC 08, 2023",NYK @ BOS,L,34,8,17,0.471,0,5,0.0,7,9,0.778,0,1,1,4,1,0,1,3,23,-21,1,Jalen Brunson,NYK,BOS,NYK,,,28,24,27,5
22023,1628973,22301201,"DEC 05, 2023",NYK @ MIL,L,34,10,22,0.455,0,5,0.0,4,7,0.571,0,3,3,6,1,0,3,1,24,-14,1,Jalen Brunson,NYK,MIL,NYK,,,33,27,30,9
22023,1628973,22300276,"DEC 01, 2023",NYK @ TOR,W,37,9,21,0.429,3,8,0.375,1,1,1.0,0,5,5,8,1,0,2,2,22,15,1,Jalen Brunson,NYK,TOR,NYK,,,35,27,30,13
22023,1628973,22300268,"NOV 30, 2023",NYK vs. DET,W,40,13,24,0.542,7,12,0.583,9,10,0.9,2,4,6,8,1,0,1,3,42,11,1,Jalen Brunson,NYK,NYK,DET,,,56,48,50,14
22023,1628973,22300057,"NOV 28, 2023",NYK vs. CHA,W,34,5,9,0.556,2,5,0.4,0,1,0.0,1,2,3,7,3,0,2,3,12,20,1,Jalen Brunson,NYK,NYK,CHA,,,22,15,19,10
22023,1628973,22300247,"NOV 26, 2023",NYK vs. PHX,L,38,15,25,0.6,5,10,0.5,0,2,0.0,0,6,6,8,3,1,2,5,35,5,1,Jalen Brunson,NYK,NYK,PHX,,,49,41,43,14
22023,1628973,22300045,"NOV 24, 2023",NYK vs. MIA,W,34,10,16,0.625,1,4,0.25,3,5,0.6,0,3,3,3,0,0,2,1,24,-6,1,Jalen Brunson,NYK,NYK,MIA,,,30,27,27,6
22023,1628973,22300221,"NOV 20, 2023",NYK @ MIN,L,36,7,15,0.467,3,6,0.5,8,8,1.0,0,4,4,6,0,0,1,2,25,-16,1,Jalen Brunson,NYK,MIN,NYK,,,35,29,31,10
22023,1628973,22300202,"NOV 18, 2023",NYK @ CHA,W,39,12,21,0.571,4,8,0.5,4,4,1.0,0,4,4,7,0,0,2,2,32,15,1,Jalen Brunson,NYK,CHA,NYK,,,43,36,39,11
22023,1628973,22300028,"NOV 17, 2023",NYK @ WAS,W,34,10,23,0.435,6,10,0.6,6,6,1.0,3,4,7,7,0,0,0,2,32,18,1,Jalen Brunson,NYK,WAS,NYK,,,46,39,39,14
22023,1628973,22300193,"NOV 15, 2023",NYK @ ATL,W,41,8,19,0.421,6,10,0.6,2,2,1.0,0,0,0,8,0,0,3,2,24,8,1,Jalen Brunson,NYK,ATL,NYK,,,32,24,32,8
22023,1628973,22300188,"NOV 13, 2023",NYK @ BOS,L,39,10,21,0.476,3,7,0.429,3,5,0.6,0,3,3,4,1,0,2,0,26,-20,1,Jalen Brunson,NYK,BOS,NYK,,,33,29,30,7
22023,1628973,22300177,"NOV 12, 2023",NYK vs. CHA,W,27,7,12,0.583,2,4,0.5,4,4,1.0,0,1,1,1,1,0,1,2,20,13,1,Jalen Brunson,NYK,NYK,CHA,,,22,21,21,2
22023,1628973,22300161,"NOV 08, 2023",NYK vs. SAS,W,33,8,19,0.421,5,8,0.625,4,4,1.0,0,2,2,6,0,0,0,2,25,27,1,Jalen Brunson,NYK,NYK,SAS,,,33,27,31,8
22023,1628973,22300151,"NOV 06, 2023",NYK vs. LAC,W,35,2,12,0.167,1,3,0.333,2,2,1.0,2,1,3,6,3,0,4,1,7,-1,1,Jalen Brunson,NYK,NYK,LAC,,,16,10,13,9
22023,1628973,22300002,"NOV 03, 2023",NYK @ MIL,L,42,17,30,0.567,2,8,0.25,9,11,0.818,2,3,5,4,1,0,4,3,45,2,1,Jalen Brunson,NYK,MIL,NYK,,,54,50,49,9
22023,1628973,22300120,"NOV 01, 2023",NYK vs. CLE,L,39,8,23,0.348,0,2,0.0,8,9,0.889,1,3,4,4,0,0,1,4,24,-6,1,Jalen Brunson,NYK,NYK,CLE,,,32,28,28,8
22023,1628973,22300112,"OCT 31, 2023",NYK @ CLE,W,34,7,16,0.438,1,3,0.333,4,5,0.8,0,5,5,2,2,0,5,1,19,21,1,Jalen Brunson,NYK,CLE,NYK,,,26,24,21,7
22023,1628973,22300090,"OCT 28, 2023",NYK @ NOP,L,31,4,14,0.286,1,5,0.2,5,6,0.833,1,3,4,5,0,0,1,2,14,-9,1,Jalen Brunson,NYK,NOP,NYK,,,23,18,19,9
22023,1628973,22300079,"OCT 27, 2023",NYK @ ATL,W,33,11,21,0.524,8,12,0.667,1,2,0.5,0,3,3,5,0,0,2,1,31,13,1,Jalen Brunson,NYK,ATL,NYK,,,39,34,36,8
22023,1628973,22300065,"OCT 25, 2023",NYK vs. BOS,L,33,6,21,0.286,3,8,0.375,0,1,0.0,1,2,3,6,3,0,2,3,15,-9,1,Jalen Brunson,NYK,NYK,BOS,,,24,18,21,9
22023,1628418,22300562,"JAN 15, 2024",MIA @ BKN,W,5,0,0,0.0,0,0,0.0,0,0,0.0,0,0,0,1,0,0,0,0,0,2,1,Thomas Bryant,MIA,BKN,MIA,,,1,0,1,1
22023,1628418,22300489,"JAN 05, 2024",MIA @ PHX,L,2,0,0,0.0,0,0,0.0,0,0,0.0,0,2,2,0,0,0,0,0,0,5,1,Thomas Bryant,MIA,PHX,MIA,,,2,2,0,2
22023,1628418,22300458,"JAN 01, 2024",MIA @ LAC,L,3,0,0,0.0,0,0,0.0,0,0,0.0,0,0,0,1,0,0,0,0,0,-6,1,Thomas Bryant,MIA,LAC,MIA,,,1,0,1,1
22023,1628418,22300366,"DEC 20, 2023",MIA @ ORL,W,17,5,7,0.714,0,0,0.0,2,2,1.0,3,2,5,1,0,0,2,1,12,20,1,Thomas Bryant,MIA,ORL,MIA,,,18,17,13,6
22023,1628418,22300337,"DEC 16, 2023",MIA vs. CHI,W,6,1,2,0.5,0,0,0.0,0,0,0.0,0,2,2,0,0,1,0,2,2,-8,1,Thomas Bryant,MIA,MIA,CHI,,,4,4,2,2
22023,1628418,22300320,"DEC 14, 2023",MIA vs. CHI,L,12,2,2,1.0,0,0,0.0,2,2,1.0,0,2,2,1,0,0,0,1,6,0,1,Thomas Bryant,MIA,MIA,CHI,,,9,8,7,3
22023,1628418,22300312,"DEC 13, 2023",MIA vs. CHA,W,16,5,7,0.714,0,0,0.0,1,1,1.0,6,3,9,0,0,0,1,2,11,-2,1,Thomas Bryant,MIA,MIA,CHA,,,20,20,11,9
22023,1628418,22300292,"DEC 11, 2023",MIA @ CHA,W,4,0,0,0.0,0,0,0.0,0,0,0.0,0,2,2,1,0,0,0,0,0,2,1,Thomas Bryant,MIA,CHA,MIA,,,3,2,1,3
22023,1628418,22300267,"NOV 30, 2023",MIA vs. IND,W,6,1,1,1.0,0,0,0.0,0,0,0.0,1,3,4,1,0,0,0,1,2,-1,1,Thomas Bryant,MIA,MIA,IND,,,7,6,3,5
22023,1628418,22300240,"NOV 25, 2023",MIA @ BKN,L,13,1,5,0.2,0,1,0.0,0,0,0.0,0,1,1,0,1,0,2,1,2,-17,1,Thomas Bryant,MIA,BKN,MIA,,,3,3,2,1
22023,1628418,22300229,"NOV 22, 2023",MIA @ CLE,W,24,4,8,0.5,0,0,0.0,2,2,1.0,1,6,7,1,1,1,0,3,10,13,1,Thomas Bryant,MIA,CLE,MIA,,,18,17,11,8
22023,1628418,22300017,"NOV 14, 2023",MIA @ CHA,W,3,1,3,0.333,0,0,0.0,0,0,0.0,1,0,1,0,0,0,0,0,2,5,1,Thomas Bryant,MIA,CHA,MIA,,,3,3,2,1
22023,1628418,22300184,"NOV 12, 2023",MIA @ SAS,W,5,1,1,1.0,0,0,0.0,0,0,0.0,0,0,0,1,0,0,0,0,2,9,1,Thomas Bryant,MIA,SAS,MIA,,,3,2,3,1
22023,1628418,22300164,"NOV 08, 2023",MIA @ MEM,W,12,1,3,0.333,0,0,0.0,0,0,0.0,1,5,6,0,0,0,1,1,2,-9,1,Thomas Bryant,MIA,MEM,MIA,,,8,8,2,6
22023,1628418,22300150,"NOV 06, 2023",MIA vs. LAL,W,10,1,1,1.0,0,0,0.0,0,0,0.0,0,4,4,0,0,1,1,1,2,-4,1,Thomas Bryant,MIA,MIA,LAL,,,6,6,2,4
22023,1628418,22300003,"NOV 03, 2023",MIA vs. WAS,W,18,5,7,0.714,0,0,0.0,1,2,0.5,2,2,4,0,0,1,2,4,11,1,1,Thomas Bryant,MIA,MIA,WAS,,,15,15,11,4
22023,1628418,22300119,"NOV 01, 2023",MIA vs. BKN,L,15,3,4,0.75,0,0,0.0,2,2,1.0,1,4,5,0,1,0,2,4,8,-9,1,Thomas Bryant,MIA,MIA,BKN,,,13,13,8,5
22023,1628418,22300107,"OCT 30, 2023",MIA @ MIL,L,22,4,7,0.571,0,1,0.0,2,2,1.0,0,2,2,0,2,0,1,0,10,-12,1,Thomas Bryant,MIA,MIL,MIA,,,12,12,10,2
22023,1628418,22300093,"OCT 28, 2023",MIA @ MIN,L,12,2,4,0.5,0,0,0.0,1,2,0.5,3,2,5,1,0,0,1,1,5,-8,1,Thomas Bryant,MIA,MIN,MIA,,,11,10,6,6
22023,1628418,22300080,"OCT 27, 2023",MIA @ BOS,L,13,1,5,0.2,0,1,0.0,0,0,0.0,1,3,4,1,0,1,1,1,2,-8,1,Thomas Bryant,MIA,BOS,MIA,,,7,6,3,5
22023,1628418,22300068,"OCT 25, 2023",MIA vs. DET,W,16,2,5,0.4,0,0,0.0,4,5,0.8,2,4,6,3,1,0,1,0,8,5,1,Thomas Bryant,MIA,MIA,DET,,,17,14,11,9
22023,1641723,22300104,"OCT 30, 2023",ATL vs. MIN,W,1,0,1,0.0,0,0,0.0,0,0,0.0,0,0,0,0,0,0,0,0,0,-4,1,Kobe Bufkin,ATL,ATL,MIN,,,0,0,0,0
22023,1641723,22300097,"OCT 29, 2023",ATL @ MIL,W,3,0,2,0.0,0,1,0.0,1,2,0.5,1,1,2,0,0,0,0,0,1,-10,1,Kobe Bufkin,ATL,MIL,ATL,,,3,3,1,2
22023,203493,22300542,"JAN 13, 2024",HOU @ BOS,L,8,1,1,1.0,1,1,1.0,0,0,0.0,0,3,3,1,0,1,0,1,3,-8,1,Reggie Bullock Jr.,HOU,BOS,HOU,,,7,6,4,4
22023,203493,22300534,"JAN 12, 2024",HOU @ DET,W,21,1,3,0.333,1,3,0.333,0,0,0.0,0,4,4,1,1,0,1,0,3,-1,1,Reggie Bullock Jr.,HOU,DET,HOU,,,8,7,4,5
22023,203493,22300485,"JAN 05, 2024",HOU vs. MIN,L,8,2,4,0.5,1,2,0.5,0,0,0.0,0,1,1,0,0,0,0,1,5,-5,1,Reggie Bullock Jr.,HOU,HOU,MIN,,,6,6,5,1
22023,203493,22300469,"JAN 03, 2024",HOU vs. BKN,W,8,0,2,0.0,0,1,0.0,0,0,0.0,0,1,1,1,0,0,0,0,0,-13,1,Reggie Bullock Jr.,HOU,HOU,BKN,,,2,1,1,2
22023,203493,22300453,"JAN 01, 2024",HOU vs. DET,W,14,3,5,0.6,1,2,0.5,0,0,0.0,0,2,2,2,0,0,1,0,7,-3,1,Reggie Bullock Jr.,HOU,HOU,DET,,,11,9,9,4
22023,203493,22300418,"DEC 27, 2023",HOU vs. PHX,L,7,0,0,0.0,0,0,0.0,0,0,0.0,0,0,0,1,0,0,0,0,0,2,1,Reggie Bullock Jr.,HOU,HOU,PHX,,,1,0,1,1
22023,203493,22300332,"DEC 15, 2023",HOU @ MEM,W,4,0,1,0.0,0,0,0.0,0,0,0.0,0,0,0,0,0,0,0,0,0,3,1,Reggie Bullock Jr.,HOU,MEM,HOU,,,0,0,0,0
22023,203493,22300314,"DEC 13, 2023",HOU vs. MEM,W,6,2,4,0.5,2,4,0.5,0,0,0.0,0,0,0,0,0,0,0,0,6,6,1,Reggie Bullock Jr.,HOU,HOU,MEM,,,6,6,6,0
22023,203493,22301212,"DEC 06, 2023",HOU vs. OKC,W,6,1,2,0.5,0,1,0.0,1,1,1.0,0,0,0,0,0,0,0,0,3,4,1,Reggie Bullock Jr.,HOU,HOU,OKC,,,3,3,3,0
22023,203493,22300263,"NOV 29, 2023",HOU @ DEN,L,12,2,2,1.0,2,2,1.0,0,0,0.0,1,0,1,0,0,0,0,3,6,-1,1,Reggie Bullock Jr.,HOU,DEN,HOU,,,7,7,6,1
22023,203493,22300231,"NOV 22, 2023",HOU vs. MEM,W,4,0,1,0.0,0,1,0.0,0,0,0.0,0,0,0,0,0,0,0,0,0,-3,1,Reggie Bullock Jr.,HOU,HOU,MEM,,,0,0,0,0
22023,203493,22300224,"NOV 20, 2023",HOU @ GSW,L,8,0,2,0.0,0,2,0.0,0,0,0.0,1,4,5,0,0,0,0,0,0,-2,1,Reggie Bullock Jr.,HOU,GSW,HOU,,,5,5,0,5
22023,203493,22300163,"NOV 08, 2023",HOU vs. LAL,W,12,1,3,0.333,1,2,0.5,0,0,0.0,0,1,1,1,0,0,0,0,3,6,1,Reggie Bullock Jr.,HOU,HOU,LAL,,,5,4,4,2
22023,203493,22300153,"NOV 06, 2023",HOU vs. SAC,W,12,0,1,0.0,0,1,0.0,0,0,0.0,0,1,1,2,0,0,0,1,0,-12,1,Reggie Bullock Jr.,HOU,HOU,SAC,,,3,1,2,3
22023,203493,22300096,"OCT 29, 2023",HOU vs. GSW,L,6,0,2,0.0,0,2,0.0,0,0,0.0,0,1,1,0,0,0,1,1,0,-15,1,Reggie Bullock Jr.,HOU,HOU,GSW,,,1,1,0,1
22023,203493,22300083,"OCT 27, 2023",HOU @ SAS,L,11,0,1,0.0,0,1,0.0,0,0,0.0,0,3,3,0,0,0,1,1,0,3,1,Reggie Bullock Jr.,HOU,SAS,HOU,,,3,3,0,3
22023,203493,22300066,"OCT 25, 2023",HOU @ ORL,L,11,1,1,1.0,1,1,1.0,0,0,0.0,0,1,1,0,1,1,0,1,3,-5,1,Reggie Bullock Jr.,HOU,ORL,HOU,,,4,4,3,1
22023,202692,22300558,"JAN 15, 2024",DET @ WAS,W,29,11,17,0.647,8,12,0.667,4,4,1.0,0,2,2,2,0,0,1,2,34,18,1,Alec Burks,DET,WAS,DET,,,38,36,36,4
22023,202692,22300534,"JAN 12, 2024",DET vs. HOU,L,30,7,14,0.5,5,9,0.556,0,0,0.0,0,0,0,1,0,2,2,3,19,-11,1,Alec Burks,DET,DET,HOU,,,20,19,20,1
22023,202692,22300519,"JAN 10, 2024",DET vs. SAS,L,20,5,13,0.385,1,5,0.2,4,4,1.0,0,2,2,2,0,0,1,1,15,-15,1,Alec Burks,DET,DET,SAS,,,19,17,17,4
22023,202692,22300512,"JAN 09, 2024",DET vs. SAC,L,20,5,11,0.455,3,7,0.429,3,5,0.6,0,3,3,1,1,0,2,0,16,-15,1,Alec Burks,DET,DET,SAC,,,20,19,17,4
22023,202692,22300502,"JAN 07, 2024",DET @ DEN,L,20,6,9,0.667,3,3,1.0,3,3,1.0,1,3,4,1,0,0,1,1,18,-16,1,Alec Burks,DET,DEN,DET,,,23,22,19,5
22023,202692,22300490,"JAN 05, 2024",DET @ GSW,L,21,5,14,0.357,3,10,0.3,0,0,0.0,1,3,4,2,0,1,2,2,13,9,1,Alec Burks,DET,GSW,DET,,,19,17,15,6
22023,202692,22300474,"JAN 03, 2024",DET @ UTA,L,34,9,17,0.529,5,9,0.556,4,5,0.8,0,4,4,1,0,0,2,4,27,-12,1,Alec Burks,DET,UTA,DET,,,32,31,28,5
22023,202692,22300453,"JAN 01, 2024",DET @ HOU,L,23,6,11,0.545,3,6,0.5,6,6,1.0,0,2,2,2,1,1,2,2,21,-10,1,Alec Burks,DET,HOU,DET,,,25,23,23,4
22023,202692,22300440,"DEC 30, 2023",DET vs. TOR,W,19,4,6,0.667,3,3,1.0,5,5,1.0,0,0,0,1,0,0,0,0,16,6,1,Alec Burks,DET,DET,TOR,,,17,16,17,1
22023,202692,22300421,"DEC 28, 2023",DET @ BOS,L,30,4,13,0.308,4,12,0.333,0,0,0.0,1,1,2,1,2,0,0,2,12,-15,1,Alec Burks,DET,BOS,DET,,,15,14,13,3
22023,202692,22300406,"DEC 26, 2023",DET vs. BKN,L,26,4,11,0.364,2,6,0.333,5,6,0.833,1,4,5,0,0,0,2,1,15,-25,1,Alec Burks,DET,DET,BKN,,,20,20,15,5
22023,202692,22300394,"DEC 23, 2023",DET @ BKN,L,16,2,8,0.25,1,5,0.2,0,0,0.0,0,1,1,2,1,0,1,2,5,-20,1,Alec Burks,DET,BKN,DET,,,8,6,7,3
22023,202692,22300374,"DEC 21, 2023",DET vs. UTA,L,9,1,4,0.25,0,3,0.0,3,3,1.0,0,1,1,0,0,1,0,1,5,-9,1,Alec Burks,DET,DET,UTA,,,6,6,5,1
22023,202692,22300352,"DEC 18, 2023",DET @ ATL,L,23,2,11,0.182,0,2,0.0,2,2,1.0,1,1,2,2,1,0,0,3,6,-5,1,Alec Burks,DET,ATL,DET,,,10,8,8,4
22023,202692,22300334,"DEC 16, 2023",DET @ MIL,L,4,0,2,0.0,0,2,0.0,1,2,0.5,0,1,1,0,0,0,0,0,1,-11,1,Alec Burks,DET,MIL,DET,,,2,2,1,1
22023,202692,22300327,"DEC 15, 2023",DET @ PHI,L,17,2,8,0.25,0,4,0.0,0,0,0.0,0,2,2,0,0,0,0,1,4,-17,1,Alec Burks,DET,PHI,DET,,,6,6,4,2
22023,202692,22300310,"DEC 13, 2023",DET vs. PHI,L,13,1,7,0.143,1,3,0.333,0,0,0.0,1,2,3,0,1,0,0,1,3,-8,1,Alec Burks,DET,DET,PHI,,,6,6,3,3
22023,202692,22300293,"DEC 11, 2023",DET vs. IND,L,13,4,6,0.667,2,3,0.667,4,4,1.0,0,0,0,0,1,0,1,0,14,-2,1,Alec Burks,DET,DET,IND,,,14,14,14,0
22023,202692,22301217,"DEC 08, 2023",DET @ ORL,L,13,4,7,0.571,2,3,0.667,4,4,1.0,1,2,3,0,0,0,1,1,14,-3,1,Alec Burks,DET,ORL,DET,,,17,17,14,3
22023,202692,22301206,"DEC 06, 2023",DET vs. MEM,L,17,1,6,0.167,1,5,0.2,0,0,0.0,0,2,2,2,0,0,1,1,3,-5,1,Alec Burks,DET,DET,MEM,,,7,5,5,4
22023,202692,22300268,"NOV 30, 2023",DET @ NYK,L,11,0,3,0.0,0,3,0.0,1,1,1.0,0,0,0,1,0,0,0,0,1,3,1,Alec Burks,DET,NYK,DET,,,2,1,2,1
22023,202692,22300258,"NOV 29, 2023",DET vs. LAL,L,10,2,7,0.286,1,3,0.333,1,1,1.0,1,0,1,0,0,0,0,1,6,-8,1,Alec Burks,DET,DET,LAL,,,7,7,6,1
22023,202692,22300253,"NOV 27, 2023",DET vs. WAS,L,13,2,8,0.25,0,5,0.0,4,4,1.0,0,0,0,1,0,0,0,1,8,-12,1,Alec Burks,DET,DET,WAS,,,9,8,9,1
22023,202692,22300047,"NOV 24, 2023",DET @ IND,L,14,2,6,0.333,2,3,0.667,0,0,0.0,0,2,2,1,1,1,2,1,6,-8,1,Alec Burks,DET,IND,DET,,,9,8,7,3
22023,202692,22300218,"NOV 20, 2023",DET vs. DEN,L,17,1,5,0.2,0,4,0.0,1,2,0.5,0,3,3,2,1,0,1,1,3,-13,1,Alec Burks,DET,DET,DEN,,,8,6,5,5
22023,202692,22300211,"NOV 19, 2023",DET @ TOR,L,22,3,9,0.333,1,3,0.333,7,8,0.875,1,3,4,1,0,0,1,3,14,-29,1,Alec Burks,DET,TOR,DET,,,19,18,15,5
22023,202692,22300030,"NOV 17, 2023",DET @ CLE,L,24,4,14,0.286,2,9,0.222,0,0,0.0,2,1,3,1,1,0,0,3,10,-15,1,Alec Burks,DET,CLE,DET,,,14,13,11,4
22023,202692,22300018,"NOV 14, 2023",DET vs. ATL,L,23,4,12,0.333,4,9,0.444,4,4,1.0,1,1,2,5,1,0,1,3,16,-16,1,Alec Burks,DET,DET,ATL,,,23,18,21,7
22023,202692,22300181,"NOV 12, 2023",DET @ CHI,L,21,3,7,0.429,2,6,0.333,8,9,0.889,1,2,3,4,0,0,0,2,16,6,1,Alec Burks,DET,CHI,DET,,,23,19,20,7
22023,202692,22300109,"OCT 30, 2023",DET @ OKC,L,21,4,9,0.444,3,4,0.75,0,0,0.0,1,1,2,7,0,0,0,3,11,-9,1,Alec Burks,DET,OKC,DET,,,20,13,18,9
22023,202692,22300088,"OCT 28, 2023",DET vs. CHI,W,26,6,12,0.5,6,10,0.6,0,1,0.0,0,2,2,0,0,1,0,1,18,19,1,Alec Burks,DET,DET,CHI,,,20,20,18,2
22023,202692,22300077,"OCT 27, 2023",DET @ CHA,W,31,5,10,0.5,3,7,0.429,11,12,0.917,0,4,4,2,1,1,0,1,24,28,1,Alec Burks,DET,CHA,DET,,,30,28,26,6
22023,202692,22300068,"OCT 25, 2023",DET @ MIA,L,25,2,8,0.25,2,5,0.4,1,2,0.5,0,5,5,0,0,1,0,1,7,9,1,Alec Burks,DET,MIA,DET,,,12,12,7,5
22023,1630215,22300494,"JAN 06, 2024",WAS vs. NYK,L,3,3,3,1.0,2,2,1.0,0,0,0.0,0,0,0,2,0,0,0,0,8,5,1,Jared Butler,WAS,WAS,NYK,,,10,8,10,2
22023,1630215,22300482,"JAN 05, 2024",WAS @ CLE,L,5,1,2,0.5,0,0,0.0,0,0,0.0,0,0,0,2,0,1,0,0,2,-1,1,Jared Butler,WAS,CLE,WAS,,,4,2,4,2
22023,1630215,22300465,"JAN 03, 2024",WAS @ CLE,L,9,2,2,1.0,1,1,1.0,0,0,0.0,0,1,1,1,0,0,0,0,5,-6,1,Jared Butler,WAS,CLE,WAS,,,7,6,6,2
22023,1630215,22300386,"DEC 22, 2023",WAS @ GSW,L,7,3,5,0.6,1,3,0.333,1,2,0.5,0,1,1,4,1,0,0,0,8,10,1,Jared Butler,WAS,GSW,WAS,,,13,9,12,5
22023,1630215,22300358,"DEC 18, 2023",WAS @ SAC,L,5,3,4,0.75,1,2,0.5,1,1,1.0,0,1,1,0,0,0,0,0,8,6,1,Jared Butler,WAS,SAC,WAS,,,9,9,8,1
22023,1630215,22300328,"DEC 15, 2023",WAS vs. IND,W,3,1,1,1.0,0,0,0.0,0,0,0.0,0,0,0,1,0,0,1,0,2,-8,1,Jared Butler,WAS,WAS,IND,,,3,2,3,1
22023,1630215,22300311,"DEC 13, 2023",WAS vs. NOP,L,13,2,4,0.5,2,4,0.5,2,2,1.0,0,1,1,4,1,0,1,1,8,-4,1,Jared Butler,WAS,WAS,NOP,,,13,9,12,5
22023,1630215,22300295,"DEC 11, 2023",WAS @ PHI,L,19,5,7,0.714,0,0,0.0,2,3,0.667,0,0,0,4,2,0,1,2,12,-15,1,Jared Butler,WAS,PHI,WAS,,,16,12,16,4
22023,1630215,22301219,"DEC 08, 2023",WAS @ BKN,L,14,1,4,0.25,0,2,0.0,3,4,0.75,0,3,3,0,0,0,3,1,5,-3,1,Jared Butler,WAS,BKN,WAS,,,8,8,5,3
22023,1630215,22301208,"DEC 06, 2023",WAS vs. PHI,L,14,0,3,0.0,0,1,0.0,0,0,0.0,0,1,1,4,0,0,1,5,0,4,1,Jared Butler,WAS,WAS,PHI,,,5,1,4,5
22023,1630215,22300259,"NOV 29, 2023",WAS @ ORL,L,5,1,2,0.5,0,1,0.0,2,2,1.0,0,0,0,3,2,0,0,0,4,1,1,Jared Butler,WAS,ORL,WAS,,,7,4,7,3
22023,1630215,22300253,"NOV 27, 2023",WAS @ DET,W,2,0,1,0.0,0,1,0.0,0,0,0.0,0,1,1,0,0,0,0,1,0,0,1,Jared Butler,WAS,DET,WAS,,,1,1,0,1
22023,1630215,22300241,"NOV 25, 2023",WAS vs. ATL,L,16,5,8,0.625,2,4,0.5,1,1,1.0,0,2,2,5,2,1,2,4,13,-5,1,Jared Butler,WAS,WAS,ATL,,,20,15,18,7
22023,1630215,22300219,"NOV 20, 2023",WAS vs. MIL,L,1,0,0,0.0,0,0,0.0,0,0,0.0,0,0,0,0,0,0,0,0,0,2,1,Jared Butler,WAS,WAS,MIL,,,0,0,0,0
22023,1630215,22300028,"NOV 17, 2023",WAS vs. NYK,L,2,0,0,0.0,0,0,0.0,0,0,0.0,0,0,0,0,0,0,0,0,0,-1,1,Jared Butler,WAS,WAS,NYK,,,0,0,0,0
22023,1630215,22300103,"OCT 30, 2023",WAS vs. BOS,L,6,0,2,0.0,0,2,0.0,0,0,0.0,0,0,0,1,0,0,1,0,0,4,1,Jared Butler,WAS,WAS,BOS,,,1,0,1,1
22023,1630215,22300064,"OCT 25, 2023",WAS @ IND,L,3,1,2,0.5,1,1,1.0,0,0,0.0,0,0,0,0,0,0,0,0,3,2,1,Jared Butler,WAS,IND,WAS,,,3,3,3,0
22023,202710,22300562,"JAN 15, 2024",MIA @ BKN,W,40,8,12,0.667,0,0,0.0,15,16,0.938,2,3,5,4,2,0,1,2,31,6,1,Jimmy Butler,MIA,BKN,MIA,,,40,36,35,9
22023,202710,22300439,"DEC 30, 2023",MIA @ UTA,L,23,2,3,0.667,0,0,0.0,4,4,1.0,0,2,2,1,0,1,2,2,8,4,1,Jimmy Butler,MIA,UTA,MIA,,,11,10,9,3
22023,202710,22300353,"DEC 18, 2023",MIA vs. MIN,L,34,5,12,0.417,1,3,0.333,4,6,0.667,2,3,5,5,0,0,1,1,15,5,1,Jimmy Butler,MIA,MIA,MIN,,,25,20,20,10
22023,202710,22300337,"DEC 16, 2023",MIA vs. CHI,W,35,9,18,0.5,0,2,0.0,10,11,0.909,1,3,4,2,2,0,2,3,28,12,1,Jimmy Butler,MIA,MIA,CHI,,,34,32,30,6
22023,202710,22300320,"DEC 14, 2023",MIA vs. CHI,L,36,6,15,0.4,0,1,0.0,8,10,0.8,2,4,6,7,0,0,1,0,20,-10,1,Jimmy Butler,MIA,MIA,CHI,,,33,26,27,13
22023,202710,22300312,"DEC 13, 2023",MIA vs. CHA,W,29,4,8,0.5,0,0,0.0,7,7,1.0,2,5,7,10,1,0,4,1,15,19,1,Jimmy Butler,MIA,MIA,CHA,,,32,22,25,17
22023,202710,22300292,"DEC 11, 2023",MIA @ CHA,W,36,7,12,0.583,1,1,1.0,8,9,0.889,2,2,4,8,1,1,3,4,23,13,1,Jimmy Butler,MIA,CHA,MIA,,,35,27,31,12
22023,202710,22301220,"DEC 08, 2023",MIA vs. CLE,L,36,5,15,0.333,0,2,0.0,6,7,0.857,3,2,5,2,1,0,2,1,16,-5,1,Jimmy Butler,MIA,MIA,CLE,,,23,21,18,7
22023,202710,22301207,"DEC 06, 2023",MIA @ TOR,W,35,7,16,0.438,1,1,1.0,4,5,0.8,0,2,2,8,1,0,0,2,19,5,1,Jimmy Butler,MIA,TOR,MIA,,,29,21,27,10
22023,202710,22300284,"DEC 02, 2023",MIA vs. IND,L,37,12,23,0.522,0,1,0.0,9,9,1.0,2,3,5,5,0,0,1,1,33,-17,1,Jimmy Butler,MIA,MIA,IND,,,43,38,38,10
22023,202710,22300267,"NOV 30, 2023",MIA vs. IND,W,38,9,19,0.474,0,1,0.0,18,20,0.9,4,7,11,3,0,0,3,1,36,-3,1,Jimmy Butler,MIA,MIA,IND,,,50,47,39,14
22023,202710,22300045,"NOV 24, 2023",MIA @ NYK,L,37,7,14,0.5,3,5,0.6,6,6,1.0,0,2,2,3,1,0,2,1,23,7,1,Jimmy Butler,MIA,NYK,MIA,,,28,25,26,5
22023,202710,22300229,"NOV 22, 2023",MIA @ CLE,W,28,3,12,0.25,1,5,0.2,3,4,0.75,1,3,4,9,2,2,1,0,10,23,1,Jimmy Butler,MIA,CLE,MIA,,,23,14,19,13
22023,202710,22300220,"NOV 20, 2023",MIA @ CHI,W,29,4,11,0.364,0,2,0.0,8,9,0.889,0,3,3,6,1,0,1,2,16,17,1,Jimmy Butler,MIA,CHI,MIA,,,25,19,22,9
22023,202710,22300204,"NOV 18, 2023",MIA @ CHI,L,33,8,16,0.5,2,6,0.333,7,7,1.0,0,3,3,2,1,0,2,2,25,7,1,Jimmy Butler,MIA,CHI,MIA,,,30,28,27,5
22023,202710,22300200,"NOV 16, 2023",MIA vs. BKN,W,35,12,19,0.632,2,5,0.4,10,11,0.909,2,3,5,3,1,3,4,0,36,9,1,Jimmy Butler,MIA,MIA,BKN,,,44,41,39,8
22023,202710,22300017,"NOV 14, 2023",MIA @ CHA,W,34,10,14,0.714,1,1,1.0,11,14,0.786,3,1,4,5,2,0,3,1,32,2,1,Jimmy Butler,MIA,CHA,MIA,,,41,36,37,9
22023,202710,22300184,"NOV 12, 2023",MIA @ SAS,W,37,5,14,0.357,1,3,0.333,8,9,0.889,2,4,6,4,0,1,2,1,19,14,1,Jimmy Butler,MIA,SAS,MIA,,,29,25,23,10
22023,202710,22300164,"NOV 08, 2023",MIA @ MEM,W,35,5,13,0.385,2,4,0.5,3,3,1.0,1,2,3,2,2,0,1,1,15,12,1,Jimmy Butler,MIA,MEM,MIA,,,20,18,17,5
22023,202710,22300150,"NOV 06, 2023",MIA vs. LAL,W,37,9,15,0.6,3,4,0.75,7,7,1.0,2,2,4,6,2,0,3,0,28,-1,1,Jimmy Butler,MIA,MIA,LAL,,,38,32,34,10
22023,202710,22300003,"NOV 03, 2023",MIA vs. WAS,W,31,7,11,0.636,1,2,0.5,5,6,0.833,0,7,7,2,3,0,2,1,20,6,1,Jimmy Butler,MIA,MIA,WAS,,,29,27,22,9
22023,202710,22300119,"NOV 01, 2023",MIA vs. BKN,L,34,7,16,0.438,0,2,0.0,6,8,0.75,4,3,7,3,1,0,1,1,20,-3,1,Jimmy Butler,MIA,MIA,BKN,,,30,27,23,10
22023,202710,22300107,"OCT 30, 2023",MIA @ MIL,L,29,4,11,0.364,1,2,0.5,4,4,1.0,2,2,4,4,0,1,1,0,13,-13,1,Jimmy Butler,MIA,MIL,MIA,,,21,17,17,8
22023,202710,22300080,"OCT 27, 2023",MIA @ BOS,L,34,3,11,0.273,0,0,0.0,8,9,0.889,2,3,5,3,1,1,1,1,14,0,1,Jimmy Butler,MIA,BOS,MIA,,,22,19,17,8
22023,202710,22300068,"OCT 25, 2023",MIA vs. DET,W,34,6,18,0.333,0,0,0.0,7,9,0.778,8,5,13,4,2,0,0,0,19,-3,1,Jimmy Butler,MIA,MIA,DET,,,36,32,23,17
22023,1631288,22300489,"JAN 05, 2024",MIA @ PHX,L,5,2,5,0.4,1,1,1.0,2,2,1.0,2,0,2,0,0,0,0,0,7,2,1,Jamal Cain,MIA,PHX,MIA,,,9,9,7,2
22023,1631288,22300475,"JAN 03, 2024",MIA @ LAL,W,1,0,0,0.0,0,0,0.0,0,0,0.0,0,0,0,0,0,0,0,0,0,0,1,Jamal Cain,MIA,LAL,MIA,,,0,0,0,0
22023,1631288,22300458,"JAN 01, 2024",MIA @ LAC,L,35,4,12,0.333,1,4,0.25,0,0,0.0,3,0,3,1,1,1,0,3,9,-22,1,Jamal Cain,MIA,LAC,MIA,,,13,12,10,4
22023,1631288,22300439,"DEC 30, 2023",MIA @ UTA,L,11,3,4,0.75,0,0,0.0,0,0,0.0,0,1,1,1,0,0,1,2,6,-8,1,Jamal Cain,MIA,UTA,MIA,,,8,7,7,2
22023,1631288,22300426,"DEC 28, 2023",MIA @ GSW,W,28,7,14,0.5,2,5,0.4,2,2,1.0,1,5,6,0,2,0,1,1,18,7,1,Jamal Cain,MIA,GSW,MIA,,,24,24,18,6
22023,1631288,22300404,"DEC 25, 2023",MIA vs. PHI,W,17,0,2,0.0,0,0,0.0,3,4,0.75,1,4,5,0,0,1,0,4,3,16,1,Jamal Cain,MIA,MIA,PHI,,,8,8,3,5
22023,1631288,22300320,"DEC 14, 2023",MIA vs. CHI,L,8,0,0,0.0,0,0,0.0,3,4,0.75,0,0,0,0,0,1,0,1,3,5,1,Jamal Cain,MIA,MIA,CHI,,,3,3,3,0
22023,1631288,22300312,"DEC 13, 2023",MIA vs. CHA,W,29,5,12,0.417,2,6,0.333,2,2,1.0,2,1,3,1,2,1,0,0,14,-6,1,Jamal Cain,MIA,MIA,CHA,,,18,17,15,4
22023,1631288,22300284,"DEC 02, 2023",MIA vs. IND,L,5,0,0,0.0,0,0,0.0,0,0,0.0,0,0,0,0,0,0,0,2,0,1,1,Jamal Cain,MIA,MIA,IND,,,0,0,0,0
22023,1631288,22300056,"NOV 28, 2023",MIA vs. MIL,L,11,1,2,0.5,1,2,0.5,2,4,0.5,0,0,0,0,0,0,0,0,5,3,1,Jamal Cain,MIA,MIA,MIL,,,5,5,5,0
22023,1631288,22300240,"NOV 25, 2023",MIA @ BKN,L,29,3,6,0.5,1,3,0.333,0,1,0.0,0,3,3,0,1,0,1,1,7,7,1,Jamal Cain,MIA,BKN,MIA,,,10,10,7,3
22023,1631288,22300175,"NOV 11, 2023",MIA @ ATL,W,0,0,0,0.0,0,0,0.0,0,0,0.0,0,0,0,0,0,0,0,0,0,0,1,Jamal Cain,MIA,ATL,MIA,,,0,0,0,0
22023,1631288,22300093,"OCT 28, 2023",MIA @ MIN,L,25,4,8,0.5,0,3,0.0,0,0,0.0,3,2,5,0,2,0,0,1,8,-23,1,Jamal Cain,MIA,MIN,MIA,,,13,13,8,5
22023,1631288,22300080,"OCT 27, 2023",MIA @ BOS,L,4,0,1,0.0,0,1,0.0,0,0,0.0,0,1,1,0,1,0,1,1,0,-5,1,Jamal Cain,MIA,BOS,MIA,,,1,1,0,1
22023,203484,22300550,"JAN 14, 2024",DEN vs. IND,W,37,3,4,0.75,2,3,0.667,3,3,1.0,0,2,2,1,2,0,1,2,11,11,1,Kentavious Caldwell-Pope,DEN,DEN,IND,9.5,Points,14,13,12,3
22023,203484,22300550,"JAN 14, 2024",DEN vs. IND,W,37,3,4,0.75,2,3,0.667,3,3,1.0,0,2,2,1,2,0,1,2,11,11,1,Kentavious Caldwell-Pope,DEN,DEN,IND,19.5,Fantasy Score,14,13,12,3
22023,203484,22300550,"JAN 14, 2024",DEN vs. IND,W,37,3,4,0.75,2,3,0.667,3,3,1.0,0,2,2,1,2,0,1,2,11,11,1,Kentavious Caldwell-Pope,DEN,DEN,IND,11.5,Pts+Rebs,14,13,12,3
22023,203484,22300550,"JAN 14, 2024",DEN vs. IND,W,37,3,4,0.75,2,3,0.667,3,3,1.0,0,2,2,1,2,0,1,2,11,11,1,Kentavious Caldwell-Pope,DEN,DEN,IND,11.5,Pts+Asts,14,13,12,3
22023,203484,22300539,"JAN 12, 2024",DEN vs. NOP,W,31,4,9,0.444,3,6,0.5,0,0,0.0,0,2,2,3,2,0,0,0,11,9,1,Kentavious Caldwell-Pope,DEN,DEN,NOP,9.5,Points,16,13,14,5
22023,203484,22300539,"JAN 12, 2024",DEN vs. NOP,W,31,4,9,0.444,3,6,0.5,0,0,0.0,0,2,2,3,2,0,0,0,11,9,1,Kentavious Caldwell-Pope,DEN,DEN,NOP,19.5,Fantasy Score,16,13,14,5
22023,203484,22300539,"JAN 12, 2024",DEN vs. NOP,W,31,4,9,0.444,3,6,0.5,0,0,0.0,0,2,2,3,2,0,0,0,11,9,1,Kentavious Caldwell-Pope,DEN,DEN,NOP,11.5,Pts+Rebs,16,13,14,5
22023,203484,22300539,"JAN 12, 2024",DEN vs. NOP,W,31,4,9,0.444,3,6,0.5,0,0,0.0,0,2,2,3,2,0,0,0,11,9,1,Kentavious Caldwell-Pope,DEN,DEN,NOP,11.5,Pts+Asts,16,13,14,5
22023,203484,22300524,"JAN 10, 2024",DEN @ UTA,L,28,4,9,0.444,2,5,0.4,2,2,1.0,0,1,1,1,4,1,1,2,12,-20,1,Kentavious Caldwell-Pope,DEN,UTA,DEN,9.5,Points,14,13,13,2
22023,203484,22300524,"JAN 10, 2024",DEN @ UTA,L,28,4,9,0.444,2,5,0.4,2,2,1.0,0,1,1,1,4,1,1,2,12,-20,1,Kentavious Caldwell-Pope,DEN,UTA,DEN,19.5,Fantasy Score,14,13,13,2
22023,203484,22300524,"JAN 10, 2024",DEN @ UTA,L,28,4,9,0.444,2,5,0.4,2,2,1.0,0,1,1,1,4,1,1,2,12,-20,1,Kentavious Caldwell-Pope,DEN,UTA,DEN,11.5,Pts+Rebs,14,13,13,2
22023,203484,22300524,"JAN 10, 2024",DEN @ UTA,L,28,4,9,0.444,2,5,0.4,2,2,1.0,0,1,1,1,4,1,1,2,12,-20,1,Kentavious Caldwell-Pope,DEN,UTA,DEN,11.5,Pts+Asts,14,13,13,2
22023,203484,22300502,"JAN 07, 2024",DEN vs. DET,W,36,6,10,0.6,3,6,0.5,3,3,1.0,0,4,4,0,2,1,3,2,18,12,1,Kentavious Caldwell-Pope,DEN,DEN,DET,9.5,Points,22,22,18,4
22023,203484,22300502,"JAN 07, 2024",DEN vs. DET,W,36,6,10,0.6,3,6,0.5,3,3,1.0,0,4,4,0,2,1,3,2,18,12,1,Kentavious Caldwell-Pope,DEN,DEN,DET,19.5,Fantasy Score,22,22,18,4
22023,203484,22300502,"JAN 07, 2024",DEN vs. DET,W,36,6,10,0.6,3,6,0.5,3,3,1.0,0,4,4,0,2,1,3,2,18,12,1,Kentavious Caldwell-Pope,DEN,DEN,DET,11.5,Pts+Rebs,22,22,18,4
22023,203484,22300502,"JAN 07, 2024",DEN vs. DET,W,36,6,10,0.6,3,6,0.5,3,3,1.0,0,4,4,0,2,1,3,2,18,12,1,Kentavious Caldwell-Pope,DEN,DEN,DET,11.5,Pts+Asts,22,22,18,4
22023,203484,22300488,"JAN 05, 2024",DEN vs. ORL,L,29,1,4,0.25,0,3,0.0,4,4,1.0,1,2,3,2,1,1,3,1,6,2,1,Kentavious Caldwell-Pope,DEN,DEN,ORL,9.5,Points,11,9,8,5
22023,203484,22300488,"JAN 05, 2024",DEN vs. ORL,L,29,1,4,0.25,0,3,0.0,4,4,1.0,1,2,3,2,1,1,3,1,6,2,1,Kentavious Caldwell-Pope,DEN,DEN,ORL,19.5,Fantasy Score,11,9,8,5
22023,203484,22300488,"JAN 05, 2024",DEN vs. ORL,L,29,1,4,0.25,0,3,0.0,4,4,1.0,1,2,3,2,1,1,3,1,6,2,1,Kentavious Caldwell-Pope,DEN,DEN,ORL,11.5,Pts+Rebs,11,9,8,5
22023,203484,22300488,"JAN 05, 2024",DEN vs. ORL,L,29,1,4,0.25,0,3,0.0,4,4,1.0,1,2,3,2,1,1,3,1,6,2,1,Kentavious Caldwell-Pope,DEN,DEN,ORL,11.5,Pts+Asts,11,9,8,5
22023,203484,22300478,"JAN 04, 2024",DEN @ GSW,W,35,4,8,0.5,0,2,0.0,0,0,0.0,1,2,3,4,1,1,1,0,8,4,1,Kentavious Caldwell-Pope,DEN,GSW,DEN,9.5,Points,15,11,12,7
22023,203484,22300478,"JAN 04, 2024",DEN @ GSW,W,35,4,8,0.5,0,2,0.0,0,0,0.0,1,2,3,4,1,1,1,0,8,4,1,Kentavious Caldwell-Pope,DEN,GSW,DEN,19.5,Fantasy Score,15,11,12,7
22023,203484,22300478,"JAN 04, 2024",DEN @ GSW,W,35,4,8,0.5,0,2,0.0,0,0,0.0,1,2,3,4,1,1,1,0,8,4,1,Kentavious Caldwell-Pope,DEN,GSW,DEN,11.5,Pts+Rebs,15,11,12,7
22023,203484,22300478,"JAN 04, 2024",DEN @ GSW,W,35,4,8,0.5,0,2,0.0,0,0,0.0,1,2,3,4,1,1,1,0,8,4,1,Kentavious Caldwell-Pope,DEN,GSW,DEN,11.5,Pts+Asts,15,11,12,7
22023,203484,22300455,"JAN 01, 2024",DEN vs. CHA,W,29,2,6,0.333,0,3,0.0,1,1,1.0,0,3,3,4,1,0,0,3,5,28,1,Kentavious Caldwell-Pope,DEN,DEN,CHA,9.5,Points,12,8,9,7
22023,203484,22300455,"JAN 01, 2024",DEN vs. CHA,W,29,2,6,0.333,0,3,0.0,1,1,1.0,0,3,3,4,1,0,0,3,5,28,1,Kentavious Caldwell-Pope,DEN,DEN,CHA,19.5,Fantasy Score,12,8,9,7
22023,203484,22300455,"JAN 01, 2024",DEN vs. CHA,W,29,2,6,0.333,0,3,0.0,1,1,1.0,0,3,3,4,1,0,0,3,5,28,1,Kentavious Caldwell-Pope,DEN,DEN,CHA,11.5,Pts+Rebs,12,8,9,7
22023,203484,22300455,"JAN 01, 2024",DEN vs. CHA,W,29,2,6,0.333,0,3,0.0,1,1,1.0,0,3,3,4,1,0,0,3,5,28,1,Kentavious Caldwell-Pope,DEN,DEN,CHA,11.5,Pts+Asts,12,8,9,7
22023,203484,22300435,"DEC 29, 2023",DEN vs. OKC,L,27,3,5,0.6,2,3,0.667,0,1,0.0,0,0,0,2,1,0,1,3,8,-16,1,Kentavious Caldwell-Pope,DEN,DEN,OKC,9.5,Points,10,8,10,2
22023,203484,22300435,"DEC 29, 2023",DEN vs. OKC,L,27,3,5,0.6,2,3,0.667,0,1,0.0,0,0,0,2,1,0,1,3,8,-16,1,Kentavious Caldwell-Pope,DEN,DEN,OKC,19.5,Fantasy Score,10,8,10,2
22023,203484,22300435,"DEC 29, 2023",DEN vs. OKC,L,27,3,5,0.6,2,3,0.667,0,1,0.0,0,0,0,2,1,0,1,3,8,-16,1,Kentavious Caldwell-Pope,DEN,DEN,OKC,11.5,Pts+Rebs,10,8,10,2
22023,203484,22300435,"DEC 29, 2023",DEN vs. OKC,L,27,3,5,0.6,2,3,0.667,0,1,0.0,0,0,0,2,1,0,1,3,8,-16,1,Kentavious Caldwell-Pope,DEN,DEN,OKC,11.5,Pts+Asts,10,8,10,2
22023,203484,22300425,"DEC 28, 2023",DEN vs. MEM,W,25,5,10,0.5,2,5,0.4,0,0,0.0,2,0,2,3,0,1,0,2,12,27,1,Kentavious Caldwell-Pope,DEN,DEN,MEM,9.5,Points,17,14,15,5
22023,203484,22300425,"DEC 28, 2023",DEN vs. MEM,W,25,5,10,0.5,2,5,0.4,0,0,0.0,2,0,2,3,0,1,0,2,12,27,1,Kentavious Caldwell-Pope,DEN,DEN,MEM,19.5,Fantasy Score,17,14,15,5
22023,203484,22300425,"DEC 28, 2023",DEN vs. MEM,W,25,5,10,0.5,2,5,0.4,0,0,0.0,2,0,2,3,0,1,0,2,12,27,1,Kentavious Caldwell-Pope,DEN,DEN,MEM,11.5,Pts+Rebs,17,14,15,5
22023,203484,22300425,"DEC 28, 2023",DEN vs. MEM,W,25,5,10,0.5,2,5,0.4,0,0,0.0,2,0,2,3,0,1,0,2,12,27,1,Kentavious Caldwell-Pope,DEN,DEN,MEM,11.5,Pts+Asts,17,14,15,5
22023,203484,22300402,"DEC 25, 2023",DEN vs. GSW,W,37,6,13,0.462,4,9,0.444,0,0,0.0,1,3,4,5,2,0,0,1,16,15,1,Kentavious Caldwell-Pope,DEN,DEN,GSW,9.5,Points,25,20,21,9
22023,203484,22300402,"DEC 25, 2023",DEN vs. GSW,W,37,6,13,0.462,4,9,0.444,0,0,0.0,1,3,4,5,2,0,0,1,16,15,1,Kentavious Caldwell-Pope,DEN,DEN,GSW,19.5,Fantasy Score,25,20,21,9
22023,203484,22300402,"DEC 25, 2023",DEN vs. GSW,W,37,6,13,0.462,4,9,0.444,0,0,0.0,1,3,4,5,2,0,0,1,16,15,1,Kentavious Caldwell-Pope,DEN,DEN,GSW,11.5,Pts+Rebs,25,20,21,9
22023,203484,22300402,"DEC 25, 2023",DEN vs. GSW,W,37,6,13,0.462,4,9,0.444,0,0,0.0,1,3,4,5,2,0,0,1,16,15,1,Kentavious Caldwell-Pope,DEN,DEN,GSW,11.5,Pts+Asts,25,20,21,9
22023,203484,22300390,"DEC 23, 2023",DEN @ CHA,W,32,1,3,0.333,1,2,0.5,0,0,0.0,0,3,3,2,2,4,0,1,3,11,1,Kentavious Caldwell-Pope,DEN,CHA,DEN,9.5,Points,8,6,5,5
22023,203484,22300390,"DEC 23, 2023",DEN @ CHA,W,32,1,3,0.333,1,2,0.5,0,0,0.0,0,3,3,2,2,4,0,1,3,11,1,Kentavious Caldwell-Pope,DEN,CHA,DEN,19.5,Fantasy Score,8,6,5,5
22023,203484,22300390,"DEC 23, 2023",DEN @ CHA,W,32,1,3,0.333,1,2,0.5,0,0,0.0,0,3,3,2,2,4,0,1,3,11,1,Kentavious Caldwell-Pope,DEN,CHA,DEN,11.5,Pts+Rebs,8,6,5,5
22023,203484,22300390,"DEC 23, 2023",DEN @ CHA,W,32,1,3,0.333,1,2,0.5,0,0,0.0,0,3,3,2,2,4,0,1,3,11,1,Kentavious Caldwell-Pope,DEN,CHA,DEN,11.5,Pts+Asts,8,6,5,5
22023,203484,22300383,"DEC 22, 2023",DEN @ BKN,W,30,1,6,0.167,1,2,0.5,0,0,0.0,1,4,5,4,2,0,1,3,3,15,1,Kentavious Caldwell-Pope,DEN,BKN,DEN,9.5,Points,12,8,7,9
22023,203484,22300383,"DEC 22, 2023",DEN @ BKN,W,30,1,6,0.167,1,2,0.5,0,0,0.0,1,4,5,4,2,0,1,3,3,15,1,Kentavious Caldwell-Pope,DEN,BKN,DEN,19.5,Fantasy Score,12,8,7,9
22023,203484,22300383,"DEC 22, 2023",DEN @ BKN,W,30,1,6,0.167,1,2,0.5,0,0,0.0,1,4,5,4,2,0,1,3,3,15,1,Kentavious Caldwell-Pope,DEN,BKN,DEN,11.5,Pts+Rebs,12,8,7,9
22023,203484,22300383,"DEC 22, 2023",DEN @ BKN,W,30,1,6,0.167,1,2,0.5,0,0,0.0,1,4,5,4,2,0,1,3,3,15,1,Kentavious Caldwell-Pope,DEN,BKN,DEN,11.5,Pts+Asts,12,8,7,9
22023,203484,22300369,"DEC 20, 2023",DEN @ TOR,W,32,4,5,0.8,2,3,0.667,0,0,0.0,0,2,2,3,2,2,0,2,10,15,1,Kentavious Caldwell-Pope,DEN,TOR,DEN,9.5,Points,15,12,13,5
22023,203484,22300369,"DEC 20, 2023",DEN @ TOR,W,32,4,5,0.8,2,3,0.667,0,0,0.0,0,2,2,3,2,2,0,2,10,15,1,Kentavious Caldwell-Pope,DEN,TOR,DEN,19.5,Fantasy Score,15,12,13,5
22023,203484,22300369,"DEC 20, 2023",DEN @ TOR,W,32,4,5,0.8,2,3,0.667,0,0,0.0,0,2,2,3,2,2,0,2,10,15,1,Kentavious Caldwell-Pope,DEN,TOR,DEN,11.5,Pts+Rebs,15,12,13,5
22023,203484,22300369,"DEC 20, 2023",DEN @ TOR,W,32,4,5,0.8,2,3,0.667,0,0,0.0,0,2,2,3,2,2,0,2,10,15,1,Kentavious Caldwell-Pope,DEN,TOR,DEN,11.5,Pts+Asts,15,12,13,5
22023,203484,22300356,"DEC 18, 2023",DEN vs. DAL,W,26,4,6,0.667,1,2,0.5,0,0,0.0,1,2,3,2,0,0,0,0,9,17,1,Kentavious Caldwell-Pope,DEN,DEN,DAL,9.5,Points,14,12,11,5
22023,203484,22300356,"DEC 18, 2023",DEN vs. DAL,W,26,4,6,0.667,1,2,0.5,0,0,0.0,1,2,3,2,0,0,0,0,9,17,1,Kentavious Caldwell-Pope,DEN,DEN,DAL,19.5,Fantasy Score,14,12,11,5
22023,203484,22300356,"DEC 18, 2023",DEN vs. DAL,W,26,4,6,0.667,1,2,0.5,0,0,0.0,1,2,3,2,0,0,0,0,9,17,1,Kentavious Caldwell-Pope,DEN,DEN,DAL,11.5,Pts+Rebs,14,12,11,5
22023,203484,22300356,"DEC 18, 2023",DEN vs. DAL,W,26,4,6,0.667,1,2,0.5,0,0,0.0,1,2,3,2,0,0,0,0,9,17,1,Kentavious Caldwell-Pope,DEN,DEN,DAL,11.5,Pts+Asts,14,12,11,5
22023,203484,22300307,"DEC 12, 2023",DEN @ CHI,W,13,2,4,0.5,0,0,0.0,0,0,0.0,0,1,1,0,0,0,0,2,4,10,1,Kentavious Caldwell-Pope,DEN,CHI,DEN,9.5,Points,5,5,4,1
22023,203484,22300307,"DEC 12, 2023",DEN @ CHI,W,13,2,4,0.5,0,0,0.0,0,0,0.0,0,1,1,0,0,0,0,2,4,10,1,Kentavious Caldwell-Pope,DEN,CHI,DEN,19.5,Fantasy Score,5,5,4,1
22023,203484,22300307,"DEC 12, 2023",DEN @ CHI,W,13,2,4,0.5,0,0,0.0,0,0,0.0,0,1,1,0,0,0,0,2,4,10,1,Kentavious Caldwell-Pope,DEN,CHI,DEN,11.5,Pts+Rebs,5,5,4,1
22023,203484,22300307,"DEC 12, 2023",DEN @ CHI,W,13,2,4,0.5,0,0,0.0,0,0,0.0,0,1,1,0,0,0,0,2,4,10,1,Kentavious Caldwell-Pope,DEN,CHI,DEN,11.5,Pts+Asts,5,5,4,1
22023,203484,22300296,"DEC 11, 2023",DEN @ ATL,W,30,1,6,0.167,0,2,0.0,6,8,0.75,0,3,3,2,0,1,2,2,8,9,1,Kentavious Caldwell-Pope,DEN,ATL,DEN,9.5,Points,13,11,10,5
22023,203484,22300296,"DEC 11, 2023",DEN @ ATL,W,30,1,6,0.167,0,2,0.0,6,8,0.75,0,3,3,2,0,1,2,2,8,9,1,Kentavious Caldwell-Pope,DEN,ATL,DEN,19.5,Fantasy Score,13,11,10,5
22023,203484,22300296,"DEC 11, 2023",DEN @ ATL,W,30,1,6,0.167,0,2,0.0,6,8,0.75,0,3,3,2,0,1,2,2,8,9,1,Kentavious Caldwell-Pope,DEN,ATL,DEN,11.5,Pts+Rebs,13,11,10,5
22023,203484,22300296,"DEC 11, 2023",DEN @ ATL,W,30,1,6,0.167,0,2,0.0,6,8,0.75,0,3,3,2,0,1,2,2,8,9,1,Kentavious Caldwell-Pope,DEN,ATL,DEN,11.5,Pts+Asts,13,11,10,5
22023,203484,22301224,"DEC 08, 2023",DEN vs. HOU,L,25,5,6,0.833,2,3,0.667,2,2,1.0,0,0,0,0,0,1,0,1,14,-16,1,Kentavious Caldwell-Pope,DEN,DEN,HOU,9.5,Points,14,14,14,0
22023,203484,22301224,"DEC 08, 2023",DEN vs. HOU,L,25,5,6,0.833,2,3,0.667,2,2,1.0,0,0,0,0,0,1,0,1,14,-16,1,Kentavious Caldwell-Pope,DEN,DEN,HOU,19.5,Fantasy Score,14,14,14,0
22023,203484,22301224,"DEC 08, 2023",DEN vs. HOU,L,25,5,6,0.833,2,3,0.667,2,2,1.0,0,0,0,0,0,1,0,1,14,-16,1,Kentavious Caldwell-Pope,DEN,DEN,HOU,11.5,Pts+Rebs,14,14,14,0
22023,203484,22301224,"DEC 08, 2023",DEN vs. HOU,L,25,5,6,0.833,2,3,0.667,2,2,1.0,0,0,0,0,0,1,0,1,14,-16,1,Kentavious Caldwell-Pope,DEN,DEN,HOU,11.5,Pts+Asts,14,14,14,0
22023,203484,22301215,"DEC 06, 2023",DEN @ LAC,L,34,1,4,0.25,1,3,0.333,0,0,0.0,0,1,1,3,1,0,0,1,3,2,1,Kentavious Caldwell-Pope,DEN,LAC,DEN,9.5,Points,7,4,6,4
22023,203484,22301215,"DEC 06, 2023",DEN @ LAC,L,34,1,4,0.25,1,3,0.333,0,0,0.0,0,1,1,3,1,0,0,1,3,2,1,Kentavious Caldwell-Pope,DEN,LAC,DEN,19.5,Fantasy Score,7,4,6,4
22023,203484,22301215,"DEC 06, 2023",DEN @ LAC,L,34,1,4,0.25,1,3,0.333,0,0,0.0,0,1,1,3,1,0,0,1,3,2,1,Kentavious Caldwell-Pope,DEN,LAC,DEN,11.5,Pts+Rebs,7,4,6,4
22023,203484,22301215,"DEC 06, 2023",DEN @ LAC,L,34,1,4,0.25,1,3,0.333,0,0,0.0,0,1,1,3,1,0,0,1,3,2,1,Kentavious Caldwell-Pope,DEN,LAC,DEN,11.5,Pts+Asts,7,4,6,4
22023,203484,22300290,"DEC 02, 2023",DEN @ SAC,L,38,4,12,0.333,0,3,0.0,1,2,0.5,0,5,5,3,4,0,4,1,9,9,1,Kentavious Caldwell-Pope,DEN,SAC,DEN,9.5,Points,17,14,12,8
22023,203484,22300290,"DEC 02, 2023",DEN @ SAC,L,38,4,12,0.333,0,3,0.0,1,2,0.5,0,5,5,3,4,0,4,1,9,9,1,Kentavious Caldwell-Pope,DEN,SAC,DEN,19.5,Fantasy Score,17,14,12,8
22023,203484,22300290,"DEC 02, 2023",DEN @ SAC,L,38,4,12,0.333,0,3,0.0,1,2,0.5,0,5,5,3,4,0,4,1,9,9,1,Kentavious Caldwell-Pope,DEN,SAC,DEN,11.5,Pts+Rebs,17,14,12,8
22023,203484,22300290,"DEC 02, 2023",DEN @ SAC,L,38,4,12,0.333,0,3,0.0,1,2,0.5,0,5,5,3,4,0,4,1,9,9,1,Kentavious Caldwell-Pope,DEN,SAC,DEN,11.5,Pts+Asts,17,14,12,8
22023,203484,22300279,"DEC 01, 2023",DEN @ PHX,W,35,6,10,0.6,3,6,0.5,0,0,0.0,0,1,1,6,3,0,0,2,15,6,1,Kentavious Caldwell-Pope,DEN,PHX,DEN,9.5,Points,22,16,21,7
22023,203484,22300279,"DEC 01, 2023",DEN @ PHX,W,35,6,10,0.6,3,6,0.5,0,0,0.0,0,1,1,6,3,0,0,2,15,6,1,Kentavious Caldwell-Pope,DEN,PHX,DEN,19.5,Fantasy Score,22,16,21,7
22023,203484,22300279,"DEC 01, 2023",DEN @ PHX,W,35,6,10,0.6,3,6,0.5,0,0,0.0,0,1,1,6,3,0,0,2,15,6,1,Kentavious Caldwell-Pope,DEN,PHX,DEN,11.5,Pts+Rebs,22,16,21,7
22023,203484,22300279,"DEC 01, 2023",DEN @ PHX,W,35,6,10,0.6,3,6,0.5,0,0,0.0,0,1,1,6,3,0,0,2,15,6,1,Kentavious Caldwell-Pope,DEN,PHX,DEN,11.5,Pts+Asts,22,16,21,7
22023,203484,22300263,"NOV 29, 2023",DEN vs. HOU,W,32,4,6,0.667,2,3,0.667,0,0,0.0,0,1,1,2,0,0,0,0,10,21,1,Kentavious Caldwell-Pope,DEN,DEN,HOU,9.5,Points,13,11,12,3
22023,203484,22300263,"NOV 29, 2023",DEN vs. HOU,W,32,4,6,0.667,2,3,0.667,0,0,0.0,0,1,1,2,0,0,0,0,10,21,1,Kentavious Caldwell-Pope,DEN,DEN,HOU,19.5,Fantasy Score,13,11,12,3
22023,203484,22300263,"NOV 29, 2023",DEN vs. HOU,W,32,4,6,0.667,2,3,0.667,0,0,0.0,0,1,1,2,0,0,0,0,10,21,1,Kentavious Caldwell-Pope,DEN,DEN,HOU,11.5,Pts+Rebs,13,11,12,3
22023,203484,22300263,"NOV 29, 2023",DEN vs. HOU,W,32,4,6,0.667,2,3,0.667,0,0,0.0,0,1,1,2,0,0,0,0,10,21,1,Kentavious Caldwell-Pope,DEN,DEN,HOU,11.5,Pts+Asts,13,11,12,3
22023,203484,22300257,"NOV 27, 2023",DEN @ LAC,W,38,3,14,0.214,0,1,0.0,6,6,1.0,2,1,3,2,1,0,0,2,12,15,1,Kentavious Caldwell-Pope,DEN,LAC,DEN,9.5,Points,17,15,14,5
22023,203484,22300257,"NOV 27, 2023",DEN @ LAC,W,38,3,14,0.214,0,1,0.0,6,6,1.0,2,1,3,2,1,0,0,2,12,15,1,Kentavious Caldwell-Pope,DEN,LAC,DEN,19.5,Fantasy Score,17,15,14,5
22023,203484,22300257,"NOV 27, 2023",DEN @ LAC,W,38,3,14,0.214,0,1,0.0,6,6,1.0,2,1,3,2,1,0,0,2,12,15,1,Kentavious Caldwell-Pope,DEN,LAC,DEN,11.5,Pts+Rebs,17,15,14,5
22023,203484,22300257,"NOV 27, 2023",DEN @ LAC,W,38,3,14,0.214,0,1,0.0,6,6,1.0,2,1,3,2,1,0,0,2,12,15,1,Kentavious Caldwell-Pope,DEN,LAC,DEN,11.5,Pts+Asts,17,15,14,5
22023,203484,22300252,"NOV 26, 2023",DEN vs. SAS,W,31,5,7,0.714,2,4,0.5,4,4,1.0,0,1,1,6,1,0,3,3,16,6,1,Kentavious Caldwell-Pope,DEN,DEN,SAS,9.5,Points,23,17,22,7
22023,203484,22300252,"NOV 26, 2023",DEN vs. SAS,W,31,5,7,0.714,2,4,0.5,4,4,1.0,0,1,1,6,1,0,3,3,16,6,1,Kentavious Caldwell-Pope,DEN,DEN,SAS,19.5,Fantasy Score,23,17,22,7
22023,203484,22300252,"NOV 26, 2023",DEN vs. SAS,W,31,5,7,0.714,2,4,0.5,4,4,1.0,0,1,1,6,1,0,3,3,16,6,1,Kentavious Caldwell-Pope,DEN,DEN,SAS,11.5,Pts+Rebs,23,17,22,7
22023,203484,22300252,"NOV 26, 2023",DEN vs. SAS,W,31,5,7,0.714,2,4,0.5,4,4,1.0,0,1,1,6,1,0,3,3,16,6,1,Kentavious Caldwell-Pope,DEN,DEN,SAS,11.5,Pts+Asts,23,17,22,7
22023,203484,22300048,"NOV 24, 2023",DEN @ HOU,L,39,7,15,0.467,1,5,0.2,5,5,1.0,3,2,5,3,3,0,2,4,20,-7,1,Kentavious Caldwell-Pope,DEN,HOU,DEN,9.5,Points,28,25,23,8
22023,203484,22300048,"NOV 24, 2023",DEN @ HOU,L,39,7,15,0.467,1,5,0.2,5,5,1.0,3,2,5,3,3,0,2,4,20,-7,1,Kentavious Caldwell-Pope,DEN,HOU,DEN,19.5,Fantasy Score,28,25,23,8
22023,203484,22300048,"NOV 24, 2023",DEN @ HOU,L,39,7,15,0.467,1,5,0.2,5,5,1.0,3,2,5,3,3,0,2,4,20,-7,1,Kentavious Caldwell-Pope,DEN,HOU,DEN,11.5,Pts+Rebs,28,25,23,8
22023,203484,22300048,"NOV 24, 2023",DEN @ HOU,L,39,7,15,0.467,1,5,0.2,5,5,1.0,3,2,5,3,3,0,2,4,20,-7,1,Kentavious Caldwell-Pope,DEN,HOU,DEN,11.5,Pts+Asts,28,25,23,8
22023,203484,22300226,"NOV 22, 2023",DEN @ ORL,L,34,3,8,0.375,2,5,0.4,2,2,1.0,0,1,1,2,0,0,2,2,10,5,1,Kentavious Caldwell-Pope,DEN,ORL,DEN,9.5,Points,13,11,12,3
22023,203484,22300226,"NOV 22, 2023",DEN @ ORL,L,34,3,8,0.375,2,5,0.4,2,2,1.0,0,1,1,2,0,0,2,2,10,5,1,Kentavious Caldwell-Pope,DEN,ORL,DEN,19.5,Fantasy Score,13,11,12,3
22023,203484,22300226,"NOV 22, 2023",DEN @ ORL,L,34,3,8,0.375,2,5,0.4,2,2,1.0,0,1,1,2,0,0,2,2,10,5,1,Kentavious Caldwell-Pope,DEN,ORL,DEN,11.5,Pts+Rebs,13,11,12,3
22023,203484,22300226,"NOV 22, 2023",DEN @ ORL,L,34,3,8,0.375,2,5,0.4,2,2,1.0,0,1,1,2,0,0,2,2,10,5,1,Kentavious Caldwell-Pope,DEN,ORL,DEN,11.5,Pts+Asts,13,11,12,3
22023,203484,22300218,"NOV 20, 2023",DEN @ DET,W,36,8,17,0.471,2,5,0.4,2,2,1.0,1,2,3,3,2,1,3,2,20,3,1,Kentavious Caldwell-Pope,DEN,DET,DEN,9.5,Points,26,23,23,6
22023,203484,22300218,"NOV 20, 2023",DEN @ DET,W,36,8,17,0.471,2,5,0.4,2,2,1.0,1,2,3,3,2,1,3,2,20,3,1,Kentavious Caldwell-Pope,DEN,DET,DEN,19.5,Fantasy Score,26,23,23,6
22023,203484,22300218,"NOV 20, 2023",DEN @ DET,W,36,8,17,0.471,2,5,0.4,2,2,1.0,1,2,3,3,2,1,3,2,20,3,1,Kentavious Caldwell-Pope,DEN,DET,DEN,11.5,Pts+Rebs,26,23,23,6
22023,203484,22300218,"NOV 20, 2023",DEN @ DET,W,36,8,17,0.471,2,5,0.4,2,2,1.0,1,2,3,3,2,1,3,2,20,3,1,Kentavious Caldwell-Pope,DEN,DET,DEN,11.5,Pts+Asts,26,23,23,6
22023,203484,22300210,"NOV 19, 2023",DEN @ CLE,L,31,2,9,0.222,1,5,0.2,4,4,1.0,2,0,2,2,1,1,1,1,9,-13,1,Kentavious Caldwell-Pope,DEN,CLE,DEN,9.5,Points,13,11,11,4
22023,203484,22300210,"NOV 19, 2023",DEN @ CLE,L,31,2,9,0.222,1,5,0.2,4,4,1.0,2,0,2,2,1,1,1,1,9,-13,1,Kentavious Caldwell-Pope,DEN,CLE,DEN,19.5,Fantasy Score,13,11,11,4
22023,203484,22300210,"NOV 19, 2023",DEN @ CLE,L,31,2,9,0.222,1,5,0.2,4,4,1.0,2,0,2,2,1,1,1,1,9,-13,1,Kentavious Caldwell-Pope,DEN,CLE,DEN,11.5,Pts+Rebs,13,11,11,4
22023,203484,22300210,"NOV 19, 2023",DEN @ CLE,L,31,2,9,0.222,1,5,0.2,4,4,1.0,2,0,2,2,1,1,1,1,9,-13,1,Kentavious Caldwell-Pope,DEN,CLE,DEN,11.5,Pts+Asts,13,11,11,4
22023,203484,22300034,"NOV 17, 2023",DEN @ NOP,L,35,3,7,0.429,2,4,0.5,0,0,0.0,0,1,1,8,1,2,0,0,8,4,1,Kentavious Caldwell-Pope,DEN,NOP,DEN,9.5,Points,17,9,16,9
22023,203484,22300034,"NOV 17, 2023",DEN @ NOP,L,35,3,7,0.429,2,4,0.5,0,0,0.0,0,1,1,8,1,2,0,0,8,4,1,Kentavious Caldwell-Pope,DEN,NOP,DEN,19.5,Fantasy Score,17,9,16,9
22023,203484,22300034,"NOV 17, 2023",DEN @ NOP,L,35,3,7,0.429,2,4,0.5,0,0,0.0,0,1,1,8,1,2,0,0,8,4,1,Kentavious Caldwell-Pope,DEN,NOP,DEN,11.5,Pts+Rebs,17,9,16,9
22023,203484,22300034,"NOV 17, 2023",DEN @ NOP,L,35,3,7,0.429,2,4,0.5,0,0,0.0,0,1,1,8,1,2,0,0,8,4,1,Kentavious Caldwell-Pope,DEN,NOP,DEN,11.5,Pts+Asts,17,9,16,9
22023,203484,22300024,"NOV 14, 2023",DEN vs. LAC,W,39,2,3,0.667,2,3,0.667,3,5,0.6,0,1,1,4,1,0,1,3,9,3,1,Kentavious Caldwell-Pope,DEN,DEN,LAC,9.5,Points,14,10,13,5
22023,203484,22300024,"NOV 14, 2023",DEN vs. LAC,W,39,2,3,0.667,2,3,0.667,3,5,0.6,0,1,1,4,1,0,1,3,9,3,1,Kentavious Caldwell-Pope,DEN,DEN,LAC,19.5,Fantasy Score,14,10,13,5
22023,203484,22300024,"NOV 14, 2023",DEN vs. LAC,W,39,2,3,0.667,2,3,0.667,3,5,0.6,0,1,1,4,1,0,1,3,9,3,1,Kentavious Caldwell-Pope,DEN,DEN,LAC,11.5,Pts+Rebs,14,10,13,5
22023,203484,22300024,"NOV 14, 2023",DEN vs. LAC,W,39,2,3,0.667,2,3,0.667,3,5,0.6,0,1,1,4,1,0,1,3,9,3,1,Kentavious Caldwell-Pope,DEN,DEN,LAC,11.5,Pts+Asts,14,10,13,5
22023,203484,22300182,"NOV 12, 2023",DEN @ HOU,L,38,2,5,0.4,1,2,0.5,0,0,0.0,0,0,0,1,1,0,1,3,5,6,1,Kentavious Caldwell-Pope,DEN,HOU,DEN,9.5,Points,6,5,6,1
22023,203484,22300182,"NOV 12, 2023",DEN @ HOU,L,38,2,5,0.4,1,2,0.5,0,0,0.0,0,0,0,1,1,0,1,3,5,6,1,Kentavious Caldwell-Pope,DEN,HOU,DEN,19.5,Fantasy Score,6,5,6,1
22023,203484,22300182,"NOV 12, 2023",DEN @ HOU,L,38,2,5,0.4,1,2,0.5,0,0,0.0,0,0,0,1,1,0,1,3,5,6,1,Kentavious Caldwell-Pope,DEN,HOU,DEN,11.5,Pts+Rebs,6,5,6,1
22023,203484,22300182,"NOV 12, 2023",DEN @ HOU,L,38,2,5,0.4,1,2,0.5,0,0,0.0,0,0,0,1,1,0,1,3,5,6,1,Kentavious Caldwell-Pope,DEN,HOU,DEN,11.5,Pts+Asts,6,5,6,1
22023,203484,22300169,"NOV 08, 2023",DEN vs. GSW,W,35,3,8,0.375,0,3,0.0,4,4,1.0,1,2,3,3,1,0,0,3,10,13,1,Kentavious Caldwell-Pope,DEN,DEN,GSW,9.5,Points,16,13,13,6
22023,203484,22300169,"NOV 08, 2023",DEN vs. GSW,W,35,3,8,0.375,0,3,0.0,4,4,1.0,1,2,3,3,1,0,0,3,10,13,1,Kentavious Caldwell-Pope,DEN,DEN,GSW,19.5,Fantasy Score,16,13,13,6
22023,203484,22300169,"NOV 08, 2023",DEN vs. GSW,W,35,3,8,0.375,0,3,0.0,4,4,1.0,1,2,3,3,1,0,0,3,10,13,1,Kentavious Caldwell-Pope,DEN,DEN,GSW,11.5,Pts+Rebs,16,13,13,6
22023,203484,22300169,"NOV 08, 2023",DEN vs. GSW,W,35,3,8,0.375,0,3,0.0,4,4,1.0,1,2,3,3,1,0,0,3,10,13,1,Kentavious Caldwell-Pope,DEN,DEN,GSW,11.5,Pts+Asts,16,13,13,6
22023,203484,22300156,"NOV 06, 2023",DEN vs. NOP,W,33,5,10,0.5,3,7,0.429,2,2,1.0,0,1,1,7,1,0,2,4,15,23,1,Kentavious Caldwell-Pope,DEN,DEN,NOP,9.5,Points,23,16,22,8
22023,203484,22300156,"NOV 06, 2023",DEN vs. NOP,W,33,5,10,0.5,3,7,0.429,2,2,1.0,0,1,1,7,1,0,2,4,15,23,1,Kentavious Caldwell-Pope,DEN,DEN,NOP,19.5,Fantasy Score,23,16,22,8
22023,203484,22300156,"NOV 06, 2023",DEN vs. NOP,W,33,5,10,0.5,3,7,0.429,2,2,1.0,0,1,1,7,1,0,2,4,15,23,1,Kentavious Caldwell-Pope,DEN,DEN,NOP,11.5,Pts+Rebs,23,16,22,8
22023,203484,22300156,"NOV 06, 2023",DEN vs. NOP,W,33,5,10,0.5,3,7,0.429,2,2,1.0,0,1,1,7,1,0,2,4,15,23,1,Kentavious Caldwell-Pope,DEN,DEN,NOP,11.5,Pts+Asts,23,16,22,8
22023,203484,22300139,"NOV 04, 2023",DEN vs. CHI,W,30,4,8,0.5,2,4,0.5,0,0,0.0,0,0,0,2,1,0,1,1,10,29,1,Kentavious Caldwell-Pope,DEN,DEN,CHI,9.5,Points,12,10,12,2
22023,203484,22300139,"NOV 04, 2023",DEN vs. CHI,W,30,4,8,0.5,2,4,0.5,0,0,0.0,0,0,0,2,1,0,1,1,10,29,1,Kentavious Caldwell-Pope,DEN,DEN,CHI,19.5,Fantasy Score,12,10,12,2
22023,203484,22300139,"NOV 04, 2023",DEN vs. CHI,W,30,4,8,0.5,2,4,0.5,0,0,0.0,0,0,0,2,1,0,1,1,10,29,1,Kentavious Caldwell-Pope,DEN,DEN,CHI,11.5,Pts+Rebs,12,10,12,2
22023,203484,22300139,"NOV 04, 2023",DEN vs. CHI,W,30,4,8,0.5,2,4,0.5,0,0,0.0,0,0,0,2,1,0,1,1,10,29,1,Kentavious Caldwell-Pope,DEN,DEN,CHI,11.5,Pts+Asts,12,10,12,2
22023,203484,22300006,"NOV 03, 2023",DEN vs. DAL,W,37,3,7,0.429,2,3,0.667,0,0,0.0,0,5,5,1,2,0,1,0,8,15,1,Kentavious Caldwell-Pope,DEN,DEN,DAL,9.5,Points,14,13,9,6
22023,203484,22300006,"NOV 03, 2023",DEN vs. DAL,W,37,3,7,0.429,2,3,0.667,0,0,0.0,0,5,5,1,2,0,1,0,8,15,1,Kentavious Caldwell-Pope,DEN,DEN,DAL,19.5,Fantasy Score,14,13,9,6
22023,203484,22300006,"NOV 03, 2023",DEN vs. DAL,W,37,3,7,0.429,2,3,0.667,0,0,0.0,0,5,5,1,2,0,1,0,8,15,1,Kentavious Caldwell-Pope,DEN,DEN,DAL,11.5,Pts+Rebs,14,13,9,6
22023,203484,22300006,"NOV 03, 2023",DEN vs. DAL,W,37,3,7,0.429,2,3,0.667,0,0,0.0,0,5,5,1,2,0,1,0,8,15,1,Kentavious Caldwell-Pope,DEN,DEN,DAL,11.5,Pts+Asts,14,13,9,6
22023,203484,22300123,"NOV 01, 2023",DEN @ MIN,L,26,2,4,0.5,1,1,1.0,1,1,1.0,0,0,0,0,1,1,1,2,6,-20,1,Kentavious Caldwell-Pope,DEN,MIN,DEN,9.5,Points,6,6,6,0
22023,203484,22300123,"NOV 01, 2023",DEN @ MIN,L,26,2,4,0.5,1,1,1.0,1,1,1.0,0,0,0,0,1,1,1,2,6,-20,1,Kentavious Caldwell-Pope,DEN,MIN,DEN,19.5,Fantasy Score,6,6,6,0
22023,203484,22300123,"NOV 01, 2023",DEN @ MIN,L,26,2,4,0.5,1,1,1.0,1,1,1.0,0,0,0,0,1,1,1,2,6,-20,1,Kentavious Caldwell-Pope,DEN,MIN,DEN,11.5,Pts+Rebs,6,6,6,0
22023,203484,22300123,"NOV 01, 2023",DEN @ MIN,L,26,2,4,0.5,1,1,1.0,1,1,1.0,0,0,0,0,1,1,1,2,6,-20,1,Kentavious Caldwell-Pope,DEN,MIN,DEN,11.5,Pts+Asts,6,6,6,0
22023,203484,22300110,"OCT 30, 2023",DEN vs. UTA,W,33,3,5,0.6,2,4,0.5,0,0,0.0,0,3,3,0,1,2,2,4,8,11,1,Kentavious Caldwell-Pope,DEN,DEN,UTA,9.5,Points,11,11,8,3
22023,203484,22300110,"OCT 30, 2023",DEN vs. UTA,W,33,3,5,0.6,2,4,0.5,0,0,0.0,0,3,3,0,1,2,2,4,8,11,1,Kentavious Caldwell-Pope,DEN,DEN,UTA,19.5,Fantasy Score,11,11,8,3
22023,203484,22300110,"OCT 30, 2023",DEN vs. UTA,W,33,3,5,0.6,2,4,0.5,0,0,0.0,0,3,3,0,1,2,2,4,8,11,1,Kentavious Caldwell-Pope,DEN,DEN,UTA,11.5,Pts+Rebs,11,11,8,3
22023,203484,22300110,"OCT 30, 2023",DEN vs. UTA,W,33,3,5,0.6,2,4,0.5,0,0,0.0,0,3,3,0,1,2,2,4,8,11,1,Kentavious Caldwell-Pope,DEN,DEN,UTA,11.5,Pts+Asts,11,11,8,3
22023,203484,22300095,"OCT 29, 2023",DEN @ OKC,W,30,2,5,0.4,1,4,0.25,2,2,1.0,0,3,3,1,2,0,1,2,7,21,1,Kentavious Caldwell-Pope,DEN,OKC,DEN,9.5,Points,11,10,8,4
22023,203484,22300095,"OCT 29, 2023",DEN @ OKC,W,30,2,5,0.4,1,4,0.25,2,2,1.0,0,3,3,1,2,0,1,2,7,21,1,Kentavious Caldwell-Pope,DEN,OKC,DEN,19.5,Fantasy Score,11,10,8,4
22023,203484,22300095,"OCT 29, 2023",DEN @ OKC,W,30,2,5,0.4,1,4,0.25,2,2,1.0,0,3,3,1,2,0,1,2,7,21,1,Kentavious Caldwell-Pope,DEN,OKC,DEN,11.5,Pts+Rebs,11,10,8,4
22023,203484,22300095,"OCT 29, 2023",DEN @ OKC,W,30,2,5,0.4,1,4,0.25,2,2,1.0,0,3,3,1,2,0,1,2,7,21,1,Kentavious Caldwell-Pope,DEN,OKC,DEN,11.5,Pts+Asts,11,10,8,4
22023,203484,22300078,"OCT 27, 2023",DEN @ MEM,W,35,3,10,0.3,2,6,0.333,0,0,0.0,0,2,2,1,5,1,0,1,8,6,1,Kentavious Caldwell-Pope,DEN,MEM,DEN,9.5,Points,11,10,9,3
22023,203484,22300078,"OCT 27, 2023",DEN @ MEM,W,35,3,10,0.3,2,6,0.333,0,0,0.0,0,2,2,1,5,1,0,1,8,6,1,Kentavious Caldwell-Pope,DEN,MEM,DEN,19.5,Fantasy Score,11,10,9,3
22023,203484,22300078,"OCT 27, 2023",DEN @ MEM,W,35,3,10,0.3,2,6,0.333,0,0,0.0,0,2,2,1,5,1,0,1,8,6,1,Kentavious Caldwell-Pope,DEN,MEM,DEN,11.5,Pts+Rebs,11,10,9,3
22023,203484,22300078,"OCT 27, 2023",DEN @ MEM,W,35,3,10,0.3,2,6,0.333,0,0,0.0,0,2,2,1,5,1,0,1,8,6,1,Kentavious Caldwell-Pope,DEN,MEM,DEN,11.5,Pts+Asts,11,10,9,3
22023,203484,22300061,"OCT 24, 2023",DEN vs. LAL,W,36,8,12,0.667,2,3,0.667,2,2,1.0,1,1,2,1,3,1,3,5,20,10,1,Kentavious Caldwell-Pope,DEN,DEN,LAL,9.5,Points,23,22,21,3
22023,203484,22300061,"OCT 24, 2023",DEN vs. LAL,W,36,8,12,0.667,2,3,0.667,2,2,1.0,1,1,2,1,3,1,3,5,20,10,1,Kentavious Caldwell-Pope,DEN,DEN,LAL,19.5,Fantasy Score,23,22,21,3
22023,203484,22300061,"OCT 24, 2023",DEN vs. LAL,W,36,8,12,0.667,2,3,0.667,2,2,1.0,1,1,2,1,3,1,3,5,20,10,1,Kentavious Caldwell-Pope,DEN,DEN,LAL,11.5,Pts+Rebs,23,22,21,3
22023,203484,22300061,"OCT 24, 2023",DEN vs. LAL,W,36,8,12,0.667,2,3,0.667,2,2,1.0,1,1,2,1,3,1,3,5,20,10,1,Kentavious Caldwell-Pope,DEN,DEN,LAL,11.5,Pts+Asts,23,22,21,3
22023,1641739,22300554,"JAN 14, 2024",POR vs. PHX,L,23,1,4,0.25,0,2,0.0,0,0,0.0,2,0,2,2,0,0,0,1,2,-6,1,Toumani Camara,POR,POR,PHX,,,6,4,4,4
22023,1641739,22300538,"JAN 12, 2024",POR @ MIN,L,25,5,8,0.625,1,3,0.333,3,4,0.75,2,3,5,0,0,1,3,1,14,-15,1,Toumani Camara,POR,MIN,POR,,,19,19,14,5
22023,1641739,22300529,"JAN 11, 2024",POR @ OKC,L,32,2,9,0.222,1,6,0.167,1,2,0.5,2,3,5,1,2,2,2,3,6,-38,1,Toumani Camara,POR,OKC,POR,,,12,11,7,6
22023,1641739,22300514,"JAN 09, 2024",POR @ NYK,L,26,2,4,0.5,1,3,0.333,0,0,0.0,3,3,6,2,1,2,2,3,5,-3,1,Toumani Camara,POR,NYK,POR,,,13,11,7,8
22023,1641739,22300498,"JAN 07, 2024",POR @ BKN,W,29,1,4,0.25,0,2,0.0,3,4,0.75,1,5,6,1,1,0,2,4,5,0,1,Toumani Camara,POR,BKN,POR,,,12,11,6,7
22023,1641739,22300487,"JAN 05, 2024",POR @ DAL,L,24,4,10,0.4,2,7,0.286,0,1,0.0,1,6,7,1,1,0,2,2,10,-11,1,Toumani Camara,POR,DAL,POR,,,18,17,11,8
22023,1641739,22300472,"JAN 03, 2024",POR @ DAL,L,20,3,8,0.375,2,4,0.5,2,3,0.667,2,3,5,0,2,1,2,6,10,-11,1,Toumani Camara,POR,DAL,POR,,,15,15,10,5
22023,1641739,22300437,"DEC 29, 2023",POR vs. SAS,W,36,6,12,0.5,1,3,0.333,0,0,0.0,4,7,11,2,3,0,3,1,13,9,1,Toumani Camara,POR,POR,SAS,,,26,24,15,13
22023,1641739,22300427,"DEC 28, 2023",POR vs. SAS,L,21,0,5,0.0,0,1,0.0,1,2,0.5,3,4,7,0,0,0,1,1,1,-11,1,Toumani Camara,POR,POR,SAS,,,8,8,1,7
22023,1641739,22300413,"DEC 26, 2023",POR vs. SAC,W,18,2,5,0.4,0,1,0.0,0,0,0.0,2,1,3,1,0,0,1,1,4,0,1,Toumani Camara,POR,POR,SAC,,,8,7,5,4
22023,1641739,22300399,"DEC 23, 2023",POR @ GSW,L,25,2,3,0.667,0,0,0.0,2,2,1.0,0,2,2,0,1,1,1,1,6,-2,1,Toumani Camara,POR,GSW,POR,,,8,8,6,2
22023,1641739,22300381,"DEC 21, 2023",POR vs. WAS,L,18,2,3,0.667,0,1,0.0,0,0,0.0,1,2,3,0,1,0,0,3,4,-16,1,Toumani Camara,POR,POR,WAS,,,7,7,4,3
22023,1641739,22300363,"DEC 19, 2023",POR vs. PHX,W,22,2,4,0.5,1,1,1.0,0,0,0.0,3,6,9,0,3,1,2,3,5,-8,1,Toumani Camara,POR,POR,PHX,,,14,14,5,9
22023,1641739,22300348,"DEC 17, 2023",POR vs. GSW,L,22,3,4,0.75,3,3,1.0,2,4,0.5,1,2,3,0,2,0,1,2,11,-5,1,Toumani Camara,POR,POR,GSW,,,14,14,11,3
22023,1641739,22300341,"DEC 16, 2023",POR vs. DAL,L,20,3,7,0.429,0,4,0.0,2,2,1.0,0,3,3,1,1,0,0,3,8,5,1,Toumani Camara,POR,POR,DAL,,,12,11,9,4
22023,1641739,22300323,"DEC 14, 2023",POR vs. UTA,L,24,7,10,0.7,3,4,0.75,1,2,0.5,4,2,6,0,0,0,1,3,18,-24,1,Toumani Camara,POR,POR,UTA,,,24,24,18,6
22023,1641739,22300304,"DEC 11, 2023",POR @ LAC,L,37,3,6,0.5,1,3,0.333,0,2,0.0,0,4,4,4,1,1,1,5,7,-5,1,Toumani Camara,POR,LAC,POR,,,15,11,11,8
22023,1641739,22301226,"DEC 08, 2023",POR vs. DAL,L,32,6,20,0.3,2,10,0.2,0,0,0.0,6,3,9,0,1,0,0,5,14,-23,1,Toumani Camara,POR,POR,DAL,,,23,23,14,9
22023,1641739,22301214,"DEC 06, 2023",POR @ GSW,L,27,3,14,0.214,0,4,0.0,0,0,0.0,5,8,13,2,0,0,3,6,6,-3,1,Toumani Camara,POR,GSW,POR,,,21,19,8,15
22023,1641739,22300289,"DEC 02, 2023",POR @ UTA,L,30,4,8,0.5,0,3,0.0,0,0,0.0,2,1,3,0,4,1,0,4,8,-5,1,Toumani Camara,POR,UTA,POR,,,11,11,8,3
22023,1641739,22300265,"NOV 30, 2023",POR @ CLE,W,24,4,6,0.667,1,3,0.333,0,0,0.0,1,1,2,1,2,1,1,0,9,-2,1,Toumani Camara,POR,CLE,POR,,,12,11,10,3
22023,1641739,22300254,"NOV 27, 2023",POR @ IND,W,17,1,3,0.333,1,2,0.5,2,2,1.0,2,0,2,0,0,0,0,2,5,0,1,Toumani Camara,POR,IND,POR,,,7,7,5,2
22023,1641739,22300245,"NOV 26, 2023",POR @ MIL,L,17,2,3,0.667,2,2,1.0,0,0,0.0,2,1,3,0,0,0,2,4,6,-3,1,Toumani Camara,POR,MIL,POR,,,9,9,6,3
22023,1641739,22300237,"NOV 22, 2023",POR vs. UTA,W,28,4,8,0.5,2,4,0.5,2,2,1.0,3,4,7,3,0,1,2,2,12,15,1,Toumani Camara,POR,POR,UTA,,,22,19,15,10
22023,1641739,22300041,"NOV 21, 2023",POR @ PHX,L,39,2,4,0.5,0,2,0.0,3,4,0.75,0,4,4,0,1,0,1,4,7,-16,1,Toumani Camara,POR,PHX,POR,,,11,11,7,4
22023,1641739,22300215,"NOV 19, 2023",POR vs. OKC,L,15,3,5,0.6,0,2,0.0,0,0,0.0,0,2,2,0,0,0,1,4,6,-15,1,Toumani Camara,POR,POR,OKC,,,8,8,6,2
22023,1641739,22300036,"NOV 17, 2023",POR vs. LAL,L,36,3,8,0.375,1,6,0.167,3,5,0.6,2,4,6,0,2,1,1,3,10,-7,1,Toumani Camara,POR,POR,LAL,,,16,16,10,6
22023,1641739,22300199,"NOV 15, 2023",POR vs. CLE,L,22,0,4,0.0,0,3,0.0,0,0,0.0,0,1,1,3,2,0,1,1,0,-12,1,Toumani Camara,POR,POR,CLE,,,4,1,3,4
22023,1641739,22300023,"NOV 14, 2023",POR @ UTA,L,26,3,6,0.5,2,4,0.5,1,2,0.5,2,3,5,1,0,2,2,2,9,-8,1,Toumani Camara,POR,UTA,POR,,,15,14,10,6
22023,1641739,22300187,"NOV 12, 2023",POR @ LAL,L,24,1,3,0.333,0,2,0.0,0,0,0.0,4,2,6,2,0,1,2,5,2,0,1,Toumani Camara,POR,LAL,POR,,,10,8,4,8
22023,1641739,22300170,"NOV 08, 2023",POR @ SAC,L,25,1,2,0.5,0,0,0.0,0,0,0.0,1,3,4,1,3,0,1,3,2,7,1,Toumani Camara,POR,SAC,POR,,,7,6,3,5
22023,1641739,22300144,"NOV 05, 2023",POR vs. MEM,L,24,3,5,0.6,2,3,0.667,0,0,0.0,3,3,6,2,1,0,3,1,8,-4,1,Toumani Camara,POR,POR,MEM,,,16,14,10,8
22023,1641739,22300007,"NOV 03, 2023",POR vs. MEM,W,31,2,8,0.25,0,3,0.0,1,1,1.0,3,0,3,1,2,0,1,4,5,2,1,Toumani Camara,POR,POR,MEM,,,9,8,6,4
22023,1641739,22300115,"NOV 01, 2023",POR @ DET,W,26,2,3,0.667,0,0,0.0,3,3,1.0,2,5,7,0,1,1,1,2,7,6,1,Toumani Camara,POR,DET,POR,,,14,14,7,7
22023,1641739,22300105,"OCT 30, 2023",POR @ TOR,W,23,1,4,0.25,0,2,0.0,1,2,0.5,2,5,7,0,0,1,1,2,3,12,1,Toumani Camara,POR,TOR,POR,,,10,10,3,7
22023,1641739,22300098,"OCT 29, 2023",POR @ PHI,L,28,5,16,0.313,1,5,0.2,1,2,0.5,3,0,3,2,0,2,0,3,12,-13,1,Toumani Camara,POR,PHI,POR,,,17,15,14,5
22023,1641739,22300086,"OCT 27, 2023",POR vs. ORL,L,23,0,4,0.0,0,2,0.0,2,2,1.0,1,3,4,3,0,0,0,0,2,2,1,Toumani Camara,POR,POR,ORL,,,9,6,5,7
22023,1641739,22300074,"OCT 25, 2023",POR @ LAC,L,16,2,5,0.4,2,2,1.0,1,2,0.5,0,2,2,1,0,1,0,2,7,13,1,Toumani Camara,POR,LAC,POR,,,10,9,8,3
22023,203991,22300559,"JAN 15, 2024",ATL vs. SAS,W,25,5,7,0.714,0,0,0.0,3,6,0.5,6,5,11,0,0,4,1,2,13,8,1,Clint Capela,ATL,ATL,SAS,,,24,24,13,11
22023,203991,22300543,"JAN 13, 2024",ATL vs. WAS,L,24,2,8,0.25,0,0,0.0,0,0,0.0,2,6,8,0,0,1,0,1,4,-10,1,Clint Capela,ATL,ATL,WAS,,,12,12,4,8
22023,203991,22300533,"JAN 12, 2024",ATL vs. IND,L,22,3,5,0.6,0,0,0.0,1,4,0.25,3,2,5,1,1,1,0,1,7,-1,1,Clint Capela,ATL,ATL,IND,,,13,12,8,6
22023,203991,22300499,"JAN 07, 2024",ATL @ ORL,L,36,2,6,0.333,0,0,0.0,0,2,0.0,4,8,12,0,3,2,1,3,4,-16,1,Clint Capela,ATL,ORL,ATL,,,16,16,4,12
22023,203991,22300480,"JAN 05, 2024",ATL @ IND,L,19,4,9,0.444,0,0,0.0,1,2,0.5,5,2,7,0,0,1,1,2,9,-22,1,Clint Capela,ATL,IND,ATL,,,16,16,9,7
22023,203991,22300467,"JAN 03, 2024",ATL vs. OKC,W,25,5,8,0.625,0,0,0.0,2,2,1.0,7,7,14,0,0,3,0,2,12,-9,1,Clint Capela,ATL,ATL,OKC,,,26,26,12,14
22023,203991,22300445,"DEC 31, 2023",ATL @ WAS,W,33,5,11,0.455,0,0,0.0,1,4,0.25,7,10,17,3,1,1,3,4,11,-4,1,Clint Capela,ATL,WAS,ATL,,,31,28,14,20
22023,203991,22300431,"DEC 29, 2023",ATL vs. SAC,L,28,5,7,0.714,0,0,0.0,2,4,0.5,6,6,12,3,1,2,2,1,12,2,1,Clint Capela,ATL,ATL,SAC,,,27,24,15,15
22023,203991,22300408,"DEC 26, 2023",ATL @ CHI,L,27,5,9,0.556,0,0,0.0,3,4,0.75,3,2,5,1,0,1,1,3,13,-7,1,Clint Capela,ATL,CHI,ATL,,,19,18,14,6
22023,203991,22300393,"DEC 23, 2023",ATL vs. MEM,L,30,8,11,0.727,0,0,0.0,4,4,1.0,5,7,12,1,0,2,1,2,20,2,1,Clint Capela,ATL,ATL,MEM,,,33,32,21,13
22023,203991,22300384,"DEC 22, 2023",ATL @ MIA,L,28,3,3,1.0,0,0,0.0,2,2,1.0,3,7,10,0,0,0,2,5,8,6,1,Clint Capela,ATL,MIA,ATL,,,18,18,8,10
22023,203991,22300371,"DEC 20, 2023",ATL @ HOU,W,21,4,6,0.667,0,0,0.0,7,7,1.0,5,4,9,2,2,1,0,3,15,-9,1,Clint Capela,ATL,HOU,ATL,,,26,24,17,11
22023,203991,22300352,"DEC 18, 2023",ATL vs. DET,W,28,7,11,0.636,0,0,0.0,3,3,1.0,7,8,15,2,1,3,1,3,17,10,1,Clint Capela,ATL,ATL,DET,,,34,32,19,17
22023,203991,22300330,"DEC 15, 2023",ATL @ TOR,W,35,9,12,0.75,0,0,0.0,0,0,0.0,6,9,15,0,0,3,1,2,18,20,1,Clint Capela,ATL,TOR,ATL,,,33,33,18,15
22023,203991,22300313,"DEC 13, 2023",ATL @ TOR,L,34,7,12,0.583,0,0,0.0,3,4,0.75,6,4,10,1,0,3,0,3,17,-17,1,Clint Capela,ATL,TOR,ATL,,,28,27,18,11
22023,203991,22300296,"DEC 11, 2023",ATL vs. DEN,L,28,6,11,0.545,0,0,0.0,2,2,1.0,4,4,8,2,1,0,0,5,14,-3,1,Clint Capela,ATL,ATL,DEN,,,24,22,16,10
22023,203991,22301218,"DEC 08, 2023",ATL @ PHI,L,30,6,12,0.5,0,0,0.0,3,4,0.75,10,6,16,2,0,1,2,5,15,-10,1,Clint Capela,ATL,PHI,ATL,,,33,31,17,18
22023,203991,22301209,"DEC 06, 2023",ATL vs. BKN,L,29,4,6,0.667,0,0,0.0,1,2,0.5,4,8,12,1,0,2,1,5,9,3,1,Clint Capela,ATL,ATL,BKN,,,22,21,10,13
22023,203991,22300286,"DEC 02, 2023",ATL @ MIL,L,30,4,13,0.308,0,0,0.0,2,2,1.0,8,9,17,4,1,3,2,4,10,1,1,Clint Capela,ATL,MIL,ATL,,,31,27,14,21
22023,203991,22300272,"NOV 30, 2023",ATL @ SAS,W,23,6,9,0.667,0,0,0.0,0,0,0.0,4,5,9,1,0,1,2,4,12,8,1,Clint Capela,ATL,SAS,ATL,,,22,21,13,10
22023,203991,22300055,"NOV 28, 2023",ATL @ CLE,L,22,6,10,0.6,0,0,0.0,2,2,1.0,6,3,9,0,2,2,2,1,14,-24,1,Clint Capela,ATL,CLE,ATL,,,23,23,14,9
22023,203991,22300246,"NOV 26, 2023",ATL @ BOS,L,21,1,5,0.2,0,0,0.0,2,6,0.333,4,4,8,1,1,2,1,0,4,-8,1,Clint Capela,ATL,BOS,ATL,,,13,12,5,9
22023,203991,22300241,"NOV 25, 2023",ATL @ WAS,W,18,6,14,0.429,0,0,0.0,0,2,0.0,7,4,11,1,0,0,0,2,12,21,1,Clint Capela,ATL,WAS,ATL,,,24,23,13,12
22023,203991,22300227,"NOV 22, 2023",ATL vs. BKN,W,27,7,8,0.875,0,0,0.0,0,0,0.0,9,6,15,0,0,3,0,1,14,-13,1,Clint Capela,ATL,ATL,BKN,,,29,29,14,15
22023,203991,22300039,"NOV 21, 2023",ATL vs. IND,L,19,6,9,0.667,0,0,0.0,2,3,0.667,3,2,5,1,0,2,1,4,14,-10,1,Clint Capela,ATL,ATL,IND,,,20,19,15,6
22023,203991,22300029,"NOV 17, 2023",ATL vs. PHI,L,29,7,11,0.636,0,0,0.0,3,5,0.6,8,3,11,2,1,1,0,3,17,-4,1,Clint Capela,ATL,ATL,PHI,,,30,28,19,13
22023,203991,22300193,"NOV 15, 2023",ATL vs. NYK,L,26,4,5,0.8,0,0,0.0,0,2,0.0,0,3,3,1,2,2,0,2,8,-21,1,Clint Capela,ATL,ATL,NYK,,,12,11,9,4
22023,203991,22300018,"NOV 14, 2023",ATL @ DET,W,27,3,4,0.75,0,0,0.0,2,2,1.0,2,6,8,1,2,3,3,5,8,8,1,Clint Capela,ATL,DET,ATL,,,17,16,9,9
22023,203991,22300175,"NOV 11, 2023",ATL vs. MIA,L,24,4,6,0.667,0,0,0.0,0,0,0.0,7,5,12,0,1,2,0,3,8,7,1,Clint Capela,ATL,ATL,MIA,,,20,20,8,12
22023,203991,22300172,"NOV 09, 2023",ATL @ ORL,W,26,2,4,0.5,0,0,0.0,2,4,0.5,2,9,11,4,0,1,0,2,6,12,1,Clint Capela,ATL,ORL,ATL,,,21,17,10,15
22023,203991,22300155,"NOV 06, 2023",ATL @ OKC,L,21,2,5,0.4,0,0,0.0,2,4,0.5,6,6,12,0,1,2,1,2,6,-10,1,Clint Capela,ATL,OKC,ATL,,,18,18,6,12
22023,203991,22300135,"NOV 04, 2023",ATL @ NOP,W,28,8,9,0.889,0,0,0.0,1,2,0.5,2,5,7,0,0,2,0,2,17,19,1,Clint Capela,ATL,NOP,ATL,,,24,24,17,7
22023,203991,22300117,"NOV 01, 2023",ATL vs. WAS,W,21,4,6,0.667,0,0,0.0,2,2,1.0,4,7,11,0,1,0,0,0,10,17,1,Clint Capela,ATL,ATL,WAS,,,21,21,10,11
22023,203991,22300104,"OCT 30, 2023",ATL vs. MIN,W,23,0,3,0.0,0,0,0.0,2,2,1.0,1,4,5,1,0,5,1,3,2,-4,1,Clint Capela,ATL,ATL,MIN,,,8,7,3,6
22023,203991,22300097,"OCT 29, 2023",ATL @ MIL,W,23,5,10,0.5,0,0,0.0,2,2,1.0,2,10,12,1,1,0,0,1,12,15,1,Clint Capela,ATL,MIL,ATL,,,25,24,13,13
22023,203991,22300079,"OCT 27, 2023",ATL vs. NYK,L,28,6,12,0.5,0,0,0.0,1,2,0.5,6,7,13,2,0,1,1,3,13,-9,1,Clint Capela,ATL,ATL,NYK,,,28,26,15,15
22023,203991,22300063,"OCT 25, 2023",ATL @ CHA,L,29,6,10,0.6,0,0,0.0,3,4,0.75,6,7,13,0,1,0,2,1,15,-19,1,Clint Capela,ATL,CHA,ATL,,,28,28,15,13
22023,1628975,22300561,"JAN 15, 2024",CHI @ CLE,L,11,2,4,0.5,1,3,0.333,0,0,0.0,1,1,2,0,0,0,0,1,5,-23,1,Jevon Carter,CHI,CLE,CHI,,,7,7,5,2
22023,1628975,22300548,"JAN 13, 2024",CHI @ SAS,W,24,5,12,0.417,4,9,0.444,0,0,0.0,0,1,1,0,0,0,3,2,14,-6,1,Jevon Carter,CHI,SAS,CHI,,,15,15,14,1
22023,1628975,22300506,"JAN 08, 2024",CHI @ CHA,W,4,1,2,0.5,0,1,0.0,0,0,0.0,0,0,0,0,0,0,0,0,2,-4,1,Jevon Carter,CHI,CHA,CHI,,,2,2,2,0
22023,1628975,22300484,"JAN 05, 2024",CHI vs. CHA,W,14,3,5,0.6,1,2,0.5,0,0,0.0,0,2,2,2,0,0,0,1,7,5,1,Jevon Carter,CHI,CHI,CHA,,,11,9,9,4
22023,1628975,22300468,"JAN 03, 2024",CHI @ NYK,L,16,1,6,0.167,0,3,0.0,0,0,0.0,0,0,0,2,1,1,1,2,2,13,1,Jevon Carter,CHI,NYK,CHI,,,4,2,4,2
22023,1628975,22300459,"JAN 02, 2024",CHI @ PHI,L,23,3,11,0.273,3,8,0.375,0,0,0.0,0,1,1,1,4,0,0,0,9,8,1,Jevon Carter,CHI,PHI,CHI,,,11,10,10,2
22023,1628975,22300442,"DEC 30, 2023",CHI vs. PHI,W,13,1,5,0.2,1,4,0.25,1,2,0.5,0,2,2,1,1,0,0,3,4,-8,1,Jevon Carter,CHI,CHI,PHI,,,7,6,5,3
22023,1628975,22300422,"DEC 28, 2023",CHI vs. IND,L,12,0,5,0.0,0,3,0.0,0,0,0.0,0,0,0,2,0,1,0,1,0,-12,1,Jevon Carter,CHI,CHI,IND,,,2,0,2,2
22023,1628975,22300408,"DEC 26, 2023",CHI vs. ATL,W,20,4,6,0.667,2,4,0.5,0,0,0.0,0,2,2,2,0,0,1,0,10,4,1,Jevon Carter,CHI,CHI,ATL,,,14,12,12,4
22023,1628975,22300396,"DEC 23, 2023",CHI vs. CLE,L,9,1,7,0.143,1,5,0.2,0,0,0.0,0,0,0,0,0,1,1,1,3,-5,1,Jevon Carter,CHI,CHI,CLE,,,3,3,3,0
22023,1628975,22300376,"DEC 21, 2023",CHI vs. SAS,W,19,1,3,0.333,1,1,1.0,2,2,1.0,0,1,1,2,0,1,0,1,5,13,1,Jevon Carter,CHI,CHI,SAS,,,8,6,7,3
22023,1628975,22300370,"DEC 20, 2023",CHI vs. LAL,W,17,4,9,0.444,2,7,0.286,0,0,0.0,0,1,1,0,1,0,0,1,10,5,1,Jevon Carter,CHI,CHI,LAL,,,11,11,10,1
22023,1628975,22300351,"DEC 18, 2023",CHI @ PHI,W,18,4,11,0.364,4,8,0.5,0,0,0.0,0,0,0,0,0,0,0,1,12,18,1,Jevon Carter,CHI,PHI,CHI,,,12,12,12,0
22023,1628975,22300337,"DEC 16, 2023",CHI @ MIA,L,12,0,3,0.0,0,3,0.0,0,0,0.0,0,1,1,3,0,0,1,2,0,-10,1,Jevon Carter,CHI,MIA,CHI,,,4,1,3,4
22023,1628975,22300320,"DEC 14, 2023",CHI @ MIA,W,13,0,2,0.0,0,2,0.0,0,0,0.0,0,0,0,1,1,0,1,3,0,-5,1,Jevon Carter,CHI,MIA,CHI,,,1,0,1,1
22023,1628975,22300307,"DEC 12, 2023",CHI vs. DEN,L,15,3,10,0.3,3,8,0.375,0,0,0.0,1,0,1,2,1,0,0,2,9,-12,1,Jevon Carter,CHI,CHI,DEN,,,12,10,11,3
22023,1628975,22300300,"DEC 11, 2023",CHI @ MIL,L,13,3,5,0.6,1,2,0.5,0,0,0.0,1,4,5,0,0,1,0,0,7,-1,1,Jevon Carter,CHI,MIL,CHI,,,12,12,7,5
22023,1628975,22301223,"DEC 08, 2023",CHI @ SAS,W,9,1,4,0.25,1,3,0.333,0,0,0.0,0,0,0,1,0,0,0,2,3,-7,1,Jevon Carter,CHI,SAS,CHI,,,4,3,4,1
22023,1628975,22301211,"DEC 06, 2023",CHI vs. CHA,W,11,0,1,0.0,0,1,0.0,0,0,0.0,0,0,0,3,1,0,1,1,0,5,1,Jevon Carter,CHI,CHI,CHA,,,3,0,3,3
22023,1628975,22300285,"DEC 02, 2023",CHI vs. NOP,W,15,1,2,0.5,0,1,0.0,0,0,0.0,0,0,0,2,0,0,1,1,2,-2,1,Jevon Carter,CHI,CHI,NOP,,,4,2,4,2
22023,1628975,22300269,"NOV 30, 2023",CHI vs. MIL,W,18,5,10,0.5,1,2,0.5,0,0,0.0,1,1,2,1,3,0,0,1,11,22,1,Jevon Carter,CHI,CHI,MIL,,,14,13,12,3
22023,1628975,22300053,"NOV 28, 2023",CHI @ BOS,L,17,4,7,0.571,0,1,0.0,0,0,0.0,0,1,1,2,0,1,1,0,8,3,1,Jevon Carter,CHI,BOS,CHI,,,11,9,10,3
22023,1628975,22300250,"NOV 26, 2023",CHI @ BKN,L,8,0,2,0.0,0,2,0.0,0,0,0.0,0,0,0,0,0,0,1,0,0,-17,1,Jevon Carter,CHI,BKN,CHI,,,0,0,0,0
22023,1628975,22300046,"NOV 24, 2023",CHI @ TOR,L,11,0,2,0.0,0,1,0.0,0,0,0.0,0,1,1,1,0,0,0,0,0,13,1,Jevon Carter,CHI,TOR,CHI,,,2,1,1,2
22023,1628975,22300234,"NOV 22, 2023",CHI @ OKC,L,19,1,7,0.143,1,6,0.167,0,0,0.0,0,0,0,2,0,0,0,2,3,-3,1,Jevon Carter,CHI,OKC,CHI,,,5,3,5,2
22023,1628975,22300220,"NOV 20, 2023",CHI vs. MIA,L,14,0,5,0.0,0,4,0.0,0,0,0.0,0,0,0,1,0,1,1,2,0,3,1,Jevon Carter,CHI,CHI,MIA,,,1,0,1,1
22023,1628975,22300204,"NOV 18, 2023",CHI vs. MIA,W,14,3,9,0.333,3,9,0.333,0,0,0.0,0,1,1,1,0,0,0,2,9,18,1,Jevon Carter,CHI,CHI,MIA,,,11,10,10,2
22023,1628975,22300033,"NOV 17, 2023",CHI vs. ORL,L,10,0,0,0.0,0,0,0.0,0,0,0.0,0,1,1,1,0,0,0,0,0,0,1,Jevon Carter,CHI,CHI,ORL,,,2,1,1,2
22023,1628975,22300196,"NOV 15, 2023",CHI vs. ORL,L,16,1,7,0.143,1,5,0.2,0,0,0.0,0,0,0,1,2,0,0,2,3,-3,1,Jevon Carter,CHI,CHI,ORL,,,4,3,4,1
22023,1628975,22300190,"NOV 13, 2023",CHI @ MIL,L,14,2,5,0.4,2,4,0.5,0,0,0.0,0,0,0,1,1,1,0,2,6,-11,1,Jevon Carter,CHI,MIL,CHI,,,7,6,7,1
22023,1628975,22300181,"NOV 12, 2023",CHI vs. DET,W,12,1,4,0.25,1,2,0.5,0,0,0.0,0,0,0,2,0,0,2,2,3,0,1,Jevon Carter,CHI,CHI,DET,,,5,3,5,2
22023,1628975,22300162,"NOV 08, 2023",CHI vs. PHX,L,13,3,8,0.375,2,4,0.5,0,0,0.0,0,0,0,0,0,1,0,2,8,10,1,Jevon Carter,CHI,CHI,PHX,,,8,8,8,0
22023,1628975,22300152,"NOV 06, 2023",CHI vs. UTA,W,17,4,8,0.5,4,8,0.5,0,0,0.0,0,0,0,1,2,0,0,1,12,7,1,Jevon Carter,CHI,CHI,UTA,,,13,12,13,1
22023,1628975,22300139,"NOV 04, 2023",CHI @ DEN,L,18,6,9,0.667,4,5,0.8,0,1,0.0,0,0,0,1,0,0,1,2,16,-2,1,Jevon Carter,CHI,DEN,CHI,,,17,16,17,1
22023,1628975,22300004,"NOV 03, 2023",CHI vs. BKN,L,14,2,3,0.667,1,2,0.5,0,0,0.0,0,1,1,0,1,0,2,2,5,-11,1,Jevon Carter,CHI,CHI,BKN,,,6,6,5,1
22023,1628975,22300124,"NOV 01, 2023",CHI @ DAL,L,15,5,7,0.714,2,2,1.0,0,0,0.0,0,1,1,2,1,1,1,0,12,-3,1,Jevon Carter,CHI,DAL,CHI,,,15,13,14,3
22023,1628975,22300102,"OCT 30, 2023",CHI @ IND,W,18,5,7,0.714,1,1,1.0,0,0,0.0,0,1,1,2,1,1,3,1,11,4,1,Jevon Carter,CHI,IND,CHI,,,14,12,13,3
22023,1628975,22300088,"OCT 28, 2023",CHI @ DET,L,13,1,6,0.167,1,4,0.25,0,0,0.0,1,0,1,0,0,0,0,0,3,-5,1,Jevon Carter,CHI,DET,CHI,,,4,4,3,1
22023,1628975,22300082,"OCT 27, 2023",CHI vs. TOR,W,13,0,2,0.0,0,2,0.0,0,0,0.0,0,1,1,2,0,0,1,1,0,2,1,Jevon Carter,CHI,CHI,TOR,,,3,1,2,3
22023,1628975,22300070,"OCT 25, 2023",CHI vs. OKC,L,16,1,4,0.25,1,4,0.25,0,0,0.0,0,1,1,2,0,0,0,0,3,-15,1,Jevon Carter,CHI,CHI,OKC,,,6,4,5,3
22023,1628976,22300557,"JAN 15, 2024",ORL @ NYK,W,19,7,11,0.636,1,3,0.333,2,2,1.0,1,2,3,0,0,1,0,1,17,14,1,Wendell Carter Jr.,ORL,NYK,ORL,,,20,20,17,3
22023,1628976,22300476,"JAN 03, 2024",ORL @ SAC,L,21,3,7,0.429,3,3,1.0,0,0,0.0,1,6,7,3,0,0,1,4,9,9,1,Wendell Carter Jr.,ORL,SAC,ORL,,,19,16,12,10
22023,1628976,22300463,"JAN 02, 2024",ORL @ GSW,L,20,1,5,0.2,0,1,0.0,4,4,1.0,0,2,2,1,1,1,0,1,6,4,1,Wendell Carter Jr.,ORL,GSW,ORL,,,9,8,7,3
22023,1628976,22300450,"DEC 31, 2023",ORL @ PHX,L,24,6,7,0.857,3,3,1.0,2,2,1.0,1,4,5,2,0,0,3,2,17,14,1,Wendell Carter Jr.,ORL,PHX,ORL,,,24,22,19,7
22023,1628976,22300415,"DEC 27, 2023",ORL vs. PHI,L,22,1,4,0.25,0,2,0.0,2,2,1.0,2,2,4,1,0,2,1,0,4,-8,1,Wendell Carter Jr.,ORL,ORL,PHI,,,9,8,5,5
22023,1628976,22300407,"DEC 26, 2023",ORL @ WAS,W,21,2,3,0.667,1,1,1.0,1,2,0.5,0,4,4,2,0,1,2,1,6,12,1,Wendell Carter Jr.,ORL,WAS,ORL,,,12,10,8,6
22023,1628976,22300391,"DEC 23, 2023",ORL @ IND,W,16,2,6,0.333,0,1,0.0,0,0,0.0,3,5,8,4,0,0,1,1,4,-16,1,Wendell Carter Jr.,ORL,IND,ORL,,,16,12,8,12
22023,1628976,22300378,"DEC 21, 2023",ORL @ MIL,L,21,2,6,0.333,0,3,0.0,0,0,0.0,1,3,4,2,0,1,0,2,4,-27,1,Wendell Carter Jr.,ORL,MIL,ORL,,,10,8,6,6
22023,1628976,22300366,"DEC 20, 2023",ORL vs. MIA,L,23,3,4,0.75,1,2,0.5,1,2,0.5,1,5,6,1,0,0,0,3,8,3,1,Wendell Carter Jr.,ORL,ORL,MIA,,,15,14,9,7
22023,1628976,22300130,"NOV 02, 2023",ORL @ UTA,W,29,5,12,0.417,3,6,0.5,1,2,0.5,2,8,10,2,0,1,2,4,14,2,1,Wendell Carter Jr.,ORL,UTA,ORL,,,26,24,16,12
22023,1628976,22300114,"OCT 31, 2023",ORL @ LAC,L,30,2,8,0.25,0,2,0.0,3,6,0.5,1,7,8,3,1,0,2,2,7,-16,1,Wendell Carter Jr.,ORL,LAC,ORL,,,18,15,10,11
22023,1628976,22300111,"OCT 30, 2023",ORL @ LAL,L,35,4,8,0.5,1,3,0.333,1,2,0.5,2,6,8,1,0,1,0,4,10,2,1,Wendell Carter Jr.,ORL,LAL,ORL,,,19,18,11,9
22023,1628976,22300086,"OCT 27, 2023",ORL @ POR,W,26,2,7,0.286,1,3,0.333,3,4,0.75,2,7,9,1,0,0,2,1,8,6,1,Wendell Carter Jr.,ORL,POR,ORL,,,18,17,9,10
22023,1628976,22300066,"OCT 25, 2023",ORL vs. HOU,W,27,4,10,0.4,0,2,0.0,0,0,0.0,4,4,8,1,2,0,2,3,8,8,1,Wendell Carter Jr.,ORL,ORL,HOU,,,17,16,9,9
22023,1627936,22300561,"JAN 15, 2024",CHI @ CLE,L,31,4,9,0.444,2,5,0.4,0,0,0.0,0,3,3,3,3,1,2,1,10,-6,1,Alex Caruso,CHI,CLE,CHI,,,16,13,13,6
22023,1627936,22300548,"JAN 13, 2024",CHI @ SAS,W,33,3,5,0.6,3,4,0.75,2,2,1.0,0,6,6,6,2,3,1,1,11,17,1,Alex Caruso,CHI,SAS,CHI,,,23,17,17,12
22023,1627936,22300536,"JAN 12, 2024",CHI vs. GSW,L,29,2,6,0.333,2,6,0.333,0,0,0.0,1,1,2,2,0,1,0,0,6,-12,1,Alex Caruso,CHI,CHI,GSW,,,10,8,8,4
22023,1627936,22300523,"JAN 10, 2024",CHI vs. HOU,W,32,3,10,0.3,2,9,0.222,4,6,0.667,2,4,6,3,1,1,0,3,12,-9,1,Alex Caruso,CHI,CHI,HOU,,,21,18,15,9
22023,1627936,22300506,"JAN 08, 2024",CHI @ CHA,W,34,2,7,0.286,1,3,0.333,0,0,0.0,0,2,2,3,2,1,0,4,5,17,1,Alex Caruso,CHI,CHA,CHI,,,10,7,8,5
22023,1627936,22300468,"JAN 03, 2024",CHI @ NYK,L,33,5,13,0.385,2,8,0.25,1,1,1.0,0,4,4,3,4,1,1,4,13,-11,1,Alex Caruso,CHI,NYK,CHI,,,20,17,16,7
22023,1627936,22300459,"JAN 02, 2024",CHI @ PHI,L,21,3,10,0.3,1,6,0.167,1,2,0.5,1,1,2,2,0,1,2,0,8,-12,1,Alex Caruso,CHI,PHI,CHI,,,12,10,10,4
22023,1627936,22300442,"DEC 30, 2023",CHI vs. PHI,W,28,4,7,0.571,3,5,0.6,3,5,0.6,0,2,2,5,1,1,3,2,14,19,1,Alex Caruso,CHI,CHI,PHI,,,21,16,19,7
22023,1627936,22300422,"DEC 28, 2023",CHI vs. IND,L,32,6,11,0.545,3,7,0.429,0,0,0.0,2,5,7,2,1,0,1,1,15,-15,1,Alex Caruso,CHI,CHI,IND,,,24,22,17,9
22023,1627936,22300408,"DEC 26, 2023",CHI vs. ATL,W,29,2,10,0.2,1,5,0.2,6,6,1.0,2,3,5,5,2,0,1,2,11,3,1,Alex Caruso,CHI,CHI,ATL,,,21,16,16,10
22023,1627936,22300396,"DEC 23, 2023",CHI vs. CLE,L,32,4,9,0.444,2,5,0.4,0,0,0.0,1,3,4,1,0,1,0,3,10,-10,1,Alex Caruso,CHI,CHI,CLE,,,15,14,11,5
22023,1627936,22300376,"DEC 21, 2023",CHI vs. SAS,W,22,4,6,0.667,0,0,0.0,0,0,0.0,0,3,3,3,3,0,2,5,8,10,1,Alex Caruso,CHI,CHI,SAS,,,14,11,11,6
22023,1627936,22300370,"DEC 20, 2023",CHI vs. LAL,W,28,5,7,0.714,3,4,0.75,2,2,1.0,2,4,6,2,0,1,4,2,15,15,1,Alex Caruso,CHI,CHI,LAL,,,23,21,17,8
22023,1627936,22300351,"DEC 18, 2023",CHI @ PHI,W,31,5,8,0.625,0,3,0.0,0,1,0.0,0,4,4,4,1,2,2,5,10,18,1,Alex Caruso,CHI,PHI,CHI,,,18,14,14,8
22023,1627936,22300320,"DEC 14, 2023",CHI @ MIA,W,5,2,4,0.5,2,3,0.667,0,0,0.0,0,0,0,1,0,0,0,0,6,11,1,Alex Caruso,CHI,MIA,CHI,,,7,6,7,1
22023,1627936,22301223,"DEC 08, 2023",CHI @ SAS,W,18,2,5,0.4,0,2,0.0,0,0,0.0,1,2,3,2,1,0,2,2,4,-3,1,Alex Caruso,CHI,SAS,CHI,,,9,7,6,5
22023,1627936,22301211,"DEC 06, 2023",CHI vs. CHA,W,30,4,7,0.571,1,2,0.5,3,4,0.75,4,2,6,2,0,2,1,2,12,-4,1,Alex Caruso,CHI,CHI,CHA,,,20,18,14,8
22023,1627936,22300285,"DEC 02, 2023",CHI vs. NOP,W,13,3,5,0.6,2,4,0.5,0,0,0.0,0,2,2,2,0,1,1,2,8,-3,1,Alex Caruso,CHI,CHI,NOP,,,12,10,10,4
22023,1627936,22300269,"NOV 30, 2023",CHI vs. MIL,W,29,4,9,0.444,3,5,0.6,0,0,0.0,0,1,1,5,2,1,7,1,11,-9,1,Alex Caruso,CHI,CHI,MIL,,,17,12,16,6
22023,1627936,22300053,"NOV 28, 2023",CHI @ BOS,L,19,3,9,0.333,2,6,0.333,0,0,0.0,1,1,2,2,3,0,1,2,8,-16,1,Alex Caruso,CHI,BOS,CHI,,,12,10,10,4
22023,1627936,22300046,"NOV 24, 2023",CHI @ TOR,L,18,2,3,0.667,1,2,0.5,2,2,1.0,1,1,2,1,0,0,0,0,7,-13,1,Alex Caruso,CHI,TOR,CHI,,,10,9,8,3
22023,1627936,22300234,"NOV 22, 2023",CHI @ OKC,L,27,5,12,0.417,2,6,0.333,0,0,0.0,1,5,6,1,1,0,0,1,12,-5,1,Alex Caruso,CHI,OKC,CHI,,,19,18,13,7
22023,1627936,22300220,"NOV 20, 2023",CHI vs. MIA,L,27,4,10,0.4,2,4,0.5,3,4,0.75,2,2,4,3,1,1,2,1,13,-21,1,Alex Caruso,CHI,CHI,MIA,,,20,17,16,7
22023,1627936,22300204,"NOV 18, 2023",CHI vs. MIA,W,29,4,8,0.5,2,4,0.5,1,2,0.5,1,0,1,3,1,1,1,2,11,-16,1,Alex Caruso,CHI,CHI,MIA,,,15,12,14,4
22023,1627936,22300033,"NOV 17, 2023",CHI vs. ORL,L,23,5,6,0.833,4,5,0.8,4,4,1.0,0,1,1,0,3,2,1,4,18,7,1,Alex Caruso,CHI,CHI,ORL,,,19,19,18,1
22023,1627936,22300196,"NOV 15, 2023",CHI vs. ORL,L,24,5,7,0.714,2,4,0.5,4,4,1.0,1,4,5,3,0,1,2,5,16,7,1,Alex Caruso,CHI,CHI,ORL,,,24,21,19,8
22023,1627936,22300162,"NOV 08, 2023",CHI vs. PHX,L,31,7,9,0.778,4,5,0.8,1,2,0.5,1,3,4,2,3,2,1,3,19,24,1,Alex Caruso,CHI,CHI,PHX,,,25,23,21,6
22023,1627936,22300152,"NOV 06, 2023",CHI vs. UTA,W,20,3,3,1.0,2,2,1.0,2,2,1.0,1,0,1,3,1,0,0,1,10,16,1,Alex Caruso,CHI,CHI,UTA,,,14,11,13,4
22023,1627936,22300139,"NOV 04, 2023",CHI @ DEN,L,14,1,3,0.333,0,2,0.0,1,1,1.0,0,0,0,2,1,0,2,3,3,-8,1,Alex Caruso,CHI,DEN,CHI,,,5,3,5,2
22023,1627936,22300004,"NOV 03, 2023",CHI vs. BKN,L,26,1,2,0.5,1,2,0.5,0,0,0.0,0,2,2,2,0,1,0,2,3,-9,1,Alex Caruso,CHI,CHI,BKN,,,7,5,5,4
22023,1627936,22300124,"NOV 01, 2023",CHI @ DAL,L,22,3,6,0.5,0,3,0.0,0,0,0.0,2,2,4,1,1,1,2,4,6,-5,1,Alex Caruso,CHI,DAL,CHI,,,11,10,7,5
22023,1627936,22300102,"OCT 30, 2023",CHI @ IND,W,26,3,5,0.6,1,2,0.5,1,2,0.5,1,3,4,3,0,1,3,1,8,6,1,Alex Caruso,CHI,IND,CHI,,,15,12,11,7
22023,1627936,22300088,"OCT 28, 2023",CHI @ DET,L,21,1,2,0.5,0,0,0.0,0,0,0.0,2,3,5,4,4,1,0,3,2,-16,1,Alex Caruso,CHI,DET,CHI,,,11,7,6,9
22023,1627936,22300082,"OCT 27, 2023",CHI vs. TOR,W,32,5,9,0.556,2,5,0.4,1,2,0.5,6,7,13,2,2,1,0,5,13,29,1,Alex Caruso,CHI,CHI,TOR,,,28,26,15,15
22023,1627936,22300070,"OCT 25, 2023",CHI vs. OKC,L,20,2,5,0.4,1,4,0.25,1,2,0.5,0,2,2,3,2,0,1,1,6,-19,1,Alex Caruso,CHI,CHI,OKC,,,11,8,9,5
22023,1630658,22300331,"DEC 15, 2023",LAL @ SAS,L,5,3,3,1.0,0,0,0.0,0,0,0.0,0,1,1,1,0,0,0,0,6,6,1,Colin Castleton,LAL,SAS,LAL,,,8,7,7,2
22023,1630658,22300271,"NOV 30, 2023",LAL @ OKC,L,4,0,1,0.0,0,0,0.0,2,2,1.0,1,2,3,0,0,0,0,0,2,-5,1,Colin Castleton,LAL,OKC,LAL,,,5,5,2,3
22023,1630658,22300163,"NOV 08, 2023",LAL @ HOU,L,14,1,3,0.333,0,0,0.0,0,0,0.0,2,0,2,2,0,0,0,5,2,-8,1,Colin Castleton,LAL,HOU,LAL,,,6,4,4,4
22023,1630658,22300134,"NOV 04, 2023",LAL @ ORL,L,4,1,1,1.0,0,0,0.0,0,0,0.0,0,1,1,0,0,0,0,0,2,-3,1,Colin Castleton,LAL,ORL,LAL,,,3,3,2,1
22023,1630608,22300140,"NOV 05, 2023",DET vs. PHX,L,3,0,0,0.0,0,0,0.0,0,0,0.0,0,0,0,0,0,0,0,0,0,5,1,Malcolm Cazalon,DET,DET,PHX,,,0,0,0,0
22023,1630577,22300559,"JAN 15, 2024",SAS @ ATL,L,20,5,8,0.625,5,8,0.625,0,0,0.0,0,1,1,1,1,0,0,1,15,5,1,Julian Champagnie,SAS,ATL,SAS,,,17,16,16,2
22023,1630577,22300548,"JAN 13, 2024",SAS vs. CHI,L,17,1,5,0.2,1,3,0.333,3,3,1.0,0,5,5,4,0,0,1,1,6,-4,1,Julian Champagnie,SAS,SAS,CHI,,,15,11,10,9
22023,1630577,22300541,"JAN 12, 2024",SAS vs. CHA,W,21,2,8,0.25,2,7,0.286,3,3,1.0,0,2,2,1,0,0,1,2,9,15,1,Julian Champagnie,SAS,SAS,CHA,,,12,11,10,3
22023,1630577,22300519,"JAN 10, 2024",SAS @ DET,W,21,1,3,0.333,0,2,0.0,0,0,0.0,1,3,4,1,2,0,0,2,2,9,1,Julian Champagnie,SAS,DET,SAS,,,7,6,3,5
22023,1630577,22300497,"JAN 07, 2024",SAS @ CLE,L,16,0,2,0.0,0,2,0.0,2,2,1.0,0,2,2,1,1,0,1,0,2,9,1,Julian Champagnie,SAS,CLE,SAS,,,5,4,3,3
22023,1630577,22300477,"JAN 04, 2024",SAS vs. MIL,L,21,0,4,0.0,0,2,0.0,0,0,0.0,0,0,0,2,1,0,0,0,0,-3,1,Julian Champagnie,SAS,SAS,MIL,,,2,0,2,2
22023,1630577,22300460,"JAN 02, 2024",SAS @ MEM,L,22,3,6,0.5,3,6,0.5,3,3,1.0,0,4,4,2,1,0,1,4,12,12,1,Julian Champagnie,SAS,MEM,SAS,,,18,16,14,6
22023,1630577,22300448,"DEC 31, 2023",SAS vs. BOS,L,19,0,2,0.0,0,2,0.0,0,0,0.0,0,2,2,2,0,0,1,2,0,-26,1,Julian Champagnie,SAS,SAS,BOS,,,4,2,2,4
22023,1630577,22300437,"DEC 29, 2023",SAS @ POR,L,12,1,5,0.2,1,4,0.25,4,5,0.8,2,1,3,0,1,1,1,1,7,-8,1,Julian Champagnie,SAS,POR,SAS,,,10,10,7,3
22023,1630577,22300427,"DEC 28, 2023",SAS @ POR,W,14,0,1,0.0,0,1,0.0,2,2,1.0,0,1,1,0,2,1,1,0,2,8,1,Julian Champagnie,SAS,POR,SAS,,,3,3,2,1
22023,1630577,22300412,"DEC 26, 2023",SAS vs. UTA,L,25,6,9,0.667,4,6,0.667,0,0,0.0,1,4,5,1,2,1,0,5,16,4,1,Julian Champagnie,SAS,SAS,UTA,,,22,21,17,6
22023,1630577,22300398,"DEC 23, 2023",SAS @ DAL,L,21,4,6,0.667,2,4,0.5,2,2,1.0,0,5,5,1,1,0,0,0,12,-7,1,Julian Champagnie,SAS,DAL,SAS,,,18,17,13,6
22023,1630577,22300376,"DEC 21, 2023",SAS @ CHI,L,11,1,1,1.0,1,1,1.0,0,0,0.0,0,1,1,0,0,1,1,1,3,-7,1,Julian Champagnie,SAS,CHI,SAS,,,4,4,3,1
22023,1630577,22300361,"DEC 19, 2023",SAS @ MIL,L,2,1,1,1.0,0,0,0.0,0,0,0.0,0,0,0,0,0,0,0,0,2,2,1,Julian Champagnie,SAS,MIL,SAS,,,2,2,2,0
22023,1630577,22300345,"DEC 17, 2023",SAS vs. NOP,L,14,5,6,0.833,5,6,0.833,0,0,0.0,1,0,1,1,0,2,0,0,15,-12,1,Julian Champagnie,SAS,SAS,NOP,,,17,16,16,2
22023,1630577,22300331,"DEC 15, 2023",SAS vs. LAL,W,9,0,2,0.0,0,2,0.0,0,0,0.0,0,0,0,0,0,0,0,1,0,-8,1,Julian Champagnie,SAS,SAS,LAL,,,0,0,0,0
22023,1630577,22300316,"DEC 13, 2023",SAS vs. LAL,L,6,0,2,0.0,0,2,0.0,0,0,0.0,0,1,1,1,1,0,0,0,0,-2,1,Julian Champagnie,SAS,SAS,LAL,,,2,1,1,2
22023,1630577,22300298,"DEC 11, 2023",SAS @ HOU,L,8,0,1,0.0,0,1,0.0,0,0,0.0,0,1,1,0,0,0,0,1,0,-2,1,Julian Champagnie,SAS,HOU,SAS,,,1,1,0,1
22023,1630577,22301223,"DEC 08, 2023",SAS vs. CHI,L,6,0,0,0.0,0,0,0.0,0,0,0.0,0,0,0,0,0,1,0,3,0,-12,1,Julian Champagnie,SAS,SAS,CHI,,,0,0,0,0
22023,1630577,22301210,"DEC 06, 2023",SAS @ MIN,L,4,0,1,0.0,0,1,0.0,0,0,0.0,0,1,1,0,0,0,0,0,0,-1,1,Julian Champagnie,SAS,MIN,SAS,,,1,1,0,1
22023,1630577,22300278,"DEC 01, 2023",SAS @ NOP,L,22,4,7,0.571,3,6,0.5,1,1,1.0,1,4,5,3,0,0,3,3,12,-7,1,Julian Champagnie,SAS,NOP,SAS,,,20,17,15,8
22023,1630577,22300272,"NOV 30, 2023",SAS vs. ATL,L,20,5,8,0.625,5,8,0.625,0,0,0.0,1,2,3,0,0,0,1,2,15,-6,1,Julian Champagnie,SAS,SAS,ATL,,,18,18,15,3
22023,1630577,22300252,"NOV 26, 2023",SAS @ DEN,L,17,4,8,0.5,3,6,0.5,2,4,0.5,0,1,1,1,0,1,0,1,13,2,1,Julian Champagnie,SAS,DEN,SAS,,,15,14,14,2
22023,1630577,22300223,"NOV 20, 2023",SAS vs. LAC,L,23,2,7,0.286,1,5,0.2,0,0,0.0,1,3,4,1,1,1,1,2,5,-11,1,Julian Champagnie,SAS,SAS,LAC,,,10,9,6,5
22023,1630577,22300206,"NOV 18, 2023",SAS vs. MEM,L,20,2,6,0.333,2,6,0.333,0,0,0.0,0,2,2,2,0,0,1,0,6,6,1,Julian Champagnie,SAS,SAS,MEM,,,10,8,8,4
22023,1630577,22300032,"NOV 17, 2023",SAS vs. SAC,L,25,2,5,0.4,2,4,0.5,3,4,0.75,1,1,2,3,0,1,2,3,9,-9,1,Julian Champagnie,SAS,SAS,SAC,,,14,11,12,5
22023,1630577,22300021,"NOV 14, 2023",SAS @ OKC,L,31,4,14,0.286,3,7,0.429,2,2,1.0,1,2,3,3,4,3,2,0,13,-21,1,Julian Champagnie,SAS,OKC,SAS,,,19,16,16,6
22023,1630577,22300161,"NOV 08, 2023",SAS @ NYK,L,3,0,2,0.0,0,2,0.0,0,0,0.0,0,0,0,0,0,0,0,0,0,0,1,Julian Champagnie,SAS,NYK,SAS,,,0,0,0,0
22023,1630577,22300146,"NOV 06, 2023",SAS @ IND,L,17,2,8,0.25,0,3,0.0,0,0,0.0,0,2,2,0,0,2,1,0,4,-15,1,Julian Champagnie,SAS,IND,SAS,,,6,6,4,2
22023,1630577,22300141,"NOV 05, 2023",SAS vs. TOR,L,7,1,3,0.333,0,2,0.0,0,0,0.0,0,0,0,0,1,0,1,0,2,-1,1,Julian Champagnie,SAS,SAS,TOR,,,2,2,2,0
22023,1630577,22300113,"OCT 31, 2023",SAS @ PHX,W,3,0,1,0.0,0,1,0.0,0,0,0.0,0,0,0,0,0,0,0,0,0,-1,1,Julian Champagnie,SAS,PHX,SAS,,,0,0,0,0
22023,1630577,22300099,"OCT 29, 2023",SAS @ LAC,L,7,1,4,0.25,1,2,0.5,0,0,0.0,0,2,2,0,0,1,1,0,3,-13,1,Julian Champagnie,SAS,LAC,SAS,,,5,5,3,2
22023,1631108,22300565,"JAN 15, 2024",LAL vs. OKC,W,11,0,2,0.0,0,1,0.0,0,0,0.0,1,0,1,0,0,0,1,1,0,5,1,Max Christie,LAL,LAL,OKC,,,1,1,0,1
22023,1631108,22300549,"JAN 13, 2024",LAL @ UTA,L,14,1,2,0.5,1,1,1.0,0,0,0.0,0,0,0,3,1,0,0,3,3,9,1,Max Christie,LAL,UTA,LAL,,,6,3,6,3
22023,1631108,22300531,"JAN 11, 2024",LAL vs. PHX,L,25,4,8,0.5,1,3,0.333,5,6,0.833,0,7,7,4,0,0,2,2,14,-2,1,Max Christie,LAL,LAL,PHX,,,25,21,18,11
22023,1631108,22300516,"JAN 09, 2024",LAL vs. TOR,W,18,2,2,1.0,1,1,1.0,1,2,0.5,1,3,4,2,0,0,0,0,6,5,1,Max Christie,LAL,LAL,TOR,,,12,10,8,6
22023,1631108,22300505,"JAN 07, 2024",LAL vs. LAC,W,13,3,6,0.5,1,1,1.0,0,0,0.0,2,1,3,0,0,2,0,0,7,10,1,Max Christie,LAL,LAL,LAC,,,10,10,7,3
22023,1631108,22300491,"JAN 05, 2024",LAL vs. MEM,L,20,1,3,0.333,0,1,0.0,0,0,0.0,0,3,3,0,1,0,2,2,2,1,1,Max Christie,LAL,LAL,MEM,,,5,5,2,3
22023,1631108,22300475,"JAN 03, 2024",LAL vs. MIA,L,28,5,12,0.417,2,9,0.222,2,2,1.0,1,4,5,0,0,0,2,2,14,-8,1,Max Christie,LAL,LAL,MIA,,,19,19,14,5
22023,1631108,22300446,"DEC 31, 2023",LAL @ NOP,L,29,3,11,0.273,1,6,0.167,0,0,0.0,1,6,7,0,2,0,2,1,7,-8,1,Max Christie,LAL,NOP,LAL,,,14,14,7,7
22023,1631108,22300428,"DEC 28, 2023",LAL vs. CHA,W,24,3,4,0.75,2,3,0.667,2,2,1.0,0,7,7,3,1,2,1,2,10,18,1,Max Christie,LAL,LAL,CHA,,,20,17,13,10
22023,1631108,22300370,"DEC 20, 2023",LAL @ CHI,L,1,0,0,0.0,0,0,0.0,0,0,0.0,0,0,0,0,0,0,0,0,0,0,1,Max Christie,LAL,CHI,LAL,,,0,0,0,0
22023,1631108,22300331,"DEC 15, 2023",LAL @ SAS,L,23,1,6,0.167,0,1,0.0,0,0,0.0,0,0,0,1,0,0,1,1,2,-25,1,Max Christie,LAL,SAS,LAL,,,3,2,3,1
22023,1631108,22300316,"DEC 13, 2023",LAL @ SAS,W,14,1,5,0.2,1,4,0.25,0,0,0.0,0,5,5,2,0,0,2,0,3,8,1,Max Christie,LAL,SAS,LAL,,,10,8,5,7
22023,1631108,22300306,"DEC 12, 2023",LAL @ DAL,L,6,0,0,0.0,0,0,0.0,0,0,0.0,0,0,0,1,0,0,0,1,0,5,1,Max Christie,LAL,DAL,LAL,,,1,0,1,1
22023,1631108,22301230,"DEC 07, 2023",LAL vs. NOP,W,17,3,5,0.6,0,1,0.0,0,2,0.0,0,2,2,0,1,0,0,1,6,6,1,Max Christie,LAL,LAL,NOP,,,8,8,6,2
22023,1631108,22301203,"DEC 05, 2023",LAL vs. PHX,W,8,1,2,0.5,1,2,0.5,0,0,0.0,0,0,0,1,0,0,0,2,3,-2,1,Max Christie,LAL,LAL,PHX,,,4,3,4,1
22023,1631108,22300291,"DEC 02, 2023",LAL vs. HOU,W,29,4,7,0.571,3,3,1.0,1,2,0.5,0,7,7,2,0,0,0,3,12,19,1,Max Christie,LAL,LAL,HOU,,,21,19,14,9
22023,1631108,22300271,"NOV 30, 2023",LAL @ OKC,L,21,3,7,0.429,2,3,0.667,0,0,0.0,0,0,0,0,2,1,1,4,8,-2,1,Max Christie,LAL,OKC,LAL,,,8,8,8,0
22023,1631108,22300258,"NOV 29, 2023",LAL @ DET,W,22,0,3,0.0,0,2,0.0,5,5,1.0,0,2,2,2,0,1,2,1,5,13,1,Max Christie,LAL,DET,LAL,,,9,7,7,4
22023,1631108,22300255,"NOV 27, 2023",LAL @ PHI,L,26,3,6,0.5,0,3,0.0,0,0,0.0,0,3,3,1,1,0,1,3,6,-16,1,Max Christie,LAL,PHI,LAL,,,10,9,7,4
22023,1631108,22300242,"NOV 25, 2023",LAL @ CLE,W,33,5,7,0.714,2,4,0.5,0,0,0.0,1,4,5,3,0,0,1,3,12,6,1,Max Christie,LAL,CLE,LAL,,,20,17,15,8
22023,1631108,22300238,"NOV 22, 2023",LAL vs. DAL,L,23,3,7,0.429,1,4,0.25,0,0,0.0,0,2,2,0,0,0,0,0,7,-19,1,Max Christie,LAL,LAL,DAL,,,9,9,7,2
22023,1631108,22300042,"NOV 21, 2023",LAL vs. UTA,W,25,3,8,0.375,1,5,0.2,0,0,0.0,0,5,5,4,1,1,0,2,7,10,1,Max Christie,LAL,LAL,UTA,,,16,12,11,9
22023,1631108,22300036,"NOV 17, 2023",LAL @ POR,W,1,0,1,0.0,0,0,0.0,0,0,0.0,0,1,1,0,0,0,1,0,0,0,1,Max Christie,LAL,POR,LAL,,,1,1,0,1
22023,1631108,22300198,"NOV 15, 2023",LAL vs. SAC,L,1,0,1,0.0,0,0,0.0,0,0,0.0,0,1,1,0,0,0,1,0,0,-4,1,Max Christie,LAL,LAL,SAC,,,1,1,0,1
22023,1631108,22300026,"NOV 14, 2023",LAL vs. MEM,W,9,2,2,1.0,1,1,1.0,0,0,0.0,0,1,1,1,1,0,1,0,5,10,1,Max Christie,LAL,LAL,MEM,,,7,6,6,2
22023,1631108,22300187,"NOV 12, 2023",LAL vs. POR,W,13,0,1,0.0,0,0,0.0,0,0,0.0,1,2,3,0,1,0,1,0,0,0,1,Max Christie,LAL,LAL,POR,,,3,3,0,3
22023,1631108,22300163,"NOV 08, 2023",LAL @ HOU,L,28,1,8,0.125,0,2,0.0,2,3,0.667,1,7,8,3,0,1,1,2,4,-15,1,Max Christie,LAL,HOU,LAL,,,15,12,7,11
22023,1631108,22300150,"NOV 06, 2023",LAL @ MIA,L,15,2,3,0.667,0,1,0.0,0,0,0.0,0,1,1,1,0,0,1,2,4,-8,1,Max Christie,LAL,MIA,LAL,,,6,5,5,2
22023,1631108,22300134,"NOV 04, 2023",LAL @ ORL,L,23,3,7,0.429,0,2,0.0,0,0,0.0,0,5,5,0,0,0,1,2,6,-24,1,Max Christie,LAL,ORL,LAL,,,11,11,6,5
22023,1631108,22300127,"NOV 01, 2023",LAL vs. LAC,W,22,1,7,0.143,1,5,0.2,2,2,1.0,0,3,3,0,1,0,0,3,5,0,1,Max Christie,LAL,LAL,LAC,,,8,8,5,3
22023,1631108,22300061,"OCT 24, 2023",LAL @ DEN,L,1,0,0,0.0,0,0,0.0,0,0,0.0,0,0,0,0,0,0,0,0,0,0,1,Max Christie,LAL,DEN,LAL,,,0,0,0,0
22023,1631321,22300448,"DEC 31, 2023",SAS vs. BOS,L,8,0,2,0.0,0,2,0.0,0,0,0.0,0,2,2,0,1,0,0,0,0,4,1,Sidy Cissoko,SAS,SAS,BOS,,,2,2,0,2
22023,1631321,22300412,"DEC 26, 2023",SAS vs. UTA,L,2,1,1,1.0,0,0,0.0,2,2,1.0,0,1,1,0,0,0,0,0,4,7,1,Sidy Cissoko,SAS,SAS,UTA,,,5,5,4,1
22023,1631321,22300398,"DEC 23, 2023",SAS @ DAL,L,14,0,3,0.0,0,2,0.0,2,2,1.0,0,3,3,0,2,0,0,2,2,6,1,Sidy Cissoko,SAS,DAL,SAS,,,5,5,2,3
22023,1631321,22300376,"DEC 21, 2023",SAS @ CHI,L,3,0,0,0.0,0,0,0.0,0,0,0.0,0,0,0,0,0,0,0,0,0,1,1,Sidy Cissoko,SAS,CHI,SAS,,,0,0,0,0
22023,1631321,22300223,"NOV 20, 2023",SAS vs. LAC,L,4,0,0,0.0,0,0,0.0,0,0,0.0,0,0,0,0,0,0,1,0,0,-3,1,Sidy Cissoko,SAS,SAS,LAC,,,0,0,0,0
22023,203903,22300564,"JAN 15, 2024",UTA vs. IND,W,27,6,13,0.462,0,3,0.0,5,6,0.833,0,3,3,2,2,0,2,1,17,6,1,Jordan Clarkson,UTA,UTA,IND,,,22,20,19,5
22023,203903,22300549,"JAN 13, 2024",UTA vs. LAL,W,31,6,18,0.333,1,6,0.167,8,8,1.0,2,2,4,4,0,1,2,2,21,-2,1,Jordan Clarkson,UTA,UTA,LAL,,,29,25,25,8
22023,203903,22300540,"JAN 12, 2024",UTA vs. TOR,W,31,8,16,0.5,5,9,0.556,0,0,0.0,0,1,1,5,0,0,0,1,21,17,1,Jordan Clarkson,UTA,UTA,TOR,,,27,22,26,6
22023,203903,22300524,"JAN 10, 2024",UTA vs. DEN,W,33,12,19,0.632,3,8,0.375,0,1,0.0,0,2,2,9,0,0,3,1,27,8,1,Jordan Clarkson,UTA,UTA,DEN,,,38,29,36,11
22023,203903,22300510,"JAN 08, 2024",UTA @ MIL,W,31,7,14,0.5,2,3,0.667,5,5,1.0,1,3,4,6,0,1,1,0,21,13,1,Jordan Clarkson,UTA,MIL,UTA,,,31,25,27,10
22023,203903,22300495,"JAN 06, 2024",UTA @ PHI,W,31,5,14,0.357,0,6,0.0,8,9,0.889,0,5,5,6,1,0,5,0,18,1,1,Jordan Clarkson,UTA,PHI,UTA,,,29,23,24,11
22023,203903,22300479,"JAN 05, 2024",UTA @ BOS,L,17,1,7,0.143,0,2,0.0,0,0,0.0,1,1,2,2,1,0,4,0,2,-23,1,Jordan Clarkson,UTA,BOS,UTA,,,6,4,4,4
22023,203903,22300474,"JAN 03, 2024",UTA vs. DET,W,38,11,20,0.55,4,5,0.8,10,11,0.909,1,5,6,3,1,0,5,1,36,5,1,Jordan Clarkson,UTA,UTA,DET,,,45,42,39,9
22023,203903,22300457,"JAN 01, 2024",UTA vs. DAL,W,28,8,16,0.5,1,6,0.167,3,3,1.0,2,8,10,11,1,0,4,4,20,36,1,Jordan Clarkson,UTA,UTA,DAL,,,41,30,31,21
22023,203903,22300439,"DEC 30, 2023",UTA vs. MIA,W,25,3,10,0.3,1,5,0.2,2,2,1.0,0,2,2,3,0,0,0,0,9,4,1,Jordan Clarkson,UTA,UTA,MIA,,,14,11,12,5
22023,203903,22300424,"DEC 28, 2023",UTA @ NOP,L,24,3,11,0.273,1,5,0.2,3,3,1.0,0,2,2,6,0,0,6,0,10,-8,1,Jordan Clarkson,UTA,NOP,UTA,,,18,12,16,8
22023,203903,22300412,"DEC 26, 2023",UTA @ SAS,W,27,7,17,0.412,2,8,0.25,8,8,1.0,1,5,6,8,0,0,3,6,24,16,1,Jordan Clarkson,UTA,SAS,UTA,,,38,30,32,14
22023,203903,22300395,"DEC 23, 2023",UTA @ TOR,W,30,11,22,0.5,4,9,0.444,4,4,1.0,1,2,3,6,1,0,2,1,30,19,1,Jordan Clarkson,UTA,TOR,UTA,,,39,33,36,9
22023,203903,22300302,"DEC 11, 2023",UTA @ OKC,L,22,3,13,0.231,0,4,0.0,2,2,1.0,2,2,4,5,1,1,2,1,8,-25,1,Jordan Clarkson,UTA,OKC,UTA,,,17,12,13,9
22023,203903,22301225,"DEC 08, 2023",UTA vs. LAC,L,28,2,9,0.222,0,3,0.0,2,3,0.667,1,3,4,5,1,0,1,2,6,-16,1,Jordan Clarkson,UTA,UTA,LAC,,,15,10,11,9
22023,203903,22300261,"NOV 29, 2023",UTA @ MEM,L,27,4,10,0.4,2,5,0.4,2,3,0.667,1,2,3,5,0,0,4,0,12,-14,1,Jordan Clarkson,UTA,MEM,UTA,,,20,15,17,8
22023,203903,22300256,"NOV 27, 2023",UTA vs. NOP,W,32,4,16,0.25,2,9,0.222,6,6,1.0,0,4,4,10,0,0,1,1,16,-3,1,Jordan Clarkson,UTA,UTA,NOP,,,30,20,26,14
22023,203903,22300237,"NOV 22, 2023",UTA @ POR,L,32,5,11,0.455,2,4,0.5,1,2,0.5,0,2,2,5,0,0,7,0,13,-8,1,Jordan Clarkson,UTA,POR,UTA,,,20,15,18,7
22023,203903,22300042,"NOV 21, 2023",UTA @ LAL,L,24,3,9,0.333,0,3,0.0,1,1,1.0,0,0,0,2,1,0,2,1,7,-24,1,Jordan Clarkson,UTA,LAL,UTA,,,9,7,9,2
22023,203903,22300214,"NOV 19, 2023",UTA vs. PHX,L,39,8,23,0.348,1,6,0.167,5,7,0.714,3,4,7,5,2,0,2,5,22,-9,1,Jordan Clarkson,UTA,UTA,PHX,,,34,29,27,12
22023,203903,22300035,"NOV 17, 2023",UTA vs. PHX,L,36,14,26,0.538,5,10,0.5,4,4,1.0,1,2,3,5,1,0,0,0,37,0,1,Jordan Clarkson,UTA,UTA,PHX,,,45,40,42,8
22023,203903,22300023,"NOV 14, 2023",UTA vs. POR,W,33,13,19,0.684,4,9,0.444,0,0,0.0,0,1,1,3,2,0,1,2,30,8,1,Jordan Clarkson,UTA,UTA,POR,,,34,31,33,4
22023,203903,22300012,"NOV 10, 2023",UTA @ MEM,W,36,9,16,0.563,2,5,0.4,6,6,1.0,2,2,4,4,2,1,3,1,26,14,1,Jordan Clarkson,UTA,MEM,UTA,,,34,30,30,8
22023,203903,22300158,"NOV 08, 2023",UTA @ IND,L,34,12,26,0.462,1,3,0.333,8,8,1.0,2,1,3,5,1,1,6,3,33,-5,1,Jordan Clarkson,UTA,IND,UTA,,,41,36,38,8
22023,203903,22300152,"NOV 06, 2023",UTA @ CHI,L,29,3,14,0.214,1,8,0.125,0,0,0.0,1,0,1,6,0,0,5,1,7,-14,1,Jordan Clarkson,UTA,CHI,UTA,,,14,8,13,7
22023,203903,22300138,"NOV 04, 2023",UTA @ MIN,L,32,5,14,0.357,0,5,0.0,0,0,0.0,2,1,3,3,0,0,0,0,10,-18,1,Jordan Clarkson,UTA,MIN,UTA,,,16,13,13,6
22023,203903,22300130,"NOV 02, 2023",UTA vs. ORL,L,37,5,20,0.25,2,8,0.25,9,9,1.0,3,3,6,6,1,0,6,1,21,-3,1,Jordan Clarkson,UTA,UTA,ORL,,,33,27,27,12
22023,203903,22300125,"NOV 01, 2023",UTA vs. MEM,W,26,8,13,0.615,4,6,0.667,0,0,0.0,0,6,6,5,2,0,3,1,20,21,1,Jordan Clarkson,UTA,UTA,MEM,,,31,26,25,11
22023,203903,22300110,"OCT 30, 2023",UTA @ DEN,L,34,2,10,0.2,0,4,0.0,0,3,0.0,2,1,3,6,1,0,5,1,4,-7,1,Jordan Clarkson,UTA,DEN,UTA,,,13,7,10,9
22023,203903,22300094,"OCT 28, 2023",UTA @ PHX,L,22,3,10,0.3,0,3,0.0,1,1,1.0,1,1,2,2,0,0,5,3,7,-26,1,Jordan Clarkson,UTA,PHX,UTA,,,11,9,9,4
22023,203903,22300085,"OCT 27, 2023",UTA vs. LAC,W,34,4,13,0.308,3,5,0.6,2,3,0.667,1,3,4,6,1,0,2,0,13,-2,1,Jordan Clarkson,UTA,UTA,LAC,,,23,17,19,10
22023,203903,22300072,"OCT 25, 2023",UTA vs. SAC,L,31,8,16,0.5,2,5,0.4,6,8,0.75,2,2,4,6,0,0,2,4,24,-4,1,Jordan Clarkson,UTA,UTA,SAC,,,34,28,30,10
22023,1629651,22300562,"JAN 15, 2024",BKN vs. MIA,L,43,4,9,0.444,0,0,0.0,1,1,1.0,2,11,13,2,0,2,1,1,9,-4,1,Nic Claxton,BKN,BKN,MIA,,,24,22,11,15
22023,1629651,22300527,"JAN 11, 2024",BKN @ CLE,L,33,6,9,0.667,0,0,0.0,1,2,0.5,3,8,11,1,1,0,4,3,13,0,1,Nic Claxton,BKN,CLE,BKN,,,25,24,14,12
22023,1629651,22300498,"JAN 07, 2024",BKN vs. POR,L,36,8,8,1.0,0,0,0.0,0,2,0.0,2,9,11,3,2,4,5,5,16,-2,1,Nic Claxton,BKN,BKN,POR,,,30,27,19,14
22023,1629651,22300481,"JAN 05, 2024",BKN vs. OKC,W,34,8,11,0.727,0,0,0.0,7,10,0.7,8,5,13,3,1,0,3,1,23,5,1,Nic Claxton,BKN,BKN,OKC,,,39,36,26,16
22023,1629651,22300469,"JAN 03, 2024",BKN @ HOU,L,28,6,8,0.75,0,0,0.0,0,0,0.0,5,8,13,0,1,2,1,5,12,-8,1,Nic Claxton,BKN,HOU,BKN,,,25,25,12,13
22023,1629651,22300461,"JAN 02, 2024",BKN @ NOP,L,23,4,7,0.571,0,0,0.0,0,0,0.0,0,3,3,1,0,2,0,1,8,-19,1,Nic Claxton,BKN,NOP,BKN,,,12,11,9,4
22023,1629651,22300447,"DEC 31, 2023",BKN @ OKC,L,37,5,11,0.455,0,0,0.0,5,10,0.5,6,10,16,5,1,1,0,2,15,-21,1,Nic Claxton,BKN,OKC,BKN,,,36,31,20,21
22023,1629651,22300430,"DEC 29, 2023",BKN @ WAS,L,30,4,10,0.4,0,0,0.0,3,5,0.6,4,8,12,2,0,3,1,0,11,7,1,Nic Claxton,BKN,WAS,BKN,,,25,23,13,14
22023,1629651,22300406,"DEC 26, 2023",BKN @ DET,W,26,5,5,1.0,0,0,0.0,1,3,0.333,2,9,11,2,0,3,0,2,11,-9,1,Nic Claxton,BKN,DET,BKN,,,24,22,13,13
22023,1629651,22300394,"DEC 23, 2023",BKN vs. DET,W,30,4,8,0.5,0,0,0.0,3,4,0.75,2,5,7,2,2,2,2,2,11,3,1,Nic Claxton,BKN,BKN,DET,,,20,18,13,9
22023,1629651,22300383,"DEC 22, 2023",BKN vs. DEN,L,28,4,8,0.5,0,0,0.0,2,4,0.5,1,15,16,6,0,3,1,1,10,-10,1,Nic Claxton,BKN,BKN,DEN,,,32,26,16,22
22023,1629651,22300368,"DEC 20, 2023",BKN vs. NYK,L,26,3,5,0.6,0,0,0.0,0,0,0.0,4,4,8,2,0,4,0,5,6,-21,1,Nic Claxton,BKN,BKN,NYK,,,16,14,8,10
22023,1629651,22300357,"DEC 18, 2023",BKN @ UTA,L,26,4,5,0.8,0,0,0.0,3,4,0.75,2,5,7,0,0,4,3,3,11,-18,1,Nic Claxton,BKN,UTA,BKN,,,18,18,11,7
22023,1629651,22300339,"DEC 16, 2023",BKN @ GSW,L,33,8,12,0.667,0,0,0.0,3,3,1.0,5,7,12,1,0,4,2,1,19,-5,1,Nic Claxton,BKN,GSW,BKN,,,32,31,20,13
22023,1629651,22300322,"DEC 14, 2023",BKN @ DEN,L,17,5,9,0.556,0,0,0.0,0,0,0.0,1,8,9,2,0,0,2,5,10,-16,1,Nic Claxton,BKN,DEN,BKN,,,21,19,12,11
22023,1629651,22300317,"DEC 13, 2023",BKN @ PHX,W,33,6,10,0.6,1,1,1.0,1,2,0.5,0,7,7,1,0,1,0,4,14,-6,1,Nic Claxton,BKN,PHX,BKN,,,22,21,15,8
22023,1629651,22300303,"DEC 11, 2023",BKN @ SAC,L,26,3,6,0.5,0,0,0.0,2,2,1.0,4,6,10,0,0,3,0,2,8,-24,1,Nic Claxton,BKN,SAC,BKN,,,18,18,8,10
22023,1629651,22301219,"DEC 08, 2023",BKN vs. WAS,W,26,6,8,0.75,0,0,0.0,1,2,0.5,4,11,15,0,0,2,1,3,13,15,1,Nic Claxton,BKN,BKN,WAS,,,28,28,13,15
22023,1629651,22301209,"DEC 06, 2023",BKN @ ATL,W,28,1,5,0.2,0,0,0.0,2,4,0.5,2,8,10,4,1,1,0,1,4,-5,1,Nic Claxton,BKN,ATL,BKN,,,18,14,8,14
22023,1629651,22300282,"DEC 02, 2023",BKN vs. ORL,W,24,3,4,0.75,0,0,0.0,0,0,0.0,4,3,7,1,0,1,1,4,6,3,1,Nic Claxton,BKN,BKN,ORL,,,14,13,7,8
22023,1629651,22300266,"NOV 30, 2023",BKN vs. CHA,L,29,9,13,0.692,0,0,0.0,2,2,1.0,9,5,14,2,1,2,1,1,20,-7,1,Nic Claxton,BKN,BKN,CHA,,,36,34,22,16
22023,1629651,22300054,"NOV 28, 2023",BKN vs. TOR,W,32,7,10,0.7,0,0,0.0,1,4,0.25,2,6,8,0,0,4,0,1,15,20,1,Nic Claxton,BKN,BKN,TOR,,,23,23,15,8
22023,1629651,22300240,"NOV 25, 2023",BKN vs. MIA,W,24,5,7,0.714,0,0,0.0,3,4,0.75,2,4,6,0,2,3,0,1,13,3,1,Nic Claxton,BKN,BKN,MIA,,,19,19,13,6
22023,1629651,22300227,"NOV 22, 2023",BKN @ ATL,L,37,10,15,0.667,0,0,0.0,2,2,1.0,7,4,11,3,1,3,2,6,22,-6,1,Nic Claxton,BKN,ATL,BKN,,,36,33,25,14
22023,1629651,22300208,"NOV 19, 2023",BKN vs. PHI,L,23,5,6,0.833,0,0,0.0,0,3,0.0,0,9,9,1,0,1,2,3,10,-17,1,Nic Claxton,BKN,BKN,PHI,,,20,19,11,10
22023,1629651,22300200,"NOV 16, 2023",BKN @ MIA,L,26,7,7,1.0,0,0,0.0,2,4,0.5,1,5,6,2,1,3,1,2,16,-7,1,Nic Claxton,BKN,MIA,BKN,,,24,22,18,8
22023,1629651,22300020,"NOV 14, 2023",BKN vs. ORL,W,21,3,5,0.6,0,0,0.0,2,2,1.0,2,4,6,0,1,2,1,4,8,20,1,Nic Claxton,BKN,BKN,ORL,,,14,14,8,6
22023,1629651,22300178,"NOV 12, 2023",BKN vs. WAS,W,28,5,7,0.714,0,0,0.0,0,0,0.0,4,9,13,2,0,4,0,2,10,8,1,Nic Claxton,BKN,BKN,WAS,,,25,23,12,15
22023,1629651,22300067,"OCT 25, 2023",BKN vs. CLE,L,28,3,10,0.3,0,0,0.0,1,1,1.0,4,3,7,4,0,3,0,1,7,-12,1,Nic Claxton,BKN,BKN,CLE,,,18,14,11,11
22023,1641730,22300417,"DEC 27, 2023",BKN vs. MIL,L,24,6,9,0.667,0,1,0.0,2,2,1.0,3,1,4,2,0,0,1,3,14,-19,1,Noah Clowney,BKN,BKN,MIL,,,20,18,16,6
22023,1641730,22300240,"NOV 25, 2023",BKN vs. MIA,W,3,0,0,0.0,0,0,0.0,0,0,0.0,0,1,1,0,0,0,0,0,0,-6,1,Noah Clowney,BKN,BKN,MIA,,,1,1,0,1
22023,1629599,22300553,"JAN 14, 2024",LAC @ MIN,L,9,0,1,0.0,0,0,0.0,0,0,0.0,1,0,1,0,1,0,1,0,0,-1,1,Amir Coffey,LAC,MIN,LAC,,,1,1,0,1
22023,1629599,22300537,"JAN 12, 2024",LAC @ MEM,W,26,6,6,1.0,1,1,1.0,0,1,0.0,0,2,2,1,2,0,1,0,13,-4,1,Amir Coffey,LAC,MEM,LAC,,,16,15,14,3
22023,1629599,22300526,"JAN 10, 2024",LAC vs. TOR,W,18,3,5,0.6,0,2,0.0,0,0,0.0,0,1,1,1,1,0,0,1,6,3,1,Amir Coffey,LAC,LAC,TOR,,,8,7,7,2
22023,1629599,22300511,"JAN 08, 2024",LAC vs. PHX,W,23,4,5,0.8,1,1,1.0,0,0,0.0,0,2,2,0,0,0,0,3,9,12,1,Amir Coffey,LAC,LAC,PHX,,,11,11,9,2
22023,1629599,22300505,"JAN 07, 2024",LAC @ LAL,L,13,0,1,0.0,0,0,0.0,0,0,0.0,0,1,1,0,0,0,0,0,0,-7,1,Amir Coffey,LAC,LAL,LAC,,,1,1,0,1
22023,1629599,22300486,"JAN 05, 2024",LAC @ NOP,W,21,2,4,0.5,0,2,0.0,0,0,0.0,1,2,3,0,1,0,2,1,4,0,1,Amir Coffey,LAC,NOP,LAC,,,7,7,4,3
22023,1629599,22300473,"JAN 03, 2024",LAC @ PHX,W,13,1,1,1.0,0,0,0.0,1,2,0.5,0,0,0,1,0,0,0,1,3,-1,1,Amir Coffey,LAC,PHX,LAC,,,4,3,4,1
22023,1629599,22300458,"JAN 01, 2024",LAC vs. MIA,W,19,2,3,0.667,1,2,0.5,0,0,0.0,1,0,1,2,0,0,0,2,5,-7,1,Amir Coffey,LAC,LAC,MIA,,,8,6,7,3
22023,1629599,22300438,"DEC 29, 2023",LAC vs. MEM,W,31,5,6,0.833,3,4,0.75,0,0,0.0,1,1,2,2,1,0,0,0,13,23,1,Amir Coffey,LAC,LAC,MEM,,,17,15,15,4
22023,1629599,22300414,"DEC 26, 2023",LAC vs. CHA,W,23,1,3,0.333,0,1,0.0,2,2,1.0,0,2,2,0,0,0,0,0,4,-1,1,Amir Coffey,LAC,LAC,CHA,,,6,6,4,2
22023,1629599,22300389,"DEC 23, 2023",LAC vs. BOS,L,17,1,3,0.333,0,1,0.0,0,0,0.0,0,2,2,1,0,0,1,0,2,-11,1,Amir Coffey,LAC,LAC,BOS,,,5,4,3,3
22023,1629599,22300379,"DEC 21, 2023",LAC @ OKC,L,33,4,7,0.571,1,4,0.25,0,0,0.0,2,2,4,1,0,0,1,2,9,-8,1,Amir Coffey,LAC,OKC,LAC,,,14,13,10,5
22023,1629599,22300372,"DEC 20, 2023",LAC @ DAL,W,39,3,6,0.5,2,5,0.4,4,4,1.0,0,5,5,3,1,0,3,5,12,-3,1,Amir Coffey,LAC,DAL,LAC,,,20,17,15,8
22023,1629599,22300350,"DEC 18, 2023",LAC @ IND,W,18,0,1,0.0,0,1,0.0,0,0,0.0,0,3,3,2,0,0,0,2,0,-9,1,Amir Coffey,LAC,IND,LAC,,,5,3,2,5
22023,1629599,22300343,"DEC 16, 2023",LAC vs. NYK,W,17,1,3,0.333,1,3,0.333,0,0,0.0,0,1,1,0,0,0,0,3,3,1,1,Amir Coffey,LAC,LAC,NYK,,,4,4,3,1
22023,1629599,22300325,"DEC 14, 2023",LAC vs. GSW,W,29,6,15,0.4,4,11,0.364,2,3,0.667,1,3,4,1,0,0,1,2,18,5,1,Amir Coffey,LAC,LAC,GSW,,,23,22,19,5
22023,1629599,22300309,"DEC 12, 2023",LAC vs. SAC,W,9,1,1,1.0,0,0,0.0,0,0,0.0,1,0,1,0,0,0,0,0,2,-12,1,Amir Coffey,LAC,LAC,SAC,,,3,3,2,1
22023,1629599,22300273,"NOV 30, 2023",LAC @ GSW,L,1,0,0,0.0,0,0,0.0,0,0,0.0,0,0,0,0,0,0,0,2,0,2,1,Amir Coffey,LAC,GSW,LAC,,,0,0,0,0
22023,1629599,22300264,"NOV 29, 2023",LAC @ SAC,W,1,0,0,0.0,0,0,0.0,0,0,0.0,0,0,0,0,0,0,0,0,0,0,1,Amir Coffey,LAC,SAC,LAC,,,0,0,0,0
22023,1629599,22300244,"NOV 25, 2023",LAC vs. DAL,W,5,0,0,0.0,0,0,0.0,0,0,0.0,1,0,1,1,0,0,0,1,0,-1,1,Amir Coffey,LAC,LAC,DAL,,,2,1,1,2
22023,1629599,22300235,"NOV 22, 2023",LAC @ SAS,W,10,2,3,0.667,0,1,0.0,0,0,0.0,1,2,3,0,1,0,0,0,4,8,1,Amir Coffey,LAC,SAS,LAC,,,7,7,4,3
22023,1629599,22300223,"NOV 20, 2023",LAC @ SAS,W,4,0,1,0.0,0,0,0.0,0,0,0.0,0,0,0,0,0,0,0,0,0,3,1,Amir Coffey,LAC,SAS,LAC,,,0,0,0,0
22023,1629599,22300014,"NOV 10, 2023",LAC @ DAL,L,13,2,6,0.333,0,2,0.0,2,2,1.0,0,2,2,0,0,0,0,1,6,8,1,Amir Coffey,LAC,DAL,LAC,,,8,8,6,2
22023,1629599,22300151,"NOV 06, 2023",LAC @ NYK,L,4,0,0,0.0,0,0,0.0,0,0,0.0,0,0,0,0,0,0,0,0,0,2,1,Amir Coffey,LAC,NYK,LAC,,,0,0,0,0
22023,1629599,22300114,"OCT 31, 2023",LAC vs. ORL,W,10,0,1,0.0,0,0,0.0,0,0,0.0,0,0,0,0,0,0,1,1,0,-4,1,Amir Coffey,LAC,LAC,ORL,,,0,0,0,0
22023,1629599,22300099,"OCT 29, 2023",LAC vs. SAS,W,6,0,0,0.0,0,0,0.0,0,0,0.0,0,1,1,1,0,0,1,0,0,10,1,Amir Coffey,LAC,LAC,SAS,,,2,1,1,2
22023,1629599,22300074,"OCT 25, 2023",LAC vs. POR,W,4,0,1,0.0,0,0,0.0,2,2,1.0,0,0,0,1,0,0,0,0,2,-7,1,Amir Coffey,LAC,LAC,POR,,,3,2,3,1
22023,1628381,22300564,"JAN 15, 2024",UTA vs. IND,W,20,3,8,0.375,0,2,0.0,4,4,1.0,4,2,6,1,0,0,1,0,10,13,1,John Collins,UTA,UTA,IND,,,17,16,11,7
22023,1628381,22300549,"JAN 13, 2024",UTA vs. LAL,W,34,7,9,0.778,3,4,0.75,2,2,1.0,2,11,13,2,3,1,1,5,19,18,1,John Collins,UTA,UTA,LAL,,,34,32,21,15
22023,1628381,22300540,"JAN 12, 2024",UTA vs. TOR,W,14,2,3,0.667,0,1,0.0,0,0,0.0,1,6,7,1,0,0,1,4,4,2,1,John Collins,UTA,UTA,TOR,,,12,11,5,8
22023,1628381,22300524,"JAN 10, 2024",UTA vs. DEN,W,24,6,10,0.6,2,4,0.5,1,2,0.5,0,6,6,3,1,0,1,2,15,12,1,John Collins,UTA,UTA,DEN,,,24,21,18,9
22023,1628381,22300510,"JAN 08, 2024",UTA @ MIL,W,27,8,15,0.533,3,7,0.429,0,0,0.0,0,3,3,1,1,0,3,3,19,6,1,John Collins,UTA,MIL,UTA,,,23,22,20,4
22023,1628381,22300495,"JAN 06, 2024",UTA @ PHI,W,28,9,10,0.9,0,0,0.0,1,2,0.5,1,4,5,2,0,1,1,1,19,7,1,John Collins,UTA,PHI,UTA,,,26,24,21,7
22023,1628381,22300479,"JAN 05, 2024",UTA @ BOS,L,22,5,8,0.625,0,1,0.0,2,3,0.667,0,11,11,2,0,1,2,5,12,-28,1,John Collins,UTA,BOS,UTA,,,25,23,14,13
22023,1628381,22300474,"JAN 03, 2024",UTA vs. DET,W,24,7,13,0.538,2,6,0.333,1,2,0.5,4,0,4,3,0,0,2,3,17,-12,1,John Collins,UTA,UTA,DET,,,24,21,20,7
22023,1628381,22300457,"JAN 01, 2024",UTA vs. DAL,W,18,7,13,0.538,0,5,0.0,1,1,1.0,0,5,5,1,1,0,0,1,15,-1,1,John Collins,UTA,UTA,DAL,,,21,20,16,6
22023,1628381,22300439,"DEC 30, 2023",UTA vs. MIA,W,21,4,11,0.364,2,6,0.333,0,0,0.0,0,6,6,0,0,0,1,3,10,-6,1,John Collins,UTA,UTA,MIA,,,16,16,10,6
22023,1628381,22300424,"DEC 28, 2023",UTA @ NOP,L,26,3,7,0.429,1,3,0.333,1,2,0.5,3,9,12,0,0,1,1,2,8,-3,1,John Collins,UTA,NOP,UTA,,,20,20,8,12
22023,1628381,22300412,"DEC 26, 2023",UTA @ SAS,W,18,2,7,0.286,1,4,0.25,2,2,1.0,0,4,4,0,0,1,3,1,7,6,1,John Collins,UTA,SAS,UTA,,,11,11,7,4
22023,1628381,22300395,"DEC 23, 2023",UTA @ TOR,W,27,4,7,0.571,2,2,1.0,0,0,0.0,1,4,5,0,0,0,0,2,10,-8,1,John Collins,UTA,TOR,UTA,,,15,15,10,5
22023,1628381,22300374,"DEC 21, 2023",UTA @ DET,W,32,4,12,0.333,0,3,0.0,5,5,1.0,2,7,9,1,2,1,3,4,13,3,1,John Collins,UTA,DET,UTA,,,23,22,14,10
22023,1628381,22300364,"DEC 20, 2023",UTA @ CLE,L,23,5,8,0.625,2,4,0.5,4,4,1.0,0,5,5,0,1,1,2,1,16,-16,1,John Collins,UTA,CLE,UTA,,,21,21,16,5
22023,1628381,22300357,"DEC 18, 2023",UTA vs. BKN,W,20,4,9,0.444,3,4,0.75,0,0,0.0,1,2,3,0,0,1,4,2,11,5,1,John Collins,UTA,UTA,BKN,,,14,14,11,3
22023,1628381,22301225,"DEC 08, 2023",UTA vs. LAC,L,35,7,12,0.583,1,5,0.2,5,5,1.0,3,10,13,2,2,4,2,1,20,-18,1,John Collins,UTA,UTA,LAC,,,35,33,22,15
22023,1628381,22301213,"DEC 06, 2023",UTA @ DAL,L,23,5,11,0.455,0,2,0.0,0,0,0.0,2,6,8,0,0,0,2,2,10,-40,1,John Collins,UTA,DAL,UTA,,,18,18,10,8
22023,1628381,22300289,"DEC 02, 2023",UTA vs. POR,W,35,6,14,0.429,1,4,0.25,4,4,1.0,2,7,9,3,1,3,2,2,17,4,1,John Collins,UTA,UTA,POR,,,29,26,20,12
22023,1628381,22300270,"NOV 30, 2023",UTA @ MIN,L,28,3,12,0.25,1,4,0.25,2,2,1.0,3,9,12,0,0,0,4,4,9,-17,1,John Collins,UTA,MIN,UTA,,,21,21,9,12
22023,1628381,22300261,"NOV 29, 2023",UTA @ MEM,L,29,7,14,0.5,3,5,0.6,0,2,0.0,1,3,4,1,1,0,1,2,17,-8,1,John Collins,UTA,MEM,UTA,,,22,21,18,5
22023,1628381,22300256,"NOV 27, 2023",UTA vs. NOP,W,29,4,10,0.4,2,6,0.333,2,3,0.667,1,2,3,0,0,0,1,1,12,-2,1,John Collins,UTA,UTA,NOP,,,15,15,12,3
22023,1628381,22300243,"NOV 25, 2023",UTA vs. NOP,W,23,5,11,0.455,0,2,0.0,2,2,1.0,2,7,9,0,0,0,3,1,12,-6,1,John Collins,UTA,UTA,NOP,,,21,21,12,9
22023,1628381,22300237,"NOV 22, 2023",UTA @ POR,L,32,6,12,0.5,0,1,0.0,0,0,0.0,6,5,11,1,0,0,0,0,12,-8,1,John Collins,UTA,POR,UTA,,,24,23,13,12
22023,1628381,22300042,"NOV 21, 2023",UTA @ LAL,L,25,6,12,0.5,2,5,0.4,1,2,0.5,2,2,4,1,1,1,1,3,15,-29,1,John Collins,UTA,LAL,UTA,,,20,19,16,5
22023,1628381,22300214,"NOV 19, 2023",UTA vs. PHX,L,43,5,14,0.357,3,5,0.6,2,2,1.0,4,8,12,0,2,1,1,2,15,-4,1,John Collins,UTA,UTA,PHX,,,27,27,15,12
22023,1628381,22300035,"NOV 17, 2023",UTA vs. PHX,L,35,5,10,0.5,1,2,0.5,4,6,0.667,4,10,14,1,0,2,0,6,15,-7,1,John Collins,UTA,UTA,PHX,,,30,29,16,15
22023,1628381,22300023,"NOV 14, 2023",UTA vs. POR,W,32,6,16,0.375,2,5,0.4,0,0,0.0,4,6,10,2,1,3,1,3,14,6,1,John Collins,UTA,UTA,POR,,,26,24,16,12
22023,1628381,22300012,"NOV 10, 2023",UTA @ MEM,W,38,5,6,0.833,3,3,1.0,5,7,0.714,0,3,3,0,0,4,3,2,18,8,1,John Collins,UTA,MEM,UTA,,,21,21,18,3
22023,1628381,22300158,"NOV 08, 2023",UTA @ IND,L,27,6,9,0.667,1,2,0.5,1,1,1.0,1,8,9,1,0,0,2,3,14,-7,1,John Collins,UTA,IND,UTA,,,24,23,15,10
22023,1628381,22300152,"NOV 06, 2023",UTA @ CHI,L,29,6,9,0.667,1,2,0.5,1,1,1.0,1,5,6,0,1,0,2,5,14,-13,1,John Collins,UTA,CHI,UTA,,,20,20,14,6
22023,1628381,22300138,"NOV 04, 2023",UTA @ MIN,L,29,5,10,0.5,1,5,0.2,3,4,0.75,2,4,6,0,1,1,2,5,14,-21,1,John Collins,UTA,MIN,UTA,,,20,20,14,6
22023,1628381,22300130,"NOV 02, 2023",UTA vs. ORL,L,33,7,10,0.7,3,4,0.75,3,4,0.75,3,7,10,0,0,1,2,5,20,0,1,John Collins,UTA,UTA,ORL,,,30,30,20,10
22023,1628381,22300125,"NOV 01, 2023",UTA vs. MEM,W,27,5,12,0.417,2,5,0.4,4,6,0.667,2,2,4,2,2,0,1,2,16,21,1,John Collins,UTA,UTA,MEM,,,22,20,18,6
22023,1628381,22300110,"OCT 30, 2023",UTA @ DEN,L,34,7,16,0.438,1,3,0.333,0,3,0.0,3,6,9,1,1,0,0,3,15,-5,1,John Collins,UTA,DEN,UTA,,,25,24,16,10
22023,1628381,22300094,"OCT 28, 2023",UTA @ PHX,L,28,5,9,0.556,1,3,0.333,0,0,0.0,5,5,10,3,0,0,1,3,11,-28,1,John Collins,UTA,PHX,UTA,,,24,21,14,13
22023,1628381,22300085,"OCT 27, 2023",UTA vs. LAC,W,34,4,11,0.364,1,5,0.2,4,4,1.0,5,7,12,0,0,1,0,4,13,-4,1,John Collins,UTA,UTA,LAC,,,25,25,13,12
22023,1628381,22300072,"OCT 25, 2023",UTA vs. SAC,L,31,6,11,0.545,1,3,0.333,2,2,1.0,3,8,11,2,1,0,0,3,15,-9,1,John Collins,UTA,UTA,SAC,,,28,26,17,13
22023,1628380,22300437,"DEC 29, 2023",SAS @ POR,L,18,8,10,0.8,0,1,0.0,1,3,0.333,1,2,3,2,0,1,1,3,17,-13,1,Zach Collins,SAS,POR,SAS,,,22,20,19,5
22023,1628380,22300427,"DEC 28, 2023",SAS @ POR,W,17,4,9,0.444,0,2,0.0,3,4,0.75,1,6,7,2,0,0,1,6,11,7,1,Zach Collins,SAS,POR,SAS,,,20,18,13,9
22023,1628380,22300412,"DEC 26, 2023",SAS vs. UTA,L,18,3,6,0.5,0,0,0.0,0,0,0.0,1,3,4,4,0,2,1,4,6,-9,1,Zach Collins,SAS,SAS,UTA,,,14,10,10,8
22023,1628380,22300398,"DEC 23, 2023",SAS @ DAL,L,28,6,10,0.6,2,4,0.5,0,0,0.0,1,4,5,4,2,2,2,3,14,-27,1,Zach Collins,SAS,DAL,SAS,,,23,19,18,9
22023,1628380,22300376,"DEC 21, 2023",SAS @ CHI,L,28,5,10,0.5,2,4,0.5,2,2,1.0,3,6,9,2,0,3,1,2,14,-20,1,Zach Collins,SAS,CHI,SAS,,,25,23,16,11
22023,1628380,22300361,"DEC 19, 2023",SAS @ MIL,L,29,9,16,0.563,4,7,0.571,0,0,0.0,2,6,8,2,1,2,4,3,22,-9,1,Zach Collins,SAS,MIL,SAS,,,32,30,24,10
22023,1628380,22300345,"DEC 17, 2023",SAS vs. NOP,L,16,1,3,0.333,0,1,0.0,0,0,0.0,1,4,5,2,0,0,0,2,2,-18,1,Zach Collins,SAS,SAS,NOP,,,9,7,4,7
22023,1628380,22300331,"DEC 15, 2023",SAS vs. LAL,W,19,5,9,0.556,1,2,0.5,5,6,0.833,4,2,6,1,0,0,1,4,16,-1,1,Zach Collins,SAS,SAS,LAL,,,23,22,17,7
22023,1628380,22300316,"DEC 13, 2023",SAS vs. LAL,L,19,3,8,0.375,2,3,0.667,2,2,1.0,1,1,2,0,0,0,1,3,10,-2,1,Zach Collins,SAS,SAS,LAL,,,12,12,10,2
22023,1628380,22300298,"DEC 11, 2023",SAS @ HOU,L,14,1,4,0.25,0,0,0.0,0,0,0.0,0,4,4,0,0,0,2,3,2,3,1,Zach Collins,SAS,HOU,SAS,,,6,6,2,4
22023,1628380,22301223,"DEC 08, 2023",SAS vs. CHI,L,23,4,5,0.8,2,2,1.0,2,3,0.667,3,7,10,5,1,0,1,1,12,13,1,Zach Collins,SAS,SAS,CHI,,,27,22,17,15
22023,1628380,22301210,"DEC 06, 2023",SAS @ MIN,L,28,6,20,0.3,0,6,0.0,0,0,0.0,4,4,8,4,0,0,3,3,12,-13,1,Zach Collins,SAS,MIN,SAS,,,24,20,16,12
22023,1628380,22300278,"DEC 01, 2023",SAS @ NOP,L,24,3,11,0.273,1,5,0.2,5,6,0.833,3,2,5,3,2,1,3,2,12,-18,1,Zach Collins,SAS,NOP,SAS,,,20,17,15,8
22023,1628380,22300272,"NOV 30, 2023",SAS vs. ATL,L,34,3,5,0.6,1,2,0.5,4,4,1.0,0,2,2,7,0,0,3,3,11,0,1,Zach Collins,SAS,SAS,ATL,,,20,13,18,9
22023,1628380,22300252,"NOV 26, 2023",SAS @ DEN,L,21,4,9,0.444,1,4,0.25,0,0,0.0,2,2,4,3,1,0,4,4,9,-14,1,Zach Collins,SAS,DEN,SAS,,,16,13,12,7
22023,1628380,22300051,"NOV 24, 2023",SAS @ GSW,L,31,2,12,0.167,0,7,0.0,2,2,1.0,3,5,8,6,0,0,3,3,6,-7,1,Zach Collins,SAS,GSW,SAS,,,20,14,12,14
22023,1628380,22300235,"NOV 22, 2023",SAS vs. LAC,L,28,6,13,0.462,2,5,0.4,2,2,1.0,2,7,9,3,0,1,1,6,16,5,1,Zach Collins,SAS,SAS,LAC,,,28,25,19,12
22023,1628380,22300223,"NOV 20, 2023",SAS vs. LAC,L,28,4,11,0.364,1,5,0.2,3,4,0.75,0,3,3,0,2,0,3,1,12,-25,1,Zach Collins,SAS,SAS,LAC,,,15,15,12,3
22023,1628380,22300206,"NOV 18, 2023",SAS vs. MEM,L,26,4,8,0.5,1,3,0.333,7,8,0.875,4,3,7,6,0,0,3,6,16,1,1,Zach Collins,SAS,SAS,MEM,,,29,23,22,13
22023,1628380,22300032,"NOV 17, 2023",SAS vs. SAC,L,34,10,14,0.714,3,5,0.6,5,6,0.833,2,6,8,5,3,1,3,5,28,19,1,Zach Collins,SAS,SAS,SAC,,,41,36,33,13
22023,1628380,22300021,"NOV 14, 2023",SAS @ OKC,L,31,6,11,0.545,1,4,0.25,0,0,0.0,5,3,8,1,0,0,4,3,13,-33,1,Zach Collins,SAS,OKC,SAS,,,22,21,14,9
22023,1628380,22300184,"NOV 12, 2023",SAS vs. MIA,L,33,6,14,0.429,1,4,0.25,5,6,0.833,2,3,5,2,0,1,3,4,18,5,1,Zach Collins,SAS,SAS,MIA,,,25,23,20,7
22023,1628380,22300013,"NOV 10, 2023",SAS vs. MIN,L,24,5,6,0.833,1,2,0.5,0,0,0.0,1,1,2,5,0,1,1,5,11,-2,1,Zach Collins,SAS,SAS,MIN,,,18,13,16,7
22023,1628380,22300161,"NOV 08, 2023",SAS @ NYK,L,25,4,6,0.667,1,2,0.5,2,2,1.0,2,5,7,3,0,3,2,4,11,-12,1,Zach Collins,SAS,NYK,SAS,,,21,18,14,10
22023,1628380,22300146,"NOV 06, 2023",SAS @ IND,L,20,6,8,0.75,1,2,0.5,1,3,0.333,2,3,5,2,0,0,2,2,14,-12,1,Zach Collins,SAS,IND,SAS,,,21,19,16,7
22023,1628380,22300141,"NOV 05, 2023",SAS vs. TOR,L,38,8,17,0.471,1,6,0.167,4,6,0.667,2,9,11,5,0,1,1,3,21,-6,1,Zach Collins,SAS,SAS,TOR,,,37,32,26,16
22023,1628380,22300131,"NOV 02, 2023",SAS @ PHX,W,35,7,10,0.7,3,3,1.0,2,2,1.0,4,4,8,4,0,0,3,2,19,8,1,Zach Collins,SAS,PHX,SAS,,,31,27,23,12
22023,1628380,22300113,"OCT 31, 2023",SAS @ PHX,W,27,6,11,0.545,1,3,0.333,1,1,1.0,1,4,5,4,1,3,2,3,14,8,1,Zach Collins,SAS,PHX,SAS,,,23,19,18,9
22023,1628380,22300099,"OCT 29, 2023",SAS @ LAC,L,25,4,11,0.364,1,4,0.25,0,0,0.0,1,5,6,4,0,0,5,2,9,-36,1,Zach Collins,SAS,LAC,SAS,,,19,15,13,10
22023,1628380,22300083,"OCT 27, 2023",SAS vs. HOU,W,39,4,12,0.333,0,7,0.0,1,3,0.333,0,6,6,8,4,0,4,5,9,-4,1,Zach Collins,SAS,SAS,HOU,,,23,15,17,14
22023,1628380,22300073,"OCT 25, 2023",SAS vs. DAL,L,32,6,10,0.6,0,4,0.0,2,2,1.0,1,4,5,3,1,2,3,4,14,-4,1,Zach Collins,SAS,SAS,DAL,,,22,19,17,8
22023,201144,22300553,"JAN 14, 2024",MIN vs. LAC,W,32,2,7,0.286,2,6,0.333,0,0,0.0,1,1,2,5,1,0,2,2,6,-4,1,Mike Conley,MIN,MIN,LAC,,,13,8,11,7
22023,201144,22300538,"JAN 12, 2024",MIN vs. POR,W,20,3,7,0.429,3,5,0.6,0,0,0.0,0,4,4,10,0,0,0,1,9,34,1,Mike Conley,MIN,MIN,POR,,,23,13,19,14
22023,201144,22300513,"JAN 09, 2024",MIN @ ORL,W,31,3,8,0.375,3,6,0.5,2,2,1.0,0,3,3,10,2,0,1,3,11,23,1,Mike Conley,MIN,ORL,MIN,,,24,14,21,13
22023,201144,22300501,"JAN 07, 2024",MIN @ DAL,L,32,3,7,0.429,3,6,0.5,0,0,0.0,0,1,1,7,0,0,2,1,9,-1,1,Mike Conley,MIN,DAL,MIN,,,17,10,16,8
22023,201144,22300485,"JAN 05, 2024",MIN @ HOU,W,25,3,8,0.375,2,5,0.4,0,0,0.0,0,2,2,5,0,0,0,3,8,13,1,Mike Conley,MIN,HOU,MIN,,,15,10,13,7
22023,201144,22300471,"JAN 03, 2024",MIN vs. NOP,L,26,3,5,0.6,1,3,0.333,0,0,0.0,0,0,0,9,1,0,0,1,7,-14,1,Mike Conley,MIN,MIN,NOP,,,16,7,16,9
22023,201144,22300451,"JAN 01, 2024",MIN @ NYK,L,29,2,6,0.333,0,1,0.0,1,1,1.0,0,2,2,5,1,1,0,1,5,-11,1,Mike Conley,MIN,NYK,MIN,,,12,7,10,7
22023,201144,22300443,"DEC 30, 2023",MIN vs. LAL,W,33,4,11,0.364,4,9,0.444,3,4,0.75,1,3,4,7,1,0,1,2,15,3,1,Mike Conley,MIN,MIN,LAL,,,26,19,22,11
22023,201144,22300423,"DEC 28, 2023",MIN vs. DAL,W,28,3,7,0.429,2,4,0.5,2,2,1.0,1,1,2,6,0,1,1,5,10,15,1,Mike Conley,MIN,MIN,DAL,,,18,12,16,8
22023,201144,22300411,"DEC 26, 2023",MIN @ OKC,L,25,6,10,0.6,5,7,0.714,0,0,0.0,0,2,2,4,2,0,0,0,17,-10,1,Mike Conley,MIN,OKC,MIN,,,23,19,21,6
22023,201144,22300400,"DEC 23, 2023",MIN @ SAC,W,32,4,10,0.4,3,7,0.429,1,1,1.0,0,7,7,9,2,0,2,1,12,28,1,Mike Conley,MIN,SAC,MIN,,,28,19,21,16
22023,201144,22300380,"DEC 21, 2023",MIN vs. LAL,W,30,6,9,0.667,4,6,0.667,0,0,0.0,0,1,1,8,2,1,1,1,16,3,1,Mike Conley,MIN,MIN,LAL,,,25,17,24,9
22023,201144,22300367,"DEC 20, 2023",MIN @ PHI,L,26,3,7,0.429,1,4,0.25,2,2,1.0,0,0,0,4,0,0,2,1,9,1,1,Mike Conley,MIN,PHI,MIN,,,13,9,13,4
22023,201144,22300353,"DEC 18, 2023",MIN @ MIA,W,33,4,5,0.8,4,5,0.8,2,2,1.0,0,1,1,6,1,0,4,1,14,4,1,Mike Conley,MIN,MIA,MIN,,,21,15,20,7
22023,201144,22300338,"DEC 16, 2023",MIN vs. IND,W,24,2,5,0.4,1,3,0.333,0,0,0.0,0,2,2,9,1,0,0,0,5,21,1,Mike Conley,MIN,MIN,IND,,,16,7,14,11
22023,201144,22300321,"DEC 14, 2023",MIN @ DAL,W,29,5,9,0.556,2,4,0.5,2,2,1.0,0,2,2,3,1,0,1,2,14,7,1,Mike Conley,MIN,DAL,MIN,,,19,16,17,5
22023,201144,22300301,"DEC 11, 2023",MIN @ NOP,L,27,6,11,0.545,4,7,0.571,1,2,0.5,1,4,5,7,0,0,3,1,17,-19,1,Mike Conley,MIN,NOP,MIN,,,29,22,24,12
22023,201144,22301221,"DEC 08, 2023",MIN @ MEM,W,32,6,11,0.545,2,3,0.667,5,5,1.0,0,4,4,7,0,0,2,1,19,25,1,Mike Conley,MIN,MEM,MIN,,,30,23,26,11
22023,201144,22301210,"DEC 06, 2023",MIN vs. SAS,W,33,5,13,0.385,4,10,0.4,4,4,1.0,0,4,4,4,3,0,1,3,18,9,1,Mike Conley,MIN,MIN,SAS,,,26,22,22,8
22023,201144,22300281,"DEC 02, 2023",MIN @ CHA,W,34,3,9,0.333,1,7,0.143,7,8,0.875,0,5,5,10,0,0,1,2,14,10,1,Mike Conley,MIN,CHA,MIN,,,29,19,24,15
22023,201144,22300270,"NOV 30, 2023",MIN vs. UTA,W,29,2,6,0.333,2,6,0.333,2,2,1.0,0,3,3,7,2,0,2,3,8,4,1,Mike Conley,MIN,MIN,UTA,,,18,11,15,10
22023,201144,22300058,"NOV 28, 2023",MIN vs. OKC,W,37,3,14,0.214,3,10,0.3,0,0,0.0,0,2,2,8,1,0,0,2,9,17,1,Mike Conley,MIN,MIN,OKC,,,19,11,17,10
22023,201144,22300249,"NOV 26, 2023",MIN @ MEM,W,32,6,11,0.545,6,9,0.667,0,0,0.0,0,4,4,10,1,0,2,1,18,8,1,Mike Conley,MIN,MEM,MIN,,,32,22,28,14
22023,201144,22300050,"NOV 24, 2023",MIN vs. SAC,L,30,2,7,0.286,2,3,0.667,0,0,0.0,1,2,3,9,1,0,1,1,6,-10,1,Mike Conley,MIN,MIN,SAC,,,18,9,15,12
22023,201144,22300232,"NOV 22, 2023",MIN vs. PHI,W,23,2,5,0.4,1,2,0.5,0,0,0.0,0,0,0,8,3,0,1,1,5,6,1,Mike Conley,MIN,MIN,PHI,,,13,5,13,8
22023,201144,22300221,"NOV 20, 2023",MIN vs. NYK,W,28,3,9,0.333,3,8,0.375,2,2,1.0,0,1,1,5,0,1,0,3,11,20,1,Mike Conley,MIN,MIN,NYK,,,17,12,16,6
22023,201144,22300203,"NOV 18, 2023",MIN @ NOP,W,30,2,8,0.25,1,5,0.2,0,0,0.0,0,3,3,5,1,0,3,1,5,-5,1,Mike Conley,MIN,NOP,MIN,,,13,8,10,8
22023,201144,22300197,"NOV 15, 2023",MIN @ PHX,L,22,5,8,0.625,1,3,0.333,3,3,1.0,1,1,2,3,0,0,0,0,14,-16,1,Mike Conley,MIN,PHX,MIN,,,19,16,17,5
22023,201144,22300025,"NOV 14, 2023",MIN @ GSW,W,31,4,6,0.667,3,4,0.75,2,2,1.0,0,2,2,8,2,0,1,1,13,12,1,Mike Conley,MIN,GSW,MIN,,,23,15,21,10
22023,201144,22300186,"NOV 12, 2023",MIN @ GSW,W,31,3,7,0.429,1,5,0.2,1,1,1.0,1,4,5,9,0,0,1,4,8,6,1,Mike Conley,MIN,GSW,MIN,,,22,13,17,14
22023,201144,22300013,"NOV 10, 2023",MIN @ SAS,W,31,3,7,0.429,1,3,0.333,4,4,1.0,2,1,3,6,0,0,4,3,11,4,1,Mike Conley,MIN,SAS,MIN,,,20,14,17,9
22023,201144,22300166,"NOV 08, 2023",MIN vs. NOP,W,21,4,5,0.8,4,5,0.8,0,0,0.0,0,4,4,4,1,0,0,2,12,16,1,Mike Conley,MIN,MIN,NOP,,,20,16,16,8
22023,201144,22300154,"NOV 06, 2023",MIN vs. BOS,W,36,3,5,0.6,2,3,0.667,0,0,0.0,0,2,2,3,2,0,0,1,8,-18,1,Mike Conley,MIN,MIN,BOS,,,13,10,11,5
22023,201144,22300138,"NOV 04, 2023",MIN vs. UTA,W,28,3,9,0.333,1,4,0.25,0,0,0.0,0,3,3,6,1,0,0,4,7,23,1,Mike Conley,MIN,MIN,UTA,,,16,10,13,9
22023,201144,22300123,"NOV 01, 2023",MIN vs. DEN,W,27,7,9,0.778,3,4,0.75,0,0,0.0,0,3,3,6,1,0,0,1,17,19,1,Mike Conley,MIN,MIN,DEN,,,26,20,23,9
22023,201144,22300104,"OCT 30, 2023",MIN @ ATL,L,28,2,9,0.222,2,6,0.333,0,0,0.0,1,1,2,3,0,0,0,3,6,-12,1,Mike Conley,MIN,ATL,MIN,,,11,8,9,5
22023,201144,22300093,"OCT 28, 2023",MIN vs. MIA,W,29,6,10,0.6,2,6,0.333,0,0,0.0,2,2,4,5,1,0,0,1,14,21,1,Mike Conley,MIN,MIN,MIA,,,23,18,19,9
22023,201144,22300069,"OCT 25, 2023",MIN @ TOR,L,31,4,9,0.444,1,4,0.25,2,2,1.0,1,3,4,3,1,1,1,1,11,-6,1,Mike Conley,MIN,TOR,MIN,,,18,15,14,7
22023,1626192,22300552,"JAN 14, 2024",MIL vs. SAC,W,33,1,3,0.333,1,3,0.333,2,2,1.0,0,3,3,2,0,0,0,3,5,5,1,Pat Connaughton,MIL,MIL,SAC,,,10,8,7,5
22023,1626192,22300545,"JAN 13, 2024",MIL vs. GSW,W,22,1,4,0.25,1,3,0.333,0,0,0.0,0,2,2,2,1,1,0,1,3,7,1,Pat Connaughton,MIL,MIL,GSW,,,7,5,5,4
22023,1626192,22300528,"JAN 11, 2024",MIL vs. BOS,W,21,1,1,1.0,0,0,0.0,0,0,0.0,1,0,1,3,0,0,0,3,2,20,1,Pat Connaughton,MIL,MIL,BOS,,,6,3,5,4
22023,1626192,22300510,"JAN 08, 2024",MIL vs. UTA,L,22,2,3,0.667,2,3,0.667,0,0,0.0,0,2,2,1,0,0,0,3,6,-12,1,Pat Connaughton,MIL,MIL,UTA,,,9,8,7,3
22023,1626192,22300496,"JAN 06, 2024",MIL @ HOU,L,19,3,5,0.6,3,5,0.6,0,0,0.0,0,1,1,1,0,0,0,0,9,-13,1,Pat Connaughton,MIL,HOU,MIL,,,11,10,10,2
22023,1626192,22300477,"JAN 04, 2024",MIL @ SAS,W,28,2,4,0.5,2,4,0.5,1,2,0.5,1,5,6,0,1,0,3,0,7,3,1,Pat Connaughton,MIL,SAS,MIL,,,13,13,7,6
22023,1626192,22300466,"JAN 03, 2024",MIL @ IND,L,14,1,3,0.333,1,2,0.5,0,0,0.0,1,1,2,1,0,0,0,3,3,-4,1,Pat Connaughton,MIL,IND,MIL,,,6,5,4,3
22023,1626192,22300454,"JAN 01, 2024",MIL vs. IND,L,24,1,3,0.333,1,3,0.333,0,0,0.0,0,2,2,2,1,1,0,1,3,-22,1,Pat Connaughton,MIL,MIL,IND,,,7,5,5,4
22023,1626192,22300433,"DEC 29, 2023",MIL @ CLE,W,23,1,3,0.333,1,3,0.333,0,0,0.0,0,1,1,3,0,0,1,0,3,6,1,Pat Connaughton,MIL,CLE,MIL,,,7,4,6,4
22023,1626192,22300417,"DEC 27, 2023",MIL @ BKN,W,18,1,3,0.333,1,3,0.333,0,0,0.0,1,0,1,1,0,0,0,0,3,14,1,Pat Connaughton,MIL,BKN,MIL,,,5,4,4,2
22023,1626192,22300401,"DEC 25, 2023",MIL @ NYK,L,24,1,4,0.25,1,4,0.25,0,0,0.0,4,3,7,1,1,0,0,3,3,-13,1,Pat Connaughton,MIL,NYK,MIL,,,11,10,4,8
22023,1626192,22300388,"DEC 23, 2023",MIL @ NYK,W,22,3,6,0.5,2,5,0.4,0,0,0.0,0,8,8,0,0,0,0,0,8,7,1,Pat Connaughton,MIL,NYK,MIL,,,16,16,8,8
22023,1626192,22300378,"DEC 21, 2023",MIL vs. ORL,W,21,3,6,0.5,0,3,0.0,2,2,1.0,2,6,8,2,0,0,0,4,8,-6,1,Pat Connaughton,MIL,MIL,ORL,,,18,16,10,10
22023,1626192,22300361,"DEC 19, 2023",MIL vs. SAS,W,18,1,8,0.125,1,6,0.167,0,0,0.0,0,3,3,2,1,0,0,2,3,5,1,Pat Connaughton,MIL,MIL,SAS,,,8,6,5,5
22023,1626192,22300346,"DEC 17, 2023",MIL vs. HOU,W,17,2,4,0.5,1,3,0.333,0,0,0.0,1,1,2,4,1,0,1,0,5,12,1,Pat Connaughton,MIL,MIL,HOU,,,11,7,9,6
22023,1626192,22300334,"DEC 16, 2023",MIL vs. DET,W,12,2,2,1.0,1,1,1.0,1,1,1.0,1,3,4,2,0,1,0,1,6,28,1,Pat Connaughton,MIL,MIL,DET,,,12,10,8,6
22023,1626192,22300056,"NOV 28, 2023",MIL @ MIA,W,15,3,5,0.6,1,3,0.333,0,0,0.0,0,1,1,1,0,0,0,0,7,-8,1,Pat Connaughton,MIL,MIA,MIL,,,9,8,8,2
22023,1626192,22300245,"NOV 26, 2023",MIL vs. POR,W,20,2,4,0.5,1,2,0.5,0,0,0.0,2,2,4,1,1,0,2,1,5,4,1,Pat Connaughton,MIL,MIL,POR,,,10,9,6,5
22023,1626192,22300049,"NOV 24, 2023",MIL vs. WAS,W,27,1,5,0.2,0,3,0.0,0,2,0.0,0,4,4,1,1,0,1,1,2,2,1,Pat Connaughton,MIL,MIL,WAS,,,7,6,3,5
22023,1626192,22300228,"NOV 22, 2023",MIL @ BOS,L,20,1,2,0.5,1,2,0.5,0,0,0.0,0,3,3,0,0,1,1,0,3,-9,1,Pat Connaughton,MIL,BOS,MIL,,,6,6,3,3
22023,1626192,22300219,"NOV 20, 2023",MIL @ WAS,W,26,1,2,0.5,1,2,0.5,0,0,0.0,1,3,4,4,0,0,0,1,3,-4,1,Pat Connaughton,MIL,WAS,MIL,,,11,7,7,8
22023,1626192,22300205,"NOV 18, 2023",MIL vs. DAL,W,35,6,12,0.5,4,9,0.444,0,0,0.0,2,3,5,3,2,0,2,1,16,22,1,Pat Connaughton,MIL,MIL,DAL,,,24,21,19,8
22023,1626192,22300027,"NOV 17, 2023",MIL @ CHA,W,31,4,9,0.444,3,6,0.5,0,0,0.0,1,6,7,3,0,0,1,0,11,2,1,Pat Connaughton,MIL,CHA,MIL,,,21,18,14,10
22023,1626192,22300195,"NOV 15, 2023",MIL @ TOR,W,22,1,3,0.333,1,3,0.333,0,0,0.0,1,6,7,0,0,0,1,2,3,10,1,Pat Connaughton,MIL,TOR,MIL,,,10,10,3,7
22023,1626192,22300190,"NOV 13, 2023",MIL vs. CHI,W,29,1,3,0.333,1,3,0.333,3,3,1.0,1,7,8,5,1,0,0,4,6,9,1,Pat Connaughton,MIL,MIL,CHI,,,19,14,11,13
22023,1626192,22300173,"NOV 11, 2023",MIL @ ORL,L,16,1,3,0.333,0,1,0.0,1,2,0.5,0,3,3,1,0,0,0,2,3,-11,1,Pat Connaughton,MIL,ORL,MIL,,,7,6,4,4
22023,1626192,22300171,"NOV 09, 2023",MIL @ IND,L,25,3,6,0.5,1,3,0.333,1,1,1.0,0,2,2,4,1,0,0,0,8,17,1,Pat Connaughton,MIL,IND,MIL,,,14,10,12,6
22023,1626192,22300165,"NOV 08, 2023",MIL vs. DET,W,19,1,3,0.333,0,1,0.0,0,0,0.0,0,0,0,1,0,0,1,0,2,-4,1,Pat Connaughton,MIL,MIL,DET,,,3,2,3,1
22023,1626192,22300149,"NOV 06, 2023",MIL @ BKN,W,19,4,7,0.571,2,5,0.4,0,0,0.0,1,0,1,3,0,0,1,1,10,-1,1,Pat Connaughton,MIL,BKN,MIL,,,14,11,13,4
22023,1626192,22300002,"NOV 03, 2023",MIL vs. NYK,W,24,1,4,0.25,0,2,0.0,0,0,0.0,2,0,2,2,1,0,1,2,2,-4,1,Pat Connaughton,MIL,MIL,NYK,,,6,4,4,4
22023,1626192,22300116,"NOV 01, 2023",MIL @ TOR,L,23,1,2,0.5,0,1,0.0,1,2,0.5,0,2,2,1,0,0,1,1,3,-10,1,Pat Connaughton,MIL,TOR,MIL,,,6,5,4,3
22023,1626192,22300107,"OCT 30, 2023",MIL vs. MIA,W,23,3,5,0.6,2,3,0.667,0,0,0.0,0,5,5,2,0,1,1,2,8,5,1,Pat Connaughton,MIL,MIL,MIA,,,15,13,10,7
22023,1626192,22300097,"OCT 29, 2023",MIL vs. ATL,L,23,2,9,0.222,1,6,0.167,0,0,0.0,1,2,3,2,2,0,1,1,5,-15,1,Pat Connaughton,MIL,MIL,ATL,,,10,8,7,5
22023,1626192,22300075,"OCT 26, 2023",MIL vs. PHI,W,20,2,6,0.333,1,4,0.25,2,2,1.0,0,2,2,2,0,1,0,0,7,-5,1,Pat Connaughton,MIL,MIL,PHI,,,11,9,9,4
22023,1641731,22300558,"JAN 15, 2024",WAS vs. DET,L,27,1,4,0.25,0,1,0.0,0,0,0.0,1,3,4,2,0,0,0,2,2,-20,1,Bilal Coulibaly,WAS,WAS,DET,,,8,6,4,6
22023,1641731,22300543,"JAN 13, 2024",WAS @ ATL,W,28,3,8,0.375,1,2,0.5,5,6,0.833,0,6,6,3,2,1,1,4,12,23,1,Bilal Coulibaly,WAS,ATL,WAS,,,21,18,15,9
22023,1641731,22300520,"JAN 10, 2024",WAS @ IND,L,22,1,5,0.2,0,1,0.0,3,4,0.75,1,5,6,1,0,1,0,4,5,-7,1,Bilal Coulibaly,WAS,IND,WAS,,,12,11,6,7
22023,1641731,22300508,"JAN 08, 2024",WAS vs. OKC,L,25,1,4,0.25,1,2,0.5,2,2,1.0,1,4,5,3,0,2,0,2,5,1,1,Bilal Coulibaly,WAS,WAS,OKC,,,13,10,8,8
22023,1641731,22300494,"JAN 06, 2024",WAS vs. NYK,L,28,2,5,0.4,0,2,0.0,0,0,0.0,2,1,3,3,0,0,3,3,4,-22,1,Bilal Coulibaly,WAS,WAS,NYK,,,10,7,7,6
22023,1641731,22300482,"JAN 05, 2024",WAS @ CLE,L,36,6,13,0.462,2,4,0.5,1,3,0.333,2,5,7,1,1,3,1,0,15,-9,1,Bilal Coulibaly,WAS,CLE,WAS,,,23,22,16,8
22023,1641731,22300465,"JAN 03, 2024",WAS @ CLE,L,33,2,12,0.167,1,4,0.25,0,2,0.0,1,4,5,1,3,2,2,4,5,-24,1,Bilal Coulibaly,WAS,CLE,WAS,,,11,10,6,6
22023,1641731,22300445,"DEC 31, 2023",WAS vs. ATL,L,17,0,3,0.0,0,1,0.0,2,2,1.0,1,3,4,3,0,0,0,2,2,-18,1,Bilal Coulibaly,WAS,WAS,ATL,,,9,6,5,7
22023,1641731,22300430,"DEC 29, 2023",WAS vs. BKN,W,20,2,3,0.667,0,0,0.0,0,0,0.0,2,4,6,2,0,0,1,3,4,7,1,Bilal Coulibaly,WAS,WAS,BKN,,,12,10,6,8
22023,1641731,22300416,"DEC 27, 2023",WAS vs. TOR,L,25,4,8,0.5,1,4,0.25,1,2,0.5,0,4,4,2,0,0,1,2,10,-11,1,Bilal Coulibaly,WAS,WAS,TOR,,,16,14,12,6
22023,1641731,22300407,"DEC 26, 2023",WAS vs. ORL,L,26,1,1,1.0,0,0,0.0,2,2,1.0,2,4,6,3,0,2,2,4,4,-2,1,Bilal Coulibaly,WAS,WAS,ORL,,,13,10,7,9
22023,1641731,22300386,"DEC 22, 2023",WAS @ GSW,L,32,3,8,0.375,1,2,0.5,0,0,0.0,0,3,3,2,1,1,2,1,7,-12,1,Bilal Coulibaly,WAS,GSW,WAS,,,12,10,9,5
22023,1641731,22300381,"DEC 21, 2023",WAS @ POR,W,18,1,1,1.0,0,0,0.0,0,0,0.0,0,2,2,2,0,0,0,5,2,-13,1,Bilal Coulibaly,WAS,POR,WAS,,,6,4,4,4
22023,1641731,22300358,"DEC 18, 2023",WAS @ SAC,L,33,3,7,0.429,0,2,0.0,5,7,0.714,1,3,4,2,0,1,0,1,11,1,1,Bilal Coulibaly,WAS,SAC,WAS,,,17,15,13,6
22023,1641731,22300347,"DEC 17, 2023",WAS @ PHX,L,20,2,7,0.286,2,6,0.333,0,0,0.0,0,1,1,1,0,0,0,3,6,-11,1,Bilal Coulibaly,WAS,PHX,WAS,,,8,7,7,2
22023,1641731,22300328,"DEC 15, 2023",WAS vs. IND,W,30,6,9,0.667,2,3,0.667,3,3,1.0,1,4,5,0,2,1,4,2,17,8,1,Bilal Coulibaly,WAS,WAS,IND,,,22,22,17,5
22023,1641731,22300311,"DEC 13, 2023",WAS vs. NOP,L,32,6,9,0.667,4,6,0.667,0,2,0.0,1,4,5,1,1,1,2,3,16,-30,1,Bilal Coulibaly,WAS,WAS,NOP,,,22,21,17,6
22023,1641731,22300295,"DEC 11, 2023",WAS @ PHI,L,31,4,11,0.364,2,7,0.286,3,6,0.5,3,5,8,4,1,1,3,0,13,-33,1,Bilal Coulibaly,WAS,PHI,WAS,,,25,21,17,12
22023,1641731,22301219,"DEC 08, 2023",WAS @ BKN,L,25,4,6,0.667,1,2,0.5,2,4,0.5,4,6,10,2,0,0,2,3,11,-22,1,Bilal Coulibaly,WAS,BKN,WAS,,,23,21,13,12
22023,1641731,22301208,"DEC 06, 2023",WAS vs. PHI,L,28,6,10,0.6,1,5,0.2,1,1,1.0,0,1,1,3,3,0,2,1,14,-7,1,Bilal Coulibaly,WAS,WAS,PHI,,,18,15,17,4
22023,1641731,22300274,"DEC 01, 2023",WAS @ ORL,L,32,6,7,0.857,0,0,0.0,0,0,0.0,1,4,5,0,3,0,2,1,12,1,1,Bilal Coulibaly,WAS,ORL,WAS,,,17,17,12,5
22023,1641731,22300259,"NOV 29, 2023",WAS @ ORL,L,25,2,5,0.4,1,1,1.0,2,2,1.0,1,4,5,0,0,0,2,1,7,-17,1,Bilal Coulibaly,WAS,ORL,WAS,,,12,12,7,5
22023,1641731,22300253,"NOV 27, 2023",WAS @ DET,W,28,2,6,0.333,0,2,0.0,1,1,1.0,0,4,4,0,2,1,2,1,5,19,1,Bilal Coulibaly,WAS,DET,WAS,,,9,9,5,4
22023,1641731,22300241,"NOV 25, 2023",WAS vs. ATL,L,32,3,5,0.6,1,2,0.5,0,0,0.0,0,3,3,2,1,1,3,1,7,-1,1,Bilal Coulibaly,WAS,WAS,ATL,,,12,10,9,5
22023,1641731,22300225,"NOV 22, 2023",WAS @ CHA,L,19,2,6,0.333,0,2,0.0,3,3,1.0,0,0,0,2,0,1,1,4,7,-16,1,Bilal Coulibaly,WAS,CHA,WAS,,,9,7,9,2
22023,1641731,22300219,"NOV 20, 2023",WAS vs. MIL,L,25,5,7,0.714,2,2,1.0,0,0,0.0,1,2,3,1,2,0,1,3,12,4,1,Bilal Coulibaly,WAS,WAS,MIL,,,16,15,13,4
22023,1641731,22300028,"NOV 17, 2023",WAS vs. NYK,L,31,2,7,0.286,0,3,0.0,2,3,0.667,0,3,3,4,0,1,2,1,6,-17,1,Bilal Coulibaly,WAS,WAS,NYK,,,13,9,10,7
22023,1641731,22300192,"NOV 15, 2023",WAS vs. DAL,L,28,4,5,0.8,2,2,1.0,0,0,0.0,0,8,8,2,0,1,0,3,10,-8,1,Bilal Coulibaly,WAS,WAS,DAL,,,20,18,12,10
22023,1641731,22300189,"NOV 13, 2023",WAS @ TOR,L,33,4,7,0.571,1,1,1.0,1,3,0.333,1,6,7,3,3,1,0,4,10,-18,1,Bilal Coulibaly,WAS,TOR,WAS,,,20,17,13,10
22023,1641731,22300178,"NOV 12, 2023",WAS @ BKN,L,34,8,12,0.667,4,7,0.571,0,1,0.0,1,6,7,3,4,0,2,0,20,2,1,Bilal Coulibaly,WAS,BKN,WAS,,,30,27,23,10
22023,1641731,22300009,"NOV 10, 2023",WAS vs. CHA,L,20,2,4,0.5,2,4,0.5,4,4,1.0,0,2,2,1,0,0,2,1,10,15,1,Bilal Coulibaly,WAS,WAS,CHA,,,13,12,11,3
22023,1641731,22300157,"NOV 08, 2023",WAS @ CHA,W,30,2,3,0.667,2,3,0.667,0,0,0.0,0,2,2,1,0,0,0,5,6,23,1,Bilal Coulibaly,WAS,CHA,WAS,,,9,8,7,3
22023,1641731,22300148,"NOV 06, 2023",WAS @ PHI,L,19,3,7,0.429,1,3,0.333,3,3,1.0,0,3,3,0,0,1,0,3,10,-15,1,Bilal Coulibaly,WAS,PHI,WAS,,,13,13,10,3
22023,1641731,22300003,"NOV 03, 2023",WAS @ MIA,L,26,4,5,0.8,1,2,0.5,0,2,0.0,0,3,3,3,0,0,1,1,9,13,1,Bilal Coulibaly,WAS,MIA,WAS,,,15,12,12,6
22023,1641731,22300117,"NOV 01, 2023",WAS @ ATL,L,28,2,5,0.4,1,4,0.25,0,2,0.0,1,2,3,3,3,0,3,2,5,15,1,Bilal Coulibaly,WAS,ATL,WAS,,,11,8,8,6
22023,1641731,22300103,"OCT 30, 2023",WAS vs. BOS,L,28,4,12,0.333,1,6,0.167,0,0,0.0,2,3,5,1,1,2,1,0,9,-5,1,Bilal Coulibaly,WAS,WAS,BOS,,,15,14,10,6
22023,1641731,22300089,"OCT 28, 2023",WAS vs. MEM,W,14,0,2,0.0,0,1,0.0,0,0,0.0,0,1,1,0,0,1,1,1,0,-6,1,Bilal Coulibaly,WAS,WAS,MEM,,,1,1,0,1
22023,1641731,22300064,"OCT 25, 2023",WAS @ IND,L,23,1,3,0.333,1,1,1.0,0,0,0.0,0,4,4,3,0,3,3,1,3,-13,1,Bilal Coulibaly,WAS,IND,WAS,,,10,7,6,7
22023,1641741,22300459,"JAN 02, 2024",PHI vs. CHI,W,6,0,1,0.0,0,1,0.0,0,0,0.0,0,0,0,0,0,0,0,0,0,-12,1,Ricky Council IV,PHI,PHI,CHI,,,0,0,0,0
22023,203496,22300442,"DEC 30, 2023",PHI @ CHI,L,5,0,1,0.0,0,1,0.0,0,0,0.0,0,1,1,0,0,0,0,0,0,1,1,Robert Covington,PHI,CHI,PHI,,,1,1,0,1
22023,203496,22300434,"DEC 29, 2023",PHI @ HOU,W,16,3,5,0.6,0,1,0.0,1,1,1.0,2,2,4,0,3,0,0,4,7,3,1,Robert Covington,PHI,HOU,PHI,,,11,11,7,4
22023,203496,22300415,"DEC 27, 2023",PHI @ ORL,W,11,1,2,0.5,0,1,0.0,0,1,0.0,0,1,1,2,2,0,1,2,2,0,1,Robert Covington,PHI,ORL,PHI,,,5,3,4,3
22023,203496,22300382,"DEC 22, 2023",PHI vs. TOR,W,24,0,1,0.0,0,1,0.0,0,0,0.0,0,3,3,2,1,1,0,4,0,15,1,Robert Covington,PHI,PHI,TOR,,,5,3,2,5
22023,203496,22300351,"DEC 18, 2023",PHI vs. CHI,L,15,1,3,0.333,0,0,0.0,0,0,0.0,1,1,2,0,2,1,0,2,2,-15,1,Robert Covington,PHI,PHI,CHI,,,4,4,2,2
22023,203496,22300335,"DEC 16, 2023",PHI @ CHA,W,14,0,0,0.0,0,0,0.0,0,0,0.0,0,3,3,0,0,1,1,2,0,9,1,Robert Covington,PHI,CHA,PHI,,,3,3,0,3
22023,203496,22300327,"DEC 15, 2023",PHI vs. DET,W,13,0,2,0.0,0,1,0.0,0,0,0.0,1,2,3,0,1,0,1,0,0,10,1,Robert Covington,PHI,PHI,DET,,,3,3,0,3
22023,203496,22300310,"DEC 13, 2023",PHI @ DET,W,17,2,4,0.5,0,2,0.0,1,1,1.0,0,6,6,2,0,0,1,2,5,1,1,Robert Covington,PHI,DET,PHI,,,13,11,7,8
22023,203496,22300295,"DEC 11, 2023",PHI vs. WAS,W,14,2,3,0.667,2,3,0.667,2,2,1.0,1,3,4,0,1,0,0,1,8,18,1,Robert Covington,PHI,PHI,WAS,,,12,12,8,4
22023,203496,22301208,"DEC 06, 2023",PHI @ WAS,W,4,0,0,0.0,0,0,0.0,0,0,0.0,0,1,1,0,0,0,1,1,0,-3,1,Robert Covington,PHI,WAS,PHI,,,1,1,0,1
22023,203496,22300275,"DEC 01, 2023",PHI @ BOS,L,30,4,9,0.444,3,6,0.5,7,7,1.0,3,2,5,1,5,1,2,4,18,-9,1,Robert Covington,PHI,BOS,PHI,,,24,23,19,6
22023,203496,22300262,"NOV 29, 2023",PHI @ NOP,L,30,4,5,0.8,4,4,1.0,0,0,0.0,2,5,7,1,0,1,0,3,12,11,1,Robert Covington,PHI,NOP,PHI,,,20,19,13,8
22023,203496,22300255,"NOV 27, 2023",PHI vs. LAL,W,18,0,3,0.0,0,2,0.0,0,0,0.0,3,4,7,2,0,1,0,1,0,14,1,Robert Covington,PHI,PHI,LAL,,,9,7,2,9
22023,203496,22300239,"NOV 25, 2023",PHI @ OKC,W,21,3,5,0.6,2,3,0.667,1,2,0.5,0,1,1,0,1,1,0,5,9,-8,1,Robert Covington,PHI,OKC,PHI,,,10,10,9,1
22023,203496,22300232,"NOV 22, 2023",PHI @ MIN,L,20,2,4,0.5,0,1,0.0,1,2,0.5,1,5,6,0,0,2,0,2,5,6,1,Robert Covington,PHI,MIN,PHI,,,11,11,5,6
22023,203496,22300040,"NOV 21, 2023",PHI vs. CLE,L,14,1,3,0.333,1,2,0.5,0,0,0.0,3,4,7,1,2,2,1,0,3,-3,1,Robert Covington,PHI,PHI,CLE,,,11,10,4,8
22023,203496,22300208,"NOV 19, 2023",PHI @ BKN,W,11,2,2,1.0,0,0,0.0,0,0,0.0,0,2,2,0,1,1,0,1,4,3,1,Robert Covington,PHI,BKN,PHI,,,6,6,4,2
22023,203496,22300029,"NOV 17, 2023",PHI @ ATL,W,20,2,4,0.5,2,2,1.0,0,0,0.0,4,3,7,3,1,1,1,4,6,3,1,Robert Covington,PHI,ATL,PHI,,,16,13,9,10
22023,203496,22300194,"NOV 15, 2023",PHI vs. BOS,L,37,6,13,0.462,0,5,0.0,4,4,1.0,3,3,6,0,2,0,0,1,16,-10,1,Robert Covington,PHI,PHI,BOS,,,22,22,16,6
22023,203496,22300019,"NOV 14, 2023",PHI vs. IND,L,16,1,3,0.333,0,2,0.0,0,0,0.0,0,1,1,1,0,1,0,2,2,-1,1,Robert Covington,PHI,PHI,IND,,,4,3,3,2
22023,203496,22300180,"NOV 12, 2023",PHI vs. IND,W,16,1,5,0.2,0,2,0.0,0,0,0.0,2,3,5,2,0,0,0,1,2,-1,1,Robert Covington,PHI,PHI,IND,,,9,7,4,7
22023,203496,22300008,"NOV 10, 2023",PHI @ DET,W,14,1,3,0.333,1,3,0.333,0,0,0.0,0,0,0,0,4,0,0,0,3,3,1,Robert Covington,PHI,DET,PHI,,,3,3,3,0
22023,203496,22300159,"NOV 08, 2023",PHI vs. BOS,W,15,2,4,0.5,1,2,0.5,0,0,0.0,2,1,3,0,2,0,0,2,5,6,1,Robert Covington,PHI,PHI,BOS,,,8,8,5,3
22023,203496,22300148,"NOV 06, 2023",PHI vs. WAS,W,4,2,2,1.0,1,1,1.0,2,2,1.0,0,0,0,0,3,1,0,2,7,0,1,Robert Covington,PHI,PHI,WAS,,,7,7,7,0
22023,203496,22300132,"NOV 04, 2023",PHI vs. PHX,W,18,0,3,0.0,0,3,0.0,2,2,1.0,1,3,4,0,2,1,2,3,2,8,1,Robert Covington,PHI,PHI,PHX,,,6,6,2,4
22023,203496,22300128,"NOV 02, 2023",PHI vs. TOR,W,1,0,0,0.0,0,0,0.0,0,0,0.0,0,0,0,0,0,0,0,0,0,-2,1,Robert Covington,PHI,PHI,TOR,,,0,0,0,0
22023,203496,22300099,"OCT 29, 2023",LAC vs. SAS,W,26,0,1,0.0,0,1,0.0,0,0,0.0,1,2,3,3,1,1,0,1,0,25,1,Robert Covington,LAC,LAC,SAS,,,6,3,3,6
22023,203496,22300085,"OCT 27, 2023",LAC @ UTA,L,20,1,3,0.333,1,3,0.333,1,2,0.5,0,1,1,2,2,0,0,4,4,-6,1,Robert Covington,LAC,UTA,LAC,,,7,5,6,3
22023,203496,22300074,"OCT 25, 2023",LAC vs. POR,W,23,2,5,0.4,1,4,0.25,0,0,0.0,1,3,4,2,3,1,0,2,5,26,1,Robert Covington,LAC,LAC,POR,,,11,9,7,6
22023,1628470,22300337,"DEC 16, 2023",CHI @ MIA,L,14,5,7,0.714,4,5,0.8,2,3,0.667,2,0,2,0,0,0,0,0,16,-11,1,Torrey Craig,CHI,MIA,CHI,,,18,18,16,2
22023,1628470,22300320,"DEC 14, 2023",CHI @ MIA,W,23,2,7,0.286,0,3,0.0,1,1,1.0,1,2,3,0,1,0,0,3,5,-6,1,Torrey Craig,CHI,MIA,CHI,,,8,8,5,3
22023,1628470,22300307,"DEC 12, 2023",CHI vs. DEN,L,19,1,4,0.25,0,2,0.0,0,0,0.0,2,3,5,1,1,0,2,4,2,-4,1,Torrey Craig,CHI,CHI,DEN,,,8,7,3,6
22023,1628470,22300300,"DEC 11, 2023",CHI @ MIL,L,29,2,9,0.222,1,5,0.2,2,4,0.5,1,4,5,1,0,1,0,6,7,-11,1,Torrey Craig,CHI,MIL,CHI,,,13,12,8,6
22023,1628470,22301223,"DEC 08, 2023",CHI @ SAS,W,23,5,8,0.625,5,7,0.714,1,2,0.5,4,4,8,0,2,0,0,3,16,1,1,Torrey Craig,CHI,SAS,CHI,,,24,24,16,8
22023,1628470,22301211,"DEC 06, 2023",CHI vs. CHA,W,17,2,4,0.5,2,2,1.0,0,0,0.0,3,1,4,2,1,0,0,2,6,1,1,Torrey Craig,CHI,CHI,CHA,,,12,10,8,6
22023,1628470,22300285,"DEC 02, 2023",CHI vs. NOP,W,19,5,6,0.833,3,4,0.75,2,2,1.0,3,3,6,2,0,1,1,3,15,16,1,Torrey Craig,CHI,CHI,NOP,,,23,21,17,8
22023,1628470,22300269,"NOV 30, 2023",CHI vs. MIL,W,27,4,10,0.4,2,6,0.333,0,0,0.0,3,5,8,2,1,1,2,4,10,14,1,Torrey Craig,CHI,CHI,MIL,,,20,18,12,10
22023,1628470,22300053,"NOV 28, 2023",CHI @ BOS,L,13,1,1,1.0,1,1,1.0,0,0,0.0,0,1,1,0,1,1,0,0,3,-5,1,Torrey Craig,CHI,BOS,CHI,,,4,4,3,1
22023,1628470,22300250,"NOV 26, 2023",CHI @ BKN,L,20,1,2,0.5,0,0,0.0,2,2,1.0,2,1,3,0,0,0,2,0,4,-25,1,Torrey Craig,CHI,BKN,CHI,,,7,7,4,3
22023,1628470,22300046,"NOV 24, 2023",CHI @ TOR,L,19,1,3,0.333,0,1,0.0,3,4,0.75,2,3,5,1,0,1,1,2,5,-6,1,Torrey Craig,CHI,TOR,CHI,,,11,10,6,6
22023,1628470,22300234,"NOV 22, 2023",CHI @ OKC,L,15,0,3,0.0,0,3,0.0,0,0,0.0,0,3,3,0,0,0,1,4,0,-15,1,Torrey Craig,CHI,OKC,CHI,,,3,3,0,3
22023,1628470,22300220,"NOV 20, 2023",CHI vs. MIA,L,16,1,5,0.2,0,3,0.0,0,0,0.0,0,1,1,0,0,0,0,1,2,-7,1,Torrey Craig,CHI,CHI,MIA,,,3,3,2,1
22023,1628470,22300204,"NOV 18, 2023",CHI vs. MIA,W,17,3,5,0.6,1,3,0.333,0,0,0.0,1,4,5,2,0,1,0,1,7,12,1,Torrey Craig,CHI,CHI,MIA,,,14,12,9,7
22023,1628470,22300033,"NOV 17, 2023",CHI vs. ORL,L,26,1,3,0.333,1,3,0.333,0,0,0.0,0,1,1,0,1,0,1,3,3,-15,1,Torrey Craig,CHI,CHI,ORL,,,4,4,3,1
22023,1628470,22300196,"NOV 15, 2023",CHI vs. ORL,L,28,4,7,0.571,0,2,0.0,3,3,1.0,3,4,7,0,1,0,2,1,11,-8,1,Torrey Craig,CHI,CHI,ORL,,,18,18,11,7
22023,1628470,22300190,"NOV 13, 2023",CHI @ MIL,L,22,3,8,0.375,1,4,0.25,1,1,1.0,7,5,12,2,0,0,0,2,8,1,1,Torrey Craig,CHI,MIL,CHI,,,22,20,10,14
22023,1628470,22300181,"NOV 12, 2023",CHI vs. DET,W,31,1,6,0.167,1,4,0.25,0,0,0.0,3,7,10,2,1,0,0,3,3,12,1,Torrey Craig,CHI,CHI,DET,,,15,13,5,12
22023,1628470,22300162,"NOV 08, 2023",CHI vs. PHX,L,20,0,3,0.0,0,2,0.0,0,0,0.0,0,2,2,1,1,0,0,3,0,-24,1,Torrey Craig,CHI,CHI,PHX,,,3,2,1,3
22023,1628470,22300152,"NOV 06, 2023",CHI vs. UTA,W,20,1,3,0.333,1,1,1.0,0,0,0.0,0,3,3,2,1,1,0,5,3,8,1,Torrey Craig,CHI,CHI,UTA,,,8,6,5,5
22023,1628470,22300139,"NOV 04, 2023",CHI @ DEN,L,27,3,6,0.5,0,1,0.0,1,1,1.0,2,4,6,3,1,0,0,1,7,-19,1,Torrey Craig,CHI,DEN,CHI,,,16,13,10,9
22023,1628470,22300004,"NOV 03, 2023",CHI vs. BKN,L,23,1,4,0.25,1,2,0.5,0,0,0.0,0,6,6,4,1,0,1,4,3,6,1,Torrey Craig,CHI,CHI,BKN,,,13,9,7,10
22023,1628470,22300124,"NOV 01, 2023",CHI @ DAL,L,17,1,2,0.5,0,1,0.0,0,0,0.0,2,3,5,1,0,0,0,3,2,1,1,Torrey Craig,CHI,DAL,CHI,,,8,7,3,6
22023,1628470,22300102,"OCT 30, 2023",CHI @ IND,W,20,2,3,0.667,1,1,1.0,0,0,0.0,1,3,4,1,2,1,2,3,5,5,1,Torrey Craig,CHI,IND,CHI,,,10,9,6,5
22023,1628470,22300088,"OCT 28, 2023",CHI @ DET,L,23,2,7,0.286,0,2,0.0,0,0,0.0,1,2,3,0,0,1,0,3,4,-12,1,Torrey Craig,CHI,DET,CHI,,,7,7,4,3
22023,1628470,22300082,"OCT 27, 2023",CHI vs. TOR,W,24,3,7,0.429,1,4,0.25,0,0,0.0,3,2,5,0,1,1,0,2,7,-6,1,Torrey Craig,CHI,CHI,TOR,,,12,12,7,5
22023,1628470,22300070,"OCT 25, 2023",CHI vs. OKC,L,22,4,6,0.667,3,4,0.75,0,0,0.0,4,3,7,1,0,0,1,2,11,-12,1,Torrey Craig,CHI,CHI,OKC,,,19,18,12,8
22023,203109,22300173,"NOV 11, 2023",MIL @ ORL,L,17,0,1,0.0,0,1,0.0,1,2,0.5,0,2,2,0,0,0,0,0,1,-13,1,Jae Crowder,MIL,ORL,MIL,,,3,3,1,2
22023,203109,22300171,"NOV 09, 2023",MIL @ IND,L,29,2,2,1.0,1,1,1.0,0,0,0.0,0,4,4,1,1,0,0,2,5,-5,1,Jae Crowder,MIL,IND,MIL,,,10,9,6,5
22023,203109,22300165,"NOV 08, 2023",MIL vs. DET,W,37,3,6,0.5,2,4,0.5,2,3,0.667,0,5,5,2,1,0,0,2,10,-2,1,Jae Crowder,MIL,MIL,DET,,,17,15,12,7
22023,203109,22300149,"NOV 06, 2023",MIL @ BKN,W,30,5,10,0.5,4,9,0.444,1,2,0.5,2,3,5,0,1,0,2,1,15,-6,1,Jae Crowder,MIL,BKN,MIL,,,20,20,15,5
22023,203109,22300002,"NOV 03, 2023",MIL vs. NYK,W,24,5,8,0.625,4,6,0.667,0,0,0.0,0,6,6,2,1,0,0,1,14,3,1,Jae Crowder,MIL,MIL,NYK,,,22,20,16,8
22023,203109,22300116,"NOV 01, 2023",MIL @ TOR,L,25,3,5,0.6,2,3,0.667,1,3,0.333,1,0,1,3,0,1,0,2,9,-5,1,Jae Crowder,MIL,TOR,MIL,,,13,10,12,4
22023,203109,22300107,"OCT 30, 2023",MIL vs. MIA,W,25,3,7,0.429,2,3,0.667,0,0,0.0,1,4,5,2,1,1,1,2,8,-11,1,Jae Crowder,MIL,MIL,MIA,,,15,13,10,7
22023,203109,22300097,"OCT 29, 2023",MIL vs. ATL,L,26,1,4,0.25,0,3,0.0,0,0,0.0,0,3,3,3,0,1,0,1,2,-27,1,Jae Crowder,MIL,MIL,ATL,,,8,5,5,6
22023,203109,22300075,"OCT 26, 2023",MIL vs. PHI,W,27,3,4,0.75,1,1,1.0,2,2,1.0,0,4,4,2,2,0,1,3,9,11,1,Jae Crowder,MIL,MIL,PHI,,,15,13,11,6
22023,1630595,22300502,"JAN 07, 2024",DET @ DEN,L,11,1,6,0.167,1,2,0.5,0,0,0.0,0,3,3,3,0,0,0,2,3,-2,1,Cade Cunningham,DET,DEN,DET,,,9,6,6,6
22023,1630595,22300490,"JAN 05, 2024",DET @ GSW,L,35,13,22,0.591,1,7,0.143,3,3,1.0,0,5,5,3,0,1,2,2,30,-7,1,Cade Cunningham,DET,GSW,DET,,,38,35,33,8
22023,1630595,22300474,"JAN 03, 2024",DET @ UTA,L,40,12,21,0.571,3,7,0.429,4,5,0.8,0,5,5,13,1,0,6,5,31,-13,1,Cade Cunningham,DET,UTA,DET,,,49,36,44,18
22023,1630595,22300453,"JAN 01, 2024",DET @ HOU,L,30,3,16,0.188,0,5,0.0,0,1,0.0,0,1,1,10,0,0,4,2,6,-21,1,Cade Cunningham,DET,HOU,DET,,,17,7,16,11
22023,1630595,22300440,"DEC 30, 2023",DET vs. TOR,W,38,9,20,0.45,2,4,0.5,10,10,1.0,0,3,3,12,1,0,0,4,30,1,1,Cade Cunningham,DET,DET,TOR,,,45,33,42,15
22023,1630595,22300421,"DEC 28, 2023",DET @ BOS,L,43,12,22,0.545,4,6,0.667,3,4,0.75,1,5,6,9,3,2,6,3,31,4,1,Cade Cunningham,DET,BOS,DET,,,46,37,40,15
22023,1630595,22300406,"DEC 26, 2023",DET vs. BKN,L,37,15,21,0.714,3,4,0.75,8,10,0.8,1,8,9,5,1,1,3,4,41,5,1,Cade Cunningham,DET,DET,BKN,,,55,50,46,14
22023,1630595,22300394,"DEC 23, 2023",DET @ BKN,L,33,9,20,0.45,1,5,0.2,3,4,0.75,0,3,3,6,0,0,2,4,22,-5,1,Cade Cunningham,DET,BKN,DET,,,31,25,28,9
22023,1630595,22300374,"DEC 21, 2023",DET vs. UTA,L,39,10,22,0.455,2,6,0.333,6,7,0.857,1,5,6,10,2,1,6,2,28,1,1,Cade Cunningham,DET,DET,UTA,,,44,34,38,16
22023,1630595,22300352,"DEC 18, 2023",DET @ ATL,L,44,16,24,0.667,3,5,0.6,8,9,0.889,1,4,5,7,3,1,3,1,43,-2,1,Cade Cunningham,DET,ATL,DET,,,55,48,50,12
22023,1630595,22300334,"DEC 16, 2023",DET @ MIL,L,31,10,17,0.588,0,2,0.0,5,6,0.833,0,1,1,6,1,0,2,3,25,-13,1,Cade Cunningham,DET,MIL,DET,,,32,26,31,7
22023,1630595,22300327,"DEC 15, 2023",DET @ PHI,L,24,2,9,0.222,0,2,0.0,0,0,0.0,0,3,3,2,1,1,3,3,4,-32,1,Cade Cunningham,DET,PHI,DET,,,9,7,6,5
22023,1630595,22300310,"DEC 13, 2023",DET vs. PHI,L,30,5,17,0.294,1,8,0.125,10,12,0.833,1,5,6,7,0,0,1,3,21,-23,1,Cade Cunningham,DET,DET,PHI,,,34,27,28,13
22023,1630595,22300293,"DEC 11, 2023",DET vs. IND,L,38,11,21,0.524,1,6,0.167,0,0,0.0,0,6,6,7,1,0,3,3,23,-8,1,Cade Cunningham,DET,DET,IND,,,36,29,30,13
22023,1630595,22301217,"DEC 08, 2023",DET @ ORL,L,32,8,15,0.533,2,6,0.333,3,4,0.75,1,2,3,6,1,0,3,1,21,-20,1,Cade Cunningham,DET,ORL,DET,,,30,24,27,9
22023,1630595,22301206,"DEC 06, 2023",DET vs. MEM,L,34,6,14,0.429,1,5,0.2,3,3,1.0,0,4,4,10,2,1,5,2,16,-1,1,Cade Cunningham,DET,DET,MEM,,,30,20,26,14
22023,1630595,22300283,"DEC 02, 2023",DET vs. CLE,L,37,8,20,0.4,3,6,0.5,4,4,1.0,0,8,8,11,2,0,1,3,23,13,1,Cade Cunningham,DET,DET,CLE,,,42,31,34,19
22023,1630595,22300268,"NOV 30, 2023",DET @ NYK,L,37,12,20,0.6,4,9,0.444,3,4,0.75,0,2,2,8,2,0,7,2,31,1,1,Cade Cunningham,DET,NYK,DET,,,41,33,39,10
22023,1630595,22300258,"NOV 29, 2023",DET vs. LAL,L,23,6,15,0.4,2,4,0.5,1,1,1.0,0,4,4,5,1,0,2,1,15,-33,1,Cade Cunningham,DET,DET,LAL,,,24,19,20,9
22023,1630595,22300253,"NOV 27, 2023",DET vs. WAS,L,32,10,22,0.455,2,7,0.286,4,4,1.0,1,4,5,7,1,0,1,2,26,-12,1,Cade Cunningham,DET,DET,WAS,,,38,31,33,12
22023,1630595,22300047,"NOV 24, 2023",DET @ IND,L,38,10,26,0.385,2,4,0.5,9,9,1.0,0,3,3,5,0,0,4,0,31,-12,1,Cade Cunningham,DET,IND,DET,,,39,34,36,8
22023,1630595,22300218,"NOV 20, 2023",DET vs. DEN,L,38,7,17,0.412,2,4,0.5,11,11,1.0,0,2,2,9,3,1,5,2,27,7,1,Cade Cunningham,DET,DET,DEN,,,38,29,36,11
22023,1630595,22300211,"NOV 19, 2023",DET @ TOR,L,27,7,17,0.412,3,5,0.6,1,3,0.333,2,3,5,4,0,0,3,2,18,-22,1,Cade Cunningham,DET,TOR,DET,,,27,23,22,9
22023,1630595,22300030,"NOV 17, 2023",DET @ CLE,L,34,9,21,0.429,2,7,0.286,0,0,0.0,1,4,5,8,0,0,4,4,20,5,1,Cade Cunningham,DET,CLE,DET,,,33,25,28,13
22023,1630595,22300018,"NOV 14, 2023",DET vs. ATL,L,38,4,14,0.286,1,3,0.333,0,0,0.0,1,2,3,12,3,0,6,3,9,-11,1,Cade Cunningham,DET,DET,ATL,,,24,12,21,15
22023,1630595,22300181,"NOV 12, 2023",DET @ CHI,L,38,4,15,0.267,0,5,0.0,2,2,1.0,0,3,3,5,0,1,1,4,10,-24,1,Cade Cunningham,DET,CHI,DET,,,18,13,15,8
22023,1630595,22300008,"NOV 10, 2023",DET vs. PHI,L,36,8,18,0.444,1,5,0.2,4,4,1.0,1,3,4,7,0,0,4,5,21,-5,1,Cade Cunningham,DET,DET,PHI,,,32,25,28,11
22023,1630595,22300165,"NOV 08, 2023",DET @ MIL,L,39,11,27,0.407,2,8,0.25,9,10,0.9,2,6,8,8,0,0,5,2,33,-8,1,Cade Cunningham,DET,MIL,DET,,,49,41,41,16
22023,1630595,22300145,"NOV 06, 2023",DET vs. GSW,L,40,7,18,0.389,1,6,0.167,6,7,0.857,0,4,4,5,2,0,5,2,21,-9,1,Cade Cunningham,DET,DET,GSW,,,30,25,26,9
22023,1630595,22300140,"NOV 05, 2023",DET vs. PHX,L,39,12,24,0.5,0,6,0.0,2,3,0.667,1,2,3,6,0,1,6,2,26,-21,1,Cade Cunningham,DET,DET,PHX,,,35,29,32,9
22023,1630595,22300129,"NOV 02, 2023",DET @ NOP,L,34,8,22,0.364,2,7,0.286,4,5,0.8,0,2,2,11,1,0,6,4,22,3,1,Cade Cunningham,DET,NOP,DET,,,35,24,33,13
22023,1630595,22300115,"NOV 01, 2023",DET vs. POR,L,37,11,27,0.407,5,9,0.556,3,3,1.0,0,5,5,4,1,0,6,3,30,-7,1,Cade Cunningham,DET,DET,POR,,,39,35,34,9
22023,1630595,22300109,"OCT 30, 2023",DET @ OKC,L,35,5,15,0.333,3,7,0.429,4,5,0.8,0,2,2,5,0,0,7,1,17,-14,1,Cade Cunningham,DET,OKC,DET,,,24,19,22,7
22023,1630595,22300088,"OCT 28, 2023",DET vs. CHI,W,40,9,19,0.474,1,4,0.25,6,7,0.857,0,4,4,10,0,0,6,3,25,10,1,Cade Cunningham,DET,DET,CHI,,,39,29,35,14
22023,1630595,22300077,"OCT 27, 2023",DET @ CHA,W,24,4,13,0.308,2,5,0.4,2,2,1.0,1,1,2,6,1,0,5,6,12,7,1,Cade Cunningham,DET,CHA,DET,,,20,14,18,8
22023,1630595,22300068,"OCT 25, 2023",DET @ MIA,L,36,13,27,0.481,4,9,0.444,0,0,0.0,0,3,3,9,1,1,3,5,30,-2,1,Cade Cunningham,DET,MIA,DET,,,42,33,39,12
22023,203552,22300556,"JAN 15, 2024",DAL vs. NOP,W,7,0,2,0.0,0,1,0.0,0,0,0.0,0,0,0,0,0,0,0,1,0,-2,1,Seth Curry,DAL,DAL,NOP,,,0,0,0,0
22023,203552,22300547,"JAN 13, 2024",DAL vs. NOP,L,12,1,3,0.333,1,2,0.5,0,0,0.0,0,0,0,0,1,0,0,3,3,1,1,Seth Curry,DAL,DAL,NOP,,,3,3,3,0
22023,203552,22300530,"JAN 11, 2024",DAL vs. NYK,W,10,0,1,0.0,0,1,0.0,0,0,0.0,0,1,1,0,0,0,1,0,0,2,1,Seth Curry,DAL,DAL,NYK,,,1,1,0,1
22023,203552,22300515,"JAN 09, 2024",DAL vs. MEM,L,10,1,2,0.5,0,1,0.0,0,0,0.0,0,0,0,0,0,0,1,1,2,-8,1,Seth Curry,DAL,DAL,MEM,,,2,2,2,0
22023,203552,22300501,"JAN 07, 2024",DAL vs. MIN,W,12,0,3,0.0,0,2,0.0,0,0,0.0,0,3,3,0,1,0,1,1,0,0,1,Seth Curry,DAL,DAL,MIN,,,3,3,0,3
22023,203552,22300487,"JAN 05, 2024",DAL vs. POR,W,20,4,9,0.444,1,4,0.25,0,0,0.0,1,1,2,1,0,0,0,2,9,12,1,Seth Curry,DAL,DAL,POR,,,12,11,10,3
22023,203552,22300472,"JAN 03, 2024",DAL vs. POR,W,15,0,1,0.0,0,0,0.0,0,0,0.0,0,1,1,2,0,0,0,0,0,28,1,Seth Curry,DAL,DAL,POR,,,3,1,2,3
22023,203552,22300423,"DEC 28, 2023",DAL @ MIN,L,30,3,8,0.375,2,4,0.5,3,4,0.75,0,2,2,3,0,0,3,2,11,6,1,Seth Curry,DAL,MIN,DAL,,,16,13,14,5
22023,203552,22300420,"DEC 27, 2023",DAL vs. CLE,L,28,6,11,0.545,5,9,0.556,2,2,1.0,1,3,4,1,2,0,0,1,19,0,1,Seth Curry,DAL,DAL,CLE,,,24,23,20,5
22023,203552,22300405,"DEC 25, 2023",DAL @ PHX,W,6,0,0,0.0,0,0,0.0,0,0,0.0,1,0,1,0,0,0,0,0,0,4,1,Seth Curry,DAL,PHX,DAL,,,1,1,0,1
22023,203552,22300385,"DEC 22, 2023",DAL @ HOU,L,18,0,7,0.0,0,2,0.0,0,0,0.0,0,2,2,0,2,0,2,1,0,-23,1,Seth Curry,DAL,HOU,DAL,,,2,2,0,2
22023,203552,22300356,"DEC 18, 2023",DAL @ DEN,L,7,0,0,0.0,0,0,0.0,0,0,0.0,0,0,0,0,0,0,0,2,0,-1,1,Seth Curry,DAL,DEN,DAL,,,0,0,0,0
22023,203552,22300341,"DEC 16, 2023",DAL @ POR,W,14,2,6,0.333,2,3,0.667,1,1,1.0,0,2,2,1,0,0,1,3,7,17,1,Seth Curry,DAL,POR,DAL,,,10,9,8,3
22023,203552,22300306,"DEC 12, 2023",DAL vs. LAL,W,12,1,2,0.5,1,2,0.5,0,0,0.0,1,1,2,0,0,1,0,0,3,4,1,Seth Curry,DAL,DAL,LAL,,,5,5,3,2
22023,203552,22300299,"DEC 11, 2023",DAL @ MEM,W,20,2,5,0.4,1,3,0.333,1,1,1.0,1,2,3,2,1,0,0,1,6,8,1,Seth Curry,DAL,MEM,DAL,,,11,9,8,5
22023,203552,22301226,"DEC 08, 2023",DAL @ POR,W,18,2,5,0.4,2,4,0.5,1,1,1.0,1,1,2,1,0,0,1,1,7,14,1,Seth Curry,DAL,POR,DAL,,,10,9,8,3
22023,203552,22301213,"DEC 06, 2023",DAL vs. UTA,W,19,4,7,0.571,2,3,0.667,0,0,0.0,1,1,2,2,2,0,0,0,10,26,1,Seth Curry,DAL,DAL,UTA,,,14,12,12,4
22023,203552,22300287,"DEC 02, 2023",DAL vs. OKC,L,36,4,15,0.267,4,9,0.444,0,0,0.0,3,2,5,3,1,1,0,2,12,14,1,Seth Curry,DAL,DAL,OKC,,,20,17,15,8
22023,203552,22300277,"DEC 01, 2023",DAL vs. MEM,L,16,5,10,0.5,2,4,0.5,0,0,0.0,0,2,2,2,1,0,0,2,12,-5,1,Seth Curry,DAL,DAL,MEM,,,16,14,14,4
22023,203552,22300059,"NOV 28, 2023",DAL vs. HOU,W,0,0,0,0.0,0,0,0.0,0,0,0.0,0,0,0,0,0,0,0,0,0,2,1,Seth Curry,DAL,DAL,HOU,,,0,0,0,0
22023,203552,22300244,"NOV 25, 2023",DAL @ LAC,L,8,1,5,0.2,1,4,0.25,0,0,0.0,0,0,0,0,0,0,0,2,3,-4,1,Seth Curry,DAL,LAC,DAL,,,3,3,3,0
22023,203552,22300238,"NOV 22, 2023",DAL @ LAL,W,0,0,0,0.0,0,0,0.0,0,0,0.0,0,0,0,0,0,0,0,0,0,2,1,Seth Curry,DAL,LAL,DAL,,,0,0,0,0
22023,203552,22300205,"NOV 18, 2023",DAL @ MIL,L,9,1,2,0.5,0,1,0.0,0,0,0.0,0,1,1,0,0,0,0,0,2,-10,1,Seth Curry,DAL,MIL,DAL,,,3,3,2,1
22023,203552,22300192,"NOV 15, 2023",DAL @ WAS,W,20,6,6,1.0,2,2,1.0,1,1,1.0,0,2,2,2,1,0,0,1,15,-3,1,Seth Curry,DAL,WAS,DAL,,,19,17,17,4
22023,203552,22300022,"NOV 14, 2023",DAL @ NOP,L,13,0,4,0.0,0,4,0.0,3,3,1.0,0,3,3,2,3,0,1,1,3,4,1,Seth Curry,DAL,NOP,DAL,,,8,6,5,5
22023,203552,22300183,"NOV 12, 2023",DAL @ NOP,W,6,0,2,0.0,0,1,0.0,0,0,0.0,1,0,1,0,0,0,0,0,0,-11,1,Seth Curry,DAL,NOP,DAL,,,1,1,0,1
22023,203552,22300014,"NOV 10, 2023",DAL vs. LAC,W,7,1,2,0.5,1,2,0.5,2,3,0.667,0,0,0,0,0,0,0,0,5,-2,1,Seth Curry,DAL,DAL,LAC,,,5,5,5,0
22023,203552,22300006,"NOV 03, 2023",DAL @ DEN,L,5,0,1,0.0,0,1,0.0,0,0,0.0,0,1,1,1,1,0,0,1,0,4,1,Seth Curry,DAL,DEN,DAL,,,2,1,1,2
22023,203552,22300124,"NOV 01, 2023",DAL vs. CHI,W,12,2,5,0.4,0,1,0.0,0,0,0.0,2,1,3,0,0,0,1,0,4,-5,1,Seth Curry,DAL,DAL,CHI,,,7,7,4,3
22023,203552,22300106,"OCT 30, 2023",DAL @ MEM,W,15,1,5,0.2,1,3,0.333,0,0,0.0,0,2,2,2,1,1,1,2,3,14,1,Seth Curry,DAL,MEM,DAL,,,7,5,5,4
22023,203552,22300084,"OCT 27, 2023",DAL vs. BKN,W,9,1,1,1.0,0,0,0.0,0,0,0.0,0,0,0,1,0,0,1,1,2,1,1,Seth Curry,DAL,DAL,BKN,,,3,2,3,1
22023,203552,22300073,"OCT 25, 2023",DAL @ SAS,W,4,0,0,0.0,0,0,0.0,0,0,0.0,0,0,0,0,0,0,0,0,0,4,1,Seth Curry,DAL,SAS,DAL,,,0,0,0,0
22023,201939,22300560,"JAN 15, 2024",GSW @ MEM,L,33,11,20,0.55,3,9,0.333,1,1,1.0,1,3,4,8,2,1,5,4,26,-2,1,Stephen Curry,GSW,MEM,GSW,,,38,30,34,12
22023,201939,22300536,"JAN 12, 2024",GSW @ CHI,W,35,8,24,0.333,6,15,0.4,5,5,1.0,0,5,5,9,1,0,1,1,27,5,1,Stephen Curry,GSW,CHI,GSW,,,41,32,36,14
22023,201939,22300525,"JAN 10, 2024",GSW vs. NOP,L,25,4,13,0.308,3,8,0.375,4,4,1.0,0,1,1,6,1,0,3,0,15,-4,1,Stephen Curry,GSW,GSW,NOP,,,22,16,21,7
22023,201939,22300504,"JAN 07, 2024",GSW vs. TOR,L,30,2,14,0.143,0,9,0.0,5,5,1.0,0,1,1,6,0,0,2,3,9,-17,1,Stephen Curry,GSW,GSW,TOR,,,16,10,15,7
22023,201939,22300490,"JAN 05, 2024",GSW vs. DET,W,31,7,19,0.368,4,12,0.333,8,9,0.889,0,6,6,4,1,1,4,0,26,0,1,Stephen Curry,GSW,GSW,DET,,,36,32,30,10
22023,201939,22300478,"JAN 04, 2024",GSW vs. DEN,L,35,11,23,0.478,5,12,0.417,3,3,1.0,0,4,4,6,1,1,2,1,30,-1,1,Stephen Curry,GSW,GSW,DEN,,,40,34,36,10
22023,201939,22300463,"JAN 02, 2024",GSW vs. ORL,W,35,12,20,0.6,4,9,0.444,8,11,0.727,1,1,2,6,4,1,2,4,36,12,1,Stephen Curry,GSW,GSW,ORL,,,44,38,42,8
22023,201939,22300444,"DEC 30, 2023",GSW vs. DAL,L,35,9,25,0.36,6,15,0.4,1,1,1.0,0,2,2,7,1,0,3,3,25,-6,1,Stephen Curry,GSW,GSW,DAL,,,34,27,32,9
22023,201939,22300426,"DEC 28, 2023",GSW vs. MIA,L,32,3,15,0.2,2,8,0.25,5,6,0.833,0,4,4,5,2,1,1,1,13,-14,1,Stephen Curry,GSW,GSW,MIA,,,22,17,18,9
22023,201939,22300402,"DEC 25, 2023",GSW @ DEN,L,34,7,21,0.333,3,13,0.231,1,1,1.0,1,1,2,4,1,1,3,4,18,-26,1,Stephen Curry,GSW,DEN,GSW,,,24,20,22,6
22023,201939,22300399,"DEC 23, 2023",GSW vs. POR,W,30,11,18,0.611,2,7,0.286,3,3,1.0,0,3,3,2,0,0,1,1,27,4,1,Stephen Curry,GSW,GSW,POR,,,32,30,29,5
22023,201939,22300386,"DEC 22, 2023",GSW vs. WAS,W,27,9,18,0.5,8,13,0.615,4,5,0.8,0,4,4,7,0,1,2,0,30,-1,1,Stephen Curry,GSW,GSW,WAS,,,41,34,37,11
22023,201939,22300362,"DEC 19, 2023",GSW vs. BOS,W,38,11,21,0.524,6,11,0.545,5,5,1.0,0,3,3,6,0,0,4,5,33,8,1,Stephen Curry,GSW,GSW,BOS,,,42,36,39,9
22023,201939,22300348,"DEC 17, 2023",GSW @ POR,W,31,2,12,0.167,0,8,0.0,3,4,0.75,0,2,2,8,1,1,4,1,7,14,1,Stephen Curry,GSW,POR,GSW,,,17,9,15,10
22023,201939,22300339,"DEC 16, 2023",GSW vs. BKN,W,35,14,22,0.636,6,8,0.75,3,3,1.0,0,3,3,1,0,3,3,1,37,7,1,Stephen Curry,GSW,GSW,BKN,,,41,40,38,4
22023,201939,22300325,"DEC 14, 2023",GSW @ LAC,L,34,5,17,0.294,3,13,0.231,4,4,1.0,0,4,4,4,0,0,1,3,17,-3,1,Stephen Curry,GSW,LAC,GSW,,,25,21,21,8
22023,201939,22300308,"DEC 12, 2023",GSW @ PHX,L,32,8,24,0.333,4,15,0.267,4,4,1.0,0,5,5,4,3,0,1,2,24,-15,1,Stephen Curry,GSW,PHX,GSW,,,33,29,28,9
22023,201939,22301222,"DEC 08, 2023",GSW @ OKC,L,40,10,20,0.5,6,12,0.5,8,8,1.0,0,6,6,3,1,0,3,0,34,-5,1,Stephen Curry,GSW,OKC,GSW,,,43,40,37,9
22023,201939,22301214,"DEC 06, 2023",GSW vs. POR,W,34,8,18,0.444,5,13,0.385,10,11,0.909,0,5,5,1,0,0,4,2,31,4,1,Stephen Curry,GSW,GSW,POR,,,37,36,32,6
22023,201939,22300280,"DEC 02, 2023",GSW @ LAC,L,37,7,18,0.389,4,9,0.444,4,4,1.0,1,3,4,11,0,0,2,0,22,2,1,Stephen Curry,GSW,LAC,GSW,,,37,26,33,15
22023,201939,22300273,"NOV 30, 2023",GSW vs. LAC,W,33,8,15,0.533,3,9,0.333,7,9,0.778,0,7,7,8,1,1,2,2,26,-4,1,Stephen Curry,GSW,GSW,LAC,,,41,33,34,15
22023,201939,22300060,"NOV 28, 2023",GSW @ SAC,L,37,8,20,0.4,4,12,0.333,9,9,1.0,3,7,10,6,0,1,5,5,29,7,1,Stephen Curry,GSW,SAC,GSW,,,45,39,35,16
22023,201939,22300051,"NOV 24, 2023",GSW vs. SAS,W,35,11,20,0.55,7,14,0.5,6,6,1.0,0,3,3,6,1,0,6,2,35,4,1,Stephen Curry,GSW,GSW,SAS,,,44,38,41,9
22023,201939,22300236,"NOV 22, 2023",GSW @ PHX,L,28,6,15,0.4,1,8,0.125,3,3,1.0,0,3,3,6,0,0,2,2,16,-17,1,Stephen Curry,GSW,PHX,GSW,,,25,19,22,9
22023,201939,22300224,"NOV 20, 2023",GSW vs. HOU,W,35,8,14,0.571,5,9,0.556,11,12,0.917,0,5,5,1,0,0,4,2,32,-3,1,Stephen Curry,GSW,GSW,HOU,,,38,37,33,6
22023,201939,22300207,"NOV 18, 2023",GSW vs. OKC,L,40,8,21,0.381,5,11,0.455,4,4,1.0,0,7,7,3,0,0,2,2,25,0,1,Stephen Curry,GSW,GSW,OKC,,,35,32,28,10
22023,201939,22300186,"NOV 12, 2023",GSW vs. MIN,L,36,11,25,0.44,5,13,0.385,11,12,0.917,1,4,5,3,1,0,5,2,38,-4,1,Stephen Curry,GSW,GSW,MIN,,,46,43,41,8
22023,201939,22300176,"NOV 11, 2023",GSW vs. CLE,L,33,9,24,0.375,4,14,0.286,8,8,1.0,1,2,3,2,1,1,4,1,30,-8,1,Stephen Curry,GSW,GSW,CLE,,,35,33,32,5
22023,201939,22300169,"NOV 08, 2023",GSW @ DEN,L,34,6,17,0.353,6,13,0.462,5,5,1.0,1,4,5,4,1,0,3,2,23,-10,1,Stephen Curry,GSW,DEN,GSW,,,32,28,27,9
22023,201939,22300145,"NOV 06, 2023",GSW @ DET,W,33,12,26,0.462,7,17,0.412,3,4,0.75,0,2,2,4,0,0,3,1,34,17,1,Stephen Curry,GSW,DET,GSW,,,40,36,38,6
22023,201939,22300142,"NOV 05, 2023",GSW @ CLE,L,31,8,16,0.5,7,11,0.636,5,6,0.833,0,2,2,4,1,0,6,0,28,-6,1,Stephen Curry,GSW,CLE,GSW,,,34,30,32,6
22023,201939,22300005,"NOV 03, 2023",GSW @ OKC,W,31,9,15,0.6,5,10,0.5,7,7,1.0,3,5,8,7,2,0,3,1,30,5,1,Stephen Curry,GSW,OKC,GSW,,,45,38,37,15
22023,201939,22300126,"NOV 01, 2023",GSW vs. SAC,W,32,7,15,0.467,4,10,0.4,3,3,1.0,1,4,5,3,0,0,7,3,21,-6,1,Stephen Curry,GSW,GSW,SAC,,,29,26,24,8
22023,201939,22300108,"OCT 30, 2023",GSW @ NOP,W,30,15,22,0.682,7,13,0.538,5,7,0.714,0,5,5,5,2,0,3,1,42,13,1,Stephen Curry,GSW,NOP,GSW,,,52,47,47,10
22023,201939,22300096,"OCT 29, 2023",GSW @ HOU,W,31,6,16,0.375,6,14,0.429,6,6,1.0,1,6,7,6,0,1,1,1,24,-2,1,Stephen Curry,GSW,HOU,GSW,,,37,31,30,13
22023,201939,22300087,"OCT 27, 2023",GSW @ SAC,W,35,14,19,0.737,7,10,0.7,6,6,1.0,1,3,4,4,2,0,4,0,41,10,1,Stephen Curry,GSW,SAC,GSW,,,49,45,45,8
22023,201939,22300062,"OCT 24, 2023",GSW vs. PHX,L,31,8,20,0.4,4,14,0.286,7,7,1.0,1,4,5,1,1,0,2,5,27,-9,1,Stephen Curry,GSW,GSW,PHX,,,33,32,28,6
22023,1630700,22300556,"JAN 15, 2024",NOP @ DAL,L,19,1,2,0.5,0,1,0.0,0,0,0.0,2,1,3,2,0,0,0,3,2,-20,1,Dyson Daniels,NOP,DAL,NOP,,,7,5,4,5
22023,1630700,22300547,"JAN 13, 2024",NOP @ DAL,W,38,4,7,0.571,0,1,0.0,2,2,1.0,2,4,6,7,0,0,2,2,10,18,1,Dyson Daniels,NOP,DAL,NOP,,,23,16,17,13
22023,1630700,22300539,"JAN 12, 2024",NOP @ DEN,L,15,1,4,0.25,0,2,0.0,0,2,0.0,2,2,4,3,3,0,0,0,2,7,1,Dyson Daniels,NOP,DEN,NOP,,,9,6,5,7
22023,1630700,22300525,"JAN 10, 2024",NOP @ GSW,W,22,3,4,0.75,1,2,0.5,1,2,0.5,0,3,3,3,1,0,1,2,8,25,1,Dyson Daniels,NOP,GSW,NOP,,,14,11,11,6
22023,1630700,22300500,"JAN 07, 2024",NOP @ SAC,W,29,6,6,1.0,2,2,1.0,0,0,0.0,1,4,5,6,0,0,0,3,14,7,1,Dyson Daniels,NOP,SAC,NOP,,,25,19,20,11
22023,1630700,22300486,"JAN 05, 2024",NOP vs. LAC,L,26,1,4,0.25,0,1,0.0,0,2,0.0,0,3,3,3,4,0,0,1,2,-6,1,Dyson Daniels,NOP,NOP,LAC,,,8,5,5,6
22023,1630700,22300471,"JAN 03, 2024",NOP @ MIN,W,24,2,3,0.667,1,1,1.0,2,2,1.0,2,3,5,1,1,0,0,0,7,-1,1,Dyson Daniels,NOP,MIN,NOP,,,13,12,8,6
22023,1630700,22300461,"JAN 02, 2024",NOP vs. BKN,W,20,2,5,0.4,1,4,0.25,2,2,1.0,1,1,2,3,2,2,1,0,7,5,1,Dyson Daniels,NOP,NOP,BKN,,,12,9,10,5
22023,1630700,22300446,"DEC 31, 2023",NOP vs. LAL,W,8,1,1,1.0,1,1,1.0,0,0,0.0,0,1,1,0,0,0,1,1,3,6,1,Dyson Daniels,NOP,NOP,LAL,,,4,4,3,1
22023,1630700,22300424,"DEC 28, 2023",NOP vs. UTA,W,14,0,1,0.0,0,1,0.0,0,0,0.0,0,2,2,2,2,1,1,2,0,-1,1,Dyson Daniels,NOP,NOP,UTA,,,4,2,2,4
22023,1630700,22300410,"DEC 26, 2023",NOP vs. MEM,L,19,3,3,1.0,1,1,1.0,4,6,0.667,0,0,0,1,2,0,0,4,11,0,1,Dyson Daniels,NOP,NOP,MEM,,,12,11,12,1
22023,1630700,22300392,"DEC 23, 2023",NOP vs. HOU,L,14,0,3,0.0,0,2,0.0,0,0,0.0,2,1,3,0,0,0,1,0,0,-6,1,Dyson Daniels,NOP,NOP,HOU,,,3,3,0,3
22023,1630700,22300375,"DEC 21, 2023",NOP @ CLE,W,20,3,4,0.75,1,1,1.0,0,0,0.0,0,2,2,1,0,0,0,1,7,-2,1,Dyson Daniels,NOP,CLE,NOP,,,10,9,8,3
22023,1630700,22300360,"DEC 19, 2023",NOP vs. MEM,L,13,1,2,0.5,1,2,0.5,0,0,0.0,0,1,1,2,0,0,0,1,3,17,1,Dyson Daniels,NOP,NOP,MEM,,,6,4,5,3
22023,1630700,22300345,"DEC 17, 2023",NOP @ SAS,W,18,2,4,0.5,1,2,0.5,0,0,0.0,1,3,4,4,1,0,1,0,5,8,1,Dyson Daniels,NOP,SAS,NOP,,,13,9,9,8
22023,1630700,22300326,"DEC 15, 2023",NOP @ CHA,W,15,0,0,0.0,0,0,0.0,0,0,0.0,0,0,0,0,1,0,0,1,0,7,1,Dyson Daniels,NOP,CHA,NOP,,,0,0,0,0
22023,1630700,22300311,"DEC 13, 2023",NOP @ WAS,W,16,1,6,0.167,0,4,0.0,0,0,0.0,2,2,4,2,2,0,0,0,2,-17,1,Dyson Daniels,NOP,WAS,NOP,,,8,6,4,6
22023,1630700,22300301,"DEC 11, 2023",NOP vs. MIN,W,28,1,3,0.333,1,1,1.0,3,4,0.75,1,1,2,2,2,1,0,3,6,5,1,Dyson Daniels,NOP,NOP,MIN,,,10,8,8,4
22023,1630700,22301230,"DEC 07, 2023",NOP @ LAL,L,17,1,5,0.2,0,2,0.0,2,2,1.0,2,6,8,0,0,1,0,1,4,2,1,Dyson Daniels,NOP,LAL,NOP,,,12,12,4,8
22023,1630700,22301204,"DEC 04, 2023",NOP @ SAC,W,6,0,1,0.0,0,0,0.0,0,0,0.0,1,0,1,0,2,0,0,1,0,8,1,Dyson Daniels,NOP,SAC,NOP,,,1,1,0,1
22023,1630700,22300285,"DEC 02, 2023",NOP @ CHI,L,22,3,5,0.6,1,3,0.333,0,0,0.0,0,2,2,2,2,0,1,2,7,4,1,Dyson Daniels,NOP,CHI,NOP,,,11,9,9,4
22023,1630700,22300278,"DEC 01, 2023",NOP vs. SAS,W,12,1,4,0.25,0,1,0.0,0,0,0.0,0,2,2,1,0,0,0,2,2,1,1,Dyson Daniels,NOP,NOP,SAS,,,5,4,3,3
22023,1630700,22300262,"NOV 29, 2023",NOP vs. PHI,W,14,2,4,0.5,0,1,0.0,0,0,0.0,1,3,4,1,2,1,1,2,4,4,1,Dyson Daniels,NOP,NOP,PHI,,,9,8,5,5
22023,1630700,22300256,"NOV 27, 2023",NOP @ UTA,L,24,1,6,0.167,0,4,0.0,0,0,0.0,0,3,3,4,0,0,1,4,2,-6,1,Dyson Daniels,NOP,UTA,NOP,,,9,5,6,7
22023,1630700,22300243,"NOV 25, 2023",NOP @ UTA,L,34,3,14,0.214,0,6,0.0,0,1,0.0,1,5,6,5,6,1,5,1,6,-18,1,Dyson Daniels,NOP,UTA,NOP,,,17,12,11,11
22023,1630700,22300052,"NOV 24, 2023",NOP @ LAC,W,36,3,7,0.429,1,2,0.5,0,0,0.0,2,6,8,5,1,1,1,2,7,18,1,Dyson Daniels,NOP,LAC,NOP,,,20,15,12,13
22023,1630700,22300233,"NOV 22, 2023",NOP vs. SAC,W,29,2,9,0.222,0,5,0.0,4,4,1.0,3,4,7,0,1,0,0,2,8,-7,1,Dyson Daniels,NOP,NOP,SAC,,,15,15,8,7
22023,1630700,22300222,"NOV 20, 2023",NOP vs. SAC,W,25,1,4,0.25,1,4,0.25,0,0,0.0,0,2,2,5,1,0,0,2,3,28,1,Dyson Daniels,NOP,NOP,SAC,,,10,5,8,7
22023,1630700,22300203,"NOV 18, 2023",NOP vs. MIN,L,37,6,12,0.5,1,3,0.333,0,0,0.0,1,4,5,6,1,0,3,4,13,-6,1,Dyson Daniels,NOP,NOP,MIN,,,24,18,19,11
22023,1630700,22300034,"NOV 17, 2023",NOP vs. DEN,W,33,4,6,0.667,0,1,0.0,2,3,0.667,1,7,8,7,3,0,0,1,10,12,1,Dyson Daniels,NOP,NOP,DEN,,,25,18,17,15
22023,1630700,22300022,"NOV 14, 2023",NOP vs. DAL,W,29,4,10,0.4,2,5,0.4,0,0,0.0,1,1,2,6,3,0,1,4,10,12,1,Dyson Daniels,NOP,NOP,DAL,,,18,12,16,8
22023,1630700,22300183,"NOV 12, 2023",NOP vs. DAL,L,31,7,12,0.583,3,6,0.5,0,0,0.0,2,7,9,4,0,0,3,3,17,-29,1,Dyson Daniels,NOP,NOP,DAL,,,30,26,21,13
22023,1630700,22300011,"NOV 10, 2023",NOP @ HOU,L,41,2,6,0.333,0,3,0.0,6,6,1.0,2,8,10,2,1,0,2,2,10,9,1,Dyson Daniels,NOP,HOU,NOP,,,22,20,12,12
22023,1630700,22300166,"NOV 08, 2023",NOP @ MIN,L,31,3,10,0.3,1,3,0.333,0,0,0.0,1,2,3,5,4,0,3,2,7,-26,1,Dyson Daniels,NOP,MIN,NOP,,,15,10,12,8
22023,1630700,22300156,"NOV 06, 2023",NOP @ DEN,L,21,4,5,0.8,1,1,1.0,0,0,0.0,0,2,2,1,1,1,3,0,9,9,1,Dyson Daniels,NOP,DEN,NOP,,,12,11,10,3
22023,1630700,22300135,"NOV 04, 2023",NOP vs. ATL,L,22,3,4,0.75,1,2,0.5,0,0,0.0,1,2,3,5,1,1,0,0,7,-4,1,Dyson Daniels,NOP,NOP,ATL,,,15,10,12,8
22023,1630700,22300129,"NOV 02, 2023",NOP vs. DET,W,25,3,4,0.75,2,2,1.0,2,2,1.0,1,6,7,6,1,0,1,2,10,5,1,Dyson Daniels,NOP,NOP,DET,,,23,17,16,13
22023,1630700,22300121,"NOV 01, 2023",NOP @ OKC,W,25,3,10,0.3,1,6,0.167,1,4,0.25,3,1,4,1,1,2,1,1,8,-6,1,Dyson Daniels,NOP,OKC,NOP,,,13,12,9,5
22023,1630700,22300108,"OCT 30, 2023",NOP vs. GSW,L,24,3,5,0.6,1,2,0.5,0,0,0.0,0,4,4,3,0,0,0,1,7,-13,1,Dyson Daniels,NOP,NOP,GSW,,,14,11,10,7
22023,1630700,22300090,"OCT 28, 2023",NOP vs. NYK,W,22,1,7,0.143,0,3,0.0,0,4,0.0,0,4,4,3,1,0,1,2,2,11,1,Dyson Daniels,NOP,NOP,NYK,,,9,6,5,7
22023,1630700,22300071,"OCT 25, 2023",NOP @ MEM,W,19,3,6,0.5,0,1,0.0,0,0,0.0,2,3,5,0,2,1,2,4,6,-2,1,Dyson Daniels,NOP,MEM,NOP,,,11,11,6,5
22023,203076,22300565,"JAN 15, 2024",LAL vs. OKC,W,38,9,17,0.529,0,1,0.0,9,10,0.9,3,12,15,5,2,1,2,3,27,8,1,Anthony Davis,LAL,LAL,OKC,,,47,42,32,20
22023,203076,22300549,"JAN 13, 2024",LAL @ UTA,L,39,5,21,0.238,0,1,0.0,5,6,0.833,2,13,15,11,1,4,6,1,15,-12,1,Anthony Davis,LAL,UTA,LAL,,,41,30,26,26
22023,203076,22300531,"JAN 11, 2024",LAL vs. PHX,L,32,6,11,0.545,0,2,0.0,1,1,1.0,0,5,5,1,1,2,3,4,13,-24,1,Anthony Davis,LAL,LAL,PHX,,,19,18,14,6
22023,203076,22300516,"JAN 09, 2024",LAL vs. TOR,W,40,13,17,0.765,2,2,1.0,13,14,0.929,1,10,11,6,0,1,3,4,41,0,1,Anthony Davis,LAL,LAL,TOR,,,58,52,47,17
22023,203076,22300505,"JAN 07, 2024",LAL vs. LAC,W,39,10,15,0.667,0,1,0.0,2,4,0.5,1,9,10,1,3,1,3,1,22,-4,1,Anthony Davis,LAL,LAL,LAC,,,33,32,23,11
22023,203076,22300491,"JAN 05, 2024",LAL vs. MEM,L,41,13,22,0.591,0,3,0.0,5,7,0.714,3,3,6,4,0,2,4,4,31,-10,1,Anthony Davis,LAL,LAL,MEM,,,41,37,35,10
22023,203076,22300475,"JAN 03, 2024",LAL vs. MIA,L,43,10,17,0.588,0,1,0.0,9,10,0.9,3,14,17,6,3,5,5,2,29,-13,1,Anthony Davis,LAL,LAL,MIA,,,52,46,35,23
22023,203076,22300446,"DEC 31, 2023",LAL @ NOP,L,35,7,15,0.467,0,2,0.0,6,8,0.75,2,8,10,3,0,5,3,4,20,-17,1,Anthony Davis,LAL,NOP,LAL,,,33,30,23,13
22023,203076,22300443,"DEC 30, 2023",LAL @ MIN,L,39,12,17,0.706,1,2,0.5,8,10,0.8,4,13,17,8,4,2,2,3,33,-6,1,Anthony Davis,LAL,MIN,LAL,,,58,50,41,25
22023,203076,22300428,"DEC 28, 2023",LAL vs. CHA,W,26,11,19,0.579,0,1,0.0,4,4,1.0,2,6,8,2,2,4,2,4,26,6,1,Anthony Davis,LAL,LAL,CHA,,,36,34,28,10
22023,203076,22300403,"DEC 25, 2023",LAL vs. BOS,L,39,15,26,0.577,2,4,0.5,8,10,0.8,5,8,13,4,0,1,2,2,40,-6,1,Anthony Davis,LAL,LAL,BOS,,,57,53,44,17
22023,203076,22300397,"DEC 23, 2023",LAL @ OKC,W,42,11,21,0.524,1,1,1.0,3,6,0.5,3,8,11,7,1,2,3,2,26,3,1,Anthony Davis,LAL,OKC,LAL,,,44,37,33,18
22023,203076,22300380,"DEC 21, 2023",LAL @ MIN,L,39,11,20,0.55,1,1,1.0,8,9,0.889,1,7,8,4,0,3,1,2,31,3,1,Anthony Davis,LAL,MIN,LAL,,,43,39,35,12
22023,203076,22300370,"DEC 20, 2023",LAL @ CHI,L,38,7,15,0.467,0,2,0.0,5,8,0.625,2,12,14,3,2,2,1,1,19,-3,1,Anthony Davis,LAL,CHI,LAL,,,36,33,22,17
22023,203076,22300359,"DEC 18, 2023",LAL vs. NYK,L,35,14,22,0.636,1,1,1.0,3,3,1.0,2,12,14,2,1,2,2,2,32,-6,1,Anthony Davis,LAL,LAL,NYK,,,48,46,34,16
22023,203076,22300316,"DEC 13, 2023",LAL @ SAS,W,38,13,23,0.565,2,3,0.667,9,12,0.75,1,9,10,1,4,0,2,3,37,5,1,Anthony Davis,LAL,SAS,LAL,,,48,47,38,11
22023,203076,22300306,"DEC 12, 2023",LAL @ DAL,L,37,15,21,0.714,1,2,0.5,6,10,0.6,5,6,11,0,0,2,2,2,37,0,1,Anthony Davis,LAL,DAL,LAL,,,48,48,37,11
22023,203076,22301230,"DEC 07, 2023",LAL vs. NOP,W,31,5,10,0.5,0,2,0.0,6,8,0.75,5,10,15,5,2,2,2,1,16,35,1,Anthony Davis,LAL,LAL,NOP,,,36,31,21,20
22023,203076,22301203,"DEC 05, 2023",LAL vs. PHX,W,39,10,26,0.385,0,0,0.0,7,8,0.875,9,6,15,1,0,2,0,1,27,-1,1,Anthony Davis,LAL,LAL,PHX,,,43,42,28,16
22023,203076,22300291,"DEC 02, 2023",LAL vs. HOU,W,37,10,22,0.455,0,0,0.0,7,9,0.778,6,8,14,3,0,5,1,2,27,12,1,Anthony Davis,LAL,LAL,HOU,,,44,41,30,17
22023,203076,22300271,"NOV 30, 2023",LAL @ OKC,L,36,11,18,0.611,0,1,0.0,9,10,0.9,1,13,14,2,2,0,0,1,31,-12,1,Anthony Davis,LAL,OKC,LAL,,,47,45,33,16
22023,203076,22300258,"NOV 29, 2023",LAL @ DET,W,29,9,15,0.6,0,0,0.0,10,13,0.769,4,12,16,4,1,3,0,1,28,29,1,Anthony Davis,LAL,DET,LAL,,,48,44,32,20
22023,203076,22300255,"NOV 27, 2023",LAL @ PHI,L,32,7,14,0.5,0,0,0.0,3,5,0.6,3,8,11,2,1,1,2,4,17,-13,1,Anthony Davis,LAL,PHI,LAL,,,30,28,19,13
22023,203076,22300242,"NOV 25, 2023",LAL @ CLE,W,38,13,20,0.65,0,0,0.0,6,7,0.857,5,8,13,3,2,3,5,3,32,3,1,Anthony Davis,LAL,CLE,LAL,,,48,45,35,16
22023,203076,22300238,"NOV 22, 2023",LAL vs. DAL,L,36,4,10,0.4,0,0,0.0,2,2,1.0,2,11,13,4,1,1,3,3,10,0,1,Anthony Davis,LAL,LAL,DAL,,,27,23,14,17
22023,203076,22300042,"NOV 21, 2023",LAL vs. UTA,W,29,11,14,0.786,0,0,0.0,4,5,0.8,5,11,16,4,2,0,2,1,26,34,1,Anthony Davis,LAL,LAL,UTA,,,46,42,30,20
22023,203076,22300216,"NOV 19, 2023",LAL vs. HOU,W,33,11,15,0.733,0,0,0.0,5,7,0.714,4,6,10,3,2,1,4,6,27,-8,1,Anthony Davis,LAL,LAL,HOU,,,40,37,30,13
22023,203076,22300036,"NOV 17, 2023",LAL @ POR,W,35,8,19,0.421,0,1,0.0,0,1,0.0,4,10,14,2,3,5,6,5,16,1,1,Anthony Davis,LAL,POR,LAL,,,32,30,18,16
22023,203076,22300198,"NOV 15, 2023",LAL vs. SAC,L,35,3,9,0.333,0,1,0.0,3,3,1.0,0,9,9,0,0,4,5,4,9,-13,1,Anthony Davis,LAL,LAL,SAC,,,18,18,9,9
22023,203076,22300026,"NOV 14, 2023",LAL vs. MEM,W,27,7,11,0.636,0,0,0.0,5,6,0.833,4,7,11,5,0,6,2,1,19,21,1,Anthony Davis,LAL,LAL,MEM,,,35,30,24,16
22023,203076,22300187,"NOV 12, 2023",LAL vs. POR,W,41,10,20,0.5,0,1,0.0,10,12,0.833,2,11,13,6,0,3,1,0,30,17,1,Anthony Davis,LAL,LAL,POR,,,49,43,36,19
22023,203076,22300015,"NOV 10, 2023",LAL @ PHX,W,36,5,14,0.357,0,0,0.0,8,8,1.0,4,7,11,4,0,1,1,3,18,-5,1,Anthony Davis,LAL,PHX,LAL,,,33,29,22,15
22023,203076,22300150,"NOV 06, 2023",LAL @ MIA,L,25,4,7,0.571,0,0,0.0,1,1,1.0,0,6,6,4,0,1,1,2,9,-9,1,Anthony Davis,LAL,MIA,LAL,,,19,15,13,10
22023,203076,22300134,"NOV 04, 2023",LAL @ ORL,L,32,10,15,0.667,0,0,0.0,8,8,1.0,6,7,13,3,0,7,4,5,28,-24,1,Anthony Davis,LAL,ORL,LAL,,,44,41,31,16
22023,203076,22300127,"NOV 01, 2023",LAL vs. LAC,W,48,10,18,0.556,0,0,0.0,7,9,0.778,4,6,10,3,1,4,0,3,27,11,1,Anthony Davis,LAL,LAL,LAC,,,40,37,30,13
22023,203076,22300111,"OCT 30, 2023",LAL vs. ORL,W,38,12,18,0.667,0,1,0.0,2,3,0.667,2,17,19,5,1,3,1,3,26,-2,1,Anthony Davis,LAL,LAL,ORL,,,50,45,31,24
22023,203076,22300100,"OCT 29, 2023",LAL @ SAC,L,42,11,22,0.5,1,2,0.5,7,8,0.875,6,10,16,2,2,3,0,5,30,-10,1,Anthony Davis,LAL,SAC,LAL,,,48,46,32,18
22023,203076,22300076,"OCT 26, 2023",LAL vs. PHX,W,39,10,17,0.588,1,2,0.5,9,10,0.9,3,9,12,2,3,3,2,2,30,7,1,Anthony Davis,LAL,LAL,PHX,,,44,42,32,14
22023,203076,22300061,"OCT 24, 2023",LAL @ DEN,L,34,6,17,0.353,1,2,0.5,4,4,1.0,1,7,8,4,0,2,2,3,17,-17,1,Anthony Davis,LAL,DEN,LAL,,,29,25,21,12
22023,1631098,22300558,"JAN 15, 2024",WAS vs. DET,L,1,0,0,0.0,0,0,0.0,0,0,0.0,0,0,0,0,0,0,0,0,0,3,1,Johnny Davis,WAS,WAS,DET,,,0,0,0,0
22023,1631098,22300494,"JAN 06, 2024",WAS vs. NYK,L,3,1,2,0.5,0,0,0.0,0,0,0.0,0,0,0,0,0,0,0,0,2,5,1,Johnny Davis,WAS,WAS,NYK,,,2,2,2,0
22023,1631098,22300482,"JAN 05, 2024",WAS @ CLE,L,6,0,2,0.0,0,0,0.0,0,0,0.0,1,0,1,0,0,0,0,0,0,-1,1,Johnny Davis,WAS,CLE,WAS,,,1,1,0,1
22023,1631098,22300465,"JAN 03, 2024",WAS @ CLE,L,5,1,3,0.333,0,0,0.0,0,0,0.0,0,0,0,0,0,0,0,0,2,0,1,Johnny Davis,WAS,CLE,WAS,,,2,2,2,0
22023,1631098,22300416,"DEC 27, 2023",WAS vs. TOR,L,6,0,1,0.0,0,0,0.0,0,0,0.0,0,0,0,0,0,0,0,1,0,-4,1,Johnny Davis,WAS,WAS,TOR,,,0,0,0,0
22023,1631098,22300274,"DEC 01, 2023",WAS @ ORL,L,6,0,2,0.0,0,0,0.0,0,0,0.0,1,0,1,0,0,0,0,1,0,-2,1,Johnny Davis,WAS,ORL,WAS,,,1,1,0,1
22023,1631098,22300259,"NOV 29, 2023",WAS @ ORL,L,10,0,1,0.0,0,0,0.0,0,0,0.0,1,0,1,0,1,0,0,1,0,-2,1,Johnny Davis,WAS,ORL,WAS,,,1,1,0,1
22023,1631098,22300253,"NOV 27, 2023",WAS @ DET,W,7,1,2,0.5,0,0,0.0,0,0,0.0,0,0,0,0,0,0,1,0,2,0,1,Johnny Davis,WAS,DET,WAS,,,2,2,2,0
22023,1631098,22300241,"NOV 25, 2023",WAS vs. ATL,L,16,2,5,0.4,0,1,0.0,0,0,0.0,0,3,3,2,1,0,1,1,4,5,1,Johnny Davis,WAS,WAS,ATL,,,9,7,6,5
22023,1631098,22300049,"NOV 24, 2023",WAS @ MIL,L,12,2,4,0.5,0,0,0.0,2,2,1.0,3,2,5,0,0,0,1,1,6,-5,1,Johnny Davis,WAS,MIL,WAS,,,11,11,6,5
22023,1631098,22300225,"NOV 22, 2023",WAS @ CHA,L,5,0,0,0.0,0,0,0.0,0,0,0.0,0,0,0,0,0,0,0,0,0,-6,1,Johnny Davis,WAS,CHA,WAS,,,0,0,0,0
22023,1631098,22300219,"NOV 20, 2023",WAS vs. MIL,L,6,0,0,0.0,0,0,0.0,0,0,0.0,0,1,1,1,0,0,0,0,0,-10,1,Johnny Davis,WAS,WAS,MIL,,,2,1,1,2
22023,1631098,22300028,"NOV 17, 2023",WAS vs. NYK,L,2,0,0,0.0,0,0,0.0,0,0,0.0,0,0,0,0,0,0,0,0,0,-1,1,Johnny Davis,WAS,WAS,NYK,,,0,0,0,0
22023,1631098,22300192,"NOV 15, 2023",WAS vs. DAL,L,7,2,3,0.667,0,0,0.0,0,0,0.0,0,1,1,1,1,0,0,1,4,11,1,Johnny Davis,WAS,WAS,DAL,,,6,5,5,2
22023,1631098,22300157,"NOV 08, 2023",WAS @ CHA,W,3,0,0,0.0,0,0,0.0,0,0,0.0,0,0,0,0,0,1,0,0,0,-2,1,Johnny Davis,WAS,CHA,WAS,,,0,0,0,0
22023,1631098,22300148,"NOV 06, 2023",WAS @ PHI,L,14,2,8,0.25,0,0,0.0,0,0,0.0,2,1,3,1,0,0,0,0,4,-6,1,Johnny Davis,WAS,PHI,WAS,,,8,7,5,4
22023,1631098,22300003,"NOV 03, 2023",WAS @ MIA,L,13,5,5,1.0,1,1,1.0,0,0,0.0,0,1,1,0,1,0,0,0,11,19,1,Johnny Davis,WAS,MIA,WAS,,,12,12,11,1
22023,1631098,22300117,"NOV 01, 2023",WAS @ ATL,L,10,3,6,0.5,0,1,0.0,1,1,1.0,0,1,1,0,3,0,0,3,7,-9,1,Johnny Davis,WAS,ATL,WAS,,,8,8,7,1
22023,1631098,22300103,"OCT 30, 2023",WAS vs. BOS,L,16,2,4,0.5,0,0,0.0,1,2,0.5,1,1,2,0,0,0,2,2,5,8,1,Johnny Davis,WAS,WAS,BOS,,,7,7,5,2
22023,1631120,22300389,"DEC 23, 2023",BOS @ LAC,W,3,0,1,0.0,0,1,0.0,0,0,0.0,0,1,1,0,0,0,0,0,0,2,1,JD Davison,BOS,LAC,BOS,,,1,1,0,1
22023,201942,22300561,"JAN 15, 2024",CHI @ CLE,L,38,3,8,0.375,0,1,0.0,0,0,0.0,0,6,6,3,2,1,2,3,6,-17,1,DeMar DeRozan,CHI,CLE,CHI,,,15,12,9,9
22023,201942,22300548,"JAN 13, 2024",CHI @ SAS,W,34,8,19,0.421,2,5,0.4,2,2,1.0,0,4,4,4,0,0,0,1,20,6,1,DeMar DeRozan,CHI,SAS,CHI,,,28,24,24,8
22023,201942,22300536,"JAN 12, 2024",CHI vs. GSW,L,41,15,21,0.714,2,5,0.4,7,8,0.875,1,6,7,5,0,0,1,5,39,4,1,DeMar DeRozan,CHI,CHI,GSW,,,51,46,44,12
22023,201942,22300523,"JAN 10, 2024",CHI vs. HOU,W,43,5,19,0.263,3,6,0.5,6,6,1.0,0,4,4,4,0,0,1,2,19,-9,1,DeMar DeRozan,CHI,CHI,HOU,,,27,23,23,8
22023,201942,22300506,"JAN 08, 2024",CHI @ CHA,W,44,7,16,0.438,1,3,0.333,3,4,0.75,0,7,7,7,3,1,3,0,18,14,1,DeMar DeRozan,CHI,CHA,CHI,,,32,25,25,14
22023,201942,22300484,"JAN 05, 2024",CHI vs. CHA,W,38,6,10,0.6,0,2,0.0,5,5,1.0,0,1,1,6,3,0,3,4,17,18,1,DeMar DeRozan,CHI,CHI,CHA,,,24,18,23,7
22023,201942,22300468,"JAN 03, 2024",CHI @ NYK,L,39,10,13,0.769,3,4,0.75,5,5,1.0,0,3,3,4,1,1,0,1,28,-25,1,DeMar DeRozan,CHI,NYK,CHI,,,35,31,32,7
22023,201942,22300459,"JAN 02, 2024",CHI @ PHI,L,30,5,10,0.5,0,3,0.0,6,7,0.857,0,4,4,3,0,0,1,4,16,-24,1,DeMar DeRozan,CHI,PHI,CHI,,,23,20,19,7
22023,201942,22300442,"DEC 30, 2023",CHI vs. PHI,W,37,9,17,0.529,0,2,0.0,6,7,0.857,0,6,6,5,0,0,2,0,24,19,1,DeMar DeRozan,CHI,CHI,PHI,,,35,30,29,11
22023,201942,22300422,"DEC 28, 2023",CHI vs. IND,L,37,7,19,0.368,0,3,0.0,7,8,0.875,0,5,5,5,2,0,1,1,21,-18,1,DeMar DeRozan,CHI,CHI,IND,,,31,26,26,10
22023,201942,22300408,"DEC 26, 2023",CHI vs. ATL,W,40,8,17,0.471,2,3,0.667,7,7,1.0,0,2,2,6,1,0,1,3,25,8,1,DeMar DeRozan,CHI,CHI,ATL,,,33,27,31,8
22023,201942,22300396,"DEC 23, 2023",CHI vs. CLE,L,40,6,14,0.429,1,3,0.333,8,9,0.889,0,5,5,8,3,0,2,4,21,-8,1,DeMar DeRozan,CHI,CHI,CLE,,,34,26,29,13
22023,201942,22300376,"DEC 21, 2023",CHI vs. SAS,W,36,9,15,0.6,1,3,0.333,2,2,1.0,0,4,4,5,0,1,0,1,21,10,1,DeMar DeRozan,CHI,CHI,SAS,,,30,25,26,9
22023,201942,22300370,"DEC 20, 2023",CHI vs. LAL,W,36,12,16,0.75,0,2,0.0,3,3,1.0,0,7,7,9,1,1,3,3,27,17,1,DeMar DeRozan,CHI,CHI,LAL,,,43,34,36,16
22023,201942,22300351,"DEC 18, 2023",CHI @ PHI,W,37,5,15,0.333,0,0,0.0,5,6,0.833,0,4,4,5,4,1,2,1,15,-5,1,DeMar DeRozan,CHI,PHI,CHI,,,24,19,20,9
22023,201942,22300337,"DEC 16, 2023",CHI @ MIA,L,42,9,13,0.692,1,2,0.5,8,9,0.889,1,2,3,5,2,3,3,1,27,5,1,DeMar DeRozan,CHI,MIA,CHI,,,35,30,32,8
22023,201942,22300320,"DEC 14, 2023",CHI @ MIA,W,41,6,14,0.429,1,3,0.333,10,11,0.909,2,3,5,4,0,0,3,2,23,14,1,DeMar DeRozan,CHI,MIA,CHI,,,32,28,27,9
22023,201942,22300307,"DEC 12, 2023",CHI vs. DEN,L,37,3,13,0.231,1,4,0.25,7,7,1.0,0,4,4,5,1,2,0,5,14,-7,1,DeMar DeRozan,CHI,CHI,DEN,,,23,18,19,9
22023,201942,22300300,"DEC 11, 2023",CHI @ MIL,L,42,14,30,0.467,3,6,0.5,10,12,0.833,0,2,2,11,0,0,2,5,41,6,1,DeMar DeRozan,CHI,MIL,CHI,,,54,43,52,13
22023,201942,22301223,"DEC 08, 2023",CHI @ SAS,W,39,7,24,0.292,0,2,0.0,6,10,0.6,1,5,6,10,3,0,2,2,20,13,1,DeMar DeRozan,CHI,SAS,CHI,,,36,26,30,16
22023,201942,22301211,"DEC 06, 2023",CHI vs. CHA,W,37,8,20,0.4,1,3,0.333,12,14,0.857,0,6,6,3,0,1,2,1,29,17,1,DeMar DeRozan,CHI,CHI,CHA,,,38,35,32,9
22023,201942,22300285,"DEC 02, 2023",CHI vs. NOP,W,40,10,18,0.556,2,4,0.5,2,2,1.0,0,5,5,10,0,0,2,3,24,2,1,DeMar DeRozan,CHI,CHI,NOP,,,39,29,34,15
22023,201942,22300053,"NOV 28, 2023",CHI @ BOS,L,26,7,14,0.5,1,3,0.333,4,4,1.0,0,2,2,6,0,0,2,2,19,-20,1,DeMar DeRozan,CHI,BOS,CHI,,,27,21,25,8
22023,201942,22300250,"NOV 26, 2023",CHI @ BKN,L,38,11,22,0.5,2,4,0.5,3,5,0.6,2,4,6,6,1,0,1,2,27,5,1,DeMar DeRozan,CHI,BKN,CHI,,,39,33,33,12
22023,201942,22300046,"NOV 24, 2023",CHI @ TOR,L,39,7,16,0.438,0,1,0.0,5,9,0.556,0,3,3,4,1,1,2,3,19,-31,1,DeMar DeRozan,CHI,TOR,CHI,,,26,22,23,7
22023,201942,22300234,"NOV 22, 2023",CHI @ OKC,L,37,6,17,0.353,0,2,0.0,13,13,1.0,1,1,2,6,2,1,1,3,25,-16,1,DeMar DeRozan,CHI,OKC,CHI,,,33,27,31,8
22023,201942,22300220,"NOV 20, 2023",CHI vs. MIA,L,34,6,10,0.6,2,4,0.5,1,1,1.0,0,4,4,5,0,1,0,1,15,-15,1,DeMar DeRozan,CHI,CHI,MIA,,,24,19,20,9
22023,201942,22300204,"NOV 18, 2023",CHI vs. MIA,W,40,6,12,0.5,2,4,0.5,9,13,0.692,1,3,4,4,1,0,3,1,23,-11,1,DeMar DeRozan,CHI,CHI,MIA,,,31,27,27,8
22023,201942,22300033,"NOV 17, 2023",CHI vs. ORL,L,36,10,20,0.5,1,1,1.0,2,4,0.5,0,4,4,3,1,0,3,1,23,-6,1,DeMar DeRozan,CHI,CHI,ORL,,,30,27,26,7
22023,201942,22300190,"NOV 13, 2023",CHI @ MIL,L,37,3,14,0.214,0,3,0.0,5,5,1.0,2,2,4,7,0,1,1,3,11,-2,1,DeMar DeRozan,CHI,MIL,CHI,,,22,15,18,11
22023,201942,22300181,"NOV 12, 2023",CHI vs. DET,W,37,11,19,0.579,2,3,0.667,5,5,1.0,1,0,1,1,0,4,0,1,29,12,1,DeMar DeRozan,CHI,CHI,DET,,,31,30,30,2
22023,201942,22300162,"NOV 08, 2023",CHI vs. PHX,L,40,6,20,0.3,1,4,0.25,9,11,0.818,0,2,2,7,1,2,2,2,22,-3,1,DeMar DeRozan,CHI,CHI,PHX,,,31,24,29,9
22023,201942,22300152,"NOV 06, 2023",CHI vs. UTA,W,30,8,13,0.615,1,1,1.0,4,5,0.8,3,2,5,4,4,0,1,3,21,2,1,DeMar DeRozan,CHI,CHI,UTA,,,30,26,25,9
22023,201942,22300139,"NOV 04, 2023",CHI @ DEN,L,34,7,16,0.438,0,1,0.0,3,4,0.75,0,3,3,6,0,0,0,4,17,-18,1,DeMar DeRozan,CHI,DEN,CHI,,,26,20,23,9
22023,201942,22300004,"NOV 03, 2023",CHI vs. BKN,L,33,9,20,0.45,2,4,0.5,4,4,1.0,1,0,1,4,0,0,0,0,24,-16,1,DeMar DeRozan,CHI,CHI,BKN,,,29,25,28,5
22023,201942,22300124,"NOV 01, 2023",CHI @ DAL,L,33,5,13,0.385,0,1,0.0,6,6,1.0,1,2,3,7,1,0,2,3,16,-17,1,DeMar DeRozan,CHI,DAL,CHI,,,26,19,23,10
22023,201942,22300102,"OCT 30, 2023",CHI @ IND,W,35,6,19,0.316,0,1,0.0,8,8,1.0,1,2,3,4,0,1,0,2,20,15,1,DeMar DeRozan,CHI,IND,CHI,,,27,23,24,7
22023,201942,22300088,"OCT 28, 2023",CHI @ DET,L,32,7,13,0.538,0,1,0.0,6,7,0.857,1,1,2,4,1,2,1,3,20,-11,1,DeMar DeRozan,CHI,DET,CHI,,,26,22,24,6
22023,201942,22300082,"OCT 27, 2023",CHI vs. TOR,W,41,11,22,0.5,1,3,0.333,10,14,0.714,1,3,4,3,4,1,2,2,33,0,1,DeMar DeRozan,CHI,CHI,TOR,,,40,37,36,7
22023,201942,22300070,"OCT 25, 2023",CHI vs. OKC,L,33,9,20,0.45,1,3,0.333,1,3,0.333,2,3,5,2,1,1,0,1,20,-29,1,DeMar DeRozan,CHI,CHI,OKC,,,27,25,22,7
22023,1641926,22300398,"DEC 23, 2023",DAL vs. SAS,W,6,0,2,0.0,0,2,0.0,0,0,0.0,0,2,2,0,0,1,3,1,0,-12,1,Dexter Dennis,DAL,DAL,SAS,,,2,2,0,2
22023,1641926,22300385,"DEC 22, 2023",DAL @ HOU,L,17,8,11,0.727,1,3,0.333,1,2,0.5,0,5,5,4,0,0,0,0,18,10,1,Dexter Dennis,DAL,HOU,DAL,,,27,23,22,9
22023,1641926,22300287,"DEC 02, 2023",DAL vs. OKC,L,3,0,2,0.0,0,2,0.0,0,0,0.0,1,1,2,0,0,0,0,0,0,-11,1,Dexter Dennis,DAL,DAL,OKC,,,2,2,0,2
22023,1641926,22300277,"DEC 01, 2023",DAL vs. MEM,L,4,2,4,0.5,0,1,0.0,0,1,0.0,0,0,0,0,0,0,0,0,4,4,1,Dexter Dennis,DAL,DAL,MEM,,,4,4,4,0
22023,1628978,22300557,"JAN 15, 2024",NYK vs. ORL,L,24,5,12,0.417,2,8,0.25,3,6,0.5,2,4,6,4,0,1,0,2,15,9,1,Donte DiVincenzo,NYK,NYK,ORL,,,25,21,19,10
22023,1628978,22300544,"JAN 13, 2024",NYK @ MEM,W,33,4,14,0.286,3,11,0.273,2,3,0.667,0,3,3,4,4,0,2,2,13,8,1,Donte DiVincenzo,NYK,MEM,NYK,,,20,16,17,7
22023,1628978,22300530,"JAN 11, 2024",NYK @ DAL,L,30,7,13,0.538,5,10,0.5,0,0,0.0,1,3,4,3,2,0,2,4,19,-6,1,Donte DiVincenzo,NYK,DAL,NYK,,,26,23,22,7
22023,1628978,22300514,"JAN 09, 2024",NYK vs. POR,W,19,4,9,0.444,3,8,0.375,2,2,1.0,0,4,4,2,1,0,0,2,13,14,1,Donte DiVincenzo,NYK,NYK,POR,,,19,17,15,6
22023,1628978,22300494,"JAN 06, 2024",NYK @ WAS,W,26,4,10,0.4,2,7,0.286,0,0,0.0,1,4,5,3,1,0,1,1,10,3,1,Donte DiVincenzo,NYK,WAS,NYK,,,18,15,13,8
22023,1628978,22300483,"JAN 05, 2024",NYK @ PHI,W,17,4,6,0.667,4,6,0.667,2,2,1.0,1,1,2,3,1,0,2,4,14,-7,1,Donte DiVincenzo,NYK,PHI,NYK,,,19,16,17,5
22023,1628978,22300468,"JAN 03, 2024",NYK vs. CHI,W,25,4,10,0.4,3,8,0.375,0,0,0.0,1,4,5,5,1,0,3,2,11,18,1,Donte DiVincenzo,NYK,NYK,CHI,,,21,16,16,10
22023,1628978,22300451,"JAN 01, 2024",NYK vs. MIN,W,26,5,11,0.455,2,6,0.333,3,4,0.75,1,3,4,2,1,1,1,0,15,15,1,Donte DiVincenzo,NYK,NYK,MIN,,,21,19,17,6
22023,1628978,22300441,"DEC 30, 2023",NYK @ IND,L,36,15,21,0.714,7,11,0.636,1,1,1.0,2,4,6,2,4,1,1,2,38,-17,1,Donte DiVincenzo,NYK,IND,NYK,,,46,44,40,8
22023,1628978,22300429,"DEC 29, 2023",NYK @ ORL,L,20,1,7,0.143,0,5,0.0,0,0,0.0,0,1,1,2,3,1,1,4,2,-12,1,Donte DiVincenzo,NYK,ORL,NYK,,,5,3,4,3
22023,1628978,22300419,"DEC 27, 2023",NYK @ OKC,L,21,6,10,0.6,5,9,0.556,0,0,0.0,0,2,2,0,0,0,1,2,17,-1,1,Donte DiVincenzo,NYK,OKC,NYK,,,19,19,17,2
22023,1628978,22300401,"DEC 25, 2023",NYK vs. MIL,W,21,1,6,0.167,1,5,0.2,0,0,0.0,0,1,1,4,1,0,1,4,3,2,1,Donte DiVincenzo,NYK,NYK,MIL,,,8,4,7,5
22023,1628978,22300388,"DEC 23, 2023",NYK vs. MIL,L,24,4,7,0.571,3,6,0.5,0,0,0.0,1,1,2,2,1,0,1,3,11,-2,1,Donte DiVincenzo,NYK,NYK,MIL,,,15,13,13,4
22023,1628978,22300368,"DEC 20, 2023",NYK @ BKN,W,23,9,15,0.6,5,10,0.5,0,0,0.0,2,6,8,1,3,0,2,2,23,13,1,Donte DiVincenzo,NYK,BKN,NYK,,,32,31,24,9
22023,1628978,22300359,"DEC 18, 2023",NYK @ LAL,W,19,3,5,0.6,2,4,0.5,0,0,0.0,0,1,1,3,0,1,1,1,8,-2,1,Donte DiVincenzo,NYK,LAL,NYK,,,12,9,11,4
22023,1628978,22300343,"DEC 16, 2023",NYK @ LAC,L,22,5,8,0.625,5,8,0.625,3,3,1.0,0,1,1,1,1,0,0,3,18,-22,1,Donte DiVincenzo,NYK,LAC,NYK,,,20,19,19,2
22023,1628978,22300333,"DEC 15, 2023",NYK @ PHX,W,19,2,3,0.667,1,2,0.5,0,0,0.0,0,1,1,1,1,0,0,4,5,-13,1,Donte DiVincenzo,NYK,PHX,NYK,,,7,6,6,2
22023,1628978,22300318,"DEC 13, 2023",NYK @ UTA,L,27,6,13,0.462,4,9,0.444,5,7,0.714,3,4,7,1,4,0,0,2,21,12,1,Donte DiVincenzo,NYK,UTA,NYK,,,29,28,22,8
22023,1628978,22300297,"DEC 11, 2023",NYK vs. TOR,W,19,1,2,0.5,1,2,0.5,0,0,0.0,0,4,4,5,0,1,1,3,3,1,1,Donte DiVincenzo,NYK,NYK,TOR,,,12,7,8,9
22023,1628978,22301227,"DEC 08, 2023",NYK @ BOS,L,22,2,6,0.333,2,5,0.4,0,0,0.0,0,4,4,2,0,0,1,2,6,-21,1,Donte DiVincenzo,NYK,BOS,NYK,,,12,10,8,6
22023,1628978,22301201,"DEC 05, 2023",NYK @ MIL,L,17,2,5,0.4,1,4,0.25,2,2,1.0,0,1,1,2,0,0,0,2,7,-12,1,Donte DiVincenzo,NYK,MIL,NYK,,,10,8,9,3
22023,1628978,22300276,"DEC 01, 2023",NYK @ TOR,W,22,7,10,0.7,7,9,0.778,0,0,0.0,0,1,1,1,0,0,0,0,21,0,1,Donte DiVincenzo,NYK,TOR,NYK,,,23,22,22,2
22023,1628978,22300268,"NOV 30, 2023",NYK vs. DET,W,23,4,8,0.5,4,8,0.5,0,0,0.0,0,3,3,2,0,1,0,1,12,0,1,Donte DiVincenzo,NYK,NYK,DET,,,17,15,14,5
22023,1628978,22300057,"NOV 28, 2023",NYK vs. CHA,W,19,2,8,0.25,2,6,0.333,0,0,0.0,0,2,2,0,1,0,2,0,6,3,1,Donte DiVincenzo,NYK,NYK,CHA,,,8,8,6,2
22023,1628978,22300247,"NOV 26, 2023",NYK vs. PHX,L,14,2,6,0.333,2,3,0.667,0,0,0.0,0,1,1,0,2,0,0,1,6,-1,1,Donte DiVincenzo,NYK,NYK,PHX,,,7,7,6,1
22023,1628978,22300045,"NOV 24, 2023",NYK vs. MIA,W,16,1,4,0.25,1,2,0.5,2,3,0.667,1,3,4,1,1,0,3,1,5,7,1,Donte DiVincenzo,NYK,NYK,MIA,,,10,9,6,5
22023,1628978,22300221,"NOV 20, 2023",NYK @ MIN,L,26,2,8,0.25,1,6,0.167,2,2,1.0,2,1,3,5,1,0,0,3,7,3,1,Donte DiVincenzo,NYK,MIN,NYK,,,15,10,12,8
22023,1628978,22300202,"NOV 18, 2023",NYK @ CHA,W,28,9,12,0.75,7,10,0.7,0,0,0.0,0,3,3,3,3,1,0,1,25,11,1,Donte DiVincenzo,NYK,CHA,NYK,,,31,28,28,6
22023,1628978,22300028,"NOV 17, 2023",NYK @ WAS,W,25,5,9,0.556,4,8,0.5,0,0,0.0,2,2,4,1,0,0,1,1,14,2,1,Donte DiVincenzo,NYK,WAS,NYK,,,19,18,15,5
22023,1628978,22300193,"NOV 15, 2023",NYK @ ATL,W,22,3,8,0.375,0,2,0.0,0,0,0.0,1,3,4,3,2,0,4,1,6,-8,1,Donte DiVincenzo,NYK,ATL,NYK,,,13,10,9,7
22023,1628978,22300188,"NOV 13, 2023",NYK @ BOS,L,16,2,6,0.333,1,4,0.25,0,0,0.0,1,0,1,1,0,0,0,1,5,-3,1,Donte DiVincenzo,NYK,BOS,NYK,,,7,6,6,2
22023,1628978,22300177,"NOV 12, 2023",NYK vs. CHA,W,23,3,8,0.375,1,6,0.167,2,3,0.667,1,0,1,2,0,1,1,2,9,16,1,Donte DiVincenzo,NYK,NYK,CHA,,,12,10,11,3
22023,1628978,22300161,"NOV 08, 2023",NYK vs. SAS,W,20,1,6,0.167,1,3,0.333,0,0,0.0,1,3,4,2,1,0,0,1,3,-12,1,Donte DiVincenzo,NYK,NYK,SAS,,,9,7,5,6
22023,1628978,22300151,"NOV 06, 2023",NYK vs. LAC,W,16,4,6,0.667,3,5,0.6,1,2,0.5,2,4,6,1,1,1,1,1,12,13,1,Donte DiVincenzo,NYK,NYK,LAC,,,19,18,13,7
22023,1628978,22300002,"NOV 03, 2023",NYK @ MIL,L,18,1,8,0.125,1,4,0.25,0,0,0.0,1,3,4,0,0,0,1,0,3,-10,1,Donte DiVincenzo,NYK,MIL,NYK,,,7,7,3,4
22023,1628978,22300120,"NOV 01, 2023",NYK vs. CLE,L,30,5,10,0.5,3,7,0.429,3,5,0.6,0,2,2,0,2,1,3,3,16,1,1,Donte DiVincenzo,NYK,NYK,CLE,,,18,18,16,2
22023,1628978,22300112,"OCT 31, 2023",NYK @ CLE,W,15,1,3,0.333,1,3,0.333,0,0,0.0,0,2,2,6,1,0,1,3,3,9,1,Donte DiVincenzo,NYK,CLE,NYK,,,11,5,9,8
22023,1628978,22300090,"OCT 28, 2023",NYK @ NOP,L,20,2,7,0.286,1,5,0.2,0,0,0.0,2,2,4,1,2,0,2,3,5,-8,1,Donte DiVincenzo,NYK,NOP,NYK,,,10,9,6,5
22023,1628978,22300079,"OCT 27, 2023",NYK @ ATL,W,20,6,10,0.6,3,5,0.6,1,2,0.5,1,1,2,1,1,1,2,2,16,-5,1,Donte DiVincenzo,NYK,ATL,NYK,,,19,18,17,3
22023,1628978,22300065,"OCT 25, 2023",NYK vs. BOS,L,15,0,4,0.0,0,3,0.0,0,0,0.0,0,3,3,2,0,0,0,1,0,5,1,Donte DiVincenzo,NYK,NYK,BOS,,,5,3,2,5
22023,1631217,22300458,"JAN 01, 2024",LAC vs. MIA,W,3,0,0,0.0,0,0,0.0,0,0,0.0,0,1,1,0,0,0,0,0,0,-3,1,Moussa Diabate,LAC,LAC,MIA,,,1,1,0,1
22023,1631217,22300273,"NOV 30, 2023",LAC @ GSW,L,1,0,0,0.0,0,0,0.0,2,2,1.0,0,0,0,0,0,0,0,0,2,2,1,Moussa Diabate,LAC,GSW,LAC,,,2,2,2,0
22023,1631217,22300244,"NOV 25, 2023",LAC vs. DAL,W,5,0,2,0.0,0,0,0.0,1,2,0.5,2,0,2,0,1,0,0,0,1,-1,1,Moussa Diabate,LAC,LAC,DAL,,,3,3,1,2
22023,1631217,22300223,"NOV 20, 2023",LAC @ SAS,W,4,1,2,0.5,0,0,0.0,1,2,0.5,2,0,2,0,1,0,0,0,3,3,1,Moussa Diabate,LAC,SAS,LAC,,,5,5,3,2
22023,1631217,22300179,"NOV 12, 2023",LAC vs. MEM,L,11,1,2,0.5,0,0,0.0,0,0,0.0,1,2,3,0,0,0,0,1,2,-6,1,Moussa Diabate,LAC,LAC,MEM,,,5,5,2,3
22023,1631217,22300014,"NOV 10, 2023",LAC @ DAL,L,16,4,6,0.667,0,0,0.0,3,4,0.75,6,3,9,0,0,0,0,3,11,2,1,Moussa Diabate,LAC,DAL,LAC,,,20,20,11,9
22023,1631217,22300151,"NOV 06, 2023",LAC @ NYK,L,6,1,1,1.0,0,0,0.0,2,2,1.0,0,0,0,0,0,0,0,0,4,-2,1,Moussa Diabate,LAC,NYK,LAC,,,4,4,4,0
22023,1631217,22300114,"OCT 31, 2023",LAC vs. ORL,W,3,1,2,0.5,0,0,0.0,0,0,0.0,1,0,1,2,0,0,1,0,2,2,1,Moussa Diabate,LAC,LAC,ORL,,,5,3,4,3
22023,1631217,22300099,"OCT 29, 2023",LAC vs. SAS,W,5,0,0,0.0,0,0,0.0,0,0,0.0,1,0,1,2,0,0,1,0,0,10,1,Moussa Diabate,LAC,LAC,SAS,,,3,1,2,3
22023,1631217,22300074,"OCT 25, 2023",LAC vs. POR,W,4,1,3,0.333,0,0,0.0,0,0,0.0,1,0,1,0,2,0,0,0,2,-10,1,Moussa Diabate,LAC,LAC,POR,,,3,3,2,1
22023,1641711,22300540,"JAN 12, 2024",TOR @ UTA,L,12,0,3,0.0,0,2,0.0,0,0,0.0,0,1,1,2,0,0,0,1,0,-8,1,Gradey Dick,TOR,UTA,TOR,,,3,1,2,3
22023,1641711,22300416,"DEC 27, 2023",TOR @ WAS,W,5,1,1,1.0,0,0,0.0,1,1,1.0,0,0,0,0,1,0,0,0,3,4,1,Gradey Dick,TOR,WAS,TOR,,,3,3,3,0
22023,1641711,22300382,"DEC 22, 2023",TOR @ PHI,L,2,0,0,0.0,0,0,0.0,0,0,0.0,0,0,0,0,1,0,0,0,0,5,1,Gradey Dick,TOR,PHI,TOR,,,0,0,0,0
22023,1641711,22300330,"DEC 15, 2023",TOR vs. ATL,L,3,1,3,0.333,1,3,0.333,0,0,0.0,0,0,0,0,0,0,0,0,3,1,1,Gradey Dick,TOR,TOR,ATL,,,3,3,3,0
22023,1641711,22300297,"DEC 11, 2023",TOR @ NYK,L,4,1,1,1.0,0,0,0.0,0,0,0.0,0,0,0,0,0,0,0,1,2,-6,1,Gradey Dick,TOR,NYK,TOR,,,2,2,2,0
22023,1641711,22300046,"NOV 24, 2023",TOR vs. CHI,W,9,0,0,0.0,0,0,0.0,2,2,1.0,0,1,1,0,0,0,1,1,2,2,1,Gradey Dick,TOR,TOR,CHI,,,3,3,2,1
22023,1641711,22300038,"NOV 21, 2023",TOR @ ORL,L,12,1,4,0.25,1,3,0.333,0,0,0.0,0,2,2,2,0,0,0,0,3,-2,1,Gradey Dick,TOR,ORL,TOR,,,7,5,5,4
22023,1641711,22300211,"NOV 19, 2023",TOR vs. DET,W,12,1,3,0.333,1,2,0.5,2,2,1.0,0,0,0,0,1,0,0,2,5,-3,1,Gradey Dick,TOR,TOR,DET,,,5,5,5,0
22023,1641711,22300031,"NOV 17, 2023",TOR vs. BOS,L,10,0,5,0.0,0,4,0.0,0,0,0.0,0,1,1,1,0,0,2,0,0,-10,1,Gradey Dick,TOR,TOR,BOS,,,2,1,1,2
22023,1641711,22300195,"NOV 15, 2023",TOR vs. MIL,L,26,2,10,0.2,1,6,0.167,6,6,1.0,0,0,0,2,1,0,1,4,11,-29,1,Gradey Dick,TOR,TOR,MIL,,,13,11,13,2
22023,1641711,22300189,"NOV 13, 2023",TOR vs. WAS,W,24,3,4,0.75,2,3,0.667,0,0,0.0,3,1,4,2,0,0,2,2,8,2,1,Gradey Dick,TOR,TOR,WAS,,,14,12,10,6
22023,1641711,22300174,"NOV 11, 2023",TOR @ BOS,L,15,1,4,0.25,0,2,0.0,2,2,1.0,0,1,1,1,0,0,1,1,4,-4,1,Gradey Dick,TOR,BOS,TOR,,,6,5,5,2
22023,1641711,22300168,"NOV 08, 2023",TOR @ DAL,W,7,0,1,0.0,0,0,0.0,0,0,0.0,0,0,0,0,0,0,2,1,0,0,1,Gradey Dick,TOR,DAL,TOR,,,0,0,0,0
22023,1641711,22300141,"NOV 05, 2023",TOR @ SAS,W,14,0,2,0.0,0,2,0.0,0,0,0.0,1,2,3,4,0,0,1,1,0,0,1,Gradey Dick,TOR,SAS,TOR,,,7,3,4,7
22023,1641711,22300128,"NOV 02, 2023",TOR @ PHI,L,14,0,2,0.0,0,0,0.0,0,0,0.0,0,0,0,1,0,0,1,1,0,-17,1,Gradey Dick,TOR,PHI,TOR,,,1,0,1,1
22023,1641711,22300116,"NOV 01, 2023",TOR vs. MIL,W,21,2,10,0.2,1,8,0.125,0,0,0.0,0,1,1,0,0,0,0,1,5,-3,1,Gradey Dick,TOR,TOR,MIL,,,6,6,5,1
22023,1641711,22300105,"OCT 30, 2023",TOR vs. POR,L,21,2,7,0.286,0,3,0.0,0,0,0.0,1,5,6,0,2,0,0,3,4,-9,1,Gradey Dick,TOR,TOR,POR,,,10,10,4,6
22023,1641711,22300092,"OCT 28, 2023",TOR vs. PHI,L,28,5,8,0.625,4,6,0.667,2,2,1.0,2,0,2,1,0,0,1,5,16,1,1,Gradey Dick,TOR,TOR,PHI,,,19,18,17,3
22023,1641711,22300082,"OCT 27, 2023",TOR @ CHI,L,6,0,2,0.0,0,2,0.0,0,0,0.0,0,1,1,0,0,0,0,0,0,-6,1,Gradey Dick,TOR,CHI,TOR,,,1,1,0,1
22023,1641711,22300069,"OCT 25, 2023",TOR vs. MIN,W,2,0,1,0.0,0,0,0.0,0,0,0.0,0,0,0,1,0,0,0,1,0,1,1,Gradey Dick,TOR,TOR,MIN,,,1,0,1,1
22023,1631172,22300565,"JAN 15, 2024",OKC @ LAL,L,12,2,5,0.4,1,4,0.25,0,0,0.0,1,2,3,0,0,0,1,2,5,-6,1,Ousmane Dieng,OKC,LAL,OKC,,,8,8,5,3
22023,1631172,22300546,"JAN 13, 2024",OKC vs. ORL,W,9,0,2,0.0,0,2,0.0,0,0,0.0,1,1,2,0,0,0,1,0,0,3,1,Ousmane Dieng,OKC,OKC,ORL,,,2,2,0,2
22023,1631172,22300529,"JAN 11, 2024",OKC vs. POR,W,23,4,11,0.364,1,5,0.2,0,0,0.0,0,6,6,3,1,0,1,2,9,10,1,Ousmane Dieng,OKC,OKC,POR,,,18,15,12,9
22023,1631172,22300397,"DEC 23, 2023",OKC vs. LAL,L,11,2,3,0.667,1,2,0.5,0,0,0.0,0,0,0,0,0,0,0,2,5,10,1,Ousmane Dieng,OKC,OKC,LAL,,,5,5,5,0
22023,1631172,22300379,"DEC 21, 2023",OKC vs. LAC,W,8,2,2,1.0,1,1,1.0,2,2,1.0,0,1,1,0,0,0,0,0,7,12,1,Ousmane Dieng,OKC,OKC,LAC,,,8,8,7,1
22023,1631172,22300355,"DEC 18, 2023",OKC vs. MEM,W,19,2,5,0.4,0,2,0.0,0,0,0.0,1,1,2,2,0,0,0,1,4,-9,1,Ousmane Dieng,OKC,OKC,MEM,,,8,6,6,4
22023,1631172,22300340,"DEC 16, 2023",OKC @ DEN,W,5,0,1,0.0,0,1,0.0,2,2,1.0,0,1,1,0,0,0,0,0,2,-4,1,Ousmane Dieng,OKC,DEN,OKC,,,3,3,2,1
22023,1631172,22300324,"DEC 14, 2023",OKC @ SAC,L,10,2,4,0.5,2,4,0.5,0,0,0.0,0,0,0,0,0,0,1,0,6,-3,1,Ousmane Dieng,OKC,SAC,OKC,,,6,6,6,0
22023,1631172,22300302,"DEC 11, 2023",OKC vs. UTA,W,26,6,7,0.857,3,4,0.75,3,4,0.75,0,3,3,3,0,0,1,2,18,-1,1,Ousmane Dieng,OKC,OKC,UTA,,,24,21,21,6
22023,1631172,22300058,"NOV 28, 2023",OKC @ MIN,L,2,0,1,0.0,0,0,0.0,0,0,0.0,0,1,1,0,0,0,0,0,0,-2,1,Ousmane Dieng,OKC,MIN,OKC,,,1,1,0,1
22023,1631172,22300239,"NOV 25, 2023",OKC vs. PHI,L,8,0,2,0.0,0,1,0.0,0,0,0.0,1,0,1,2,0,0,0,1,0,8,1,Ousmane Dieng,OKC,OKC,PHI,,,3,1,2,3
22023,1631172,22300185,"NOV 12, 2023",OKC @ PHX,W,6,0,1,0.0,0,1,0.0,0,0,0.0,0,0,0,0,0,0,0,0,0,-4,1,Ousmane Dieng,OKC,PHX,OKC,,,0,0,0,0
22023,1631172,22300016,"NOV 10, 2023",OKC @ SAC,L,8,0,1,0.0,0,1,0.0,0,0,0.0,0,1,1,1,0,0,0,1,0,0,1,Ousmane Dieng,OKC,SAC,OKC,,,2,1,1,2
22023,1631172,22300167,"NOV 08, 2023",OKC vs. CLE,W,9,1,2,0.5,0,1,0.0,2,2,1.0,2,3,5,1,1,0,0,1,4,9,1,Ousmane Dieng,OKC,OKC,CLE,,,10,9,5,6
22023,1631172,22300155,"NOV 06, 2023",OKC vs. ATL,W,10,1,4,0.25,1,2,0.5,0,0,0.0,1,1,2,0,0,0,1,0,3,-5,1,Ousmane Dieng,OKC,OKC,ATL,,,5,5,3,2
22023,1631172,22300005,"NOV 03, 2023",OKC vs. GSW,L,5,1,3,0.333,1,3,0.333,0,0,0.0,0,1,1,1,0,0,1,0,3,-3,1,Ousmane Dieng,OKC,OKC,GSW,,,5,4,4,2
22023,1631172,22300121,"NOV 01, 2023",OKC vs. NOP,L,12,1,4,0.25,0,3,0.0,0,0,0.0,0,2,2,1,0,0,0,0,2,-11,1,Ousmane Dieng,OKC,OKC,NOP,,,5,4,3,3
22023,1631172,22300109,"OCT 30, 2023",OKC vs. DET,W,18,4,4,1.0,2,2,1.0,0,1,0.0,1,0,1,2,0,0,1,0,10,-2,1,Ousmane Dieng,OKC,OKC,DET,,,13,11,12,3
22023,1631172,22300095,"OCT 29, 2023",OKC vs. DEN,L,19,2,8,0.25,0,5,0.0,1,1,1.0,0,5,5,1,0,0,0,0,5,-10,1,Ousmane Dieng,OKC,OKC,DEN,,,11,10,6,6
22023,1631172,22300081,"OCT 27, 2023",OKC @ CLE,W,11,0,2,0.0,0,2,0.0,0,0,0.0,0,1,1,2,0,0,0,3,0,-4,1,Ousmane Dieng,OKC,CLE,OKC,,,3,1,2,3
22023,1631172,22300070,"OCT 25, 2023",OKC @ CHI,W,14,3,5,0.6,3,5,0.6,0,0,0.0,1,1,2,0,0,0,1,1,9,2,1,Ousmane Dieng,OKC,CHI,OKC,,,11,11,9,2
22023,203915,22300562,"JAN 15, 2024",BKN vs. MIA,L,20,1,6,0.167,1,6,0.167,0,0,0.0,0,0,0,1,3,0,1,2,3,-13,1,Spencer Dinwiddie,BKN,BKN,MIA,,,4,3,4,1
22023,203915,22300527,"JAN 11, 2024",BKN @ CLE,L,16,1,3,0.333,0,2,0.0,0,0,0.0,0,2,2,3,0,0,0,2,2,-20,1,Spencer Dinwiddie,BKN,CLE,BKN,,,7,4,5,5
22023,203915,22300498,"JAN 07, 2024",BKN vs. POR,L,28,1,6,0.167,1,4,0.25,2,2,1.0,1,2,3,5,0,0,1,0,5,3,1,Spencer Dinwiddie,BKN,BKN,POR,,,13,8,10,8
22023,203915,22300481,"JAN 05, 2024",BKN vs. OKC,W,33,7,12,0.583,3,7,0.429,6,6,1.0,0,3,3,4,0,1,2,3,23,-7,1,Spencer Dinwiddie,BKN,BKN,OKC,,,30,26,27,7
22023,203915,22300469,"JAN 03, 2024",BKN @ HOU,L,28,3,5,0.6,2,3,0.667,3,5,0.6,0,1,1,5,2,0,1,1,11,-16,1,Spencer Dinwiddie,BKN,HOU,BKN,,,17,12,16,6
22023,203915,22300461,"JAN 02, 2024",BKN @ NOP,L,21,0,6,0.0,0,4,0.0,0,0,0.0,0,0,0,5,0,0,1,1,0,-25,1,Spencer Dinwiddie,BKN,NOP,BKN,,,5,0,5,5
22023,203915,22300447,"DEC 31, 2023",BKN @ OKC,L,37,4,13,0.308,1,6,0.167,4,4,1.0,3,0,3,5,1,0,1,3,13,-12,1,Spencer Dinwiddie,BKN,OKC,BKN,,,21,16,18,8
22023,203915,22300430,"DEC 29, 2023",BKN @ WAS,L,27,5,16,0.313,3,10,0.3,4,6,0.667,2,6,8,6,1,0,1,2,17,12,1,Spencer Dinwiddie,BKN,WAS,BKN,,,31,25,23,14
22023,203915,22300406,"DEC 26, 2023",BKN @ DET,W,34,2,11,0.182,0,3,0.0,5,8,0.625,1,4,5,6,1,0,0,4,9,1,1,Spencer Dinwiddie,BKN,DET,BKN,,,20,14,15,11
22023,203915,22300394,"DEC 23, 2023",BKN vs. DET,W,30,5,12,0.417,2,5,0.4,2,4,0.5,1,3,4,7,1,0,1,1,14,11,1,Spencer Dinwiddie,BKN,BKN,DET,,,25,18,21,11
22023,203915,22300383,"DEC 22, 2023",BKN vs. DEN,L,33,2,4,0.5,2,4,0.5,0,0,0.0,1,0,1,3,0,0,1,3,6,-11,1,Spencer Dinwiddie,BKN,BKN,DEN,,,10,7,9,4
22023,203915,22300368,"DEC 20, 2023",BKN vs. NYK,L,31,3,11,0.273,2,8,0.25,2,2,1.0,0,2,2,2,1,0,2,0,10,-27,1,Spencer Dinwiddie,BKN,BKN,NYK,,,14,12,12,4
22023,203915,22300357,"DEC 18, 2023",BKN @ UTA,L,36,7,15,0.467,1,6,0.167,2,3,0.667,1,7,8,11,0,2,1,0,17,-16,1,Spencer Dinwiddie,BKN,UTA,BKN,,,36,25,28,19
22023,203915,22300339,"DEC 16, 2023",BKN @ GSW,L,40,6,13,0.462,3,10,0.3,1,2,0.5,1,4,5,14,3,1,2,1,16,-6,1,Spencer Dinwiddie,BKN,GSW,BKN,,,35,21,30,19
22023,203915,22300322,"DEC 14, 2023",BKN @ DEN,L,24,5,11,0.455,1,4,0.25,6,7,0.857,0,4,4,8,1,0,2,3,17,-10,1,Spencer Dinwiddie,BKN,DEN,BKN,,,29,21,25,12
22023,203915,22300317,"DEC 13, 2023",BKN @ PHX,W,35,6,11,0.545,2,5,0.4,2,4,0.5,2,6,8,7,2,0,2,4,16,-10,1,Spencer Dinwiddie,BKN,PHX,BKN,,,31,24,23,15
22023,203915,22300303,"DEC 11, 2023",BKN @ SAC,L,34,5,14,0.357,2,8,0.25,4,5,0.8,0,2,2,8,0,0,3,2,16,-19,1,Spencer Dinwiddie,BKN,SAC,BKN,,,26,18,24,10
22023,203915,22301219,"DEC 08, 2023",BKN vs. WAS,W,33,6,15,0.4,1,6,0.167,1,1,1.0,0,3,3,9,4,0,2,3,14,19,1,Spencer Dinwiddie,BKN,BKN,WAS,,,26,17,23,12
22023,203915,22301209,"DEC 06, 2023",BKN @ ATL,W,28,5,19,0.263,1,5,0.2,2,3,0.667,1,1,2,4,1,1,2,0,13,-7,1,Spencer Dinwiddie,BKN,ATL,BKN,,,19,15,17,6
22023,203915,22300282,"DEC 02, 2023",BKN vs. ORL,W,35,8,15,0.533,3,7,0.429,3,4,0.75,0,4,4,3,0,0,2,2,22,21,1,Spencer Dinwiddie,BKN,BKN,ORL,,,29,26,25,7
22023,203915,22300266,"NOV 30, 2023",BKN vs. CHA,L,34,3,9,0.333,1,6,0.167,2,2,1.0,0,4,4,8,0,0,1,1,9,2,1,Spencer Dinwiddie,BKN,BKN,CHA,,,21,13,17,12
22023,203915,22300054,"NOV 28, 2023",BKN vs. TOR,W,38,5,17,0.294,3,11,0.273,10,10,1.0,1,8,9,8,4,0,1,0,23,15,1,Spencer Dinwiddie,BKN,BKN,TOR,,,40,32,31,17
22023,203915,22300250,"NOV 26, 2023",BKN vs. CHI,W,38,7,17,0.412,3,9,0.333,7,8,0.875,2,3,5,7,1,0,2,4,24,9,1,Spencer Dinwiddie,BKN,BKN,CHI,,,36,29,31,12
22023,203915,22300240,"NOV 25, 2023",BKN vs. MIA,W,36,4,9,0.444,2,7,0.286,4,4,1.0,0,2,2,11,2,0,3,2,14,17,1,Spencer Dinwiddie,BKN,BKN,MIA,,,27,16,25,13
22023,203915,22300227,"NOV 22, 2023",BKN @ ATL,L,42,9,23,0.391,3,8,0.375,5,5,1.0,2,4,6,12,0,0,4,3,26,8,1,Spencer Dinwiddie,BKN,ATL,BKN,,,44,32,38,18
22023,203915,22300208,"NOV 19, 2023",BKN vs. PHI,L,28,3,10,0.3,1,4,0.25,5,6,0.833,0,4,4,5,0,1,2,0,12,-21,1,Spencer Dinwiddie,BKN,BKN,PHI,,,21,16,17,9
22023,203915,22300200,"NOV 16, 2023",BKN @ MIA,L,33,2,9,0.222,2,7,0.286,4,6,0.667,2,3,5,7,0,0,2,1,10,4,1,Spencer Dinwiddie,BKN,MIA,BKN,,,22,15,17,12
22023,203915,22300020,"NOV 14, 2023",BKN vs. ORL,W,38,10,18,0.556,5,10,0.5,4,6,0.667,1,4,5,9,0,0,1,3,29,25,1,Spencer Dinwiddie,BKN,BKN,ORL,,,43,34,38,14
22023,203915,22300178,"NOV 12, 2023",BKN vs. WAS,W,31,3,10,0.3,0,5,0.0,6,7,0.857,0,4,4,3,2,1,0,2,12,13,1,Spencer Dinwiddie,BKN,BKN,WAS,,,19,16,15,7
22023,203915,22300010,"NOV 10, 2023",BKN @ BOS,L,20,3,7,0.429,3,6,0.5,3,4,0.75,0,4,4,4,0,0,2,2,12,-14,1,Spencer Dinwiddie,BKN,BOS,BKN,,,20,16,16,8
22023,203915,22300160,"NOV 08, 2023",BKN vs. LAC,W,26,2,8,0.25,2,7,0.286,1,2,0.5,0,3,3,4,0,0,2,0,7,-1,1,Spencer Dinwiddie,BKN,BKN,LAC,,,14,10,11,7
22023,203915,22300149,"NOV 06, 2023",BKN vs. MIL,L,24,1,4,0.25,1,3,0.333,0,0,0.0,1,2,3,3,0,0,0,0,3,13,1,Spencer Dinwiddie,BKN,BKN,MIL,,,9,6,6,6
22023,203915,22300136,"NOV 04, 2023",BKN vs. BOS,L,35,8,14,0.571,3,7,0.429,0,3,0.0,0,6,6,6,0,0,1,1,19,-6,1,Spencer Dinwiddie,BKN,BKN,BOS,,,31,25,25,12
22023,203915,22300004,"NOV 03, 2023",BKN @ CHI,W,31,4,7,0.571,2,4,0.5,0,0,0.0,0,3,3,9,2,0,3,0,10,15,1,Spencer Dinwiddie,BKN,CHI,BKN,,,22,13,19,12
22023,203915,22300101,"OCT 30, 2023",BKN @ CHA,W,13,2,6,0.333,1,3,0.333,0,0,0.0,0,1,1,3,0,0,1,2,5,14,1,Spencer Dinwiddie,BKN,CHA,BKN,,,9,6,8,4
22023,203915,22300084,"OCT 27, 2023",BKN @ DAL,L,40,8,17,0.471,6,12,0.5,1,2,0.5,0,3,3,8,0,0,2,4,23,4,1,Spencer Dinwiddie,BKN,DAL,BKN,,,34,26,31,11
22023,203915,22300067,"OCT 25, 2023",BKN vs. CLE,L,24,1,3,0.333,1,3,0.333,2,2,1.0,0,1,1,3,0,0,1,2,5,-10,1,Spencer Dinwiddie,BKN,BKN,CLE,,,9,6,8,4
22023,1629029,22300515,"JAN 09, 2024",DAL vs. MEM,L,36,9,21,0.429,2,8,0.25,11,15,0.733,0,6,6,6,3,0,3,1,31,-14,1,Luka Doncic,DAL,DAL,MEM,,,43,37,37,12
22023,1629029,22300501,"JAN 07, 2024",DAL vs. MIN,W,39,12,26,0.462,5,12,0.417,5,8,0.625,0,6,6,8,1,0,3,3,34,5,1,Luka Doncic,DAL,DAL,MIN,,,48,40,42,14
22023,1629029,22300472,"JAN 03, 2024",DAL vs. POR,W,31,13,21,0.619,4,7,0.571,11,14,0.786,0,6,6,5,1,0,4,1,41,23,1,Luka Doncic,DAL,DAL,POR,,,52,47,46,11
22023,1629029,22300457,"JAN 01, 2024",DAL @ UTA,L,34,6,20,0.3,3,13,0.231,4,6,0.667,0,6,6,14,1,0,4,1,19,-17,1,Luka Doncic,DAL,UTA,DAL,,,39,25,33,20
22023,1629029,22300444,"DEC 30, 2023",DAL @ GSW,W,38,14,29,0.483,5,13,0.385,6,7,0.857,0,8,8,10,1,1,4,3,39,9,1,Luka Doncic,DAL,GSW,DAL,,,57,47,49,18
22023,1629029,22300420,"DEC 27, 2023",DAL vs. CLE,L,37,14,29,0.483,3,10,0.3,8,10,0.8,0,7,7,6,2,2,5,0,39,-9,1,Luka Doncic,DAL,DAL,CLE,,,52,46,45,13
22023,1629029,22300405,"DEC 25, 2023",DAL @ PHX,W,44,15,25,0.6,8,16,0.5,12,12,1.0,1,5,6,15,4,3,4,2,50,16,1,Luka Doncic,DAL,PHX,DAL,,,71,56,65,21
22023,1629029,22300398,"DEC 23, 2023",DAL vs. SAS,W,32,13,27,0.481,5,10,0.5,8,11,0.727,2,10,12,10,1,1,2,1,39,37,1,Luka Doncic,DAL,DAL,SAS,,,61,51,49,22
22023,1629029,22300372,"DEC 20, 2023",DAL vs. LAC,L,44,9,25,0.36,2,11,0.182,8,14,0.571,1,8,9,10,1,0,5,1,28,-4,1,Luka Doncic,DAL,DAL,LAC,,,47,37,38,19
22023,1629029,22300356,"DEC 18, 2023",DAL @ DEN,L,36,13,24,0.542,6,12,0.5,6,10,0.6,3,8,11,8,0,0,3,1,38,-29,1,Luka Doncic,DAL,DEN,DAL,,,57,49,46,19
22023,1629029,22300341,"DEC 16, 2023",DAL @ POR,W,37,15,28,0.536,4,12,0.333,6,6,1.0,2,10,12,10,1,0,4,3,40,-4,1,Luka Doncic,DAL,POR,DAL,,,62,52,50,22
22023,1629029,22300321,"DEC 14, 2023",DAL vs. MIN,L,39,15,27,0.556,2,7,0.286,7,7,1.0,1,5,6,13,2,0,8,2,39,-12,1,Luka Doncic,DAL,DAL,MIN,,,58,45,52,19
22023,1629029,22300306,"DEC 12, 2023",DAL vs. LAL,W,43,12,28,0.429,3,10,0.3,6,6,1.0,0,6,6,17,1,0,4,0,33,10,1,Luka Doncic,DAL,DAL,LAL,,,56,39,50,23
22023,1629029,22300299,"DEC 11, 2023",DAL @ MEM,W,44,9,21,0.429,5,10,0.5,12,13,0.923,0,8,8,6,2,2,3,3,35,3,1,Luka Doncic,DAL,MEM,DAL,,,49,43,41,14
22023,1629029,22301226,"DEC 08, 2023",DAL @ POR,W,41,11,28,0.393,3,14,0.214,7,8,0.875,0,6,6,10,1,1,5,1,32,13,1,Luka Doncic,DAL,POR,DAL,,,48,38,42,16
22023,1629029,22301213,"DEC 06, 2023",DAL vs. UTA,W,32,14,25,0.56,6,12,0.5,6,8,0.75,2,8,10,11,1,0,4,2,40,34,1,Luka Doncic,DAL,DAL,UTA,,,61,50,51,21
22023,1629029,22300287,"DEC 02, 2023",DAL vs. OKC,L,46,11,22,0.5,5,13,0.385,9,14,0.643,2,13,15,18,2,2,7,2,36,-7,1,Luka Doncic,DAL,DAL,OKC,,,69,51,54,33
22023,1629029,22300059,"NOV 28, 2023",DAL vs. HOU,W,38,15,29,0.517,3,10,0.3,8,9,0.889,0,9,9,9,2,0,0,3,41,12,1,Luka Doncic,DAL,DAL,HOU,,,59,50,50,18
22023,1629029,22300244,"NOV 25, 2023",DAL @ LAC,L,38,12,27,0.444,1,8,0.125,5,5,1.0,0,3,3,4,2,2,4,4,30,-14,1,Luka Doncic,DAL,LAC,DAL,,,37,33,34,7
22023,1629029,22300238,"NOV 22, 2023",DAL @ LAL,W,39,10,26,0.385,3,12,0.25,7,8,0.875,0,12,12,8,2,0,0,2,30,-11,1,Luka Doncic,DAL,LAL,DAL,,,50,42,38,20
22023,1629029,22300212,"NOV 19, 2023",DAL vs. SAC,L,32,7,19,0.368,3,7,0.429,8,10,0.8,1,9,10,7,3,0,2,0,25,-14,1,Luka Doncic,DAL,DAL,SAC,,,42,35,32,17
22023,1629029,22300205,"NOV 18, 2023",DAL @ MIL,L,35,15,26,0.577,4,9,0.444,1,4,0.25,1,8,9,9,0,0,3,1,35,-17,1,Luka Doncic,DAL,MIL,DAL,,,53,44,44,18
22023,1629029,22300192,"NOV 15, 2023",DAL @ WAS,W,32,7,18,0.389,4,11,0.364,8,12,0.667,1,6,7,10,0,0,3,2,26,12,1,Luka Doncic,DAL,WAS,DAL,,,43,33,36,17
22023,1629029,22300022,"NOV 14, 2023",DAL @ NOP,L,26,5,16,0.313,3,5,0.6,3,5,0.6,1,1,2,2,0,0,8,0,16,-26,1,Luka Doncic,DAL,NOP,DAL,,,20,18,18,4
22023,1629029,22300183,"NOV 12, 2023",DAL @ NOP,W,28,11,18,0.611,4,9,0.444,4,5,0.8,0,4,4,9,1,0,2,0,30,14,1,Luka Doncic,DAL,NOP,DAL,,,43,34,39,13
22023,1629029,22300014,"NOV 10, 2023",DAL vs. LAC,W,32,17,21,0.81,6,9,0.667,4,4,1.0,0,6,6,6,1,0,1,1,44,32,1,Luka Doncic,DAL,DAL,LAC,,,56,50,50,12
22023,1629029,22300168,"NOV 08, 2023",DAL vs. TOR,L,38,11,26,0.423,2,10,0.2,7,10,0.7,0,7,7,8,4,1,4,3,31,-7,1,Luka Doncic,DAL,DAL,TOR,,,46,38,39,15
22023,1629029,22300147,"NOV 06, 2023",DAL @ ORL,W,35,9,17,0.529,5,10,0.5,6,6,1.0,0,3,3,6,2,0,6,2,29,7,1,Luka Doncic,DAL,ORL,DAL,,,38,32,35,9
22023,1629029,22300143,"NOV 05, 2023",DAL vs. CHA,W,36,8,19,0.421,1,9,0.111,6,7,0.857,1,11,12,9,0,1,4,3,23,3,1,Luka Doncic,DAL,DAL,CHA,,,44,35,32,21
22023,1629029,22300006,"NOV 03, 2023",DAL @ DEN,L,38,11,24,0.458,6,11,0.545,6,7,0.857,3,7,10,8,0,1,9,2,34,-4,1,Luka Doncic,DAL,DEN,DAL,,,52,44,42,18
22023,1629029,22300124,"NOV 01, 2023",DAL vs. CHI,W,40,5,16,0.313,1,8,0.125,7,9,0.778,0,7,7,10,2,1,6,2,18,11,1,Luka Doncic,DAL,DAL,CHI,,,35,25,28,17
22023,1629029,22300106,"OCT 30, 2023",DAL @ MEM,W,40,11,22,0.5,6,12,0.5,7,10,0.7,0,12,12,12,1,1,6,4,35,6,1,Luka Doncic,DAL,MEM,DAL,,,59,47,47,24
22023,1629029,22300084,"OCT 27, 2023",DAL vs. BKN,W,36,16,25,0.64,9,14,0.643,8,10,0.8,1,9,10,7,0,0,0,1,49,9,1,Luka Doncic,DAL,DAL,BKN,,,66,59,56,17
22023,1629029,22300073,"OCT 25, 2023",DAL @ SAS,W,34,13,25,0.52,3,11,0.273,4,7,0.571,1,12,13,10,2,0,4,1,33,4,1,Luka Doncic,DAL,SAS,DAL,,,56,46,43,23
22023,1629652,22300565,"JAN 15, 2024",OKC @ LAL,L,29,4,9,0.444,3,8,0.375,0,0,0.0,4,3,7,1,1,0,1,2,11,-2,1,Luguentz Dort,OKC,LAL,OKC,10.5,Points,19,18,12,8
22023,1629652,22300565,"JAN 15, 2024",OKC @ LAL,L,29,4,9,0.444,3,8,0.375,0,0,0.0,4,3,7,1,1,0,1,2,11,-2,1,Luguentz Dort,OKC,LAL,OKC,5.0,3-PT Attempted,19,18,12,8
22023,1629652,22300565,"JAN 15, 2024",OKC @ LAL,L,29,4,9,0.444,3,8,0.375,0,0,0.0,4,3,7,1,1,0,1,2,11,-2,1,Luguentz Dort,OKC,LAL,OKC,14.0,Pts+Rebs,19,18,12,8
22023,1629652,22300565,"JAN 15, 2024",OKC @ LAL,L,29,4,9,0.444,3,8,0.375,0,0,0.0,4,3,7,1,1,0,1,2,11,-2,1,Luguentz Dort,OKC,LAL,OKC,11.5,Pts+Asts,19,18,12,8
22023,1629652,22300546,"JAN 13, 2024",OKC vs. ORL,W,32,4,8,0.5,2,5,0.4,2,2,1.0,1,2,3,2,1,1,1,5,12,0,1,Luguentz Dort,OKC,OKC,ORL,10.5,Points,17,15,14,5
22023,1629652,22300546,"JAN 13, 2024",OKC vs. ORL,W,32,4,8,0.5,2,5,0.4,2,2,1.0,1,2,3,2,1,1,1,5,12,0,1,Luguentz Dort,OKC,OKC,ORL,5.0,3-PT Attempted,17,15,14,5
22023,1629652,22300546,"JAN 13, 2024",OKC vs. ORL,W,32,4,8,0.5,2,5,0.4,2,2,1.0,1,2,3,2,1,1,1,5,12,0,1,Luguentz Dort,OKC,OKC,ORL,14.0,Pts+Rebs,17,15,14,5
22023,1629652,22300546,"JAN 13, 2024",OKC vs. ORL,W,32,4,8,0.5,2,5,0.4,2,2,1.0,1,2,3,2,1,1,1,5,12,0,1,Luguentz Dort,OKC,OKC,ORL,11.5,Pts+Asts,17,15,14,5
22023,1629652,22300529,"JAN 11, 2024",OKC vs. POR,W,19,3,7,0.429,3,5,0.6,2,2,1.0,0,3,3,1,1,1,1,2,11,45,1,Luguentz Dort,OKC,OKC,POR,10.5,Points,15,14,12,4
22023,1629652,22300529,"JAN 11, 2024",OKC vs. POR,W,19,3,7,0.429,3,5,0.6,2,2,1.0,0,3,3,1,1,1,1,2,11,45,1,Luguentz Dort,OKC,OKC,POR,5.0,3-PT Attempted,15,14,12,4
22023,1629652,22300529,"JAN 11, 2024",OKC vs. POR,W,19,3,7,0.429,3,5,0.6,2,2,1.0,0,3,3,1,1,1,1,2,11,45,1,Luguentz Dort,OKC,OKC,POR,14.0,Pts+Rebs,15,14,12,4
22023,1629652,22300529,"JAN 11, 2024",OKC vs. POR,W,19,3,7,0.429,3,5,0.6,2,2,1.0,0,3,3,1,1,1,1,2,11,45,1,Luguentz Dort,OKC,OKC,POR,11.5,Pts+Asts,15,14,12,4
22023,1629652,22300522,"JAN 10, 2024",OKC @ MIA,W,26,5,10,0.5,2,4,0.5,2,4,0.5,0,2,2,0,0,0,0,3,14,-3,1,Luguentz Dort,OKC,MIA,OKC,10.5,Points,16,16,14,2
22023,1629652,22300522,"JAN 10, 2024",OKC @ MIA,W,26,5,10,0.5,2,4,0.5,2,4,0.5,0,2,2,0,0,0,0,3,14,-3,1,Luguentz Dort,OKC,MIA,OKC,5.0,3-PT Attempted,16,16,14,2
22023,1629652,22300522,"JAN 10, 2024",OKC @ MIA,W,26,5,10,0.5,2,4,0.5,2,4,0.5,0,2,2,0,0,0,0,3,14,-3,1,Luguentz Dort,OKC,MIA,OKC,14.0,Pts+Rebs,16,16,14,2
22023,1629652,22300522,"JAN 10, 2024",OKC @ MIA,W,26,5,10,0.5,2,4,0.5,2,4,0.5,0,2,2,0,0,0,0,3,14,-3,1,Luguentz Dort,OKC,MIA,OKC,11.5,Pts+Asts,16,16,14,2
22023,1629652,22300508,"JAN 08, 2024",OKC @ WAS,W,27,2,5,0.4,0,3,0.0,3,4,0.75,0,3,3,1,0,1,2,4,7,0,1,Luguentz Dort,OKC,WAS,OKC,10.5,Points,11,10,8,4
22023,1629652,22300508,"JAN 08, 2024",OKC @ WAS,W,27,2,5,0.4,0,3,0.0,3,4,0.75,0,3,3,1,0,1,2,4,7,0,1,Luguentz Dort,OKC,WAS,OKC,5.0,3-PT Attempted,11,10,8,4
22023,1629652,22300508,"JAN 08, 2024",OKC @ WAS,W,27,2,5,0.4,0,3,0.0,3,4,0.75,0,3,3,1,0,1,2,4,7,0,1,Luguentz Dort,OKC,WAS,OKC,14.0,Pts+Rebs,11,10,8,4
22023,1629652,22300508,"JAN 08, 2024",OKC @ WAS,W,27,2,5,0.4,0,3,0.0,3,4,0.75,0,3,3,1,0,1,2,4,7,0,1,Luguentz Dort,OKC,WAS,OKC,11.5,Pts+Asts,11,10,8,4
22023,1629652,22300481,"JAN 05, 2024",OKC @ BKN,L,28,5,8,0.625,2,5,0.4,0,0,0.0,2,2,4,3,3,0,1,4,12,-5,1,Luguentz Dort,OKC,BKN,OKC,10.5,Points,19,16,15,7
22023,1629652,22300481,"JAN 05, 2024",OKC @ BKN,L,28,5,8,0.625,2,5,0.4,0,0,0.0,2,2,4,3,3,0,1,4,12,-5,1,Luguentz Dort,OKC,BKN,OKC,5.0,3-PT Attempted,19,16,15,7
22023,1629652,22300481,"JAN 05, 2024",OKC @ BKN,L,28,5,8,0.625,2,5,0.4,0,0,0.0,2,2,4,3,3,0,1,4,12,-5,1,Luguentz Dort,OKC,BKN,OKC,14.0,Pts+Rebs,19,16,15,7
22023,1629652,22300481,"JAN 05, 2024",OKC @ BKN,L,28,5,8,0.625,2,5,0.4,0,0,0.0,2,2,4,3,3,0,1,4,12,-5,1,Luguentz Dort,OKC,BKN,OKC,11.5,Pts+Asts,19,16,15,7
22023,1629652,22300467,"JAN 03, 2024",OKC @ ATL,L,29,3,7,0.429,2,3,0.667,6,6,1.0,3,1,4,3,0,0,0,4,14,11,1,Luguentz Dort,OKC,ATL,OKC,10.5,Points,21,18,17,7
22023,1629652,22300467,"JAN 03, 2024",OKC @ ATL,L,29,3,7,0.429,2,3,0.667,6,6,1.0,3,1,4,3,0,0,0,4,14,11,1,Luguentz Dort,OKC,ATL,OKC,5.0,3-PT Attempted,21,18,17,7
22023,1629652,22300467,"JAN 03, 2024",OKC @ ATL,L,29,3,7,0.429,2,3,0.667,6,6,1.0,3,1,4,3,0,0,0,4,14,11,1,Luguentz Dort,OKC,ATL,OKC,14.0,Pts+Rebs,21,18,17,7
22023,1629652,22300467,"JAN 03, 2024",OKC @ ATL,L,29,3,7,0.429,2,3,0.667,6,6,1.0,3,1,4,3,0,0,0,4,14,11,1,Luguentz Dort,OKC,ATL,OKC,11.5,Pts+Asts,21,18,17,7
22023,1629652,22300462,"JAN 02, 2024",OKC vs. BOS,W,37,4,14,0.286,1,7,0.143,0,0,0.0,5,3,8,1,1,3,0,2,9,8,1,Luguentz Dort,OKC,OKC,BOS,10.5,Points,18,17,10,9
22023,1629652,22300462,"JAN 02, 2024",OKC vs. BOS,W,37,4,14,0.286,1,7,0.143,0,0,0.0,5,3,8,1,1,3,0,2,9,8,1,Luguentz Dort,OKC,OKC,BOS,5.0,3-PT Attempted,18,17,10,9
22023,1629652,22300462,"JAN 02, 2024",OKC vs. BOS,W,37,4,14,0.286,1,7,0.143,0,0,0.0,5,3,8,1,1,3,0,2,9,8,1,Luguentz Dort,OKC,OKC,BOS,14.0,Pts+Rebs,18,17,10,9
22023,1629652,22300462,"JAN 02, 2024",OKC vs. BOS,W,37,4,14,0.286,1,7,0.143,0,0,0.0,5,3,8,1,1,3,0,2,9,8,1,Luguentz Dort,OKC,OKC,BOS,11.5,Pts+Asts,18,17,10,9
22023,1629652,22300447,"DEC 31, 2023",OKC vs. BKN,W,30,7,10,0.7,4,5,0.8,0,0,0.0,0,4,4,3,0,1,0,4,18,15,1,Luguentz Dort,OKC,OKC,BKN,10.5,Points,25,22,21,7
22023,1629652,22300447,"DEC 31, 2023",OKC vs. BKN,W,30,7,10,0.7,4,5,0.8,0,0,0.0,0,4,4,3,0,1,0,4,18,15,1,Luguentz Dort,OKC,OKC,BKN,5.0,3-PT Attempted,25,22,21,7
22023,1629652,22300447,"DEC 31, 2023",OKC vs. BKN,W,30,7,10,0.7,4,5,0.8,0,0,0.0,0,4,4,3,0,1,0,4,18,15,1,Luguentz Dort,OKC,OKC,BKN,14.0,Pts+Rebs,25,22,21,7
22023,1629652,22300447,"DEC 31, 2023",OKC vs. BKN,W,30,7,10,0.7,4,5,0.8,0,0,0.0,0,4,4,3,0,1,0,4,18,15,1,Luguentz Dort,OKC,OKC,BKN,11.5,Pts+Asts,25,22,21,7
22023,1629652,22300435,"DEC 29, 2023",OKC @ DEN,W,32,2,6,0.333,0,3,0.0,0,0,0.0,1,3,4,1,3,1,1,3,4,24,1,Luguentz Dort,OKC,DEN,OKC,10.5,Points,9,8,5,5
22023,1629652,22300435,"DEC 29, 2023",OKC @ DEN,W,32,2,6,0.333,0,3,0.0,0,0,0.0,1,3,4,1,3,1,1,3,4,24,1,Luguentz Dort,OKC,DEN,OKC,5.0,3-PT Attempted,9,8,5,5
22023,1629652,22300435,"DEC 29, 2023",OKC @ DEN,W,32,2,6,0.333,0,3,0.0,0,0,0.0,1,3,4,1,3,1,1,3,4,24,1,Luguentz Dort,OKC,DEN,OKC,14.0,Pts+Rebs,9,8,5,5
22023,1629652,22300435,"DEC 29, 2023",OKC @ DEN,W,32,2,6,0.333,0,3,0.0,0,0,0.0,1,3,4,1,3,1,1,3,4,24,1,Luguentz Dort,OKC,DEN,OKC,11.5,Pts+Asts,9,8,5,5
22023,1629652,22300419,"DEC 27, 2023",OKC vs. NYK,W,27,2,9,0.222,1,4,0.25,0,0,0.0,0,2,2,2,0,0,0,4,5,13,1,Luguentz Dort,OKC,OKC,NYK,10.5,Points,9,7,7,4
22023,1629652,22300419,"DEC 27, 2023",OKC vs. NYK,W,27,2,9,0.222,1,4,0.25,0,0,0.0,0,2,2,2,0,0,0,4,5,13,1,Luguentz Dort,OKC,OKC,NYK,5.0,3-PT Attempted,9,7,7,4
22023,1629652,22300419,"DEC 27, 2023",OKC vs. NYK,W,27,2,9,0.222,1,4,0.25,0,0,0.0,0,2,2,2,0,0,0,4,5,13,1,Luguentz Dort,OKC,OKC,NYK,14.0,Pts+Rebs,9,7,7,4
22023,1629652,22300419,"DEC 27, 2023",OKC vs. NYK,W,27,2,9,0.222,1,4,0.25,0,0,0.0,0,2,2,2,0,0,0,4,5,13,1,Luguentz Dort,OKC,OKC,NYK,11.5,Pts+Asts,9,7,7,4
22023,1629652,22300411,"DEC 26, 2023",OKC vs. MIN,W,33,7,9,0.778,5,6,0.833,1,2,0.5,0,4,4,0,2,2,2,4,20,14,1,Luguentz Dort,OKC,OKC,MIN,10.5,Points,24,24,20,4
22023,1629652,22300411,"DEC 26, 2023",OKC vs. MIN,W,33,7,9,0.778,5,6,0.833,1,2,0.5,0,4,4,0,2,2,2,4,20,14,1,Luguentz Dort,OKC,OKC,MIN,5.0,3-PT Attempted,24,24,20,4
22023,1629652,22300411,"DEC 26, 2023",OKC vs. MIN,W,33,7,9,0.778,5,6,0.833,1,2,0.5,0,4,4,0,2,2,2,4,20,14,1,Luguentz Dort,OKC,OKC,MIN,14.0,Pts+Rebs,24,24,20,4
22023,1629652,22300411,"DEC 26, 2023",OKC vs. MIN,W,33,7,9,0.778,5,6,0.833,1,2,0.5,0,4,4,0,2,2,2,4,20,14,1,Luguentz Dort,OKC,OKC,MIN,11.5,Pts+Asts,24,24,20,4
22023,1629652,22300397,"DEC 23, 2023",OKC vs. LAL,L,30,3,9,0.333,2,6,0.333,0,0,0.0,1,4,5,0,0,1,2,2,8,-18,1,Luguentz Dort,OKC,OKC,LAL,10.5,Points,13,13,8,5
22023,1629652,22300397,"DEC 23, 2023",OKC vs. LAL,L,30,3,9,0.333,2,6,0.333,0,0,0.0,1,4,5,0,0,1,2,2,8,-18,1,Luguentz Dort,OKC,OKC,LAL,5.0,3-PT Attempted,13,13,8,5
22023,1629652,22300397,"DEC 23, 2023",OKC vs. LAL,L,30,3,9,0.333,2,6,0.333,0,0,0.0,1,4,5,0,0,1,2,2,8,-18,1,Luguentz Dort,OKC,OKC,LAL,14.0,Pts+Rebs,13,13,8,5
22023,1629652,22300397,"DEC 23, 2023",OKC vs. LAL,L,30,3,9,0.333,2,6,0.333,0,0,0.0,1,4,5,0,0,1,2,2,8,-18,1,Luguentz Dort,OKC,OKC,LAL,11.5,Pts+Asts,13,13,8,5
22023,1629652,22300379,"DEC 21, 2023",OKC vs. LAC,W,31,8,12,0.667,3,6,0.5,2,2,1.0,1,2,3,4,0,1,0,2,21,20,1,Luguentz Dort,OKC,OKC,LAC,10.5,Points,28,24,25,7
22023,1629652,22300379,"DEC 21, 2023",OKC vs. LAC,W,31,8,12,0.667,3,6,0.5,2,2,1.0,1,2,3,4,0,1,0,2,21,20,1,Luguentz Dort,OKC,OKC,LAC,5.0,3-PT Attempted,28,24,25,7
22023,1629652,22300379,"DEC 21, 2023",OKC vs. LAC,W,31,8,12,0.667,3,6,0.5,2,2,1.0,1,2,3,4,0,1,0,2,21,20,1,Luguentz Dort,OKC,OKC,LAC,14.0,Pts+Rebs,28,24,25,7
22023,1629652,22300379,"DEC 21, 2023",OKC vs. LAC,W,31,8,12,0.667,3,6,0.5,2,2,1.0,1,2,3,4,0,1,0,2,21,20,1,Luguentz Dort,OKC,OKC,LAC,11.5,Pts+Asts,28,24,25,7
22023,1629652,22300355,"DEC 18, 2023",OKC vs. MEM,W,21,4,7,0.571,3,6,0.5,0,0,0.0,0,2,2,2,0,1,0,2,11,24,1,Luguentz Dort,OKC,OKC,MEM,10.5,Points,15,13,13,4
22023,1629652,22300355,"DEC 18, 2023",OKC vs. MEM,W,21,4,7,0.571,3,6,0.5,0,0,0.0,0,2,2,2,0,1,0,2,11,24,1,Luguentz Dort,OKC,OKC,MEM,5.0,3-PT Attempted,15,13,13,4
22023,1629652,22300355,"DEC 18, 2023",OKC vs. MEM,W,21,4,7,0.571,3,6,0.5,0,0,0.0,0,2,2,2,0,1,0,2,11,24,1,Luguentz Dort,OKC,OKC,MEM,14.0,Pts+Rebs,15,13,13,4
22023,1629652,22300355,"DEC 18, 2023",OKC vs. MEM,W,21,4,7,0.571,3,6,0.5,0,0,0.0,0,2,2,2,0,1,0,2,11,24,1,Luguentz Dort,OKC,OKC,MEM,11.5,Pts+Asts,15,13,13,4
22023,1629652,22300340,"DEC 16, 2023",OKC @ DEN,W,26,4,8,0.5,2,3,0.667,3,4,0.75,2,2,4,2,0,0,0,4,13,5,1,Luguentz Dort,OKC,DEN,OKC,10.5,Points,19,17,15,6
22023,1629652,22300340,"DEC 16, 2023",OKC @ DEN,W,26,4,8,0.5,2,3,0.667,3,4,0.75,2,2,4,2,0,0,0,4,13,5,1,Luguentz Dort,OKC,DEN,OKC,5.0,3-PT Attempted,19,17,15,6
22023,1629652,22300340,"DEC 16, 2023",OKC @ DEN,W,26,4,8,0.5,2,3,0.667,3,4,0.75,2,2,4,2,0,0,0,4,13,5,1,Luguentz Dort,OKC,DEN,OKC,14.0,Pts+Rebs,19,17,15,6
22023,1629652,22300340,"DEC 16, 2023",OKC @ DEN,W,26,4,8,0.5,2,3,0.667,3,4,0.75,2,2,4,2,0,0,0,4,13,5,1,Luguentz Dort,OKC,DEN,OKC,11.5,Pts+Asts,19,17,15,6
22023,1629652,22300324,"DEC 14, 2023",OKC @ SAC,L,32,5,8,0.625,3,5,0.6,4,5,0.8,2,2,4,0,3,2,1,4,17,3,1,Luguentz Dort,OKC,SAC,OKC,10.5,Points,21,21,17,4
22023,1629652,22300324,"DEC 14, 2023",OKC @ SAC,L,32,5,8,0.625,3,5,0.6,4,5,0.8,2,2,4,0,3,2,1,4,17,3,1,Luguentz Dort,OKC,SAC,OKC,5.0,3-PT Attempted,21,21,17,4
22023,1629652,22300324,"DEC 14, 2023",OKC @ SAC,L,32,5,8,0.625,3,5,0.6,4,5,0.8,2,2,4,0,3,2,1,4,17,3,1,Luguentz Dort,OKC,SAC,OKC,14.0,Pts+Rebs,21,21,17,4
22023,1629652,22300324,"DEC 14, 2023",OKC @ SAC,L,32,5,8,0.625,3,5,0.6,4,5,0.8,2,2,4,0,3,2,1,4,17,3,1,Luguentz Dort,OKC,SAC,OKC,11.5,Pts+Asts,21,21,17,4
22023,1629652,22301222,"DEC 08, 2023",OKC vs. GSW,W,39,4,9,0.444,0,3,0.0,8,8,1.0,4,1,5,1,0,1,1,4,16,6,1,Luguentz Dort,OKC,OKC,GSW,10.5,Points,22,21,17,6
22023,1629652,22301222,"DEC 08, 2023",OKC vs. GSW,W,39,4,9,0.444,0,3,0.0,8,8,1.0,4,1,5,1,0,1,1,4,16,6,1,Luguentz Dort,OKC,OKC,GSW,5.0,3-PT Attempted,22,21,17,6
22023,1629652,22301222,"DEC 08, 2023",OKC vs. GSW,W,39,4,9,0.444,0,3,0.0,8,8,1.0,4,1,5,1,0,1,1,4,16,6,1,Luguentz Dort,OKC,OKC,GSW,14.0,Pts+Rebs,22,21,17,6
22023,1629652,22301222,"DEC 08, 2023",OKC vs. GSW,W,39,4,9,0.444,0,3,0.0,8,8,1.0,4,1,5,1,0,1,1,4,16,6,1,Luguentz Dort,OKC,OKC,GSW,11.5,Pts+Asts,22,21,17,6
22023,1629652,22301212,"DEC 06, 2023",OKC @ HOU,L,15,0,5,0.0,0,3,0.0,4,4,1.0,2,1,3,0,0,0,1,1,4,-27,1,Luguentz Dort,OKC,HOU,OKC,10.5,Points,7,7,4,3
22023,1629652,22301212,"DEC 06, 2023",OKC @ HOU,L,15,0,5,0.0,0,3,0.0,4,4,1.0,2,1,3,0,0,0,1,1,4,-27,1,Luguentz Dort,OKC,HOU,OKC,5.0,3-PT Attempted,7,7,4,3
22023,1629652,22301212,"DEC 06, 2023",OKC @ HOU,L,15,0,5,0.0,0,3,0.0,4,4,1.0,2,1,3,0,0,0,1,1,4,-27,1,Luguentz Dort,OKC,HOU,OKC,14.0,Pts+Rebs,7,7,4,3
22023,1629652,22301212,"DEC 06, 2023",OKC @ HOU,L,15,0,5,0.0,0,3,0.0,4,4,1.0,2,1,3,0,0,0,1,1,4,-27,1,Luguentz Dort,OKC,HOU,OKC,11.5,Pts+Asts,7,7,4,3
22023,1629652,22300287,"DEC 02, 2023",OKC @ DAL,W,33,4,13,0.308,1,6,0.167,1,2,0.5,1,4,5,3,0,0,2,4,10,-10,1,Luguentz Dort,OKC,DAL,OKC,10.5,Points,18,15,13,8
22023,1629652,22300287,"DEC 02, 2023",OKC @ DAL,W,33,4,13,0.308,1,6,0.167,1,2,0.5,1,4,5,3,0,0,2,4,10,-10,1,Luguentz Dort,OKC,DAL,OKC,5.0,3-PT Attempted,18,15,13,8
22023,1629652,22300287,"DEC 02, 2023",OKC @ DAL,W,33,4,13,0.308,1,6,0.167,1,2,0.5,1,4,5,3,0,0,2,4,10,-10,1,Luguentz Dort,OKC,DAL,OKC,14.0,Pts+Rebs,18,15,13,8
22023,1629652,22300287,"DEC 02, 2023",OKC @ DAL,W,33,4,13,0.308,1,6,0.167,1,2,0.5,1,4,5,3,0,0,2,4,10,-10,1,Luguentz Dort,OKC,DAL,OKC,11.5,Pts+Asts,18,15,13,8
22023,1629652,22300271,"NOV 30, 2023",OKC vs. LAL,W,28,5,9,0.556,2,5,0.4,0,0,0.0,3,4,7,3,2,1,0,2,12,11,1,Luguentz Dort,OKC,OKC,LAL,10.5,Points,22,19,15,10
22023,1629652,22300271,"NOV 30, 2023",OKC vs. LAL,W,28,5,9,0.556,2,5,0.4,0,0,0.0,3,4,7,3,2,1,0,2,12,11,1,Luguentz Dort,OKC,OKC,LAL,5.0,3-PT Attempted,22,19,15,10
22023,1629652,22300271,"NOV 30, 2023",OKC vs. LAL,W,28,5,9,0.556,2,5,0.4,0,0,0.0,3,4,7,3,2,1,0,2,12,11,1,Luguentz Dort,OKC,OKC,LAL,14.0,Pts+Rebs,22,19,15,10
22023,1629652,22300271,"NOV 30, 2023",OKC vs. LAL,W,28,5,9,0.556,2,5,0.4,0,0,0.0,3,4,7,3,2,1,0,2,12,11,1,Luguentz Dort,OKC,OKC,LAL,11.5,Pts+Asts,22,19,15,10
22023,1629652,22300058,"NOV 28, 2023",OKC @ MIN,L,25,1,5,0.2,1,2,0.5,0,0,0.0,0,3,3,1,0,0,1,5,3,-6,1,Luguentz Dort,OKC,MIN,OKC,10.5,Points,7,6,4,4
22023,1629652,22300058,"NOV 28, 2023",OKC @ MIN,L,25,1,5,0.2,1,2,0.5,0,0,0.0,0,3,3,1,0,0,1,5,3,-6,1,Luguentz Dort,OKC,MIN,OKC,5.0,3-PT Attempted,7,6,4,4
22023,1629652,22300058,"NOV 28, 2023",OKC @ MIN,L,25,1,5,0.2,1,2,0.5,0,0,0.0,0,3,3,1,0,0,1,5,3,-6,1,Luguentz Dort,OKC,MIN,OKC,14.0,Pts+Rebs,7,6,4,4
22023,1629652,22300058,"NOV 28, 2023",OKC @ MIN,L,25,1,5,0.2,1,2,0.5,0,0,0.0,0,3,3,1,0,0,1,5,3,-6,1,Luguentz Dort,OKC,MIN,OKC,11.5,Pts+Asts,7,6,4,4
22023,1629652,22300239,"NOV 25, 2023",OKC vs. PHI,L,25,2,5,0.4,1,3,0.333,0,1,0.0,1,1,2,0,0,0,1,3,5,-13,1,Luguentz Dort,OKC,OKC,PHI,10.5,Points,7,7,5,2
22023,1629652,22300239,"NOV 25, 2023",OKC vs. PHI,L,25,2,5,0.4,1,3,0.333,0,1,0.0,1,1,2,0,0,0,1,3,5,-13,1,Luguentz Dort,OKC,OKC,PHI,5.0,3-PT Attempted,7,7,5,2
22023,1629652,22300239,"NOV 25, 2023",OKC vs. PHI,L,25,2,5,0.4,1,3,0.333,0,1,0.0,1,1,2,0,0,0,1,3,5,-13,1,Luguentz Dort,OKC,OKC,PHI,14.0,Pts+Rebs,7,7,5,2
22023,1629652,22300239,"NOV 25, 2023",OKC vs. PHI,L,25,2,5,0.4,1,3,0.333,0,1,0.0,1,1,2,0,0,0,1,3,5,-13,1,Luguentz Dort,OKC,OKC,PHI,11.5,Pts+Asts,7,7,5,2
22023,1629652,22300234,"NOV 22, 2023",OKC vs. CHI,W,27,1,6,0.167,0,4,0.0,0,0,0.0,0,2,2,2,0,2,2,6,2,9,1,Luguentz Dort,OKC,OKC,CHI,10.5,Points,6,4,4,4
22023,1629652,22300234,"NOV 22, 2023",OKC vs. CHI,W,27,1,6,0.167,0,4,0.0,0,0,0.0,0,2,2,2,0,2,2,6,2,9,1,Luguentz Dort,OKC,OKC,CHI,5.0,3-PT Attempted,6,4,4,4
22023,1629652,22300234,"NOV 22, 2023",OKC vs. CHI,W,27,1,6,0.167,0,4,0.0,0,0,0.0,0,2,2,2,0,2,2,6,2,9,1,Luguentz Dort,OKC,OKC,CHI,14.0,Pts+Rebs,6,4,4,4
22023,1629652,22300234,"NOV 22, 2023",OKC vs. CHI,W,27,1,6,0.167,0,4,0.0,0,0,0.0,0,2,2,2,0,2,2,6,2,9,1,Luguentz Dort,OKC,OKC,CHI,11.5,Pts+Asts,6,4,4,4
22023,1629652,22300215,"NOV 19, 2023",OKC @ POR,W,23,4,6,0.667,2,3,0.667,2,2,1.0,0,0,0,1,0,0,0,1,12,27,1,Luguentz Dort,OKC,POR,OKC,10.5,Points,13,12,13,1
22023,1629652,22300215,"NOV 19, 2023",OKC @ POR,W,23,4,6,0.667,2,3,0.667,2,2,1.0,0,0,0,1,0,0,0,1,12,27,1,Luguentz Dort,OKC,POR,OKC,5.0,3-PT Attempted,13,12,13,1
22023,1629652,22300215,"NOV 19, 2023",OKC @ POR,W,23,4,6,0.667,2,3,0.667,2,2,1.0,0,0,0,1,0,0,0,1,12,27,1,Luguentz Dort,OKC,POR,OKC,14.0,Pts+Rebs,13,12,13,1
22023,1629652,22300215,"NOV 19, 2023",OKC @ POR,W,23,4,6,0.667,2,3,0.667,2,2,1.0,0,0,0,1,0,0,0,1,12,27,1,Luguentz Dort,OKC,POR,OKC,11.5,Pts+Asts,13,12,13,1
22023,1629652,22300207,"NOV 18, 2023",OKC @ GSW,W,27,1,6,0.167,1,4,0.25,0,0,0.0,1,5,6,2,0,0,0,2,3,-11,1,Luguentz Dort,OKC,GSW,OKC,10.5,Points,11,9,5,8
22023,1629652,22300207,"NOV 18, 2023",OKC @ GSW,W,27,1,6,0.167,1,4,0.25,0,0,0.0,1,5,6,2,0,0,0,2,3,-11,1,Luguentz Dort,OKC,GSW,OKC,5.0,3-PT Attempted,11,9,5,8
22023,1629652,22300207,"NOV 18, 2023",OKC @ GSW,W,27,1,6,0.167,1,4,0.25,0,0,0.0,1,5,6,2,0,0,0,2,3,-11,1,Luguentz Dort,OKC,GSW,OKC,14.0,Pts+Rebs,11,9,5,8
22023,1629652,22300207,"NOV 18, 2023",OKC @ GSW,W,27,1,6,0.167,1,4,0.25,0,0,0.0,1,5,6,2,0,0,0,2,3,-11,1,Luguentz Dort,OKC,GSW,OKC,11.5,Pts+Asts,11,9,5,8
22023,1629652,22300201,"NOV 16, 2023",OKC @ GSW,W,24,2,5,0.4,1,3,0.333,0,0,0.0,0,2,2,0,1,0,1,2,5,-1,1,Luguentz Dort,OKC,GSW,OKC,10.5,Points,7,7,5,2
22023,1629652,22300201,"NOV 16, 2023",OKC @ GSW,W,24,2,5,0.4,1,3,0.333,0,0,0.0,0,2,2,0,1,0,1,2,5,-1,1,Luguentz Dort,OKC,GSW,OKC,5.0,3-PT Attempted,7,7,5,2
22023,1629652,22300201,"NOV 16, 2023",OKC @ GSW,W,24,2,5,0.4,1,3,0.333,0,0,0.0,0,2,2,0,1,0,1,2,5,-1,1,Luguentz Dort,OKC,GSW,OKC,14.0,Pts+Rebs,7,7,5,2
22023,1629652,22300201,"NOV 16, 2023",OKC @ GSW,W,24,2,5,0.4,1,3,0.333,0,0,0.0,0,2,2,0,1,0,1,2,5,-1,1,Luguentz Dort,OKC,GSW,OKC,11.5,Pts+Asts,7,7,5,2
22023,1629652,22300021,"NOV 14, 2023",OKC vs. SAS,W,24,2,6,0.333,1,3,0.333,1,2,0.5,1,2,3,0,1,1,0,2,6,22,1,Luguentz Dort,OKC,OKC,SAS,10.5,Points,9,9,6,3
22023,1629652,22300021,"NOV 14, 2023",OKC vs. SAS,W,24,2,6,0.333,1,3,0.333,1,2,0.5,1,2,3,0,1,1,0,2,6,22,1,Luguentz Dort,OKC,OKC,SAS,5.0,3-PT Attempted,9,9,6,3
22023,1629652,22300021,"NOV 14, 2023",OKC vs. SAS,W,24,2,6,0.333,1,3,0.333,1,2,0.5,1,2,3,0,1,1,0,2,6,22,1,Luguentz Dort,OKC,OKC,SAS,14.0,Pts+Rebs,9,9,6,3
22023,1629652,22300021,"NOV 14, 2023",OKC vs. SAS,W,24,2,6,0.333,1,3,0.333,1,2,0.5,1,2,3,0,1,1,0,2,6,22,1,Luguentz Dort,OKC,OKC,SAS,11.5,Pts+Asts,9,9,6,3
22023,1629652,22300185,"NOV 12, 2023",OKC @ PHX,W,33,3,10,0.3,0,5,0.0,3,4,0.75,2,4,6,1,2,1,0,5,9,8,1,Luguentz Dort,OKC,PHX,OKC,10.5,Points,16,15,10,7
22023,1629652,22300185,"NOV 12, 2023",OKC @ PHX,W,33,3,10,0.3,0,5,0.0,3,4,0.75,2,4,6,1,2,1,0,5,9,8,1,Luguentz Dort,OKC,PHX,OKC,5.0,3-PT Attempted,16,15,10,7
22023,1629652,22300185,"NOV 12, 2023",OKC @ PHX,W,33,3,10,0.3,0,5,0.0,3,4,0.75,2,4,6,1,2,1,0,5,9,8,1,Luguentz Dort,OKC,PHX,OKC,14.0,Pts+Rebs,16,15,10,7
22023,1629652,22300185,"NOV 12, 2023",OKC @ PHX,W,33,3,10,0.3,0,5,0.0,3,4,0.75,2,4,6,1,2,1,0,5,9,8,1,Luguentz Dort,OKC,PHX,OKC,11.5,Pts+Asts,16,15,10,7
22023,1629652,22300016,"NOV 10, 2023",OKC @ SAC,L,25,2,5,0.4,2,3,0.667,2,2,1.0,2,4,6,2,3,1,2,4,8,-11,1,Luguentz Dort,OKC,SAC,OKC,10.5,Points,16,14,10,8
22023,1629652,22300016,"NOV 10, 2023",OKC @ SAC,L,25,2,5,0.4,2,3,0.667,2,2,1.0,2,4,6,2,3,1,2,4,8,-11,1,Luguentz Dort,OKC,SAC,OKC,5.0,3-PT Attempted,16,14,10,8
22023,1629652,22300016,"NOV 10, 2023",OKC @ SAC,L,25,2,5,0.4,2,3,0.667,2,2,1.0,2,4,6,2,3,1,2,4,8,-11,1,Luguentz Dort,OKC,SAC,OKC,14.0,Pts+Rebs,16,14,10,8
22023,1629652,22300016,"NOV 10, 2023",OKC @ SAC,L,25,2,5,0.4,2,3,0.667,2,2,1.0,2,4,6,2,3,1,2,4,8,-11,1,Luguentz Dort,OKC,SAC,OKC,11.5,Pts+Asts,16,14,10,8
22023,1629652,22300167,"NOV 08, 2023",OKC vs. CLE,W,36,3,9,0.333,3,5,0.6,5,6,0.833,1,3,4,3,2,3,3,3,14,-5,1,Luguentz Dort,OKC,OKC,CLE,10.5,Points,21,18,17,7
22023,1629652,22300167,"NOV 08, 2023",OKC vs. CLE,W,36,3,9,0.333,3,5,0.6,5,6,0.833,1,3,4,3,2,3,3,3,14,-5,1,Luguentz Dort,OKC,OKC,CLE,5.0,3-PT Attempted,21,18,17,7
22023,1629652,22300167,"NOV 08, 2023",OKC vs. CLE,W,36,3,9,0.333,3,5,0.6,5,6,0.833,1,3,4,3,2,3,3,3,14,-5,1,Luguentz Dort,OKC,OKC,CLE,14.0,Pts+Rebs,21,18,17,7
22023,1629652,22300167,"NOV 08, 2023",OKC vs. CLE,W,36,3,9,0.333,3,5,0.6,5,6,0.833,1,3,4,3,2,3,3,3,14,-5,1,Luguentz Dort,OKC,OKC,CLE,11.5,Pts+Asts,21,18,17,7
22023,1629652,22300155,"NOV 06, 2023",OKC vs. ATL,W,32,6,10,0.6,2,5,0.4,5,5,1.0,2,7,9,3,0,2,2,1,19,7,1,Luguentz Dort,OKC,OKC,ATL,10.5,Points,31,28,22,12
22023,1629652,22300155,"NOV 06, 2023",OKC vs. ATL,W,32,6,10,0.6,2,5,0.4,5,5,1.0,2,7,9,3,0,2,2,1,19,7,1,Luguentz Dort,OKC,OKC,ATL,5.0,3-PT Attempted,31,28,22,12
22023,1629652,22300155,"NOV 06, 2023",OKC vs. ATL,W,32,6,10,0.6,2,5,0.4,5,5,1.0,2,7,9,3,0,2,2,1,19,7,1,Luguentz Dort,OKC,OKC,ATL,14.0,Pts+Rebs,31,28,22,12
22023,1629652,22300155,"NOV 06, 2023",OKC vs. ATL,W,32,6,10,0.6,2,5,0.4,5,5,1.0,2,7,9,3,0,2,2,1,19,7,1,Luguentz Dort,OKC,OKC,ATL,11.5,Pts+Asts,31,28,22,12
22023,1629652,22300005,"NOV 03, 2023",OKC vs. GSW,L,30,9,12,0.75,6,6,1.0,5,7,0.714,2,3,5,0,0,0,1,4,29,-5,1,Luguentz Dort,OKC,OKC,GSW,10.5,Points,34,34,29,5
22023,1629652,22300005,"NOV 03, 2023",OKC vs. GSW,L,30,9,12,0.75,6,6,1.0,5,7,0.714,2,3,5,0,0,0,1,4,29,-5,1,Luguentz Dort,OKC,OKC,GSW,5.0,3-PT Attempted,34,34,29,5
22023,1629652,22300005,"NOV 03, 2023",OKC vs. GSW,L,30,9,12,0.75,6,6,1.0,5,7,0.714,2,3,5,0,0,0,1,4,29,-5,1,Luguentz Dort,OKC,OKC,GSW,14.0,Pts+Rebs,34,34,29,5
22023,1629652,22300005,"NOV 03, 2023",OKC vs. GSW,L,30,9,12,0.75,6,6,1.0,5,7,0.714,2,3,5,0,0,0,1,4,29,-5,1,Luguentz Dort,OKC,OKC,GSW,11.5,Pts+Asts,34,34,29,5
22023,1629652,22300121,"NOV 01, 2023",OKC vs. NOP,L,30,3,7,0.429,3,6,0.5,0,0,0.0,1,1,2,0,1,0,1,4,9,-3,1,Luguentz Dort,OKC,OKC,NOP,10.5,Points,11,11,9,2
22023,1629652,22300121,"NOV 01, 2023",OKC vs. NOP,L,30,3,7,0.429,3,6,0.5,0,0,0.0,1,1,2,0,1,0,1,4,9,-3,1,Luguentz Dort,OKC,OKC,NOP,5.0,3-PT Attempted,11,11,9,2
22023,1629652,22300121,"NOV 01, 2023",OKC vs. NOP,L,30,3,7,0.429,3,6,0.5,0,0,0.0,1,1,2,0,1,0,1,4,9,-3,1,Luguentz Dort,OKC,OKC,NOP,14.0,Pts+Rebs,11,11,9,2
22023,1629652,22300121,"NOV 01, 2023",OKC vs. NOP,L,30,3,7,0.429,3,6,0.5,0,0,0.0,1,1,2,0,1,0,1,4,9,-3,1,Luguentz Dort,OKC,OKC,NOP,11.5,Pts+Asts,11,11,9,2
22023,1629652,22300109,"OCT 30, 2023",OKC vs. DET,W,26,3,7,0.429,1,4,0.25,0,0,0.0,0,2,2,0,2,1,0,1,7,12,1,Luguentz Dort,OKC,OKC,DET,10.5,Points,9,9,7,2
22023,1629652,22300109,"OCT 30, 2023",OKC vs. DET,W,26,3,7,0.429,1,4,0.25,0,0,0.0,0,2,2,0,2,1,0,1,7,12,1,Luguentz Dort,OKC,OKC,DET,5.0,3-PT Attempted,9,9,7,2
22023,1629652,22300109,"OCT 30, 2023",OKC vs. DET,W,26,3,7,0.429,1,4,0.25,0,0,0.0,0,2,2,0,2,1,0,1,7,12,1,Luguentz Dort,OKC,OKC,DET,14.0,Pts+Rebs,9,9,7,2
22023,1629652,22300109,"OCT 30, 2023",OKC vs. DET,W,26,3,7,0.429,1,4,0.25,0,0,0.0,0,2,2,0,2,1,0,1,7,12,1,Luguentz Dort,OKC,OKC,DET,11.5,Pts+Asts,9,9,7,2
22023,1629652,22300095,"OCT 29, 2023",OKC vs. DEN,L,21,3,7,0.429,1,5,0.2,3,3,1.0,1,0,1,0,1,1,0,2,10,-18,1,Luguentz Dort,OKC,OKC,DEN,10.5,Points,11,11,10,1
22023,1629652,22300095,"OCT 29, 2023",OKC vs. DEN,L,21,3,7,0.429,1,5,0.2,3,3,1.0,1,0,1,0,1,1,0,2,10,-18,1,Luguentz Dort,OKC,OKC,DEN,5.0,3-PT Attempted,11,11,10,1
22023,1629652,22300095,"OCT 29, 2023",OKC vs. DEN,L,21,3,7,0.429,1,5,0.2,3,3,1.0,1,0,1,0,1,1,0,2,10,-18,1,Luguentz Dort,OKC,OKC,DEN,14.0,Pts+Rebs,11,11,10,1
22023,1629652,22300095,"OCT 29, 2023",OKC vs. DEN,L,21,3,7,0.429,1,5,0.2,3,3,1.0,1,0,1,0,1,1,0,2,10,-18,1,Luguentz Dort,OKC,OKC,DEN,11.5,Pts+Asts,11,11,10,1
22023,1629652,22300081,"OCT 27, 2023",OKC @ CLE,W,39,9,13,0.692,3,4,0.75,4,6,0.667,3,3,6,2,1,1,1,5,25,-6,1,Luguentz Dort,OKC,CLE,OKC,10.5,Points,33,31,27,8
22023,1629652,22300081,"OCT 27, 2023",OKC @ CLE,W,39,9,13,0.692,3,4,0.75,4,6,0.667,3,3,6,2,1,1,1,5,25,-6,1,Luguentz Dort,OKC,CLE,OKC,5.0,3-PT Attempted,33,31,27,8
22023,1629652,22300081,"OCT 27, 2023",OKC @ CLE,W,39,9,13,0.692,3,4,0.75,4,6,0.667,3,3,6,2,1,1,1,5,25,-6,1,Luguentz Dort,OKC,CLE,OKC,14.0,Pts+Rebs,33,31,27,8
22023,1629652,22300081,"OCT 27, 2023",OKC @ CLE,W,39,9,13,0.692,3,4,0.75,4,6,0.667,3,3,6,2,1,1,1,5,25,-6,1,Luguentz Dort,OKC,CLE,OKC,11.5,Pts+Asts,33,31,27,8
22023,1629652,22300070,"OCT 25, 2023",OKC @ CHI,W,33,3,8,0.375,2,5,0.4,0,0,0.0,0,7,7,2,2,1,2,1,8,13,1,Luguentz Dort,OKC,CHI,OKC,10.5,Points,17,15,10,9
22023,1629652,22300070,"OCT 25, 2023",OKC @ CHI,W,33,3,8,0.375,2,5,0.4,0,0,0.0,0,7,7,2,2,1,2,1,8,13,1,Luguentz Dort,OKC,CHI,OKC,5.0,3-PT Attempted,17,15,10,9
22023,1629652,22300070,"OCT 25, 2023",OKC @ CHI,W,33,3,8,0.375,2,5,0.4,0,0,0.0,0,7,7,2,2,1,2,1,8,13,1,Luguentz Dort,OKC,CHI,OKC,14.0,Pts+Rebs,17,15,10,9
22023,1629652,22300070,"OCT 25, 2023",OKC @ CHI,W,33,3,8,0.375,2,5,0.4,0,0,0.0,0,7,7,2,2,1,2,1,8,13,1,Luguentz Dort,OKC,CHI,OKC,11.5,Pts+Asts,17,15,10,9
22023,1630245,22300561,"JAN 15, 2024",CHI @ CLE,L,19,3,7,0.429,1,2,0.5,3,3,1.0,1,2,3,3,0,0,0,3,10,6,1,Ayo Dosunmu,CHI,CLE,CHI,,,16,13,13,6
22023,1630245,22300548,"JAN 13, 2024",CHI @ SAS,W,29,8,9,0.889,3,3,1.0,2,2,1.0,0,2,2,4,1,0,2,4,21,7,1,Ayo Dosunmu,CHI,SAS,CHI,,,27,23,25,6
22023,1630245,22300536,"JAN 12, 2024",CHI vs. GSW,L,17,2,4,0.5,2,3,0.667,0,0,0.0,0,0,0,0,0,0,3,4,6,-23,1,Ayo Dosunmu,CHI,CHI,GSW,,,6,6,6,0
22023,1630245,22300523,"JAN 10, 2024",CHI vs. HOU,W,18,3,8,0.375,2,4,0.5,0,0,0.0,2,2,4,3,0,0,0,0,8,-5,1,Ayo Dosunmu,CHI,CHI,HOU,,,15,12,11,7
22023,1630245,22300506,"JAN 08, 2024",CHI @ CHA,W,18,2,3,0.667,0,0,0.0,2,2,1.0,1,0,1,2,0,1,1,3,6,-3,1,Ayo Dosunmu,CHI,CHA,CHI,,,9,7,8,3
22023,1630245,22300484,"JAN 05, 2024",CHI vs. CHA,W,40,5,9,0.556,2,3,0.667,0,0,0.0,0,5,5,4,1,2,0,2,12,14,1,Ayo Dosunmu,CHI,CHI,CHA,,,21,17,16,9
22023,1630245,22300468,"JAN 03, 2024",CHI @ NYK,L,31,2,12,0.167,1,6,0.167,2,2,1.0,0,4,4,4,0,2,0,1,7,-11,1,Ayo Dosunmu,CHI,NYK,CHI,,,15,11,11,8
22023,1630245,22300459,"JAN 02, 2024",CHI @ PHI,L,32,7,14,0.5,1,4,0.25,0,0,0.0,0,3,3,0,1,0,3,2,15,-19,1,Ayo Dosunmu,CHI,PHI,CHI,,,18,18,15,3
22023,1630245,22300442,"DEC 30, 2023",CHI vs. PHI,W,29,3,11,0.273,0,4,0.0,0,0,0.0,2,1,3,2,0,1,0,2,6,0,1,Ayo Dosunmu,CHI,CHI,PHI,,,11,9,8,5
22023,1630245,22300422,"DEC 28, 2023",CHI vs. IND,L,33,7,15,0.467,0,2,0.0,1,2,0.5,1,4,5,3,0,0,0,3,15,-9,1,Ayo Dosunmu,CHI,CHI,IND,,,23,20,18,8
22023,1630245,22300408,"DEC 26, 2023",CHI vs. ATL,W,35,6,14,0.429,2,4,0.5,5,6,0.833,4,3,7,4,3,0,0,1,19,11,1,Ayo Dosunmu,CHI,CHI,ATL,,,30,26,23,11
22023,1630245,22300396,"DEC 23, 2023",CHI vs. CLE,L,20,2,6,0.333,0,3,0.0,0,0,0.0,1,2,3,1,0,0,1,3,4,-8,1,Ayo Dosunmu,CHI,CHI,CLE,,,8,7,5,4
22023,1630245,22300376,"DEC 21, 2023",CHI vs. SAS,W,26,5,8,0.625,1,4,0.25,0,0,0.0,0,2,2,0,1,0,0,2,11,13,1,Ayo Dosunmu,CHI,CHI,SAS,,,13,13,11,2
22023,1630245,22300370,"DEC 20, 2023",CHI vs. LAL,W,22,5,8,0.625,4,6,0.667,0,0,0.0,1,1,2,1,2,2,1,1,14,0,1,Ayo Dosunmu,CHI,CHI,LAL,,,17,16,15,3
22023,1630245,22300351,"DEC 18, 2023",CHI @ PHI,W,19,1,3,0.333,0,1,0.0,2,2,1.0,3,1,4,1,1,1,2,1,4,-23,1,Ayo Dosunmu,CHI,PHI,CHI,,,9,8,5,5
22023,1630245,22300337,"DEC 16, 2023",CHI @ MIA,L,41,3,11,0.273,2,7,0.286,0,0,0.0,1,3,4,3,2,1,2,4,8,6,1,Ayo Dosunmu,CHI,MIA,CHI,,,15,12,11,7
22023,1630245,22300320,"DEC 14, 2023",CHI @ MIA,W,35,10,12,0.833,3,4,0.75,1,4,0.25,2,6,8,5,1,0,0,3,24,-1,1,Ayo Dosunmu,CHI,MIA,CHI,,,37,32,29,13
22023,1630245,22300307,"DEC 12, 2023",CHI vs. DEN,L,38,3,7,0.429,1,4,0.25,2,2,1.0,0,3,3,3,0,1,2,4,9,-6,1,Ayo Dosunmu,CHI,CHI,DEN,,,15,12,12,6
22023,1630245,22300300,"DEC 11, 2023",CHI @ MIL,L,26,0,6,0.0,0,2,0.0,0,0,0.0,0,0,0,0,0,0,0,1,0,2,1,Ayo Dosunmu,CHI,MIL,CHI,,,0,0,0,0
22023,1630245,22301223,"DEC 08, 2023",CHI @ SAS,W,26,2,5,0.4,0,2,0.0,0,0,0.0,0,3,3,3,1,0,0,1,4,-2,1,Ayo Dosunmu,CHI,SAS,CHI,,,10,7,7,6
22023,1630245,22301211,"DEC 06, 2023",CHI vs. CHA,W,22,3,9,0.333,2,4,0.5,0,0,0.0,0,2,2,2,1,0,4,2,8,11,1,Ayo Dosunmu,CHI,CHI,CHA,,,12,10,10,4
22023,1630245,22300285,"DEC 02, 2023",CHI vs. NOP,W,33,6,9,0.667,1,4,0.25,2,2,1.0,0,0,0,3,2,0,2,2,15,8,1,Ayo Dosunmu,CHI,CHI,NOP,,,18,15,18,3
22023,1630245,22300269,"NOV 30, 2023",CHI vs. MIL,W,39,6,8,0.75,1,3,0.333,1,2,0.5,1,5,6,6,3,0,2,2,14,-8,1,Ayo Dosunmu,CHI,CHI,MIL,,,26,20,20,12
22023,1630245,22300053,"NOV 28, 2023",CHI @ BOS,L,24,4,10,0.4,1,3,0.333,1,2,0.5,0,0,0,2,1,0,0,3,10,-16,1,Ayo Dosunmu,CHI,BOS,CHI,,,12,10,12,2
22023,1630245,22300250,"NOV 26, 2023",CHI @ BKN,L,14,2,3,0.667,0,1,0.0,1,2,0.5,1,1,2,2,0,0,1,2,5,-21,1,Ayo Dosunmu,CHI,BKN,CHI,,,9,7,7,4
22023,1630245,22300046,"NOV 24, 2023",CHI @ TOR,L,13,1,4,0.25,0,2,0.0,0,0,0.0,0,1,1,1,1,0,0,1,2,-5,1,Ayo Dosunmu,CHI,TOR,CHI,,,4,3,3,2
22023,1630245,22300234,"NOV 22, 2023",CHI @ OKC,L,21,4,7,0.571,3,5,0.6,0,0,0.0,0,2,2,2,1,1,2,4,11,-9,1,Ayo Dosunmu,CHI,OKC,CHI,,,15,13,13,4
22023,1630245,22300220,"NOV 20, 2023",CHI vs. MIA,L,12,1,3,0.333,0,1,0.0,4,4,1.0,1,1,2,1,0,0,0,2,6,2,1,Ayo Dosunmu,CHI,CHI,MIA,,,9,8,7,3
22023,1630245,22300204,"NOV 18, 2023",CHI vs. MIA,W,13,0,2,0.0,0,2,0.0,2,2,1.0,0,1,1,2,0,0,1,2,2,16,1,Ayo Dosunmu,CHI,CHI,MIA,,,5,3,4,3
22023,1630245,22300033,"NOV 17, 2023",CHI vs. ORL,L,14,0,3,0.0,0,1,0.0,0,0,0.0,0,2,2,1,0,0,0,1,0,-12,1,Ayo Dosunmu,CHI,CHI,ORL,,,3,2,1,3
22023,1630245,22300196,"NOV 15, 2023",CHI vs. ORL,L,18,2,4,0.5,1,3,0.333,0,0,0.0,1,1,2,2,0,0,1,1,5,-6,1,Ayo Dosunmu,CHI,CHI,ORL,,,9,7,7,4
22023,1630245,22300190,"NOV 13, 2023",CHI @ MIL,L,26,2,4,0.5,1,2,0.5,0,0,0.0,1,1,2,1,0,0,1,4,5,-13,1,Ayo Dosunmu,CHI,MIL,CHI,,,8,7,6,3
22023,1630245,22300181,"NOV 12, 2023",CHI vs. DET,W,27,6,7,0.857,0,1,0.0,1,2,0.5,0,1,1,3,3,0,0,3,13,19,1,Ayo Dosunmu,CHI,CHI,DET,,,17,14,16,4
22023,1630245,22300162,"NOV 08, 2023",CHI vs. PHX,L,10,1,2,0.5,0,0,0.0,0,0,0.0,2,1,3,1,0,0,1,0,2,-4,1,Ayo Dosunmu,CHI,CHI,PHX,,,6,5,3,4
22023,1630245,22300152,"NOV 06, 2023",CHI vs. UTA,W,16,2,5,0.4,2,3,0.667,2,2,1.0,0,1,1,0,0,0,1,0,8,6,1,Ayo Dosunmu,CHI,CHI,UTA,,,9,9,8,1
22023,1630245,22300124,"NOV 01, 2023",CHI @ DAL,L,11,3,4,0.75,2,3,0.667,0,0,0.0,0,1,1,1,0,0,0,1,8,8,1,Ayo Dosunmu,CHI,DAL,CHI,,,10,9,9,2
22023,1630245,22300102,"OCT 30, 2023",CHI @ IND,W,10,0,1,0.0,0,1,0.0,0,0,0.0,0,1,1,0,1,1,0,2,0,-2,1,Ayo Dosunmu,CHI,IND,CHI,,,1,1,0,1
22023,1630245,22300088,"OCT 28, 2023",CHI @ DET,L,15,2,7,0.286,1,2,0.5,0,0,0.0,2,1,3,3,0,0,0,0,5,-6,1,Ayo Dosunmu,CHI,DET,CHI,,,11,8,8,6
22023,1630245,22300082,"OCT 27, 2023",CHI vs. TOR,W,11,2,4,0.5,0,1,0.0,0,0,0.0,0,1,1,0,0,0,0,0,4,10,1,Ayo Dosunmu,CHI,CHI,TOR,,,5,5,4,1
22023,1630245,22300070,"OCT 25, 2023",CHI vs. OKC,L,9,3,5,0.6,2,4,0.5,0,0,0.0,0,0,0,1,1,0,1,0,8,3,1,Ayo Dosunmu,CHI,CHI,OKC,,,9,8,9,1
22023,203083,22300561,"JAN 15, 2024",CHI @ CLE,L,22,3,3,1.0,0,0,0.0,2,4,0.5,3,7,10,1,2,2,2,2,8,4,1,Andre Drummond,CHI,CLE,CHI,,,19,18,9,11
22023,203083,22300548,"JAN 13, 2024",CHI @ SAS,W,17,3,7,0.429,0,0,0.0,1,3,0.333,4,6,10,1,1,1,0,2,7,-7,1,Andre Drummond,CHI,SAS,CHI,,,18,17,8,11
22023,203083,22300536,"JAN 12, 2024",CHI vs. GSW,L,12,2,2,1.0,0,0,0.0,1,2,0.5,0,4,4,1,0,1,0,0,5,-6,1,Andre Drummond,CHI,CHI,GSW,,,10,9,6,5
22023,203083,22300523,"JAN 10, 2024",CHI vs. HOU,W,13,2,2,1.0,0,0,0.0,0,0,0.0,0,0,0,1,2,0,3,1,4,-11,1,Andre Drummond,CHI,CHI,HOU,,,5,4,5,1
22023,203083,22300506,"JAN 08, 2024",CHI @ CHA,W,23,9,12,0.75,0,0,0.0,3,3,1.0,5,10,15,0,0,0,2,1,21,16,1,Andre Drummond,CHI,CHA,CHI,,,36,36,21,15
22023,203083,22300484,"JAN 05, 2024",CHI vs. CHA,W,23,3,7,0.429,0,0,0.0,1,2,0.5,3,7,10,0,1,3,2,1,7,8,1,Andre Drummond,CHI,CHI,CHA,,,17,17,7,10
22023,203083,22300468,"JAN 03, 2024",CHI @ NYK,L,30,5,12,0.417,0,0,0.0,3,6,0.5,8,8,16,0,2,1,1,3,13,-15,1,Andre Drummond,CHI,NYK,CHI,,,29,29,13,16
22023,203083,22300459,"JAN 02, 2024",CHI @ PHI,L,28,5,13,0.385,0,1,0.0,1,4,0.25,10,7,17,0,1,1,2,2,11,-31,1,Andre Drummond,CHI,PHI,CHI,,,28,28,11,17
22023,203083,22300442,"DEC 30, 2023",CHI vs. PHI,W,30,6,8,0.75,0,0,0.0,3,10,0.3,3,20,23,2,2,3,3,4,15,16,1,Andre Drummond,CHI,CHI,PHI,,,40,38,17,25
22023,203083,22300422,"DEC 28, 2023",CHI vs. IND,L,21,3,9,0.333,0,0,0.0,1,4,0.25,7,9,16,0,1,0,1,4,7,-8,1,Andre Drummond,CHI,CHI,IND,,,23,23,7,16
22023,203083,22300408,"DEC 26, 2023",CHI vs. ATL,W,38,11,13,0.846,0,0,0.0,2,2,1.0,10,15,25,1,3,2,2,4,24,4,1,Andre Drummond,CHI,CHI,ATL,,,50,49,25,26
22023,203083,22300396,"DEC 23, 2023",CHI vs. CLE,L,13,0,0,0.0,0,0,0.0,1,2,0.5,2,4,6,0,1,0,1,4,1,-10,1,Andre Drummond,CHI,CHI,CLE,,,7,7,1,6
22023,203083,22300376,"DEC 21, 2023",CHI vs. SAS,W,19,5,10,0.5,0,0,0.0,2,3,0.667,4,4,8,1,5,2,1,0,12,17,1,Andre Drummond,CHI,CHI,SAS,,,21,20,13,9
22023,203083,22300370,"DEC 20, 2023",CHI vs. LAL,W,16,4,5,0.8,0,0,0.0,3,4,0.75,0,7,7,1,1,0,2,2,11,12,1,Andre Drummond,CHI,CHI,LAL,,,19,18,12,8
22023,203083,22300351,"DEC 18, 2023",CHI @ PHI,W,14,2,3,0.667,0,0,0.0,1,2,0.5,3,5,8,0,1,1,0,0,5,8,1,Andre Drummond,CHI,PHI,CHI,,,13,13,5,8
22023,203083,22300337,"DEC 16, 2023",CHI @ MIA,L,11,1,2,0.5,0,0,0.0,2,2,1.0,0,4,4,0,1,0,1,1,4,-3,1,Andre Drummond,CHI,MIA,CHI,,,8,8,4,4
22023,203083,22300320,"DEC 14, 2023",CHI @ MIA,W,12,3,4,0.75,0,0,0.0,1,2,0.5,1,4,5,0,0,0,0,3,7,-4,1,Andre Drummond,CHI,MIA,CHI,,,12,12,7,5
22023,203083,22300307,"DEC 12, 2023",CHI vs. DEN,L,14,3,4,0.75,0,0,0.0,2,3,0.667,1,3,4,0,2,2,1,1,8,-5,1,Andre Drummond,CHI,CHI,DEN,,,12,12,8,4
22023,203083,22300300,"DEC 11, 2023",CHI @ MIL,L,14,3,12,0.25,0,0,0.0,3,3,1.0,11,5,16,1,1,0,0,1,9,-2,1,Andre Drummond,CHI,MIL,CHI,,,26,25,10,17
22023,203083,22301223,"DEC 08, 2023",CHI @ SAS,W,12,3,7,0.429,0,0,0.0,1,4,0.25,6,2,8,0,0,0,0,2,7,-6,1,Andre Drummond,CHI,SAS,CHI,,,15,15,7,8
22023,203083,22301211,"DEC 06, 2023",CHI vs. CHA,W,14,3,8,0.375,0,0,0.0,1,2,0.5,5,4,9,1,1,0,3,3,7,10,1,Andre Drummond,CHI,CHI,CHA,,,17,16,8,10
22023,203083,22300285,"DEC 02, 2023",CHI vs. NOP,W,15,3,7,0.429,0,0,0.0,1,2,0.5,3,5,8,1,0,1,1,2,7,0,1,Andre Drummond,CHI,CHI,NOP,,,16,15,8,9
22023,203083,22300269,"NOV 30, 2023",CHI vs. MIL,W,13,2,2,1.0,0,0,0.0,6,8,0.75,5,9,14,1,1,0,2,1,10,13,1,Andre Drummond,CHI,CHI,MIL,,,25,24,11,15
22023,203083,22300053,"NOV 28, 2023",CHI @ BOS,L,13,2,5,0.4,0,0,0.0,1,6,0.167,2,4,6,0,0,1,0,1,5,-11,1,Andre Drummond,CHI,BOS,CHI,,,11,11,5,6
22023,203083,22300250,"NOV 26, 2023",CHI @ BKN,L,11,1,2,0.5,0,0,0.0,2,3,0.667,2,3,5,0,1,0,2,3,4,-11,1,Andre Drummond,CHI,BKN,CHI,,,9,9,4,5
22023,203083,22300046,"NOV 24, 2023",CHI @ TOR,L,6,1,4,0.25,0,0,0.0,0,0,0.0,3,2,5,0,0,0,0,2,2,-10,1,Andre Drummond,CHI,TOR,CHI,,,7,7,2,5
22023,203083,22300234,"NOV 22, 2023",CHI @ OKC,L,11,1,3,0.333,0,0,0.0,0,0,0.0,1,4,5,1,0,0,0,2,2,-11,1,Andre Drummond,CHI,OKC,CHI,,,8,7,3,6
22023,203083,22300220,"NOV 20, 2023",CHI vs. MIA,L,14,1,3,0.333,0,0,0.0,0,0,0.0,1,4,5,1,0,1,1,1,2,-2,1,Andre Drummond,CHI,CHI,MIA,,,8,7,3,6
22023,203083,22300204,"NOV 18, 2023",CHI vs. MIA,W,15,2,3,0.667,0,0,0.0,2,2,1.0,3,6,9,0,1,1,1,3,6,10,1,Andre Drummond,CHI,CHI,MIA,,,15,15,6,9
22023,203083,22300033,"NOV 17, 2023",CHI vs. ORL,L,18,1,2,0.5,0,1,0.0,3,4,0.75,2,4,6,0,2,1,2,1,5,-2,1,Andre Drummond,CHI,CHI,ORL,,,11,11,5,6
22023,203083,22300196,"NOV 15, 2023",CHI vs. ORL,L,12,3,5,0.6,0,0,0.0,3,4,0.75,5,9,14,1,1,0,2,3,9,-6,1,Andre Drummond,CHI,CHI,ORL,,,24,23,10,15
22023,203083,22300190,"NOV 13, 2023",CHI @ MIL,L,12,2,5,0.4,0,0,0.0,0,0,0.0,1,2,3,0,2,0,1,2,4,-8,1,Andre Drummond,CHI,MIL,CHI,,,7,7,4,3
22023,203083,22300181,"NOV 12, 2023",CHI vs. DET,W,15,5,8,0.625,0,0,0.0,1,2,0.5,5,8,13,1,2,0,1,2,11,5,1,Andre Drummond,CHI,CHI,DET,,,25,24,12,14
22023,203083,22300162,"NOV 08, 2023",CHI vs. PHX,L,12,1,1,1.0,0,0,0.0,0,0,0.0,1,2,3,1,1,0,2,2,2,15,1,Andre Drummond,CHI,CHI,PHX,,,6,5,3,4
22023,203083,22300152,"NOV 06, 2023",CHI vs. UTA,W,14,5,10,0.5,0,0,0.0,2,3,0.667,5,2,7,1,1,1,2,2,12,4,1,Andre Drummond,CHI,CHI,UTA,,,20,19,13,8
22023,203083,22300139,"NOV 04, 2023",CHI @ DEN,L,15,2,3,0.667,0,0,0.0,1,2,0.5,4,7,11,0,1,0,0,1,5,7,1,Andre Drummond,CHI,DEN,CHI,,,16,16,5,11
22023,203083,22300004,"NOV 03, 2023",CHI vs. BKN,L,12,3,3,1.0,0,0,0.0,1,4,0.25,0,4,4,0,1,0,1,1,7,-9,1,Andre Drummond,CHI,CHI,BKN,,,11,11,7,4
22023,203083,22300124,"NOV 01, 2023",CHI @ DAL,L,12,4,5,0.8,0,0,0.0,0,0,0.0,1,2,3,0,2,0,0,2,8,-3,1,Andre Drummond,CHI,DAL,CHI,,,11,11,8,3
22023,203083,22300102,"OCT 30, 2023",CHI @ IND,W,14,2,4,0.5,0,0,0.0,1,2,0.5,2,1,3,2,1,0,1,0,5,7,1,Andre Drummond,CHI,IND,CHI,,,10,8,7,5
22023,203083,22300088,"OCT 28, 2023",CHI @ DET,L,14,1,6,0.167,0,0,0.0,0,0,0.0,3,2,5,2,3,1,0,0,2,-5,1,Andre Drummond,CHI,DET,CHI,,,9,7,4,7
22023,203083,22300082,"OCT 27, 2023",CHI vs. TOR,W,12,3,6,0.5,0,0,0.0,2,2,1.0,2,0,2,0,0,0,2,2,8,1,1,Andre Drummond,CHI,CHI,TOR,,,10,10,8,2
22023,203083,22300070,"OCT 25, 2023",CHI vs. OKC,L,16,3,4,0.75,0,0,0.0,0,0,0.0,3,2,5,1,1,0,1,1,6,-1,1,Andre Drummond,CHI,CHI,OKC,,,12,11,7,6
22023,1630537,22300532,"JAN 12, 2024",SAC @ PHI,L,10,0,2,0.0,0,1,0.0,1,2,0.5,1,2,3,0,0,0,1,1,1,-9,1,Chris Duarte,SAC,PHI,SAC,,,4,4,1,3
22023,1630537,22300518,"JAN 10, 2024",SAC @ CHA,W,14,0,2,0.0,0,0,0.0,0,0,0.0,1,1,2,2,0,0,0,2,0,5,1,Chris Duarte,SAC,CHA,SAC,,,4,2,2,4
22023,1630537,22300500,"JAN 07, 2024",SAC vs. NOP,L,15,0,3,0.0,0,2,0.0,1,2,0.5,0,0,0,1,0,0,0,0,1,-19,1,Chris Duarte,SAC,SAC,NOP,,,2,1,2,1
22023,1630537,22300492,"JAN 05, 2024",SAC vs. TOR,W,16,4,6,0.667,2,3,0.667,0,0,0.0,0,0,0,1,0,0,1,2,10,2,1,Chris Duarte,SAC,SAC,TOR,,,11,10,11,1
22023,1630537,22300476,"JAN 03, 2024",SAC vs. ORL,W,10,0,3,0.0,0,1,0.0,0,0,0.0,0,0,0,1,1,0,2,3,0,-6,1,Chris Duarte,SAC,SAC,ORL,,,1,0,1,1
22023,1630537,22300464,"JAN 02, 2024",SAC vs. CHA,L,30,5,11,0.455,2,4,0.5,0,0,0.0,4,3,7,4,1,0,1,1,12,3,1,Chris Duarte,SAC,SAC,CHA,,,23,19,16,11
22023,1630537,22300449,"DEC 31, 2023",SAC @ MEM,W,26,2,6,0.333,1,2,0.5,2,2,1.0,1,5,6,0,0,0,1,2,7,11,1,Chris Duarte,SAC,MEM,SAC,,,13,13,7,6
22023,1630537,22300431,"DEC 29, 2023",SAC @ ATL,W,25,2,5,0.4,1,3,0.333,0,0,0.0,0,0,0,4,1,0,1,1,5,10,1,Chris Duarte,SAC,ATL,SAC,,,9,5,9,4
22023,1630537,22300413,"DEC 26, 2023",SAC @ POR,L,8,2,2,1.0,0,0,0.0,0,0,0.0,0,3,3,1,1,0,0,0,4,-6,1,Chris Duarte,SAC,POR,SAC,,,8,7,5,4
22023,1630537,22300400,"DEC 23, 2023",SAC vs. MIN,L,18,1,3,0.333,1,3,0.333,0,0,0.0,1,3,4,0,2,0,1,1,3,4,1,Chris Duarte,SAC,SAC,MIN,,,7,7,3,4
22023,1630537,22300387,"DEC 22, 2023",SAC vs. PHX,W,2,0,2,0.0,0,1,0.0,0,0,0.0,1,0,1,0,0,0,0,0,0,-6,1,Chris Duarte,SAC,SAC,PHX,,,1,1,0,1
22023,1630537,22300373,"DEC 20, 2023",SAC vs. BOS,L,5,0,2,0.0,0,1,0.0,0,0,0.0,0,1,1,0,0,0,0,0,0,-4,1,Chris Duarte,SAC,SAC,BOS,,,1,1,0,1
22023,1630537,22300358,"DEC 18, 2023",SAC vs. WAS,W,4,0,1,0.0,0,1,0.0,0,0,0.0,0,0,0,0,0,0,0,0,0,-7,1,Chris Duarte,SAC,SAC,WAS,,,0,0,0,0
22023,1630537,22300342,"DEC 16, 2023",SAC vs. UTA,W,4,0,2,0.0,0,0,0.0,0,0,0.0,0,1,1,0,0,0,1,0,0,3,1,Chris Duarte,SAC,SAC,UTA,,,1,1,0,1
22023,1630537,22300309,"DEC 12, 2023",SAC @ LAC,L,12,1,3,0.333,0,2,0.0,4,4,1.0,0,2,2,1,0,1,0,1,6,9,1,Chris Duarte,SAC,LAC,SAC,,,9,8,7,3
22023,1630537,22300303,"DEC 11, 2023",SAC vs. BKN,W,3,0,1,0.0,0,1,0.0,0,0,0.0,0,0,0,1,0,0,0,0,0,-7,1,Chris Duarte,SAC,SAC,BKN,,,1,0,1,1
22023,1630537,22301228,"DEC 08, 2023",SAC @ PHX,W,1,0,0,0.0,0,0,0.0,0,0,0.0,0,0,0,0,0,0,0,0,0,-4,1,Chris Duarte,SAC,PHX,SAC,,,0,0,0,0
22023,1630537,22300264,"NOV 29, 2023",SAC vs. LAC,L,13,3,6,0.5,0,2,0.0,1,1,1.0,1,2,3,0,0,0,0,2,7,-8,1,Chris Duarte,SAC,SAC,LAC,,,10,10,7,3
22023,1630537,22300060,"NOV 28, 2023",SAC vs. GSW,W,14,2,4,0.5,0,1,0.0,1,2,0.5,0,0,0,0,2,0,0,2,5,-10,1,Chris Duarte,SAC,SAC,GSW,,,5,5,5,0
22023,1630537,22300050,"NOV 24, 2023",SAC @ MIN,W,22,0,3,0.0,0,2,0.0,0,0,0.0,2,3,5,0,1,0,2,3,0,2,1,Chris Duarte,SAC,MIN,SAC,,,5,5,0,5
22023,1630537,22300233,"NOV 22, 2023",SAC @ NOP,L,20,2,3,0.667,2,3,0.667,0,0,0.0,0,1,1,2,0,0,1,5,6,22,1,Chris Duarte,SAC,NOP,SAC,,,9,7,8,3
22023,1630537,22300222,"NOV 20, 2023",SAC @ NOP,L,8,0,2,0.0,0,2,0.0,0,0,0.0,0,2,2,0,0,0,0,1,0,-3,1,Chris Duarte,SAC,NOP,SAC,,,2,2,0,2
22023,1630537,22300212,"NOV 19, 2023",SAC @ DAL,W,33,5,8,0.625,3,4,0.75,0,0,0.0,0,8,8,4,2,0,1,3,13,7,1,Chris Duarte,SAC,DAL,SAC,,,25,21,17,12
22023,1630537,22300032,"NOV 17, 2023",SAC @ SAS,W,15,2,4,0.5,2,3,0.667,0,0,0.0,0,3,3,0,2,0,2,2,6,-8,1,Chris Duarte,SAC,SAS,SAC,,,9,9,6,3
22023,1630537,22300198,"NOV 15, 2023",SAC @ LAL,W,4,2,2,1.0,0,0,0.0,0,0,0.0,0,0,0,1,0,0,0,1,4,3,1,Chris Duarte,SAC,LAL,SAC,,,5,4,5,1
22023,1630537,22300191,"NOV 13, 2023",SAC vs. CLE,W,9,1,3,0.333,0,2,0.0,0,0,0.0,0,0,0,0,0,0,1,4,2,-2,1,Chris Duarte,SAC,SAC,CLE,,,2,2,2,0
22023,1630537,22300016,"NOV 10, 2023",SAC vs. OKC,W,5,0,2,0.0,0,2,0.0,0,0,0.0,0,1,1,0,1,0,1,2,0,-1,1,Chris Duarte,SAC,SAC,OKC,,,1,1,0,1
22023,1630537,22300170,"NOV 08, 2023",SAC vs. POR,W,11,1,4,0.25,1,3,0.333,0,0,0.0,0,2,2,0,1,0,0,2,3,-8,1,Chris Duarte,SAC,SAC,POR,,,5,5,3,2
22023,1630537,22300153,"NOV 06, 2023",SAC @ HOU,L,15,1,3,0.333,1,1,1.0,2,4,0.5,0,1,1,2,0,0,1,1,5,-8,1,Chris Duarte,SAC,HOU,SAC,,,8,6,7,3
22023,1630537,22300137,"NOV 04, 2023",SAC @ HOU,L,26,3,8,0.375,2,6,0.333,2,2,1.0,0,2,2,1,1,1,0,4,10,-4,1,Chris Duarte,SAC,HOU,SAC,,,13,12,11,3
22023,1630537,22300126,"NOV 01, 2023",SAC @ GSW,L,7,0,3,0.0,0,1,0.0,2,2,1.0,0,1,1,2,0,0,1,3,2,-1,1,Chris Duarte,SAC,GSW,SAC,,,5,3,4,3
22023,1630537,22300100,"OCT 29, 2023",SAC vs. LAL,W,14,2,4,0.5,0,2,0.0,0,0,0.0,0,2,2,0,1,0,0,3,4,1,1,Chris Duarte,SAC,SAC,LAL,,,6,6,4,2
22023,1630537,22300087,"OCT 27, 2023",SAC vs. GSW,L,26,1,7,0.143,0,4,0.0,2,3,0.667,0,1,1,3,1,0,1,6,4,0,1,Chris Duarte,SAC,SAC,GSW,,,8,5,7,4
22023,1630537,22300072,"OCT 25, 2023",SAC @ UTA,W,15,3,5,0.6,3,4,0.75,0,0,0.0,1,1,2,1,0,0,0,3,9,5,1,Chris Duarte,SAC,UTA,SAC,,,12,11,10,3
22023,1627739,22300564,"JAN 15, 2024",UTA vs. IND,W,21,2,3,0.667,0,0,0.0,0,0,0.0,1,1,2,6,2,1,1,3,4,21,1,Kris Dunn,UTA,UTA,IND,,,12,6,10,8
22023,1627739,22300549,"JAN 13, 2024",UTA vs. LAL,W,17,3,4,0.75,1,2,0.5,0,0,0.0,0,0,0,3,1,0,2,2,7,6,1,Kris Dunn,UTA,UTA,LAL,,,10,7,10,3
22023,1627739,22300540,"JAN 12, 2024",UTA vs. TOR,W,17,3,4,0.75,0,1,0.0,0,0,0.0,2,3,5,5,1,2,2,3,6,15,1,Kris Dunn,UTA,UTA,TOR,,,16,11,11,10
22023,1627739,22300524,"JAN 10, 2024",UTA vs. DEN,W,26,2,2,1.0,1,1,1.0,0,0,0.0,1,3,4,3,4,1,2,4,5,6,1,Kris Dunn,UTA,UTA,DEN,,,12,9,8,7
22023,1627739,22300510,"JAN 08, 2024",UTA @ MIL,W,24,2,2,1.0,1,1,1.0,0,0,0.0,1,3,4,13,1,2,1,1,5,11,1,Kris Dunn,UTA,MIL,UTA,,,22,9,18,17
22023,1627739,22300495,"JAN 06, 2024",UTA @ PHI,W,23,0,1,0.0,0,1,0.0,0,0,0.0,0,5,5,1,1,2,1,3,0,8,1,Kris Dunn,UTA,PHI,UTA,,,6,5,1,6
22023,1627739,22300479,"JAN 05, 2024",UTA @ BOS,L,26,1,7,0.143,0,1,0.0,0,0,0.0,2,3,5,5,3,1,1,4,2,-9,1,Kris Dunn,UTA,BOS,UTA,,,12,7,7,10
22023,1627739,22300474,"JAN 03, 2024",UTA vs. DET,W,16,2,6,0.333,0,1,0.0,0,0,0.0,0,1,1,4,3,1,0,0,4,-3,1,Kris Dunn,UTA,UTA,DET,,,9,5,8,5
22023,1627739,22300457,"JAN 01, 2024",UTA vs. DAL,W,21,3,4,0.75,1,1,1.0,0,0,0.0,0,3,3,7,0,0,2,2,7,-1,1,Kris Dunn,UTA,UTA,DAL,,,17,10,14,10
22023,1627739,22300439,"DEC 30, 2023",UTA vs. MIA,W,18,1,5,0.2,0,1,0.0,0,0,0.0,0,1,1,6,2,1,1,3,2,0,1,Kris Dunn,UTA,UTA,MIA,,,9,3,8,7
22023,1627739,22300424,"DEC 28, 2023",UTA @ NOP,L,19,3,5,0.6,1,3,0.333,0,0,0.0,0,0,0,3,0,1,0,2,7,2,1,Kris Dunn,UTA,NOP,UTA,,,10,7,10,3
22023,1627739,22300412,"DEC 26, 2023",UTA @ SAS,W,19,0,2,0.0,0,1,0.0,2,2,1.0,2,5,7,6,0,0,1,0,2,5,1,Kris Dunn,UTA,SAS,UTA,,,15,9,8,13
22023,1627739,22300395,"DEC 23, 2023",UTA @ TOR,W,34,3,11,0.273,2,6,0.333,0,0,0.0,0,8,8,13,1,1,2,1,8,10,1,Kris Dunn,UTA,TOR,UTA,,,29,16,21,21
22023,1627739,22300374,"DEC 21, 2023",UTA @ DET,W,33,5,11,0.455,0,2,0.0,3,4,0.75,1,4,5,10,2,1,1,2,13,11,1,Kris Dunn,UTA,DET,UTA,,,28,18,23,15
22023,1627739,22300364,"DEC 20, 2023",UTA @ CLE,L,16,3,3,1.0,2,2,1.0,0,0,0.0,0,2,2,1,0,0,4,4,8,-10,1,Kris Dunn,UTA,CLE,UTA,,,11,10,9,3
22023,1627739,22300357,"DEC 18, 2023",UTA vs. BKN,W,16,2,2,1.0,0,0,0.0,0,0,0.0,2,1,3,5,0,0,0,1,4,6,1,Kris Dunn,UTA,UTA,BKN,,,12,7,9,8
22023,1627739,22300342,"DEC 16, 2023",UTA @ SAC,L,27,5,10,0.5,1,4,0.25,0,0,0.0,1,3,4,3,1,1,6,1,11,-13,1,Kris Dunn,UTA,SAC,UTA,,,18,15,14,7
22023,1627739,22300323,"DEC 14, 2023",UTA @ POR,W,26,3,8,0.375,0,2,0.0,0,0,0.0,1,1,2,5,0,0,0,2,6,-17,1,Kris Dunn,UTA,POR,UTA,,,13,8,11,7
22023,1627739,22300318,"DEC 13, 2023",UTA vs. NYK,W,18,4,4,1.0,2,2,1.0,0,0,0.0,0,2,2,7,1,0,1,3,10,13,1,Kris Dunn,UTA,UTA,NYK,,,19,12,17,9
22023,1627739,22300302,"DEC 11, 2023",UTA @ OKC,L,25,2,4,0.5,0,1,0.0,0,0,0.0,2,4,6,7,1,0,0,2,4,11,1,Kris Dunn,UTA,OKC,UTA,,,17,10,11,13
22023,1627739,22301213,"DEC 06, 2023",UTA @ DAL,L,17,3,8,0.375,1,4,0.25,1,2,0.5,1,3,4,2,0,0,0,2,8,-3,1,Kris Dunn,UTA,DAL,UTA,,,14,12,10,6
22023,1627739,22300243,"NOV 25, 2023",UTA vs. NOP,W,19,4,7,0.571,0,0,0.0,0,0,0.0,1,2,3,2,2,0,2,3,8,2,1,Kris Dunn,UTA,UTA,NOP,,,13,11,10,5
22023,1627739,22300237,"NOV 22, 2023",UTA @ POR,L,5,0,1,0.0,0,0,0.0,1,2,0.5,0,2,2,1,0,1,0,0,1,2,1,Kris Dunn,UTA,POR,UTA,,,4,3,2,3
22023,1627739,22300042,"NOV 21, 2023",UTA @ LAL,L,8,2,4,0.5,1,1,1.0,0,0,0.0,0,0,0,2,0,0,2,1,5,1,1,Kris Dunn,UTA,LAL,UTA,,,7,5,7,2
22023,1627739,22300035,"NOV 17, 2023",UTA vs. PHX,L,0,0,0,0.0,0,0,0.0,0,0,0.0,0,0,0,0,0,0,0,0,0,0,1,Kris Dunn,UTA,UTA,PHX,,,0,0,0,0
22023,1627739,22300023,"NOV 14, 2023",UTA vs. POR,W,1,0,0,0.0,0,0,0.0,0,0,0.0,0,0,0,0,0,0,1,0,0,0,1,Kris Dunn,UTA,UTA,POR,,,0,0,0,0
22023,1627739,22300158,"NOV 08, 2023",UTA @ IND,L,12,3,5,0.6,1,1,1.0,0,0,0.0,1,3,4,2,0,0,0,0,7,-3,1,Kris Dunn,UTA,IND,UTA,,,13,11,9,6
22023,1627739,22300152,"NOV 06, 2023",UTA @ CHI,L,11,1,1,1.0,1,1,1.0,0,0,0.0,2,3,5,3,0,0,2,1,3,-3,1,Kris Dunn,UTA,CHI,UTA,,,11,8,6,8
22023,1627739,22300130,"NOV 02, 2023",UTA vs. ORL,L,6,1,2,0.5,0,0,0.0,0,0,0.0,0,2,2,3,0,0,0,0,2,-1,1,Kris Dunn,UTA,UTA,ORL,,,7,4,5,5
22023,1627739,22300125,"NOV 01, 2023",UTA vs. MEM,W,13,1,2,0.5,1,1,1.0,2,2,1.0,0,1,1,3,0,0,0,3,5,10,1,Kris Dunn,UTA,UTA,MEM,,,9,6,8,4
22023,1627739,22300110,"OCT 30, 2023",UTA @ DEN,L,6,0,2,0.0,0,1,0.0,0,0,0.0,0,2,2,1,0,0,0,1,0,0,1,Kris Dunn,UTA,DEN,UTA,,,3,2,1,3
22023,1627739,22300094,"OCT 28, 2023",UTA @ PHX,L,20,2,7,0.286,0,1,0.0,0,0,0.0,0,2,2,3,2,0,1,2,4,4,1,Kris Dunn,UTA,PHX,UTA,,,9,6,7,5
22023,1627739,22300085,"OCT 27, 2023",UTA vs. LAC,W,19,2,7,0.286,0,2,0.0,0,0,0.0,0,1,1,3,1,0,3,6,4,8,1,Kris Dunn,UTA,UTA,LAC,,,8,5,7,4
22023,1627739,22300072,"OCT 25, 2023",UTA vs. SAC,L,16,3,6,0.5,0,1,0.0,2,4,0.5,0,1,1,2,2,0,4,0,8,-16,1,Kris Dunn,UTA,UTA,SAC,,,11,9,10,3
22023,201142,22300554,"JAN 14, 2024",PHX @ POR,W,38,8,16,0.5,2,5,0.4,3,3,1.0,1,4,5,6,0,0,3,4,21,0,1,Kevin Durant,PHX,POR,PHX,27.0,Points,32,26,27,11
22023,201142,22300554,"JAN 14, 2024",PHX @ POR,W,38,8,16,0.5,2,5,0.4,3,3,1.0,1,4,5,6,0,0,3,4,21,0,1,Kevin Durant,PHX,POR,PHX,6.5,Rebounds,32,26,27,11
22023,201142,22300554,"JAN 14, 2024",PHX @ POR,W,38,8,16,0.5,2,5,0.4,3,3,1.0,1,4,5,6,0,0,3,4,21,0,1,Kevin Durant,PHX,POR,PHX,38.5,Pts+Rebs+Asts,32,26,27,11
22023,201142,22300554,"JAN 14, 2024",PHX @ POR,W,38,8,16,0.5,2,5,0.4,3,3,1.0,1,4,5,6,0,0,3,4,21,0,1,Kevin Durant,PHX,POR,PHX,5.0,Assists,32,26,27,11
22023,201142,22300554,"JAN 14, 2024",PHX @ POR,W,38,8,16,0.5,2,5,0.4,3,3,1.0,1,4,5,6,0,0,3,4,21,0,1,Kevin Durant,PHX,POR,PHX,45.0,Fantasy Score,32,26,27,11
22023,201142,22300554,"JAN 14, 2024",PHX @ POR,W,38,8,16,0.5,2,5,0.4,3,3,1.0,1,4,5,6,0,0,3,4,21,0,1,Kevin Durant,PHX,POR,PHX,5.5,3-PT Attempted,32,26,27,11
22023,201142,22300554,"JAN 14, 2024",PHX @ POR,W,38,8,16,0.5,2,5,0.4,3,3,1.0,1,4,5,6,0,0,3,4,21,0,1,Kevin Durant,PHX,POR,PHX,5.5,Free Throws Made,32,26,27,11
22023,201142,22300554,"JAN 14, 2024",PHX @ POR,W,38,8,16,0.5,2,5,0.4,3,3,1.0,1,4,5,6,0,0,3,4,21,0,1,Kevin Durant,PHX,POR,PHX,18.0,FG Attempted,32,26,27,11
22023,201142,22300554,"JAN 14, 2024",PHX @ POR,W,38,8,16,0.5,2,5,0.4,3,3,1.0,1,4,5,6,0,0,3,4,21,0,1,Kevin Durant,PHX,POR,PHX,33.5,Pts+Rebs,32,26,27,11
22023,201142,22300554,"JAN 14, 2024",PHX @ POR,W,38,8,16,0.5,2,5,0.4,3,3,1.0,1,4,5,6,0,0,3,4,21,0,1,Kevin Durant,PHX,POR,PHX,0.5,Dunks,32,26,27,11
22023,201142,22300554,"JAN 14, 2024",PHX @ POR,W,38,8,16,0.5,2,5,0.4,3,3,1.0,1,4,5,6,0,0,3,4,21,0,1,Kevin Durant,PHX,POR,PHX,32.0,Pts+Asts,32,26,27,11
22023,201142,22300554,"JAN 14, 2024",PHX @ POR,W,38,8,16,0.5,2,5,0.4,3,3,1.0,1,4,5,6,0,0,3,4,21,0,1,Kevin Durant,PHX,POR,PHX,12.0,Rebs+Asts,32,26,27,11
22023,201142,22300531,"JAN 11, 2024",PHX @ LAL,W,32,7,12,0.583,2,5,0.4,2,2,1.0,0,5,5,5,3,1,1,0,18,15,1,Kevin Durant,PHX,LAL,PHX,27.0,Points,28,23,23,10
22023,201142,22300531,"JAN 11, 2024",PHX @ LAL,W,32,7,12,0.583,2,5,0.4,2,2,1.0,0,5,5,5,3,1,1,0,18,15,1,Kevin Durant,PHX,LAL,PHX,6.5,Rebounds,28,23,23,10
22023,201142,22300531,"JAN 11, 2024",PHX @ LAL,W,32,7,12,0.583,2,5,0.4,2,2,1.0,0,5,5,5,3,1,1,0,18,15,1,Kevin Durant,PHX,LAL,PHX,38.5,Pts+Rebs+Asts,28,23,23,10
22023,201142,22300531,"JAN 11, 2024",PHX @ LAL,W,32,7,12,0.583,2,5,0.4,2,2,1.0,0,5,5,5,3,1,1,0,18,15,1,Kevin Durant,PHX,LAL,PHX,5.0,Assists,28,23,23,10
22023,201142,22300531,"JAN 11, 2024",PHX @ LAL,W,32,7,12,0.583,2,5,0.4,2,2,1.0,0,5,5,5,3,1,1,0,18,15,1,Kevin Durant,PHX,LAL,PHX,45.0,Fantasy Score,28,23,23,10
22023,201142,22300531,"JAN 11, 2024",PHX @ LAL,W,32,7,12,0.583,2,5,0.4,2,2,1.0,0,5,5,5,3,1,1,0,18,15,1,Kevin Durant,PHX,LAL,PHX,5.5,3-PT Attempted,28,23,23,10
22023,201142,22300531,"JAN 11, 2024",PHX @ LAL,W,32,7,12,0.583,2,5,0.4,2,2,1.0,0,5,5,5,3,1,1,0,18,15,1,Kevin Durant,PHX,LAL,PHX,5.5,Free Throws Made,28,23,23,10
22023,201142,22300531,"JAN 11, 2024",PHX @ LAL,W,32,7,12,0.583,2,5,0.4,2,2,1.0,0,5,5,5,3,1,1,0,18,15,1,Kevin Durant,PHX,LAL,PHX,18.0,FG Attempted,28,23,23,10
22023,201142,22300531,"JAN 11, 2024",PHX @ LAL,W,32,7,12,0.583,2,5,0.4,2,2,1.0,0,5,5,5,3,1,1,0,18,15,1,Kevin Durant,PHX,LAL,PHX,33.5,Pts+Rebs,28,23,23,10
22023,201142,22300531,"JAN 11, 2024",PHX @ LAL,W,32,7,12,0.583,2,5,0.4,2,2,1.0,0,5,5,5,3,1,1,0,18,15,1,Kevin Durant,PHX,LAL,PHX,0.5,Dunks,28,23,23,10
22023,201142,22300531,"JAN 11, 2024",PHX @ LAL,W,32,7,12,0.583,2,5,0.4,2,2,1.0,0,5,5,5,3,1,1,0,18,15,1,Kevin Durant,PHX,LAL,PHX,32.0,Pts+Asts,28,23,23,10
22023,201142,22300531,"JAN 11, 2024",PHX @ LAL,W,32,7,12,0.583,2,5,0.4,2,2,1.0,0,5,5,5,3,1,1,0,18,15,1,Kevin Durant,PHX,LAL,PHX,12.0,Rebs+Asts,28,23,23,10
22023,201142,22300511,"JAN 08, 2024",PHX @ LAC,L,35,10,17,0.588,3,6,0.5,7,8,0.875,0,7,7,2,0,1,3,2,30,-14,1,Kevin Durant,PHX,LAC,PHX,27.0,Points,39,37,32,9
22023,201142,22300511,"JAN 08, 2024",PHX @ LAC,L,35,10,17,0.588,3,6,0.5,7,8,0.875,0,7,7,2,0,1,3,2,30,-14,1,Kevin Durant,PHX,LAC,PHX,6.5,Rebounds,39,37,32,9
22023,201142,22300511,"JAN 08, 2024",PHX @ LAC,L,35,10,17,0.588,3,6,0.5,7,8,0.875,0,7,7,2,0,1,3,2,30,-14,1,Kevin Durant,PHX,LAC,PHX,38.5,Pts+Rebs+Asts,39,37,32,9
22023,201142,22300511,"JAN 08, 2024",PHX @ LAC,L,35,10,17,0.588,3,6,0.5,7,8,0.875,0,7,7,2,0,1,3,2,30,-14,1,Kevin Durant,PHX,LAC,PHX,5.0,Assists,39,37,32,9
22023,201142,22300511,"JAN 08, 2024",PHX @ LAC,L,35,10,17,0.588,3,6,0.5,7,8,0.875,0,7,7,2,0,1,3,2,30,-14,1,Kevin Durant,PHX,LAC,PHX,45.0,Fantasy Score,39,37,32,9
22023,201142,22300511,"JAN 08, 2024",PHX @ LAC,L,35,10,17,0.588,3,6,0.5,7,8,0.875,0,7,7,2,0,1,3,2,30,-14,1,Kevin Durant,PHX,LAC,PHX,5.5,3-PT Attempted,39,37,32,9
22023,201142,22300511,"JAN 08, 2024",PHX @ LAC,L,35,10,17,0.588,3,6,0.5,7,8,0.875,0,7,7,2,0,1,3,2,30,-14,1,Kevin Durant,PHX,LAC,PHX,5.5,Free Throws Made,39,37,32,9
22023,201142,22300511,"JAN 08, 2024",PHX @ LAC,L,35,10,17,0.588,3,6,0.5,7,8,0.875,0,7,7,2,0,1,3,2,30,-14,1,Kevin Durant,PHX,LAC,PHX,18.0,FG Attempted,39,37,32,9
22023,201142,22300511,"JAN 08, 2024",PHX @ LAC,L,35,10,17,0.588,3,6,0.5,7,8,0.875,0,7,7,2,0,1,3,2,30,-14,1,Kevin Durant,PHX,LAC,PHX,33.5,Pts+Rebs,39,37,32,9
22023,201142,22300511,"JAN 08, 2024",PHX @ LAC,L,35,10,17,0.588,3,6,0.5,7,8,0.875,0,7,7,2,0,1,3,2,30,-14,1,Kevin Durant,PHX,LAC,PHX,0.5,Dunks,39,37,32,9
22023,201142,22300511,"JAN 08, 2024",PHX @ LAC,L,35,10,17,0.588,3,6,0.5,7,8,0.875,0,7,7,2,0,1,3,2,30,-14,1,Kevin Durant,PHX,LAC,PHX,32.0,Pts+Asts,39,37,32,9
22023,201142,22300511,"JAN 08, 2024",PHX @ LAC,L,35,10,17,0.588,3,6,0.5,7,8,0.875,0,7,7,2,0,1,3,2,30,-14,1,Kevin Durant,PHX,LAC,PHX,12.0,Rebs+Asts,39,37,32,9
22023,201142,22300503,"JAN 07, 2024",PHX vs. MEM,L,36,11,23,0.478,0,1,0.0,1,1,1.0,2,8,10,5,0,1,1,1,23,-7,1,Kevin Durant,PHX,PHX,MEM,27.0,Points,38,33,28,15
22023,201142,22300503,"JAN 07, 2024",PHX vs. MEM,L,36,11,23,0.478,0,1,0.0,1,1,1.0,2,8,10,5,0,1,1,1,23,-7,1,Kevin Durant,PHX,PHX,MEM,6.5,Rebounds,38,33,28,15
22023,201142,22300503,"JAN 07, 2024",PHX vs. MEM,L,36,11,23,0.478,0,1,0.0,1,1,1.0,2,8,10,5,0,1,1,1,23,-7,1,Kevin Durant,PHX,PHX,MEM,38.5,Pts+Rebs+Asts,38,33,28,15
22023,201142,22300503,"JAN 07, 2024",PHX vs. MEM,L,36,11,23,0.478,0,1,0.0,1,1,1.0,2,8,10,5,0,1,1,1,23,-7,1,Kevin Durant,PHX,PHX,MEM,5.0,Assists,38,33,28,15
22023,201142,22300503,"JAN 07, 2024",PHX vs. MEM,L,36,11,23,0.478,0,1,0.0,1,1,1.0,2,8,10,5,0,1,1,1,23,-7,1,Kevin Durant,PHX,PHX,MEM,45.0,Fantasy Score,38,33,28,15
22023,201142,22300503,"JAN 07, 2024",PHX vs. MEM,L,36,11,23,0.478,0,1,0.0,1,1,1.0,2,8,10,5,0,1,1,1,23,-7,1,Kevin Durant,PHX,PHX,MEM,5.5,3-PT Attempted,38,33,28,15
22023,201142,22300503,"JAN 07, 2024",PHX vs. MEM,L,36,11,23,0.478,0,1,0.0,1,1,1.0,2,8,10,5,0,1,1,1,23,-7,1,Kevin Durant,PHX,PHX,MEM,5.5,Free Throws Made,38,33,28,15
22023,201142,22300503,"JAN 07, 2024",PHX vs. MEM,L,36,11,23,0.478,0,1,0.0,1,1,1.0,2,8,10,5,0,1,1,1,23,-7,1,Kevin Durant,PHX,PHX,MEM,18.0,FG Attempted,38,33,28,15
22023,201142,22300503,"JAN 07, 2024",PHX vs. MEM,L,36,11,23,0.478,0,1,0.0,1,1,1.0,2,8,10,5,0,1,1,1,23,-7,1,Kevin Durant,PHX,PHX,MEM,33.5,Pts+Rebs,38,33,28,15
22023,201142,22300503,"JAN 07, 2024",PHX vs. MEM,L,36,11,23,0.478,0,1,0.0,1,1,1.0,2,8,10,5,0,1,1,1,23,-7,1,Kevin Durant,PHX,PHX,MEM,0.5,Dunks,38,33,28,15
22023,201142,22300503,"JAN 07, 2024",PHX vs. MEM,L,36,11,23,0.478,0,1,0.0,1,1,1.0,2,8,10,5,0,1,1,1,23,-7,1,Kevin Durant,PHX,PHX,MEM,32.0,Pts+Asts,38,33,28,15
22023,201142,22300503,"JAN 07, 2024",PHX vs. MEM,L,36,11,23,0.478,0,1,0.0,1,1,1.0,2,8,10,5,0,1,1,1,23,-7,1,Kevin Durant,PHX,PHX,MEM,12.0,Rebs+Asts,38,33,28,15
22023,201142,22300450,"DEC 31, 2023",PHX vs. ORL,W,39,12,21,0.571,2,5,0.4,5,5,1.0,0,5,5,5,3,1,0,1,31,9,1,Kevin Durant,PHX,PHX,ORL,27.0,Points,41,36,36,10
22023,201142,22300450,"DEC 31, 2023",PHX vs. ORL,W,39,12,21,0.571,2,5,0.4,5,5,1.0,0,5,5,5,3,1,0,1,31,9,1,Kevin Durant,PHX,PHX,ORL,6.5,Rebounds,41,36,36,10
22023,201142,22300450,"DEC 31, 2023",PHX vs. ORL,W,39,12,21,0.571,2,5,0.4,5,5,1.0,0,5,5,5,3,1,0,1,31,9,1,Kevin Durant,PHX,PHX,ORL,38.5,Pts+Rebs+Asts,41,36,36,10
22023,201142,22300450,"DEC 31, 2023",PHX vs. ORL,W,39,12,21,0.571,2,5,0.4,5,5,1.0,0,5,5,5,3,1,0,1,31,9,1,Kevin Durant,PHX,PHX,ORL,5.0,Assists,41,36,36,10
22023,201142,22300450,"DEC 31, 2023",PHX vs. ORL,W,39,12,21,0.571,2,5,0.4,5,5,1.0,0,5,5,5,3,1,0,1,31,9,1,Kevin Durant,PHX,PHX,ORL,45.0,Fantasy Score,41,36,36,10
22023,201142,22300450,"DEC 31, 2023",PHX vs. ORL,W,39,12,21,0.571,2,5,0.4,5,5,1.0,0,5,5,5,3,1,0,1,31,9,1,Kevin Durant,PHX,PHX,ORL,5.5,3-PT Attempted,41,36,36,10
22023,201142,22300450,"DEC 31, 2023",PHX vs. ORL,W,39,12,21,0.571,2,5,0.4,5,5,1.0,0,5,5,5,3,1,0,1,31,9,1,Kevin Durant,PHX,PHX,ORL,5.5,Free Throws Made,41,36,36,10
22023,201142,22300450,"DEC 31, 2023",PHX vs. ORL,W,39,12,21,0.571,2,5,0.4,5,5,1.0,0,5,5,5,3,1,0,1,31,9,1,Kevin Durant,PHX,PHX,ORL,18.0,FG Attempted,41,36,36,10
22023,201142,22300450,"DEC 31, 2023",PHX vs. ORL,W,39,12,21,0.571,2,5,0.4,5,5,1.0,0,5,5,5,3,1,0,1,31,9,1,Kevin Durant,PHX,PHX,ORL,33.5,Pts+Rebs,41,36,36,10
22023,201142,22300450,"DEC 31, 2023",PHX vs. ORL,W,39,12,21,0.571,2,5,0.4,5,5,1.0,0,5,5,5,3,1,0,1,31,9,1,Kevin Durant,PHX,PHX,ORL,0.5,Dunks,41,36,36,10
22023,201142,22300450,"DEC 31, 2023",PHX vs. ORL,W,39,12,21,0.571,2,5,0.4,5,5,1.0,0,5,5,5,3,1,0,1,31,9,1,Kevin Durant,PHX,PHX,ORL,32.0,Pts+Asts,41,36,36,10
22023,201142,22300450,"DEC 31, 2023",PHX vs. ORL,W,39,12,21,0.571,2,5,0.4,5,5,1.0,0,5,5,5,3,1,0,1,31,9,1,Kevin Durant,PHX,PHX,ORL,12.0,Rebs+Asts,41,36,36,10
22023,201142,22300436,"DEC 29, 2023",PHX vs. CHA,W,39,8,11,0.727,3,3,1.0,2,2,1.0,1,3,4,11,1,3,1,2,21,10,1,Kevin Durant,PHX,PHX,CHA,27.0,Points,36,25,32,15
22023,201142,22300436,"DEC 29, 2023",PHX vs. CHA,W,39,8,11,0.727,3,3,1.0,2,2,1.0,1,3,4,11,1,3,1,2,21,10,1,Kevin Durant,PHX,PHX,CHA,6.5,Rebounds,36,25,32,15
22023,201142,22300436,"DEC 29, 2023",PHX vs. CHA,W,39,8,11,0.727,3,3,1.0,2,2,1.0,1,3,4,11,1,3,1,2,21,10,1,Kevin Durant,PHX,PHX,CHA,38.5,Pts+Rebs+Asts,36,25,32,15
22023,201142,22300436,"DEC 29, 2023",PHX vs. CHA,W,39,8,11,0.727,3,3,1.0,2,2,1.0,1,3,4,11,1,3,1,2,21,10,1,Kevin Durant,PHX,PHX,CHA,5.0,Assists,36,25,32,15
22023,201142,22300436,"DEC 29, 2023",PHX vs. CHA,W,39,8,11,0.727,3,3,1.0,2,2,1.0,1,3,4,11,1,3,1,2,21,10,1,Kevin Durant,PHX,PHX,CHA,45.0,Fantasy Score,36,25,32,15
22023,201142,22300436,"DEC 29, 2023",PHX vs. CHA,W,39,8,11,0.727,3,3,1.0,2,2,1.0,1,3,4,11,1,3,1,2,21,10,1,Kevin Durant,PHX,PHX,CHA,5.5,3-PT Attempted,36,25,32,15
22023,201142,22300436,"DEC 29, 2023",PHX vs. CHA,W,39,8,11,0.727,3,3,1.0,2,2,1.0,1,3,4,11,1,3,1,2,21,10,1,Kevin Durant,PHX,PHX,CHA,5.5,Free Throws Made,36,25,32,15
22023,201142,22300436,"DEC 29, 2023",PHX vs. CHA,W,39,8,11,0.727,3,3,1.0,2,2,1.0,1,3,4,11,1,3,1,2,21,10,1,Kevin Durant,PHX,PHX,CHA,18.0,FG Attempted,36,25,32,15
22023,201142,22300436,"DEC 29, 2023",PHX vs. CHA,W,39,8,11,0.727,3,3,1.0,2,2,1.0,1,3,4,11,1,3,1,2,21,10,1,Kevin Durant,PHX,PHX,CHA,33.5,Pts+Rebs,36,25,32,15
22023,201142,22300436,"DEC 29, 2023",PHX vs. CHA,W,39,8,11,0.727,3,3,1.0,2,2,1.0,1,3,4,11,1,3,1,2,21,10,1,Kevin Durant,PHX,PHX,CHA,0.5,Dunks,36,25,32,15
22023,201142,22300436,"DEC 29, 2023",PHX vs. CHA,W,39,8,11,0.727,3,3,1.0,2,2,1.0,1,3,4,11,1,3,1,2,21,10,1,Kevin Durant,PHX,PHX,CHA,32.0,Pts+Asts,36,25,32,15
22023,201142,22300436,"DEC 29, 2023",PHX vs. CHA,W,39,8,11,0.727,3,3,1.0,2,2,1.0,1,3,4,11,1,3,1,2,21,10,1,Kevin Durant,PHX,PHX,CHA,12.0,Rebs+Asts,36,25,32,15
22023,201142,22300418,"DEC 27, 2023",PHX @ HOU,W,41,9,16,0.563,3,7,0.429,6,8,0.75,0,10,10,16,2,1,3,2,27,17,1,Kevin Durant,PHX,HOU,PHX,27.0,Points,53,37,43,26
22023,201142,22300418,"DEC 27, 2023",PHX @ HOU,W,41,9,16,0.563,3,7,0.429,6,8,0.75,0,10,10,16,2,1,3,2,27,17,1,Kevin Durant,PHX,HOU,PHX,6.5,Rebounds,53,37,43,26
22023,201142,22300418,"DEC 27, 2023",PHX @ HOU,W,41,9,16,0.563,3,7,0.429,6,8,0.75,0,10,10,16,2,1,3,2,27,17,1,Kevin Durant,PHX,HOU,PHX,38.5,Pts+Rebs+Asts,53,37,43,26
22023,201142,22300418,"DEC 27, 2023",PHX @ HOU,W,41,9,16,0.563,3,7,0.429,6,8,0.75,0,10,10,16,2,1,3,2,27,17,1,Kevin Durant,PHX,HOU,PHX,5.0,Assists,53,37,43,26
22023,201142,22300418,"DEC 27, 2023",PHX @ HOU,W,41,9,16,0.563,3,7,0.429,6,8,0.75,0,10,10,16,2,1,3,2,27,17,1,Kevin Durant,PHX,HOU,PHX,45.0,Fantasy Score,53,37,43,26
22023,201142,22300418,"DEC 27, 2023",PHX @ HOU,W,41,9,16,0.563,3,7,0.429,6,8,0.75,0,10,10,16,2,1,3,2,27,17,1,Kevin Durant,PHX,HOU,PHX,5.5,3-PT Attempted,53,37,43,26
22023,201142,22300418,"DEC 27, 2023",PHX @ HOU,W,41,9,16,0.563,3,7,0.429,6,8,0.75,0,10,10,16,2,1,3,2,27,17,1,Kevin Durant,PHX,HOU,PHX,5.5,Free Throws Made,53,37,43,26
22023,201142,22300418,"DEC 27, 2023",PHX @ HOU,W,41,9,16,0.563,3,7,0.429,6,8,0.75,0,10,10,16,2,1,3,2,27,17,1,Kevin Durant,PHX,HOU,PHX,18.0,FG Attempted,53,37,43,26
22023,201142,22300418,"DEC 27, 2023",PHX @ HOU,W,41,9,16,0.563,3,7,0.429,6,8,0.75,0,10,10,16,2,1,3,2,27,17,1,Kevin Durant,PHX,HOU,PHX,33.5,Pts+Rebs,53,37,43,26
22023,201142,22300418,"DEC 27, 2023",PHX @ HOU,W,41,9,16,0.563,3,7,0.429,6,8,0.75,0,10,10,16,2,1,3,2,27,17,1,Kevin Durant,PHX,HOU,PHX,0.5,Dunks,53,37,43,26
22023,201142,22300418,"DEC 27, 2023",PHX @ HOU,W,41,9,16,0.563,3,7,0.429,6,8,0.75,0,10,10,16,2,1,3,2,27,17,1,Kevin Durant,PHX,HOU,PHX,32.0,Pts+Asts,53,37,43,26
22023,201142,22300418,"DEC 27, 2023",PHX @ HOU,W,41,9,16,0.563,3,7,0.429,6,8,0.75,0,10,10,16,2,1,3,2,27,17,1,Kevin Durant,PHX,HOU,PHX,12.0,Rebs+Asts,53,37,43,26
22023,201142,22300405,"DEC 25, 2023",PHX vs. DAL,L,43,4,11,0.364,1,3,0.333,7,7,1.0,1,7,8,7,0,1,6,2,16,-5,1,Kevin Durant,PHX,PHX,DAL,27.0,Points,31,24,23,15
22023,201142,22300405,"DEC 25, 2023",PHX vs. DAL,L,43,4,11,0.364,1,3,0.333,7,7,1.0,1,7,8,7,0,1,6,2,16,-5,1,Kevin Durant,PHX,PHX,DAL,6.5,Rebounds,31,24,23,15
22023,201142,22300405,"DEC 25, 2023",PHX vs. DAL,L,43,4,11,0.364,1,3,0.333,7,7,1.0,1,7,8,7,0,1,6,2,16,-5,1,Kevin Durant,PHX,PHX,DAL,38.5,Pts+Rebs+Asts,31,24,23,15
22023,201142,22300405,"DEC 25, 2023",PHX vs. DAL,L,43,4,11,0.364,1,3,0.333,7,7,1.0,1,7,8,7,0,1,6,2,16,-5,1,Kevin Durant,PHX,PHX,DAL,5.0,Assists,31,24,23,15
22023,201142,22300405,"DEC 25, 2023",PHX vs. DAL,L,43,4,11,0.364,1,3,0.333,7,7,1.0,1,7,8,7,0,1,6,2,16,-5,1,Kevin Durant,PHX,PHX,DAL,45.0,Fantasy Score,31,24,23,15
22023,201142,22300405,"DEC 25, 2023",PHX vs. DAL,L,43,4,11,0.364,1,3,0.333,7,7,1.0,1,7,8,7,0,1,6,2,16,-5,1,Kevin Durant,PHX,PHX,DAL,5.5,3-PT Attempted,31,24,23,15
22023,201142,22300405,"DEC 25, 2023",PHX vs. DAL,L,43,4,11,0.364,1,3,0.333,7,7,1.0,1,7,8,7,0,1,6,2,16,-5,1,Kevin Durant,PHX,PHX,DAL,5.5,Free Throws Made,31,24,23,15
22023,201142,22300405,"DEC 25, 2023",PHX vs. DAL,L,43,4,11,0.364,1,3,0.333,7,7,1.0,1,7,8,7,0,1,6,2,16,-5,1,Kevin Durant,PHX,PHX,DAL,18.0,FG Attempted,31,24,23,15
22023,201142,22300405,"DEC 25, 2023",PHX vs. DAL,L,43,4,11,0.364,1,3,0.333,7,7,1.0,1,7,8,7,0,1,6,2,16,-5,1,Kevin Durant,PHX,PHX,DAL,33.5,Pts+Rebs,31,24,23,15
22023,201142,22300405,"DEC 25, 2023",PHX vs. DAL,L,43,4,11,0.364,1,3,0.333,7,7,1.0,1,7,8,7,0,1,6,2,16,-5,1,Kevin Durant,PHX,PHX,DAL,0.5,Dunks,31,24,23,15
22023,201142,22300405,"DEC 25, 2023",PHX vs. DAL,L,43,4,11,0.364,1,3,0.333,7,7,1.0,1,7,8,7,0,1,6,2,16,-5,1,Kevin Durant,PHX,PHX,DAL,32.0,Pts+Asts,31,24,23,15
22023,201142,22300405,"DEC 25, 2023",PHX vs. DAL,L,43,4,11,0.364,1,3,0.333,7,7,1.0,1,7,8,7,0,1,6,2,16,-5,1,Kevin Durant,PHX,PHX,DAL,12.0,Rebs+Asts,31,24,23,15
22023,201142,22300387,"DEC 22, 2023",PHX @ SAC,L,34,9,14,0.643,2,3,0.667,8,9,0.889,0,7,7,2,1,0,7,0,28,-14,1,Kevin Durant,PHX,SAC,PHX,27.0,Points,37,35,30,9
22023,201142,22300387,"DEC 22, 2023",PHX @ SAC,L,34,9,14,0.643,2,3,0.667,8,9,0.889,0,7,7,2,1,0,7,0,28,-14,1,Kevin Durant,PHX,SAC,PHX,6.5,Rebounds,37,35,30,9
22023,201142,22300387,"DEC 22, 2023",PHX @ SAC,L,34,9,14,0.643,2,3,0.667,8,9,0.889,0,7,7,2,1,0,7,0,28,-14,1,Kevin Durant,PHX,SAC,PHX,38.5,Pts+Rebs+Asts,37,35,30,9
22023,201142,22300387,"DEC 22, 2023",PHX @ SAC,L,34,9,14,0.643,2,3,0.667,8,9,0.889,0,7,7,2,1,0,7,0,28,-14,1,Kevin Durant,PHX,SAC,PHX,5.0,Assists,37,35,30,9
22023,201142,22300387,"DEC 22, 2023",PHX @ SAC,L,34,9,14,0.643,2,3,0.667,8,9,0.889,0,7,7,2,1,0,7,0,28,-14,1,Kevin Durant,PHX,SAC,PHX,45.0,Fantasy Score,37,35,30,9
22023,201142,22300387,"DEC 22, 2023",PHX @ SAC,L,34,9,14,0.643,2,3,0.667,8,9,0.889,0,7,7,2,1,0,7,0,28,-14,1,Kevin Durant,PHX,SAC,PHX,5.5,3-PT Attempted,37,35,30,9
22023,201142,22300387,"DEC 22, 2023",PHX @ SAC,L,34,9,14,0.643,2,3,0.667,8,9,0.889,0,7,7,2,1,0,7,0,28,-14,1,Kevin Durant,PHX,SAC,PHX,5.5,Free Throws Made,37,35,30,9
22023,201142,22300387,"DEC 22, 2023",PHX @ SAC,L,34,9,14,0.643,2,3,0.667,8,9,0.889,0,7,7,2,1,0,7,0,28,-14,1,Kevin Durant,PHX,SAC,PHX,18.0,FG Attempted,37,35,30,9
22023,201142,22300387,"DEC 22, 2023",PHX @ SAC,L,34,9,14,0.643,2,3,0.667,8,9,0.889,0,7,7,2,1,0,7,0,28,-14,1,Kevin Durant,PHX,SAC,PHX,33.5,Pts+Rebs,37,35,30,9
22023,201142,22300387,"DEC 22, 2023",PHX @ SAC,L,34,9,14,0.643,2,3,0.667,8,9,0.889,0,7,7,2,1,0,7,0,28,-14,1,Kevin Durant,PHX,SAC,PHX,0.5,Dunks,37,35,30,9
22023,201142,22300387,"DEC 22, 2023",PHX @ SAC,L,34,9,14,0.643,2,3,0.667,8,9,0.889,0,7,7,2,1,0,7,0,28,-14,1,Kevin Durant,PHX,SAC,PHX,32.0,Pts+Asts,37,35,30,9
22023,201142,22300387,"DEC 22, 2023",PHX @ SAC,L,34,9,14,0.643,2,3,0.667,8,9,0.889,0,7,7,2,1,0,7,0,28,-14,1,Kevin Durant,PHX,SAC,PHX,12.0,Rebs+Asts,37,35,30,9
22023,201142,22300363,"DEC 19, 2023",PHX @ POR,L,38,16,28,0.571,1,3,0.333,7,8,0.875,0,4,4,5,2,0,5,1,40,8,1,Kevin Durant,PHX,POR,PHX,27.0,Points,49,44,45,9
22023,201142,22300363,"DEC 19, 2023",PHX @ POR,L,38,16,28,0.571,1,3,0.333,7,8,0.875,0,4,4,5,2,0,5,1,40,8,1,Kevin Durant,PHX,POR,PHX,6.5,Rebounds,49,44,45,9
22023,201142,22300363,"DEC 19, 2023",PHX @ POR,L,38,16,28,0.571,1,3,0.333,7,8,0.875,0,4,4,5,2,0,5,1,40,8,1,Kevin Durant,PHX,POR,PHX,38.5,Pts+Rebs+Asts,49,44,45,9
22023,201142,22300363,"DEC 19, 2023",PHX @ POR,L,38,16,28,0.571,1,3,0.333,7,8,0.875,0,4,4,5,2,0,5,1,40,8,1,Kevin Durant,PHX,POR,PHX,5.0,Assists,49,44,45,9
22023,201142,22300363,"DEC 19, 2023",PHX @ POR,L,38,16,28,0.571,1,3,0.333,7,8,0.875,0,4,4,5,2,0,5,1,40,8,1,Kevin Durant,PHX,POR,PHX,45.0,Fantasy Score,49,44,45,9
22023,201142,22300363,"DEC 19, 2023",PHX @ POR,L,38,16,28,0.571,1,3,0.333,7,8,0.875,0,4,4,5,2,0,5,1,40,8,1,Kevin Durant,PHX,POR,PHX,5.5,3-PT Attempted,49,44,45,9
22023,201142,22300363,"DEC 19, 2023",PHX @ POR,L,38,16,28,0.571,1,3,0.333,7,8,0.875,0,4,4,5,2,0,5,1,40,8,1,Kevin Durant,PHX,POR,PHX,5.5,Free Throws Made,49,44,45,9
22023,201142,22300363,"DEC 19, 2023",PHX @ POR,L,38,16,28,0.571,1,3,0.333,7,8,0.875,0,4,4,5,2,0,5,1,40,8,1,Kevin Durant,PHX,POR,PHX,18.0,FG Attempted,49,44,45,9
22023,201142,22300363,"DEC 19, 2023",PHX @ POR,L,38,16,28,0.571,1,3,0.333,7,8,0.875,0,4,4,5,2,0,5,1,40,8,1,Kevin Durant,PHX,POR,PHX,33.5,Pts+Rebs,49,44,45,9
22023,201142,22300363,"DEC 19, 2023",PHX @ POR,L,38,16,28,0.571,1,3,0.333,7,8,0.875,0,4,4,5,2,0,5,1,40,8,1,Kevin Durant,PHX,POR,PHX,0.5,Dunks,49,44,45,9
22023,201142,22300363,"DEC 19, 2023",PHX @ POR,L,38,16,28,0.571,1,3,0.333,7,8,0.875,0,4,4,5,2,0,5,1,40,8,1,Kevin Durant,PHX,POR,PHX,32.0,Pts+Asts,49,44,45,9
22023,201142,22300363,"DEC 19, 2023",PHX @ POR,L,38,16,28,0.571,1,3,0.333,7,8,0.875,0,4,4,5,2,0,5,1,40,8,1,Kevin Durant,PHX,POR,PHX,12.0,Rebs+Asts,49,44,45,9
22023,201142,22300347,"DEC 17, 2023",PHX vs. WAS,W,35,11,24,0.458,0,2,0.0,6,9,0.667,3,2,5,5,1,1,2,1,28,-2,1,Kevin Durant,PHX,PHX,WAS,27.0,Points,38,33,33,10
22023,201142,22300347,"DEC 17, 2023",PHX vs. WAS,W,35,11,24,0.458,0,2,0.0,6,9,0.667,3,2,5,5,1,1,2,1,28,-2,1,Kevin Durant,PHX,PHX,WAS,6.5,Rebounds,38,33,33,10
22023,201142,22300347,"DEC 17, 2023",PHX vs. WAS,W,35,11,24,0.458,0,2,0.0,6,9,0.667,3,2,5,5,1,1,2,1,28,-2,1,Kevin Durant,PHX,PHX,WAS,38.5,Pts+Rebs+Asts,38,33,33,10
22023,201142,22300347,"DEC 17, 2023",PHX vs. WAS,W,35,11,24,0.458,0,2,0.0,6,9,0.667,3,2,5,5,1,1,2,1,28,-2,1,Kevin Durant,PHX,PHX,WAS,5.0,Assists,38,33,33,10
22023,201142,22300347,"DEC 17, 2023",PHX vs. WAS,W,35,11,24,0.458,0,2,0.0,6,9,0.667,3,2,5,5,1,1,2,1,28,-2,1,Kevin Durant,PHX,PHX,WAS,45.0,Fantasy Score,38,33,33,10
22023,201142,22300347,"DEC 17, 2023",PHX vs. WAS,W,35,11,24,0.458,0,2,0.0,6,9,0.667,3,2,5,5,1,1,2,1,28,-2,1,Kevin Durant,PHX,PHX,WAS,5.5,3-PT Attempted,38,33,33,10
22023,201142,22300347,"DEC 17, 2023",PHX vs. WAS,W,35,11,24,0.458,0,2,0.0,6,9,0.667,3,2,5,5,1,1,2,1,28,-2,1,Kevin Durant,PHX,PHX,WAS,5.5,Free Throws Made,38,33,33,10
22023,201142,22300347,"DEC 17, 2023",PHX vs. WAS,W,35,11,24,0.458,0,2,0.0,6,9,0.667,3,2,5,5,1,1,2,1,28,-2,1,Kevin Durant,PHX,PHX,WAS,18.0,FG Attempted,38,33,33,10
22023,201142,22300347,"DEC 17, 2023",PHX vs. WAS,W,35,11,24,0.458,0,2,0.0,6,9,0.667,3,2,5,5,1,1,2,1,28,-2,1,Kevin Durant,PHX,PHX,WAS,33.5,Pts+Rebs,38,33,33,10
22023,201142,22300347,"DEC 17, 2023",PHX vs. WAS,W,35,11,24,0.458,0,2,0.0,6,9,0.667,3,2,5,5,1,1,2,1,28,-2,1,Kevin Durant,PHX,PHX,WAS,0.5,Dunks,38,33,33,10
22023,201142,22300347,"DEC 17, 2023",PHX vs. WAS,W,35,11,24,0.458,0,2,0.0,6,9,0.667,3,2,5,5,1,1,2,1,28,-2,1,Kevin Durant,PHX,PHX,WAS,32.0,Pts+Asts,38,33,33,10
22023,201142,22300347,"DEC 17, 2023",PHX vs. WAS,W,35,11,24,0.458,0,2,0.0,6,9,0.667,3,2,5,5,1,1,2,1,28,-2,1,Kevin Durant,PHX,PHX,WAS,12.0,Rebs+Asts,38,33,33,10
22023,201142,22300333,"DEC 15, 2023",PHX vs. NYK,L,36,10,21,0.476,4,9,0.444,5,7,0.714,0,3,3,6,0,0,0,1,29,-7,1,Kevin Durant,PHX,PHX,NYK,27.0,Points,38,32,35,9
22023,201142,22300333,"DEC 15, 2023",PHX vs. NYK,L,36,10,21,0.476,4,9,0.444,5,7,0.714,0,3,3,6,0,0,0,1,29,-7,1,Kevin Durant,PHX,PHX,NYK,6.5,Rebounds,38,32,35,9
22023,201142,22300333,"DEC 15, 2023",PHX vs. NYK,L,36,10,21,0.476,4,9,0.444,5,7,0.714,0,3,3,6,0,0,0,1,29,-7,1,Kevin Durant,PHX,PHX,NYK,38.5,Pts+Rebs+Asts,38,32,35,9
22023,201142,22300333,"DEC 15, 2023",PHX vs. NYK,L,36,10,21,0.476,4,9,0.444,5,7,0.714,0,3,3,6,0,0,0,1,29,-7,1,Kevin Durant,PHX,PHX,NYK,5.0,Assists,38,32,35,9
22023,201142,22300333,"DEC 15, 2023",PHX vs. NYK,L,36,10,21,0.476,4,9,0.444,5,7,0.714,0,3,3,6,0,0,0,1,29,-7,1,Kevin Durant,PHX,PHX,NYK,45.0,Fantasy Score,38,32,35,9
22023,201142,22300333,"DEC 15, 2023",PHX vs. NYK,L,36,10,21,0.476,4,9,0.444,5,7,0.714,0,3,3,6,0,0,0,1,29,-7,1,Kevin Durant,PHX,PHX,NYK,5.5,3-PT Attempted,38,32,35,9
22023,201142,22300333,"DEC 15, 2023",PHX vs. NYK,L,36,10,21,0.476,4,9,0.444,5,7,0.714,0,3,3,6,0,0,0,1,29,-7,1,Kevin Durant,PHX,PHX,NYK,5.5,Free Throws Made,38,32,35,9
22023,201142,22300333,"DEC 15, 2023",PHX vs. NYK,L,36,10,21,0.476,4,9,0.444,5,7,0.714,0,3,3,6,0,0,0,1,29,-7,1,Kevin Durant,PHX,PHX,NYK,18.0,FG Attempted,38,32,35,9
22023,201142,22300333,"DEC 15, 2023",PHX vs. NYK,L,36,10,21,0.476,4,9,0.444,5,7,0.714,0,3,3,6,0,0,0,1,29,-7,1,Kevin Durant,PHX,PHX,NYK,33.5,Pts+Rebs,38,32,35,9
22023,201142,22300333,"DEC 15, 2023",PHX vs. NYK,L,36,10,21,0.476,4,9,0.444,5,7,0.714,0,3,3,6,0,0,0,1,29,-7,1,Kevin Durant,PHX,PHX,NYK,0.5,Dunks,38,32,35,9
22023,201142,22300333,"DEC 15, 2023",PHX vs. NYK,L,36,10,21,0.476,4,9,0.444,5,7,0.714,0,3,3,6,0,0,0,1,29,-7,1,Kevin Durant,PHX,PHX,NYK,32.0,Pts+Asts,38,32,35,9
22023,201142,22300333,"DEC 15, 2023",PHX vs. NYK,L,36,10,21,0.476,4,9,0.444,5,7,0.714,0,3,3,6,0,0,0,1,29,-7,1,Kevin Durant,PHX,PHX,NYK,12.0,Rebs+Asts,38,32,35,9
22023,201142,22300317,"DEC 13, 2023",PHX vs. BKN,L,38,9,18,0.5,1,5,0.2,8,10,0.8,1,5,6,4,1,2,2,3,27,0,1,Kevin Durant,PHX,PHX,BKN,27.0,Points,37,33,31,10
22023,201142,22300317,"DEC 13, 2023",PHX vs. BKN,L,38,9,18,0.5,1,5,0.2,8,10,0.8,1,5,6,4,1,2,2,3,27,0,1,Kevin Durant,PHX,PHX,BKN,6.5,Rebounds,37,33,31,10
22023,201142,22300317,"DEC 13, 2023",PHX vs. BKN,L,38,9,18,0.5,1,5,0.2,8,10,0.8,1,5,6,4,1,2,2,3,27,0,1,Kevin Durant,PHX,PHX,BKN,38.5,Pts+Rebs+Asts,37,33,31,10
22023,201142,22300317,"DEC 13, 2023",PHX vs. BKN,L,38,9,18,0.5,1,5,0.2,8,10,0.8,1,5,6,4,1,2,2,3,27,0,1,Kevin Durant,PHX,PHX,BKN,5.0,Assists,37,33,31,10
22023,201142,22300317,"DEC 13, 2023",PHX vs. BKN,L,38,9,18,0.5,1,5,0.2,8,10,0.8,1,5,6,4,1,2,2,3,27,0,1,Kevin Durant,PHX,PHX,BKN,45.0,Fantasy Score,37,33,31,10
22023,201142,22300317,"DEC 13, 2023",PHX vs. BKN,L,38,9,18,0.5,1,5,0.2,8,10,0.8,1,5,6,4,1,2,2,3,27,0,1,Kevin Durant,PHX,PHX,BKN,5.5,3-PT Attempted,37,33,31,10
22023,201142,22300317,"DEC 13, 2023",PHX vs. BKN,L,38,9,18,0.5,1,5,0.2,8,10,0.8,1,5,6,4,1,2,2,3,27,0,1,Kevin Durant,PHX,PHX,BKN,5.5,Free Throws Made,37,33,31,10
22023,201142,22300317,"DEC 13, 2023",PHX vs. BKN,L,38,9,18,0.5,1,5,0.2,8,10,0.8,1,5,6,4,1,2,2,3,27,0,1,Kevin Durant,PHX,PHX,BKN,18.0,FG Attempted,37,33,31,10
22023,201142,22300317,"DEC 13, 2023",PHX vs. BKN,L,38,9,18,0.5,1,5,0.2,8,10,0.8,1,5,6,4,1,2,2,3,27,0,1,Kevin Durant,PHX,PHX,BKN,33.5,Pts+Rebs,37,33,31,10
22023,201142,22300317,"DEC 13, 2023",PHX vs. BKN,L,38,9,18,0.5,1,5,0.2,8,10,0.8,1,5,6,4,1,2,2,3,27,0,1,Kevin Durant,PHX,PHX,BKN,0.5,Dunks,37,33,31,10
22023,201142,22300317,"DEC 13, 2023",PHX vs. BKN,L,38,9,18,0.5,1,5,0.2,8,10,0.8,1,5,6,4,1,2,2,3,27,0,1,Kevin Durant,PHX,PHX,BKN,32.0,Pts+Asts,37,33,31,10
22023,201142,22300317,"DEC 13, 2023",PHX vs. BKN,L,38,9,18,0.5,1,5,0.2,8,10,0.8,1,5,6,4,1,2,2,3,27,0,1,Kevin Durant,PHX,PHX,BKN,12.0,Rebs+Asts,37,33,31,10
22023,201142,22301203,"DEC 05, 2023",PHX @ LAL,L,39,12,17,0.706,4,7,0.571,3,4,0.75,0,7,7,4,0,1,5,5,31,6,1,Kevin Durant,PHX,LAL,PHX,27.0,Points,42,38,35,11
22023,201142,22301203,"DEC 05, 2023",PHX @ LAL,L,39,12,17,0.706,4,7,0.571,3,4,0.75,0,7,7,4,0,1,5,5,31,6,1,Kevin Durant,PHX,LAL,PHX,6.5,Rebounds,42,38,35,11
22023,201142,22301203,"DEC 05, 2023",PHX @ LAL,L,39,12,17,0.706,4,7,0.571,3,4,0.75,0,7,7,4,0,1,5,5,31,6,1,Kevin Durant,PHX,LAL,PHX,38.5,Pts+Rebs+Asts,42,38,35,11
22023,201142,22301203,"DEC 05, 2023",PHX @ LAL,L,39,12,17,0.706,4,7,0.571,3,4,0.75,0,7,7,4,0,1,5,5,31,6,1,Kevin Durant,PHX,LAL,PHX,5.0,Assists,42,38,35,11
22023,201142,22301203,"DEC 05, 2023",PHX @ LAL,L,39,12,17,0.706,4,7,0.571,3,4,0.75,0,7,7,4,0,1,5,5,31,6,1,Kevin Durant,PHX,LAL,PHX,45.0,Fantasy Score,42,38,35,11
22023,201142,22301203,"DEC 05, 2023",PHX @ LAL,L,39,12,17,0.706,4,7,0.571,3,4,0.75,0,7,7,4,0,1,5,5,31,6,1,Kevin Durant,PHX,LAL,PHX,5.5,3-PT Attempted,42,38,35,11
22023,201142,22301203,"DEC 05, 2023",PHX @ LAL,L,39,12,17,0.706,4,7,0.571,3,4,0.75,0,7,7,4,0,1,5,5,31,6,1,Kevin Durant,PHX,LAL,PHX,5.5,Free Throws Made,42,38,35,11
22023,201142,22301203,"DEC 05, 2023",PHX @ LAL,L,39,12,17,0.706,4,7,0.571,3,4,0.75,0,7,7,4,0,1,5,5,31,6,1,Kevin Durant,PHX,LAL,PHX,18.0,FG Attempted,42,38,35,11
22023,201142,22301203,"DEC 05, 2023",PHX @ LAL,L,39,12,17,0.706,4,7,0.571,3,4,0.75,0,7,7,4,0,1,5,5,31,6,1,Kevin Durant,PHX,LAL,PHX,33.5,Pts+Rebs,42,38,35,11
22023,201142,22301203,"DEC 05, 2023",PHX @ LAL,L,39,12,17,0.706,4,7,0.571,3,4,0.75,0,7,7,4,0,1,5,5,31,6,1,Kevin Durant,PHX,LAL,PHX,0.5,Dunks,42,38,35,11
22023,201142,22301203,"DEC 05, 2023",PHX @ LAL,L,39,12,17,0.706,4,7,0.571,3,4,0.75,0,7,7,4,0,1,5,5,31,6,1,Kevin Durant,PHX,LAL,PHX,32.0,Pts+Asts,42,38,35,11
22023,201142,22301203,"DEC 05, 2023",PHX @ LAL,L,39,12,17,0.706,4,7,0.571,3,4,0.75,0,7,7,4,0,1,5,5,31,6,1,Kevin Durant,PHX,LAL,PHX,12.0,Rebs+Asts,42,38,35,11
22023,201142,22300288,"DEC 02, 2023",PHX vs. MEM,W,33,10,14,0.714,2,3,0.667,5,7,0.714,0,2,2,5,1,1,2,1,27,8,1,Kevin Durant,PHX,PHX,MEM,27.0,Points,34,29,32,7
22023,201142,22300288,"DEC 02, 2023",PHX vs. MEM,W,33,10,14,0.714,2,3,0.667,5,7,0.714,0,2,2,5,1,1,2,1,27,8,1,Kevin Durant,PHX,PHX,MEM,6.5,Rebounds,34,29,32,7
22023,201142,22300288,"DEC 02, 2023",PHX vs. MEM,W,33,10,14,0.714,2,3,0.667,5,7,0.714,0,2,2,5,1,1,2,1,27,8,1,Kevin Durant,PHX,PHX,MEM,38.5,Pts+Rebs+Asts,34,29,32,7
22023,201142,22300288,"DEC 02, 2023",PHX vs. MEM,W,33,10,14,0.714,2,3,0.667,5,7,0.714,0,2,2,5,1,1,2,1,27,8,1,Kevin Durant,PHX,PHX,MEM,5.0,Assists,34,29,32,7
22023,201142,22300288,"DEC 02, 2023",PHX vs. MEM,W,33,10,14,0.714,2,3,0.667,5,7,0.714,0,2,2,5,1,1,2,1,27,8,1,Kevin Durant,PHX,PHX,MEM,45.0,Fantasy Score,34,29,32,7
22023,201142,22300288,"DEC 02, 2023",PHX vs. MEM,W,33,10,14,0.714,2,3,0.667,5,7,0.714,0,2,2,5,1,1,2,1,27,8,1,Kevin Durant,PHX,PHX,MEM,5.5,3-PT Attempted,34,29,32,7
22023,201142,22300288,"DEC 02, 2023",PHX vs. MEM,W,33,10,14,0.714,2,3,0.667,5,7,0.714,0,2,2,5,1,1,2,1,27,8,1,Kevin Durant,PHX,PHX,MEM,5.5,Free Throws Made,34,29,32,7
22023,201142,22300288,"DEC 02, 2023",PHX vs. MEM,W,33,10,14,0.714,2,3,0.667,5,7,0.714,0,2,2,5,1,1,2,1,27,8,1,Kevin Durant,PHX,PHX,MEM,18.0,FG Attempted,34,29,32,7
22023,201142,22300288,"DEC 02, 2023",PHX vs. MEM,W,33,10,14,0.714,2,3,0.667,5,7,0.714,0,2,2,5,1,1,2,1,27,8,1,Kevin Durant,PHX,PHX,MEM,33.5,Pts+Rebs,34,29,32,7
22023,201142,22300288,"DEC 02, 2023",PHX vs. MEM,W,33,10,14,0.714,2,3,0.667,5,7,0.714,0,2,2,5,1,1,2,1,27,8,1,Kevin Durant,PHX,PHX,MEM,0.5,Dunks,34,29,32,7
22023,201142,22300288,"DEC 02, 2023",PHX vs. MEM,W,33,10,14,0.714,2,3,0.667,5,7,0.714,0,2,2,5,1,1,2,1,27,8,1,Kevin Durant,PHX,PHX,MEM,32.0,Pts+Asts,34,29,32,7
22023,201142,22300288,"DEC 02, 2023",PHX vs. MEM,W,33,10,14,0.714,2,3,0.667,5,7,0.714,0,2,2,5,1,1,2,1,27,8,1,Kevin Durant,PHX,PHX,MEM,12.0,Rebs+Asts,34,29,32,7
22023,201142,22300279,"DEC 01, 2023",PHX vs. DEN,L,36,8,25,0.32,1,3,0.333,13,13,1.0,0,4,4,11,1,3,1,2,30,-6,1,Kevin Durant,PHX,PHX,DEN,27.0,Points,45,34,41,15
22023,201142,22300279,"DEC 01, 2023",PHX vs. DEN,L,36,8,25,0.32,1,3,0.333,13,13,1.0,0,4,4,11,1,3,1,2,30,-6,1,Kevin Durant,PHX,PHX,DEN,6.5,Rebounds,45,34,41,15
22023,201142,22300279,"DEC 01, 2023",PHX vs. DEN,L,36,8,25,0.32,1,3,0.333,13,13,1.0,0,4,4,11,1,3,1,2,30,-6,1,Kevin Durant,PHX,PHX,DEN,38.5,Pts+Rebs+Asts,45,34,41,15
22023,201142,22300279,"DEC 01, 2023",PHX vs. DEN,L,36,8,25,0.32,1,3,0.333,13,13,1.0,0,4,4,11,1,3,1,2,30,-6,1,Kevin Durant,PHX,PHX,DEN,5.0,Assists,45,34,41,15
22023,201142,22300279,"DEC 01, 2023",PHX vs. DEN,L,36,8,25,0.32,1,3,0.333,13,13,1.0,0,4,4,11,1,3,1,2,30,-6,1,Kevin Durant,PHX,PHX,DEN,45.0,Fantasy Score,45,34,41,15
22023,201142,22300279,"DEC 01, 2023",PHX vs. DEN,L,36,8,25,0.32,1,3,0.333,13,13,1.0,0,4,4,11,1,3,1,2,30,-6,1,Kevin Durant,PHX,PHX,DEN,5.5,3-PT Attempted,45,34,41,15
22023,201142,22300279,"DEC 01, 2023",PHX vs. DEN,L,36,8,25,0.32,1,3,0.333,13,13,1.0,0,4,4,11,1,3,1,2,30,-6,1,Kevin Durant,PHX,PHX,DEN,5.5,Free Throws Made,45,34,41,15
22023,201142,22300279,"DEC 01, 2023",PHX vs. DEN,L,36,8,25,0.32,1,3,0.333,13,13,1.0,0,4,4,11,1,3,1,2,30,-6,1,Kevin Durant,PHX,PHX,DEN,18.0,FG Attempted,45,34,41,15
22023,201142,22300279,"DEC 01, 2023",PHX vs. DEN,L,36,8,25,0.32,1,3,0.333,13,13,1.0,0,4,4,11,1,3,1,2,30,-6,1,Kevin Durant,PHX,PHX,DEN,33.5,Pts+Rebs,45,34,41,15
22023,201142,22300279,"DEC 01, 2023",PHX vs. DEN,L,36,8,25,0.32,1,3,0.333,13,13,1.0,0,4,4,11,1,3,1,2,30,-6,1,Kevin Durant,PHX,PHX,DEN,0.5,Dunks,45,34,41,15
22023,201142,22300279,"DEC 01, 2023",PHX vs. DEN,L,36,8,25,0.32,1,3,0.333,13,13,1.0,0,4,4,11,1,3,1,2,30,-6,1,Kevin Durant,PHX,PHX,DEN,32.0,Pts+Asts,45,34,41,15
22023,201142,22300279,"DEC 01, 2023",PHX vs. DEN,L,36,8,25,0.32,1,3,0.333,13,13,1.0,0,4,4,11,1,3,1,2,30,-6,1,Kevin Durant,PHX,PHX,DEN,12.0,Rebs+Asts,45,34,41,15
22023,201142,22300260,"NOV 29, 2023",PHX @ TOR,L,36,11,30,0.367,2,8,0.25,6,6,1.0,0,4,4,6,1,0,1,1,30,-1,1,Kevin Durant,PHX,TOR,PHX,27.0,Points,40,34,36,10
22023,201142,22300260,"NOV 29, 2023",PHX @ TOR,L,36,11,30,0.367,2,8,0.25,6,6,1.0,0,4,4,6,1,0,1,1,30,-1,1,Kevin Durant,PHX,TOR,PHX,6.5,Rebounds,40,34,36,10
22023,201142,22300260,"NOV 29, 2023",PHX @ TOR,L,36,11,30,0.367,2,8,0.25,6,6,1.0,0,4,4,6,1,0,1,1,30,-1,1,Kevin Durant,PHX,TOR,PHX,38.5,Pts+Rebs+Asts,40,34,36,10
22023,201142,22300260,"NOV 29, 2023",PHX @ TOR,L,36,11,30,0.367,2,8,0.25,6,6,1.0,0,4,4,6,1,0,1,1,30,-1,1,Kevin Durant,PHX,TOR,PHX,5.0,Assists,40,34,36,10
22023,201142,22300260,"NOV 29, 2023",PHX @ TOR,L,36,11,30,0.367,2,8,0.25,6,6,1.0,0,4,4,6,1,0,1,1,30,-1,1,Kevin Durant,PHX,TOR,PHX,45.0,Fantasy Score,40,34,36,10
22023,201142,22300260,"NOV 29, 2023",PHX @ TOR,L,36,11,30,0.367,2,8,0.25,6,6,1.0,0,4,4,6,1,0,1,1,30,-1,1,Kevin Durant,PHX,TOR,PHX,5.5,3-PT Attempted,40,34,36,10
22023,201142,22300260,"NOV 29, 2023",PHX @ TOR,L,36,11,30,0.367,2,8,0.25,6,6,1.0,0,4,4,6,1,0,1,1,30,-1,1,Kevin Durant,PHX,TOR,PHX,5.5,Free Throws Made,40,34,36,10
22023,201142,22300260,"NOV 29, 2023",PHX @ TOR,L,36,11,30,0.367,2,8,0.25,6,6,1.0,0,4,4,6,1,0,1,1,30,-1,1,Kevin Durant,PHX,TOR,PHX,18.0,FG Attempted,40,34,36,10
22023,201142,22300260,"NOV 29, 2023",PHX @ TOR,L,36,11,30,0.367,2,8,0.25,6,6,1.0,0,4,4,6,1,0,1,1,30,-1,1,Kevin Durant,PHX,TOR,PHX,33.5,Pts+Rebs,40,34,36,10
22023,201142,22300260,"NOV 29, 2023",PHX @ TOR,L,36,11,30,0.367,2,8,0.25,6,6,1.0,0,4,4,6,1,0,1,1,30,-1,1,Kevin Durant,PHX,TOR,PHX,0.5,Dunks,40,34,36,10
22023,201142,22300260,"NOV 29, 2023",PHX @ TOR,L,36,11,30,0.367,2,8,0.25,6,6,1.0,0,4,4,6,1,0,1,1,30,-1,1,Kevin Durant,PHX,TOR,PHX,32.0,Pts+Asts,40,34,36,10
22023,201142,22300260,"NOV 29, 2023",PHX @ TOR,L,36,11,30,0.367,2,8,0.25,6,6,1.0,0,4,4,6,1,0,1,1,30,-1,1,Kevin Durant,PHX,TOR,PHX,12.0,Rebs+Asts,40,34,36,10
22023,201142,22300236,"NOV 22, 2023",PHX vs. GSW,W,34,7,14,0.5,3,4,0.75,15,15,1.0,0,8,8,2,0,2,6,2,32,5,1,Kevin Durant,PHX,PHX,GSW,27.0,Points,42,40,34,10
22023,201142,22300236,"NOV 22, 2023",PHX vs. GSW,W,34,7,14,0.5,3,4,0.75,15,15,1.0,0,8,8,2,0,2,6,2,32,5,1,Kevin Durant,PHX,PHX,GSW,6.5,Rebounds,42,40,34,10
22023,201142,22300236,"NOV 22, 2023",PHX vs. GSW,W,34,7,14,0.5,3,4,0.75,15,15,1.0,0,8,8,2,0,2,6,2,32,5,1,Kevin Durant,PHX,PHX,GSW,38.5,Pts+Rebs+Asts,42,40,34,10
22023,201142,22300236,"NOV 22, 2023",PHX vs. GSW,W,34,7,14,0.5,3,4,0.75,15,15,1.0,0,8,8,2,0,2,6,2,32,5,1,Kevin Durant,PHX,PHX,GSW,5.0,Assists,42,40,34,10
22023,201142,22300236,"NOV 22, 2023",PHX vs. GSW,W,34,7,14,0.5,3,4,0.75,15,15,1.0,0,8,8,2,0,2,6,2,32,5,1,Kevin Durant,PHX,PHX,GSW,45.0,Fantasy Score,42,40,34,10
22023,201142,22300236,"NOV 22, 2023",PHX vs. GSW,W,34,7,14,0.5,3,4,0.75,15,15,1.0,0,8,8,2,0,2,6,2,32,5,1,Kevin Durant,PHX,PHX,GSW,5.5,3-PT Attempted,42,40,34,10
22023,201142,22300236,"NOV 22, 2023",PHX vs. GSW,W,34,7,14,0.5,3,4,0.75,15,15,1.0,0,8,8,2,0,2,6,2,32,5,1,Kevin Durant,PHX,PHX,GSW,5.5,Free Throws Made,42,40,34,10
22023,201142,22300236,"NOV 22, 2023",PHX vs. GSW,W,34,7,14,0.5,3,4,0.75,15,15,1.0,0,8,8,2,0,2,6,2,32,5,1,Kevin Durant,PHX,PHX,GSW,18.0,FG Attempted,42,40,34,10
22023,201142,22300236,"NOV 22, 2023",PHX vs. GSW,W,34,7,14,0.5,3,4,0.75,15,15,1.0,0,8,8,2,0,2,6,2,32,5,1,Kevin Durant,PHX,PHX,GSW,33.5,Pts+Rebs,42,40,34,10
22023,201142,22300236,"NOV 22, 2023",PHX vs. GSW,W,34,7,14,0.5,3,4,0.75,15,15,1.0,0,8,8,2,0,2,6,2,32,5,1,Kevin Durant,PHX,PHX,GSW,0.5,Dunks,42,40,34,10
22023,201142,22300236,"NOV 22, 2023",PHX vs. GSW,W,34,7,14,0.5,3,4,0.75,15,15,1.0,0,8,8,2,0,2,6,2,32,5,1,Kevin Durant,PHX,PHX,GSW,32.0,Pts+Asts,42,40,34,10
22023,201142,22300236,"NOV 22, 2023",PHX vs. GSW,W,34,7,14,0.5,3,4,0.75,15,15,1.0,0,8,8,2,0,2,6,2,32,5,1,Kevin Durant,PHX,PHX,GSW,12.0,Rebs+Asts,42,40,34,10
22023,201142,22300041,"NOV 21, 2023",PHX vs. POR,W,37,13,21,0.619,2,2,1.0,3,3,1.0,0,4,4,9,0,1,3,4,31,20,1,Kevin Durant,PHX,PHX,POR,27.0,Points,44,35,40,13
22023,201142,22300041,"NOV 21, 2023",PHX vs. POR,W,37,13,21,0.619,2,2,1.0,3,3,1.0,0,4,4,9,0,1,3,4,31,20,1,Kevin Durant,PHX,PHX,POR,6.5,Rebounds,44,35,40,13
22023,201142,22300041,"NOV 21, 2023",PHX vs. POR,W,37,13,21,0.619,2,2,1.0,3,3,1.0,0,4,4,9,0,1,3,4,31,20,1,Kevin Durant,PHX,PHX,POR,38.5,Pts+Rebs+Asts,44,35,40,13
22023,201142,22300041,"NOV 21, 2023",PHX vs. POR,W,37,13,21,0.619,2,2,1.0,3,3,1.0,0,4,4,9,0,1,3,4,31,20,1,Kevin Durant,PHX,PHX,POR,5.0,Assists,44,35,40,13
22023,201142,22300041,"NOV 21, 2023",PHX vs. POR,W,37,13,21,0.619,2,2,1.0,3,3,1.0,0,4,4,9,0,1,3,4,31,20,1,Kevin Durant,PHX,PHX,POR,45.0,Fantasy Score,44,35,40,13
22023,201142,22300041,"NOV 21, 2023",PHX vs. POR,W,37,13,21,0.619,2,2,1.0,3,3,1.0,0,4,4,9,0,1,3,4,31,20,1,Kevin Durant,PHX,PHX,POR,5.5,3-PT Attempted,44,35,40,13
22023,201142,22300041,"NOV 21, 2023",PHX vs. POR,W,37,13,21,0.619,2,2,1.0,3,3,1.0,0,4,4,9,0,1,3,4,31,20,1,Kevin Durant,PHX,PHX,POR,5.5,Free Throws Made,44,35,40,13
22023,201142,22300041,"NOV 21, 2023",PHX vs. POR,W,37,13,21,0.619,2,2,1.0,3,3,1.0,0,4,4,9,0,1,3,4,31,20,1,Kevin Durant,PHX,PHX,POR,18.0,FG Attempted,44,35,40,13
22023,201142,22300041,"NOV 21, 2023",PHX vs. POR,W,37,13,21,0.619,2,2,1.0,3,3,1.0,0,4,4,9,0,1,3,4,31,20,1,Kevin Durant,PHX,PHX,POR,33.5,Pts+Rebs,44,35,40,13
22023,201142,22300041,"NOV 21, 2023",PHX vs. POR,W,37,13,21,0.619,2,2,1.0,3,3,1.0,0,4,4,9,0,1,3,4,31,20,1,Kevin Durant,PHX,PHX,POR,0.5,Dunks,44,35,40,13
22023,201142,22300041,"NOV 21, 2023",PHX vs. POR,W,37,13,21,0.619,2,2,1.0,3,3,1.0,0,4,4,9,0,1,3,4,31,20,1,Kevin Durant,PHX,PHX,POR,32.0,Pts+Asts,44,35,40,13
22023,201142,22300041,"NOV 21, 2023",PHX vs. POR,W,37,13,21,0.619,2,2,1.0,3,3,1.0,0,4,4,9,0,1,3,4,31,20,1,Kevin Durant,PHX,PHX,POR,12.0,Rebs+Asts,44,35,40,13
22023,201142,22300214,"NOV 19, 2023",PHX @ UTA,W,46,14,27,0.519,4,9,0.444,7,7,1.0,0,8,8,10,2,2,7,2,39,4,1,Kevin Durant,PHX,UTA,PHX,27.0,Points,57,47,49,18
22023,201142,22300214,"NOV 19, 2023",PHX @ UTA,W,46,14,27,0.519,4,9,0.444,7,7,1.0,0,8,8,10,2,2,7,2,39,4,1,Kevin Durant,PHX,UTA,PHX,6.5,Rebounds,57,47,49,18
22023,201142,22300214,"NOV 19, 2023",PHX @ UTA,W,46,14,27,0.519,4,9,0.444,7,7,1.0,0,8,8,10,2,2,7,2,39,4,1,Kevin Durant,PHX,UTA,PHX,38.5,Pts+Rebs+Asts,57,47,49,18
22023,201142,22300214,"NOV 19, 2023",PHX @ UTA,W,46,14,27,0.519,4,9,0.444,7,7,1.0,0,8,8,10,2,2,7,2,39,4,1,Kevin Durant,PHX,UTA,PHX,5.0,Assists,57,47,49,18
22023,201142,22300214,"NOV 19, 2023",PHX @ UTA,W,46,14,27,0.519,4,9,0.444,7,7,1.0,0,8,8,10,2,2,7,2,39,4,1,Kevin Durant,PHX,UTA,PHX,45.0,Fantasy Score,57,47,49,18
22023,201142,22300214,"NOV 19, 2023",PHX @ UTA,W,46,14,27,0.519,4,9,0.444,7,7,1.0,0,8,8,10,2,2,7,2,39,4,1,Kevin Durant,PHX,UTA,PHX,5.5,3-PT Attempted,57,47,49,18
22023,201142,22300214,"NOV 19, 2023",PHX @ UTA,W,46,14,27,0.519,4,9,0.444,7,7,1.0,0,8,8,10,2,2,7,2,39,4,1,Kevin Durant,PHX,UTA,PHX,5.5,Free Throws Made,57,47,49,18
22023,201142,22300214,"NOV 19, 2023",PHX @ UTA,W,46,14,27,0.519,4,9,0.444,7,7,1.0,0,8,8,10,2,2,7,2,39,4,1,Kevin Durant,PHX,UTA,PHX,18.0,FG Attempted,57,47,49,18
22023,201142,22300214,"NOV 19, 2023",PHX @ UTA,W,46,14,27,0.519,4,9,0.444,7,7,1.0,0,8,8,10,2,2,7,2,39,4,1,Kevin Durant,PHX,UTA,PHX,33.5,Pts+Rebs,57,47,49,18
22023,201142,22300214,"NOV 19, 2023",PHX @ UTA,W,46,14,27,0.519,4,9,0.444,7,7,1.0,0,8,8,10,2,2,7,2,39,4,1,Kevin Durant,PHX,UTA,PHX,0.5,Dunks,57,47,49,18
22023,201142,22300214,"NOV 19, 2023",PHX @ UTA,W,46,14,27,0.519,4,9,0.444,7,7,1.0,0,8,8,10,2,2,7,2,39,4,1,Kevin Durant,PHX,UTA,PHX,32.0,Pts+Asts,57,47,49,18
22023,201142,22300214,"NOV 19, 2023",PHX @ UTA,W,46,14,27,0.519,4,9,0.444,7,7,1.0,0,8,8,10,2,2,7,2,39,4,1,Kevin Durant,PHX,UTA,PHX,12.0,Rebs+Asts,57,47,49,18
22023,201142,22300035,"NOV 17, 2023",PHX @ UTA,W,33,15,22,0.682,6,8,0.75,2,2,1.0,0,9,9,9,0,0,1,1,38,-8,1,Kevin Durant,PHX,UTA,PHX,27.0,Points,56,47,47,18
22023,201142,22300035,"NOV 17, 2023",PHX @ UTA,W,33,15,22,0.682,6,8,0.75,2,2,1.0,0,9,9,9,0,0,1,1,38,-8,1,Kevin Durant,PHX,UTA,PHX,6.5,Rebounds,56,47,47,18
22023,201142,22300035,"NOV 17, 2023",PHX @ UTA,W,33,15,22,0.682,6,8,0.75,2,2,1.0,0,9,9,9,0,0,1,1,38,-8,1,Kevin Durant,PHX,UTA,PHX,38.5,Pts+Rebs+Asts,56,47,47,18
22023,201142,22300035,"NOV 17, 2023",PHX @ UTA,W,33,15,22,0.682,6,8,0.75,2,2,1.0,0,9,9,9,0,0,1,1,38,-8,1,Kevin Durant,PHX,UTA,PHX,5.0,Assists,56,47,47,18
22023,201142,22300035,"NOV 17, 2023",PHX @ UTA,W,33,15,22,0.682,6,8,0.75,2,2,1.0,0,9,9,9,0,0,1,1,38,-8,1,Kevin Durant,PHX,UTA,PHX,45.0,Fantasy Score,56,47,47,18
22023,201142,22300035,"NOV 17, 2023",PHX @ UTA,W,33,15,22,0.682,6,8,0.75,2,2,1.0,0,9,9,9,0,0,1,1,38,-8,1,Kevin Durant,PHX,UTA,PHX,5.5,3-PT Attempted,56,47,47,18
22023,201142,22300035,"NOV 17, 2023",PHX @ UTA,W,33,15,22,0.682,6,8,0.75,2,2,1.0,0,9,9,9,0,0,1,1,38,-8,1,Kevin Durant,PHX,UTA,PHX,5.5,Free Throws Made,56,47,47,18
22023,201142,22300035,"NOV 17, 2023",PHX @ UTA,W,33,15,22,0.682,6,8,0.75,2,2,1.0,0,9,9,9,0,0,1,1,38,-8,1,Kevin Durant,PHX,UTA,PHX,18.0,FG Attempted,56,47,47,18
22023,201142,22300035,"NOV 17, 2023",PHX @ UTA,W,33,15,22,0.682,6,8,0.75,2,2,1.0,0,9,9,9,0,0,1,1,38,-8,1,Kevin Durant,PHX,UTA,PHX,33.5,Pts+Rebs,56,47,47,18
22023,201142,22300035,"NOV 17, 2023",PHX @ UTA,W,33,15,22,0.682,6,8,0.75,2,2,1.0,0,9,9,9,0,0,1,1,38,-8,1,Kevin Durant,PHX,UTA,PHX,0.5,Dunks,56,47,47,18
22023,201142,22300035,"NOV 17, 2023",PHX @ UTA,W,33,15,22,0.682,6,8,0.75,2,2,1.0,0,9,9,9,0,0,1,1,38,-8,1,Kevin Durant,PHX,UTA,PHX,32.0,Pts+Asts,56,47,47,18
22023,201142,22300035,"NOV 17, 2023",PHX @ UTA,W,33,15,22,0.682,6,8,0.75,2,2,1.0,0,9,9,9,0,0,1,1,38,-8,1,Kevin Durant,PHX,UTA,PHX,12.0,Rebs+Asts,56,47,47,18
22023,201142,22300197,"NOV 15, 2023",PHX vs. MIN,W,35,11,15,0.733,2,2,1.0,7,7,1.0,0,6,6,6,0,1,2,3,31,27,1,Kevin Durant,PHX,PHX,MIN,27.0,Points,43,37,37,12
22023,201142,22300197,"NOV 15, 2023",PHX vs. MIN,W,35,11,15,0.733,2,2,1.0,7,7,1.0,0,6,6,6,0,1,2,3,31,27,1,Kevin Durant,PHX,PHX,MIN,6.5,Rebounds,43,37,37,12
22023,201142,22300197,"NOV 15, 2023",PHX vs. MIN,W,35,11,15,0.733,2,2,1.0,7,7,1.0,0,6,6,6,0,1,2,3,31,27,1,Kevin Durant,PHX,PHX,MIN,38.5,Pts+Rebs+Asts,43,37,37,12
22023,201142,22300197,"NOV 15, 2023",PHX vs. MIN,W,35,11,15,0.733,2,2,1.0,7,7,1.0,0,6,6,6,0,1,2,3,31,27,1,Kevin Durant,PHX,PHX,MIN,5.0,Assists,43,37,37,12
22023,201142,22300197,"NOV 15, 2023",PHX vs. MIN,W,35,11,15,0.733,2,2,1.0,7,7,1.0,0,6,6,6,0,1,2,3,31,27,1,Kevin Durant,PHX,PHX,MIN,45.0,Fantasy Score,43,37,37,12
22023,201142,22300197,"NOV 15, 2023",PHX vs. MIN,W,35,11,15,0.733,2,2,1.0,7,7,1.0,0,6,6,6,0,1,2,3,31,27,1,Kevin Durant,PHX,PHX,MIN,5.5,3-PT Attempted,43,37,37,12
22023,201142,22300197,"NOV 15, 2023",PHX vs. MIN,W,35,11,15,0.733,2,2,1.0,7,7,1.0,0,6,6,6,0,1,2,3,31,27,1,Kevin Durant,PHX,PHX,MIN,5.5,Free Throws Made,43,37,37,12
22023,201142,22300197,"NOV 15, 2023",PHX vs. MIN,W,35,11,15,0.733,2,2,1.0,7,7,1.0,0,6,6,6,0,1,2,3,31,27,1,Kevin Durant,PHX,PHX,MIN,18.0,FG Attempted,43,37,37,12
22023,201142,22300197,"NOV 15, 2023",PHX vs. MIN,W,35,11,15,0.733,2,2,1.0,7,7,1.0,0,6,6,6,0,1,2,3,31,27,1,Kevin Durant,PHX,PHX,MIN,33.5,Pts+Rebs,43,37,37,12
22023,201142,22300197,"NOV 15, 2023",PHX vs. MIN,W,35,11,15,0.733,2,2,1.0,7,7,1.0,0,6,6,6,0,1,2,3,31,27,1,Kevin Durant,PHX,PHX,MIN,0.5,Dunks,43,37,37,12
22023,201142,22300197,"NOV 15, 2023",PHX vs. MIN,W,35,11,15,0.733,2,2,1.0,7,7,1.0,0,6,6,6,0,1,2,3,31,27,1,Kevin Durant,PHX,PHX,MIN,32.0,Pts+Asts,43,37,37,12
22023,201142,22300197,"NOV 15, 2023",PHX vs. MIN,W,35,11,15,0.733,2,2,1.0,7,7,1.0,0,6,6,6,0,1,2,3,31,27,1,Kevin Durant,PHX,PHX,MIN,12.0,Rebs+Asts,43,37,37,12
22023,201142,22300185,"NOV 12, 2023",PHX vs. OKC,L,36,7,18,0.389,3,5,0.6,11,11,1.0,0,9,9,4,1,2,3,1,28,-13,1,Kevin Durant,PHX,PHX,OKC,27.0,Points,41,37,32,13
22023,201142,22300185,"NOV 12, 2023",PHX vs. OKC,L,36,7,18,0.389,3,5,0.6,11,11,1.0,0,9,9,4,1,2,3,1,28,-13,1,Kevin Durant,PHX,PHX,OKC,6.5,Rebounds,41,37,32,13
22023,201142,22300185,"NOV 12, 2023",PHX vs. OKC,L,36,7,18,0.389,3,5,0.6,11,11,1.0,0,9,9,4,1,2,3,1,28,-13,1,Kevin Durant,PHX,PHX,OKC,38.5,Pts+Rebs+Asts,41,37,32,13
22023,201142,22300185,"NOV 12, 2023",PHX vs. OKC,L,36,7,18,0.389,3,5,0.6,11,11,1.0,0,9,9,4,1,2,3,1,28,-13,1,Kevin Durant,PHX,PHX,OKC,5.0,Assists,41,37,32,13
22023,201142,22300185,"NOV 12, 2023",PHX vs. OKC,L,36,7,18,0.389,3,5,0.6,11,11,1.0,0,9,9,4,1,2,3,1,28,-13,1,Kevin Durant,PHX,PHX,OKC,45.0,Fantasy Score,41,37,32,13
22023,201142,22300185,"NOV 12, 2023",PHX vs. OKC,L,36,7,18,0.389,3,5,0.6,11,11,1.0,0,9,9,4,1,2,3,1,28,-13,1,Kevin Durant,PHX,PHX,OKC,5.5,3-PT Attempted,41,37,32,13
22023,201142,22300185,"NOV 12, 2023",PHX vs. OKC,L,36,7,18,0.389,3,5,0.6,11,11,1.0,0,9,9,4,1,2,3,1,28,-13,1,Kevin Durant,PHX,PHX,OKC,5.5,Free Throws Made,41,37,32,13
22023,201142,22300185,"NOV 12, 2023",PHX vs. OKC,L,36,7,18,0.389,3,5,0.6,11,11,1.0,0,9,9,4,1,2,3,1,28,-13,1,Kevin Durant,PHX,PHX,OKC,18.0,FG Attempted,41,37,32,13
22023,201142,22300185,"NOV 12, 2023",PHX vs. OKC,L,36,7,18,0.389,3,5,0.6,11,11,1.0,0,9,9,4,1,2,3,1,28,-13,1,Kevin Durant,PHX,PHX,OKC,33.5,Pts+Rebs,41,37,32,13
22023,201142,22300185,"NOV 12, 2023",PHX vs. OKC,L,36,7,18,0.389,3,5,0.6,11,11,1.0,0,9,9,4,1,2,3,1,28,-13,1,Kevin Durant,PHX,PHX,OKC,0.5,Dunks,41,37,32,13
22023,201142,22300185,"NOV 12, 2023",PHX vs. OKC,L,36,7,18,0.389,3,5,0.6,11,11,1.0,0,9,9,4,1,2,3,1,28,-13,1,Kevin Durant,PHX,PHX,OKC,32.0,Pts+Asts,41,37,32,13
22023,201142,22300185,"NOV 12, 2023",PHX vs. OKC,L,36,7,18,0.389,3,5,0.6,11,11,1.0,0,9,9,4,1,2,3,1,28,-13,1,Kevin Durant,PHX,PHX,OKC,12.0,Rebs+Asts,41,37,32,13
22023,201142,22300015,"NOV 10, 2023",PHX vs. LAL,L,39,13,27,0.481,4,6,0.667,8,10,0.8,1,8,9,5,0,0,4,4,38,8,1,Kevin Durant,PHX,PHX,LAL,27.0,Points,52,47,43,14
22023,201142,22300015,"NOV 10, 2023",PHX vs. LAL,L,39,13,27,0.481,4,6,0.667,8,10,0.8,1,8,9,5,0,0,4,4,38,8,1,Kevin Durant,PHX,PHX,LAL,6.5,Rebounds,52,47,43,14
22023,201142,22300015,"NOV 10, 2023",PHX vs. LAL,L,39,13,27,0.481,4,6,0.667,8,10,0.8,1,8,9,5,0,0,4,4,38,8,1,Kevin Durant,PHX,PHX,LAL,38.5,Pts+Rebs+Asts,52,47,43,14
22023,201142,22300015,"NOV 10, 2023",PHX vs. LAL,L,39,13,27,0.481,4,6,0.667,8,10,0.8,1,8,9,5,0,0,4,4,38,8,1,Kevin Durant,PHX,PHX,LAL,5.0,Assists,52,47,43,14
22023,201142,22300015,"NOV 10, 2023",PHX vs. LAL,L,39,13,27,0.481,4,6,0.667,8,10,0.8,1,8,9,5,0,0,4,4,38,8,1,Kevin Durant,PHX,PHX,LAL,45.0,Fantasy Score,52,47,43,14
22023,201142,22300015,"NOV 10, 2023",PHX vs. LAL,L,39,13,27,0.481,4,6,0.667,8,10,0.8,1,8,9,5,0,0,4,4,38,8,1,Kevin Durant,PHX,PHX,LAL,5.5,3-PT Attempted,52,47,43,14
22023,201142,22300015,"NOV 10, 2023",PHX vs. LAL,L,39,13,27,0.481,4,6,0.667,8,10,0.8,1,8,9,5,0,0,4,4,38,8,1,Kevin Durant,PHX,PHX,LAL,5.5,Free Throws Made,52,47,43,14
22023,201142,22300015,"NOV 10, 2023",PHX vs. LAL,L,39,13,27,0.481,4,6,0.667,8,10,0.8,1,8,9,5,0,0,4,4,38,8,1,Kevin Durant,PHX,PHX,LAL,18.0,FG Attempted,52,47,43,14
22023,201142,22300015,"NOV 10, 2023",PHX vs. LAL,L,39,13,27,0.481,4,6,0.667,8,10,0.8,1,8,9,5,0,0,4,4,38,8,1,Kevin Durant,PHX,PHX,LAL,33.5,Pts+Rebs,52,47,43,14
22023,201142,22300015,"NOV 10, 2023",PHX vs. LAL,L,39,13,27,0.481,4,6,0.667,8,10,0.8,1,8,9,5,0,0,4,4,38,8,1,Kevin Durant,PHX,PHX,LAL,0.5,Dunks,52,47,43,14
22023,201142,22300015,"NOV 10, 2023",PHX vs. LAL,L,39,13,27,0.481,4,6,0.667,8,10,0.8,1,8,9,5,0,0,4,4,38,8,1,Kevin Durant,PHX,PHX,LAL,32.0,Pts+Asts,52,47,43,14
22023,201142,22300015,"NOV 10, 2023",PHX vs. LAL,L,39,13,27,0.481,4,6,0.667,8,10,0.8,1,8,9,5,0,0,4,4,38,8,1,Kevin Durant,PHX,PHX,LAL,12.0,Rebs+Asts,52,47,43,14
22023,201142,22300162,"NOV 08, 2023",PHX @ CHI,W,42,7,16,0.438,2,5,0.4,9,9,1.0,1,6,7,9,2,1,6,2,25,5,1,Kevin Durant,PHX,CHI,PHX,27.0,Points,41,32,34,16
22023,201142,22300162,"NOV 08, 2023",PHX @ CHI,W,42,7,16,0.438,2,5,0.4,9,9,1.0,1,6,7,9,2,1,6,2,25,5,1,Kevin Durant,PHX,CHI,PHX,6.5,Rebounds,41,32,34,16
22023,201142,22300162,"NOV 08, 2023",PHX @ CHI,W,42,7,16,0.438,2,5,0.4,9,9,1.0,1,6,7,9,2,1,6,2,25,5,1,Kevin Durant,PHX,CHI,PHX,38.5,Pts+Rebs+Asts,41,32,34,16
22023,201142,22300162,"NOV 08, 2023",PHX @ CHI,W,42,7,16,0.438,2,5,0.4,9,9,1.0,1,6,7,9,2,1,6,2,25,5,1,Kevin Durant,PHX,CHI,PHX,5.0,Assists,41,32,34,16
22023,201142,22300162,"NOV 08, 2023",PHX @ CHI,W,42,7,16,0.438,2,5,0.4,9,9,1.0,1,6,7,9,2,1,6,2,25,5,1,Kevin Durant,PHX,CHI,PHX,45.0,Fantasy Score,41,32,34,16
22023,201142,22300162,"NOV 08, 2023",PHX @ CHI,W,42,7,16,0.438,2,5,0.4,9,9,1.0,1,6,7,9,2,1,6,2,25,5,1,Kevin Durant,PHX,CHI,PHX,5.5,3-PT Attempted,41,32,34,16
22023,201142,22300162,"NOV 08, 2023",PHX @ CHI,W,42,7,16,0.438,2,5,0.4,9,9,1.0,1,6,7,9,2,1,6,2,25,5,1,Kevin Durant,PHX,CHI,PHX,5.5,Free Throws Made,41,32,34,16
22023,201142,22300162,"NOV 08, 2023",PHX @ CHI,W,42,7,16,0.438,2,5,0.4,9,9,1.0,1,6,7,9,2,1,6,2,25,5,1,Kevin Durant,PHX,CHI,PHX,18.0,FG Attempted,41,32,34,16
22023,201142,22300162,"NOV 08, 2023",PHX @ CHI,W,42,7,16,0.438,2,5,0.4,9,9,1.0,1,6,7,9,2,1,6,2,25,5,1,Kevin Durant,PHX,CHI,PHX,33.5,Pts+Rebs,41,32,34,16
22023,201142,22300162,"NOV 08, 2023",PHX @ CHI,W,42,7,16,0.438,2,5,0.4,9,9,1.0,1,6,7,9,2,1,6,2,25,5,1,Kevin Durant,PHX,CHI,PHX,0.5,Dunks,41,32,34,16
22023,201142,22300162,"NOV 08, 2023",PHX @ CHI,W,42,7,16,0.438,2,5,0.4,9,9,1.0,1,6,7,9,2,1,6,2,25,5,1,Kevin Durant,PHX,CHI,PHX,32.0,Pts+Asts,41,32,34,16
22023,201142,22300162,"NOV 08, 2023",PHX @ CHI,W,42,7,16,0.438,2,5,0.4,9,9,1.0,1,6,7,9,2,1,6,2,25,5,1,Kevin Durant,PHX,CHI,PHX,12.0,Rebs+Asts,41,32,34,16
22023,201142,22300140,"NOV 05, 2023",PHX @ DET,W,35,14,27,0.519,1,3,0.333,12,12,1.0,0,4,4,5,1,2,3,1,41,7,1,Kevin Durant,PHX,DET,PHX,27.0,Points,50,45,46,9
22023,201142,22300140,"NOV 05, 2023",PHX @ DET,W,35,14,27,0.519,1,3,0.333,12,12,1.0,0,4,4,5,1,2,3,1,41,7,1,Kevin Durant,PHX,DET,PHX,6.5,Rebounds,50,45,46,9
22023,201142,22300140,"NOV 05, 2023",PHX @ DET,W,35,14,27,0.519,1,3,0.333,12,12,1.0,0,4,4,5,1,2,3,1,41,7,1,Kevin Durant,PHX,DET,PHX,38.5,Pts+Rebs+Asts,50,45,46,9
22023,201142,22300140,"NOV 05, 2023",PHX @ DET,W,35,14,27,0.519,1,3,0.333,12,12,1.0,0,4,4,5,1,2,3,1,41,7,1,Kevin Durant,PHX,DET,PHX,5.0,Assists,50,45,46,9
22023,201142,22300140,"NOV 05, 2023",PHX @ DET,W,35,14,27,0.519,1,3,0.333,12,12,1.0,0,4,4,5,1,2,3,1,41,7,1,Kevin Durant,PHX,DET,PHX,45.0,Fantasy Score,50,45,46,9
22023,201142,22300140,"NOV 05, 2023",PHX @ DET,W,35,14,27,0.519,1,3,0.333,12,12,1.0,0,4,4,5,1,2,3,1,41,7,1,Kevin Durant,PHX,DET,PHX,5.5,3-PT Attempted,50,45,46,9
22023,201142,22300140,"NOV 05, 2023",PHX @ DET,W,35,14,27,0.519,1,3,0.333,12,12,1.0,0,4,4,5,1,2,3,1,41,7,1,Kevin Durant,PHX,DET,PHX,5.5,Free Throws Made,50,45,46,9
22023,201142,22300140,"NOV 05, 2023",PHX @ DET,W,35,14,27,0.519,1,3,0.333,12,12,1.0,0,4,4,5,1,2,3,1,41,7,1,Kevin Durant,PHX,DET,PHX,18.0,FG Attempted,50,45,46,9
22023,201142,22300140,"NOV 05, 2023",PHX @ DET,W,35,14,27,0.519,1,3,0.333,12,12,1.0,0,4,4,5,1,2,3,1,41,7,1,Kevin Durant,PHX,DET,PHX,33.5,Pts+Rebs,50,45,46,9
22023,201142,22300140,"NOV 05, 2023",PHX @ DET,W,35,14,27,0.519,1,3,0.333,12,12,1.0,0,4,4,5,1,2,3,1,41,7,1,Kevin Durant,PHX,DET,PHX,0.5,Dunks,50,45,46,9
22023,201142,22300140,"NOV 05, 2023",PHX @ DET,W,35,14,27,0.519,1,3,0.333,12,12,1.0,0,4,4,5,1,2,3,1,41,7,1,Kevin Durant,PHX,DET,PHX,32.0,Pts+Asts,50,45,46,9
22023,201142,22300140,"NOV 05, 2023",PHX @ DET,W,35,14,27,0.519,1,3,0.333,12,12,1.0,0,4,4,5,1,2,3,1,41,7,1,Kevin Durant,PHX,DET,PHX,12.0,Rebs+Asts,50,45,46,9
22023,201142,22300132,"NOV 04, 2023",PHX @ PHI,L,36,9,20,0.45,1,4,0.25,12,14,0.857,1,7,8,3,1,2,5,1,31,-13,1,Kevin Durant,PHX,PHI,PHX,27.0,Points,42,39,34,11
22023,201142,22300132,"NOV 04, 2023",PHX @ PHI,L,36,9,20,0.45,1,4,0.25,12,14,0.857,1,7,8,3,1,2,5,1,31,-13,1,Kevin Durant,PHX,PHI,PHX,6.5,Rebounds,42,39,34,11
22023,201142,22300132,"NOV 04, 2023",PHX @ PHI,L,36,9,20,0.45,1,4,0.25,12,14,0.857,1,7,8,3,1,2,5,1,31,-13,1,Kevin Durant,PHX,PHI,PHX,38.5,Pts+Rebs+Asts,42,39,34,11
22023,201142,22300132,"NOV 04, 2023",PHX @ PHI,L,36,9,20,0.45,1,4,0.25,12,14,0.857,1,7,8,3,1,2,5,1,31,-13,1,Kevin Durant,PHX,PHI,PHX,5.0,Assists,42,39,34,11
22023,201142,22300132,"NOV 04, 2023",PHX @ PHI,L,36,9,20,0.45,1,4,0.25,12,14,0.857,1,7,8,3,1,2,5,1,31,-13,1,Kevin Durant,PHX,PHI,PHX,45.0,Fantasy Score,42,39,34,11
22023,201142,22300132,"NOV 04, 2023",PHX @ PHI,L,36,9,20,0.45,1,4,0.25,12,14,0.857,1,7,8,3,1,2,5,1,31,-13,1,Kevin Durant,PHX,PHI,PHX,5.5,3-PT Attempted,42,39,34,11
22023,201142,22300132,"NOV 04, 2023",PHX @ PHI,L,36,9,20,0.45,1,4,0.25,12,14,0.857,1,7,8,3,1,2,5,1,31,-13,1,Kevin Durant,PHX,PHI,PHX,5.5,Free Throws Made,42,39,34,11
22023,201142,22300132,"NOV 04, 2023",PHX @ PHI,L,36,9,20,0.45,1,4,0.25,12,14,0.857,1,7,8,3,1,2,5,1,31,-13,1,Kevin Durant,PHX,PHI,PHX,18.0,FG Attempted,42,39,34,11
22023,201142,22300132,"NOV 04, 2023",PHX @ PHI,L,36,9,20,0.45,1,4,0.25,12,14,0.857,1,7,8,3,1,2,5,1,31,-13,1,Kevin Durant,PHX,PHI,PHX,33.5,Pts+Rebs,42,39,34,11
22023,201142,22300132,"NOV 04, 2023",PHX @ PHI,L,36,9,20,0.45,1,4,0.25,12,14,0.857,1,7,8,3,1,2,5,1,31,-13,1,Kevin Durant,PHX,PHI,PHX,0.5,Dunks,42,39,34,11
22023,201142,22300132,"NOV 04, 2023",PHX @ PHI,L,36,9,20,0.45,1,4,0.25,12,14,0.857,1,7,8,3,1,2,5,1,31,-13,1,Kevin Durant,PHX,PHI,PHX,32.0,Pts+Asts,42,39,34,11
22023,201142,22300132,"NOV 04, 2023",PHX @ PHI,L,36,9,20,0.45,1,4,0.25,12,14,0.857,1,7,8,3,1,2,5,1,31,-13,1,Kevin Durant,PHX,PHI,PHX,12.0,Rebs+Asts,42,39,34,11
22023,201142,22300131,"NOV 02, 2023",PHX vs. SAS,L,37,10,15,0.667,3,5,0.6,5,9,0.556,0,6,6,1,0,2,3,3,28,-17,1,Kevin Durant,PHX,PHX,SAS,27.0,Points,35,34,29,7
22023,201142,22300131,"NOV 02, 2023",PHX vs. SAS,L,37,10,15,0.667,3,5,0.6,5,9,0.556,0,6,6,1,0,2,3,3,28,-17,1,Kevin Durant,PHX,PHX,SAS,6.5,Rebounds,35,34,29,7
22023,201142,22300131,"NOV 02, 2023",PHX vs. SAS,L,37,10,15,0.667,3,5,0.6,5,9,0.556,0,6,6,1,0,2,3,3,28,-17,1,Kevin Durant,PHX,PHX,SAS,38.5,Pts+Rebs+Asts,35,34,29,7
22023,201142,22300131,"NOV 02, 2023",PHX vs. SAS,L,37,10,15,0.667,3,5,0.6,5,9,0.556,0,6,6,1,0,2,3,3,28,-17,1,Kevin Durant,PHX,PHX,SAS,5.0,Assists,35,34,29,7
22023,201142,22300131,"NOV 02, 2023",PHX vs. SAS,L,37,10,15,0.667,3,5,0.6,5,9,0.556,0,6,6,1,0,2,3,3,28,-17,1,Kevin Durant,PHX,PHX,SAS,45.0,Fantasy Score,35,34,29,7
22023,201142,22300131,"NOV 02, 2023",PHX vs. SAS,L,37,10,15,0.667,3,5,0.6,5,9,0.556,0,6,6,1,0,2,3,3,28,-17,1,Kevin Durant,PHX,PHX,SAS,5.5,3-PT Attempted,35,34,29,7
22023,201142,22300131,"NOV 02, 2023",PHX vs. SAS,L,37,10,15,0.667,3,5,0.6,5,9,0.556,0,6,6,1,0,2,3,3,28,-17,1,Kevin Durant,PHX,PHX,SAS,5.5,Free Throws Made,35,34,29,7
22023,201142,22300131,"NOV 02, 2023",PHX vs. SAS,L,37,10,15,0.667,3,5,0.6,5,9,0.556,0,6,6,1,0,2,3,3,28,-17,1,Kevin Durant,PHX,PHX,SAS,18.0,FG Attempted,35,34,29,7
22023,201142,22300131,"NOV 02, 2023",PHX vs. SAS,L,37,10,15,0.667,3,5,0.6,5,9,0.556,0,6,6,1,0,2,3,3,28,-17,1,Kevin Durant,PHX,PHX,SAS,33.5,Pts+Rebs,35,34,29,7
22023,201142,22300131,"NOV 02, 2023",PHX vs. SAS,L,37,10,15,0.667,3,5,0.6,5,9,0.556,0,6,6,1,0,2,3,3,28,-17,1,Kevin Durant,PHX,PHX,SAS,0.5,Dunks,35,34,29,7
22023,201142,22300131,"NOV 02, 2023",PHX vs. SAS,L,37,10,15,0.667,3,5,0.6,5,9,0.556,0,6,6,1,0,2,3,3,28,-17,1,Kevin Durant,PHX,PHX,SAS,32.0,Pts+Asts,35,34,29,7
22023,201142,22300131,"NOV 02, 2023",PHX vs. SAS,L,37,10,15,0.667,3,5,0.6,5,9,0.556,0,6,6,1,0,2,3,3,28,-17,1,Kevin Durant,PHX,PHX,SAS,12.0,Rebs+Asts,35,34,29,7
22023,201142,22300113,"OCT 31, 2023",PHX vs. SAS,L,37,12,19,0.632,1,3,0.333,1,2,0.5,0,2,2,7,2,0,5,0,26,3,1,Kevin Durant,PHX,PHX,SAS,27.0,Points,35,28,33,9
22023,201142,22300113,"OCT 31, 2023",PHX vs. SAS,L,37,12,19,0.632,1,3,0.333,1,2,0.5,0,2,2,7,2,0,5,0,26,3,1,Kevin Durant,PHX,PHX,SAS,6.5,Rebounds,35,28,33,9
22023,201142,22300113,"OCT 31, 2023",PHX vs. SAS,L,37,12,19,0.632,1,3,0.333,1,2,0.5,0,2,2,7,2,0,5,0,26,3,1,Kevin Durant,PHX,PHX,SAS,38.5,Pts+Rebs+Asts,35,28,33,9
22023,201142,22300113,"OCT 31, 2023",PHX vs. SAS,L,37,12,19,0.632,1,3,0.333,1,2,0.5,0,2,2,7,2,0,5,0,26,3,1,Kevin Durant,PHX,PHX,SAS,5.0,Assists,35,28,33,9
22023,201142,22300113,"OCT 31, 2023",PHX vs. SAS,L,37,12,19,0.632,1,3,0.333,1,2,0.5,0,2,2,7,2,0,5,0,26,3,1,Kevin Durant,PHX,PHX,SAS,45.0,Fantasy Score,35,28,33,9
22023,201142,22300113,"OCT 31, 2023",PHX vs. SAS,L,37,12,19,0.632,1,3,0.333,1,2,0.5,0,2,2,7,2,0,5,0,26,3,1,Kevin Durant,PHX,PHX,SAS,5.5,3-PT Attempted,35,28,33,9
22023,201142,22300113,"OCT 31, 2023",PHX vs. SAS,L,37,12,19,0.632,1,3,0.333,1,2,0.5,0,2,2,7,2,0,5,0,26,3,1,Kevin Durant,PHX,PHX,SAS,5.5,Free Throws Made,35,28,33,9
22023,201142,22300113,"OCT 31, 2023",PHX vs. SAS,L,37,12,19,0.632,1,3,0.333,1,2,0.5,0,2,2,7,2,0,5,0,26,3,1,Kevin Durant,PHX,PHX,SAS,18.0,FG Attempted,35,28,33,9
22023,201142,22300113,"OCT 31, 2023",PHX vs. SAS,L,37,12,19,0.632,1,3,0.333,1,2,0.5,0,2,2,7,2,0,5,0,26,3,1,Kevin Durant,PHX,PHX,SAS,33.5,Pts+Rebs,35,28,33,9
22023,201142,22300113,"OCT 31, 2023",PHX vs. SAS,L,37,12,19,0.632,1,3,0.333,1,2,0.5,0,2,2,7,2,0,5,0,26,3,1,Kevin Durant,PHX,PHX,SAS,0.5,Dunks,35,28,33,9
22023,201142,22300113,"OCT 31, 2023",PHX vs. SAS,L,37,12,19,0.632,1,3,0.333,1,2,0.5,0,2,2,7,2,0,5,0,26,3,1,Kevin Durant,PHX,PHX,SAS,32.0,Pts+Asts,35,28,33,9
22023,201142,22300113,"OCT 31, 2023",PHX vs. SAS,L,37,12,19,0.632,1,3,0.333,1,2,0.5,0,2,2,7,2,0,5,0,26,3,1,Kevin Durant,PHX,PHX,SAS,12.0,Rebs+Asts,35,28,33,9
22023,201142,22300094,"OCT 28, 2023",PHX vs. UTA,W,29,8,11,0.727,1,4,0.25,9,9,1.0,0,4,4,7,1,1,2,1,26,30,1,Kevin Durant,PHX,PHX,UTA,27.0,Points,37,30,33,11
22023,201142,22300094,"OCT 28, 2023",PHX vs. UTA,W,29,8,11,0.727,1,4,0.25,9,9,1.0,0,4,4,7,1,1,2,1,26,30,1,Kevin Durant,PHX,PHX,UTA,6.5,Rebounds,37,30,33,11
22023,201142,22300094,"OCT 28, 2023",PHX vs. UTA,W,29,8,11,0.727,1,4,0.25,9,9,1.0,0,4,4,7,1,1,2,1,26,30,1,Kevin Durant,PHX,PHX,UTA,38.5,Pts+Rebs+Asts,37,30,33,11
22023,201142,22300094,"OCT 28, 2023",PHX vs. UTA,W,29,8,11,0.727,1,4,0.25,9,9,1.0,0,4,4,7,1,1,2,1,26,30,1,Kevin Durant,PHX,PHX,UTA,5.0,Assists,37,30,33,11
22023,201142,22300094,"OCT 28, 2023",PHX vs. UTA,W,29,8,11,0.727,1,4,0.25,9,9,1.0,0,4,4,7,1,1,2,1,26,30,1,Kevin Durant,PHX,PHX,UTA,45.0,Fantasy Score,37,30,33,11
22023,201142,22300094,"OCT 28, 2023",PHX vs. UTA,W,29,8,11,0.727,1,4,0.25,9,9,1.0,0,4,4,7,1,1,2,1,26,30,1,Kevin Durant,PHX,PHX,UTA,5.5,3-PT Attempted,37,30,33,11
22023,201142,22300094,"OCT 28, 2023",PHX vs. UTA,W,29,8,11,0.727,1,4,0.25,9,9,1.0,0,4,4,7,1,1,2,1,26,30,1,Kevin Durant,PHX,PHX,UTA,5.5,Free Throws Made,37,30,33,11
22023,201142,22300094,"OCT 28, 2023",PHX vs. UTA,W,29,8,11,0.727,1,4,0.25,9,9,1.0,0,4,4,7,1,1,2,1,26,30,1,Kevin Durant,PHX,PHX,UTA,18.0,FG Attempted,37,30,33,11
22023,201142,22300094,"OCT 28, 2023",PHX vs. UTA,W,29,8,11,0.727,1,4,0.25,9,9,1.0,0,4,4,7,1,1,2,1,26,30,1,Kevin Durant,PHX,PHX,UTA,33.5,Pts+Rebs,37,30,33,11
22023,201142,22300094,"OCT 28, 2023",PHX vs. UTA,W,29,8,11,0.727,1,4,0.25,9,9,1.0,0,4,4,7,1,1,2,1,26,30,1,Kevin Durant,PHX,PHX,UTA,0.5,Dunks,37,30,33,11
22023,201142,22300094,"OCT 28, 2023",PHX vs. UTA,W,29,8,11,0.727,1,4,0.25,9,9,1.0,0,4,4,7,1,1,2,1,26,30,1,Kevin Durant,PHX,PHX,UTA,32.0,Pts+Asts,37,30,33,11
22023,201142,22300094,"OCT 28, 2023",PHX vs. UTA,W,29,8,11,0.727,1,4,0.25,9,9,1.0,0,4,4,7,1,1,2,1,26,30,1,Kevin Durant,PHX,PHX,UTA,12.0,Rebs+Asts,37,30,33,11
22023,201142,22300076,"OCT 26, 2023",PHX @ LAL,L,39,14,28,0.5,1,5,0.2,10,13,0.769,0,11,11,2,1,1,8,2,39,18,1,Kevin Durant,PHX,LAL,PHX,27.0,Points,52,50,41,13
22023,201142,22300076,"OCT 26, 2023",PHX @ LAL,L,39,14,28,0.5,1,5,0.2,10,13,0.769,0,11,11,2,1,1,8,2,39,18,1,Kevin Durant,PHX,LAL,PHX,6.5,Rebounds,52,50,41,13
22023,201142,22300076,"OCT 26, 2023",PHX @ LAL,L,39,14,28,0.5,1,5,0.2,10,13,0.769,0,11,11,2,1,1,8,2,39,18,1,Kevin Durant,PHX,LAL,PHX,38.5,Pts+Rebs+Asts,52,50,41,13
22023,201142,22300076,"OCT 26, 2023",PHX @ LAL,L,39,14,28,0.5,1,5,0.2,10,13,0.769,0,11,11,2,1,1,8,2,39,18,1,Kevin Durant,PHX,LAL,PHX,5.0,Assists,52,50,41,13
22023,201142,22300076,"OCT 26, 2023",PHX @ LAL,L,39,14,28,0.5,1,5,0.2,10,13,0.769,0,11,11,2,1,1,8,2,39,18,1,Kevin Durant,PHX,LAL,PHX,45.0,Fantasy Score,52,50,41,13
22023,201142,22300076,"OCT 26, 2023",PHX @ LAL,L,39,14,28,0.5,1,5,0.2,10,13,0.769,0,11,11,2,1,1,8,2,39,18,1,Kevin Durant,PHX,LAL,PHX,5.5,3-PT Attempted,52,50,41,13
22023,201142,22300076,"OCT 26, 2023",PHX @ LAL,L,39,14,28,0.5,1,5,0.2,10,13,0.769,0,11,11,2,1,1,8,2,39,18,1,Kevin Durant,PHX,LAL,PHX,5.5,Free Throws Made,52,50,41,13
22023,201142,22300076,"OCT 26, 2023",PHX @ LAL,L,39,14,28,0.5,1,5,0.2,10,13,0.769,0,11,11,2,1,1,8,2,39,18,1,Kevin Durant,PHX,LAL,PHX,18.0,FG Attempted,52,50,41,13
22023,201142,22300076,"OCT 26, 2023",PHX @ LAL,L,39,14,28,0.5,1,5,0.2,10,13,0.769,0,11,11,2,1,1,8,2,39,18,1,Kevin Durant,PHX,LAL,PHX,33.5,Pts+Rebs,52,50,41,13
22023,201142,22300076,"OCT 26, 2023",PHX @ LAL,L,39,14,28,0.5,1,5,0.2,10,13,0.769,0,11,11,2,1,1,8,2,39,18,1,Kevin Durant,PHX,LAL,PHX,0.5,Dunks,52,50,41,13
22023,201142,22300076,"OCT 26, 2023",PHX @ LAL,L,39,14,28,0.5,1,5,0.2,10,13,0.769,0,11,11,2,1,1,8,2,39,18,1,Kevin Durant,PHX,LAL,PHX,32.0,Pts+Asts,52,50,41,13
22023,201142,22300076,"OCT 26, 2023",PHX @ LAL,L,39,14,28,0.5,1,5,0.2,10,13,0.769,0,11,11,2,1,1,8,2,39,18,1,Kevin Durant,PHX,LAL,PHX,12.0,Rebs+Asts,52,50,41,13
22023,201142,22300062,"OCT 24, 2023",PHX @ GSW,W,37,7,22,0.318,1,2,0.5,3,5,0.6,2,9,11,3,0,1,2,1,18,0,1,Kevin Durant,PHX,GSW,PHX,27.0,Points,32,29,21,14
22023,201142,22300062,"OCT 24, 2023",PHX @ GSW,W,37,7,22,0.318,1,2,0.5,3,5,0.6,2,9,11,3,0,1,2,1,18,0,1,Kevin Durant,PHX,GSW,PHX,6.5,Rebounds,32,29,21,14
22023,201142,22300062,"OCT 24, 2023",PHX @ GSW,W,37,7,22,0.318,1,2,0.5,3,5,0.6,2,9,11,3,0,1,2,1,18,0,1,Kevin Durant,PHX,GSW,PHX,38.5,Pts+Rebs+Asts,32,29,21,14
22023,201142,22300062,"OCT 24, 2023",PHX @ GSW,W,37,7,22,0.318,1,2,0.5,3,5,0.6,2,9,11,3,0,1,2,1,18,0,1,Kevin Durant,PHX,GSW,PHX,5.0,Assists,32,29,21,14
22023,201142,22300062,"OCT 24, 2023",PHX @ GSW,W,37,7,22,0.318,1,2,0.5,3,5,0.6,2,9,11,3,0,1,2,1,18,0,1,Kevin Durant,PHX,GSW,PHX,45.0,Fantasy Score,32,29,21,14
22023,201142,22300062,"OCT 24, 2023",PHX @ GSW,W,37,7,22,0.318,1,2,0.5,3,5,0.6,2,9,11,3,0,1,2,1,18,0,1,Kevin Durant,PHX,GSW,PHX,5.5,3-PT Attempted,32,29,21,14
22023,201142,22300062,"OCT 24, 2023",PHX @ GSW,W,37,7,22,0.318,1,2,0.5,3,5,0.6,2,9,11,3,0,1,2,1,18,0,1,Kevin Durant,PHX,GSW,PHX,5.5,Free Throws Made,32,29,21,14
22023,201142,22300062,"OCT 24, 2023",PHX @ GSW,W,37,7,22,0.318,1,2,0.5,3,5,0.6,2,9,11,3,0,1,2,1,18,0,1,Kevin Durant,PHX,GSW,PHX,18.0,FG Attempted,32,29,21,14
22023,201142,22300062,"OCT 24, 2023",PHX @ GSW,W,37,7,22,0.318,1,2,0.5,3,5,0.6,2,9,11,3,0,1,2,1,18,0,1,Kevin Durant,PHX,GSW,PHX,33.5,Pts+Rebs,32,29,21,14
22023,201142,22300062,"OCT 24, 2023",PHX @ GSW,W,37,7,22,0.318,1,2,0.5,3,5,0.6,2,9,11,3,0,1,2,1,18,0,1,Kevin Durant,PHX,GSW,PHX,0.5,Dunks,32,29,21,14
22023,201142,22300062,"OCT 24, 2023",PHX @ GSW,W,37,7,22,0.318,1,2,0.5,3,5,0.6,2,9,11,3,0,1,2,1,18,0,1,Kevin Durant,PHX,GSW,PHX,32.0,Pts+Asts,32,29,21,14
22023,201142,22300062,"OCT 24, 2023",PHX @ GSW,W,37,7,22,0.318,1,2,0.5,3,5,0.6,2,9,11,3,0,1,2,1,18,0,1,Kevin Durant,PHX,GSW,PHX,12.0,Rebs+Asts,32,29,21,14
22023,1631105,22300558,"JAN 15, 2024",DET @ WAS,W,26,8,8,1.0,0,0,0.0,4,5,0.8,2,17,19,4,0,1,2,3,20,8,1,Jalen Duren,DET,WAS,DET,,,43,39,24,23
22023,1631105,22300534,"JAN 12, 2024",DET vs. HOU,L,32,7,12,0.583,0,0,0.0,1,2,0.5,2,6,8,3,2,1,2,3,15,9,1,Jalen Duren,DET,DET,HOU,,,26,23,18,11
22023,1631105,22300519,"JAN 10, 2024",DET vs. SAS,L,30,10,16,0.625,0,0,0.0,1,1,1.0,2,10,12,2,0,0,1,4,21,-7,1,Jalen Duren,DET,DET,SAS,,,35,33,23,14
22023,1631105,22300512,"JAN 09, 2024",DET vs. SAC,L,24,8,14,0.571,0,0,0.0,0,0,0.0,3,7,10,3,0,0,3,4,16,-22,1,Jalen Duren,DET,DET,SAC,,,29,26,19,13
22023,1631105,22300502,"JAN 07, 2024",DET @ DEN,L,30,8,12,0.667,0,0,0.0,4,6,0.667,2,3,5,4,0,0,1,1,20,-14,1,Jalen Duren,DET,DEN,DET,,,29,25,24,9
22023,1631105,22300490,"JAN 05, 2024",DET @ GSW,L,33,6,6,1.0,0,0,0.0,1,2,0.5,4,8,12,2,0,2,1,2,13,-5,1,Jalen Duren,DET,GSW,DET,,,27,25,15,14
22023,1631105,22300474,"JAN 03, 2024",DET @ UTA,L,36,6,7,0.857,0,0,0.0,5,5,1.0,4,6,10,3,0,1,2,0,17,-14,1,Jalen Duren,DET,UTA,DET,,,30,27,20,13
22023,1631105,22300453,"JAN 01, 2024",DET @ HOU,L,22,6,8,0.75,0,0,0.0,0,0,0.0,3,11,14,1,0,0,1,5,12,0,1,Jalen Duren,DET,HOU,DET,,,27,26,13,15
22023,1631105,22300440,"DEC 30, 2023",DET vs. TOR,W,34,6,11,0.545,0,0,0.0,6,6,1.0,2,15,17,2,0,0,1,5,18,-6,1,Jalen Duren,DET,DET,TOR,,,37,35,20,19
22023,1631105,22300421,"DEC 28, 2023",DET @ BOS,L,40,5,6,0.833,0,0,0.0,5,6,0.833,8,6,14,2,0,0,0,1,15,-6,1,Jalen Duren,DET,BOS,DET,,,31,29,17,16
22023,1631105,22300406,"DEC 26, 2023",DET vs. BKN,L,33,6,11,0.545,0,0,0.0,0,0,0.0,5,10,15,4,1,1,1,3,12,8,1,Jalen Duren,DET,DET,BKN,,,31,27,16,19
22023,1631105,22301206,"DEC 06, 2023",DET vs. MEM,L,30,8,12,0.667,0,0,0.0,1,1,1.0,1,10,11,0,0,1,2,1,17,2,1,Jalen Duren,DET,DET,MEM,,,28,28,17,11
22023,1631105,22300283,"DEC 02, 2023",DET vs. CLE,L,30,8,8,1.0,0,0,0.0,1,6,0.167,3,8,11,1,1,2,2,3,17,6,1,Jalen Duren,DET,DET,CLE,,,29,28,18,12
22023,1631105,22300268,"NOV 30, 2023",DET @ NYK,L,34,5,7,0.714,0,0,0.0,0,0,0.0,0,12,12,2,0,0,2,3,10,1,1,Jalen Duren,DET,NYK,DET,,,24,22,12,14
22023,1631105,22300258,"NOV 29, 2023",DET vs. LAL,L,18,3,8,0.375,0,0,0.0,0,0,0.0,4,3,7,0,0,1,2,3,6,-20,1,Jalen Duren,DET,DET,LAL,,,13,13,6,7
22023,1631105,22300253,"NOV 27, 2023",DET vs. WAS,L,33,5,8,0.625,0,0,0.0,2,5,0.4,7,7,14,3,1,5,6,5,12,-4,1,Jalen Duren,DET,DET,WAS,,,29,26,15,17
22023,1631105,22300047,"NOV 24, 2023",DET @ IND,L,29,5,10,0.5,0,1,0.0,3,4,0.75,4,9,13,4,1,1,2,5,13,-11,1,Jalen Duren,DET,IND,DET,,,30,26,17,17
22023,1631105,22300008,"NOV 10, 2023",DET vs. PHI,L,23,2,5,0.4,0,0,0.0,0,0,0.0,1,3,4,3,0,1,3,1,4,-8,1,Jalen Duren,DET,DET,PHI,,,11,8,7,7
22023,1631105,22300165,"NOV 08, 2023",DET @ MIL,L,28,5,10,0.5,0,1,0.0,1,1,1.0,3,9,12,5,0,0,2,5,11,-3,1,Jalen Duren,DET,MIL,DET,,,28,23,16,17
22023,1631105,22300140,"NOV 05, 2023",DET vs. PHX,L,31,6,10,0.6,0,0,0.0,0,0,0.0,3,8,11,3,2,0,5,4,12,-19,1,Jalen Duren,DET,DET,PHX,,,26,23,15,14
22023,1631105,22300129,"NOV 02, 2023",DET @ NOP,L,25,5,8,0.625,0,0,0.0,2,2,1.0,0,5,5,1,0,0,1,5,12,-12,1,Jalen Duren,DET,NOP,DET,,,18,17,13,6
22023,1631105,22300109,"OCT 30, 2023",DET @ OKC,L,23,4,11,0.364,0,0,0.0,0,1,0.0,3,4,7,1,1,0,1,3,8,-8,1,Jalen Duren,DET,OKC,DET,,,16,15,9,8
22023,1631105,22300088,"OCT 28, 2023",DET vs. CHI,W,33,9,11,0.818,0,0,0.0,5,5,1.0,6,9,15,5,1,2,1,3,23,6,1,Jalen Duren,DET,DET,CHI,,,43,38,28,20
22023,1631105,22300077,"OCT 27, 2023",DET @ CHA,W,35,7,8,0.875,0,0,0.0,0,0,0.0,6,11,17,3,1,2,5,3,14,5,1,Jalen Duren,DET,CHA,DET,,,34,31,17,20
22023,1631105,22300068,"OCT 25, 2023",DET @ MIA,L,32,8,11,0.727,0,0,0.0,1,3,0.333,6,8,14,4,0,4,4,4,17,-4,1,Jalen Duren,DET,MIA,DET,,,35,31,21,18
22023,1631106,22300453,"JAN 01, 2024",HOU vs. DET,W,24,8,15,0.533,1,4,0.25,0,0,0.0,2,2,4,1,3,0,0,3,17,16,1,Tari Eason,HOU,HOU,DET,,,22,21,18,5
22023,1631106,22300434,"DEC 29, 2023",HOU vs. PHI,L,27,5,13,0.385,0,2,0.0,0,0,0.0,5,6,11,2,3,2,2,3,10,-8,1,Tari Eason,HOU,HOU,PHI,,,23,21,12,13
22023,1631106,22300418,"DEC 27, 2023",HOU vs. PHX,L,25,2,6,0.333,1,4,0.25,1,2,0.5,0,3,3,2,5,0,1,2,6,-20,1,Tari Eason,HOU,HOU,PHX,,,11,9,8,5
22023,1631106,22300409,"DEC 26, 2023",HOU vs. IND,L,26,7,13,0.538,1,2,0.5,1,2,0.5,3,5,8,1,2,0,0,3,16,9,1,Tari Eason,HOU,HOU,IND,,,25,24,17,9
22023,1631106,22300392,"DEC 23, 2023",HOU @ NOP,W,20,4,11,0.364,0,2,0.0,0,0,0.0,2,2,4,0,2,0,0,5,8,-6,1,Tari Eason,HOU,NOP,HOU,,,12,12,8,4
22023,1631106,22300349,"DEC 18, 2023",HOU @ CLE,L,33,5,13,0.385,0,2,0.0,4,5,0.8,4,4,8,2,4,1,2,4,14,-1,1,Tari Eason,HOU,CLE,HOU,,,24,22,16,10
22023,1631106,22300346,"DEC 17, 2023",HOU @ MIL,L,30,5,8,0.625,1,2,0.5,0,0,0.0,0,6,6,1,2,0,0,2,11,-4,1,Tari Eason,HOU,MIL,HOU,,,18,17,12,7
22023,1631106,22300332,"DEC 15, 2023",HOU @ MEM,W,23,4,8,0.5,1,1,1.0,2,2,1.0,1,7,8,1,2,1,2,2,11,11,1,Tari Eason,HOU,MEM,HOU,,,20,19,12,9
22023,1631106,22300314,"DEC 13, 2023",HOU vs. MEM,W,27,10,16,0.625,3,4,0.75,2,4,0.5,6,8,14,1,1,1,3,2,25,19,1,Tari Eason,HOU,HOU,MEM,,,40,39,26,15
22023,1631106,22300298,"DEC 11, 2023",HOU vs. SAS,W,27,8,16,0.5,2,5,0.4,0,1,0.0,4,10,14,1,2,0,2,2,18,12,1,Tari Eason,HOU,HOU,SAS,,,33,32,19,15
22023,1631106,22301224,"DEC 08, 2023",HOU @ DEN,W,17,0,4,0.0,0,2,0.0,3,4,0.75,1,7,8,2,0,0,0,1,3,-2,1,Tari Eason,HOU,DEN,HOU,,,13,11,5,10
22023,1631106,22301212,"DEC 06, 2023",HOU vs. OKC,W,22,2,6,0.333,2,4,0.5,3,4,0.75,2,6,8,4,0,2,1,2,9,8,1,Tari Eason,HOU,HOU,OKC,,,21,17,13,12
22023,1631106,22300291,"DEC 02, 2023",HOU @ LAL,L,20,2,5,0.4,0,1,0.0,2,2,1.0,2,5,7,2,1,1,1,2,6,-4,1,Tari Eason,HOU,LAL,HOU,,,15,13,8,9
22023,1631106,22300263,"NOV 29, 2023",HOU @ DEN,L,17,2,5,0.4,0,1,0.0,0,0,0.0,2,0,2,0,0,2,0,0,4,8,1,Tari Eason,HOU,DEN,HOU,,,6,6,4,2
22023,1631106,22300059,"NOV 28, 2023",HOU @ DAL,L,21,4,7,0.571,0,0,0.0,3,5,0.6,2,6,8,0,0,2,2,4,11,9,1,Tari Eason,HOU,DAL,HOU,,,19,19,11,8
22023,1631106,22300048,"NOV 24, 2023",HOU vs. DEN,W,16,3,6,0.5,1,2,0.5,0,0,0.0,1,3,4,1,1,0,0,2,7,9,1,Tari Eason,HOU,HOU,DEN,,,12,11,8,5
22023,1631106,22300231,"NOV 22, 2023",HOU vs. MEM,W,19,2,4,0.5,2,3,0.667,0,0,0.0,1,4,5,2,1,1,1,2,6,24,1,Tari Eason,HOU,HOU,MEM,,,13,11,8,7
22023,1631106,22300216,"NOV 19, 2023",HOU @ LAL,L,17,1,2,0.5,0,1,0.0,0,0,0.0,0,5,5,0,0,1,0,2,2,-18,1,Tari Eason,HOU,LAL,HOU,,,7,7,2,5
22023,1631106,22300037,"NOV 17, 2023",HOU @ LAC,L,20,6,9,0.667,0,1,0.0,0,2,0.0,2,4,6,0,1,2,1,3,12,11,1,Tari Eason,HOU,LAC,HOU,,,18,18,12,6
22023,1631106,22300182,"NOV 12, 2023",HOU vs. DEN,W,16,3,4,0.75,2,3,0.667,0,0,0.0,1,2,3,2,1,0,0,1,8,12,1,Tari Eason,HOU,HOU,DEN,,,13,11,10,5
22023,1631106,22300011,"NOV 10, 2023",HOU vs. NOP,W,19,1,8,0.125,0,2,0.0,0,0,0.0,1,7,8,0,0,2,0,3,2,-2,1,Tari Eason,HOU,HOU,NOP,,,10,10,2,8
22023,1631106,22300163,"NOV 08, 2023",HOU vs. LAL,W,14,4,10,0.4,1,2,0.5,0,0,0.0,4,5,9,2,0,1,2,1,9,5,1,Tari Eason,HOU,HOU,LAL,,,20,18,11,11
22023,1630162,22300553,"JAN 14, 2024",MIN vs. LAC,W,38,10,16,0.625,2,4,0.5,11,12,0.917,1,8,9,6,2,0,5,1,33,13,1,Anthony Edwards,MIN,MIN,LAC,,,48,42,39,15
22023,1630162,22300538,"JAN 12, 2024",MIN vs. POR,W,27,4,9,0.444,0,3,0.0,1,2,0.5,0,3,3,6,1,1,0,2,9,41,1,Anthony Edwards,MIN,MIN,POR,,,18,12,15,9
22023,1630162,22300517,"JAN 10, 2024",MIN @ BOS,L,46,11,25,0.44,3,6,0.5,4,4,1.0,0,6,6,3,0,0,5,1,29,-1,1,Anthony Edwards,MIN,BOS,MIN,,,38,35,32,9
22023,1630162,22300513,"JAN 09, 2024",MIN @ ORL,W,26,2,7,0.286,0,2,0.0,2,3,0.667,1,3,4,3,0,0,5,3,6,1,1,Anthony Edwards,MIN,ORL,MIN,,,13,10,9,7
22023,1630162,22300501,"JAN 07, 2024",MIN @ DAL,L,37,14,27,0.519,3,6,0.5,5,7,0.714,5,5,10,3,3,1,2,3,36,-5,1,Anthony Edwards,MIN,DAL,MIN,,,49,46,39,13
22023,1630162,22300485,"JAN 05, 2024",MIN @ HOU,W,33,8,17,0.471,2,5,0.4,6,6,1.0,0,3,3,5,2,0,5,2,24,14,1,Anthony Edwards,MIN,HOU,MIN,,,32,27,29,8
22023,1630162,22300471,"JAN 03, 2024",MIN vs. NOP,L,37,11,22,0.5,4,7,0.571,9,10,0.9,2,2,4,5,1,1,6,1,35,-15,1,Anthony Edwards,MIN,MIN,NOP,,,44,39,40,9
22023,1630162,22300451,"JAN 01, 2024",MIN @ NYK,L,38,11,21,0.524,4,9,0.444,9,10,0.9,0,4,4,2,0,2,4,1,35,2,1,Anthony Edwards,MIN,NYK,MIN,,,41,39,37,6
22023,1630162,22300443,"DEC 30, 2023",MIN vs. LAL,W,38,10,23,0.435,2,8,0.25,9,11,0.818,0,3,3,3,0,3,3,3,31,8,1,Anthony Edwards,MIN,MIN,LAL,,,37,34,34,6
22023,1630162,22300423,"DEC 28, 2023",MIN vs. DAL,W,38,12,23,0.522,6,11,0.545,14,18,0.778,0,3,3,4,3,1,6,2,44,11,1,Anthony Edwards,MIN,MIN,DAL,,,51,47,48,7
22023,1630162,22300411,"DEC 26, 2023",MIN @ OKC,L,34,7,16,0.438,2,5,0.4,9,13,0.692,1,6,7,6,1,0,4,3,25,-16,1,Anthony Edwards,MIN,OKC,MIN,,,38,32,31,13
22023,1630162,22300400,"DEC 23, 2023",MIN @ SAC,W,39,13,27,0.481,3,12,0.25,5,5,1.0,0,5,5,10,1,1,5,1,34,8,1,Anthony Edwards,MIN,SAC,MIN,,,49,39,44,15
22023,1630162,22300380,"DEC 21, 2023",MIN vs. LAL,W,38,9,19,0.474,2,6,0.333,7,8,0.875,0,7,7,5,3,1,5,0,27,2,1,Anthony Edwards,MIN,MIN,LAL,,,39,34,32,12
22023,1630162,22300367,"DEC 20, 2023",MIN @ PHI,L,36,9,20,0.45,2,6,0.333,7,8,0.875,1,6,7,5,0,0,1,2,27,-10,1,Anthony Edwards,MIN,PHI,MIN,,,39,34,32,12
22023,1630162,22300353,"DEC 18, 2023",MIN @ MIA,W,40,13,25,0.52,2,9,0.222,4,4,1.0,0,8,8,5,3,2,1,1,32,6,1,Anthony Edwards,MIN,MIA,MIN,,,45,40,37,13
22023,1630162,22300338,"DEC 16, 2023",MIN vs. IND,W,34,14,23,0.609,7,10,0.7,2,2,1.0,0,2,2,4,3,0,4,3,37,17,1,Anthony Edwards,MIN,MIN,IND,,,43,39,41,6
22023,1630162,22300321,"DEC 14, 2023",MIN @ DAL,W,35,3,19,0.158,0,3,0.0,3,6,0.5,1,1,2,11,2,0,5,2,9,20,1,Anthony Edwards,MIN,DAL,MIN,,,22,11,20,13
22023,1630162,22301221,"DEC 08, 2023",MIN @ MEM,W,4,0,1,0.0,0,0,0.0,0,0,0.0,0,0,0,1,0,0,0,0,0,-3,1,Anthony Edwards,MIN,MEM,MIN,,,1,0,1,1
22023,1630162,22301210,"DEC 06, 2023",MIN vs. SAS,W,37,4,17,0.235,2,5,0.4,7,8,0.875,1,6,7,6,1,1,3,2,17,14,1,Anthony Edwards,MIN,MIN,SAS,,,30,24,23,13
22023,1630162,22300058,"NOV 28, 2023",MIN vs. OKC,W,28,7,16,0.438,3,6,0.5,4,6,0.667,0,5,5,1,0,1,2,2,21,0,1,Anthony Edwards,MIN,MIN,OKC,,,27,26,22,6
22023,1630162,22300249,"NOV 26, 2023",MIN @ MEM,W,34,8,14,0.571,1,4,0.25,7,7,1.0,0,5,5,7,0,1,2,3,24,23,1,Anthony Edwards,MIN,MEM,MIN,,,36,29,31,12
22023,1630162,22300050,"NOV 24, 2023",MIN vs. SAC,L,40,8,21,0.381,2,9,0.222,17,18,0.944,0,7,7,5,2,2,4,2,35,5,1,Anthony Edwards,MIN,MIN,SAC,,,47,42,40,12
22023,1630162,22300232,"NOV 22, 2023",MIN vs. PHI,W,36,11,22,0.5,5,9,0.556,4,4,1.0,2,4,6,6,2,0,2,2,31,19,1,Anthony Edwards,MIN,MIN,PHI,,,43,37,37,12
22023,1630162,22300221,"NOV 20, 2023",MIN vs. NYK,W,39,9,21,0.429,1,6,0.167,4,4,1.0,2,8,10,5,2,0,3,1,23,9,1,Anthony Edwards,MIN,MIN,NYK,,,38,33,28,15
22023,1630162,22300203,"NOV 18, 2023",MIN @ NOP,W,30,9,19,0.474,5,10,0.5,0,0,0.0,0,3,3,4,0,0,3,6,23,13,1,Anthony Edwards,MIN,NOP,MIN,,,30,26,27,7
22023,1630162,22300197,"NOV 15, 2023",MIN @ PHX,L,31,4,16,0.25,1,3,0.333,4,4,1.0,1,3,4,4,1,1,1,0,13,-29,1,Anthony Edwards,MIN,PHX,MIN,,,21,17,17,8
22023,1630162,22300025,"NOV 14, 2023",MIN @ GSW,W,36,7,16,0.438,3,6,0.5,3,5,0.6,0,4,4,4,3,0,5,1,20,-9,1,Anthony Edwards,MIN,GSW,MIN,,,28,24,24,8
22023,1630162,22300186,"NOV 12, 2023",MIN @ GSW,W,38,11,27,0.407,1,9,0.111,10,10,1.0,1,5,6,7,2,0,4,0,33,15,1,Anthony Edwards,MIN,GSW,MIN,,,46,39,40,13
22023,1630162,22300013,"NOV 10, 2023",MIN @ SAS,W,37,9,21,0.429,2,8,0.25,8,11,0.727,2,5,7,5,2,1,4,1,28,3,1,Anthony Edwards,MIN,SAS,MIN,,,40,35,33,12
22023,1630162,22300166,"NOV 08, 2023",MIN vs. NOP,W,33,10,22,0.455,2,8,0.25,4,5,0.8,0,3,3,8,3,2,3,1,26,35,1,Anthony Edwards,MIN,MIN,NOP,,,37,29,34,11
22023,1630162,22300154,"NOV 06, 2023",MIN vs. BOS,W,38,15,25,0.6,2,8,0.25,6,7,0.857,0,9,9,7,1,0,3,5,38,18,1,Anthony Edwards,MIN,MIN,BOS,,,54,47,45,16
22023,1630162,22300138,"NOV 04, 2023",MIN vs. UTA,W,36,13,19,0.684,2,4,0.5,3,5,0.6,0,8,8,6,1,0,6,0,31,27,1,Anthony Edwards,MIN,MIN,UTA,,,45,39,37,14
22023,1630162,22300123,"NOV 01, 2023",MIN vs. DEN,W,32,8,16,0.5,1,4,0.25,7,8,0.875,0,2,2,1,2,0,4,1,24,11,1,Anthony Edwards,MIN,MIN,DEN,,,27,26,25,3
22023,1630162,22300104,"OCT 30, 2023",MIN @ ATL,L,38,13,21,0.619,5,8,0.625,0,1,0.0,0,5,5,7,1,0,5,4,31,-9,1,Anthony Edwards,MIN,ATL,MIN,,,43,36,38,12
22023,1630162,22300093,"OCT 28, 2023",MIN vs. MIA,W,33,7,15,0.467,3,5,0.6,2,2,1.0,0,2,2,7,0,0,2,3,19,21,1,Anthony Edwards,MIN,MIN,MIA,,,28,21,26,9
22023,1630162,22300069,"OCT 25, 2023",MIN @ TOR,L,38,8,27,0.296,4,7,0.571,6,6,1.0,5,9,14,1,0,0,2,1,26,0,1,Anthony Edwards,MIN,TOR,MIN,,,41,40,27,15
22023,1630556,22300532,"JAN 12, 2024",SAC @ PHI,L,6,1,3,0.333,0,1,0.0,0,0,0.0,1,0,1,0,0,0,0,1,2,3,1,Kessler Edwards,SAC,PHI,SAC,,,3,3,2,1
22023,1630556,22300512,"JAN 09, 2024",SAC @ DET,W,1,0,0,0.0,0,0,0.0,0,0,0.0,0,0,0,1,0,0,0,0,0,2,1,Kessler Edwards,SAC,DET,SAC,,,1,0,1,1
22023,1630556,22300500,"JAN 07, 2024",SAC vs. NOP,L,8,3,4,0.75,2,2,1.0,2,2,1.0,1,1,2,0,0,0,0,0,10,7,1,Kessler Edwards,SAC,SAC,NOP,,,12,12,10,2
22023,1630556,22300449,"DEC 31, 2023",SAC @ MEM,W,4,0,2,0.0,0,2,0.0,0,0,0.0,0,0,0,0,0,0,0,0,0,4,1,Kessler Edwards,SAC,MEM,SAC,,,0,0,0,0
22023,1630556,22300413,"DEC 26, 2023",SAC @ POR,L,2,0,0,0.0,0,0,0.0,0,0,0.0,0,0,0,0,0,0,0,0,0,2,1,Kessler Edwards,SAC,POR,SAC,,,0,0,0,0
22023,1630556,22300400,"DEC 23, 2023",SAC vs. MIN,L,0,0,0,0.0,0,0,0.0,0,0,0.0,0,0,0,0,0,0,0,0,0,0,1,Kessler Edwards,SAC,SAC,MIN,,,0,0,0,0
22023,1630556,22300387,"DEC 22, 2023",SAC vs. PHX,W,2,0,1,0.0,0,1,0.0,0,0,0.0,0,0,0,0,0,0,0,0,0,-6,1,Kessler Edwards,SAC,SAC,PHX,,,0,0,0,0
22023,1630556,22300373,"DEC 20, 2023",SAC vs. BOS,L,6,3,5,0.6,1,2,0.5,0,0,0.0,0,2,2,0,0,0,0,0,7,0,1,Kessler Edwards,SAC,SAC,BOS,,,9,9,7,2
22023,1630556,22300358,"DEC 18, 2023",SAC vs. WAS,W,4,1,2,0.5,1,2,0.5,0,0,0.0,0,1,1,1,0,0,0,0,3,-7,1,Kessler Edwards,SAC,SAC,WAS,,,5,4,4,2
22023,1630556,22300342,"DEC 16, 2023",SAC vs. UTA,W,2,0,0,0.0,0,0,0.0,0,0,0.0,0,0,0,0,0,0,0,0,0,1,1,Kessler Edwards,SAC,SAC,UTA,,,0,0,0,0
22023,1630556,22300324,"DEC 14, 2023",SAC vs. OKC,W,0,0,0,0.0,0,0,0.0,0,0,0.0,0,0,0,0,0,0,0,0,0,-2,1,Kessler Edwards,SAC,SAC,OKC,,,0,0,0,0
22023,1630556,22300309,"DEC 12, 2023",SAC @ LAC,L,8,3,3,1.0,1,1,1.0,0,0,0.0,0,0,0,0,0,0,0,0,7,12,1,Kessler Edwards,SAC,LAC,SAC,,,7,7,7,0
22023,1630556,22300303,"DEC 11, 2023",SAC vs. BKN,W,3,0,0,0.0,0,0,0.0,0,0,0.0,0,0,0,0,0,0,0,0,0,-7,1,Kessler Edwards,SAC,SAC,BKN,,,0,0,0,0
22023,1630556,22301228,"DEC 08, 2023",SAC @ PHX,W,1,0,0,0.0,0,0,0.0,0,0,0.0,0,0,0,0,0,0,0,1,0,-4,1,Kessler Edwards,SAC,PHX,SAC,,,0,0,0,0
22023,1630556,22300264,"NOV 29, 2023",SAC vs. LAC,L,7,0,1,0.0,0,1,0.0,0,0,0.0,1,0,1,0,0,0,0,0,0,-16,1,Kessler Edwards,SAC,SAC,LAC,,,1,1,0,1
22023,1630556,22300060,"NOV 28, 2023",SAC vs. GSW,W,5,0,1,0.0,0,1,0.0,0,0,0.0,0,2,2,0,0,0,0,0,0,-3,1,Kessler Edwards,SAC,SAC,GSW,,,2,2,0,2
22023,1630556,22300050,"NOV 24, 2023",SAC @ MIN,W,18,4,7,0.571,2,3,0.667,0,0,0.0,1,1,2,1,1,0,0,1,10,-7,1,Kessler Edwards,SAC,MIN,SAC,,,13,12,11,3
22023,1630556,22300233,"NOV 22, 2023",SAC @ NOP,L,1,0,1,0.0,0,1,0.0,0,0,0.0,0,0,0,0,0,0,0,0,0,0,1,Kessler Edwards,SAC,NOP,SAC,,,0,0,0,0
22023,1630556,22300222,"NOV 20, 2023",SAC @ NOP,L,15,1,4,0.25,1,4,0.25,0,0,0.0,0,4,4,0,0,1,0,2,3,-12,1,Kessler Edwards,SAC,NOP,SAC,,,7,7,3,4
22023,1630556,22300212,"NOV 19, 2023",SAC @ DAL,W,9,0,1,0.0,0,0,0.0,0,0,0.0,1,0,1,1,0,0,0,0,0,0,1,Kessler Edwards,SAC,DAL,SAC,,,2,1,1,2
22023,1630556,22300198,"NOV 15, 2023",SAC @ LAL,W,0,0,0,0.0,0,0,0.0,0,0,0.0,0,0,0,0,0,0,0,0,0,0,1,Kessler Edwards,SAC,LAL,SAC,,,0,0,0,0
22023,1630556,22300191,"NOV 13, 2023",SAC vs. CLE,W,1,0,0,0.0,0,0,0.0,0,0,0.0,0,0,0,0,0,0,0,0,0,-5,1,Kessler Edwards,SAC,SAC,CLE,,,0,0,0,0
22023,1630556,22300016,"NOV 10, 2023",SAC vs. OKC,W,3,0,0,0.0,0,0,0.0,0,0,0.0,0,0,0,0,0,0,0,0,0,-3,1,Kessler Edwards,SAC,SAC,OKC,,,0,0,0,0
22023,1630556,22300170,"NOV 08, 2023",SAC vs. POR,W,16,0,1,0.0,0,1,0.0,0,0,0.0,0,4,4,1,0,1,1,4,0,4,1,Kessler Edwards,SAC,SAC,POR,,,5,4,1,5
22023,1630556,22300153,"NOV 06, 2023",SAC @ HOU,L,12,1,4,0.25,1,2,0.5,1,2,0.5,0,1,1,2,1,0,0,1,4,11,1,Kessler Edwards,SAC,HOU,SAC,,,7,5,6,3
22023,1630556,22300137,"NOV 04, 2023",SAC @ HOU,L,1,0,0,0.0,0,0,0.0,0,0,0.0,0,0,0,0,0,0,0,0,0,0,1,Kessler Edwards,SAC,HOU,SAC,,,0,0,0,0
22023,1630556,22300100,"OCT 29, 2023",SAC vs. LAL,W,0,0,0,0.0,0,0,0.0,0,0,0.0,0,0,0,0,0,0,0,0,0,-2,1,Kessler Edwards,SAC,SAC,LAL,,,0,0,0,0
22023,1630556,22300072,"OCT 25, 2023",SAC @ UTA,W,1,0,1,0.0,0,1,0.0,0,0,0.0,0,0,0,0,0,0,0,0,0,-2,1,Kessler Edwards,SAC,UTA,SAC,,,0,0,0,0
22023,1631165,22300532,"JAN 12, 2024",SAC @ PHI,L,10,1,3,0.333,1,2,0.5,0,0,0.0,0,2,2,0,0,0,2,1,3,-11,1,Keon Ellis,SAC,PHI,SAC,,,5,5,3,2
22023,1631165,22300518,"JAN 10, 2024",SAC @ CHA,W,9,1,3,0.333,1,3,0.333,0,0,0.0,0,1,1,1,0,1,0,2,3,4,1,Keon Ellis,SAC,CHA,SAC,,,5,4,4,2
22023,1631165,22300512,"JAN 09, 2024",SAC @ DET,W,4,0,0,0.0,0,0,0.0,0,0,0.0,0,0,0,0,0,0,0,1,0,-4,1,Keon Ellis,SAC,DET,SAC,,,0,0,0,0
22023,1631165,22300500,"JAN 07, 2024",SAC vs. NOP,L,12,5,6,0.833,3,3,1.0,0,0,0.0,2,0,2,1,1,0,0,1,13,9,1,Keon Ellis,SAC,SAC,NOP,,,16,15,14,3
22023,1631165,22300449,"DEC 31, 2023",SAC @ MEM,W,4,0,0,0.0,0,0,0.0,0,0,0.0,0,0,0,0,0,0,0,1,0,4,1,Keon Ellis,SAC,MEM,SAC,,,0,0,0,0
22023,1631165,22300413,"DEC 26, 2023",SAC @ POR,L,9,0,0,0.0,0,0,0.0,0,0,0.0,0,0,0,2,0,1,0,1,0,-14,1,Keon Ellis,SAC,POR,SAC,,,2,0,2,2
22023,1631165,22300400,"DEC 23, 2023",SAC vs. MIN,L,11,0,3,0.0,0,2,0.0,0,0,0.0,0,0,0,1,0,0,0,1,0,-14,1,Keon Ellis,SAC,SAC,MIN,,,1,0,1,1
22023,1631165,22300387,"DEC 22, 2023",SAC vs. PHX,W,17,0,3,0.0,0,2,0.0,1,2,0.5,1,2,3,1,1,1,0,3,1,-3,1,Keon Ellis,SAC,SAC,PHX,,,5,4,2,4
22023,1631165,22300373,"DEC 20, 2023",SAC vs. BOS,L,19,4,7,0.571,4,7,0.571,0,0,0.0,0,2,2,4,1,2,0,1,12,2,1,Keon Ellis,SAC,SAC,BOS,,,18,14,16,6
22023,1631165,22300358,"DEC 18, 2023",SAC vs. WAS,W,15,1,5,0.2,1,5,0.2,0,0,0.0,0,1,1,2,1,1,0,4,3,1,1,Keon Ellis,SAC,SAC,WAS,,,6,4,5,3
22023,1631165,22300342,"DEC 16, 2023",SAC vs. UTA,W,26,0,3,0.0,0,3,0.0,2,2,1.0,0,1,1,7,1,0,3,2,2,23,1,Keon Ellis,SAC,SAC,UTA,,,10,3,9,8
22023,1631165,22300324,"DEC 14, 2023",SAC vs. OKC,W,28,6,8,0.75,5,7,0.714,0,0,0.0,2,4,6,3,1,1,0,5,17,10,1,Keon Ellis,SAC,SAC,OKC,,,26,23,20,9
22023,1631165,22300309,"DEC 12, 2023",SAC @ LAC,L,12,1,1,1.0,1,1,1.0,0,0,0.0,0,0,0,1,0,1,2,0,3,5,1,Keon Ellis,SAC,LAC,SAC,,,4,3,4,1
22023,1631165,22300303,"DEC 11, 2023",SAC vs. BKN,W,15,1,4,0.25,1,4,0.25,0,0,0.0,0,1,1,2,1,0,0,1,3,-10,1,Keon Ellis,SAC,SAC,BKN,,,6,4,5,3
22023,1631165,22301228,"DEC 08, 2023",SAC @ PHX,W,17,4,6,0.667,2,4,0.5,0,0,0.0,0,2,2,0,0,0,2,3,10,-2,1,Keon Ellis,SAC,PHX,SAC,,,12,12,10,2
22023,1631165,22301204,"DEC 04, 2023",SAC vs. NOP,L,8,1,2,0.5,1,2,0.5,2,2,1.0,0,0,0,0,1,0,0,1,5,-1,1,Keon Ellis,SAC,SAC,NOP,,,5,5,5,0
22023,1631165,22300290,"DEC 02, 2023",SAC vs. DEN,W,8,0,1,0.0,0,1,0.0,0,0,0.0,0,0,0,2,0,0,0,1,0,-14,1,Keon Ellis,SAC,SAC,DEN,,,2,0,2,2
22023,1631165,22300060,"NOV 28, 2023",SAC vs. GSW,W,6,1,2,0.5,1,2,0.5,0,0,0.0,0,0,0,0,0,0,0,0,3,1,1,Keon Ellis,SAC,SAC,GSW,,,3,3,3,0
22023,1631165,22300212,"NOV 19, 2023",SAC @ DAL,W,9,0,0,0.0,0,0,0.0,0,0,0.0,1,3,4,0,0,0,0,1,0,9,1,Keon Ellis,SAC,DAL,SAC,,,4,4,0,4
22023,1631165,22300032,"NOV 17, 2023",SAC @ SAS,W,10,1,1,1.0,0,0,0.0,0,0,0.0,0,0,0,2,1,0,1,0,2,-1,1,Keon Ellis,SAC,SAS,SAC,,,4,2,4,2
22023,1631165,22300198,"NOV 15, 2023",SAC @ LAL,W,9,0,3,0.0,0,2,0.0,0,0,0.0,1,1,2,1,0,0,0,2,0,6,1,Keon Ellis,SAC,LAL,SAC,,,3,2,1,3
22023,1631165,22300191,"NOV 13, 2023",SAC vs. CLE,W,12,1,3,0.333,0,2,0.0,0,0,0.0,0,0,0,2,0,1,2,1,2,-3,1,Keon Ellis,SAC,SAC,CLE,,,4,2,4,2
22023,1631165,22300016,"NOV 10, 2023",SAC vs. OKC,W,31,2,8,0.25,1,7,0.143,3,4,0.75,1,3,4,2,0,3,1,3,8,4,1,Keon Ellis,SAC,SAC,OKC,,,14,12,10,6
22023,1631165,22300170,"NOV 08, 2023",SAC vs. POR,W,21,1,3,0.333,0,2,0.0,2,3,0.667,0,4,4,0,3,0,2,1,4,-4,1,Keon Ellis,SAC,SAC,POR,,,8,8,4,4
22023,1631165,22300153,"NOV 06, 2023",SAC @ HOU,L,14,5,7,0.714,4,6,0.667,1,4,0.25,1,1,2,1,1,0,0,1,15,10,1,Keon Ellis,SAC,HOU,SAC,,,18,17,16,3
22023,1631165,22300137,"NOV 04, 2023",SAC @ HOU,L,1,0,1,0.0,0,1,0.0,0,0,0.0,0,0,0,0,1,0,0,1,0,0,1,Keon Ellis,SAC,HOU,SAC,,,0,0,0,0
22023,1631165,22300072,"OCT 25, 2023",SAC @ UTA,W,1,0,0,0.0,0,0,0.0,0,0,0.0,0,0,0,0,0,0,0,0,0,-2,1,Keon Ellis,SAC,UTA,SAC,,,0,0,0,0
22023,203954,22300555,"JAN 15, 2024",PHI vs. HOU,W,31,12,21,0.571,1,5,0.2,16,17,0.941,2,8,10,3,1,1,2,5,41,7,1,Joel Embiid,PHI,PHI,HOU,33.5,Points,54,51,44,13
22023,203954,22300555,"JAN 15, 2024",PHI vs. HOU,W,31,12,21,0.571,1,5,0.2,16,17,0.941,2,8,10,3,1,1,2,5,41,7,1,Joel Embiid,PHI,PHI,HOU,11.0,Rebounds,54,51,44,13
22023,203954,22300555,"JAN 15, 2024",PHI vs. HOU,W,31,12,21,0.571,1,5,0.2,16,17,0.941,2,8,10,3,1,1,2,5,41,7,1,Joel Embiid,PHI,PHI,HOU,50.5,Pts+Rebs+Asts,54,51,44,13
22023,203954,22300555,"JAN 15, 2024",PHI vs. HOU,W,31,12,21,0.571,1,5,0.2,16,17,0.941,2,8,10,3,1,1,2,5,41,7,1,Joel Embiid,PHI,PHI,HOU,5.0,Assists,54,51,44,13
22023,203954,22300555,"JAN 15, 2024",PHI vs. HOU,W,31,12,21,0.571,1,5,0.2,16,17,0.941,2,8,10,3,1,1,2,5,41,7,1,Joel Embiid,PHI,PHI,HOU,58.5,Fantasy Score,54,51,44,13
22023,203954,22300555,"JAN 15, 2024",PHI vs. HOU,W,31,12,21,0.571,1,5,0.2,16,17,0.941,2,8,10,3,1,1,2,5,41,7,1,Joel Embiid,PHI,PHI,HOU,9.5,Defensive Rebounds,54,51,44,13
22023,203954,22300555,"JAN 15, 2024",PHI vs. HOU,W,31,12,21,0.571,1,5,0.2,16,17,0.941,2,8,10,3,1,1,2,5,41,7,1,Joel Embiid,PHI,PHI,HOU,9.5,Free Throws Made,54,51,44,13
22023,203954,22300555,"JAN 15, 2024",PHI vs. HOU,W,31,12,21,0.571,1,5,0.2,16,17,0.941,2,8,10,3,1,1,2,5,41,7,1,Joel Embiid,PHI,PHI,HOU,21.5,FG Attempted,54,51,44,13
22023,203954,22300555,"JAN 15, 2024",PHI vs. HOU,W,31,12,21,0.571,1,5,0.2,16,17,0.941,2,8,10,3,1,1,2,5,41,7,1,Joel Embiid,PHI,PHI,HOU,44.5,Pts+Rebs,54,51,44,13
22023,203954,22300555,"JAN 15, 2024",PHI vs. HOU,W,31,12,21,0.571,1,5,0.2,16,17,0.941,2,8,10,3,1,1,2,5,41,7,1,Joel Embiid,PHI,PHI,HOU,1.0,Dunks,54,51,44,13
22023,203954,22300555,"JAN 15, 2024",PHI vs. HOU,W,31,12,21,0.571,1,5,0.2,16,17,0.941,2,8,10,3,1,1,2,5,41,7,1,Joel Embiid,PHI,PHI,HOU,38.5,Pts+Asts,54,51,44,13
22023,203954,22300555,"JAN 15, 2024",PHI vs. HOU,W,31,12,21,0.571,1,5,0.2,16,17,0.941,2,8,10,3,1,1,2,5,41,7,1,Joel Embiid,PHI,PHI,HOU,16.0,Rebs+Asts,54,51,44,13
22023,203954,22300483,"JAN 05, 2024",PHI vs. NYK,L,36,10,23,0.435,1,1,1.0,9,12,0.75,3,7,10,3,1,3,6,3,30,-29,1,Joel Embiid,PHI,PHI,NYK,33.5,Points,43,40,33,13
22023,203954,22300483,"JAN 05, 2024",PHI vs. NYK,L,36,10,23,0.435,1,1,1.0,9,12,0.75,3,7,10,3,1,3,6,3,30,-29,1,Joel Embiid,PHI,PHI,NYK,11.0,Rebounds,43,40,33,13
22023,203954,22300483,"JAN 05, 2024",PHI vs. NYK,L,36,10,23,0.435,1,1,1.0,9,12,0.75,3,7,10,3,1,3,6,3,30,-29,1,Joel Embiid,PHI,PHI,NYK,50.5,Pts+Rebs+Asts,43,40,33,13
22023,203954,22300483,"JAN 05, 2024",PHI vs. NYK,L,36,10,23,0.435,1,1,1.0,9,12,0.75,3,7,10,3,1,3,6,3,30,-29,1,Joel Embiid,PHI,PHI,NYK,5.0,Assists,43,40,33,13
22023,203954,22300483,"JAN 05, 2024",PHI vs. NYK,L,36,10,23,0.435,1,1,1.0,9,12,0.75,3,7,10,3,1,3,6,3,30,-29,1,Joel Embiid,PHI,PHI,NYK,58.5,Fantasy Score,43,40,33,13
22023,203954,22300483,"JAN 05, 2024",PHI vs. NYK,L,36,10,23,0.435,1,1,1.0,9,12,0.75,3,7,10,3,1,3,6,3,30,-29,1,Joel Embiid,PHI,PHI,NYK,9.5,Defensive Rebounds,43,40,33,13
22023,203954,22300483,"JAN 05, 2024",PHI vs. NYK,L,36,10,23,0.435,1,1,1.0,9,12,0.75,3,7,10,3,1,3,6,3,30,-29,1,Joel Embiid,PHI,PHI,NYK,9.5,Free Throws Made,43,40,33,13
22023,203954,22300483,"JAN 05, 2024",PHI vs. NYK,L,36,10,23,0.435,1,1,1.0,9,12,0.75,3,7,10,3,1,3,6,3,30,-29,1,Joel Embiid,PHI,PHI,NYK,21.5,FG Attempted,43,40,33,13
22023,203954,22300483,"JAN 05, 2024",PHI vs. NYK,L,36,10,23,0.435,1,1,1.0,9,12,0.75,3,7,10,3,1,3,6,3,30,-29,1,Joel Embiid,PHI,PHI,NYK,44.5,Pts+Rebs,43,40,33,13
22023,203954,22300483,"JAN 05, 2024",PHI vs. NYK,L,36,10,23,0.435,1,1,1.0,9,12,0.75,3,7,10,3,1,3,6,3,30,-29,1,Joel Embiid,PHI,PHI,NYK,1.0,Dunks,43,40,33,13
22023,203954,22300483,"JAN 05, 2024",PHI vs. NYK,L,36,10,23,0.435,1,1,1.0,9,12,0.75,3,7,10,3,1,3,6,3,30,-29,1,Joel Embiid,PHI,PHI,NYK,38.5,Pts+Asts,43,40,33,13
22023,203954,22300483,"JAN 05, 2024",PHI vs. NYK,L,36,10,23,0.435,1,1,1.0,9,12,0.75,3,7,10,3,1,3,6,3,30,-29,1,Joel Embiid,PHI,PHI,NYK,16.0,Rebs+Asts,43,40,33,13
22023,203954,22300459,"JAN 02, 2024",PHI vs. CHI,W,31,10,20,0.5,2,5,0.4,9,12,0.75,0,15,15,10,1,2,4,4,31,32,1,Joel Embiid,PHI,PHI,CHI,33.5,Points,56,46,41,25
22023,203954,22300459,"JAN 02, 2024",PHI vs. CHI,W,31,10,20,0.5,2,5,0.4,9,12,0.75,0,15,15,10,1,2,4,4,31,32,1,Joel Embiid,PHI,PHI,CHI,11.0,Rebounds,56,46,41,25
22023,203954,22300459,"JAN 02, 2024",PHI vs. CHI,W,31,10,20,0.5,2,5,0.4,9,12,0.75,0,15,15,10,1,2,4,4,31,32,1,Joel Embiid,PHI,PHI,CHI,50.5,Pts+Rebs+Asts,56,46,41,25
22023,203954,22300459,"JAN 02, 2024",PHI vs. CHI,W,31,10,20,0.5,2,5,0.4,9,12,0.75,0,15,15,10,1,2,4,4,31,32,1,Joel Embiid,PHI,PHI,CHI,5.0,Assists,56,46,41,25
22023,203954,22300459,"JAN 02, 2024",PHI vs. CHI,W,31,10,20,0.5,2,5,0.4,9,12,0.75,0,15,15,10,1,2,4,4,31,32,1,Joel Embiid,PHI,PHI,CHI,58.5,Fantasy Score,56,46,41,25
22023,203954,22300459,"JAN 02, 2024",PHI vs. CHI,W,31,10,20,0.5,2,5,0.4,9,12,0.75,0,15,15,10,1,2,4,4,31,32,1,Joel Embiid,PHI,PHI,CHI,9.5,Defensive Rebounds,56,46,41,25
22023,203954,22300459,"JAN 02, 2024",PHI vs. CHI,W,31,10,20,0.5,2,5,0.4,9,12,0.75,0,15,15,10,1,2,4,4,31,32,1,Joel Embiid,PHI,PHI,CHI,9.5,Free Throws Made,56,46,41,25
22023,203954,22300459,"JAN 02, 2024",PHI vs. CHI,W,31,10,20,0.5,2,5,0.4,9,12,0.75,0,15,15,10,1,2,4,4,31,32,1,Joel Embiid,PHI,PHI,CHI,21.5,FG Attempted,56,46,41,25
22023,203954,22300459,"JAN 02, 2024",PHI vs. CHI,W,31,10,20,0.5,2,5,0.4,9,12,0.75,0,15,15,10,1,2,4,4,31,32,1,Joel Embiid,PHI,PHI,CHI,44.5,Pts+Rebs,56,46,41,25
22023,203954,22300459,"JAN 02, 2024",PHI vs. CHI,W,31,10,20,0.5,2,5,0.4,9,12,0.75,0,15,15,10,1,2,4,4,31,32,1,Joel Embiid,PHI,PHI,CHI,1.0,Dunks,56,46,41,25
22023,203954,22300459,"JAN 02, 2024",PHI vs. CHI,W,31,10,20,0.5,2,5,0.4,9,12,0.75,0,15,15,10,1,2,4,4,31,32,1,Joel Embiid,PHI,PHI,CHI,38.5,Pts+Asts,56,46,41,25
22023,203954,22300459,"JAN 02, 2024",PHI vs. CHI,W,31,10,20,0.5,2,5,0.4,9,12,0.75,0,15,15,10,1,2,4,4,31,32,1,Joel Embiid,PHI,PHI,CHI,16.0,Rebs+Asts,56,46,41,25
22023,203954,22300382,"DEC 22, 2023",PHI vs. TOR,W,35,11,21,0.524,2,2,1.0,7,8,0.875,1,9,10,9,2,4,6,1,31,2,1,Joel Embiid,PHI,PHI,TOR,33.5,Points,50,41,40,19
22023,203954,22300382,"DEC 22, 2023",PHI vs. TOR,W,35,11,21,0.524,2,2,1.0,7,8,0.875,1,9,10,9,2,4,6,1,31,2,1,Joel Embiid,PHI,PHI,TOR,11.0,Rebounds,50,41,40,19
22023,203954,22300382,"DEC 22, 2023",PHI vs. TOR,W,35,11,21,0.524,2,2,1.0,7,8,0.875,1,9,10,9,2,4,6,1,31,2,1,Joel Embiid,PHI,PHI,TOR,50.5,Pts+Rebs+Asts,50,41,40,19
22023,203954,22300382,"DEC 22, 2023",PHI vs. TOR,W,35,11,21,0.524,2,2,1.0,7,8,0.875,1,9,10,9,2,4,6,1,31,2,1,Joel Embiid,PHI,PHI,TOR,5.0,Assists,50,41,40,19
22023,203954,22300382,"DEC 22, 2023",PHI vs. TOR,W,35,11,21,0.524,2,2,1.0,7,8,0.875,1,9,10,9,2,4,6,1,31,2,1,Joel Embiid,PHI,PHI,TOR,58.5,Fantasy Score,50,41,40,19
22023,203954,22300382,"DEC 22, 2023",PHI vs. TOR,W,35,11,21,0.524,2,2,1.0,7,8,0.875,1,9,10,9,2,4,6,1,31,2,1,Joel Embiid,PHI,PHI,TOR,9.5,Defensive Rebounds,50,41,40,19
22023,203954,22300382,"DEC 22, 2023",PHI vs. TOR,W,35,11,21,0.524,2,2,1.0,7,8,0.875,1,9,10,9,2,4,6,1,31,2,1,Joel Embiid,PHI,PHI,TOR,9.5,Free Throws Made,50,41,40,19
22023,203954,22300382,"DEC 22, 2023",PHI vs. TOR,W,35,11,21,0.524,2,2,1.0,7,8,0.875,1,9,10,9,2,4,6,1,31,2,1,Joel Embiid,PHI,PHI,TOR,21.5,FG Attempted,50,41,40,19
22023,203954,22300382,"DEC 22, 2023",PHI vs. TOR,W,35,11,21,0.524,2,2,1.0,7,8,0.875,1,9,10,9,2,4,6,1,31,2,1,Joel Embiid,PHI,PHI,TOR,44.5,Pts+Rebs,50,41,40,19
22023,203954,22300382,"DEC 22, 2023",PHI vs. TOR,W,35,11,21,0.524,2,2,1.0,7,8,0.875,1,9,10,9,2,4,6,1,31,2,1,Joel Embiid,PHI,PHI,TOR,1.0,Dunks,50,41,40,19
22023,203954,22300382,"DEC 22, 2023",PHI vs. TOR,W,35,11,21,0.524,2,2,1.0,7,8,0.875,1,9,10,9,2,4,6,1,31,2,1,Joel Embiid,PHI,PHI,TOR,38.5,Pts+Asts,50,41,40,19
22023,203954,22300382,"DEC 22, 2023",PHI vs. TOR,W,35,11,21,0.524,2,2,1.0,7,8,0.875,1,9,10,9,2,4,6,1,31,2,1,Joel Embiid,PHI,PHI,TOR,16.0,Rebs+Asts,50,41,40,19
22023,203954,22300367,"DEC 20, 2023",PHI vs. MIN,W,36,17,25,0.68,0,1,0.0,17,18,0.944,2,10,12,3,2,1,2,5,51,3,1,Joel Embiid,PHI,PHI,MIN,33.5,Points,66,63,54,15
22023,203954,22300367,"DEC 20, 2023",PHI vs. MIN,W,36,17,25,0.68,0,1,0.0,17,18,0.944,2,10,12,3,2,1,2,5,51,3,1,Joel Embiid,PHI,PHI,MIN,11.0,Rebounds,66,63,54,15
22023,203954,22300367,"DEC 20, 2023",PHI vs. MIN,W,36,17,25,0.68,0,1,0.0,17,18,0.944,2,10,12,3,2,1,2,5,51,3,1,Joel Embiid,PHI,PHI,MIN,50.5,Pts+Rebs+Asts,66,63,54,15
22023,203954,22300367,"DEC 20, 2023",PHI vs. MIN,W,36,17,25,0.68,0,1,0.0,17,18,0.944,2,10,12,3,2,1,2,5,51,3,1,Joel Embiid,PHI,PHI,MIN,5.0,Assists,66,63,54,15
22023,203954,22300367,"DEC 20, 2023",PHI vs. MIN,W,36,17,25,0.68,0,1,0.0,17,18,0.944,2,10,12,3,2,1,2,5,51,3,1,Joel Embiid,PHI,PHI,MIN,58.5,Fantasy Score,66,63,54,15
22023,203954,22300367,"DEC 20, 2023",PHI vs. MIN,W,36,17,25,0.68,0,1,0.0,17,18,0.944,2,10,12,3,2,1,2,5,51,3,1,Joel Embiid,PHI,PHI,MIN,9.5,Defensive Rebounds,66,63,54,15
22023,203954,22300367,"DEC 20, 2023",PHI vs. MIN,W,36,17,25,0.68,0,1,0.0,17,18,0.944,2,10,12,3,2,1,2,5,51,3,1,Joel Embiid,PHI,PHI,MIN,9.5,Free Throws Made,66,63,54,15
22023,203954,22300367,"DEC 20, 2023",PHI vs. MIN,W,36,17,25,0.68,0,1,0.0,17,18,0.944,2,10,12,3,2,1,2,5,51,3,1,Joel Embiid,PHI,PHI,MIN,21.5,FG Attempted,66,63,54,15
22023,203954,22300367,"DEC 20, 2023",PHI vs. MIN,W,36,17,25,0.68,0,1,0.0,17,18,0.944,2,10,12,3,2,1,2,5,51,3,1,Joel Embiid,PHI,PHI,MIN,44.5,Pts+Rebs,66,63,54,15
22023,203954,22300367,"DEC 20, 2023",PHI vs. MIN,W,36,17,25,0.68,0,1,0.0,17,18,0.944,2,10,12,3,2,1,2,5,51,3,1,Joel Embiid,PHI,PHI,MIN,1.0,Dunks,66,63,54,15
22023,203954,22300367,"DEC 20, 2023",PHI vs. MIN,W,36,17,25,0.68,0,1,0.0,17,18,0.944,2,10,12,3,2,1,2,5,51,3,1,Joel Embiid,PHI,PHI,MIN,38.5,Pts+Asts,66,63,54,15
22023,203954,22300367,"DEC 20, 2023",PHI vs. MIN,W,36,17,25,0.68,0,1,0.0,17,18,0.944,2,10,12,3,2,1,2,5,51,3,1,Joel Embiid,PHI,PHI,MIN,16.0,Rebs+Asts,66,63,54,15
22023,203954,22300351,"DEC 18, 2023",PHI vs. CHI,L,37,15,28,0.536,2,6,0.333,8,9,0.889,1,13,14,6,0,2,4,5,40,-5,1,Joel Embiid,PHI,PHI,CHI,33.5,Points,60,54,46,20
22023,203954,22300351,"DEC 18, 2023",PHI vs. CHI,L,37,15,28,0.536,2,6,0.333,8,9,0.889,1,13,14,6,0,2,4,5,40,-5,1,Joel Embiid,PHI,PHI,CHI,11.0,Rebounds,60,54,46,20
22023,203954,22300351,"DEC 18, 2023",PHI vs. CHI,L,37,15,28,0.536,2,6,0.333,8,9,0.889,1,13,14,6,0,2,4,5,40,-5,1,Joel Embiid,PHI,PHI,CHI,50.5,Pts+Rebs+Asts,60,54,46,20
22023,203954,22300351,"DEC 18, 2023",PHI vs. CHI,L,37,15,28,0.536,2,6,0.333,8,9,0.889,1,13,14,6,0,2,4,5,40,-5,1,Joel Embiid,PHI,PHI,CHI,5.0,Assists,60,54,46,20
22023,203954,22300351,"DEC 18, 2023",PHI vs. CHI,L,37,15,28,0.536,2,6,0.333,8,9,0.889,1,13,14,6,0,2,4,5,40,-5,1,Joel Embiid,PHI,PHI,CHI,58.5,Fantasy Score,60,54,46,20
22023,203954,22300351,"DEC 18, 2023",PHI vs. CHI,L,37,15,28,0.536,2,6,0.333,8,9,0.889,1,13,14,6,0,2,4,5,40,-5,1,Joel Embiid,PHI,PHI,CHI,9.5,Defensive Rebounds,60,54,46,20
22023,203954,22300351,"DEC 18, 2023",PHI vs. CHI,L,37,15,28,0.536,2,6,0.333,8,9,0.889,1,13,14,6,0,2,4,5,40,-5,1,Joel Embiid,PHI,PHI,CHI,9.5,Free Throws Made,60,54,46,20
22023,203954,22300351,"DEC 18, 2023",PHI vs. CHI,L,37,15,28,0.536,2,6,0.333,8,9,0.889,1,13,14,6,0,2,4,5,40,-5,1,Joel Embiid,PHI,PHI,CHI,21.5,FG Attempted,60,54,46,20
22023,203954,22300351,"DEC 18, 2023",PHI vs. CHI,L,37,15,28,0.536,2,6,0.333,8,9,0.889,1,13,14,6,0,2,4,5,40,-5,1,Joel Embiid,PHI,PHI,CHI,44.5,Pts+Rebs,60,54,46,20
22023,203954,22300351,"DEC 18, 2023",PHI vs. CHI,L,37,15,28,0.536,2,6,0.333,8,9,0.889,1,13,14,6,0,2,4,5,40,-5,1,Joel Embiid,PHI,PHI,CHI,1.0,Dunks,60,54,46,20
22023,203954,22300351,"DEC 18, 2023",PHI vs. CHI,L,37,15,28,0.536,2,6,0.333,8,9,0.889,1,13,14,6,0,2,4,5,40,-5,1,Joel Embiid,PHI,PHI,CHI,38.5,Pts+Asts,60,54,46,20
22023,203954,22300351,"DEC 18, 2023",PHI vs. CHI,L,37,15,28,0.536,2,6,0.333,8,9,0.889,1,13,14,6,0,2,4,5,40,-5,1,Joel Embiid,PHI,PHI,CHI,16.0,Rebs+Asts,60,54,46,20
22023,203954,22300335,"DEC 16, 2023",PHI @ CHA,W,30,18,23,0.783,0,1,0.0,6,6,1.0,0,15,15,3,1,2,4,2,42,36,1,Joel Embiid,PHI,CHA,PHI,33.5,Points,60,57,45,18
22023,203954,22300335,"DEC 16, 2023",PHI @ CHA,W,30,18,23,0.783,0,1,0.0,6,6,1.0,0,15,15,3,1,2,4,2,42,36,1,Joel Embiid,PHI,CHA,PHI,11.0,Rebounds,60,57,45,18
22023,203954,22300335,"DEC 16, 2023",PHI @ CHA,W,30,18,23,0.783,0,1,0.0,6,6,1.0,0,15,15,3,1,2,4,2,42,36,1,Joel Embiid,PHI,CHA,PHI,50.5,Pts+Rebs+Asts,60,57,45,18
22023,203954,22300335,"DEC 16, 2023",PHI @ CHA,W,30,18,23,0.783,0,1,0.0,6,6,1.0,0,15,15,3,1,2,4,2,42,36,1,Joel Embiid,PHI,CHA,PHI,5.0,Assists,60,57,45,18
22023,203954,22300335,"DEC 16, 2023",PHI @ CHA,W,30,18,23,0.783,0,1,0.0,6,6,1.0,0,15,15,3,1,2,4,2,42,36,1,Joel Embiid,PHI,CHA,PHI,58.5,Fantasy Score,60,57,45,18
22023,203954,22300335,"DEC 16, 2023",PHI @ CHA,W,30,18,23,0.783,0,1,0.0,6,6,1.0,0,15,15,3,1,2,4,2,42,36,1,Joel Embiid,PHI,CHA,PHI,9.5,Defensive Rebounds,60,57,45,18
22023,203954,22300335,"DEC 16, 2023",PHI @ CHA,W,30,18,23,0.783,0,1,0.0,6,6,1.0,0,15,15,3,1,2,4,2,42,36,1,Joel Embiid,PHI,CHA,PHI,9.5,Free Throws Made,60,57,45,18
22023,203954,22300335,"DEC 16, 2023",PHI @ CHA,W,30,18,23,0.783,0,1,0.0,6,6,1.0,0,15,15,3,1,2,4,2,42,36,1,Joel Embiid,PHI,CHA,PHI,21.5,FG Attempted,60,57,45,18
22023,203954,22300335,"DEC 16, 2023",PHI @ CHA,W,30,18,23,0.783,0,1,0.0,6,6,1.0,0,15,15,3,1,2,4,2,42,36,1,Joel Embiid,PHI,CHA,PHI,44.5,Pts+Rebs,60,57,45,18
22023,203954,22300335,"DEC 16, 2023",PHI @ CHA,W,30,18,23,0.783,0,1,0.0,6,6,1.0,0,15,15,3,1,2,4,2,42,36,1,Joel Embiid,PHI,CHA,PHI,1.0,Dunks,60,57,45,18
22023,203954,22300335,"DEC 16, 2023",PHI @ CHA,W,30,18,23,0.783,0,1,0.0,6,6,1.0,0,15,15,3,1,2,4,2,42,36,1,Joel Embiid,PHI,CHA,PHI,38.5,Pts+Asts,60,57,45,18
22023,203954,22300335,"DEC 16, 2023",PHI @ CHA,W,30,18,23,0.783,0,1,0.0,6,6,1.0,0,15,15,3,1,2,4,2,42,36,1,Joel Embiid,PHI,CHA,PHI,16.0,Rebs+Asts,60,57,45,18
22023,203954,22300327,"DEC 15, 2023",PHI vs. DET,W,29,9,19,0.474,2,3,0.667,15,16,0.938,0,13,13,2,2,4,4,2,35,28,1,Joel Embiid,PHI,PHI,DET,33.5,Points,50,48,37,15
22023,203954,22300327,"DEC 15, 2023",PHI vs. DET,W,29,9,19,0.474,2,3,0.667,15,16,0.938,0,13,13,2,2,4,4,2,35,28,1,Joel Embiid,PHI,PHI,DET,11.0,Rebounds,50,48,37,15
22023,203954,22300327,"DEC 15, 2023",PHI vs. DET,W,29,9,19,0.474,2,3,0.667,15,16,0.938,0,13,13,2,2,4,4,2,35,28,1,Joel Embiid,PHI,PHI,DET,50.5,Pts+Rebs+Asts,50,48,37,15
22023,203954,22300327,"DEC 15, 2023",PHI vs. DET,W,29,9,19,0.474,2,3,0.667,15,16,0.938,0,13,13,2,2,4,4,2,35,28,1,Joel Embiid,PHI,PHI,DET,5.0,Assists,50,48,37,15
22023,203954,22300327,"DEC 15, 2023",PHI vs. DET,W,29,9,19,0.474,2,3,0.667,15,16,0.938,0,13,13,2,2,4,4,2,35,28,1,Joel Embiid,PHI,PHI,DET,58.5,Fantasy Score,50,48,37,15
22023,203954,22300327,"DEC 15, 2023",PHI vs. DET,W,29,9,19,0.474,2,3,0.667,15,16,0.938,0,13,13,2,2,4,4,2,35,28,1,Joel Embiid,PHI,PHI,DET,9.5,Defensive Rebounds,50,48,37,15
22023,203954,22300327,"DEC 15, 2023",PHI vs. DET,W,29,9,19,0.474,2,3,0.667,15,16,0.938,0,13,13,2,2,4,4,2,35,28,1,Joel Embiid,PHI,PHI,DET,9.5,Free Throws Made,50,48,37,15
22023,203954,22300327,"DEC 15, 2023",PHI vs. DET,W,29,9,19,0.474,2,3,0.667,15,16,0.938,0,13,13,2,2,4,4,2,35,28,1,Joel Embiid,PHI,PHI,DET,21.5,FG Attempted,50,48,37,15
22023,203954,22300327,"DEC 15, 2023",PHI vs. DET,W,29,9,19,0.474,2,3,0.667,15,16,0.938,0,13,13,2,2,4,4,2,35,28,1,Joel Embiid,PHI,PHI,DET,44.5,Pts+Rebs,50,48,37,15
22023,203954,22300327,"DEC 15, 2023",PHI vs. DET,W,29,9,19,0.474,2,3,0.667,15,16,0.938,0,13,13,2,2,4,4,2,35,28,1,Joel Embiid,PHI,PHI,DET,1.0,Dunks,50,48,37,15
22023,203954,22300327,"DEC 15, 2023",PHI vs. DET,W,29,9,19,0.474,2,3,0.667,15,16,0.938,0,13,13,2,2,4,4,2,35,28,1,Joel Embiid,PHI,PHI,DET,38.5,Pts+Asts,50,48,37,15
22023,203954,22300327,"DEC 15, 2023",PHI vs. DET,W,29,9,19,0.474,2,3,0.667,15,16,0.938,0,13,13,2,2,4,4,2,35,28,1,Joel Embiid,PHI,PHI,DET,16.0,Rebs+Asts,50,48,37,15
22023,203954,22300310,"DEC 13, 2023",PHI @ DET,W,31,14,24,0.583,1,3,0.333,12,12,1.0,4,7,11,5,2,0,2,1,41,27,1,Joel Embiid,PHI,DET,PHI,33.5,Points,57,52,46,16
22023,203954,22300310,"DEC 13, 2023",PHI @ DET,W,31,14,24,0.583,1,3,0.333,12,12,1.0,4,7,11,5,2,0,2,1,41,27,1,Joel Embiid,PHI,DET,PHI,11.0,Rebounds,57,52,46,16
22023,203954,22300310,"DEC 13, 2023",PHI @ DET,W,31,14,24,0.583,1,3,0.333,12,12,1.0,4,7,11,5,2,0,2,1,41,27,1,Joel Embiid,PHI,DET,PHI,50.5,Pts+Rebs+Asts,57,52,46,16
22023,203954,22300310,"DEC 13, 2023",PHI @ DET,W,31,14,24,0.583,1,3,0.333,12,12,1.0,4,7,11,5,2,0,2,1,41,27,1,Joel Embiid,PHI,DET,PHI,5.0,Assists,57,52,46,16
22023,203954,22300310,"DEC 13, 2023",PHI @ DET,W,31,14,24,0.583,1,3,0.333,12,12,1.0,4,7,11,5,2,0,2,1,41,27,1,Joel Embiid,PHI,DET,PHI,58.5,Fantasy Score,57,52,46,16
22023,203954,22300310,"DEC 13, 2023",PHI @ DET,W,31,14,24,0.583,1,3,0.333,12,12,1.0,4,7,11,5,2,0,2,1,41,27,1,Joel Embiid,PHI,DET,PHI,9.5,Defensive Rebounds,57,52,46,16
22023,203954,22300310,"DEC 13, 2023",PHI @ DET,W,31,14,24,0.583,1,3,0.333,12,12,1.0,4,7,11,5,2,0,2,1,41,27,1,Joel Embiid,PHI,DET,PHI,9.5,Free Throws Made,57,52,46,16
22023,203954,22300310,"DEC 13, 2023",PHI @ DET,W,31,14,24,0.583,1,3,0.333,12,12,1.0,4,7,11,5,2,0,2,1,41,27,1,Joel Embiid,PHI,DET,PHI,21.5,FG Attempted,57,52,46,16
22023,203954,22300310,"DEC 13, 2023",PHI @ DET,W,31,14,24,0.583,1,3,0.333,12,12,1.0,4,7,11,5,2,0,2,1,41,27,1,Joel Embiid,PHI,DET,PHI,44.5,Pts+Rebs,57,52,46,16
22023,203954,22300310,"DEC 13, 2023",PHI @ DET,W,31,14,24,0.583,1,3,0.333,12,12,1.0,4,7,11,5,2,0,2,1,41,27,1,Joel Embiid,PHI,DET,PHI,1.0,Dunks,57,52,46,16
22023,203954,22300310,"DEC 13, 2023",PHI @ DET,W,31,14,24,0.583,1,3,0.333,12,12,1.0,4,7,11,5,2,0,2,1,41,27,1,Joel Embiid,PHI,DET,PHI,38.5,Pts+Asts,57,52,46,16
22023,203954,22300310,"DEC 13, 2023",PHI @ DET,W,31,14,24,0.583,1,3,0.333,12,12,1.0,4,7,11,5,2,0,2,1,41,27,1,Joel Embiid,PHI,DET,PHI,16.0,Rebs+Asts,57,52,46,16
22023,203954,22300295,"DEC 11, 2023",PHI vs. WAS,W,30,14,20,0.7,2,5,0.4,4,4,1.0,0,11,11,6,2,1,7,4,34,30,1,Joel Embiid,PHI,PHI,WAS,33.5,Points,51,45,40,17
22023,203954,22300295,"DEC 11, 2023",PHI vs. WAS,W,30,14,20,0.7,2,5,0.4,4,4,1.0,0,11,11,6,2,1,7,4,34,30,1,Joel Embiid,PHI,PHI,WAS,11.0,Rebounds,51,45,40,17
22023,203954,22300295,"DEC 11, 2023",PHI vs. WAS,W,30,14,20,0.7,2,5,0.4,4,4,1.0,0,11,11,6,2,1,7,4,34,30,1,Joel Embiid,PHI,PHI,WAS,50.5,Pts+Rebs+Asts,51,45,40,17
22023,203954,22300295,"DEC 11, 2023",PHI vs. WAS,W,30,14,20,0.7,2,5,0.4,4,4,1.0,0,11,11,6,2,1,7,4,34,30,1,Joel Embiid,PHI,PHI,WAS,5.0,Assists,51,45,40,17
22023,203954,22300295,"DEC 11, 2023",PHI vs. WAS,W,30,14,20,0.7,2,5,0.4,4,4,1.0,0,11,11,6,2,1,7,4,34,30,1,Joel Embiid,PHI,PHI,WAS,58.5,Fantasy Score,51,45,40,17
22023,203954,22300295,"DEC 11, 2023",PHI vs. WAS,W,30,14,20,0.7,2,5,0.4,4,4,1.0,0,11,11,6,2,1,7,4,34,30,1,Joel Embiid,PHI,PHI,WAS,9.5,Defensive Rebounds,51,45,40,17
22023,203954,22300295,"DEC 11, 2023",PHI vs. WAS,W,30,14,20,0.7,2,5,0.4,4,4,1.0,0,11,11,6,2,1,7,4,34,30,1,Joel Embiid,PHI,PHI,WAS,9.5,Free Throws Made,51,45,40,17
22023,203954,22300295,"DEC 11, 2023",PHI vs. WAS,W,30,14,20,0.7,2,5,0.4,4,4,1.0,0,11,11,6,2,1,7,4,34,30,1,Joel Embiid,PHI,PHI,WAS,21.5,FG Attempted,51,45,40,17
22023,203954,22300295,"DEC 11, 2023",PHI vs. WAS,W,30,14,20,0.7,2,5,0.4,4,4,1.0,0,11,11,6,2,1,7,4,34,30,1,Joel Embiid,PHI,PHI,WAS,44.5,Pts+Rebs,51,45,40,17
22023,203954,22300295,"DEC 11, 2023",PHI vs. WAS,W,30,14,20,0.7,2,5,0.4,4,4,1.0,0,11,11,6,2,1,7,4,34,30,1,Joel Embiid,PHI,PHI,WAS,1.0,Dunks,51,45,40,17
22023,203954,22300295,"DEC 11, 2023",PHI vs. WAS,W,30,14,20,0.7,2,5,0.4,4,4,1.0,0,11,11,6,2,1,7,4,34,30,1,Joel Embiid,PHI,PHI,WAS,38.5,Pts+Asts,51,45,40,17
22023,203954,22300295,"DEC 11, 2023",PHI vs. WAS,W,30,14,20,0.7,2,5,0.4,4,4,1.0,0,11,11,6,2,1,7,4,34,30,1,Joel Embiid,PHI,PHI,WAS,16.0,Rebs+Asts,51,45,40,17
22023,203954,22301218,"DEC 08, 2023",PHI vs. ATL,W,36,12,24,0.5,1,3,0.333,13,15,0.867,4,10,14,3,1,4,2,1,38,16,1,Joel Embiid,PHI,PHI,ATL,33.5,Points,55,52,41,17
22023,203954,22301218,"DEC 08, 2023",PHI vs. ATL,W,36,12,24,0.5,1,3,0.333,13,15,0.867,4,10,14,3,1,4,2,1,38,16,1,Joel Embiid,PHI,PHI,ATL,11.0,Rebounds,55,52,41,17
22023,203954,22301218,"DEC 08, 2023",PHI vs. ATL,W,36,12,24,0.5,1,3,0.333,13,15,0.867,4,10,14,3,1,4,2,1,38,16,1,Joel Embiid,PHI,PHI,ATL,50.5,Pts+Rebs+Asts,55,52,41,17
22023,203954,22301218,"DEC 08, 2023",PHI vs. ATL,W,36,12,24,0.5,1,3,0.333,13,15,0.867,4,10,14,3,1,4,2,1,38,16,1,Joel Embiid,PHI,PHI,ATL,5.0,Assists,55,52,41,17
22023,203954,22301218,"DEC 08, 2023",PHI vs. ATL,W,36,12,24,0.5,1,3,0.333,13,15,0.867,4,10,14,3,1,4,2,1,38,16,1,Joel Embiid,PHI,PHI,ATL,58.5,Fantasy Score,55,52,41,17
22023,203954,22301218,"DEC 08, 2023",PHI vs. ATL,W,36,12,24,0.5,1,3,0.333,13,15,0.867,4,10,14,3,1,4,2,1,38,16,1,Joel Embiid,PHI,PHI,ATL,9.5,Defensive Rebounds,55,52,41,17
22023,203954,22301218,"DEC 08, 2023",PHI vs. ATL,W,36,12,24,0.5,1,3,0.333,13,15,0.867,4,10,14,3,1,4,2,1,38,16,1,Joel Embiid,PHI,PHI,ATL,9.5,Free Throws Made,55,52,41,17
22023,203954,22301218,"DEC 08, 2023",PHI vs. ATL,W,36,12,24,0.5,1,3,0.333,13,15,0.867,4,10,14,3,1,4,2,1,38,16,1,Joel Embiid,PHI,PHI,ATL,21.5,FG Attempted,55,52,41,17
22023,203954,22301218,"DEC 08, 2023",PHI vs. ATL,W,36,12,24,0.5,1,3,0.333,13,15,0.867,4,10,14,3,1,4,2,1,38,16,1,Joel Embiid,PHI,PHI,ATL,44.5,Pts+Rebs,55,52,41,17
22023,203954,22301218,"DEC 08, 2023",PHI vs. ATL,W,36,12,24,0.5,1,3,0.333,13,15,0.867,4,10,14,3,1,4,2,1,38,16,1,Joel Embiid,PHI,PHI,ATL,1.0,Dunks,55,52,41,17
22023,203954,22301218,"DEC 08, 2023",PHI vs. ATL,W,36,12,24,0.5,1,3,0.333,13,15,0.867,4,10,14,3,1,4,2,1,38,16,1,Joel Embiid,PHI,PHI,ATL,38.5,Pts+Asts,55,52,41,17
22023,203954,22301218,"DEC 08, 2023",PHI vs. ATL,W,36,12,24,0.5,1,3,0.333,13,15,0.867,4,10,14,3,1,4,2,1,38,16,1,Joel Embiid,PHI,PHI,ATL,16.0,Rebs+Asts,55,52,41,17
22023,203954,22301208,"DEC 06, 2023",PHI @ WAS,W,38,19,29,0.655,1,2,0.5,11,13,0.846,6,7,13,7,1,1,6,2,50,8,1,Joel Embiid,PHI,WAS,PHI,33.5,Points,70,63,57,20
22023,203954,22301208,"DEC 06, 2023",PHI @ WAS,W,38,19,29,0.655,1,2,0.5,11,13,0.846,6,7,13,7,1,1,6,2,50,8,1,Joel Embiid,PHI,WAS,PHI,11.0,Rebounds,70,63,57,20
22023,203954,22301208,"DEC 06, 2023",PHI @ WAS,W,38,19,29,0.655,1,2,0.5,11,13,0.846,6,7,13,7,1,1,6,2,50,8,1,Joel Embiid,PHI,WAS,PHI,50.5,Pts+Rebs+Asts,70,63,57,20
22023,203954,22301208,"DEC 06, 2023",PHI @ WAS,W,38,19,29,0.655,1,2,0.5,11,13,0.846,6,7,13,7,1,1,6,2,50,8,1,Joel Embiid,PHI,WAS,PHI,5.0,Assists,70,63,57,20
22023,203954,22301208,"DEC 06, 2023",PHI @ WAS,W,38,19,29,0.655,1,2,0.5,11,13,0.846,6,7,13,7,1,1,6,2,50,8,1,Joel Embiid,PHI,WAS,PHI,58.5,Fantasy Score,70,63,57,20
22023,203954,22301208,"DEC 06, 2023",PHI @ WAS,W,38,19,29,0.655,1,2,0.5,11,13,0.846,6,7,13,7,1,1,6,2,50,8,1,Joel Embiid,PHI,WAS,PHI,9.5,Defensive Rebounds,70,63,57,20
22023,203954,22301208,"DEC 06, 2023",PHI @ WAS,W,38,19,29,0.655,1,2,0.5,11,13,0.846,6,7,13,7,1,1,6,2,50,8,1,Joel Embiid,PHI,WAS,PHI,9.5,Free Throws Made,70,63,57,20
22023,203954,22301208,"DEC 06, 2023",PHI @ WAS,W,38,19,29,0.655,1,2,0.5,11,13,0.846,6,7,13,7,1,1,6,2,50,8,1,Joel Embiid,PHI,WAS,PHI,21.5,FG Attempted,70,63,57,20
22023,203954,22301208,"DEC 06, 2023",PHI @ WAS,W,38,19,29,0.655,1,2,0.5,11,13,0.846,6,7,13,7,1,1,6,2,50,8,1,Joel Embiid,PHI,WAS,PHI,44.5,Pts+Rebs,70,63,57,20
22023,203954,22301208,"DEC 06, 2023",PHI @ WAS,W,38,19,29,0.655,1,2,0.5,11,13,0.846,6,7,13,7,1,1,6,2,50,8,1,Joel Embiid,PHI,WAS,PHI,1.0,Dunks,70,63,57,20
22023,203954,22301208,"DEC 06, 2023",PHI @ WAS,W,38,19,29,0.655,1,2,0.5,11,13,0.846,6,7,13,7,1,1,6,2,50,8,1,Joel Embiid,PHI,WAS,PHI,38.5,Pts+Asts,70,63,57,20
22023,203954,22301208,"DEC 06, 2023",PHI @ WAS,W,38,19,29,0.655,1,2,0.5,11,13,0.846,6,7,13,7,1,1,6,2,50,8,1,Joel Embiid,PHI,WAS,PHI,16.0,Rebs+Asts,70,63,57,20
22023,203954,22300255,"NOV 27, 2023",PHI vs. LAL,W,31,9,15,0.6,2,3,0.667,10,12,0.833,4,7,11,11,1,1,3,2,30,11,1,Joel Embiid,PHI,PHI,LAL,33.5,Points,52,41,41,22
22023,203954,22300255,"NOV 27, 2023",PHI vs. LAL,W,31,9,15,0.6,2,3,0.667,10,12,0.833,4,7,11,11,1,1,3,2,30,11,1,Joel Embiid,PHI,PHI,LAL,11.0,Rebounds,52,41,41,22
22023,203954,22300255,"NOV 27, 2023",PHI vs. LAL,W,31,9,15,0.6,2,3,0.667,10,12,0.833,4,7,11,11,1,1,3,2,30,11,1,Joel Embiid,PHI,PHI,LAL,50.5,Pts+Rebs+Asts,52,41,41,22
22023,203954,22300255,"NOV 27, 2023",PHI vs. LAL,W,31,9,15,0.6,2,3,0.667,10,12,0.833,4,7,11,11,1,1,3,2,30,11,1,Joel Embiid,PHI,PHI,LAL,5.0,Assists,52,41,41,22
22023,203954,22300255,"NOV 27, 2023",PHI vs. LAL,W,31,9,15,0.6,2,3,0.667,10,12,0.833,4,7,11,11,1,1,3,2,30,11,1,Joel Embiid,PHI,PHI,LAL,58.5,Fantasy Score,52,41,41,22
22023,203954,22300255,"NOV 27, 2023",PHI vs. LAL,W,31,9,15,0.6,2,3,0.667,10,12,0.833,4,7,11,11,1,1,3,2,30,11,1,Joel Embiid,PHI,PHI,LAL,9.5,Defensive Rebounds,52,41,41,22
22023,203954,22300255,"NOV 27, 2023",PHI vs. LAL,W,31,9,15,0.6,2,3,0.667,10,12,0.833,4,7,11,11,1,1,3,2,30,11,1,Joel Embiid,PHI,PHI,LAL,9.5,Free Throws Made,52,41,41,22
22023,203954,22300255,"NOV 27, 2023",PHI vs. LAL,W,31,9,15,0.6,2,3,0.667,10,12,0.833,4,7,11,11,1,1,3,2,30,11,1,Joel Embiid,PHI,PHI,LAL,21.5,FG Attempted,52,41,41,22
22023,203954,22300255,"NOV 27, 2023",PHI vs. LAL,W,31,9,15,0.6,2,3,0.667,10,12,0.833,4,7,11,11,1,1,3,2,30,11,1,Joel Embiid,PHI,PHI,LAL,44.5,Pts+Rebs,52,41,41,22
22023,203954,22300255,"NOV 27, 2023",PHI vs. LAL,W,31,9,15,0.6,2,3,0.667,10,12,0.833,4,7,11,11,1,1,3,2,30,11,1,Joel Embiid,PHI,PHI,LAL,1.0,Dunks,52,41,41,22
22023,203954,22300255,"NOV 27, 2023",PHI vs. LAL,W,31,9,15,0.6,2,3,0.667,10,12,0.833,4,7,11,11,1,1,3,2,30,11,1,Joel Embiid,PHI,PHI,LAL,38.5,Pts+Asts,52,41,41,22
22023,203954,22300255,"NOV 27, 2023",PHI vs. LAL,W,31,9,15,0.6,2,3,0.667,10,12,0.833,4,7,11,11,1,1,3,2,30,11,1,Joel Embiid,PHI,PHI,LAL,16.0,Rebs+Asts,52,41,41,22
22023,203954,22300239,"NOV 25, 2023",PHI @ OKC,W,37,8,18,0.444,0,4,0.0,19,21,0.905,4,7,11,9,1,4,4,5,35,7,1,Joel Embiid,PHI,OKC,PHI,33.5,Points,55,46,44,20
22023,203954,22300239,"NOV 25, 2023",PHI @ OKC,W,37,8,18,0.444,0,4,0.0,19,21,0.905,4,7,11,9,1,4,4,5,35,7,1,Joel Embiid,PHI,OKC,PHI,11.0,Rebounds,55,46,44,20
22023,203954,22300239,"NOV 25, 2023",PHI @ OKC,W,37,8,18,0.444,0,4,0.0,19,21,0.905,4,7,11,9,1,4,4,5,35,7,1,Joel Embiid,PHI,OKC,PHI,50.5,Pts+Rebs+Asts,55,46,44,20
22023,203954,22300239,"NOV 25, 2023",PHI @ OKC,W,37,8,18,0.444,0,4,0.0,19,21,0.905,4,7,11,9,1,4,4,5,35,7,1,Joel Embiid,PHI,OKC,PHI,5.0,Assists,55,46,44,20
22023,203954,22300239,"NOV 25, 2023",PHI @ OKC,W,37,8,18,0.444,0,4,0.0,19,21,0.905,4,7,11,9,1,4,4,5,35,7,1,Joel Embiid,PHI,OKC,PHI,58.5,Fantasy Score,55,46,44,20
22023,203954,22300239,"NOV 25, 2023",PHI @ OKC,W,37,8,18,0.444,0,4,0.0,19,21,0.905,4,7,11,9,1,4,4,5,35,7,1,Joel Embiid,PHI,OKC,PHI,9.5,Defensive Rebounds,55,46,44,20
22023,203954,22300239,"NOV 25, 2023",PHI @ OKC,W,37,8,18,0.444,0,4,0.0,19,21,0.905,4,7,11,9,1,4,4,5,35,7,1,Joel Embiid,PHI,OKC,PHI,9.5,Free Throws Made,55,46,44,20
22023,203954,22300239,"NOV 25, 2023",PHI @ OKC,W,37,8,18,0.444,0,4,0.0,19,21,0.905,4,7,11,9,1,4,4,5,35,7,1,Joel Embiid,PHI,OKC,PHI,21.5,FG Attempted,55,46,44,20
22023,203954,22300239,"NOV 25, 2023",PHI @ OKC,W,37,8,18,0.444,0,4,0.0,19,21,0.905,4,7,11,9,1,4,4,5,35,7,1,Joel Embiid,PHI,OKC,PHI,44.5,Pts+Rebs,55,46,44,20
22023,203954,22300239,"NOV 25, 2023",PHI @ OKC,W,37,8,18,0.444,0,4,0.0,19,21,0.905,4,7,11,9,1,4,4,5,35,7,1,Joel Embiid,PHI,OKC,PHI,1.0,Dunks,55,46,44,20
22023,203954,22300239,"NOV 25, 2023",PHI @ OKC,W,37,8,18,0.444,0,4,0.0,19,21,0.905,4,7,11,9,1,4,4,5,35,7,1,Joel Embiid,PHI,OKC,PHI,38.5,Pts+Asts,55,46,44,20
22023,203954,22300239,"NOV 25, 2023",PHI @ OKC,W,37,8,18,0.444,0,4,0.0,19,21,0.905,4,7,11,9,1,4,4,5,35,7,1,Joel Embiid,PHI,OKC,PHI,16.0,Rebs+Asts,55,46,44,20
22023,203954,22300040,"NOV 21, 2023",PHI vs. CLE,L,41,9,21,0.429,1,3,0.333,13,16,0.813,3,10,13,5,2,5,6,6,32,3,1,Joel Embiid,PHI,PHI,CLE,33.5,Points,50,45,37,18
22023,203954,22300040,"NOV 21, 2023",PHI vs. CLE,L,41,9,21,0.429,1,3,0.333,13,16,0.813,3,10,13,5,2,5,6,6,32,3,1,Joel Embiid,PHI,PHI,CLE,11.0,Rebounds,50,45,37,18
22023,203954,22300040,"NOV 21, 2023",PHI vs. CLE,L,41,9,21,0.429,1,3,0.333,13,16,0.813,3,10,13,5,2,5,6,6,32,3,1,Joel Embiid,PHI,PHI,CLE,50.5,Pts+Rebs+Asts,50,45,37,18
22023,203954,22300040,"NOV 21, 2023",PHI vs. CLE,L,41,9,21,0.429,1,3,0.333,13,16,0.813,3,10,13,5,2,5,6,6,32,3,1,Joel Embiid,PHI,PHI,CLE,5.0,Assists,50,45,37,18
22023,203954,22300040,"NOV 21, 2023",PHI vs. CLE,L,41,9,21,0.429,1,3,0.333,13,16,0.813,3,10,13,5,2,5,6,6,32,3,1,Joel Embiid,PHI,PHI,CLE,58.5,Fantasy Score,50,45,37,18
22023,203954,22300040,"NOV 21, 2023",PHI vs. CLE,L,41,9,21,0.429,1,3,0.333,13,16,0.813,3,10,13,5,2,5,6,6,32,3,1,Joel Embiid,PHI,PHI,CLE,9.5,Defensive Rebounds,50,45,37,18
22023,203954,22300040,"NOV 21, 2023",PHI vs. CLE,L,41,9,21,0.429,1,3,0.333,13,16,0.813,3,10,13,5,2,5,6,6,32,3,1,Joel Embiid,PHI,PHI,CLE,9.5,Free Throws Made,50,45,37,18
22023,203954,22300040,"NOV 21, 2023",PHI vs. CLE,L,41,9,21,0.429,1,3,0.333,13,16,0.813,3,10,13,5,2,5,6,6,32,3,1,Joel Embiid,PHI,PHI,CLE,21.5,FG Attempted,50,45,37,18
22023,203954,22300040,"NOV 21, 2023",PHI vs. CLE,L,41,9,21,0.429,1,3,0.333,13,16,0.813,3,10,13,5,2,5,6,6,32,3,1,Joel Embiid,PHI,PHI,CLE,44.5,Pts+Rebs,50,45,37,18
22023,203954,22300040,"NOV 21, 2023",PHI vs. CLE,L,41,9,21,0.429,1,3,0.333,13,16,0.813,3,10,13,5,2,5,6,6,32,3,1,Joel Embiid,PHI,PHI,CLE,1.0,Dunks,50,45,37,18
22023,203954,22300040,"NOV 21, 2023",PHI vs. CLE,L,41,9,21,0.429,1,3,0.333,13,16,0.813,3,10,13,5,2,5,6,6,32,3,1,Joel Embiid,PHI,PHI,CLE,38.5,Pts+Asts,50,45,37,18
22023,203954,22300040,"NOV 21, 2023",PHI vs. CLE,L,41,9,21,0.429,1,3,0.333,13,16,0.813,3,10,13,5,2,5,6,6,32,3,1,Joel Embiid,PHI,PHI,CLE,16.0,Rebs+Asts,50,45,37,18
22023,203954,22300208,"NOV 19, 2023",PHI @ BKN,W,31,11,24,0.458,1,2,0.5,9,10,0.9,2,10,12,9,0,1,1,3,32,25,1,Joel Embiid,PHI,BKN,PHI,33.5,Points,53,44,41,21
22023,203954,22300208,"NOV 19, 2023",PHI @ BKN,W,31,11,24,0.458,1,2,0.5,9,10,0.9,2,10,12,9,0,1,1,3,32,25,1,Joel Embiid,PHI,BKN,PHI,11.0,Rebounds,53,44,41,21
22023,203954,22300208,"NOV 19, 2023",PHI @ BKN,W,31,11,24,0.458,1,2,0.5,9,10,0.9,2,10,12,9,0,1,1,3,32,25,1,Joel Embiid,PHI,BKN,PHI,50.5,Pts+Rebs+Asts,53,44,41,21
22023,203954,22300208,"NOV 19, 2023",PHI @ BKN,W,31,11,24,0.458,1,2,0.5,9,10,0.9,2,10,12,9,0,1,1,3,32,25,1,Joel Embiid,PHI,BKN,PHI,5.0,Assists,53,44,41,21
22023,203954,22300208,"NOV 19, 2023",PHI @ BKN,W,31,11,24,0.458,1,2,0.5,9,10,0.9,2,10,12,9,0,1,1,3,32,25,1,Joel Embiid,PHI,BKN,PHI,58.5,Fantasy Score,53,44,41,21
22023,203954,22300208,"NOV 19, 2023",PHI @ BKN,W,31,11,24,0.458,1,2,0.5,9,10,0.9,2,10,12,9,0,1,1,3,32,25,1,Joel Embiid,PHI,BKN,PHI,9.5,Defensive Rebounds,53,44,41,21
22023,203954,22300208,"NOV 19, 2023",PHI @ BKN,W,31,11,24,0.458,1,2,0.5,9,10,0.9,2,10,12,9,0,1,1,3,32,25,1,Joel Embiid,PHI,BKN,PHI,9.5,Free Throws Made,53,44,41,21
22023,203954,22300208,"NOV 19, 2023",PHI @ BKN,W,31,11,24,0.458,1,2,0.5,9,10,0.9,2,10,12,9,0,1,1,3,32,25,1,Joel Embiid,PHI,BKN,PHI,21.5,FG Attempted,53,44,41,21
22023,203954,22300208,"NOV 19, 2023",PHI @ BKN,W,31,11,24,0.458,1,2,0.5,9,10,0.9,2,10,12,9,0,1,1,3,32,25,1,Joel Embiid,PHI,BKN,PHI,44.5,Pts+Rebs,53,44,41,21
22023,203954,22300208,"NOV 19, 2023",PHI @ BKN,W,31,11,24,0.458,1,2,0.5,9,10,0.9,2,10,12,9,0,1,1,3,32,25,1,Joel Embiid,PHI,BKN,PHI,1.0,Dunks,53,44,41,21
22023,203954,22300208,"NOV 19, 2023",PHI @ BKN,W,31,11,24,0.458,1,2,0.5,9,10,0.9,2,10,12,9,0,1,1,3,32,25,1,Joel Embiid,PHI,BKN,PHI,38.5,Pts+Asts,53,44,41,21
22023,203954,22300208,"NOV 19, 2023",PHI @ BKN,W,31,11,24,0.458,1,2,0.5,9,10,0.9,2,10,12,9,0,1,1,3,32,25,1,Joel Embiid,PHI,BKN,PHI,16.0,Rebs+Asts,53,44,41,21
22023,203954,22300029,"NOV 17, 2023",PHI @ ATL,W,37,10,19,0.526,1,3,0.333,11,11,1.0,2,5,7,8,2,0,4,3,32,16,1,Joel Embiid,PHI,ATL,PHI,33.5,Points,47,39,40,15
22023,203954,22300029,"NOV 17, 2023",PHI @ ATL,W,37,10,19,0.526,1,3,0.333,11,11,1.0,2,5,7,8,2,0,4,3,32,16,1,Joel Embiid,PHI,ATL,PHI,11.0,Rebounds,47,39,40,15
22023,203954,22300029,"NOV 17, 2023",PHI @ ATL,W,37,10,19,0.526,1,3,0.333,11,11,1.0,2,5,7,8,2,0,4,3,32,16,1,Joel Embiid,PHI,ATL,PHI,50.5,Pts+Rebs+Asts,47,39,40,15
22023,203954,22300029,"NOV 17, 2023",PHI @ ATL,W,37,10,19,0.526,1,3,0.333,11,11,1.0,2,5,7,8,2,0,4,3,32,16,1,Joel Embiid,PHI,ATL,PHI,5.0,Assists,47,39,40,15
22023,203954,22300029,"NOV 17, 2023",PHI @ ATL,W,37,10,19,0.526,1,3,0.333,11,11,1.0,2,5,7,8,2,0,4,3,32,16,1,Joel Embiid,PHI,ATL,PHI,58.5,Fantasy Score,47,39,40,15
22023,203954,22300029,"NOV 17, 2023",PHI @ ATL,W,37,10,19,0.526,1,3,0.333,11,11,1.0,2,5,7,8,2,0,4,3,32,16,1,Joel Embiid,PHI,ATL,PHI,9.5,Defensive Rebounds,47,39,40,15
22023,203954,22300029,"NOV 17, 2023",PHI @ ATL,W,37,10,19,0.526,1,3,0.333,11,11,1.0,2,5,7,8,2,0,4,3,32,16,1,Joel Embiid,PHI,ATL,PHI,9.5,Free Throws Made,47,39,40,15
22023,203954,22300029,"NOV 17, 2023",PHI @ ATL,W,37,10,19,0.526,1,3,0.333,11,11,1.0,2,5,7,8,2,0,4,3,32,16,1,Joel Embiid,PHI,ATL,PHI,21.5,FG Attempted,47,39,40,15
22023,203954,22300029,"NOV 17, 2023",PHI @ ATL,W,37,10,19,0.526,1,3,0.333,11,11,1.0,2,5,7,8,2,0,4,3,32,16,1,Joel Embiid,PHI,ATL,PHI,44.5,Pts+Rebs,47,39,40,15
22023,203954,22300029,"NOV 17, 2023",PHI @ ATL,W,37,10,19,0.526,1,3,0.333,11,11,1.0,2,5,7,8,2,0,4,3,32,16,1,Joel Embiid,PHI,ATL,PHI,1.0,Dunks,47,39,40,15
22023,203954,22300029,"NOV 17, 2023",PHI @ ATL,W,37,10,19,0.526,1,3,0.333,11,11,1.0,2,5,7,8,2,0,4,3,32,16,1,Joel Embiid,PHI,ATL,PHI,38.5,Pts+Asts,47,39,40,15
22023,203954,22300029,"NOV 17, 2023",PHI @ ATL,W,37,10,19,0.526,1,3,0.333,11,11,1.0,2,5,7,8,2,0,4,3,32,16,1,Joel Embiid,PHI,ATL,PHI,16.0,Rebs+Asts,47,39,40,15
22023,203954,22300194,"NOV 15, 2023",PHI vs. BOS,L,34,8,16,0.5,0,2,0.0,4,4,1.0,3,6,9,7,1,0,2,3,20,-25,1,Joel Embiid,PHI,PHI,BOS,33.5,Points,36,29,27,16
22023,203954,22300194,"NOV 15, 2023",PHI vs. BOS,L,34,8,16,0.5,0,2,0.0,4,4,1.0,3,6,9,7,1,0,2,3,20,-25,1,Joel Embiid,PHI,PHI,BOS,11.0,Rebounds,36,29,27,16
22023,203954,22300194,"NOV 15, 2023",PHI vs. BOS,L,34,8,16,0.5,0,2,0.0,4,4,1.0,3,6,9,7,1,0,2,3,20,-25,1,Joel Embiid,PHI,PHI,BOS,50.5,Pts+Rebs+Asts,36,29,27,16
22023,203954,22300194,"NOV 15, 2023",PHI vs. BOS,L,34,8,16,0.5,0,2,0.0,4,4,1.0,3,6,9,7,1,0,2,3,20,-25,1,Joel Embiid,PHI,PHI,BOS,5.0,Assists,36,29,27,16
22023,203954,22300194,"NOV 15, 2023",PHI vs. BOS,L,34,8,16,0.5,0,2,0.0,4,4,1.0,3,6,9,7,1,0,2,3,20,-25,1,Joel Embiid,PHI,PHI,BOS,58.5,Fantasy Score,36,29,27,16
22023,203954,22300194,"NOV 15, 2023",PHI vs. BOS,L,34,8,16,0.5,0,2,0.0,4,4,1.0,3,6,9,7,1,0,2,3,20,-25,1,Joel Embiid,PHI,PHI,BOS,9.5,Defensive Rebounds,36,29,27,16
22023,203954,22300194,"NOV 15, 2023",PHI vs. BOS,L,34,8,16,0.5,0,2,0.0,4,4,1.0,3,6,9,7,1,0,2,3,20,-25,1,Joel Embiid,PHI,PHI,BOS,9.5,Free Throws Made,36,29,27,16
22023,203954,22300194,"NOV 15, 2023",PHI vs. BOS,L,34,8,16,0.5,0,2,0.0,4,4,1.0,3,6,9,7,1,0,2,3,20,-25,1,Joel Embiid,PHI,PHI,BOS,21.5,FG Attempted,36,29,27,16
22023,203954,22300194,"NOV 15, 2023",PHI vs. BOS,L,34,8,16,0.5,0,2,0.0,4,4,1.0,3,6,9,7,1,0,2,3,20,-25,1,Joel Embiid,PHI,PHI,BOS,44.5,Pts+Rebs,36,29,27,16
22023,203954,22300194,"NOV 15, 2023",PHI vs. BOS,L,34,8,16,0.5,0,2,0.0,4,4,1.0,3,6,9,7,1,0,2,3,20,-25,1,Joel Embiid,PHI,PHI,BOS,1.0,Dunks,36,29,27,16
22023,203954,22300194,"NOV 15, 2023",PHI vs. BOS,L,34,8,16,0.5,0,2,0.0,4,4,1.0,3,6,9,7,1,0,2,3,20,-25,1,Joel Embiid,PHI,PHI,BOS,38.5,Pts+Asts,36,29,27,16
22023,203954,22300194,"NOV 15, 2023",PHI vs. BOS,L,34,8,16,0.5,0,2,0.0,4,4,1.0,3,6,9,7,1,0,2,3,20,-25,1,Joel Embiid,PHI,PHI,BOS,16.0,Rebs+Asts,36,29,27,16
22023,203954,22300019,"NOV 14, 2023",PHI vs. IND,L,38,11,22,0.5,0,4,0.0,17,17,1.0,3,9,12,6,3,0,5,4,39,-9,1,Joel Embiid,PHI,PHI,IND,33.5,Points,57,51,45,18
22023,203954,22300019,"NOV 14, 2023",PHI vs. IND,L,38,11,22,0.5,0,4,0.0,17,17,1.0,3,9,12,6,3,0,5,4,39,-9,1,Joel Embiid,PHI,PHI,IND,11.0,Rebounds,57,51,45,18
22023,203954,22300019,"NOV 14, 2023",PHI vs. IND,L,38,11,22,0.5,0,4,0.0,17,17,1.0,3,9,12,6,3,0,5,4,39,-9,1,Joel Embiid,PHI,PHI,IND,50.5,Pts+Rebs+Asts,57,51,45,18
22023,203954,22300019,"NOV 14, 2023",PHI vs. IND,L,38,11,22,0.5,0,4,0.0,17,17,1.0,3,9,12,6,3,0,5,4,39,-9,1,Joel Embiid,PHI,PHI,IND,5.0,Assists,57,51,45,18
22023,203954,22300019,"NOV 14, 2023",PHI vs. IND,L,38,11,22,0.5,0,4,0.0,17,17,1.0,3,9,12,6,3,0,5,4,39,-9,1,Joel Embiid,PHI,PHI,IND,58.5,Fantasy Score,57,51,45,18
22023,203954,22300019,"NOV 14, 2023",PHI vs. IND,L,38,11,22,0.5,0,4,0.0,17,17,1.0,3,9,12,6,3,0,5,4,39,-9,1,Joel Embiid,PHI,PHI,IND,9.5,Defensive Rebounds,57,51,45,18
22023,203954,22300019,"NOV 14, 2023",PHI vs. IND,L,38,11,22,0.5,0,4,0.0,17,17,1.0,3,9,12,6,3,0,5,4,39,-9,1,Joel Embiid,PHI,PHI,IND,9.5,Free Throws Made,57,51,45,18
22023,203954,22300019,"NOV 14, 2023",PHI vs. IND,L,38,11,22,0.5,0,4,0.0,17,17,1.0,3,9,12,6,3,0,5,4,39,-9,1,Joel Embiid,PHI,PHI,IND,21.5,FG Attempted,57,51,45,18
22023,203954,22300019,"NOV 14, 2023",PHI vs. IND,L,38,11,22,0.5,0,4,0.0,17,17,1.0,3,9,12,6,3,0,5,4,39,-9,1,Joel Embiid,PHI,PHI,IND,44.5,Pts+Rebs,57,51,45,18
22023,203954,22300019,"NOV 14, 2023",PHI vs. IND,L,38,11,22,0.5,0,4,0.0,17,17,1.0,3,9,12,6,3,0,5,4,39,-9,1,Joel Embiid,PHI,PHI,IND,1.0,Dunks,57,51,45,18
22023,203954,22300019,"NOV 14, 2023",PHI vs. IND,L,38,11,22,0.5,0,4,0.0,17,17,1.0,3,9,12,6,3,0,5,4,39,-9,1,Joel Embiid,PHI,PHI,IND,38.5,Pts+Asts,57,51,45,18
22023,203954,22300019,"NOV 14, 2023",PHI vs. IND,L,38,11,22,0.5,0,4,0.0,17,17,1.0,3,9,12,6,3,0,5,4,39,-9,1,Joel Embiid,PHI,PHI,IND,16.0,Rebs+Asts,57,51,45,18
22023,203954,22300180,"NOV 12, 2023",PHI vs. IND,W,33,12,26,0.462,1,4,0.25,12,14,0.857,8,5,13,7,1,1,3,2,37,-1,1,Joel Embiid,PHI,PHI,IND,33.5,Points,57,50,44,20
22023,203954,22300180,"NOV 12, 2023",PHI vs. IND,W,33,12,26,0.462,1,4,0.25,12,14,0.857,8,5,13,7,1,1,3,2,37,-1,1,Joel Embiid,PHI,PHI,IND,11.0,Rebounds,57,50,44,20
22023,203954,22300180,"NOV 12, 2023",PHI vs. IND,W,33,12,26,0.462,1,4,0.25,12,14,0.857,8,5,13,7,1,1,3,2,37,-1,1,Joel Embiid,PHI,PHI,IND,50.5,Pts+Rebs+Asts,57,50,44,20
22023,203954,22300180,"NOV 12, 2023",PHI vs. IND,W,33,12,26,0.462,1,4,0.25,12,14,0.857,8,5,13,7,1,1,3,2,37,-1,1,Joel Embiid,PHI,PHI,IND,5.0,Assists,57,50,44,20
22023,203954,22300180,"NOV 12, 2023",PHI vs. IND,W,33,12,26,0.462,1,4,0.25,12,14,0.857,8,5,13,7,1,1,3,2,37,-1,1,Joel Embiid,PHI,PHI,IND,58.5,Fantasy Score,57,50,44,20
22023,203954,22300180,"NOV 12, 2023",PHI vs. IND,W,33,12,26,0.462,1,4,0.25,12,14,0.857,8,5,13,7,1,1,3,2,37,-1,1,Joel Embiid,PHI,PHI,IND,9.5,Defensive Rebounds,57,50,44,20
22023,203954,22300180,"NOV 12, 2023",PHI vs. IND,W,33,12,26,0.462,1,4,0.25,12,14,0.857,8,5,13,7,1,1,3,2,37,-1,1,Joel Embiid,PHI,PHI,IND,9.5,Free Throws Made,57,50,44,20
22023,203954,22300180,"NOV 12, 2023",PHI vs. IND,W,33,12,26,0.462,1,4,0.25,12,14,0.857,8,5,13,7,1,1,3,2,37,-1,1,Joel Embiid,PHI,PHI,IND,21.5,FG Attempted,57,50,44,20
22023,203954,22300180,"NOV 12, 2023",PHI vs. IND,W,33,12,26,0.462,1,4,0.25,12,14,0.857,8,5,13,7,1,1,3,2,37,-1,1,Joel Embiid,PHI,PHI,IND,44.5,Pts+Rebs,57,50,44,20
22023,203954,22300180,"NOV 12, 2023",PHI vs. IND,W,33,12,26,0.462,1,4,0.25,12,14,0.857,8,5,13,7,1,1,3,2,37,-1,1,Joel Embiid,PHI,PHI,IND,1.0,Dunks,57,50,44,20
22023,203954,22300180,"NOV 12, 2023",PHI vs. IND,W,33,12,26,0.462,1,4,0.25,12,14,0.857,8,5,13,7,1,1,3,2,37,-1,1,Joel Embiid,PHI,PHI,IND,38.5,Pts+Asts,57,50,44,20
22023,203954,22300180,"NOV 12, 2023",PHI vs. IND,W,33,12,26,0.462,1,4,0.25,12,14,0.857,8,5,13,7,1,1,3,2,37,-1,1,Joel Embiid,PHI,PHI,IND,16.0,Rebs+Asts,57,50,44,20
22023,203954,22300008,"NOV 10, 2023",PHI @ DET,W,36,8,21,0.381,1,4,0.25,16,19,0.842,7,9,16,3,0,2,5,3,33,1,1,Joel Embiid,PHI,DET,PHI,33.5,Points,52,49,36,19
22023,203954,22300008,"NOV 10, 2023",PHI @ DET,W,36,8,21,0.381,1,4,0.25,16,19,0.842,7,9,16,3,0,2,5,3,33,1,1,Joel Embiid,PHI,DET,PHI,11.0,Rebounds,52,49,36,19
22023,203954,22300008,"NOV 10, 2023",PHI @ DET,W,36,8,21,0.381,1,4,0.25,16,19,0.842,7,9,16,3,0,2,5,3,33,1,1,Joel Embiid,PHI,DET,PHI,50.5,Pts+Rebs+Asts,52,49,36,19
22023,203954,22300008,"NOV 10, 2023",PHI @ DET,W,36,8,21,0.381,1,4,0.25,16,19,0.842,7,9,16,3,0,2,5,3,33,1,1,Joel Embiid,PHI,DET,PHI,5.0,Assists,52,49,36,19
22023,203954,22300008,"NOV 10, 2023",PHI @ DET,W,36,8,21,0.381,1,4,0.25,16,19,0.842,7,9,16,3,0,2,5,3,33,1,1,Joel Embiid,PHI,DET,PHI,58.5,Fantasy Score,52,49,36,19
22023,203954,22300008,"NOV 10, 2023",PHI @ DET,W,36,8,21,0.381,1,4,0.25,16,19,0.842,7,9,16,3,0,2,5,3,33,1,1,Joel Embiid,PHI,DET,PHI,9.5,Defensive Rebounds,52,49,36,19
22023,203954,22300008,"NOV 10, 2023",PHI @ DET,W,36,8,21,0.381,1,4,0.25,16,19,0.842,7,9,16,3,0,2,5,3,33,1,1,Joel Embiid,PHI,DET,PHI,9.5,Free Throws Made,52,49,36,19
22023,203954,22300008,"NOV 10, 2023",PHI @ DET,W,36,8,21,0.381,1,4,0.25,16,19,0.842,7,9,16,3,0,2,5,3,33,1,1,Joel Embiid,PHI,DET,PHI,21.5,FG Attempted,52,49,36,19
22023,203954,22300008,"NOV 10, 2023",PHI @ DET,W,36,8,21,0.381,1,4,0.25,16,19,0.842,7,9,16,3,0,2,5,3,33,1,1,Joel Embiid,PHI,DET,PHI,44.5,Pts+Rebs,52,49,36,19
22023,203954,22300008,"NOV 10, 2023",PHI @ DET,W,36,8,21,0.381,1,4,0.25,16,19,0.842,7,9,16,3,0,2,5,3,33,1,1,Joel Embiid,PHI,DET,PHI,1.0,Dunks,52,49,36,19
22023,203954,22300008,"NOV 10, 2023",PHI @ DET,W,36,8,21,0.381,1,4,0.25,16,19,0.842,7,9,16,3,0,2,5,3,33,1,1,Joel Embiid,PHI,DET,PHI,38.5,Pts+Asts,52,49,36,19
22023,203954,22300008,"NOV 10, 2023",PHI @ DET,W,36,8,21,0.381,1,4,0.25,16,19,0.842,7,9,16,3,0,2,5,3,33,1,1,Joel Embiid,PHI,DET,PHI,16.0,Rebs+Asts,52,49,36,19
22023,203954,22300159,"NOV 08, 2023",PHI vs. BOS,W,37,10,20,0.5,1,4,0.25,6,6,1.0,1,9,10,4,1,4,6,3,27,4,1,Joel Embiid,PHI,PHI,BOS,33.5,Points,41,37,31,14
22023,203954,22300159,"NOV 08, 2023",PHI vs. BOS,W,37,10,20,0.5,1,4,0.25,6,6,1.0,1,9,10,4,1,4,6,3,27,4,1,Joel Embiid,PHI,PHI,BOS,11.0,Rebounds,41,37,31,14
22023,203954,22300159,"NOV 08, 2023",PHI vs. BOS,W,37,10,20,0.5,1,4,0.25,6,6,1.0,1,9,10,4,1,4,6,3,27,4,1,Joel Embiid,PHI,PHI,BOS,50.5,Pts+Rebs+Asts,41,37,31,14
22023,203954,22300159,"NOV 08, 2023",PHI vs. BOS,W,37,10,20,0.5,1,4,0.25,6,6,1.0,1,9,10,4,1,4,6,3,27,4,1,Joel Embiid,PHI,PHI,BOS,5.0,Assists,41,37,31,14
22023,203954,22300159,"NOV 08, 2023",PHI vs. BOS,W,37,10,20,0.5,1,4,0.25,6,6,1.0,1,9,10,4,1,4,6,3,27,4,1,Joel Embiid,PHI,PHI,BOS,58.5,Fantasy Score,41,37,31,14
22023,203954,22300159,"NOV 08, 2023",PHI vs. BOS,W,37,10,20,0.5,1,4,0.25,6,6,1.0,1,9,10,4,1,4,6,3,27,4,1,Joel Embiid,PHI,PHI,BOS,9.5,Defensive Rebounds,41,37,31,14
22023,203954,22300159,"NOV 08, 2023",PHI vs. BOS,W,37,10,20,0.5,1,4,0.25,6,6,1.0,1,9,10,4,1,4,6,3,27,4,1,Joel Embiid,PHI,PHI,BOS,9.5,Free Throws Made,41,37,31,14
22023,203954,22300159,"NOV 08, 2023",PHI vs. BOS,W,37,10,20,0.5,1,4,0.25,6,6,1.0,1,9,10,4,1,4,6,3,27,4,1,Joel Embiid,PHI,PHI,BOS,21.5,FG Attempted,41,37,31,14
22023,203954,22300159,"NOV 08, 2023",PHI vs. BOS,W,37,10,20,0.5,1,4,0.25,6,6,1.0,1,9,10,4,1,4,6,3,27,4,1,Joel Embiid,PHI,PHI,BOS,44.5,Pts+Rebs,41,37,31,14
22023,203954,22300159,"NOV 08, 2023",PHI vs. BOS,W,37,10,20,0.5,1,4,0.25,6,6,1.0,1,9,10,4,1,4,6,3,27,4,1,Joel Embiid,PHI,PHI,BOS,1.0,Dunks,41,37,31,14
22023,203954,22300159,"NOV 08, 2023",PHI vs. BOS,W,37,10,20,0.5,1,4,0.25,6,6,1.0,1,9,10,4,1,4,6,3,27,4,1,Joel Embiid,PHI,PHI,BOS,38.5,Pts+Asts,41,37,31,14
22023,203954,22300159,"NOV 08, 2023",PHI vs. BOS,W,37,10,20,0.5,1,4,0.25,6,6,1.0,1,9,10,4,1,4,6,3,27,4,1,Joel Embiid,PHI,PHI,BOS,16.0,Rebs+Asts,41,37,31,14
22023,203954,22300148,"NOV 06, 2023",PHI vs. WAS,W,31,17,25,0.68,0,2,0.0,14,14,1.0,2,9,11,6,1,1,1,2,48,15,1,Joel Embiid,PHI,PHI,WAS,33.5,Points,65,59,54,17
22023,203954,22300148,"NOV 06, 2023",PHI vs. WAS,W,31,17,25,0.68,0,2,0.0,14,14,1.0,2,9,11,6,1,1,1,2,48,15,1,Joel Embiid,PHI,PHI,WAS,11.0,Rebounds,65,59,54,17
22023,203954,22300148,"NOV 06, 2023",PHI vs. WAS,W,31,17,25,0.68,0,2,0.0,14,14,1.0,2,9,11,6,1,1,1,2,48,15,1,Joel Embiid,PHI,PHI,WAS,50.5,Pts+Rebs+Asts,65,59,54,17
22023,203954,22300148,"NOV 06, 2023",PHI vs. WAS,W,31,17,25,0.68,0,2,0.0,14,14,1.0,2,9,11,6,1,1,1,2,48,15,1,Joel Embiid,PHI,PHI,WAS,5.0,Assists,65,59,54,17
22023,203954,22300148,"NOV 06, 2023",PHI vs. WAS,W,31,17,25,0.68,0,2,0.0,14,14,1.0,2,9,11,6,1,1,1,2,48,15,1,Joel Embiid,PHI,PHI,WAS,58.5,Fantasy Score,65,59,54,17
22023,203954,22300148,"NOV 06, 2023",PHI vs. WAS,W,31,17,25,0.68,0,2,0.0,14,14,1.0,2,9,11,6,1,1,1,2,48,15,1,Joel Embiid,PHI,PHI,WAS,9.5,Defensive Rebounds,65,59,54,17
22023,203954,22300148,"NOV 06, 2023",PHI vs. WAS,W,31,17,25,0.68,0,2,0.0,14,14,1.0,2,9,11,6,1,1,1,2,48,15,1,Joel Embiid,PHI,PHI,WAS,9.5,Free Throws Made,65,59,54,17
22023,203954,22300148,"NOV 06, 2023",PHI vs. WAS,W,31,17,25,0.68,0,2,0.0,14,14,1.0,2,9,11,6,1,1,1,2,48,15,1,Joel Embiid,PHI,PHI,WAS,21.5,FG Attempted,65,59,54,17
22023,203954,22300148,"NOV 06, 2023",PHI vs. WAS,W,31,17,25,0.68,0,2,0.0,14,14,1.0,2,9,11,6,1,1,1,2,48,15,1,Joel Embiid,PHI,PHI,WAS,44.5,Pts+Rebs,65,59,54,17
22023,203954,22300148,"NOV 06, 2023",PHI vs. WAS,W,31,17,25,0.68,0,2,0.0,14,14,1.0,2,9,11,6,1,1,1,2,48,15,1,Joel Embiid,PHI,PHI,WAS,1.0,Dunks,65,59,54,17
22023,203954,22300148,"NOV 06, 2023",PHI vs. WAS,W,31,17,25,0.68,0,2,0.0,14,14,1.0,2,9,11,6,1,1,1,2,48,15,1,Joel Embiid,PHI,PHI,WAS,38.5,Pts+Asts,65,59,54,17
22023,203954,22300148,"NOV 06, 2023",PHI vs. WAS,W,31,17,25,0.68,0,2,0.0,14,14,1.0,2,9,11,6,1,1,1,2,48,15,1,Joel Embiid,PHI,PHI,WAS,16.0,Rebs+Asts,65,59,54,17
22023,203954,22300132,"NOV 04, 2023",PHI vs. PHX,W,31,9,18,0.5,3,3,1.0,5,5,1.0,3,8,11,3,0,1,4,2,26,4,1,Joel Embiid,PHI,PHI,PHX,33.5,Points,40,37,29,14
22023,203954,22300132,"NOV 04, 2023",PHI vs. PHX,W,31,9,18,0.5,3,3,1.0,5,5,1.0,3,8,11,3,0,1,4,2,26,4,1,Joel Embiid,PHI,PHI,PHX,11.0,Rebounds,40,37,29,14
22023,203954,22300132,"NOV 04, 2023",PHI vs. PHX,W,31,9,18,0.5,3,3,1.0,5,5,1.0,3,8,11,3,0,1,4,2,26,4,1,Joel Embiid,PHI,PHI,PHX,50.5,Pts+Rebs+Asts,40,37,29,14
22023,203954,22300132,"NOV 04, 2023",PHI vs. PHX,W,31,9,18,0.5,3,3,1.0,5,5,1.0,3,8,11,3,0,1,4,2,26,4,1,Joel Embiid,PHI,PHI,PHX,5.0,Assists,40,37,29,14
22023,203954,22300132,"NOV 04, 2023",PHI vs. PHX,W,31,9,18,0.5,3,3,1.0,5,5,1.0,3,8,11,3,0,1,4,2,26,4,1,Joel Embiid,PHI,PHI,PHX,58.5,Fantasy Score,40,37,29,14
22023,203954,22300132,"NOV 04, 2023",PHI vs. PHX,W,31,9,18,0.5,3,3,1.0,5,5,1.0,3,8,11,3,0,1,4,2,26,4,1,Joel Embiid,PHI,PHI,PHX,9.5,Defensive Rebounds,40,37,29,14
22023,203954,22300132,"NOV 04, 2023",PHI vs. PHX,W,31,9,18,0.5,3,3,1.0,5,5,1.0,3,8,11,3,0,1,4,2,26,4,1,Joel Embiid,PHI,PHI,PHX,9.5,Free Throws Made,40,37,29,14
22023,203954,22300132,"NOV 04, 2023",PHI vs. PHX,W,31,9,18,0.5,3,3,1.0,5,5,1.0,3,8,11,3,0,1,4,2,26,4,1,Joel Embiid,PHI,PHI,PHX,21.5,FG Attempted,40,37,29,14
22023,203954,22300132,"NOV 04, 2023",PHI vs. PHX,W,31,9,18,0.5,3,3,1.0,5,5,1.0,3,8,11,3,0,1,4,2,26,4,1,Joel Embiid,PHI,PHI,PHX,44.5,Pts+Rebs,40,37,29,14
22023,203954,22300132,"NOV 04, 2023",PHI vs. PHX,W,31,9,18,0.5,3,3,1.0,5,5,1.0,3,8,11,3,0,1,4,2,26,4,1,Joel Embiid,PHI,PHI,PHX,1.0,Dunks,40,37,29,14
22023,203954,22300132,"NOV 04, 2023",PHI vs. PHX,W,31,9,18,0.5,3,3,1.0,5,5,1.0,3,8,11,3,0,1,4,2,26,4,1,Joel Embiid,PHI,PHI,PHX,38.5,Pts+Asts,40,37,29,14
22023,203954,22300132,"NOV 04, 2023",PHI vs. PHX,W,31,9,18,0.5,3,3,1.0,5,5,1.0,3,8,11,3,0,1,4,2,26,4,1,Joel Embiid,PHI,PHI,PHX,16.0,Rebs+Asts,40,37,29,14
22023,203954,22300128,"NOV 02, 2023",PHI vs. TOR,W,35,8,22,0.364,0,2,0.0,12,13,0.923,5,8,13,7,0,1,4,2,28,22,1,Joel Embiid,PHI,PHI,TOR,33.5,Points,48,41,35,20
22023,203954,22300128,"NOV 02, 2023",PHI vs. TOR,W,35,8,22,0.364,0,2,0.0,12,13,0.923,5,8,13,7,0,1,4,2,28,22,1,Joel Embiid,PHI,PHI,TOR,11.0,Rebounds,48,41,35,20
22023,203954,22300128,"NOV 02, 2023",PHI vs. TOR,W,35,8,22,0.364,0,2,0.0,12,13,0.923,5,8,13,7,0,1,4,2,28,22,1,Joel Embiid,PHI,PHI,TOR,50.5,Pts+Rebs+Asts,48,41,35,20
22023,203954,22300128,"NOV 02, 2023",PHI vs. TOR,W,35,8,22,0.364,0,2,0.0,12,13,0.923,5,8,13,7,0,1,4,2,28,22,1,Joel Embiid,PHI,PHI,TOR,5.0,Assists,48,41,35,20
22023,203954,22300128,"NOV 02, 2023",PHI vs. TOR,W,35,8,22,0.364,0,2,0.0,12,13,0.923,5,8,13,7,0,1,4,2,28,22,1,Joel Embiid,PHI,PHI,TOR,58.5,Fantasy Score,48,41,35,20
22023,203954,22300128,"NOV 02, 2023",PHI vs. TOR,W,35,8,22,0.364,0,2,0.0,12,13,0.923,5,8,13,7,0,1,4,2,28,22,1,Joel Embiid,PHI,PHI,TOR,9.5,Defensive Rebounds,48,41,35,20
22023,203954,22300128,"NOV 02, 2023",PHI vs. TOR,W,35,8,22,0.364,0,2,0.0,12,13,0.923,5,8,13,7,0,1,4,2,28,22,1,Joel Embiid,PHI,PHI,TOR,9.5,Free Throws Made,48,41,35,20
22023,203954,22300128,"NOV 02, 2023",PHI vs. TOR,W,35,8,22,0.364,0,2,0.0,12,13,0.923,5,8,13,7,0,1,4,2,28,22,1,Joel Embiid,PHI,PHI,TOR,21.5,FG Attempted,48,41,35,20
22023,203954,22300128,"NOV 02, 2023",PHI vs. TOR,W,35,8,22,0.364,0,2,0.0,12,13,0.923,5,8,13,7,0,1,4,2,28,22,1,Joel Embiid,PHI,PHI,TOR,44.5,Pts+Rebs,48,41,35,20
22023,203954,22300128,"NOV 02, 2023",PHI vs. TOR,W,35,8,22,0.364,0,2,0.0,12,13,0.923,5,8,13,7,0,1,4,2,28,22,1,Joel Embiid,PHI,PHI,TOR,1.0,Dunks,48,41,35,20
22023,203954,22300128,"NOV 02, 2023",PHI vs. TOR,W,35,8,22,0.364,0,2,0.0,12,13,0.923,5,8,13,7,0,1,4,2,28,22,1,Joel Embiid,PHI,PHI,TOR,38.5,Pts+Asts,48,41,35,20
22023,203954,22300128,"NOV 02, 2023",PHI vs. TOR,W,35,8,22,0.364,0,2,0.0,12,13,0.923,5,8,13,7,0,1,4,2,28,22,1,Joel Embiid,PHI,PHI,TOR,16.0,Rebs+Asts,48,41,35,20
22023,203954,22300098,"OCT 29, 2023",PHI vs. POR,W,29,12,22,0.545,2,4,0.5,9,12,0.75,5,10,15,7,2,6,3,3,35,28,1,Joel Embiid,PHI,PHI,POR,33.5,Points,57,50,42,22
22023,203954,22300098,"OCT 29, 2023",PHI vs. POR,W,29,12,22,0.545,2,4,0.5,9,12,0.75,5,10,15,7,2,6,3,3,35,28,1,Joel Embiid,PHI,PHI,POR,11.0,Rebounds,57,50,42,22
22023,203954,22300098,"OCT 29, 2023",PHI vs. POR,W,29,12,22,0.545,2,4,0.5,9,12,0.75,5,10,15,7,2,6,3,3,35,28,1,Joel Embiid,PHI,PHI,POR,50.5,Pts+Rebs+Asts,57,50,42,22
22023,203954,22300098,"OCT 29, 2023",PHI vs. POR,W,29,12,22,0.545,2,4,0.5,9,12,0.75,5,10,15,7,2,6,3,3,35,28,1,Joel Embiid,PHI,PHI,POR,5.0,Assists,57,50,42,22
22023,203954,22300098,"OCT 29, 2023",PHI vs. POR,W,29,12,22,0.545,2,4,0.5,9,12,0.75,5,10,15,7,2,6,3,3,35,28,1,Joel Embiid,PHI,PHI,POR,58.5,Fantasy Score,57,50,42,22
22023,203954,22300098,"OCT 29, 2023",PHI vs. POR,W,29,12,22,0.545,2,4,0.5,9,12,0.75,5,10,15,7,2,6,3,3,35,28,1,Joel Embiid,PHI,PHI,POR,9.5,Defensive Rebounds,57,50,42,22
22023,203954,22300098,"OCT 29, 2023",PHI vs. POR,W,29,12,22,0.545,2,4,0.5,9,12,0.75,5,10,15,7,2,6,3,3,35,28,1,Joel Embiid,PHI,PHI,POR,9.5,Free Throws Made,57,50,42,22
22023,203954,22300098,"OCT 29, 2023",PHI vs. POR,W,29,12,22,0.545,2,4,0.5,9,12,0.75,5,10,15,7,2,6,3,3,35,28,1,Joel Embiid,PHI,PHI,POR,21.5,FG Attempted,57,50,42,22
22023,203954,22300098,"OCT 29, 2023",PHI vs. POR,W,29,12,22,0.545,2,4,0.5,9,12,0.75,5,10,15,7,2,6,3,3,35,28,1,Joel Embiid,PHI,PHI,POR,44.5,Pts+Rebs,57,50,42,22
22023,203954,22300098,"OCT 29, 2023",PHI vs. POR,W,29,12,22,0.545,2,4,0.5,9,12,0.75,5,10,15,7,2,6,3,3,35,28,1,Joel Embiid,PHI,PHI,POR,1.0,Dunks,57,50,42,22
22023,203954,22300098,"OCT 29, 2023",PHI vs. POR,W,29,12,22,0.545,2,4,0.5,9,12,0.75,5,10,15,7,2,6,3,3,35,28,1,Joel Embiid,PHI,PHI,POR,38.5,Pts+Asts,57,50,42,22
22023,203954,22300098,"OCT 29, 2023",PHI vs. POR,W,29,12,22,0.545,2,4,0.5,9,12,0.75,5,10,15,7,2,6,3,3,35,28,1,Joel Embiid,PHI,PHI,POR,16.0,Rebs+Asts,57,50,42,22
22023,203954,22300092,"OCT 28, 2023",PHI @ TOR,W,35,14,21,0.667,1,3,0.333,5,6,0.833,0,9,9,8,1,2,1,0,34,-2,1,Joel Embiid,PHI,TOR,PHI,33.5,Points,51,43,42,17
22023,203954,22300092,"OCT 28, 2023",PHI @ TOR,W,35,14,21,0.667,1,3,0.333,5,6,0.833,0,9,9,8,1,2,1,0,34,-2,1,Joel Embiid,PHI,TOR,PHI,11.0,Rebounds,51,43,42,17
22023,203954,22300092,"OCT 28, 2023",PHI @ TOR,W,35,14,21,0.667,1,3,0.333,5,6,0.833,0,9,9,8,1,2,1,0,34,-2,1,Joel Embiid,PHI,TOR,PHI,50.5,Pts+Rebs+Asts,51,43,42,17
22023,203954,22300092,"OCT 28, 2023",PHI @ TOR,W,35,14,21,0.667,1,3,0.333,5,6,0.833,0,9,9,8,1,2,1,0,34,-2,1,Joel Embiid,PHI,TOR,PHI,5.0,Assists,51,43,42,17
22023,203954,22300092,"OCT 28, 2023",PHI @ TOR,W,35,14,21,0.667,1,3,0.333,5,6,0.833,0,9,9,8,1,2,1,0,34,-2,1,Joel Embiid,PHI,TOR,PHI,58.5,Fantasy Score,51,43,42,17
22023,203954,22300092,"OCT 28, 2023",PHI @ TOR,W,35,14,21,0.667,1,3,0.333,5,6,0.833,0,9,9,8,1,2,1,0,34,-2,1,Joel Embiid,PHI,TOR,PHI,9.5,Defensive Rebounds,51,43,42,17
22023,203954,22300092,"OCT 28, 2023",PHI @ TOR,W,35,14,21,0.667,1,3,0.333,5,6,0.833,0,9,9,8,1,2,1,0,34,-2,1,Joel Embiid,PHI,TOR,PHI,9.5,Free Throws Made,51,43,42,17
22023,203954,22300092,"OCT 28, 2023",PHI @ TOR,W,35,14,21,0.667,1,3,0.333,5,6,0.833,0,9,9,8,1,2,1,0,34,-2,1,Joel Embiid,PHI,TOR,PHI,21.5,FG Attempted,51,43,42,17
22023,203954,22300092,"OCT 28, 2023",PHI @ TOR,W,35,14,21,0.667,1,3,0.333,5,6,0.833,0,9,9,8,1,2,1,0,34,-2,1,Joel Embiid,PHI,TOR,PHI,44.5,Pts+Rebs,51,43,42,17
22023,203954,22300092,"OCT 28, 2023",PHI @ TOR,W,35,14,21,0.667,1,3,0.333,5,6,0.833,0,9,9,8,1,2,1,0,34,-2,1,Joel Embiid,PHI,TOR,PHI,1.0,Dunks,51,43,42,17
22023,203954,22300092,"OCT 28, 2023",PHI @ TOR,W,35,14,21,0.667,1,3,0.333,5,6,0.833,0,9,9,8,1,2,1,0,34,-2,1,Joel Embiid,PHI,TOR,PHI,38.5,Pts+Asts,51,43,42,17
22023,203954,22300092,"OCT 28, 2023",PHI @ TOR,W,35,14,21,0.667,1,3,0.333,5,6,0.833,0,9,9,8,1,2,1,0,34,-2,1,Joel Embiid,PHI,TOR,PHI,16.0,Rebs+Asts,51,43,42,17
22023,203954,22300075,"OCT 26, 2023",PHI @ MIL,L,36,9,21,0.429,3,7,0.429,3,8,0.375,0,7,7,6,0,1,7,5,24,-1,1,Joel Embiid,PHI,MIL,PHI,33.5,Points,37,31,30,13
22023,203954,22300075,"OCT 26, 2023",PHI @ MIL,L,36,9,21,0.429,3,7,0.429,3,8,0.375,0,7,7,6,0,1,7,5,24,-1,1,Joel Embiid,PHI,MIL,PHI,11.0,Rebounds,37,31,30,13
22023,203954,22300075,"OCT 26, 2023",PHI @ MIL,L,36,9,21,0.429,3,7,0.429,3,8,0.375,0,7,7,6,0,1,7,5,24,-1,1,Joel Embiid,PHI,MIL,PHI,50.5,Pts+Rebs+Asts,37,31,30,13
22023,203954,22300075,"OCT 26, 2023",PHI @ MIL,L,36,9,21,0.429,3,7,0.429,3,8,0.375,0,7,7,6,0,1,7,5,24,-1,1,Joel Embiid,PHI,MIL,PHI,5.0,Assists,37,31,30,13
22023,203954,22300075,"OCT 26, 2023",PHI @ MIL,L,36,9,21,0.429,3,7,0.429,3,8,0.375,0,7,7,6,0,1,7,5,24,-1,1,Joel Embiid,PHI,MIL,PHI,58.5,Fantasy Score,37,31,30,13
22023,203954,22300075,"OCT 26, 2023",PHI @ MIL,L,36,9,21,0.429,3,7,0.429,3,8,0.375,0,7,7,6,0,1,7,5,24,-1,1,Joel Embiid,PHI,MIL,PHI,9.5,Defensive Rebounds,37,31,30,13
22023,203954,22300075,"OCT 26, 2023",PHI @ MIL,L,36,9,21,0.429,3,7,0.429,3,8,0.375,0,7,7,6,0,1,7,5,24,-1,1,Joel Embiid,PHI,MIL,PHI,9.5,Free Throws Made,37,31,30,13
22023,203954,22300075,"OCT 26, 2023",PHI @ MIL,L,36,9,21,0.429,3,7,0.429,3,8,0.375,0,7,7,6,0,1,7,5,24,-1,1,Joel Embiid,PHI,MIL,PHI,21.5,FG Attempted,37,31,30,13
22023,203954,22300075,"OCT 26, 2023",PHI @ MIL,L,36,9,21,0.429,3,7,0.429,3,8,0.375,0,7,7,6,0,1,7,5,24,-1,1,Joel Embiid,PHI,MIL,PHI,44.5,Pts+Rebs,37,31,30,13
22023,203954,22300075,"OCT 26, 2023",PHI @ MIL,L,36,9,21,0.429,3,7,0.429,3,8,0.375,0,7,7,6,0,1,7,5,24,-1,1,Joel Embiid,PHI,MIL,PHI,1.0,Dunks,37,31,30,13
22023,203954,22300075,"OCT 26, 2023",PHI @ MIL,L,36,9,21,0.429,3,7,0.429,3,8,0.375,0,7,7,6,0,1,7,5,24,-1,1,Joel Embiid,PHI,MIL,PHI,38.5,Pts+Asts,37,31,30,13
22023,203954,22300075,"OCT 26, 2023",PHI @ MIL,L,36,9,21,0.429,3,7,0.429,3,8,0.375,0,7,7,6,0,1,7,5,24,-1,1,Joel Embiid,PHI,MIL,PHI,16.0,Rebs+Asts,37,31,30,13
22023,1629234,22300554,"JAN 14, 2024",PHX @ POR,W,4,0,1,0.0,0,0,0.0,0,0,0.0,0,1,1,0,0,0,0,0,0,4,1,Drew Eubanks,PHX,POR,PHX,,,1,1,0,1
22023,1629234,22300511,"JAN 08, 2024",PHX @ LAC,L,16,0,1,0.0,0,0,0.0,0,0,0.0,2,2,4,0,0,2,0,2,0,-5,1,Drew Eubanks,PHX,LAC,PHX,,,4,4,0,4
22023,1629234,22300503,"JAN 07, 2024",PHX vs. MEM,L,13,2,3,0.667,0,0,0.0,4,5,0.8,3,4,7,0,0,0,2,1,8,0,1,Drew Eubanks,PHX,PHX,MEM,,,15,15,8,7
22023,1629234,22300489,"JAN 05, 2024",PHX vs. MIA,W,22,4,8,0.5,1,1,1.0,2,4,0.5,2,4,6,0,1,0,0,1,11,-5,1,Drew Eubanks,PHX,PHX,MIA,,,17,17,11,6
22023,1629234,22300473,"JAN 03, 2024",PHX vs. LAC,L,4,0,0,0.0,0,0,0.0,0,0,0.0,0,0,0,0,0,0,0,1,0,2,1,Drew Eubanks,PHX,PHX,LAC,,,0,0,0,0
22023,1629234,22300456,"JAN 01, 2024",PHX vs. POR,W,6,0,0,0.0,0,0,0.0,1,4,0.25,0,1,1,0,0,0,0,2,1,-5,1,Drew Eubanks,PHX,PHX,POR,,,2,2,1,1
22023,1629234,22300405,"DEC 25, 2023",PHX vs. DAL,L,17,1,3,0.333,0,0,0.0,0,0,0.0,2,5,7,0,1,0,1,3,2,-14,1,Drew Eubanks,PHX,PHX,DAL,,,9,9,2,7
22023,1629234,22300387,"DEC 22, 2023",PHX @ SAC,L,15,1,3,0.333,0,0,0.0,0,0,0.0,1,1,2,0,1,0,2,2,2,-23,1,Drew Eubanks,PHX,SAC,PHX,,,4,4,2,2
22023,1629234,22300363,"DEC 19, 2023",PHX @ POR,L,17,2,2,1.0,0,0,0.0,1,2,0.5,3,3,6,1,1,3,1,1,5,0,1,Drew Eubanks,PHX,POR,PHX,,,12,11,6,7
22023,1629234,22300347,"DEC 17, 2023",PHX vs. WAS,W,17,5,7,0.714,0,0,0.0,2,2,1.0,1,4,5,0,1,1,2,0,12,10,1,Drew Eubanks,PHX,PHX,WAS,,,17,17,12,5
22023,1629234,22300333,"DEC 15, 2023",PHX vs. NYK,L,15,3,4,0.75,0,0,0.0,2,2,1.0,1,2,3,0,1,2,1,1,8,-13,1,Drew Eubanks,PHX,PHX,NYK,,,11,11,8,3
22023,1629234,22300317,"DEC 13, 2023",PHX vs. BKN,L,4,0,1,0.0,0,0,0.0,0,0,0.0,0,0,0,0,0,0,0,0,0,-18,1,Drew Eubanks,PHX,PHX,BKN,,,0,0,0,0
22023,1629234,22300308,"DEC 12, 2023",PHX vs. GSW,W,17,1,1,1.0,0,0,0.0,1,1,1.0,1,5,6,1,1,2,3,1,3,-7,1,Drew Eubanks,PHX,PHX,GSW,,,10,9,4,7
22023,1629234,22301228,"DEC 08, 2023",PHX vs. SAC,L,16,4,8,0.5,0,0,0.0,0,0,0.0,2,4,6,0,0,0,1,3,8,-10,1,Drew Eubanks,PHX,PHX,SAC,,,14,14,8,6
22023,1629234,22301203,"DEC 05, 2023",PHX @ LAL,L,18,3,3,1.0,0,0,0.0,0,0,0.0,2,0,2,1,1,0,3,2,6,-16,1,Drew Eubanks,PHX,LAL,PHX,,,9,8,7,3
22023,1629234,22300288,"DEC 02, 2023",PHX vs. MEM,W,18,2,5,0.4,0,0,0.0,2,2,1.0,1,2,3,1,0,2,1,3,6,1,1,Drew Eubanks,PHX,PHX,MEM,,,10,9,7,4
22023,1629234,22300279,"DEC 01, 2023",PHX vs. DEN,L,15,0,1,0.0,0,0,0.0,0,0,0.0,0,6,6,1,0,0,0,2,0,-9,1,Drew Eubanks,PHX,PHX,DEN,,,7,6,1,7
22023,1629234,22300260,"NOV 29, 2023",PHX @ TOR,L,18,2,6,0.333,0,0,0.0,0,0,0.0,1,3,4,1,0,1,0,0,4,-9,1,Drew Eubanks,PHX,TOR,PHX,,,9,8,5,5
22023,1629234,22300247,"NOV 26, 2023",PHX @ NYK,W,15,1,2,0.5,0,0,0.0,1,2,0.5,4,2,6,1,0,0,2,4,3,2,1,Drew Eubanks,PHX,NYK,PHX,,,10,9,4,7
22023,1629234,22300236,"NOV 22, 2023",PHX vs. GSW,W,16,2,4,0.5,0,0,0.0,2,2,1.0,1,5,6,0,0,3,0,1,6,3,1,Drew Eubanks,PHX,PHX,GSW,,,12,12,6,6
22023,1629234,22300041,"NOV 21, 2023",PHX vs. POR,W,13,1,4,0.25,0,0,0.0,5,5,1.0,2,0,2,0,0,0,2,4,7,-3,1,Drew Eubanks,PHX,PHX,POR,,,9,9,7,2
22023,1629234,22300214,"NOV 19, 2023",PHX @ UTA,W,17,2,4,0.5,0,0,0.0,0,0,0.0,0,0,0,1,0,0,0,1,4,-4,1,Drew Eubanks,PHX,UTA,PHX,,,5,4,5,1
22023,1629234,22300035,"NOV 17, 2023",PHX @ UTA,W,21,5,5,1.0,1,1,1.0,0,0,0.0,0,4,4,0,0,0,0,2,11,8,1,Drew Eubanks,PHX,UTA,PHX,,,15,15,11,4
22023,1629234,22300197,"NOV 15, 2023",PHX vs. MIN,W,20,6,9,0.667,1,1,1.0,0,0,0.0,2,2,4,3,0,0,1,2,13,11,1,Drew Eubanks,PHX,PHX,MIN,,,20,17,16,7
22023,1629234,22300185,"NOV 12, 2023",PHX vs. OKC,L,21,7,9,0.778,0,0,0.0,1,2,0.5,4,1,5,1,0,0,2,1,15,4,1,Drew Eubanks,PHX,PHX,OKC,,,21,20,16,6
22023,1629234,22300015,"NOV 10, 2023",PHX vs. LAL,L,14,1,3,0.333,0,0,0.0,0,0,0.0,2,3,5,1,0,1,2,2,2,-6,1,Drew Eubanks,PHX,PHX,LAL,,,8,7,3,6
22023,1629234,22300162,"NOV 08, 2023",PHX @ CHI,W,14,1,1,1.0,0,0,0.0,2,2,1.0,0,3,3,2,0,2,0,2,4,-12,1,Drew Eubanks,PHX,CHI,PHX,,,9,7,6,5
22023,1629234,22300140,"NOV 05, 2023",PHX @ DET,W,18,4,5,0.8,0,0,0.0,0,0,0.0,1,2,3,1,1,3,2,4,8,6,1,Drew Eubanks,PHX,DET,PHX,,,12,11,9,4
22023,1629234,22300132,"NOV 04, 2023",PHX @ PHI,L,20,2,4,0.5,0,0,0.0,6,6,1.0,2,3,5,4,1,1,0,1,10,-13,1,Drew Eubanks,PHX,PHI,PHX,,,19,15,14,9
22023,1629234,22300131,"NOV 02, 2023",PHX vs. SAS,L,27,5,9,0.556,0,0,0.0,3,3,1.0,1,4,5,1,0,1,1,1,13,-9,1,Drew Eubanks,PHX,PHX,SAS,,,19,18,14,6
22023,1629234,22300113,"OCT 31, 2023",PHX vs. SAS,L,17,1,3,0.333,0,0,0.0,1,2,0.5,1,8,9,4,1,2,2,1,3,13,1,Drew Eubanks,PHX,PHX,SAS,,,16,12,7,13
22023,1629234,22300094,"OCT 28, 2023",PHX vs. UTA,W,19,6,7,0.857,0,0,0.0,0,0,0.0,2,3,5,2,0,2,0,3,12,11,1,Drew Eubanks,PHX,PHX,UTA,,,19,17,14,7
22023,1629234,22300076,"OCT 26, 2023",PHX @ LAL,L,17,1,2,0.5,0,0,0.0,0,0,0.0,1,3,4,2,0,0,2,3,2,-1,1,Drew Eubanks,PHX,LAL,PHX,,,8,6,4,6
22023,1629234,22300062,"OCT 24, 2023",PHX @ GSW,W,19,1,3,0.333,0,0,0.0,2,4,0.5,2,5,7,2,0,3,3,3,4,-2,1,Drew Eubanks,PHX,GSW,PHX,,,13,11,6,9
22023,203957,22300457,"JAN 01, 2024",DAL @ UTA,L,12,2,3,0.667,0,0,0.0,0,0,0.0,1,0,1,3,0,0,0,0,4,-4,1,Dante Exum,DAL,UTA,DAL,,,8,5,7,4
22023,203957,22300444,"DEC 30, 2023",DAL @ GSW,W,34,8,12,0.667,3,5,0.6,0,0,0.0,0,0,0,5,1,0,1,1,19,16,1,Dante Exum,DAL,GSW,DAL,,,24,19,24,5
22023,203957,22300423,"DEC 28, 2023",DAL @ MIN,L,24,5,11,0.455,1,1,1.0,0,0,0.0,0,2,2,6,0,0,4,4,11,-9,1,Dante Exum,DAL,MIN,DAL,,,19,13,17,8
22023,203957,22300420,"DEC 27, 2023",DAL vs. CLE,L,33,4,8,0.5,1,3,0.333,4,4,1.0,0,4,4,6,3,0,0,4,13,2,1,Dante Exum,DAL,DAL,CLE,,,23,17,19,10
22023,203957,22300405,"DEC 25, 2023",DAL @ PHX,W,33,3,7,0.429,1,4,0.25,0,0,0.0,1,3,4,5,1,0,3,3,7,14,1,Dante Exum,DAL,PHX,DAL,,,16,11,12,9
22023,203957,22300398,"DEC 23, 2023",DAL vs. SAS,W,32,8,10,0.8,2,2,1.0,2,2,1.0,2,5,7,4,0,1,3,1,20,18,1,Dante Exum,DAL,DAL,SAS,,,31,27,24,11
22023,203957,22300372,"DEC 20, 2023",DAL vs. LAC,L,40,6,12,0.5,1,4,0.25,3,4,0.75,1,5,6,1,2,0,0,2,16,-7,1,Dante Exum,DAL,DAL,LAC,,,23,22,17,7
22023,203957,22300356,"DEC 18, 2023",DAL @ DEN,L,23,5,5,1.0,1,1,1.0,0,0,0.0,0,1,1,2,0,0,1,3,11,-14,1,Dante Exum,DAL,DEN,DAL,,,14,12,13,3
22023,203957,22300341,"DEC 16, 2023",DAL @ POR,W,27,8,11,0.727,1,2,0.5,1,1,1.0,0,2,2,3,1,0,2,3,18,14,1,Dante Exum,DAL,POR,DAL,,,23,20,21,5
22023,203957,22300321,"DEC 14, 2023",DAL vs. MIN,L,28,5,6,0.833,2,3,0.667,2,2,1.0,0,4,4,4,0,0,2,2,14,7,1,Dante Exum,DAL,DAL,MIN,,,22,18,18,8
22023,203957,22300306,"DEC 12, 2023",DAL vs. LAL,W,36,8,10,0.8,7,9,0.778,3,4,0.75,2,2,4,3,1,1,1,2,26,7,1,Dante Exum,DAL,DAL,LAL,,,33,30,29,7
22023,203957,22300299,"DEC 11, 2023",DAL @ MEM,W,35,6,11,0.545,1,4,0.25,3,4,0.75,1,3,4,6,2,1,3,3,16,2,1,Dante Exum,DAL,MEM,DAL,,,26,20,22,10
22023,203957,22301226,"DEC 08, 2023",DAL @ POR,W,33,9,15,0.6,2,2,1.0,3,4,0.75,2,4,6,7,0,0,1,3,23,2,1,Dante Exum,DAL,POR,DAL,,,36,29,30,13
22023,203957,22301213,"DEC 06, 2023",DAL vs. UTA,W,26,2,9,0.222,1,5,0.2,0,0,0.0,0,6,6,7,2,0,0,1,5,40,1,Dante Exum,DAL,DAL,UTA,,,18,11,12,13
22023,203957,22300059,"NOV 28, 2023",DAL vs. HOU,W,15,3,4,0.75,1,2,0.5,5,8,0.625,1,0,1,3,1,0,2,0,12,2,1,Dante Exum,DAL,DAL,HOU,,,16,13,15,4
22023,203957,22300244,"NOV 25, 2023",DAL @ LAC,L,18,1,4,0.25,0,1,0.0,0,0,0.0,3,5,8,2,1,0,1,1,2,4,1,Dante Exum,DAL,LAC,DAL,,,12,10,4,10
22023,203957,22300238,"NOV 22, 2023",DAL @ LAL,W,9,2,5,0.4,0,2,0.0,0,0,0.0,0,0,0,0,0,0,0,2,4,7,1,Dante Exum,DAL,LAL,DAL,,,4,4,4,0
22023,203957,22300212,"NOV 19, 2023",DAL vs. SAC,L,15,4,5,0.8,0,1,0.0,0,0,0.0,0,2,2,4,0,0,0,0,8,-3,1,Dante Exum,DAL,DAL,SAC,,,14,10,12,6
22023,203957,22300205,"NOV 18, 2023",DAL @ MIL,L,11,3,5,0.6,0,2,0.0,0,0,0.0,0,1,1,1,0,0,0,0,6,5,1,Dante Exum,DAL,MIL,DAL,,,8,7,7,2
22023,203957,22300192,"NOV 15, 2023",DAL @ WAS,W,19,2,6,0.333,0,1,0.0,1,2,0.5,0,7,7,3,0,0,0,3,5,0,1,Dante Exum,DAL,WAS,DAL,,,15,12,8,10
22023,203957,22300022,"NOV 14, 2023",DAL @ NOP,L,12,4,6,0.667,0,2,0.0,1,1,1.0,1,0,1,2,0,0,1,2,9,3,1,Dante Exum,DAL,NOP,DAL,,,12,10,11,3
22023,203957,22300183,"NOV 12, 2023",DAL @ NOP,W,13,3,6,0.5,0,0,0.0,0,0,0.0,0,1,1,1,1,1,0,2,6,6,1,Dante Exum,DAL,NOP,DAL,,,8,7,7,2
22023,203957,22300014,"NOV 10, 2023",DAL vs. LAC,W,18,3,7,0.429,2,3,0.667,0,0,0.0,1,1,2,6,0,0,0,3,8,7,1,Dante Exum,DAL,DAL,LAC,,,16,10,14,8
22023,203957,22300168,"NOV 08, 2023",DAL vs. TOR,L,8,2,3,0.667,0,0,0.0,1,3,0.333,2,3,5,0,0,0,0,1,5,2,1,Dante Exum,DAL,DAL,TOR,,,10,10,5,5
22023,203957,22300143,"NOV 05, 2023",DAL vs. CHA,W,3,1,2,0.5,1,1,1.0,0,0,0.0,0,1,1,0,0,0,0,1,3,-1,1,Dante Exum,DAL,DAL,CHA,,,4,4,3,1
22023,203957,22300006,"NOV 03, 2023",DAL @ DEN,L,1,0,0,0.0,0,0,0.0,0,0,0.0,0,0,0,0,0,0,0,0,0,2,1,Dante Exum,DAL,DEN,DAL,,,0,0,0,0
22023,203957,22300124,"NOV 01, 2023",DAL vs. CHI,W,10,1,3,0.333,0,0,0.0,0,0,0.0,0,2,2,0,1,0,1,0,2,-5,1,Dante Exum,DAL,DAL,CHI,,,4,4,2,2
22023,203957,22300106,"OCT 30, 2023",DAL @ MEM,W,6,1,3,0.333,0,0,0.0,0,0,0.0,0,4,4,2,0,0,0,0,2,7,1,Dante Exum,DAL,MEM,DAL,,,8,6,4,6
22023,203957,22300084,"OCT 27, 2023",DAL vs. BKN,W,4,1,2,0.5,0,1,0.0,0,0,0.0,0,0,0,0,1,1,0,0,2,-1,1,Dante Exum,DAL,DAL,BKN,,,2,2,2,0
22023,203957,22300073,"OCT 25, 2023",DAL @ SAS,W,8,1,2,0.5,0,1,0.0,1,1,1.0,0,1,1,0,0,0,0,1,3,4,1,Dante Exum,DAL,SAS,DAL,,,4,4,3,1
22023,1628981,22300543,"JAN 13, 2024",ATL vs. WAS,L,5,1,1,1.0,0,0,0.0,2,2,1.0,0,2,2,0,0,0,1,0,4,1,1,Bruno Fernando,ATL,ATL,WAS,,,6,6,4,2
22023,1628981,22300533,"JAN 12, 2024",ATL vs. IND,L,4,0,1,0.0,0,1,0.0,0,0,0.0,0,1,1,0,0,0,0,0,0,2,1,Bruno Fernando,ATL,ATL,IND,,,1,1,0,1
22023,1628981,22300521,"JAN 10, 2024",ATL vs. PHI,W,17,3,4,0.75,0,0,0.0,2,9,0.222,2,3,5,0,1,3,1,2,8,8,1,Bruno Fernando,ATL,ATL,PHI,,,13,13,8,5
22023,1628981,22300480,"JAN 05, 2024",ATL @ IND,L,7,2,2,1.0,0,0,0.0,2,2,1.0,0,2,2,0,0,1,0,1,6,-2,1,Bruno Fernando,ATL,IND,ATL,,,8,8,6,2
22023,1628981,22300445,"DEC 31, 2023",ATL @ WAS,W,15,0,2,0.0,0,0,0.0,0,0,0.0,0,3,3,2,1,0,1,4,0,7,1,Bruno Fernando,ATL,WAS,ATL,,,5,3,2,5
22023,1628981,22300336,"DEC 16, 2023",ATL @ CLE,L,16,5,7,0.714,0,0,0.0,3,5,0.6,2,6,8,1,0,1,0,2,13,7,1,Bruno Fernando,ATL,CLE,ATL,,,22,21,14,9
22023,1628981,22300330,"DEC 15, 2023",ATL @ TOR,W,1,0,0,0.0,0,0,0.0,0,0,0.0,0,0,0,0,0,0,0,0,0,-3,1,Bruno Fernando,ATL,TOR,ATL,,,0,0,0,0
22023,1628981,22300055,"NOV 28, 2023",ATL @ CLE,L,4,1,6,0.167,0,0,0.0,0,0,0.0,2,1,3,0,0,0,1,1,2,0,1,Bruno Fernando,ATL,CLE,ATL,,,5,5,2,3
22023,1628981,22300241,"NOV 25, 2023",ATL @ WAS,W,5,2,2,1.0,0,0,0.0,1,1,1.0,1,0,1,0,0,0,1,0,5,-2,1,Bruno Fernando,ATL,WAS,ATL,,,6,6,5,1
22023,1628981,22300172,"NOV 09, 2023",ATL @ ORL,W,1,0,0,0.0,0,0,0.0,0,0,0.0,0,0,0,0,0,0,0,1,0,7,1,Bruno Fernando,ATL,ORL,ATL,,,0,0,0,0
22023,1628981,22300104,"OCT 30, 2023",ATL vs. MIN,W,1,0,0,0.0,0,0,0.0,0,0,0.0,0,0,0,0,0,0,0,0,0,-4,1,Bruno Fernando,ATL,ATL,MIN,,,0,0,0,0
22023,1628981,22300097,"OCT 29, 2023",ATL @ MIL,W,5,0,1,0.0,0,1,0.0,0,0,0.0,0,0,0,0,0,0,2,1,0,-7,1,Bruno Fernando,ATL,MIL,ATL,,,0,0,0,0
22023,1627827,22300562,"JAN 15, 2024",BKN vs. MIA,L,28,1,6,0.167,1,5,0.2,2,2,1.0,2,5,7,2,0,2,0,0,5,-5,1,Dorian Finney-Smith,BKN,BKN,MIA,,,14,12,7,9
22023,1627827,22300527,"JAN 11, 2024",BKN @ CLE,L,14,0,1,0.0,0,1,0.0,0,0,0.0,0,0,0,0,0,1,1,3,0,-17,1,Dorian Finney-Smith,BKN,CLE,BKN,,,0,0,0,0
22023,1627827,22300498,"JAN 07, 2024",BKN vs. POR,L,36,3,8,0.375,3,7,0.429,0,0,0.0,2,3,5,2,1,0,1,3,9,5,1,Dorian Finney-Smith,BKN,BKN,POR,,,16,14,11,7
22023,1627827,22300481,"JAN 05, 2024",BKN vs. OKC,W,22,3,6,0.5,3,5,0.6,0,0,0.0,1,2,3,2,1,1,0,4,9,6,1,Dorian Finney-Smith,BKN,BKN,OKC,,,14,12,11,5
22023,1627827,22300469,"JAN 03, 2024",BKN @ HOU,L,20,4,16,0.25,1,11,0.091,0,0,0.0,1,1,2,2,0,1,2,2,9,4,1,Dorian Finney-Smith,BKN,HOU,BKN,,,13,11,11,4
22023,1627827,22300461,"JAN 02, 2024",BKN @ NOP,L,20,1,6,0.167,1,4,0.25,0,0,0.0,1,3,4,1,2,0,0,1,3,-17,1,Dorian Finney-Smith,BKN,NOP,BKN,,,8,7,4,5
22023,1627827,22300447,"DEC 31, 2023",BKN @ OKC,L,24,3,13,0.231,2,8,0.25,0,0,0.0,3,3,6,2,1,0,0,2,8,-11,1,Dorian Finney-Smith,BKN,OKC,BKN,,,16,14,10,8
22023,1627827,22300430,"DEC 29, 2023",BKN @ WAS,L,33,2,8,0.25,0,3,0.0,0,0,0.0,5,2,7,1,1,0,0,2,4,-11,1,Dorian Finney-Smith,BKN,WAS,BKN,,,12,11,5,8
22023,1627827,22300406,"DEC 26, 2023",BKN @ DET,W,33,3,8,0.375,3,7,0.429,2,2,1.0,1,3,4,1,1,0,0,4,11,16,1,Dorian Finney-Smith,BKN,DET,BKN,,,16,15,12,5
22023,1627827,22300394,"DEC 23, 2023",BKN vs. DET,W,27,4,6,0.667,2,4,0.5,0,0,0.0,0,6,6,1,2,0,0,1,10,22,1,Dorian Finney-Smith,BKN,BKN,DET,,,17,16,11,7
22023,1627827,22300383,"DEC 22, 2023",BKN vs. DEN,L,30,5,9,0.556,4,5,0.8,0,0,0.0,2,2,4,1,0,0,1,2,14,11,1,Dorian Finney-Smith,BKN,BKN,DEN,,,19,18,15,5
22023,1627827,22300368,"DEC 20, 2023",BKN vs. NYK,L,24,3,8,0.375,2,6,0.333,2,2,1.0,0,3,3,0,0,0,1,2,10,-9,1,Dorian Finney-Smith,BKN,BKN,NYK,,,13,13,10,3
22023,1627827,22300357,"DEC 18, 2023",BKN @ UTA,L,21,2,7,0.286,2,5,0.4,0,0,0.0,2,0,2,3,1,0,0,4,6,-7,1,Dorian Finney-Smith,BKN,UTA,BKN,,,11,8,9,5
22023,1627827,22300322,"DEC 14, 2023",BKN @ DEN,L,16,0,3,0.0,0,1,0.0,0,0,0.0,4,0,4,0,1,0,1,2,0,-9,1,Dorian Finney-Smith,BKN,DEN,BKN,,,4,4,0,4
22023,1627827,22300317,"DEC 13, 2023",BKN @ PHX,W,25,4,9,0.444,0,4,0.0,0,0,0.0,3,3,6,1,2,0,2,3,8,15,1,Dorian Finney-Smith,BKN,PHX,BKN,,,15,14,9,7
22023,1627827,22300303,"DEC 11, 2023",BKN @ SAC,L,25,5,6,0.833,3,4,0.75,0,0,0.0,0,3,3,1,1,2,0,0,13,-10,1,Dorian Finney-Smith,BKN,SAC,BKN,,,17,16,14,4
22023,1627827,22301219,"DEC 08, 2023",BKN vs. WAS,W,26,2,5,0.4,1,4,0.25,3,3,1.0,2,1,3,0,1,0,0,0,8,12,1,Dorian Finney-Smith,BKN,BKN,WAS,,,11,11,8,3
22023,1627827,22301209,"DEC 06, 2023",BKN @ ATL,W,30,6,10,0.6,3,6,0.5,0,0,0.0,2,3,5,0,1,1,1,3,15,6,1,Dorian Finney-Smith,BKN,ATL,BKN,,,20,20,15,5
22023,1627827,22300266,"NOV 30, 2023",BKN vs. CHA,L,39,5,7,0.714,4,6,0.667,0,0,0.0,3,3,6,1,2,1,1,0,14,2,1,Dorian Finney-Smith,BKN,BKN,CHA,,,21,20,15,7
22023,1627827,22300054,"NOV 28, 2023",BKN vs. TOR,W,26,2,10,0.2,1,4,0.25,0,0,0.0,5,4,9,2,1,1,0,4,5,10,1,Dorian Finney-Smith,BKN,BKN,TOR,,,16,14,7,11
22023,1627827,22300250,"NOV 26, 2023",BKN vs. CHI,W,34,3,10,0.3,3,7,0.429,0,0,0.0,0,4,4,1,2,1,1,3,9,-17,1,Dorian Finney-Smith,BKN,BKN,CHI,,,14,13,10,5
22023,1627827,22300240,"NOV 25, 2023",BKN vs. MIA,W,34,7,9,0.778,2,4,0.5,0,0,0.0,2,3,5,3,0,1,0,0,16,23,1,Dorian Finney-Smith,BKN,BKN,MIA,,,24,21,19,8
22023,1627827,22300227,"NOV 22, 2023",BKN @ ATL,L,38,3,7,0.429,2,5,0.4,0,0,0.0,3,5,8,1,0,0,1,3,8,-5,1,Dorian Finney-Smith,BKN,ATL,BKN,,,17,16,9,9
22023,1627827,22300208,"NOV 19, 2023",BKN vs. PHI,L,27,2,7,0.286,1,3,0.333,0,0,0.0,1,2,3,2,0,0,1,2,5,-19,1,Dorian Finney-Smith,BKN,BKN,PHI,,,10,8,7,5
22023,1627827,22300200,"NOV 16, 2023",BKN @ MIA,L,32,4,6,0.667,3,4,0.75,0,0,0.0,1,5,6,1,1,0,3,3,11,-9,1,Dorian Finney-Smith,BKN,MIA,BKN,,,18,17,12,7
22023,1627827,22300020,"NOV 14, 2023",BKN vs. ORL,W,24,2,5,0.4,1,4,0.25,0,0,0.0,2,2,4,0,1,0,0,1,5,-6,1,Dorian Finney-Smith,BKN,BKN,ORL,,,9,9,5,4
22023,1627827,22300178,"NOV 12, 2023",BKN vs. WAS,W,20,2,7,0.286,2,6,0.333,0,0,0.0,2,1,3,0,0,0,2,5,6,7,1,Dorian Finney-Smith,BKN,BKN,WAS,,,9,9,6,3
22023,1627827,22300010,"NOV 10, 2023",BKN @ BOS,L,27,3,6,0.5,3,5,0.6,0,0,0.0,2,1,3,2,0,1,0,4,9,-24,1,Dorian Finney-Smith,BKN,BOS,BKN,,,14,12,11,5
22023,1627827,22300160,"NOV 08, 2023",BKN vs. LAC,W,35,4,11,0.364,4,8,0.5,0,0,0.0,3,6,9,2,1,3,0,2,12,4,1,Dorian Finney-Smith,BKN,BKN,LAC,,,23,21,14,11
22023,1627827,22300149,"NOV 06, 2023",BKN vs. MIL,L,37,3,12,0.25,1,7,0.143,0,0,0.0,4,2,6,2,0,1,1,2,7,7,1,Dorian Finney-Smith,BKN,BKN,MIL,,,15,13,9,8
22023,1627827,22300136,"NOV 04, 2023",BKN vs. BOS,L,37,5,10,0.5,4,9,0.444,0,0,0.0,4,4,8,1,0,0,0,3,14,-19,1,Dorian Finney-Smith,BKN,BKN,BOS,,,23,22,15,9
22023,1627827,22300004,"NOV 03, 2023",BKN @ CHI,W,33,8,14,0.571,5,9,0.556,0,0,0.0,2,1,3,0,0,1,0,1,21,-8,1,Dorian Finney-Smith,BKN,CHI,BKN,,,24,24,21,3
22023,1627827,22300119,"NOV 01, 2023",BKN @ MIA,W,30,6,10,0.6,3,5,0.6,0,0,0.0,0,3,3,2,0,0,1,3,15,-20,1,Dorian Finney-Smith,BKN,MIA,BKN,,,20,18,17,5
22023,1627827,22300101,"OCT 30, 2023",BKN @ CHA,W,31,7,12,0.583,4,9,0.444,1,2,0.5,1,6,7,1,1,2,1,0,19,5,1,Dorian Finney-Smith,BKN,CHA,BKN,,,27,26,20,8
22023,1627827,22300084,"OCT 27, 2023",BKN @ DAL,L,32,4,8,0.5,4,7,0.571,0,0,0.0,1,6,7,3,0,0,2,5,12,-15,1,Dorian Finney-Smith,BKN,DAL,BKN,,,22,19,15,10
22023,1627827,22300067,"OCT 25, 2023",BKN vs. CLE,L,28,4,8,0.5,2,6,0.333,0,1,0.0,1,4,5,2,0,0,3,1,10,7,1,Dorian Finney-Smith,BKN,BKN,CLE,,,17,15,12,7
22023,1630201,22300557,"JAN 15, 2024",NYK vs. ORL,L,12,0,4,0.0,0,4,0.0,2,4,0.5,0,0,0,0,0,0,0,0,2,-7,1,Malachi Flynn,NYK,NYK,ORL,,,2,2,2,0
22023,1630201,22300544,"JAN 13, 2024",NYK @ MEM,W,10,4,5,0.8,1,2,0.5,0,0,0.0,0,1,1,3,1,0,1,3,9,-1,1,Malachi Flynn,NYK,MEM,NYK,,,13,10,12,4
22023,1630201,22300514,"JAN 09, 2024",NYK vs. POR,W,4,0,1,0.0,0,1,0.0,2,2,1.0,0,0,0,0,0,0,0,0,2,-5,1,Malachi Flynn,NYK,NYK,POR,,,2,2,2,0
22023,1630201,22300494,"JAN 06, 2024",NYK @ WAS,W,1,0,1,0.0,0,0,0.0,0,0,0.0,0,0,0,0,0,0,0,0,0,-3,1,Malachi Flynn,NYK,WAS,NYK,,,0,0,0,0
22023,1630201,22300483,"JAN 05, 2024",NYK @ PHI,W,1,0,0,0.0,0,0,0.0,0,0,0.0,0,1,1,0,0,0,0,0,0,2,1,Malachi Flynn,NYK,PHI,NYK,,,1,1,0,1
22023,1630201,22300432,"DEC 29, 2023",TOR @ BOS,L,6,0,0,0.0,0,0,0.0,0,0,0.0,0,0,0,0,2,0,0,1,0,2,1,Malachi Flynn,TOR,BOS,TOR,,,0,0,0,0
22023,1630201,22300416,"DEC 27, 2023",TOR @ WAS,W,5,2,3,0.667,2,3,0.667,0,0,0.0,1,0,1,0,0,0,2,1,6,4,1,Malachi Flynn,TOR,WAS,TOR,,,7,7,6,1
22023,1630201,22300395,"DEC 23, 2023",TOR vs. UTA,L,14,1,3,0.333,1,3,0.333,0,0,0.0,0,2,2,6,0,0,0,1,3,-3,1,Malachi Flynn,TOR,TOR,UTA,,,11,5,9,8
22023,1630201,22300382,"DEC 22, 2023",TOR @ PHI,L,10,1,4,0.25,0,2,0.0,0,0,0.0,2,2,4,2,0,1,3,0,2,9,1,Malachi Flynn,TOR,PHI,TOR,,,8,6,4,6
22023,1630201,22300369,"DEC 20, 2023",TOR vs. DEN,L,16,2,8,0.25,2,3,0.667,0,0,0.0,0,3,3,2,1,0,1,1,6,7,1,Malachi Flynn,TOR,TOR,DEN,,,11,9,8,5
22023,1630201,22300354,"DEC 18, 2023",TOR vs. CHA,W,16,1,6,0.167,0,4,0.0,0,0,0.0,0,3,3,2,0,0,0,1,2,4,1,Malachi Flynn,TOR,TOR,CHA,,,7,5,4,5
22023,1630201,22300330,"DEC 15, 2023",TOR vs. ATL,L,19,3,4,0.75,2,2,1.0,3,4,0.75,0,4,4,1,0,1,2,4,11,-3,1,Malachi Flynn,TOR,TOR,ATL,,,16,15,12,5
22023,1630201,22300313,"DEC 13, 2023",TOR vs. ATL,W,17,0,4,0.0,0,3,0.0,0,0,0.0,0,2,2,8,0,0,2,2,0,-8,1,Malachi Flynn,TOR,TOR,ATL,,,10,2,8,10
22023,1630201,22300297,"DEC 11, 2023",TOR @ NYK,L,17,4,5,0.8,2,2,1.0,0,0,0.0,1,3,4,4,0,0,3,2,10,3,1,Malachi Flynn,TOR,NYK,TOR,,,18,14,14,8
22023,1630201,22301216,"DEC 08, 2023",TOR @ CHA,L,17,3,7,0.429,0,4,0.0,2,2,1.0,0,0,0,4,2,0,1,1,8,8,1,Malachi Flynn,TOR,CHA,TOR,,,12,8,12,4
22023,1630201,22301207,"DEC 06, 2023",TOR vs. MIA,L,6,1,1,1.0,1,1,1.0,0,0,0.0,0,1,1,1,0,0,0,1,3,-3,1,Malachi Flynn,TOR,TOR,MIA,,,5,4,4,2
22023,1630201,22300276,"DEC 01, 2023",TOR vs. NYK,L,11,0,2,0.0,0,1,0.0,0,0,0.0,0,1,1,4,0,1,0,1,0,-3,1,Malachi Flynn,TOR,TOR,NYK,,,5,1,4,5
22023,1630201,22300260,"NOV 29, 2023",TOR vs. PHX,W,14,0,3,0.0,0,3,0.0,2,2,1.0,1,4,5,1,0,0,1,0,2,9,1,Malachi Flynn,TOR,TOR,PHX,,,8,7,3,6
22023,1630201,22300054,"NOV 28, 2023",TOR @ BKN,L,16,2,5,0.4,1,3,0.333,0,0,0.0,0,0,0,1,0,0,0,1,5,-10,1,Malachi Flynn,TOR,BKN,TOR,,,6,5,6,1
22023,1630201,22300251,"NOV 26, 2023",TOR @ CLE,L,17,1,6,0.167,1,4,0.25,0,0,0.0,0,4,4,0,0,0,1,1,3,-13,1,Malachi Flynn,TOR,CLE,TOR,,,7,7,3,4
22023,1630201,22300046,"NOV 24, 2023",TOR vs. CHI,W,14,0,2,0.0,0,2,0.0,2,2,1.0,0,1,1,1,1,0,1,1,2,4,1,Malachi Flynn,TOR,TOR,CHI,,,4,3,3,2
22023,1630201,22300230,"NOV 22, 2023",TOR @ IND,W,20,6,8,0.75,2,3,0.667,0,0,0.0,2,2,4,2,0,1,1,2,14,-4,1,Malachi Flynn,TOR,IND,TOR,,,20,18,16,6
22023,1630201,22300038,"NOV 21, 2023",TOR @ ORL,L,19,2,4,0.5,1,2,0.5,1,2,0.5,0,3,3,1,1,1,1,1,6,-14,1,Malachi Flynn,TOR,ORL,TOR,,,10,9,7,4
22023,1630201,22300211,"NOV 19, 2023",TOR vs. DET,W,21,3,5,0.6,1,2,0.5,0,2,0.0,0,2,2,4,2,0,1,4,7,0,1,Malachi Flynn,TOR,TOR,DET,,,13,9,11,6
22023,1630201,22300031,"NOV 17, 2023",TOR vs. BOS,L,19,2,5,0.4,1,1,1.0,0,0,0.0,1,0,1,5,0,0,1,1,5,-15,1,Malachi Flynn,TOR,TOR,BOS,,,11,6,10,6
22023,1630201,22300195,"NOV 15, 2023",TOR vs. MIL,L,27,3,11,0.273,0,8,0.0,1,1,1.0,2,1,3,5,0,1,0,1,7,4,1,Malachi Flynn,TOR,TOR,MIL,,,15,10,12,8
22023,1630201,22300189,"NOV 13, 2023",TOR vs. WAS,W,23,2,5,0.4,1,4,0.25,1,1,1.0,0,2,2,1,1,0,1,2,6,12,1,Malachi Flynn,TOR,TOR,WAS,,,9,8,7,3
22023,1630201,22300174,"NOV 11, 2023",TOR @ BOS,L,23,5,7,0.714,2,4,0.5,0,1,0.0,0,1,1,1,0,0,1,0,12,-21,1,Malachi Flynn,TOR,BOS,TOR,,,14,13,13,2
22023,1630201,22300168,"NOV 08, 2023",TOR @ DAL,W,15,2,5,0.4,2,4,0.5,2,2,1.0,0,4,4,4,0,0,0,2,8,7,1,Malachi Flynn,TOR,DAL,TOR,,,16,12,12,8
22023,1630201,22300141,"NOV 05, 2023",TOR @ SAS,W,15,1,3,0.333,1,2,0.5,2,2,1.0,1,2,3,4,0,0,0,1,5,6,1,Malachi Flynn,TOR,SAS,TOR,,,12,8,9,7
22023,1630201,22300128,"NOV 02, 2023",TOR @ PHI,L,17,2,5,0.4,2,3,0.667,0,0,0.0,1,2,3,1,2,0,1,2,6,-8,1,Malachi Flynn,TOR,PHI,TOR,,,10,9,7,4
22023,1630201,22300116,"NOV 01, 2023",TOR vs. MIL,W,19,1,3,0.333,0,1,0.0,0,0,0.0,1,2,3,4,3,0,3,1,2,-2,1,Malachi Flynn,TOR,TOR,MIL,,,9,5,6,7
22023,1630201,22300105,"OCT 30, 2023",TOR vs. POR,L,15,3,5,0.6,0,2,0.0,0,0,0.0,0,1,1,0,1,0,1,1,6,-9,1,Malachi Flynn,TOR,TOR,POR,,,7,7,6,1
22023,1630201,22300092,"OCT 28, 2023",TOR vs. PHI,L,13,2,4,0.5,2,2,1.0,1,1,1.0,0,0,0,2,1,0,3,1,7,-2,1,Malachi Flynn,TOR,TOR,PHI,,,9,7,9,2
22023,1630201,22300082,"OCT 27, 2023",TOR @ CHI,L,4,0,1,0.0,0,1,0.0,0,0,0.0,0,0,0,0,0,0,0,0,0,-14,1,Malachi Flynn,TOR,CHI,TOR,,,0,0,0,0
22023,1630201,22300069,"OCT 25, 2023",TOR vs. MIN,W,10,1,3,0.333,1,1,1.0,0,0,0.0,0,0,0,2,1,0,2,4,3,-14,1,Malachi Flynn,TOR,TOR,MIN,,,5,3,5,2
22023,1631323,22300564,"JAN 15, 2024",UTA vs. IND,W,24,3,5,0.6,2,3,0.667,0,0,0.0,0,4,4,2,0,0,1,2,8,22,1,Simone Fontecchio,UTA,UTA,IND,,,14,12,10,6
22023,1631323,22300549,"JAN 13, 2024",UTA vs. LAL,W,24,0,5,0.0,0,3,0.0,0,0,0.0,2,2,4,4,0,0,1,3,0,16,1,Simone Fontecchio,UTA,UTA,LAL,,,8,4,4,8
22023,1631323,22300540,"JAN 12, 2024",UTA vs. TOR,W,23,5,9,0.556,3,5,0.6,0,0,0.0,1,1,2,0,0,1,0,0,13,10,1,Simone Fontecchio,UTA,UTA,TOR,,,15,15,13,2
22023,1631323,22300524,"JAN 10, 2024",UTA vs. DEN,W,21,1,5,0.2,1,4,0.25,0,0,0.0,0,0,0,2,0,0,3,0,3,13,1,Simone Fontecchio,UTA,UTA,DEN,,,5,3,5,2
22023,1631323,22300510,"JAN 08, 2024",UTA @ MIL,W,32,2,6,0.333,1,5,0.2,0,0,0.0,0,3,3,1,1,1,1,4,5,4,1,Simone Fontecchio,UTA,MIL,UTA,,,9,8,6,4
22023,1631323,22300495,"JAN 06, 2024",UTA @ PHI,W,33,3,9,0.333,1,6,0.167,0,0,0.0,1,6,7,2,1,0,4,1,7,6,1,Simone Fontecchio,UTA,PHI,UTA,,,16,14,9,9
22023,1631323,22300479,"JAN 05, 2024",UTA @ BOS,L,25,2,7,0.286,2,5,0.4,1,2,0.5,1,3,4,3,1,0,2,2,7,-13,1,Simone Fontecchio,UTA,BOS,UTA,,,14,11,10,7
22023,1631323,22300474,"JAN 03, 2024",UTA vs. DET,W,35,6,11,0.545,3,4,0.75,1,1,1.0,2,5,7,4,2,0,0,2,16,13,1,Simone Fontecchio,UTA,UTA,DET,,,27,23,20,11
22023,1631323,22300457,"JAN 01, 2024",UTA vs. DAL,W,29,10,16,0.625,3,8,0.375,1,1,1.0,0,6,6,2,2,1,1,0,24,27,1,Simone Fontecchio,UTA,UTA,DAL,,,32,30,26,8
22023,1631323,22300439,"DEC 30, 2023",UTA vs. MIA,W,31,4,9,0.444,1,5,0.2,3,6,0.5,3,4,7,2,2,1,0,4,12,7,1,Simone Fontecchio,UTA,UTA,MIA,,,21,19,14,9
22023,1631323,22300424,"DEC 28, 2023",UTA @ NOP,L,14,2,4,0.5,1,2,0.5,0,0,0.0,2,0,2,0,1,0,1,4,5,-13,1,Simone Fontecchio,UTA,NOP,UTA,,,7,7,5,2
22023,1631323,22300412,"DEC 26, 2023",UTA @ SAS,W,23,3,5,0.6,2,4,0.5,0,0,0.0,1,2,3,0,0,0,1,1,8,25,1,Simone Fontecchio,UTA,SAS,UTA,,,11,11,8,3
22023,1631323,22300395,"DEC 23, 2023",UTA @ TOR,W,20,2,3,0.667,2,3,0.667,0,0,0.0,1,0,1,0,1,0,3,3,6,0,1,Simone Fontecchio,UTA,TOR,UTA,,,7,7,6,1
22023,1631323,22300374,"DEC 21, 2023",UTA @ DET,W,29,6,12,0.5,4,7,0.571,0,0,0.0,0,2,2,0,1,0,0,1,16,2,1,Simone Fontecchio,UTA,DET,UTA,,,18,18,16,2
22023,1631323,22300364,"DEC 20, 2023",UTA @ CLE,L,36,3,7,0.429,2,5,0.4,1,2,0.5,1,6,7,2,0,0,2,3,9,8,1,Simone Fontecchio,UTA,CLE,UTA,,,18,16,11,9
22023,1631323,22300357,"DEC 18, 2023",UTA vs. BKN,W,25,1,7,0.143,0,3,0.0,0,0,0.0,2,2,4,3,2,0,1,3,2,9,1,Simone Fontecchio,UTA,UTA,BKN,,,9,6,5,7
22023,1631323,22300342,"DEC 16, 2023",UTA @ SAC,L,25,3,9,0.333,1,5,0.2,0,0,0.0,0,2,2,0,0,0,0,0,7,-23,1,Simone Fontecchio,UTA,SAC,UTA,,,9,9,7,2
22023,1631323,22300323,"DEC 14, 2023",UTA @ POR,W,25,7,8,0.875,5,5,1.0,5,5,1.0,1,4,5,0,1,0,0,0,24,24,1,Simone Fontecchio,UTA,POR,UTA,,,29,29,24,5
22023,1631323,22300318,"DEC 13, 2023",UTA vs. NYK,W,31,4,12,0.333,3,10,0.3,4,4,1.0,3,3,6,2,2,0,2,4,15,-10,1,Simone Fontecchio,UTA,UTA,NYK,,,23,21,17,8
22023,1631323,22300302,"DEC 11, 2023",UTA @ OKC,L,23,7,11,0.636,3,6,0.5,2,2,1.0,1,1,2,1,0,4,0,1,19,-13,1,Simone Fontecchio,UTA,OKC,UTA,,,22,21,20,3
22023,1631323,22301225,"DEC 08, 2023",UTA vs. LAC,L,31,3,8,0.375,2,5,0.4,0,2,0.0,0,2,2,0,0,0,2,4,8,-19,1,Simone Fontecchio,UTA,UTA,LAC,,,10,10,8,2
22023,1631323,22301213,"DEC 06, 2023",UTA @ DAL,L,24,2,5,0.4,1,3,0.333,2,2,1.0,0,2,2,3,0,1,1,1,7,-40,1,Simone Fontecchio,UTA,DAL,UTA,,,12,9,10,5
22023,1631323,22300289,"DEC 02, 2023",UTA vs. POR,W,35,3,12,0.25,1,8,0.125,0,0,0.0,1,4,5,5,0,2,2,2,7,-4,1,Simone Fontecchio,UTA,UTA,POR,,,17,12,12,10
22023,1631323,22300270,"NOV 30, 2023",UTA @ MIN,L,34,6,12,0.5,2,7,0.286,2,2,1.0,3,2,5,5,1,0,2,3,16,-11,1,Simone Fontecchio,UTA,MIN,UTA,,,26,21,21,10
22023,1631323,22300261,"NOV 29, 2023",UTA @ MEM,L,25,4,13,0.308,4,8,0.5,0,0,0.0,0,4,4,4,1,0,0,1,12,-10,1,Simone Fontecchio,UTA,MEM,UTA,,,20,16,16,8
22023,1631323,22300256,"NOV 27, 2023",UTA vs. NOP,W,28,4,9,0.444,3,8,0.375,3,4,0.75,0,4,4,2,2,0,0,3,14,-1,1,Simone Fontecchio,UTA,UTA,NOP,,,20,18,16,6
22023,1631323,22300243,"NOV 25, 2023",UTA vs. NOP,W,26,3,8,0.375,2,7,0.286,2,2,1.0,0,3,3,0,0,1,2,1,10,0,1,Simone Fontecchio,UTA,UTA,NOP,,,13,13,10,3
22023,1631323,22300237,"NOV 22, 2023",UTA @ POR,L,16,3,7,0.429,2,6,0.333,0,0,0.0,1,0,1,1,1,0,1,1,8,-8,1,Simone Fontecchio,UTA,POR,UTA,,,10,9,9,2
22023,1631323,22300042,"NOV 21, 2023",UTA @ LAL,L,27,4,6,0.667,3,5,0.6,0,0,0.0,2,2,4,0,0,1,1,3,11,-6,1,Simone Fontecchio,UTA,LAL,UTA,,,15,15,11,4
22023,1631323,22300214,"NOV 19, 2023",UTA vs. PHX,L,18,1,3,0.333,1,1,1.0,0,0,0.0,1,0,1,0,0,1,1,1,3,4,1,Simone Fontecchio,UTA,UTA,PHX,,,4,4,3,1
22023,1631323,22300035,"NOV 17, 2023",UTA vs. PHX,L,15,3,5,0.6,2,4,0.5,0,0,0.0,0,1,1,0,0,0,1,2,8,-2,1,Simone Fontecchio,UTA,UTA,PHX,,,9,9,8,1
22023,1631323,22300023,"NOV 14, 2023",UTA vs. POR,W,16,0,2,0.0,0,2,0.0,0,0,0.0,0,1,1,0,0,0,0,2,0,11,1,Simone Fontecchio,UTA,UTA,POR,,,1,1,0,1
22023,1631323,22300012,"NOV 10, 2023",UTA @ MEM,W,12,2,3,0.667,2,2,1.0,0,0,0.0,1,1,2,1,2,0,1,2,6,-8,1,Simone Fontecchio,UTA,MEM,UTA,,,9,8,7,3
22023,1631323,22300158,"NOV 08, 2023",UTA @ IND,L,18,4,8,0.5,2,5,0.4,0,0,0.0,3,2,5,1,0,1,2,2,10,-15,1,Simone Fontecchio,UTA,IND,UTA,,,16,15,11,6
22023,1631323,22300152,"NOV 06, 2023",UTA @ CHI,L,4,0,2,0.0,0,2,0.0,0,0,0.0,0,0,0,0,0,0,1,0,0,5,1,Simone Fontecchio,UTA,CHI,UTA,,,0,0,0,0
22023,1631323,22300138,"NOV 04, 2023",UTA @ MIN,L,10,2,3,0.667,1,1,1.0,0,0,0.0,0,2,2,0,0,0,1,0,5,-7,1,Simone Fontecchio,UTA,MIN,UTA,,,7,7,5,2
22023,1631323,22300130,"NOV 02, 2023",UTA vs. ORL,L,7,0,1,0.0,0,1,0.0,0,0,0.0,0,2,2,0,0,0,0,0,0,5,1,Simone Fontecchio,UTA,UTA,ORL,,,2,2,0,2
22023,1631323,22300125,"NOV 01, 2023",UTA vs. MEM,W,8,2,5,0.4,1,3,0.333,0,0,0.0,0,1,1,1,0,0,1,1,5,-3,1,Simone Fontecchio,UTA,UTA,MEM,,,7,6,6,2
22023,1631323,22300094,"OCT 28, 2023",UTA @ PHX,L,18,5,8,0.625,3,6,0.5,0,0,0.0,1,2,3,0,0,1,2,1,13,6,1,Simone Fontecchio,UTA,PHX,UTA,,,16,16,13,3
22023,1631323,22300072,"OCT 25, 2023",UTA vs. SAC,L,2,1,2,0.5,0,1,0.0,0,0,0.0,1,0,1,1,0,0,0,0,2,2,1,Simone Fontecchio,UTA,UTA,SAC,,,4,3,3,2
22023,1630259,22300309,"DEC 12, 2023",SAC @ LAC,L,8,2,2,1.0,1,1,1.0,0,0,0.0,0,1,1,1,0,0,1,0,5,12,1,Jordan Ford,SAC,LAC,SAC,,,7,6,6,2
22023,1630259,22300264,"NOV 29, 2023",SAC vs. LAC,L,1,0,0,0.0,0,0,0.0,0,0,0.0,0,0,0,0,0,0,0,0,0,0,1,Jordan Ford,SAC,SAC,LAC,,,0,0,0,0
22023,1630259,22300191,"NOV 13, 2023",SAC vs. CLE,W,1,0,1,0.0,0,1,0.0,0,0,0.0,0,0,0,0,0,0,0,0,0,-5,1,Jordan Ford,SAC,SAC,CLE,,,0,0,0,0
22023,1630259,22300153,"NOV 06, 2023",SAC @ HOU,L,8,2,3,0.667,1,1,1.0,0,0,0.0,0,1,1,1,0,0,0,0,5,9,1,Jordan Ford,SAC,HOU,SAC,,,7,6,6,2
22023,1630259,22300137,"NOV 04, 2023",SAC @ HOU,L,1,0,0,0.0,0,0,0.0,2,2,1.0,0,0,0,0,0,0,0,0,2,0,1,Jordan Ford,SAC,HOU,SAC,,,2,2,2,0
22023,1630259,22300072,"OCT 25, 2023",SAC @ UTA,W,1,0,1,0.0,0,0,0.0,0,0,0.0,0,0,0,0,0,0,0,0,0,-2,1,Jordan Ford,SAC,UTA,SAC,,,0,0,0,0
22023,1630235,22300559,"JAN 15, 2024",ATL vs. SAS,W,12,1,3,0.333,1,1,1.0,0,0,0.0,1,2,3,0,0,0,0,2,3,-13,1,Trent Forrest,ATL,ATL,SAS,,,6,6,3,3
22023,1630235,22300543,"JAN 13, 2024",ATL vs. WAS,L,13,1,4,0.25,0,0,0.0,2,4,0.5,0,2,2,1,1,0,2,1,4,-7,1,Trent Forrest,ATL,ATL,WAS,,,7,6,5,3
22023,1630235,22300533,"JAN 12, 2024",ATL vs. IND,L,20,2,5,0.4,0,0,0.0,0,0,0.0,0,0,0,6,1,0,1,0,4,-5,1,Trent Forrest,ATL,ATL,IND,,,10,4,10,6
22023,1630235,22300521,"JAN 10, 2024",ATL vs. PHI,W,19,2,3,0.667,0,1,0.0,0,0,0.0,0,5,5,3,0,0,0,3,4,6,1,Trent Forrest,ATL,ATL,PHI,,,12,9,7,8
22023,1630235,22300480,"JAN 05, 2024",ATL @ IND,L,14,2,4,0.5,0,1,0.0,2,2,1.0,0,2,2,2,1,0,2,0,6,-11,1,Trent Forrest,ATL,IND,ATL,,,10,8,8,4
22023,1630235,22300467,"JAN 03, 2024",ATL vs. OKC,W,14,3,3,1.0,0,0,0.0,0,0,0.0,0,2,2,2,0,1,0,3,6,7,1,Trent Forrest,ATL,ATL,OKC,,,10,8,8,4
22023,1630235,22300408,"DEC 26, 2023",ATL @ CHI,L,3,0,0,0.0,0,0,0.0,0,0,0.0,0,0,0,0,0,0,0,0,0,4,1,Trent Forrest,ATL,CHI,ATL,,,0,0,0,0
22023,1630235,22300336,"DEC 16, 2023",ATL @ CLE,L,7,0,2,0.0,0,0,0.0,0,0,0.0,1,2,3,0,1,0,1,0,0,-4,1,Trent Forrest,ATL,CLE,ATL,,,3,3,0,3
22023,1630235,22300330,"DEC 15, 2023",ATL @ TOR,W,11,0,4,0.0,0,1,0.0,0,0,0.0,1,2,3,4,1,0,0,1,0,2,1,Trent Forrest,ATL,TOR,ATL,,,7,3,4,7
22023,1630235,22301218,"DEC 08, 2023",ATL @ PHI,L,13,2,5,0.4,0,0,0.0,2,2,1.0,1,0,1,1,0,0,1,2,6,-3,1,Trent Forrest,ATL,PHI,ATL,,,8,7,7,2
22023,1630235,22300055,"NOV 28, 2023",ATL @ CLE,L,4,0,1,0.0,0,0,0.0,0,0,0.0,0,0,0,0,0,0,0,0,0,0,1,Trent Forrest,ATL,CLE,ATL,,,0,0,0,0
22023,1630235,22300241,"NOV 25, 2023",ATL @ WAS,W,9,1,2,0.5,0,0,0.0,0,0,0.0,0,0,0,2,0,0,1,1,2,-7,1,Trent Forrest,ATL,WAS,ATL,,,4,2,4,2
22023,1630235,22300018,"NOV 14, 2023",ATL @ DET,W,13,0,1,0.0,0,0,0.0,2,2,1.0,1,0,1,4,0,0,0,0,2,-3,1,Trent Forrest,ATL,DET,ATL,,,7,3,6,5
22023,1630235,22300097,"OCT 29, 2023",ATL @ MIL,W,5,0,0,0.0,0,0,0.0,0,0,0.0,0,0,0,1,0,0,0,1,0,-7,1,Trent Forrest,ATL,MIL,ATL,,,1,0,1,1
22023,203095,22300441,"DEC 30, 2023",NYK @ IND,L,17,3,10,0.3,2,8,0.25,2,2,1.0,0,2,2,2,3,0,1,0,10,-13,1,Evan Fournier,NYK,IND,NYK,,,14,12,12,4
22023,203095,22300028,"NOV 17, 2023",NYK @ WAS,W,16,1,6,0.167,0,4,0.0,0,0,0.0,0,1,1,1,1,0,0,2,2,6,1,Evan Fournier,NYK,WAS,NYK,,,4,3,3,2
22023,1628368,22300552,"JAN 14, 2024",SAC @ MIL,L,43,12,26,0.462,2,6,0.333,6,7,0.857,1,1,2,5,3,0,4,4,32,-3,1,De'Aaron Fox,SAC,MIL,SAC,27.5,Points,39,34,37,7
22023,1628368,22300552,"JAN 14, 2024",SAC @ MIL,L,43,12,26,0.462,2,6,0.333,6,7,0.857,1,1,2,5,3,0,4,4,32,-3,1,De'Aaron Fox,SAC,MIL,SAC,37.0,Pts+Rebs+Asts,39,34,37,7
22023,1628368,22300552,"JAN 14, 2024",SAC @ MIL,L,43,12,26,0.462,2,6,0.333,6,7,0.857,1,1,2,5,3,0,4,4,32,-3,1,De'Aaron Fox,SAC,MIL,SAC,5.0,Assists,39,34,37,7
22023,1628368,22300552,"JAN 14, 2024",SAC @ MIL,L,43,12,26,0.462,2,6,0.333,6,7,0.857,1,1,2,5,3,0,4,4,32,-3,1,De'Aaron Fox,SAC,MIL,SAC,41.5,Fantasy Score,39,34,37,7
22023,1628368,22300552,"JAN 14, 2024",SAC @ MIL,L,43,12,26,0.462,2,6,0.333,6,7,0.857,1,1,2,5,3,0,4,4,32,-3,1,De'Aaron Fox,SAC,MIL,SAC,0.5,Offensive Rebounds,39,34,37,7
22023,1628368,22300552,"JAN 14, 2024",SAC @ MIL,L,43,12,26,0.462,2,6,0.333,6,7,0.857,1,1,2,5,3,0,4,4,32,-3,1,De'Aaron Fox,SAC,MIL,SAC,7.5,3-PT Attempted,39,34,37,7
22023,1628368,22300552,"JAN 14, 2024",SAC @ MIL,L,43,12,26,0.462,2,6,0.333,6,7,0.857,1,1,2,5,3,0,4,4,32,-3,1,De'Aaron Fox,SAC,MIL,SAC,4.5,Free Throws Made,39,34,37,7
22023,1628368,22300552,"JAN 14, 2024",SAC @ MIL,L,43,12,26,0.462,2,6,0.333,6,7,0.857,1,1,2,5,3,0,4,4,32,-3,1,De'Aaron Fox,SAC,MIL,SAC,21.5,FG Attempted,39,34,37,7
22023,1628368,22300552,"JAN 14, 2024",SAC @ MIL,L,43,12,26,0.462,2,6,0.333,6,7,0.857,1,1,2,5,3,0,4,4,32,-3,1,De'Aaron Fox,SAC,MIL,SAC,31.5,Pts+Rebs,39,34,37,7
22023,1628368,22300552,"JAN 14, 2024",SAC @ MIL,L,43,12,26,0.462,2,6,0.333,6,7,0.857,1,1,2,5,3,0,4,4,32,-3,1,De'Aaron Fox,SAC,MIL,SAC,32.5,Pts+Asts,39,34,37,7
22023,1628368,22300552,"JAN 14, 2024",SAC @ MIL,L,43,12,26,0.462,2,6,0.333,6,7,0.857,1,1,2,5,3,0,4,4,32,-3,1,De'Aaron Fox,SAC,MIL,SAC,9.0,Rebs+Asts,39,34,37,7
22023,1628368,22300532,"JAN 12, 2024",SAC @ PHI,L,38,5,15,0.333,2,7,0.286,9,11,0.818,1,4,5,4,1,0,2,2,21,-25,1,De'Aaron Fox,SAC,PHI,SAC,27.5,Points,30,26,25,9
22023,1628368,22300532,"JAN 12, 2024",SAC @ PHI,L,38,5,15,0.333,2,7,0.286,9,11,0.818,1,4,5,4,1,0,2,2,21,-25,1,De'Aaron Fox,SAC,PHI,SAC,37.0,Pts+Rebs+Asts,30,26,25,9
22023,1628368,22300532,"JAN 12, 2024",SAC @ PHI,L,38,5,15,0.333,2,7,0.286,9,11,0.818,1,4,5,4,1,0,2,2,21,-25,1,De'Aaron Fox,SAC,PHI,SAC,5.0,Assists,30,26,25,9
22023,1628368,22300532,"JAN 12, 2024",SAC @ PHI,L,38,5,15,0.333,2,7,0.286,9,11,0.818,1,4,5,4,1,0,2,2,21,-25,1,De'Aaron Fox,SAC,PHI,SAC,41.5,Fantasy Score,30,26,25,9
22023,1628368,22300532,"JAN 12, 2024",SAC @ PHI,L,38,5,15,0.333,2,7,0.286,9,11,0.818,1,4,5,4,1,0,2,2,21,-25,1,De'Aaron Fox,SAC,PHI,SAC,0.5,Offensive Rebounds,30,26,25,9
22023,1628368,22300532,"JAN 12, 2024",SAC @ PHI,L,38,5,15,0.333,2,7,0.286,9,11,0.818,1,4,5,4,1,0,2,2,21,-25,1,De'Aaron Fox,SAC,PHI,SAC,7.5,3-PT Attempted,30,26,25,9
22023,1628368,22300532,"JAN 12, 2024",SAC @ PHI,L,38,5,15,0.333,2,7,0.286,9,11,0.818,1,4,5,4,1,0,2,2,21,-25,1,De'Aaron Fox,SAC,PHI,SAC,4.5,Free Throws Made,30,26,25,9
22023,1628368,22300532,"JAN 12, 2024",SAC @ PHI,L,38,5,15,0.333,2,7,0.286,9,11,0.818,1,4,5,4,1,0,2,2,21,-25,1,De'Aaron Fox,SAC,PHI,SAC,21.5,FG Attempted,30,26,25,9
22023,1628368,22300532,"JAN 12, 2024",SAC @ PHI,L,38,5,15,0.333,2,7,0.286,9,11,0.818,1,4,5,4,1,0,2,2,21,-25,1,De'Aaron Fox,SAC,PHI,SAC,31.5,Pts+Rebs,30,26,25,9
22023,1628368,22300532,"JAN 12, 2024",SAC @ PHI,L,38,5,15,0.333,2,7,0.286,9,11,0.818,1,4,5,4,1,0,2,2,21,-25,1,De'Aaron Fox,SAC,PHI,SAC,32.5,Pts+Asts,30,26,25,9
22023,1628368,22300532,"JAN 12, 2024",SAC @ PHI,L,38,5,15,0.333,2,7,0.286,9,11,0.818,1,4,5,4,1,0,2,2,21,-25,1,De'Aaron Fox,SAC,PHI,SAC,9.0,Rebs+Asts,30,26,25,9
22023,1628368,22300518,"JAN 10, 2024",SAC @ CHA,W,28,8,14,0.571,3,7,0.429,0,2,0.0,0,1,1,3,1,1,1,0,19,25,1,De'Aaron Fox,SAC,CHA,SAC,27.5,Points,23,20,22,4
22023,1628368,22300518,"JAN 10, 2024",SAC @ CHA,W,28,8,14,0.571,3,7,0.429,0,2,0.0,0,1,1,3,1,1,1,0,19,25,1,De'Aaron Fox,SAC,CHA,SAC,37.0,Pts+Rebs+Asts,23,20,22,4
22023,1628368,22300518,"JAN 10, 2024",SAC @ CHA,W,28,8,14,0.571,3,7,0.429,0,2,0.0,0,1,1,3,1,1,1,0,19,25,1,De'Aaron Fox,SAC,CHA,SAC,5.0,Assists,23,20,22,4
22023,1628368,22300518,"JAN 10, 2024",SAC @ CHA,W,28,8,14,0.571,3,7,0.429,0,2,0.0,0,1,1,3,1,1,1,0,19,25,1,De'Aaron Fox,SAC,CHA,SAC,41.5,Fantasy Score,23,20,22,4
22023,1628368,22300518,"JAN 10, 2024",SAC @ CHA,W,28,8,14,0.571,3,7,0.429,0,2,0.0,0,1,1,3,1,1,1,0,19,25,1,De'Aaron Fox,SAC,CHA,SAC,0.5,Offensive Rebounds,23,20,22,4
22023,1628368,22300518,"JAN 10, 2024",SAC @ CHA,W,28,8,14,0.571,3,7,0.429,0,2,0.0,0,1,1,3,1,1,1,0,19,25,1,De'Aaron Fox,SAC,CHA,SAC,7.5,3-PT Attempted,23,20,22,4
22023,1628368,22300518,"JAN 10, 2024",SAC @ CHA,W,28,8,14,0.571,3,7,0.429,0,2,0.0,0,1,1,3,1,1,1,0,19,25,1,De'Aaron Fox,SAC,CHA,SAC,4.5,Free Throws Made,23,20,22,4
22023,1628368,22300518,"JAN 10, 2024",SAC @ CHA,W,28,8,14,0.571,3,7,0.429,0,2,0.0,0,1,1,3,1,1,1,0,19,25,1,De'Aaron Fox,SAC,CHA,SAC,21.5,FG Attempted,23,20,22,4
22023,1628368,22300518,"JAN 10, 2024",SAC @ CHA,W,28,8,14,0.571,3,7,0.429,0,2,0.0,0,1,1,3,1,1,1,0,19,25,1,De'Aaron Fox,SAC,CHA,SAC,31.5,Pts+Rebs,23,20,22,4
22023,1628368,22300518,"JAN 10, 2024",SAC @ CHA,W,28,8,14,0.571,3,7,0.429,0,2,0.0,0,1,1,3,1,1,1,0,19,25,1,De'Aaron Fox,SAC,CHA,SAC,32.5,Pts+Asts,23,20,22,4
22023,1628368,22300518,"JAN 10, 2024",SAC @ CHA,W,28,8,14,0.571,3,7,0.429,0,2,0.0,0,1,1,3,1,1,1,0,19,25,1,De'Aaron Fox,SAC,CHA,SAC,9.0,Rebs+Asts,23,20,22,4
22023,1628368,22300512,"JAN 09, 2024",SAC @ DET,W,33,10,19,0.526,4,7,0.571,2,2,1.0,0,3,3,4,2,0,5,2,26,2,1,De'Aaron Fox,SAC,DET,SAC,27.5,Points,33,29,30,7
22023,1628368,22300512,"JAN 09, 2024",SAC @ DET,W,33,10,19,0.526,4,7,0.571,2,2,1.0,0,3,3,4,2,0,5,2,26,2,1,De'Aaron Fox,SAC,DET,SAC,37.0,Pts+Rebs+Asts,33,29,30,7
22023,1628368,22300512,"JAN 09, 2024",SAC @ DET,W,33,10,19,0.526,4,7,0.571,2,2,1.0,0,3,3,4,2,0,5,2,26,2,1,De'Aaron Fox,SAC,DET,SAC,5.0,Assists,33,29,30,7
22023,1628368,22300512,"JAN 09, 2024",SAC @ DET,W,33,10,19,0.526,4,7,0.571,2,2,1.0,0,3,3,4,2,0,5,2,26,2,1,De'Aaron Fox,SAC,DET,SAC,41.5,Fantasy Score,33,29,30,7
22023,1628368,22300512,"JAN 09, 2024",SAC @ DET,W,33,10,19,0.526,4,7,0.571,2,2,1.0,0,3,3,4,2,0,5,2,26,2,1,De'Aaron Fox,SAC,DET,SAC,0.5,Offensive Rebounds,33,29,30,7
22023,1628368,22300512,"JAN 09, 2024",SAC @ DET,W,33,10,19,0.526,4,7,0.571,2,2,1.0,0,3,3,4,2,0,5,2,26,2,1,De'Aaron Fox,SAC,DET,SAC,7.5,3-PT Attempted,33,29,30,7
22023,1628368,22300512,"JAN 09, 2024",SAC @ DET,W,33,10,19,0.526,4,7,0.571,2,2,1.0,0,3,3,4,2,0,5,2,26,2,1,De'Aaron Fox,SAC,DET,SAC,4.5,Free Throws Made,33,29,30,7
22023,1628368,22300512,"JAN 09, 2024",SAC @ DET,W,33,10,19,0.526,4,7,0.571,2,2,1.0,0,3,3,4,2,0,5,2,26,2,1,De'Aaron Fox,SAC,DET,SAC,21.5,FG Attempted,33,29,30,7
22023,1628368,22300512,"JAN 09, 2024",SAC @ DET,W,33,10,19,0.526,4,7,0.571,2,2,1.0,0,3,3,4,2,0,5,2,26,2,1,De'Aaron Fox,SAC,DET,SAC,31.5,Pts+Rebs,33,29,30,7
22023,1628368,22300512,"JAN 09, 2024",SAC @ DET,W,33,10,19,0.526,4,7,0.571,2,2,1.0,0,3,3,4,2,0,5,2,26,2,1,De'Aaron Fox,SAC,DET,SAC,32.5,Pts+Asts,33,29,30,7
22023,1628368,22300512,"JAN 09, 2024",SAC @ DET,W,33,10,19,0.526,4,7,0.571,2,2,1.0,0,3,3,4,2,0,5,2,26,2,1,De'Aaron Fox,SAC,DET,SAC,9.0,Rebs+Asts,33,29,30,7
22023,1628368,22300500,"JAN 07, 2024",SAC vs. NOP,L,26,1,10,0.1,1,4,0.25,0,0,0.0,0,2,2,4,0,0,4,3,3,-30,1,De'Aaron Fox,SAC,SAC,NOP,27.5,Points,9,5,7,6
22023,1628368,22300500,"JAN 07, 2024",SAC vs. NOP,L,26,1,10,0.1,1,4,0.25,0,0,0.0,0,2,2,4,0,0,4,3,3,-30,1,De'Aaron Fox,SAC,SAC,NOP,37.0,Pts+Rebs+Asts,9,5,7,6
22023,1628368,22300500,"JAN 07, 2024",SAC vs. NOP,L,26,1,10,0.1,1,4,0.25,0,0,0.0,0,2,2,4,0,0,4,3,3,-30,1,De'Aaron Fox,SAC,SAC,NOP,5.0,Assists,9,5,7,6
22023,1628368,22300500,"JAN 07, 2024",SAC vs. NOP,L,26,1,10,0.1,1,4,0.25,0,0,0.0,0,2,2,4,0,0,4,3,3,-30,1,De'Aaron Fox,SAC,SAC,NOP,41.5,Fantasy Score,9,5,7,6
22023,1628368,22300500,"JAN 07, 2024",SAC vs. NOP,L,26,1,10,0.1,1,4,0.25,0,0,0.0,0,2,2,4,0,0,4,3,3,-30,1,De'Aaron Fox,SAC,SAC,NOP,0.5,Offensive Rebounds,9,5,7,6
22023,1628368,22300500,"JAN 07, 2024",SAC vs. NOP,L,26,1,10,0.1,1,4,0.25,0,0,0.0,0,2,2,4,0,0,4,3,3,-30,1,De'Aaron Fox,SAC,SAC,NOP,7.5,3-PT Attempted,9,5,7,6
22023,1628368,22300500,"JAN 07, 2024",SAC vs. NOP,L,26,1,10,0.1,1,4,0.25,0,0,0.0,0,2,2,4,0,0,4,3,3,-30,1,De'Aaron Fox,SAC,SAC,NOP,4.5,Free Throws Made,9,5,7,6
22023,1628368,22300500,"JAN 07, 2024",SAC vs. NOP,L,26,1,10,0.1,1,4,0.25,0,0,0.0,0,2,2,4,0,0,4,3,3,-30,1,De'Aaron Fox,SAC,SAC,NOP,21.5,FG Attempted,9,5,7,6
22023,1628368,22300500,"JAN 07, 2024",SAC vs. NOP,L,26,1,10,0.1,1,4,0.25,0,0,0.0,0,2,2,4,0,0,4,3,3,-30,1,De'Aaron Fox,SAC,SAC,NOP,31.5,Pts+Rebs,9,5,7,6
22023,1628368,22300500,"JAN 07, 2024",SAC vs. NOP,L,26,1,10,0.1,1,4,0.25,0,0,0.0,0,2,2,4,0,0,4,3,3,-30,1,De'Aaron Fox,SAC,SAC,NOP,32.5,Pts+Asts,9,5,7,6
22023,1628368,22300500,"JAN 07, 2024",SAC vs. NOP,L,26,1,10,0.1,1,4,0.25,0,0,0.0,0,2,2,4,0,0,4,3,3,-30,1,De'Aaron Fox,SAC,SAC,NOP,9.0,Rebs+Asts,9,5,7,6
22023,1628368,22300492,"JAN 05, 2024",SAC vs. TOR,W,37,10,20,0.5,1,3,0.333,3,3,1.0,1,1,2,4,2,1,2,4,24,-1,1,De'Aaron Fox,SAC,SAC,TOR,27.5,Points,30,26,28,6
22023,1628368,22300492,"JAN 05, 2024",SAC vs. TOR,W,37,10,20,0.5,1,3,0.333,3,3,1.0,1,1,2,4,2,1,2,4,24,-1,1,De'Aaron Fox,SAC,SAC,TOR,37.0,Pts+Rebs+Asts,30,26,28,6
22023,1628368,22300492,"JAN 05, 2024",SAC vs. TOR,W,37,10,20,0.5,1,3,0.333,3,3,1.0,1,1,2,4,2,1,2,4,24,-1,1,De'Aaron Fox,SAC,SAC,TOR,5.0,Assists,30,26,28,6
22023,1628368,22300492,"JAN 05, 2024",SAC vs. TOR,W,37,10,20,0.5,1,3,0.333,3,3,1.0,1,1,2,4,2,1,2,4,24,-1,1,De'Aaron Fox,SAC,SAC,TOR,41.5,Fantasy Score,30,26,28,6
22023,1628368,22300492,"JAN 05, 2024",SAC vs. TOR,W,37,10,20,0.5,1,3,0.333,3,3,1.0,1,1,2,4,2,1,2,4,24,-1,1,De'Aaron Fox,SAC,SAC,TOR,0.5,Offensive Rebounds,30,26,28,6
22023,1628368,22300492,"JAN 05, 2024",SAC vs. TOR,W,37,10,20,0.5,1,3,0.333,3,3,1.0,1,1,2,4,2,1,2,4,24,-1,1,De'Aaron Fox,SAC,SAC,TOR,7.5,3-PT Attempted,30,26,28,6
22023,1628368,22300492,"JAN 05, 2024",SAC vs. TOR,W,37,10,20,0.5,1,3,0.333,3,3,1.0,1,1,2,4,2,1,2,4,24,-1,1,De'Aaron Fox,SAC,SAC,TOR,4.5,Free Throws Made,30,26,28,6
22023,1628368,22300492,"JAN 05, 2024",SAC vs. TOR,W,37,10,20,0.5,1,3,0.333,3,3,1.0,1,1,2,4,2,1,2,4,24,-1,1,De'Aaron Fox,SAC,SAC,TOR,21.5,FG Attempted,30,26,28,6
22023,1628368,22300492,"JAN 05, 2024",SAC vs. TOR,W,37,10,20,0.5,1,3,0.333,3,3,1.0,1,1,2,4,2,1,2,4,24,-1,1,De'Aaron Fox,SAC,SAC,TOR,31.5,Pts+Rebs,30,26,28,6
22023,1628368,22300492,"JAN 05, 2024",SAC vs. TOR,W,37,10,20,0.5,1,3,0.333,3,3,1.0,1,1,2,4,2,1,2,4,24,-1,1,De'Aaron Fox,SAC,SAC,TOR,32.5,Pts+Asts,30,26,28,6
22023,1628368,22300492,"JAN 05, 2024",SAC vs. TOR,W,37,10,20,0.5,1,3,0.333,3,3,1.0,1,1,2,4,2,1,2,4,24,-1,1,De'Aaron Fox,SAC,SAC,TOR,9.0,Rebs+Asts,30,26,28,6
22023,1628368,22300476,"JAN 03, 2024",SAC vs. ORL,W,44,6,22,0.273,0,5,0.0,3,4,0.75,3,1,4,7,1,0,3,1,15,-1,1,De'Aaron Fox,SAC,SAC,ORL,27.5,Points,26,19,22,11
22023,1628368,22300476,"JAN 03, 2024",SAC vs. ORL,W,44,6,22,0.273,0,5,0.0,3,4,0.75,3,1,4,7,1,0,3,1,15,-1,1,De'Aaron Fox,SAC,SAC,ORL,37.0,Pts+Rebs+Asts,26,19,22,11
22023,1628368,22300476,"JAN 03, 2024",SAC vs. ORL,W,44,6,22,0.273,0,5,0.0,3,4,0.75,3,1,4,7,1,0,3,1,15,-1,1,De'Aaron Fox,SAC,SAC,ORL,5.0,Assists,26,19,22,11
22023,1628368,22300476,"JAN 03, 2024",SAC vs. ORL,W,44,6,22,0.273,0,5,0.0,3,4,0.75,3,1,4,7,1,0,3,1,15,-1,1,De'Aaron Fox,SAC,SAC,ORL,41.5,Fantasy Score,26,19,22,11
22023,1628368,22300476,"JAN 03, 2024",SAC vs. ORL,W,44,6,22,0.273,0,5,0.0,3,4,0.75,3,1,4,7,1,0,3,1,15,-1,1,De'Aaron Fox,SAC,SAC,ORL,0.5,Offensive Rebounds,26,19,22,11
22023,1628368,22300476,"JAN 03, 2024",SAC vs. ORL,W,44,6,22,0.273,0,5,0.0,3,4,0.75,3,1,4,7,1,0,3,1,15,-1,1,De'Aaron Fox,SAC,SAC,ORL,7.5,3-PT Attempted,26,19,22,11
22023,1628368,22300476,"JAN 03, 2024",SAC vs. ORL,W,44,6,22,0.273,0,5,0.0,3,4,0.75,3,1,4,7,1,0,3,1,15,-1,1,De'Aaron Fox,SAC,SAC,ORL,4.5,Free Throws Made,26,19,22,11
22023,1628368,22300476,"JAN 03, 2024",SAC vs. ORL,W,44,6,22,0.273,0,5,0.0,3,4,0.75,3,1,4,7,1,0,3,1,15,-1,1,De'Aaron Fox,SAC,SAC,ORL,21.5,FG Attempted,26,19,22,11
22023,1628368,22300476,"JAN 03, 2024",SAC vs. ORL,W,44,6,22,0.273,0,5,0.0,3,4,0.75,3,1,4,7,1,0,3,1,15,-1,1,De'Aaron Fox,SAC,SAC,ORL,31.5,Pts+Rebs,26,19,22,11
22023,1628368,22300476,"JAN 03, 2024",SAC vs. ORL,W,44,6,22,0.273,0,5,0.0,3,4,0.75,3,1,4,7,1,0,3,1,15,-1,1,De'Aaron Fox,SAC,SAC,ORL,32.5,Pts+Asts,26,19,22,11
22023,1628368,22300476,"JAN 03, 2024",SAC vs. ORL,W,44,6,22,0.273,0,5,0.0,3,4,0.75,3,1,4,7,1,0,3,1,15,-1,1,De'Aaron Fox,SAC,SAC,ORL,9.0,Rebs+Asts,26,19,22,11
22023,1628368,22300464,"JAN 02, 2024",SAC vs. CHA,L,38,11,25,0.44,3,10,0.3,5,8,0.625,0,5,5,6,1,1,3,2,30,4,1,De'Aaron Fox,SAC,SAC,CHA,27.5,Points,41,35,36,11
22023,1628368,22300464,"JAN 02, 2024",SAC vs. CHA,L,38,11,25,0.44,3,10,0.3,5,8,0.625,0,5,5,6,1,1,3,2,30,4,1,De'Aaron Fox,SAC,SAC,CHA,37.0,Pts+Rebs+Asts,41,35,36,11
22023,1628368,22300464,"JAN 02, 2024",SAC vs. CHA,L,38,11,25,0.44,3,10,0.3,5,8,0.625,0,5,5,6,1,1,3,2,30,4,1,De'Aaron Fox,SAC,SAC,CHA,5.0,Assists,41,35,36,11
22023,1628368,22300464,"JAN 02, 2024",SAC vs. CHA,L,38,11,25,0.44,3,10,0.3,5,8,0.625,0,5,5,6,1,1,3,2,30,4,1,De'Aaron Fox,SAC,SAC,CHA,41.5,Fantasy Score,41,35,36,11
22023,1628368,22300464,"JAN 02, 2024",SAC vs. CHA,L,38,11,25,0.44,3,10,0.3,5,8,0.625,0,5,5,6,1,1,3,2,30,4,1,De'Aaron Fox,SAC,SAC,CHA,0.5,Offensive Rebounds,41,35,36,11
22023,1628368,22300464,"JAN 02, 2024",SAC vs. CHA,L,38,11,25,0.44,3,10,0.3,5,8,0.625,0,5,5,6,1,1,3,2,30,4,1,De'Aaron Fox,SAC,SAC,CHA,7.5,3-PT Attempted,41,35,36,11
22023,1628368,22300464,"JAN 02, 2024",SAC vs. CHA,L,38,11,25,0.44,3,10,0.3,5,8,0.625,0,5,5,6,1,1,3,2,30,4,1,De'Aaron Fox,SAC,SAC,CHA,4.5,Free Throws Made,41,35,36,11
22023,1628368,22300464,"JAN 02, 2024",SAC vs. CHA,L,38,11,25,0.44,3,10,0.3,5,8,0.625,0,5,5,6,1,1,3,2,30,4,1,De'Aaron Fox,SAC,SAC,CHA,21.5,FG Attempted,41,35,36,11
22023,1628368,22300464,"JAN 02, 2024",SAC vs. CHA,L,38,11,25,0.44,3,10,0.3,5,8,0.625,0,5,5,6,1,1,3,2,30,4,1,De'Aaron Fox,SAC,SAC,CHA,31.5,Pts+Rebs,41,35,36,11
22023,1628368,22300464,"JAN 02, 2024",SAC vs. CHA,L,38,11,25,0.44,3,10,0.3,5,8,0.625,0,5,5,6,1,1,3,2,30,4,1,De'Aaron Fox,SAC,SAC,CHA,32.5,Pts+Asts,41,35,36,11
22023,1628368,22300464,"JAN 02, 2024",SAC vs. CHA,L,38,11,25,0.44,3,10,0.3,5,8,0.625,0,5,5,6,1,1,3,2,30,4,1,De'Aaron Fox,SAC,SAC,CHA,9.0,Rebs+Asts,41,35,36,11
22023,1628368,22300449,"DEC 31, 2023",SAC @ MEM,W,34,9,23,0.391,3,8,0.375,3,5,0.6,1,3,4,4,0,1,1,3,24,20,1,De'Aaron Fox,SAC,MEM,SAC,27.5,Points,32,28,28,8
22023,1628368,22300449,"DEC 31, 2023",SAC @ MEM,W,34,9,23,0.391,3,8,0.375,3,5,0.6,1,3,4,4,0,1,1,3,24,20,1,De'Aaron Fox,SAC,MEM,SAC,37.0,Pts+Rebs+Asts,32,28,28,8
22023,1628368,22300449,"DEC 31, 2023",SAC @ MEM,W,34,9,23,0.391,3,8,0.375,3,5,0.6,1,3,4,4,0,1,1,3,24,20,1,De'Aaron Fox,SAC,MEM,SAC,5.0,Assists,32,28,28,8
22023,1628368,22300449,"DEC 31, 2023",SAC @ MEM,W,34,9,23,0.391,3,8,0.375,3,5,0.6,1,3,4,4,0,1,1,3,24,20,1,De'Aaron Fox,SAC,MEM,SAC,41.5,Fantasy Score,32,28,28,8
22023,1628368,22300449,"DEC 31, 2023",SAC @ MEM,W,34,9,23,0.391,3,8,0.375,3,5,0.6,1,3,4,4,0,1,1,3,24,20,1,De'Aaron Fox,SAC,MEM,SAC,0.5,Offensive Rebounds,32,28,28,8
22023,1628368,22300449,"DEC 31, 2023",SAC @ MEM,W,34,9,23,0.391,3,8,0.375,3,5,0.6,1,3,4,4,0,1,1,3,24,20,1,De'Aaron Fox,SAC,MEM,SAC,7.5,3-PT Attempted,32,28,28,8
22023,1628368,22300449,"DEC 31, 2023",SAC @ MEM,W,34,9,23,0.391,3,8,0.375,3,5,0.6,1,3,4,4,0,1,1,3,24,20,1,De'Aaron Fox,SAC,MEM,SAC,4.5,Free Throws Made,32,28,28,8
22023,1628368,22300449,"DEC 31, 2023",SAC @ MEM,W,34,9,23,0.391,3,8,0.375,3,5,0.6,1,3,4,4,0,1,1,3,24,20,1,De'Aaron Fox,SAC,MEM,SAC,21.5,FG Attempted,32,28,28,8
22023,1628368,22300449,"DEC 31, 2023",SAC @ MEM,W,34,9,23,0.391,3,8,0.375,3,5,0.6,1,3,4,4,0,1,1,3,24,20,1,De'Aaron Fox,SAC,MEM,SAC,31.5,Pts+Rebs,32,28,28,8
22023,1628368,22300449,"DEC 31, 2023",SAC @ MEM,W,34,9,23,0.391,3,8,0.375,3,5,0.6,1,3,4,4,0,1,1,3,24,20,1,De'Aaron Fox,SAC,MEM,SAC,32.5,Pts+Asts,32,28,28,8
22023,1628368,22300449,"DEC 31, 2023",SAC @ MEM,W,34,9,23,0.391,3,8,0.375,3,5,0.6,1,3,4,4,0,1,1,3,24,20,1,De'Aaron Fox,SAC,MEM,SAC,9.0,Rebs+Asts,32,28,28,8
22023,1628368,22300431,"DEC 29, 2023",SAC @ ATL,W,41,10,20,0.5,8,16,0.5,3,7,0.429,1,4,5,8,5,0,3,3,31,9,1,De'Aaron Fox,SAC,ATL,SAC,27.5,Points,44,36,39,13
22023,1628368,22300431,"DEC 29, 2023",SAC @ ATL,W,41,10,20,0.5,8,16,0.5,3,7,0.429,1,4,5,8,5,0,3,3,31,9,1,De'Aaron Fox,SAC,ATL,SAC,37.0,Pts+Rebs+Asts,44,36,39,13
22023,1628368,22300431,"DEC 29, 2023",SAC @ ATL,W,41,10,20,0.5,8,16,0.5,3,7,0.429,1,4,5,8,5,0,3,3,31,9,1,De'Aaron Fox,SAC,ATL,SAC,5.0,Assists,44,36,39,13
22023,1628368,22300431,"DEC 29, 2023",SAC @ ATL,W,41,10,20,0.5,8,16,0.5,3,7,0.429,1,4,5,8,5,0,3,3,31,9,1,De'Aaron Fox,SAC,ATL,SAC,41.5,Fantasy Score,44,36,39,13
22023,1628368,22300431,"DEC 29, 2023",SAC @ ATL,W,41,10,20,0.5,8,16,0.5,3,7,0.429,1,4,5,8,5,0,3,3,31,9,1,De'Aaron Fox,SAC,ATL,SAC,0.5,Offensive Rebounds,44,36,39,13
22023,1628368,22300431,"DEC 29, 2023",SAC @ ATL,W,41,10,20,0.5,8,16,0.5,3,7,0.429,1,4,5,8,5,0,3,3,31,9,1,De'Aaron Fox,SAC,ATL,SAC,7.5,3-PT Attempted,44,36,39,13
22023,1628368,22300431,"DEC 29, 2023",SAC @ ATL,W,41,10,20,0.5,8,16,0.5,3,7,0.429,1,4,5,8,5,0,3,3,31,9,1,De'Aaron Fox,SAC,ATL,SAC,4.5,Free Throws Made,44,36,39,13
22023,1628368,22300431,"DEC 29, 2023",SAC @ ATL,W,41,10,20,0.5,8,16,0.5,3,7,0.429,1,4,5,8,5,0,3,3,31,9,1,De'Aaron Fox,SAC,ATL,SAC,21.5,FG Attempted,44,36,39,13
22023,1628368,22300431,"DEC 29, 2023",SAC @ ATL,W,41,10,20,0.5,8,16,0.5,3,7,0.429,1,4,5,8,5,0,3,3,31,9,1,De'Aaron Fox,SAC,ATL,SAC,31.5,Pts+Rebs,44,36,39,13
22023,1628368,22300431,"DEC 29, 2023",SAC @ ATL,W,41,10,20,0.5,8,16,0.5,3,7,0.429,1,4,5,8,5,0,3,3,31,9,1,De'Aaron Fox,SAC,ATL,SAC,32.5,Pts+Asts,44,36,39,13
22023,1628368,22300431,"DEC 29, 2023",SAC @ ATL,W,41,10,20,0.5,8,16,0.5,3,7,0.429,1,4,5,8,5,0,3,3,31,9,1,De'Aaron Fox,SAC,ATL,SAC,9.0,Rebs+Asts,44,36,39,13
22023,1628368,22300413,"DEC 26, 2023",SAC @ POR,L,38,16,26,0.615,7,15,0.467,4,6,0.667,2,6,8,4,1,1,5,2,43,-2,1,De'Aaron Fox,SAC,POR,SAC,27.5,Points,55,51,47,12
22023,1628368,22300413,"DEC 26, 2023",SAC @ POR,L,38,16,26,0.615,7,15,0.467,4,6,0.667,2,6,8,4,1,1,5,2,43,-2,1,De'Aaron Fox,SAC,POR,SAC,37.0,Pts+Rebs+Asts,55,51,47,12
22023,1628368,22300413,"DEC 26, 2023",SAC @ POR,L,38,16,26,0.615,7,15,0.467,4,6,0.667,2,6,8,4,1,1,5,2,43,-2,1,De'Aaron Fox,SAC,POR,SAC,5.0,Assists,55,51,47,12
22023,1628368,22300413,"DEC 26, 2023",SAC @ POR,L,38,16,26,0.615,7,15,0.467,4,6,0.667,2,6,8,4,1,1,5,2,43,-2,1,De'Aaron Fox,SAC,POR,SAC,41.5,Fantasy Score,55,51,47,12
22023,1628368,22300413,"DEC 26, 2023",SAC @ POR,L,38,16,26,0.615,7,15,0.467,4,6,0.667,2,6,8,4,1,1,5,2,43,-2,1,De'Aaron Fox,SAC,POR,SAC,0.5,Offensive Rebounds,55,51,47,12
22023,1628368,22300413,"DEC 26, 2023",SAC @ POR,L,38,16,26,0.615,7,15,0.467,4,6,0.667,2,6,8,4,1,1,5,2,43,-2,1,De'Aaron Fox,SAC,POR,SAC,7.5,3-PT Attempted,55,51,47,12
22023,1628368,22300413,"DEC 26, 2023",SAC @ POR,L,38,16,26,0.615,7,15,0.467,4,6,0.667,2,6,8,4,1,1,5,2,43,-2,1,De'Aaron Fox,SAC,POR,SAC,4.5,Free Throws Made,55,51,47,12
22023,1628368,22300413,"DEC 26, 2023",SAC @ POR,L,38,16,26,0.615,7,15,0.467,4,6,0.667,2,6,8,4,1,1,5,2,43,-2,1,De'Aaron Fox,SAC,POR,SAC,21.5,FG Attempted,55,51,47,12
22023,1628368,22300413,"DEC 26, 2023",SAC @ POR,L,38,16,26,0.615,7,15,0.467,4,6,0.667,2,6,8,4,1,1,5,2,43,-2,1,De'Aaron Fox,SAC,POR,SAC,31.5,Pts+Rebs,55,51,47,12
22023,1628368,22300413,"DEC 26, 2023",SAC @ POR,L,38,16,26,0.615,7,15,0.467,4,6,0.667,2,6,8,4,1,1,5,2,43,-2,1,De'Aaron Fox,SAC,POR,SAC,32.5,Pts+Asts,55,51,47,12
22023,1628368,22300413,"DEC 26, 2023",SAC @ POR,L,38,16,26,0.615,7,15,0.467,4,6,0.667,2,6,8,4,1,1,5,2,43,-2,1,De'Aaron Fox,SAC,POR,SAC,9.0,Rebs+Asts,55,51,47,12
22023,1628368,22300400,"DEC 23, 2023",SAC vs. MIN,L,39,10,23,0.435,3,11,0.273,4,4,1.0,2,2,4,6,2,0,3,1,27,-4,1,De'Aaron Fox,SAC,SAC,MIN,27.5,Points,37,31,33,10
22023,1628368,22300400,"DEC 23, 2023",SAC vs. MIN,L,39,10,23,0.435,3,11,0.273,4,4,1.0,2,2,4,6,2,0,3,1,27,-4,1,De'Aaron Fox,SAC,SAC,MIN,37.0,Pts+Rebs+Asts,37,31,33,10
22023,1628368,22300400,"DEC 23, 2023",SAC vs. MIN,L,39,10,23,0.435,3,11,0.273,4,4,1.0,2,2,4,6,2,0,3,1,27,-4,1,De'Aaron Fox,SAC,SAC,MIN,5.0,Assists,37,31,33,10
22023,1628368,22300400,"DEC 23, 2023",SAC vs. MIN,L,39,10,23,0.435,3,11,0.273,4,4,1.0,2,2,4,6,2,0,3,1,27,-4,1,De'Aaron Fox,SAC,SAC,MIN,41.5,Fantasy Score,37,31,33,10
22023,1628368,22300400,"DEC 23, 2023",SAC vs. MIN,L,39,10,23,0.435,3,11,0.273,4,4,1.0,2,2,4,6,2,0,3,1,27,-4,1,De'Aaron Fox,SAC,SAC,MIN,0.5,Offensive Rebounds,37,31,33,10
22023,1628368,22300400,"DEC 23, 2023",SAC vs. MIN,L,39,10,23,0.435,3,11,0.273,4,4,1.0,2,2,4,6,2,0,3,1,27,-4,1,De'Aaron Fox,SAC,SAC,MIN,7.5,3-PT Attempted,37,31,33,10
22023,1628368,22300400,"DEC 23, 2023",SAC vs. MIN,L,39,10,23,0.435,3,11,0.273,4,4,1.0,2,2,4,6,2,0,3,1,27,-4,1,De'Aaron Fox,SAC,SAC,MIN,4.5,Free Throws Made,37,31,33,10
22023,1628368,22300400,"DEC 23, 2023",SAC vs. MIN,L,39,10,23,0.435,3,11,0.273,4,4,1.0,2,2,4,6,2,0,3,1,27,-4,1,De'Aaron Fox,SAC,SAC,MIN,21.5,FG Attempted,37,31,33,10
22023,1628368,22300400,"DEC 23, 2023",SAC vs. MIN,L,39,10,23,0.435,3,11,0.273,4,4,1.0,2,2,4,6,2,0,3,1,27,-4,1,De'Aaron Fox,SAC,SAC,MIN,31.5,Pts+Rebs,37,31,33,10
22023,1628368,22300400,"DEC 23, 2023",SAC vs. MIN,L,39,10,23,0.435,3,11,0.273,4,4,1.0,2,2,4,6,2,0,3,1,27,-4,1,De'Aaron Fox,SAC,SAC,MIN,32.5,Pts+Asts,37,31,33,10
22023,1628368,22300400,"DEC 23, 2023",SAC vs. MIN,L,39,10,23,0.435,3,11,0.273,4,4,1.0,2,2,4,6,2,0,3,1,27,-4,1,De'Aaron Fox,SAC,SAC,MIN,9.0,Rebs+Asts,37,31,33,10
22023,1628368,22300387,"DEC 22, 2023",SAC vs. PHX,W,32,9,17,0.529,2,6,0.333,3,4,0.75,0,6,6,7,3,2,2,2,23,21,1,De'Aaron Fox,SAC,SAC,PHX,27.5,Points,36,29,30,13
22023,1628368,22300387,"DEC 22, 2023",SAC vs. PHX,W,32,9,17,0.529,2,6,0.333,3,4,0.75,0,6,6,7,3,2,2,2,23,21,1,De'Aaron Fox,SAC,SAC,PHX,37.0,Pts+Rebs+Asts,36,29,30,13
22023,1628368,22300387,"DEC 22, 2023",SAC vs. PHX,W,32,9,17,0.529,2,6,0.333,3,4,0.75,0,6,6,7,3,2,2,2,23,21,1,De'Aaron Fox,SAC,SAC,PHX,5.0,Assists,36,29,30,13
22023,1628368,22300387,"DEC 22, 2023",SAC vs. PHX,W,32,9,17,0.529,2,6,0.333,3,4,0.75,0,6,6,7,3,2,2,2,23,21,1,De'Aaron Fox,SAC,SAC,PHX,41.5,Fantasy Score,36,29,30,13
22023,1628368,22300387,"DEC 22, 2023",SAC vs. PHX,W,32,9,17,0.529,2,6,0.333,3,4,0.75,0,6,6,7,3,2,2,2,23,21,1,De'Aaron Fox,SAC,SAC,PHX,0.5,Offensive Rebounds,36,29,30,13
22023,1628368,22300387,"DEC 22, 2023",SAC vs. PHX,W,32,9,17,0.529,2,6,0.333,3,4,0.75,0,6,6,7,3,2,2,2,23,21,1,De'Aaron Fox,SAC,SAC,PHX,7.5,3-PT Attempted,36,29,30,13
22023,1628368,22300387,"DEC 22, 2023",SAC vs. PHX,W,32,9,17,0.529,2,6,0.333,3,4,0.75,0,6,6,7,3,2,2,2,23,21,1,De'Aaron Fox,SAC,SAC,PHX,4.5,Free Throws Made,36,29,30,13
22023,1628368,22300387,"DEC 22, 2023",SAC vs. PHX,W,32,9,17,0.529,2,6,0.333,3,4,0.75,0,6,6,7,3,2,2,2,23,21,1,De'Aaron Fox,SAC,SAC,PHX,21.5,FG Attempted,36,29,30,13
22023,1628368,22300387,"DEC 22, 2023",SAC vs. PHX,W,32,9,17,0.529,2,6,0.333,3,4,0.75,0,6,6,7,3,2,2,2,23,21,1,De'Aaron Fox,SAC,SAC,PHX,31.5,Pts+Rebs,36,29,30,13
22023,1628368,22300387,"DEC 22, 2023",SAC vs. PHX,W,32,9,17,0.529,2,6,0.333,3,4,0.75,0,6,6,7,3,2,2,2,23,21,1,De'Aaron Fox,SAC,SAC,PHX,32.5,Pts+Asts,36,29,30,13
22023,1628368,22300387,"DEC 22, 2023",SAC vs. PHX,W,32,9,17,0.529,2,6,0.333,3,4,0.75,0,6,6,7,3,2,2,2,23,21,1,De'Aaron Fox,SAC,SAC,PHX,9.0,Rebs+Asts,36,29,30,13
22023,1628368,22300373,"DEC 20, 2023",SAC vs. BOS,L,26,9,16,0.563,6,8,0.75,5,6,0.833,2,1,3,3,3,0,3,4,29,-19,1,De'Aaron Fox,SAC,SAC,BOS,27.5,Points,35,32,32,6
22023,1628368,22300373,"DEC 20, 2023",SAC vs. BOS,L,26,9,16,0.563,6,8,0.75,5,6,0.833,2,1,3,3,3,0,3,4,29,-19,1,De'Aaron Fox,SAC,SAC,BOS,37.0,Pts+Rebs+Asts,35,32,32,6
22023,1628368,22300373,"DEC 20, 2023",SAC vs. BOS,L,26,9,16,0.563,6,8,0.75,5,6,0.833,2,1,3,3,3,0,3,4,29,-19,1,De'Aaron Fox,SAC,SAC,BOS,5.0,Assists,35,32,32,6
22023,1628368,22300373,"DEC 20, 2023",SAC vs. BOS,L,26,9,16,0.563,6,8,0.75,5,6,0.833,2,1,3,3,3,0,3,4,29,-19,1,De'Aaron Fox,SAC,SAC,BOS,41.5,Fantasy Score,35,32,32,6
22023,1628368,22300373,"DEC 20, 2023",SAC vs. BOS,L,26,9,16,0.563,6,8,0.75,5,6,0.833,2,1,3,3,3,0,3,4,29,-19,1,De'Aaron Fox,SAC,SAC,BOS,0.5,Offensive Rebounds,35,32,32,6
22023,1628368,22300373,"DEC 20, 2023",SAC vs. BOS,L,26,9,16,0.563,6,8,0.75,5,6,0.833,2,1,3,3,3,0,3,4,29,-19,1,De'Aaron Fox,SAC,SAC,BOS,7.5,3-PT Attempted,35,32,32,6
22023,1628368,22300373,"DEC 20, 2023",SAC vs. BOS,L,26,9,16,0.563,6,8,0.75,5,6,0.833,2,1,3,3,3,0,3,4,29,-19,1,De'Aaron Fox,SAC,SAC,BOS,4.5,Free Throws Made,35,32,32,6
22023,1628368,22300373,"DEC 20, 2023",SAC vs. BOS,L,26,9,16,0.563,6,8,0.75,5,6,0.833,2,1,3,3,3,0,3,4,29,-19,1,De'Aaron Fox,SAC,SAC,BOS,21.5,FG Attempted,35,32,32,6
22023,1628368,22300373,"DEC 20, 2023",SAC vs. BOS,L,26,9,16,0.563,6,8,0.75,5,6,0.833,2,1,3,3,3,0,3,4,29,-19,1,De'Aaron Fox,SAC,SAC,BOS,31.5,Pts+Rebs,35,32,32,6
22023,1628368,22300373,"DEC 20, 2023",SAC vs. BOS,L,26,9,16,0.563,6,8,0.75,5,6,0.833,2,1,3,3,3,0,3,4,29,-19,1,De'Aaron Fox,SAC,SAC,BOS,32.5,Pts+Asts,35,32,32,6
22023,1628368,22300373,"DEC 20, 2023",SAC vs. BOS,L,26,9,16,0.563,6,8,0.75,5,6,0.833,2,1,3,3,3,0,3,4,29,-19,1,De'Aaron Fox,SAC,SAC,BOS,9.0,Rebs+Asts,35,32,32,6
22023,1628368,22300358,"DEC 18, 2023",SAC vs. WAS,W,33,10,19,0.526,2,7,0.286,8,12,0.667,0,5,5,6,3,1,1,2,30,20,1,De'Aaron Fox,SAC,SAC,WAS,27.5,Points,41,35,36,11
22023,1628368,22300358,"DEC 18, 2023",SAC vs. WAS,W,33,10,19,0.526,2,7,0.286,8,12,0.667,0,5,5,6,3,1,1,2,30,20,1,De'Aaron Fox,SAC,SAC,WAS,37.0,Pts+Rebs+Asts,41,35,36,11
22023,1628368,22300358,"DEC 18, 2023",SAC vs. WAS,W,33,10,19,0.526,2,7,0.286,8,12,0.667,0,5,5,6,3,1,1,2,30,20,1,De'Aaron Fox,SAC,SAC,WAS,5.0,Assists,41,35,36,11
22023,1628368,22300358,"DEC 18, 2023",SAC vs. WAS,W,33,10,19,0.526,2,7,0.286,8,12,0.667,0,5,5,6,3,1,1,2,30,20,1,De'Aaron Fox,SAC,SAC,WAS,41.5,Fantasy Score,41,35,36,11
22023,1628368,22300358,"DEC 18, 2023",SAC vs. WAS,W,33,10,19,0.526,2,7,0.286,8,12,0.667,0,5,5,6,3,1,1,2,30,20,1,De'Aaron Fox,SAC,SAC,WAS,0.5,Offensive Rebounds,41,35,36,11
22023,1628368,22300358,"DEC 18, 2023",SAC vs. WAS,W,33,10,19,0.526,2,7,0.286,8,12,0.667,0,5,5,6,3,1,1,2,30,20,1,De'Aaron Fox,SAC,SAC,WAS,7.5,3-PT Attempted,41,35,36,11
22023,1628368,22300358,"DEC 18, 2023",SAC vs. WAS,W,33,10,19,0.526,2,7,0.286,8,12,0.667,0,5,5,6,3,1,1,2,30,20,1,De'Aaron Fox,SAC,SAC,WAS,4.5,Free Throws Made,41,35,36,11
22023,1628368,22300358,"DEC 18, 2023",SAC vs. WAS,W,33,10,19,0.526,2,7,0.286,8,12,0.667,0,5,5,6,3,1,1,2,30,20,1,De'Aaron Fox,SAC,SAC,WAS,21.5,FG Attempted,41,35,36,11
22023,1628368,22300358,"DEC 18, 2023",SAC vs. WAS,W,33,10,19,0.526,2,7,0.286,8,12,0.667,0,5,5,6,3,1,1,2,30,20,1,De'Aaron Fox,SAC,SAC,WAS,31.5,Pts+Rebs,41,35,36,11
22023,1628368,22300358,"DEC 18, 2023",SAC vs. WAS,W,33,10,19,0.526,2,7,0.286,8,12,0.667,0,5,5,6,3,1,1,2,30,20,1,De'Aaron Fox,SAC,SAC,WAS,32.5,Pts+Asts,41,35,36,11
22023,1628368,22300358,"DEC 18, 2023",SAC vs. WAS,W,33,10,19,0.526,2,7,0.286,8,12,0.667,0,5,5,6,3,1,1,2,30,20,1,De'Aaron Fox,SAC,SAC,WAS,9.0,Rebs+Asts,41,35,36,11
22023,1628368,22300324,"DEC 14, 2023",SAC vs. OKC,W,34,14,25,0.56,5,11,0.455,8,11,0.727,0,3,3,7,2,0,5,3,41,3,1,De'Aaron Fox,SAC,SAC,OKC,27.5,Points,51,44,48,10
22023,1628368,22300324,"DEC 14, 2023",SAC vs. OKC,W,34,14,25,0.56,5,11,0.455,8,11,0.727,0,3,3,7,2,0,5,3,41,3,1,De'Aaron Fox,SAC,SAC,OKC,37.0,Pts+Rebs+Asts,51,44,48,10
22023,1628368,22300324,"DEC 14, 2023",SAC vs. OKC,W,34,14,25,0.56,5,11,0.455,8,11,0.727,0,3,3,7,2,0,5,3,41,3,1,De'Aaron Fox,SAC,SAC,OKC,5.0,Assists,51,44,48,10
22023,1628368,22300324,"DEC 14, 2023",SAC vs. OKC,W,34,14,25,0.56,5,11,0.455,8,11,0.727,0,3,3,7,2,0,5,3,41,3,1,De'Aaron Fox,SAC,SAC,OKC,41.5,Fantasy Score,51,44,48,10
22023,1628368,22300324,"DEC 14, 2023",SAC vs. OKC,W,34,14,25,0.56,5,11,0.455,8,11,0.727,0,3,3,7,2,0,5,3,41,3,1,De'Aaron Fox,SAC,SAC,OKC,0.5,Offensive Rebounds,51,44,48,10
22023,1628368,22300324,"DEC 14, 2023",SAC vs. OKC,W,34,14,25,0.56,5,11,0.455,8,11,0.727,0,3,3,7,2,0,5,3,41,3,1,De'Aaron Fox,SAC,SAC,OKC,7.5,3-PT Attempted,51,44,48,10
22023,1628368,22300324,"DEC 14, 2023",SAC vs. OKC,W,34,14,25,0.56,5,11,0.455,8,11,0.727,0,3,3,7,2,0,5,3,41,3,1,De'Aaron Fox,SAC,SAC,OKC,4.5,Free Throws Made,51,44,48,10
22023,1628368,22300324,"DEC 14, 2023",SAC vs. OKC,W,34,14,25,0.56,5,11,0.455,8,11,0.727,0,3,3,7,2,0,5,3,41,3,1,De'Aaron Fox,SAC,SAC,OKC,21.5,FG Attempted,51,44,48,10
22023,1628368,22300324,"DEC 14, 2023",SAC vs. OKC,W,34,14,25,0.56,5,11,0.455,8,11,0.727,0,3,3,7,2,0,5,3,41,3,1,De'Aaron Fox,SAC,SAC,OKC,31.5,Pts+Rebs,51,44,48,10
22023,1628368,22300324,"DEC 14, 2023",SAC vs. OKC,W,34,14,25,0.56,5,11,0.455,8,11,0.727,0,3,3,7,2,0,5,3,41,3,1,De'Aaron Fox,SAC,SAC,OKC,32.5,Pts+Asts,51,44,48,10
22023,1628368,22300324,"DEC 14, 2023",SAC vs. OKC,W,34,14,25,0.56,5,11,0.455,8,11,0.727,0,3,3,7,2,0,5,3,41,3,1,De'Aaron Fox,SAC,SAC,OKC,9.0,Rebs+Asts,51,44,48,10
22023,1628368,22300309,"DEC 12, 2023",SAC @ LAC,L,25,5,16,0.313,3,7,0.429,1,1,1.0,0,3,3,3,0,0,4,3,14,-14,1,De'Aaron Fox,SAC,LAC,SAC,27.5,Points,20,17,17,6
22023,1628368,22300309,"DEC 12, 2023",SAC @ LAC,L,25,5,16,0.313,3,7,0.429,1,1,1.0,0,3,3,3,0,0,4,3,14,-14,1,De'Aaron Fox,SAC,LAC,SAC,37.0,Pts+Rebs+Asts,20,17,17,6
22023,1628368,22300309,"DEC 12, 2023",SAC @ LAC,L,25,5,16,0.313,3,7,0.429,1,1,1.0,0,3,3,3,0,0,4,3,14,-14,1,De'Aaron Fox,SAC,LAC,SAC,5.0,Assists,20,17,17,6
22023,1628368,22300309,"DEC 12, 2023",SAC @ LAC,L,25,5,16,0.313,3,7,0.429,1,1,1.0,0,3,3,3,0,0,4,3,14,-14,1,De'Aaron Fox,SAC,LAC,SAC,41.5,Fantasy Score,20,17,17,6
22023,1628368,22300309,"DEC 12, 2023",SAC @ LAC,L,25,5,16,0.313,3,7,0.429,1,1,1.0,0,3,3,3,0,0,4,3,14,-14,1,De'Aaron Fox,SAC,LAC,SAC,0.5,Offensive Rebounds,20,17,17,6
22023,1628368,22300309,"DEC 12, 2023",SAC @ LAC,L,25,5,16,0.313,3,7,0.429,1,1,1.0,0,3,3,3,0,0,4,3,14,-14,1,De'Aaron Fox,SAC,LAC,SAC,7.5,3-PT Attempted,20,17,17,6
22023,1628368,22300309,"DEC 12, 2023",SAC @ LAC,L,25,5,16,0.313,3,7,0.429,1,1,1.0,0,3,3,3,0,0,4,3,14,-14,1,De'Aaron Fox,SAC,LAC,SAC,4.5,Free Throws Made,20,17,17,6
22023,1628368,22300309,"DEC 12, 2023",SAC @ LAC,L,25,5,16,0.313,3,7,0.429,1,1,1.0,0,3,3,3,0,0,4,3,14,-14,1,De'Aaron Fox,SAC,LAC,SAC,21.5,FG Attempted,20,17,17,6
22023,1628368,22300309,"DEC 12, 2023",SAC @ LAC,L,25,5,16,0.313,3,7,0.429,1,1,1.0,0,3,3,3,0,0,4,3,14,-14,1,De'Aaron Fox,SAC,LAC,SAC,31.5,Pts+Rebs,20,17,17,6
22023,1628368,22300309,"DEC 12, 2023",SAC @ LAC,L,25,5,16,0.313,3,7,0.429,1,1,1.0,0,3,3,3,0,0,4,3,14,-14,1,De'Aaron Fox,SAC,LAC,SAC,32.5,Pts+Asts,20,17,17,6
22023,1628368,22300309,"DEC 12, 2023",SAC @ LAC,L,25,5,16,0.313,3,7,0.429,1,1,1.0,0,3,3,3,0,0,4,3,14,-14,1,De'Aaron Fox,SAC,LAC,SAC,9.0,Rebs+Asts,20,17,17,6
22023,1628368,22300303,"DEC 11, 2023",SAC vs. BKN,W,33,10,22,0.455,5,10,0.5,4,6,0.667,0,3,3,8,0,0,3,4,29,31,1,De'Aaron Fox,SAC,SAC,BKN,27.5,Points,40,32,37,11
22023,1628368,22300303,"DEC 11, 2023",SAC vs. BKN,W,33,10,22,0.455,5,10,0.5,4,6,0.667,0,3,3,8,0,0,3,4,29,31,1,De'Aaron Fox,SAC,SAC,BKN,37.0,Pts+Rebs+Asts,40,32,37,11
22023,1628368,22300303,"DEC 11, 2023",SAC vs. BKN,W,33,10,22,0.455,5,10,0.5,4,6,0.667,0,3,3,8,0,0,3,4,29,31,1,De'Aaron Fox,SAC,SAC,BKN,5.0,Assists,40,32,37,11
22023,1628368,22300303,"DEC 11, 2023",SAC vs. BKN,W,33,10,22,0.455,5,10,0.5,4,6,0.667,0,3,3,8,0,0,3,4,29,31,1,De'Aaron Fox,SAC,SAC,BKN,41.5,Fantasy Score,40,32,37,11
22023,1628368,22300303,"DEC 11, 2023",SAC vs. BKN,W,33,10,22,0.455,5,10,0.5,4,6,0.667,0,3,3,8,0,0,3,4,29,31,1,De'Aaron Fox,SAC,SAC,BKN,0.5,Offensive Rebounds,40,32,37,11
22023,1628368,22300303,"DEC 11, 2023",SAC vs. BKN,W,33,10,22,0.455,5,10,0.5,4,6,0.667,0,3,3,8,0,0,3,4,29,31,1,De'Aaron Fox,SAC,SAC,BKN,7.5,3-PT Attempted,40,32,37,11
22023,1628368,22300303,"DEC 11, 2023",SAC vs. BKN,W,33,10,22,0.455,5,10,0.5,4,6,0.667,0,3,3,8,0,0,3,4,29,31,1,De'Aaron Fox,SAC,SAC,BKN,4.5,Free Throws Made,40,32,37,11
22023,1628368,22300303,"DEC 11, 2023",SAC vs. BKN,W,33,10,22,0.455,5,10,0.5,4,6,0.667,0,3,3,8,0,0,3,4,29,31,1,De'Aaron Fox,SAC,SAC,BKN,21.5,FG Attempted,40,32,37,11
22023,1628368,22300303,"DEC 11, 2023",SAC vs. BKN,W,33,10,22,0.455,5,10,0.5,4,6,0.667,0,3,3,8,0,0,3,4,29,31,1,De'Aaron Fox,SAC,SAC,BKN,31.5,Pts+Rebs,40,32,37,11
22023,1628368,22300303,"DEC 11, 2023",SAC vs. BKN,W,33,10,22,0.455,5,10,0.5,4,6,0.667,0,3,3,8,0,0,3,4,29,31,1,De'Aaron Fox,SAC,SAC,BKN,32.5,Pts+Asts,40,32,37,11
22023,1628368,22300303,"DEC 11, 2023",SAC vs. BKN,W,33,10,22,0.455,5,10,0.5,4,6,0.667,0,3,3,8,0,0,3,4,29,31,1,De'Aaron Fox,SAC,SAC,BKN,9.0,Rebs+Asts,40,32,37,11
22023,1628368,22301228,"DEC 08, 2023",SAC @ PHX,W,35,11,24,0.458,4,7,0.571,8,10,0.8,2,2,4,7,1,0,2,0,34,3,1,De'Aaron Fox,SAC,PHX,SAC,27.5,Points,45,38,41,11
22023,1628368,22301228,"DEC 08, 2023",SAC @ PHX,W,35,11,24,0.458,4,7,0.571,8,10,0.8,2,2,4,7,1,0,2,0,34,3,1,De'Aaron Fox,SAC,PHX,SAC,37.0,Pts+Rebs+Asts,45,38,41,11
22023,1628368,22301228,"DEC 08, 2023",SAC @ PHX,W,35,11,24,0.458,4,7,0.571,8,10,0.8,2,2,4,7,1,0,2,0,34,3,1,De'Aaron Fox,SAC,PHX,SAC,5.0,Assists,45,38,41,11
22023,1628368,22301228,"DEC 08, 2023",SAC @ PHX,W,35,11,24,0.458,4,7,0.571,8,10,0.8,2,2,4,7,1,0,2,0,34,3,1,De'Aaron Fox,SAC,PHX,SAC,41.5,Fantasy Score,45,38,41,11
22023,1628368,22301228,"DEC 08, 2023",SAC @ PHX,W,35,11,24,0.458,4,7,0.571,8,10,0.8,2,2,4,7,1,0,2,0,34,3,1,De'Aaron Fox,SAC,PHX,SAC,0.5,Offensive Rebounds,45,38,41,11
22023,1628368,22301228,"DEC 08, 2023",SAC @ PHX,W,35,11,24,0.458,4,7,0.571,8,10,0.8,2,2,4,7,1,0,2,0,34,3,1,De'Aaron Fox,SAC,PHX,SAC,7.5,3-PT Attempted,45,38,41,11
22023,1628368,22301228,"DEC 08, 2023",SAC @ PHX,W,35,11,24,0.458,4,7,0.571,8,10,0.8,2,2,4,7,1,0,2,0,34,3,1,De'Aaron Fox,SAC,PHX,SAC,4.5,Free Throws Made,45,38,41,11
22023,1628368,22301228,"DEC 08, 2023",SAC @ PHX,W,35,11,24,0.458,4,7,0.571,8,10,0.8,2,2,4,7,1,0,2,0,34,3,1,De'Aaron Fox,SAC,PHX,SAC,21.5,FG Attempted,45,38,41,11
22023,1628368,22301228,"DEC 08, 2023",SAC @ PHX,W,35,11,24,0.458,4,7,0.571,8,10,0.8,2,2,4,7,1,0,2,0,34,3,1,De'Aaron Fox,SAC,PHX,SAC,31.5,Pts+Rebs,45,38,41,11
22023,1628368,22301228,"DEC 08, 2023",SAC @ PHX,W,35,11,24,0.458,4,7,0.571,8,10,0.8,2,2,4,7,1,0,2,0,34,3,1,De'Aaron Fox,SAC,PHX,SAC,32.5,Pts+Asts,45,38,41,11
22023,1628368,22301228,"DEC 08, 2023",SAC @ PHX,W,35,11,24,0.458,4,7,0.571,8,10,0.8,2,2,4,7,1,0,2,0,34,3,1,De'Aaron Fox,SAC,PHX,SAC,9.0,Rebs+Asts,45,38,41,11
22023,1628368,22301204,"DEC 04, 2023",SAC vs. NOP,L,40,10,25,0.4,1,7,0.143,9,13,0.692,1,4,5,4,1,0,6,3,30,-9,1,De'Aaron Fox,SAC,SAC,NOP,27.5,Points,39,35,34,9
22023,1628368,22301204,"DEC 04, 2023",SAC vs. NOP,L,40,10,25,0.4,1,7,0.143,9,13,0.692,1,4,5,4,1,0,6,3,30,-9,1,De'Aaron Fox,SAC,SAC,NOP,37.0,Pts+Rebs+Asts,39,35,34,9
22023,1628368,22301204,"DEC 04, 2023",SAC vs. NOP,L,40,10,25,0.4,1,7,0.143,9,13,0.692,1,4,5,4,1,0,6,3,30,-9,1,De'Aaron Fox,SAC,SAC,NOP,5.0,Assists,39,35,34,9
22023,1628368,22301204,"DEC 04, 2023",SAC vs. NOP,L,40,10,25,0.4,1,7,0.143,9,13,0.692,1,4,5,4,1,0,6,3,30,-9,1,De'Aaron Fox,SAC,SAC,NOP,41.5,Fantasy Score,39,35,34,9
22023,1628368,22301204,"DEC 04, 2023",SAC vs. NOP,L,40,10,25,0.4,1,7,0.143,9,13,0.692,1,4,5,4,1,0,6,3,30,-9,1,De'Aaron Fox,SAC,SAC,NOP,0.5,Offensive Rebounds,39,35,34,9
22023,1628368,22301204,"DEC 04, 2023",SAC vs. NOP,L,40,10,25,0.4,1,7,0.143,9,13,0.692,1,4,5,4,1,0,6,3,30,-9,1,De'Aaron Fox,SAC,SAC,NOP,7.5,3-PT Attempted,39,35,34,9
22023,1628368,22301204,"DEC 04, 2023",SAC vs. NOP,L,40,10,25,0.4,1,7,0.143,9,13,0.692,1,4,5,4,1,0,6,3,30,-9,1,De'Aaron Fox,SAC,SAC,NOP,4.5,Free Throws Made,39,35,34,9
22023,1628368,22301204,"DEC 04, 2023",SAC vs. NOP,L,40,10,25,0.4,1,7,0.143,9,13,0.692,1,4,5,4,1,0,6,3,30,-9,1,De'Aaron Fox,SAC,SAC,NOP,21.5,FG Attempted,39,35,34,9
22023,1628368,22301204,"DEC 04, 2023",SAC vs. NOP,L,40,10,25,0.4,1,7,0.143,9,13,0.692,1,4,5,4,1,0,6,3,30,-9,1,De'Aaron Fox,SAC,SAC,NOP,31.5,Pts+Rebs,39,35,34,9
22023,1628368,22301204,"DEC 04, 2023",SAC vs. NOP,L,40,10,25,0.4,1,7,0.143,9,13,0.692,1,4,5,4,1,0,6,3,30,-9,1,De'Aaron Fox,SAC,SAC,NOP,32.5,Pts+Asts,39,35,34,9
22023,1628368,22301204,"DEC 04, 2023",SAC vs. NOP,L,40,10,25,0.4,1,7,0.143,9,13,0.692,1,4,5,4,1,0,6,3,30,-9,1,De'Aaron Fox,SAC,SAC,NOP,9.0,Rebs+Asts,39,35,34,9
22023,1628368,22300290,"DEC 02, 2023",SAC vs. DEN,W,38,10,22,0.455,3,6,0.5,3,4,0.75,1,3,4,16,3,1,1,1,26,22,1,De'Aaron Fox,SAC,SAC,DEN,27.5,Points,46,30,42,20
22023,1628368,22300290,"DEC 02, 2023",SAC vs. DEN,W,38,10,22,0.455,3,6,0.5,3,4,0.75,1,3,4,16,3,1,1,1,26,22,1,De'Aaron Fox,SAC,SAC,DEN,37.0,Pts+Rebs+Asts,46,30,42,20
22023,1628368,22300290,"DEC 02, 2023",SAC vs. DEN,W,38,10,22,0.455,3,6,0.5,3,4,0.75,1,3,4,16,3,1,1,1,26,22,1,De'Aaron Fox,SAC,SAC,DEN,5.0,Assists,46,30,42,20
22023,1628368,22300290,"DEC 02, 2023",SAC vs. DEN,W,38,10,22,0.455,3,6,0.5,3,4,0.75,1,3,4,16,3,1,1,1,26,22,1,De'Aaron Fox,SAC,SAC,DEN,41.5,Fantasy Score,46,30,42,20
22023,1628368,22300290,"DEC 02, 2023",SAC vs. DEN,W,38,10,22,0.455,3,6,0.5,3,4,0.75,1,3,4,16,3,1,1,1,26,22,1,De'Aaron Fox,SAC,SAC,DEN,0.5,Offensive Rebounds,46,30,42,20
22023,1628368,22300290,"DEC 02, 2023",SAC vs. DEN,W,38,10,22,0.455,3,6,0.5,3,4,0.75,1,3,4,16,3,1,1,1,26,22,1,De'Aaron Fox,SAC,SAC,DEN,7.5,3-PT Attempted,46,30,42,20
22023,1628368,22300290,"DEC 02, 2023",SAC vs. DEN,W,38,10,22,0.455,3,6,0.5,3,4,0.75,1,3,4,16,3,1,1,1,26,22,1,De'Aaron Fox,SAC,SAC,DEN,4.5,Free Throws Made,46,30,42,20
22023,1628368,22300290,"DEC 02, 2023",SAC vs. DEN,W,38,10,22,0.455,3,6,0.5,3,4,0.75,1,3,4,16,3,1,1,1,26,22,1,De'Aaron Fox,SAC,SAC,DEN,21.5,FG Attempted,46,30,42,20
22023,1628368,22300290,"DEC 02, 2023",SAC vs. DEN,W,38,10,22,0.455,3,6,0.5,3,4,0.75,1,3,4,16,3,1,1,1,26,22,1,De'Aaron Fox,SAC,SAC,DEN,31.5,Pts+Rebs,46,30,42,20
22023,1628368,22300290,"DEC 02, 2023",SAC vs. DEN,W,38,10,22,0.455,3,6,0.5,3,4,0.75,1,3,4,16,3,1,1,1,26,22,1,De'Aaron Fox,SAC,SAC,DEN,32.5,Pts+Asts,46,30,42,20
22023,1628368,22300290,"DEC 02, 2023",SAC vs. DEN,W,38,10,22,0.455,3,6,0.5,3,4,0.75,1,3,4,16,3,1,1,1,26,22,1,De'Aaron Fox,SAC,SAC,DEN,9.0,Rebs+Asts,46,30,42,20
22023,1628368,22300264,"NOV 29, 2023",SAC vs. LAC,L,38,14,23,0.609,3,8,0.375,9,10,0.9,1,4,5,3,0,1,4,3,40,-17,1,De'Aaron Fox,SAC,SAC,LAC,27.5,Points,48,45,43,8
22023,1628368,22300264,"NOV 29, 2023",SAC vs. LAC,L,38,14,23,0.609,3,8,0.375,9,10,0.9,1,4,5,3,0,1,4,3,40,-17,1,De'Aaron Fox,SAC,SAC,LAC,37.0,Pts+Rebs+Asts,48,45,43,8
22023,1628368,22300264,"NOV 29, 2023",SAC vs. LAC,L,38,14,23,0.609,3,8,0.375,9,10,0.9,1,4,5,3,0,1,4,3,40,-17,1,De'Aaron Fox,SAC,SAC,LAC,5.0,Assists,48,45,43,8
22023,1628368,22300264,"NOV 29, 2023",SAC vs. LAC,L,38,14,23,0.609,3,8,0.375,9,10,0.9,1,4,5,3,0,1,4,3,40,-17,1,De'Aaron Fox,SAC,SAC,LAC,41.5,Fantasy Score,48,45,43,8
22023,1628368,22300264,"NOV 29, 2023",SAC vs. LAC,L,38,14,23,0.609,3,8,0.375,9,10,0.9,1,4,5,3,0,1,4,3,40,-17,1,De'Aaron Fox,SAC,SAC,LAC,0.5,Offensive Rebounds,48,45,43,8
22023,1628368,22300264,"NOV 29, 2023",SAC vs. LAC,L,38,14,23,0.609,3,8,0.375,9,10,0.9,1,4,5,3,0,1,4,3,40,-17,1,De'Aaron Fox,SAC,SAC,LAC,7.5,3-PT Attempted,48,45,43,8
22023,1628368,22300264,"NOV 29, 2023",SAC vs. LAC,L,38,14,23,0.609,3,8,0.375,9,10,0.9,1,4,5,3,0,1,4,3,40,-17,1,De'Aaron Fox,SAC,SAC,LAC,4.5,Free Throws Made,48,45,43,8
22023,1628368,22300264,"NOV 29, 2023",SAC vs. LAC,L,38,14,23,0.609,3,8,0.375,9,10,0.9,1,4,5,3,0,1,4,3,40,-17,1,De'Aaron Fox,SAC,SAC,LAC,21.5,FG Attempted,48,45,43,8
22023,1628368,22300264,"NOV 29, 2023",SAC vs. LAC,L,38,14,23,0.609,3,8,0.375,9,10,0.9,1,4,5,3,0,1,4,3,40,-17,1,De'Aaron Fox,SAC,SAC,LAC,31.5,Pts+Rebs,48,45,43,8
22023,1628368,22300264,"NOV 29, 2023",SAC vs. LAC,L,38,14,23,0.609,3,8,0.375,9,10,0.9,1,4,5,3,0,1,4,3,40,-17,1,De'Aaron Fox,SAC,SAC,LAC,32.5,Pts+Asts,48,45,43,8
22023,1628368,22300264,"NOV 29, 2023",SAC vs. LAC,L,38,14,23,0.609,3,8,0.375,9,10,0.9,1,4,5,3,0,1,4,3,40,-17,1,De'Aaron Fox,SAC,SAC,LAC,9.0,Rebs+Asts,48,45,43,8
22023,1628368,22300060,"NOV 28, 2023",SAC vs. GSW,W,40,9,20,0.45,2,8,0.25,9,17,0.529,1,8,9,7,2,0,2,4,29,9,1,De'Aaron Fox,SAC,SAC,GSW,27.5,Points,45,38,36,16
22023,1628368,22300060,"NOV 28, 2023",SAC vs. GSW,W,40,9,20,0.45,2,8,0.25,9,17,0.529,1,8,9,7,2,0,2,4,29,9,1,De'Aaron Fox,SAC,SAC,GSW,37.0,Pts+Rebs+Asts,45,38,36,16
22023,1628368,22300060,"NOV 28, 2023",SAC vs. GSW,W,40,9,20,0.45,2,8,0.25,9,17,0.529,1,8,9,7,2,0,2,4,29,9,1,De'Aaron Fox,SAC,SAC,GSW,5.0,Assists,45,38,36,16
22023,1628368,22300060,"NOV 28, 2023",SAC vs. GSW,W,40,9,20,0.45,2,8,0.25,9,17,0.529,1,8,9,7,2,0,2,4,29,9,1,De'Aaron Fox,SAC,SAC,GSW,41.5,Fantasy Score,45,38,36,16
22023,1628368,22300060,"NOV 28, 2023",SAC vs. GSW,W,40,9,20,0.45,2,8,0.25,9,17,0.529,1,8,9,7,2,0,2,4,29,9,1,De'Aaron Fox,SAC,SAC,GSW,0.5,Offensive Rebounds,45,38,36,16
22023,1628368,22300060,"NOV 28, 2023",SAC vs. GSW,W,40,9,20,0.45,2,8,0.25,9,17,0.529,1,8,9,7,2,0,2,4,29,9,1,De'Aaron Fox,SAC,SAC,GSW,7.5,3-PT Attempted,45,38,36,16
22023,1628368,22300060,"NOV 28, 2023",SAC vs. GSW,W,40,9,20,0.45,2,8,0.25,9,17,0.529,1,8,9,7,2,0,2,4,29,9,1,De'Aaron Fox,SAC,SAC,GSW,4.5,Free Throws Made,45,38,36,16
22023,1628368,22300060,"NOV 28, 2023",SAC vs. GSW,W,40,9,20,0.45,2,8,0.25,9,17,0.529,1,8,9,7,2,0,2,4,29,9,1,De'Aaron Fox,SAC,SAC,GSW,21.5,FG Attempted,45,38,36,16
22023,1628368,22300060,"NOV 28, 2023",SAC vs. GSW,W,40,9,20,0.45,2,8,0.25,9,17,0.529,1,8,9,7,2,0,2,4,29,9,1,De'Aaron Fox,SAC,SAC,GSW,31.5,Pts+Rebs,45,38,36,16
22023,1628368,22300060,"NOV 28, 2023",SAC vs. GSW,W,40,9,20,0.45,2,8,0.25,9,17,0.529,1,8,9,7,2,0,2,4,29,9,1,De'Aaron Fox,SAC,SAC,GSW,32.5,Pts+Asts,45,38,36,16
22023,1628368,22300060,"NOV 28, 2023",SAC vs. GSW,W,40,9,20,0.45,2,8,0.25,9,17,0.529,1,8,9,7,2,0,2,4,29,9,1,De'Aaron Fox,SAC,SAC,GSW,9.0,Rebs+Asts,45,38,36,16
22023,1628368,22300050,"NOV 24, 2023",SAC @ MIN,W,37,14,32,0.438,3,7,0.429,5,6,0.833,2,5,7,12,1,0,2,3,36,19,1,De'Aaron Fox,SAC,MIN,SAC,27.5,Points,55,43,48,19
22023,1628368,22300050,"NOV 24, 2023",SAC @ MIN,W,37,14,32,0.438,3,7,0.429,5,6,0.833,2,5,7,12,1,0,2,3,36,19,1,De'Aaron Fox,SAC,MIN,SAC,37.0,Pts+Rebs+Asts,55,43,48,19
22023,1628368,22300050,"NOV 24, 2023",SAC @ MIN,W,37,14,32,0.438,3,7,0.429,5,6,0.833,2,5,7,12,1,0,2,3,36,19,1,De'Aaron Fox,SAC,MIN,SAC,5.0,Assists,55,43,48,19
22023,1628368,22300050,"NOV 24, 2023",SAC @ MIN,W,37,14,32,0.438,3,7,0.429,5,6,0.833,2,5,7,12,1,0,2,3,36,19,1,De'Aaron Fox,SAC,MIN,SAC,41.5,Fantasy Score,55,43,48,19
22023,1628368,22300050,"NOV 24, 2023",SAC @ MIN,W,37,14,32,0.438,3,7,0.429,5,6,0.833,2,5,7,12,1,0,2,3,36,19,1,De'Aaron Fox,SAC,MIN,SAC,0.5,Offensive Rebounds,55,43,48,19
22023,1628368,22300050,"NOV 24, 2023",SAC @ MIN,W,37,14,32,0.438,3,7,0.429,5,6,0.833,2,5,7,12,1,0,2,3,36,19,1,De'Aaron Fox,SAC,MIN,SAC,7.5,3-PT Attempted,55,43,48,19
22023,1628368,22300050,"NOV 24, 2023",SAC @ MIN,W,37,14,32,0.438,3,7,0.429,5,6,0.833,2,5,7,12,1,0,2,3,36,19,1,De'Aaron Fox,SAC,MIN,SAC,4.5,Free Throws Made,55,43,48,19
22023,1628368,22300050,"NOV 24, 2023",SAC @ MIN,W,37,14,32,0.438,3,7,0.429,5,6,0.833,2,5,7,12,1,0,2,3,36,19,1,De'Aaron Fox,SAC,MIN,SAC,21.5,FG Attempted,55,43,48,19
22023,1628368,22300050,"NOV 24, 2023",SAC @ MIN,W,37,14,32,0.438,3,7,0.429,5,6,0.833,2,5,7,12,1,0,2,3,36,19,1,De'Aaron Fox,SAC,MIN,SAC,31.5,Pts+Rebs,55,43,48,19
22023,1628368,22300050,"NOV 24, 2023",SAC @ MIN,W,37,14,32,0.438,3,7,0.429,5,6,0.833,2,5,7,12,1,0,2,3,36,19,1,De'Aaron Fox,SAC,MIN,SAC,32.5,Pts+Asts,55,43,48,19
22023,1628368,22300050,"NOV 24, 2023",SAC @ MIN,W,37,14,32,0.438,3,7,0.429,5,6,0.833,2,5,7,12,1,0,2,3,36,19,1,De'Aaron Fox,SAC,MIN,SAC,9.0,Rebs+Asts,55,43,48,19
22023,1628368,22300233,"NOV 22, 2023",SAC @ NOP,L,38,9,17,0.529,2,7,0.286,6,7,0.857,0,2,2,5,1,0,2,5,26,-14,1,De'Aaron Fox,SAC,NOP,SAC,27.5,Points,33,28,31,7
22023,1628368,22300233,"NOV 22, 2023",SAC @ NOP,L,38,9,17,0.529,2,7,0.286,6,7,0.857,0,2,2,5,1,0,2,5,26,-14,1,De'Aaron Fox,SAC,NOP,SAC,37.0,Pts+Rebs+Asts,33,28,31,7
22023,1628368,22300233,"NOV 22, 2023",SAC @ NOP,L,38,9,17,0.529,2,7,0.286,6,7,0.857,0,2,2,5,1,0,2,5,26,-14,1,De'Aaron Fox,SAC,NOP,SAC,5.0,Assists,33,28,31,7
22023,1628368,22300233,"NOV 22, 2023",SAC @ NOP,L,38,9,17,0.529,2,7,0.286,6,7,0.857,0,2,2,5,1,0,2,5,26,-14,1,De'Aaron Fox,SAC,NOP,SAC,41.5,Fantasy Score,33,28,31,7
22023,1628368,22300233,"NOV 22, 2023",SAC @ NOP,L,38,9,17,0.529,2,7,0.286,6,7,0.857,0,2,2,5,1,0,2,5,26,-14,1,De'Aaron Fox,SAC,NOP,SAC,0.5,Offensive Rebounds,33,28,31,7
22023,1628368,22300233,"NOV 22, 2023",SAC @ NOP,L,38,9,17,0.529,2,7,0.286,6,7,0.857,0,2,2,5,1,0,2,5,26,-14,1,De'Aaron Fox,SAC,NOP,SAC,7.5,3-PT Attempted,33,28,31,7
22023,1628368,22300233,"NOV 22, 2023",SAC @ NOP,L,38,9,17,0.529,2,7,0.286,6,7,0.857,0,2,2,5,1,0,2,5,26,-14,1,De'Aaron Fox,SAC,NOP,SAC,4.5,Free Throws Made,33,28,31,7
22023,1628368,22300233,"NOV 22, 2023",SAC @ NOP,L,38,9,17,0.529,2,7,0.286,6,7,0.857,0,2,2,5,1,0,2,5,26,-14,1,De'Aaron Fox,SAC,NOP,SAC,21.5,FG Attempted,33,28,31,7
22023,1628368,22300233,"NOV 22, 2023",SAC @ NOP,L,38,9,17,0.529,2,7,0.286,6,7,0.857,0,2,2,5,1,0,2,5,26,-14,1,De'Aaron Fox,SAC,NOP,SAC,31.5,Pts+Rebs,33,28,31,7
22023,1628368,22300233,"NOV 22, 2023",SAC @ NOP,L,38,9,17,0.529,2,7,0.286,6,7,0.857,0,2,2,5,1,0,2,5,26,-14,1,De'Aaron Fox,SAC,NOP,SAC,32.5,Pts+Asts,33,28,31,7
22023,1628368,22300233,"NOV 22, 2023",SAC @ NOP,L,38,9,17,0.529,2,7,0.286,6,7,0.857,0,2,2,5,1,0,2,5,26,-14,1,De'Aaron Fox,SAC,NOP,SAC,9.0,Rebs+Asts,33,28,31,7
22023,1628368,22300222,"NOV 20, 2023",SAC @ NOP,L,29,5,18,0.278,2,12,0.167,2,4,0.5,0,2,2,0,1,0,2,1,14,-32,1,De'Aaron Fox,SAC,NOP,SAC,27.5,Points,16,16,14,2
22023,1628368,22300222,"NOV 20, 2023",SAC @ NOP,L,29,5,18,0.278,2,12,0.167,2,4,0.5,0,2,2,0,1,0,2,1,14,-32,1,De'Aaron Fox,SAC,NOP,SAC,37.0,Pts+Rebs+Asts,16,16,14,2
22023,1628368,22300222,"NOV 20, 2023",SAC @ NOP,L,29,5,18,0.278,2,12,0.167,2,4,0.5,0,2,2,0,1,0,2,1,14,-32,1,De'Aaron Fox,SAC,NOP,SAC,5.0,Assists,16,16,14,2
22023,1628368,22300222,"NOV 20, 2023",SAC @ NOP,L,29,5,18,0.278,2,12,0.167,2,4,0.5,0,2,2,0,1,0,2,1,14,-32,1,De'Aaron Fox,SAC,NOP,SAC,41.5,Fantasy Score,16,16,14,2
22023,1628368,22300222,"NOV 20, 2023",SAC @ NOP,L,29,5,18,0.278,2,12,0.167,2,4,0.5,0,2,2,0,1,0,2,1,14,-32,1,De'Aaron Fox,SAC,NOP,SAC,0.5,Offensive Rebounds,16,16,14,2
22023,1628368,22300222,"NOV 20, 2023",SAC @ NOP,L,29,5,18,0.278,2,12,0.167,2,4,0.5,0,2,2,0,1,0,2,1,14,-32,1,De'Aaron Fox,SAC,NOP,SAC,7.5,3-PT Attempted,16,16,14,2
22023,1628368,22300222,"NOV 20, 2023",SAC @ NOP,L,29,5,18,0.278,2,12,0.167,2,4,0.5,0,2,2,0,1,0,2,1,14,-32,1,De'Aaron Fox,SAC,NOP,SAC,4.5,Free Throws Made,16,16,14,2
22023,1628368,22300222,"NOV 20, 2023",SAC @ NOP,L,29,5,18,0.278,2,12,0.167,2,4,0.5,0,2,2,0,1,0,2,1,14,-32,1,De'Aaron Fox,SAC,NOP,SAC,21.5,FG Attempted,16,16,14,2
22023,1628368,22300222,"NOV 20, 2023",SAC @ NOP,L,29,5,18,0.278,2,12,0.167,2,4,0.5,0,2,2,0,1,0,2,1,14,-32,1,De'Aaron Fox,SAC,NOP,SAC,31.5,Pts+Rebs,16,16,14,2
22023,1628368,22300222,"NOV 20, 2023",SAC @ NOP,L,29,5,18,0.278,2,12,0.167,2,4,0.5,0,2,2,0,1,0,2,1,14,-32,1,De'Aaron Fox,SAC,NOP,SAC,32.5,Pts+Asts,16,16,14,2
22023,1628368,22300222,"NOV 20, 2023",SAC @ NOP,L,29,5,18,0.278,2,12,0.167,2,4,0.5,0,2,2,0,1,0,2,1,14,-32,1,De'Aaron Fox,SAC,NOP,SAC,9.0,Rebs+Asts,16,16,14,2
22023,1628368,22300212,"NOV 19, 2023",SAC @ DAL,W,31,10,20,0.5,6,10,0.6,4,5,0.8,1,3,4,7,3,0,0,1,30,2,1,De'Aaron Fox,SAC,DAL,SAC,27.5,Points,41,34,37,11
22023,1628368,22300212,"NOV 19, 2023",SAC @ DAL,W,31,10,20,0.5,6,10,0.6,4,5,0.8,1,3,4,7,3,0,0,1,30,2,1,De'Aaron Fox,SAC,DAL,SAC,37.0,Pts+Rebs+Asts,41,34,37,11
22023,1628368,22300212,"NOV 19, 2023",SAC @ DAL,W,31,10,20,0.5,6,10,0.6,4,5,0.8,1,3,4,7,3,0,0,1,30,2,1,De'Aaron Fox,SAC,DAL,SAC,5.0,Assists,41,34,37,11
22023,1628368,22300212,"NOV 19, 2023",SAC @ DAL,W,31,10,20,0.5,6,10,0.6,4,5,0.8,1,3,4,7,3,0,0,1,30,2,1,De'Aaron Fox,SAC,DAL,SAC,41.5,Fantasy Score,41,34,37,11
22023,1628368,22300212,"NOV 19, 2023",SAC @ DAL,W,31,10,20,0.5,6,10,0.6,4,5,0.8,1,3,4,7,3,0,0,1,30,2,1,De'Aaron Fox,SAC,DAL,SAC,0.5,Offensive Rebounds,41,34,37,11
22023,1628368,22300212,"NOV 19, 2023",SAC @ DAL,W,31,10,20,0.5,6,10,0.6,4,5,0.8,1,3,4,7,3,0,0,1,30,2,1,De'Aaron Fox,SAC,DAL,SAC,7.5,3-PT Attempted,41,34,37,11
22023,1628368,22300212,"NOV 19, 2023",SAC @ DAL,W,31,10,20,0.5,6,10,0.6,4,5,0.8,1,3,4,7,3,0,0,1,30,2,1,De'Aaron Fox,SAC,DAL,SAC,4.5,Free Throws Made,41,34,37,11
22023,1628368,22300212,"NOV 19, 2023",SAC @ DAL,W,31,10,20,0.5,6,10,0.6,4,5,0.8,1,3,4,7,3,0,0,1,30,2,1,De'Aaron Fox,SAC,DAL,SAC,21.5,FG Attempted,41,34,37,11
22023,1628368,22300212,"NOV 19, 2023",SAC @ DAL,W,31,10,20,0.5,6,10,0.6,4,5,0.8,1,3,4,7,3,0,0,1,30,2,1,De'Aaron Fox,SAC,DAL,SAC,31.5,Pts+Rebs,41,34,37,11
22023,1628368,22300212,"NOV 19, 2023",SAC @ DAL,W,31,10,20,0.5,6,10,0.6,4,5,0.8,1,3,4,7,3,0,0,1,30,2,1,De'Aaron Fox,SAC,DAL,SAC,32.5,Pts+Asts,41,34,37,11
22023,1628368,22300212,"NOV 19, 2023",SAC @ DAL,W,31,10,20,0.5,6,10,0.6,4,5,0.8,1,3,4,7,3,0,0,1,30,2,1,De'Aaron Fox,SAC,DAL,SAC,9.0,Rebs+Asts,41,34,37,11
22023,1628368,22300032,"NOV 17, 2023",SAC @ SAS,W,41,14,24,0.583,5,11,0.455,10,13,0.769,0,8,8,7,1,1,1,2,43,3,1,De'Aaron Fox,SAC,SAS,SAC,27.5,Points,58,51,50,15
22023,1628368,22300032,"NOV 17, 2023",SAC @ SAS,W,41,14,24,0.583,5,11,0.455,10,13,0.769,0,8,8,7,1,1,1,2,43,3,1,De'Aaron Fox,SAC,SAS,SAC,37.0,Pts+Rebs+Asts,58,51,50,15
22023,1628368,22300032,"NOV 17, 2023",SAC @ SAS,W,41,14,24,0.583,5,11,0.455,10,13,0.769,0,8,8,7,1,1,1,2,43,3,1,De'Aaron Fox,SAC,SAS,SAC,5.0,Assists,58,51,50,15
22023,1628368,22300032,"NOV 17, 2023",SAC @ SAS,W,41,14,24,0.583,5,11,0.455,10,13,0.769,0,8,8,7,1,1,1,2,43,3,1,De'Aaron Fox,SAC,SAS,SAC,41.5,Fantasy Score,58,51,50,15
22023,1628368,22300032,"NOV 17, 2023",SAC @ SAS,W,41,14,24,0.583,5,11,0.455,10,13,0.769,0,8,8,7,1,1,1,2,43,3,1,De'Aaron Fox,SAC,SAS,SAC,0.5,Offensive Rebounds,58,51,50,15
22023,1628368,22300032,"NOV 17, 2023",SAC @ SAS,W,41,14,24,0.583,5,11,0.455,10,13,0.769,0,8,8,7,1,1,1,2,43,3,1,De'Aaron Fox,SAC,SAS,SAC,7.5,3-PT Attempted,58,51,50,15
22023,1628368,22300032,"NOV 17, 2023",SAC @ SAS,W,41,14,24,0.583,5,11,0.455,10,13,0.769,0,8,8,7,1,1,1,2,43,3,1,De'Aaron Fox,SAC,SAS,SAC,4.5,Free Throws Made,58,51,50,15
22023,1628368,22300032,"NOV 17, 2023",SAC @ SAS,W,41,14,24,0.583,5,11,0.455,10,13,0.769,0,8,8,7,1,1,1,2,43,3,1,De'Aaron Fox,SAC,SAS,SAC,21.5,FG Attempted,58,51,50,15
22023,1628368,22300032,"NOV 17, 2023",SAC @ SAS,W,41,14,24,0.583,5,11,0.455,10,13,0.769,0,8,8,7,1,1,1,2,43,3,1,De'Aaron Fox,SAC,SAS,SAC,31.5,Pts+Rebs,58,51,50,15
22023,1628368,22300032,"NOV 17, 2023",SAC @ SAS,W,41,14,24,0.583,5,11,0.455,10,13,0.769,0,8,8,7,1,1,1,2,43,3,1,De'Aaron Fox,SAC,SAS,SAC,32.5,Pts+Asts,58,51,50,15
22023,1628368,22300032,"NOV 17, 2023",SAC @ SAS,W,41,14,24,0.583,5,11,0.455,10,13,0.769,0,8,8,7,1,1,1,2,43,3,1,De'Aaron Fox,SAC,SAS,SAC,9.0,Rebs+Asts,58,51,50,15
22023,1628368,22300198,"NOV 15, 2023",SAC @ LAL,W,38,10,22,0.455,3,9,0.333,5,7,0.714,3,2,5,5,4,0,3,3,28,15,1,De'Aaron Fox,SAC,LAL,SAC,27.5,Points,38,33,33,10
22023,1628368,22300198,"NOV 15, 2023",SAC @ LAL,W,38,10,22,0.455,3,9,0.333,5,7,0.714,3,2,5,5,4,0,3,3,28,15,1,De'Aaron Fox,SAC,LAL,SAC,37.0,Pts+Rebs+Asts,38,33,33,10
22023,1628368,22300198,"NOV 15, 2023",SAC @ LAL,W,38,10,22,0.455,3,9,0.333,5,7,0.714,3,2,5,5,4,0,3,3,28,15,1,De'Aaron Fox,SAC,LAL,SAC,5.0,Assists,38,33,33,10
22023,1628368,22300198,"NOV 15, 2023",SAC @ LAL,W,38,10,22,0.455,3,9,0.333,5,7,0.714,3,2,5,5,4,0,3,3,28,15,1,De'Aaron Fox,SAC,LAL,SAC,41.5,Fantasy Score,38,33,33,10
22023,1628368,22300198,"NOV 15, 2023",SAC @ LAL,W,38,10,22,0.455,3,9,0.333,5,7,0.714,3,2,5,5,4,0,3,3,28,15,1,De'Aaron Fox,SAC,LAL,SAC,0.5,Offensive Rebounds,38,33,33,10
22023,1628368,22300198,"NOV 15, 2023",SAC @ LAL,W,38,10,22,0.455,3,9,0.333,5,7,0.714,3,2,5,5,4,0,3,3,28,15,1,De'Aaron Fox,SAC,LAL,SAC,7.5,3-PT Attempted,38,33,33,10
22023,1628368,22300198,"NOV 15, 2023",SAC @ LAL,W,38,10,22,0.455,3,9,0.333,5,7,0.714,3,2,5,5,4,0,3,3,28,15,1,De'Aaron Fox,SAC,LAL,SAC,4.5,Free Throws Made,38,33,33,10
22023,1628368,22300198,"NOV 15, 2023",SAC @ LAL,W,38,10,22,0.455,3,9,0.333,5,7,0.714,3,2,5,5,4,0,3,3,28,15,1,De'Aaron Fox,SAC,LAL,SAC,21.5,FG Attempted,38,33,33,10
22023,1628368,22300198,"NOV 15, 2023",SAC @ LAL,W,38,10,22,0.455,3,9,0.333,5,7,0.714,3,2,5,5,4,0,3,3,28,15,1,De'Aaron Fox,SAC,LAL,SAC,31.5,Pts+Rebs,38,33,33,10
22023,1628368,22300198,"NOV 15, 2023",SAC @ LAL,W,38,10,22,0.455,3,9,0.333,5,7,0.714,3,2,5,5,4,0,3,3,28,15,1,De'Aaron Fox,SAC,LAL,SAC,32.5,Pts+Asts,38,33,33,10
22023,1628368,22300198,"NOV 15, 2023",SAC @ LAL,W,38,10,22,0.455,3,9,0.333,5,7,0.714,3,2,5,5,4,0,3,3,28,15,1,De'Aaron Fox,SAC,LAL,SAC,9.0,Rebs+Asts,38,33,33,10
22023,1628368,22300191,"NOV 13, 2023",SAC vs. CLE,W,36,11,20,0.55,2,6,0.333,4,7,0.571,1,1,2,6,1,0,1,2,28,17,1,De'Aaron Fox,SAC,SAC,CLE,27.5,Points,36,30,34,8
22023,1628368,22300191,"NOV 13, 2023",SAC vs. CLE,W,36,11,20,0.55,2,6,0.333,4,7,0.571,1,1,2,6,1,0,1,2,28,17,1,De'Aaron Fox,SAC,SAC,CLE,37.0,Pts+Rebs+Asts,36,30,34,8
22023,1628368,22300191,"NOV 13, 2023",SAC vs. CLE,W,36,11,20,0.55,2,6,0.333,4,7,0.571,1,1,2,6,1,0,1,2,28,17,1,De'Aaron Fox,SAC,SAC,CLE,5.0,Assists,36,30,34,8
22023,1628368,22300191,"NOV 13, 2023",SAC vs. CLE,W,36,11,20,0.55,2,6,0.333,4,7,0.571,1,1,2,6,1,0,1,2,28,17,1,De'Aaron Fox,SAC,SAC,CLE,41.5,Fantasy Score,36,30,34,8
22023,1628368,22300191,"NOV 13, 2023",SAC vs. CLE,W,36,11,20,0.55,2,6,0.333,4,7,0.571,1,1,2,6,1,0,1,2,28,17,1,De'Aaron Fox,SAC,SAC,CLE,0.5,Offensive Rebounds,36,30,34,8
22023,1628368,22300191,"NOV 13, 2023",SAC vs. CLE,W,36,11,20,0.55,2,6,0.333,4,7,0.571,1,1,2,6,1,0,1,2,28,17,1,De'Aaron Fox,SAC,SAC,CLE,7.5,3-PT Attempted,36,30,34,8
22023,1628368,22300191,"NOV 13, 2023",SAC vs. CLE,W,36,11,20,0.55,2,6,0.333,4,7,0.571,1,1,2,6,1,0,1,2,28,17,1,De'Aaron Fox,SAC,SAC,CLE,4.5,Free Throws Made,36,30,34,8
22023,1628368,22300191,"NOV 13, 2023",SAC vs. CLE,W,36,11,20,0.55,2,6,0.333,4,7,0.571,1,1,2,6,1,0,1,2,28,17,1,De'Aaron Fox,SAC,SAC,CLE,21.5,FG Attempted,36,30,34,8
22023,1628368,22300191,"NOV 13, 2023",SAC vs. CLE,W,36,11,20,0.55,2,6,0.333,4,7,0.571,1,1,2,6,1,0,1,2,28,17,1,De'Aaron Fox,SAC,SAC,CLE,31.5,Pts+Rebs,36,30,34,8
22023,1628368,22300191,"NOV 13, 2023",SAC vs. CLE,W,36,11,20,0.55,2,6,0.333,4,7,0.571,1,1,2,6,1,0,1,2,28,17,1,De'Aaron Fox,SAC,SAC,CLE,32.5,Pts+Asts,36,30,34,8
22023,1628368,22300191,"NOV 13, 2023",SAC vs. CLE,W,36,11,20,0.55,2,6,0.333,4,7,0.571,1,1,2,6,1,0,1,2,28,17,1,De'Aaron Fox,SAC,SAC,CLE,9.0,Rebs+Asts,36,30,34,8
22023,1628368,22300100,"OCT 29, 2023",SAC vs. LAL,W,34,14,24,0.583,3,8,0.375,6,8,0.75,1,3,4,8,1,1,3,5,37,15,1,De'Aaron Fox,SAC,SAC,LAL,27.5,Points,49,41,45,12
22023,1628368,22300100,"OCT 29, 2023",SAC vs. LAL,W,34,14,24,0.583,3,8,0.375,6,8,0.75,1,3,4,8,1,1,3,5,37,15,1,De'Aaron Fox,SAC,SAC,LAL,37.0,Pts+Rebs+Asts,49,41,45,12
22023,1628368,22300100,"OCT 29, 2023",SAC vs. LAL,W,34,14,24,0.583,3,8,0.375,6,8,0.75,1,3,4,8,1,1,3,5,37,15,1,De'Aaron Fox,SAC,SAC,LAL,5.0,Assists,49,41,45,12
22023,1628368,22300100,"OCT 29, 2023",SAC vs. LAL,W,34,14,24,0.583,3,8,0.375,6,8,0.75,1,3,4,8,1,1,3,5,37,15,1,De'Aaron Fox,SAC,SAC,LAL,41.5,Fantasy Score,49,41,45,12
22023,1628368,22300100,"OCT 29, 2023",SAC vs. LAL,W,34,14,24,0.583,3,8,0.375,6,8,0.75,1,3,4,8,1,1,3,5,37,15,1,De'Aaron Fox,SAC,SAC,LAL,0.5,Offensive Rebounds,49,41,45,12
22023,1628368,22300100,"OCT 29, 2023",SAC vs. LAL,W,34,14,24,0.583,3,8,0.375,6,8,0.75,1,3,4,8,1,1,3,5,37,15,1,De'Aaron Fox,SAC,SAC,LAL,7.5,3-PT Attempted,49,41,45,12
22023,1628368,22300100,"OCT 29, 2023",SAC vs. LAL,W,34,14,24,0.583,3,8,0.375,6,8,0.75,1,3,4,8,1,1,3,5,37,15,1,De'Aaron Fox,SAC,SAC,LAL,4.5,Free Throws Made,49,41,45,12
22023,1628368,22300100,"OCT 29, 2023",SAC vs. LAL,W,34,14,24,0.583,3,8,0.375,6,8,0.75,1,3,4,8,1,1,3,5,37,15,1,De'Aaron Fox,SAC,SAC,LAL,21.5,FG Attempted,49,41,45,12
22023,1628368,22300100,"OCT 29, 2023",SAC vs. LAL,W,34,14,24,0.583,3,8,0.375,6,8,0.75,1,3,4,8,1,1,3,5,37,15,1,De'Aaron Fox,SAC,SAC,LAL,31.5,Pts+Rebs,49,41,45,12
22023,1628368,22300100,"OCT 29, 2023",SAC vs. LAL,W,34,14,24,0.583,3,8,0.375,6,8,0.75,1,3,4,8,1,1,3,5,37,15,1,De'Aaron Fox,SAC,SAC,LAL,32.5,Pts+Asts,49,41,45,12
22023,1628368,22300100,"OCT 29, 2023",SAC vs. LAL,W,34,14,24,0.583,3,8,0.375,6,8,0.75,1,3,4,8,1,1,3,5,37,15,1,De'Aaron Fox,SAC,SAC,LAL,9.0,Rebs+Asts,49,41,45,12
22023,1628368,22300087,"OCT 27, 2023",SAC vs. GSW,L,39,14,28,0.5,5,9,0.556,6,7,0.857,0,4,4,4,2,0,2,3,39,1,1,De'Aaron Fox,SAC,SAC,GSW,27.5,Points,47,43,43,8
22023,1628368,22300087,"OCT 27, 2023",SAC vs. GSW,L,39,14,28,0.5,5,9,0.556,6,7,0.857,0,4,4,4,2,0,2,3,39,1,1,De'Aaron Fox,SAC,SAC,GSW,37.0,Pts+Rebs+Asts,47,43,43,8
22023,1628368,22300087,"OCT 27, 2023",SAC vs. GSW,L,39,14,28,0.5,5,9,0.556,6,7,0.857,0,4,4,4,2,0,2,3,39,1,1,De'Aaron Fox,SAC,SAC,GSW,5.0,Assists,47,43,43,8
22023,1628368,22300087,"OCT 27, 2023",SAC vs. GSW,L,39,14,28,0.5,5,9,0.556,6,7,0.857,0,4,4,4,2,0,2,3,39,1,1,De'Aaron Fox,SAC,SAC,GSW,41.5,Fantasy Score,47,43,43,8
22023,1628368,22300087,"OCT 27, 2023",SAC vs. GSW,L,39,14,28,0.5,5,9,0.556,6,7,0.857,0,4,4,4,2,0,2,3,39,1,1,De'Aaron Fox,SAC,SAC,GSW,0.5,Offensive Rebounds,47,43,43,8
22023,1628368,22300087,"OCT 27, 2023",SAC vs. GSW,L,39,14,28,0.5,5,9,0.556,6,7,0.857,0,4,4,4,2,0,2,3,39,1,1,De'Aaron Fox,SAC,SAC,GSW,7.5,3-PT Attempted,47,43,43,8
22023,1628368,22300087,"OCT 27, 2023",SAC vs. GSW,L,39,14,28,0.5,5,9,0.556,6,7,0.857,0,4,4,4,2,0,2,3,39,1,1,De'Aaron Fox,SAC,SAC,GSW,4.5,Free Throws Made,47,43,43,8
22023,1628368,22300087,"OCT 27, 2023",SAC vs. GSW,L,39,14,28,0.5,5,9,0.556,6,7,0.857,0,4,4,4,2,0,2,3,39,1,1,De'Aaron Fox,SAC,SAC,GSW,21.5,FG Attempted,47,43,43,8
22023,1628368,22300087,"OCT 27, 2023",SAC vs. GSW,L,39,14,28,0.5,5,9,0.556,6,7,0.857,0,4,4,4,2,0,2,3,39,1,1,De'Aaron Fox,SAC,SAC,GSW,31.5,Pts+Rebs,47,43,43,8
22023,1628368,22300087,"OCT 27, 2023",SAC vs. GSW,L,39,14,28,0.5,5,9,0.556,6,7,0.857,0,4,4,4,2,0,2,3,39,1,1,De'Aaron Fox,SAC,SAC,GSW,32.5,Pts+Asts,47,43,43,8
22023,1628368,22300087,"OCT 27, 2023",SAC vs. GSW,L,39,14,28,0.5,5,9,0.556,6,7,0.857,0,4,4,4,2,0,2,3,39,1,1,De'Aaron Fox,SAC,SAC,GSW,9.0,Rebs+Asts,47,43,43,8
22023,1628368,22300072,"OCT 25, 2023",SAC @ UTA,W,33,6,18,0.333,1,7,0.143,5,6,0.833,2,3,5,6,1,1,3,4,18,14,1,De'Aaron Fox,SAC,UTA,SAC,27.5,Points,29,23,24,11
22023,1628368,22300072,"OCT 25, 2023",SAC @ UTA,W,33,6,18,0.333,1,7,0.143,5,6,0.833,2,3,5,6,1,1,3,4,18,14,1,De'Aaron Fox,SAC,UTA,SAC,37.0,Pts+Rebs+Asts,29,23,24,11
22023,1628368,22300072,"OCT 25, 2023",SAC @ UTA,W,33,6,18,0.333,1,7,0.143,5,6,0.833,2,3,5,6,1,1,3,4,18,14,1,De'Aaron Fox,SAC,UTA,SAC,5.0,Assists,29,23,24,11
22023,1628368,22300072,"OCT 25, 2023",SAC @ UTA,W,33,6,18,0.333,1,7,0.143,5,6,0.833,2,3,5,6,1,1,3,4,18,14,1,De'Aaron Fox,SAC,UTA,SAC,41.5,Fantasy Score,29,23,24,11
22023,1628368,22300072,"OCT 25, 2023",SAC @ UTA,W,33,6,18,0.333,1,7,0.143,5,6,0.833,2,3,5,6,1,1,3,4,18,14,1,De'Aaron Fox,SAC,UTA,SAC,0.5,Offensive Rebounds,29,23,24,11
22023,1628368,22300072,"OCT 25, 2023",SAC @ UTA,W,33,6,18,0.333,1,7,0.143,5,6,0.833,2,3,5,6,1,1,3,4,18,14,1,De'Aaron Fox,SAC,UTA,SAC,7.5,3-PT Attempted,29,23,24,11
22023,1628368,22300072,"OCT 25, 2023",SAC @ UTA,W,33,6,18,0.333,1,7,0.143,5,6,0.833,2,3,5,6,1,1,3,4,18,14,1,De'Aaron Fox,SAC,UTA,SAC,4.5,Free Throws Made,29,23,24,11
22023,1628368,22300072,"OCT 25, 2023",SAC @ UTA,W,33,6,18,0.333,1,7,0.143,5,6,0.833,2,3,5,6,1,1,3,4,18,14,1,De'Aaron Fox,SAC,UTA,SAC,21.5,FG Attempted,29,23,24,11
22023,1628368,22300072,"OCT 25, 2023",SAC @ UTA,W,33,6,18,0.333,1,7,0.143,5,6,0.833,2,3,5,6,1,1,3,4,18,14,1,De'Aaron Fox,SAC,UTA,SAC,31.5,Pts+Rebs,29,23,24,11
22023,1628368,22300072,"OCT 25, 2023",SAC @ UTA,W,33,6,18,0.333,1,7,0.143,5,6,0.833,2,3,5,6,1,1,3,4,18,14,1,De'Aaron Fox,SAC,UTA,SAC,32.5,Pts+Asts,29,23,24,11
22023,1628368,22300072,"OCT 25, 2023",SAC @ UTA,W,33,6,18,0.333,1,7,0.143,5,6,0.833,2,3,5,6,1,1,3,4,18,14,1,De'Aaron Fox,SAC,UTA,SAC,9.0,Rebs+Asts,29,23,24,11
22023,1641788,22300271,"NOV 30, 2023",LAL @ OKC,L,4,0,1,0.0,0,1,0.0,2,2,1.0,1,0,1,0,0,0,0,0,2,-5,1,Alex Fudge,LAL,OKC,LAL,,,3,3,2,1
22023,1641788,22300258,"NOV 29, 2023",LAL @ DET,W,4,0,3,0.0,0,1,0.0,0,0,0.0,1,0,1,0,0,0,0,1,0,-3,1,Alex Fudge,LAL,DET,LAL,,,1,1,0,1
22023,1641788,22300255,"NOV 27, 2023",LAL @ PHI,L,2,1,1,1.0,0,0,0.0,0,0,0.0,0,0,0,0,0,0,1,0,2,-9,1,Alex Fudge,LAL,PHI,LAL,,,2,2,2,0
22023,1641788,22300134,"NOV 04, 2023",LAL @ ORL,L,4,0,1,0.0,0,0,0.0,0,0,0.0,0,0,0,0,0,0,0,0,0,-3,1,Alex Fudge,LAL,ORL,LAL,,,0,0,0,0
22023,1628365,22300557,"JAN 15, 2024",ORL @ NYK,W,23,3,8,0.375,0,0,0.0,0,0,0.0,1,4,5,7,0,0,0,2,6,11,1,Markelle Fultz,ORL,NYK,ORL,,,18,11,13,12
22023,1628365,22300535,"JAN 12, 2024",ORL @ MIA,L,17,1,2,0.5,0,0,0.0,1,2,0.5,2,1,3,3,2,1,2,2,3,-6,1,Markelle Fultz,ORL,MIA,ORL,,,9,6,6,6
22023,1628365,22300513,"JAN 09, 2024",ORL vs. MIN,L,13,2,7,0.286,0,0,0.0,0,0,0.0,1,2,3,2,0,0,0,0,4,-3,1,Markelle Fultz,ORL,ORL,MIN,,,9,7,6,5
22023,1628365,22300499,"JAN 07, 2024",ORL vs. ATL,W,15,0,2,0.0,0,0,0.0,0,4,0.0,0,2,2,4,1,0,1,0,0,-6,1,Markelle Fultz,ORL,ORL,ATL,,,6,2,4,6
22023,1628365,22300172,"NOV 09, 2023",ORL vs. ATL,L,29,5,12,0.417,0,0,0.0,3,3,1.0,2,0,2,3,1,0,1,1,13,-2,1,Markelle Fultz,ORL,ORL,ATL,,,18,15,16,5
22023,1628365,22300114,"OCT 31, 2023",ORL @ LAC,L,32,6,11,0.545,0,0,0.0,0,1,0.0,1,4,5,1,1,0,2,3,12,-16,1,Markelle Fultz,ORL,LAC,ORL,,,18,17,13,6
22023,1628365,22300111,"OCT 30, 2023",ORL @ LAL,L,33,7,16,0.438,0,1,0.0,0,0,0.0,1,3,4,8,1,2,1,2,14,0,1,Markelle Fultz,ORL,LAL,ORL,,,26,18,22,12
22023,1628365,22300086,"OCT 27, 2023",ORL @ POR,W,25,4,8,0.5,0,2,0.0,0,0,0.0,1,1,2,6,0,0,1,0,8,11,1,Markelle Fultz,ORL,POR,ORL,,,16,10,14,8
22023,1628365,22300066,"OCT 25, 2023",ORL vs. HOU,W,25,5,9,0.556,0,0,0.0,0,0,0.0,3,1,4,2,3,0,1,0,10,12,1,Markelle Fultz,ORL,ORL,HOU,,,16,14,12,6
22023,1629655,22300558,"JAN 15, 2024",WAS vs. DET,L,26,4,6,0.667,0,0,0.0,0,0,0.0,3,3,6,3,1,2,2,3,8,-12,1,Daniel Gafford,WAS,WAS,DET,,,17,14,11,9
22023,1629655,22300543,"JAN 13, 2024",WAS @ ATL,W,30,4,4,1.0,0,0,0.0,2,2,1.0,0,6,6,0,1,2,1,0,10,26,1,Daniel Gafford,WAS,ATL,WAS,,,16,16,10,6
22023,1629655,22300520,"JAN 10, 2024",WAS @ IND,L,37,4,6,0.667,0,0,0.0,4,6,0.667,1,7,8,2,2,6,3,4,12,-3,1,Daniel Gafford,WAS,IND,WAS,,,22,20,14,10
22023,1629655,22300508,"JAN 08, 2024",WAS vs. OKC,L,26,3,7,0.429,0,0,0.0,3,3,1.0,4,5,9,1,0,1,0,2,9,1,1,Daniel Gafford,WAS,WAS,OKC,,,19,18,10,10
22023,1629655,22300494,"JAN 06, 2024",WAS vs. NYK,L,31,2,2,1.0,0,0,0.0,2,4,0.5,4,8,12,3,1,1,1,5,6,-8,1,Daniel Gafford,WAS,WAS,NYK,,,21,18,9,15
22023,1629655,22300482,"JAN 05, 2024",WAS @ CLE,L,24,1,2,0.5,0,0,0.0,2,2,1.0,0,4,4,1,0,1,0,2,4,-18,1,Daniel Gafford,WAS,CLE,WAS,,,9,8,5,5
22023,1629655,22300465,"JAN 03, 2024",WAS @ CLE,L,20,6,8,0.75,0,0,0.0,0,1,0.0,3,2,5,1,0,1,0,2,12,-13,1,Daniel Gafford,WAS,CLE,WAS,,,18,17,13,6
22023,1629655,22300445,"DEC 31, 2023",WAS vs. ATL,L,28,3,4,0.75,0,0,0.0,4,4,1.0,2,7,9,0,2,4,0,2,10,13,1,Daniel Gafford,WAS,WAS,ATL,,,19,19,10,9
22023,1629655,22300430,"DEC 29, 2023",WAS vs. BKN,W,17,1,4,0.25,0,0,0.0,2,2,1.0,1,4,5,0,1,0,1,4,4,-15,1,Daniel Gafford,WAS,WAS,BKN,,,9,9,4,5
22023,1629655,22300416,"DEC 27, 2023",WAS vs. TOR,L,30,5,9,0.556,0,0,0.0,2,2,1.0,2,6,8,1,4,1,0,2,12,-21,1,Daniel Gafford,WAS,WAS,TOR,,,21,20,13,9
22023,1629655,22300407,"DEC 26, 2023",WAS vs. ORL,L,32,6,7,0.857,0,0,0.0,1,2,0.5,6,7,13,3,2,3,3,4,13,-1,1,Daniel Gafford,WAS,WAS,ORL,,,29,26,16,16
22023,1629655,22300386,"DEC 22, 2023",WAS @ GSW,L,23,5,7,0.714,0,0,0.0,5,6,0.833,1,3,4,1,1,0,1,1,15,-3,1,Daniel Gafford,WAS,GSW,WAS,,,20,19,16,5
22023,1629655,22300381,"DEC 21, 2023",WAS @ POR,W,31,7,10,0.7,0,0,0.0,2,3,0.667,3,5,8,0,4,6,1,6,16,9,1,Daniel Gafford,WAS,POR,WAS,,,24,24,16,8
22023,1629655,22300358,"DEC 18, 2023",WAS @ SAC,L,25,3,5,0.6,0,0,0.0,2,2,1.0,2,3,5,1,0,3,0,4,8,-27,1,Daniel Gafford,WAS,SAC,WAS,,,14,13,9,6
22023,1629655,22300347,"DEC 17, 2023",WAS @ PHX,L,35,10,13,0.769,0,0,0.0,6,7,0.857,7,10,17,3,0,2,1,4,26,4,1,Daniel Gafford,WAS,PHX,WAS,,,46,43,29,20
22023,1629655,22300328,"DEC 15, 2023",WAS vs. IND,W,28,3,6,0.5,0,0,0.0,3,4,0.75,5,5,10,4,0,3,2,4,9,19,1,Daniel Gafford,WAS,WAS,IND,,,23,19,13,14
22023,1629655,22300311,"DEC 13, 2023",WAS vs. NOP,L,24,5,6,0.833,0,0,0.0,3,4,0.75,2,5,7,0,1,2,1,3,13,-4,1,Daniel Gafford,WAS,WAS,NOP,,,20,20,13,7
22023,1629655,22301219,"DEC 08, 2023",WAS @ BKN,L,22,1,5,0.2,0,0,0.0,1,2,0.5,2,0,2,2,0,2,1,1,3,-23,1,Daniel Gafford,WAS,BKN,WAS,,,7,5,5,4
22023,1629655,22301208,"DEC 06, 2023",WAS vs. PHI,L,23,8,10,0.8,0,0,0.0,2,2,1.0,2,4,6,4,1,2,0,6,18,-8,1,Daniel Gafford,WAS,WAS,PHI,,,28,24,22,10
22023,1629655,22300274,"DEC 01, 2023",WAS @ ORL,L,27,7,10,0.7,0,0,0.0,4,7,0.571,4,7,11,3,0,3,1,5,18,-1,1,Daniel Gafford,WAS,ORL,WAS,,,32,29,21,14
22023,1629655,22300259,"NOV 29, 2023",WAS @ ORL,L,26,2,2,1.0,0,0,0.0,0,0,0.0,1,2,3,4,1,2,0,3,4,-6,1,Daniel Gafford,WAS,ORL,WAS,,,11,7,8,7
22023,1629655,22300253,"NOV 27, 2023",WAS @ DET,W,27,4,5,0.8,0,0,0.0,2,2,1.0,3,6,9,2,2,4,2,3,10,10,1,Daniel Gafford,WAS,DET,WAS,,,21,19,12,11
22023,1629655,22300241,"NOV 25, 2023",WAS vs. ATL,L,18,6,8,0.75,0,0,0.0,0,0,0.0,1,3,4,0,0,2,0,2,12,-18,1,Daniel Gafford,WAS,WAS,ATL,,,16,16,12,4
22023,1629655,22300049,"NOV 24, 2023",WAS @ MIL,L,29,3,6,0.5,0,0,0.0,2,3,0.667,5,4,9,4,1,2,1,5,8,-6,1,Daniel Gafford,WAS,MIL,WAS,,,21,17,12,13
22023,1629655,22300225,"NOV 22, 2023",WAS @ CHA,L,34,7,9,0.778,0,0,0.0,1,2,0.5,5,11,16,1,1,0,2,4,15,15,1,Daniel Gafford,WAS,CHA,WAS,,,32,31,16,17
22023,1629655,22300219,"NOV 20, 2023",WAS vs. MIL,L,29,7,13,0.538,0,0,0.0,0,0,0.0,1,4,5,2,0,2,0,3,14,-1,1,Daniel Gafford,WAS,WAS,MIL,,,21,19,16,7
22023,1629655,22300028,"NOV 17, 2023",WAS vs. NYK,L,28,4,8,0.5,0,0,0.0,2,2,1.0,4,3,7,0,1,0,1,4,10,-15,1,Daniel Gafford,WAS,WAS,NYK,,,17,17,10,7
22023,1629655,22300192,"NOV 15, 2023",WAS vs. DAL,L,24,5,6,0.833,0,0,0.0,0,1,0.0,2,7,9,2,0,0,0,1,10,-16,1,Daniel Gafford,WAS,WAS,DAL,,,21,19,12,11
22023,1629655,22300189,"NOV 13, 2023",WAS @ TOR,L,26,6,7,0.857,0,0,0.0,2,2,1.0,1,8,9,3,1,3,2,2,14,7,1,Daniel Gafford,WAS,TOR,WAS,,,26,23,17,12
22023,1629655,22300178,"NOV 12, 2023",WAS @ BKN,L,16,2,3,0.667,0,0,0.0,1,2,0.5,2,3,5,0,2,0,1,1,5,-4,1,Daniel Gafford,WAS,BKN,WAS,,,10,10,5,5
22023,1629655,22300009,"NOV 10, 2023",WAS vs. CHA,L,30,4,7,0.571,0,0,0.0,2,3,0.667,4,5,9,1,2,4,2,4,10,-16,1,Daniel Gafford,WAS,WAS,CHA,,,20,19,11,10
22023,1629655,22300157,"NOV 08, 2023",WAS @ CHA,W,13,2,3,0.667,0,0,0.0,1,2,0.5,3,2,5,1,0,2,1,4,5,3,1,Daniel Gafford,WAS,CHA,WAS,,,11,10,6,6
22023,1629655,22300148,"NOV 06, 2023",WAS @ PHI,L,30,6,7,0.857,0,0,0.0,0,0,0.0,3,4,7,3,0,5,4,5,12,-3,1,Daniel Gafford,WAS,PHI,WAS,,,22,19,15,10
22023,1629655,22300003,"NOV 03, 2023",WAS @ MIA,L,20,1,1,1.0,0,0,0.0,2,3,0.667,1,4,5,1,0,2,2,5,4,-10,1,Daniel Gafford,WAS,MIA,WAS,,,10,9,5,6
22023,1629655,22300089,"OCT 28, 2023",WAS vs. MEM,W,28,3,4,0.75,0,0,0.0,4,6,0.667,4,7,11,0,0,2,1,2,10,8,1,Daniel Gafford,WAS,WAS,MEM,,,21,21,10,11
22023,1629655,22300064,"OCT 25, 2023",WAS @ IND,L,21,2,2,1.0,0,0,0.0,2,4,0.5,1,4,5,0,0,2,0,5,6,-23,1,Daniel Gafford,WAS,IND,WAS,,,11,11,6,5
22023,201568,22300416,"DEC 27, 2023",WAS vs. TOR,L,5,0,2,0.0,0,1,0.0,0,0,0.0,0,1,1,0,0,0,0,0,0,-8,1,Danilo Gallinari,WAS,WAS,TOR,,,1,1,0,1
22023,201568,22300407,"DEC 26, 2023",WAS vs. ORL,L,16,2,5,0.4,1,3,0.333,4,5,0.8,1,2,3,1,0,0,1,2,9,-7,1,Danilo Gallinari,WAS,WAS,ORL,,,13,12,10,4
22023,201568,22300381,"DEC 21, 2023",WAS @ POR,W,13,1,3,0.333,1,2,0.5,1,2,0.5,0,2,2,0,0,0,0,0,4,-6,1,Danilo Gallinari,WAS,POR,WAS,,,6,6,4,2
22023,201568,22300347,"DEC 17, 2023",WAS @ PHX,L,12,1,2,0.5,1,2,0.5,3,3,1.0,0,1,1,0,1,0,0,0,6,-10,1,Danilo Gallinari,WAS,PHX,WAS,,,7,7,6,1
22023,201568,22300328,"DEC 15, 2023",WAS vs. IND,W,10,1,2,0.5,0,1,0.0,2,2,1.0,1,4,5,1,0,0,0,0,4,14,1,Danilo Gallinari,WAS,WAS,IND,,,10,9,5,6
22023,201568,22300311,"DEC 13, 2023",WAS vs. NOP,L,16,2,6,0.333,1,3,0.333,4,4,1.0,0,1,1,1,0,0,1,0,9,-20,1,Danilo Gallinari,WAS,WAS,NOP,,,11,10,10,2
22023,201568,22300295,"DEC 11, 2023",WAS @ PHI,L,11,0,0,0.0,0,0,0.0,2,2,1.0,0,1,1,0,0,0,2,2,2,-8,1,Danilo Gallinari,WAS,PHI,WAS,,,3,3,2,1
22023,201568,22301219,"DEC 08, 2023",WAS @ BKN,L,19,2,9,0.222,0,5,0.0,0,0,0.0,0,2,2,1,0,0,0,3,4,1,1,Danilo Gallinari,WAS,BKN,WAS,,,7,6,5,3
22023,201568,22301208,"DEC 06, 2023",WAS vs. PHI,L,17,2,6,0.333,2,5,0.4,1,1,1.0,0,6,6,2,1,0,0,1,7,-1,1,Danilo Gallinari,WAS,WAS,PHI,,,15,13,9,8
22023,201568,22300274,"DEC 01, 2023",WAS @ ORL,L,21,3,4,0.75,1,1,1.0,0,0,0.0,1,5,6,1,1,0,1,2,7,-4,1,Danilo Gallinari,WAS,ORL,WAS,,,14,13,8,7
22023,201568,22300259,"NOV 29, 2023",WAS @ ORL,L,12,1,4,0.25,0,1,0.0,4,5,0.8,0,1,1,0,0,0,0,1,6,-12,1,Danilo Gallinari,WAS,ORL,WAS,,,7,7,6,1
22023,201568,22300253,"NOV 27, 2023",WAS @ DET,W,19,5,8,0.625,3,6,0.5,3,3,1.0,0,2,2,2,0,0,1,2,16,9,1,Danilo Gallinari,WAS,DET,WAS,,,20,18,18,4
22023,201568,22300049,"NOV 24, 2023",WAS @ MIL,L,18,2,5,0.4,1,2,0.5,2,2,1.0,0,4,4,1,0,0,0,2,7,1,1,Danilo Gallinari,WAS,MIL,WAS,,,12,11,8,5
22023,201568,22300225,"NOV 22, 2023",WAS @ CHA,L,14,0,5,0.0,0,2,0.0,1,2,0.5,0,5,5,1,0,0,0,0,1,-18,1,Danilo Gallinari,WAS,CHA,WAS,,,7,6,2,6
22023,201568,22300219,"NOV 20, 2023",WAS vs. MIL,L,18,2,6,0.333,0,3,0.0,0,0,0.0,1,1,2,3,0,0,0,1,4,-14,1,Danilo Gallinari,WAS,WAS,MIL,,,9,6,7,5
22023,201568,22300028,"NOV 17, 2023",WAS vs. NYK,L,17,3,7,0.429,1,3,0.333,0,0,0.0,1,5,6,1,0,2,0,3,7,-3,1,Danilo Gallinari,WAS,WAS,NYK,,,14,13,8,7
22023,201568,22300192,"NOV 15, 2023",WAS vs. DAL,L,18,3,6,0.5,0,2,0.0,4,4,1.0,2,4,6,1,0,0,2,0,10,-8,1,Danilo Gallinari,WAS,WAS,DAL,,,17,16,11,7
22023,201568,22300178,"NOV 12, 2023",WAS @ BKN,L,20,3,7,0.429,1,3,0.333,5,5,1.0,0,3,3,3,1,0,0,1,12,14,1,Danilo Gallinari,WAS,BKN,WAS,,,18,15,15,6
22023,201568,22300009,"NOV 10, 2023",WAS vs. CHA,L,18,3,6,0.5,1,4,0.25,2,2,1.0,1,0,1,4,0,0,1,1,9,9,1,Danilo Gallinari,WAS,WAS,CHA,,,14,10,13,5
22023,201568,22300157,"NOV 08, 2023",WAS @ CHA,W,20,7,11,0.636,4,7,0.571,0,2,0.0,0,4,4,2,0,1,1,3,18,18,1,Danilo Gallinari,WAS,CHA,WAS,,,24,22,20,6
22023,201568,22300148,"NOV 06, 2023",WAS @ PHI,L,4,0,2,0.0,0,2,0.0,1,1,1.0,0,1,1,0,0,0,0,0,1,-9,1,Danilo Gallinari,WAS,PHI,WAS,,,2,2,1,1
22023,201568,22300003,"NOV 03, 2023",WAS @ MIA,L,9,3,5,0.6,0,1,0.0,0,2,0.0,1,2,3,3,0,0,1,0,6,-4,1,Danilo Gallinari,WAS,MIA,WAS,,,12,9,9,6
22023,201568,22300117,"NOV 01, 2023",WAS @ ATL,L,19,4,5,0.8,0,0,0.0,0,0,0.0,1,4,5,0,0,0,0,1,8,-4,1,Danilo Gallinari,WAS,ATL,WAS,,,13,13,8,5
22023,201568,22300103,"OCT 30, 2023",WAS vs. BOS,L,16,1,5,0.2,0,2,0.0,1,2,0.5,0,2,2,2,1,0,1,0,3,-14,1,Danilo Gallinari,WAS,WAS,BOS,,,7,5,5,4
22023,201568,22300089,"OCT 28, 2023",WAS vs. MEM,W,8,2,3,0.667,0,1,0.0,1,1,1.0,0,0,0,1,1,0,0,0,5,2,1,Danilo Gallinari,WAS,WAS,MEM,,,6,5,6,1
22023,201568,22300064,"OCT 25, 2023",WAS @ IND,L,17,4,7,0.571,2,2,1.0,6,6,1.0,2,1,3,0,0,0,0,1,16,5,1,Danilo Gallinari,WAS,IND,WAS,,,19,19,16,3
22023,1629636,22300319,"DEC 14, 2023",CLE @ BOS,L,36,8,19,0.421,3,7,0.429,0,0,0.0,1,1,2,3,2,0,5,2,19,-11,1,Darius Garland,CLE,BOS,CLE,,,24,21,22,5
22023,1629636,22300305,"DEC 12, 2023",CLE @ BOS,L,38,11,23,0.478,4,8,0.5,0,0,0.0,0,2,2,7,1,0,2,1,26,-3,1,Darius Garland,CLE,BOS,CLE,,,35,28,33,9
22023,1629636,22300294,"DEC 11, 2023",CLE @ ORL,L,39,11,23,0.478,3,9,0.333,11,12,0.917,1,5,6,5,2,0,3,0,36,6,1,Darius Garland,CLE,ORL,CLE,,,47,42,41,11
22023,1629636,22301220,"DEC 08, 2023",CLE @ MIA,W,26,6,11,0.545,1,4,0.25,5,7,0.714,0,2,2,6,4,0,2,4,18,20,1,Darius Garland,CLE,MIA,CLE,,,26,20,24,8
22023,1629636,22301205,"DEC 06, 2023",CLE vs. ORL,W,40,10,18,0.556,1,4,0.25,5,5,1.0,2,1,3,9,0,0,0,1,26,8,1,Darius Garland,CLE,CLE,ORL,,,38,29,35,12
22023,1629636,22300283,"DEC 02, 2023",CLE @ DET,W,34,9,23,0.391,2,7,0.286,2,3,0.667,0,2,2,5,3,1,2,1,22,13,1,Darius Garland,CLE,DET,CLE,,,29,24,27,7
22023,1629636,22300265,"NOV 30, 2023",CLE vs. POR,L,37,6,18,0.333,2,8,0.25,1,1,1.0,1,3,4,7,1,0,8,0,15,2,1,Darius Garland,CLE,CLE,POR,,,26,19,22,11
22023,1629636,22300055,"NOV 28, 2023",CLE vs. ATL,W,38,7,15,0.467,2,5,0.4,3,4,0.75,1,1,2,8,2,0,2,1,19,22,1,Darius Garland,CLE,CLE,ATL,,,29,21,27,10
22023,1629636,22300251,"NOV 26, 2023",CLE vs. TOR,W,41,10,16,0.625,3,6,0.5,1,1,1.0,0,2,2,8,0,0,5,2,24,12,1,Darius Garland,CLE,CLE,TOR,,,34,26,32,10
22023,1629636,22300242,"NOV 25, 2023",CLE vs. LAL,L,14,2,6,0.333,0,1,0.0,2,2,1.0,0,1,1,3,1,0,2,1,6,-3,1,Darius Garland,CLE,CLE,LAL,,,10,7,9,4
22023,1629636,22300229,"NOV 22, 2023",CLE vs. MIA,L,27,6,11,0.545,1,2,0.5,1,2,0.5,0,1,1,3,1,0,3,3,14,-24,1,Darius Garland,CLE,CLE,MIA,,,18,15,17,4
22023,1629636,22300040,"NOV 21, 2023",CLE @ PHI,W,43,10,25,0.4,2,6,0.333,10,11,0.909,1,4,5,8,3,0,4,1,32,4,1,Darius Garland,CLE,PHI,CLE,,,45,37,40,13
22023,1629636,22300210,"NOV 19, 2023",CLE vs. DEN,W,33,10,16,0.625,2,4,0.5,4,5,0.8,0,3,3,6,1,1,4,0,26,18,1,Darius Garland,CLE,CLE,DEN,,,35,29,32,9
22023,1629636,22300030,"NOV 17, 2023",CLE vs. DET,W,34,10,19,0.526,2,5,0.4,6,8,0.75,1,2,3,3,0,0,5,1,28,-6,1,Darius Garland,CLE,CLE,DET,,,34,31,31,6
22023,1629636,22300191,"NOV 13, 2023",CLE @ SAC,L,34,5,14,0.357,3,8,0.375,3,4,0.75,0,3,3,6,0,0,1,1,16,-14,1,Darius Garland,CLE,SAC,CLE,,,25,19,22,9
22023,1629636,22300176,"NOV 11, 2023",CLE @ GSW,W,36,6,13,0.462,3,5,0.6,4,6,0.667,2,4,6,4,5,0,4,2,19,5,1,Darius Garland,CLE,GSW,CLE,,,29,25,23,10
22023,1629636,22300167,"NOV 08, 2023",CLE @ OKC,L,36,7,11,0.636,1,3,0.333,0,1,0.0,1,2,3,9,2,1,8,4,15,-1,1,Darius Garland,CLE,OKC,CLE,,,27,18,24,12
22023,1629636,22300142,"NOV 05, 2023",CLE vs. GSW,W,30,6,17,0.353,0,5,0.0,12,13,0.923,0,3,3,7,0,0,6,3,24,15,1,Darius Garland,CLE,CLE,GSW,,,34,27,31,10
22023,1629636,22300001,"NOV 03, 2023",CLE @ IND,L,32,5,11,0.455,0,2,0.0,4,4,1.0,0,0,0,6,2,1,4,1,14,-10,1,Darius Garland,CLE,IND,CLE,,,20,14,20,6
22023,1629636,22300067,"OCT 25, 2023",CLE @ BKN,W,32,6,12,0.5,1,5,0.2,2,2,1.0,1,1,2,5,2,0,6,2,15,6,1,Darius Garland,CLE,BKN,CLE,,,22,17,20,7
22023,1630586,22300399,"DEC 23, 2023",GSW vs. POR,W,4,0,0,0.0,0,0,0.0,0,0,0.0,0,0,0,0,1,0,0,1,0,1,1,Usman Garuba,GSW,GSW,POR,,,0,0,0,0
22023,1630586,22300386,"DEC 22, 2023",GSW vs. WAS,W,2,0,1,0.0,0,0,0.0,0,0,0.0,0,0,0,1,0,0,0,0,0,-4,1,Usman Garuba,GSW,GSW,WAS,,,1,0,1,1
22023,1630568,22300485,"JAN 05, 2024",MIN @ HOU,W,3,1,4,0.25,0,2,0.0,0,0,0.0,1,0,1,0,0,0,1,1,2,0,1,Luka Garza,MIN,HOU,MIN,,,3,3,2,1
22023,1630568,22300367,"DEC 20, 2023",MIN @ PHI,L,2,0,1,0.0,0,1,0.0,0,0,0.0,0,1,1,1,0,0,0,2,0,0,1,Luka Garza,MIN,PHI,MIN,,,2,1,1,2
22023,1630568,22301221,"DEC 08, 2023",MIN @ MEM,W,3,0,1,0.0,0,0,0.0,0,0,0.0,0,0,0,1,0,0,0,1,0,1,1,Luka Garza,MIN,MEM,MIN,,,1,0,1,1
22023,1630568,22300232,"NOV 22, 2023",MIN vs. PHI,W,2,0,1,0.0,0,1,0.0,1,2,0.5,0,1,1,0,0,0,1,0,1,-1,1,Luka Garza,MIN,MIN,PHI,,,2,2,1,1
22023,1630568,22300197,"NOV 15, 2023",MIN @ PHX,L,5,1,4,0.25,0,1,0.0,3,4,0.75,2,0,2,0,0,0,0,0,5,5,1,Luka Garza,MIN,PHX,MIN,,,7,7,5,2
22023,1630568,22300166,"NOV 08, 2023",MIN vs. NOP,W,5,2,4,0.5,0,0,0.0,1,2,0.5,1,1,2,0,0,0,0,3,5,-6,1,Luka Garza,MIN,MIN,NOP,,,7,7,5,2
22023,1630568,22300104,"OCT 30, 2023",MIN @ ATL,L,1,1,1,1.0,0,0,0.0,0,0,0.0,0,1,1,0,0,0,0,0,2,4,1,Luka Garza,MIN,ATL,MIN,,,3,3,2,1
22023,1629232,22300108,"OCT 30, 2023",NOP vs. GSW,L,7,0,4,0.0,0,2,0.0,0,0,0.0,0,1,1,0,0,0,0,0,0,-2,1,Kaiser Gates,NOP,NOP,GSW,,,1,1,0,1
22023,1641718,22300564,"JAN 15, 2024",UTA vs. IND,W,24,6,11,0.545,3,7,0.429,4,5,0.8,0,0,0,5,1,0,2,1,19,13,1,Keyonte George,UTA,UTA,IND,,,24,19,24,5
22023,1641718,22300549,"JAN 13, 2024",UTA vs. LAL,W,27,5,11,0.455,3,9,0.333,6,6,1.0,0,3,3,3,1,0,1,0,19,-6,1,Keyonte George,UTA,UTA,LAL,,,25,22,22,6
22023,1641718,22300540,"JAN 12, 2024",UTA vs. TOR,W,24,3,10,0.3,0,5,0.0,3,3,1.0,0,3,3,6,0,0,3,0,9,12,1,Keyonte George,UTA,UTA,TOR,,,18,12,15,9
22023,1641718,22300524,"JAN 10, 2024",UTA vs. DEN,W,22,2,7,0.286,1,4,0.25,1,2,0.5,0,1,1,3,1,0,1,0,6,7,1,Keyonte George,UTA,UTA,DEN,,,10,7,9,4
22023,1641718,22300510,"JAN 08, 2024",UTA @ MIL,W,22,7,13,0.538,4,9,0.444,1,1,1.0,0,6,6,4,0,0,2,0,19,7,1,Keyonte George,UTA,MIL,UTA,,,29,25,23,10
22023,1641718,22300495,"JAN 06, 2024",UTA @ PHI,W,16,2,4,0.5,0,2,0.0,2,2,1.0,0,2,2,3,0,0,2,2,6,5,1,Keyonte George,UTA,PHI,UTA,,,11,8,9,5
22023,1641718,22300479,"JAN 05, 2024",UTA @ BOS,L,20,4,10,0.4,2,7,0.286,2,2,1.0,1,3,4,1,0,0,1,0,12,-16,1,Keyonte George,UTA,BOS,UTA,,,17,16,13,5
22023,1641718,22300474,"JAN 03, 2024",UTA vs. DET,W,23,2,9,0.222,1,4,0.25,0,0,0.0,0,2,2,2,1,0,1,1,5,4,1,Keyonte George,UTA,UTA,DET,,,9,7,7,4
22023,1641718,22300457,"JAN 01, 2024",UTA vs. DAL,W,29,3,8,0.375,2,6,0.333,6,6,1.0,0,3,3,3,0,0,0,1,14,38,1,Keyonte George,UTA,UTA,DAL,,,20,17,17,6
22023,1641718,22300439,"DEC 30, 2023",UTA vs. MIA,W,28,6,10,0.6,5,8,0.625,4,5,0.8,0,6,6,2,0,0,2,3,21,14,1,Keyonte George,UTA,UTA,MIA,,,29,27,23,8
22023,1641718,22300424,"DEC 28, 2023",UTA @ NOP,L,22,1,7,0.143,1,5,0.2,1,2,0.5,0,3,3,5,0,0,2,1,4,-13,1,Keyonte George,UTA,NOP,UTA,,,12,7,9,8
22023,1641718,22300412,"DEC 26, 2023",UTA @ SAS,W,24,4,11,0.364,2,5,0.4,0,1,0.0,0,0,0,4,1,0,2,3,10,8,1,Keyonte George,UTA,SAS,UTA,,,14,10,14,4
22023,1641718,22300318,"DEC 13, 2023",UTA vs. NYK,W,4,0,1,0.0,0,1,0.0,0,0,0.0,0,0,0,0,0,0,2,1,0,0,1,Keyonte George,UTA,UTA,NYK,,,0,0,0,0
22023,1641718,22300302,"DEC 11, 2023",UTA @ OKC,L,33,10,17,0.588,5,9,0.556,5,5,1.0,0,3,3,7,1,0,3,0,30,5,1,Keyonte George,UTA,OKC,UTA,,,40,33,37,10
22023,1641718,22301225,"DEC 08, 2023",UTA vs. LAC,L,28,5,11,0.455,2,5,0.4,3,5,0.6,0,0,0,3,1,0,1,1,15,-25,1,Keyonte George,UTA,UTA,LAC,,,18,15,18,3
22023,1641718,22301213,"DEC 06, 2023",UTA @ DAL,L,32,2,11,0.182,0,4,0.0,3,4,0.75,0,4,4,11,0,1,5,0,7,-48,1,Keyonte George,UTA,DAL,UTA,,,22,11,18,15
22023,1641718,22300289,"DEC 02, 2023",UTA vs. POR,W,36,7,17,0.412,1,8,0.125,6,10,0.6,2,4,6,6,0,0,4,2,21,1,1,Keyonte George,UTA,UTA,POR,,,33,27,27,12
22023,1641718,22300270,"NOV 30, 2023",UTA @ MIN,L,33,4,19,0.211,1,6,0.167,3,3,1.0,1,3,4,4,0,0,2,2,12,-11,1,Keyonte George,UTA,MIN,UTA,,,20,16,16,8
22023,1641718,22300261,"NOV 29, 2023",UTA @ MEM,L,24,2,6,0.333,2,4,0.5,2,2,1.0,1,2,3,2,0,0,2,0,8,-7,1,Keyonte George,UTA,MEM,UTA,,,13,11,10,5
22023,1641718,22300256,"NOV 27, 2023",UTA vs. NOP,W,31,6,14,0.429,3,8,0.375,4,6,0.667,1,4,5,3,2,0,2,0,19,-1,1,Keyonte George,UTA,UTA,NOP,,,27,24,22,8
22023,1641718,22300243,"NOV 25, 2023",UTA vs. NOP,W,27,4,13,0.308,4,9,0.444,3,5,0.6,0,6,6,5,0,0,5,1,15,-2,1,Keyonte George,UTA,UTA,NOP,,,26,21,20,11
22023,1641718,22300237,"NOV 22, 2023",UTA @ POR,L,34,3,9,0.333,3,6,0.5,7,7,1.0,0,3,3,7,1,0,0,2,16,-1,1,Keyonte George,UTA,POR,UTA,,,26,19,23,10
22023,1641718,22300042,"NOV 21, 2023",UTA @ LAL,L,21,3,11,0.273,1,5,0.2,2,2,1.0,1,2,3,2,1,0,2,2,9,-21,1,Keyonte George,UTA,LAL,UTA,,,14,12,11,5
22023,1641718,22300214,"NOV 19, 2023",UTA vs. PHX,L,34,2,12,0.167,0,5,0.0,3,4,0.75,2,3,5,11,1,0,5,2,7,-9,1,Keyonte George,UTA,UTA,PHX,,,23,12,18,16
22023,1641718,22300035,"NOV 17, 2023",UTA vs. PHX,L,29,5,11,0.455,3,6,0.5,2,3,0.667,0,3,3,6,1,0,3,2,15,2,1,Keyonte George,UTA,UTA,PHX,,,24,18,21,9
22023,1641718,22300023,"NOV 14, 2023",UTA vs. POR,W,26,4,9,0.444,2,7,0.286,5,5,1.0,0,4,4,7,1,0,2,2,15,8,1,Keyonte George,UTA,UTA,POR,,,26,19,22,11
22023,1641718,22300012,"NOV 10, 2023",UTA @ MEM,W,30,2,12,0.167,1,6,0.167,2,2,1.0,0,3,3,11,0,1,2,1,7,1,1,Keyonte George,UTA,MEM,UTA,,,21,10,18,14
22023,1641718,22300158,"NOV 08, 2023",UTA @ IND,L,31,3,8,0.375,1,3,0.333,0,0,0.0,0,2,2,9,0,0,1,2,7,-11,1,Keyonte George,UTA,IND,UTA,,,18,9,16,11
22023,1641718,22300152,"NOV 06, 2023",UTA @ CHI,L,21,2,5,0.4,1,3,0.333,0,0,0.0,0,2,2,4,0,0,2,1,5,-15,1,Keyonte George,UTA,CHI,UTA,,,11,7,9,6
22023,1641718,22300138,"NOV 04, 2023",UTA @ MIN,L,27,3,6,0.5,1,4,0.25,1,2,0.5,0,0,0,4,0,0,3,2,8,-15,1,Keyonte George,UTA,MIN,UTA,,,12,8,12,4
22023,1641718,22300130,"NOV 02, 2023",UTA vs. ORL,L,17,1,2,0.5,1,1,1.0,3,5,0.6,0,2,2,3,0,0,2,1,6,-5,1,Keyonte George,UTA,UTA,ORL,,,11,8,9,5
22023,1641718,22300125,"NOV 01, 2023",UTA vs. MEM,W,23,4,8,0.5,1,4,0.25,0,0,0.0,0,1,1,3,1,1,3,0,9,10,1,Keyonte George,UTA,UTA,MEM,,,13,10,12,4
22023,1641718,22300110,"OCT 30, 2023",UTA @ DEN,L,20,1,6,0.167,1,4,0.25,0,0,0.0,1,0,1,2,1,0,0,0,3,-12,1,Keyonte George,UTA,DEN,UTA,,,6,4,5,3
22023,1641718,22300094,"OCT 28, 2023",UTA @ PHX,L,27,4,12,0.333,2,8,0.25,2,2,1.0,2,5,7,6,1,0,2,0,12,-8,1,Keyonte George,UTA,PHX,UTA,,,25,19,18,13
22023,1641718,22300085,"OCT 27, 2023",UTA vs. LAC,W,12,3,5,0.6,2,3,0.667,0,0,0.0,1,2,3,2,0,0,1,2,8,-3,1,Keyonte George,UTA,UTA,LAC,,,13,11,10,5
22023,1641718,22300072,"OCT 25, 2023",UTA vs. SAC,L,19,3,5,0.6,1,3,0.333,1,1,1.0,0,2,2,2,0,0,1,0,8,-9,1,Keyonte George,UTA,UTA,SAC,,,12,10,10,4
22023,202331,22300553,"JAN 14, 2024",LAC @ MIN,L,42,5,19,0.263,4,13,0.308,2,2,1.0,0,4,4,3,0,0,1,2,16,-6,1,Paul George,LAC,MIN,LAC,24.5,Points,23,20,19,7
22023,202331,22300553,"JAN 14, 2024",LAC @ MIN,L,42,5,19,0.263,4,13,0.308,2,2,1.0,0,4,4,3,0,0,1,2,16,-6,1,Paul George,LAC,MIN,LAC,6.0,Rebounds,23,20,19,7
22023,202331,22300553,"JAN 14, 2024",LAC @ MIN,L,42,5,19,0.263,4,13,0.308,2,2,1.0,0,4,4,3,0,0,1,2,16,-6,1,Paul George,LAC,MIN,LAC,33.5,Pts+Rebs+Asts,23,20,19,7
22023,202331,22300553,"JAN 14, 2024",LAC @ MIN,L,42,5,19,0.263,4,13,0.308,2,2,1.0,0,4,4,3,0,0,1,2,16,-6,1,Paul George,LAC,MIN,LAC,38.0,Fantasy Score,23,20,19,7
22023,202331,22300553,"JAN 14, 2024",LAC @ MIN,L,42,5,19,0.263,4,13,0.308,2,2,1.0,0,4,4,3,0,0,1,2,16,-6,1,Paul George,LAC,MIN,LAC,0.5,Offensive Rebounds,23,20,19,7
22023,202331,22300553,"JAN 14, 2024",LAC @ MIN,L,42,5,19,0.263,4,13,0.308,2,2,1.0,0,4,4,3,0,0,1,2,16,-6,1,Paul George,LAC,MIN,LAC,9.5,3-PT Attempted,23,20,19,7
22023,202331,22300553,"JAN 14, 2024",LAC @ MIN,L,42,5,19,0.263,4,13,0.308,2,2,1.0,0,4,4,3,0,0,1,2,16,-6,1,Paul George,LAC,MIN,LAC,3.5,Free Throws Made,23,20,19,7
22023,202331,22300553,"JAN 14, 2024",LAC @ MIN,L,42,5,19,0.263,4,13,0.308,2,2,1.0,0,4,4,3,0,0,1,2,16,-6,1,Paul George,LAC,MIN,LAC,19.0,FG Attempted,23,20,19,7
22023,202331,22300553,"JAN 14, 2024",LAC @ MIN,L,42,5,19,0.263,4,13,0.308,2,2,1.0,0,4,4,3,0,0,1,2,16,-6,1,Paul George,LAC,MIN,LAC,30.5,Pts+Rebs,23,20,19,7
22023,202331,22300553,"JAN 14, 2024",LAC @ MIN,L,42,5,19,0.263,4,13,0.308,2,2,1.0,0,4,4,3,0,0,1,2,16,-6,1,Paul George,LAC,MIN,LAC,27.5,Pts+Asts,23,20,19,7
22023,202331,22300553,"JAN 14, 2024",LAC @ MIN,L,42,5,19,0.263,4,13,0.308,2,2,1.0,0,4,4,3,0,0,1,2,16,-6,1,Paul George,LAC,MIN,LAC,9.0,Rebs+Asts,23,20,19,7
22023,202331,22300537,"JAN 12, 2024",LAC @ MEM,W,35,12,18,0.667,7,10,0.7,6,6,1.0,0,3,3,1,2,0,4,3,37,18,1,Paul George,LAC,MEM,LAC,24.5,Points,41,40,38,4
22023,202331,22300537,"JAN 12, 2024",LAC @ MEM,W,35,12,18,0.667,7,10,0.7,6,6,1.0,0,3,3,1,2,0,4,3,37,18,1,Paul George,LAC,MEM,LAC,6.0,Rebounds,41,40,38,4
22023,202331,22300537,"JAN 12, 2024",LAC @ MEM,W,35,12,18,0.667,7,10,0.7,6,6,1.0,0,3,3,1,2,0,4,3,37,18,1,Paul George,LAC,MEM,LAC,33.5,Pts+Rebs+Asts,41,40,38,4
22023,202331,22300537,"JAN 12, 2024",LAC @ MEM,W,35,12,18,0.667,7,10,0.7,6,6,1.0,0,3,3,1,2,0,4,3,37,18,1,Paul George,LAC,MEM,LAC,38.0,Fantasy Score,41,40,38,4
22023,202331,22300537,"JAN 12, 2024",LAC @ MEM,W,35,12,18,0.667,7,10,0.7,6,6,1.0,0,3,3,1,2,0,4,3,37,18,1,Paul George,LAC,MEM,LAC,0.5,Offensive Rebounds,41,40,38,4
22023,202331,22300537,"JAN 12, 2024",LAC @ MEM,W,35,12,18,0.667,7,10,0.7,6,6,1.0,0,3,3,1,2,0,4,3,37,18,1,Paul George,LAC,MEM,LAC,9.5,3-PT Attempted,41,40,38,4
22023,202331,22300537,"JAN 12, 2024",LAC @ MEM,W,35,12,18,0.667,7,10,0.7,6,6,1.0,0,3,3,1,2,0,4,3,37,18,1,Paul George,LAC,MEM,LAC,3.5,Free Throws Made,41,40,38,4
22023,202331,22300537,"JAN 12, 2024",LAC @ MEM,W,35,12,18,0.667,7,10,0.7,6,6,1.0,0,3,3,1,2,0,4,3,37,18,1,Paul George,LAC,MEM,LAC,19.0,FG Attempted,41,40,38,4
22023,202331,22300537,"JAN 12, 2024",LAC @ MEM,W,35,12,18,0.667,7,10,0.7,6,6,1.0,0,3,3,1,2,0,4,3,37,18,1,Paul George,LAC,MEM,LAC,30.5,Pts+Rebs,41,40,38,4
22023,202331,22300537,"JAN 12, 2024",LAC @ MEM,W,35,12,18,0.667,7,10,0.7,6,6,1.0,0,3,3,1,2,0,4,3,37,18,1,Paul George,LAC,MEM,LAC,27.5,Pts+Asts,41,40,38,4
22023,202331,22300537,"JAN 12, 2024",LAC @ MEM,W,35,12,18,0.667,7,10,0.7,6,6,1.0,0,3,3,1,2,0,4,3,37,18,1,Paul George,LAC,MEM,LAC,9.0,Rebs+Asts,41,40,38,4
22023,202331,22300526,"JAN 10, 2024",LAC vs. TOR,W,38,12,22,0.545,5,9,0.556,0,0,0.0,0,7,7,6,2,1,0,4,29,15,1,Paul George,LAC,LAC,TOR,24.5,Points,42,36,35,13
22023,202331,22300526,"JAN 10, 2024",LAC vs. TOR,W,38,12,22,0.545,5,9,0.556,0,0,0.0,0,7,7,6,2,1,0,4,29,15,1,Paul George,LAC,LAC,TOR,6.0,Rebounds,42,36,35,13
22023,202331,22300526,"JAN 10, 2024",LAC vs. TOR,W,38,12,22,0.545,5,9,0.556,0,0,0.0,0,7,7,6,2,1,0,4,29,15,1,Paul George,LAC,LAC,TOR,33.5,Pts+Rebs+Asts,42,36,35,13
22023,202331,22300526,"JAN 10, 2024",LAC vs. TOR,W,38,12,22,0.545,5,9,0.556,0,0,0.0,0,7,7,6,2,1,0,4,29,15,1,Paul George,LAC,LAC,TOR,38.0,Fantasy Score,42,36,35,13
22023,202331,22300526,"JAN 10, 2024",LAC vs. TOR,W,38,12,22,0.545,5,9,0.556,0,0,0.0,0,7,7,6,2,1,0,4,29,15,1,Paul George,LAC,LAC,TOR,0.5,Offensive Rebounds,42,36,35,13
22023,202331,22300526,"JAN 10, 2024",LAC vs. TOR,W,38,12,22,0.545,5,9,0.556,0,0,0.0,0,7,7,6,2,1,0,4,29,15,1,Paul George,LAC,LAC,TOR,9.5,3-PT Attempted,42,36,35,13
22023,202331,22300526,"JAN 10, 2024",LAC vs. TOR,W,38,12,22,0.545,5,9,0.556,0,0,0.0,0,7,7,6,2,1,0,4,29,15,1,Paul George,LAC,LAC,TOR,3.5,Free Throws Made,42,36,35,13
22023,202331,22300526,"JAN 10, 2024",LAC vs. TOR,W,38,12,22,0.545,5,9,0.556,0,0,0.0,0,7,7,6,2,1,0,4,29,15,1,Paul George,LAC,LAC,TOR,19.0,FG Attempted,42,36,35,13
22023,202331,22300526,"JAN 10, 2024",LAC vs. TOR,W,38,12,22,0.545,5,9,0.556,0,0,0.0,0,7,7,6,2,1,0,4,29,15,1,Paul George,LAC,LAC,TOR,30.5,Pts+Rebs,42,36,35,13
22023,202331,22300526,"JAN 10, 2024",LAC vs. TOR,W,38,12,22,0.545,5,9,0.556,0,0,0.0,0,7,7,6,2,1,0,4,29,15,1,Paul George,LAC,LAC,TOR,27.5,Pts+Asts,42,36,35,13
22023,202331,22300526,"JAN 10, 2024",LAC vs. TOR,W,38,12,22,0.545,5,9,0.556,0,0,0.0,0,7,7,6,2,1,0,4,29,15,1,Paul George,LAC,LAC,TOR,9.0,Rebs+Asts,42,36,35,13
22023,202331,22300511,"JAN 08, 2024",LAC vs. PHX,W,31,10,19,0.526,4,9,0.444,1,2,0.5,1,6,7,0,1,0,1,2,25,21,1,Paul George,LAC,LAC,PHX,24.5,Points,32,32,25,7
22023,202331,22300511,"JAN 08, 2024",LAC vs. PHX,W,31,10,19,0.526,4,9,0.444,1,2,0.5,1,6,7,0,1,0,1,2,25,21,1,Paul George,LAC,LAC,PHX,6.0,Rebounds,32,32,25,7
22023,202331,22300511,"JAN 08, 2024",LAC vs. PHX,W,31,10,19,0.526,4,9,0.444,1,2,0.5,1,6,7,0,1,0,1,2,25,21,1,Paul George,LAC,LAC,PHX,33.5,Pts+Rebs+Asts,32,32,25,7
22023,202331,22300511,"JAN 08, 2024",LAC vs. PHX,W,31,10,19,0.526,4,9,0.444,1,2,0.5,1,6,7,0,1,0,1,2,25,21,1,Paul George,LAC,LAC,PHX,38.0,Fantasy Score,32,32,25,7
22023,202331,22300511,"JAN 08, 2024",LAC vs. PHX,W,31,10,19,0.526,4,9,0.444,1,2,0.5,1,6,7,0,1,0,1,2,25,21,1,Paul George,LAC,LAC,PHX,0.5,Offensive Rebounds,32,32,25,7
22023,202331,22300511,"JAN 08, 2024",LAC vs. PHX,W,31,10,19,0.526,4,9,0.444,1,2,0.5,1,6,7,0,1,0,1,2,25,21,1,Paul George,LAC,LAC,PHX,9.5,3-PT Attempted,32,32,25,7
22023,202331,22300511,"JAN 08, 2024",LAC vs. PHX,W,31,10,19,0.526,4,9,0.444,1,2,0.5,1,6,7,0,1,0,1,2,25,21,1,Paul George,LAC,LAC,PHX,3.5,Free Throws Made,32,32,25,7
22023,202331,22300511,"JAN 08, 2024",LAC vs. PHX,W,31,10,19,0.526,4,9,0.444,1,2,0.5,1,6,7,0,1,0,1,2,25,21,1,Paul George,LAC,LAC,PHX,19.0,FG Attempted,32,32,25,7
22023,202331,22300511,"JAN 08, 2024",LAC vs. PHX,W,31,10,19,0.526,4,9,0.444,1,2,0.5,1,6,7,0,1,0,1,2,25,21,1,Paul George,LAC,LAC,PHX,30.5,Pts+Rebs,32,32,25,7
22023,202331,22300511,"JAN 08, 2024",LAC vs. PHX,W,31,10,19,0.526,4,9,0.444,1,2,0.5,1,6,7,0,1,0,1,2,25,21,1,Paul George,LAC,LAC,PHX,27.5,Pts+Asts,32,32,25,7
22023,202331,22300511,"JAN 08, 2024",LAC vs. PHX,W,31,10,19,0.526,4,9,0.444,1,2,0.5,1,6,7,0,1,0,1,2,25,21,1,Paul George,LAC,LAC,PHX,9.0,Rebs+Asts,32,32,25,7
22023,202331,22300505,"JAN 07, 2024",LAC @ LAL,L,38,8,18,0.444,4,11,0.364,2,2,1.0,0,4,4,3,5,1,3,4,22,3,1,Paul George,LAC,LAL,LAC,24.5,Points,29,26,25,7
22023,202331,22300505,"JAN 07, 2024",LAC @ LAL,L,38,8,18,0.444,4,11,0.364,2,2,1.0,0,4,4,3,5,1,3,4,22,3,1,Paul George,LAC,LAL,LAC,6.0,Rebounds,29,26,25,7
22023,202331,22300505,"JAN 07, 2024",LAC @ LAL,L,38,8,18,0.444,4,11,0.364,2,2,1.0,0,4,4,3,5,1,3,4,22,3,1,Paul George,LAC,LAL,LAC,33.5,Pts+Rebs+Asts,29,26,25,7
22023,202331,22300505,"JAN 07, 2024",LAC @ LAL,L,38,8,18,0.444,4,11,0.364,2,2,1.0,0,4,4,3,5,1,3,4,22,3,1,Paul George,LAC,LAL,LAC,38.0,Fantasy Score,29,26,25,7
22023,202331,22300505,"JAN 07, 2024",LAC @ LAL,L,38,8,18,0.444,4,11,0.364,2,2,1.0,0,4,4,3,5,1,3,4,22,3,1,Paul George,LAC,LAL,LAC,0.5,Offensive Rebounds,29,26,25,7
22023,202331,22300505,"JAN 07, 2024",LAC @ LAL,L,38,8,18,0.444,4,11,0.364,2,2,1.0,0,4,4,3,5,1,3,4,22,3,1,Paul George,LAC,LAL,LAC,9.5,3-PT Attempted,29,26,25,7
22023,202331,22300505,"JAN 07, 2024",LAC @ LAL,L,38,8,18,0.444,4,11,0.364,2,2,1.0,0,4,4,3,5,1,3,4,22,3,1,Paul George,LAC,LAL,LAC,3.5,Free Throws Made,29,26,25,7
22023,202331,22300505,"JAN 07, 2024",LAC @ LAL,L,38,8,18,0.444,4,11,0.364,2,2,1.0,0,4,4,3,5,1,3,4,22,3,1,Paul George,LAC,LAL,LAC,19.0,FG Attempted,29,26,25,7
22023,202331,22300505,"JAN 07, 2024",LAC @ LAL,L,38,8,18,0.444,4,11,0.364,2,2,1.0,0,4,4,3,5,1,3,4,22,3,1,Paul George,LAC,LAL,LAC,30.5,Pts+Rebs,29,26,25,7
22023,202331,22300505,"JAN 07, 2024",LAC @ LAL,L,38,8,18,0.444,4,11,0.364,2,2,1.0,0,4,4,3,5,1,3,4,22,3,1,Paul George,LAC,LAL,LAC,27.5,Pts+Asts,29,26,25,7
22023,202331,22300505,"JAN 07, 2024",LAC @ LAL,L,38,8,18,0.444,4,11,0.364,2,2,1.0,0,4,4,3,5,1,3,4,22,3,1,Paul George,LAC,LAL,LAC,9.0,Rebs+Asts,29,26,25,7
22023,202331,22300486,"JAN 05, 2024",LAC @ NOP,W,30,9,15,0.6,6,10,0.6,0,0,0.0,0,7,7,1,0,1,2,2,24,22,1,Paul George,LAC,NOP,LAC,24.5,Points,32,31,25,8
22023,202331,22300486,"JAN 05, 2024",LAC @ NOP,W,30,9,15,0.6,6,10,0.6,0,0,0.0,0,7,7,1,0,1,2,2,24,22,1,Paul George,LAC,NOP,LAC,6.0,Rebounds,32,31,25,8
22023,202331,22300486,"JAN 05, 2024",LAC @ NOP,W,30,9,15,0.6,6,10,0.6,0,0,0.0,0,7,7,1,0,1,2,2,24,22,1,Paul George,LAC,NOP,LAC,33.5,Pts+Rebs+Asts,32,31,25,8
22023,202331,22300486,"JAN 05, 2024",LAC @ NOP,W,30,9,15,0.6,6,10,0.6,0,0,0.0,0,7,7,1,0,1,2,2,24,22,1,Paul George,LAC,NOP,LAC,38.0,Fantasy Score,32,31,25,8
22023,202331,22300486,"JAN 05, 2024",LAC @ NOP,W,30,9,15,0.6,6,10,0.6,0,0,0.0,0,7,7,1,0,1,2,2,24,22,1,Paul George,LAC,NOP,LAC,0.5,Offensive Rebounds,32,31,25,8
22023,202331,22300486,"JAN 05, 2024",LAC @ NOP,W,30,9,15,0.6,6,10,0.6,0,0,0.0,0,7,7,1,0,1,2,2,24,22,1,Paul George,LAC,NOP,LAC,9.5,3-PT Attempted,32,31,25,8
22023,202331,22300486,"JAN 05, 2024",LAC @ NOP,W,30,9,15,0.6,6,10,0.6,0,0,0.0,0,7,7,1,0,1,2,2,24,22,1,Paul George,LAC,NOP,LAC,3.5,Free Throws Made,32,31,25,8
22023,202331,22300486,"JAN 05, 2024",LAC @ NOP,W,30,9,15,0.6,6,10,0.6,0,0,0.0,0,7,7,1,0,1,2,2,24,22,1,Paul George,LAC,NOP,LAC,19.0,FG Attempted,32,31,25,8
22023,202331,22300486,"JAN 05, 2024",LAC @ NOP,W,30,9,15,0.6,6,10,0.6,0,0,0.0,0,7,7,1,0,1,2,2,24,22,1,Paul George,LAC,NOP,LAC,30.5,Pts+Rebs,32,31,25,8
22023,202331,22300486,"JAN 05, 2024",LAC @ NOP,W,30,9,15,0.6,6,10,0.6,0,0,0.0,0,7,7,1,0,1,2,2,24,22,1,Paul George,LAC,NOP,LAC,27.5,Pts+Asts,32,31,25,8
22023,202331,22300486,"JAN 05, 2024",LAC @ NOP,W,30,9,15,0.6,6,10,0.6,0,0,0.0,0,7,7,1,0,1,2,2,24,22,1,Paul George,LAC,NOP,LAC,9.0,Rebs+Asts,32,31,25,8
22023,202331,22300473,"JAN 03, 2024",LAC @ PHX,W,37,8,14,0.571,5,10,0.5,12,14,0.857,2,5,7,3,2,0,1,3,33,12,1,Paul George,LAC,PHX,LAC,24.5,Points,43,40,36,10
22023,202331,22300473,"JAN 03, 2024",LAC @ PHX,W,37,8,14,0.571,5,10,0.5,12,14,0.857,2,5,7,3,2,0,1,3,33,12,1,Paul George,LAC,PHX,LAC,6.0,Rebounds,43,40,36,10
22023,202331,22300473,"JAN 03, 2024",LAC @ PHX,W,37,8,14,0.571,5,10,0.5,12,14,0.857,2,5,7,3,2,0,1,3,33,12,1,Paul George,LAC,PHX,LAC,33.5,Pts+Rebs+Asts,43,40,36,10
22023,202331,22300473,"JAN 03, 2024",LAC @ PHX,W,37,8,14,0.571,5,10,0.5,12,14,0.857,2,5,7,3,2,0,1,3,33,12,1,Paul George,LAC,PHX,LAC,38.0,Fantasy Score,43,40,36,10
22023,202331,22300473,"JAN 03, 2024",LAC @ PHX,W,37,8,14,0.571,5,10,0.5,12,14,0.857,2,5,7,3,2,0,1,3,33,12,1,Paul George,LAC,PHX,LAC,0.5,Offensive Rebounds,43,40,36,10
22023,202331,22300473,"JAN 03, 2024",LAC @ PHX,W,37,8,14,0.571,5,10,0.5,12,14,0.857,2,5,7,3,2,0,1,3,33,12,1,Paul George,LAC,PHX,LAC,9.5,3-PT Attempted,43,40,36,10
22023,202331,22300473,"JAN 03, 2024",LAC @ PHX,W,37,8,14,0.571,5,10,0.5,12,14,0.857,2,5,7,3,2,0,1,3,33,12,1,Paul George,LAC,PHX,LAC,3.5,Free Throws Made,43,40,36,10
22023,202331,22300473,"JAN 03, 2024",LAC @ PHX,W,37,8,14,0.571,5,10,0.5,12,14,0.857,2,5,7,3,2,0,1,3,33,12,1,Paul George,LAC,PHX,LAC,19.0,FG Attempted,43,40,36,10
22023,202331,22300473,"JAN 03, 2024",LAC @ PHX,W,37,8,14,0.571,5,10,0.5,12,14,0.857,2,5,7,3,2,0,1,3,33,12,1,Paul George,LAC,PHX,LAC,30.5,Pts+Rebs,43,40,36,10
22023,202331,22300473,"JAN 03, 2024",LAC @ PHX,W,37,8,14,0.571,5,10,0.5,12,14,0.857,2,5,7,3,2,0,1,3,33,12,1,Paul George,LAC,PHX,LAC,27.5,Pts+Asts,43,40,36,10
22023,202331,22300473,"JAN 03, 2024",LAC @ PHX,W,37,8,14,0.571,5,10,0.5,12,14,0.857,2,5,7,3,2,0,1,3,33,12,1,Paul George,LAC,PHX,LAC,9.0,Rebs+Asts,43,40,36,10
22023,202331,22300458,"JAN 01, 2024",LAC vs. MIA,W,34,7,14,0.5,3,8,0.375,6,6,1.0,0,3,3,2,1,0,3,4,23,14,1,Paul George,LAC,LAC,MIA,24.5,Points,28,26,25,5
22023,202331,22300458,"JAN 01, 2024",LAC vs. MIA,W,34,7,14,0.5,3,8,0.375,6,6,1.0,0,3,3,2,1,0,3,4,23,14,1,Paul George,LAC,LAC,MIA,6.0,Rebounds,28,26,25,5
22023,202331,22300458,"JAN 01, 2024",LAC vs. MIA,W,34,7,14,0.5,3,8,0.375,6,6,1.0,0,3,3,2,1,0,3,4,23,14,1,Paul George,LAC,LAC,MIA,33.5,Pts+Rebs+Asts,28,26,25,5
22023,202331,22300458,"JAN 01, 2024",LAC vs. MIA,W,34,7,14,0.5,3,8,0.375,6,6,1.0,0,3,3,2,1,0,3,4,23,14,1,Paul George,LAC,LAC,MIA,38.0,Fantasy Score,28,26,25,5
22023,202331,22300458,"JAN 01, 2024",LAC vs. MIA,W,34,7,14,0.5,3,8,0.375,6,6,1.0,0,3,3,2,1,0,3,4,23,14,1,Paul George,LAC,LAC,MIA,0.5,Offensive Rebounds,28,26,25,5
22023,202331,22300458,"JAN 01, 2024",LAC vs. MIA,W,34,7,14,0.5,3,8,0.375,6,6,1.0,0,3,3,2,1,0,3,4,23,14,1,Paul George,LAC,LAC,MIA,9.5,3-PT Attempted,28,26,25,5
22023,202331,22300458,"JAN 01, 2024",LAC vs. MIA,W,34,7,14,0.5,3,8,0.375,6,6,1.0,0,3,3,2,1,0,3,4,23,14,1,Paul George,LAC,LAC,MIA,3.5,Free Throws Made,28,26,25,5
22023,202331,22300458,"JAN 01, 2024",LAC vs. MIA,W,34,7,14,0.5,3,8,0.375,6,6,1.0,0,3,3,2,1,0,3,4,23,14,1,Paul George,LAC,LAC,MIA,19.0,FG Attempted,28,26,25,5
22023,202331,22300458,"JAN 01, 2024",LAC vs. MIA,W,34,7,14,0.5,3,8,0.375,6,6,1.0,0,3,3,2,1,0,3,4,23,14,1,Paul George,LAC,LAC,MIA,30.5,Pts+Rebs,28,26,25,5
22023,202331,22300458,"JAN 01, 2024",LAC vs. MIA,W,34,7,14,0.5,3,8,0.375,6,6,1.0,0,3,3,2,1,0,3,4,23,14,1,Paul George,LAC,LAC,MIA,27.5,Pts+Asts,28,26,25,5
22023,202331,22300458,"JAN 01, 2024",LAC vs. MIA,W,34,7,14,0.5,3,8,0.375,6,6,1.0,0,3,3,2,1,0,3,4,23,14,1,Paul George,LAC,LAC,MIA,9.0,Rebs+Asts,28,26,25,5
22023,202331,22300438,"DEC 29, 2023",LAC vs. MEM,W,36,8,21,0.381,2,8,0.25,5,6,0.833,1,6,7,3,1,0,4,6,23,2,1,Paul George,LAC,LAC,MEM,24.5,Points,33,30,26,10
22023,202331,22300438,"DEC 29, 2023",LAC vs. MEM,W,36,8,21,0.381,2,8,0.25,5,6,0.833,1,6,7,3,1,0,4,6,23,2,1,Paul George,LAC,LAC,MEM,6.0,Rebounds,33,30,26,10
22023,202331,22300438,"DEC 29, 2023",LAC vs. MEM,W,36,8,21,0.381,2,8,0.25,5,6,0.833,1,6,7,3,1,0,4,6,23,2,1,Paul George,LAC,LAC,MEM,33.5,Pts+Rebs+Asts,33,30,26,10
22023,202331,22300438,"DEC 29, 2023",LAC vs. MEM,W,36,8,21,0.381,2,8,0.25,5,6,0.833,1,6,7,3,1,0,4,6,23,2,1,Paul George,LAC,LAC,MEM,38.0,Fantasy Score,33,30,26,10
22023,202331,22300438,"DEC 29, 2023",LAC vs. MEM,W,36,8,21,0.381,2,8,0.25,5,6,0.833,1,6,7,3,1,0,4,6,23,2,1,Paul George,LAC,LAC,MEM,0.5,Offensive Rebounds,33,30,26,10
22023,202331,22300438,"DEC 29, 2023",LAC vs. MEM,W,36,8,21,0.381,2,8,0.25,5,6,0.833,1,6,7,3,1,0,4,6,23,2,1,Paul George,LAC,LAC,MEM,9.5,3-PT Attempted,33,30,26,10
22023,202331,22300438,"DEC 29, 2023",LAC vs. MEM,W,36,8,21,0.381,2,8,0.25,5,6,0.833,1,6,7,3,1,0,4,6,23,2,1,Paul George,LAC,LAC,MEM,3.5,Free Throws Made,33,30,26,10
22023,202331,22300438,"DEC 29, 2023",LAC vs. MEM,W,36,8,21,0.381,2,8,0.25,5,6,0.833,1,6,7,3,1,0,4,6,23,2,1,Paul George,LAC,LAC,MEM,19.0,FG Attempted,33,30,26,10
22023,202331,22300438,"DEC 29, 2023",LAC vs. MEM,W,36,8,21,0.381,2,8,0.25,5,6,0.833,1,6,7,3,1,0,4,6,23,2,1,Paul George,LAC,LAC,MEM,30.5,Pts+Rebs,33,30,26,10
22023,202331,22300438,"DEC 29, 2023",LAC vs. MEM,W,36,8,21,0.381,2,8,0.25,5,6,0.833,1,6,7,3,1,0,4,6,23,2,1,Paul George,LAC,LAC,MEM,27.5,Pts+Asts,33,30,26,10
22023,202331,22300438,"DEC 29, 2023",LAC vs. MEM,W,36,8,21,0.381,2,8,0.25,5,6,0.833,1,6,7,3,1,0,4,6,23,2,1,Paul George,LAC,LAC,MEM,9.0,Rebs+Asts,33,30,26,10
22023,202331,22300414,"DEC 26, 2023",LAC vs. CHA,W,37,10,25,0.4,5,11,0.455,0,0,0.0,2,2,4,4,0,0,3,4,25,9,1,Paul George,LAC,LAC,CHA,24.5,Points,33,29,29,8
22023,202331,22300414,"DEC 26, 2023",LAC vs. CHA,W,37,10,25,0.4,5,11,0.455,0,0,0.0,2,2,4,4,0,0,3,4,25,9,1,Paul George,LAC,LAC,CHA,6.0,Rebounds,33,29,29,8
22023,202331,22300414,"DEC 26, 2023",LAC vs. CHA,W,37,10,25,0.4,5,11,0.455,0,0,0.0,2,2,4,4,0,0,3,4,25,9,1,Paul George,LAC,LAC,CHA,33.5,Pts+Rebs+Asts,33,29,29,8
22023,202331,22300414,"DEC 26, 2023",LAC vs. CHA,W,37,10,25,0.4,5,11,0.455,0,0,0.0,2,2,4,4,0,0,3,4,25,9,1,Paul George,LAC,LAC,CHA,38.0,Fantasy Score,33,29,29,8
22023,202331,22300414,"DEC 26, 2023",LAC vs. CHA,W,37,10,25,0.4,5,11,0.455,0,0,0.0,2,2,4,4,0,0,3,4,25,9,1,Paul George,LAC,LAC,CHA,0.5,Offensive Rebounds,33,29,29,8
22023,202331,22300414,"DEC 26, 2023",LAC vs. CHA,W,37,10,25,0.4,5,11,0.455,0,0,0.0,2,2,4,4,0,0,3,4,25,9,1,Paul George,LAC,LAC,CHA,9.5,3-PT Attempted,33,29,29,8
22023,202331,22300414,"DEC 26, 2023",LAC vs. CHA,W,37,10,25,0.4,5,11,0.455,0,0,0.0,2,2,4,4,0,0,3,4,25,9,1,Paul George,LAC,LAC,CHA,3.5,Free Throws Made,33,29,29,8
22023,202331,22300414,"DEC 26, 2023",LAC vs. CHA,W,37,10,25,0.4,5,11,0.455,0,0,0.0,2,2,4,4,0,0,3,4,25,9,1,Paul George,LAC,LAC,CHA,19.0,FG Attempted,33,29,29,8
22023,202331,22300414,"DEC 26, 2023",LAC vs. CHA,W,37,10,25,0.4,5,11,0.455,0,0,0.0,2,2,4,4,0,0,3,4,25,9,1,Paul George,LAC,LAC,CHA,30.5,Pts+Rebs,33,29,29,8
22023,202331,22300414,"DEC 26, 2023",LAC vs. CHA,W,37,10,25,0.4,5,11,0.455,0,0,0.0,2,2,4,4,0,0,3,4,25,9,1,Paul George,LAC,LAC,CHA,27.5,Pts+Asts,33,29,29,8
22023,202331,22300414,"DEC 26, 2023",LAC vs. CHA,W,37,10,25,0.4,5,11,0.455,0,0,0.0,2,2,4,4,0,0,3,4,25,9,1,Paul George,LAC,LAC,CHA,9.0,Rebs+Asts,33,29,29,8
22023,202331,22300389,"DEC 23, 2023",LAC vs. BOS,L,30,9,17,0.529,3,7,0.429,0,0,0.0,1,2,3,2,1,2,1,1,21,-27,1,Paul George,LAC,LAC,BOS,24.5,Points,26,24,23,5
22023,202331,22300389,"DEC 23, 2023",LAC vs. BOS,L,30,9,17,0.529,3,7,0.429,0,0,0.0,1,2,3,2,1,2,1,1,21,-27,1,Paul George,LAC,LAC,BOS,6.0,Rebounds,26,24,23,5
22023,202331,22300389,"DEC 23, 2023",LAC vs. BOS,L,30,9,17,0.529,3,7,0.429,0,0,0.0,1,2,3,2,1,2,1,1,21,-27,1,Paul George,LAC,LAC,BOS,33.5,Pts+Rebs+Asts,26,24,23,5
22023,202331,22300389,"DEC 23, 2023",LAC vs. BOS,L,30,9,17,0.529,3,7,0.429,0,0,0.0,1,2,3,2,1,2,1,1,21,-27,1,Paul George,LAC,LAC,BOS,38.0,Fantasy Score,26,24,23,5
22023,202331,22300389,"DEC 23, 2023",LAC vs. BOS,L,30,9,17,0.529,3,7,0.429,0,0,0.0,1,2,3,2,1,2,1,1,21,-27,1,Paul George,LAC,LAC,BOS,0.5,Offensive Rebounds,26,24,23,5
22023,202331,22300389,"DEC 23, 2023",LAC vs. BOS,L,30,9,17,0.529,3,7,0.429,0,0,0.0,1,2,3,2,1,2,1,1,21,-27,1,Paul George,LAC,LAC,BOS,9.5,3-PT Attempted,26,24,23,5
22023,202331,22300389,"DEC 23, 2023",LAC vs. BOS,L,30,9,17,0.529,3,7,0.429,0,0,0.0,1,2,3,2,1,2,1,1,21,-27,1,Paul George,LAC,LAC,BOS,3.5,Free Throws Made,26,24,23,5
22023,202331,22300389,"DEC 23, 2023",LAC vs. BOS,L,30,9,17,0.529,3,7,0.429,0,0,0.0,1,2,3,2,1,2,1,1,21,-27,1,Paul George,LAC,LAC,BOS,19.0,FG Attempted,26,24,23,5
22023,202331,22300389,"DEC 23, 2023",LAC vs. BOS,L,30,9,17,0.529,3,7,0.429,0,0,0.0,1,2,3,2,1,2,1,1,21,-27,1,Paul George,LAC,LAC,BOS,30.5,Pts+Rebs,26,24,23,5
22023,202331,22300389,"DEC 23, 2023",LAC vs. BOS,L,30,9,17,0.529,3,7,0.429,0,0,0.0,1,2,3,2,1,2,1,1,21,-27,1,Paul George,LAC,LAC,BOS,27.5,Pts+Asts,26,24,23,5
22023,202331,22300389,"DEC 23, 2023",LAC vs. BOS,L,30,9,17,0.529,3,7,0.429,0,0,0.0,1,2,3,2,1,2,1,1,21,-27,1,Paul George,LAC,LAC,BOS,9.0,Rebs+Asts,26,24,23,5
22023,202331,22300379,"DEC 21, 2023",LAC @ OKC,L,29,7,14,0.5,5,8,0.625,3,3,1.0,0,4,4,4,1,1,1,4,22,-13,1,Paul George,LAC,OKC,LAC,24.5,Points,30,26,26,8
22023,202331,22300379,"DEC 21, 2023",LAC @ OKC,L,29,7,14,0.5,5,8,0.625,3,3,1.0,0,4,4,4,1,1,1,4,22,-13,1,Paul George,LAC,OKC,LAC,6.0,Rebounds,30,26,26,8
22023,202331,22300379,"DEC 21, 2023",LAC @ OKC,L,29,7,14,0.5,5,8,0.625,3,3,1.0,0,4,4,4,1,1,1,4,22,-13,1,Paul George,LAC,OKC,LAC,33.5,Pts+Rebs+Asts,30,26,26,8
22023,202331,22300379,"DEC 21, 2023",LAC @ OKC,L,29,7,14,0.5,5,8,0.625,3,3,1.0,0,4,4,4,1,1,1,4,22,-13,1,Paul George,LAC,OKC,LAC,38.0,Fantasy Score,30,26,26,8
22023,202331,22300379,"DEC 21, 2023",LAC @ OKC,L,29,7,14,0.5,5,8,0.625,3,3,1.0,0,4,4,4,1,1,1,4,22,-13,1,Paul George,LAC,OKC,LAC,0.5,Offensive Rebounds,30,26,26,8
22023,202331,22300379,"DEC 21, 2023",LAC @ OKC,L,29,7,14,0.5,5,8,0.625,3,3,1.0,0,4,4,4,1,1,1,4,22,-13,1,Paul George,LAC,OKC,LAC,9.5,3-PT Attempted,30,26,26,8
22023,202331,22300379,"DEC 21, 2023",LAC @ OKC,L,29,7,14,0.5,5,8,0.625,3,3,1.0,0,4,4,4,1,1,1,4,22,-13,1,Paul George,LAC,OKC,LAC,3.5,Free Throws Made,30,26,26,8
22023,202331,22300379,"DEC 21, 2023",LAC @ OKC,L,29,7,14,0.5,5,8,0.625,3,3,1.0,0,4,4,4,1,1,1,4,22,-13,1,Paul George,LAC,OKC,LAC,19.0,FG Attempted,30,26,26,8
22023,202331,22300379,"DEC 21, 2023",LAC @ OKC,L,29,7,14,0.5,5,8,0.625,3,3,1.0,0,4,4,4,1,1,1,4,22,-13,1,Paul George,LAC,OKC,LAC,30.5,Pts+Rebs,30,26,26,8
22023,202331,22300379,"DEC 21, 2023",LAC @ OKC,L,29,7,14,0.5,5,8,0.625,3,3,1.0,0,4,4,4,1,1,1,4,22,-13,1,Paul George,LAC,OKC,LAC,27.5,Pts+Asts,30,26,26,8
22023,202331,22300379,"DEC 21, 2023",LAC @ OKC,L,29,7,14,0.5,5,8,0.625,3,3,1.0,0,4,4,4,1,1,1,4,22,-13,1,Paul George,LAC,OKC,LAC,9.0,Rebs+Asts,30,26,26,8
22023,202331,22300350,"DEC 18, 2023",LAC @ IND,W,31,9,21,0.429,5,11,0.455,4,4,1.0,0,3,3,4,1,1,1,3,27,22,1,Paul George,LAC,IND,LAC,24.5,Points,34,30,31,7
22023,202331,22300350,"DEC 18, 2023",LAC @ IND,W,31,9,21,0.429,5,11,0.455,4,4,1.0,0,3,3,4,1,1,1,3,27,22,1,Paul George,LAC,IND,LAC,6.0,Rebounds,34,30,31,7
22023,202331,22300350,"DEC 18, 2023",LAC @ IND,W,31,9,21,0.429,5,11,0.455,4,4,1.0,0,3,3,4,1,1,1,3,27,22,1,Paul George,LAC,IND,LAC,33.5,Pts+Rebs+Asts,34,30,31,7
22023,202331,22300350,"DEC 18, 2023",LAC @ IND,W,31,9,21,0.429,5,11,0.455,4,4,1.0,0,3,3,4,1,1,1,3,27,22,1,Paul George,LAC,IND,LAC,38.0,Fantasy Score,34,30,31,7
22023,202331,22300350,"DEC 18, 2023",LAC @ IND,W,31,9,21,0.429,5,11,0.455,4,4,1.0,0,3,3,4,1,1,1,3,27,22,1,Paul George,LAC,IND,LAC,0.5,Offensive Rebounds,34,30,31,7
22023,202331,22300350,"DEC 18, 2023",LAC @ IND,W,31,9,21,0.429,5,11,0.455,4,4,1.0,0,3,3,4,1,1,1,3,27,22,1,Paul George,LAC,IND,LAC,9.5,3-PT Attempted,34,30,31,7
22023,202331,22300350,"DEC 18, 2023",LAC @ IND,W,31,9,21,0.429,5,11,0.455,4,4,1.0,0,3,3,4,1,1,1,3,27,22,1,Paul George,LAC,IND,LAC,3.5,Free Throws Made,34,30,31,7
22023,202331,22300350,"DEC 18, 2023",LAC @ IND,W,31,9,21,0.429,5,11,0.455,4,4,1.0,0,3,3,4,1,1,1,3,27,22,1,Paul George,LAC,IND,LAC,19.0,FG Attempted,34,30,31,7
22023,202331,22300350,"DEC 18, 2023",LAC @ IND,W,31,9,21,0.429,5,11,0.455,4,4,1.0,0,3,3,4,1,1,1,3,27,22,1,Paul George,LAC,IND,LAC,30.5,Pts+Rebs,34,30,31,7
22023,202331,22300350,"DEC 18, 2023",LAC @ IND,W,31,9,21,0.429,5,11,0.455,4,4,1.0,0,3,3,4,1,1,1,3,27,22,1,Paul George,LAC,IND,LAC,27.5,Pts+Asts,34,30,31,7
22023,202331,22300350,"DEC 18, 2023",LAC @ IND,W,31,9,21,0.429,5,11,0.455,4,4,1.0,0,3,3,4,1,1,1,3,27,22,1,Paul George,LAC,IND,LAC,9.0,Rebs+Asts,34,30,31,7
22023,202331,22300343,"DEC 16, 2023",LAC vs. NYK,W,31,11,18,0.611,3,6,0.5,0,0,0.0,0,4,4,7,2,0,2,4,25,26,1,Paul George,LAC,LAC,NYK,24.5,Points,36,29,32,11
22023,202331,22300343,"DEC 16, 2023",LAC vs. NYK,W,31,11,18,0.611,3,6,0.5,0,0,0.0,0,4,4,7,2,0,2,4,25,26,1,Paul George,LAC,LAC,NYK,6.0,Rebounds,36,29,32,11
22023,202331,22300343,"DEC 16, 2023",LAC vs. NYK,W,31,11,18,0.611,3,6,0.5,0,0,0.0,0,4,4,7,2,0,2,4,25,26,1,Paul George,LAC,LAC,NYK,33.5,Pts+Rebs+Asts,36,29,32,11
22023,202331,22300343,"DEC 16, 2023",LAC vs. NYK,W,31,11,18,0.611,3,6,0.5,0,0,0.0,0,4,4,7,2,0,2,4,25,26,1,Paul George,LAC,LAC,NYK,38.0,Fantasy Score,36,29,32,11
22023,202331,22300343,"DEC 16, 2023",LAC vs. NYK,W,31,11,18,0.611,3,6,0.5,0,0,0.0,0,4,4,7,2,0,2,4,25,26,1,Paul George,LAC,LAC,NYK,0.5,Offensive Rebounds,36,29,32,11
22023,202331,22300343,"DEC 16, 2023",LAC vs. NYK,W,31,11,18,0.611,3,6,0.5,0,0,0.0,0,4,4,7,2,0,2,4,25,26,1,Paul George,LAC,LAC,NYK,9.5,3-PT Attempted,36,29,32,11
22023,202331,22300343,"DEC 16, 2023",LAC vs. NYK,W,31,11,18,0.611,3,6,0.5,0,0,0.0,0,4,4,7,2,0,2,4,25,26,1,Paul George,LAC,LAC,NYK,3.5,Free Throws Made,36,29,32,11
22023,202331,22300343,"DEC 16, 2023",LAC vs. NYK,W,31,11,18,0.611,3,6,0.5,0,0,0.0,0,4,4,7,2,0,2,4,25,26,1,Paul George,LAC,LAC,NYK,19.0,FG Attempted,36,29,32,11
22023,202331,22300343,"DEC 16, 2023",LAC vs. NYK,W,31,11,18,0.611,3,6,0.5,0,0,0.0,0,4,4,7,2,0,2,4,25,26,1,Paul George,LAC,LAC,NYK,30.5,Pts+Rebs,36,29,32,11
22023,202331,22300343,"DEC 16, 2023",LAC vs. NYK,W,31,11,18,0.611,3,6,0.5,0,0,0.0,0,4,4,7,2,0,2,4,25,26,1,Paul George,LAC,LAC,NYK,27.5,Pts+Asts,36,29,32,11
22023,202331,22300343,"DEC 16, 2023",LAC vs. NYK,W,31,11,18,0.611,3,6,0.5,0,0,0.0,0,4,4,7,2,0,2,4,25,26,1,Paul George,LAC,LAC,NYK,9.0,Rebs+Asts,36,29,32,11
22023,202331,22300309,"DEC 12, 2023",LAC vs. SAC,W,16,3,7,0.429,2,5,0.4,1,1,1.0,0,6,6,1,2,0,3,0,9,14,1,Paul George,LAC,LAC,SAC,24.5,Points,16,15,10,7
22023,202331,22300309,"DEC 12, 2023",LAC vs. SAC,W,16,3,7,0.429,2,5,0.4,1,1,1.0,0,6,6,1,2,0,3,0,9,14,1,Paul George,LAC,LAC,SAC,6.0,Rebounds,16,15,10,7
22023,202331,22300309,"DEC 12, 2023",LAC vs. SAC,W,16,3,7,0.429,2,5,0.4,1,1,1.0,0,6,6,1,2,0,3,0,9,14,1,Paul George,LAC,LAC,SAC,33.5,Pts+Rebs+Asts,16,15,10,7
22023,202331,22300309,"DEC 12, 2023",LAC vs. SAC,W,16,3,7,0.429,2,5,0.4,1,1,1.0,0,6,6,1,2,0,3,0,9,14,1,Paul George,LAC,LAC,SAC,38.0,Fantasy Score,16,15,10,7
22023,202331,22300309,"DEC 12, 2023",LAC vs. SAC,W,16,3,7,0.429,2,5,0.4,1,1,1.0,0,6,6,1,2,0,3,0,9,14,1,Paul George,LAC,LAC,SAC,0.5,Offensive Rebounds,16,15,10,7
22023,202331,22300309,"DEC 12, 2023",LAC vs. SAC,W,16,3,7,0.429,2,5,0.4,1,1,1.0,0,6,6,1,2,0,3,0,9,14,1,Paul George,LAC,LAC,SAC,9.5,3-PT Attempted,16,15,10,7
22023,202331,22300309,"DEC 12, 2023",LAC vs. SAC,W,16,3,7,0.429,2,5,0.4,1,1,1.0,0,6,6,1,2,0,3,0,9,14,1,Paul George,LAC,LAC,SAC,3.5,Free Throws Made,16,15,10,7
22023,202331,22300309,"DEC 12, 2023",LAC vs. SAC,W,16,3,7,0.429,2,5,0.4,1,1,1.0,0,6,6,1,2,0,3,0,9,14,1,Paul George,LAC,LAC,SAC,19.0,FG Attempted,16,15,10,7
22023,202331,22300309,"DEC 12, 2023",LAC vs. SAC,W,16,3,7,0.429,2,5,0.4,1,1,1.0,0,6,6,1,2,0,3,0,9,14,1,Paul George,LAC,LAC,SAC,30.5,Pts+Rebs,16,15,10,7
22023,202331,22300309,"DEC 12, 2023",LAC vs. SAC,W,16,3,7,0.429,2,5,0.4,1,1,1.0,0,6,6,1,2,0,3,0,9,14,1,Paul George,LAC,LAC,SAC,27.5,Pts+Asts,16,15,10,7
22023,202331,22300309,"DEC 12, 2023",LAC vs. SAC,W,16,3,7,0.429,2,5,0.4,1,1,1.0,0,6,6,1,2,0,3,0,9,14,1,Paul George,LAC,LAC,SAC,9.0,Rebs+Asts,16,15,10,7
22023,202331,22300304,"DEC 11, 2023",LAC vs. POR,W,41,7,17,0.412,2,8,0.25,4,4,1.0,3,5,8,8,1,1,1,4,20,3,1,Paul George,LAC,LAC,POR,24.5,Points,36,28,28,16
22023,202331,22300304,"DEC 11, 2023",LAC vs. POR,W,41,7,17,0.412,2,8,0.25,4,4,1.0,3,5,8,8,1,1,1,4,20,3,1,Paul George,LAC,LAC,POR,6.0,Rebounds,36,28,28,16
22023,202331,22300304,"DEC 11, 2023",LAC vs. POR,W,41,7,17,0.412,2,8,0.25,4,4,1.0,3,5,8,8,1,1,1,4,20,3,1,Paul George,LAC,LAC,POR,33.5,Pts+Rebs+Asts,36,28,28,16
22023,202331,22300304,"DEC 11, 2023",LAC vs. POR,W,41,7,17,0.412,2,8,0.25,4,4,1.0,3,5,8,8,1,1,1,4,20,3,1,Paul George,LAC,LAC,POR,38.0,Fantasy Score,36,28,28,16
22023,202331,22300304,"DEC 11, 2023",LAC vs. POR,W,41,7,17,0.412,2,8,0.25,4,4,1.0,3,5,8,8,1,1,1,4,20,3,1,Paul George,LAC,LAC,POR,0.5,Offensive Rebounds,36,28,28,16
22023,202331,22300304,"DEC 11, 2023",LAC vs. POR,W,41,7,17,0.412,2,8,0.25,4,4,1.0,3,5,8,8,1,1,1,4,20,3,1,Paul George,LAC,LAC,POR,9.5,3-PT Attempted,36,28,28,16
22023,202331,22300304,"DEC 11, 2023",LAC vs. POR,W,41,7,17,0.412,2,8,0.25,4,4,1.0,3,5,8,8,1,1,1,4,20,3,1,Paul George,LAC,LAC,POR,3.5,Free Throws Made,36,28,28,16
22023,202331,22300304,"DEC 11, 2023",LAC vs. POR,W,41,7,17,0.412,2,8,0.25,4,4,1.0,3,5,8,8,1,1,1,4,20,3,1,Paul George,LAC,LAC,POR,19.0,FG Attempted,36,28,28,16
22023,202331,22300304,"DEC 11, 2023",LAC vs. POR,W,41,7,17,0.412,2,8,0.25,4,4,1.0,3,5,8,8,1,1,1,4,20,3,1,Paul George,LAC,LAC,POR,30.5,Pts+Rebs,36,28,28,16
22023,202331,22300304,"DEC 11, 2023",LAC vs. POR,W,41,7,17,0.412,2,8,0.25,4,4,1.0,3,5,8,8,1,1,1,4,20,3,1,Paul George,LAC,LAC,POR,27.5,Pts+Asts,36,28,28,16
22023,202331,22300304,"DEC 11, 2023",LAC vs. POR,W,41,7,17,0.412,2,8,0.25,4,4,1.0,3,5,8,8,1,1,1,4,20,3,1,Paul George,LAC,LAC,POR,9.0,Rebs+Asts,36,28,28,16
22023,202331,22301225,"DEC 08, 2023",LAC @ UTA,W,37,8,13,0.615,2,5,0.4,2,3,0.667,0,3,3,2,6,1,1,2,20,14,1,Paul George,LAC,UTA,LAC,24.5,Points,25,23,22,5
22023,202331,22301225,"DEC 08, 2023",LAC @ UTA,W,37,8,13,0.615,2,5,0.4,2,3,0.667,0,3,3,2,6,1,1,2,20,14,1,Paul George,LAC,UTA,LAC,6.0,Rebounds,25,23,22,5
22023,202331,22301225,"DEC 08, 2023",LAC @ UTA,W,37,8,13,0.615,2,5,0.4,2,3,0.667,0,3,3,2,6,1,1,2,20,14,1,Paul George,LAC,UTA,LAC,33.5,Pts+Rebs+Asts,25,23,22,5
22023,202331,22301225,"DEC 08, 2023",LAC @ UTA,W,37,8,13,0.615,2,5,0.4,2,3,0.667,0,3,3,2,6,1,1,2,20,14,1,Paul George,LAC,UTA,LAC,38.0,Fantasy Score,25,23,22,5
22023,202331,22301225,"DEC 08, 2023",LAC @ UTA,W,37,8,13,0.615,2,5,0.4,2,3,0.667,0,3,3,2,6,1,1,2,20,14,1,Paul George,LAC,UTA,LAC,0.5,Offensive Rebounds,25,23,22,5
22023,202331,22301225,"DEC 08, 2023",LAC @ UTA,W,37,8,13,0.615,2,5,0.4,2,3,0.667,0,3,3,2,6,1,1,2,20,14,1,Paul George,LAC,UTA,LAC,9.5,3-PT Attempted,25,23,22,5
22023,202331,22301225,"DEC 08, 2023",LAC @ UTA,W,37,8,13,0.615,2,5,0.4,2,3,0.667,0,3,3,2,6,1,1,2,20,14,1,Paul George,LAC,UTA,LAC,3.5,Free Throws Made,25,23,22,5
22023,202331,22301225,"DEC 08, 2023",LAC @ UTA,W,37,8,13,0.615,2,5,0.4,2,3,0.667,0,3,3,2,6,1,1,2,20,14,1,Paul George,LAC,UTA,LAC,19.0,FG Attempted,25,23,22,5
22023,202331,22301225,"DEC 08, 2023",LAC @ UTA,W,37,8,13,0.615,2,5,0.4,2,3,0.667,0,3,3,2,6,1,1,2,20,14,1,Paul George,LAC,UTA,LAC,30.5,Pts+Rebs,25,23,22,5
22023,202331,22301225,"DEC 08, 2023",LAC @ UTA,W,37,8,13,0.615,2,5,0.4,2,3,0.667,0,3,3,2,6,1,1,2,20,14,1,Paul George,LAC,UTA,LAC,27.5,Pts+Asts,25,23,22,5
22023,202331,22301225,"DEC 08, 2023",LAC @ UTA,W,37,8,13,0.615,2,5,0.4,2,3,0.667,0,3,3,2,6,1,1,2,20,14,1,Paul George,LAC,UTA,LAC,9.0,Rebs+Asts,25,23,22,5
22023,202331,22301215,"DEC 06, 2023",LAC vs. DEN,W,38,8,20,0.4,5,9,0.556,4,4,1.0,1,7,8,1,0,1,2,1,25,11,1,Paul George,LAC,LAC,DEN,24.5,Points,34,33,26,9
22023,202331,22301215,"DEC 06, 2023",LAC vs. DEN,W,38,8,20,0.4,5,9,0.556,4,4,1.0,1,7,8,1,0,1,2,1,25,11,1,Paul George,LAC,LAC,DEN,6.0,Rebounds,34,33,26,9
22023,202331,22301215,"DEC 06, 2023",LAC vs. DEN,W,38,8,20,0.4,5,9,0.556,4,4,1.0,1,7,8,1,0,1,2,1,25,11,1,Paul George,LAC,LAC,DEN,33.5,Pts+Rebs+Asts,34,33,26,9
22023,202331,22301215,"DEC 06, 2023",LAC vs. DEN,W,38,8,20,0.4,5,9,0.556,4,4,1.0,1,7,8,1,0,1,2,1,25,11,1,Paul George,LAC,LAC,DEN,38.0,Fantasy Score,34,33,26,9
22023,202331,22301215,"DEC 06, 2023",LAC vs. DEN,W,38,8,20,0.4,5,9,0.556,4,4,1.0,1,7,8,1,0,1,2,1,25,11,1,Paul George,LAC,LAC,DEN,0.5,Offensive Rebounds,34,33,26,9
22023,202331,22301215,"DEC 06, 2023",LAC vs. DEN,W,38,8,20,0.4,5,9,0.556,4,4,1.0,1,7,8,1,0,1,2,1,25,11,1,Paul George,LAC,LAC,DEN,9.5,3-PT Attempted,34,33,26,9
22023,202331,22301215,"DEC 06, 2023",LAC vs. DEN,W,38,8,20,0.4,5,9,0.556,4,4,1.0,1,7,8,1,0,1,2,1,25,11,1,Paul George,LAC,LAC,DEN,3.5,Free Throws Made,34,33,26,9
22023,202331,22301215,"DEC 06, 2023",LAC vs. DEN,W,38,8,20,0.4,5,9,0.556,4,4,1.0,1,7,8,1,0,1,2,1,25,11,1,Paul George,LAC,LAC,DEN,19.0,FG Attempted,34,33,26,9
22023,202331,22301215,"DEC 06, 2023",LAC vs. DEN,W,38,8,20,0.4,5,9,0.556,4,4,1.0,1,7,8,1,0,1,2,1,25,11,1,Paul George,LAC,LAC,DEN,30.5,Pts+Rebs,34,33,26,9
22023,202331,22301215,"DEC 06, 2023",LAC vs. DEN,W,38,8,20,0.4,5,9,0.556,4,4,1.0,1,7,8,1,0,1,2,1,25,11,1,Paul George,LAC,LAC,DEN,27.5,Pts+Asts,34,33,26,9
22023,202331,22301215,"DEC 06, 2023",LAC vs. DEN,W,38,8,20,0.4,5,9,0.556,4,4,1.0,1,7,8,1,0,1,2,1,25,11,1,Paul George,LAC,LAC,DEN,9.0,Rebs+Asts,34,33,26,9
22023,202331,22300280,"DEC 02, 2023",LAC vs. GSW,W,38,8,17,0.471,4,8,0.5,5,5,1.0,0,6,6,6,1,0,1,5,25,5,1,Paul George,LAC,LAC,GSW,24.5,Points,37,31,31,12
22023,202331,22300280,"DEC 02, 2023",LAC vs. GSW,W,38,8,17,0.471,4,8,0.5,5,5,1.0,0,6,6,6,1,0,1,5,25,5,1,Paul George,LAC,LAC,GSW,6.0,Rebounds,37,31,31,12
22023,202331,22300280,"DEC 02, 2023",LAC vs. GSW,W,38,8,17,0.471,4,8,0.5,5,5,1.0,0,6,6,6,1,0,1,5,25,5,1,Paul George,LAC,LAC,GSW,33.5,Pts+Rebs+Asts,37,31,31,12
22023,202331,22300280,"DEC 02, 2023",LAC vs. GSW,W,38,8,17,0.471,4,8,0.5,5,5,1.0,0,6,6,6,1,0,1,5,25,5,1,Paul George,LAC,LAC,GSW,38.0,Fantasy Score,37,31,31,12
22023,202331,22300280,"DEC 02, 2023",LAC vs. GSW,W,38,8,17,0.471,4,8,0.5,5,5,1.0,0,6,6,6,1,0,1,5,25,5,1,Paul George,LAC,LAC,GSW,0.5,Offensive Rebounds,37,31,31,12
22023,202331,22300280,"DEC 02, 2023",LAC vs. GSW,W,38,8,17,0.471,4,8,0.5,5,5,1.0,0,6,6,6,1,0,1,5,25,5,1,Paul George,LAC,LAC,GSW,9.5,3-PT Attempted,37,31,31,12
22023,202331,22300280,"DEC 02, 2023",LAC vs. GSW,W,38,8,17,0.471,4,8,0.5,5,5,1.0,0,6,6,6,1,0,1,5,25,5,1,Paul George,LAC,LAC,GSW,3.5,Free Throws Made,37,31,31,12
22023,202331,22300280,"DEC 02, 2023",LAC vs. GSW,W,38,8,17,0.471,4,8,0.5,5,5,1.0,0,6,6,6,1,0,1,5,25,5,1,Paul George,LAC,LAC,GSW,19.0,FG Attempted,37,31,31,12
22023,202331,22300280,"DEC 02, 2023",LAC vs. GSW,W,38,8,17,0.471,4,8,0.5,5,5,1.0,0,6,6,6,1,0,1,5,25,5,1,Paul George,LAC,LAC,GSW,30.5,Pts+Rebs,37,31,31,12
22023,202331,22300280,"DEC 02, 2023",LAC vs. GSW,W,38,8,17,0.471,4,8,0.5,5,5,1.0,0,6,6,6,1,0,1,5,25,5,1,Paul George,LAC,LAC,GSW,27.5,Pts+Asts,37,31,31,12
22023,202331,22300280,"DEC 02, 2023",LAC vs. GSW,W,38,8,17,0.471,4,8,0.5,5,5,1.0,0,6,6,6,1,0,1,5,25,5,1,Paul George,LAC,LAC,GSW,9.0,Rebs+Asts,37,31,31,12
22023,202331,22300273,"NOV 30, 2023",LAC @ GSW,L,37,6,18,0.333,3,10,0.3,0,0,0.0,0,1,1,10,0,0,1,5,15,-6,1,Paul George,LAC,GSW,LAC,24.5,Points,26,16,25,11
22023,202331,22300273,"NOV 30, 2023",LAC @ GSW,L,37,6,18,0.333,3,10,0.3,0,0,0.0,0,1,1,10,0,0,1,5,15,-6,1,Paul George,LAC,GSW,LAC,6.0,Rebounds,26,16,25,11
22023,202331,22300273,"NOV 30, 2023",LAC @ GSW,L,37,6,18,0.333,3,10,0.3,0,0,0.0,0,1,1,10,0,0,1,5,15,-6,1,Paul George,LAC,GSW,LAC,33.5,Pts+Rebs+Asts,26,16,25,11
22023,202331,22300273,"NOV 30, 2023",LAC @ GSW,L,37,6,18,0.333,3,10,0.3,0,0,0.0,0,1,1,10,0,0,1,5,15,-6,1,Paul George,LAC,GSW,LAC,38.0,Fantasy Score,26,16,25,11
22023,202331,22300273,"NOV 30, 2023",LAC @ GSW,L,37,6,18,0.333,3,10,0.3,0,0,0.0,0,1,1,10,0,0,1,5,15,-6,1,Paul George,LAC,GSW,LAC,0.5,Offensive Rebounds,26,16,25,11
22023,202331,22300273,"NOV 30, 2023",LAC @ GSW,L,37,6,18,0.333,3,10,0.3,0,0,0.0,0,1,1,10,0,0,1,5,15,-6,1,Paul George,LAC,GSW,LAC,9.5,3-PT Attempted,26,16,25,11
22023,202331,22300273,"NOV 30, 2023",LAC @ GSW,L,37,6,18,0.333,3,10,0.3,0,0,0.0,0,1,1,10,0,0,1,5,15,-6,1,Paul George,LAC,GSW,LAC,3.5,Free Throws Made,26,16,25,11
22023,202331,22300273,"NOV 30, 2023",LAC @ GSW,L,37,6,18,0.333,3,10,0.3,0,0,0.0,0,1,1,10,0,0,1,5,15,-6,1,Paul George,LAC,GSW,LAC,19.0,FG Attempted,26,16,25,11
22023,202331,22300273,"NOV 30, 2023",LAC @ GSW,L,37,6,18,0.333,3,10,0.3,0,0,0.0,0,1,1,10,0,0,1,5,15,-6,1,Paul George,LAC,GSW,LAC,30.5,Pts+Rebs,26,16,25,11
22023,202331,22300273,"NOV 30, 2023",LAC @ GSW,L,37,6,18,0.333,3,10,0.3,0,0,0.0,0,1,1,10,0,0,1,5,15,-6,1,Paul George,LAC,GSW,LAC,27.5,Pts+Asts,26,16,25,11
22023,202331,22300273,"NOV 30, 2023",LAC @ GSW,L,37,6,18,0.333,3,10,0.3,0,0,0.0,0,1,1,10,0,0,1,5,15,-6,1,Paul George,LAC,GSW,LAC,9.0,Rebs+Asts,26,16,25,11
22023,202331,22300264,"NOV 29, 2023",LAC @ SAC,W,40,7,18,0.389,4,9,0.444,1,2,0.5,0,3,3,7,0,0,1,1,19,14,1,Paul George,LAC,SAC,LAC,24.5,Points,29,22,26,10
22023,202331,22300264,"NOV 29, 2023",LAC @ SAC,W,40,7,18,0.389,4,9,0.444,1,2,0.5,0,3,3,7,0,0,1,1,19,14,1,Paul George,LAC,SAC,LAC,6.0,Rebounds,29,22,26,10
22023,202331,22300264,"NOV 29, 2023",LAC @ SAC,W,40,7,18,0.389,4,9,0.444,1,2,0.5,0,3,3,7,0,0,1,1,19,14,1,Paul George,LAC,SAC,LAC,33.5,Pts+Rebs+Asts,29,22,26,10
22023,202331,22300264,"NOV 29, 2023",LAC @ SAC,W,40,7,18,0.389,4,9,0.444,1,2,0.5,0,3,3,7,0,0,1,1,19,14,1,Paul George,LAC,SAC,LAC,38.0,Fantasy Score,29,22,26,10
22023,202331,22300264,"NOV 29, 2023",LAC @ SAC,W,40,7,18,0.389,4,9,0.444,1,2,0.5,0,3,3,7,0,0,1,1,19,14,1,Paul George,LAC,SAC,LAC,0.5,Offensive Rebounds,29,22,26,10
22023,202331,22300264,"NOV 29, 2023",LAC @ SAC,W,40,7,18,0.389,4,9,0.444,1,2,0.5,0,3,3,7,0,0,1,1,19,14,1,Paul George,LAC,SAC,LAC,9.5,3-PT Attempted,29,22,26,10
22023,202331,22300264,"NOV 29, 2023",LAC @ SAC,W,40,7,18,0.389,4,9,0.444,1,2,0.5,0,3,3,7,0,0,1,1,19,14,1,Paul George,LAC,SAC,LAC,3.5,Free Throws Made,29,22,26,10
22023,202331,22300264,"NOV 29, 2023",LAC @ SAC,W,40,7,18,0.389,4,9,0.444,1,2,0.5,0,3,3,7,0,0,1,1,19,14,1,Paul George,LAC,SAC,LAC,19.0,FG Attempted,29,22,26,10
22023,202331,22300264,"NOV 29, 2023",LAC @ SAC,W,40,7,18,0.389,4,9,0.444,1,2,0.5,0,3,3,7,0,0,1,1,19,14,1,Paul George,LAC,SAC,LAC,30.5,Pts+Rebs,29,22,26,10
22023,202331,22300264,"NOV 29, 2023",LAC @ SAC,W,40,7,18,0.389,4,9,0.444,1,2,0.5,0,3,3,7,0,0,1,1,19,14,1,Paul George,LAC,SAC,LAC,27.5,Pts+Asts,29,22,26,10
22023,202331,22300264,"NOV 29, 2023",LAC @ SAC,W,40,7,18,0.389,4,9,0.444,1,2,0.5,0,3,3,7,0,0,1,1,19,14,1,Paul George,LAC,SAC,LAC,9.0,Rebs+Asts,29,22,26,10
22023,202331,22300257,"NOV 27, 2023",LAC vs. DEN,L,37,2,13,0.154,0,4,0.0,2,2,1.0,3,5,8,4,1,1,3,5,6,-11,1,Paul George,LAC,LAC,DEN,24.5,Points,18,14,10,12
22023,202331,22300257,"NOV 27, 2023",LAC vs. DEN,L,37,2,13,0.154,0,4,0.0,2,2,1.0,3,5,8,4,1,1,3,5,6,-11,1,Paul George,LAC,LAC,DEN,6.0,Rebounds,18,14,10,12
22023,202331,22300257,"NOV 27, 2023",LAC vs. DEN,L,37,2,13,0.154,0,4,0.0,2,2,1.0,3,5,8,4,1,1,3,5,6,-11,1,Paul George,LAC,LAC,DEN,33.5,Pts+Rebs+Asts,18,14,10,12
22023,202331,22300257,"NOV 27, 2023",LAC vs. DEN,L,37,2,13,0.154,0,4,0.0,2,2,1.0,3,5,8,4,1,1,3,5,6,-11,1,Paul George,LAC,LAC,DEN,38.0,Fantasy Score,18,14,10,12
22023,202331,22300257,"NOV 27, 2023",LAC vs. DEN,L,37,2,13,0.154,0,4,0.0,2,2,1.0,3,5,8,4,1,1,3,5,6,-11,1,Paul George,LAC,LAC,DEN,0.5,Offensive Rebounds,18,14,10,12
22023,202331,22300257,"NOV 27, 2023",LAC vs. DEN,L,37,2,13,0.154,0,4,0.0,2,2,1.0,3,5,8,4,1,1,3,5,6,-11,1,Paul George,LAC,LAC,DEN,9.5,3-PT Attempted,18,14,10,12
22023,202331,22300257,"NOV 27, 2023",LAC vs. DEN,L,37,2,13,0.154,0,4,0.0,2,2,1.0,3,5,8,4,1,1,3,5,6,-11,1,Paul George,LAC,LAC,DEN,3.5,Free Throws Made,18,14,10,12
22023,202331,22300257,"NOV 27, 2023",LAC vs. DEN,L,37,2,13,0.154,0,4,0.0,2,2,1.0,3,5,8,4,1,1,3,5,6,-11,1,Paul George,LAC,LAC,DEN,19.0,FG Attempted,18,14,10,12
22023,202331,22300257,"NOV 27, 2023",LAC vs. DEN,L,37,2,13,0.154,0,4,0.0,2,2,1.0,3,5,8,4,1,1,3,5,6,-11,1,Paul George,LAC,LAC,DEN,30.5,Pts+Rebs,18,14,10,12
22023,202331,22300257,"NOV 27, 2023",LAC vs. DEN,L,37,2,13,0.154,0,4,0.0,2,2,1.0,3,5,8,4,1,1,3,5,6,-11,1,Paul George,LAC,LAC,DEN,27.5,Pts+Asts,18,14,10,12
22023,202331,22300257,"NOV 27, 2023",LAC vs. DEN,L,37,2,13,0.154,0,4,0.0,2,2,1.0,3,5,8,4,1,1,3,5,6,-11,1,Paul George,LAC,LAC,DEN,9.0,Rebs+Asts,18,14,10,12
22023,202331,22300244,"NOV 25, 2023",LAC vs. DAL,W,36,9,19,0.474,2,5,0.4,5,5,1.0,1,8,9,4,0,0,1,4,25,19,1,Paul George,LAC,LAC,DAL,24.5,Points,38,34,29,13
22023,202331,22300244,"NOV 25, 2023",LAC vs. DAL,W,36,9,19,0.474,2,5,0.4,5,5,1.0,1,8,9,4,0,0,1,4,25,19,1,Paul George,LAC,LAC,DAL,6.0,Rebounds,38,34,29,13
22023,202331,22300244,"NOV 25, 2023",LAC vs. DAL,W,36,9,19,0.474,2,5,0.4,5,5,1.0,1,8,9,4,0,0,1,4,25,19,1,Paul George,LAC,LAC,DAL,33.5,Pts+Rebs+Asts,38,34,29,13
22023,202331,22300244,"NOV 25, 2023",LAC vs. DAL,W,36,9,19,0.474,2,5,0.4,5,5,1.0,1,8,9,4,0,0,1,4,25,19,1,Paul George,LAC,LAC,DAL,38.0,Fantasy Score,38,34,29,13
22023,202331,22300244,"NOV 25, 2023",LAC vs. DAL,W,36,9,19,0.474,2,5,0.4,5,5,1.0,1,8,9,4,0,0,1,4,25,19,1,Paul George,LAC,LAC,DAL,0.5,Offensive Rebounds,38,34,29,13
22023,202331,22300244,"NOV 25, 2023",LAC vs. DAL,W,36,9,19,0.474,2,5,0.4,5,5,1.0,1,8,9,4,0,0,1,4,25,19,1,Paul George,LAC,LAC,DAL,9.5,3-PT Attempted,38,34,29,13
22023,202331,22300244,"NOV 25, 2023",LAC vs. DAL,W,36,9,19,0.474,2,5,0.4,5,5,1.0,1,8,9,4,0,0,1,4,25,19,1,Paul George,LAC,LAC,DAL,3.5,Free Throws Made,38,34,29,13
22023,202331,22300244,"NOV 25, 2023",LAC vs. DAL,W,36,9,19,0.474,2,5,0.4,5,5,1.0,1,8,9,4,0,0,1,4,25,19,1,Paul George,LAC,LAC,DAL,19.0,FG Attempted,38,34,29,13
22023,202331,22300244,"NOV 25, 2023",LAC vs. DAL,W,36,9,19,0.474,2,5,0.4,5,5,1.0,1,8,9,4,0,0,1,4,25,19,1,Paul George,LAC,LAC,DAL,30.5,Pts+Rebs,38,34,29,13
22023,202331,22300244,"NOV 25, 2023",LAC vs. DAL,W,36,9,19,0.474,2,5,0.4,5,5,1.0,1,8,9,4,0,0,1,4,25,19,1,Paul George,LAC,LAC,DAL,27.5,Pts+Asts,38,34,29,13
22023,202331,22300244,"NOV 25, 2023",LAC vs. DAL,W,36,9,19,0.474,2,5,0.4,5,5,1.0,1,8,9,4,0,0,1,4,25,19,1,Paul George,LAC,LAC,DAL,9.0,Rebs+Asts,38,34,29,13
22023,202331,22300052,"NOV 24, 2023",LAC vs. NOP,L,39,14,30,0.467,4,12,0.333,2,3,0.667,1,7,8,2,0,0,2,3,34,-9,1,Paul George,LAC,LAC,NOP,24.5,Points,44,42,36,10
22023,202331,22300052,"NOV 24, 2023",LAC vs. NOP,L,39,14,30,0.467,4,12,0.333,2,3,0.667,1,7,8,2,0,0,2,3,34,-9,1,Paul George,LAC,LAC,NOP,6.0,Rebounds,44,42,36,10
22023,202331,22300052,"NOV 24, 2023",LAC vs. NOP,L,39,14,30,0.467,4,12,0.333,2,3,0.667,1,7,8,2,0,0,2,3,34,-9,1,Paul George,LAC,LAC,NOP,33.5,Pts+Rebs+Asts,44,42,36,10
22023,202331,22300052,"NOV 24, 2023",LAC vs. NOP,L,39,14,30,0.467,4,12,0.333,2,3,0.667,1,7,8,2,0,0,2,3,34,-9,1,Paul George,LAC,LAC,NOP,38.0,Fantasy Score,44,42,36,10
22023,202331,22300052,"NOV 24, 2023",LAC vs. NOP,L,39,14,30,0.467,4,12,0.333,2,3,0.667,1,7,8,2,0,0,2,3,34,-9,1,Paul George,LAC,LAC,NOP,0.5,Offensive Rebounds,44,42,36,10
22023,202331,22300052,"NOV 24, 2023",LAC vs. NOP,L,39,14,30,0.467,4,12,0.333,2,3,0.667,1,7,8,2,0,0,2,3,34,-9,1,Paul George,LAC,LAC,NOP,9.5,3-PT Attempted,44,42,36,10
22023,202331,22300052,"NOV 24, 2023",LAC vs. NOP,L,39,14,30,0.467,4,12,0.333,2,3,0.667,1,7,8,2,0,0,2,3,34,-9,1,Paul George,LAC,LAC,NOP,3.5,Free Throws Made,44,42,36,10
22023,202331,22300052,"NOV 24, 2023",LAC vs. NOP,L,39,14,30,0.467,4,12,0.333,2,3,0.667,1,7,8,2,0,0,2,3,34,-9,1,Paul George,LAC,LAC,NOP,19.0,FG Attempted,44,42,36,10
22023,202331,22300052,"NOV 24, 2023",LAC vs. NOP,L,39,14,30,0.467,4,12,0.333,2,3,0.667,1,7,8,2,0,0,2,3,34,-9,1,Paul George,LAC,LAC,NOP,30.5,Pts+Rebs,44,42,36,10
22023,202331,22300052,"NOV 24, 2023",LAC vs. NOP,L,39,14,30,0.467,4,12,0.333,2,3,0.667,1,7,8,2,0,0,2,3,34,-9,1,Paul George,LAC,LAC,NOP,27.5,Pts+Asts,44,42,36,10
22023,202331,22300052,"NOV 24, 2023",LAC vs. NOP,L,39,14,30,0.467,4,12,0.333,2,3,0.667,1,7,8,2,0,0,2,3,34,-9,1,Paul George,LAC,LAC,NOP,9.0,Rebs+Asts,44,42,36,10
22023,202331,22300235,"NOV 22, 2023",LAC @ SAS,W,36,8,23,0.348,4,12,0.333,4,4,1.0,1,7,8,3,2,0,2,3,24,7,1,Paul George,LAC,SAS,LAC,24.5,Points,35,32,27,11
22023,202331,22300235,"NOV 22, 2023",LAC @ SAS,W,36,8,23,0.348,4,12,0.333,4,4,1.0,1,7,8,3,2,0,2,3,24,7,1,Paul George,LAC,SAS,LAC,6.0,Rebounds,35,32,27,11
22023,202331,22300235,"NOV 22, 2023",LAC @ SAS,W,36,8,23,0.348,4,12,0.333,4,4,1.0,1,7,8,3,2,0,2,3,24,7,1,Paul George,LAC,SAS,LAC,33.5,Pts+Rebs+Asts,35,32,27,11
22023,202331,22300235,"NOV 22, 2023",LAC @ SAS,W,36,8,23,0.348,4,12,0.333,4,4,1.0,1,7,8,3,2,0,2,3,24,7,1,Paul George,LAC,SAS,LAC,38.0,Fantasy Score,35,32,27,11
22023,202331,22300235,"NOV 22, 2023",LAC @ SAS,W,36,8,23,0.348,4,12,0.333,4,4,1.0,1,7,8,3,2,0,2,3,24,7,1,Paul George,LAC,SAS,LAC,0.5,Offensive Rebounds,35,32,27,11
22023,202331,22300235,"NOV 22, 2023",LAC @ SAS,W,36,8,23,0.348,4,12,0.333,4,4,1.0,1,7,8,3,2,0,2,3,24,7,1,Paul George,LAC,SAS,LAC,9.5,3-PT Attempted,35,32,27,11
22023,202331,22300235,"NOV 22, 2023",LAC @ SAS,W,36,8,23,0.348,4,12,0.333,4,4,1.0,1,7,8,3,2,0,2,3,24,7,1,Paul George,LAC,SAS,LAC,3.5,Free Throws Made,35,32,27,11
22023,202331,22300235,"NOV 22, 2023",LAC @ SAS,W,36,8,23,0.348,4,12,0.333,4,4,1.0,1,7,8,3,2,0,2,3,24,7,1,Paul George,LAC,SAS,LAC,19.0,FG Attempted,35,32,27,11
22023,202331,22300235,"NOV 22, 2023",LAC @ SAS,W,36,8,23,0.348,4,12,0.333,4,4,1.0,1,7,8,3,2,0,2,3,24,7,1,Paul George,LAC,SAS,LAC,30.5,Pts+Rebs,35,32,27,11
22023,202331,22300235,"NOV 22, 2023",LAC @ SAS,W,36,8,23,0.348,4,12,0.333,4,4,1.0,1,7,8,3,2,0,2,3,24,7,1,Paul George,LAC,SAS,LAC,27.5,Pts+Asts,35,32,27,11
22023,202331,22300235,"NOV 22, 2023",LAC @ SAS,W,36,8,23,0.348,4,12,0.333,4,4,1.0,1,7,8,3,2,0,2,3,24,7,1,Paul George,LAC,SAS,LAC,9.0,Rebs+Asts,35,32,27,11
22023,202331,22300223,"NOV 20, 2023",LAC @ SAS,W,32,11,16,0.688,4,8,0.5,2,2,1.0,0,5,5,6,1,0,2,1,28,23,1,Paul George,LAC,SAS,LAC,24.5,Points,39,33,34,11
22023,202331,22300223,"NOV 20, 2023",LAC @ SAS,W,32,11,16,0.688,4,8,0.5,2,2,1.0,0,5,5,6,1,0,2,1,28,23,1,Paul George,LAC,SAS,LAC,6.0,Rebounds,39,33,34,11
22023,202331,22300223,"NOV 20, 2023",LAC @ SAS,W,32,11,16,0.688,4,8,0.5,2,2,1.0,0,5,5,6,1,0,2,1,28,23,1,Paul George,LAC,SAS,LAC,33.5,Pts+Rebs+Asts,39,33,34,11
22023,202331,22300223,"NOV 20, 2023",LAC @ SAS,W,32,11,16,0.688,4,8,0.5,2,2,1.0,0,5,5,6,1,0,2,1,28,23,1,Paul George,LAC,SAS,LAC,38.0,Fantasy Score,39,33,34,11
22023,202331,22300223,"NOV 20, 2023",LAC @ SAS,W,32,11,16,0.688,4,8,0.5,2,2,1.0,0,5,5,6,1,0,2,1,28,23,1,Paul George,LAC,SAS,LAC,0.5,Offensive Rebounds,39,33,34,11
22023,202331,22300223,"NOV 20, 2023",LAC @ SAS,W,32,11,16,0.688,4,8,0.5,2,2,1.0,0,5,5,6,1,0,2,1,28,23,1,Paul George,LAC,SAS,LAC,9.5,3-PT Attempted,39,33,34,11
22023,202331,22300223,"NOV 20, 2023",LAC @ SAS,W,32,11,16,0.688,4,8,0.5,2,2,1.0,0,5,5,6,1,0,2,1,28,23,1,Paul George,LAC,SAS,LAC,3.5,Free Throws Made,39,33,34,11
22023,202331,22300223,"NOV 20, 2023",LAC @ SAS,W,32,11,16,0.688,4,8,0.5,2,2,1.0,0,5,5,6,1,0,2,1,28,23,1,Paul George,LAC,SAS,LAC,19.0,FG Attempted,39,33,34,11
22023,202331,22300223,"NOV 20, 2023",LAC @ SAS,W,32,11,16,0.688,4,8,0.5,2,2,1.0,0,5,5,6,1,0,2,1,28,23,1,Paul George,LAC,SAS,LAC,30.5,Pts+Rebs,39,33,34,11
22023,202331,22300223,"NOV 20, 2023",LAC @ SAS,W,32,11,16,0.688,4,8,0.5,2,2,1.0,0,5,5,6,1,0,2,1,28,23,1,Paul George,LAC,SAS,LAC,27.5,Pts+Asts,39,33,34,11
22023,202331,22300223,"NOV 20, 2023",LAC @ SAS,W,32,11,16,0.688,4,8,0.5,2,2,1.0,0,5,5,6,1,0,2,1,28,23,1,Paul George,LAC,SAS,LAC,9.0,Rebs+Asts,39,33,34,11
22023,202331,22300037,"NOV 17, 2023",LAC vs. HOU,W,40,8,22,0.364,4,10,0.4,3,3,1.0,1,7,8,3,2,1,3,2,23,9,1,Paul George,LAC,LAC,HOU,24.5,Points,34,31,26,11
22023,202331,22300037,"NOV 17, 2023",LAC vs. HOU,W,40,8,22,0.364,4,10,0.4,3,3,1.0,1,7,8,3,2,1,3,2,23,9,1,Paul George,LAC,LAC,HOU,6.0,Rebounds,34,31,26,11
22023,202331,22300037,"NOV 17, 2023",LAC vs. HOU,W,40,8,22,0.364,4,10,0.4,3,3,1.0,1,7,8,3,2,1,3,2,23,9,1,Paul George,LAC,LAC,HOU,33.5,Pts+Rebs+Asts,34,31,26,11
22023,202331,22300037,"NOV 17, 2023",LAC vs. HOU,W,40,8,22,0.364,4,10,0.4,3,3,1.0,1,7,8,3,2,1,3,2,23,9,1,Paul George,LAC,LAC,HOU,38.0,Fantasy Score,34,31,26,11
22023,202331,22300037,"NOV 17, 2023",LAC vs. HOU,W,40,8,22,0.364,4,10,0.4,3,3,1.0,1,7,8,3,2,1,3,2,23,9,1,Paul George,LAC,LAC,HOU,0.5,Offensive Rebounds,34,31,26,11
22023,202331,22300037,"NOV 17, 2023",LAC vs. HOU,W,40,8,22,0.364,4,10,0.4,3,3,1.0,1,7,8,3,2,1,3,2,23,9,1,Paul George,LAC,LAC,HOU,9.5,3-PT Attempted,34,31,26,11
22023,202331,22300037,"NOV 17, 2023",LAC vs. HOU,W,40,8,22,0.364,4,10,0.4,3,3,1.0,1,7,8,3,2,1,3,2,23,9,1,Paul George,LAC,LAC,HOU,3.5,Free Throws Made,34,31,26,11
22023,202331,22300037,"NOV 17, 2023",LAC vs. HOU,W,40,8,22,0.364,4,10,0.4,3,3,1.0,1,7,8,3,2,1,3,2,23,9,1,Paul George,LAC,LAC,HOU,19.0,FG Attempted,34,31,26,11
22023,202331,22300037,"NOV 17, 2023",LAC vs. HOU,W,40,8,22,0.364,4,10,0.4,3,3,1.0,1,7,8,3,2,1,3,2,23,9,1,Paul George,LAC,LAC,HOU,30.5,Pts+Rebs,34,31,26,11
22023,202331,22300037,"NOV 17, 2023",LAC vs. HOU,W,40,8,22,0.364,4,10,0.4,3,3,1.0,1,7,8,3,2,1,3,2,23,9,1,Paul George,LAC,LAC,HOU,27.5,Pts+Asts,34,31,26,11
22023,202331,22300037,"NOV 17, 2023",LAC vs. HOU,W,40,8,22,0.364,4,10,0.4,3,3,1.0,1,7,8,3,2,1,3,2,23,9,1,Paul George,LAC,LAC,HOU,9.0,Rebs+Asts,34,31,26,11
22023,202331,22300024,"NOV 14, 2023",LAC @ DEN,L,40,13,26,0.5,4,11,0.364,5,5,1.0,0,7,7,3,3,0,1,4,35,-5,1,Paul George,LAC,DEN,LAC,24.5,Points,45,42,38,10
22023,202331,22300024,"NOV 14, 2023",LAC @ DEN,L,40,13,26,0.5,4,11,0.364,5,5,1.0,0,7,7,3,3,0,1,4,35,-5,1,Paul George,LAC,DEN,LAC,6.0,Rebounds,45,42,38,10
22023,202331,22300024,"NOV 14, 2023",LAC @ DEN,L,40,13,26,0.5,4,11,0.364,5,5,1.0,0,7,7,3,3,0,1,4,35,-5,1,Paul George,LAC,DEN,LAC,33.5,Pts+Rebs+Asts,45,42,38,10
22023,202331,22300024,"NOV 14, 2023",LAC @ DEN,L,40,13,26,0.5,4,11,0.364,5,5,1.0,0,7,7,3,3,0,1,4,35,-5,1,Paul George,LAC,DEN,LAC,38.0,Fantasy Score,45,42,38,10
22023,202331,22300024,"NOV 14, 2023",LAC @ DEN,L,40,13,26,0.5,4,11,0.364,5,5,1.0,0,7,7,3,3,0,1,4,35,-5,1,Paul George,LAC,DEN,LAC,0.5,Offensive Rebounds,45,42,38,10
22023,202331,22300024,"NOV 14, 2023",LAC @ DEN,L,40,13,26,0.5,4,11,0.364,5,5,1.0,0,7,7,3,3,0,1,4,35,-5,1,Paul George,LAC,DEN,LAC,9.5,3-PT Attempted,45,42,38,10
22023,202331,22300024,"NOV 14, 2023",LAC @ DEN,L,40,13,26,0.5,4,11,0.364,5,5,1.0,0,7,7,3,3,0,1,4,35,-5,1,Paul George,LAC,DEN,LAC,3.5,Free Throws Made,45,42,38,10
22023,202331,22300024,"NOV 14, 2023",LAC @ DEN,L,40,13,26,0.5,4,11,0.364,5,5,1.0,0,7,7,3,3,0,1,4,35,-5,1,Paul George,LAC,DEN,LAC,19.0,FG Attempted,45,42,38,10
22023,202331,22300024,"NOV 14, 2023",LAC @ DEN,L,40,13,26,0.5,4,11,0.364,5,5,1.0,0,7,7,3,3,0,1,4,35,-5,1,Paul George,LAC,DEN,LAC,30.5,Pts+Rebs,45,42,38,10
22023,202331,22300024,"NOV 14, 2023",LAC @ DEN,L,40,13,26,0.5,4,11,0.364,5,5,1.0,0,7,7,3,3,0,1,4,35,-5,1,Paul George,LAC,DEN,LAC,27.5,Pts+Asts,45,42,38,10
22023,202331,22300024,"NOV 14, 2023",LAC @ DEN,L,40,13,26,0.5,4,11,0.364,5,5,1.0,0,7,7,3,3,0,1,4,35,-5,1,Paul George,LAC,DEN,LAC,9.0,Rebs+Asts,45,42,38,10
22023,202331,22300179,"NOV 12, 2023",LAC vs. MEM,L,37,8,16,0.5,3,7,0.429,7,9,0.778,1,6,7,7,2,0,7,5,26,2,1,Paul George,LAC,LAC,MEM,24.5,Points,40,33,33,14
22023,202331,22300179,"NOV 12, 2023",LAC vs. MEM,L,37,8,16,0.5,3,7,0.429,7,9,0.778,1,6,7,7,2,0,7,5,26,2,1,Paul George,LAC,LAC,MEM,6.0,Rebounds,40,33,33,14
22023,202331,22300179,"NOV 12, 2023",LAC vs. MEM,L,37,8,16,0.5,3,7,0.429,7,9,0.778,1,6,7,7,2,0,7,5,26,2,1,Paul George,LAC,LAC,MEM,33.5,Pts+Rebs+Asts,40,33,33,14
22023,202331,22300179,"NOV 12, 2023",LAC vs. MEM,L,37,8,16,0.5,3,7,0.429,7,9,0.778,1,6,7,7,2,0,7,5,26,2,1,Paul George,LAC,LAC,MEM,38.0,Fantasy Score,40,33,33,14
22023,202331,22300179,"NOV 12, 2023",LAC vs. MEM,L,37,8,16,0.5,3,7,0.429,7,9,0.778,1,6,7,7,2,0,7,5,26,2,1,Paul George,LAC,LAC,MEM,0.5,Offensive Rebounds,40,33,33,14
22023,202331,22300179,"NOV 12, 2023",LAC vs. MEM,L,37,8,16,0.5,3,7,0.429,7,9,0.778,1,6,7,7,2,0,7,5,26,2,1,Paul George,LAC,LAC,MEM,9.5,3-PT Attempted,40,33,33,14
22023,202331,22300179,"NOV 12, 2023",LAC vs. MEM,L,37,8,16,0.5,3,7,0.429,7,9,0.778,1,6,7,7,2,0,7,5,26,2,1,Paul George,LAC,LAC,MEM,3.5,Free Throws Made,40,33,33,14
22023,202331,22300179,"NOV 12, 2023",LAC vs. MEM,L,37,8,16,0.5,3,7,0.429,7,9,0.778,1,6,7,7,2,0,7,5,26,2,1,Paul George,LAC,LAC,MEM,19.0,FG Attempted,40,33,33,14
22023,202331,22300179,"NOV 12, 2023",LAC vs. MEM,L,37,8,16,0.5,3,7,0.429,7,9,0.778,1,6,7,7,2,0,7,5,26,2,1,Paul George,LAC,LAC,MEM,30.5,Pts+Rebs,40,33,33,14
22023,202331,22300179,"NOV 12, 2023",LAC vs. MEM,L,37,8,16,0.5,3,7,0.429,7,9,0.778,1,6,7,7,2,0,7,5,26,2,1,Paul George,LAC,LAC,MEM,27.5,Pts+Asts,40,33,33,14
22023,202331,22300179,"NOV 12, 2023",LAC vs. MEM,L,37,8,16,0.5,3,7,0.429,7,9,0.778,1,6,7,7,2,0,7,5,26,2,1,Paul George,LAC,LAC,MEM,9.0,Rebs+Asts,40,33,33,14
22023,202331,22300014,"NOV 10, 2023",LAC @ DAL,L,23,3,12,0.25,1,7,0.143,1,1,1.0,0,3,3,2,1,0,2,3,8,-14,1,Paul George,LAC,DAL,LAC,24.5,Points,13,11,10,5
22023,202331,22300014,"NOV 10, 2023",LAC @ DAL,L,23,3,12,0.25,1,7,0.143,1,1,1.0,0,3,3,2,1,0,2,3,8,-14,1,Paul George,LAC,DAL,LAC,6.0,Rebounds,13,11,10,5
22023,202331,22300014,"NOV 10, 2023",LAC @ DAL,L,23,3,12,0.25,1,7,0.143,1,1,1.0,0,3,3,2,1,0,2,3,8,-14,1,Paul George,LAC,DAL,LAC,33.5,Pts+Rebs+Asts,13,11,10,5
22023,202331,22300014,"NOV 10, 2023",LAC @ DAL,L,23,3,12,0.25,1,7,0.143,1,1,1.0,0,3,3,2,1,0,2,3,8,-14,1,Paul George,LAC,DAL,LAC,38.0,Fantasy Score,13,11,10,5
22023,202331,22300014,"NOV 10, 2023",LAC @ DAL,L,23,3,12,0.25,1,7,0.143,1,1,1.0,0,3,3,2,1,0,2,3,8,-14,1,Paul George,LAC,DAL,LAC,0.5,Offensive Rebounds,13,11,10,5
22023,202331,22300014,"NOV 10, 2023",LAC @ DAL,L,23,3,12,0.25,1,7,0.143,1,1,1.0,0,3,3,2,1,0,2,3,8,-14,1,Paul George,LAC,DAL,LAC,9.5,3-PT Attempted,13,11,10,5
22023,202331,22300014,"NOV 10, 2023",LAC @ DAL,L,23,3,12,0.25,1,7,0.143,1,1,1.0,0,3,3,2,1,0,2,3,8,-14,1,Paul George,LAC,DAL,LAC,3.5,Free Throws Made,13,11,10,5
22023,202331,22300014,"NOV 10, 2023",LAC @ DAL,L,23,3,12,0.25,1,7,0.143,1,1,1.0,0,3,3,2,1,0,2,3,8,-14,1,Paul George,LAC,DAL,LAC,19.0,FG Attempted,13,11,10,5
22023,202331,22300014,"NOV 10, 2023",LAC @ DAL,L,23,3,12,0.25,1,7,0.143,1,1,1.0,0,3,3,2,1,0,2,3,8,-14,1,Paul George,LAC,DAL,LAC,30.5,Pts+Rebs,13,11,10,5
22023,202331,22300014,"NOV 10, 2023",LAC @ DAL,L,23,3,12,0.25,1,7,0.143,1,1,1.0,0,3,3,2,1,0,2,3,8,-14,1,Paul George,LAC,DAL,LAC,27.5,Pts+Asts,13,11,10,5
22023,202331,22300014,"NOV 10, 2023",LAC @ DAL,L,23,3,12,0.25,1,7,0.143,1,1,1.0,0,3,3,2,1,0,2,3,8,-14,1,Paul George,LAC,DAL,LAC,9.0,Rebs+Asts,13,11,10,5
22023,202331,22300160,"NOV 08, 2023",LAC @ BKN,L,39,7,20,0.35,2,10,0.2,8,8,1.0,1,6,7,1,3,1,3,2,24,-7,1,Paul George,LAC,BKN,LAC,24.5,Points,32,31,25,8
22023,202331,22300160,"NOV 08, 2023",LAC @ BKN,L,39,7,20,0.35,2,10,0.2,8,8,1.0,1,6,7,1,3,1,3,2,24,-7,1,Paul George,LAC,BKN,LAC,6.0,Rebounds,32,31,25,8
22023,202331,22300160,"NOV 08, 2023",LAC @ BKN,L,39,7,20,0.35,2,10,0.2,8,8,1.0,1,6,7,1,3,1,3,2,24,-7,1,Paul George,LAC,BKN,LAC,33.5,Pts+Rebs+Asts,32,31,25,8
22023,202331,22300160,"NOV 08, 2023",LAC @ BKN,L,39,7,20,0.35,2,10,0.2,8,8,1.0,1,6,7,1,3,1,3,2,24,-7,1,Paul George,LAC,BKN,LAC,38.0,Fantasy Score,32,31,25,8
22023,202331,22300160,"NOV 08, 2023",LAC @ BKN,L,39,7,20,0.35,2,10,0.2,8,8,1.0,1,6,7,1,3,1,3,2,24,-7,1,Paul George,LAC,BKN,LAC,0.5,Offensive Rebounds,32,31,25,8
22023,202331,22300160,"NOV 08, 2023",LAC @ BKN,L,39,7,20,0.35,2,10,0.2,8,8,1.0,1,6,7,1,3,1,3,2,24,-7,1,Paul George,LAC,BKN,LAC,9.5,3-PT Attempted,32,31,25,8
22023,202331,22300160,"NOV 08, 2023",LAC @ BKN,L,39,7,20,0.35,2,10,0.2,8,8,1.0,1,6,7,1,3,1,3,2,24,-7,1,Paul George,LAC,BKN,LAC,3.5,Free Throws Made,32,31,25,8
22023,202331,22300160,"NOV 08, 2023",LAC @ BKN,L,39,7,20,0.35,2,10,0.2,8,8,1.0,1,6,7,1,3,1,3,2,24,-7,1,Paul George,LAC,BKN,LAC,19.0,FG Attempted,32,31,25,8
22023,202331,22300160,"NOV 08, 2023",LAC @ BKN,L,39,7,20,0.35,2,10,0.2,8,8,1.0,1,6,7,1,3,1,3,2,24,-7,1,Paul George,LAC,BKN,LAC,30.5,Pts+Rebs,32,31,25,8
22023,202331,22300160,"NOV 08, 2023",LAC @ BKN,L,39,7,20,0.35,2,10,0.2,8,8,1.0,1,6,7,1,3,1,3,2,24,-7,1,Paul George,LAC,BKN,LAC,27.5,Pts+Asts,32,31,25,8
22023,202331,22300160,"NOV 08, 2023",LAC @ BKN,L,39,7,20,0.35,2,10,0.2,8,8,1.0,1,6,7,1,3,1,3,2,24,-7,1,Paul George,LAC,BKN,LAC,9.0,Rebs+Asts,32,31,25,8
22023,202331,22300151,"NOV 06, 2023",LAC @ NYK,L,34,2,11,0.182,1,6,0.167,5,5,1.0,0,7,7,3,3,0,4,2,10,-7,1,Paul George,LAC,NYK,LAC,24.5,Points,20,17,13,10
22023,202331,22300151,"NOV 06, 2023",LAC @ NYK,L,34,2,11,0.182,1,6,0.167,5,5,1.0,0,7,7,3,3,0,4,2,10,-7,1,Paul George,LAC,NYK,LAC,6.0,Rebounds,20,17,13,10
22023,202331,22300151,"NOV 06, 2023",LAC @ NYK,L,34,2,11,0.182,1,6,0.167,5,5,1.0,0,7,7,3,3,0,4,2,10,-7,1,Paul George,LAC,NYK,LAC,33.5,Pts+Rebs+Asts,20,17,13,10
22023,202331,22300151,"NOV 06, 2023",LAC @ NYK,L,34,2,11,0.182,1,6,0.167,5,5,1.0,0,7,7,3,3,0,4,2,10,-7,1,Paul George,LAC,NYK,LAC,38.0,Fantasy Score,20,17,13,10
22023,202331,22300151,"NOV 06, 2023",LAC @ NYK,L,34,2,11,0.182,1,6,0.167,5,5,1.0,0,7,7,3,3,0,4,2,10,-7,1,Paul George,LAC,NYK,LAC,0.5,Offensive Rebounds,20,17,13,10
22023,202331,22300151,"NOV 06, 2023",LAC @ NYK,L,34,2,11,0.182,1,6,0.167,5,5,1.0,0,7,7,3,3,0,4,2,10,-7,1,Paul George,LAC,NYK,LAC,9.5,3-PT Attempted,20,17,13,10
22023,202331,22300151,"NOV 06, 2023",LAC @ NYK,L,34,2,11,0.182,1,6,0.167,5,5,1.0,0,7,7,3,3,0,4,2,10,-7,1,Paul George,LAC,NYK,LAC,3.5,Free Throws Made,20,17,13,10
22023,202331,22300151,"NOV 06, 2023",LAC @ NYK,L,34,2,11,0.182,1,6,0.167,5,5,1.0,0,7,7,3,3,0,4,2,10,-7,1,Paul George,LAC,NYK,LAC,19.0,FG Attempted,20,17,13,10
22023,202331,22300151,"NOV 06, 2023",LAC @ NYK,L,34,2,11,0.182,1,6,0.167,5,5,1.0,0,7,7,3,3,0,4,2,10,-7,1,Paul George,LAC,NYK,LAC,30.5,Pts+Rebs,20,17,13,10
22023,202331,22300151,"NOV 06, 2023",LAC @ NYK,L,34,2,11,0.182,1,6,0.167,5,5,1.0,0,7,7,3,3,0,4,2,10,-7,1,Paul George,LAC,NYK,LAC,27.5,Pts+Asts,20,17,13,10
22023,202331,22300151,"NOV 06, 2023",LAC @ NYK,L,34,2,11,0.182,1,6,0.167,5,5,1.0,0,7,7,3,3,0,4,2,10,-7,1,Paul George,LAC,NYK,LAC,9.0,Rebs+Asts,20,17,13,10
22023,202331,22300127,"NOV 01, 2023",LAC @ LAL,L,37,11,16,0.688,6,9,0.667,7,8,0.875,0,6,6,1,2,0,3,6,35,22,1,Paul George,LAC,LAL,LAC,24.5,Points,42,41,36,7
22023,202331,22300127,"NOV 01, 2023",LAC @ LAL,L,37,11,16,0.688,6,9,0.667,7,8,0.875,0,6,6,1,2,0,3,6,35,22,1,Paul George,LAC,LAL,LAC,6.0,Rebounds,42,41,36,7
22023,202331,22300127,"NOV 01, 2023",LAC @ LAL,L,37,11,16,0.688,6,9,0.667,7,8,0.875,0,6,6,1,2,0,3,6,35,22,1,Paul George,LAC,LAL,LAC,33.5,Pts+Rebs+Asts,42,41,36,7
22023,202331,22300127,"NOV 01, 2023",LAC @ LAL,L,37,11,16,0.688,6,9,0.667,7,8,0.875,0,6,6,1,2,0,3,6,35,22,1,Paul George,LAC,LAL,LAC,38.0,Fantasy Score,42,41,36,7
22023,202331,22300127,"NOV 01, 2023",LAC @ LAL,L,37,11,16,0.688,6,9,0.667,7,8,0.875,0,6,6,1,2,0,3,6,35,22,1,Paul George,LAC,LAL,LAC,0.5,Offensive Rebounds,42,41,36,7
22023,202331,22300127,"NOV 01, 2023",LAC @ LAL,L,37,11,16,0.688,6,9,0.667,7,8,0.875,0,6,6,1,2,0,3,6,35,22,1,Paul George,LAC,LAL,LAC,9.5,3-PT Attempted,42,41,36,7
22023,202331,22300127,"NOV 01, 2023",LAC @ LAL,L,37,11,16,0.688,6,9,0.667,7,8,0.875,0,6,6,1,2,0,3,6,35,22,1,Paul George,LAC,LAL,LAC,3.5,Free Throws Made,42,41,36,7
22023,202331,22300127,"NOV 01, 2023",LAC @ LAL,L,37,11,16,0.688,6,9,0.667,7,8,0.875,0,6,6,1,2,0,3,6,35,22,1,Paul George,LAC,LAL,LAC,19.0,FG Attempted,42,41,36,7
22023,202331,22300127,"NOV 01, 2023",LAC @ LAL,L,37,11,16,0.688,6,9,0.667,7,8,0.875,0,6,6,1,2,0,3,6,35,22,1,Paul George,LAC,LAL,LAC,30.5,Pts+Rebs,42,41,36,7
22023,202331,22300127,"NOV 01, 2023",LAC @ LAL,L,37,11,16,0.688,6,9,0.667,7,8,0.875,0,6,6,1,2,0,3,6,35,22,1,Paul George,LAC,LAL,LAC,27.5,Pts+Asts,42,41,36,7
22023,202331,22300127,"NOV 01, 2023",LAC @ LAL,L,37,11,16,0.688,6,9,0.667,7,8,0.875,0,6,6,1,2,0,3,6,35,22,1,Paul George,LAC,LAL,LAC,9.0,Rebs+Asts,42,41,36,7
22023,202331,22300114,"OCT 31, 2023",LAC vs. ORL,W,33,8,17,0.471,6,9,0.667,5,6,0.833,1,6,7,7,2,0,3,2,27,15,1,Paul George,LAC,LAC,ORL,24.5,Points,41,34,34,14
22023,202331,22300114,"OCT 31, 2023",LAC vs. ORL,W,33,8,17,0.471,6,9,0.667,5,6,0.833,1,6,7,7,2,0,3,2,27,15,1,Paul George,LAC,LAC,ORL,6.0,Rebounds,41,34,34,14
22023,202331,22300114,"OCT 31, 2023",LAC vs. ORL,W,33,8,17,0.471,6,9,0.667,5,6,0.833,1,6,7,7,2,0,3,2,27,15,1,Paul George,LAC,LAC,ORL,33.5,Pts+Rebs+Asts,41,34,34,14
22023,202331,22300114,"OCT 31, 2023",LAC vs. ORL,W,33,8,17,0.471,6,9,0.667,5,6,0.833,1,6,7,7,2,0,3,2,27,15,1,Paul George,LAC,LAC,ORL,38.0,Fantasy Score,41,34,34,14
22023,202331,22300114,"OCT 31, 2023",LAC vs. ORL,W,33,8,17,0.471,6,9,0.667,5,6,0.833,1,6,7,7,2,0,3,2,27,15,1,Paul George,LAC,LAC,ORL,0.5,Offensive Rebounds,41,34,34,14
22023,202331,22300114,"OCT 31, 2023",LAC vs. ORL,W,33,8,17,0.471,6,9,0.667,5,6,0.833,1,6,7,7,2,0,3,2,27,15,1,Paul George,LAC,LAC,ORL,9.5,3-PT Attempted,41,34,34,14
22023,202331,22300114,"OCT 31, 2023",LAC vs. ORL,W,33,8,17,0.471,6,9,0.667,5,6,0.833,1,6,7,7,2,0,3,2,27,15,1,Paul George,LAC,LAC,ORL,3.5,Free Throws Made,41,34,34,14
22023,202331,22300114,"OCT 31, 2023",LAC vs. ORL,W,33,8,17,0.471,6,9,0.667,5,6,0.833,1,6,7,7,2,0,3,2,27,15,1,Paul George,LAC,LAC,ORL,19.0,FG Attempted,41,34,34,14
22023,202331,22300114,"OCT 31, 2023",LAC vs. ORL,W,33,8,17,0.471,6,9,0.667,5,6,0.833,1,6,7,7,2,0,3,2,27,15,1,Paul George,LAC,LAC,ORL,30.5,Pts+Rebs,41,34,34,14
22023,202331,22300114,"OCT 31, 2023",LAC vs. ORL,W,33,8,17,0.471,6,9,0.667,5,6,0.833,1,6,7,7,2,0,3,2,27,15,1,Paul George,LAC,LAC,ORL,27.5,Pts+Asts,41,34,34,14
22023,202331,22300114,"OCT 31, 2023",LAC vs. ORL,W,33,8,17,0.471,6,9,0.667,5,6,0.833,1,6,7,7,2,0,3,2,27,15,1,Paul George,LAC,LAC,ORL,9.0,Rebs+Asts,41,34,34,14
22023,202331,22300099,"OCT 29, 2023",LAC vs. SAS,W,28,8,17,0.471,2,7,0.286,1,1,1.0,1,3,4,5,5,0,1,1,19,24,1,Paul George,LAC,LAC,SAS,24.5,Points,28,23,24,9
22023,202331,22300099,"OCT 29, 2023",LAC vs. SAS,W,28,8,17,0.471,2,7,0.286,1,1,1.0,1,3,4,5,5,0,1,1,19,24,1,Paul George,LAC,LAC,SAS,6.0,Rebounds,28,23,24,9
22023,202331,22300099,"OCT 29, 2023",LAC vs. SAS,W,28,8,17,0.471,2,7,0.286,1,1,1.0,1,3,4,5,5,0,1,1,19,24,1,Paul George,LAC,LAC,SAS,33.5,Pts+Rebs+Asts,28,23,24,9
22023,202331,22300099,"OCT 29, 2023",LAC vs. SAS,W,28,8,17,0.471,2,7,0.286,1,1,1.0,1,3,4,5,5,0,1,1,19,24,1,Paul George,LAC,LAC,SAS,38.0,Fantasy Score,28,23,24,9
22023,202331,22300099,"OCT 29, 2023",LAC vs. SAS,W,28,8,17,0.471,2,7,0.286,1,1,1.0,1,3,4,5,5,0,1,1,19,24,1,Paul George,LAC,LAC,SAS,0.5,Offensive Rebounds,28,23,24,9
22023,202331,22300099,"OCT 29, 2023",LAC vs. SAS,W,28,8,17,0.471,2,7,0.286,1,1,1.0,1,3,4,5,5,0,1,1,19,24,1,Paul George,LAC,LAC,SAS,9.5,3-PT Attempted,28,23,24,9
22023,202331,22300099,"OCT 29, 2023",LAC vs. SAS,W,28,8,17,0.471,2,7,0.286,1,1,1.0,1,3,4,5,5,0,1,1,19,24,1,Paul George,LAC,LAC,SAS,3.5,Free Throws Made,28,23,24,9
22023,202331,22300099,"OCT 29, 2023",LAC vs. SAS,W,28,8,17,0.471,2,7,0.286,1,1,1.0,1,3,4,5,5,0,1,1,19,24,1,Paul George,LAC,LAC,SAS,19.0,FG Attempted,28,23,24,9
22023,202331,22300099,"OCT 29, 2023",LAC vs. SAS,W,28,8,17,0.471,2,7,0.286,1,1,1.0,1,3,4,5,5,0,1,1,19,24,1,Paul George,LAC,LAC,SAS,30.5,Pts+Rebs,28,23,24,9
22023,202331,22300099,"OCT 29, 2023",LAC vs. SAS,W,28,8,17,0.471,2,7,0.286,1,1,1.0,1,3,4,5,5,0,1,1,19,24,1,Paul George,LAC,LAC,SAS,27.5,Pts+Asts,28,23,24,9
22023,202331,22300099,"OCT 29, 2023",LAC vs. SAS,W,28,8,17,0.471,2,7,0.286,1,1,1.0,1,3,4,5,5,0,1,1,19,24,1,Paul George,LAC,LAC,SAS,9.0,Rebs+Asts,28,23,24,9
22023,202331,22300085,"OCT 27, 2023",LAC @ UTA,L,38,9,17,0.529,3,9,0.333,15,15,1.0,1,3,4,1,0,0,2,1,36,3,1,Paul George,LAC,UTA,LAC,24.5,Points,41,40,37,5
22023,202331,22300085,"OCT 27, 2023",LAC @ UTA,L,38,9,17,0.529,3,9,0.333,15,15,1.0,1,3,4,1,0,0,2,1,36,3,1,Paul George,LAC,UTA,LAC,6.0,Rebounds,41,40,37,5
22023,202331,22300085,"OCT 27, 2023",LAC @ UTA,L,38,9,17,0.529,3,9,0.333,15,15,1.0,1,3,4,1,0,0,2,1,36,3,1,Paul George,LAC,UTA,LAC,33.5,Pts+Rebs+Asts,41,40,37,5
22023,202331,22300085,"OCT 27, 2023",LAC @ UTA,L,38,9,17,0.529,3,9,0.333,15,15,1.0,1,3,4,1,0,0,2,1,36,3,1,Paul George,LAC,UTA,LAC,38.0,Fantasy Score,41,40,37,5
22023,202331,22300085,"OCT 27, 2023",LAC @ UTA,L,38,9,17,0.529,3,9,0.333,15,15,1.0,1,3,4,1,0,0,2,1,36,3,1,Paul George,LAC,UTA,LAC,0.5,Offensive Rebounds,41,40,37,5
22023,202331,22300085,"OCT 27, 2023",LAC @ UTA,L,38,9,17,0.529,3,9,0.333,15,15,1.0,1,3,4,1,0,0,2,1,36,3,1,Paul George,LAC,UTA,LAC,9.5,3-PT Attempted,41,40,37,5
22023,202331,22300085,"OCT 27, 2023",LAC @ UTA,L,38,9,17,0.529,3,9,0.333,15,15,1.0,1,3,4,1,0,0,2,1,36,3,1,Paul George,LAC,UTA,LAC,3.5,Free Throws Made,41,40,37,5
22023,202331,22300085,"OCT 27, 2023",LAC @ UTA,L,38,9,17,0.529,3,9,0.333,15,15,1.0,1,3,4,1,0,0,2,1,36,3,1,Paul George,LAC,UTA,LAC,19.0,FG Attempted,41,40,37,5
22023,202331,22300085,"OCT 27, 2023",LAC @ UTA,L,38,9,17,0.529,3,9,0.333,15,15,1.0,1,3,4,1,0,0,2,1,36,3,1,Paul George,LAC,UTA,LAC,30.5,Pts+Rebs,41,40,37,5
22023,202331,22300085,"OCT 27, 2023",LAC @ UTA,L,38,9,17,0.529,3,9,0.333,15,15,1.0,1,3,4,1,0,0,2,1,36,3,1,Paul George,LAC,UTA,LAC,27.5,Pts+Asts,41,40,37,5
22023,202331,22300085,"OCT 27, 2023",LAC @ UTA,L,38,9,17,0.529,3,9,0.333,15,15,1.0,1,3,4,1,0,0,2,1,36,3,1,Paul George,LAC,UTA,LAC,9.0,Rebs+Asts,41,40,37,5
22023,202331,22300074,"OCT 25, 2023",LAC vs. POR,W,32,11,17,0.647,4,7,0.571,1,1,1.0,0,3,3,6,3,0,4,2,27,23,1,Paul George,LAC,LAC,POR,24.5,Points,36,30,33,9
22023,202331,22300074,"OCT 25, 2023",LAC vs. POR,W,32,11,17,0.647,4,7,0.571,1,1,1.0,0,3,3,6,3,0,4,2,27,23,1,Paul George,LAC,LAC,POR,6.0,Rebounds,36,30,33,9
22023,202331,22300074,"OCT 25, 2023",LAC vs. POR,W,32,11,17,0.647,4,7,0.571,1,1,1.0,0,3,3,6,3,0,4,2,27,23,1,Paul George,LAC,LAC,POR,33.5,Pts+Rebs+Asts,36,30,33,9
22023,202331,22300074,"OCT 25, 2023",LAC vs. POR,W,32,11,17,0.647,4,7,0.571,1,1,1.0,0,3,3,6,3,0,4,2,27,23,1,Paul George,LAC,LAC,POR,38.0,Fantasy Score,36,30,33,9
22023,202331,22300074,"OCT 25, 2023",LAC vs. POR,W,32,11,17,0.647,4,7,0.571,1,1,1.0,0,3,3,6,3,0,4,2,27,23,1,Paul George,LAC,LAC,POR,0.5,Offensive Rebounds,36,30,33,9
22023,202331,22300074,"OCT 25, 2023",LAC vs. POR,W,32,11,17,0.647,4,7,0.571,1,1,1.0,0,3,3,6,3,0,4,2,27,23,1,Paul George,LAC,LAC,POR,9.5,3-PT Attempted,36,30,33,9
22023,202331,22300074,"OCT 25, 2023",LAC vs. POR,W,32,11,17,0.647,4,7,0.571,1,1,1.0,0,3,3,6,3,0,4,2,27,23,1,Paul George,LAC,LAC,POR,3.5,Free Throws Made,36,30,33,9
22023,202331,22300074,"OCT 25, 2023",LAC vs. POR,W,32,11,17,0.647,4,7,0.571,1,1,1.0,0,3,3,6,3,0,4,2,27,23,1,Paul George,LAC,LAC,POR,19.0,FG Attempted,36,30,33,9
22023,202331,22300074,"OCT 25, 2023",LAC vs. POR,W,32,11,17,0.647,4,7,0.571,1,1,1.0,0,3,3,6,3,0,4,2,27,23,1,Paul George,LAC,LAC,POR,30.5,Pts+Rebs,36,30,33,9
22023,202331,22300074,"OCT 25, 2023",LAC vs. POR,W,32,11,17,0.647,4,7,0.571,1,1,1.0,0,3,3,6,3,0,4,2,27,23,1,Paul George,LAC,LAC,POR,27.5,Pts+Asts,36,30,33,9
22023,202331,22300074,"OCT 25, 2023",LAC vs. POR,W,32,11,17,0.647,4,7,0.571,1,1,1.0,0,3,3,6,3,0,4,2,27,23,1,Paul George,LAC,LAC,POR,9.0,Rebs+Asts,36,30,33,9
22023,1630581,22300565,"JAN 15, 2024",OKC @ LAL,L,22,2,8,0.25,2,5,0.4,2,2,1.0,2,3,5,3,0,1,0,1,8,-6,1,Josh Giddey,OKC,LAL,OKC,10.5,Points,16,13,11,8
22023,1630581,22300565,"JAN 15, 2024",OKC @ LAL,L,22,2,8,0.25,2,5,0.4,2,2,1.0,2,3,5,3,0,1,0,1,8,-6,1,Josh Giddey,OKC,LAL,OKC,6.0,Rebounds,16,13,11,8
22023,1630581,22300565,"JAN 15, 2024",OKC @ LAL,L,22,2,8,0.25,2,5,0.4,2,2,1.0,2,3,5,3,0,1,0,1,8,-6,1,Josh Giddey,OKC,LAL,OKC,20.5,Pts+Rebs+Asts,16,13,11,8
22023,1630581,22300565,"JAN 15, 2024",OKC @ LAL,L,22,2,8,0.25,2,5,0.4,2,2,1.0,2,3,5,3,0,1,0,1,8,-6,1,Josh Giddey,OKC,LAL,OKC,4.0,Assists,16,13,11,8
22023,1630581,22300565,"JAN 15, 2024",OKC @ LAL,L,22,2,8,0.25,2,5,0.4,2,2,1.0,2,3,5,3,0,1,0,1,8,-6,1,Josh Giddey,OKC,LAL,OKC,25.0,Fantasy Score,16,13,11,8
22023,1630581,22300565,"JAN 15, 2024",OKC @ LAL,L,22,2,8,0.25,2,5,0.4,2,2,1.0,2,3,5,3,0,1,0,1,8,-6,1,Josh Giddey,OKC,LAL,OKC,16.5,Pts+Rebs,16,13,11,8
22023,1630581,22300565,"JAN 15, 2024",OKC @ LAL,L,22,2,8,0.25,2,5,0.4,2,2,1.0,2,3,5,3,0,1,0,1,8,-6,1,Josh Giddey,OKC,LAL,OKC,14.5,Pts+Asts,16,13,11,8
22023,1630581,22300565,"JAN 15, 2024",OKC @ LAL,L,22,2,8,0.25,2,5,0.4,2,2,1.0,2,3,5,3,0,1,0,1,8,-6,1,Josh Giddey,OKC,LAL,OKC,10.5,Rebs+Asts,16,13,11,8
22023,1630581,22300546,"JAN 13, 2024",OKC vs. ORL,W,27,4,12,0.333,1,5,0.2,3,4,0.75,1,7,8,4,1,0,0,1,12,15,1,Josh Giddey,OKC,OKC,ORL,10.5,Points,24,20,16,12
22023,1630581,22300546,"JAN 13, 2024",OKC vs. ORL,W,27,4,12,0.333,1,5,0.2,3,4,0.75,1,7,8,4,1,0,0,1,12,15,1,Josh Giddey,OKC,OKC,ORL,6.0,Rebounds,24,20,16,12
22023,1630581,22300546,"JAN 13, 2024",OKC vs. ORL,W,27,4,12,0.333,1,5,0.2,3,4,0.75,1,7,8,4,1,0,0,1,12,15,1,Josh Giddey,OKC,OKC,ORL,20.5,Pts+Rebs+Asts,24,20,16,12
22023,1630581,22300546,"JAN 13, 2024",OKC vs. ORL,W,27,4,12,0.333,1,5,0.2,3,4,0.75,1,7,8,4,1,0,0,1,12,15,1,Josh Giddey,OKC,OKC,ORL,4.0,Assists,24,20,16,12
22023,1630581,22300546,"JAN 13, 2024",OKC vs. ORL,W,27,4,12,0.333,1,5,0.2,3,4,0.75,1,7,8,4,1,0,0,1,12,15,1,Josh Giddey,OKC,OKC,ORL,25.0,Fantasy Score,24,20,16,12
22023,1630581,22300546,"JAN 13, 2024",OKC vs. ORL,W,27,4,12,0.333,1,5,0.2,3,4,0.75,1,7,8,4,1,0,0,1,12,15,1,Josh Giddey,OKC,OKC,ORL,16.5,Pts+Rebs,24,20,16,12
22023,1630581,22300546,"JAN 13, 2024",OKC vs. ORL,W,27,4,12,0.333,1,5,0.2,3,4,0.75,1,7,8,4,1,0,0,1,12,15,1,Josh Giddey,OKC,OKC,ORL,14.5,Pts+Asts,24,20,16,12
22023,1630581,22300546,"JAN 13, 2024",OKC vs. ORL,W,27,4,12,0.333,1,5,0.2,3,4,0.75,1,7,8,4,1,0,0,1,12,15,1,Josh Giddey,OKC,OKC,ORL,10.5,Rebs+Asts,24,20,16,12
22023,1630581,22300529,"JAN 11, 2024",OKC vs. POR,W,23,5,5,1.0,0,0,0.0,3,3,1.0,0,10,10,12,0,3,1,0,13,46,1,Josh Giddey,OKC,OKC,POR,10.5,Points,35,23,25,22
22023,1630581,22300529,"JAN 11, 2024",OKC vs. POR,W,23,5,5,1.0,0,0,0.0,3,3,1.0,0,10,10,12,0,3,1,0,13,46,1,Josh Giddey,OKC,OKC,POR,6.0,Rebounds,35,23,25,22
22023,1630581,22300529,"JAN 11, 2024",OKC vs. POR,W,23,5,5,1.0,0,0,0.0,3,3,1.0,0,10,10,12,0,3,1,0,13,46,1,Josh Giddey,OKC,OKC,POR,20.5,Pts+Rebs+Asts,35,23,25,22
22023,1630581,22300529,"JAN 11, 2024",OKC vs. POR,W,23,5,5,1.0,0,0,0.0,3,3,1.0,0,10,10,12,0,3,1,0,13,46,1,Josh Giddey,OKC,OKC,POR,4.0,Assists,35,23,25,22
22023,1630581,22300529,"JAN 11, 2024",OKC vs. POR,W,23,5,5,1.0,0,0,0.0,3,3,1.0,0,10,10,12,0,3,1,0,13,46,1,Josh Giddey,OKC,OKC,POR,25.0,Fantasy Score,35,23,25,22
22023,1630581,22300529,"JAN 11, 2024",OKC vs. POR,W,23,5,5,1.0,0,0,0.0,3,3,1.0,0,10,10,12,0,3,1,0,13,46,1,Josh Giddey,OKC,OKC,POR,16.5,Pts+Rebs,35,23,25,22
22023,1630581,22300529,"JAN 11, 2024",OKC vs. POR,W,23,5,5,1.0,0,0,0.0,3,3,1.0,0,10,10,12,0,3,1,0,13,46,1,Josh Giddey,OKC,OKC,POR,14.5,Pts+Asts,35,23,25,22
22023,1630581,22300529,"JAN 11, 2024",OKC vs. POR,W,23,5,5,1.0,0,0,0.0,3,3,1.0,0,10,10,12,0,3,1,0,13,46,1,Josh Giddey,OKC,OKC,POR,10.5,Rebs+Asts,35,23,25,22
22023,1630581,22300522,"JAN 10, 2024",OKC @ MIA,W,20,3,5,0.6,1,2,0.5,2,2,1.0,0,7,7,2,1,0,2,0,9,7,1,Josh Giddey,OKC,MIA,OKC,10.5,Points,18,16,11,9
22023,1630581,22300522,"JAN 10, 2024",OKC @ MIA,W,20,3,5,0.6,1,2,0.5,2,2,1.0,0,7,7,2,1,0,2,0,9,7,1,Josh Giddey,OKC,MIA,OKC,6.0,Rebounds,18,16,11,9
22023,1630581,22300522,"JAN 10, 2024",OKC @ MIA,W,20,3,5,0.6,1,2,0.5,2,2,1.0,0,7,7,2,1,0,2,0,9,7,1,Josh Giddey,OKC,MIA,OKC,20.5,Pts+Rebs+Asts,18,16,11,9
22023,1630581,22300522,"JAN 10, 2024",OKC @ MIA,W,20,3,5,0.6,1,2,0.5,2,2,1.0,0,7,7,2,1,0,2,0,9,7,1,Josh Giddey,OKC,MIA,OKC,4.0,Assists,18,16,11,9
22023,1630581,22300522,"JAN 10, 2024",OKC @ MIA,W,20,3,5,0.6,1,2,0.5,2,2,1.0,0,7,7,2,1,0,2,0,9,7,1,Josh Giddey,OKC,MIA,OKC,25.0,Fantasy Score,18,16,11,9
22023,1630581,22300522,"JAN 10, 2024",OKC @ MIA,W,20,3,5,0.6,1,2,0.5,2,2,1.0,0,7,7,2,1,0,2,0,9,7,1,Josh Giddey,OKC,MIA,OKC,16.5,Pts+Rebs,18,16,11,9
22023,1630581,22300522,"JAN 10, 2024",OKC @ MIA,W,20,3,5,0.6,1,2,0.5,2,2,1.0,0,7,7,2,1,0,2,0,9,7,1,Josh Giddey,OKC,MIA,OKC,14.5,Pts+Asts,18,16,11,9
22023,1630581,22300522,"JAN 10, 2024",OKC @ MIA,W,20,3,5,0.6,1,2,0.5,2,2,1.0,0,7,7,2,1,0,2,0,9,7,1,Josh Giddey,OKC,MIA,OKC,10.5,Rebs+Asts,18,16,11,9
22023,1630581,22300508,"JAN 08, 2024",OKC @ WAS,W,26,4,11,0.364,1,3,0.333,0,0,0.0,1,5,6,9,2,0,1,2,9,22,1,Josh Giddey,OKC,WAS,OKC,10.5,Points,24,15,18,15
22023,1630581,22300508,"JAN 08, 2024",OKC @ WAS,W,26,4,11,0.364,1,3,0.333,0,0,0.0,1,5,6,9,2,0,1,2,9,22,1,Josh Giddey,OKC,WAS,OKC,6.0,Rebounds,24,15,18,15
22023,1630581,22300508,"JAN 08, 2024",OKC @ WAS,W,26,4,11,0.364,1,3,0.333,0,0,0.0,1,5,6,9,2,0,1,2,9,22,1,Josh Giddey,OKC,WAS,OKC,20.5,Pts+Rebs+Asts,24,15,18,15
22023,1630581,22300508,"JAN 08, 2024",OKC @ WAS,W,26,4,11,0.364,1,3,0.333,0,0,0.0,1,5,6,9,2,0,1,2,9,22,1,Josh Giddey,OKC,WAS,OKC,4.0,Assists,24,15,18,15
22023,1630581,22300508,"JAN 08, 2024",OKC @ WAS,W,26,4,11,0.364,1,3,0.333,0,0,0.0,1,5,6,9,2,0,1,2,9,22,1,Josh Giddey,OKC,WAS,OKC,25.0,Fantasy Score,24,15,18,15
22023,1630581,22300508,"JAN 08, 2024",OKC @ WAS,W,26,4,11,0.364,1,3,0.333,0,0,0.0,1,5,6,9,2,0,1,2,9,22,1,Josh Giddey,OKC,WAS,OKC,16.5,Pts+Rebs,24,15,18,15
22023,1630581,22300508,"JAN 08, 2024",OKC @ WAS,W,26,4,11,0.364,1,3,0.333,0,0,0.0,1,5,6,9,2,0,1,2,9,22,1,Josh Giddey,OKC,WAS,OKC,14.5,Pts+Asts,24,15,18,15
22023,1630581,22300508,"JAN 08, 2024",OKC @ WAS,W,26,4,11,0.364,1,3,0.333,0,0,0.0,1,5,6,9,2,0,1,2,9,22,1,Josh Giddey,OKC,WAS,OKC,10.5,Rebs+Asts,24,15,18,15
22023,1630581,22300481,"JAN 05, 2024",OKC @ BKN,L,24,5,9,0.556,0,1,0.0,3,4,0.75,0,8,8,5,1,1,2,3,13,-7,1,Josh Giddey,OKC,BKN,OKC,10.5,Points,26,21,18,13
22023,1630581,22300481,"JAN 05, 2024",OKC @ BKN,L,24,5,9,0.556,0,1,0.0,3,4,0.75,0,8,8,5,1,1,2,3,13,-7,1,Josh Giddey,OKC,BKN,OKC,6.0,Rebounds,26,21,18,13
22023,1630581,22300481,"JAN 05, 2024",OKC @ BKN,L,24,5,9,0.556,0,1,0.0,3,4,0.75,0,8,8,5,1,1,2,3,13,-7,1,Josh Giddey,OKC,BKN,OKC,20.5,Pts+Rebs+Asts,26,21,18,13
22023,1630581,22300481,"JAN 05, 2024",OKC @ BKN,L,24,5,9,0.556,0,1,0.0,3,4,0.75,0,8,8,5,1,1,2,3,13,-7,1,Josh Giddey,OKC,BKN,OKC,4.0,Assists,26,21,18,13
22023,1630581,22300481,"JAN 05, 2024",OKC @ BKN,L,24,5,9,0.556,0,1,0.0,3,4,0.75,0,8,8,5,1,1,2,3,13,-7,1,Josh Giddey,OKC,BKN,OKC,25.0,Fantasy Score,26,21,18,13
22023,1630581,22300481,"JAN 05, 2024",OKC @ BKN,L,24,5,9,0.556,0,1,0.0,3,4,0.75,0,8,8,5,1,1,2,3,13,-7,1,Josh Giddey,OKC,BKN,OKC,16.5,Pts+Rebs,26,21,18,13
22023,1630581,22300481,"JAN 05, 2024",OKC @ BKN,L,24,5,9,0.556,0,1,0.0,3,4,0.75,0,8,8,5,1,1,2,3,13,-7,1,Josh Giddey,OKC,BKN,OKC,14.5,Pts+Asts,26,21,18,13
22023,1630581,22300481,"JAN 05, 2024",OKC @ BKN,L,24,5,9,0.556,0,1,0.0,3,4,0.75,0,8,8,5,1,1,2,3,13,-7,1,Josh Giddey,OKC,BKN,OKC,10.5,Rebs+Asts,26,21,18,13
22023,1630581,22300467,"JAN 03, 2024",OKC @ ATL,L,22,3,7,0.429,2,3,0.667,1,2,0.5,2,1,3,4,1,0,2,1,9,1,1,Josh Giddey,OKC,ATL,OKC,10.5,Points,16,12,13,7
22023,1630581,22300467,"JAN 03, 2024",OKC @ ATL,L,22,3,7,0.429,2,3,0.667,1,2,0.5,2,1,3,4,1,0,2,1,9,1,1,Josh Giddey,OKC,ATL,OKC,6.0,Rebounds,16,12,13,7
22023,1630581,22300467,"JAN 03, 2024",OKC @ ATL,L,22,3,7,0.429,2,3,0.667,1,2,0.5,2,1,3,4,1,0,2,1,9,1,1,Josh Giddey,OKC,ATL,OKC,20.5,Pts+Rebs+Asts,16,12,13,7
22023,1630581,22300467,"JAN 03, 2024",OKC @ ATL,L,22,3,7,0.429,2,3,0.667,1,2,0.5,2,1,3,4,1,0,2,1,9,1,1,Josh Giddey,OKC,ATL,OKC,4.0,Assists,16,12,13,7
22023,1630581,22300467,"JAN 03, 2024",OKC @ ATL,L,22,3,7,0.429,2,3,0.667,1,2,0.5,2,1,3,4,1,0,2,1,9,1,1,Josh Giddey,OKC,ATL,OKC,25.0,Fantasy Score,16,12,13,7
22023,1630581,22300467,"JAN 03, 2024",OKC @ ATL,L,22,3,7,0.429,2,3,0.667,1,2,0.5,2,1,3,4,1,0,2,1,9,1,1,Josh Giddey,OKC,ATL,OKC,16.5,Pts+Rebs,16,12,13,7
22023,1630581,22300467,"JAN 03, 2024",OKC @ ATL,L,22,3,7,0.429,2,3,0.667,1,2,0.5,2,1,3,4,1,0,2,1,9,1,1,Josh Giddey,OKC,ATL,OKC,14.5,Pts+Asts,16,12,13,7
22023,1630581,22300467,"JAN 03, 2024",OKC @ ATL,L,22,3,7,0.429,2,3,0.667,1,2,0.5,2,1,3,4,1,0,2,1,9,1,1,Josh Giddey,OKC,ATL,OKC,10.5,Rebs+Asts,16,12,13,7
22023,1630581,22300462,"JAN 02, 2024",OKC vs. BOS,W,27,8,14,0.571,4,7,0.571,3,3,1.0,1,7,8,6,0,0,3,0,23,10,1,Josh Giddey,OKC,OKC,BOS,10.5,Points,37,31,29,14
22023,1630581,22300462,"JAN 02, 2024",OKC vs. BOS,W,27,8,14,0.571,4,7,0.571,3,3,1.0,1,7,8,6,0,0,3,0,23,10,1,Josh Giddey,OKC,OKC,BOS,6.0,Rebounds,37,31,29,14
22023,1630581,22300462,"JAN 02, 2024",OKC vs. BOS,W,27,8,14,0.571,4,7,0.571,3,3,1.0,1,7,8,6,0,0,3,0,23,10,1,Josh Giddey,OKC,OKC,BOS,20.5,Pts+Rebs+Asts,37,31,29,14
22023,1630581,22300462,"JAN 02, 2024",OKC vs. BOS,W,27,8,14,0.571,4,7,0.571,3,3,1.0,1,7,8,6,0,0,3,0,23,10,1,Josh Giddey,OKC,OKC,BOS,4.0,Assists,37,31,29,14
22023,1630581,22300462,"JAN 02, 2024",OKC vs. BOS,W,27,8,14,0.571,4,7,0.571,3,3,1.0,1,7,8,6,0,0,3,0,23,10,1,Josh Giddey,OKC,OKC,BOS,25.0,Fantasy Score,37,31,29,14
22023,1630581,22300462,"JAN 02, 2024",OKC vs. BOS,W,27,8,14,0.571,4,7,0.571,3,3,1.0,1,7,8,6,0,0,3,0,23,10,1,Josh Giddey,OKC,OKC,BOS,16.5,Pts+Rebs,37,31,29,14
22023,1630581,22300462,"JAN 02, 2024",OKC vs. BOS,W,27,8,14,0.571,4,7,0.571,3,3,1.0,1,7,8,6,0,0,3,0,23,10,1,Josh Giddey,OKC,OKC,BOS,14.5,Pts+Asts,37,31,29,14
22023,1630581,22300462,"JAN 02, 2024",OKC vs. BOS,W,27,8,14,0.571,4,7,0.571,3,3,1.0,1,7,8,6,0,0,3,0,23,10,1,Josh Giddey,OKC,OKC,BOS,10.5,Rebs+Asts,37,31,29,14
22023,1630581,22300447,"DEC 31, 2023",OKC vs. BKN,W,27,8,16,0.5,4,8,0.5,0,0,0.0,1,5,6,5,0,0,2,3,20,4,1,Josh Giddey,OKC,OKC,BKN,10.5,Points,31,26,25,11
22023,1630581,22300447,"DEC 31, 2023",OKC vs. BKN,W,27,8,16,0.5,4,8,0.5,0,0,0.0,1,5,6,5,0,0,2,3,20,4,1,Josh Giddey,OKC,OKC,BKN,6.0,Rebounds,31,26,25,11
22023,1630581,22300447,"DEC 31, 2023",OKC vs. BKN,W,27,8,16,0.5,4,8,0.5,0,0,0.0,1,5,6,5,0,0,2,3,20,4,1,Josh Giddey,OKC,OKC,BKN,20.5,Pts+Rebs+Asts,31,26,25,11
22023,1630581,22300447,"DEC 31, 2023",OKC vs. BKN,W,27,8,16,0.5,4,8,0.5,0,0,0.0,1,5,6,5,0,0,2,3,20,4,1,Josh Giddey,OKC,OKC,BKN,4.0,Assists,31,26,25,11
22023,1630581,22300447,"DEC 31, 2023",OKC vs. BKN,W,27,8,16,0.5,4,8,0.5,0,0,0.0,1,5,6,5,0,0,2,3,20,4,1,Josh Giddey,OKC,OKC,BKN,25.0,Fantasy Score,31,26,25,11
22023,1630581,22300447,"DEC 31, 2023",OKC vs. BKN,W,27,8,16,0.5,4,8,0.5,0,0,0.0,1,5,6,5,0,0,2,3,20,4,1,Josh Giddey,OKC,OKC,BKN,16.5,Pts+Rebs,31,26,25,11
22023,1630581,22300447,"DEC 31, 2023",OKC vs. BKN,W,27,8,16,0.5,4,8,0.5,0,0,0.0,1,5,6,5,0,0,2,3,20,4,1,Josh Giddey,OKC,OKC,BKN,14.5,Pts+Asts,31,26,25,11
22023,1630581,22300447,"DEC 31, 2023",OKC vs. BKN,W,27,8,16,0.5,4,8,0.5,0,0,0.0,1,5,6,5,0,0,2,3,20,4,1,Josh Giddey,OKC,OKC,BKN,10.5,Rebs+Asts,31,26,25,11
22023,1630581,22300435,"DEC 29, 2023",OKC @ DEN,W,21,6,10,0.6,0,1,0.0,0,0,0.0,2,6,8,4,1,0,3,1,12,16,1,Josh Giddey,OKC,DEN,OKC,10.5,Points,24,20,16,12
22023,1630581,22300435,"DEC 29, 2023",OKC @ DEN,W,21,6,10,0.6,0,1,0.0,0,0,0.0,2,6,8,4,1,0,3,1,12,16,1,Josh Giddey,OKC,DEN,OKC,6.0,Rebounds,24,20,16,12
22023,1630581,22300435,"DEC 29, 2023",OKC @ DEN,W,21,6,10,0.6,0,1,0.0,0,0,0.0,2,6,8,4,1,0,3,1,12,16,1,Josh Giddey,OKC,DEN,OKC,20.5,Pts+Rebs+Asts,24,20,16,12
22023,1630581,22300435,"DEC 29, 2023",OKC @ DEN,W,21,6,10,0.6,0,1,0.0,0,0,0.0,2,6,8,4,1,0,3,1,12,16,1,Josh Giddey,OKC,DEN,OKC,4.0,Assists,24,20,16,12
22023,1630581,22300435,"DEC 29, 2023",OKC @ DEN,W,21,6,10,0.6,0,1,0.0,0,0,0.0,2,6,8,4,1,0,3,1,12,16,1,Josh Giddey,OKC,DEN,OKC,25.0,Fantasy Score,24,20,16,12
22023,1630581,22300435,"DEC 29, 2023",OKC @ DEN,W,21,6,10,0.6,0,1,0.0,0,0,0.0,2,6,8,4,1,0,3,1,12,16,1,Josh Giddey,OKC,DEN,OKC,16.5,Pts+Rebs,24,20,16,12
22023,1630581,22300435,"DEC 29, 2023",OKC @ DEN,W,21,6,10,0.6,0,1,0.0,0,0,0.0,2,6,8,4,1,0,3,1,12,16,1,Josh Giddey,OKC,DEN,OKC,14.5,Pts+Asts,24,20,16,12
22023,1630581,22300435,"DEC 29, 2023",OKC @ DEN,W,21,6,10,0.6,0,1,0.0,0,0,0.0,2,6,8,4,1,0,3,1,12,16,1,Josh Giddey,OKC,DEN,OKC,10.5,Rebs+Asts,24,20,16,12
22023,1630581,22300419,"DEC 27, 2023",OKC vs. NYK,W,29,3,4,0.75,0,0,0.0,1,2,0.5,0,6,6,2,0,2,2,1,7,11,1,Josh Giddey,OKC,OKC,NYK,10.5,Points,15,13,9,8
22023,1630581,22300419,"DEC 27, 2023",OKC vs. NYK,W,29,3,4,0.75,0,0,0.0,1,2,0.5,0,6,6,2,0,2,2,1,7,11,1,Josh Giddey,OKC,OKC,NYK,6.0,Rebounds,15,13,9,8
22023,1630581,22300419,"DEC 27, 2023",OKC vs. NYK,W,29,3,4,0.75,0,0,0.0,1,2,0.5,0,6,6,2,0,2,2,1,7,11,1,Josh Giddey,OKC,OKC,NYK,20.5,Pts+Rebs+Asts,15,13,9,8
22023,1630581,22300419,"DEC 27, 2023",OKC vs. NYK,W,29,3,4,0.75,0,0,0.0,1,2,0.5,0,6,6,2,0,2,2,1,7,11,1,Josh Giddey,OKC,OKC,NYK,4.0,Assists,15,13,9,8
22023,1630581,22300419,"DEC 27, 2023",OKC vs. NYK,W,29,3,4,0.75,0,0,0.0,1,2,0.5,0,6,6,2,0,2,2,1,7,11,1,Josh Giddey,OKC,OKC,NYK,25.0,Fantasy Score,15,13,9,8
22023,1630581,22300419,"DEC 27, 2023",OKC vs. NYK,W,29,3,4,0.75,0,0,0.0,1,2,0.5,0,6,6,2,0,2,2,1,7,11,1,Josh Giddey,OKC,OKC,NYK,16.5,Pts+Rebs,15,13,9,8
22023,1630581,22300419,"DEC 27, 2023",OKC vs. NYK,W,29,3,4,0.75,0,0,0.0,1,2,0.5,0,6,6,2,0,2,2,1,7,11,1,Josh Giddey,OKC,OKC,NYK,14.5,Pts+Asts,15,13,9,8
22023,1630581,22300419,"DEC 27, 2023",OKC vs. NYK,W,29,3,4,0.75,0,0,0.0,1,2,0.5,0,6,6,2,0,2,2,1,7,11,1,Josh Giddey,OKC,OKC,NYK,10.5,Rebs+Asts,15,13,9,8
22023,1630581,22300411,"DEC 26, 2023",OKC vs. MIN,W,25,4,7,0.571,0,2,0.0,2,2,1.0,0,2,2,7,0,0,2,3,10,21,1,Josh Giddey,OKC,OKC,MIN,10.5,Points,19,12,17,9
22023,1630581,22300411,"DEC 26, 2023",OKC vs. MIN,W,25,4,7,0.571,0,2,0.0,2,2,1.0,0,2,2,7,0,0,2,3,10,21,1,Josh Giddey,OKC,OKC,MIN,6.0,Rebounds,19,12,17,9
22023,1630581,22300411,"DEC 26, 2023",OKC vs. MIN,W,25,4,7,0.571,0,2,0.0,2,2,1.0,0,2,2,7,0,0,2,3,10,21,1,Josh Giddey,OKC,OKC,MIN,20.5,Pts+Rebs+Asts,19,12,17,9
22023,1630581,22300411,"DEC 26, 2023",OKC vs. MIN,W,25,4,7,0.571,0,2,0.0,2,2,1.0,0,2,2,7,0,0,2,3,10,21,1,Josh Giddey,OKC,OKC,MIN,4.0,Assists,19,12,17,9
22023,1630581,22300411,"DEC 26, 2023",OKC vs. MIN,W,25,4,7,0.571,0,2,0.0,2,2,1.0,0,2,2,7,0,0,2,3,10,21,1,Josh Giddey,OKC,OKC,MIN,25.0,Fantasy Score,19,12,17,9
22023,1630581,22300411,"DEC 26, 2023",OKC vs. MIN,W,25,4,7,0.571,0,2,0.0,2,2,1.0,0,2,2,7,0,0,2,3,10,21,1,Josh Giddey,OKC,OKC,MIN,16.5,Pts+Rebs,19,12,17,9
22023,1630581,22300411,"DEC 26, 2023",OKC vs. MIN,W,25,4,7,0.571,0,2,0.0,2,2,1.0,0,2,2,7,0,0,2,3,10,21,1,Josh Giddey,OKC,OKC,MIN,14.5,Pts+Asts,19,12,17,9
22023,1630581,22300411,"DEC 26, 2023",OKC vs. MIN,W,25,4,7,0.571,0,2,0.0,2,2,1.0,0,2,2,7,0,0,2,3,10,21,1,Josh Giddey,OKC,OKC,MIN,10.5,Rebs+Asts,19,12,17,9
22023,1630581,22300379,"DEC 21, 2023",OKC vs. LAC,W,14,4,5,0.8,3,3,1.0,0,0,0.0,1,2,3,4,0,0,5,0,11,2,1,Josh Giddey,OKC,OKC,LAC,10.5,Points,18,14,15,7
22023,1630581,22300379,"DEC 21, 2023",OKC vs. LAC,W,14,4,5,0.8,3,3,1.0,0,0,0.0,1,2,3,4,0,0,5,0,11,2,1,Josh Giddey,OKC,OKC,LAC,6.0,Rebounds,18,14,15,7
22023,1630581,22300379,"DEC 21, 2023",OKC vs. LAC,W,14,4,5,0.8,3,3,1.0,0,0,0.0,1,2,3,4,0,0,5,0,11,2,1,Josh Giddey,OKC,OKC,LAC,20.5,Pts+Rebs+Asts,18,14,15,7
22023,1630581,22300379,"DEC 21, 2023",OKC vs. LAC,W,14,4,5,0.8,3,3,1.0,0,0,0.0,1,2,3,4,0,0,5,0,11,2,1,Josh Giddey,OKC,OKC,LAC,4.0,Assists,18,14,15,7
22023,1630581,22300379,"DEC 21, 2023",OKC vs. LAC,W,14,4,5,0.8,3,3,1.0,0,0,0.0,1,2,3,4,0,0,5,0,11,2,1,Josh Giddey,OKC,OKC,LAC,25.0,Fantasy Score,18,14,15,7
22023,1630581,22300379,"DEC 21, 2023",OKC vs. LAC,W,14,4,5,0.8,3,3,1.0,0,0,0.0,1,2,3,4,0,0,5,0,11,2,1,Josh Giddey,OKC,OKC,LAC,16.5,Pts+Rebs,18,14,15,7
22023,1630581,22300379,"DEC 21, 2023",OKC vs. LAC,W,14,4,5,0.8,3,3,1.0,0,0,0.0,1,2,3,4,0,0,5,0,11,2,1,Josh Giddey,OKC,OKC,LAC,14.5,Pts+Asts,18,14,15,7
22023,1630581,22300379,"DEC 21, 2023",OKC vs. LAC,W,14,4,5,0.8,3,3,1.0,0,0,0.0,1,2,3,4,0,0,5,0,11,2,1,Josh Giddey,OKC,OKC,LAC,10.5,Rebs+Asts,18,14,15,7
22023,1630581,22300355,"DEC 18, 2023",OKC vs. MEM,W,24,6,12,0.5,0,4,0.0,4,4,1.0,3,9,12,4,1,0,1,0,16,16,1,Josh Giddey,OKC,OKC,MEM,10.5,Points,32,28,20,16
22023,1630581,22300355,"DEC 18, 2023",OKC vs. MEM,W,24,6,12,0.5,0,4,0.0,4,4,1.0,3,9,12,4,1,0,1,0,16,16,1,Josh Giddey,OKC,OKC,MEM,6.0,Rebounds,32,28,20,16
22023,1630581,22300355,"DEC 18, 2023",OKC vs. MEM,W,24,6,12,0.5,0,4,0.0,4,4,1.0,3,9,12,4,1,0,1,0,16,16,1,Josh Giddey,OKC,OKC,MEM,20.5,Pts+Rebs+Asts,32,28,20,16
22023,1630581,22300355,"DEC 18, 2023",OKC vs. MEM,W,24,6,12,0.5,0,4,0.0,4,4,1.0,3,9,12,4,1,0,1,0,16,16,1,Josh Giddey,OKC,OKC,MEM,4.0,Assists,32,28,20,16
22023,1630581,22300355,"DEC 18, 2023",OKC vs. MEM,W,24,6,12,0.5,0,4,0.0,4,4,1.0,3,9,12,4,1,0,1,0,16,16,1,Josh Giddey,OKC,OKC,MEM,25.0,Fantasy Score,32,28,20,16
22023,1630581,22300355,"DEC 18, 2023",OKC vs. MEM,W,24,6,12,0.5,0,4,0.0,4,4,1.0,3,9,12,4,1,0,1,0,16,16,1,Josh Giddey,OKC,OKC,MEM,16.5,Pts+Rebs,32,28,20,16
22023,1630581,22300355,"DEC 18, 2023",OKC vs. MEM,W,24,6,12,0.5,0,4,0.0,4,4,1.0,3,9,12,4,1,0,1,0,16,16,1,Josh Giddey,OKC,OKC,MEM,14.5,Pts+Asts,32,28,20,16
22023,1630581,22300355,"DEC 18, 2023",OKC vs. MEM,W,24,6,12,0.5,0,4,0.0,4,4,1.0,3,9,12,4,1,0,1,0,16,16,1,Josh Giddey,OKC,OKC,MEM,10.5,Rebs+Asts,32,28,20,16
22023,1630581,22300340,"DEC 16, 2023",OKC @ DEN,W,15,2,4,0.5,0,1,0.0,0,0,0.0,0,2,2,4,0,0,1,0,4,-7,1,Josh Giddey,OKC,DEN,OKC,10.5,Points,10,6,8,6
22023,1630581,22300340,"DEC 16, 2023",OKC @ DEN,W,15,2,4,0.5,0,1,0.0,0,0,0.0,0,2,2,4,0,0,1,0,4,-7,1,Josh Giddey,OKC,DEN,OKC,6.0,Rebounds,10,6,8,6
22023,1630581,22300340,"DEC 16, 2023",OKC @ DEN,W,15,2,4,0.5,0,1,0.0,0,0,0.0,0,2,2,4,0,0,1,0,4,-7,1,Josh Giddey,OKC,DEN,OKC,20.5,Pts+Rebs+Asts,10,6,8,6
22023,1630581,22300340,"DEC 16, 2023",OKC @ DEN,W,15,2,4,0.5,0,1,0.0,0,0,0.0,0,2,2,4,0,0,1,0,4,-7,1,Josh Giddey,OKC,DEN,OKC,4.0,Assists,10,6,8,6
22023,1630581,22300340,"DEC 16, 2023",OKC @ DEN,W,15,2,4,0.5,0,1,0.0,0,0,0.0,0,2,2,4,0,0,1,0,4,-7,1,Josh Giddey,OKC,DEN,OKC,25.0,Fantasy Score,10,6,8,6
22023,1630581,22300340,"DEC 16, 2023",OKC @ DEN,W,15,2,4,0.5,0,1,0.0,0,0,0.0,0,2,2,4,0,0,1,0,4,-7,1,Josh Giddey,OKC,DEN,OKC,16.5,Pts+Rebs,10,6,8,6
22023,1630581,22300340,"DEC 16, 2023",OKC @ DEN,W,15,2,4,0.5,0,1,0.0,0,0,0.0,0,2,2,4,0,0,1,0,4,-7,1,Josh Giddey,OKC,DEN,OKC,14.5,Pts+Asts,10,6,8,6
22023,1630581,22300340,"DEC 16, 2023",OKC @ DEN,W,15,2,4,0.5,0,1,0.0,0,0,0.0,0,2,2,4,0,0,1,0,4,-7,1,Josh Giddey,OKC,DEN,OKC,10.5,Rebs+Asts,10,6,8,6
22023,1630581,22300324,"DEC 14, 2023",OKC @ SAC,L,29,8,14,0.571,2,3,0.667,0,0,0.0,5,3,8,4,2,1,4,4,18,10,1,Josh Giddey,OKC,SAC,OKC,10.5,Points,30,26,22,12
22023,1630581,22300324,"DEC 14, 2023",OKC @ SAC,L,29,8,14,0.571,2,3,0.667,0,0,0.0,5,3,8,4,2,1,4,4,18,10,1,Josh Giddey,OKC,SAC,OKC,6.0,Rebounds,30,26,22,12
22023,1630581,22300324,"DEC 14, 2023",OKC @ SAC,L,29,8,14,0.571,2,3,0.667,0,0,0.0,5,3,8,4,2,1,4,4,18,10,1,Josh Giddey,OKC,SAC,OKC,20.5,Pts+Rebs+Asts,30,26,22,12
22023,1630581,22300324,"DEC 14, 2023",OKC @ SAC,L,29,8,14,0.571,2,3,0.667,0,0,0.0,5,3,8,4,2,1,4,4,18,10,1,Josh Giddey,OKC,SAC,OKC,4.0,Assists,30,26,22,12
22023,1630581,22300324,"DEC 14, 2023",OKC @ SAC,L,29,8,14,0.571,2,3,0.667,0,0,0.0,5,3,8,4,2,1,4,4,18,10,1,Josh Giddey,OKC,SAC,OKC,25.0,Fantasy Score,30,26,22,12
22023,1630581,22300324,"DEC 14, 2023",OKC @ SAC,L,29,8,14,0.571,2,3,0.667,0,0,0.0,5,3,8,4,2,1,4,4,18,10,1,Josh Giddey,OKC,SAC,OKC,16.5,Pts+Rebs,30,26,22,12
22023,1630581,22300324,"DEC 14, 2023",OKC @ SAC,L,29,8,14,0.571,2,3,0.667,0,0,0.0,5,3,8,4,2,1,4,4,18,10,1,Josh Giddey,OKC,SAC,OKC,14.5,Pts+Asts,30,26,22,12
22023,1630581,22300324,"DEC 14, 2023",OKC @ SAC,L,29,8,14,0.571,2,3,0.667,0,0,0.0,5,3,8,4,2,1,4,4,18,10,1,Josh Giddey,OKC,SAC,OKC,10.5,Rebs+Asts,30,26,22,12
22023,1630581,22300302,"DEC 11, 2023",OKC vs. UTA,W,24,5,11,0.455,2,3,0.667,0,0,0.0,2,8,10,8,1,1,3,1,12,17,1,Josh Giddey,OKC,OKC,UTA,10.5,Points,30,22,20,18
22023,1630581,22300302,"DEC 11, 2023",OKC vs. UTA,W,24,5,11,0.455,2,3,0.667,0,0,0.0,2,8,10,8,1,1,3,1,12,17,1,Josh Giddey,OKC,OKC,UTA,6.0,Rebounds,30,22,20,18
22023,1630581,22300302,"DEC 11, 2023",OKC vs. UTA,W,24,5,11,0.455,2,3,0.667,0,0,0.0,2,8,10,8,1,1,3,1,12,17,1,Josh Giddey,OKC,OKC,UTA,20.5,Pts+Rebs+Asts,30,22,20,18
22023,1630581,22300302,"DEC 11, 2023",OKC vs. UTA,W,24,5,11,0.455,2,3,0.667,0,0,0.0,2,8,10,8,1,1,3,1,12,17,1,Josh Giddey,OKC,OKC,UTA,4.0,Assists,30,22,20,18
22023,1630581,22300302,"DEC 11, 2023",OKC vs. UTA,W,24,5,11,0.455,2,3,0.667,0,0,0.0,2,8,10,8,1,1,3,1,12,17,1,Josh Giddey,OKC,OKC,UTA,25.0,Fantasy Score,30,22,20,18
22023,1630581,22300302,"DEC 11, 2023",OKC vs. UTA,W,24,5,11,0.455,2,3,0.667,0,0,0.0,2,8,10,8,1,1,3,1,12,17,1,Josh Giddey,OKC,OKC,UTA,16.5,Pts+Rebs,30,22,20,18
22023,1630581,22300302,"DEC 11, 2023",OKC vs. UTA,W,24,5,11,0.455,2,3,0.667,0,0,0.0,2,8,10,8,1,1,3,1,12,17,1,Josh Giddey,OKC,OKC,UTA,14.5,Pts+Asts,30,22,20,18
22023,1630581,22300302,"DEC 11, 2023",OKC vs. UTA,W,24,5,11,0.455,2,3,0.667,0,0,0.0,2,8,10,8,1,1,3,1,12,17,1,Josh Giddey,OKC,OKC,UTA,10.5,Rebs+Asts,30,22,20,18
22023,1630581,22301222,"DEC 08, 2023",OKC vs. GSW,W,25,4,12,0.333,1,6,0.167,0,0,0.0,1,8,9,4,3,0,1,2,9,-10,1,Josh Giddey,OKC,OKC,GSW,10.5,Points,22,18,13,13
22023,1630581,22301222,"DEC 08, 2023",OKC vs. GSW,W,25,4,12,0.333,1,6,0.167,0,0,0.0,1,8,9,4,3,0,1,2,9,-10,1,Josh Giddey,OKC,OKC,GSW,6.0,Rebounds,22,18,13,13
22023,1630581,22301222,"DEC 08, 2023",OKC vs. GSW,W,25,4,12,0.333,1,6,0.167,0,0,0.0,1,8,9,4,3,0,1,2,9,-10,1,Josh Giddey,OKC,OKC,GSW,20.5,Pts+Rebs+Asts,22,18,13,13
22023,1630581,22301222,"DEC 08, 2023",OKC vs. GSW,W,25,4,12,0.333,1,6,0.167,0,0,0.0,1,8,9,4,3,0,1,2,9,-10,1,Josh Giddey,OKC,OKC,GSW,4.0,Assists,22,18,13,13
22023,1630581,22301222,"DEC 08, 2023",OKC vs. GSW,W,25,4,12,0.333,1,6,0.167,0,0,0.0,1,8,9,4,3,0,1,2,9,-10,1,Josh Giddey,OKC,OKC,GSW,25.0,Fantasy Score,22,18,13,13
22023,1630581,22301222,"DEC 08, 2023",OKC vs. GSW,W,25,4,12,0.333,1,6,0.167,0,0,0.0,1,8,9,4,3,0,1,2,9,-10,1,Josh Giddey,OKC,OKC,GSW,16.5,Pts+Rebs,22,18,13,13
22023,1630581,22301222,"DEC 08, 2023",OKC vs. GSW,W,25,4,12,0.333,1,6,0.167,0,0,0.0,1,8,9,4,3,0,1,2,9,-10,1,Josh Giddey,OKC,OKC,GSW,14.5,Pts+Asts,22,18,13,13
22023,1630581,22301222,"DEC 08, 2023",OKC vs. GSW,W,25,4,12,0.333,1,6,0.167,0,0,0.0,1,8,9,4,3,0,1,2,9,-10,1,Josh Giddey,OKC,OKC,GSW,10.5,Rebs+Asts,22,18,13,13
22023,1630581,22301212,"DEC 06, 2023",OKC @ HOU,L,25,3,11,0.273,2,5,0.4,0,0,0.0,1,3,4,6,1,0,0,3,8,-11,1,Josh Giddey,OKC,HOU,OKC,10.5,Points,18,12,14,10
22023,1630581,22301212,"DEC 06, 2023",OKC @ HOU,L,25,3,11,0.273,2,5,0.4,0,0,0.0,1,3,4,6,1,0,0,3,8,-11,1,Josh Giddey,OKC,HOU,OKC,6.0,Rebounds,18,12,14,10
22023,1630581,22301212,"DEC 06, 2023",OKC @ HOU,L,25,3,11,0.273,2,5,0.4,0,0,0.0,1,3,4,6,1,0,0,3,8,-11,1,Josh Giddey,OKC,HOU,OKC,20.5,Pts+Rebs+Asts,18,12,14,10
22023,1630581,22301212,"DEC 06, 2023",OKC @ HOU,L,25,3,11,0.273,2,5,0.4,0,0,0.0,1,3,4,6,1,0,0,3,8,-11,1,Josh Giddey,OKC,HOU,OKC,4.0,Assists,18,12,14,10
22023,1630581,22301212,"DEC 06, 2023",OKC @ HOU,L,25,3,11,0.273,2,5,0.4,0,0,0.0,1,3,4,6,1,0,0,3,8,-11,1,Josh Giddey,OKC,HOU,OKC,25.0,Fantasy Score,18,12,14,10
22023,1630581,22301212,"DEC 06, 2023",OKC @ HOU,L,25,3,11,0.273,2,5,0.4,0,0,0.0,1,3,4,6,1,0,0,3,8,-11,1,Josh Giddey,OKC,HOU,OKC,16.5,Pts+Rebs,18,12,14,10
22023,1630581,22301212,"DEC 06, 2023",OKC @ HOU,L,25,3,11,0.273,2,5,0.4,0,0,0.0,1,3,4,6,1,0,0,3,8,-11,1,Josh Giddey,OKC,HOU,OKC,14.5,Pts+Asts,18,12,14,10
22023,1630581,22301212,"DEC 06, 2023",OKC @ HOU,L,25,3,11,0.273,2,5,0.4,0,0,0.0,1,3,4,6,1,0,0,3,8,-11,1,Josh Giddey,OKC,HOU,OKC,10.5,Rebs+Asts,18,12,14,10
22023,1630581,22300287,"DEC 02, 2023",OKC @ DAL,W,17,4,13,0.308,2,6,0.333,0,0,0.0,2,1,3,1,0,0,2,1,10,1,1,Josh Giddey,OKC,DAL,OKC,10.5,Points,14,13,11,4
22023,1630581,22300287,"DEC 02, 2023",OKC @ DAL,W,17,4,13,0.308,2,6,0.333,0,0,0.0,2,1,3,1,0,0,2,1,10,1,1,Josh Giddey,OKC,DAL,OKC,6.0,Rebounds,14,13,11,4
22023,1630581,22300287,"DEC 02, 2023",OKC @ DAL,W,17,4,13,0.308,2,6,0.333,0,0,0.0,2,1,3,1,0,0,2,1,10,1,1,Josh Giddey,OKC,DAL,OKC,20.5,Pts+Rebs+Asts,14,13,11,4
22023,1630581,22300287,"DEC 02, 2023",OKC @ DAL,W,17,4,13,0.308,2,6,0.333,0,0,0.0,2,1,3,1,0,0,2,1,10,1,1,Josh Giddey,OKC,DAL,OKC,4.0,Assists,14,13,11,4
22023,1630581,22300287,"DEC 02, 2023",OKC @ DAL,W,17,4,13,0.308,2,6,0.333,0,0,0.0,2,1,3,1,0,0,2,1,10,1,1,Josh Giddey,OKC,DAL,OKC,25.0,Fantasy Score,14,13,11,4
22023,1630581,22300287,"DEC 02, 2023",OKC @ DAL,W,17,4,13,0.308,2,6,0.333,0,0,0.0,2,1,3,1,0,0,2,1,10,1,1,Josh Giddey,OKC,DAL,OKC,16.5,Pts+Rebs,14,13,11,4
22023,1630581,22300287,"DEC 02, 2023",OKC @ DAL,W,17,4,13,0.308,2,6,0.333,0,0,0.0,2,1,3,1,0,0,2,1,10,1,1,Josh Giddey,OKC,DAL,OKC,14.5,Pts+Asts,14,13,11,4
22023,1630581,22300287,"DEC 02, 2023",OKC @ DAL,W,17,4,13,0.308,2,6,0.333,0,0,0.0,2,1,3,1,0,0,2,1,10,1,1,Josh Giddey,OKC,DAL,OKC,10.5,Rebs+Asts,14,13,11,4
22023,1630581,22300271,"NOV 30, 2023",OKC vs. LAL,W,21,5,10,0.5,2,5,0.4,2,2,1.0,2,6,8,1,1,0,4,2,14,6,1,Josh Giddey,OKC,OKC,LAL,10.5,Points,23,22,15,9
22023,1630581,22300271,"NOV 30, 2023",OKC vs. LAL,W,21,5,10,0.5,2,5,0.4,2,2,1.0,2,6,8,1,1,0,4,2,14,6,1,Josh Giddey,OKC,OKC,LAL,6.0,Rebounds,23,22,15,9
22023,1630581,22300271,"NOV 30, 2023",OKC vs. LAL,W,21,5,10,0.5,2,5,0.4,2,2,1.0,2,6,8,1,1,0,4,2,14,6,1,Josh Giddey,OKC,OKC,LAL,20.5,Pts+Rebs+Asts,23,22,15,9
22023,1630581,22300271,"NOV 30, 2023",OKC vs. LAL,W,21,5,10,0.5,2,5,0.4,2,2,1.0,2,6,8,1,1,0,4,2,14,6,1,Josh Giddey,OKC,OKC,LAL,4.0,Assists,23,22,15,9
22023,1630581,22300271,"NOV 30, 2023",OKC vs. LAL,W,21,5,10,0.5,2,5,0.4,2,2,1.0,2,6,8,1,1,0,4,2,14,6,1,Josh Giddey,OKC,OKC,LAL,25.0,Fantasy Score,23,22,15,9
22023,1630581,22300271,"NOV 30, 2023",OKC vs. LAL,W,21,5,10,0.5,2,5,0.4,2,2,1.0,2,6,8,1,1,0,4,2,14,6,1,Josh Giddey,OKC,OKC,LAL,16.5,Pts+Rebs,23,22,15,9
22023,1630581,22300271,"NOV 30, 2023",OKC vs. LAL,W,21,5,10,0.5,2,5,0.4,2,2,1.0,2,6,8,1,1,0,4,2,14,6,1,Josh Giddey,OKC,OKC,LAL,14.5,Pts+Asts,23,22,15,9
22023,1630581,22300271,"NOV 30, 2023",OKC vs. LAL,W,21,5,10,0.5,2,5,0.4,2,2,1.0,2,6,8,1,1,0,4,2,14,6,1,Josh Giddey,OKC,OKC,LAL,10.5,Rebs+Asts,23,22,15,9
22023,1630581,22300058,"NOV 28, 2023",OKC @ MIN,L,28,4,8,0.5,0,1,0.0,2,4,0.5,3,3,6,1,0,0,2,1,10,-10,1,Josh Giddey,OKC,MIN,OKC,10.5,Points,17,16,11,7
22023,1630581,22300058,"NOV 28, 2023",OKC @ MIN,L,28,4,8,0.5,0,1,0.0,2,4,0.5,3,3,6,1,0,0,2,1,10,-10,1,Josh Giddey,OKC,MIN,OKC,6.0,Rebounds,17,16,11,7
22023,1630581,22300058,"NOV 28, 2023",OKC @ MIN,L,28,4,8,0.5,0,1,0.0,2,4,0.5,3,3,6,1,0,0,2,1,10,-10,1,Josh Giddey,OKC,MIN,OKC,20.5,Pts+Rebs+Asts,17,16,11,7
22023,1630581,22300058,"NOV 28, 2023",OKC @ MIN,L,28,4,8,0.5,0,1,0.0,2,4,0.5,3,3,6,1,0,0,2,1,10,-10,1,Josh Giddey,OKC,MIN,OKC,4.0,Assists,17,16,11,7
22023,1630581,22300058,"NOV 28, 2023",OKC @ MIN,L,28,4,8,0.5,0,1,0.0,2,4,0.5,3,3,6,1,0,0,2,1,10,-10,1,Josh Giddey,OKC,MIN,OKC,25.0,Fantasy Score,17,16,11,7
22023,1630581,22300058,"NOV 28, 2023",OKC @ MIN,L,28,4,8,0.5,0,1,0.0,2,4,0.5,3,3,6,1,0,0,2,1,10,-10,1,Josh Giddey,OKC,MIN,OKC,16.5,Pts+Rebs,17,16,11,7
22023,1630581,22300058,"NOV 28, 2023",OKC @ MIN,L,28,4,8,0.5,0,1,0.0,2,4,0.5,3,3,6,1,0,0,2,1,10,-10,1,Josh Giddey,OKC,MIN,OKC,14.5,Pts+Asts,17,16,11,7
22023,1630581,22300058,"NOV 28, 2023",OKC @ MIN,L,28,4,8,0.5,0,1,0.0,2,4,0.5,3,3,6,1,0,0,2,1,10,-10,1,Josh Giddey,OKC,MIN,OKC,10.5,Rebs+Asts,17,16,11,7
22023,1630581,22300239,"NOV 25, 2023",OKC vs. PHI,L,26,4,12,0.333,0,1,0.0,2,2,1.0,3,4,7,8,0,0,1,4,10,-13,1,Josh Giddey,OKC,OKC,PHI,10.5,Points,25,17,18,15
22023,1630581,22300239,"NOV 25, 2023",OKC vs. PHI,L,26,4,12,0.333,0,1,0.0,2,2,1.0,3,4,7,8,0,0,1,4,10,-13,1,Josh Giddey,OKC,OKC,PHI,6.0,Rebounds,25,17,18,15
22023,1630581,22300239,"NOV 25, 2023",OKC vs. PHI,L,26,4,12,0.333,0,1,0.0,2,2,1.0,3,4,7,8,0,0,1,4,10,-13,1,Josh Giddey,OKC,OKC,PHI,20.5,Pts+Rebs+Asts,25,17,18,15
22023,1630581,22300239,"NOV 25, 2023",OKC vs. PHI,L,26,4,12,0.333,0,1,0.0,2,2,1.0,3,4,7,8,0,0,1,4,10,-13,1,Josh Giddey,OKC,OKC,PHI,4.0,Assists,25,17,18,15
22023,1630581,22300239,"NOV 25, 2023",OKC vs. PHI,L,26,4,12,0.333,0,1,0.0,2,2,1.0,3,4,7,8,0,0,1,4,10,-13,1,Josh Giddey,OKC,OKC,PHI,25.0,Fantasy Score,25,17,18,15
22023,1630581,22300239,"NOV 25, 2023",OKC vs. PHI,L,26,4,12,0.333,0,1,0.0,2,2,1.0,3,4,7,8,0,0,1,4,10,-13,1,Josh Giddey,OKC,OKC,PHI,16.5,Pts+Rebs,25,17,18,15
22023,1630581,22300239,"NOV 25, 2023",OKC vs. PHI,L,26,4,12,0.333,0,1,0.0,2,2,1.0,3,4,7,8,0,0,1,4,10,-13,1,Josh Giddey,OKC,OKC,PHI,14.5,Pts+Asts,25,17,18,15
22023,1630581,22300239,"NOV 25, 2023",OKC vs. PHI,L,26,4,12,0.333,0,1,0.0,2,2,1.0,3,4,7,8,0,0,1,4,10,-13,1,Josh Giddey,OKC,OKC,PHI,10.5,Rebs+Asts,25,17,18,15
22023,1630581,22300234,"NOV 22, 2023",OKC vs. CHI,W,29,4,13,0.308,1,3,0.333,1,2,0.5,1,5,6,2,2,0,2,1,10,3,1,Josh Giddey,OKC,OKC,CHI,10.5,Points,18,16,12,8
22023,1630581,22300234,"NOV 22, 2023",OKC vs. CHI,W,29,4,13,0.308,1,3,0.333,1,2,0.5,1,5,6,2,2,0,2,1,10,3,1,Josh Giddey,OKC,OKC,CHI,6.0,Rebounds,18,16,12,8
22023,1630581,22300234,"NOV 22, 2023",OKC vs. CHI,W,29,4,13,0.308,1,3,0.333,1,2,0.5,1,5,6,2,2,0,2,1,10,3,1,Josh Giddey,OKC,OKC,CHI,20.5,Pts+Rebs+Asts,18,16,12,8
22023,1630581,22300234,"NOV 22, 2023",OKC vs. CHI,W,29,4,13,0.308,1,3,0.333,1,2,0.5,1,5,6,2,2,0,2,1,10,3,1,Josh Giddey,OKC,OKC,CHI,4.0,Assists,18,16,12,8
22023,1630581,22300234,"NOV 22, 2023",OKC vs. CHI,W,29,4,13,0.308,1,3,0.333,1,2,0.5,1,5,6,2,2,0,2,1,10,3,1,Josh Giddey,OKC,OKC,CHI,25.0,Fantasy Score,18,16,12,8
22023,1630581,22300234,"NOV 22, 2023",OKC vs. CHI,W,29,4,13,0.308,1,3,0.333,1,2,0.5,1,5,6,2,2,0,2,1,10,3,1,Josh Giddey,OKC,OKC,CHI,16.5,Pts+Rebs,18,16,12,8
22023,1630581,22300234,"NOV 22, 2023",OKC vs. CHI,W,29,4,13,0.308,1,3,0.333,1,2,0.5,1,5,6,2,2,0,2,1,10,3,1,Josh Giddey,OKC,OKC,CHI,14.5,Pts+Asts,18,16,12,8
22023,1630581,22300234,"NOV 22, 2023",OKC vs. CHI,W,29,4,13,0.308,1,3,0.333,1,2,0.5,1,5,6,2,2,0,2,1,10,3,1,Josh Giddey,OKC,OKC,CHI,10.5,Rebs+Asts,18,16,12,8
22023,1630581,22300215,"NOV 19, 2023",OKC @ POR,W,23,3,6,0.5,0,0,0.0,0,0,0.0,0,4,4,5,1,0,4,1,6,12,1,Josh Giddey,OKC,POR,OKC,10.5,Points,15,10,11,9
22023,1630581,22300215,"NOV 19, 2023",OKC @ POR,W,23,3,6,0.5,0,0,0.0,0,0,0.0,0,4,4,5,1,0,4,1,6,12,1,Josh Giddey,OKC,POR,OKC,6.0,Rebounds,15,10,11,9
22023,1630581,22300215,"NOV 19, 2023",OKC @ POR,W,23,3,6,0.5,0,0,0.0,0,0,0.0,0,4,4,5,1,0,4,1,6,12,1,Josh Giddey,OKC,POR,OKC,20.5,Pts+Rebs+Asts,15,10,11,9
22023,1630581,22300215,"NOV 19, 2023",OKC @ POR,W,23,3,6,0.5,0,0,0.0,0,0,0.0,0,4,4,5,1,0,4,1,6,12,1,Josh Giddey,OKC,POR,OKC,4.0,Assists,15,10,11,9
22023,1630581,22300215,"NOV 19, 2023",OKC @ POR,W,23,3,6,0.5,0,0,0.0,0,0,0.0,0,4,4,5,1,0,4,1,6,12,1,Josh Giddey,OKC,POR,OKC,25.0,Fantasy Score,15,10,11,9
22023,1630581,22300215,"NOV 19, 2023",OKC @ POR,W,23,3,6,0.5,0,0,0.0,0,0,0.0,0,4,4,5,1,0,4,1,6,12,1,Josh Giddey,OKC,POR,OKC,16.5,Pts+Rebs,15,10,11,9
22023,1630581,22300215,"NOV 19, 2023",OKC @ POR,W,23,3,6,0.5,0,0,0.0,0,0,0.0,0,4,4,5,1,0,4,1,6,12,1,Josh Giddey,OKC,POR,OKC,14.5,Pts+Asts,15,10,11,9
22023,1630581,22300215,"NOV 19, 2023",OKC @ POR,W,23,3,6,0.5,0,0,0.0,0,0,0.0,0,4,4,5,1,0,4,1,6,12,1,Josh Giddey,OKC,POR,OKC,10.5,Rebs+Asts,15,10,11,9
22023,1630581,22300207,"NOV 18, 2023",OKC @ GSW,W,22,4,10,0.4,1,2,0.5,2,2,1.0,2,3,5,2,1,2,0,2,11,4,1,Josh Giddey,OKC,GSW,OKC,10.5,Points,18,16,13,7
22023,1630581,22300207,"NOV 18, 2023",OKC @ GSW,W,22,4,10,0.4,1,2,0.5,2,2,1.0,2,3,5,2,1,2,0,2,11,4,1,Josh Giddey,OKC,GSW,OKC,6.0,Rebounds,18,16,13,7
22023,1630581,22300207,"NOV 18, 2023",OKC @ GSW,W,22,4,10,0.4,1,2,0.5,2,2,1.0,2,3,5,2,1,2,0,2,11,4,1,Josh Giddey,OKC,GSW,OKC,20.5,Pts+Rebs+Asts,18,16,13,7
22023,1630581,22300207,"NOV 18, 2023",OKC @ GSW,W,22,4,10,0.4,1,2,0.5,2,2,1.0,2,3,5,2,1,2,0,2,11,4,1,Josh Giddey,OKC,GSW,OKC,4.0,Assists,18,16,13,7
22023,1630581,22300207,"NOV 18, 2023",OKC @ GSW,W,22,4,10,0.4,1,2,0.5,2,2,1.0,2,3,5,2,1,2,0,2,11,4,1,Josh Giddey,OKC,GSW,OKC,25.0,Fantasy Score,18,16,13,7
22023,1630581,22300207,"NOV 18, 2023",OKC @ GSW,W,22,4,10,0.4,1,2,0.5,2,2,1.0,2,3,5,2,1,2,0,2,11,4,1,Josh Giddey,OKC,GSW,OKC,16.5,Pts+Rebs,18,16,13,7
22023,1630581,22300207,"NOV 18, 2023",OKC @ GSW,W,22,4,10,0.4,1,2,0.5,2,2,1.0,2,3,5,2,1,2,0,2,11,4,1,Josh Giddey,OKC,GSW,OKC,14.5,Pts+Asts,18,16,13,7
22023,1630581,22300207,"NOV 18, 2023",OKC @ GSW,W,22,4,10,0.4,1,2,0.5,2,2,1.0,2,3,5,2,1,2,0,2,11,4,1,Josh Giddey,OKC,GSW,OKC,10.5,Rebs+Asts,18,16,13,7
22023,1630581,22300201,"NOV 16, 2023",OKC @ GSW,W,26,8,14,0.571,3,3,1.0,0,0,0.0,2,4,6,1,2,0,3,1,19,-3,1,Josh Giddey,OKC,GSW,OKC,10.5,Points,26,25,20,7
22023,1630581,22300201,"NOV 16, 2023",OKC @ GSW,W,26,8,14,0.571,3,3,1.0,0,0,0.0,2,4,6,1,2,0,3,1,19,-3,1,Josh Giddey,OKC,GSW,OKC,6.0,Rebounds,26,25,20,7
22023,1630581,22300201,"NOV 16, 2023",OKC @ GSW,W,26,8,14,0.571,3,3,1.0,0,0,0.0,2,4,6,1,2,0,3,1,19,-3,1,Josh Giddey,OKC,GSW,OKC,20.5,Pts+Rebs+Asts,26,25,20,7
22023,1630581,22300201,"NOV 16, 2023",OKC @ GSW,W,26,8,14,0.571,3,3,1.0,0,0,0.0,2,4,6,1,2,0,3,1,19,-3,1,Josh Giddey,OKC,GSW,OKC,4.0,Assists,26,25,20,7
22023,1630581,22300201,"NOV 16, 2023",OKC @ GSW,W,26,8,14,0.571,3,3,1.0,0,0,0.0,2,4,6,1,2,0,3,1,19,-3,1,Josh Giddey,OKC,GSW,OKC,25.0,Fantasy Score,26,25,20,7
22023,1630581,22300201,"NOV 16, 2023",OKC @ GSW,W,26,8,14,0.571,3,3,1.0,0,0,0.0,2,4,6,1,2,0,3,1,19,-3,1,Josh Giddey,OKC,GSW,OKC,16.5,Pts+Rebs,26,25,20,7
22023,1630581,22300201,"NOV 16, 2023",OKC @ GSW,W,26,8,14,0.571,3,3,1.0,0,0,0.0,2,4,6,1,2,0,3,1,19,-3,1,Josh Giddey,OKC,GSW,OKC,14.5,Pts+Asts,26,25,20,7
22023,1630581,22300201,"NOV 16, 2023",OKC @ GSW,W,26,8,14,0.571,3,3,1.0,0,0,0.0,2,4,6,1,2,0,3,1,19,-3,1,Josh Giddey,OKC,GSW,OKC,10.5,Rebs+Asts,26,25,20,7
22023,1630581,22300021,"NOV 14, 2023",OKC vs. SAS,W,25,7,11,0.636,0,2,0.0,4,5,0.8,1,6,7,7,0,2,3,0,18,20,1,Josh Giddey,OKC,OKC,SAS,10.5,Points,32,25,25,14
22023,1630581,22300021,"NOV 14, 2023",OKC vs. SAS,W,25,7,11,0.636,0,2,0.0,4,5,0.8,1,6,7,7,0,2,3,0,18,20,1,Josh Giddey,OKC,OKC,SAS,6.0,Rebounds,32,25,25,14
22023,1630581,22300021,"NOV 14, 2023",OKC vs. SAS,W,25,7,11,0.636,0,2,0.0,4,5,0.8,1,6,7,7,0,2,3,0,18,20,1,Josh Giddey,OKC,OKC,SAS,20.5,Pts+Rebs+Asts,32,25,25,14
22023,1630581,22300021,"NOV 14, 2023",OKC vs. SAS,W,25,7,11,0.636,0,2,0.0,4,5,0.8,1,6,7,7,0,2,3,0,18,20,1,Josh Giddey,OKC,OKC,SAS,4.0,Assists,32,25,25,14
22023,1630581,22300021,"NOV 14, 2023",OKC vs. SAS,W,25,7,11,0.636,0,2,0.0,4,5,0.8,1,6,7,7,0,2,3,0,18,20,1,Josh Giddey,OKC,OKC,SAS,25.0,Fantasy Score,32,25,25,14
22023,1630581,22300021,"NOV 14, 2023",OKC vs. SAS,W,25,7,11,0.636,0,2,0.0,4,5,0.8,1,6,7,7,0,2,3,0,18,20,1,Josh Giddey,OKC,OKC,SAS,16.5,Pts+Rebs,32,25,25,14
22023,1630581,22300021,"NOV 14, 2023",OKC vs. SAS,W,25,7,11,0.636,0,2,0.0,4,5,0.8,1,6,7,7,0,2,3,0,18,20,1,Josh Giddey,OKC,OKC,SAS,14.5,Pts+Asts,32,25,25,14
22023,1630581,22300021,"NOV 14, 2023",OKC vs. SAS,W,25,7,11,0.636,0,2,0.0,4,5,0.8,1,6,7,7,0,2,3,0,18,20,1,Josh Giddey,OKC,OKC,SAS,10.5,Rebs+Asts,32,25,25,14
22023,1630581,22300185,"NOV 12, 2023",OKC @ PHX,W,32,5,12,0.417,0,1,0.0,0,0,0.0,3,3,6,10,2,2,4,1,10,17,1,Josh Giddey,OKC,PHX,OKC,10.5,Points,26,16,20,16
22023,1630581,22300185,"NOV 12, 2023",OKC @ PHX,W,32,5,12,0.417,0,1,0.0,0,0,0.0,3,3,6,10,2,2,4,1,10,17,1,Josh Giddey,OKC,PHX,OKC,6.0,Rebounds,26,16,20,16
22023,1630581,22300185,"NOV 12, 2023",OKC @ PHX,W,32,5,12,0.417,0,1,0.0,0,0,0.0,3,3,6,10,2,2,4,1,10,17,1,Josh Giddey,OKC,PHX,OKC,20.5,Pts+Rebs+Asts,26,16,20,16
22023,1630581,22300185,"NOV 12, 2023",OKC @ PHX,W,32,5,12,0.417,0,1,0.0,0,0,0.0,3,3,6,10,2,2,4,1,10,17,1,Josh Giddey,OKC,PHX,OKC,4.0,Assists,26,16,20,16
22023,1630581,22300185,"NOV 12, 2023",OKC @ PHX,W,32,5,12,0.417,0,1,0.0,0,0,0.0,3,3,6,10,2,2,4,1,10,17,1,Josh Giddey,OKC,PHX,OKC,25.0,Fantasy Score,26,16,20,16
22023,1630581,22300185,"NOV 12, 2023",OKC @ PHX,W,32,5,12,0.417,0,1,0.0,0,0,0.0,3,3,6,10,2,2,4,1,10,17,1,Josh Giddey,OKC,PHX,OKC,16.5,Pts+Rebs,26,16,20,16
22023,1630581,22300185,"NOV 12, 2023",OKC @ PHX,W,32,5,12,0.417,0,1,0.0,0,0,0.0,3,3,6,10,2,2,4,1,10,17,1,Josh Giddey,OKC,PHX,OKC,14.5,Pts+Asts,26,16,20,16
22023,1630581,22300185,"NOV 12, 2023",OKC @ PHX,W,32,5,12,0.417,0,1,0.0,0,0,0.0,3,3,6,10,2,2,4,1,10,17,1,Josh Giddey,OKC,PHX,OKC,10.5,Rebs+Asts,26,16,20,16
22023,1630581,22300016,"NOV 10, 2023",OKC @ SAC,L,27,6,10,0.6,0,1,0.0,1,1,1.0,1,3,4,5,0,0,4,1,13,-19,1,Josh Giddey,OKC,SAC,OKC,10.5,Points,22,17,18,9
22023,1630581,22300016,"NOV 10, 2023",OKC @ SAC,L,27,6,10,0.6,0,1,0.0,1,1,1.0,1,3,4,5,0,0,4,1,13,-19,1,Josh Giddey,OKC,SAC,OKC,6.0,Rebounds,22,17,18,9
22023,1630581,22300016,"NOV 10, 2023",OKC @ SAC,L,27,6,10,0.6,0,1,0.0,1,1,1.0,1,3,4,5,0,0,4,1,13,-19,1,Josh Giddey,OKC,SAC,OKC,20.5,Pts+Rebs+Asts,22,17,18,9
22023,1630581,22300016,"NOV 10, 2023",OKC @ SAC,L,27,6,10,0.6,0,1,0.0,1,1,1.0,1,3,4,5,0,0,4,1,13,-19,1,Josh Giddey,OKC,SAC,OKC,4.0,Assists,22,17,18,9
22023,1630581,22300016,"NOV 10, 2023",OKC @ SAC,L,27,6,10,0.6,0,1,0.0,1,1,1.0,1,3,4,5,0,0,4,1,13,-19,1,Josh Giddey,OKC,SAC,OKC,25.0,Fantasy Score,22,17,18,9
22023,1630581,22300016,"NOV 10, 2023",OKC @ SAC,L,27,6,10,0.6,0,1,0.0,1,1,1.0,1,3,4,5,0,0,4,1,13,-19,1,Josh Giddey,OKC,SAC,OKC,16.5,Pts+Rebs,22,17,18,9
22023,1630581,22300016,"NOV 10, 2023",OKC @ SAC,L,27,6,10,0.6,0,1,0.0,1,1,1.0,1,3,4,5,0,0,4,1,13,-19,1,Josh Giddey,OKC,SAC,OKC,14.5,Pts+Asts,22,17,18,9
22023,1630581,22300016,"NOV 10, 2023",OKC @ SAC,L,27,6,10,0.6,0,1,0.0,1,1,1.0,1,3,4,5,0,0,4,1,13,-19,1,Josh Giddey,OKC,SAC,OKC,10.5,Rebs+Asts,22,17,18,9
22023,1630581,22300167,"NOV 08, 2023",OKC vs. CLE,W,25,4,11,0.364,0,2,0.0,0,0,0.0,1,4,5,6,2,1,1,0,8,2,1,Josh Giddey,OKC,OKC,CLE,10.5,Points,19,13,14,11
22023,1630581,22300167,"NOV 08, 2023",OKC vs. CLE,W,25,4,11,0.364,0,2,0.0,0,0,0.0,1,4,5,6,2,1,1,0,8,2,1,Josh Giddey,OKC,OKC,CLE,6.0,Rebounds,19,13,14,11
22023,1630581,22300167,"NOV 08, 2023",OKC vs. CLE,W,25,4,11,0.364,0,2,0.0,0,0,0.0,1,4,5,6,2,1,1,0,8,2,1,Josh Giddey,OKC,OKC,CLE,20.5,Pts+Rebs+Asts,19,13,14,11
22023,1630581,22300167,"NOV 08, 2023",OKC vs. CLE,W,25,4,11,0.364,0,2,0.0,0,0,0.0,1,4,5,6,2,1,1,0,8,2,1,Josh Giddey,OKC,OKC,CLE,4.0,Assists,19,13,14,11
22023,1630581,22300167,"NOV 08, 2023",OKC vs. CLE,W,25,4,11,0.364,0,2,0.0,0,0,0.0,1,4,5,6,2,1,1,0,8,2,1,Josh Giddey,OKC,OKC,CLE,25.0,Fantasy Score,19,13,14,11
22023,1630581,22300167,"NOV 08, 2023",OKC vs. CLE,W,25,4,11,0.364,0,2,0.0,0,0,0.0,1,4,5,6,2,1,1,0,8,2,1,Josh Giddey,OKC,OKC,CLE,16.5,Pts+Rebs,19,13,14,11
22023,1630581,22300167,"NOV 08, 2023",OKC vs. CLE,W,25,4,11,0.364,0,2,0.0,0,0,0.0,1,4,5,6,2,1,1,0,8,2,1,Josh Giddey,OKC,OKC,CLE,14.5,Pts+Asts,19,13,14,11
22023,1630581,22300167,"NOV 08, 2023",OKC vs. CLE,W,25,4,11,0.364,0,2,0.0,0,0,0.0,1,4,5,6,2,1,1,0,8,2,1,Josh Giddey,OKC,OKC,CLE,10.5,Rebs+Asts,19,13,14,11
22023,1630581,22300155,"NOV 06, 2023",OKC vs. ATL,W,27,4,13,0.308,0,0,0.0,0,0,0.0,3,4,7,4,0,0,4,3,8,8,1,Josh Giddey,OKC,OKC,ATL,10.5,Points,19,15,12,11
22023,1630581,22300155,"NOV 06, 2023",OKC vs. ATL,W,27,4,13,0.308,0,0,0.0,0,0,0.0,3,4,7,4,0,0,4,3,8,8,1,Josh Giddey,OKC,OKC,ATL,6.0,Rebounds,19,15,12,11
22023,1630581,22300155,"NOV 06, 2023",OKC vs. ATL,W,27,4,13,0.308,0,0,0.0,0,0,0.0,3,4,7,4,0,0,4,3,8,8,1,Josh Giddey,OKC,OKC,ATL,20.5,Pts+Rebs+Asts,19,15,12,11
22023,1630581,22300155,"NOV 06, 2023",OKC vs. ATL,W,27,4,13,0.308,0,0,0.0,0,0,0.0,3,4,7,4,0,0,4,3,8,8,1,Josh Giddey,OKC,OKC,ATL,4.0,Assists,19,15,12,11
22023,1630581,22300155,"NOV 06, 2023",OKC vs. ATL,W,27,4,13,0.308,0,0,0.0,0,0,0.0,3,4,7,4,0,0,4,3,8,8,1,Josh Giddey,OKC,OKC,ATL,25.0,Fantasy Score,19,15,12,11
22023,1630581,22300155,"NOV 06, 2023",OKC vs. ATL,W,27,4,13,0.308,0,0,0.0,0,0,0.0,3,4,7,4,0,0,4,3,8,8,1,Josh Giddey,OKC,OKC,ATL,16.5,Pts+Rebs,19,15,12,11
22023,1630581,22300155,"NOV 06, 2023",OKC vs. ATL,W,27,4,13,0.308,0,0,0.0,0,0,0.0,3,4,7,4,0,0,4,3,8,8,1,Josh Giddey,OKC,OKC,ATL,14.5,Pts+Asts,19,15,12,11
22023,1630581,22300155,"NOV 06, 2023",OKC vs. ATL,W,27,4,13,0.308,0,0,0.0,0,0,0.0,3,4,7,4,0,0,4,3,8,8,1,Josh Giddey,OKC,OKC,ATL,10.5,Rebs+Asts,19,15,12,11
22023,1630581,22300005,"NOV 03, 2023",OKC vs. GSW,L,31,8,15,0.533,0,3,0.0,2,2,1.0,0,5,5,4,0,0,6,2,18,4,1,Josh Giddey,OKC,OKC,GSW,10.5,Points,27,23,22,9
22023,1630581,22300005,"NOV 03, 2023",OKC vs. GSW,L,31,8,15,0.533,0,3,0.0,2,2,1.0,0,5,5,4,0,0,6,2,18,4,1,Josh Giddey,OKC,OKC,GSW,6.0,Rebounds,27,23,22,9
22023,1630581,22300005,"NOV 03, 2023",OKC vs. GSW,L,31,8,15,0.533,0,3,0.0,2,2,1.0,0,5,5,4,0,0,6,2,18,4,1,Josh Giddey,OKC,OKC,GSW,20.5,Pts+Rebs+Asts,27,23,22,9
22023,1630581,22300005,"NOV 03, 2023",OKC vs. GSW,L,31,8,15,0.533,0,3,0.0,2,2,1.0,0,5,5,4,0,0,6,2,18,4,1,Josh Giddey,OKC,OKC,GSW,4.0,Assists,27,23,22,9
22023,1630581,22300005,"NOV 03, 2023",OKC vs. GSW,L,31,8,15,0.533,0,3,0.0,2,2,1.0,0,5,5,4,0,0,6,2,18,4,1,Josh Giddey,OKC,OKC,GSW,25.0,Fantasy Score,27,23,22,9
22023,1630581,22300005,"NOV 03, 2023",OKC vs. GSW,L,31,8,15,0.533,0,3,0.0,2,2,1.0,0,5,5,4,0,0,6,2,18,4,1,Josh Giddey,OKC,OKC,GSW,16.5,Pts+Rebs,27,23,22,9
22023,1630581,22300005,"NOV 03, 2023",OKC vs. GSW,L,31,8,15,0.533,0,3,0.0,2,2,1.0,0,5,5,4,0,0,6,2,18,4,1,Josh Giddey,OKC,OKC,GSW,14.5,Pts+Asts,27,23,22,9
22023,1630581,22300005,"NOV 03, 2023",OKC vs. GSW,L,31,8,15,0.533,0,3,0.0,2,2,1.0,0,5,5,4,0,0,6,2,18,4,1,Josh Giddey,OKC,OKC,GSW,10.5,Rebs+Asts,27,23,22,9
22023,1630581,22300121,"NOV 01, 2023",OKC vs. NOP,L,31,6,16,0.375,1,4,0.25,2,2,1.0,0,9,9,4,1,1,2,1,15,-6,1,Josh Giddey,OKC,OKC,NOP,10.5,Points,28,24,19,13
22023,1630581,22300121,"NOV 01, 2023",OKC vs. NOP,L,31,6,16,0.375,1,4,0.25,2,2,1.0,0,9,9,4,1,1,2,1,15,-6,1,Josh Giddey,OKC,OKC,NOP,6.0,Rebounds,28,24,19,13
22023,1630581,22300121,"NOV 01, 2023",OKC vs. NOP,L,31,6,16,0.375,1,4,0.25,2,2,1.0,0,9,9,4,1,1,2,1,15,-6,1,Josh Giddey,OKC,OKC,NOP,20.5,Pts+Rebs+Asts,28,24,19,13
22023,1630581,22300121,"NOV 01, 2023",OKC vs. NOP,L,31,6,16,0.375,1,4,0.25,2,2,1.0,0,9,9,4,1,1,2,1,15,-6,1,Josh Giddey,OKC,OKC,NOP,4.0,Assists,28,24,19,13
22023,1630581,22300121,"NOV 01, 2023",OKC vs. NOP,L,31,6,16,0.375,1,4,0.25,2,2,1.0,0,9,9,4,1,1,2,1,15,-6,1,Josh Giddey,OKC,OKC,NOP,25.0,Fantasy Score,28,24,19,13
22023,1630581,22300121,"NOV 01, 2023",OKC vs. NOP,L,31,6,16,0.375,1,4,0.25,2,2,1.0,0,9,9,4,1,1,2,1,15,-6,1,Josh Giddey,OKC,OKC,NOP,16.5,Pts+Rebs,28,24,19,13
22023,1630581,22300121,"NOV 01, 2023",OKC vs. NOP,L,31,6,16,0.375,1,4,0.25,2,2,1.0,0,9,9,4,1,1,2,1,15,-6,1,Josh Giddey,OKC,OKC,NOP,14.5,Pts+Asts,28,24,19,13
22023,1630581,22300121,"NOV 01, 2023",OKC vs. NOP,L,31,6,16,0.375,1,4,0.25,2,2,1.0,0,9,9,4,1,1,2,1,15,-6,1,Josh Giddey,OKC,OKC,NOP,10.5,Rebs+Asts,28,24,19,13
22023,1630581,22300109,"OCT 30, 2023",OKC vs. DET,W,28,9,18,0.5,0,2,0.0,3,5,0.6,3,4,7,3,1,1,1,1,21,10,1,Josh Giddey,OKC,OKC,DET,10.5,Points,31,28,24,10
22023,1630581,22300109,"OCT 30, 2023",OKC vs. DET,W,28,9,18,0.5,0,2,0.0,3,5,0.6,3,4,7,3,1,1,1,1,21,10,1,Josh Giddey,OKC,OKC,DET,6.0,Rebounds,31,28,24,10
22023,1630581,22300109,"OCT 30, 2023",OKC vs. DET,W,28,9,18,0.5,0,2,0.0,3,5,0.6,3,4,7,3,1,1,1,1,21,10,1,Josh Giddey,OKC,OKC,DET,20.5,Pts+Rebs+Asts,31,28,24,10
22023,1630581,22300109,"OCT 30, 2023",OKC vs. DET,W,28,9,18,0.5,0,2,0.0,3,5,0.6,3,4,7,3,1,1,1,1,21,10,1,Josh Giddey,OKC,OKC,DET,4.0,Assists,31,28,24,10
22023,1630581,22300109,"OCT 30, 2023",OKC vs. DET,W,28,9,18,0.5,0,2,0.0,3,5,0.6,3,4,7,3,1,1,1,1,21,10,1,Josh Giddey,OKC,OKC,DET,25.0,Fantasy Score,31,28,24,10
22023,1630581,22300109,"OCT 30, 2023",OKC vs. DET,W,28,9,18,0.5,0,2,0.0,3,5,0.6,3,4,7,3,1,1,1,1,21,10,1,Josh Giddey,OKC,OKC,DET,16.5,Pts+Rebs,31,28,24,10
22023,1630581,22300109,"OCT 30, 2023",OKC vs. DET,W,28,9,18,0.5,0,2,0.0,3,5,0.6,3,4,7,3,1,1,1,1,21,10,1,Josh Giddey,OKC,OKC,DET,14.5,Pts+Asts,31,28,24,10
22023,1630581,22300109,"OCT 30, 2023",OKC vs. DET,W,28,9,18,0.5,0,2,0.0,3,5,0.6,3,4,7,3,1,1,1,1,21,10,1,Josh Giddey,OKC,OKC,DET,10.5,Rebs+Asts,31,28,24,10
22023,1630581,22300095,"OCT 29, 2023",OKC vs. DEN,L,22,4,13,0.308,1,2,0.5,0,0,0.0,1,1,2,3,1,0,2,0,9,-18,1,Josh Giddey,OKC,OKC,DEN,10.5,Points,14,11,12,5
22023,1630581,22300095,"OCT 29, 2023",OKC vs. DEN,L,22,4,13,0.308,1,2,0.5,0,0,0.0,1,1,2,3,1,0,2,0,9,-18,1,Josh Giddey,OKC,OKC,DEN,6.0,Rebounds,14,11,12,5
22023,1630581,22300095,"OCT 29, 2023",OKC vs. DEN,L,22,4,13,0.308,1,2,0.5,0,0,0.0,1,1,2,3,1,0,2,0,9,-18,1,Josh Giddey,OKC,OKC,DEN,20.5,Pts+Rebs+Asts,14,11,12,5
22023,1630581,22300095,"OCT 29, 2023",OKC vs. DEN,L,22,4,13,0.308,1,2,0.5,0,0,0.0,1,1,2,3,1,0,2,0,9,-18,1,Josh Giddey,OKC,OKC,DEN,4.0,Assists,14,11,12,5
22023,1630581,22300095,"OCT 29, 2023",OKC vs. DEN,L,22,4,13,0.308,1,2,0.5,0,0,0.0,1,1,2,3,1,0,2,0,9,-18,1,Josh Giddey,OKC,OKC,DEN,25.0,Fantasy Score,14,11,12,5
22023,1630581,22300095,"OCT 29, 2023",OKC vs. DEN,L,22,4,13,0.308,1,2,0.5,0,0,0.0,1,1,2,3,1,0,2,0,9,-18,1,Josh Giddey,OKC,OKC,DEN,16.5,Pts+Rebs,14,11,12,5
22023,1630581,22300095,"OCT 29, 2023",OKC vs. DEN,L,22,4,13,0.308,1,2,0.5,0,0,0.0,1,1,2,3,1,0,2,0,9,-18,1,Josh Giddey,OKC,OKC,DEN,14.5,Pts+Asts,14,11,12,5
22023,1630581,22300095,"OCT 29, 2023",OKC vs. DEN,L,22,4,13,0.308,1,2,0.5,0,0,0.0,1,1,2,3,1,0,2,0,9,-18,1,Josh Giddey,OKC,OKC,DEN,10.5,Rebs+Asts,14,11,12,5
22023,1630581,22300081,"OCT 27, 2023",OKC @ CLE,W,28,1,8,0.125,0,1,0.0,0,0,0.0,0,6,6,6,0,0,3,1,2,-12,1,Josh Giddey,OKC,CLE,OKC,10.5,Points,14,8,8,12
22023,1630581,22300081,"OCT 27, 2023",OKC @ CLE,W,28,1,8,0.125,0,1,0.0,0,0,0.0,0,6,6,6,0,0,3,1,2,-12,1,Josh Giddey,OKC,CLE,OKC,6.0,Rebounds,14,8,8,12
22023,1630581,22300081,"OCT 27, 2023",OKC @ CLE,W,28,1,8,0.125,0,1,0.0,0,0,0.0,0,6,6,6,0,0,3,1,2,-12,1,Josh Giddey,OKC,CLE,OKC,20.5,Pts+Rebs+Asts,14,8,8,12
22023,1630581,22300081,"OCT 27, 2023",OKC @ CLE,W,28,1,8,0.125,0,1,0.0,0,0,0.0,0,6,6,6,0,0,3,1,2,-12,1,Josh Giddey,OKC,CLE,OKC,4.0,Assists,14,8,8,12
22023,1630581,22300081,"OCT 27, 2023",OKC @ CLE,W,28,1,8,0.125,0,1,0.0,0,0,0.0,0,6,6,6,0,0,3,1,2,-12,1,Josh Giddey,OKC,CLE,OKC,25.0,Fantasy Score,14,8,8,12
22023,1630581,22300081,"OCT 27, 2023",OKC @ CLE,W,28,1,8,0.125,0,1,0.0,0,0,0.0,0,6,6,6,0,0,3,1,2,-12,1,Josh Giddey,OKC,CLE,OKC,16.5,Pts+Rebs,14,8,8,12
22023,1630581,22300081,"OCT 27, 2023",OKC @ CLE,W,28,1,8,0.125,0,1,0.0,0,0,0.0,0,6,6,6,0,0,3,1,2,-12,1,Josh Giddey,OKC,CLE,OKC,14.5,Pts+Asts,14,8,8,12
22023,1630581,22300081,"OCT 27, 2023",OKC @ CLE,W,28,1,8,0.125,0,1,0.0,0,0,0.0,0,6,6,6,0,0,3,1,2,-12,1,Josh Giddey,OKC,CLE,OKC,10.5,Rebs+Asts,14,8,8,12
22023,1630581,22300070,"OCT 25, 2023",OKC @ CHI,W,32,7,14,0.5,2,3,0.667,0,0,0.0,1,5,6,6,0,0,3,1,16,19,1,Josh Giddey,OKC,CHI,OKC,10.5,Points,28,22,22,12
22023,1630581,22300070,"OCT 25, 2023",OKC @ CHI,W,32,7,14,0.5,2,3,0.667,0,0,0.0,1,5,6,6,0,0,3,1,16,19,1,Josh Giddey,OKC,CHI,OKC,6.0,Rebounds,28,22,22,12
22023,1630581,22300070,"OCT 25, 2023",OKC @ CHI,W,32,7,14,0.5,2,3,0.667,0,0,0.0,1,5,6,6,0,0,3,1,16,19,1,Josh Giddey,OKC,CHI,OKC,20.5,Pts+Rebs+Asts,28,22,22,12
22023,1630581,22300070,"OCT 25, 2023",OKC @ CHI,W,32,7,14,0.5,2,3,0.667,0,0,0.0,1,5,6,6,0,0,3,1,16,19,1,Josh Giddey,OKC,CHI,OKC,4.0,Assists,28,22,22,12
22023,1630581,22300070,"OCT 25, 2023",OKC @ CHI,W,32,7,14,0.5,2,3,0.667,0,0,0.0,1,5,6,6,0,0,3,1,16,19,1,Josh Giddey,OKC,CHI,OKC,25.0,Fantasy Score,28,22,22,12
22023,1630581,22300070,"OCT 25, 2023",OKC @ CHI,W,32,7,14,0.5,2,3,0.667,0,0,0.0,1,5,6,6,0,0,3,1,16,19,1,Josh Giddey,OKC,CHI,OKC,16.5,Pts+Rebs,28,22,22,12
22023,1630581,22300070,"OCT 25, 2023",OKC @ CHI,W,32,7,14,0.5,2,3,0.667,0,0,0.0,1,5,6,6,0,0,3,1,16,19,1,Josh Giddey,OKC,CHI,OKC,14.5,Pts+Asts,28,22,22,12
22023,1630581,22300070,"OCT 25, 2023",OKC @ CHI,W,32,7,14,0.5,2,3,0.667,0,0,0.0,1,5,6,6,0,0,3,1,16,19,1,Josh Giddey,OKC,CHI,OKC,10.5,Rebs+Asts,28,22,22,12
22023,1628385,22300527,"JAN 11, 2024",BKN @ CLE,L,3,1,2,0.5,0,0,0.0,0,0,0.0,1,0,1,1,0,0,1,0,2,-4,1,Harry Giles III,BKN,CLE,BKN,,,4,3,3,2
22023,1628385,22300461,"JAN 02, 2024",BKN @ NOP,L,8,3,6,0.5,0,2,0.0,0,2,0.0,1,2,3,1,0,1,0,2,6,0,1,Harry Giles III,BKN,NOP,BKN,,,10,9,7,4
22023,1628385,22300417,"DEC 27, 2023",BKN vs. MIL,L,7,0,3,0.0,0,0,0.0,1,2,0.5,2,2,4,0,0,0,0,2,1,-6,1,Harry Giles III,BKN,BKN,MIL,,,5,5,1,4
22023,1628385,22300394,"DEC 23, 2023",BKN vs. DET,W,1,0,0,0.0,0,0,0.0,0,0,0.0,0,0,0,0,0,0,0,0,0,-6,1,Harry Giles III,BKN,BKN,DET,,,0,0,0,0
22023,1628385,22300368,"DEC 20, 2023",BKN vs. NYK,L,4,0,1,0.0,0,0,0.0,0,0,0.0,0,0,0,0,0,1,1,1,0,6,1,Harry Giles III,BKN,BKN,NYK,,,0,0,0,0
22023,1628385,22300357,"DEC 18, 2023",BKN @ UTA,L,3,0,0,0.0,0,0,0.0,0,0,0.0,0,0,0,0,0,0,0,0,0,0,1,Harry Giles III,BKN,UTA,BKN,,,0,0,0,0
22023,1628385,22300322,"DEC 14, 2023",BKN @ DEN,L,15,4,9,0.444,0,1,0.0,3,3,1.0,3,3,6,1,1,0,0,1,11,1,1,Harry Giles III,BKN,DEN,BKN,,,18,17,12,7
22023,1628385,22300303,"DEC 11, 2023",BKN @ SAC,L,4,1,2,0.5,0,1,0.0,1,1,1.0,0,0,0,0,0,0,0,1,3,4,1,Harry Giles III,BKN,SAC,BKN,,,3,3,3,0
22023,1628385,22301219,"DEC 08, 2023",BKN vs. WAS,W,5,4,6,0.667,0,1,0.0,0,2,0.0,2,0,2,0,0,1,0,0,8,2,1,Harry Giles III,BKN,BKN,WAS,,,10,10,8,2
22023,1628385,22300208,"NOV 19, 2023",BKN vs. PHI,L,6,2,3,0.667,0,1,0.0,1,1,1.0,0,1,1,0,0,0,0,1,5,0,1,Harry Giles III,BKN,BKN,PHI,,,6,6,5,1
22023,1628385,22300010,"NOV 10, 2023",BKN @ BOS,L,6,3,3,1.0,1,1,1.0,0,0,0.0,0,1,1,0,0,0,1,1,7,6,1,Harry Giles III,BKN,BOS,BKN,,,8,8,7,1
22023,1628983,22300565,"JAN 15, 2024",OKC @ LAL,L,34,9,19,0.474,1,6,0.167,5,5,1.0,0,3,3,6,1,1,3,3,24,-12,1,Shai Gilgeous-Alexander,OKC,LAL,OKC,31.0,Points,33,27,30,9
22023,1628983,22300565,"JAN 15, 2024",OKC @ LAL,L,34,9,19,0.474,1,6,0.167,5,5,1.0,0,3,3,6,1,1,3,3,24,-12,1,Shai Gilgeous-Alexander,OKC,LAL,OKC,31.0,Points,33,27,30,9
22023,1628983,22300565,"JAN 15, 2024",OKC @ LAL,L,34,9,19,0.474,1,6,0.167,5,5,1.0,0,3,3,6,1,1,3,3,24,-12,1,Shai Gilgeous-Alexander,OKC,LAL,OKC,6.0,Rebounds,33,27,30,9
22023,1628983,22300565,"JAN 15, 2024",OKC @ LAL,L,34,9,19,0.474,1,6,0.167,5,5,1.0,0,3,3,6,1,1,3,3,24,-12,1,Shai Gilgeous-Alexander,OKC,LAL,OKC,42.5,Pts+Rebs+Asts,33,27,30,9
22023,1628983,22300565,"JAN 15, 2024",OKC @ LAL,L,34,9,19,0.474,1,6,0.167,5,5,1.0,0,3,3,6,1,1,3,3,24,-12,1,Shai Gilgeous-Alexander,OKC,LAL,OKC,6.0,Assists,33,27,30,9
22023,1628983,22300565,"JAN 15, 2024",OKC @ LAL,L,34,9,19,0.474,1,6,0.167,5,5,1.0,0,3,3,6,1,1,3,3,24,-12,1,Shai Gilgeous-Alexander,OKC,LAL,OKC,51.5,Fantasy Score,33,27,30,9
22023,1628983,22300565,"JAN 15, 2024",OKC @ LAL,L,34,9,19,0.474,1,6,0.167,5,5,1.0,0,3,3,6,1,1,3,3,24,-12,1,Shai Gilgeous-Alexander,OKC,LAL,OKC,4.0,3-PT Attempted,33,27,30,9
22023,1628983,22300565,"JAN 15, 2024",OKC @ LAL,L,34,9,19,0.474,1,6,0.167,5,5,1.0,0,3,3,6,1,1,3,3,24,-12,1,Shai Gilgeous-Alexander,OKC,LAL,OKC,7.5,Free Throws Made,33,27,30,9
22023,1628983,22300565,"JAN 15, 2024",OKC @ LAL,L,34,9,19,0.474,1,6,0.167,5,5,1.0,0,3,3,6,1,1,3,3,24,-12,1,Shai Gilgeous-Alexander,OKC,LAL,OKC,20.5,FG Attempted,33,27,30,9
22023,1628983,22300565,"JAN 15, 2024",OKC @ LAL,L,34,9,19,0.474,1,6,0.167,5,5,1.0,0,3,3,6,1,1,3,3,24,-12,1,Shai Gilgeous-Alexander,OKC,LAL,OKC,36.5,Pts+Rebs,33,27,30,9
22023,1628983,22300565,"JAN 15, 2024",OKC @ LAL,L,34,9,19,0.474,1,6,0.167,5,5,1.0,0,3,3,6,1,1,3,3,24,-12,1,Shai Gilgeous-Alexander,OKC,LAL,OKC,0.5,Dunks,33,27,30,9
22023,1628983,22300565,"JAN 15, 2024",OKC @ LAL,L,34,9,19,0.474,1,6,0.167,5,5,1.0,0,3,3,6,1,1,3,3,24,-12,1,Shai Gilgeous-Alexander,OKC,LAL,OKC,36.5,Pts+Asts,33,27,30,9
22023,1628983,22300565,"JAN 15, 2024",OKC @ LAL,L,34,9,19,0.474,1,6,0.167,5,5,1.0,0,3,3,6,1,1,3,3,24,-12,1,Shai Gilgeous-Alexander,OKC,LAL,OKC,1.5,Steals,33,27,30,9
22023,1628983,22300565,"JAN 15, 2024",OKC @ LAL,L,34,9,19,0.474,1,6,0.167,5,5,1.0,0,3,3,6,1,1,3,3,24,-12,1,Shai Gilgeous-Alexander,OKC,LAL,OKC,12.0,Rebs+Asts,33,27,30,9
22023,1628983,22300546,"JAN 13, 2024",OKC vs. ORL,W,36,13,20,0.65,0,4,0.0,11,12,0.917,2,4,6,7,3,1,0,2,37,14,1,Shai Gilgeous-Alexander,OKC,OKC,ORL,31.0,Points,50,43,44,13
22023,1628983,22300546,"JAN 13, 2024",OKC vs. ORL,W,36,13,20,0.65,0,4,0.0,11,12,0.917,2,4,6,7,3,1,0,2,37,14,1,Shai Gilgeous-Alexander,OKC,OKC,ORL,31.0,Points,50,43,44,13
22023,1628983,22300546,"JAN 13, 2024",OKC vs. ORL,W,36,13,20,0.65,0,4,0.0,11,12,0.917,2,4,6,7,3,1,0,2,37,14,1,Shai Gilgeous-Alexander,OKC,OKC,ORL,6.0,Rebounds,50,43,44,13
22023,1628983,22300546,"JAN 13, 2024",OKC vs. ORL,W,36,13,20,0.65,0,4,0.0,11,12,0.917,2,4,6,7,3,1,0,2,37,14,1,Shai Gilgeous-Alexander,OKC,OKC,ORL,42.5,Pts+Rebs+Asts,50,43,44,13
22023,1628983,22300546,"JAN 13, 2024",OKC vs. ORL,W,36,13,20,0.65,0,4,0.0,11,12,0.917,2,4,6,7,3,1,0,2,37,14,1,Shai Gilgeous-Alexander,OKC,OKC,ORL,6.0,Assists,50,43,44,13
22023,1628983,22300546,"JAN 13, 2024",OKC vs. ORL,W,36,13,20,0.65,0,4,0.0,11,12,0.917,2,4,6,7,3,1,0,2,37,14,1,Shai Gilgeous-Alexander,OKC,OKC,ORL,51.5,Fantasy Score,50,43,44,13
22023,1628983,22300546,"JAN 13, 2024",OKC vs. ORL,W,36,13,20,0.65,0,4,0.0,11,12,0.917,2,4,6,7,3,1,0,2,37,14,1,Shai Gilgeous-Alexander,OKC,OKC,ORL,4.0,3-PT Attempted,50,43,44,13
22023,1628983,22300546,"JAN 13, 2024",OKC vs. ORL,W,36,13,20,0.65,0,4,0.0,11,12,0.917,2,4,6,7,3,1,0,2,37,14,1,Shai Gilgeous-Alexander,OKC,OKC,ORL,7.5,Free Throws Made,50,43,44,13
22023,1628983,22300546,"JAN 13, 2024",OKC vs. ORL,W,36,13,20,0.65,0,4,0.0,11,12,0.917,2,4,6,7,3,1,0,2,37,14,1,Shai Gilgeous-Alexander,OKC,OKC,ORL,20.5,FG Attempted,50,43,44,13
22023,1628983,22300546,"JAN 13, 2024",OKC vs. ORL,W,36,13,20,0.65,0,4,0.0,11,12,0.917,2,4,6,7,3,1,0,2,37,14,1,Shai Gilgeous-Alexander,OKC,OKC,ORL,36.5,Pts+Rebs,50,43,44,13
22023,1628983,22300546,"JAN 13, 2024",OKC vs. ORL,W,36,13,20,0.65,0,4,0.0,11,12,0.917,2,4,6,7,3,1,0,2,37,14,1,Shai Gilgeous-Alexander,OKC,OKC,ORL,0.5,Dunks,50,43,44,13
22023,1628983,22300546,"JAN 13, 2024",OKC vs. ORL,W,36,13,20,0.65,0,4,0.0,11,12,0.917,2,4,6,7,3,1,0,2,37,14,1,Shai Gilgeous-Alexander,OKC,OKC,ORL,36.5,Pts+Asts,50,43,44,13
22023,1628983,22300546,"JAN 13, 2024",OKC vs. ORL,W,36,13,20,0.65,0,4,0.0,11,12,0.917,2,4,6,7,3,1,0,2,37,14,1,Shai Gilgeous-Alexander,OKC,OKC,ORL,1.5,Steals,50,43,44,13
22023,1628983,22300546,"JAN 13, 2024",OKC vs. ORL,W,36,13,20,0.65,0,4,0.0,11,12,0.917,2,4,6,7,3,1,0,2,37,14,1,Shai Gilgeous-Alexander,OKC,OKC,ORL,12.0,Rebs+Asts,50,43,44,13
22023,1628983,22300529,"JAN 11, 2024",OKC vs. POR,W,21,11,15,0.733,1,3,0.333,8,8,1.0,1,4,5,4,0,1,2,2,31,41,1,Shai Gilgeous-Alexander,OKC,OKC,POR,31.0,Points,40,36,35,9
22023,1628983,22300529,"JAN 11, 2024",OKC vs. POR,W,21,11,15,0.733,1,3,0.333,8,8,1.0,1,4,5,4,0,1,2,2,31,41,1,Shai Gilgeous-Alexander,OKC,OKC,POR,31.0,Points,40,36,35,9
22023,1628983,22300529,"JAN 11, 2024",OKC vs. POR,W,21,11,15,0.733,1,3,0.333,8,8,1.0,1,4,5,4,0,1,2,2,31,41,1,Shai Gilgeous-Alexander,OKC,OKC,POR,6.0,Rebounds,40,36,35,9
22023,1628983,22300529,"JAN 11, 2024",OKC vs. POR,W,21,11,15,0.733,1,3,0.333,8,8,1.0,1,4,5,4,0,1,2,2,31,41,1,Shai Gilgeous-Alexander,OKC,OKC,POR,42.5,Pts+Rebs+Asts,40,36,35,9
22023,1628983,22300529,"JAN 11, 2024",OKC vs. POR,W,21,11,15,0.733,1,3,0.333,8,8,1.0,1,4,5,4,0,1,2,2,31,41,1,Shai Gilgeous-Alexander,OKC,OKC,POR,6.0,Assists,40,36,35,9
22023,1628983,22300529,"JAN 11, 2024",OKC vs. POR,W,21,11,15,0.733,1,3,0.333,8,8,1.0,1,4,5,4,0,1,2,2,31,41,1,Shai Gilgeous-Alexander,OKC,OKC,POR,51.5,Fantasy Score,40,36,35,9
22023,1628983,22300529,"JAN 11, 2024",OKC vs. POR,W,21,11,15,0.733,1,3,0.333,8,8,1.0,1,4,5,4,0,1,2,2,31,41,1,Shai Gilgeous-Alexander,OKC,OKC,POR,4.0,3-PT Attempted,40,36,35,9
22023,1628983,22300529,"JAN 11, 2024",OKC vs. POR,W,21,11,15,0.733,1,3,0.333,8,8,1.0,1,4,5,4,0,1,2,2,31,41,1,Shai Gilgeous-Alexander,OKC,OKC,POR,7.5,Free Throws Made,40,36,35,9
22023,1628983,22300529,"JAN 11, 2024",OKC vs. POR,W,21,11,15,0.733,1,3,0.333,8,8,1.0,1,4,5,4,0,1,2,2,31,41,1,Shai Gilgeous-Alexander,OKC,OKC,POR,20.5,FG Attempted,40,36,35,9
22023,1628983,22300529,"JAN 11, 2024",OKC vs. POR,W,21,11,15,0.733,1,3,0.333,8,8,1.0,1,4,5,4,0,1,2,2,31,41,1,Shai Gilgeous-Alexander,OKC,OKC,POR,36.5,Pts+Rebs,40,36,35,9
22023,1628983,22300529,"JAN 11, 2024",OKC vs. POR,W,21,11,15,0.733,1,3,0.333,8,8,1.0,1,4,5,4,0,1,2,2,31,41,1,Shai Gilgeous-Alexander,OKC,OKC,POR,0.5,Dunks,40,36,35,9
22023,1628983,22300529,"JAN 11, 2024",OKC vs. POR,W,21,11,15,0.733,1,3,0.333,8,8,1.0,1,4,5,4,0,1,2,2,31,41,1,Shai Gilgeous-Alexander,OKC,OKC,POR,36.5,Pts+Asts,40,36,35,9
22023,1628983,22300529,"JAN 11, 2024",OKC vs. POR,W,21,11,15,0.733,1,3,0.333,8,8,1.0,1,4,5,4,0,1,2,2,31,41,1,Shai Gilgeous-Alexander,OKC,OKC,POR,1.5,Steals,40,36,35,9
22023,1628983,22300529,"JAN 11, 2024",OKC vs. POR,W,21,11,15,0.733,1,3,0.333,8,8,1.0,1,4,5,4,0,1,2,2,31,41,1,Shai Gilgeous-Alexander,OKC,OKC,POR,12.0,Rebs+Asts,40,36,35,9
22023,1628983,22300522,"JAN 10, 2024",OKC @ MIA,W,34,11,17,0.647,2,5,0.4,4,5,0.8,0,2,2,8,1,1,3,3,28,-3,1,Shai Gilgeous-Alexander,OKC,MIA,OKC,31.0,Points,38,30,36,10
22023,1628983,22300522,"JAN 10, 2024",OKC @ MIA,W,34,11,17,0.647,2,5,0.4,4,5,0.8,0,2,2,8,1,1,3,3,28,-3,1,Shai Gilgeous-Alexander,OKC,MIA,OKC,31.0,Points,38,30,36,10
22023,1628983,22300522,"JAN 10, 2024",OKC @ MIA,W,34,11,17,0.647,2,5,0.4,4,5,0.8,0,2,2,8,1,1,3,3,28,-3,1,Shai Gilgeous-Alexander,OKC,MIA,OKC,6.0,Rebounds,38,30,36,10
22023,1628983,22300522,"JAN 10, 2024",OKC @ MIA,W,34,11,17,0.647,2,5,0.4,4,5,0.8,0,2,2,8,1,1,3,3,28,-3,1,Shai Gilgeous-Alexander,OKC,MIA,OKC,42.5,Pts+Rebs+Asts,38,30,36,10
22023,1628983,22300522,"JAN 10, 2024",OKC @ MIA,W,34,11,17,0.647,2,5,0.4,4,5,0.8,0,2,2,8,1,1,3,3,28,-3,1,Shai Gilgeous-Alexander,OKC,MIA,OKC,6.0,Assists,38,30,36,10
22023,1628983,22300522,"JAN 10, 2024",OKC @ MIA,W,34,11,17,0.647,2,5,0.4,4,5,0.8,0,2,2,8,1,1,3,3,28,-3,1,Shai Gilgeous-Alexander,OKC,MIA,OKC,51.5,Fantasy Score,38,30,36,10
22023,1628983,22300522,"JAN 10, 2024",OKC @ MIA,W,34,11,17,0.647,2,5,0.4,4,5,0.8,0,2,2,8,1,1,3,3,28,-3,1,Shai Gilgeous-Alexander,OKC,MIA,OKC,4.0,3-PT Attempted,38,30,36,10
22023,1628983,22300522,"JAN 10, 2024",OKC @ MIA,W,34,11,17,0.647,2,5,0.4,4,5,0.8,0,2,2,8,1,1,3,3,28,-3,1,Shai Gilgeous-Alexander,OKC,MIA,OKC,7.5,Free Throws Made,38,30,36,10
22023,1628983,22300522,"JAN 10, 2024",OKC @ MIA,W,34,11,17,0.647,2,5,0.4,4,5,0.8,0,2,2,8,1,1,3,3,28,-3,1,Shai Gilgeous-Alexander,OKC,MIA,OKC,20.5,FG Attempted,38,30,36,10
22023,1628983,22300522,"JAN 10, 2024",OKC @ MIA,W,34,11,17,0.647,2,5,0.4,4,5,0.8,0,2,2,8,1,1,3,3,28,-3,1,Shai Gilgeous-Alexander,OKC,MIA,OKC,36.5,Pts+Rebs,38,30,36,10
22023,1628983,22300522,"JAN 10, 2024",OKC @ MIA,W,34,11,17,0.647,2,5,0.4,4,5,0.8,0,2,2,8,1,1,3,3,28,-3,1,Shai Gilgeous-Alexander,OKC,MIA,OKC,0.5,Dunks,38,30,36,10
22023,1628983,22300522,"JAN 10, 2024",OKC @ MIA,W,34,11,17,0.647,2,5,0.4,4,5,0.8,0,2,2,8,1,1,3,3,28,-3,1,Shai Gilgeous-Alexander,OKC,MIA,OKC,36.5,Pts+Asts,38,30,36,10
22023,1628983,22300522,"JAN 10, 2024",OKC @ MIA,W,34,11,17,0.647,2,5,0.4,4,5,0.8,0,2,2,8,1,1,3,3,28,-3,1,Shai Gilgeous-Alexander,OKC,MIA,OKC,1.5,Steals,38,30,36,10
22023,1628983,22300522,"JAN 10, 2024",OKC @ MIA,W,34,11,17,0.647,2,5,0.4,4,5,0.8,0,2,2,8,1,1,3,3,28,-3,1,Shai Gilgeous-Alexander,OKC,MIA,OKC,12.0,Rebs+Asts,38,30,36,10
22023,1628983,22300508,"JAN 08, 2024",OKC @ WAS,W,36,11,17,0.647,2,3,0.667,8,10,0.8,1,5,6,5,3,1,3,5,32,3,1,Shai Gilgeous-Alexander,OKC,WAS,OKC,31.0,Points,43,38,37,11
22023,1628983,22300508,"JAN 08, 2024",OKC @ WAS,W,36,11,17,0.647,2,3,0.667,8,10,0.8,1,5,6,5,3,1,3,5,32,3,1,Shai Gilgeous-Alexander,OKC,WAS,OKC,31.0,Points,43,38,37,11
22023,1628983,22300508,"JAN 08, 2024",OKC @ WAS,W,36,11,17,0.647,2,3,0.667,8,10,0.8,1,5,6,5,3,1,3,5,32,3,1,Shai Gilgeous-Alexander,OKC,WAS,OKC,6.0,Rebounds,43,38,37,11
22023,1628983,22300508,"JAN 08, 2024",OKC @ WAS,W,36,11,17,0.647,2,3,0.667,8,10,0.8,1,5,6,5,3,1,3,5,32,3,1,Shai Gilgeous-Alexander,OKC,WAS,OKC,42.5,Pts+Rebs+Asts,43,38,37,11
22023,1628983,22300508,"JAN 08, 2024",OKC @ WAS,W,36,11,17,0.647,2,3,0.667,8,10,0.8,1,5,6,5,3,1,3,5,32,3,1,Shai Gilgeous-Alexander,OKC,WAS,OKC,6.0,Assists,43,38,37,11
22023,1628983,22300508,"JAN 08, 2024",OKC @ WAS,W,36,11,17,0.647,2,3,0.667,8,10,0.8,1,5,6,5,3,1,3,5,32,3,1,Shai Gilgeous-Alexander,OKC,WAS,OKC,51.5,Fantasy Score,43,38,37,11
22023,1628983,22300508,"JAN 08, 2024",OKC @ WAS,W,36,11,17,0.647,2,3,0.667,8,10,0.8,1,5,6,5,3,1,3,5,32,3,1,Shai Gilgeous-Alexander,OKC,WAS,OKC,4.0,3-PT Attempted,43,38,37,11
22023,1628983,22300508,"JAN 08, 2024",OKC @ WAS,W,36,11,17,0.647,2,3,0.667,8,10,0.8,1,5,6,5,3,1,3,5,32,3,1,Shai Gilgeous-Alexander,OKC,WAS,OKC,7.5,Free Throws Made,43,38,37,11
22023,1628983,22300508,"JAN 08, 2024",OKC @ WAS,W,36,11,17,0.647,2,3,0.667,8,10,0.8,1,5,6,5,3,1,3,5,32,3,1,Shai Gilgeous-Alexander,OKC,WAS,OKC,20.5,FG Attempted,43,38,37,11
22023,1628983,22300508,"JAN 08, 2024",OKC @ WAS,W,36,11,17,0.647,2,3,0.667,8,10,0.8,1,5,6,5,3,1,3,5,32,3,1,Shai Gilgeous-Alexander,OKC,WAS,OKC,36.5,Pts+Rebs,43,38,37,11
22023,1628983,22300508,"JAN 08, 2024",OKC @ WAS,W,36,11,17,0.647,2,3,0.667,8,10,0.8,1,5,6,5,3,1,3,5,32,3,1,Shai Gilgeous-Alexander,OKC,WAS,OKC,0.5,Dunks,43,38,37,11
22023,1628983,22300508,"JAN 08, 2024",OKC @ WAS,W,36,11,17,0.647,2,3,0.667,8,10,0.8,1,5,6,5,3,1,3,5,32,3,1,Shai Gilgeous-Alexander,OKC,WAS,OKC,36.5,Pts+Asts,43,38,37,11
22023,1628983,22300508,"JAN 08, 2024",OKC @ WAS,W,36,11,17,0.647,2,3,0.667,8,10,0.8,1,5,6,5,3,1,3,5,32,3,1,Shai Gilgeous-Alexander,OKC,WAS,OKC,1.5,Steals,43,38,37,11
22023,1628983,22300508,"JAN 08, 2024",OKC @ WAS,W,36,11,17,0.647,2,3,0.667,8,10,0.8,1,5,6,5,3,1,3,5,32,3,1,Shai Gilgeous-Alexander,OKC,WAS,OKC,12.0,Rebs+Asts,43,38,37,11
22023,1628983,22300481,"JAN 05, 2024",OKC @ BKN,L,36,11,19,0.579,2,5,0.4,10,15,0.667,1,8,9,6,0,0,2,5,34,-10,1,Shai Gilgeous-Alexander,OKC,BKN,OKC,31.0,Points,49,43,40,15
22023,1628983,22300481,"JAN 05, 2024",OKC @ BKN,L,36,11,19,0.579,2,5,0.4,10,15,0.667,1,8,9,6,0,0,2,5,34,-10,1,Shai Gilgeous-Alexander,OKC,BKN,OKC,31.0,Points,49,43,40,15
22023,1628983,22300481,"JAN 05, 2024",OKC @ BKN,L,36,11,19,0.579,2,5,0.4,10,15,0.667,1,8,9,6,0,0,2,5,34,-10,1,Shai Gilgeous-Alexander,OKC,BKN,OKC,6.0,Rebounds,49,43,40,15
22023,1628983,22300481,"JAN 05, 2024",OKC @ BKN,L,36,11,19,0.579,2,5,0.4,10,15,0.667,1,8,9,6,0,0,2,5,34,-10,1,Shai Gilgeous-Alexander,OKC,BKN,OKC,42.5,Pts+Rebs+Asts,49,43,40,15
22023,1628983,22300481,"JAN 05, 2024",OKC @ BKN,L,36,11,19,0.579,2,5,0.4,10,15,0.667,1,8,9,6,0,0,2,5,34,-10,1,Shai Gilgeous-Alexander,OKC,BKN,OKC,6.0,Assists,49,43,40,15
22023,1628983,22300481,"JAN 05, 2024",OKC @ BKN,L,36,11,19,0.579,2,5,0.4,10,15,0.667,1,8,9,6,0,0,2,5,34,-10,1,Shai Gilgeous-Alexander,OKC,BKN,OKC,51.5,Fantasy Score,49,43,40,15
22023,1628983,22300481,"JAN 05, 2024",OKC @ BKN,L,36,11,19,0.579,2,5,0.4,10,15,0.667,1,8,9,6,0,0,2,5,34,-10,1,Shai Gilgeous-Alexander,OKC,BKN,OKC,4.0,3-PT Attempted,49,43,40,15
22023,1628983,22300481,"JAN 05, 2024",OKC @ BKN,L,36,11,19,0.579,2,5,0.4,10,15,0.667,1,8,9,6,0,0,2,5,34,-10,1,Shai Gilgeous-Alexander,OKC,BKN,OKC,7.5,Free Throws Made,49,43,40,15
22023,1628983,22300481,"JAN 05, 2024",OKC @ BKN,L,36,11,19,0.579,2,5,0.4,10,15,0.667,1,8,9,6,0,0,2,5,34,-10,1,Shai Gilgeous-Alexander,OKC,BKN,OKC,20.5,FG Attempted,49,43,40,15
22023,1628983,22300481,"JAN 05, 2024",OKC @ BKN,L,36,11,19,0.579,2,5,0.4,10,15,0.667,1,8,9,6,0,0,2,5,34,-10,1,Shai Gilgeous-Alexander,OKC,BKN,OKC,36.5,Pts+Rebs,49,43,40,15
22023,1628983,22300481,"JAN 05, 2024",OKC @ BKN,L,36,11,19,0.579,2,5,0.4,10,15,0.667,1,8,9,6,0,0,2,5,34,-10,1,Shai Gilgeous-Alexander,OKC,BKN,OKC,0.5,Dunks,49,43,40,15
22023,1628983,22300481,"JAN 05, 2024",OKC @ BKN,L,36,11,19,0.579,2,5,0.4,10,15,0.667,1,8,9,6,0,0,2,5,34,-10,1,Shai Gilgeous-Alexander,OKC,BKN,OKC,36.5,Pts+Asts,49,43,40,15
22023,1628983,22300481,"JAN 05, 2024",OKC @ BKN,L,36,11,19,0.579,2,5,0.4,10,15,0.667,1,8,9,6,0,0,2,5,34,-10,1,Shai Gilgeous-Alexander,OKC,BKN,OKC,1.5,Steals,49,43,40,15
22023,1628983,22300481,"JAN 05, 2024",OKC @ BKN,L,36,11,19,0.579,2,5,0.4,10,15,0.667,1,8,9,6,0,0,2,5,34,-10,1,Shai Gilgeous-Alexander,OKC,BKN,OKC,12.0,Rebs+Asts,49,43,40,15
22023,1628983,22300467,"JAN 03, 2024",OKC @ ATL,L,35,11,24,0.458,2,3,0.667,9,11,0.818,1,12,13,8,0,0,2,2,33,2,1,Shai Gilgeous-Alexander,OKC,ATL,OKC,31.0,Points,54,46,41,21
22023,1628983,22300467,"JAN 03, 2024",OKC @ ATL,L,35,11,24,0.458,2,3,0.667,9,11,0.818,1,12,13,8,0,0,2,2,33,2,1,Shai Gilgeous-Alexander,OKC,ATL,OKC,31.0,Points,54,46,41,21
22023,1628983,22300467,"JAN 03, 2024",OKC @ ATL,L,35,11,24,0.458,2,3,0.667,9,11,0.818,1,12,13,8,0,0,2,2,33,2,1,Shai Gilgeous-Alexander,OKC,ATL,OKC,6.0,Rebounds,54,46,41,21
22023,1628983,22300467,"JAN 03, 2024",OKC @ ATL,L,35,11,24,0.458,2,3,0.667,9,11,0.818,1,12,13,8,0,0,2,2,33,2,1,Shai Gilgeous-Alexander,OKC,ATL,OKC,42.5,Pts+Rebs+Asts,54,46,41,21
22023,1628983,22300467,"JAN 03, 2024",OKC @ ATL,L,35,11,24,0.458,2,3,0.667,9,11,0.818,1,12,13,8,0,0,2,2,33,2,1,Shai Gilgeous-Alexander,OKC,ATL,OKC,6.0,Assists,54,46,41,21
22023,1628983,22300467,"JAN 03, 2024",OKC @ ATL,L,35,11,24,0.458,2,3,0.667,9,11,0.818,1,12,13,8,0,0,2,2,33,2,1,Shai Gilgeous-Alexander,OKC,ATL,OKC,51.5,Fantasy Score,54,46,41,21
22023,1628983,22300467,"JAN 03, 2024",OKC @ ATL,L,35,11,24,0.458,2,3,0.667,9,11,0.818,1,12,13,8,0,0,2,2,33,2,1,Shai Gilgeous-Alexander,OKC,ATL,OKC,4.0,3-PT Attempted,54,46,41,21
22023,1628983,22300467,"JAN 03, 2024",OKC @ ATL,L,35,11,24,0.458,2,3,0.667,9,11,0.818,1,12,13,8,0,0,2,2,33,2,1,Shai Gilgeous-Alexander,OKC,ATL,OKC,7.5,Free Throws Made,54,46,41,21
22023,1628983,22300467,"JAN 03, 2024",OKC @ ATL,L,35,11,24,0.458,2,3,0.667,9,11,0.818,1,12,13,8,0,0,2,2,33,2,1,Shai Gilgeous-Alexander,OKC,ATL,OKC,20.5,FG Attempted,54,46,41,21
22023,1628983,22300467,"JAN 03, 2024",OKC @ ATL,L,35,11,24,0.458,2,3,0.667,9,11,0.818,1,12,13,8,0,0,2,2,33,2,1,Shai Gilgeous-Alexander,OKC,ATL,OKC,36.5,Pts+Rebs,54,46,41,21
22023,1628983,22300467,"JAN 03, 2024",OKC @ ATL,L,35,11,24,0.458,2,3,0.667,9,11,0.818,1,12,13,8,0,0,2,2,33,2,1,Shai Gilgeous-Alexander,OKC,ATL,OKC,0.5,Dunks,54,46,41,21
22023,1628983,22300467,"JAN 03, 2024",OKC @ ATL,L,35,11,24,0.458,2,3,0.667,9,11,0.818,1,12,13,8,0,0,2,2,33,2,1,Shai Gilgeous-Alexander,OKC,ATL,OKC,36.5,Pts+Asts,54,46,41,21
22023,1628983,22300467,"JAN 03, 2024",OKC @ ATL,L,35,11,24,0.458,2,3,0.667,9,11,0.818,1,12,13,8,0,0,2,2,33,2,1,Shai Gilgeous-Alexander,OKC,ATL,OKC,1.5,Steals,54,46,41,21
22023,1628983,22300467,"JAN 03, 2024",OKC @ ATL,L,35,11,24,0.458,2,3,0.667,9,11,0.818,1,12,13,8,0,0,2,2,33,2,1,Shai Gilgeous-Alexander,OKC,ATL,OKC,12.0,Rebs+Asts,54,46,41,21
22023,1628983,22300462,"JAN 02, 2024",OKC vs. BOS,W,37,14,22,0.636,3,5,0.6,5,8,0.625,0,6,6,7,1,0,0,5,36,3,1,Shai Gilgeous-Alexander,OKC,OKC,BOS,31.0,Points,49,42,43,13
22023,1628983,22300462,"JAN 02, 2024",OKC vs. BOS,W,37,14,22,0.636,3,5,0.6,5,8,0.625,0,6,6,7,1,0,0,5,36,3,1,Shai Gilgeous-Alexander,OKC,OKC,BOS,31.0,Points,49,42,43,13
22023,1628983,22300462,"JAN 02, 2024",OKC vs. BOS,W,37,14,22,0.636,3,5,0.6,5,8,0.625,0,6,6,7,1,0,0,5,36,3,1,Shai Gilgeous-Alexander,OKC,OKC,BOS,6.0,Rebounds,49,42,43,13
22023,1628983,22300462,"JAN 02, 2024",OKC vs. BOS,W,37,14,22,0.636,3,5,0.6,5,8,0.625,0,6,6,7,1,0,0,5,36,3,1,Shai Gilgeous-Alexander,OKC,OKC,BOS,42.5,Pts+Rebs+Asts,49,42,43,13
22023,1628983,22300462,"JAN 02, 2024",OKC vs. BOS,W,37,14,22,0.636,3,5,0.6,5,8,0.625,0,6,6,7,1,0,0,5,36,3,1,Shai Gilgeous-Alexander,OKC,OKC,BOS,6.0,Assists,49,42,43,13
22023,1628983,22300462,"JAN 02, 2024",OKC vs. BOS,W,37,14,22,0.636,3,5,0.6,5,8,0.625,0,6,6,7,1,0,0,5,36,3,1,Shai Gilgeous-Alexander,OKC,OKC,BOS,51.5,Fantasy Score,49,42,43,13
22023,1628983,22300462,"JAN 02, 2024",OKC vs. BOS,W,37,14,22,0.636,3,5,0.6,5,8,0.625,0,6,6,7,1,0,0,5,36,3,1,Shai Gilgeous-Alexander,OKC,OKC,BOS,4.0,3-PT Attempted,49,42,43,13
22023,1628983,22300462,"JAN 02, 2024",OKC vs. BOS,W,37,14,22,0.636,3,5,0.6,5,8,0.625,0,6,6,7,1,0,0,5,36,3,1,Shai Gilgeous-Alexander,OKC,OKC,BOS,7.5,Free Throws Made,49,42,43,13
22023,1628983,22300462,"JAN 02, 2024",OKC vs. BOS,W,37,14,22,0.636,3,5,0.6,5,8,0.625,0,6,6,7,1,0,0,5,36,3,1,Shai Gilgeous-Alexander,OKC,OKC,BOS,20.5,FG Attempted,49,42,43,13
22023,1628983,22300462,"JAN 02, 2024",OKC vs. BOS,W,37,14,22,0.636,3,5,0.6,5,8,0.625,0,6,6,7,1,0,0,5,36,3,1,Shai Gilgeous-Alexander,OKC,OKC,BOS,36.5,Pts+Rebs,49,42,43,13
22023,1628983,22300462,"JAN 02, 2024",OKC vs. BOS,W,37,14,22,0.636,3,5,0.6,5,8,0.625,0,6,6,7,1,0,0,5,36,3,1,Shai Gilgeous-Alexander,OKC,OKC,BOS,0.5,Dunks,49,42,43,13
22023,1628983,22300462,"JAN 02, 2024",OKC vs. BOS,W,37,14,22,0.636,3,5,0.6,5,8,0.625,0,6,6,7,1,0,0,5,36,3,1,Shai Gilgeous-Alexander,OKC,OKC,BOS,36.5,Pts+Asts,49,42,43,13
22023,1628983,22300462,"JAN 02, 2024",OKC vs. BOS,W,37,14,22,0.636,3,5,0.6,5,8,0.625,0,6,6,7,1,0,0,5,36,3,1,Shai Gilgeous-Alexander,OKC,OKC,BOS,1.5,Steals,49,42,43,13
22023,1628983,22300462,"JAN 02, 2024",OKC vs. BOS,W,37,14,22,0.636,3,5,0.6,5,8,0.625,0,6,6,7,1,0,0,5,36,3,1,Shai Gilgeous-Alexander,OKC,OKC,BOS,12.0,Rebs+Asts,49,42,43,13
22023,1628983,22300447,"DEC 31, 2023",OKC vs. BKN,W,35,7,15,0.467,1,2,0.5,9,9,1.0,0,4,4,6,0,0,1,2,24,9,1,Shai Gilgeous-Alexander,OKC,OKC,BKN,31.0,Points,34,28,30,10
22023,1628983,22300447,"DEC 31, 2023",OKC vs. BKN,W,35,7,15,0.467,1,2,0.5,9,9,1.0,0,4,4,6,0,0,1,2,24,9,1,Shai Gilgeous-Alexander,OKC,OKC,BKN,31.0,Points,34,28,30,10
22023,1628983,22300447,"DEC 31, 2023",OKC vs. BKN,W,35,7,15,0.467,1,2,0.5,9,9,1.0,0,4,4,6,0,0,1,2,24,9,1,Shai Gilgeous-Alexander,OKC,OKC,BKN,6.0,Rebounds,34,28,30,10
22023,1628983,22300447,"DEC 31, 2023",OKC vs. BKN,W,35,7,15,0.467,1,2,0.5,9,9,1.0,0,4,4,6,0,0,1,2,24,9,1,Shai Gilgeous-Alexander,OKC,OKC,BKN,42.5,Pts+Rebs+Asts,34,28,30,10
22023,1628983,22300447,"DEC 31, 2023",OKC vs. BKN,W,35,7,15,0.467,1,2,0.5,9,9,1.0,0,4,4,6,0,0,1,2,24,9,1,Shai Gilgeous-Alexander,OKC,OKC,BKN,6.0,Assists,34,28,30,10
22023,1628983,22300447,"DEC 31, 2023",OKC vs. BKN,W,35,7,15,0.467,1,2,0.5,9,9,1.0,0,4,4,6,0,0,1,2,24,9,1,Shai Gilgeous-Alexander,OKC,OKC,BKN,51.5,Fantasy Score,34,28,30,10
22023,1628983,22300447,"DEC 31, 2023",OKC vs. BKN,W,35,7,15,0.467,1,2,0.5,9,9,1.0,0,4,4,6,0,0,1,2,24,9,1,Shai Gilgeous-Alexander,OKC,OKC,BKN,4.0,3-PT Attempted,34,28,30,10
22023,1628983,22300447,"DEC 31, 2023",OKC vs. BKN,W,35,7,15,0.467,1,2,0.5,9,9,1.0,0,4,4,6,0,0,1,2,24,9,1,Shai Gilgeous-Alexander,OKC,OKC,BKN,7.5,Free Throws Made,34,28,30,10
22023,1628983,22300447,"DEC 31, 2023",OKC vs. BKN,W,35,7,15,0.467,1,2,0.5,9,9,1.0,0,4,4,6,0,0,1,2,24,9,1,Shai Gilgeous-Alexander,OKC,OKC,BKN,20.5,FG Attempted,34,28,30,10
22023,1628983,22300447,"DEC 31, 2023",OKC vs. BKN,W,35,7,15,0.467,1,2,0.5,9,9,1.0,0,4,4,6,0,0,1,2,24,9,1,Shai Gilgeous-Alexander,OKC,OKC,BKN,36.5,Pts+Rebs,34,28,30,10
22023,1628983,22300447,"DEC 31, 2023",OKC vs. BKN,W,35,7,15,0.467,1,2,0.5,9,9,1.0,0,4,4,6,0,0,1,2,24,9,1,Shai Gilgeous-Alexander,OKC,OKC,BKN,0.5,Dunks,34,28,30,10
22023,1628983,22300447,"DEC 31, 2023",OKC vs. BKN,W,35,7,15,0.467,1,2,0.5,9,9,1.0,0,4,4,6,0,0,1,2,24,9,1,Shai Gilgeous-Alexander,OKC,OKC,BKN,36.5,Pts+Asts,34,28,30,10
22023,1628983,22300447,"DEC 31, 2023",OKC vs. BKN,W,35,7,15,0.467,1,2,0.5,9,9,1.0,0,4,4,6,0,0,1,2,24,9,1,Shai Gilgeous-Alexander,OKC,OKC,BKN,1.5,Steals,34,28,30,10
22023,1628983,22300447,"DEC 31, 2023",OKC vs. BKN,W,35,7,15,0.467,1,2,0.5,9,9,1.0,0,4,4,6,0,0,1,2,24,9,1,Shai Gilgeous-Alexander,OKC,OKC,BKN,12.0,Rebs+Asts,34,28,30,10
22023,1628983,22300435,"DEC 29, 2023",OKC @ DEN,W,33,14,20,0.7,2,3,0.667,10,10,1.0,0,4,4,3,2,1,1,3,40,21,1,Shai Gilgeous-Alexander,OKC,DEN,OKC,31.0,Points,47,44,43,7
22023,1628983,22300435,"DEC 29, 2023",OKC @ DEN,W,33,14,20,0.7,2,3,0.667,10,10,1.0,0,4,4,3,2,1,1,3,40,21,1,Shai Gilgeous-Alexander,OKC,DEN,OKC,31.0,Points,47,44,43,7
22023,1628983,22300435,"DEC 29, 2023",OKC @ DEN,W,33,14,20,0.7,2,3,0.667,10,10,1.0,0,4,4,3,2,1,1,3,40,21,1,Shai Gilgeous-Alexander,OKC,DEN,OKC,6.0,Rebounds,47,44,43,7
22023,1628983,22300435,"DEC 29, 2023",OKC @ DEN,W,33,14,20,0.7,2,3,0.667,10,10,1.0,0,4,4,3,2,1,1,3,40,21,1,Shai Gilgeous-Alexander,OKC,DEN,OKC,42.5,Pts+Rebs+Asts,47,44,43,7
22023,1628983,22300435,"DEC 29, 2023",OKC @ DEN,W,33,14,20,0.7,2,3,0.667,10,10,1.0,0,4,4,3,2,1,1,3,40,21,1,Shai Gilgeous-Alexander,OKC,DEN,OKC,6.0,Assists,47,44,43,7
22023,1628983,22300435,"DEC 29, 2023",OKC @ DEN,W,33,14,20,0.7,2,3,0.667,10,10,1.0,0,4,4,3,2,1,1,3,40,21,1,Shai Gilgeous-Alexander,OKC,DEN,OKC,51.5,Fantasy Score,47,44,43,7
22023,1628983,22300435,"DEC 29, 2023",OKC @ DEN,W,33,14,20,0.7,2,3,0.667,10,10,1.0,0,4,4,3,2,1,1,3,40,21,1,Shai Gilgeous-Alexander,OKC,DEN,OKC,4.0,3-PT Attempted,47,44,43,7
22023,1628983,22300435,"DEC 29, 2023",OKC @ DEN,W,33,14,20,0.7,2,3,0.667,10,10,1.0,0,4,4,3,2,1,1,3,40,21,1,Shai Gilgeous-Alexander,OKC,DEN,OKC,7.5,Free Throws Made,47,44,43,7
22023,1628983,22300435,"DEC 29, 2023",OKC @ DEN,W,33,14,20,0.7,2,3,0.667,10,10,1.0,0,4,4,3,2,1,1,3,40,21,1,Shai Gilgeous-Alexander,OKC,DEN,OKC,20.5,FG Attempted,47,44,43,7
22023,1628983,22300435,"DEC 29, 2023",OKC @ DEN,W,33,14,20,0.7,2,3,0.667,10,10,1.0,0,4,4,3,2,1,1,3,40,21,1,Shai Gilgeous-Alexander,OKC,DEN,OKC,36.5,Pts+Rebs,47,44,43,7
22023,1628983,22300435,"DEC 29, 2023",OKC @ DEN,W,33,14,20,0.7,2,3,0.667,10,10,1.0,0,4,4,3,2,1,1,3,40,21,1,Shai Gilgeous-Alexander,OKC,DEN,OKC,0.5,Dunks,47,44,43,7
22023,1628983,22300435,"DEC 29, 2023",OKC @ DEN,W,33,14,20,0.7,2,3,0.667,10,10,1.0,0,4,4,3,2,1,1,3,40,21,1,Shai Gilgeous-Alexander,OKC,DEN,OKC,36.5,Pts+Asts,47,44,43,7
22023,1628983,22300435,"DEC 29, 2023",OKC @ DEN,W,33,14,20,0.7,2,3,0.667,10,10,1.0,0,4,4,3,2,1,1,3,40,21,1,Shai Gilgeous-Alexander,OKC,DEN,OKC,1.5,Steals,47,44,43,7
22023,1628983,22300435,"DEC 29, 2023",OKC @ DEN,W,33,14,20,0.7,2,3,0.667,10,10,1.0,0,4,4,3,2,1,1,3,40,21,1,Shai Gilgeous-Alexander,OKC,DEN,OKC,12.0,Rebs+Asts,47,44,43,7
22023,1628983,22300419,"DEC 27, 2023",OKC vs. NYK,W,36,13,23,0.565,2,5,0.4,8,9,0.889,1,6,7,8,2,2,1,0,36,12,1,Shai Gilgeous-Alexander,OKC,OKC,NYK,31.0,Points,51,43,44,15
22023,1628983,22300419,"DEC 27, 2023",OKC vs. NYK,W,36,13,23,0.565,2,5,0.4,8,9,0.889,1,6,7,8,2,2,1,0,36,12,1,Shai Gilgeous-Alexander,OKC,OKC,NYK,31.0,Points,51,43,44,15
22023,1628983,22300419,"DEC 27, 2023",OKC vs. NYK,W,36,13,23,0.565,2,5,0.4,8,9,0.889,1,6,7,8,2,2,1,0,36,12,1,Shai Gilgeous-Alexander,OKC,OKC,NYK,6.0,Rebounds,51,43,44,15
22023,1628983,22300419,"DEC 27, 2023",OKC vs. NYK,W,36,13,23,0.565,2,5,0.4,8,9,0.889,1,6,7,8,2,2,1,0,36,12,1,Shai Gilgeous-Alexander,OKC,OKC,NYK,42.5,Pts+Rebs+Asts,51,43,44,15
22023,1628983,22300419,"DEC 27, 2023",OKC vs. NYK,W,36,13,23,0.565,2,5,0.4,8,9,0.889,1,6,7,8,2,2,1,0,36,12,1,Shai Gilgeous-Alexander,OKC,OKC,NYK,6.0,Assists,51,43,44,15
22023,1628983,22300419,"DEC 27, 2023",OKC vs. NYK,W,36,13,23,0.565,2,5,0.4,8,9,0.889,1,6,7,8,2,2,1,0,36,12,1,Shai Gilgeous-Alexander,OKC,OKC,NYK,51.5,Fantasy Score,51,43,44,15
22023,1628983,22300419,"DEC 27, 2023",OKC vs. NYK,W,36,13,23,0.565,2,5,0.4,8,9,0.889,1,6,7,8,2,2,1,0,36,12,1,Shai Gilgeous-Alexander,OKC,OKC,NYK,4.0,3-PT Attempted,51,43,44,15
22023,1628983,22300419,"DEC 27, 2023",OKC vs. NYK,W,36,13,23,0.565,2,5,0.4,8,9,0.889,1,6,7,8,2,2,1,0,36,12,1,Shai Gilgeous-Alexander,OKC,OKC,NYK,7.5,Free Throws Made,51,43,44,15
22023,1628983,22300419,"DEC 27, 2023",OKC vs. NYK,W,36,13,23,0.565,2,5,0.4,8,9,0.889,1,6,7,8,2,2,1,0,36,12,1,Shai Gilgeous-Alexander,OKC,OKC,NYK,20.5,FG Attempted,51,43,44,15
22023,1628983,22300419,"DEC 27, 2023",OKC vs. NYK,W,36,13,23,0.565,2,5,0.4,8,9,0.889,1,6,7,8,2,2,1,0,36,12,1,Shai Gilgeous-Alexander,OKC,OKC,NYK,36.5,Pts+Rebs,51,43,44,15
22023,1628983,22300419,"DEC 27, 2023",OKC vs. NYK,W,36,13,23,0.565,2,5,0.4,8,9,0.889,1,6,7,8,2,2,1,0,36,12,1,Shai Gilgeous-Alexander,OKC,OKC,NYK,0.5,Dunks,51,43,44,15
22023,1628983,22300419,"DEC 27, 2023",OKC vs. NYK,W,36,13,23,0.565,2,5,0.4,8,9,0.889,1,6,7,8,2,2,1,0,36,12,1,Shai Gilgeous-Alexander,OKC,OKC,NYK,36.5,Pts+Asts,51,43,44,15
22023,1628983,22300419,"DEC 27, 2023",OKC vs. NYK,W,36,13,23,0.565,2,5,0.4,8,9,0.889,1,6,7,8,2,2,1,0,36,12,1,Shai Gilgeous-Alexander,OKC,OKC,NYK,1.5,Steals,51,43,44,15
22023,1628983,22300419,"DEC 27, 2023",OKC vs. NYK,W,36,13,23,0.565,2,5,0.4,8,9,0.889,1,6,7,8,2,2,1,0,36,12,1,Shai Gilgeous-Alexander,OKC,OKC,NYK,12.0,Rebs+Asts,51,43,44,15
22023,1628983,22300411,"DEC 26, 2023",OKC vs. MIN,W,33,14,19,0.737,0,3,0.0,6,7,0.857,0,6,6,9,2,1,3,3,34,16,1,Shai Gilgeous-Alexander,OKC,OKC,MIN,31.0,Points,49,40,43,15
22023,1628983,22300411,"DEC 26, 2023",OKC vs. MIN,W,33,14,19,0.737,0,3,0.0,6,7,0.857,0,6,6,9,2,1,3,3,34,16,1,Shai Gilgeous-Alexander,OKC,OKC,MIN,31.0,Points,49,40,43,15
22023,1628983,22300411,"DEC 26, 2023",OKC vs. MIN,W,33,14,19,0.737,0,3,0.0,6,7,0.857,0,6,6,9,2,1,3,3,34,16,1,Shai Gilgeous-Alexander,OKC,OKC,MIN,6.0,Rebounds,49,40,43,15
22023,1628983,22300411,"DEC 26, 2023",OKC vs. MIN,W,33,14,19,0.737,0,3,0.0,6,7,0.857,0,6,6,9,2,1,3,3,34,16,1,Shai Gilgeous-Alexander,OKC,OKC,MIN,42.5,Pts+Rebs+Asts,49,40,43,15
22023,1628983,22300411,"DEC 26, 2023",OKC vs. MIN,W,33,14,19,0.737,0,3,0.0,6,7,0.857,0,6,6,9,2,1,3,3,34,16,1,Shai Gilgeous-Alexander,OKC,OKC,MIN,6.0,Assists,49,40,43,15
22023,1628983,22300411,"DEC 26, 2023",OKC vs. MIN,W,33,14,19,0.737,0,3,0.0,6,7,0.857,0,6,6,9,2,1,3,3,34,16,1,Shai Gilgeous-Alexander,OKC,OKC,MIN,51.5,Fantasy Score,49,40,43,15
22023,1628983,22300411,"DEC 26, 2023",OKC vs. MIN,W,33,14,19,0.737,0,3,0.0,6,7,0.857,0,6,6,9,2,1,3,3,34,16,1,Shai Gilgeous-Alexander,OKC,OKC,MIN,4.0,3-PT Attempted,49,40,43,15
22023,1628983,22300411,"DEC 26, 2023",OKC vs. MIN,W,33,14,19,0.737,0,3,0.0,6,7,0.857,0,6,6,9,2,1,3,3,34,16,1,Shai Gilgeous-Alexander,OKC,OKC,MIN,7.5,Free Throws Made,49,40,43,15
22023,1628983,22300411,"DEC 26, 2023",OKC vs. MIN,W,33,14,19,0.737,0,3,0.0,6,7,0.857,0,6,6,9,2,1,3,3,34,16,1,Shai Gilgeous-Alexander,OKC,OKC,MIN,20.5,FG Attempted,49,40,43,15
22023,1628983,22300411,"DEC 26, 2023",OKC vs. MIN,W,33,14,19,0.737,0,3,0.0,6,7,0.857,0,6,6,9,2,1,3,3,34,16,1,Shai Gilgeous-Alexander,OKC,OKC,MIN,36.5,Pts+Rebs,49,40,43,15
22023,1628983,22300411,"DEC 26, 2023",OKC vs. MIN,W,33,14,19,0.737,0,3,0.0,6,7,0.857,0,6,6,9,2,1,3,3,34,16,1,Shai Gilgeous-Alexander,OKC,OKC,MIN,0.5,Dunks,49,40,43,15
22023,1628983,22300411,"DEC 26, 2023",OKC vs. MIN,W,33,14,19,0.737,0,3,0.0,6,7,0.857,0,6,6,9,2,1,3,3,34,16,1,Shai Gilgeous-Alexander,OKC,OKC,MIN,36.5,Pts+Asts,49,40,43,15
22023,1628983,22300411,"DEC 26, 2023",OKC vs. MIN,W,33,14,19,0.737,0,3,0.0,6,7,0.857,0,6,6,9,2,1,3,3,34,16,1,Shai Gilgeous-Alexander,OKC,OKC,MIN,1.5,Steals,49,40,43,15
22023,1628983,22300411,"DEC 26, 2023",OKC vs. MIN,W,33,14,19,0.737,0,3,0.0,6,7,0.857,0,6,6,9,2,1,3,3,34,16,1,Shai Gilgeous-Alexander,OKC,OKC,MIN,12.0,Rebs+Asts,49,40,43,15
22023,1628983,22300397,"DEC 23, 2023",OKC vs. LAL,L,38,12,21,0.571,1,5,0.2,9,10,0.9,1,4,5,7,3,0,3,2,34,-6,1,Shai Gilgeous-Alexander,OKC,OKC,LAL,31.0,Points,46,39,41,12
22023,1628983,22300397,"DEC 23, 2023",OKC vs. LAL,L,38,12,21,0.571,1,5,0.2,9,10,0.9,1,4,5,7,3,0,3,2,34,-6,1,Shai Gilgeous-Alexander,OKC,OKC,LAL,31.0,Points,46,39,41,12
22023,1628983,22300397,"DEC 23, 2023",OKC vs. LAL,L,38,12,21,0.571,1,5,0.2,9,10,0.9,1,4,5,7,3,0,3,2,34,-6,1,Shai Gilgeous-Alexander,OKC,OKC,LAL,6.0,Rebounds,46,39,41,12
22023,1628983,22300397,"DEC 23, 2023",OKC vs. LAL,L,38,12,21,0.571,1,5,0.2,9,10,0.9,1,4,5,7,3,0,3,2,34,-6,1,Shai Gilgeous-Alexander,OKC,OKC,LAL,42.5,Pts+Rebs+Asts,46,39,41,12
22023,1628983,22300397,"DEC 23, 2023",OKC vs. LAL,L,38,12,21,0.571,1,5,0.2,9,10,0.9,1,4,5,7,3,0,3,2,34,-6,1,Shai Gilgeous-Alexander,OKC,OKC,LAL,6.0,Assists,46,39,41,12
22023,1628983,22300397,"DEC 23, 2023",OKC vs. LAL,L,38,12,21,0.571,1,5,0.2,9,10,0.9,1,4,5,7,3,0,3,2,34,-6,1,Shai Gilgeous-Alexander,OKC,OKC,LAL,51.5,Fantasy Score,46,39,41,12
22023,1628983,22300397,"DEC 23, 2023",OKC vs. LAL,L,38,12,21,0.571,1,5,0.2,9,10,0.9,1,4,5,7,3,0,3,2,34,-6,1,Shai Gilgeous-Alexander,OKC,OKC,LAL,4.0,3-PT Attempted,46,39,41,12
22023,1628983,22300397,"DEC 23, 2023",OKC vs. LAL,L,38,12,21,0.571,1,5,0.2,9,10,0.9,1,4,5,7,3,0,3,2,34,-6,1,Shai Gilgeous-Alexander,OKC,OKC,LAL,7.5,Free Throws Made,46,39,41,12
22023,1628983,22300397,"DEC 23, 2023",OKC vs. LAL,L,38,12,21,0.571,1,5,0.2,9,10,0.9,1,4,5,7,3,0,3,2,34,-6,1,Shai Gilgeous-Alexander,OKC,OKC,LAL,20.5,FG Attempted,46,39,41,12
22023,1628983,22300397,"DEC 23, 2023",OKC vs. LAL,L,38,12,21,0.571,1,5,0.2,9,10,0.9,1,4,5,7,3,0,3,2,34,-6,1,Shai Gilgeous-Alexander,OKC,OKC,LAL,36.5,Pts+Rebs,46,39,41,12
22023,1628983,22300397,"DEC 23, 2023",OKC vs. LAL,L,38,12,21,0.571,1,5,0.2,9,10,0.9,1,4,5,7,3,0,3,2,34,-6,1,Shai Gilgeous-Alexander,OKC,OKC,LAL,0.5,Dunks,46,39,41,12
22023,1628983,22300397,"DEC 23, 2023",OKC vs. LAL,L,38,12,21,0.571,1,5,0.2,9,10,0.9,1,4,5,7,3,0,3,2,34,-6,1,Shai Gilgeous-Alexander,OKC,OKC,LAL,36.5,Pts+Asts,46,39,41,12
22023,1628983,22300397,"DEC 23, 2023",OKC vs. LAL,L,38,12,21,0.571,1,5,0.2,9,10,0.9,1,4,5,7,3,0,3,2,34,-6,1,Shai Gilgeous-Alexander,OKC,OKC,LAL,1.5,Steals,46,39,41,12
22023,1628983,22300397,"DEC 23, 2023",OKC vs. LAL,L,38,12,21,0.571,1,5,0.2,9,10,0.9,1,4,5,7,3,0,3,2,34,-6,1,Shai Gilgeous-Alexander,OKC,OKC,LAL,12.0,Rebs+Asts,46,39,41,12
22023,1628983,22300379,"DEC 21, 2023",OKC vs. LAC,W,32,11,25,0.44,1,6,0.167,8,9,0.889,2,6,8,4,4,2,1,0,31,9,1,Shai Gilgeous-Alexander,OKC,OKC,LAC,31.0,Points,43,39,35,12
22023,1628983,22300379,"DEC 21, 2023",OKC vs. LAC,W,32,11,25,0.44,1,6,0.167,8,9,0.889,2,6,8,4,4,2,1,0,31,9,1,Shai Gilgeous-Alexander,OKC,OKC,LAC,31.0,Points,43,39,35,12
22023,1628983,22300379,"DEC 21, 2023",OKC vs. LAC,W,32,11,25,0.44,1,6,0.167,8,9,0.889,2,6,8,4,4,2,1,0,31,9,1,Shai Gilgeous-Alexander,OKC,OKC,LAC,6.0,Rebounds,43,39,35,12
22023,1628983,22300379,"DEC 21, 2023",OKC vs. LAC,W,32,11,25,0.44,1,6,0.167,8,9,0.889,2,6,8,4,4,2,1,0,31,9,1,Shai Gilgeous-Alexander,OKC,OKC,LAC,42.5,Pts+Rebs+Asts,43,39,35,12
22023,1628983,22300379,"DEC 21, 2023",OKC vs. LAC,W,32,11,25,0.44,1,6,0.167,8,9,0.889,2,6,8,4,4,2,1,0,31,9,1,Shai Gilgeous-Alexander,OKC,OKC,LAC,6.0,Assists,43,39,35,12
22023,1628983,22300379,"DEC 21, 2023",OKC vs. LAC,W,32,11,25,0.44,1,6,0.167,8,9,0.889,2,6,8,4,4,2,1,0,31,9,1,Shai Gilgeous-Alexander,OKC,OKC,LAC,51.5,Fantasy Score,43,39,35,12
22023,1628983,22300379,"DEC 21, 2023",OKC vs. LAC,W,32,11,25,0.44,1,6,0.167,8,9,0.889,2,6,8,4,4,2,1,0,31,9,1,Shai Gilgeous-Alexander,OKC,OKC,LAC,4.0,3-PT Attempted,43,39,35,12
22023,1628983,22300379,"DEC 21, 2023",OKC vs. LAC,W,32,11,25,0.44,1,6,0.167,8,9,0.889,2,6,8,4,4,2,1,0,31,9,1,Shai Gilgeous-Alexander,OKC,OKC,LAC,7.5,Free Throws Made,43,39,35,12
22023,1628983,22300379,"DEC 21, 2023",OKC vs. LAC,W,32,11,25,0.44,1,6,0.167,8,9,0.889,2,6,8,4,4,2,1,0,31,9,1,Shai Gilgeous-Alexander,OKC,OKC,LAC,20.5,FG Attempted,43,39,35,12
22023,1628983,22300379,"DEC 21, 2023",OKC vs. LAC,W,32,11,25,0.44,1,6,0.167,8,9,0.889,2,6,8,4,4,2,1,0,31,9,1,Shai Gilgeous-Alexander,OKC,OKC,LAC,36.5,Pts+Rebs,43,39,35,12
22023,1628983,22300379,"DEC 21, 2023",OKC vs. LAC,W,32,11,25,0.44,1,6,0.167,8,9,0.889,2,6,8,4,4,2,1,0,31,9,1,Shai Gilgeous-Alexander,OKC,OKC,LAC,0.5,Dunks,43,39,35,12
22023,1628983,22300379,"DEC 21, 2023",OKC vs. LAC,W,32,11,25,0.44,1,6,0.167,8,9,0.889,2,6,8,4,4,2,1,0,31,9,1,Shai Gilgeous-Alexander,OKC,OKC,LAC,36.5,Pts+Asts,43,39,35,12
22023,1628983,22300379,"DEC 21, 2023",OKC vs. LAC,W,32,11,25,0.44,1,6,0.167,8,9,0.889,2,6,8,4,4,2,1,0,31,9,1,Shai Gilgeous-Alexander,OKC,OKC,LAC,1.5,Steals,43,39,35,12
22023,1628983,22300379,"DEC 21, 2023",OKC vs. LAC,W,32,11,25,0.44,1,6,0.167,8,9,0.889,2,6,8,4,4,2,1,0,31,9,1,Shai Gilgeous-Alexander,OKC,OKC,LAC,12.0,Rebs+Asts,43,39,35,12
22023,1628983,22300355,"DEC 18, 2023",OKC vs. MEM,W,28,8,18,0.444,1,3,0.333,13,14,0.929,0,9,9,5,4,0,2,4,30,30,1,Shai Gilgeous-Alexander,OKC,OKC,MEM,31.0,Points,44,39,35,14
22023,1628983,22300355,"DEC 18, 2023",OKC vs. MEM,W,28,8,18,0.444,1,3,0.333,13,14,0.929,0,9,9,5,4,0,2,4,30,30,1,Shai Gilgeous-Alexander,OKC,OKC,MEM,31.0,Points,44,39,35,14
22023,1628983,22300355,"DEC 18, 2023",OKC vs. MEM,W,28,8,18,0.444,1,3,0.333,13,14,0.929,0,9,9,5,4,0,2,4,30,30,1,Shai Gilgeous-Alexander,OKC,OKC,MEM,6.0,Rebounds,44,39,35,14
22023,1628983,22300355,"DEC 18, 2023",OKC vs. MEM,W,28,8,18,0.444,1,3,0.333,13,14,0.929,0,9,9,5,4,0,2,4,30,30,1,Shai Gilgeous-Alexander,OKC,OKC,MEM,42.5,Pts+Rebs+Asts,44,39,35,14
22023,1628983,22300355,"DEC 18, 2023",OKC vs. MEM,W,28,8,18,0.444,1,3,0.333,13,14,0.929,0,9,9,5,4,0,2,4,30,30,1,Shai Gilgeous-Alexander,OKC,OKC,MEM,6.0,Assists,44,39,35,14
22023,1628983,22300355,"DEC 18, 2023",OKC vs. MEM,W,28,8,18,0.444,1,3,0.333,13,14,0.929,0,9,9,5,4,0,2,4,30,30,1,Shai Gilgeous-Alexander,OKC,OKC,MEM,51.5,Fantasy Score,44,39,35,14
22023,1628983,22300355,"DEC 18, 2023",OKC vs. MEM,W,28,8,18,0.444,1,3,0.333,13,14,0.929,0,9,9,5,4,0,2,4,30,30,1,Shai Gilgeous-Alexander,OKC,OKC,MEM,4.0,3-PT Attempted,44,39,35,14
22023,1628983,22300355,"DEC 18, 2023",OKC vs. MEM,W,28,8,18,0.444,1,3,0.333,13,14,0.929,0,9,9,5,4,0,2,4,30,30,1,Shai Gilgeous-Alexander,OKC,OKC,MEM,7.5,Free Throws Made,44,39,35,14
22023,1628983,22300355,"DEC 18, 2023",OKC vs. MEM,W,28,8,18,0.444,1,3,0.333,13,14,0.929,0,9,9,5,4,0,2,4,30,30,1,Shai Gilgeous-Alexander,OKC,OKC,MEM,20.5,FG Attempted,44,39,35,14
22023,1628983,22300355,"DEC 18, 2023",OKC vs. MEM,W,28,8,18,0.444,1,3,0.333,13,14,0.929,0,9,9,5,4,0,2,4,30,30,1,Shai Gilgeous-Alexander,OKC,OKC,MEM,36.5,Pts+Rebs,44,39,35,14
22023,1628983,22300355,"DEC 18, 2023",OKC vs. MEM,W,28,8,18,0.444,1,3,0.333,13,14,0.929,0,9,9,5,4,0,2,4,30,30,1,Shai Gilgeous-Alexander,OKC,OKC,MEM,0.5,Dunks,44,39,35,14
22023,1628983,22300355,"DEC 18, 2023",OKC vs. MEM,W,28,8,18,0.444,1,3,0.333,13,14,0.929,0,9,9,5,4,0,2,4,30,30,1,Shai Gilgeous-Alexander,OKC,OKC,MEM,36.5,Pts+Asts,44,39,35,14
22023,1628983,22300355,"DEC 18, 2023",OKC vs. MEM,W,28,8,18,0.444,1,3,0.333,13,14,0.929,0,9,9,5,4,0,2,4,30,30,1,Shai Gilgeous-Alexander,OKC,OKC,MEM,1.5,Steals,44,39,35,14
22023,1628983,22300355,"DEC 18, 2023",OKC vs. MEM,W,28,8,18,0.444,1,3,0.333,13,14,0.929,0,9,9,5,4,0,2,4,30,30,1,Shai Gilgeous-Alexander,OKC,OKC,MEM,12.0,Rebs+Asts,44,39,35,14
22023,1628983,22300340,"DEC 16, 2023",OKC @ DEN,W,37,9,20,0.45,0,2,0.0,7,8,0.875,0,6,6,8,2,0,2,1,25,3,1,Shai Gilgeous-Alexander,OKC,DEN,OKC,31.0,Points,39,31,33,14
22023,1628983,22300340,"DEC 16, 2023",OKC @ DEN,W,37,9,20,0.45,0,2,0.0,7,8,0.875,0,6,6,8,2,0,2,1,25,3,1,Shai Gilgeous-Alexander,OKC,DEN,OKC,31.0,Points,39,31,33,14
22023,1628983,22300340,"DEC 16, 2023",OKC @ DEN,W,37,9,20,0.45,0,2,0.0,7,8,0.875,0,6,6,8,2,0,2,1,25,3,1,Shai Gilgeous-Alexander,OKC,DEN,OKC,6.0,Rebounds,39,31,33,14
22023,1628983,22300340,"DEC 16, 2023",OKC @ DEN,W,37,9,20,0.45,0,2,0.0,7,8,0.875,0,6,6,8,2,0,2,1,25,3,1,Shai Gilgeous-Alexander,OKC,DEN,OKC,42.5,Pts+Rebs+Asts,39,31,33,14
22023,1628983,22300340,"DEC 16, 2023",OKC @ DEN,W,37,9,20,0.45,0,2,0.0,7,8,0.875,0,6,6,8,2,0,2,1,25,3,1,Shai Gilgeous-Alexander,OKC,DEN,OKC,6.0,Assists,39,31,33,14
22023,1628983,22300340,"DEC 16, 2023",OKC @ DEN,W,37,9,20,0.45,0,2,0.0,7,8,0.875,0,6,6,8,2,0,2,1,25,3,1,Shai Gilgeous-Alexander,OKC,DEN,OKC,51.5,Fantasy Score,39,31,33,14
22023,1628983,22300340,"DEC 16, 2023",OKC @ DEN,W,37,9,20,0.45,0,2,0.0,7,8,0.875,0,6,6,8,2,0,2,1,25,3,1,Shai Gilgeous-Alexander,OKC,DEN,OKC,4.0,3-PT Attempted,39,31,33,14
22023,1628983,22300340,"DEC 16, 2023",OKC @ DEN,W,37,9,20,0.45,0,2,0.0,7,8,0.875,0,6,6,8,2,0,2,1,25,3,1,Shai Gilgeous-Alexander,OKC,DEN,OKC,7.5,Free Throws Made,39,31,33,14
22023,1628983,22300340,"DEC 16, 2023",OKC @ DEN,W,37,9,20,0.45,0,2,0.0,7,8,0.875,0,6,6,8,2,0,2,1,25,3,1,Shai Gilgeous-Alexander,OKC,DEN,OKC,20.5,FG Attempted,39,31,33,14
22023,1628983,22300340,"DEC 16, 2023",OKC @ DEN,W,37,9,20,0.45,0,2,0.0,7,8,0.875,0,6,6,8,2,0,2,1,25,3,1,Shai Gilgeous-Alexander,OKC,DEN,OKC,36.5,Pts+Rebs,39,31,33,14
22023,1628983,22300340,"DEC 16, 2023",OKC @ DEN,W,37,9,20,0.45,0,2,0.0,7,8,0.875,0,6,6,8,2,0,2,1,25,3,1,Shai Gilgeous-Alexander,OKC,DEN,OKC,0.5,Dunks,39,31,33,14
22023,1628983,22300340,"DEC 16, 2023",OKC @ DEN,W,37,9,20,0.45,0,2,0.0,7,8,0.875,0,6,6,8,2,0,2,1,25,3,1,Shai Gilgeous-Alexander,OKC,DEN,OKC,36.5,Pts+Asts,39,31,33,14
22023,1628983,22300340,"DEC 16, 2023",OKC @ DEN,W,37,9,20,0.45,0,2,0.0,7,8,0.875,0,6,6,8,2,0,2,1,25,3,1,Shai Gilgeous-Alexander,OKC,DEN,OKC,1.5,Steals,39,31,33,14
22023,1628983,22300340,"DEC 16, 2023",OKC @ DEN,W,37,9,20,0.45,0,2,0.0,7,8,0.875,0,6,6,8,2,0,2,1,25,3,1,Shai Gilgeous-Alexander,OKC,DEN,OKC,12.0,Rebs+Asts,39,31,33,14
22023,1628983,22300324,"DEC 14, 2023",OKC @ SAC,L,38,13,27,0.481,1,5,0.2,16,18,0.889,2,4,6,9,2,0,3,2,43,3,1,Shai Gilgeous-Alexander,OKC,SAC,OKC,31.0,Points,58,49,52,15
22023,1628983,22300324,"DEC 14, 2023",OKC @ SAC,L,38,13,27,0.481,1,5,0.2,16,18,0.889,2,4,6,9,2,0,3,2,43,3,1,Shai Gilgeous-Alexander,OKC,SAC,OKC,31.0,Points,58,49,52,15
22023,1628983,22300324,"DEC 14, 2023",OKC @ SAC,L,38,13,27,0.481,1,5,0.2,16,18,0.889,2,4,6,9,2,0,3,2,43,3,1,Shai Gilgeous-Alexander,OKC,SAC,OKC,6.0,Rebounds,58,49,52,15
22023,1628983,22300324,"DEC 14, 2023",OKC @ SAC,L,38,13,27,0.481,1,5,0.2,16,18,0.889,2,4,6,9,2,0,3,2,43,3,1,Shai Gilgeous-Alexander,OKC,SAC,OKC,42.5,Pts+Rebs+Asts,58,49,52,15
22023,1628983,22300324,"DEC 14, 2023",OKC @ SAC,L,38,13,27,0.481,1,5,0.2,16,18,0.889,2,4,6,9,2,0,3,2,43,3,1,Shai Gilgeous-Alexander,OKC,SAC,OKC,6.0,Assists,58,49,52,15
22023,1628983,22300324,"DEC 14, 2023",OKC @ SAC,L,38,13,27,0.481,1,5,0.2,16,18,0.889,2,4,6,9,2,0,3,2,43,3,1,Shai Gilgeous-Alexander,OKC,SAC,OKC,51.5,Fantasy Score,58,49,52,15
22023,1628983,22300324,"DEC 14, 2023",OKC @ SAC,L,38,13,27,0.481,1,5,0.2,16,18,0.889,2,4,6,9,2,0,3,2,43,3,1,Shai Gilgeous-Alexander,OKC,SAC,OKC,4.0,3-PT Attempted,58,49,52,15
22023,1628983,22300324,"DEC 14, 2023",OKC @ SAC,L,38,13,27,0.481,1,5,0.2,16,18,0.889,2,4,6,9,2,0,3,2,43,3,1,Shai Gilgeous-Alexander,OKC,SAC,OKC,7.5,Free Throws Made,58,49,52,15
22023,1628983,22300324,"DEC 14, 2023",OKC @ SAC,L,38,13,27,0.481,1,5,0.2,16,18,0.889,2,4,6,9,2,0,3,2,43,3,1,Shai Gilgeous-Alexander,OKC,SAC,OKC,20.5,FG Attempted,58,49,52,15
22023,1628983,22300324,"DEC 14, 2023",OKC @ SAC,L,38,13,27,0.481,1,5,0.2,16,18,0.889,2,4,6,9,2,0,3,2,43,3,1,Shai Gilgeous-Alexander,OKC,SAC,OKC,36.5,Pts+Rebs,58,49,52,15
22023,1628983,22300324,"DEC 14, 2023",OKC @ SAC,L,38,13,27,0.481,1,5,0.2,16,18,0.889,2,4,6,9,2,0,3,2,43,3,1,Shai Gilgeous-Alexander,OKC,SAC,OKC,0.5,Dunks,58,49,52,15
22023,1628983,22300324,"DEC 14, 2023",OKC @ SAC,L,38,13,27,0.481,1,5,0.2,16,18,0.889,2,4,6,9,2,0,3,2,43,3,1,Shai Gilgeous-Alexander,OKC,SAC,OKC,36.5,Pts+Asts,58,49,52,15
22023,1628983,22300324,"DEC 14, 2023",OKC @ SAC,L,38,13,27,0.481,1,5,0.2,16,18,0.889,2,4,6,9,2,0,3,2,43,3,1,Shai Gilgeous-Alexander,OKC,SAC,OKC,1.5,Steals,58,49,52,15
22023,1628983,22300324,"DEC 14, 2023",OKC @ SAC,L,38,13,27,0.481,1,5,0.2,16,18,0.889,2,4,6,9,2,0,3,2,43,3,1,Shai Gilgeous-Alexander,OKC,SAC,OKC,12.0,Rebs+Asts,58,49,52,15
22023,1628983,22300302,"DEC 11, 2023",OKC vs. UTA,W,28,12,17,0.706,0,1,0.0,6,6,1.0,1,3,4,7,3,0,1,1,30,35,1,Shai Gilgeous-Alexander,OKC,OKC,UTA,31.0,Points,41,34,37,11
22023,1628983,22300302,"DEC 11, 2023",OKC vs. UTA,W,28,12,17,0.706,0,1,0.0,6,6,1.0,1,3,4,7,3,0,1,1,30,35,1,Shai Gilgeous-Alexander,OKC,OKC,UTA,31.0,Points,41,34,37,11
22023,1628983,22300302,"DEC 11, 2023",OKC vs. UTA,W,28,12,17,0.706,0,1,0.0,6,6,1.0,1,3,4,7,3,0,1,1,30,35,1,Shai Gilgeous-Alexander,OKC,OKC,UTA,6.0,Rebounds,41,34,37,11
22023,1628983,22300302,"DEC 11, 2023",OKC vs. UTA,W,28,12,17,0.706,0,1,0.0,6,6,1.0,1,3,4,7,3,0,1,1,30,35,1,Shai Gilgeous-Alexander,OKC,OKC,UTA,42.5,Pts+Rebs+Asts,41,34,37,11
22023,1628983,22300302,"DEC 11, 2023",OKC vs. UTA,W,28,12,17,0.706,0,1,0.0,6,6,1.0,1,3,4,7,3,0,1,1,30,35,1,Shai Gilgeous-Alexander,OKC,OKC,UTA,6.0,Assists,41,34,37,11
22023,1628983,22300302,"DEC 11, 2023",OKC vs. UTA,W,28,12,17,0.706,0,1,0.0,6,6,1.0,1,3,4,7,3,0,1,1,30,35,1,Shai Gilgeous-Alexander,OKC,OKC,UTA,51.5,Fantasy Score,41,34,37,11
22023,1628983,22300302,"DEC 11, 2023",OKC vs. UTA,W,28,12,17,0.706,0,1,0.0,6,6,1.0,1,3,4,7,3,0,1,1,30,35,1,Shai Gilgeous-Alexander,OKC,OKC,UTA,4.0,3-PT Attempted,41,34,37,11
22023,1628983,22300302,"DEC 11, 2023",OKC vs. UTA,W,28,12,17,0.706,0,1,0.0,6,6,1.0,1,3,4,7,3,0,1,1,30,35,1,Shai Gilgeous-Alexander,OKC,OKC,UTA,7.5,Free Throws Made,41,34,37,11
22023,1628983,22300302,"DEC 11, 2023",OKC vs. UTA,W,28,12,17,0.706,0,1,0.0,6,6,1.0,1,3,4,7,3,0,1,1,30,35,1,Shai Gilgeous-Alexander,OKC,OKC,UTA,20.5,FG Attempted,41,34,37,11
22023,1628983,22300302,"DEC 11, 2023",OKC vs. UTA,W,28,12,17,0.706,0,1,0.0,6,6,1.0,1,3,4,7,3,0,1,1,30,35,1,Shai Gilgeous-Alexander,OKC,OKC,UTA,36.5,Pts+Rebs,41,34,37,11
22023,1628983,22300302,"DEC 11, 2023",OKC vs. UTA,W,28,12,17,0.706,0,1,0.0,6,6,1.0,1,3,4,7,3,0,1,1,30,35,1,Shai Gilgeous-Alexander,OKC,OKC,UTA,0.5,Dunks,41,34,37,11
22023,1628983,22300302,"DEC 11, 2023",OKC vs. UTA,W,28,12,17,0.706,0,1,0.0,6,6,1.0,1,3,4,7,3,0,1,1,30,35,1,Shai Gilgeous-Alexander,OKC,OKC,UTA,36.5,Pts+Asts,41,34,37,11
22023,1628983,22300302,"DEC 11, 2023",OKC vs. UTA,W,28,12,17,0.706,0,1,0.0,6,6,1.0,1,3,4,7,3,0,1,1,30,35,1,Shai Gilgeous-Alexander,OKC,OKC,UTA,1.5,Steals,41,34,37,11
22023,1628983,22300302,"DEC 11, 2023",OKC vs. UTA,W,28,12,17,0.706,0,1,0.0,6,6,1.0,1,3,4,7,3,0,1,1,30,35,1,Shai Gilgeous-Alexander,OKC,OKC,UTA,12.0,Rebs+Asts,41,34,37,11
22023,1628983,22301222,"DEC 08, 2023",OKC vs. GSW,W,42,15,30,0.5,0,3,0.0,8,11,0.727,3,2,5,5,5,1,0,4,38,11,1,Shai Gilgeous-Alexander,OKC,OKC,GSW,31.0,Points,48,43,43,10
22023,1628983,22301222,"DEC 08, 2023",OKC vs. GSW,W,42,15,30,0.5,0,3,0.0,8,11,0.727,3,2,5,5,5,1,0,4,38,11,1,Shai Gilgeous-Alexander,OKC,OKC,GSW,31.0,Points,48,43,43,10
22023,1628983,22301222,"DEC 08, 2023",OKC vs. GSW,W,42,15,30,0.5,0,3,0.0,8,11,0.727,3,2,5,5,5,1,0,4,38,11,1,Shai Gilgeous-Alexander,OKC,OKC,GSW,6.0,Rebounds,48,43,43,10
22023,1628983,22301222,"DEC 08, 2023",OKC vs. GSW,W,42,15,30,0.5,0,3,0.0,8,11,0.727,3,2,5,5,5,1,0,4,38,11,1,Shai Gilgeous-Alexander,OKC,OKC,GSW,42.5,Pts+Rebs+Asts,48,43,43,10
22023,1628983,22301222,"DEC 08, 2023",OKC vs. GSW,W,42,15,30,0.5,0,3,0.0,8,11,0.727,3,2,5,5,5,1,0,4,38,11,1,Shai Gilgeous-Alexander,OKC,OKC,GSW,6.0,Assists,48,43,43,10
22023,1628983,22301222,"DEC 08, 2023",OKC vs. GSW,W,42,15,30,0.5,0,3,0.0,8,11,0.727,3,2,5,5,5,1,0,4,38,11,1,Shai Gilgeous-Alexander,OKC,OKC,GSW,51.5,Fantasy Score,48,43,43,10
22023,1628983,22301222,"DEC 08, 2023",OKC vs. GSW,W,42,15,30,0.5,0,3,0.0,8,11,0.727,3,2,5,5,5,1,0,4,38,11,1,Shai Gilgeous-Alexander,OKC,OKC,GSW,4.0,3-PT Attempted,48,43,43,10
22023,1628983,22301222,"DEC 08, 2023",OKC vs. GSW,W,42,15,30,0.5,0,3,0.0,8,11,0.727,3,2,5,5,5,1,0,4,38,11,1,Shai Gilgeous-Alexander,OKC,OKC,GSW,7.5,Free Throws Made,48,43,43,10
22023,1628983,22301222,"DEC 08, 2023",OKC vs. GSW,W,42,15,30,0.5,0,3,0.0,8,11,0.727,3,2,5,5,5,1,0,4,38,11,1,Shai Gilgeous-Alexander,OKC,OKC,GSW,20.5,FG Attempted,48,43,43,10
22023,1628983,22301222,"DEC 08, 2023",OKC vs. GSW,W,42,15,30,0.5,0,3,0.0,8,11,0.727,3,2,5,5,5,1,0,4,38,11,1,Shai Gilgeous-Alexander,OKC,OKC,GSW,36.5,Pts+Rebs,48,43,43,10
22023,1628983,22301222,"DEC 08, 2023",OKC vs. GSW,W,42,15,30,0.5,0,3,0.0,8,11,0.727,3,2,5,5,5,1,0,4,38,11,1,Shai Gilgeous-Alexander,OKC,OKC,GSW,0.5,Dunks,48,43,43,10
22023,1628983,22301222,"DEC 08, 2023",OKC vs. GSW,W,42,15,30,0.5,0,3,0.0,8,11,0.727,3,2,5,5,5,1,0,4,38,11,1,Shai Gilgeous-Alexander,OKC,OKC,GSW,36.5,Pts+Asts,48,43,43,10
22023,1628983,22301222,"DEC 08, 2023",OKC vs. GSW,W,42,15,30,0.5,0,3,0.0,8,11,0.727,3,2,5,5,5,1,0,4,38,11,1,Shai Gilgeous-Alexander,OKC,OKC,GSW,1.5,Steals,48,43,43,10
22023,1628983,22301222,"DEC 08, 2023",OKC vs. GSW,W,42,15,30,0.5,0,3,0.0,8,11,0.727,3,2,5,5,5,1,0,4,38,11,1,Shai Gilgeous-Alexander,OKC,OKC,GSW,12.0,Rebs+Asts,48,43,43,10
22023,1628983,22301212,"DEC 06, 2023",OKC @ HOU,L,37,13,18,0.722,0,0,0.0,7,9,0.778,0,3,3,6,6,1,2,4,33,-6,1,Shai Gilgeous-Alexander,OKC,HOU,OKC,31.0,Points,42,36,39,9
22023,1628983,22301212,"DEC 06, 2023",OKC @ HOU,L,37,13,18,0.722,0,0,0.0,7,9,0.778,0,3,3,6,6,1,2,4,33,-6,1,Shai Gilgeous-Alexander,OKC,HOU,OKC,31.0,Points,42,36,39,9
22023,1628983,22301212,"DEC 06, 2023",OKC @ HOU,L,37,13,18,0.722,0,0,0.0,7,9,0.778,0,3,3,6,6,1,2,4,33,-6,1,Shai Gilgeous-Alexander,OKC,HOU,OKC,6.0,Rebounds,42,36,39,9
22023,1628983,22301212,"DEC 06, 2023",OKC @ HOU,L,37,13,18,0.722,0,0,0.0,7,9,0.778,0,3,3,6,6,1,2,4,33,-6,1,Shai Gilgeous-Alexander,OKC,HOU,OKC,42.5,Pts+Rebs+Asts,42,36,39,9
22023,1628983,22301212,"DEC 06, 2023",OKC @ HOU,L,37,13,18,0.722,0,0,0.0,7,9,0.778,0,3,3,6,6,1,2,4,33,-6,1,Shai Gilgeous-Alexander,OKC,HOU,OKC,6.0,Assists,42,36,39,9
22023,1628983,22301212,"DEC 06, 2023",OKC @ HOU,L,37,13,18,0.722,0,0,0.0,7,9,0.778,0,3,3,6,6,1,2,4,33,-6,1,Shai Gilgeous-Alexander,OKC,HOU,OKC,51.5,Fantasy Score,42,36,39,9
22023,1628983,22301212,"DEC 06, 2023",OKC @ HOU,L,37,13,18,0.722,0,0,0.0,7,9,0.778,0,3,3,6,6,1,2,4,33,-6,1,Shai Gilgeous-Alexander,OKC,HOU,OKC,4.0,3-PT Attempted,42,36,39,9
22023,1628983,22301212,"DEC 06, 2023",OKC @ HOU,L,37,13,18,0.722,0,0,0.0,7,9,0.778,0,3,3,6,6,1,2,4,33,-6,1,Shai Gilgeous-Alexander,OKC,HOU,OKC,7.5,Free Throws Made,42,36,39,9
22023,1628983,22301212,"DEC 06, 2023",OKC @ HOU,L,37,13,18,0.722,0,0,0.0,7,9,0.778,0,3,3,6,6,1,2,4,33,-6,1,Shai Gilgeous-Alexander,OKC,HOU,OKC,20.5,FG Attempted,42,36,39,9
22023,1628983,22301212,"DEC 06, 2023",OKC @ HOU,L,37,13,18,0.722,0,0,0.0,7,9,0.778,0,3,3,6,6,1,2,4,33,-6,1,Shai Gilgeous-Alexander,OKC,HOU,OKC,36.5,Pts+Rebs,42,36,39,9
22023,1628983,22301212,"DEC 06, 2023",OKC @ HOU,L,37,13,18,0.722,0,0,0.0,7,9,0.778,0,3,3,6,6,1,2,4,33,-6,1,Shai Gilgeous-Alexander,OKC,HOU,OKC,0.5,Dunks,42,36,39,9
22023,1628983,22301212,"DEC 06, 2023",OKC @ HOU,L,37,13,18,0.722,0,0,0.0,7,9,0.778,0,3,3,6,6,1,2,4,33,-6,1,Shai Gilgeous-Alexander,OKC,HOU,OKC,36.5,Pts+Asts,42,36,39,9
22023,1628983,22301212,"DEC 06, 2023",OKC @ HOU,L,37,13,18,0.722,0,0,0.0,7,9,0.778,0,3,3,6,6,1,2,4,33,-6,1,Shai Gilgeous-Alexander,OKC,HOU,OKC,1.5,Steals,42,36,39,9
22023,1628983,22301212,"DEC 06, 2023",OKC @ HOU,L,37,13,18,0.722,0,0,0.0,7,9,0.778,0,3,3,6,6,1,2,4,33,-6,1,Shai Gilgeous-Alexander,OKC,HOU,OKC,12.0,Rebs+Asts,42,36,39,9
22023,1628983,22300287,"DEC 02, 2023",OKC @ DAL,W,39,6,13,0.462,2,3,0.667,3,4,0.75,1,2,3,9,5,1,2,4,17,8,1,Shai Gilgeous-Alexander,OKC,DAL,OKC,31.0,Points,29,20,26,12
22023,1628983,22300287,"DEC 02, 2023",OKC @ DAL,W,39,6,13,0.462,2,3,0.667,3,4,0.75,1,2,3,9,5,1,2,4,17,8,1,Shai Gilgeous-Alexander,OKC,DAL,OKC,31.0,Points,29,20,26,12
22023,1628983,22300287,"DEC 02, 2023",OKC @ DAL,W,39,6,13,0.462,2,3,0.667,3,4,0.75,1,2,3,9,5,1,2,4,17,8,1,Shai Gilgeous-Alexander,OKC,DAL,OKC,6.0,Rebounds,29,20,26,12
22023,1628983,22300287,"DEC 02, 2023",OKC @ DAL,W,39,6,13,0.462,2,3,0.667,3,4,0.75,1,2,3,9,5,1,2,4,17,8,1,Shai Gilgeous-Alexander,OKC,DAL,OKC,42.5,Pts+Rebs+Asts,29,20,26,12
22023,1628983,22300287,"DEC 02, 2023",OKC @ DAL,W,39,6,13,0.462,2,3,0.667,3,4,0.75,1,2,3,9,5,1,2,4,17,8,1,Shai Gilgeous-Alexander,OKC,DAL,OKC,6.0,Assists,29,20,26,12
22023,1628983,22300287,"DEC 02, 2023",OKC @ DAL,W,39,6,13,0.462,2,3,0.667,3,4,0.75,1,2,3,9,5,1,2,4,17,8,1,Shai Gilgeous-Alexander,OKC,DAL,OKC,51.5,Fantasy Score,29,20,26,12
22023,1628983,22300287,"DEC 02, 2023",OKC @ DAL,W,39,6,13,0.462,2,3,0.667,3,4,0.75,1,2,3,9,5,1,2,4,17,8,1,Shai Gilgeous-Alexander,OKC,DAL,OKC,4.0,3-PT Attempted,29,20,26,12
22023,1628983,22300287,"DEC 02, 2023",OKC @ DAL,W,39,6,13,0.462,2,3,0.667,3,4,0.75,1,2,3,9,5,1,2,4,17,8,1,Shai Gilgeous-Alexander,OKC,DAL,OKC,7.5,Free Throws Made,29,20,26,12
22023,1628983,22300287,"DEC 02, 2023",OKC @ DAL,W,39,6,13,0.462,2,3,0.667,3,4,0.75,1,2,3,9,5,1,2,4,17,8,1,Shai Gilgeous-Alexander,OKC,DAL,OKC,20.5,FG Attempted,29,20,26,12
22023,1628983,22300287,"DEC 02, 2023",OKC @ DAL,W,39,6,13,0.462,2,3,0.667,3,4,0.75,1,2,3,9,5,1,2,4,17,8,1,Shai Gilgeous-Alexander,OKC,DAL,OKC,36.5,Pts+Rebs,29,20,26,12
22023,1628983,22300287,"DEC 02, 2023",OKC @ DAL,W,39,6,13,0.462,2,3,0.667,3,4,0.75,1,2,3,9,5,1,2,4,17,8,1,Shai Gilgeous-Alexander,OKC,DAL,OKC,0.5,Dunks,29,20,26,12
22023,1628983,22300287,"DEC 02, 2023",OKC @ DAL,W,39,6,13,0.462,2,3,0.667,3,4,0.75,1,2,3,9,5,1,2,4,17,8,1,Shai Gilgeous-Alexander,OKC,DAL,OKC,36.5,Pts+Asts,29,20,26,12
22023,1628983,22300287,"DEC 02, 2023",OKC @ DAL,W,39,6,13,0.462,2,3,0.667,3,4,0.75,1,2,3,9,5,1,2,4,17,8,1,Shai Gilgeous-Alexander,OKC,DAL,OKC,1.5,Steals,29,20,26,12
22023,1628983,22300287,"DEC 02, 2023",OKC @ DAL,W,39,6,13,0.462,2,3,0.667,3,4,0.75,1,2,3,9,5,1,2,4,17,8,1,Shai Gilgeous-Alexander,OKC,DAL,OKC,12.0,Rebs+Asts,29,20,26,12
22023,1628983,22300271,"NOV 30, 2023",OKC vs. LAL,W,35,11,18,0.611,1,4,0.25,10,10,1.0,0,4,4,7,1,0,0,4,33,15,1,Shai Gilgeous-Alexander,OKC,OKC,LAL,31.0,Points,44,37,40,11
22023,1628983,22300271,"NOV 30, 2023",OKC vs. LAL,W,35,11,18,0.611,1,4,0.25,10,10,1.0,0,4,4,7,1,0,0,4,33,15,1,Shai Gilgeous-Alexander,OKC,OKC,LAL,31.0,Points,44,37,40,11
22023,1628983,22300271,"NOV 30, 2023",OKC vs. LAL,W,35,11,18,0.611,1,4,0.25,10,10,1.0,0,4,4,7,1,0,0,4,33,15,1,Shai Gilgeous-Alexander,OKC,OKC,LAL,6.0,Rebounds,44,37,40,11
22023,1628983,22300271,"NOV 30, 2023",OKC vs. LAL,W,35,11,18,0.611,1,4,0.25,10,10,1.0,0,4,4,7,1,0,0,4,33,15,1,Shai Gilgeous-Alexander,OKC,OKC,LAL,42.5,Pts+Rebs+Asts,44,37,40,11
22023,1628983,22300271,"NOV 30, 2023",OKC vs. LAL,W,35,11,18,0.611,1,4,0.25,10,10,1.0,0,4,4,7,1,0,0,4,33,15,1,Shai Gilgeous-Alexander,OKC,OKC,LAL,6.0,Assists,44,37,40,11
22023,1628983,22300271,"NOV 30, 2023",OKC vs. LAL,W,35,11,18,0.611,1,4,0.25,10,10,1.0,0,4,4,7,1,0,0,4,33,15,1,Shai Gilgeous-Alexander,OKC,OKC,LAL,51.5,Fantasy Score,44,37,40,11
22023,1628983,22300271,"NOV 30, 2023",OKC vs. LAL,W,35,11,18,0.611,1,4,0.25,10,10,1.0,0,4,4,7,1,0,0,4,33,15,1,Shai Gilgeous-Alexander,OKC,OKC,LAL,4.0,3-PT Attempted,44,37,40,11
22023,1628983,22300271,"NOV 30, 2023",OKC vs. LAL,W,35,11,18,0.611,1,4,0.25,10,10,1.0,0,4,4,7,1,0,0,4,33,15,1,Shai Gilgeous-Alexander,OKC,OKC,LAL,7.5,Free Throws Made,44,37,40,11
22023,1628983,22300271,"NOV 30, 2023",OKC vs. LAL,W,35,11,18,0.611,1,4,0.25,10,10,1.0,0,4,4,7,1,0,0,4,33,15,1,Shai Gilgeous-Alexander,OKC,OKC,LAL,20.5,FG Attempted,44,37,40,11
22023,1628983,22300271,"NOV 30, 2023",OKC vs. LAL,W,35,11,18,0.611,1,4,0.25,10,10,1.0,0,4,4,7,1,0,0,4,33,15,1,Shai Gilgeous-Alexander,OKC,OKC,LAL,36.5,Pts+Rebs,44,37,40,11
22023,1628983,22300271,"NOV 30, 2023",OKC vs. LAL,W,35,11,18,0.611,1,4,0.25,10,10,1.0,0,4,4,7,1,0,0,4,33,15,1,Shai Gilgeous-Alexander,OKC,OKC,LAL,0.5,Dunks,44,37,40,11
22023,1628983,22300271,"NOV 30, 2023",OKC vs. LAL,W,35,11,18,0.611,1,4,0.25,10,10,1.0,0,4,4,7,1,0,0,4,33,15,1,Shai Gilgeous-Alexander,OKC,OKC,LAL,36.5,Pts+Asts,44,37,40,11
22023,1628983,22300271,"NOV 30, 2023",OKC vs. LAL,W,35,11,18,0.611,1,4,0.25,10,10,1.0,0,4,4,7,1,0,0,4,33,15,1,Shai Gilgeous-Alexander,OKC,OKC,LAL,1.5,Steals,44,37,40,11
22023,1628983,22300271,"NOV 30, 2023",OKC vs. LAL,W,35,11,18,0.611,1,4,0.25,10,10,1.0,0,4,4,7,1,0,0,4,33,15,1,Shai Gilgeous-Alexander,OKC,OKC,LAL,12.0,Rebs+Asts,44,37,40,11
22023,1628983,22300058,"NOV 28, 2023",OKC @ MIN,L,34,13,22,0.591,0,1,0.0,6,6,1.0,1,3,4,4,3,2,3,2,32,4,1,Shai Gilgeous-Alexander,OKC,MIN,OKC,31.0,Points,40,36,36,8
22023,1628983,22300058,"NOV 28, 2023",OKC @ MIN,L,34,13,22,0.591,0,1,0.0,6,6,1.0,1,3,4,4,3,2,3,2,32,4,1,Shai Gilgeous-Alexander,OKC,MIN,OKC,31.0,Points,40,36,36,8
22023,1628983,22300058,"NOV 28, 2023",OKC @ MIN,L,34,13,22,0.591,0,1,0.0,6,6,1.0,1,3,4,4,3,2,3,2,32,4,1,Shai Gilgeous-Alexander,OKC,MIN,OKC,6.0,Rebounds,40,36,36,8
22023,1628983,22300058,"NOV 28, 2023",OKC @ MIN,L,34,13,22,0.591,0,1,0.0,6,6,1.0,1,3,4,4,3,2,3,2,32,4,1,Shai Gilgeous-Alexander,OKC,MIN,OKC,42.5,Pts+Rebs+Asts,40,36,36,8
22023,1628983,22300058,"NOV 28, 2023",OKC @ MIN,L,34,13,22,0.591,0,1,0.0,6,6,1.0,1,3,4,4,3,2,3,2,32,4,1,Shai Gilgeous-Alexander,OKC,MIN,OKC,6.0,Assists,40,36,36,8
22023,1628983,22300058,"NOV 28, 2023",OKC @ MIN,L,34,13,22,0.591,0,1,0.0,6,6,1.0,1,3,4,4,3,2,3,2,32,4,1,Shai Gilgeous-Alexander,OKC,MIN,OKC,51.5,Fantasy Score,40,36,36,8
22023,1628983,22300058,"NOV 28, 2023",OKC @ MIN,L,34,13,22,0.591,0,1,0.0,6,6,1.0,1,3,4,4,3,2,3,2,32,4,1,Shai Gilgeous-Alexander,OKC,MIN,OKC,4.0,3-PT Attempted,40,36,36,8
22023,1628983,22300058,"NOV 28, 2023",OKC @ MIN,L,34,13,22,0.591,0,1,0.0,6,6,1.0,1,3,4,4,3,2,3,2,32,4,1,Shai Gilgeous-Alexander,OKC,MIN,OKC,7.5,Free Throws Made,40,36,36,8
22023,1628983,22300058,"NOV 28, 2023",OKC @ MIN,L,34,13,22,0.591,0,1,0.0,6,6,1.0,1,3,4,4,3,2,3,2,32,4,1,Shai Gilgeous-Alexander,OKC,MIN,OKC,20.5,FG Attempted,40,36,36,8
22023,1628983,22300058,"NOV 28, 2023",OKC @ MIN,L,34,13,22,0.591,0,1,0.0,6,6,1.0,1,3,4,4,3,2,3,2,32,4,1,Shai Gilgeous-Alexander,OKC,MIN,OKC,36.5,Pts+Rebs,40,36,36,8
22023,1628983,22300058,"NOV 28, 2023",OKC @ MIN,L,34,13,22,0.591,0,1,0.0,6,6,1.0,1,3,4,4,3,2,3,2,32,4,1,Shai Gilgeous-Alexander,OKC,MIN,OKC,0.5,Dunks,40,36,36,8
22023,1628983,22300058,"NOV 28, 2023",OKC @ MIN,L,34,13,22,0.591,0,1,0.0,6,6,1.0,1,3,4,4,3,2,3,2,32,4,1,Shai Gilgeous-Alexander,OKC,MIN,OKC,36.5,Pts+Asts,40,36,36,8
22023,1628983,22300058,"NOV 28, 2023",OKC @ MIN,L,34,13,22,0.591,0,1,0.0,6,6,1.0,1,3,4,4,3,2,3,2,32,4,1,Shai Gilgeous-Alexander,OKC,MIN,OKC,1.5,Steals,40,36,36,8
22023,1628983,22300058,"NOV 28, 2023",OKC @ MIN,L,34,13,22,0.591,0,1,0.0,6,6,1.0,1,3,4,4,3,2,3,2,32,4,1,Shai Gilgeous-Alexander,OKC,MIN,OKC,12.0,Rebs+Asts,40,36,36,8
22023,1628983,22300239,"NOV 25, 2023",OKC vs. PHI,L,36,10,21,0.476,1,2,0.5,10,10,1.0,3,3,6,5,2,0,1,3,31,1,1,Shai Gilgeous-Alexander,OKC,OKC,PHI,31.0,Points,42,37,36,11
22023,1628983,22300239,"NOV 25, 2023",OKC vs. PHI,L,36,10,21,0.476,1,2,0.5,10,10,1.0,3,3,6,5,2,0,1,3,31,1,1,Shai Gilgeous-Alexander,OKC,OKC,PHI,31.0,Points,42,37,36,11
22023,1628983,22300239,"NOV 25, 2023",OKC vs. PHI,L,36,10,21,0.476,1,2,0.5,10,10,1.0,3,3,6,5,2,0,1,3,31,1,1,Shai Gilgeous-Alexander,OKC,OKC,PHI,6.0,Rebounds,42,37,36,11
22023,1628983,22300239,"NOV 25, 2023",OKC vs. PHI,L,36,10,21,0.476,1,2,0.5,10,10,1.0,3,3,6,5,2,0,1,3,31,1,1,Shai Gilgeous-Alexander,OKC,OKC,PHI,42.5,Pts+Rebs+Asts,42,37,36,11
22023,1628983,22300239,"NOV 25, 2023",OKC vs. PHI,L,36,10,21,0.476,1,2,0.5,10,10,1.0,3,3,6,5,2,0,1,3,31,1,1,Shai Gilgeous-Alexander,OKC,OKC,PHI,6.0,Assists,42,37,36,11
22023,1628983,22300239,"NOV 25, 2023",OKC vs. PHI,L,36,10,21,0.476,1,2,0.5,10,10,1.0,3,3,6,5,2,0,1,3,31,1,1,Shai Gilgeous-Alexander,OKC,OKC,PHI,51.5,Fantasy Score,42,37,36,11
22023,1628983,22300239,"NOV 25, 2023",OKC vs. PHI,L,36,10,21,0.476,1,2,0.5,10,10,1.0,3,3,6,5,2,0,1,3,31,1,1,Shai Gilgeous-Alexander,OKC,OKC,PHI,4.0,3-PT Attempted,42,37,36,11
22023,1628983,22300239,"NOV 25, 2023",OKC vs. PHI,L,36,10,21,0.476,1,2,0.5,10,10,1.0,3,3,6,5,2,0,1,3,31,1,1,Shai Gilgeous-Alexander,OKC,OKC,PHI,7.5,Free Throws Made,42,37,36,11
22023,1628983,22300239,"NOV 25, 2023",OKC vs. PHI,L,36,10,21,0.476,1,2,0.5,10,10,1.0,3,3,6,5,2,0,1,3,31,1,1,Shai Gilgeous-Alexander,OKC,OKC,PHI,20.5,FG Attempted,42,37,36,11
22023,1628983,22300239,"NOV 25, 2023",OKC vs. PHI,L,36,10,21,0.476,1,2,0.5,10,10,1.0,3,3,6,5,2,0,1,3,31,1,1,Shai Gilgeous-Alexander,OKC,OKC,PHI,36.5,Pts+Rebs,42,37,36,11
22023,1628983,22300239,"NOV 25, 2023",OKC vs. PHI,L,36,10,21,0.476,1,2,0.5,10,10,1.0,3,3,6,5,2,0,1,3,31,1,1,Shai Gilgeous-Alexander,OKC,OKC,PHI,0.5,Dunks,42,37,36,11
22023,1628983,22300239,"NOV 25, 2023",OKC vs. PHI,L,36,10,21,0.476,1,2,0.5,10,10,1.0,3,3,6,5,2,0,1,3,31,1,1,Shai Gilgeous-Alexander,OKC,OKC,PHI,36.5,Pts+Asts,42,37,36,11
22023,1628983,22300239,"NOV 25, 2023",OKC vs. PHI,L,36,10,21,0.476,1,2,0.5,10,10,1.0,3,3,6,5,2,0,1,3,31,1,1,Shai Gilgeous-Alexander,OKC,OKC,PHI,1.5,Steals,42,37,36,11
22023,1628983,22300239,"NOV 25, 2023",OKC vs. PHI,L,36,10,21,0.476,1,2,0.5,10,10,1.0,3,3,6,5,2,0,1,3,31,1,1,Shai Gilgeous-Alexander,OKC,OKC,PHI,12.0,Rebs+Asts,42,37,36,11
22023,1628983,22300234,"NOV 22, 2023",OKC vs. CHI,W,37,11,19,0.579,1,3,0.333,17,18,0.944,1,4,5,12,1,3,2,2,40,16,1,Shai Gilgeous-Alexander,OKC,OKC,CHI,31.0,Points,57,45,52,17
22023,1628983,22300234,"NOV 22, 2023",OKC vs. CHI,W,37,11,19,0.579,1,3,0.333,17,18,0.944,1,4,5,12,1,3,2,2,40,16,1,Shai Gilgeous-Alexander,OKC,OKC,CHI,31.0,Points,57,45,52,17
22023,1628983,22300234,"NOV 22, 2023",OKC vs. CHI,W,37,11,19,0.579,1,3,0.333,17,18,0.944,1,4,5,12,1,3,2,2,40,16,1,Shai Gilgeous-Alexander,OKC,OKC,CHI,6.0,Rebounds,57,45,52,17
22023,1628983,22300234,"NOV 22, 2023",OKC vs. CHI,W,37,11,19,0.579,1,3,0.333,17,18,0.944,1,4,5,12,1,3,2,2,40,16,1,Shai Gilgeous-Alexander,OKC,OKC,CHI,42.5,Pts+Rebs+Asts,57,45,52,17
22023,1628983,22300234,"NOV 22, 2023",OKC vs. CHI,W,37,11,19,0.579,1,3,0.333,17,18,0.944,1,4,5,12,1,3,2,2,40,16,1,Shai Gilgeous-Alexander,OKC,OKC,CHI,6.0,Assists,57,45,52,17
22023,1628983,22300234,"NOV 22, 2023",OKC vs. CHI,W,37,11,19,0.579,1,3,0.333,17,18,0.944,1,4,5,12,1,3,2,2,40,16,1,Shai Gilgeous-Alexander,OKC,OKC,CHI,51.5,Fantasy Score,57,45,52,17
22023,1628983,22300234,"NOV 22, 2023",OKC vs. CHI,W,37,11,19,0.579,1,3,0.333,17,18,0.944,1,4,5,12,1,3,2,2,40,16,1,Shai Gilgeous-Alexander,OKC,OKC,CHI,4.0,3-PT Attempted,57,45,52,17
22023,1628983,22300234,"NOV 22, 2023",OKC vs. CHI,W,37,11,19,0.579,1,3,0.333,17,18,0.944,1,4,5,12,1,3,2,2,40,16,1,Shai Gilgeous-Alexander,OKC,OKC,CHI,7.5,Free Throws Made,57,45,52,17
22023,1628983,22300234,"NOV 22, 2023",OKC vs. CHI,W,37,11,19,0.579,1,3,0.333,17,18,0.944,1,4,5,12,1,3,2,2,40,16,1,Shai Gilgeous-Alexander,OKC,OKC,CHI,20.5,FG Attempted,57,45,52,17
22023,1628983,22300234,"NOV 22, 2023",OKC vs. CHI,W,37,11,19,0.579,1,3,0.333,17,18,0.944,1,4,5,12,1,3,2,2,40,16,1,Shai Gilgeous-Alexander,OKC,OKC,CHI,36.5,Pts+Rebs,57,45,52,17
22023,1628983,22300234,"NOV 22, 2023",OKC vs. CHI,W,37,11,19,0.579,1,3,0.333,17,18,0.944,1,4,5,12,1,3,2,2,40,16,1,Shai Gilgeous-Alexander,OKC,OKC,CHI,0.5,Dunks,57,45,52,17
22023,1628983,22300234,"NOV 22, 2023",OKC vs. CHI,W,37,11,19,0.579,1,3,0.333,17,18,0.944,1,4,5,12,1,3,2,2,40,16,1,Shai Gilgeous-Alexander,OKC,OKC,CHI,36.5,Pts+Asts,57,45,52,17
22023,1628983,22300234,"NOV 22, 2023",OKC vs. CHI,W,37,11,19,0.579,1,3,0.333,17,18,0.944,1,4,5,12,1,3,2,2,40,16,1,Shai Gilgeous-Alexander,OKC,OKC,CHI,1.5,Steals,57,45,52,17
22023,1628983,22300234,"NOV 22, 2023",OKC vs. CHI,W,37,11,19,0.579,1,3,0.333,17,18,0.944,1,4,5,12,1,3,2,2,40,16,1,Shai Gilgeous-Alexander,OKC,OKC,CHI,12.0,Rebs+Asts,57,45,52,17
22023,1628983,22300215,"NOV 19, 2023",OKC @ POR,W,23,10,13,0.769,1,1,1.0,7,7,1.0,0,3,3,4,1,0,3,2,28,26,1,Shai Gilgeous-Alexander,OKC,POR,OKC,31.0,Points,35,31,32,7
22023,1628983,22300215,"NOV 19, 2023",OKC @ POR,W,23,10,13,0.769,1,1,1.0,7,7,1.0,0,3,3,4,1,0,3,2,28,26,1,Shai Gilgeous-Alexander,OKC,POR,OKC,31.0,Points,35,31,32,7
22023,1628983,22300215,"NOV 19, 2023",OKC @ POR,W,23,10,13,0.769,1,1,1.0,7,7,1.0,0,3,3,4,1,0,3,2,28,26,1,Shai Gilgeous-Alexander,OKC,POR,OKC,6.0,Rebounds,35,31,32,7
22023,1628983,22300215,"NOV 19, 2023",OKC @ POR,W,23,10,13,0.769,1,1,1.0,7,7,1.0,0,3,3,4,1,0,3,2,28,26,1,Shai Gilgeous-Alexander,OKC,POR,OKC,42.5,Pts+Rebs+Asts,35,31,32,7
22023,1628983,22300215,"NOV 19, 2023",OKC @ POR,W,23,10,13,0.769,1,1,1.0,7,7,1.0,0,3,3,4,1,0,3,2,28,26,1,Shai Gilgeous-Alexander,OKC,POR,OKC,6.0,Assists,35,31,32,7
22023,1628983,22300215,"NOV 19, 2023",OKC @ POR,W,23,10,13,0.769,1,1,1.0,7,7,1.0,0,3,3,4,1,0,3,2,28,26,1,Shai Gilgeous-Alexander,OKC,POR,OKC,51.5,Fantasy Score,35,31,32,7
22023,1628983,22300215,"NOV 19, 2023",OKC @ POR,W,23,10,13,0.769,1,1,1.0,7,7,1.0,0,3,3,4,1,0,3,2,28,26,1,Shai Gilgeous-Alexander,OKC,POR,OKC,4.0,3-PT Attempted,35,31,32,7
22023,1628983,22300215,"NOV 19, 2023",OKC @ POR,W,23,10,13,0.769,1,1,1.0,7,7,1.0,0,3,3,4,1,0,3,2,28,26,1,Shai Gilgeous-Alexander,OKC,POR,OKC,7.5,Free Throws Made,35,31,32,7
22023,1628983,22300215,"NOV 19, 2023",OKC @ POR,W,23,10,13,0.769,1,1,1.0,7,7,1.0,0,3,3,4,1,0,3,2,28,26,1,Shai Gilgeous-Alexander,OKC,POR,OKC,20.5,FG Attempted,35,31,32,7
22023,1628983,22300215,"NOV 19, 2023",OKC @ POR,W,23,10,13,0.769,1,1,1.0,7,7,1.0,0,3,3,4,1,0,3,2,28,26,1,Shai Gilgeous-Alexander,OKC,POR,OKC,36.5,Pts+Rebs,35,31,32,7
22023,1628983,22300215,"NOV 19, 2023",OKC @ POR,W,23,10,13,0.769,1,1,1.0,7,7,1.0,0,3,3,4,1,0,3,2,28,26,1,Shai Gilgeous-Alexander,OKC,POR,OKC,0.5,Dunks,35,31,32,7
22023,1628983,22300215,"NOV 19, 2023",OKC @ POR,W,23,10,13,0.769,1,1,1.0,7,7,1.0,0,3,3,4,1,0,3,2,28,26,1,Shai Gilgeous-Alexander,OKC,POR,OKC,36.5,Pts+Asts,35,31,32,7
22023,1628983,22300215,"NOV 19, 2023",OKC @ POR,W,23,10,13,0.769,1,1,1.0,7,7,1.0,0,3,3,4,1,0,3,2,28,26,1,Shai Gilgeous-Alexander,OKC,POR,OKC,1.5,Steals,35,31,32,7
22023,1628983,22300215,"NOV 19, 2023",OKC @ POR,W,23,10,13,0.769,1,1,1.0,7,7,1.0,0,3,3,4,1,0,3,2,28,26,1,Shai Gilgeous-Alexander,OKC,POR,OKC,12.0,Rebs+Asts,35,31,32,7
22023,1628983,22300207,"NOV 18, 2023",OKC @ GSW,W,41,18,29,0.621,2,3,0.667,2,2,1.0,1,6,7,6,2,2,3,1,40,7,1,Shai Gilgeous-Alexander,OKC,GSW,OKC,31.0,Points,53,47,46,13
22023,1628983,22300207,"NOV 18, 2023",OKC @ GSW,W,41,18,29,0.621,2,3,0.667,2,2,1.0,1,6,7,6,2,2,3,1,40,7,1,Shai Gilgeous-Alexander,OKC,GSW,OKC,31.0,Points,53,47,46,13
22023,1628983,22300207,"NOV 18, 2023",OKC @ GSW,W,41,18,29,0.621,2,3,0.667,2,2,1.0,1,6,7,6,2,2,3,1,40,7,1,Shai Gilgeous-Alexander,OKC,GSW,OKC,6.0,Rebounds,53,47,46,13
22023,1628983,22300207,"NOV 18, 2023",OKC @ GSW,W,41,18,29,0.621,2,3,0.667,2,2,1.0,1,6,7,6,2,2,3,1,40,7,1,Shai Gilgeous-Alexander,OKC,GSW,OKC,42.5,Pts+Rebs+Asts,53,47,46,13
22023,1628983,22300207,"NOV 18, 2023",OKC @ GSW,W,41,18,29,0.621,2,3,0.667,2,2,1.0,1,6,7,6,2,2,3,1,40,7,1,Shai Gilgeous-Alexander,OKC,GSW,OKC,6.0,Assists,53,47,46,13
22023,1628983,22300207,"NOV 18, 2023",OKC @ GSW,W,41,18,29,0.621,2,3,0.667,2,2,1.0,1,6,7,6,2,2,3,1,40,7,1,Shai Gilgeous-Alexander,OKC,GSW,OKC,51.5,Fantasy Score,53,47,46,13
22023,1628983,22300207,"NOV 18, 2023",OKC @ GSW,W,41,18,29,0.621,2,3,0.667,2,2,1.0,1,6,7,6,2,2,3,1,40,7,1,Shai Gilgeous-Alexander,OKC,GSW,OKC,4.0,3-PT Attempted,53,47,46,13
22023,1628983,22300207,"NOV 18, 2023",OKC @ GSW,W,41,18,29,0.621,2,3,0.667,2,2,1.0,1,6,7,6,2,2,3,1,40,7,1,Shai Gilgeous-Alexander,OKC,GSW,OKC,7.5,Free Throws Made,53,47,46,13
22023,1628983,22300207,"NOV 18, 2023",OKC @ GSW,W,41,18,29,0.621,2,3,0.667,2,2,1.0,1,6,7,6,2,2,3,1,40,7,1,Shai Gilgeous-Alexander,OKC,GSW,OKC,20.5,FG Attempted,53,47,46,13
22023,1628983,22300207,"NOV 18, 2023",OKC @ GSW,W,41,18,29,0.621,2,3,0.667,2,2,1.0,1,6,7,6,2,2,3,1,40,7,1,Shai Gilgeous-Alexander,OKC,GSW,OKC,36.5,Pts+Rebs,53,47,46,13
22023,1628983,22300207,"NOV 18, 2023",OKC @ GSW,W,41,18,29,0.621,2,3,0.667,2,2,1.0,1,6,7,6,2,2,3,1,40,7,1,Shai Gilgeous-Alexander,OKC,GSW,OKC,0.5,Dunks,53,47,46,13
22023,1628983,22300207,"NOV 18, 2023",OKC @ GSW,W,41,18,29,0.621,2,3,0.667,2,2,1.0,1,6,7,6,2,2,3,1,40,7,1,Shai Gilgeous-Alexander,OKC,GSW,OKC,36.5,Pts+Asts,53,47,46,13
22023,1628983,22300207,"NOV 18, 2023",OKC @ GSW,W,41,18,29,0.621,2,3,0.667,2,2,1.0,1,6,7,6,2,2,3,1,40,7,1,Shai Gilgeous-Alexander,OKC,GSW,OKC,1.5,Steals,53,47,46,13
22023,1628983,22300207,"NOV 18, 2023",OKC @ GSW,W,41,18,29,0.621,2,3,0.667,2,2,1.0,1,6,7,6,2,2,3,1,40,7,1,Shai Gilgeous-Alexander,OKC,GSW,OKC,12.0,Rebs+Asts,53,47,46,13
22023,1628983,22300201,"NOV 16, 2023",OKC @ GSW,W,29,6,21,0.286,3,7,0.429,9,9,1.0,1,1,2,7,3,1,2,4,24,12,1,Shai Gilgeous-Alexander,OKC,GSW,OKC,31.0,Points,33,26,31,9
22023,1628983,22300201,"NOV 16, 2023",OKC @ GSW,W,29,6,21,0.286,3,7,0.429,9,9,1.0,1,1,2,7,3,1,2,4,24,12,1,Shai Gilgeous-Alexander,OKC,GSW,OKC,31.0,Points,33,26,31,9
22023,1628983,22300201,"NOV 16, 2023",OKC @ GSW,W,29,6,21,0.286,3,7,0.429,9,9,1.0,1,1,2,7,3,1,2,4,24,12,1,Shai Gilgeous-Alexander,OKC,GSW,OKC,6.0,Rebounds,33,26,31,9
22023,1628983,22300201,"NOV 16, 2023",OKC @ GSW,W,29,6,21,0.286,3,7,0.429,9,9,1.0,1,1,2,7,3,1,2,4,24,12,1,Shai Gilgeous-Alexander,OKC,GSW,OKC,42.5,Pts+Rebs+Asts,33,26,31,9
22023,1628983,22300201,"NOV 16, 2023",OKC @ GSW,W,29,6,21,0.286,3,7,0.429,9,9,1.0,1,1,2,7,3,1,2,4,24,12,1,Shai Gilgeous-Alexander,OKC,GSW,OKC,6.0,Assists,33,26,31,9
22023,1628983,22300201,"NOV 16, 2023",OKC @ GSW,W,29,6,21,0.286,3,7,0.429,9,9,1.0,1,1,2,7,3,1,2,4,24,12,1,Shai Gilgeous-Alexander,OKC,GSW,OKC,51.5,Fantasy Score,33,26,31,9
22023,1628983,22300201,"NOV 16, 2023",OKC @ GSW,W,29,6,21,0.286,3,7,0.429,9,9,1.0,1,1,2,7,3,1,2,4,24,12,1,Shai Gilgeous-Alexander,OKC,GSW,OKC,4.0,3-PT Attempted,33,26,31,9
22023,1628983,22300201,"NOV 16, 2023",OKC @ GSW,W,29,6,21,0.286,3,7,0.429,9,9,1.0,1,1,2,7,3,1,2,4,24,12,1,Shai Gilgeous-Alexander,OKC,GSW,OKC,7.5,Free Throws Made,33,26,31,9
22023,1628983,22300201,"NOV 16, 2023",OKC @ GSW,W,29,6,21,0.286,3,7,0.429,9,9,1.0,1,1,2,7,3,1,2,4,24,12,1,Shai Gilgeous-Alexander,OKC,GSW,OKC,20.5,FG Attempted,33,26,31,9
22023,1628983,22300201,"NOV 16, 2023",OKC @ GSW,W,29,6,21,0.286,3,7,0.429,9,9,1.0,1,1,2,7,3,1,2,4,24,12,1,Shai Gilgeous-Alexander,OKC,GSW,OKC,36.5,Pts+Rebs,33,26,31,9
22023,1628983,22300201,"NOV 16, 2023",OKC @ GSW,W,29,6,21,0.286,3,7,0.429,9,9,1.0,1,1,2,7,3,1,2,4,24,12,1,Shai Gilgeous-Alexander,OKC,GSW,OKC,0.5,Dunks,33,26,31,9
22023,1628983,22300201,"NOV 16, 2023",OKC @ GSW,W,29,6,21,0.286,3,7,0.429,9,9,1.0,1,1,2,7,3,1,2,4,24,12,1,Shai Gilgeous-Alexander,OKC,GSW,OKC,36.5,Pts+Asts,33,26,31,9
22023,1628983,22300201,"NOV 16, 2023",OKC @ GSW,W,29,6,21,0.286,3,7,0.429,9,9,1.0,1,1,2,7,3,1,2,4,24,12,1,Shai Gilgeous-Alexander,OKC,GSW,OKC,1.5,Steals,33,26,31,9
22023,1628983,22300201,"NOV 16, 2023",OKC @ GSW,W,29,6,21,0.286,3,7,0.429,9,9,1.0,1,1,2,7,3,1,2,4,24,12,1,Shai Gilgeous-Alexander,OKC,GSW,OKC,12.0,Rebs+Asts,33,26,31,9
22023,1628983,22300021,"NOV 14, 2023",OKC vs. SAS,W,28,10,16,0.625,1,4,0.25,7,7,1.0,1,5,6,5,7,0,2,2,28,25,1,Shai Gilgeous-Alexander,OKC,OKC,SAS,31.0,Points,39,34,33,11
22023,1628983,22300021,"NOV 14, 2023",OKC vs. SAS,W,28,10,16,0.625,1,4,0.25,7,7,1.0,1,5,6,5,7,0,2,2,28,25,1,Shai Gilgeous-Alexander,OKC,OKC,SAS,31.0,Points,39,34,33,11
22023,1628983,22300021,"NOV 14, 2023",OKC vs. SAS,W,28,10,16,0.625,1,4,0.25,7,7,1.0,1,5,6,5,7,0,2,2,28,25,1,Shai Gilgeous-Alexander,OKC,OKC,SAS,6.0,Rebounds,39,34,33,11
22023,1628983,22300021,"NOV 14, 2023",OKC vs. SAS,W,28,10,16,0.625,1,4,0.25,7,7,1.0,1,5,6,5,7,0,2,2,28,25,1,Shai Gilgeous-Alexander,OKC,OKC,SAS,42.5,Pts+Rebs+Asts,39,34,33,11
22023,1628983,22300021,"NOV 14, 2023",OKC vs. SAS,W,28,10,16,0.625,1,4,0.25,7,7,1.0,1,5,6,5,7,0,2,2,28,25,1,Shai Gilgeous-Alexander,OKC,OKC,SAS,6.0,Assists,39,34,33,11
22023,1628983,22300021,"NOV 14, 2023",OKC vs. SAS,W,28,10,16,0.625,1,4,0.25,7,7,1.0,1,5,6,5,7,0,2,2,28,25,1,Shai Gilgeous-Alexander,OKC,OKC,SAS,51.5,Fantasy Score,39,34,33,11
22023,1628983,22300021,"NOV 14, 2023",OKC vs. SAS,W,28,10,16,0.625,1,4,0.25,7,7,1.0,1,5,6,5,7,0,2,2,28,25,1,Shai Gilgeous-Alexander,OKC,OKC,SAS,4.0,3-PT Attempted,39,34,33,11
22023,1628983,22300021,"NOV 14, 2023",OKC vs. SAS,W,28,10,16,0.625,1,4,0.25,7,7,1.0,1,5,6,5,7,0,2,2,28,25,1,Shai Gilgeous-Alexander,OKC,OKC,SAS,7.5,Free Throws Made,39,34,33,11
22023,1628983,22300021,"NOV 14, 2023",OKC vs. SAS,W,28,10,16,0.625,1,4,0.25,7,7,1.0,1,5,6,5,7,0,2,2,28,25,1,Shai Gilgeous-Alexander,OKC,OKC,SAS,20.5,FG Attempted,39,34,33,11
22023,1628983,22300021,"NOV 14, 2023",OKC vs. SAS,W,28,10,16,0.625,1,4,0.25,7,7,1.0,1,5,6,5,7,0,2,2,28,25,1,Shai Gilgeous-Alexander,OKC,OKC,SAS,36.5,Pts+Rebs,39,34,33,11
22023,1628983,22300021,"NOV 14, 2023",OKC vs. SAS,W,28,10,16,0.625,1,4,0.25,7,7,1.0,1,5,6,5,7,0,2,2,28,25,1,Shai Gilgeous-Alexander,OKC,OKC,SAS,0.5,Dunks,39,34,33,11
22023,1628983,22300021,"NOV 14, 2023",OKC vs. SAS,W,28,10,16,0.625,1,4,0.25,7,7,1.0,1,5,6,5,7,0,2,2,28,25,1,Shai Gilgeous-Alexander,OKC,OKC,SAS,36.5,Pts+Asts,39,34,33,11
22023,1628983,22300021,"NOV 14, 2023",OKC vs. SAS,W,28,10,16,0.625,1,4,0.25,7,7,1.0,1,5,6,5,7,0,2,2,28,25,1,Shai Gilgeous-Alexander,OKC,OKC,SAS,1.5,Steals,39,34,33,11
22023,1628983,22300021,"NOV 14, 2023",OKC vs. SAS,W,28,10,16,0.625,1,4,0.25,7,7,1.0,1,5,6,5,7,0,2,2,28,25,1,Shai Gilgeous-Alexander,OKC,OKC,SAS,12.0,Rebs+Asts,39,34,33,11
22023,1628983,22300185,"NOV 12, 2023",OKC @ PHX,W,37,13,22,0.591,2,5,0.4,7,8,0.875,0,7,7,4,1,1,1,3,35,7,1,Shai Gilgeous-Alexander,OKC,PHX,OKC,31.0,Points,46,42,39,11
22023,1628983,22300185,"NOV 12, 2023",OKC @ PHX,W,37,13,22,0.591,2,5,0.4,7,8,0.875,0,7,7,4,1,1,1,3,35,7,1,Shai Gilgeous-Alexander,OKC,PHX,OKC,31.0,Points,46,42,39,11
22023,1628983,22300185,"NOV 12, 2023",OKC @ PHX,W,37,13,22,0.591,2,5,0.4,7,8,0.875,0,7,7,4,1,1,1,3,35,7,1,Shai Gilgeous-Alexander,OKC,PHX,OKC,6.0,Rebounds,46,42,39,11
22023,1628983,22300185,"NOV 12, 2023",OKC @ PHX,W,37,13,22,0.591,2,5,0.4,7,8,0.875,0,7,7,4,1,1,1,3,35,7,1,Shai Gilgeous-Alexander,OKC,PHX,OKC,42.5,Pts+Rebs+Asts,46,42,39,11
22023,1628983,22300185,"NOV 12, 2023",OKC @ PHX,W,37,13,22,0.591,2,5,0.4,7,8,0.875,0,7,7,4,1,1,1,3,35,7,1,Shai Gilgeous-Alexander,OKC,PHX,OKC,6.0,Assists,46,42,39,11
22023,1628983,22300185,"NOV 12, 2023",OKC @ PHX,W,37,13,22,0.591,2,5,0.4,7,8,0.875,0,7,7,4,1,1,1,3,35,7,1,Shai Gilgeous-Alexander,OKC,PHX,OKC,51.5,Fantasy Score,46,42,39,11
22023,1628983,22300185,"NOV 12, 2023",OKC @ PHX,W,37,13,22,0.591,2,5,0.4,7,8,0.875,0,7,7,4,1,1,1,3,35,7,1,Shai Gilgeous-Alexander,OKC,PHX,OKC,4.0,3-PT Attempted,46,42,39,11
22023,1628983,22300185,"NOV 12, 2023",OKC @ PHX,W,37,13,22,0.591,2,5,0.4,7,8,0.875,0,7,7,4,1,1,1,3,35,7,1,Shai Gilgeous-Alexander,OKC,PHX,OKC,7.5,Free Throws Made,46,42,39,11
22023,1628983,22300185,"NOV 12, 2023",OKC @ PHX,W,37,13,22,0.591,2,5,0.4,7,8,0.875,0,7,7,4,1,1,1,3,35,7,1,Shai Gilgeous-Alexander,OKC,PHX,OKC,20.5,FG Attempted,46,42,39,11
22023,1628983,22300185,"NOV 12, 2023",OKC @ PHX,W,37,13,22,0.591,2,5,0.4,7,8,0.875,0,7,7,4,1,1,1,3,35,7,1,Shai Gilgeous-Alexander,OKC,PHX,OKC,36.5,Pts+Rebs,46,42,39,11
22023,1628983,22300185,"NOV 12, 2023",OKC @ PHX,W,37,13,22,0.591,2,5,0.4,7,8,0.875,0,7,7,4,1,1,1,3,35,7,1,Shai Gilgeous-Alexander,OKC,PHX,OKC,0.5,Dunks,46,42,39,11
22023,1628983,22300185,"NOV 12, 2023",OKC @ PHX,W,37,13,22,0.591,2,5,0.4,7,8,0.875,0,7,7,4,1,1,1,3,35,7,1,Shai Gilgeous-Alexander,OKC,PHX,OKC,36.5,Pts+Asts,46,42,39,11
22023,1628983,22300185,"NOV 12, 2023",OKC @ PHX,W,37,13,22,0.591,2,5,0.4,7,8,0.875,0,7,7,4,1,1,1,3,35,7,1,Shai Gilgeous-Alexander,OKC,PHX,OKC,1.5,Steals,46,42,39,11
22023,1628983,22300185,"NOV 12, 2023",OKC @ PHX,W,37,13,22,0.591,2,5,0.4,7,8,0.875,0,7,7,4,1,1,1,3,35,7,1,Shai Gilgeous-Alexander,OKC,PHX,OKC,12.0,Rebs+Asts,46,42,39,11
22023,1628983,22300016,"NOV 10, 2023",OKC @ SAC,L,38,14,25,0.56,0,2,0.0,5,6,0.833,0,7,7,5,2,2,2,1,33,-3,1,Shai Gilgeous-Alexander,OKC,SAC,OKC,31.0,Points,45,40,38,12
22023,1628983,22300016,"NOV 10, 2023",OKC @ SAC,L,38,14,25,0.56,0,2,0.0,5,6,0.833,0,7,7,5,2,2,2,1,33,-3,1,Shai Gilgeous-Alexander,OKC,SAC,OKC,31.0,Points,45,40,38,12
22023,1628983,22300016,"NOV 10, 2023",OKC @ SAC,L,38,14,25,0.56,0,2,0.0,5,6,0.833,0,7,7,5,2,2,2,1,33,-3,1,Shai Gilgeous-Alexander,OKC,SAC,OKC,6.0,Rebounds,45,40,38,12
22023,1628983,22300016,"NOV 10, 2023",OKC @ SAC,L,38,14,25,0.56,0,2,0.0,5,6,0.833,0,7,7,5,2,2,2,1,33,-3,1,Shai Gilgeous-Alexander,OKC,SAC,OKC,42.5,Pts+Rebs+Asts,45,40,38,12
22023,1628983,22300016,"NOV 10, 2023",OKC @ SAC,L,38,14,25,0.56,0,2,0.0,5,6,0.833,0,7,7,5,2,2,2,1,33,-3,1,Shai Gilgeous-Alexander,OKC,SAC,OKC,6.0,Assists,45,40,38,12
22023,1628983,22300016,"NOV 10, 2023",OKC @ SAC,L,38,14,25,0.56,0,2,0.0,5,6,0.833,0,7,7,5,2,2,2,1,33,-3,1,Shai Gilgeous-Alexander,OKC,SAC,OKC,51.5,Fantasy Score,45,40,38,12
22023,1628983,22300016,"NOV 10, 2023",OKC @ SAC,L,38,14,25,0.56,0,2,0.0,5,6,0.833,0,7,7,5,2,2,2,1,33,-3,1,Shai Gilgeous-Alexander,OKC,SAC,OKC,4.0,3-PT Attempted,45,40,38,12
22023,1628983,22300016,"NOV 10, 2023",OKC @ SAC,L,38,14,25,0.56,0,2,0.0,5,6,0.833,0,7,7,5,2,2,2,1,33,-3,1,Shai Gilgeous-Alexander,OKC,SAC,OKC,7.5,Free Throws Made,45,40,38,12
22023,1628983,22300016,"NOV 10, 2023",OKC @ SAC,L,38,14,25,0.56,0,2,0.0,5,6,0.833,0,7,7,5,2,2,2,1,33,-3,1,Shai Gilgeous-Alexander,OKC,SAC,OKC,20.5,FG Attempted,45,40,38,12
22023,1628983,22300016,"NOV 10, 2023",OKC @ SAC,L,38,14,25,0.56,0,2,0.0,5,6,0.833,0,7,7,5,2,2,2,1,33,-3,1,Shai Gilgeous-Alexander,OKC,SAC,OKC,36.5,Pts+Rebs,45,40,38,12
22023,1628983,22300016,"NOV 10, 2023",OKC @ SAC,L,38,14,25,0.56,0,2,0.0,5,6,0.833,0,7,7,5,2,2,2,1,33,-3,1,Shai Gilgeous-Alexander,OKC,SAC,OKC,0.5,Dunks,45,40,38,12
22023,1628983,22300016,"NOV 10, 2023",OKC @ SAC,L,38,14,25,0.56,0,2,0.0,5,6,0.833,0,7,7,5,2,2,2,1,33,-3,1,Shai Gilgeous-Alexander,OKC,SAC,OKC,36.5,Pts+Asts,45,40,38,12
22023,1628983,22300016,"NOV 10, 2023",OKC @ SAC,L,38,14,25,0.56,0,2,0.0,5,6,0.833,0,7,7,5,2,2,2,1,33,-3,1,Shai Gilgeous-Alexander,OKC,SAC,OKC,1.5,Steals,45,40,38,12
22023,1628983,22300016,"NOV 10, 2023",OKC @ SAC,L,38,14,25,0.56,0,2,0.0,5,6,0.833,0,7,7,5,2,2,2,1,33,-3,1,Shai Gilgeous-Alexander,OKC,SAC,OKC,12.0,Rebs+Asts,45,40,38,12
22023,1628983,22300167,"NOV 08, 2023",OKC vs. CLE,W,38,15,22,0.682,1,2,0.5,12,13,0.923,2,5,7,6,2,1,3,3,43,10,1,Shai Gilgeous-Alexander,OKC,OKC,CLE,31.0,Points,56,50,49,13
22023,1628983,22300167,"NOV 08, 2023",OKC vs. CLE,W,38,15,22,0.682,1,2,0.5,12,13,0.923,2,5,7,6,2,1,3,3,43,10,1,Shai Gilgeous-Alexander,OKC,OKC,CLE,31.0,Points,56,50,49,13
22023,1628983,22300167,"NOV 08, 2023",OKC vs. CLE,W,38,15,22,0.682,1,2,0.5,12,13,0.923,2,5,7,6,2,1,3,3,43,10,1,Shai Gilgeous-Alexander,OKC,OKC,CLE,6.0,Rebounds,56,50,49,13
22023,1628983,22300167,"NOV 08, 2023",OKC vs. CLE,W,38,15,22,0.682,1,2,0.5,12,13,0.923,2,5,7,6,2,1,3,3,43,10,1,Shai Gilgeous-Alexander,OKC,OKC,CLE,42.5,Pts+Rebs+Asts,56,50,49,13
22023,1628983,22300167,"NOV 08, 2023",OKC vs. CLE,W,38,15,22,0.682,1,2,0.5,12,13,0.923,2,5,7,6,2,1,3,3,43,10,1,Shai Gilgeous-Alexander,OKC,OKC,CLE,6.0,Assists,56,50,49,13
22023,1628983,22300167,"NOV 08, 2023",OKC vs. CLE,W,38,15,22,0.682,1,2,0.5,12,13,0.923,2,5,7,6,2,1,3,3,43,10,1,Shai Gilgeous-Alexander,OKC,OKC,CLE,51.5,Fantasy Score,56,50,49,13
22023,1628983,22300167,"NOV 08, 2023",OKC vs. CLE,W,38,15,22,0.682,1,2,0.5,12,13,0.923,2,5,7,6,2,1,3,3,43,10,1,Shai Gilgeous-Alexander,OKC,OKC,CLE,4.0,3-PT Attempted,56,50,49,13
22023,1628983,22300167,"NOV 08, 2023",OKC vs. CLE,W,38,15,22,0.682,1,2,0.5,12,13,0.923,2,5,7,6,2,1,3,3,43,10,1,Shai Gilgeous-Alexander,OKC,OKC,CLE,7.5,Free Throws Made,56,50,49,13
22023,1628983,22300167,"NOV 08, 2023",OKC vs. CLE,W,38,15,22,0.682,1,2,0.5,12,13,0.923,2,5,7,6,2,1,3,3,43,10,1,Shai Gilgeous-Alexander,OKC,OKC,CLE,20.5,FG Attempted,56,50,49,13
22023,1628983,22300167,"NOV 08, 2023",OKC vs. CLE,W,38,15,22,0.682,1,2,0.5,12,13,0.923,2,5,7,6,2,1,3,3,43,10,1,Shai Gilgeous-Alexander,OKC,OKC,CLE,36.5,Pts+Rebs,56,50,49,13
22023,1628983,22300167,"NOV 08, 2023",OKC vs. CLE,W,38,15,22,0.682,1,2,0.5,12,13,0.923,2,5,7,6,2,1,3,3,43,10,1,Shai Gilgeous-Alexander,OKC,OKC,CLE,0.5,Dunks,56,50,49,13
22023,1628983,22300167,"NOV 08, 2023",OKC vs. CLE,W,38,15,22,0.682,1,2,0.5,12,13,0.923,2,5,7,6,2,1,3,3,43,10,1,Shai Gilgeous-Alexander,OKC,OKC,CLE,36.5,Pts+Asts,56,50,49,13
22023,1628983,22300167,"NOV 08, 2023",OKC vs. CLE,W,38,15,22,0.682,1,2,0.5,12,13,0.923,2,5,7,6,2,1,3,3,43,10,1,Shai Gilgeous-Alexander,OKC,OKC,CLE,1.5,Steals,56,50,49,13
22023,1628983,22300167,"NOV 08, 2023",OKC vs. CLE,W,38,15,22,0.682,1,2,0.5,12,13,0.923,2,5,7,6,2,1,3,3,43,10,1,Shai Gilgeous-Alexander,OKC,OKC,CLE,12.0,Rebs+Asts,56,50,49,13
22023,1628983,22300155,"NOV 06, 2023",OKC vs. ATL,W,37,11,20,0.55,3,7,0.429,5,6,0.833,1,7,8,6,1,0,2,5,30,14,1,Shai Gilgeous-Alexander,OKC,OKC,ATL,31.0,Points,44,38,36,14
22023,1628983,22300155,"NOV 06, 2023",OKC vs. ATL,W,37,11,20,0.55,3,7,0.429,5,6,0.833,1,7,8,6,1,0,2,5,30,14,1,Shai Gilgeous-Alexander,OKC,OKC,ATL,31.0,Points,44,38,36,14
22023,1628983,22300155,"NOV 06, 2023",OKC vs. ATL,W,37,11,20,0.55,3,7,0.429,5,6,0.833,1,7,8,6,1,0,2,5,30,14,1,Shai Gilgeous-Alexander,OKC,OKC,ATL,6.0,Rebounds,44,38,36,14
22023,1628983,22300155,"NOV 06, 2023",OKC vs. ATL,W,37,11,20,0.55,3,7,0.429,5,6,0.833,1,7,8,6,1,0,2,5,30,14,1,Shai Gilgeous-Alexander,OKC,OKC,ATL,42.5,Pts+Rebs+Asts,44,38,36,14
22023,1628983,22300155,"NOV 06, 2023",OKC vs. ATL,W,37,11,20,0.55,3,7,0.429,5,6,0.833,1,7,8,6,1,0,2,5,30,14,1,Shai Gilgeous-Alexander,OKC,OKC,ATL,6.0,Assists,44,38,36,14
22023,1628983,22300155,"NOV 06, 2023",OKC vs. ATL,W,37,11,20,0.55,3,7,0.429,5,6,0.833,1,7,8,6,1,0,2,5,30,14,1,Shai Gilgeous-Alexander,OKC,OKC,ATL,51.5,Fantasy Score,44,38,36,14
22023,1628983,22300155,"NOV 06, 2023",OKC vs. ATL,W,37,11,20,0.55,3,7,0.429,5,6,0.833,1,7,8,6,1,0,2,5,30,14,1,Shai Gilgeous-Alexander,OKC,OKC,ATL,4.0,3-PT Attempted,44,38,36,14
22023,1628983,22300155,"NOV 06, 2023",OKC vs. ATL,W,37,11,20,0.55,3,7,0.429,5,6,0.833,1,7,8,6,1,0,2,5,30,14,1,Shai Gilgeous-Alexander,OKC,OKC,ATL,7.5,Free Throws Made,44,38,36,14
22023,1628983,22300155,"NOV 06, 2023",OKC vs. ATL,W,37,11,20,0.55,3,7,0.429,5,6,0.833,1,7,8,6,1,0,2,5,30,14,1,Shai Gilgeous-Alexander,OKC,OKC,ATL,20.5,FG Attempted,44,38,36,14
22023,1628983,22300155,"NOV 06, 2023",OKC vs. ATL,W,37,11,20,0.55,3,7,0.429,5,6,0.833,1,7,8,6,1,0,2,5,30,14,1,Shai Gilgeous-Alexander,OKC,OKC,ATL,36.5,Pts+Rebs,44,38,36,14
22023,1628983,22300155,"NOV 06, 2023",OKC vs. ATL,W,37,11,20,0.55,3,7,0.429,5,6,0.833,1,7,8,6,1,0,2,5,30,14,1,Shai Gilgeous-Alexander,OKC,OKC,ATL,0.5,Dunks,44,38,36,14
22023,1628983,22300155,"NOV 06, 2023",OKC vs. ATL,W,37,11,20,0.55,3,7,0.429,5,6,0.833,1,7,8,6,1,0,2,5,30,14,1,Shai Gilgeous-Alexander,OKC,OKC,ATL,36.5,Pts+Asts,44,38,36,14
22023,1628983,22300155,"NOV 06, 2023",OKC vs. ATL,W,37,11,20,0.55,3,7,0.429,5,6,0.833,1,7,8,6,1,0,2,5,30,14,1,Shai Gilgeous-Alexander,OKC,OKC,ATL,1.5,Steals,44,38,36,14
22023,1628983,22300155,"NOV 06, 2023",OKC vs. ATL,W,37,11,20,0.55,3,7,0.429,5,6,0.833,1,7,8,6,1,0,2,5,30,14,1,Shai Gilgeous-Alexander,OKC,OKC,ATL,12.0,Rebs+Asts,44,38,36,14
22023,1628983,22300121,"NOV 01, 2023",OKC vs. NOP,L,38,8,20,0.4,0,5,0.0,4,5,0.8,0,5,5,8,3,0,2,2,20,1,1,Shai Gilgeous-Alexander,OKC,OKC,NOP,31.0,Points,33,25,28,13
22023,1628983,22300121,"NOV 01, 2023",OKC vs. NOP,L,38,8,20,0.4,0,5,0.0,4,5,0.8,0,5,5,8,3,0,2,2,20,1,1,Shai Gilgeous-Alexander,OKC,OKC,NOP,31.0,Points,33,25,28,13
22023,1628983,22300121,"NOV 01, 2023",OKC vs. NOP,L,38,8,20,0.4,0,5,0.0,4,5,0.8,0,5,5,8,3,0,2,2,20,1,1,Shai Gilgeous-Alexander,OKC,OKC,NOP,6.0,Rebounds,33,25,28,13
22023,1628983,22300121,"NOV 01, 2023",OKC vs. NOP,L,38,8,20,0.4,0,5,0.0,4,5,0.8,0,5,5,8,3,0,2,2,20,1,1,Shai Gilgeous-Alexander,OKC,OKC,NOP,42.5,Pts+Rebs+Asts,33,25,28,13
22023,1628983,22300121,"NOV 01, 2023",OKC vs. NOP,L,38,8,20,0.4,0,5,0.0,4,5,0.8,0,5,5,8,3,0,2,2,20,1,1,Shai Gilgeous-Alexander,OKC,OKC,NOP,6.0,Assists,33,25,28,13
22023,1628983,22300121,"NOV 01, 2023",OKC vs. NOP,L,38,8,20,0.4,0,5,0.0,4,5,0.8,0,5,5,8,3,0,2,2,20,1,1,Shai Gilgeous-Alexander,OKC,OKC,NOP,51.5,Fantasy Score,33,25,28,13
22023,1628983,22300121,"NOV 01, 2023",OKC vs. NOP,L,38,8,20,0.4,0,5,0.0,4,5,0.8,0,5,5,8,3,0,2,2,20,1,1,Shai Gilgeous-Alexander,OKC,OKC,NOP,4.0,3-PT Attempted,33,25,28,13
22023,1628983,22300121,"NOV 01, 2023",OKC vs. NOP,L,38,8,20,0.4,0,5,0.0,4,5,0.8,0,5,5,8,3,0,2,2,20,1,1,Shai Gilgeous-Alexander,OKC,OKC,NOP,7.5,Free Throws Made,33,25,28,13
22023,1628983,22300121,"NOV 01, 2023",OKC vs. NOP,L,38,8,20,0.4,0,5,0.0,4,5,0.8,0,5,5,8,3,0,2,2,20,1,1,Shai Gilgeous-Alexander,OKC,OKC,NOP,20.5,FG Attempted,33,25,28,13
22023,1628983,22300121,"NOV 01, 2023",OKC vs. NOP,L,38,8,20,0.4,0,5,0.0,4,5,0.8,0,5,5,8,3,0,2,2,20,1,1,Shai Gilgeous-Alexander,OKC,OKC,NOP,36.5,Pts+Rebs,33,25,28,13
22023,1628983,22300121,"NOV 01, 2023",OKC vs. NOP,L,38,8,20,0.4,0,5,0.0,4,5,0.8,0,5,5,8,3,0,2,2,20,1,1,Shai Gilgeous-Alexander,OKC,OKC,NOP,0.5,Dunks,33,25,28,13
22023,1628983,22300121,"NOV 01, 2023",OKC vs. NOP,L,38,8,20,0.4,0,5,0.0,4,5,0.8,0,5,5,8,3,0,2,2,20,1,1,Shai Gilgeous-Alexander,OKC,OKC,NOP,36.5,Pts+Asts,33,25,28,13
22023,1628983,22300121,"NOV 01, 2023",OKC vs. NOP,L,38,8,20,0.4,0,5,0.0,4,5,0.8,0,5,5,8,3,0,2,2,20,1,1,Shai Gilgeous-Alexander,OKC,OKC,NOP,1.5,Steals,33,25,28,13
22023,1628983,22300121,"NOV 01, 2023",OKC vs. NOP,L,38,8,20,0.4,0,5,0.0,4,5,0.8,0,5,5,8,3,0,2,2,20,1,1,Shai Gilgeous-Alexander,OKC,OKC,NOP,12.0,Rebs+Asts,33,25,28,13
22023,1628983,22300109,"OCT 30, 2023",OKC vs. DET,W,33,11,23,0.478,1,3,0.333,9,9,1.0,1,8,9,4,3,0,5,2,32,17,1,Shai Gilgeous-Alexander,OKC,OKC,DET,31.0,Points,45,41,36,13
22023,1628983,22300109,"OCT 30, 2023",OKC vs. DET,W,33,11,23,0.478,1,3,0.333,9,9,1.0,1,8,9,4,3,0,5,2,32,17,1,Shai Gilgeous-Alexander,OKC,OKC,DET,31.0,Points,45,41,36,13
22023,1628983,22300109,"OCT 30, 2023",OKC vs. DET,W,33,11,23,0.478,1,3,0.333,9,9,1.0,1,8,9,4,3,0,5,2,32,17,1,Shai Gilgeous-Alexander,OKC,OKC,DET,6.0,Rebounds,45,41,36,13
22023,1628983,22300109,"OCT 30, 2023",OKC vs. DET,W,33,11,23,0.478,1,3,0.333,9,9,1.0,1,8,9,4,3,0,5,2,32,17,1,Shai Gilgeous-Alexander,OKC,OKC,DET,42.5,Pts+Rebs+Asts,45,41,36,13
22023,1628983,22300109,"OCT 30, 2023",OKC vs. DET,W,33,11,23,0.478,1,3,0.333,9,9,1.0,1,8,9,4,3,0,5,2,32,17,1,Shai Gilgeous-Alexander,OKC,OKC,DET,6.0,Assists,45,41,36,13
22023,1628983,22300109,"OCT 30, 2023",OKC vs. DET,W,33,11,23,0.478,1,3,0.333,9,9,1.0,1,8,9,4,3,0,5,2,32,17,1,Shai Gilgeous-Alexander,OKC,OKC,DET,51.5,Fantasy Score,45,41,36,13
22023,1628983,22300109,"OCT 30, 2023",OKC vs. DET,W,33,11,23,0.478,1,3,0.333,9,9,1.0,1,8,9,4,3,0,5,2,32,17,1,Shai Gilgeous-Alexander,OKC,OKC,DET,4.0,3-PT Attempted,45,41,36,13
22023,1628983,22300109,"OCT 30, 2023",OKC vs. DET,W,33,11,23,0.478,1,3,0.333,9,9,1.0,1,8,9,4,3,0,5,2,32,17,1,Shai Gilgeous-Alexander,OKC,OKC,DET,7.5,Free Throws Made,45,41,36,13
22023,1628983,22300109,"OCT 30, 2023",OKC vs. DET,W,33,11,23,0.478,1,3,0.333,9,9,1.0,1,8,9,4,3,0,5,2,32,17,1,Shai Gilgeous-Alexander,OKC,OKC,DET,20.5,FG Attempted,45,41,36,13
22023,1628983,22300109,"OCT 30, 2023",OKC vs. DET,W,33,11,23,0.478,1,3,0.333,9,9,1.0,1,8,9,4,3,0,5,2,32,17,1,Shai Gilgeous-Alexander,OKC,OKC,DET,36.5,Pts+Rebs,45,41,36,13
22023,1628983,22300109,"OCT 30, 2023",OKC vs. DET,W,33,11,23,0.478,1,3,0.333,9,9,1.0,1,8,9,4,3,0,5,2,32,17,1,Shai Gilgeous-Alexander,OKC,OKC,DET,0.5,Dunks,45,41,36,13
22023,1628983,22300109,"OCT 30, 2023",OKC vs. DET,W,33,11,23,0.478,1,3,0.333,9,9,1.0,1,8,9,4,3,0,5,2,32,17,1,Shai Gilgeous-Alexander,OKC,OKC,DET,36.5,Pts+Asts,45,41,36,13
22023,1628983,22300109,"OCT 30, 2023",OKC vs. DET,W,33,11,23,0.478,1,3,0.333,9,9,1.0,1,8,9,4,3,0,5,2,32,17,1,Shai Gilgeous-Alexander,OKC,OKC,DET,1.5,Steals,45,41,36,13
22023,1628983,22300109,"OCT 30, 2023",OKC vs. DET,W,33,11,23,0.478,1,3,0.333,9,9,1.0,1,8,9,4,3,0,5,2,32,17,1,Shai Gilgeous-Alexander,OKC,OKC,DET,12.0,Rebs+Asts,45,41,36,13
22023,1628983,22300095,"OCT 29, 2023",OKC vs. DEN,L,28,2,16,0.125,0,4,0.0,3,4,0.75,1,3,4,7,1,0,0,2,7,-22,1,Shai Gilgeous-Alexander,OKC,OKC,DEN,31.0,Points,18,11,14,11
22023,1628983,22300095,"OCT 29, 2023",OKC vs. DEN,L,28,2,16,0.125,0,4,0.0,3,4,0.75,1,3,4,7,1,0,0,2,7,-22,1,Shai Gilgeous-Alexander,OKC,OKC,DEN,31.0,Points,18,11,14,11
22023,1628983,22300095,"OCT 29, 2023",OKC vs. DEN,L,28,2,16,0.125,0,4,0.0,3,4,0.75,1,3,4,7,1,0,0,2,7,-22,1,Shai Gilgeous-Alexander,OKC,OKC,DEN,6.0,Rebounds,18,11,14,11
22023,1628983,22300095,"OCT 29, 2023",OKC vs. DEN,L,28,2,16,0.125,0,4,0.0,3,4,0.75,1,3,4,7,1,0,0,2,7,-22,1,Shai Gilgeous-Alexander,OKC,OKC,DEN,42.5,Pts+Rebs+Asts,18,11,14,11
22023,1628983,22300095,"OCT 29, 2023",OKC vs. DEN,L,28,2,16,0.125,0,4,0.0,3,4,0.75,1,3,4,7,1,0,0,2,7,-22,1,Shai Gilgeous-Alexander,OKC,OKC,DEN,6.0,Assists,18,11,14,11
22023,1628983,22300095,"OCT 29, 2023",OKC vs. DEN,L,28,2,16,0.125,0,4,0.0,3,4,0.75,1,3,4,7,1,0,0,2,7,-22,1,Shai Gilgeous-Alexander,OKC,OKC,DEN,51.5,Fantasy Score,18,11,14,11
22023,1628983,22300095,"OCT 29, 2023",OKC vs. DEN,L,28,2,16,0.125,0,4,0.0,3,4,0.75,1,3,4,7,1,0,0,2,7,-22,1,Shai Gilgeous-Alexander,OKC,OKC,DEN,4.0,3-PT Attempted,18,11,14,11
22023,1628983,22300095,"OCT 29, 2023",OKC vs. DEN,L,28,2,16,0.125,0,4,0.0,3,4,0.75,1,3,4,7,1,0,0,2,7,-22,1,Shai Gilgeous-Alexander,OKC,OKC,DEN,7.5,Free Throws Made,18,11,14,11
22023,1628983,22300095,"OCT 29, 2023",OKC vs. DEN,L,28,2,16,0.125,0,4,0.0,3,4,0.75,1,3,4,7,1,0,0,2,7,-22,1,Shai Gilgeous-Alexander,OKC,OKC,DEN,20.5,FG Attempted,18,11,14,11
22023,1628983,22300095,"OCT 29, 2023",OKC vs. DEN,L,28,2,16,0.125,0,4,0.0,3,4,0.75,1,3,4,7,1,0,0,2,7,-22,1,Shai Gilgeous-Alexander,OKC,OKC,DEN,36.5,Pts+Rebs,18,11,14,11
22023,1628983,22300095,"OCT 29, 2023",OKC vs. DEN,L,28,2,16,0.125,0,4,0.0,3,4,0.75,1,3,4,7,1,0,0,2,7,-22,1,Shai Gilgeous-Alexander,OKC,OKC,DEN,0.5,Dunks,18,11,14,11
22023,1628983,22300095,"OCT 29, 2023",OKC vs. DEN,L,28,2,16,0.125,0,4,0.0,3,4,0.75,1,3,4,7,1,0,0,2,7,-22,1,Shai Gilgeous-Alexander,OKC,OKC,DEN,36.5,Pts+Asts,18,11,14,11
22023,1628983,22300095,"OCT 29, 2023",OKC vs. DEN,L,28,2,16,0.125,0,4,0.0,3,4,0.75,1,3,4,7,1,0,0,2,7,-22,1,Shai Gilgeous-Alexander,OKC,OKC,DEN,1.5,Steals,18,11,14,11
22023,1628983,22300095,"OCT 29, 2023",OKC vs. DEN,L,28,2,16,0.125,0,4,0.0,3,4,0.75,1,3,4,7,1,0,0,2,7,-22,1,Shai Gilgeous-Alexander,OKC,OKC,DEN,12.0,Rebs+Asts,18,11,14,11
22023,1628983,22300081,"OCT 27, 2023",OKC @ CLE,W,36,15,26,0.577,2,2,1.0,2,2,1.0,1,10,11,4,5,1,5,2,34,4,1,Shai Gilgeous-Alexander,OKC,CLE,OKC,31.0,Points,49,45,38,15
22023,1628983,22300081,"OCT 27, 2023",OKC @ CLE,W,36,15,26,0.577,2,2,1.0,2,2,1.0,1,10,11,4,5,1,5,2,34,4,1,Shai Gilgeous-Alexander,OKC,CLE,OKC,31.0,Points,49,45,38,15
22023,1628983,22300081,"OCT 27, 2023",OKC @ CLE,W,36,15,26,0.577,2,2,1.0,2,2,1.0,1,10,11,4,5,1,5,2,34,4,1,Shai Gilgeous-Alexander,OKC,CLE,OKC,6.0,Rebounds,49,45,38,15
22023,1628983,22300081,"OCT 27, 2023",OKC @ CLE,W,36,15,26,0.577,2,2,1.0,2,2,1.0,1,10,11,4,5,1,5,2,34,4,1,Shai Gilgeous-Alexander,OKC,CLE,OKC,42.5,Pts+Rebs+Asts,49,45,38,15
22023,1628983,22300081,"OCT 27, 2023",OKC @ CLE,W,36,15,26,0.577,2,2,1.0,2,2,1.0,1,10,11,4,5,1,5,2,34,4,1,Shai Gilgeous-Alexander,OKC,CLE,OKC,6.0,Assists,49,45,38,15
22023,1628983,22300081,"OCT 27, 2023",OKC @ CLE,W,36,15,26,0.577,2,2,1.0,2,2,1.0,1,10,11,4,5,1,5,2,34,4,1,Shai Gilgeous-Alexander,OKC,CLE,OKC,51.5,Fantasy Score,49,45,38,15
22023,1628983,22300081,"OCT 27, 2023",OKC @ CLE,W,36,15,26,0.577,2,2,1.0,2,2,1.0,1,10,11,4,5,1,5,2,34,4,1,Shai Gilgeous-Alexander,OKC,CLE,OKC,4.0,3-PT Attempted,49,45,38,15
22023,1628983,22300081,"OCT 27, 2023",OKC @ CLE,W,36,15,26,0.577,2,2,1.0,2,2,1.0,1,10,11,4,5,1,5,2,34,4,1,Shai Gilgeous-Alexander,OKC,CLE,OKC,7.5,Free Throws Made,49,45,38,15
22023,1628983,22300081,"OCT 27, 2023",OKC @ CLE,W,36,15,26,0.577,2,2,1.0,2,2,1.0,1,10,11,4,5,1,5,2,34,4,1,Shai Gilgeous-Alexander,OKC,CLE,OKC,20.5,FG Attempted,49,45,38,15
22023,1628983,22300081,"OCT 27, 2023",OKC @ CLE,W,36,15,26,0.577,2,2,1.0,2,2,1.0,1,10,11,4,5,1,5,2,34,4,1,Shai Gilgeous-Alexander,OKC,CLE,OKC,36.5,Pts+Rebs,49,45,38,15
22023,1628983,22300081,"OCT 27, 2023",OKC @ CLE,W,36,15,26,0.577,2,2,1.0,2,2,1.0,1,10,11,4,5,1,5,2,34,4,1,Shai Gilgeous-Alexander,OKC,CLE,OKC,0.5,Dunks,49,45,38,15
22023,1628983,22300081,"OCT 27, 2023",OKC @ CLE,W,36,15,26,0.577,2,2,1.0,2,2,1.0,1,10,11,4,5,1,5,2,34,4,1,Shai Gilgeous-Alexander,OKC,CLE,OKC,36.5,Pts+Asts,49,45,38,15
22023,1628983,22300081,"OCT 27, 2023",OKC @ CLE,W,36,15,26,0.577,2,2,1.0,2,2,1.0,1,10,11,4,5,1,5,2,34,4,1,Shai Gilgeous-Alexander,OKC,CLE,OKC,1.5,Steals,49,45,38,15
22023,1628983,22300081,"OCT 27, 2023",OKC @ CLE,W,36,15,26,0.577,2,2,1.0,2,2,1.0,1,10,11,4,5,1,5,2,34,4,1,Shai Gilgeous-Alexander,OKC,CLE,OKC,12.0,Rebs+Asts,49,45,38,15
22023,1628983,22300070,"OCT 25, 2023",OKC @ CHI,W,36,12,18,0.667,2,5,0.4,5,5,1.0,0,5,5,10,1,2,1,0,31,19,1,Shai Gilgeous-Alexander,OKC,CHI,OKC,31.0,Points,46,36,41,15
22023,1628983,22300070,"OCT 25, 2023",OKC @ CHI,W,36,12,18,0.667,2,5,0.4,5,5,1.0,0,5,5,10,1,2,1,0,31,19,1,Shai Gilgeous-Alexander,OKC,CHI,OKC,31.0,Points,46,36,41,15
22023,1628983,22300070,"OCT 25, 2023",OKC @ CHI,W,36,12,18,0.667,2,5,0.4,5,5,1.0,0,5,5,10,1,2,1,0,31,19,1,Shai Gilgeous-Alexander,OKC,CHI,OKC,6.0,Rebounds,46,36,41,15
22023,1628983,22300070,"OCT 25, 2023",OKC @ CHI,W,36,12,18,0.667,2,5,0.4,5,5,1.0,0,5,5,10,1,2,1,0,31,19,1,Shai Gilgeous-Alexander,OKC,CHI,OKC,42.5,Pts+Rebs+Asts,46,36,41,15
22023,1628983,22300070,"OCT 25, 2023",OKC @ CHI,W,36,12,18,0.667,2,5,0.4,5,5,1.0,0,5,5,10,1,2,1,0,31,19,1,Shai Gilgeous-Alexander,OKC,CHI,OKC,6.0,Assists,46,36,41,15
22023,1628983,22300070,"OCT 25, 2023",OKC @ CHI,W,36,12,18,0.667,2,5,0.4,5,5,1.0,0,5,5,10,1,2,1,0,31,19,1,Shai Gilgeous-Alexander,OKC,CHI,OKC,51.5,Fantasy Score,46,36,41,15
22023,1628983,22300070,"OCT 25, 2023",OKC @ CHI,W,36,12,18,0.667,2,5,0.4,5,5,1.0,0,5,5,10,1,2,1,0,31,19,1,Shai Gilgeous-Alexander,OKC,CHI,OKC,4.0,3-PT Attempted,46,36,41,15
22023,1628983,22300070,"OCT 25, 2023",OKC @ CHI,W,36,12,18,0.667,2,5,0.4,5,5,1.0,0,5,5,10,1,2,1,0,31,19,1,Shai Gilgeous-Alexander,OKC,CHI,OKC,7.5,Free Throws Made,46,36,41,15
22023,1628983,22300070,"OCT 25, 2023",OKC @ CHI,W,36,12,18,0.667,2,5,0.4,5,5,1.0,0,5,5,10,1,2,1,0,31,19,1,Shai Gilgeous-Alexander,OKC,CHI,OKC,20.5,FG Attempted,46,36,41,15
22023,1628983,22300070,"OCT 25, 2023",OKC @ CHI,W,36,12,18,0.667,2,5,0.4,5,5,1.0,0,5,5,10,1,2,1,0,31,19,1,Shai Gilgeous-Alexander,OKC,CHI,OKC,36.5,Pts+Rebs,46,36,41,15
22023,1628983,22300070,"OCT 25, 2023",OKC @ CHI,W,36,12,18,0.667,2,5,0.4,5,5,1.0,0,5,5,10,1,2,1,0,31,19,1,Shai Gilgeous-Alexander,OKC,CHI,OKC,0.5,Dunks,46,36,41,15
22023,1628983,22300070,"OCT 25, 2023",OKC @ CHI,W,36,12,18,0.667,2,5,0.4,5,5,1.0,0,5,5,10,1,2,1,0,31,19,1,Shai Gilgeous-Alexander,OKC,CHI,OKC,36.5,Pts+Asts,46,36,41,15
22023,1628983,22300070,"OCT 25, 2023",OKC @ CHI,W,36,12,18,0.667,2,5,0.4,5,5,1.0,0,5,5,10,1,2,1,0,31,19,1,Shai Gilgeous-Alexander,OKC,CHI,OKC,1.5,Steals,46,36,41,15
22023,1628983,22300070,"OCT 25, 2023",OKC @ CHI,W,36,12,18,0.667,2,5,0.4,5,5,1.0,0,5,5,10,1,2,1,0,31,19,1,Shai Gilgeous-Alexander,OKC,CHI,OKC,12.0,Rebs+Asts,46,36,41,15
22023,1630264,22300558,"JAN 15, 2024",WAS vs. DET,L,3,1,2,0.5,1,1,1.0,0,0,0.0,1,0,1,0,0,0,1,0,3,1,1,Anthony Gill,WAS,WAS,DET,,,4,4,3,1
22023,1630264,22300494,"JAN 06, 2024",WAS vs. NYK,L,3,1,1,1.0,1,1,1.0,0,0,0.0,0,2,2,0,0,0,0,0,3,5,1,Anthony Gill,WAS,WAS,NYK,,,5,5,3,2
22023,1630264,22300482,"JAN 05, 2024",WAS @ CLE,L,5,0,3,0.0,0,1,0.0,1,2,0.5,1,0,1,0,0,0,0,1,1,-1,1,Anthony Gill,WAS,CLE,WAS,,,2,2,1,1
22023,1630264,22300465,"JAN 03, 2024",WAS @ CLE,L,5,1,1,1.0,0,0,0.0,0,0,0.0,0,1,1,0,0,0,0,0,2,4,1,Anthony Gill,WAS,CLE,WAS,,,3,3,2,1
22023,1630264,22300416,"DEC 27, 2023",WAS vs. TOR,L,5,0,0,0.0,0,0,0.0,0,0,0.0,0,0,0,0,0,1,0,0,0,-3,1,Anthony Gill,WAS,WAS,TOR,,,0,0,0,0
22023,1630264,22300386,"DEC 22, 2023",WAS @ GSW,L,11,4,5,0.8,0,1,0.0,0,0,0.0,2,1,3,0,0,1,0,0,8,10,1,Anthony Gill,WAS,GSW,WAS,,,11,11,8,3
22023,1630264,22300381,"DEC 21, 2023",WAS @ POR,W,0,0,0,0.0,0,0,0.0,0,0,0.0,0,0,0,0,0,0,0,0,0,-2,1,Anthony Gill,WAS,POR,WAS,,,0,0,0,0
22023,1630264,22300358,"DEC 18, 2023",WAS @ SAC,L,20,2,5,0.4,0,2,0.0,0,0,0.0,1,3,4,3,0,0,1,1,4,9,1,Anthony Gill,WAS,SAC,WAS,,,11,8,7,7
22023,1630264,22300347,"DEC 17, 2023",WAS @ PHX,L,0,0,0,0.0,0,0,0.0,0,0,0.0,0,0,0,0,0,0,0,0,0,0,1,Anthony Gill,WAS,PHX,WAS,,,0,0,0,0
22023,1630264,22300328,"DEC 15, 2023",WAS vs. IND,W,3,0,0,0.0,0,0,0.0,0,0,0.0,0,0,0,0,0,0,0,0,0,-8,1,Anthony Gill,WAS,WAS,IND,,,0,0,0,0
22023,1630264,22300311,"DEC 13, 2023",WAS vs. NOP,L,10,1,2,0.5,0,1,0.0,0,0,0.0,0,2,2,2,0,0,0,2,2,-4,1,Anthony Gill,WAS,WAS,NOP,,,6,4,4,4
22023,1630264,22300295,"DEC 11, 2023",WAS @ PHI,L,10,1,2,0.5,0,0,0.0,1,2,0.5,1,3,4,0,0,1,2,2,3,2,1,Anthony Gill,WAS,PHI,WAS,,,7,7,3,4
22023,1630264,22301219,"DEC 08, 2023",WAS @ BKN,L,4,1,4,0.25,0,1,0.0,0,0,0.0,3,0,3,0,0,0,0,1,2,-2,1,Anthony Gill,WAS,BKN,WAS,,,5,5,2,3
22023,1630264,22300259,"NOV 29, 2023",WAS @ ORL,L,5,0,1,0.0,0,1,0.0,0,0,0.0,0,1,1,0,0,0,0,0,0,3,1,Anthony Gill,WAS,ORL,WAS,,,1,1,0,1
22023,1630264,22300253,"NOV 27, 2023",WAS @ DET,W,2,0,0,0.0,0,0,0.0,0,0,0.0,0,0,0,0,0,0,0,0,0,0,1,Anthony Gill,WAS,DET,WAS,,,0,0,0,0
22023,1630264,22300241,"NOV 25, 2023",WAS vs. ATL,L,18,4,6,0.667,0,1,0.0,2,2,1.0,1,2,3,1,0,0,2,1,10,-8,1,Anthony Gill,WAS,WAS,ATL,,,14,13,11,4
22023,1630264,22300219,"NOV 20, 2023",WAS vs. MIL,L,1,0,0,0.0,0,0,0.0,0,0,0.0,0,0,0,0,1,0,0,0,0,2,1,Anthony Gill,WAS,WAS,MIL,,,0,0,0,0
22023,1630264,22300028,"NOV 17, 2023",WAS vs. NYK,L,2,0,0,0.0,0,0,0.0,2,2,1.0,0,1,1,1,0,0,0,0,2,-1,1,Anthony Gill,WAS,WAS,NYK,,,4,3,3,2
22023,1630264,22300192,"NOV 15, 2023",WAS vs. DAL,L,5,0,0,0.0,0,0,0.0,0,0,0.0,0,1,1,0,1,0,3,1,0,9,1,Anthony Gill,WAS,WAS,DAL,,,1,1,0,1
22023,1630264,22300157,"NOV 08, 2023",WAS @ CHA,W,4,0,3,0.0,0,0,0.0,0,0,0.0,1,0,1,0,0,0,0,0,0,-4,1,Anthony Gill,WAS,CHA,WAS,,,1,1,0,1
22023,1630264,22300148,"NOV 06, 2023",WAS @ PHI,L,8,2,3,0.667,0,1,0.0,1,2,0.5,1,0,1,0,1,2,0,0,5,6,1,Anthony Gill,WAS,PHI,WAS,,,6,6,5,1
22023,1630264,22300003,"NOV 03, 2023",WAS @ MIA,L,7,2,3,0.667,0,0,0.0,2,2,1.0,1,1,2,0,0,1,1,1,6,18,1,Anthony Gill,WAS,MIA,WAS,,,8,8,6,2
22023,1630264,22300117,"NOV 01, 2023",WAS @ ATL,L,7,1,1,1.0,0,0,0.0,0,0,0.0,0,1,1,2,0,0,1,0,2,17,1,Anthony Gill,WAS,ATL,WAS,,,5,3,4,3
22023,1630264,22300103,"OCT 30, 2023",WAS vs. BOS,L,10,1,3,0.333,0,0,0.0,3,4,0.75,0,2,2,1,0,0,0,2,5,9,1,Anthony Gill,WAS,WAS,BOS,,,8,7,6,3
22023,1631221,22300539,"JAN 12, 2024",DEN vs. NOP,W,2,1,1,1.0,0,0,0.0,0,0,0.0,0,0,0,0,0,0,0,1,2,-6,1,Collin Gillespie,DEN,DEN,NOP,,,2,2,2,0
22023,1631221,22300524,"JAN 10, 2024",DEN @ UTA,L,6,2,3,0.667,1,1,1.0,3,4,0.75,0,1,1,1,0,0,0,0,8,12,1,Collin Gillespie,DEN,UTA,DEN,,,10,9,9,2
22023,1631221,22300502,"JAN 07, 2024",DEN vs. DET,W,2,0,0,0.0,0,0,0.0,0,0,0.0,0,0,0,0,0,0,1,1,0,-6,1,Collin Gillespie,DEN,DEN,DET,,,0,0,0,0
22023,1631221,22300356,"DEC 18, 2023",DEN vs. DAL,W,5,0,1,0.0,0,0,0.0,0,0,0.0,1,0,1,0,0,0,0,1,0,-6,1,Collin Gillespie,DEN,DEN,DAL,,,1,1,0,1
22023,1631221,22300263,"NOV 29, 2023",DEN vs. HOU,W,3,0,1,0.0,0,1,0.0,0,0,0.0,0,0,0,0,0,0,1,0,0,-9,1,Collin Gillespie,DEN,DEN,HOU,,,0,0,0,0
22023,1631221,22300252,"NOV 26, 2023",DEN vs. SAS,W,2,0,0,0.0,0,0,0.0,0,0,0.0,0,0,0,0,0,0,0,0,0,-4,1,Collin Gillespie,DEN,DEN,SAS,,,0,0,0,0
22023,1631221,22300048,"NOV 24, 2023",DEN @ HOU,L,3,0,0,0.0,0,0,0.0,0,0,0.0,0,0,0,0,0,0,1,0,0,-7,1,Collin Gillespie,DEN,HOU,DEN,,,0,0,0,0
22023,1631221,22300210,"NOV 19, 2023",DEN @ CLE,L,3,0,0,0.0,0,0,0.0,0,0,0.0,0,0,0,1,0,0,0,0,0,10,1,Collin Gillespie,DEN,CLE,DEN,,,1,0,1,1
22023,1631221,22300182,"NOV 12, 2023",DEN @ HOU,L,20,3,7,0.429,0,2,0.0,0,0,0.0,0,1,1,3,2,0,1,2,6,0,1,Collin Gillespie,DEN,HOU,DEN,,,10,7,9,4
22023,1631221,22300169,"NOV 08, 2023",DEN vs. GSW,W,16,1,2,0.5,1,2,0.5,0,0,0.0,0,0,0,1,0,0,1,2,3,-10,1,Collin Gillespie,DEN,DEN,GSW,,,4,3,4,1
22023,1631221,22300156,"NOV 06, 2023",DEN vs. NOP,W,17,2,4,0.5,1,3,0.333,1,1,1.0,0,1,1,1,2,0,0,3,6,-1,1,Collin Gillespie,DEN,DEN,NOP,,,8,7,7,2
22023,1631221,22300139,"NOV 04, 2023",DEN vs. CHI,W,12,2,4,0.5,1,3,0.333,0,0,0.0,0,1,1,2,0,0,0,1,5,12,1,Collin Gillespie,DEN,DEN,CHI,,,8,6,7,3
22023,1631221,22300095,"OCT 29, 2023",DEN @ OKC,W,6,0,1,0.0,0,1,0.0,0,0,0.0,0,0,0,0,1,0,0,1,0,2,1,Collin Gillespie,DEN,OKC,DEN,,,0,0,0,0
22023,1631221,22300061,"OCT 24, 2023",DEN vs. LAL,W,1,0,0,0.0,0,0,0.0,0,0,0.0,0,0,0,0,0,0,0,0,0,0,1,Collin Gillespie,DEN,DEN,LAL,,,0,0,0,0
22023,1631367,22300560,"JAN 15, 2024",MEM vs. GSW,W,19,4,7,0.571,3,4,0.75,0,0,0.0,0,2,2,3,2,1,0,0,11,11,1,Jacob Gilyard,MEM,MEM,GSW,,,16,13,14,5
22023,1631367,22300544,"JAN 13, 2024",MEM vs. NYK,L,32,2,8,0.25,1,6,0.167,0,0,0.0,1,1,2,7,2,0,0,4,5,-12,1,Jacob Gilyard,MEM,MEM,NYK,,,14,7,12,9
22023,1631367,22300537,"JAN 12, 2024",MEM vs. LAC,L,20,0,2,0.0,0,2,0.0,0,0,0.0,0,1,1,8,0,0,1,1,0,0,1,Jacob Gilyard,MEM,MEM,LAC,,,9,1,8,9
22023,1631367,22300425,"DEC 28, 2023",MEM @ DEN,L,12,2,3,0.667,2,3,0.667,0,0,0.0,0,0,0,1,0,1,0,0,6,-14,1,Jacob Gilyard,MEM,DEN,MEM,,,7,6,7,1
22023,1631367,22300355,"DEC 18, 2023",MEM @ OKC,L,34,4,9,0.444,4,6,0.667,0,0,0.0,0,1,1,7,1,0,3,2,12,-3,1,Jacob Gilyard,MEM,OKC,MEM,,,20,13,19,8
22023,1631367,22300332,"DEC 15, 2023",MEM vs. HOU,L,16,0,3,0.0,0,2,0.0,0,0,0.0,0,1,1,3,1,0,2,1,0,-4,1,Jacob Gilyard,MEM,MEM,HOU,,,4,1,3,4
22023,1631367,22300314,"DEC 13, 2023",MEM @ HOU,L,13,1,1,1.0,1,1,1.0,0,0,0.0,0,0,0,3,0,0,0,0,3,1,1,Jacob Gilyard,MEM,HOU,MEM,,,6,3,6,3
22023,1631367,22301221,"DEC 08, 2023",MEM vs. MIN,L,4,0,1,0.0,0,1,0.0,0,0,0.0,0,0,0,2,0,0,0,0,0,0,1,Jacob Gilyard,MEM,MEM,MIN,,,2,0,2,2
22023,1631367,22301206,"DEC 06, 2023",MEM @ DET,W,0,0,0,0.0,0,0,0.0,0,0,0.0,0,0,0,0,0,0,0,0,0,0,1,Jacob Gilyard,MEM,DET,MEM,,,0,0,0,0
22023,1631367,22300277,"DEC 01, 2023",MEM @ DAL,W,2,0,0,0.0,0,0,0.0,0,0,0.0,0,0,0,0,0,0,0,0,0,-4,1,Jacob Gilyard,MEM,DAL,MEM,,,0,0,0,0
22023,1631367,22300249,"NOV 26, 2023",MEM vs. MIN,L,16,0,2,0.0,0,2,0.0,0,0,0.0,0,0,0,1,0,0,0,0,0,-21,1,Jacob Gilyard,MEM,MEM,MIN,,,1,0,1,1
22023,1631367,22300044,"NOV 24, 2023",MEM vs. PHX,L,24,2,5,0.4,1,4,0.25,1,1,1.0,0,0,0,5,0,0,2,2,6,-2,1,Jacob Gilyard,MEM,MEM,PHX,,,11,6,11,5
22023,1631367,22300231,"NOV 22, 2023",MEM @ HOU,L,24,2,6,0.333,1,4,0.25,0,0,0.0,1,0,1,4,0,0,0,1,5,-14,1,Jacob Gilyard,MEM,HOU,MEM,,,10,6,9,5
22023,1631367,22300213,"NOV 19, 2023",MEM vs. BOS,L,15,1,2,0.5,1,2,0.5,0,0,0.0,1,1,2,5,2,0,1,1,3,-2,1,Jacob Gilyard,MEM,MEM,BOS,,,10,5,8,7
22023,1631367,22300206,"NOV 18, 2023",MEM @ SAS,W,12,1,2,0.5,1,2,0.5,0,0,0.0,0,0,0,1,0,0,0,3,3,-14,1,Jacob Gilyard,MEM,SAS,MEM,,,4,3,4,1
22023,1631367,22300026,"NOV 14, 2023",MEM @ LAL,L,21,3,5,0.6,3,5,0.6,0,0,0.0,1,2,3,1,2,0,1,2,9,-13,1,Jacob Gilyard,MEM,LAL,MEM,,,13,12,10,4
22023,1631367,22300179,"NOV 12, 2023",MEM @ LAC,W,24,2,6,0.333,2,6,0.333,0,0,0.0,1,4,5,3,3,0,0,3,6,3,1,Jacob Gilyard,MEM,LAC,MEM,,,14,11,9,8
22023,1631367,22300012,"NOV 10, 2023",MEM vs. UTA,L,34,5,10,0.5,4,9,0.444,0,0,0.0,2,2,4,8,1,0,2,2,14,-12,1,Jacob Gilyard,MEM,MEM,UTA,,,26,18,22,12
22023,1631367,22300164,"NOV 08, 2023",MEM vs. MIA,L,15,2,3,0.667,2,3,0.667,0,0,0.0,0,0,0,4,0,0,0,1,6,10,1,Jacob Gilyard,MEM,MEM,MIA,,,10,6,10,4
22023,1631367,22300144,"NOV 05, 2023",MEM @ POR,W,11,0,0,0.0,0,0,0.0,0,0,0.0,0,0,0,2,0,1,1,1,0,-5,1,Jacob Gilyard,MEM,POR,MEM,,,2,0,2,2
22023,1631367,22300007,"NOV 03, 2023",MEM @ POR,L,12,0,0,0.0,0,0,0.0,0,0,0.0,0,0,0,3,0,0,1,0,0,17,1,Jacob Gilyard,MEM,POR,MEM,,,3,0,3,3
22023,1631367,22300125,"NOV 01, 2023",MEM @ UTA,L,20,1,2,0.5,1,2,0.5,0,0,0.0,0,3,3,6,1,0,0,0,3,4,1,Jacob Gilyard,MEM,UTA,MEM,,,12,6,9,9
22023,1631367,22300106,"OCT 30, 2023",MEM vs. DAL,L,1,0,1,0.0,0,0,0.0,0,0,0.0,0,0,0,0,0,0,0,0,0,0,1,Jacob Gilyard,MEM,MEM,DAL,,,0,0,0,0
22023,203497,22300553,"JAN 14, 2024",MIN vs. LAC,W,37,4,5,0.8,0,0,0.0,7,14,0.5,3,15,18,0,0,4,1,4,15,-1,1,Rudy Gobert,MIN,MIN,LAC,,,33,33,15,18
22023,203497,22300538,"JAN 12, 2024",MIN vs. POR,W,28,9,11,0.818,0,0,0.0,6,8,0.75,5,12,17,0,0,2,1,2,24,33,1,Rudy Gobert,MIN,MIN,POR,,,41,41,24,17
22023,203497,22300513,"JAN 09, 2024",MIN @ ORL,W,34,8,10,0.8,0,0,0.0,5,6,0.833,1,11,12,1,1,3,2,3,21,13,1,Rudy Gobert,MIN,ORL,MIN,,,34,33,22,13
22023,203497,22300501,"JAN 07, 2024",MIN @ DAL,L,34,4,9,0.444,0,0,0.0,1,4,0.25,6,11,17,1,1,0,5,4,9,1,1,Rudy Gobert,MIN,DAL,MIN,,,27,26,10,18
22023,203497,22300485,"JAN 05, 2024",MIN @ HOU,W,33,6,7,0.857,0,0,0.0,1,3,0.333,3,9,12,1,2,2,1,2,13,22,1,Rudy Gobert,MIN,HOU,MIN,,,26,25,14,13
22023,203497,22300471,"JAN 03, 2024",MIN vs. NOP,L,24,2,3,0.667,0,0,0.0,1,2,0.5,1,4,5,0,0,1,1,4,5,-16,1,Rudy Gobert,MIN,MIN,NOP,,,10,10,5,5
22023,203497,22300451,"JAN 01, 2024",MIN @ NYK,L,38,3,8,0.375,0,0,0.0,4,6,0.667,2,13,15,1,0,0,1,2,10,-11,1,Rudy Gobert,MIN,NYK,MIN,,,26,25,11,16
22023,203497,22300443,"DEC 30, 2023",MIN vs. LAL,W,38,6,7,0.857,0,0,0.0,1,1,1.0,4,9,13,0,2,1,4,3,13,19,1,Rudy Gobert,MIN,MIN,LAL,,,26,26,13,13
22023,203497,22300423,"DEC 28, 2023",MIN vs. DAL,W,38,7,7,1.0,0,0,0.0,6,7,0.857,2,9,11,2,0,3,2,2,20,3,1,Rudy Gobert,MIN,MIN,DAL,,,33,31,22,13
22023,203497,22300411,"DEC 26, 2023",MIN @ OKC,L,29,2,6,0.333,0,1,0.0,6,8,0.75,0,5,5,0,0,0,1,1,10,-14,1,Rudy Gobert,MIN,OKC,MIN,,,15,15,10,5
22023,203497,22300400,"DEC 23, 2023",MIN @ SAC,W,39,10,13,0.769,0,0,0.0,1,2,0.5,6,11,17,1,0,2,1,3,21,27,1,Rudy Gobert,MIN,SAC,MIN,,,39,38,22,18
22023,203497,22300380,"DEC 21, 2023",MIN vs. LAL,W,37,6,11,0.545,0,0,0.0,3,6,0.5,5,8,13,3,1,3,2,3,15,-1,1,Rudy Gobert,MIN,MIN,LAL,,,31,28,18,16
22023,203497,22300367,"DEC 20, 2023",MIN @ PHI,L,24,3,4,0.75,0,0,0.0,2,2,1.0,2,7,9,1,2,0,0,4,8,6,1,Rudy Gobert,MIN,PHI,MIN,,,18,17,9,10
22023,203497,22300353,"DEC 18, 2023",MIN @ MIA,W,35,3,8,0.375,0,0,0.0,3,4,0.75,3,13,16,2,2,2,1,2,9,4,1,Rudy Gobert,MIN,MIA,MIN,,,27,25,11,18
22023,203497,22300338,"DEC 16, 2023",MIN vs. IND,W,25,2,3,0.667,0,0,0.0,1,4,0.25,2,5,7,1,1,1,2,1,5,3,1,Rudy Gobert,MIN,MIN,IND,,,13,12,6,8
22023,203497,22300321,"DEC 14, 2023",MIN @ DAL,W,30,3,4,0.75,0,0,0.0,2,6,0.333,2,10,12,5,3,1,2,4,8,11,1,Rudy Gobert,MIN,DAL,MIN,,,25,20,13,17
22023,203497,22300301,"DEC 11, 2023",MIN @ NOP,L,25,4,8,0.5,0,0,0.0,0,0,0.0,2,6,8,0,0,2,2,4,8,-20,1,Rudy Gobert,MIN,NOP,MIN,,,16,16,8,8
22023,203497,22301221,"DEC 08, 2023",MIN @ MEM,W,36,6,9,0.667,0,0,0.0,4,4,1.0,9,11,20,1,1,6,2,4,16,25,1,Rudy Gobert,MIN,MEM,MIN,,,37,36,17,21
22023,203497,22301210,"DEC 06, 2023",MIN vs. SAS,W,30,7,8,0.875,0,0,0.0,2,2,1.0,5,15,20,2,0,2,1,3,16,31,1,Rudy Gobert,MIN,MIN,SAS,,,38,36,18,22
22023,203497,22300281,"DEC 02, 2023",MIN @ CHA,W,39,10,12,0.833,0,0,0.0,6,9,0.667,2,10,12,0,0,3,1,1,26,10,1,Rudy Gobert,MIN,CHA,MIN,,,38,38,26,12
22023,203497,22300270,"NOV 30, 2023",MIN vs. UTA,W,37,6,11,0.545,0,0,0.0,3,4,0.75,3,10,13,0,0,3,0,4,15,15,1,Rudy Gobert,MIN,MIN,UTA,,,28,28,15,13
22023,203497,22300058,"NOV 28, 2023",MIN vs. OKC,W,36,6,10,0.6,0,0,0.0,5,6,0.833,6,10,16,0,1,4,1,1,17,-1,1,Rudy Gobert,MIN,MIN,OKC,,,33,33,17,16
22023,203497,22300249,"NOV 26, 2023",MIN @ MEM,W,25,5,7,0.714,0,0,0.0,3,4,0.75,1,3,4,0,0,2,2,5,13,16,1,Rudy Gobert,MIN,MEM,MIN,,,17,17,13,4
22023,203497,22300050,"NOV 24, 2023",MIN vs. SAC,L,36,5,8,0.625,0,0,0.0,2,2,1.0,3,8,11,0,0,2,3,5,12,4,1,Rudy Gobert,MIN,MIN,SAC,,,23,23,12,11
22023,203497,22300232,"NOV 22, 2023",MIN vs. PHI,W,31,6,8,0.75,0,0,0.0,1,2,0.5,3,8,11,3,0,3,2,3,13,1,1,Rudy Gobert,MIN,MIN,PHI,,,27,24,16,14
22023,203497,22300221,"NOV 20, 2023",MIN vs. NYK,W,26,7,7,1.0,0,0,0.0,2,7,0.286,3,4,7,1,0,2,1,2,16,16,1,Rudy Gobert,MIN,MIN,NYK,,,24,23,17,8
22023,203497,22300203,"NOV 18, 2023",MIN @ NOP,W,34,5,7,0.714,0,0,0.0,7,10,0.7,2,9,11,1,2,1,1,2,17,-7,1,Rudy Gobert,MIN,NOP,MIN,,,29,28,18,12
22023,203497,22300197,"NOV 15, 2023",MIN @ PHX,L,25,2,5,0.4,0,0,0.0,0,0,0.0,4,4,8,2,1,2,2,2,4,-25,1,Rudy Gobert,MIN,PHX,MIN,,,14,12,6,10
22023,203497,22300025,"NOV 14, 2023",MIN @ GSW,W,35,2,8,0.25,0,0,0.0,5,6,0.833,6,7,13,2,0,3,2,4,9,8,1,Rudy Gobert,MIN,GSW,MIN,,,24,22,11,15
22023,203497,22300186,"NOV 12, 2023",MIN @ GSW,W,35,4,7,0.571,0,0,0.0,2,8,0.25,4,6,10,3,1,5,2,3,10,-1,1,Rudy Gobert,MIN,GSW,MIN,,,23,20,13,13
22023,203497,22300013,"NOV 10, 2023",MIN @ SAS,W,34,5,10,0.5,0,0,0.0,1,1,1.0,4,6,10,1,1,0,1,3,11,1,1,Rudy Gobert,MIN,SAS,MIN,,,22,21,12,11
22023,203497,22300166,"NOV 08, 2023",MIN vs. NOP,W,32,4,5,0.8,0,0,0.0,9,12,0.75,5,16,21,1,0,2,4,2,17,24,1,Rudy Gobert,MIN,MIN,NOP,,,39,38,18,22
22023,203497,22300154,"NOV 06, 2023",MIN vs. BOS,W,41,6,6,1.0,0,0,0.0,2,11,0.182,2,10,12,1,0,1,2,4,14,24,1,Rudy Gobert,MIN,MIN,BOS,,,27,26,15,13
22023,203497,22300138,"NOV 04, 2023",MIN vs. UTA,W,29,5,10,0.5,0,0,0.0,1,2,0.5,4,6,10,1,0,4,1,3,11,10,1,Rudy Gobert,MIN,MIN,UTA,,,22,21,12,11
22023,203497,22300123,"NOV 01, 2023",MIN vs. DEN,W,32,0,7,0.0,0,0,0.0,4,4,1.0,2,10,12,1,1,2,1,3,4,15,1,Rudy Gobert,MIN,MIN,DEN,,,17,16,5,13
22023,203497,22300104,"OCT 30, 2023",MIN @ ATL,L,31,3,7,0.429,0,0,0.0,8,11,0.727,6,7,13,1,1,2,0,2,14,-13,1,Rudy Gobert,MIN,ATL,MIN,,,28,27,15,14
22023,203497,22300093,"OCT 28, 2023",MIN vs. MIA,W,31,7,9,0.778,0,0,0.0,0,0,0.0,4,10,14,1,1,0,2,1,14,14,1,Rudy Gobert,MIN,MIN,MIA,,,29,28,15,15
22023,203497,22300069,"OCT 25, 2023",MIN @ TOR,L,32,6,12,0.5,0,0,0.0,3,5,0.6,5,8,13,1,2,4,2,3,15,-11,1,Rudy Gobert,MIN,TOR,MIN,,,29,28,16,14
22023,1630692,22300531,"JAN 11, 2024",PHX @ LAL,W,5,0,1,0.0,0,0,0.0,0,0,0.0,0,0,0,1,1,0,1,1,0,-7,1,Jordan Goodwin,PHX,LAL,PHX,,,1,0,1,1
22023,1630692,22300511,"JAN 08, 2024",PHX @ LAC,L,5,2,3,0.667,0,0,0.0,0,0,0.0,0,0,0,0,0,0,0,0,4,-3,1,Jordan Goodwin,PHX,LAC,PHX,,,4,4,4,0
22023,1630692,22300489,"JAN 05, 2024",PHX vs. MIA,W,2,0,1,0.0,0,1,0.0,0,0,0.0,0,0,0,0,0,0,0,0,0,-5,1,Jordan Goodwin,PHX,PHX,MIA,,,0,0,0,0
22023,1630692,22300456,"JAN 01, 2024",PHX vs. POR,W,6,1,2,0.5,0,1,0.0,0,0,0.0,1,0,1,1,1,0,1,0,2,-5,1,Jordan Goodwin,PHX,PHX,POR,,,4,3,3,2
22023,1630692,22300436,"DEC 29, 2023",PHX vs. CHA,W,1,0,0,0.0,0,0,0.0,0,0,0.0,0,0,0,0,0,0,0,0,0,2,1,Jordan Goodwin,PHX,PHX,CHA,,,0,0,0,0
22023,1630692,22300405,"DEC 25, 2023",PHX vs. DAL,L,11,0,3,0.0,0,1,0.0,2,2,1.0,3,0,3,1,0,0,0,0,2,3,1,Jordan Goodwin,PHX,PHX,DAL,,,6,5,3,4
22023,1630692,22300387,"DEC 22, 2023",PHX @ SAC,L,14,1,6,0.167,0,1,0.0,1,2,0.5,2,1,3,0,1,0,1,2,3,5,1,Jordan Goodwin,PHX,SAC,PHX,,,6,6,3,3
22023,1630692,22300363,"DEC 19, 2023",PHX @ POR,L,20,1,7,0.143,0,2,0.0,0,0,0.0,3,3,6,2,0,1,1,2,2,0,1,Jordan Goodwin,PHX,POR,PHX,,,10,8,4,8
22023,1630692,22300347,"DEC 17, 2023",PHX vs. WAS,W,20,3,7,0.429,0,3,0.0,0,0,0.0,3,5,8,6,0,0,2,2,6,17,1,Jordan Goodwin,PHX,PHX,WAS,,,20,14,12,14
22023,1630692,22300333,"DEC 15, 2023",PHX vs. NYK,L,23,1,5,0.2,1,3,0.333,0,0,0.0,0,3,3,9,0,0,1,3,3,-13,1,Jordan Goodwin,PHX,PHX,NYK,,,15,6,12,12
22023,1630692,22300317,"DEC 13, 2023",PHX vs. BKN,L,27,1,6,0.167,0,2,0.0,0,0,0.0,0,0,0,1,1,0,2,1,2,-19,1,Jordan Goodwin,PHX,PHX,BKN,,,3,2,3,1
22023,1630692,22300308,"DEC 12, 2023",PHX vs. GSW,W,30,5,10,0.5,1,5,0.2,5,5,1.0,0,5,5,6,2,1,1,3,16,-10,1,Jordan Goodwin,PHX,PHX,GSW,,,27,21,22,11
22023,1630692,22301228,"DEC 08, 2023",PHX vs. SAC,L,20,3,6,0.5,0,1,0.0,2,2,1.0,2,3,5,6,0,0,2,2,8,-12,1,Jordan Goodwin,PHX,PHX,SAC,,,19,13,14,11
22023,1630692,22301203,"DEC 05, 2023",PHX @ LAL,L,15,3,6,0.5,1,2,0.5,0,0,0.0,2,4,6,1,0,0,1,1,7,1,1,Jordan Goodwin,PHX,LAL,PHX,,,14,13,8,7
22023,1630692,22300288,"DEC 02, 2023",PHX vs. MEM,W,19,2,6,0.333,1,3,0.333,2,2,1.0,1,3,4,1,0,0,1,3,7,-5,1,Jordan Goodwin,PHX,PHX,MEM,,,12,11,8,5
22023,1630692,22300279,"DEC 01, 2023",PHX vs. DEN,L,20,1,3,0.333,0,1,0.0,0,0,0.0,2,4,6,0,0,0,0,1,2,-5,1,Jordan Goodwin,PHX,PHX,DEN,,,8,8,2,6
22023,1630692,22300260,"NOV 29, 2023",PHX @ TOR,L,23,4,8,0.5,1,3,0.333,0,0,0.0,3,3,6,4,0,0,2,2,9,3,1,Jordan Goodwin,PHX,TOR,PHX,,,19,15,13,10
22023,1630692,22300247,"NOV 26, 2023",PHX @ NYK,W,29,6,10,0.6,2,3,0.667,0,0,0.0,3,4,7,5,1,1,0,2,14,7,1,Jordan Goodwin,PHX,NYK,PHX,,,26,21,19,12
22023,1630692,22300044,"NOV 24, 2023",PHX @ MEM,W,20,6,8,0.75,1,3,0.333,1,1,1.0,2,3,5,2,1,0,1,0,14,19,1,Jordan Goodwin,PHX,MEM,PHX,,,21,19,16,7
22023,1630692,22300236,"NOV 22, 2023",PHX vs. GSW,W,1,0,0,0.0,0,0,0.0,0,0,0.0,0,0,0,0,0,0,0,0,0,-5,1,Jordan Goodwin,PHX,PHX,GSW,,,0,0,0,0
22023,1630692,22300041,"NOV 21, 2023",PHX vs. POR,W,5,1,3,0.333,0,1,0.0,0,0,0.0,0,0,0,0,0,0,0,0,2,-9,1,Jordan Goodwin,PHX,PHX,POR,,,2,2,2,0
22023,1630692,22300214,"NOV 19, 2023",PHX @ UTA,W,11,0,0,0.0,0,0,0.0,0,0,0.0,0,3,3,3,1,0,1,0,0,0,1,Jordan Goodwin,PHX,UTA,PHX,,,6,3,3,6
22023,1630692,22300035,"NOV 17, 2023",PHX @ UTA,W,14,1,6,0.167,1,4,0.25,0,0,0.0,0,2,2,4,1,0,0,2,3,13,1,Jordan Goodwin,PHX,UTA,PHX,,,9,5,7,6
22023,1630692,22300197,"NOV 15, 2023",PHX vs. MIN,W,16,1,1,1.0,1,1,1.0,0,0,0.0,0,3,3,3,1,1,0,2,3,6,1,Jordan Goodwin,PHX,PHX,MIN,,,9,6,6,6
22023,1630692,22300185,"NOV 12, 2023",PHX vs. OKC,L,29,4,10,0.4,3,7,0.429,0,0,0.0,1,4,5,3,1,1,1,2,11,3,1,Jordan Goodwin,PHX,PHX,OKC,,,19,16,14,8
22023,1630692,22300015,"NOV 10, 2023",PHX vs. LAL,L,7,1,3,0.333,1,3,0.333,0,0,0.0,1,1,2,0,0,0,0,0,3,-13,1,Jordan Goodwin,PHX,PHX,LAL,,,5,5,3,2
22023,1630692,22300162,"NOV 08, 2023",PHX @ CHI,W,17,2,5,0.4,2,3,0.667,0,0,0.0,1,1,2,0,0,0,0,1,6,2,1,Jordan Goodwin,PHX,CHI,PHX,,,8,8,6,2
22023,1630692,22300140,"NOV 05, 2023",PHX @ DET,W,21,2,7,0.286,2,4,0.5,2,2,1.0,0,7,7,3,1,1,2,2,8,12,1,Jordan Goodwin,PHX,DET,PHX,,,18,15,11,10
22023,1630692,22300132,"NOV 04, 2023",PHX @ PHI,L,16,2,10,0.2,1,6,0.167,1,2,0.5,2,1,3,0,2,2,0,0,6,5,1,Jordan Goodwin,PHX,PHI,PHX,,,9,9,6,3
22023,1630692,22300131,"NOV 02, 2023",PHX vs. SAS,L,10,1,3,0.333,1,2,0.5,0,0,0.0,1,0,1,3,1,0,1,0,3,-13,1,Jordan Goodwin,PHX,PHX,SAS,,,7,4,6,4
22023,1630692,22300113,"OCT 31, 2023",PHX vs. SAS,L,15,3,7,0.429,0,2,0.0,0,0,0.0,2,2,4,0,1,0,1,3,6,-2,1,Jordan Goodwin,PHX,PHX,SAS,,,10,10,6,4
22023,1630692,22300094,"OCT 28, 2023",PHX vs. UTA,W,25,2,9,0.222,2,5,0.4,6,6,1.0,2,3,5,5,1,0,2,2,12,3,1,Jordan Goodwin,PHX,PHX,UTA,,,22,17,17,10
22023,1630692,22300076,"OCT 26, 2023",PHX @ LAL,L,30,6,15,0.4,1,5,0.2,1,3,0.333,0,6,6,2,2,0,1,2,14,8,1,Jordan Goodwin,PHX,LAL,PHX,,,22,20,16,8
22023,1630692,22300062,"OCT 24, 2023",PHX @ GSW,W,14,1,4,0.25,0,1,0.0,0,0,0.0,1,3,4,3,1,0,2,0,2,7,1,Jordan Goodwin,PHX,GSW,PHX,,,9,6,5,7
22023,203932,22300550,"JAN 14, 2024",DEN vs. IND,W,37,7,10,0.7,0,1,0.0,6,8,0.75,1,9,10,3,0,0,2,0,20,17,1,Aaron Gordon,DEN,DEN,IND,13.5,Points,33,30,23,13
22023,203932,22300550,"JAN 14, 2024",DEN vs. IND,W,37,7,10,0.7,0,1,0.0,6,8,0.75,1,9,10,3,0,0,2,0,20,17,1,Aaron Gordon,DEN,DEN,IND,6.0,Rebounds,33,30,23,13
22023,203932,22300550,"JAN 14, 2024",DEN vs. IND,W,37,7,10,0.7,0,1,0.0,6,8,0.75,1,9,10,3,0,0,2,0,20,17,1,Aaron Gordon,DEN,DEN,IND,22.5,Pts+Rebs+Asts,33,30,23,13
22023,203932,22300550,"JAN 14, 2024",DEN vs. IND,W,37,7,10,0.7,0,1,0.0,6,8,0.75,1,9,10,3,0,0,2,0,20,17,1,Aaron Gordon,DEN,DEN,IND,25.5,Fantasy Score,33,30,23,13
22023,203932,22300550,"JAN 14, 2024",DEN vs. IND,W,37,7,10,0.7,0,1,0.0,6,8,0.75,1,9,10,3,0,0,2,0,20,17,1,Aaron Gordon,DEN,DEN,IND,19.5,Pts+Rebs,33,30,23,13
22023,203932,22300550,"JAN 14, 2024",DEN vs. IND,W,37,7,10,0.7,0,1,0.0,6,8,0.75,1,9,10,3,0,0,2,0,20,17,1,Aaron Gordon,DEN,DEN,IND,15.5,Pts+Asts,33,30,23,13
22023,203932,22300550,"JAN 14, 2024",DEN vs. IND,W,37,7,10,0.7,0,1,0.0,6,8,0.75,1,9,10,3,0,0,2,0,20,17,1,Aaron Gordon,DEN,DEN,IND,8.5,Rebs+Asts,33,30,23,13
22023,203932,22300539,"JAN 12, 2024",DEN vs. NOP,W,31,7,12,0.583,0,2,0.0,1,3,0.333,3,2,5,2,0,0,2,2,15,9,1,Aaron Gordon,DEN,DEN,NOP,13.5,Points,22,20,17,7
22023,203932,22300539,"JAN 12, 2024",DEN vs. NOP,W,31,7,12,0.583,0,2,0.0,1,3,0.333,3,2,5,2,0,0,2,2,15,9,1,Aaron Gordon,DEN,DEN,NOP,6.0,Rebounds,22,20,17,7
22023,203932,22300539,"JAN 12, 2024",DEN vs. NOP,W,31,7,12,0.583,0,2,0.0,1,3,0.333,3,2,5,2,0,0,2,2,15,9,1,Aaron Gordon,DEN,DEN,NOP,22.5,Pts+Rebs+Asts,22,20,17,7
22023,203932,22300539,"JAN 12, 2024",DEN vs. NOP,W,31,7,12,0.583,0,2,0.0,1,3,0.333,3,2,5,2,0,0,2,2,15,9,1,Aaron Gordon,DEN,DEN,NOP,25.5,Fantasy Score,22,20,17,7
22023,203932,22300539,"JAN 12, 2024",DEN vs. NOP,W,31,7,12,0.583,0,2,0.0,1,3,0.333,3,2,5,2,0,0,2,2,15,9,1,Aaron Gordon,DEN,DEN,NOP,19.5,Pts+Rebs,22,20,17,7
22023,203932,22300539,"JAN 12, 2024",DEN vs. NOP,W,31,7,12,0.583,0,2,0.0,1,3,0.333,3,2,5,2,0,0,2,2,15,9,1,Aaron Gordon,DEN,DEN,NOP,15.5,Pts+Asts,22,20,17,7
22023,203932,22300539,"JAN 12, 2024",DEN vs. NOP,W,31,7,12,0.583,0,2,0.0,1,3,0.333,3,2,5,2,0,0,2,2,15,9,1,Aaron Gordon,DEN,DEN,NOP,8.5,Rebs+Asts,22,20,17,7
22023,203932,22300524,"JAN 10, 2024",DEN @ UTA,L,29,5,6,0.833,2,2,1.0,0,0,0.0,2,3,5,4,1,0,2,4,12,-20,1,Aaron Gordon,DEN,UTA,DEN,13.5,Points,21,17,16,9
22023,203932,22300524,"JAN 10, 2024",DEN @ UTA,L,29,5,6,0.833,2,2,1.0,0,0,0.0,2,3,5,4,1,0,2,4,12,-20,1,Aaron Gordon,DEN,UTA,DEN,6.0,Rebounds,21,17,16,9
22023,203932,22300524,"JAN 10, 2024",DEN @ UTA,L,29,5,6,0.833,2,2,1.0,0,0,0.0,2,3,5,4,1,0,2,4,12,-20,1,Aaron Gordon,DEN,UTA,DEN,22.5,Pts+Rebs+Asts,21,17,16,9
22023,203932,22300524,"JAN 10, 2024",DEN @ UTA,L,29,5,6,0.833,2,2,1.0,0,0,0.0,2,3,5,4,1,0,2,4,12,-20,1,Aaron Gordon,DEN,UTA,DEN,25.5,Fantasy Score,21,17,16,9
22023,203932,22300524,"JAN 10, 2024",DEN @ UTA,L,29,5,6,0.833,2,2,1.0,0,0,0.0,2,3,5,4,1,0,2,4,12,-20,1,Aaron Gordon,DEN,UTA,DEN,19.5,Pts+Rebs,21,17,16,9
22023,203932,22300524,"JAN 10, 2024",DEN @ UTA,L,29,5,6,0.833,2,2,1.0,0,0,0.0,2,3,5,4,1,0,2,4,12,-20,1,Aaron Gordon,DEN,UTA,DEN,15.5,Pts+Asts,21,17,16,9
22023,203932,22300524,"JAN 10, 2024",DEN @ UTA,L,29,5,6,0.833,2,2,1.0,0,0,0.0,2,3,5,4,1,0,2,4,12,-20,1,Aaron Gordon,DEN,UTA,DEN,8.5,Rebs+Asts,21,17,16,9
22023,203932,22300502,"JAN 07, 2024",DEN vs. DET,W,20,3,4,0.75,0,0,0.0,2,2,1.0,1,0,1,1,1,0,0,0,8,10,1,Aaron Gordon,DEN,DEN,DET,13.5,Points,10,9,9,2
22023,203932,22300502,"JAN 07, 2024",DEN vs. DET,W,20,3,4,0.75,0,0,0.0,2,2,1.0,1,0,1,1,1,0,0,0,8,10,1,Aaron Gordon,DEN,DEN,DET,6.0,Rebounds,10,9,9,2
22023,203932,22300502,"JAN 07, 2024",DEN vs. DET,W,20,3,4,0.75,0,0,0.0,2,2,1.0,1,0,1,1,1,0,0,0,8,10,1,Aaron Gordon,DEN,DEN,DET,22.5,Pts+Rebs+Asts,10,9,9,2
22023,203932,22300502,"JAN 07, 2024",DEN vs. DET,W,20,3,4,0.75,0,0,0.0,2,2,1.0,1,0,1,1,1,0,0,0,8,10,1,Aaron Gordon,DEN,DEN,DET,25.5,Fantasy Score,10,9,9,2
22023,203932,22300502,"JAN 07, 2024",DEN vs. DET,W,20,3,4,0.75,0,0,0.0,2,2,1.0,1,0,1,1,1,0,0,0,8,10,1,Aaron Gordon,DEN,DEN,DET,19.5,Pts+Rebs,10,9,9,2
22023,203932,22300502,"JAN 07, 2024",DEN vs. DET,W,20,3,4,0.75,0,0,0.0,2,2,1.0,1,0,1,1,1,0,0,0,8,10,1,Aaron Gordon,DEN,DEN,DET,15.5,Pts+Asts,10,9,9,2
22023,203932,22300502,"JAN 07, 2024",DEN vs. DET,W,20,3,4,0.75,0,0,0.0,2,2,1.0,1,0,1,1,1,0,0,0,8,10,1,Aaron Gordon,DEN,DEN,DET,8.5,Rebs+Asts,10,9,9,2
22023,203932,22300488,"JAN 05, 2024",DEN vs. ORL,L,36,5,8,0.625,2,4,0.5,4,5,0.8,3,5,8,3,0,0,1,4,16,-4,1,Aaron Gordon,DEN,DEN,ORL,13.5,Points,27,24,19,11
22023,203932,22300488,"JAN 05, 2024",DEN vs. ORL,L,36,5,8,0.625,2,4,0.5,4,5,0.8,3,5,8,3,0,0,1,4,16,-4,1,Aaron Gordon,DEN,DEN,ORL,6.0,Rebounds,27,24,19,11
22023,203932,22300488,"JAN 05, 2024",DEN vs. ORL,L,36,5,8,0.625,2,4,0.5,4,5,0.8,3,5,8,3,0,0,1,4,16,-4,1,Aaron Gordon,DEN,DEN,ORL,22.5,Pts+Rebs+Asts,27,24,19,11
22023,203932,22300488,"JAN 05, 2024",DEN vs. ORL,L,36,5,8,0.625,2,4,0.5,4,5,0.8,3,5,8,3,0,0,1,4,16,-4,1,Aaron Gordon,DEN,DEN,ORL,25.5,Fantasy Score,27,24,19,11
22023,203932,22300488,"JAN 05, 2024",DEN vs. ORL,L,36,5,8,0.625,2,4,0.5,4,5,0.8,3,5,8,3,0,0,1,4,16,-4,1,Aaron Gordon,DEN,DEN,ORL,19.5,Pts+Rebs,27,24,19,11
22023,203932,22300488,"JAN 05, 2024",DEN vs. ORL,L,36,5,8,0.625,2,4,0.5,4,5,0.8,3,5,8,3,0,0,1,4,16,-4,1,Aaron Gordon,DEN,DEN,ORL,15.5,Pts+Asts,27,24,19,11
22023,203932,22300488,"JAN 05, 2024",DEN vs. ORL,L,36,5,8,0.625,2,4,0.5,4,5,0.8,3,5,8,3,0,0,1,4,16,-4,1,Aaron Gordon,DEN,DEN,ORL,8.5,Rebs+Asts,27,24,19,11
22023,203932,22300478,"JAN 04, 2024",DEN @ GSW,W,35,11,17,0.647,2,4,0.5,6,7,0.857,5,4,9,2,0,1,0,2,30,6,1,Aaron Gordon,DEN,GSW,DEN,13.5,Points,41,39,32,11
22023,203932,22300478,"JAN 04, 2024",DEN @ GSW,W,35,11,17,0.647,2,4,0.5,6,7,0.857,5,4,9,2,0,1,0,2,30,6,1,Aaron Gordon,DEN,GSW,DEN,6.0,Rebounds,41,39,32,11
22023,203932,22300478,"JAN 04, 2024",DEN @ GSW,W,35,11,17,0.647,2,4,0.5,6,7,0.857,5,4,9,2,0,1,0,2,30,6,1,Aaron Gordon,DEN,GSW,DEN,22.5,Pts+Rebs+Asts,41,39,32,11
22023,203932,22300478,"JAN 04, 2024",DEN @ GSW,W,35,11,17,0.647,2,4,0.5,6,7,0.857,5,4,9,2,0,1,0,2,30,6,1,Aaron Gordon,DEN,GSW,DEN,25.5,Fantasy Score,41,39,32,11
22023,203932,22300478,"JAN 04, 2024",DEN @ GSW,W,35,11,17,0.647,2,4,0.5,6,7,0.857,5,4,9,2,0,1,0,2,30,6,1,Aaron Gordon,DEN,GSW,DEN,19.5,Pts+Rebs,41,39,32,11
22023,203932,22300478,"JAN 04, 2024",DEN @ GSW,W,35,11,17,0.647,2,4,0.5,6,7,0.857,5,4,9,2,0,1,0,2,30,6,1,Aaron Gordon,DEN,GSW,DEN,15.5,Pts+Asts,41,39,32,11
22023,203932,22300478,"JAN 04, 2024",DEN @ GSW,W,35,11,17,0.647,2,4,0.5,6,7,0.857,5,4,9,2,0,1,0,2,30,6,1,Aaron Gordon,DEN,GSW,DEN,8.5,Rebs+Asts,41,39,32,11
22023,203932,22300455,"JAN 01, 2024",DEN vs. CHA,W,25,4,5,0.8,1,1,1.0,1,2,0.5,1,1,2,0,1,1,0,0,10,29,1,Aaron Gordon,DEN,DEN,CHA,13.5,Points,12,12,10,2
22023,203932,22300455,"JAN 01, 2024",DEN vs. CHA,W,25,4,5,0.8,1,1,1.0,1,2,0.5,1,1,2,0,1,1,0,0,10,29,1,Aaron Gordon,DEN,DEN,CHA,6.0,Rebounds,12,12,10,2
22023,203932,22300455,"JAN 01, 2024",DEN vs. CHA,W,25,4,5,0.8,1,1,1.0,1,2,0.5,1,1,2,0,1,1,0,0,10,29,1,Aaron Gordon,DEN,DEN,CHA,22.5,Pts+Rebs+Asts,12,12,10,2
22023,203932,22300455,"JAN 01, 2024",DEN vs. CHA,W,25,4,5,0.8,1,1,1.0,1,2,0.5,1,1,2,0,1,1,0,0,10,29,1,Aaron Gordon,DEN,DEN,CHA,25.5,Fantasy Score,12,12,10,2
22023,203932,22300455,"JAN 01, 2024",DEN vs. CHA,W,25,4,5,0.8,1,1,1.0,1,2,0.5,1,1,2,0,1,1,0,0,10,29,1,Aaron Gordon,DEN,DEN,CHA,19.5,Pts+Rebs,12,12,10,2
22023,203932,22300455,"JAN 01, 2024",DEN vs. CHA,W,25,4,5,0.8,1,1,1.0,1,2,0.5,1,1,2,0,1,1,0,0,10,29,1,Aaron Gordon,DEN,DEN,CHA,15.5,Pts+Asts,12,12,10,2
22023,203932,22300455,"JAN 01, 2024",DEN vs. CHA,W,25,4,5,0.8,1,1,1.0,1,2,0.5,1,1,2,0,1,1,0,0,10,29,1,Aaron Gordon,DEN,DEN,CHA,8.5,Rebs+Asts,12,12,10,2
22023,203932,22300402,"DEC 25, 2023",DEN vs. GSW,W,32,7,10,0.7,1,4,0.25,1,4,0.25,4,6,10,3,1,0,2,2,16,13,1,Aaron Gordon,DEN,DEN,GSW,13.5,Points,29,26,19,13
22023,203932,22300402,"DEC 25, 2023",DEN vs. GSW,W,32,7,10,0.7,1,4,0.25,1,4,0.25,4,6,10,3,1,0,2,2,16,13,1,Aaron Gordon,DEN,DEN,GSW,6.0,Rebounds,29,26,19,13
22023,203932,22300402,"DEC 25, 2023",DEN vs. GSW,W,32,7,10,0.7,1,4,0.25,1,4,0.25,4,6,10,3,1,0,2,2,16,13,1,Aaron Gordon,DEN,DEN,GSW,22.5,Pts+Rebs+Asts,29,26,19,13
22023,203932,22300402,"DEC 25, 2023",DEN vs. GSW,W,32,7,10,0.7,1,4,0.25,1,4,0.25,4,6,10,3,1,0,2,2,16,13,1,Aaron Gordon,DEN,DEN,GSW,25.5,Fantasy Score,29,26,19,13
22023,203932,22300402,"DEC 25, 2023",DEN vs. GSW,W,32,7,10,0.7,1,4,0.25,1,4,0.25,4,6,10,3,1,0,2,2,16,13,1,Aaron Gordon,DEN,DEN,GSW,19.5,Pts+Rebs,29,26,19,13
22023,203932,22300402,"DEC 25, 2023",DEN vs. GSW,W,32,7,10,0.7,1,4,0.25,1,4,0.25,4,6,10,3,1,0,2,2,16,13,1,Aaron Gordon,DEN,DEN,GSW,15.5,Pts+Asts,29,26,19,13
22023,203932,22300402,"DEC 25, 2023",DEN vs. GSW,W,32,7,10,0.7,1,4,0.25,1,4,0.25,4,6,10,3,1,0,2,2,16,13,1,Aaron Gordon,DEN,DEN,GSW,8.5,Rebs+Asts,29,26,19,13
22023,203932,22300390,"DEC 23, 2023",DEN @ CHA,W,32,5,11,0.455,0,0,0.0,4,5,0.8,2,0,2,1,1,1,2,1,14,12,1,Aaron Gordon,DEN,CHA,DEN,13.5,Points,17,16,15,3
22023,203932,22300390,"DEC 23, 2023",DEN @ CHA,W,32,5,11,0.455,0,0,0.0,4,5,0.8,2,0,2,1,1,1,2,1,14,12,1,Aaron Gordon,DEN,CHA,DEN,6.0,Rebounds,17,16,15,3
22023,203932,22300390,"DEC 23, 2023",DEN @ CHA,W,32,5,11,0.455,0,0,0.0,4,5,0.8,2,0,2,1,1,1,2,1,14,12,1,Aaron Gordon,DEN,CHA,DEN,22.5,Pts+Rebs+Asts,17,16,15,3
22023,203932,22300390,"DEC 23, 2023",DEN @ CHA,W,32,5,11,0.455,0,0,0.0,4,5,0.8,2,0,2,1,1,1,2,1,14,12,1,Aaron Gordon,DEN,CHA,DEN,25.5,Fantasy Score,17,16,15,3
22023,203932,22300390,"DEC 23, 2023",DEN @ CHA,W,32,5,11,0.455,0,0,0.0,4,5,0.8,2,0,2,1,1,1,2,1,14,12,1,Aaron Gordon,DEN,CHA,DEN,19.5,Pts+Rebs,17,16,15,3
22023,203932,22300390,"DEC 23, 2023",DEN @ CHA,W,32,5,11,0.455,0,0,0.0,4,5,0.8,2,0,2,1,1,1,2,1,14,12,1,Aaron Gordon,DEN,CHA,DEN,15.5,Pts+Asts,17,16,15,3
22023,203932,22300390,"DEC 23, 2023",DEN @ CHA,W,32,5,11,0.455,0,0,0.0,4,5,0.8,2,0,2,1,1,1,2,1,14,12,1,Aaron Gordon,DEN,CHA,DEN,8.5,Rebs+Asts,17,16,15,3
22023,203932,22300383,"DEC 22, 2023",DEN @ BKN,W,32,5,6,0.833,0,0,0.0,8,9,0.889,2,3,5,2,1,0,1,1,18,19,1,Aaron Gordon,DEN,BKN,DEN,13.5,Points,25,23,20,7
22023,203932,22300383,"DEC 22, 2023",DEN @ BKN,W,32,5,6,0.833,0,0,0.0,8,9,0.889,2,3,5,2,1,0,1,1,18,19,1,Aaron Gordon,DEN,BKN,DEN,6.0,Rebounds,25,23,20,7
22023,203932,22300383,"DEC 22, 2023",DEN @ BKN,W,32,5,6,0.833,0,0,0.0,8,9,0.889,2,3,5,2,1,0,1,1,18,19,1,Aaron Gordon,DEN,BKN,DEN,22.5,Pts+Rebs+Asts,25,23,20,7
22023,203932,22300383,"DEC 22, 2023",DEN @ BKN,W,32,5,6,0.833,0,0,0.0,8,9,0.889,2,3,5,2,1,0,1,1,18,19,1,Aaron Gordon,DEN,BKN,DEN,25.5,Fantasy Score,25,23,20,7
22023,203932,22300383,"DEC 22, 2023",DEN @ BKN,W,32,5,6,0.833,0,0,0.0,8,9,0.889,2,3,5,2,1,0,1,1,18,19,1,Aaron Gordon,DEN,BKN,DEN,19.5,Pts+Rebs,25,23,20,7
22023,203932,22300383,"DEC 22, 2023",DEN @ BKN,W,32,5,6,0.833,0,0,0.0,8,9,0.889,2,3,5,2,1,0,1,1,18,19,1,Aaron Gordon,DEN,BKN,DEN,15.5,Pts+Asts,25,23,20,7
22023,203932,22300383,"DEC 22, 2023",DEN @ BKN,W,32,5,6,0.833,0,0,0.0,8,9,0.889,2,3,5,2,1,0,1,1,18,19,1,Aaron Gordon,DEN,BKN,DEN,8.5,Rebs+Asts,25,23,20,7
22023,203932,22300369,"DEC 20, 2023",DEN @ TOR,W,30,6,9,0.667,0,1,0.0,0,0,0.0,3,2,5,2,0,0,1,1,12,14,1,Aaron Gordon,DEN,TOR,DEN,13.5,Points,19,17,14,7
22023,203932,22300369,"DEC 20, 2023",DEN @ TOR,W,30,6,9,0.667,0,1,0.0,0,0,0.0,3,2,5,2,0,0,1,1,12,14,1,Aaron Gordon,DEN,TOR,DEN,6.0,Rebounds,19,17,14,7
22023,203932,22300369,"DEC 20, 2023",DEN @ TOR,W,30,6,9,0.667,0,1,0.0,0,0,0.0,3,2,5,2,0,0,1,1,12,14,1,Aaron Gordon,DEN,TOR,DEN,22.5,Pts+Rebs+Asts,19,17,14,7
22023,203932,22300369,"DEC 20, 2023",DEN @ TOR,W,30,6,9,0.667,0,1,0.0,0,0,0.0,3,2,5,2,0,0,1,1,12,14,1,Aaron Gordon,DEN,TOR,DEN,25.5,Fantasy Score,19,17,14,7
22023,203932,22300369,"DEC 20, 2023",DEN @ TOR,W,30,6,9,0.667,0,1,0.0,0,0,0.0,3,2,5,2,0,0,1,1,12,14,1,Aaron Gordon,DEN,TOR,DEN,19.5,Pts+Rebs,19,17,14,7
22023,203932,22300369,"DEC 20, 2023",DEN @ TOR,W,30,6,9,0.667,0,1,0.0,0,0,0.0,3,2,5,2,0,0,1,1,12,14,1,Aaron Gordon,DEN,TOR,DEN,15.5,Pts+Asts,19,17,14,7
22023,203932,22300369,"DEC 20, 2023",DEN @ TOR,W,30,6,9,0.667,0,1,0.0,0,0,0.0,3,2,5,2,0,0,1,1,12,14,1,Aaron Gordon,DEN,TOR,DEN,8.5,Rebs+Asts,19,17,14,7
22023,203932,22300356,"DEC 18, 2023",DEN vs. DAL,W,24,7,9,0.778,2,3,0.667,5,6,0.833,1,4,5,5,1,0,0,1,21,18,1,Aaron Gordon,DEN,DEN,DAL,13.5,Points,31,26,26,10
22023,203932,22300356,"DEC 18, 2023",DEN vs. DAL,W,24,7,9,0.778,2,3,0.667,5,6,0.833,1,4,5,5,1,0,0,1,21,18,1,Aaron Gordon,DEN,DEN,DAL,6.0,Rebounds,31,26,26,10
22023,203932,22300356,"DEC 18, 2023",DEN vs. DAL,W,24,7,9,0.778,2,3,0.667,5,6,0.833,1,4,5,5,1,0,0,1,21,18,1,Aaron Gordon,DEN,DEN,DAL,22.5,Pts+Rebs+Asts,31,26,26,10
22023,203932,22300356,"DEC 18, 2023",DEN vs. DAL,W,24,7,9,0.778,2,3,0.667,5,6,0.833,1,4,5,5,1,0,0,1,21,18,1,Aaron Gordon,DEN,DEN,DAL,25.5,Fantasy Score,31,26,26,10
22023,203932,22300356,"DEC 18, 2023",DEN vs. DAL,W,24,7,9,0.778,2,3,0.667,5,6,0.833,1,4,5,5,1,0,0,1,21,18,1,Aaron Gordon,DEN,DEN,DAL,19.5,Pts+Rebs,31,26,26,10
22023,203932,22300356,"DEC 18, 2023",DEN vs. DAL,W,24,7,9,0.778,2,3,0.667,5,6,0.833,1,4,5,5,1,0,0,1,21,18,1,Aaron Gordon,DEN,DEN,DAL,15.5,Pts+Asts,31,26,26,10
22023,203932,22300356,"DEC 18, 2023",DEN vs. DAL,W,24,7,9,0.778,2,3,0.667,5,6,0.833,1,4,5,5,1,0,0,1,21,18,1,Aaron Gordon,DEN,DEN,DAL,8.5,Rebs+Asts,31,26,26,10
22023,203932,22300340,"DEC 16, 2023",DEN vs. OKC,L,33,5,10,0.5,0,0,0.0,6,7,0.857,6,3,9,5,2,0,0,2,16,-7,1,Aaron Gordon,DEN,DEN,OKC,13.5,Points,30,25,21,14
22023,203932,22300340,"DEC 16, 2023",DEN vs. OKC,L,33,5,10,0.5,0,0,0.0,6,7,0.857,6,3,9,5,2,0,0,2,16,-7,1,Aaron Gordon,DEN,DEN,OKC,6.0,Rebounds,30,25,21,14
22023,203932,22300340,"DEC 16, 2023",DEN vs. OKC,L,33,5,10,0.5,0,0,0.0,6,7,0.857,6,3,9,5,2,0,0,2,16,-7,1,Aaron Gordon,DEN,DEN,OKC,22.5,Pts+Rebs+Asts,30,25,21,14
22023,203932,22300340,"DEC 16, 2023",DEN vs. OKC,L,33,5,10,0.5,0,0,0.0,6,7,0.857,6,3,9,5,2,0,0,2,16,-7,1,Aaron Gordon,DEN,DEN,OKC,25.5,Fantasy Score,30,25,21,14
22023,203932,22300340,"DEC 16, 2023",DEN vs. OKC,L,33,5,10,0.5,0,0,0.0,6,7,0.857,6,3,9,5,2,0,0,2,16,-7,1,Aaron Gordon,DEN,DEN,OKC,19.5,Pts+Rebs,30,25,21,14
22023,203932,22300340,"DEC 16, 2023",DEN vs. OKC,L,33,5,10,0.5,0,0,0.0,6,7,0.857,6,3,9,5,2,0,0,2,16,-7,1,Aaron Gordon,DEN,DEN,OKC,15.5,Pts+Asts,30,25,21,14
22023,203932,22300340,"DEC 16, 2023",DEN vs. OKC,L,33,5,10,0.5,0,0,0.0,6,7,0.857,6,3,9,5,2,0,0,2,16,-7,1,Aaron Gordon,DEN,DEN,OKC,8.5,Rebs+Asts,30,25,21,14
22023,203932,22300322,"DEC 14, 2023",DEN vs. BKN,W,24,6,9,0.667,0,1,0.0,1,1,1.0,0,3,3,2,1,1,2,0,13,16,1,Aaron Gordon,DEN,DEN,BKN,13.5,Points,18,16,15,5
22023,203932,22300322,"DEC 14, 2023",DEN vs. BKN,W,24,6,9,0.667,0,1,0.0,1,1,1.0,0,3,3,2,1,1,2,0,13,16,1,Aaron Gordon,DEN,DEN,BKN,6.0,Rebounds,18,16,15,5
22023,203932,22300322,"DEC 14, 2023",DEN vs. BKN,W,24,6,9,0.667,0,1,0.0,1,1,1.0,0,3,3,2,1,1,2,0,13,16,1,Aaron Gordon,DEN,DEN,BKN,22.5,Pts+Rebs+Asts,18,16,15,5
22023,203932,22300322,"DEC 14, 2023",DEN vs. BKN,W,24,6,9,0.667,0,1,0.0,1,1,1.0,0,3,3,2,1,1,2,0,13,16,1,Aaron Gordon,DEN,DEN,BKN,25.5,Fantasy Score,18,16,15,5
22023,203932,22300322,"DEC 14, 2023",DEN vs. BKN,W,24,6,9,0.667,0,1,0.0,1,1,1.0,0,3,3,2,1,1,2,0,13,16,1,Aaron Gordon,DEN,DEN,BKN,19.5,Pts+Rebs,18,16,15,5
22023,203932,22300322,"DEC 14, 2023",DEN vs. BKN,W,24,6,9,0.667,0,1,0.0,1,1,1.0,0,3,3,2,1,1,2,0,13,16,1,Aaron Gordon,DEN,DEN,BKN,15.5,Pts+Asts,18,16,15,5
22023,203932,22300322,"DEC 14, 2023",DEN vs. BKN,W,24,6,9,0.667,0,1,0.0,1,1,1.0,0,3,3,2,1,1,2,0,13,16,1,Aaron Gordon,DEN,DEN,BKN,8.5,Rebs+Asts,18,16,15,5
22023,203932,22300307,"DEC 12, 2023",DEN @ CHI,W,32,6,13,0.462,1,2,0.5,1,2,0.5,5,2,7,6,0,0,0,1,14,8,1,Aaron Gordon,DEN,CHI,DEN,13.5,Points,27,21,20,13
22023,203932,22300307,"DEC 12, 2023",DEN @ CHI,W,32,6,13,0.462,1,2,0.5,1,2,0.5,5,2,7,6,0,0,0,1,14,8,1,Aaron Gordon,DEN,CHI,DEN,6.0,Rebounds,27,21,20,13
22023,203932,22300307,"DEC 12, 2023",DEN @ CHI,W,32,6,13,0.462,1,2,0.5,1,2,0.5,5,2,7,6,0,0,0,1,14,8,1,Aaron Gordon,DEN,CHI,DEN,22.5,Pts+Rebs+Asts,27,21,20,13
22023,203932,22300307,"DEC 12, 2023",DEN @ CHI,W,32,6,13,0.462,1,2,0.5,1,2,0.5,5,2,7,6,0,0,0,1,14,8,1,Aaron Gordon,DEN,CHI,DEN,25.5,Fantasy Score,27,21,20,13
22023,203932,22300307,"DEC 12, 2023",DEN @ CHI,W,32,6,13,0.462,1,2,0.5,1,2,0.5,5,2,7,6,0,0,0,1,14,8,1,Aaron Gordon,DEN,CHI,DEN,19.5,Pts+Rebs,27,21,20,13
22023,203932,22300307,"DEC 12, 2023",DEN @ CHI,W,32,6,13,0.462,1,2,0.5,1,2,0.5,5,2,7,6,0,0,0,1,14,8,1,Aaron Gordon,DEN,CHI,DEN,15.5,Pts+Asts,27,21,20,13
22023,203932,22300307,"DEC 12, 2023",DEN @ CHI,W,32,6,13,0.462,1,2,0.5,1,2,0.5,5,2,7,6,0,0,0,1,14,8,1,Aaron Gordon,DEN,CHI,DEN,8.5,Rebs+Asts,27,21,20,13
22023,203932,22300296,"DEC 11, 2023",DEN @ ATL,W,29,7,10,0.7,0,0,0.0,4,5,0.8,7,5,12,1,0,0,2,2,18,9,1,Aaron Gordon,DEN,ATL,DEN,13.5,Points,31,30,19,13
22023,203932,22300296,"DEC 11, 2023",DEN @ ATL,W,29,7,10,0.7,0,0,0.0,4,5,0.8,7,5,12,1,0,0,2,2,18,9,1,Aaron Gordon,DEN,ATL,DEN,6.0,Rebounds,31,30,19,13
22023,203932,22300296,"DEC 11, 2023",DEN @ ATL,W,29,7,10,0.7,0,0,0.0,4,5,0.8,7,5,12,1,0,0,2,2,18,9,1,Aaron Gordon,DEN,ATL,DEN,22.5,Pts+Rebs+Asts,31,30,19,13
22023,203932,22300296,"DEC 11, 2023",DEN @ ATL,W,29,7,10,0.7,0,0,0.0,4,5,0.8,7,5,12,1,0,0,2,2,18,9,1,Aaron Gordon,DEN,ATL,DEN,25.5,Fantasy Score,31,30,19,13
22023,203932,22300296,"DEC 11, 2023",DEN @ ATL,W,29,7,10,0.7,0,0,0.0,4,5,0.8,7,5,12,1,0,0,2,2,18,9,1,Aaron Gordon,DEN,ATL,DEN,19.5,Pts+Rebs,31,30,19,13
22023,203932,22300296,"DEC 11, 2023",DEN @ ATL,W,29,7,10,0.7,0,0,0.0,4,5,0.8,7,5,12,1,0,0,2,2,18,9,1,Aaron Gordon,DEN,ATL,DEN,15.5,Pts+Asts,31,30,19,13
22023,203932,22300296,"DEC 11, 2023",DEN @ ATL,W,29,7,10,0.7,0,0,0.0,4,5,0.8,7,5,12,1,0,0,2,2,18,9,1,Aaron Gordon,DEN,ATL,DEN,8.5,Rebs+Asts,31,30,19,13
22023,203932,22301224,"DEC 08, 2023",DEN vs. HOU,L,22,1,5,0.2,0,2,0.0,1,5,0.2,1,5,6,3,0,0,1,1,3,-12,1,Aaron Gordon,DEN,DEN,HOU,13.5,Points,12,9,6,9
22023,203932,22301224,"DEC 08, 2023",DEN vs. HOU,L,22,1,5,0.2,0,2,0.0,1,5,0.2,1,5,6,3,0,0,1,1,3,-12,1,Aaron Gordon,DEN,DEN,HOU,6.0,Rebounds,12,9,6,9
22023,203932,22301224,"DEC 08, 2023",DEN vs. HOU,L,22,1,5,0.2,0,2,0.0,1,5,0.2,1,5,6,3,0,0,1,1,3,-12,1,Aaron Gordon,DEN,DEN,HOU,22.5,Pts+Rebs+Asts,12,9,6,9
22023,203932,22301224,"DEC 08, 2023",DEN vs. HOU,L,22,1,5,0.2,0,2,0.0,1,5,0.2,1,5,6,3,0,0,1,1,3,-12,1,Aaron Gordon,DEN,DEN,HOU,25.5,Fantasy Score,12,9,6,9
22023,203932,22301224,"DEC 08, 2023",DEN vs. HOU,L,22,1,5,0.2,0,2,0.0,1,5,0.2,1,5,6,3,0,0,1,1,3,-12,1,Aaron Gordon,DEN,DEN,HOU,19.5,Pts+Rebs,12,9,6,9
22023,203932,22301224,"DEC 08, 2023",DEN vs. HOU,L,22,1,5,0.2,0,2,0.0,1,5,0.2,1,5,6,3,0,0,1,1,3,-12,1,Aaron Gordon,DEN,DEN,HOU,15.5,Pts+Asts,12,9,6,9
22023,203932,22301224,"DEC 08, 2023",DEN vs. HOU,L,22,1,5,0.2,0,2,0.0,1,5,0.2,1,5,6,3,0,0,1,1,3,-12,1,Aaron Gordon,DEN,DEN,HOU,8.5,Rebs+Asts,12,9,6,9
22023,203932,22301215,"DEC 06, 2023",DEN @ LAC,L,31,4,9,0.444,0,0,0.0,0,0,0.0,2,4,6,2,2,0,0,2,8,6,1,Aaron Gordon,DEN,LAC,DEN,13.5,Points,16,14,10,8
22023,203932,22301215,"DEC 06, 2023",DEN @ LAC,L,31,4,9,0.444,0,0,0.0,0,0,0.0,2,4,6,2,2,0,0,2,8,6,1,Aaron Gordon,DEN,LAC,DEN,6.0,Rebounds,16,14,10,8
22023,203932,22301215,"DEC 06, 2023",DEN @ LAC,L,31,4,9,0.444,0,0,0.0,0,0,0.0,2,4,6,2,2,0,0,2,8,6,1,Aaron Gordon,DEN,LAC,DEN,22.5,Pts+Rebs+Asts,16,14,10,8
22023,203932,22301215,"DEC 06, 2023",DEN @ LAC,L,31,4,9,0.444,0,0,0.0,0,0,0.0,2,4,6,2,2,0,0,2,8,6,1,Aaron Gordon,DEN,LAC,DEN,25.5,Fantasy Score,16,14,10,8
22023,203932,22301215,"DEC 06, 2023",DEN @ LAC,L,31,4,9,0.444,0,0,0.0,0,0,0.0,2,4,6,2,2,0,0,2,8,6,1,Aaron Gordon,DEN,LAC,DEN,19.5,Pts+Rebs,16,14,10,8
22023,203932,22301215,"DEC 06, 2023",DEN @ LAC,L,31,4,9,0.444,0,0,0.0,0,0,0.0,2,4,6,2,2,0,0,2,8,6,1,Aaron Gordon,DEN,LAC,DEN,15.5,Pts+Asts,16,14,10,8
22023,203932,22301215,"DEC 06, 2023",DEN @ LAC,L,31,4,9,0.444,0,0,0.0,0,0,0.0,2,4,6,2,2,0,0,2,8,6,1,Aaron Gordon,DEN,LAC,DEN,8.5,Rebs+Asts,16,14,10,8
22023,203932,22300290,"DEC 02, 2023",DEN @ SAC,L,33,8,13,0.615,1,3,0.333,0,0,0.0,4,3,7,3,0,1,1,1,17,-11,1,Aaron Gordon,DEN,SAC,DEN,13.5,Points,27,24,20,10
22023,203932,22300290,"DEC 02, 2023",DEN @ SAC,L,33,8,13,0.615,1,3,0.333,0,0,0.0,4,3,7,3,0,1,1,1,17,-11,1,Aaron Gordon,DEN,SAC,DEN,6.0,Rebounds,27,24,20,10
22023,203932,22300290,"DEC 02, 2023",DEN @ SAC,L,33,8,13,0.615,1,3,0.333,0,0,0.0,4,3,7,3,0,1,1,1,17,-11,1,Aaron Gordon,DEN,SAC,DEN,22.5,Pts+Rebs+Asts,27,24,20,10
22023,203932,22300290,"DEC 02, 2023",DEN @ SAC,L,33,8,13,0.615,1,3,0.333,0,0,0.0,4,3,7,3,0,1,1,1,17,-11,1,Aaron Gordon,DEN,SAC,DEN,25.5,Fantasy Score,27,24,20,10
22023,203932,22300290,"DEC 02, 2023",DEN @ SAC,L,33,8,13,0.615,1,3,0.333,0,0,0.0,4,3,7,3,0,1,1,1,17,-11,1,Aaron Gordon,DEN,SAC,DEN,19.5,Pts+Rebs,27,24,20,10
22023,203932,22300290,"DEC 02, 2023",DEN @ SAC,L,33,8,13,0.615,1,3,0.333,0,0,0.0,4,3,7,3,0,1,1,1,17,-11,1,Aaron Gordon,DEN,SAC,DEN,15.5,Pts+Asts,27,24,20,10
22023,203932,22300290,"DEC 02, 2023",DEN @ SAC,L,33,8,13,0.615,1,3,0.333,0,0,0.0,4,3,7,3,0,1,1,1,17,-11,1,Aaron Gordon,DEN,SAC,DEN,8.5,Rebs+Asts,27,24,20,10
22023,203932,22300048,"NOV 24, 2023",DEN @ HOU,L,39,0,12,0.0,0,4,0.0,2,4,0.5,3,4,7,2,0,0,1,1,2,-9,1,Aaron Gordon,DEN,HOU,DEN,13.5,Points,11,9,4,9
22023,203932,22300048,"NOV 24, 2023",DEN @ HOU,L,39,0,12,0.0,0,4,0.0,2,4,0.5,3,4,7,2,0,0,1,1,2,-9,1,Aaron Gordon,DEN,HOU,DEN,6.0,Rebounds,11,9,4,9
22023,203932,22300048,"NOV 24, 2023",DEN @ HOU,L,39,0,12,0.0,0,4,0.0,2,4,0.5,3,4,7,2,0,0,1,1,2,-9,1,Aaron Gordon,DEN,HOU,DEN,22.5,Pts+Rebs+Asts,11,9,4,9
22023,203932,22300048,"NOV 24, 2023",DEN @ HOU,L,39,0,12,0.0,0,4,0.0,2,4,0.5,3,4,7,2,0,0,1,1,2,-9,1,Aaron Gordon,DEN,HOU,DEN,25.5,Fantasy Score,11,9,4,9
22023,203932,22300048,"NOV 24, 2023",DEN @ HOU,L,39,0,12,0.0,0,4,0.0,2,4,0.5,3,4,7,2,0,0,1,1,2,-9,1,Aaron Gordon,DEN,HOU,DEN,19.5,Pts+Rebs,11,9,4,9
22023,203932,22300048,"NOV 24, 2023",DEN @ HOU,L,39,0,12,0.0,0,4,0.0,2,4,0.5,3,4,7,2,0,0,1,1,2,-9,1,Aaron Gordon,DEN,HOU,DEN,15.5,Pts+Asts,11,9,4,9
22023,203932,22300048,"NOV 24, 2023",DEN @ HOU,L,39,0,12,0.0,0,4,0.0,2,4,0.5,3,4,7,2,0,0,1,1,2,-9,1,Aaron Gordon,DEN,HOU,DEN,8.5,Rebs+Asts,11,9,4,9
22023,203932,22300226,"NOV 22, 2023",DEN @ ORL,L,37,7,16,0.438,1,3,0.333,0,2,0.0,7,3,10,1,2,0,2,3,15,4,1,Aaron Gordon,DEN,ORL,DEN,13.5,Points,26,25,16,11
22023,203932,22300226,"NOV 22, 2023",DEN @ ORL,L,37,7,16,0.438,1,3,0.333,0,2,0.0,7,3,10,1,2,0,2,3,15,4,1,Aaron Gordon,DEN,ORL,DEN,6.0,Rebounds,26,25,16,11
22023,203932,22300226,"NOV 22, 2023",DEN @ ORL,L,37,7,16,0.438,1,3,0.333,0,2,0.0,7,3,10,1,2,0,2,3,15,4,1,Aaron Gordon,DEN,ORL,DEN,22.5,Pts+Rebs+Asts,26,25,16,11
22023,203932,22300226,"NOV 22, 2023",DEN @ ORL,L,37,7,16,0.438,1,3,0.333,0,2,0.0,7,3,10,1,2,0,2,3,15,4,1,Aaron Gordon,DEN,ORL,DEN,25.5,Fantasy Score,26,25,16,11
22023,203932,22300226,"NOV 22, 2023",DEN @ ORL,L,37,7,16,0.438,1,3,0.333,0,2,0.0,7,3,10,1,2,0,2,3,15,4,1,Aaron Gordon,DEN,ORL,DEN,19.5,Pts+Rebs,26,25,16,11
22023,203932,22300226,"NOV 22, 2023",DEN @ ORL,L,37,7,16,0.438,1,3,0.333,0,2,0.0,7,3,10,1,2,0,2,3,15,4,1,Aaron Gordon,DEN,ORL,DEN,15.5,Pts+Asts,26,25,16,11
22023,203932,22300226,"NOV 22, 2023",DEN @ ORL,L,37,7,16,0.438,1,3,0.333,0,2,0.0,7,3,10,1,2,0,2,3,15,4,1,Aaron Gordon,DEN,ORL,DEN,8.5,Rebs+Asts,26,25,16,11
22023,203932,22300218,"NOV 20, 2023",DEN @ DET,W,37,4,11,0.364,0,1,0.0,3,4,0.75,5,4,9,7,1,0,2,1,11,-2,1,Aaron Gordon,DEN,DET,DEN,13.5,Points,27,20,18,16
22023,203932,22300218,"NOV 20, 2023",DEN @ DET,W,37,4,11,0.364,0,1,0.0,3,4,0.75,5,4,9,7,1,0,2,1,11,-2,1,Aaron Gordon,DEN,DET,DEN,6.0,Rebounds,27,20,18,16
22023,203932,22300218,"NOV 20, 2023",DEN @ DET,W,37,4,11,0.364,0,1,0.0,3,4,0.75,5,4,9,7,1,0,2,1,11,-2,1,Aaron Gordon,DEN,DET,DEN,22.5,Pts+Rebs+Asts,27,20,18,16
22023,203932,22300218,"NOV 20, 2023",DEN @ DET,W,37,4,11,0.364,0,1,0.0,3,4,0.75,5,4,9,7,1,0,2,1,11,-2,1,Aaron Gordon,DEN,DET,DEN,25.5,Fantasy Score,27,20,18,16
22023,203932,22300218,"NOV 20, 2023",DEN @ DET,W,37,4,11,0.364,0,1,0.0,3,4,0.75,5,4,9,7,1,0,2,1,11,-2,1,Aaron Gordon,DEN,DET,DEN,19.5,Pts+Rebs,27,20,18,16
22023,203932,22300218,"NOV 20, 2023",DEN @ DET,W,37,4,11,0.364,0,1,0.0,3,4,0.75,5,4,9,7,1,0,2,1,11,-2,1,Aaron Gordon,DEN,DET,DEN,15.5,Pts+Asts,27,20,18,16
22023,203932,22300218,"NOV 20, 2023",DEN @ DET,W,37,4,11,0.364,0,1,0.0,3,4,0.75,5,4,9,7,1,0,2,1,11,-2,1,Aaron Gordon,DEN,DET,DEN,8.5,Rebs+Asts,27,20,18,16
22023,203932,22300210,"NOV 19, 2023",DEN @ CLE,L,32,4,11,0.364,0,2,0.0,3,6,0.5,2,2,4,5,1,2,1,2,11,-18,1,Aaron Gordon,DEN,CLE,DEN,13.5,Points,20,15,16,9
22023,203932,22300210,"NOV 19, 2023",DEN @ CLE,L,32,4,11,0.364,0,2,0.0,3,6,0.5,2,2,4,5,1,2,1,2,11,-18,1,Aaron Gordon,DEN,CLE,DEN,6.0,Rebounds,20,15,16,9
22023,203932,22300210,"NOV 19, 2023",DEN @ CLE,L,32,4,11,0.364,0,2,0.0,3,6,0.5,2,2,4,5,1,2,1,2,11,-18,1,Aaron Gordon,DEN,CLE,DEN,22.5,Pts+Rebs+Asts,20,15,16,9
22023,203932,22300210,"NOV 19, 2023",DEN @ CLE,L,32,4,11,0.364,0,2,0.0,3,6,0.5,2,2,4,5,1,2,1,2,11,-18,1,Aaron Gordon,DEN,CLE,DEN,25.5,Fantasy Score,20,15,16,9
22023,203932,22300210,"NOV 19, 2023",DEN @ CLE,L,32,4,11,0.364,0,2,0.0,3,6,0.5,2,2,4,5,1,2,1,2,11,-18,1,Aaron Gordon,DEN,CLE,DEN,19.5,Pts+Rebs,20,15,16,9
22023,203932,22300210,"NOV 19, 2023",DEN @ CLE,L,32,4,11,0.364,0,2,0.0,3,6,0.5,2,2,4,5,1,2,1,2,11,-18,1,Aaron Gordon,DEN,CLE,DEN,15.5,Pts+Asts,20,15,16,9
22023,203932,22300210,"NOV 19, 2023",DEN @ CLE,L,32,4,11,0.364,0,2,0.0,3,6,0.5,2,2,4,5,1,2,1,2,11,-18,1,Aaron Gordon,DEN,CLE,DEN,8.5,Rebs+Asts,20,15,16,9
22023,203932,22300034,"NOV 17, 2023",DEN @ NOP,L,39,7,14,0.5,0,4,0.0,0,3,0.0,1,7,8,2,1,0,0,4,14,1,1,Aaron Gordon,DEN,NOP,DEN,13.5,Points,24,22,16,10
22023,203932,22300034,"NOV 17, 2023",DEN @ NOP,L,39,7,14,0.5,0,4,0.0,0,3,0.0,1,7,8,2,1,0,0,4,14,1,1,Aaron Gordon,DEN,NOP,DEN,6.0,Rebounds,24,22,16,10
22023,203932,22300034,"NOV 17, 2023",DEN @ NOP,L,39,7,14,0.5,0,4,0.0,0,3,0.0,1,7,8,2,1,0,0,4,14,1,1,Aaron Gordon,DEN,NOP,DEN,22.5,Pts+Rebs+Asts,24,22,16,10
22023,203932,22300034,"NOV 17, 2023",DEN @ NOP,L,39,7,14,0.5,0,4,0.0,0,3,0.0,1,7,8,2,1,0,0,4,14,1,1,Aaron Gordon,DEN,NOP,DEN,25.5,Fantasy Score,24,22,16,10
22023,203932,22300034,"NOV 17, 2023",DEN @ NOP,L,39,7,14,0.5,0,4,0.0,0,3,0.0,1,7,8,2,1,0,0,4,14,1,1,Aaron Gordon,DEN,NOP,DEN,19.5,Pts+Rebs,24,22,16,10
22023,203932,22300034,"NOV 17, 2023",DEN @ NOP,L,39,7,14,0.5,0,4,0.0,0,3,0.0,1,7,8,2,1,0,0,4,14,1,1,Aaron Gordon,DEN,NOP,DEN,15.5,Pts+Asts,24,22,16,10
22023,203932,22300034,"NOV 17, 2023",DEN @ NOP,L,39,7,14,0.5,0,4,0.0,0,3,0.0,1,7,8,2,1,0,0,4,14,1,1,Aaron Gordon,DEN,NOP,DEN,8.5,Rebs+Asts,24,22,16,10
22023,203932,22300024,"NOV 14, 2023",DEN vs. LAC,W,39,8,12,0.667,1,2,0.5,3,3,1.0,1,4,5,5,0,0,3,1,20,2,1,Aaron Gordon,DEN,DEN,LAC,13.5,Points,30,25,25,10
22023,203932,22300024,"NOV 14, 2023",DEN vs. LAC,W,39,8,12,0.667,1,2,0.5,3,3,1.0,1,4,5,5,0,0,3,1,20,2,1,Aaron Gordon,DEN,DEN,LAC,6.0,Rebounds,30,25,25,10
22023,203932,22300024,"NOV 14, 2023",DEN vs. LAC,W,39,8,12,0.667,1,2,0.5,3,3,1.0,1,4,5,5,0,0,3,1,20,2,1,Aaron Gordon,DEN,DEN,LAC,22.5,Pts+Rebs+Asts,30,25,25,10
22023,203932,22300024,"NOV 14, 2023",DEN vs. LAC,W,39,8,12,0.667,1,2,0.5,3,3,1.0,1,4,5,5,0,0,3,1,20,2,1,Aaron Gordon,DEN,DEN,LAC,25.5,Fantasy Score,30,25,25,10
22023,203932,22300024,"NOV 14, 2023",DEN vs. LAC,W,39,8,12,0.667,1,2,0.5,3,3,1.0,1,4,5,5,0,0,3,1,20,2,1,Aaron Gordon,DEN,DEN,LAC,19.5,Pts+Rebs,30,25,25,10
22023,203932,22300024,"NOV 14, 2023",DEN vs. LAC,W,39,8,12,0.667,1,2,0.5,3,3,1.0,1,4,5,5,0,0,3,1,20,2,1,Aaron Gordon,DEN,DEN,LAC,15.5,Pts+Asts,30,25,25,10
22023,203932,22300024,"NOV 14, 2023",DEN vs. LAC,W,39,8,12,0.667,1,2,0.5,3,3,1.0,1,4,5,5,0,0,3,1,20,2,1,Aaron Gordon,DEN,DEN,LAC,8.5,Rebs+Asts,30,25,25,10
22023,203932,22300182,"NOV 12, 2023",DEN @ HOU,L,39,6,10,0.6,1,2,0.5,3,6,0.5,1,7,8,5,0,2,2,2,16,8,1,Aaron Gordon,DEN,HOU,DEN,13.5,Points,29,24,21,13
22023,203932,22300182,"NOV 12, 2023",DEN @ HOU,L,39,6,10,0.6,1,2,0.5,3,6,0.5,1,7,8,5,0,2,2,2,16,8,1,Aaron Gordon,DEN,HOU,DEN,6.0,Rebounds,29,24,21,13
22023,203932,22300182,"NOV 12, 2023",DEN @ HOU,L,39,6,10,0.6,1,2,0.5,3,6,0.5,1,7,8,5,0,2,2,2,16,8,1,Aaron Gordon,DEN,HOU,DEN,22.5,Pts+Rebs+Asts,29,24,21,13
22023,203932,22300182,"NOV 12, 2023",DEN @ HOU,L,39,6,10,0.6,1,2,0.5,3,6,0.5,1,7,8,5,0,2,2,2,16,8,1,Aaron Gordon,DEN,HOU,DEN,25.5,Fantasy Score,29,24,21,13
22023,203932,22300182,"NOV 12, 2023",DEN @ HOU,L,39,6,10,0.6,1,2,0.5,3,6,0.5,1,7,8,5,0,2,2,2,16,8,1,Aaron Gordon,DEN,HOU,DEN,19.5,Pts+Rebs,29,24,21,13
22023,203932,22300182,"NOV 12, 2023",DEN @ HOU,L,39,6,10,0.6,1,2,0.5,3,6,0.5,1,7,8,5,0,2,2,2,16,8,1,Aaron Gordon,DEN,HOU,DEN,15.5,Pts+Asts,29,24,21,13
22023,203932,22300182,"NOV 12, 2023",DEN @ HOU,L,39,6,10,0.6,1,2,0.5,3,6,0.5,1,7,8,5,0,2,2,2,16,8,1,Aaron Gordon,DEN,HOU,DEN,8.5,Rebs+Asts,29,24,21,13
22023,203932,22300169,"NOV 08, 2023",DEN vs. GSW,W,34,5,14,0.357,1,2,0.5,3,4,0.75,4,7,11,3,3,1,2,2,14,12,1,Aaron Gordon,DEN,DEN,GSW,13.5,Points,28,25,17,14
22023,203932,22300169,"NOV 08, 2023",DEN vs. GSW,W,34,5,14,0.357,1,2,0.5,3,4,0.75,4,7,11,3,3,1,2,2,14,12,1,Aaron Gordon,DEN,DEN,GSW,6.0,Rebounds,28,25,17,14
22023,203932,22300169,"NOV 08, 2023",DEN vs. GSW,W,34,5,14,0.357,1,2,0.5,3,4,0.75,4,7,11,3,3,1,2,2,14,12,1,Aaron Gordon,DEN,DEN,GSW,22.5,Pts+Rebs+Asts,28,25,17,14
22023,203932,22300169,"NOV 08, 2023",DEN vs. GSW,W,34,5,14,0.357,1,2,0.5,3,4,0.75,4,7,11,3,3,1,2,2,14,12,1,Aaron Gordon,DEN,DEN,GSW,25.5,Fantasy Score,28,25,17,14
22023,203932,22300169,"NOV 08, 2023",DEN vs. GSW,W,34,5,14,0.357,1,2,0.5,3,4,0.75,4,7,11,3,3,1,2,2,14,12,1,Aaron Gordon,DEN,DEN,GSW,19.5,Pts+Rebs,28,25,17,14
22023,203932,22300169,"NOV 08, 2023",DEN vs. GSW,W,34,5,14,0.357,1,2,0.5,3,4,0.75,4,7,11,3,3,1,2,2,14,12,1,Aaron Gordon,DEN,DEN,GSW,15.5,Pts+Asts,28,25,17,14
22023,203932,22300169,"NOV 08, 2023",DEN vs. GSW,W,34,5,14,0.357,1,2,0.5,3,4,0.75,4,7,11,3,3,1,2,2,14,12,1,Aaron Gordon,DEN,DEN,GSW,8.5,Rebs+Asts,28,25,17,14
22023,203932,22300156,"NOV 06, 2023",DEN vs. NOP,W,36,7,11,0.636,0,2,0.0,1,2,0.5,5,7,12,6,0,1,2,1,15,8,1,Aaron Gordon,DEN,DEN,NOP,13.5,Points,33,27,21,18
22023,203932,22300156,"NOV 06, 2023",DEN vs. NOP,W,36,7,11,0.636,0,2,0.0,1,2,0.5,5,7,12,6,0,1,2,1,15,8,1,Aaron Gordon,DEN,DEN,NOP,6.0,Rebounds,33,27,21,18
22023,203932,22300156,"NOV 06, 2023",DEN vs. NOP,W,36,7,11,0.636,0,2,0.0,1,2,0.5,5,7,12,6,0,1,2,1,15,8,1,Aaron Gordon,DEN,DEN,NOP,22.5,Pts+Rebs+Asts,33,27,21,18
22023,203932,22300156,"NOV 06, 2023",DEN vs. NOP,W,36,7,11,0.636,0,2,0.0,1,2,0.5,5,7,12,6,0,1,2,1,15,8,1,Aaron Gordon,DEN,DEN,NOP,25.5,Fantasy Score,33,27,21,18
22023,203932,22300156,"NOV 06, 2023",DEN vs. NOP,W,36,7,11,0.636,0,2,0.0,1,2,0.5,5,7,12,6,0,1,2,1,15,8,1,Aaron Gordon,DEN,DEN,NOP,19.5,Pts+Rebs,33,27,21,18
22023,203932,22300156,"NOV 06, 2023",DEN vs. NOP,W,36,7,11,0.636,0,2,0.0,1,2,0.5,5,7,12,6,0,1,2,1,15,8,1,Aaron Gordon,DEN,DEN,NOP,15.5,Pts+Asts,33,27,21,18
22023,203932,22300156,"NOV 06, 2023",DEN vs. NOP,W,36,7,11,0.636,0,2,0.0,1,2,0.5,5,7,12,6,0,1,2,1,15,8,1,Aaron Gordon,DEN,DEN,NOP,8.5,Rebs+Asts,33,27,21,18
22023,203932,22300139,"NOV 04, 2023",DEN vs. CHI,W,35,4,9,0.444,1,3,0.333,6,8,0.75,3,9,12,5,2,1,3,2,15,26,1,Aaron Gordon,DEN,DEN,CHI,13.5,Points,32,27,20,17
22023,203932,22300139,"NOV 04, 2023",DEN vs. CHI,W,35,4,9,0.444,1,3,0.333,6,8,0.75,3,9,12,5,2,1,3,2,15,26,1,Aaron Gordon,DEN,DEN,CHI,6.0,Rebounds,32,27,20,17
22023,203932,22300139,"NOV 04, 2023",DEN vs. CHI,W,35,4,9,0.444,1,3,0.333,6,8,0.75,3,9,12,5,2,1,3,2,15,26,1,Aaron Gordon,DEN,DEN,CHI,22.5,Pts+Rebs+Asts,32,27,20,17
22023,203932,22300139,"NOV 04, 2023",DEN vs. CHI,W,35,4,9,0.444,1,3,0.333,6,8,0.75,3,9,12,5,2,1,3,2,15,26,1,Aaron Gordon,DEN,DEN,CHI,25.5,Fantasy Score,32,27,20,17
22023,203932,22300139,"NOV 04, 2023",DEN vs. CHI,W,35,4,9,0.444,1,3,0.333,6,8,0.75,3,9,12,5,2,1,3,2,15,26,1,Aaron Gordon,DEN,DEN,CHI,19.5,Pts+Rebs,32,27,20,17
22023,203932,22300139,"NOV 04, 2023",DEN vs. CHI,W,35,4,9,0.444,1,3,0.333,6,8,0.75,3,9,12,5,2,1,3,2,15,26,1,Aaron Gordon,DEN,DEN,CHI,15.5,Pts+Asts,32,27,20,17
22023,203932,22300139,"NOV 04, 2023",DEN vs. CHI,W,35,4,9,0.444,1,3,0.333,6,8,0.75,3,9,12,5,2,1,3,2,15,26,1,Aaron Gordon,DEN,DEN,CHI,8.5,Rebs+Asts,32,27,20,17
22023,203932,22300006,"NOV 03, 2023",DEN vs. DAL,W,35,8,17,0.471,2,6,0.333,0,0,0.0,2,6,8,6,2,1,4,2,18,22,1,Aaron Gordon,DEN,DEN,DAL,13.5,Points,32,26,24,14
22023,203932,22300006,"NOV 03, 2023",DEN vs. DAL,W,35,8,17,0.471,2,6,0.333,0,0,0.0,2,6,8,6,2,1,4,2,18,22,1,Aaron Gordon,DEN,DEN,DAL,6.0,Rebounds,32,26,24,14
22023,203932,22300006,"NOV 03, 2023",DEN vs. DAL,W,35,8,17,0.471,2,6,0.333,0,0,0.0,2,6,8,6,2,1,4,2,18,22,1,Aaron Gordon,DEN,DEN,DAL,22.5,Pts+Rebs+Asts,32,26,24,14
22023,203932,22300006,"NOV 03, 2023",DEN vs. DAL,W,35,8,17,0.471,2,6,0.333,0,0,0.0,2,6,8,6,2,1,4,2,18,22,1,Aaron Gordon,DEN,DEN,DAL,25.5,Fantasy Score,32,26,24,14
22023,203932,22300006,"NOV 03, 2023",DEN vs. DAL,W,35,8,17,0.471,2,6,0.333,0,0,0.0,2,6,8,6,2,1,4,2,18,22,1,Aaron Gordon,DEN,DEN,DAL,19.5,Pts+Rebs,32,26,24,14
22023,203932,22300006,"NOV 03, 2023",DEN vs. DAL,W,35,8,17,0.471,2,6,0.333,0,0,0.0,2,6,8,6,2,1,4,2,18,22,1,Aaron Gordon,DEN,DEN,DAL,15.5,Pts+Asts,32,26,24,14
22023,203932,22300006,"NOV 03, 2023",DEN vs. DAL,W,35,8,17,0.471,2,6,0.333,0,0,0.0,2,6,8,6,2,1,4,2,18,22,1,Aaron Gordon,DEN,DEN,DAL,8.5,Rebs+Asts,32,26,24,14
22023,203932,22300123,"NOV 01, 2023",DEN @ MIN,L,18,2,3,0.667,0,1,0.0,0,0,0.0,1,1,2,2,0,1,2,4,4,-13,1,Aaron Gordon,DEN,MIN,DEN,13.5,Points,8,6,6,4
22023,203932,22300123,"NOV 01, 2023",DEN @ MIN,L,18,2,3,0.667,0,1,0.0,0,0,0.0,1,1,2,2,0,1,2,4,4,-13,1,Aaron Gordon,DEN,MIN,DEN,6.0,Rebounds,8,6,6,4
22023,203932,22300123,"NOV 01, 2023",DEN @ MIN,L,18,2,3,0.667,0,1,0.0,0,0,0.0,1,1,2,2,0,1,2,4,4,-13,1,Aaron Gordon,DEN,MIN,DEN,22.5,Pts+Rebs+Asts,8,6,6,4
22023,203932,22300123,"NOV 01, 2023",DEN @ MIN,L,18,2,3,0.667,0,1,0.0,0,0,0.0,1,1,2,2,0,1,2,4,4,-13,1,Aaron Gordon,DEN,MIN,DEN,25.5,Fantasy Score,8,6,6,4
22023,203932,22300123,"NOV 01, 2023",DEN @ MIN,L,18,2,3,0.667,0,1,0.0,0,0,0.0,1,1,2,2,0,1,2,4,4,-13,1,Aaron Gordon,DEN,MIN,DEN,19.5,Pts+Rebs,8,6,6,4
22023,203932,22300123,"NOV 01, 2023",DEN @ MIN,L,18,2,3,0.667,0,1,0.0,0,0,0.0,1,1,2,2,0,1,2,4,4,-13,1,Aaron Gordon,DEN,MIN,DEN,15.5,Pts+Asts,8,6,6,4
22023,203932,22300123,"NOV 01, 2023",DEN @ MIN,L,18,2,3,0.667,0,1,0.0,0,0,0.0,1,1,2,2,0,1,2,4,4,-13,1,Aaron Gordon,DEN,MIN,DEN,8.5,Rebs+Asts,8,6,6,4
22023,203932,22300110,"OCT 30, 2023",DEN vs. UTA,W,33,10,12,0.833,0,0,0.0,1,4,0.25,3,4,7,2,0,0,3,2,21,8,1,Aaron Gordon,DEN,DEN,UTA,13.5,Points,30,28,23,9
22023,203932,22300110,"OCT 30, 2023",DEN vs. UTA,W,33,10,12,0.833,0,0,0.0,1,4,0.25,3,4,7,2,0,0,3,2,21,8,1,Aaron Gordon,DEN,DEN,UTA,6.0,Rebounds,30,28,23,9
22023,203932,22300110,"OCT 30, 2023",DEN vs. UTA,W,33,10,12,0.833,0,0,0.0,1,4,0.25,3,4,7,2,0,0,3,2,21,8,1,Aaron Gordon,DEN,DEN,UTA,22.5,Pts+Rebs+Asts,30,28,23,9
22023,203932,22300110,"OCT 30, 2023",DEN vs. UTA,W,33,10,12,0.833,0,0,0.0,1,4,0.25,3,4,7,2,0,0,3,2,21,8,1,Aaron Gordon,DEN,DEN,UTA,25.5,Fantasy Score,30,28,23,9
22023,203932,22300110,"OCT 30, 2023",DEN vs. UTA,W,33,10,12,0.833,0,0,0.0,1,4,0.25,3,4,7,2,0,0,3,2,21,8,1,Aaron Gordon,DEN,DEN,UTA,19.5,Pts+Rebs,30,28,23,9
22023,203932,22300110,"OCT 30, 2023",DEN vs. UTA,W,33,10,12,0.833,0,0,0.0,1,4,0.25,3,4,7,2,0,0,3,2,21,8,1,Aaron Gordon,DEN,DEN,UTA,15.5,Pts+Asts,30,28,23,9
22023,203932,22300110,"OCT 30, 2023",DEN vs. UTA,W,33,10,12,0.833,0,0,0.0,1,4,0.25,3,4,7,2,0,0,3,2,21,8,1,Aaron Gordon,DEN,DEN,UTA,8.5,Rebs+Asts,30,28,23,9
22023,203932,22300095,"OCT 29, 2023",DEN @ OKC,W,23,4,7,0.571,0,1,0.0,1,3,0.333,1,2,3,2,1,3,1,1,9,22,1,Aaron Gordon,DEN,OKC,DEN,13.5,Points,14,12,11,5
22023,203932,22300095,"OCT 29, 2023",DEN @ OKC,W,23,4,7,0.571,0,1,0.0,1,3,0.333,1,2,3,2,1,3,1,1,9,22,1,Aaron Gordon,DEN,OKC,DEN,6.0,Rebounds,14,12,11,5
22023,203932,22300095,"OCT 29, 2023",DEN @ OKC,W,23,4,7,0.571,0,1,0.0,1,3,0.333,1,2,3,2,1,3,1,1,9,22,1,Aaron Gordon,DEN,OKC,DEN,22.5,Pts+Rebs+Asts,14,12,11,5
22023,203932,22300095,"OCT 29, 2023",DEN @ OKC,W,23,4,7,0.571,0,1,0.0,1,3,0.333,1,2,3,2,1,3,1,1,9,22,1,Aaron Gordon,DEN,OKC,DEN,25.5,Fantasy Score,14,12,11,5
22023,203932,22300095,"OCT 29, 2023",DEN @ OKC,W,23,4,7,0.571,0,1,0.0,1,3,0.333,1,2,3,2,1,3,1,1,9,22,1,Aaron Gordon,DEN,OKC,DEN,19.5,Pts+Rebs,14,12,11,5
22023,203932,22300095,"OCT 29, 2023",DEN @ OKC,W,23,4,7,0.571,0,1,0.0,1,3,0.333,1,2,3,2,1,3,1,1,9,22,1,Aaron Gordon,DEN,OKC,DEN,15.5,Pts+Asts,14,12,11,5
22023,203932,22300095,"OCT 29, 2023",DEN @ OKC,W,23,4,7,0.571,0,1,0.0,1,3,0.333,1,2,3,2,1,3,1,1,9,22,1,Aaron Gordon,DEN,OKC,DEN,8.5,Rebs+Asts,14,12,11,5
22023,203932,22300078,"OCT 27, 2023",DEN @ MEM,W,30,5,11,0.455,0,1,0.0,0,1,0.0,1,1,2,3,3,1,1,3,10,8,1,Aaron Gordon,DEN,MEM,DEN,13.5,Points,15,12,13,5
22023,203932,22300078,"OCT 27, 2023",DEN @ MEM,W,30,5,11,0.455,0,1,0.0,0,1,0.0,1,1,2,3,3,1,1,3,10,8,1,Aaron Gordon,DEN,MEM,DEN,6.0,Rebounds,15,12,13,5
22023,203932,22300078,"OCT 27, 2023",DEN @ MEM,W,30,5,11,0.455,0,1,0.0,0,1,0.0,1,1,2,3,3,1,1,3,10,8,1,Aaron Gordon,DEN,MEM,DEN,22.5,Pts+Rebs+Asts,15,12,13,5
22023,203932,22300078,"OCT 27, 2023",DEN @ MEM,W,30,5,11,0.455,0,1,0.0,0,1,0.0,1,1,2,3,3,1,1,3,10,8,1,Aaron Gordon,DEN,MEM,DEN,25.5,Fantasy Score,15,12,13,5
22023,203932,22300078,"OCT 27, 2023",DEN @ MEM,W,30,5,11,0.455,0,1,0.0,0,1,0.0,1,1,2,3,3,1,1,3,10,8,1,Aaron Gordon,DEN,MEM,DEN,19.5,Pts+Rebs,15,12,13,5
22023,203932,22300078,"OCT 27, 2023",DEN @ MEM,W,30,5,11,0.455,0,1,0.0,0,1,0.0,1,1,2,3,3,1,1,3,10,8,1,Aaron Gordon,DEN,MEM,DEN,15.5,Pts+Asts,15,12,13,5
22023,203932,22300078,"OCT 27, 2023",DEN @ MEM,W,30,5,11,0.455,0,1,0.0,0,1,0.0,1,1,2,3,3,1,1,3,10,8,1,Aaron Gordon,DEN,MEM,DEN,8.5,Rebs+Asts,15,12,13,5
22023,203932,22300061,"OCT 24, 2023",DEN vs. LAL,W,35,7,11,0.636,1,2,0.5,0,0,0.0,2,5,7,5,2,1,0,0,15,6,1,Aaron Gordon,DEN,DEN,LAL,13.5,Points,27,22,20,12
22023,203932,22300061,"OCT 24, 2023",DEN vs. LAL,W,35,7,11,0.636,1,2,0.5,0,0,0.0,2,5,7,5,2,1,0,0,15,6,1,Aaron Gordon,DEN,DEN,LAL,6.0,Rebounds,27,22,20,12
22023,203932,22300061,"OCT 24, 2023",DEN vs. LAL,W,35,7,11,0.636,1,2,0.5,0,0,0.0,2,5,7,5,2,1,0,0,15,6,1,Aaron Gordon,DEN,DEN,LAL,22.5,Pts+Rebs+Asts,27,22,20,12
22023,203932,22300061,"OCT 24, 2023",DEN vs. LAL,W,35,7,11,0.636,1,2,0.5,0,0,0.0,2,5,7,5,2,1,0,0,15,6,1,Aaron Gordon,DEN,DEN,LAL,25.5,Fantasy Score,27,22,20,12
22023,203932,22300061,"OCT 24, 2023",DEN vs. LAL,W,35,7,11,0.636,1,2,0.5,0,0,0.0,2,5,7,5,2,1,0,0,15,6,1,Aaron Gordon,DEN,DEN,LAL,19.5,Pts+Rebs,27,22,20,12
22023,203932,22300061,"OCT 24, 2023",DEN vs. LAL,W,35,7,11,0.636,1,2,0.5,0,0,0.0,2,5,7,5,2,1,0,0,15,6,1,Aaron Gordon,DEN,DEN,LAL,15.5,Pts+Asts,27,22,20,12
22023,203932,22300061,"OCT 24, 2023",DEN vs. LAL,W,35,7,11,0.636,1,2,0.5,0,0,0.0,2,5,7,5,2,1,0,0,15,6,1,Aaron Gordon,DEN,DEN,LAL,8.5,Rebs+Asts,27,22,20,12
22023,201569,22300554,"JAN 14, 2024",PHX @ POR,W,24,1,4,0.25,1,3,0.333,0,0,0.0,0,2,2,4,1,0,0,0,3,-1,1,Eric Gordon,PHX,POR,PHX,8.5,Points,9,5,7,6
22023,201569,22300554,"JAN 14, 2024",PHX @ POR,W,24,1,4,0.25,1,3,0.333,0,0,0.0,0,2,2,4,1,0,0,0,3,-1,1,Eric Gordon,PHX,POR,PHX,11.0,Pts+Rebs,9,5,7,6
22023,201569,22300554,"JAN 14, 2024",PHX @ POR,W,24,1,4,0.25,1,3,0.333,0,0,0.0,0,2,2,4,1,0,0,0,3,-1,1,Eric Gordon,PHX,POR,PHX,10.5,Pts+Asts,9,5,7,6
22023,201569,22300554,"JAN 14, 2024",PHX @ POR,W,24,1,4,0.25,1,3,0.333,0,0,0.0,0,2,2,4,1,0,0,0,3,-1,1,Eric Gordon,PHX,POR,PHX,0.5,Steals,9,5,7,6
22023,201569,22300531,"JAN 11, 2024",PHX @ LAL,W,23,2,11,0.182,1,9,0.111,0,0,0.0,2,1,3,0,0,0,0,0,5,1,1,Eric Gordon,PHX,LAL,PHX,8.5,Points,8,8,5,3
22023,201569,22300531,"JAN 11, 2024",PHX @ LAL,W,23,2,11,0.182,1,9,0.111,0,0,0.0,2,1,3,0,0,0,0,0,5,1,1,Eric Gordon,PHX,LAL,PHX,11.0,Pts+Rebs,8,8,5,3
22023,201569,22300531,"JAN 11, 2024",PHX @ LAL,W,23,2,11,0.182,1,9,0.111,0,0,0.0,2,1,3,0,0,0,0,0,5,1,1,Eric Gordon,PHX,LAL,PHX,10.5,Pts+Asts,8,8,5,3
22023,201569,22300531,"JAN 11, 2024",PHX @ LAL,W,23,2,11,0.182,1,9,0.111,0,0,0.0,2,1,3,0,0,0,0,0,5,1,1,Eric Gordon,PHX,LAL,PHX,0.5,Steals,8,8,5,3
22023,201569,22300511,"JAN 08, 2024",PHX @ LAC,L,25,3,8,0.375,2,7,0.286,4,4,1.0,0,1,1,2,0,0,1,1,12,-20,1,Eric Gordon,PHX,LAC,PHX,8.5,Points,15,13,14,3
22023,201569,22300511,"JAN 08, 2024",PHX @ LAC,L,25,3,8,0.375,2,7,0.286,4,4,1.0,0,1,1,2,0,0,1,1,12,-20,1,Eric Gordon,PHX,LAC,PHX,11.0,Pts+Rebs,15,13,14,3
22023,201569,22300511,"JAN 08, 2024",PHX @ LAC,L,25,3,8,0.375,2,7,0.286,4,4,1.0,0,1,1,2,0,0,1,1,12,-20,1,Eric Gordon,PHX,LAC,PHX,10.5,Pts+Asts,15,13,14,3
22023,201569,22300511,"JAN 08, 2024",PHX @ LAC,L,25,3,8,0.375,2,7,0.286,4,4,1.0,0,1,1,2,0,0,1,1,12,-20,1,Eric Gordon,PHX,LAC,PHX,0.5,Steals,15,13,14,3
22023,201569,22300473,"JAN 03, 2024",PHX vs. LAC,L,28,5,11,0.455,3,6,0.5,3,4,0.75,1,4,5,1,1,0,1,1,16,3,1,Eric Gordon,PHX,PHX,LAC,8.5,Points,22,21,17,6
22023,201569,22300473,"JAN 03, 2024",PHX vs. LAC,L,28,5,11,0.455,3,6,0.5,3,4,0.75,1,4,5,1,1,0,1,1,16,3,1,Eric Gordon,PHX,PHX,LAC,11.0,Pts+Rebs,22,21,17,6
22023,201569,22300473,"JAN 03, 2024",PHX vs. LAC,L,28,5,11,0.455,3,6,0.5,3,4,0.75,1,4,5,1,1,0,1,1,16,3,1,Eric Gordon,PHX,PHX,LAC,10.5,Pts+Asts,22,21,17,6
22023,201569,22300473,"JAN 03, 2024",PHX vs. LAC,L,28,5,11,0.455,3,6,0.5,3,4,0.75,1,4,5,1,1,0,1,1,16,3,1,Eric Gordon,PHX,PHX,LAC,0.5,Steals,22,21,17,6
22023,201569,22300456,"JAN 01, 2024",PHX vs. POR,W,20,4,10,0.4,2,6,0.333,2,5,0.4,0,3,3,1,1,0,1,0,12,16,1,Eric Gordon,PHX,PHX,POR,8.5,Points,16,15,13,4
22023,201569,22300456,"JAN 01, 2024",PHX vs. POR,W,20,4,10,0.4,2,6,0.333,2,5,0.4,0,3,3,1,1,0,1,0,12,16,1,Eric Gordon,PHX,PHX,POR,11.0,Pts+Rebs,16,15,13,4
22023,201569,22300456,"JAN 01, 2024",PHX vs. POR,W,20,4,10,0.4,2,6,0.333,2,5,0.4,0,3,3,1,1,0,1,0,12,16,1,Eric Gordon,PHX,PHX,POR,10.5,Pts+Asts,16,15,13,4
22023,201569,22300456,"JAN 01, 2024",PHX vs. POR,W,20,4,10,0.4,2,6,0.333,2,5,0.4,0,3,3,1,1,0,1,0,12,16,1,Eric Gordon,PHX,PHX,POR,0.5,Steals,16,15,13,4
22023,201569,22300450,"DEC 31, 2023",PHX vs. ORL,W,30,0,3,0.0,0,2,0.0,0,0,0.0,0,1,1,0,2,0,0,3,0,-3,1,Eric Gordon,PHX,PHX,ORL,8.5,Points,1,1,0,1
22023,201569,22300450,"DEC 31, 2023",PHX vs. ORL,W,30,0,3,0.0,0,2,0.0,0,0,0.0,0,1,1,0,2,0,0,3,0,-3,1,Eric Gordon,PHX,PHX,ORL,11.0,Pts+Rebs,1,1,0,1
22023,201569,22300450,"DEC 31, 2023",PHX vs. ORL,W,30,0,3,0.0,0,2,0.0,0,0,0.0,0,1,1,0,2,0,0,3,0,-3,1,Eric Gordon,PHX,PHX,ORL,10.5,Pts+Asts,1,1,0,1
22023,201569,22300450,"DEC 31, 2023",PHX vs. ORL,W,30,0,3,0.0,0,2,0.0,0,0,0.0,0,1,1,0,2,0,0,3,0,-3,1,Eric Gordon,PHX,PHX,ORL,0.5,Steals,1,1,0,1
22023,201569,22300436,"DEC 29, 2023",PHX vs. CHA,W,33,7,12,0.583,7,12,0.583,0,0,0.0,0,2,2,1,0,1,4,1,21,5,1,Eric Gordon,PHX,PHX,CHA,8.5,Points,24,23,22,3
22023,201569,22300436,"DEC 29, 2023",PHX vs. CHA,W,33,7,12,0.583,7,12,0.583,0,0,0.0,0,2,2,1,0,1,4,1,21,5,1,Eric Gordon,PHX,PHX,CHA,11.0,Pts+Rebs,24,23,22,3
22023,201569,22300436,"DEC 29, 2023",PHX vs. CHA,W,33,7,12,0.583,7,12,0.583,0,0,0.0,0,2,2,1,0,1,4,1,21,5,1,Eric Gordon,PHX,PHX,CHA,10.5,Pts+Asts,24,23,22,3
22023,201569,22300436,"DEC 29, 2023",PHX vs. CHA,W,33,7,12,0.583,7,12,0.583,0,0,0.0,0,2,2,1,0,1,4,1,21,5,1,Eric Gordon,PHX,PHX,CHA,0.5,Steals,24,23,22,3
22023,201569,22300418,"DEC 27, 2023",PHX @ HOU,W,39,10,15,0.667,7,11,0.636,0,0,0.0,0,0,0,1,0,3,0,1,27,11,1,Eric Gordon,PHX,HOU,PHX,8.5,Points,28,27,28,1
22023,201569,22300418,"DEC 27, 2023",PHX @ HOU,W,39,10,15,0.667,7,11,0.636,0,0,0.0,0,0,0,1,0,3,0,1,27,11,1,Eric Gordon,PHX,HOU,PHX,11.0,Pts+Rebs,28,27,28,1
22023,201569,22300418,"DEC 27, 2023",PHX @ HOU,W,39,10,15,0.667,7,11,0.636,0,0,0.0,0,0,0,1,0,3,0,1,27,11,1,Eric Gordon,PHX,HOU,PHX,10.5,Pts+Asts,28,27,28,1
22023,201569,22300418,"DEC 27, 2023",PHX @ HOU,W,39,10,15,0.667,7,11,0.636,0,0,0.0,0,0,0,1,0,3,0,1,27,11,1,Eric Gordon,PHX,HOU,PHX,0.5,Steals,28,27,28,1
22023,201569,22300405,"DEC 25, 2023",PHX vs. DAL,L,37,6,12,0.5,2,7,0.286,0,0,0.0,0,1,1,2,0,0,0,3,14,-17,1,Eric Gordon,PHX,PHX,DAL,8.5,Points,17,15,16,3
22023,201569,22300405,"DEC 25, 2023",PHX vs. DAL,L,37,6,12,0.5,2,7,0.286,0,0,0.0,0,1,1,2,0,0,0,3,14,-17,1,Eric Gordon,PHX,PHX,DAL,11.0,Pts+Rebs,17,15,16,3
22023,201569,22300405,"DEC 25, 2023",PHX vs. DAL,L,37,6,12,0.5,2,7,0.286,0,0,0.0,0,1,1,2,0,0,0,3,14,-17,1,Eric Gordon,PHX,PHX,DAL,10.5,Pts+Asts,17,15,16,3
22023,201569,22300405,"DEC 25, 2023",PHX vs. DAL,L,37,6,12,0.5,2,7,0.286,0,0,0.0,0,1,1,2,0,0,0,3,14,-17,1,Eric Gordon,PHX,PHX,DAL,0.5,Steals,17,15,16,3
22023,201569,22300387,"DEC 22, 2023",PHX @ SAC,L,25,0,2,0.0,0,1,0.0,0,0,0.0,0,4,4,2,0,1,0,1,0,-25,1,Eric Gordon,PHX,SAC,PHX,8.5,Points,6,4,2,6
22023,201569,22300387,"DEC 22, 2023",PHX @ SAC,L,25,0,2,0.0,0,1,0.0,0,0,0.0,0,4,4,2,0,1,0,1,0,-25,1,Eric Gordon,PHX,SAC,PHX,11.0,Pts+Rebs,6,4,2,6
22023,201569,22300387,"DEC 22, 2023",PHX @ SAC,L,25,0,2,0.0,0,1,0.0,0,0,0.0,0,4,4,2,0,1,0,1,0,-25,1,Eric Gordon,PHX,SAC,PHX,10.5,Pts+Asts,6,4,2,6
22023,201569,22300387,"DEC 22, 2023",PHX @ SAC,L,25,0,2,0.0,0,1,0.0,0,0,0.0,0,4,4,2,0,1,0,1,0,-25,1,Eric Gordon,PHX,SAC,PHX,0.5,Steals,6,4,2,6
22023,201569,22300363,"DEC 19, 2023",PHX @ POR,L,29,1,7,0.143,1,4,0.25,2,2,1.0,1,2,3,4,2,0,0,1,5,7,1,Eric Gordon,PHX,POR,PHX,8.5,Points,12,8,9,7
22023,201569,22300363,"DEC 19, 2023",PHX @ POR,L,29,1,7,0.143,1,4,0.25,2,2,1.0,1,2,3,4,2,0,0,1,5,7,1,Eric Gordon,PHX,POR,PHX,11.0,Pts+Rebs,12,8,9,7
22023,201569,22300363,"DEC 19, 2023",PHX @ POR,L,29,1,7,0.143,1,4,0.25,2,2,1.0,1,2,3,4,2,0,0,1,5,7,1,Eric Gordon,PHX,POR,PHX,10.5,Pts+Asts,12,8,9,7
22023,201569,22300363,"DEC 19, 2023",PHX @ POR,L,29,1,7,0.143,1,4,0.25,2,2,1.0,1,2,3,4,2,0,0,1,5,7,1,Eric Gordon,PHX,POR,PHX,0.5,Steals,12,8,9,7
22023,201569,22300347,"DEC 17, 2023",PHX vs. WAS,W,30,5,9,0.556,2,6,0.333,1,2,0.5,0,2,2,1,1,0,1,0,13,12,1,Eric Gordon,PHX,PHX,WAS,8.5,Points,16,15,14,3
22023,201569,22300347,"DEC 17, 2023",PHX vs. WAS,W,30,5,9,0.556,2,6,0.333,1,2,0.5,0,2,2,1,1,0,1,0,13,12,1,Eric Gordon,PHX,PHX,WAS,11.0,Pts+Rebs,16,15,14,3
22023,201569,22300347,"DEC 17, 2023",PHX vs. WAS,W,30,5,9,0.556,2,6,0.333,1,2,0.5,0,2,2,1,1,0,1,0,13,12,1,Eric Gordon,PHX,PHX,WAS,10.5,Pts+Asts,16,15,14,3
22023,201569,22300347,"DEC 17, 2023",PHX vs. WAS,W,30,5,9,0.556,2,6,0.333,1,2,0.5,0,2,2,1,1,0,1,0,13,12,1,Eric Gordon,PHX,PHX,WAS,0.5,Steals,16,15,14,3
22023,201569,22300308,"DEC 12, 2023",PHX vs. GSW,W,32,3,11,0.273,1,6,0.167,1,1,1.0,0,0,0,0,0,0,1,1,8,-12,1,Eric Gordon,PHX,PHX,GSW,8.5,Points,8,8,8,0
22023,201569,22300308,"DEC 12, 2023",PHX vs. GSW,W,32,3,11,0.273,1,6,0.167,1,1,1.0,0,0,0,0,0,0,1,1,8,-12,1,Eric Gordon,PHX,PHX,GSW,11.0,Pts+Rebs,8,8,8,0
22023,201569,22300308,"DEC 12, 2023",PHX vs. GSW,W,32,3,11,0.273,1,6,0.167,1,1,1.0,0,0,0,0,0,0,1,1,8,-12,1,Eric Gordon,PHX,PHX,GSW,10.5,Pts+Asts,8,8,8,0
22023,201569,22300308,"DEC 12, 2023",PHX vs. GSW,W,32,3,11,0.273,1,6,0.167,1,1,1.0,0,0,0,0,0,0,1,1,8,-12,1,Eric Gordon,PHX,PHX,GSW,0.5,Steals,8,8,8,0
22023,201569,22301228,"DEC 08, 2023",PHX vs. SAC,L,38,7,13,0.538,3,7,0.429,2,2,1.0,0,0,0,3,2,1,4,3,19,-2,1,Eric Gordon,PHX,PHX,SAC,8.5,Points,22,19,22,3
22023,201569,22301228,"DEC 08, 2023",PHX vs. SAC,L,38,7,13,0.538,3,7,0.429,2,2,1.0,0,0,0,3,2,1,4,3,19,-2,1,Eric Gordon,PHX,PHX,SAC,11.0,Pts+Rebs,22,19,22,3
22023,201569,22301228,"DEC 08, 2023",PHX vs. SAC,L,38,7,13,0.538,3,7,0.429,2,2,1.0,0,0,0,3,2,1,4,3,19,-2,1,Eric Gordon,PHX,PHX,SAC,10.5,Pts+Asts,22,19,22,3
22023,201569,22301228,"DEC 08, 2023",PHX vs. SAC,L,38,7,13,0.538,3,7,0.429,2,2,1.0,0,0,0,3,2,1,4,3,19,-2,1,Eric Gordon,PHX,PHX,SAC,0.5,Steals,22,19,22,3
22023,201569,22301203,"DEC 05, 2023",PHX @ LAL,L,35,3,8,0.375,1,4,0.25,0,0,0.0,0,4,4,4,2,1,1,1,7,7,1,Eric Gordon,PHX,LAL,PHX,8.5,Points,15,11,11,8
22023,201569,22301203,"DEC 05, 2023",PHX @ LAL,L,35,3,8,0.375,1,4,0.25,0,0,0.0,0,4,4,4,2,1,1,1,7,7,1,Eric Gordon,PHX,LAL,PHX,11.0,Pts+Rebs,15,11,11,8
22023,201569,22301203,"DEC 05, 2023",PHX @ LAL,L,35,3,8,0.375,1,4,0.25,0,0,0.0,0,4,4,4,2,1,1,1,7,7,1,Eric Gordon,PHX,LAL,PHX,10.5,Pts+Asts,15,11,11,8
22023,201569,22301203,"DEC 05, 2023",PHX @ LAL,L,35,3,8,0.375,1,4,0.25,0,0,0.0,0,4,4,4,2,1,1,1,7,7,1,Eric Gordon,PHX,LAL,PHX,0.5,Steals,15,11,11,8
22023,201569,22300279,"DEC 01, 2023",PHX vs. DEN,L,33,6,11,0.545,4,7,0.571,0,0,0.0,1,2,3,3,1,1,3,1,16,-6,1,Eric Gordon,PHX,PHX,DEN,8.5,Points,22,19,19,6
22023,201569,22300279,"DEC 01, 2023",PHX vs. DEN,L,33,6,11,0.545,4,7,0.571,0,0,0.0,1,2,3,3,1,1,3,1,16,-6,1,Eric Gordon,PHX,PHX,DEN,11.0,Pts+Rebs,22,19,19,6
22023,201569,22300279,"DEC 01, 2023",PHX vs. DEN,L,33,6,11,0.545,4,7,0.571,0,0,0.0,1,2,3,3,1,1,3,1,16,-6,1,Eric Gordon,PHX,PHX,DEN,10.5,Pts+Asts,22,19,19,6
22023,201569,22300279,"DEC 01, 2023",PHX vs. DEN,L,33,6,11,0.545,4,7,0.571,0,0,0.0,1,2,3,3,1,1,3,1,16,-6,1,Eric Gordon,PHX,PHX,DEN,0.5,Steals,22,19,19,6
22023,201569,22300260,"NOV 29, 2023",PHX @ TOR,L,34,4,9,0.444,2,5,0.4,0,0,0.0,0,1,1,1,1,0,0,2,10,-9,1,Eric Gordon,PHX,TOR,PHX,8.5,Points,12,11,11,2
22023,201569,22300260,"NOV 29, 2023",PHX @ TOR,L,34,4,9,0.444,2,5,0.4,0,0,0.0,0,1,1,1,1,0,0,2,10,-9,1,Eric Gordon,PHX,TOR,PHX,11.0,Pts+Rebs,12,11,11,2
22023,201569,22300260,"NOV 29, 2023",PHX @ TOR,L,34,4,9,0.444,2,5,0.4,0,0,0.0,0,1,1,1,1,0,0,2,10,-9,1,Eric Gordon,PHX,TOR,PHX,10.5,Pts+Asts,12,11,11,2
22023,201569,22300260,"NOV 29, 2023",PHX @ TOR,L,34,4,9,0.444,2,5,0.4,0,0,0.0,0,1,1,1,1,0,0,2,10,-9,1,Eric Gordon,PHX,TOR,PHX,0.5,Steals,12,11,11,2
22023,201569,22300247,"NOV 26, 2023",PHX @ NYK,W,33,9,13,0.692,6,9,0.667,1,2,0.5,0,2,2,2,0,1,2,3,25,0,1,Eric Gordon,PHX,NYK,PHX,8.5,Points,29,27,27,4
22023,201569,22300247,"NOV 26, 2023",PHX @ NYK,W,33,9,13,0.692,6,9,0.667,1,2,0.5,0,2,2,2,0,1,2,3,25,0,1,Eric Gordon,PHX,NYK,PHX,11.0,Pts+Rebs,29,27,27,4
22023,201569,22300247,"NOV 26, 2023",PHX @ NYK,W,33,9,13,0.692,6,9,0.667,1,2,0.5,0,2,2,2,0,1,2,3,25,0,1,Eric Gordon,PHX,NYK,PHX,10.5,Pts+Asts,29,27,27,4
22023,201569,22300247,"NOV 26, 2023",PHX @ NYK,W,33,9,13,0.692,6,9,0.667,1,2,0.5,0,2,2,2,0,1,2,3,25,0,1,Eric Gordon,PHX,NYK,PHX,0.5,Steals,29,27,27,4
22023,201569,22300044,"NOV 24, 2023",PHX @ MEM,W,34,6,15,0.4,4,11,0.364,4,4,1.0,0,1,1,2,0,0,2,0,20,5,1,Eric Gordon,PHX,MEM,PHX,8.5,Points,23,21,22,3
22023,201569,22300044,"NOV 24, 2023",PHX @ MEM,W,34,6,15,0.4,4,11,0.364,4,4,1.0,0,1,1,2,0,0,2,0,20,5,1,Eric Gordon,PHX,MEM,PHX,11.0,Pts+Rebs,23,21,22,3
22023,201569,22300044,"NOV 24, 2023",PHX @ MEM,W,34,6,15,0.4,4,11,0.364,4,4,1.0,0,1,1,2,0,0,2,0,20,5,1,Eric Gordon,PHX,MEM,PHX,10.5,Pts+Asts,23,21,22,3
22023,201569,22300044,"NOV 24, 2023",PHX @ MEM,W,34,6,15,0.4,4,11,0.364,4,4,1.0,0,1,1,2,0,0,2,0,20,5,1,Eric Gordon,PHX,MEM,PHX,0.5,Steals,23,21,22,3
22023,201569,22300236,"NOV 22, 2023",PHX vs. GSW,W,29,4,12,0.333,3,9,0.333,2,3,0.667,0,1,1,4,3,0,2,3,13,9,1,Eric Gordon,PHX,PHX,GSW,8.5,Points,18,14,17,5
22023,201569,22300236,"NOV 22, 2023",PHX vs. GSW,W,29,4,12,0.333,3,9,0.333,2,3,0.667,0,1,1,4,3,0,2,3,13,9,1,Eric Gordon,PHX,PHX,GSW,11.0,Pts+Rebs,18,14,17,5
22023,201569,22300236,"NOV 22, 2023",PHX vs. GSW,W,29,4,12,0.333,3,9,0.333,2,3,0.667,0,1,1,4,3,0,2,3,13,9,1,Eric Gordon,PHX,PHX,GSW,10.5,Pts+Asts,18,14,17,5
22023,201569,22300236,"NOV 22, 2023",PHX vs. GSW,W,29,4,12,0.333,3,9,0.333,2,3,0.667,0,1,1,4,3,0,2,3,13,9,1,Eric Gordon,PHX,PHX,GSW,0.5,Steals,18,14,17,5
22023,201569,22300041,"NOV 21, 2023",PHX vs. POR,W,36,4,5,0.8,2,3,0.667,0,0,0.0,0,2,2,4,1,1,2,2,10,13,1,Eric Gordon,PHX,PHX,POR,8.5,Points,16,12,14,6
22023,201569,22300041,"NOV 21, 2023",PHX vs. POR,W,36,4,5,0.8,2,3,0.667,0,0,0.0,0,2,2,4,1,1,2,2,10,13,1,Eric Gordon,PHX,PHX,POR,11.0,Pts+Rebs,16,12,14,6
22023,201569,22300041,"NOV 21, 2023",PHX vs. POR,W,36,4,5,0.8,2,3,0.667,0,0,0.0,0,2,2,4,1,1,2,2,10,13,1,Eric Gordon,PHX,PHX,POR,10.5,Pts+Asts,16,12,14,6
22023,201569,22300041,"NOV 21, 2023",PHX vs. POR,W,36,4,5,0.8,2,3,0.667,0,0,0.0,0,2,2,4,1,1,2,2,10,13,1,Eric Gordon,PHX,PHX,POR,0.5,Steals,16,12,14,6
22023,201569,22300214,"NOV 19, 2023",PHX @ UTA,W,41,7,16,0.438,5,12,0.417,1,2,0.5,1,4,5,6,2,2,1,3,20,5,1,Eric Gordon,PHX,UTA,PHX,8.5,Points,31,25,26,11
22023,201569,22300214,"NOV 19, 2023",PHX @ UTA,W,41,7,16,0.438,5,12,0.417,1,2,0.5,1,4,5,6,2,2,1,3,20,5,1,Eric Gordon,PHX,UTA,PHX,11.0,Pts+Rebs,31,25,26,11
22023,201569,22300214,"NOV 19, 2023",PHX @ UTA,W,41,7,16,0.438,5,12,0.417,1,2,0.5,1,4,5,6,2,2,1,3,20,5,1,Eric Gordon,PHX,UTA,PHX,10.5,Pts+Asts,31,25,26,11
22023,201569,22300214,"NOV 19, 2023",PHX @ UTA,W,41,7,16,0.438,5,12,0.417,1,2,0.5,1,4,5,6,2,2,1,3,20,5,1,Eric Gordon,PHX,UTA,PHX,0.5,Steals,31,25,26,11
22023,201569,22300035,"NOV 17, 2023",PHX @ UTA,W,33,5,12,0.417,4,8,0.5,0,0,0.0,0,2,2,1,1,1,1,2,14,-2,1,Eric Gordon,PHX,UTA,PHX,8.5,Points,17,16,15,3
22023,201569,22300035,"NOV 17, 2023",PHX @ UTA,W,33,5,12,0.417,4,8,0.5,0,0,0.0,0,2,2,1,1,1,1,2,14,-2,1,Eric Gordon,PHX,UTA,PHX,11.0,Pts+Rebs,17,16,15,3
22023,201569,22300035,"NOV 17, 2023",PHX @ UTA,W,33,5,12,0.417,4,8,0.5,0,0,0.0,0,2,2,1,1,1,1,2,14,-2,1,Eric Gordon,PHX,UTA,PHX,10.5,Pts+Asts,17,16,15,3
22023,201569,22300035,"NOV 17, 2023",PHX @ UTA,W,33,5,12,0.417,4,8,0.5,0,0,0.0,0,2,2,1,1,1,1,2,14,-2,1,Eric Gordon,PHX,UTA,PHX,0.5,Steals,17,16,15,3
22023,201569,22300197,"NOV 15, 2023",PHX vs. MIN,W,29,6,9,0.667,3,6,0.5,0,0,0.0,0,1,1,3,0,0,1,2,15,19,1,Eric Gordon,PHX,PHX,MIN,8.5,Points,19,16,18,4
22023,201569,22300197,"NOV 15, 2023",PHX vs. MIN,W,29,6,9,0.667,3,6,0.5,0,0,0.0,0,1,1,3,0,0,1,2,15,19,1,Eric Gordon,PHX,PHX,MIN,11.0,Pts+Rebs,19,16,18,4
22023,201569,22300197,"NOV 15, 2023",PHX vs. MIN,W,29,6,9,0.667,3,6,0.5,0,0,0.0,0,1,1,3,0,0,1,2,15,19,1,Eric Gordon,PHX,PHX,MIN,10.5,Pts+Asts,19,16,18,4
22023,201569,22300197,"NOV 15, 2023",PHX vs. MIN,W,29,6,9,0.667,3,6,0.5,0,0,0.0,0,1,1,3,0,0,1,2,15,19,1,Eric Gordon,PHX,PHX,MIN,0.5,Steals,19,16,18,4
22023,201569,22300015,"NOV 10, 2023",PHX vs. LAL,L,28,5,9,0.556,3,4,0.75,0,0,0.0,1,1,2,2,3,0,1,0,13,3,1,Eric Gordon,PHX,PHX,LAL,8.5,Points,17,15,15,4
22023,201569,22300015,"NOV 10, 2023",PHX vs. LAL,L,28,5,9,0.556,3,4,0.75,0,0,0.0,1,1,2,2,3,0,1,0,13,3,1,Eric Gordon,PHX,PHX,LAL,11.0,Pts+Rebs,17,15,15,4
22023,201569,22300015,"NOV 10, 2023",PHX vs. LAL,L,28,5,9,0.556,3,4,0.75,0,0,0.0,1,1,2,2,3,0,1,0,13,3,1,Eric Gordon,PHX,PHX,LAL,10.5,Pts+Asts,17,15,15,4
22023,201569,22300015,"NOV 10, 2023",PHX vs. LAL,L,28,5,9,0.556,3,4,0.75,0,0,0.0,1,1,2,2,3,0,1,0,13,3,1,Eric Gordon,PHX,PHX,LAL,0.5,Steals,17,15,15,4
22023,201569,22300162,"NOV 08, 2023",PHX @ CHI,W,25,1,9,0.111,0,8,0.0,0,0,0.0,0,1,1,2,0,0,3,1,2,-16,1,Eric Gordon,PHX,CHI,PHX,8.5,Points,5,3,4,3
22023,201569,22300162,"NOV 08, 2023",PHX @ CHI,W,25,1,9,0.111,0,8,0.0,0,0,0.0,0,1,1,2,0,0,3,1,2,-16,1,Eric Gordon,PHX,CHI,PHX,11.0,Pts+Rebs,5,3,4,3
22023,201569,22300162,"NOV 08, 2023",PHX @ CHI,W,25,1,9,0.111,0,8,0.0,0,0,0.0,0,1,1,2,0,0,3,1,2,-16,1,Eric Gordon,PHX,CHI,PHX,10.5,Pts+Asts,5,3,4,3
22023,201569,22300162,"NOV 08, 2023",PHX @ CHI,W,25,1,9,0.111,0,8,0.0,0,0,0.0,0,1,1,2,0,0,3,1,2,-16,1,Eric Gordon,PHX,CHI,PHX,0.5,Steals,5,3,4,3
22023,201569,22300140,"NOV 05, 2023",PHX @ DET,W,31,8,14,0.571,3,5,0.6,2,2,1.0,2,3,5,8,1,0,1,0,21,23,1,Eric Gordon,PHX,DET,PHX,8.5,Points,34,26,29,13
22023,201569,22300140,"NOV 05, 2023",PHX @ DET,W,31,8,14,0.571,3,5,0.6,2,2,1.0,2,3,5,8,1,0,1,0,21,23,1,Eric Gordon,PHX,DET,PHX,11.0,Pts+Rebs,34,26,29,13
22023,201569,22300140,"NOV 05, 2023",PHX @ DET,W,31,8,14,0.571,3,5,0.6,2,2,1.0,2,3,5,8,1,0,1,0,21,23,1,Eric Gordon,PHX,DET,PHX,10.5,Pts+Asts,34,26,29,13
22023,201569,22300140,"NOV 05, 2023",PHX @ DET,W,31,8,14,0.571,3,5,0.6,2,2,1.0,2,3,5,8,1,0,1,0,21,23,1,Eric Gordon,PHX,DET,PHX,0.5,Steals,34,26,29,13
22023,201569,22300132,"NOV 04, 2023",PHX @ PHI,L,34,6,15,0.4,1,4,0.25,0,0,0.0,0,1,1,3,2,2,1,1,13,-19,1,Eric Gordon,PHX,PHI,PHX,8.5,Points,17,14,16,4
22023,201569,22300132,"NOV 04, 2023",PHX @ PHI,L,34,6,15,0.4,1,4,0.25,0,0,0.0,0,1,1,3,2,2,1,1,13,-19,1,Eric Gordon,PHX,PHI,PHX,11.0,Pts+Rebs,17,14,16,4
22023,201569,22300132,"NOV 04, 2023",PHX @ PHI,L,34,6,15,0.4,1,4,0.25,0,0,0.0,0,1,1,3,2,2,1,1,13,-19,1,Eric Gordon,PHX,PHI,PHX,10.5,Pts+Asts,17,14,16,4
22023,201569,22300132,"NOV 04, 2023",PHX @ PHI,L,34,6,15,0.4,1,4,0.25,0,0,0.0,0,1,1,3,2,2,1,1,13,-19,1,Eric Gordon,PHX,PHI,PHX,0.5,Steals,17,14,16,4
22023,201569,22300131,"NOV 02, 2023",PHX vs. SAS,L,24,3,5,0.6,1,2,0.5,0,0,0.0,0,1,1,1,1,1,0,1,7,-2,1,Eric Gordon,PHX,PHX,SAS,8.5,Points,9,8,8,2
22023,201569,22300131,"NOV 02, 2023",PHX vs. SAS,L,24,3,5,0.6,1,2,0.5,0,0,0.0,0,1,1,1,1,1,0,1,7,-2,1,Eric Gordon,PHX,PHX,SAS,11.0,Pts+Rebs,9,8,8,2
22023,201569,22300131,"NOV 02, 2023",PHX vs. SAS,L,24,3,5,0.6,1,2,0.5,0,0,0.0,0,1,1,1,1,1,0,1,7,-2,1,Eric Gordon,PHX,PHX,SAS,10.5,Pts+Asts,9,8,8,2
22023,201569,22300131,"NOV 02, 2023",PHX vs. SAS,L,24,3,5,0.6,1,2,0.5,0,0,0.0,0,1,1,1,1,1,0,1,7,-2,1,Eric Gordon,PHX,PHX,SAS,0.5,Steals,9,8,8,2
22023,201569,22300113,"OCT 31, 2023",PHX vs. SAS,L,36,8,14,0.571,4,9,0.444,0,0,0.0,0,2,2,6,0,0,4,1,20,8,1,Eric Gordon,PHX,PHX,SAS,8.5,Points,28,22,26,8
22023,201569,22300113,"OCT 31, 2023",PHX vs. SAS,L,36,8,14,0.571,4,9,0.444,0,0,0.0,0,2,2,6,0,0,4,1,20,8,1,Eric Gordon,PHX,PHX,SAS,11.0,Pts+Rebs,28,22,26,8
22023,201569,22300113,"OCT 31, 2023",PHX vs. SAS,L,36,8,14,0.571,4,9,0.444,0,0,0.0,0,2,2,6,0,0,4,1,20,8,1,Eric Gordon,PHX,PHX,SAS,10.5,Pts+Asts,28,22,26,8
22023,201569,22300113,"OCT 31, 2023",PHX vs. SAS,L,36,8,14,0.571,4,9,0.444,0,0,0.0,0,2,2,6,0,0,4,1,20,8,1,Eric Gordon,PHX,PHX,SAS,0.5,Steals,28,22,26,8
22023,201569,22300094,"OCT 28, 2023",PHX vs. UTA,W,26,9,14,0.643,3,7,0.429,0,0,0.0,0,2,2,4,1,0,0,1,21,23,1,Eric Gordon,PHX,PHX,UTA,8.5,Points,27,23,25,6
22023,201569,22300094,"OCT 28, 2023",PHX vs. UTA,W,26,9,14,0.643,3,7,0.429,0,0,0.0,0,2,2,4,1,0,0,1,21,23,1,Eric Gordon,PHX,PHX,UTA,11.0,Pts+Rebs,27,23,25,6
22023,201569,22300094,"OCT 28, 2023",PHX vs. UTA,W,26,9,14,0.643,3,7,0.429,0,0,0.0,0,2,2,4,1,0,0,1,21,23,1,Eric Gordon,PHX,PHX,UTA,10.5,Pts+Asts,27,23,25,6
22023,201569,22300094,"OCT 28, 2023",PHX vs. UTA,W,26,9,14,0.643,3,7,0.429,0,0,0.0,0,2,2,4,1,0,0,1,21,23,1,Eric Gordon,PHX,PHX,UTA,0.5,Steals,27,23,25,6
22023,201569,22300076,"OCT 26, 2023",PHX @ LAL,L,30,6,16,0.375,2,8,0.25,1,1,1.0,1,1,2,0,0,0,2,2,15,-27,1,Eric Gordon,PHX,LAL,PHX,8.5,Points,17,17,15,2
22023,201569,22300076,"OCT 26, 2023",PHX @ LAL,L,30,6,16,0.375,2,8,0.25,1,1,1.0,1,1,2,0,0,0,2,2,15,-27,1,Eric Gordon,PHX,LAL,PHX,11.0,Pts+Rebs,17,17,15,2
22023,201569,22300076,"OCT 26, 2023",PHX @ LAL,L,30,6,16,0.375,2,8,0.25,1,1,1.0,1,1,2,0,0,0,2,2,15,-27,1,Eric Gordon,PHX,LAL,PHX,10.5,Pts+Asts,17,17,15,2
22023,201569,22300076,"OCT 26, 2023",PHX @ LAL,L,30,6,16,0.375,2,8,0.25,1,1,1.0,1,1,2,0,0,0,2,2,15,-27,1,Eric Gordon,PHX,LAL,PHX,0.5,Steals,17,17,15,2
22023,201569,22300062,"OCT 24, 2023",PHX @ GSW,W,32,4,16,0.25,2,9,0.222,0,0,0.0,1,3,4,1,1,1,1,2,10,6,1,Eric Gordon,PHX,GSW,PHX,8.5,Points,15,14,11,5
22023,201569,22300062,"OCT 24, 2023",PHX @ GSW,W,32,4,16,0.25,2,9,0.222,0,0,0.0,1,3,4,1,1,1,1,2,10,6,1,Eric Gordon,PHX,GSW,PHX,11.0,Pts+Rebs,15,14,11,5
22023,201569,22300062,"OCT 24, 2023",PHX @ GSW,W,32,4,16,0.25,2,9,0.222,0,0,0.0,1,3,4,1,1,1,1,2,10,6,1,Eric Gordon,PHX,GSW,PHX,10.5,Pts+Asts,15,14,11,5
22023,201569,22300062,"OCT 24, 2023",PHX @ GSW,W,32,4,16,0.25,2,9,0.222,0,0,0.0,1,3,4,1,1,1,1,2,10,6,1,Eric Gordon,PHX,GSW,PHX,0.5,Steals,15,14,11,5
22023,1628984,22300541,"JAN 12, 2024",SAS vs. CHA,W,10,3,5,0.6,2,4,0.5,0,0,0.0,0,0,0,2,1,0,0,1,8,2,1,Devonte' Graham,SAS,SAS,CHA,,,10,8,10,2
22023,1628984,22300448,"DEC 31, 2023",SAS vs. BOS,L,8,3,4,0.75,2,2,1.0,1,1,1.0,1,1,2,1,0,0,1,0,9,4,1,Devonte' Graham,SAS,SAS,BOS,,,12,11,10,3
22023,1628984,22300398,"DEC 23, 2023",SAS @ DAL,L,8,0,3,0.0,0,2,0.0,0,0,0.0,0,5,5,0,0,0,0,0,0,16,1,Devonte' Graham,SAS,DAL,SAS,,,5,5,0,5
22023,1628984,22300345,"DEC 17, 2023",SAS vs. NOP,L,7,2,3,0.667,2,3,0.667,1,2,0.5,0,0,0,2,0,0,0,1,7,2,1,Devonte' Graham,SAS,SAS,NOP,,,9,7,9,2
22023,1628984,22300331,"DEC 15, 2023",SAS vs. LAL,W,10,0,2,0.0,0,1,0.0,0,0,0.0,0,1,1,3,0,0,0,0,0,-8,1,Devonte' Graham,SAS,SAS,LAL,,,4,1,3,4
22023,1628984,22300252,"NOV 26, 2023",SAS @ DEN,L,7,1,2,0.5,0,1,0.0,0,0,0.0,0,0,0,3,0,0,0,0,2,8,1,Devonte' Graham,SAS,DEN,SAS,,,5,2,5,3
22023,1628984,22300021,"NOV 14, 2023",SAS @ OKC,L,17,1,3,0.333,0,2,0.0,2,3,0.667,0,1,1,7,0,0,2,2,4,5,1,Devonte' Graham,SAS,OKC,SAS,,,12,5,11,8
22023,1628984,22300146,"NOV 06, 2023",SAS @ IND,L,12,0,2,0.0,0,1,0.0,2,2,1.0,1,0,1,1,2,1,0,0,2,-9,1,Devonte' Graham,SAS,IND,SAS,,,4,3,3,2
22023,203924,22300538,"JAN 12, 2024",POR @ MIN,L,31,4,15,0.267,2,7,0.286,3,3,1.0,0,0,0,1,2,0,0,3,13,-36,1,Jerami Grant,POR,MIN,POR,,,14,13,14,1
22023,203924,22300529,"JAN 11, 2024",POR @ OKC,L,25,4,10,0.4,1,3,0.333,0,0,0.0,0,2,2,2,1,1,0,2,9,-40,1,Jerami Grant,POR,OKC,POR,,,13,11,11,4
22023,203924,22300514,"JAN 09, 2024",POR @ NYK,L,28,8,16,0.5,1,4,0.25,4,6,0.667,0,2,2,0,0,0,1,2,21,-31,1,Jerami Grant,POR,NYK,POR,,,23,23,21,2
22023,203924,22300498,"JAN 07, 2024",POR @ BKN,W,42,11,24,0.458,3,7,0.429,2,2,1.0,0,2,2,1,1,1,0,2,27,0,1,Jerami Grant,POR,BKN,POR,,,30,29,28,3
22023,203924,22300487,"JAN 05, 2024",POR @ DAL,L,23,6,11,0.545,2,3,0.667,4,5,0.8,0,1,1,3,3,1,1,1,18,-24,1,Jerami Grant,POR,DAL,POR,,,22,19,21,4
22023,203924,22300472,"JAN 03, 2024",POR @ DAL,L,20,4,9,0.444,1,3,0.333,1,3,0.333,0,1,1,2,0,0,3,3,10,-13,1,Jerami Grant,POR,DAL,POR,,,13,11,12,3
22023,203924,22300456,"JAN 01, 2024",POR @ PHX,L,25,6,12,0.5,1,3,0.333,2,3,0.667,0,1,1,3,1,1,3,1,15,-13,1,Jerami Grant,POR,PHX,POR,,,19,16,18,4
22023,203924,22300437,"DEC 29, 2023",POR vs. SAS,W,39,9,17,0.529,4,5,0.8,5,6,0.833,0,6,6,4,0,0,4,2,27,6,1,Jerami Grant,POR,POR,SAS,,,37,33,31,10
22023,203924,22300427,"DEC 28, 2023",POR vs. SAS,L,41,9,21,0.429,1,5,0.2,10,13,0.769,3,7,10,5,0,0,4,4,29,-7,1,Jerami Grant,POR,POR,SAS,,,44,39,34,15
22023,203924,22300413,"DEC 26, 2023",POR vs. SAC,W,28,5,10,0.5,1,3,0.333,2,3,0.667,0,2,2,2,0,1,0,1,13,-3,1,Jerami Grant,POR,POR,SAC,,,17,15,15,4
22023,203924,22300399,"DEC 23, 2023",POR @ GSW,L,32,5,12,0.417,1,4,0.25,6,8,0.75,1,1,2,3,0,0,2,3,17,-20,1,Jerami Grant,POR,GSW,POR,,,22,19,20,5
22023,203924,22300381,"DEC 21, 2023",POR vs. WAS,L,32,6,14,0.429,4,7,0.571,4,7,0.571,1,1,2,4,1,0,2,4,20,-15,1,Jerami Grant,POR,POR,WAS,,,26,22,24,6
22023,203924,22300363,"DEC 19, 2023",POR vs. PHX,W,36,8,15,0.533,3,4,0.75,3,3,1.0,0,1,1,4,0,2,2,2,22,-10,1,Jerami Grant,POR,POR,PHX,,,27,23,26,5
22023,203924,22300348,"DEC 17, 2023",POR vs. GSW,L,41,11,19,0.579,3,9,0.333,5,5,1.0,1,6,7,6,1,0,3,4,30,-13,1,Jerami Grant,POR,POR,GSW,,,43,37,36,13
22023,203924,22300341,"DEC 16, 2023",POR vs. DAL,L,38,12,20,0.6,1,4,0.25,2,3,0.667,1,4,5,1,0,0,0,2,27,-8,1,Jerami Grant,POR,POR,DAL,,,33,32,28,6
22023,203924,22300289,"DEC 02, 2023",POR @ UTA,L,26,1,9,0.111,0,5,0.0,7,7,1.0,0,3,3,0,0,1,3,2,9,-12,1,Jerami Grant,POR,UTA,POR,,,12,12,9,3
22023,203924,22300265,"NOV 30, 2023",POR @ CLE,W,28,4,12,0.333,3,6,0.5,2,2,1.0,0,2,2,3,2,1,3,4,13,6,1,Jerami Grant,POR,CLE,POR,,,18,15,16,5
22023,203924,22300254,"NOV 27, 2023",POR @ IND,W,38,12,18,0.667,3,3,1.0,7,7,1.0,1,6,7,3,0,3,1,1,34,3,1,Jerami Grant,POR,IND,POR,,,44,41,37,10
22023,203924,22300245,"NOV 26, 2023",POR @ MIL,L,39,7,18,0.389,3,6,0.5,5,6,0.833,1,1,2,2,4,0,4,3,22,-8,1,Jerami Grant,POR,MIL,POR,,,26,24,24,4
22023,203924,22300237,"NOV 22, 2023",POR vs. UTA,W,32,10,13,0.769,5,6,0.833,5,6,0.833,0,2,2,4,1,1,2,3,30,25,1,Jerami Grant,POR,POR,UTA,,,36,32,34,6
22023,203924,22300041,"NOV 21, 2023",POR @ PHX,L,36,8,19,0.421,5,8,0.625,5,6,0.833,1,3,4,6,1,1,1,1,26,-7,1,Jerami Grant,POR,PHX,POR,,,36,30,32,10
22023,203924,22300215,"NOV 19, 2023",POR vs. OKC,L,27,4,12,0.333,1,5,0.2,5,6,0.833,0,0,0,1,1,0,2,1,14,-25,1,Jerami Grant,POR,POR,OKC,,,15,14,15,1
22023,203924,22300036,"NOV 17, 2023",POR vs. LAL,L,40,8,20,0.4,4,9,0.444,4,4,1.0,0,4,4,3,1,0,1,0,24,-14,1,Jerami Grant,POR,POR,LAL,,,31,28,27,7
22023,203924,22300199,"NOV 15, 2023",POR vs. CLE,L,32,7,17,0.412,1,6,0.167,2,2,1.0,0,3,3,2,2,0,3,2,17,4,1,Jerami Grant,POR,POR,CLE,,,22,20,19,5
22023,203924,22300023,"NOV 14, 2023",POR @ UTA,L,27,10,17,0.588,3,6,0.5,3,4,0.75,0,2,2,1,0,1,2,3,26,-11,1,Jerami Grant,POR,UTA,POR,,,29,28,27,3
22023,203924,22300187,"NOV 12, 2023",POR @ LAL,L,41,8,17,0.471,3,6,0.5,4,5,0.8,0,5,5,1,0,1,2,3,23,-15,1,Jerami Grant,POR,LAL,POR,,,29,28,24,6
22023,203924,22300170,"NOV 08, 2023",POR @ SAC,L,46,12,25,0.48,5,8,0.625,9,12,0.75,1,8,9,5,0,3,4,2,38,7,1,Jerami Grant,POR,SAC,POR,,,52,47,43,14
22023,203924,22300144,"NOV 05, 2023",POR vs. MEM,L,38,10,22,0.455,4,13,0.308,3,4,0.75,2,1,3,3,0,0,2,3,27,-22,1,Jerami Grant,POR,POR,MEM,,,33,30,30,6
22023,203924,22300007,"NOV 03, 2023",POR vs. MEM,W,44,9,23,0.391,3,7,0.429,5,9,0.556,2,6,8,3,0,1,3,0,26,9,1,Jerami Grant,POR,POR,MEM,,,37,34,29,11
22023,203924,22300115,"NOV 01, 2023",POR @ DET,W,38,7,16,0.438,2,4,0.5,8,10,0.8,0,1,1,0,1,0,4,4,24,15,1,Jerami Grant,POR,DET,POR,,,25,25,24,1
22023,203924,22300105,"OCT 30, 2023",POR @ TOR,W,37,8,18,0.444,2,8,0.25,4,4,1.0,1,5,6,0,1,1,2,2,22,8,1,Jerami Grant,POR,TOR,POR,,,28,28,22,6
22023,203924,22300098,"OCT 29, 2023",POR @ PHI,L,28,5,16,0.313,1,4,0.25,6,7,0.857,2,3,5,1,0,2,2,2,17,-29,1,Jerami Grant,POR,PHI,POR,,,23,22,18,6
22023,203924,22300086,"OCT 27, 2023",POR vs. ORL,L,36,4,14,0.286,1,5,0.2,6,7,0.857,0,4,4,3,2,0,3,5,15,2,1,Jerami Grant,POR,POR,ORL,,,22,19,18,7
22023,203924,22300074,"OCT 25, 2023",POR @ LAC,L,30,5,12,0.417,0,4,0.0,3,4,0.75,2,1,3,1,0,1,3,1,13,-22,1,Jerami Grant,POR,LAC,POR,,,17,16,14,4
22023,1631260,22300552,"JAN 14, 2024",MIL vs. SAC,W,18,1,5,0.2,1,4,0.25,2,2,1.0,0,0,0,0,0,0,0,2,5,-4,1,AJ Green,MIL,MIL,SAC,,,5,5,5,0
22023,1631260,22300528,"JAN 11, 2024",MIL vs. BOS,W,9,3,6,0.5,2,5,0.4,1,1,1.0,0,2,2,2,0,1,0,1,9,1,1,AJ Green,MIL,MIL,BOS,,,13,11,11,4
22023,1631260,22300510,"JAN 08, 2024",MIL vs. UTA,L,11,3,4,0.75,2,3,0.667,0,0,0.0,1,0,1,0,0,0,0,0,8,-15,1,AJ Green,MIL,MIL,UTA,,,9,9,8,1
22023,1631260,22300496,"JAN 06, 2024",MIL @ HOU,L,3,0,0,0.0,0,0,0.0,0,0,0.0,0,0,0,0,0,0,0,1,0,6,1,AJ Green,MIL,HOU,MIL,,,0,0,0,0
22023,1631260,22300417,"DEC 27, 2023",MIL @ BKN,W,4,1,2,0.5,1,2,0.5,0,0,0.0,0,1,1,0,0,0,0,2,3,7,1,AJ Green,MIL,BKN,MIL,,,4,4,3,1
22023,1631260,22300388,"DEC 23, 2023",MIL @ NYK,W,0,0,0,0.0,0,0,0.0,0,0,0.0,0,0,0,0,0,0,0,0,0,0,1,AJ Green,MIL,NYK,MIL,,,0,0,0,0
22023,1631260,22300361,"DEC 19, 2023",MIL vs. SAS,W,2,0,1,0.0,0,1,0.0,0,0,0.0,0,0,0,0,0,0,0,0,0,-2,1,AJ Green,MIL,MIL,SAS,,,0,0,0,0
22023,1631260,22300346,"DEC 17, 2023",MIL vs. HOU,W,0,0,0,0.0,0,0,0.0,0,0,0.0,0,0,0,0,0,0,0,0,0,-3,1,AJ Green,MIL,MIL,HOU,,,0,0,0,0
22023,1631260,22300334,"DEC 16, 2023",MIL vs. DET,W,20,3,6,0.5,3,6,0.5,0,0,0.0,1,0,1,1,0,0,0,5,9,22,1,AJ Green,MIL,MIL,DET,,,11,10,10,2
22023,1631260,22300315,"DEC 13, 2023",MIL vs. IND,W,1,0,0,0.0,0,0,0.0,0,0,0.0,0,0,0,0,0,0,0,0,0,-9,1,AJ Green,MIL,MIL,IND,,,0,0,0,0
22023,1631260,22300300,"DEC 11, 2023",MIL vs. CHI,W,14,4,6,0.667,4,5,0.8,0,0,0.0,0,5,5,3,0,0,0,1,12,0,1,AJ Green,MIL,MIL,CHI,,,20,17,15,8
22023,1631260,22301229,"DEC 07, 2023",MIL vs. IND,L,4,0,1,0.0,0,0,0.0,0,0,0.0,0,0,0,0,0,0,0,0,0,-1,1,AJ Green,MIL,MIL,IND,,,0,0,0,0
22023,1631260,22301201,"DEC 05, 2023",MIL vs. NYK,W,15,3,4,0.75,3,4,0.75,0,0,0.0,0,0,0,1,0,0,0,0,9,8,1,AJ Green,MIL,MIL,NYK,,,10,9,10,1
22023,1631260,22300286,"DEC 02, 2023",MIL vs. ATL,W,9,0,0,0.0,0,0,0.0,0,0,0.0,1,0,1,0,0,0,0,1,0,9,1,AJ Green,MIL,MIL,ATL,,,1,1,0,1
22023,1631260,22300056,"NOV 28, 2023",MIL @ MIA,W,2,0,1,0.0,0,1,0.0,0,0,0.0,0,0,0,0,0,0,0,1,0,-2,1,AJ Green,MIL,MIA,MIL,,,0,0,0,0
22023,1631260,22300245,"NOV 26, 2023",MIL vs. POR,W,4,0,2,0.0,0,2,0.0,0,0,0.0,1,0,1,0,0,0,0,1,0,-9,1,AJ Green,MIL,MIL,POR,,,1,1,0,1
22023,1631260,22300049,"NOV 24, 2023",MIL vs. WAS,W,4,1,4,0.25,1,4,0.25,0,0,0.0,0,0,0,0,0,0,0,0,3,-2,1,AJ Green,MIL,MIL,WAS,,,3,3,3,0
22023,1631260,22300219,"NOV 20, 2023",MIL @ WAS,W,15,1,4,0.25,0,3,0.0,0,0,0.0,0,2,2,1,0,0,0,1,2,-9,1,AJ Green,MIL,WAS,MIL,,,5,4,3,3
22023,1631260,22300205,"NOV 18, 2023",MIL vs. DAL,W,11,3,5,0.6,2,4,0.5,0,0,0.0,0,0,0,1,0,0,0,1,8,7,1,AJ Green,MIL,MIL,DAL,,,9,8,9,1
22023,1631260,22300027,"NOV 17, 2023",MIL @ CHA,W,3,2,3,0.667,2,3,0.667,0,0,0.0,0,1,1,0,0,0,0,0,6,11,1,AJ Green,MIL,CHA,MIL,,,7,7,6,1
22023,1631260,22300195,"NOV 15, 2023",MIL @ TOR,W,7,0,1,0.0,0,1,0.0,0,0,0.0,0,0,0,0,0,0,0,0,0,-20,1,AJ Green,MIL,TOR,MIL,,,0,0,0,0
22023,1631260,22300173,"NOV 11, 2023",MIL @ ORL,L,9,1,3,0.333,1,3,0.333,0,0,0.0,0,2,2,3,0,0,0,0,3,5,1,AJ Green,MIL,ORL,MIL,,,8,5,6,5
22023,1631260,22300116,"NOV 01, 2023",MIL @ TOR,L,6,1,1,1.0,0,0,0.0,0,0,0.0,0,1,1,1,0,0,0,1,2,6,1,AJ Green,MIL,TOR,MIL,,,4,3,3,2
22023,1631260,22300107,"OCT 30, 2023",MIL vs. MIA,W,15,0,4,0.0,0,3,0.0,0,0,0.0,0,0,0,2,0,0,0,3,0,8,1,AJ Green,MIL,MIL,MIA,,,2,0,2,2
22023,1631260,22300097,"OCT 29, 2023",MIL vs. ATL,L,6,2,2,1.0,2,2,1.0,1,1,1.0,0,1,1,0,0,0,0,0,7,10,1,AJ Green,MIL,MIL,ATL,,,8,8,7,1
22023,201980,22300092,"OCT 28, 2023",PHI @ TOR,W,5,0,1,0.0,0,0,0.0,0,0,0.0,0,0,0,0,0,0,0,1,0,-2,1,Danny Green,PHI,TOR,PHI,,,0,0,0,0
22023,201980,22300075,"OCT 26, 2023",PHI @ MIL,L,14,0,1,0.0,0,1,0.0,0,0,0.0,0,2,2,1,1,0,0,0,0,2,1,Danny Green,PHI,MIL,PHI,,,3,2,1,3
22023,203110,22300560,"JAN 15, 2024",GSW @ MEM,L,24,2,4,0.5,1,1,1.0,2,2,1.0,0,7,7,4,1,0,3,4,7,1,1,Draymond Green,GSW,MEM,GSW,,,18,14,11,11
22023,203110,22300308,"DEC 12, 2023",GSW @ PHX,L,17,1,3,0.333,0,2,0.0,0,0,0.0,0,2,2,2,0,0,3,3,2,-15,1,Draymond Green,GSW,PHX,GSW,,,6,4,4,4
22023,203110,22301222,"DEC 08, 2023",GSW @ OKC,L,35,5,7,0.714,1,2,0.5,1,2,0.5,1,4,5,13,0,1,4,6,12,-2,1,Draymond Green,GSW,OKC,GSW,,,30,17,25,18
22023,203110,22301214,"DEC 06, 2023",GSW vs. POR,W,31,3,7,0.429,0,2,0.0,4,4,1.0,6,4,10,9,0,2,4,3,10,-1,1,Draymond Green,GSW,GSW,POR,,,29,20,19,19
22023,203110,22300280,"DEC 02, 2023",GSW @ LAC,L,32,8,15,0.533,4,8,0.5,1,2,0.5,1,8,9,4,0,1,3,2,21,-6,1,Draymond Green,GSW,LAC,GSW,,,34,30,25,13
22023,203110,22300273,"NOV 30, 2023",GSW vs. LAC,W,29,4,8,0.5,2,4,0.5,3,4,0.75,1,4,5,5,0,0,2,5,13,-11,1,Draymond Green,GSW,GSW,LAC,,,23,18,18,10
22023,203110,22300060,"NOV 28, 2023",GSW @ SAC,L,33,3,8,0.375,2,4,0.5,0,0,0.0,0,6,6,3,0,2,4,4,8,5,1,Draymond Green,GSW,SAC,GSW,,,17,14,11,9
22023,203110,22300025,"NOV 14, 2023",GSW vs. MIN,L,2,0,0,0.0,0,0,0.0,0,0,0.0,0,2,2,0,0,0,1,1,0,-2,1,Draymond Green,GSW,GSW,MIN,,,2,2,0,2
22023,203110,22300186,"NOV 12, 2023",GSW vs. MIN,L,24,3,7,0.429,1,3,0.333,2,2,1.0,2,7,9,7,1,0,2,5,9,-11,1,Draymond Green,GSW,GSW,MIN,,,25,18,16,16
22023,203110,22300176,"NOV 11, 2023",GSW vs. CLE,L,18,3,4,0.75,2,3,0.667,0,0,0.0,2,3,5,4,0,0,1,3,8,-1,1,Draymond Green,GSW,GSW,CLE,,,17,13,12,9
22023,203110,22300145,"NOV 06, 2023",GSW @ DET,W,28,2,4,0.5,0,1,0.0,2,2,1.0,3,6,9,8,0,0,1,2,6,1,1,Draymond Green,GSW,DET,GSW,,,23,15,14,17
22023,203110,22300142,"NOV 05, 2023",GSW @ CLE,L,29,5,11,0.455,2,3,0.667,6,6,1.0,0,3,3,8,3,1,1,0,18,-6,1,Draymond Green,GSW,CLE,GSW,,,29,21,26,11
22023,203110,22300005,"NOV 03, 2023",GSW @ OKC,W,29,5,11,0.455,2,4,0.5,3,3,1.0,2,3,5,3,0,1,3,5,15,-1,1,Draymond Green,GSW,OKC,GSW,,,23,20,18,8
22023,203110,22300126,"NOV 01, 2023",GSW vs. SAC,W,28,4,7,0.571,2,4,0.5,3,4,0.75,2,0,2,9,2,2,2,1,13,-5,1,Draymond Green,GSW,GSW,SAC,,,24,15,22,11
22023,203110,22300108,"OCT 30, 2023",GSW @ NOP,W,22,3,8,0.375,0,2,0.0,0,0,0.0,1,5,6,7,0,1,1,2,6,6,1,Draymond Green,GSW,NOP,GSW,,,19,12,13,13
22023,203110,22300096,"OCT 29, 2023",GSW @ HOU,W,21,2,4,0.5,0,0,0.0,0,1,0.0,1,4,5,5,0,0,4,3,4,2,1,Draymond Green,GSW,HOU,GSW,,,14,9,9,10
22023,1630224,22300555,"JAN 15, 2024",HOU @ PHI,L,27,7,16,0.438,1,7,0.143,5,7,0.714,0,5,5,3,0,0,2,2,20,-7,1,Jalen Green,HOU,PHI,HOU,,,28,25,23,8
22023,1630224,22300542,"JAN 13, 2024",HOU @ BOS,L,20,3,9,0.333,2,5,0.4,2,2,1.0,0,3,3,1,0,0,1,0,10,-17,1,Jalen Green,HOU,BOS,HOU,,,14,13,11,4
22023,1630224,22300534,"JAN 12, 2024",HOU @ DET,W,39,9,25,0.36,2,9,0.222,8,9,0.889,2,2,4,3,2,1,1,3,28,7,1,Jalen Green,HOU,DET,HOU,,,35,32,31,7
22023,1630224,22300523,"JAN 10, 2024",HOU @ CHI,L,40,8,19,0.421,2,7,0.286,0,1,0.0,1,5,6,8,1,0,2,2,18,-4,1,Jalen Green,HOU,CHI,HOU,,,32,24,26,14
22023,1630224,22300509,"JAN 08, 2024",HOU @ MIA,L,31,2,10,0.2,2,8,0.25,5,6,0.833,0,5,5,6,0,0,3,3,11,-11,1,Jalen Green,HOU,MIA,HOU,,,22,16,17,11
22023,1630224,22300496,"JAN 06, 2024",HOU vs. MIL,W,28,5,12,0.417,1,6,0.167,5,5,1.0,0,4,4,2,1,0,1,1,16,4,1,Jalen Green,HOU,HOU,MIL,,,22,20,18,6
22023,1630224,22300485,"JAN 05, 2024",HOU vs. MIN,L,31,7,16,0.438,4,8,0.5,2,4,0.5,1,4,5,2,0,0,2,1,20,-9,1,Jalen Green,HOU,HOU,MIN,,,27,25,22,7
22023,1630224,22300469,"JAN 03, 2024",HOU vs. BKN,W,31,5,15,0.333,3,9,0.333,1,2,0.5,0,8,8,4,0,0,4,1,14,17,1,Jalen Green,HOU,HOU,BKN,,,26,22,18,12
22023,1630224,22300453,"JAN 01, 2024",HOU vs. DET,W,27,6,12,0.5,5,9,0.556,5,6,0.833,0,5,5,1,1,0,0,0,22,20,1,Jalen Green,HOU,HOU,DET,,,28,27,23,6
22023,1630224,22300434,"DEC 29, 2023",HOU vs. PHI,L,36,12,19,0.632,5,9,0.556,2,4,0.5,0,6,6,4,0,0,1,0,31,-7,1,Jalen Green,HOU,HOU,PHI,,,41,37,35,10
22023,1630224,22300418,"DEC 27, 2023",HOU vs. PHX,L,26,8,20,0.4,6,12,0.5,1,2,0.5,1,4,5,3,1,0,2,0,23,-17,1,Jalen Green,HOU,HOU,PHX,,,31,28,26,8
22023,1630224,22300409,"DEC 26, 2023",HOU vs. IND,L,20,2,7,0.286,0,3,0.0,1,2,0.5,0,1,1,2,1,0,0,0,5,-19,1,Jalen Green,HOU,HOU,IND,,,8,6,7,3
22023,1630224,22300392,"DEC 23, 2023",HOU @ NOP,W,22,2,8,0.25,0,4,0.0,5,6,0.833,0,4,4,2,1,0,5,1,9,-2,1,Jalen Green,HOU,NOP,HOU,,,15,13,11,6
22023,1630224,22300385,"DEC 22, 2023",HOU vs. DAL,W,27,5,14,0.357,3,7,0.429,4,4,1.0,1,5,6,4,2,0,4,2,17,35,1,Jalen Green,HOU,HOU,DAL,,,27,23,21,10
22023,1630224,22300371,"DEC 20, 2023",HOU vs. ATL,L,32,7,19,0.368,2,7,0.286,0,0,0.0,1,3,4,2,1,1,1,1,16,-7,1,Jalen Green,HOU,HOU,ATL,,,22,20,18,6
22023,1630224,22300349,"DEC 18, 2023",HOU @ CLE,L,34,2,12,0.167,1,4,0.25,7,7,1.0,0,6,6,3,1,2,2,2,12,-16,1,Jalen Green,HOU,CLE,HOU,,,21,18,15,9
22023,1630224,22300346,"DEC 17, 2023",HOU @ MIL,L,29,6,11,0.545,2,4,0.5,2,2,1.0,0,2,2,7,0,0,1,0,16,-8,1,Jalen Green,HOU,MIL,HOU,,,25,18,23,9
22023,1630224,22300332,"DEC 15, 2023",HOU @ MEM,W,28,4,12,0.333,3,7,0.429,3,4,0.75,1,3,4,4,0,1,1,1,14,-2,1,Jalen Green,HOU,MEM,HOU,,,22,18,18,8
22023,1630224,22300314,"DEC 13, 2023",HOU vs. MEM,W,24,2,12,0.167,0,5,0.0,4,4,1.0,0,4,4,4,0,0,3,3,8,-1,1,Jalen Green,HOU,HOU,MEM,,,16,12,12,8
22023,1630224,22300298,"DEC 11, 2023",HOU vs. SAS,W,24,2,10,0.2,1,4,0.25,2,2,1.0,0,3,3,1,0,0,1,1,7,-14,1,Jalen Green,HOU,HOU,SAS,,,11,10,8,4
22023,1630224,22301224,"DEC 08, 2023",HOU @ DEN,W,35,8,17,0.471,2,9,0.222,7,9,0.778,0,3,3,1,0,0,1,0,25,-8,1,Jalen Green,HOU,DEN,HOU,,,29,28,26,4
22023,1630224,22301212,"DEC 06, 2023",HOU vs. OKC,W,25,6,12,0.5,1,3,0.333,2,2,1.0,0,7,7,1,0,0,3,3,15,0,1,Jalen Green,HOU,HOU,OKC,,,23,22,16,8
22023,1630224,22300291,"DEC 02, 2023",HOU @ LAL,L,32,4,15,0.267,1,6,0.167,1,2,0.5,1,6,7,2,0,0,6,1,10,-6,1,Jalen Green,HOU,LAL,HOU,,,19,17,12,9
22023,1630224,22300263,"NOV 29, 2023",HOU @ DEN,L,34,8,12,0.667,5,8,0.625,5,6,0.833,0,6,6,9,0,1,2,0,26,-11,1,Jalen Green,HOU,DEN,HOU,,,41,32,35,15
22023,1630224,22300059,"NOV 28, 2023",HOU @ DAL,L,34,5,14,0.357,2,6,0.333,0,0,0.0,1,2,3,5,0,1,2,4,12,5,1,Jalen Green,HOU,DAL,HOU,,,20,15,17,8
22023,1630224,22300048,"NOV 24, 2023",HOU vs. DEN,W,36,10,18,0.556,3,8,0.375,2,3,0.667,0,5,5,2,3,0,3,0,25,0,1,Jalen Green,HOU,HOU,DEN,,,32,30,27,7
22023,1630224,22300231,"NOV 22, 2023",HOU vs. MEM,W,30,13,26,0.5,3,13,0.231,5,5,1.0,1,1,2,4,1,0,1,0,34,11,1,Jalen Green,HOU,HOU,MEM,,,40,36,38,6
22023,1630224,22300224,"NOV 20, 2023",HOU @ GSW,L,23,6,15,0.4,2,9,0.222,2,2,1.0,0,3,3,2,0,0,1,3,16,-13,1,Jalen Green,HOU,GSW,HOU,,,21,19,18,5
22023,1630224,22300216,"NOV 19, 2023",HOU @ LAL,L,31,3,10,0.3,2,5,0.4,1,3,0.333,0,6,6,3,0,1,4,1,9,3,1,Jalen Green,HOU,LAL,HOU,,,18,15,12,9
22023,1630224,22300037,"NOV 17, 2023",HOU @ LAC,L,33,5,16,0.313,1,6,0.167,9,10,0.9,0,4,4,5,0,1,4,3,20,-10,1,Jalen Green,HOU,LAC,HOU,,,29,24,25,9
22023,1630224,22300182,"NOV 12, 2023",HOU vs. DEN,W,35,1,13,0.077,1,4,0.25,6,6,1.0,0,8,8,5,1,0,0,1,9,10,1,Jalen Green,HOU,HOU,DEN,,,22,17,14,13
22023,1630224,22300011,"NOV 10, 2023",HOU vs. NOP,W,35,7,18,0.389,2,8,0.25,9,10,0.9,0,4,4,1,0,0,1,1,25,-1,1,Jalen Green,HOU,HOU,NOP,,,30,29,26,5
22023,1630224,22300163,"NOV 08, 2023",HOU vs. LAL,W,21,11,15,0.733,5,6,0.833,1,4,0.25,1,6,7,3,1,0,1,3,28,24,1,Jalen Green,HOU,HOU,LAL,,,38,35,31,10
22023,1630224,22300153,"NOV 06, 2023",HOU vs. SAC,W,26,5,9,0.556,3,5,0.6,10,12,0.833,0,2,2,2,1,1,3,0,23,13,1,Jalen Green,HOU,HOU,SAC,,,27,25,25,4
22023,1630224,22300137,"NOV 04, 2023",HOU vs. SAC,W,36,4,10,0.4,0,2,0.0,2,7,0.286,0,2,2,5,0,0,3,1,10,26,1,Jalen Green,HOU,HOU,SAC,,,17,12,15,7
22023,1630224,22300122,"NOV 01, 2023",HOU vs. CHA,W,31,6,16,0.375,4,8,0.5,7,7,1.0,1,3,4,3,2,0,1,3,23,-4,1,Jalen Green,HOU,HOU,CHA,,,30,27,26,7
22023,1630224,22300096,"OCT 29, 2023",HOU vs. GSW,L,38,8,20,0.4,1,5,0.2,4,5,0.8,1,8,9,1,0,1,4,1,21,4,1,Jalen Green,HOU,HOU,GSW,,,31,30,22,10
22023,1630224,22300083,"OCT 27, 2023",HOU @ SAS,L,38,10,20,0.5,2,6,0.333,0,0,0.0,1,4,5,4,0,0,2,2,22,-3,1,Jalen Green,HOU,SAS,HOU,,,31,27,26,9
22023,1630224,22300066,"OCT 25, 2023",HOU @ ORL,L,30,2,10,0.2,0,1,0.0,6,7,0.857,0,1,1,0,1,1,4,2,10,-12,1,Jalen Green,HOU,ORL,HOU,,,11,11,10,1
22023,201145,22300555,"JAN 15, 2024",HOU @ PHI,L,13,0,5,0.0,0,1,0.0,1,2,0.5,1,1,2,0,0,2,1,1,1,-30,1,Jeff Green,HOU,PHI,HOU,,,3,3,1,2
22023,201145,22300542,"JAN 13, 2024",HOU @ BOS,L,14,3,5,0.6,1,1,1.0,2,2,1.0,0,1,1,1,0,0,0,1,9,-6,1,Jeff Green,HOU,BOS,HOU,,,11,10,10,2
22023,201145,22300534,"JAN 12, 2024",HOU @ DET,W,13,2,2,1.0,0,0,0.0,2,2,1.0,0,2,2,0,0,0,1,2,6,-3,1,Jeff Green,HOU,DET,HOU,,,8,8,6,2
22023,201145,22300523,"JAN 10, 2024",HOU @ CHI,L,19,4,5,0.8,0,1,0.0,1,1,1.0,1,2,3,1,0,0,1,1,9,3,1,Jeff Green,HOU,CHI,HOU,,,13,12,10,4
22023,201145,22300509,"JAN 08, 2024",HOU @ MIA,L,20,2,4,0.5,0,1,0.0,1,2,0.5,0,0,0,2,0,1,1,3,5,-9,1,Jeff Green,HOU,MIA,HOU,,,7,5,7,2
22023,201145,22300496,"JAN 06, 2024",HOU vs. MIL,W,34,5,11,0.455,2,5,0.4,4,5,0.8,0,2,2,2,0,1,1,4,16,2,1,Jeff Green,HOU,HOU,MIL,,,20,18,18,4
22023,201145,22300485,"JAN 05, 2024",HOU vs. MIN,L,21,2,4,0.5,0,2,0.0,0,0,0.0,1,0,1,0,0,0,0,2,4,-17,1,Jeff Green,HOU,HOU,MIN,,,5,5,4,1
22023,201145,22300469,"JAN 03, 2024",HOU vs. BKN,W,17,2,4,0.5,2,2,1.0,2,2,1.0,0,0,0,0,0,0,1,1,8,-7,1,Jeff Green,HOU,HOU,BKN,,,8,8,8,0
22023,201145,22300453,"JAN 01, 2024",HOU vs. DET,W,9,1,2,0.5,0,1,0.0,1,2,0.5,0,2,2,2,0,0,1,0,3,6,1,Jeff Green,HOU,HOU,DET,,,7,5,5,4
22023,201145,22300434,"DEC 29, 2023",HOU vs. PHI,L,33,5,11,0.455,0,2,0.0,0,1,0.0,2,2,4,0,1,1,0,2,10,-7,1,Jeff Green,HOU,HOU,PHI,,,14,14,10,4
22023,201145,22300418,"DEC 27, 2023",HOU vs. PHX,L,7,1,3,0.333,0,1,0.0,0,0,0.0,0,1,1,1,0,1,1,2,2,-9,1,Jeff Green,HOU,HOU,PHX,,,4,3,3,2
22023,201145,22300409,"DEC 26, 2023",HOU vs. IND,L,11,1,1,1.0,0,0,0.0,0,0,0.0,0,0,0,0,0,0,1,2,2,5,1,Jeff Green,HOU,HOU,IND,,,2,2,2,0
22023,201145,22300392,"DEC 23, 2023",HOU @ NOP,W,21,1,3,0.333,0,1,0.0,0,0,0.0,1,2,3,2,0,0,0,1,2,6,1,Jeff Green,HOU,NOP,HOU,,,7,5,4,5
22023,201145,22300385,"DEC 22, 2023",HOU vs. DAL,W,8,1,2,0.5,0,0,0.0,0,0,0.0,0,1,1,0,0,2,0,0,2,5,1,Jeff Green,HOU,HOU,DAL,,,3,3,2,1
22023,201145,22300371,"DEC 20, 2023",HOU vs. ATL,L,12,1,2,0.5,0,1,0.0,0,0,0.0,0,1,1,0,0,0,3,4,2,-10,1,Jeff Green,HOU,HOU,ATL,,,3,3,2,1
22023,201145,22300349,"DEC 18, 2023",HOU @ CLE,L,24,6,6,1.0,0,0,0.0,3,3,1.0,0,1,1,3,0,1,1,3,15,16,1,Jeff Green,HOU,CLE,HOU,,,19,16,18,4
22023,201145,22300346,"DEC 17, 2023",HOU @ MIL,L,17,4,5,0.8,1,1,1.0,7,8,0.875,0,0,0,1,0,0,1,0,16,-2,1,Jeff Green,HOU,MIL,HOU,,,17,16,17,1
22023,201145,22300332,"DEC 15, 2023",HOU @ MEM,W,19,3,9,0.333,0,1,0.0,6,7,0.857,2,2,4,1,0,1,1,1,12,8,1,Jeff Green,HOU,MEM,HOU,,,17,16,13,5
22023,201145,22300314,"DEC 13, 2023",HOU vs. MEM,W,13,3,3,1.0,0,0,0.0,3,3,1.0,1,2,3,0,0,0,2,2,9,10,1,Jeff Green,HOU,HOU,MEM,,,12,12,9,3
22023,201145,22300298,"DEC 11, 2023",HOU vs. SAS,W,19,2,4,0.5,1,2,0.5,7,7,1.0,1,1,2,1,0,0,0,3,12,-6,1,Jeff Green,HOU,HOU,SAS,,,15,14,13,3
22023,201145,22301224,"DEC 08, 2023",HOU @ DEN,W,27,0,1,0.0,0,1,0.0,5,6,0.833,2,2,4,1,1,1,0,4,5,2,1,Jeff Green,HOU,DEN,HOU,,,10,9,6,5
22023,201145,22300291,"DEC 02, 2023",HOU @ LAL,L,11,0,2,0.0,0,0,0.0,0,0,0.0,0,1,1,0,0,0,2,3,0,-12,1,Jeff Green,HOU,LAL,HOU,,,1,1,0,1
22023,201145,22300263,"NOV 29, 2023",HOU @ DEN,L,22,4,6,0.667,2,3,0.667,2,3,0.667,0,2,2,2,1,1,0,1,12,4,1,Jeff Green,HOU,DEN,HOU,,,16,14,14,4
22023,201145,22300059,"NOV 28, 2023",HOU @ DAL,L,13,2,2,1.0,0,0,0.0,2,2,1.0,0,0,0,1,0,0,2,1,6,2,1,Jeff Green,HOU,DAL,HOU,,,7,6,7,1
22023,201145,22300048,"NOV 24, 2023",HOU vs. DEN,W,8,0,2,0.0,0,2,0.0,0,0,0.0,0,0,0,0,0,3,0,0,0,12,1,Jeff Green,HOU,HOU,DEN,,,0,0,0,0
22023,201145,22300231,"NOV 22, 2023",HOU vs. MEM,W,12,0,3,0.0,0,1,0.0,0,0,0.0,0,1,1,0,0,1,0,1,0,2,1,Jeff Green,HOU,HOU,MEM,,,1,1,0,1
22023,201145,22300224,"NOV 20, 2023",HOU @ GSW,L,14,1,4,0.25,1,3,0.333,2,2,1.0,1,0,1,1,0,0,0,0,5,-11,1,Jeff Green,HOU,GSW,HOU,,,7,6,6,2
22023,201145,22300216,"NOV 19, 2023",HOU @ LAL,L,14,5,5,1.0,0,0,0.0,3,3,1.0,0,2,2,0,0,0,0,2,13,-15,1,Jeff Green,HOU,LAL,HOU,,,15,15,13,2
22023,201145,22300037,"NOV 17, 2023",HOU @ LAC,L,15,0,3,0.0,0,1,0.0,0,0,0.0,1,1,2,2,0,0,1,0,0,4,1,Jeff Green,HOU,LAC,HOU,,,4,2,2,4
22023,201145,22300182,"NOV 12, 2023",HOU vs. DEN,W,26,5,7,0.714,2,4,0.5,3,4,0.75,1,3,4,0,1,1,0,1,15,14,1,Jeff Green,HOU,HOU,DEN,,,19,19,15,4
22023,201145,22300011,"NOV 10, 2023",HOU vs. NOP,W,23,1,3,0.333,0,2,0.0,3,3,1.0,1,3,4,0,0,0,1,1,5,12,1,Jeff Green,HOU,HOU,NOP,,,9,9,5,4
22023,201145,22300163,"NOV 08, 2023",HOU vs. LAL,W,11,4,5,0.8,0,0,0.0,1,2,0.5,3,3,6,0,0,0,1,3,9,10,1,Jeff Green,HOU,HOU,LAL,,,15,15,9,6
22023,201145,22300153,"NOV 06, 2023",HOU vs. SAC,W,5,2,2,1.0,0,0,0.0,2,4,0.5,0,1,1,0,1,0,0,1,6,12,1,Jeff Green,HOU,HOU,SAC,,,7,7,6,1
22023,201145,22300137,"NOV 04, 2023",HOU vs. SAC,W,5,0,1,0.0,0,0,0.0,1,2,0.5,2,3,5,0,0,0,1,0,1,-2,1,Jeff Green,HOU,HOU,SAC,,,6,6,1,5
22023,201145,22300122,"NOV 01, 2023",HOU vs. CHA,W,12,2,3,0.667,2,2,1.0,3,4,0.75,0,2,2,0,0,0,1,1,9,2,1,Jeff Green,HOU,HOU,CHA,,,11,11,9,2
22023,201145,22300096,"OCT 29, 2023",HOU vs. GSW,L,21,2,7,0.286,0,2,0.0,2,2,1.0,1,2,3,2,0,1,0,0,6,-13,1,Jeff Green,HOU,HOU,GSW,,,11,9,8,5
22023,201145,22300083,"OCT 27, 2023",HOU @ SAS,L,21,4,4,1.0,0,0,0.0,2,2,1.0,0,1,1,1,0,0,0,1,10,-1,1,Jeff Green,HOU,SAS,HOU,,,12,11,11,2
22023,201145,22300066,"OCT 25, 2023",HOU @ ORL,L,14,2,4,0.5,0,1,0.0,0,1,0.0,3,0,3,1,0,0,1,2,4,-11,1,Jeff Green,HOU,ORL,HOU,,,8,7,5,4
22023,1630182,22300556,"JAN 15, 2024",DAL vs. NOP,W,30,4,8,0.5,3,5,0.6,2,6,0.333,1,3,4,3,0,0,1,5,13,14,1,Josh Green,DAL,DAL,NOP,,,20,17,16,7
22023,1630182,22300547,"JAN 13, 2024",DAL vs. NOP,L,32,3,8,0.375,1,3,0.333,2,2,1.0,2,4,6,4,0,0,3,2,9,-3,1,Josh Green,DAL,DAL,NOP,,,19,15,13,10
22023,1630182,22300530,"JAN 11, 2024",DAL vs. NYK,W,35,8,12,0.667,2,4,0.5,0,2,0.0,0,2,2,3,1,0,0,2,18,-15,1,Josh Green,DAL,DAL,NYK,,,23,20,21,5
22023,1630182,22300515,"JAN 09, 2024",DAL vs. MEM,L,23,0,3,0.0,0,1,0.0,0,0,0.0,1,2,3,0,0,1,0,1,0,1,1,Josh Green,DAL,DAL,MEM,,,3,3,0,3
22023,1630182,22300501,"JAN 07, 2024",DAL vs. MIN,W,31,2,3,0.667,0,1,0.0,0,0,0.0,0,5,5,1,0,1,0,2,4,-2,1,Josh Green,DAL,DAL,MIN,,,10,9,5,6
22023,1630182,22300487,"JAN 05, 2024",DAL vs. POR,W,25,7,8,0.875,0,0,0.0,0,0,0.0,2,3,5,5,1,0,1,0,14,28,1,Josh Green,DAL,DAL,POR,,,24,19,19,10
22023,1630182,22300472,"JAN 03, 2024",DAL vs. POR,W,27,3,5,0.6,0,2,0.0,2,2,1.0,0,4,4,1,2,0,0,4,8,22,1,Josh Green,DAL,DAL,POR,,,13,12,9,5
22023,1630182,22300457,"JAN 01, 2024",DAL @ UTA,L,21,0,4,0.0,0,1,0.0,0,0,0.0,0,2,2,1,0,0,2,4,0,-21,1,Josh Green,DAL,UTA,DAL,,,3,2,1,3
22023,1630182,22300444,"DEC 30, 2023",DAL @ GSW,W,25,6,8,0.75,3,4,0.75,3,3,1.0,0,0,0,2,0,0,1,0,18,2,1,Josh Green,DAL,GSW,DAL,,,20,18,20,2
22023,1630182,22300423,"DEC 28, 2023",DAL @ MIN,L,15,1,3,0.333,0,1,0.0,0,0,0.0,0,0,0,5,0,0,1,0,2,-7,1,Josh Green,DAL,MIN,DAL,,,7,2,7,5
22023,1630182,22300420,"DEC 27, 2023",DAL vs. CLE,L,21,1,4,0.25,0,2,0.0,0,0,0.0,0,3,3,5,2,0,1,1,2,12,1,Josh Green,DAL,DAL,CLE,,,10,5,7,8
22023,1630182,22300277,"DEC 01, 2023",DAL vs. MEM,L,31,4,10,0.4,1,3,0.333,1,1,1.0,0,2,2,5,3,0,3,0,10,-6,1,Josh Green,DAL,DAL,MEM,,,17,12,15,7
22023,1630182,22300059,"NOV 28, 2023",DAL vs. HOU,W,30,2,4,0.5,1,1,1.0,0,0,0.0,1,6,7,2,0,1,1,4,5,12,1,Josh Green,DAL,DAL,HOU,,,14,12,7,9
22023,1630182,22300244,"NOV 25, 2023",DAL @ LAC,L,9,0,2,0.0,0,1,0.0,0,0,0.0,0,1,1,1,0,0,0,2,0,-15,1,Josh Green,DAL,LAC,DAL,,,2,1,1,2
22023,1630182,22300238,"NOV 22, 2023",DAL @ LAL,W,22,6,10,0.6,3,6,0.5,0,0,0.0,0,3,3,1,0,0,0,1,15,10,1,Josh Green,DAL,LAL,DAL,,,19,18,16,4
22023,1630182,22300212,"NOV 19, 2023",DAL vs. SAC,L,26,4,8,0.5,2,5,0.4,1,2,0.5,1,3,4,5,2,0,1,2,11,-1,1,Josh Green,DAL,DAL,SAC,,,20,15,16,9
22023,1630182,22300205,"NOV 18, 2023",DAL @ MIL,L,20,1,3,0.333,1,3,0.333,0,0,0.0,1,3,4,3,0,0,0,1,3,-27,1,Josh Green,DAL,MIL,DAL,,,10,7,6,7
22023,1630182,22300192,"NOV 15, 2023",DAL @ WAS,W,37,0,4,0.0,0,4,0.0,0,0,0.0,1,3,4,1,1,0,0,1,0,12,1,Josh Green,DAL,WAS,DAL,,,5,4,1,5
22023,1630182,22300022,"NOV 14, 2023",DAL @ NOP,L,28,1,3,0.333,0,2,0.0,0,0,0.0,1,4,5,4,0,0,2,1,2,-14,1,Josh Green,DAL,NOP,DAL,,,11,7,6,9
22023,1630182,22300183,"NOV 12, 2023",DAL @ NOP,W,28,5,11,0.455,3,7,0.429,0,0,0.0,0,2,2,3,2,0,1,1,13,11,1,Josh Green,DAL,NOP,DAL,,,18,15,16,5
22023,1630182,22300014,"NOV 10, 2023",DAL vs. LAC,W,18,1,4,0.25,1,4,0.25,0,0,0.0,0,0,0,3,0,0,0,2,3,-15,1,Josh Green,DAL,DAL,LAC,,,6,3,6,3
22023,1630182,22300168,"NOV 08, 2023",DAL vs. TOR,L,18,1,3,0.333,1,2,0.5,0,0,0.0,0,1,1,2,0,1,1,2,3,-21,1,Josh Green,DAL,DAL,TOR,,,6,4,5,3
22023,1630182,22300147,"NOV 06, 2023",DAL @ ORL,W,20,2,3,0.667,1,2,0.5,1,2,0.5,0,2,2,1,1,0,1,3,6,10,1,Josh Green,DAL,ORL,DAL,,,9,8,7,3
22023,1630182,22300143,"NOV 05, 2023",DAL vs. CHA,W,24,3,9,0.333,1,4,0.25,0,2,0.0,0,2,2,3,1,1,1,1,7,2,1,Josh Green,DAL,DAL,CHA,,,12,9,10,5
22023,1630182,22300006,"NOV 03, 2023",DAL @ DEN,L,27,5,8,0.625,3,5,0.6,0,0,0.0,1,4,5,2,2,0,0,2,13,4,1,Josh Green,DAL,DEN,DAL,,,20,18,15,7
22023,1630182,22300124,"NOV 01, 2023",DAL vs. CHI,W,26,1,5,0.2,1,5,0.2,0,0,0.0,0,3,3,1,0,0,2,2,3,14,1,Josh Green,DAL,DAL,CHI,,,7,6,4,4
22023,1630182,22300106,"OCT 30, 2023",DAL @ MEM,W,34,5,10,0.5,2,4,0.5,0,0,0.0,1,1,2,3,1,0,1,0,12,4,1,Josh Green,DAL,MEM,DAL,,,17,14,15,5
22023,1630182,22300084,"OCT 27, 2023",DAL vs. BKN,W,28,2,7,0.286,0,3,0.0,3,6,0.5,1,2,3,2,3,0,3,2,7,8,1,Josh Green,DAL,DAL,BKN,,,12,10,9,5
22023,1630182,22300073,"OCT 25, 2023",DAL @ SAS,W,30,3,5,0.6,2,2,1.0,3,4,0.75,2,0,2,1,1,0,0,4,11,4,1,Josh Green,DAL,SAS,DAL,,,14,13,12,3
22023,1631100,22300543,"JAN 13, 2024",ATL vs. WAS,L,5,0,1,0.0,0,1,0.0,0,0,0.0,0,1,1,0,0,0,0,0,0,1,1,AJ Griffin,ATL,ATL,WAS,,,1,1,0,1
22023,1631100,22300533,"JAN 12, 2024",ATL vs. IND,L,4,1,2,0.5,0,1,0.0,0,0,0.0,0,0,0,0,0,1,0,0,2,2,1,AJ Griffin,ATL,ATL,IND,,,2,2,2,0
22023,1631100,22300480,"JAN 05, 2024",ATL @ IND,L,7,1,3,0.333,1,3,0.333,0,0,0.0,0,0,0,0,0,0,2,0,3,-2,1,AJ Griffin,ATL,IND,ATL,,,3,3,3,0
22023,1631100,22300296,"DEC 11, 2023",ATL vs. DEN,L,9,0,1,0.0,0,1,0.0,0,0,0.0,0,2,2,1,0,0,0,1,0,1,1,AJ Griffin,ATL,ATL,DEN,,,3,2,1,3
22023,1631100,22300055,"NOV 28, 2023",ATL @ CLE,L,15,0,8,0.0,0,4,0.0,0,0,0.0,1,0,1,0,0,0,0,1,0,-2,1,AJ Griffin,ATL,CLE,ATL,,,1,1,0,1
22023,1631100,22300246,"NOV 26, 2023",ATL @ BOS,L,12,0,5,0.0,0,3,0.0,0,0,0.0,0,4,4,1,0,0,0,0,0,7,1,AJ Griffin,ATL,BOS,ATL,,,5,4,1,5
22023,1631100,22300241,"NOV 25, 2023",ATL @ WAS,W,6,2,3,0.667,2,3,0.667,0,0,0.0,0,0,0,0,0,0,0,0,6,-4,1,AJ Griffin,ATL,WAS,ATL,,,6,6,6,0
22023,1631100,22300227,"NOV 22, 2023",ATL vs. BKN,W,3,0,0,0.0,0,0,0.0,0,0,0.0,0,0,0,0,0,0,0,0,0,10,1,AJ Griffin,ATL,ATL,BKN,,,0,0,0,0
22023,1631100,22300018,"NOV 14, 2023",ATL @ DET,W,8,1,3,0.333,1,3,0.333,2,2,1.0,0,0,0,0,0,0,0,2,5,1,1,AJ Griffin,ATL,DET,ATL,,,5,5,5,0
22023,1631100,22300172,"NOV 09, 2023",ATL @ ORL,W,10,1,2,0.5,0,1,0.0,0,0,0.0,0,0,0,0,0,0,2,1,2,-11,1,AJ Griffin,ATL,ORL,ATL,,,2,2,2,0
22023,1631100,22300117,"NOV 01, 2023",ATL vs. WAS,W,12,0,2,0.0,0,2,0.0,0,0,0.0,0,0,0,0,0,0,0,0,0,-14,1,AJ Griffin,ATL,ATL,WAS,,,0,0,0,0
22023,1631100,22300104,"OCT 30, 2023",ATL vs. MIN,W,6,1,1,1.0,1,1,1.0,0,0,0.0,0,0,0,1,0,0,0,0,3,-8,1,AJ Griffin,ATL,ATL,MIN,,,4,3,4,1
22023,1631100,22300097,"OCT 29, 2023",ATL @ MIL,W,10,2,3,0.667,2,2,1.0,0,0,0.0,1,0,1,1,1,0,1,0,6,-7,1,AJ Griffin,ATL,MIL,ATL,,,8,7,7,2
22023,1631100,22300079,"OCT 27, 2023",ATL vs. NYK,L,8,2,4,0.5,2,4,0.5,0,0,0.0,0,2,2,0,0,0,0,0,6,-4,1,AJ Griffin,ATL,ATL,NYK,,,8,8,6,2
22023,1631100,22300063,"OCT 25, 2023",ATL @ CHA,L,10,1,2,0.5,0,1,0.0,0,0,0.0,0,2,2,0,0,0,1,1,2,2,1,AJ Griffin,ATL,CHA,ATL,,,4,4,2,2
22023,1629656,22300557,"JAN 15, 2024",NYK vs. ORL,L,14,3,4,0.75,2,3,0.667,0,0,0.0,0,2,2,1,1,0,2,2,8,-12,1,Quentin Grimes,NYK,NYK,ORL,,,11,10,9,3
22023,1629656,22300544,"JAN 13, 2024",NYK @ MEM,W,15,1,5,0.2,1,4,0.25,0,0,0.0,0,2,2,1,0,0,0,1,3,4,1,Quentin Grimes,NYK,MEM,NYK,,,6,5,4,3
22023,1629656,22300530,"JAN 11, 2024",NYK @ DAL,L,15,3,6,0.5,3,6,0.5,0,2,0.0,0,0,0,3,0,0,0,1,9,-8,1,Quentin Grimes,NYK,DAL,NYK,,,12,9,12,3
22023,1629656,22300514,"JAN 09, 2024",NYK vs. POR,W,21,5,11,0.455,4,9,0.444,3,3,1.0,0,4,4,1,3,0,2,1,17,9,1,Quentin Grimes,NYK,NYK,POR,,,22,21,18,5
22023,1629656,22300494,"JAN 06, 2024",NYK @ WAS,W,15,2,5,0.4,2,4,0.5,0,0,0.0,0,1,1,1,1,0,1,1,6,-6,1,Quentin Grimes,NYK,WAS,NYK,,,8,7,7,2
22023,1629656,22300483,"JAN 05, 2024",NYK @ PHI,W,24,6,13,0.462,4,9,0.444,3,3,1.0,2,6,8,2,1,1,1,3,19,37,1,Quentin Grimes,NYK,PHI,NYK,,,29,27,21,10
22023,1629656,22300468,"JAN 03, 2024",NYK vs. CHI,W,18,3,9,0.333,2,6,0.333,0,0,0.0,0,1,1,0,1,0,0,0,8,-20,1,Quentin Grimes,NYK,NYK,CHI,,,9,9,8,1
22023,1629656,22300451,"JAN 01, 2024",NYK vs. MIN,W,18,3,4,0.75,2,3,0.667,2,2,1.0,2,1,3,1,0,0,0,1,10,-6,1,Quentin Grimes,NYK,NYK,MIN,,,14,13,11,4
22023,1629656,22300429,"DEC 29, 2023",NYK @ ORL,L,14,1,3,0.333,1,3,0.333,0,0,0.0,0,2,2,0,1,0,0,1,3,1,1,Quentin Grimes,NYK,ORL,NYK,,,5,5,3,2
22023,1629656,22300419,"DEC 27, 2023",NYK @ OKC,L,11,2,2,1.0,2,2,1.0,0,0,0.0,0,3,3,1,0,0,0,1,6,0,1,Quentin Grimes,NYK,OKC,NYK,,,10,9,7,4
22023,1629656,22300401,"DEC 25, 2023",NYK vs. MIL,W,12,1,2,0.5,0,1,0.0,0,1,0.0,0,1,1,2,0,0,0,0,2,-1,1,Quentin Grimes,NYK,NYK,MIL,,,5,3,4,3
22023,1629656,22300388,"DEC 23, 2023",NYK vs. MIL,L,16,1,3,0.333,0,1,0.0,0,0,0.0,0,2,2,0,1,0,0,2,2,-5,1,Quentin Grimes,NYK,NYK,MIL,,,4,4,2,2
22023,1629656,22300368,"DEC 20, 2023",NYK @ BKN,W,18,2,7,0.286,1,4,0.25,0,0,0.0,0,1,1,0,1,1,0,1,5,-2,1,Quentin Grimes,NYK,BKN,NYK,,,6,6,5,1
22023,1629656,22300359,"DEC 18, 2023",NYK @ LAL,W,11,1,5,0.2,1,4,0.25,0,0,0.0,0,0,0,2,1,0,0,0,3,4,1,Quentin Grimes,NYK,LAL,NYK,,,5,3,5,2
22023,1629656,22300343,"DEC 16, 2023",NYK @ LAC,L,24,3,8,0.375,2,5,0.4,0,0,0.0,0,1,1,0,1,0,0,3,8,-5,1,Quentin Grimes,NYK,LAC,NYK,,,9,9,8,1
22023,1629656,22300333,"DEC 15, 2023",NYK @ PHX,W,15,3,7,0.429,3,6,0.5,0,0,0.0,2,0,2,1,0,0,0,2,9,12,1,Quentin Grimes,NYK,PHX,NYK,,,12,11,10,3
22023,1629656,22300318,"DEC 13, 2023",NYK @ UTA,L,16,1,4,0.25,0,3,0.0,0,2,0.0,0,2,2,1,0,0,1,1,2,-27,1,Quentin Grimes,NYK,UTA,NYK,,,5,4,3,3
22023,1629656,22300297,"DEC 11, 2023",NYK vs. TOR,W,27,7,11,0.636,5,7,0.714,0,0,0.0,0,3,3,1,0,0,0,0,19,10,1,Quentin Grimes,NYK,NYK,TOR,,,23,22,20,4
22023,1629656,22301227,"DEC 08, 2023",NYK @ BOS,L,19,5,10,0.5,3,7,0.429,0,0,0.0,0,1,1,2,0,0,2,1,13,12,1,Quentin Grimes,NYK,BOS,NYK,,,16,14,15,3
22023,1629656,22301201,"DEC 05, 2023",NYK @ MIL,L,18,0,1,0.0,0,1,0.0,0,0,0.0,0,1,1,0,1,0,0,4,0,-3,1,Quentin Grimes,NYK,MIL,NYK,,,1,1,0,1
22023,1629656,22300276,"DEC 01, 2023",NYK @ TOR,W,21,1,3,0.333,0,2,0.0,2,2,1.0,1,0,1,2,0,0,0,2,4,0,1,Quentin Grimes,NYK,TOR,NYK,,,7,5,6,3
22023,1629656,22300268,"NOV 30, 2023",NYK vs. DET,W,16,0,5,0.0,0,3,0.0,0,0,0.0,0,1,1,0,2,0,0,1,0,-2,1,Quentin Grimes,NYK,NYK,DET,,,1,1,0,1
22023,1629656,22300057,"NOV 28, 2023",NYK vs. CHA,W,19,2,4,0.5,2,3,0.667,0,0,0.0,1,0,1,1,0,0,1,0,6,2,1,Quentin Grimes,NYK,NYK,CHA,,,8,7,7,2
22023,1629656,22300247,"NOV 26, 2023",NYK vs. PHX,L,20,1,5,0.2,1,3,0.333,0,0,0.0,1,2,3,2,0,0,1,2,3,-8,1,Quentin Grimes,NYK,NYK,PHX,,,8,6,5,5
22023,1629656,22300045,"NOV 24, 2023",NYK vs. MIA,W,21,1,4,0.25,1,3,0.333,0,0,0.0,0,0,0,2,1,0,0,3,3,-20,1,Quentin Grimes,NYK,NYK,MIA,,,5,3,5,2
22023,1629656,22300221,"NOV 20, 2023",NYK @ MIN,L,25,0,6,0.0,0,6,0.0,0,0,0.0,0,1,1,2,2,0,0,2,0,-18,1,Quentin Grimes,NYK,MIN,NYK,,,3,1,2,3
22023,1629656,22300193,"NOV 15, 2023",NYK @ ATL,W,29,4,11,0.364,3,8,0.375,0,0,0.0,0,1,1,1,1,0,3,3,11,2,1,Quentin Grimes,NYK,ATL,NYK,,,13,12,12,2
22023,1629656,22300188,"NOV 13, 2023",NYK @ BOS,L,28,4,6,0.667,4,6,0.667,0,0,0.0,0,0,0,1,0,0,0,2,12,-10,1,Quentin Grimes,NYK,BOS,NYK,,,13,12,13,1
22023,1629656,22300177,"NOV 12, 2023",NYK vs. CHA,W,23,2,5,0.4,2,5,0.4,0,0,0.0,0,1,1,1,1,0,0,1,6,5,1,Quentin Grimes,NYK,NYK,CHA,,,8,7,7,2
22023,1629656,22300161,"NOV 08, 2023",NYK vs. SAS,W,19,3,5,0.6,2,4,0.5,0,0,0.0,0,1,1,3,0,0,0,0,8,26,1,Quentin Grimes,NYK,NYK,SAS,,,12,9,11,4
22023,1629656,22300151,"NOV 06, 2023",NYK vs. LAC,W,21,1,4,0.25,1,4,0.25,0,0,0.0,0,1,1,0,1,0,1,1,3,-6,1,Quentin Grimes,NYK,NYK,LAC,,,4,4,3,1
22023,1629656,22300002,"NOV 03, 2023",NYK @ MIL,L,34,6,11,0.545,5,10,0.5,0,0,0.0,0,4,4,2,0,0,1,3,17,3,1,Quentin Grimes,NYK,MIL,NYK,,,23,21,19,6
22023,1629656,22300120,"NOV 01, 2023",NYK vs. CLE,L,22,2,7,0.286,1,6,0.167,0,0,0.0,0,2,2,1,1,0,1,0,5,-9,1,Quentin Grimes,NYK,NYK,CLE,,,8,7,6,3
22023,1629656,22300112,"OCT 31, 2023",NYK @ CLE,W,22,2,4,0.5,1,3,0.333,0,0,0.0,0,1,1,1,2,0,0,3,5,8,1,Quentin Grimes,NYK,CLE,NYK,,,7,6,6,2
22023,1629656,22300090,"OCT 28, 2023",NYK @ NOP,L,27,2,9,0.222,1,6,0.167,0,0,0.0,0,2,2,1,2,0,0,1,5,-2,1,Quentin Grimes,NYK,NOP,NYK,,,8,7,6,3
22023,1629656,22300079,"OCT 27, 2023",NYK @ ATL,W,25,2,6,0.333,2,5,0.4,0,0,0.0,1,0,1,1,0,0,1,3,6,8,1,Quentin Grimes,NYK,ATL,NYK,,,8,7,7,2
22023,1629656,22300065,"OCT 25, 2023",NYK vs. BOS,L,23,4,7,0.571,3,6,0.5,0,1,0.0,0,1,1,0,0,0,0,2,11,-1,1,Quentin Grimes,NYK,NYK,BOS,,,12,12,11,1
22023,1631243,22300104,"OCT 30, 2023",ATL vs. MIN,W,1,0,0,0.0,0,0,0.0,0,0,0.0,0,0,0,0,0,0,0,0,0,-4,1,Mouhamed Gueye,ATL,ATL,MIN,,,0,0,0,0
22023,1631243,22300097,"OCT 29, 2023",ATL @ MIL,W,3,0,1,0.0,0,1,0.0,0,0,0.0,0,0,0,0,1,0,0,1,0,-9,1,Mouhamed Gueye,ATL,MIL,ATL,,,0,0,0,0
22023,1629060,22300565,"JAN 15, 2024",LAL vs. OKC,W,20,5,8,0.625,2,3,0.667,0,0,0.0,1,2,3,0,0,2,1,1,12,6,1,Rui Hachimura,LAL,LAL,OKC,,,15,15,12,3
22023,1629060,22300549,"JAN 13, 2024",LAL @ UTA,L,19,6,12,0.5,0,2,0.0,5,6,0.833,1,2,3,1,1,0,0,0,17,12,1,Rui Hachimura,LAL,UTA,LAL,,,21,20,18,4
22023,1629060,22300446,"DEC 31, 2023",LAL @ NOP,L,8,1,1,1.0,0,0,0.0,2,2,1.0,0,1,1,1,1,0,1,0,4,-4,1,Rui Hachimura,LAL,NOP,LAL,,,6,5,5,2
22023,1629060,22300443,"DEC 30, 2023",LAL @ MIN,L,17,2,8,0.25,0,1,0.0,1,1,1.0,1,0,1,0,0,0,0,0,5,-11,1,Rui Hachimura,LAL,MIN,LAL,,,6,6,5,1
22023,1629060,22300428,"DEC 28, 2023",LAL vs. CHA,W,28,7,12,0.583,0,1,0.0,3,3,1.0,0,4,4,1,1,0,0,2,17,34,1,Rui Hachimura,LAL,LAL,CHA,,,22,21,18,5
22023,1629060,22300403,"DEC 25, 2023",LAL vs. BOS,L,29,5,14,0.357,2,9,0.222,0,0,0.0,0,3,3,0,0,0,1,2,12,5,1,Rui Hachimura,LAL,LAL,BOS,,,15,15,12,3
22023,1629060,22300397,"DEC 23, 2023",LAL @ OKC,W,30,8,14,0.571,3,5,0.6,2,2,1.0,0,6,6,2,1,0,0,0,21,1,1,Rui Hachimura,LAL,OKC,LAL,,,29,27,23,8
22023,1629060,22300380,"DEC 21, 2023",LAL @ MIN,L,34,7,12,0.583,2,5,0.4,2,6,0.333,1,3,4,0,1,0,2,3,18,-6,1,Rui Hachimura,LAL,MIN,LAL,,,22,22,18,4
22023,1629060,22300370,"DEC 20, 2023",LAL @ CHI,L,16,2,9,0.222,1,2,0.5,0,0,0.0,3,2,5,1,0,0,0,0,5,-12,1,Rui Hachimura,LAL,CHI,LAL,,,11,10,6,6
22023,1629060,22300359,"DEC 18, 2023",LAL vs. NYK,L,17,3,6,0.5,1,2,0.5,1,1,1.0,2,0,2,0,2,0,0,1,8,-9,1,Rui Hachimura,LAL,LAL,NYK,,,10,10,8,2
22023,1629060,22300331,"DEC 15, 2023",LAL @ SAS,L,34,8,15,0.533,0,5,0.0,4,5,0.8,0,5,5,4,0,1,0,1,20,1,1,Rui Hachimura,LAL,SAS,LAL,,,29,25,24,9
22023,1629060,22300316,"DEC 13, 2023",LAL @ SAS,W,24,6,10,0.6,1,2,0.5,0,0,0.0,0,7,7,1,0,1,3,2,13,15,1,Rui Hachimura,LAL,SAS,LAL,,,21,20,14,8
22023,1629060,22300306,"DEC 12, 2023",LAL @ DAL,L,29,3,9,0.333,1,2,0.5,0,0,0.0,0,3,3,2,1,0,1,3,7,-3,1,Rui Hachimura,LAL,DAL,LAL,,,12,10,9,5
22023,1629060,22301230,"DEC 07, 2023",LAL vs. NOP,W,21,5,9,0.556,1,3,0.333,1,2,0.5,0,1,1,2,0,0,0,3,12,9,1,Rui Hachimura,LAL,LAL,NOP,,,15,13,14,3
22023,1629060,22301203,"DEC 05, 2023",LAL vs. PHX,W,21,3,8,0.375,1,4,0.25,0,0,0.0,0,2,2,1,0,0,0,1,7,5,1,Rui Hachimura,LAL,LAL,PHX,,,10,9,8,3
22023,1629060,22300238,"NOV 22, 2023",LAL vs. DAL,L,26,4,11,0.364,1,2,0.5,0,0,0.0,2,1,3,1,0,0,1,3,9,-8,1,Rui Hachimura,LAL,LAL,DAL,,,13,12,10,4
22023,1629060,22300042,"NOV 21, 2023",LAL vs. UTA,W,28,4,13,0.308,2,5,0.4,2,2,1.0,2,4,6,1,0,0,1,3,12,21,1,Rui Hachimura,LAL,LAL,UTA,,,19,18,13,7
22023,1629060,22300216,"NOV 19, 2023",LAL vs. HOU,W,32,4,10,0.4,0,4,0.0,3,4,0.75,1,3,4,2,2,0,2,0,11,-2,1,Rui Hachimura,LAL,LAL,HOU,,,17,15,13,6
22023,1629060,22300036,"NOV 17, 2023",LAL @ POR,W,28,3,5,0.6,1,2,0.5,0,0,0.0,1,4,5,2,0,0,0,1,7,9,1,Rui Hachimura,LAL,POR,LAL,,,14,12,9,7
22023,1629060,22300198,"NOV 15, 2023",LAL vs. SAC,L,18,2,5,0.4,1,1,1.0,0,0,0.0,0,0,0,0,0,0,0,0,5,-5,1,Rui Hachimura,LAL,LAL,SAC,,,5,5,5,0
22023,1629060,22300026,"NOV 14, 2023",LAL vs. MEM,W,24,8,10,0.8,3,3,1.0,4,4,1.0,0,3,3,0,0,0,5,2,23,6,1,Rui Hachimura,LAL,LAL,MEM,,,26,26,23,3
22023,1629060,22300187,"NOV 12, 2023",LAL vs. POR,W,33,6,10,0.6,1,3,0.333,6,6,1.0,1,4,5,2,2,0,1,1,19,17,1,Rui Hachimura,LAL,LAL,POR,,,26,24,21,7
22023,1629060,22300015,"NOV 10, 2023",LAL @ PHX,W,20,3,6,0.5,1,3,0.333,0,1,0.0,0,3,3,1,4,1,1,3,7,6,1,Rui Hachimura,LAL,PHX,LAL,,,11,10,8,4
22023,1629060,22300163,"NOV 08, 2023",LAL @ HOU,L,26,10,15,0.667,2,3,0.667,2,5,0.4,1,7,8,2,2,1,0,0,24,-13,1,Rui Hachimura,LAL,HOU,LAL,,,34,32,26,10
22023,1629060,22300100,"OCT 29, 2023",LAL @ SAC,L,17,3,6,0.5,2,4,0.5,3,4,0.75,2,4,6,1,0,0,0,1,11,9,1,Rui Hachimura,LAL,SAC,LAL,,,18,17,12,7
22023,1629060,22300076,"OCT 26, 2023",LAL vs. PHX,W,12,2,3,0.667,1,2,0.5,2,2,1.0,0,0,0,0,1,1,1,2,7,-13,1,Rui Hachimura,LAL,LAL,PHX,,,7,7,7,0
22023,1629060,22300061,"OCT 24, 2023",LAL @ DEN,L,15,3,10,0.3,0,3,0.0,0,0,0.0,2,1,3,0,0,0,0,2,6,-8,1,Rui Hachimura,LAL,DEN,LAL,,,9,9,6,3
22023,1630169,22300507,"JAN 08, 2024",IND vs. BOS,W,13,3,5,0.6,1,3,0.333,0,0,0.0,0,2,2,6,0,0,2,1,7,-4,1,Tyrese Haliburton,IND,IND,BOS,,,15,9,13,8
22023,1630169,22300493,"JAN 06, 2024",IND vs. BOS,L,35,5,17,0.294,2,9,0.222,5,5,1.0,1,5,6,7,5,0,4,1,17,-14,1,Tyrese Haliburton,IND,IND,BOS,,,30,23,24,13
22023,1630169,22300480,"JAN 05, 2024",IND vs. ATL,W,25,4,6,0.667,2,4,0.5,0,0,0.0,1,7,8,18,2,1,2,1,10,24,1,Tyrese Haliburton,IND,IND,ATL,,,36,18,28,26
22023,1630169,22300466,"JAN 03, 2024",IND vs. MIL,W,34,10,20,0.5,5,11,0.455,6,6,1.0,0,2,2,12,1,3,0,1,31,21,1,Tyrese Haliburton,IND,IND,MIL,,,45,33,43,14
22023,1630169,22300454,"JAN 01, 2024",IND @ MIL,W,37,11,22,0.5,1,7,0.143,3,3,1.0,1,8,9,11,1,1,2,0,26,-5,1,Tyrese Haliburton,IND,MIL,IND,,,46,35,37,20
22023,1630169,22300441,"DEC 30, 2023",IND vs. NYK,W,36,8,17,0.471,2,10,0.2,4,4,1.0,1,4,5,23,2,1,2,0,22,19,1,Tyrese Haliburton,IND,IND,NYK,,,50,27,45,28
22023,1630169,22300422,"DEC 28, 2023",IND @ CHI,W,37,7,17,0.412,6,13,0.462,1,2,0.5,0,3,3,20,2,1,0,2,21,32,1,Tyrese Haliburton,IND,CHI,IND,,,44,24,41,23
22023,1630169,22300409,"DEC 26, 2023",IND @ HOU,W,38,13,21,0.619,7,13,0.538,0,1,0.0,1,5,6,10,1,0,3,0,33,15,1,Tyrese Haliburton,IND,HOU,IND,,,49,39,43,16
22023,1630169,22300391,"DEC 23, 2023",IND vs. ORL,L,40,12,22,0.545,3,5,0.6,2,3,0.667,0,2,2,15,3,0,3,2,29,8,1,Tyrese Haliburton,IND,IND,ORL,,,46,31,44,17
22023,1630169,22300377,"DEC 21, 2023",IND @ MEM,L,38,7,19,0.368,2,12,0.167,1,2,0.5,0,4,4,14,0,0,4,2,17,1,1,Tyrese Haliburton,IND,MEM,IND,,,35,21,31,18
22023,1630169,22300365,"DEC 20, 2023",IND vs. CHA,W,28,6,14,0.429,3,9,0.333,4,4,1.0,1,2,3,13,1,1,4,0,19,32,1,Tyrese Haliburton,IND,IND,CHA,,,35,22,32,16
22023,1630169,22300350,"DEC 18, 2023",IND vs. LAC,L,31,3,12,0.25,1,5,0.2,1,2,0.5,0,2,2,11,0,0,4,1,8,-37,1,Tyrese Haliburton,IND,IND,LAC,,,21,10,19,13
22023,1630169,22300328,"DEC 15, 2023",IND @ WAS,L,28,7,17,0.412,2,6,0.333,3,3,1.0,1,1,2,11,0,0,4,2,19,-18,1,Tyrese Haliburton,IND,WAS,IND,,,32,21,30,13
22023,1630169,22300315,"DEC 13, 2023",IND @ MIL,L,31,8,16,0.5,1,4,0.25,5,7,0.714,1,4,5,7,0,0,3,0,22,-14,1,Tyrese Haliburton,IND,MIL,IND,,,34,27,29,12
22023,1630169,22300293,"DEC 11, 2023",IND @ DET,W,33,5,12,0.417,3,6,0.5,1,1,1.0,0,5,5,16,1,2,7,2,14,8,1,Tyrese Haliburton,IND,DET,IND,,,35,19,30,21
22023,1630169,22301229,"DEC 07, 2023",IND @ MIL,W,37,11,19,0.579,3,9,0.333,2,2,1.0,3,4,7,15,0,1,0,1,27,0,1,Tyrese Haliburton,IND,MIL,IND,,,49,34,42,22
22023,1630169,22301202,"DEC 04, 2023",IND vs. BOS,W,40,10,18,0.556,5,11,0.455,1,1,1.0,3,7,10,13,1,0,0,2,26,15,1,Tyrese Haliburton,IND,IND,BOS,,,49,36,39,23
22023,1630169,22300267,"NOV 30, 2023",IND @ MIA,L,40,15,28,0.536,6,16,0.375,8,12,0.667,0,2,2,10,3,1,2,0,44,-6,1,Tyrese Haliburton,IND,MIA,IND,,,56,46,54,12
22023,1630169,22300254,"NOV 27, 2023",IND vs. POR,L,36,11,17,0.647,3,6,0.5,8,9,0.889,0,2,2,9,0,0,3,1,33,-3,1,Tyrese Haliburton,IND,IND,POR,,,44,35,42,11
22023,1630169,22300047,"NOV 24, 2023",IND vs. DET,W,32,9,23,0.391,5,13,0.385,3,3,1.0,0,2,2,10,0,0,1,0,26,9,1,Tyrese Haliburton,IND,IND,DET,,,38,28,36,12
22023,1630169,22300230,"NOV 22, 2023",IND vs. TOR,L,34,12,22,0.545,5,10,0.5,4,5,0.8,1,2,3,16,0,1,3,3,33,3,1,Tyrese Haliburton,IND,IND,TOR,,,52,36,49,19
22023,1630169,22300039,"NOV 21, 2023",IND @ ATL,W,39,11,18,0.611,9,15,0.6,6,7,0.857,1,4,5,16,3,1,6,0,37,16,1,Tyrese Haliburton,IND,ATL,IND,,,58,42,53,21
22023,1630169,22300209,"NOV 19, 2023",IND vs. ORL,L,25,4,14,0.286,1,3,0.333,3,3,1.0,0,2,2,3,0,1,4,2,12,-30,1,Tyrese Haliburton,IND,IND,ORL,,,17,14,15,5
22023,1630169,22300019,"NOV 14, 2023",IND @ PHI,W,38,11,18,0.611,7,12,0.583,4,5,0.8,1,6,7,15,2,1,0,1,33,19,1,Tyrese Haliburton,IND,PHI,IND,,,55,40,48,22
22023,1630169,22300180,"NOV 12, 2023",IND @ PHI,L,37,9,14,0.643,3,6,0.5,4,4,1.0,0,1,1,17,2,1,0,0,25,4,1,Tyrese Haliburton,IND,PHI,IND,,,43,26,42,18
22023,1630169,22300171,"NOV 09, 2023",IND vs. MIL,W,38,10,17,0.588,5,9,0.556,4,4,1.0,1,5,6,10,0,1,2,1,29,14,1,Tyrese Haliburton,IND,IND,MIL,,,45,35,39,16
22023,1630169,22300158,"NOV 08, 2023",IND vs. UTA,W,31,6,12,0.5,1,6,0.167,3,3,1.0,1,5,6,13,1,0,2,0,16,-1,1,Tyrese Haliburton,IND,IND,UTA,,,35,22,29,19
22023,1630169,22300146,"NOV 06, 2023",IND vs. SAS,W,27,9,19,0.474,3,7,0.429,2,2,1.0,0,2,2,8,1,1,2,1,23,27,1,Tyrese Haliburton,IND,IND,SAS,,,33,25,31,10
22023,1630169,22300133,"NOV 04, 2023",IND vs. CHA,L,37,14,21,0.667,8,12,0.667,7,7,1.0,0,2,2,12,0,1,3,2,43,8,1,Tyrese Haliburton,IND,IND,CHA,,,57,45,55,14
22023,1630169,22300001,"NOV 03, 2023",IND vs. CLE,W,34,5,14,0.357,0,5,0.0,8,9,0.889,0,2,2,13,2,0,4,2,18,3,1,Tyrese Haliburton,IND,IND,CLE,,,33,20,31,15
22023,1630169,22300102,"OCT 30, 2023",IND vs. CHI,L,36,6,16,0.375,1,8,0.125,6,7,0.857,1,4,5,13,2,0,4,1,19,2,1,Tyrese Haliburton,IND,IND,CHI,,,37,24,32,18
22023,1630169,22300091,"OCT 28, 2023",IND @ CLE,W,32,7,16,0.438,4,7,0.571,3,3,1.0,1,7,8,13,0,0,1,2,21,-1,1,Tyrese Haliburton,IND,CLE,IND,,,42,29,34,21
22023,1630169,22300064,"OCT 25, 2023",IND vs. WAS,W,27,9,16,0.563,2,6,0.333,0,0,0.0,0,3,3,11,1,2,3,1,20,6,1,Tyrese Haliburton,IND,IND,WAS,,,34,23,31,14
22023,1630181,22300489,"JAN 05, 2024",MIA @ PHX,L,2,0,0,0.0,0,0,0.0,0,0,0.0,0,0,0,1,0,0,0,1,0,5,1,R.J. Hampton,MIA,PHX,MIA,,,1,0,1,1
22023,1630181,22300475,"JAN 03, 2024",MIA @ LAL,W,1,0,0,0.0,0,0,0.0,0,0,0.0,0,0,0,0,0,0,0,0,0,0,1,R.J. Hampton,MIA,LAL,MIA,,,0,0,0,0
22023,1630181,22300458,"JAN 01, 2024",MIA @ LAC,L,12,0,1,0.0,0,1,0.0,0,0,0.0,0,0,0,0,0,0,0,2,0,9,1,R.J. Hampton,MIA,LAC,MIA,,,0,0,0,0
22023,1630181,22300439,"DEC 30, 2023",MIA @ UTA,L,8,0,1,0.0,0,1,0.0,0,0,0.0,0,2,2,0,0,0,1,1,0,-5,1,R.J. Hampton,MIA,UTA,MIA,,,2,2,0,2
22023,1630181,22300426,"DEC 28, 2023",MIA @ GSW,W,25,3,6,0.5,0,2,0.0,1,2,0.5,2,0,2,3,0,0,1,3,7,8,1,R.J. Hampton,MIA,GSW,MIA,,,12,9,10,5
22023,1630181,22300404,"DEC 25, 2023",MIA vs. PHI,W,17,0,4,0.0,0,3,0.0,0,0,0.0,0,0,0,4,0,0,0,0,0,-9,1,R.J. Hampton,MIA,MIA,PHI,,,4,0,4,4
22023,1630181,22300320,"DEC 14, 2023",MIA vs. CHI,L,9,1,1,1.0,1,1,1.0,0,0,0.0,0,2,2,0,0,0,1,1,3,6,1,R.J. Hampton,MIA,MIA,CHI,,,5,5,3,2
22023,1630181,22300093,"OCT 28, 2023",MIA @ MIN,L,2,0,1,0.0,0,0,0.0,0,0,0.0,0,0,0,0,0,0,0,0,0,7,1,R.J. Hampton,MIA,MIN,MIA,,,0,0,0,0
22023,203501,22300556,"JAN 15, 2024",DAL vs. NOP,W,41,11,23,0.478,9,15,0.6,10,10,1.0,0,2,2,2,1,0,4,0,41,-1,1,Tim Hardaway Jr.,DAL,DAL,NOP,,,45,43,43,4
22023,203501,22300547,"JAN 13, 2024",DAL vs. NOP,L,39,8,17,0.471,3,8,0.375,5,6,0.833,0,4,4,0,0,0,0,3,24,-6,1,Tim Hardaway Jr.,DAL,DAL,NOP,,,28,28,24,4
22023,203501,22300530,"JAN 11, 2024",DAL vs. NYK,W,39,10,20,0.5,6,13,0.462,6,7,0.857,2,4,6,4,2,0,2,2,32,12,1,Tim Hardaway Jr.,DAL,DAL,NYK,,,42,38,36,10
22023,203501,22300515,"JAN 09, 2024",DAL vs. MEM,L,30,3,6,0.5,2,3,0.667,1,1,1.0,0,3,3,2,0,0,1,3,9,-26,1,Tim Hardaway Jr.,DAL,DAL,MEM,,,14,12,11,5
22023,203501,22300501,"JAN 07, 2024",DAL vs. MIN,W,32,4,13,0.308,2,8,0.25,2,2,1.0,0,4,4,1,0,0,0,2,12,14,1,Tim Hardaway Jr.,DAL,DAL,MIN,,,17,16,13,5
22023,203501,22300487,"JAN 05, 2024",DAL vs. POR,W,27,8,14,0.571,3,7,0.429,0,1,0.0,0,2,2,4,1,1,2,3,19,21,1,Tim Hardaway Jr.,DAL,DAL,POR,,,25,21,23,6
22023,203501,22300472,"JAN 03, 2024",DAL vs. POR,W,23,5,10,0.5,2,5,0.4,2,2,1.0,0,3,3,0,0,0,0,2,14,8,1,Tim Hardaway Jr.,DAL,DAL,POR,,,17,17,14,3
22023,203501,22300457,"JAN 01, 2024",DAL @ UTA,L,23,3,9,0.333,0,6,0.0,0,0,0.0,0,2,2,0,0,0,1,1,6,-16,1,Tim Hardaway Jr.,DAL,UTA,DAL,,,8,8,6,2
22023,203501,22300444,"DEC 30, 2023",DAL @ GSW,W,29,5,12,0.417,2,8,0.25,4,5,0.8,0,6,6,5,0,0,0,2,16,9,1,Tim Hardaway Jr.,DAL,GSW,DAL,,,27,22,21,11
22023,203501,22300423,"DEC 28, 2023",DAL @ MIN,L,32,11,19,0.579,5,11,0.455,5,7,0.714,0,3,3,3,2,0,1,2,32,5,1,Tim Hardaway Jr.,DAL,MIN,DAL,,,38,35,35,6
22023,203501,22300420,"DEC 27, 2023",DAL vs. CLE,L,30,4,13,0.308,1,5,0.2,5,6,0.833,0,4,4,1,0,0,0,2,14,-5,1,Tim Hardaway Jr.,DAL,DAL,CLE,,,19,18,15,5
22023,203501,22300405,"DEC 25, 2023",DAL @ PHX,W,38,6,14,0.429,3,9,0.333,3,3,1.0,0,7,7,2,1,0,1,4,18,10,1,Tim Hardaway Jr.,DAL,PHX,DAL,,,27,25,20,9
22023,203501,22300398,"DEC 23, 2023",DAL vs. SAS,W,30,9,20,0.45,5,11,0.455,0,0,0.0,0,6,6,3,0,0,0,1,23,28,1,Tim Hardaway Jr.,DAL,DAL,SAS,,,32,29,26,9
22023,203501,22300385,"DEC 22, 2023",DAL @ HOU,L,26,6,20,0.3,2,8,0.25,2,2,1.0,1,2,3,1,0,0,1,0,16,-27,1,Tim Hardaway Jr.,DAL,HOU,DAL,,,20,19,17,4
22023,203501,22300372,"DEC 20, 2023",DAL vs. LAC,L,37,8,21,0.381,3,11,0.273,2,2,1.0,1,2,3,3,3,0,1,2,21,1,1,Tim Hardaway Jr.,DAL,DAL,LAC,,,27,24,24,6
22023,203501,22300356,"DEC 18, 2023",DAL @ DEN,L,22,3,12,0.25,2,9,0.222,0,0,0.0,0,2,2,1,0,0,2,2,8,-7,1,Tim Hardaway Jr.,DAL,DEN,DAL,,,11,10,9,3
22023,203501,22300341,"DEC 16, 2023",DAL @ POR,W,36,8,21,0.381,5,15,0.333,4,4,1.0,0,6,6,1,1,0,1,0,25,12,1,Tim Hardaway Jr.,DAL,POR,DAL,,,32,31,26,7
22023,203501,22300321,"DEC 14, 2023",DAL vs. MIN,L,32,4,15,0.267,0,7,0.0,2,3,0.667,0,4,4,0,0,0,2,2,10,-30,1,Tim Hardaway Jr.,DAL,DAL,MIN,,,14,14,10,4
22023,203501,22300306,"DEC 12, 2023",DAL vs. LAL,W,37,10,21,0.476,5,10,0.5,7,8,0.875,1,2,3,3,1,0,0,2,32,-6,1,Tim Hardaway Jr.,DAL,DAL,LAL,,,38,35,35,6
22023,203501,22301226,"DEC 08, 2023",DAL @ POR,W,37,7,12,0.583,4,9,0.444,2,2,1.0,0,4,4,0,0,0,1,4,20,15,1,Tim Hardaway Jr.,DAL,POR,DAL,,,24,24,20,4
22023,203501,22301213,"DEC 06, 2023",DAL vs. UTA,W,22,5,14,0.357,4,12,0.333,3,4,0.75,1,3,4,2,0,0,0,1,17,8,1,Tim Hardaway Jr.,DAL,DAL,UTA,,,23,21,19,6
22023,203501,22300059,"NOV 28, 2023",DAL vs. HOU,W,22,4,12,0.333,3,8,0.375,0,0,0.0,1,0,1,0,0,0,0,0,11,1,1,Tim Hardaway Jr.,DAL,DAL,HOU,,,12,12,11,1
22023,203501,22300244,"NOV 25, 2023",DAL @ LAC,L,29,5,14,0.357,2,9,0.222,0,0,0.0,0,3,3,0,0,0,1,2,12,-9,1,Tim Hardaway Jr.,DAL,LAC,DAL,,,15,15,12,3
22023,203501,22300238,"NOV 22, 2023",DAL @ LAL,W,30,2,10,0.2,2,8,0.25,1,2,0.5,1,1,2,3,1,0,0,0,7,11,1,Tim Hardaway Jr.,DAL,LAL,DAL,,,12,9,10,5
22023,203501,22300212,"NOV 19, 2023",DAL vs. SAC,L,27,5,11,0.455,2,4,0.5,2,2,1.0,0,2,2,2,0,0,0,3,14,-10,1,Tim Hardaway Jr.,DAL,DAL,SAC,,,18,16,16,4
22023,203501,22300205,"NOV 18, 2023",DAL @ MIL,L,26,6,14,0.429,4,10,0.4,1,1,1.0,0,2,2,2,0,0,1,0,17,0,1,Tim Hardaway Jr.,DAL,MIL,DAL,,,21,19,19,4
22023,203501,22300192,"NOV 15, 2023",DAL @ WAS,W,27,11,20,0.55,7,11,0.636,2,5,0.4,0,4,4,3,0,0,1,1,31,17,1,Tim Hardaway Jr.,DAL,WAS,DAL,,,38,35,34,7
22023,203501,22300022,"NOV 14, 2023",DAL @ NOP,L,21,5,11,0.455,3,9,0.333,4,4,1.0,0,0,0,1,0,0,1,2,17,-26,1,Tim Hardaway Jr.,DAL,NOP,DAL,,,18,17,18,1
22023,203501,22300183,"NOV 12, 2023",DAL @ NOP,W,28,4,14,0.286,3,10,0.3,4,4,1.0,0,9,9,2,0,0,0,1,15,14,1,Tim Hardaway Jr.,DAL,NOP,DAL,,,26,24,17,11
22023,203501,22300014,"NOV 10, 2023",DAL vs. LAC,W,27,6,13,0.462,2,8,0.25,3,3,1.0,0,3,3,3,0,0,0,0,17,20,1,Tim Hardaway Jr.,DAL,DAL,LAC,,,23,20,20,6
22023,203501,22300168,"NOV 08, 2023",DAL vs. TOR,L,26,6,11,0.545,5,9,0.556,0,0,0.0,1,1,2,1,0,0,3,0,17,-19,1,Tim Hardaway Jr.,DAL,DAL,TOR,,,20,19,18,3
22023,203501,22300147,"NOV 06, 2023",DAL @ ORL,W,31,8,16,0.5,4,11,0.364,1,1,1.0,0,6,6,0,0,0,0,0,21,3,1,Tim Hardaway Jr.,DAL,ORL,DAL,,,27,27,21,6
22023,203501,22300143,"NOV 05, 2023",DAL vs. CHA,W,32,5,17,0.294,4,12,0.333,2,2,1.0,0,2,2,1,0,0,0,0,16,1,1,Tim Hardaway Jr.,DAL,DAL,CHA,,,19,18,17,3
22023,203501,22300006,"NOV 03, 2023",DAL @ DEN,L,27,3,8,0.375,1,5,0.2,2,2,1.0,0,3,3,2,1,0,2,3,9,-10,1,Tim Hardaway Jr.,DAL,DEN,DAL,,,14,12,11,5
22023,203501,22300124,"NOV 01, 2023",DAL vs. CHI,W,27,8,15,0.533,7,13,0.538,1,1,1.0,0,3,3,2,1,0,2,0,24,-9,1,Tim Hardaway Jr.,DAL,DAL,CHI,,,29,27,26,5
22023,203501,22300106,"OCT 30, 2023",DAL @ MEM,W,29,8,14,0.571,3,7,0.429,2,2,1.0,0,5,5,0,0,0,1,1,21,6,1,Tim Hardaway Jr.,DAL,MEM,DAL,,,26,26,21,5
22023,203501,22300084,"OCT 27, 2023",DAL vs. BKN,W,30,6,17,0.353,3,7,0.429,4,4,1.0,1,3,4,1,0,0,1,2,19,13,1,Tim Hardaway Jr.,DAL,DAL,BKN,,,24,23,20,5
22023,203501,22300073,"OCT 25, 2023",DAL @ SAS,W,28,5,14,0.357,3,10,0.3,4,4,1.0,2,4,6,4,1,0,1,0,17,9,1,Tim Hardaway Jr.,DAL,SAS,DAL,,,27,23,21,10
22023,201935,22300553,"JAN 14, 2024",LAC @ MIN,L,36,4,14,0.286,2,9,0.222,4,5,0.8,0,1,1,8,2,2,4,3,14,-3,1,James Harden,LAC,MIN,LAC,16.5,Points,23,15,22,9
22023,201935,22300553,"JAN 14, 2024",LAC @ MIN,L,36,4,14,0.286,2,9,0.222,4,5,0.8,0,1,1,8,2,2,4,3,14,-3,1,James Harden,LAC,MIN,LAC,5.0,Rebounds,23,15,22,9
22023,201935,22300553,"JAN 14, 2024",LAC @ MIN,L,36,4,14,0.286,2,9,0.222,4,5,0.8,0,1,1,8,2,2,4,3,14,-3,1,James Harden,LAC,MIN,LAC,30.5,Pts+Rebs+Asts,23,15,22,9
22023,201935,22300553,"JAN 14, 2024",LAC @ MIN,L,36,4,14,0.286,2,9,0.222,4,5,0.8,0,1,1,8,2,2,4,3,14,-3,1,James Harden,LAC,MIN,LAC,9.0,Assists,23,15,22,9
22023,201935,22300553,"JAN 14, 2024",LAC @ MIN,L,36,4,14,0.286,2,9,0.222,4,5,0.8,0,1,1,8,2,2,4,3,14,-3,1,James Harden,LAC,MIN,LAC,38.0,Fantasy Score,23,15,22,9
22023,201935,22300553,"JAN 14, 2024",LAC @ MIN,L,36,4,14,0.286,2,9,0.222,4,5,0.8,0,1,1,8,2,2,4,3,14,-3,1,James Harden,LAC,MIN,LAC,6.5,3-PT Attempted,23,15,22,9
22023,201935,22300553,"JAN 14, 2024",LAC @ MIN,L,36,4,14,0.286,2,9,0.222,4,5,0.8,0,1,1,8,2,2,4,3,14,-3,1,James Harden,LAC,MIN,LAC,3.5,Free Throws Made,23,15,22,9
22023,201935,22300553,"JAN 14, 2024",LAC @ MIN,L,36,4,14,0.286,2,9,0.222,4,5,0.8,0,1,1,8,2,2,4,3,14,-3,1,James Harden,LAC,MIN,LAC,12.0,FG Attempted,23,15,22,9
22023,201935,22300553,"JAN 14, 2024",LAC @ MIN,L,36,4,14,0.286,2,9,0.222,4,5,0.8,0,1,1,8,2,2,4,3,14,-3,1,James Harden,LAC,MIN,LAC,21.5,Pts+Rebs,23,15,22,9
22023,201935,22300553,"JAN 14, 2024",LAC @ MIN,L,36,4,14,0.286,2,9,0.222,4,5,0.8,0,1,1,8,2,2,4,3,14,-3,1,James Harden,LAC,MIN,LAC,25.5,Pts+Asts,23,15,22,9
22023,201935,22300553,"JAN 14, 2024",LAC @ MIN,L,36,4,14,0.286,2,9,0.222,4,5,0.8,0,1,1,8,2,2,4,3,14,-3,1,James Harden,LAC,MIN,LAC,14.0,Rebs+Asts,23,15,22,9
22023,201935,22300537,"JAN 12, 2024",LAC @ MEM,W,28,3,7,0.429,2,4,0.5,3,3,1.0,0,1,1,9,1,0,3,0,11,20,1,James Harden,LAC,MEM,LAC,16.5,Points,21,12,20,10
22023,201935,22300537,"JAN 12, 2024",LAC @ MEM,W,28,3,7,0.429,2,4,0.5,3,3,1.0,0,1,1,9,1,0,3,0,11,20,1,James Harden,LAC,MEM,LAC,5.0,Rebounds,21,12,20,10
22023,201935,22300537,"JAN 12, 2024",LAC @ MEM,W,28,3,7,0.429,2,4,0.5,3,3,1.0,0,1,1,9,1,0,3,0,11,20,1,James Harden,LAC,MEM,LAC,30.5,Pts+Rebs+Asts,21,12,20,10
22023,201935,22300537,"JAN 12, 2024",LAC @ MEM,W,28,3,7,0.429,2,4,0.5,3,3,1.0,0,1,1,9,1,0,3,0,11,20,1,James Harden,LAC,MEM,LAC,9.0,Assists,21,12,20,10
22023,201935,22300537,"JAN 12, 2024",LAC @ MEM,W,28,3,7,0.429,2,4,0.5,3,3,1.0,0,1,1,9,1,0,3,0,11,20,1,James Harden,LAC,MEM,LAC,38.0,Fantasy Score,21,12,20,10
22023,201935,22300537,"JAN 12, 2024",LAC @ MEM,W,28,3,7,0.429,2,4,0.5,3,3,1.0,0,1,1,9,1,0,3,0,11,20,1,James Harden,LAC,MEM,LAC,6.5,3-PT Attempted,21,12,20,10
22023,201935,22300537,"JAN 12, 2024",LAC @ MEM,W,28,3,7,0.429,2,4,0.5,3,3,1.0,0,1,1,9,1,0,3,0,11,20,1,James Harden,LAC,MEM,LAC,3.5,Free Throws Made,21,12,20,10
22023,201935,22300537,"JAN 12, 2024",LAC @ MEM,W,28,3,7,0.429,2,4,0.5,3,3,1.0,0,1,1,9,1,0,3,0,11,20,1,James Harden,LAC,MEM,LAC,12.0,FG Attempted,21,12,20,10
22023,201935,22300537,"JAN 12, 2024",LAC @ MEM,W,28,3,7,0.429,2,4,0.5,3,3,1.0,0,1,1,9,1,0,3,0,11,20,1,James Harden,LAC,MEM,LAC,21.5,Pts+Rebs,21,12,20,10
22023,201935,22300537,"JAN 12, 2024",LAC @ MEM,W,28,3,7,0.429,2,4,0.5,3,3,1.0,0,1,1,9,1,0,3,0,11,20,1,James Harden,LAC,MEM,LAC,25.5,Pts+Asts,21,12,20,10
22023,201935,22300537,"JAN 12, 2024",LAC @ MEM,W,28,3,7,0.429,2,4,0.5,3,3,1.0,0,1,1,9,1,0,3,0,11,20,1,James Harden,LAC,MEM,LAC,14.0,Rebs+Asts,21,12,20,10
22023,201935,22300526,"JAN 10, 2024",LAC vs. TOR,W,34,5,13,0.385,2,7,0.286,2,2,1.0,0,5,5,11,1,0,3,4,14,8,1,James Harden,LAC,LAC,TOR,16.5,Points,30,19,25,16
22023,201935,22300526,"JAN 10, 2024",LAC vs. TOR,W,34,5,13,0.385,2,7,0.286,2,2,1.0,0,5,5,11,1,0,3,4,14,8,1,James Harden,LAC,LAC,TOR,5.0,Rebounds,30,19,25,16
22023,201935,22300526,"JAN 10, 2024",LAC vs. TOR,W,34,5,13,0.385,2,7,0.286,2,2,1.0,0,5,5,11,1,0,3,4,14,8,1,James Harden,LAC,LAC,TOR,30.5,Pts+Rebs+Asts,30,19,25,16
22023,201935,22300526,"JAN 10, 2024",LAC vs. TOR,W,34,5,13,0.385,2,7,0.286,2,2,1.0,0,5,5,11,1,0,3,4,14,8,1,James Harden,LAC,LAC,TOR,9.0,Assists,30,19,25,16
22023,201935,22300526,"JAN 10, 2024",LAC vs. TOR,W,34,5,13,0.385,2,7,0.286,2,2,1.0,0,5,5,11,1,0,3,4,14,8,1,James Harden,LAC,LAC,TOR,38.0,Fantasy Score,30,19,25,16
22023,201935,22300526,"JAN 10, 2024",LAC vs. TOR,W,34,5,13,0.385,2,7,0.286,2,2,1.0,0,5,5,11,1,0,3,4,14,8,1,James Harden,LAC,LAC,TOR,6.5,3-PT Attempted,30,19,25,16
22023,201935,22300526,"JAN 10, 2024",LAC vs. TOR,W,34,5,13,0.385,2,7,0.286,2,2,1.0,0,5,5,11,1,0,3,4,14,8,1,James Harden,LAC,LAC,TOR,3.5,Free Throws Made,30,19,25,16
22023,201935,22300526,"JAN 10, 2024",LAC vs. TOR,W,34,5,13,0.385,2,7,0.286,2,2,1.0,0,5,5,11,1,0,3,4,14,8,1,James Harden,LAC,LAC,TOR,12.0,FG Attempted,30,19,25,16
22023,201935,22300526,"JAN 10, 2024",LAC vs. TOR,W,34,5,13,0.385,2,7,0.286,2,2,1.0,0,5,5,11,1,0,3,4,14,8,1,James Harden,LAC,LAC,TOR,21.5,Pts+Rebs,30,19,25,16
22023,201935,22300526,"JAN 10, 2024",LAC vs. TOR,W,34,5,13,0.385,2,7,0.286,2,2,1.0,0,5,5,11,1,0,3,4,14,8,1,James Harden,LAC,LAC,TOR,25.5,Pts+Asts,30,19,25,16
22023,201935,22300526,"JAN 10, 2024",LAC vs. TOR,W,34,5,13,0.385,2,7,0.286,2,2,1.0,0,5,5,11,1,0,3,4,14,8,1,James Harden,LAC,LAC,TOR,14.0,Rebs+Asts,30,19,25,16
22023,201935,22300511,"JAN 08, 2024",LAC vs. PHX,W,30,6,8,0.75,3,4,0.75,4,4,1.0,0,7,7,10,0,0,3,1,19,25,1,James Harden,LAC,LAC,PHX,16.5,Points,36,26,29,17
22023,201935,22300511,"JAN 08, 2024",LAC vs. PHX,W,30,6,8,0.75,3,4,0.75,4,4,1.0,0,7,7,10,0,0,3,1,19,25,1,James Harden,LAC,LAC,PHX,5.0,Rebounds,36,26,29,17
22023,201935,22300511,"JAN 08, 2024",LAC vs. PHX,W,30,6,8,0.75,3,4,0.75,4,4,1.0,0,7,7,10,0,0,3,1,19,25,1,James Harden,LAC,LAC,PHX,30.5,Pts+Rebs+Asts,36,26,29,17
22023,201935,22300511,"JAN 08, 2024",LAC vs. PHX,W,30,6,8,0.75,3,4,0.75,4,4,1.0,0,7,7,10,0,0,3,1,19,25,1,James Harden,LAC,LAC,PHX,9.0,Assists,36,26,29,17
22023,201935,22300511,"JAN 08, 2024",LAC vs. PHX,W,30,6,8,0.75,3,4,0.75,4,4,1.0,0,7,7,10,0,0,3,1,19,25,1,James Harden,LAC,LAC,PHX,38.0,Fantasy Score,36,26,29,17
22023,201935,22300511,"JAN 08, 2024",LAC vs. PHX,W,30,6,8,0.75,3,4,0.75,4,4,1.0,0,7,7,10,0,0,3,1,19,25,1,James Harden,LAC,LAC,PHX,6.5,3-PT Attempted,36,26,29,17
22023,201935,22300511,"JAN 08, 2024",LAC vs. PHX,W,30,6,8,0.75,3,4,0.75,4,4,1.0,0,7,7,10,0,0,3,1,19,25,1,James Harden,LAC,LAC,PHX,3.5,Free Throws Made,36,26,29,17
22023,201935,22300511,"JAN 08, 2024",LAC vs. PHX,W,30,6,8,0.75,3,4,0.75,4,4,1.0,0,7,7,10,0,0,3,1,19,25,1,James Harden,LAC,LAC,PHX,12.0,FG Attempted,36,26,29,17
22023,201935,22300511,"JAN 08, 2024",LAC vs. PHX,W,30,6,8,0.75,3,4,0.75,4,4,1.0,0,7,7,10,0,0,3,1,19,25,1,James Harden,LAC,LAC,PHX,21.5,Pts+Rebs,36,26,29,17
22023,201935,22300511,"JAN 08, 2024",LAC vs. PHX,W,30,6,8,0.75,3,4,0.75,4,4,1.0,0,7,7,10,0,0,3,1,19,25,1,James Harden,LAC,LAC,PHX,25.5,Pts+Asts,36,26,29,17
22023,201935,22300511,"JAN 08, 2024",LAC vs. PHX,W,30,6,8,0.75,3,4,0.75,4,4,1.0,0,7,7,10,0,0,3,1,19,25,1,James Harden,LAC,LAC,PHX,14.0,Rebs+Asts,36,26,29,17
22023,201935,22300505,"JAN 07, 2024",LAC @ LAL,L,39,4,13,0.308,3,7,0.429,4,5,0.8,2,2,4,9,1,0,5,3,15,-1,1,James Harden,LAC,LAL,LAC,16.5,Points,28,19,24,13
22023,201935,22300505,"JAN 07, 2024",LAC @ LAL,L,39,4,13,0.308,3,7,0.429,4,5,0.8,2,2,4,9,1,0,5,3,15,-1,1,James Harden,LAC,LAL,LAC,5.0,Rebounds,28,19,24,13
22023,201935,22300505,"JAN 07, 2024",LAC @ LAL,L,39,4,13,0.308,3,7,0.429,4,5,0.8,2,2,4,9,1,0,5,3,15,-1,1,James Harden,LAC,LAL,LAC,30.5,Pts+Rebs+Asts,28,19,24,13
22023,201935,22300505,"JAN 07, 2024",LAC @ LAL,L,39,4,13,0.308,3,7,0.429,4,5,0.8,2,2,4,9,1,0,5,3,15,-1,1,James Harden,LAC,LAL,LAC,9.0,Assists,28,19,24,13
22023,201935,22300505,"JAN 07, 2024",LAC @ LAL,L,39,4,13,0.308,3,7,0.429,4,5,0.8,2,2,4,9,1,0,5,3,15,-1,1,James Harden,LAC,LAL,LAC,38.0,Fantasy Score,28,19,24,13
22023,201935,22300505,"JAN 07, 2024",LAC @ LAL,L,39,4,13,0.308,3,7,0.429,4,5,0.8,2,2,4,9,1,0,5,3,15,-1,1,James Harden,LAC,LAL,LAC,6.5,3-PT Attempted,28,19,24,13
22023,201935,22300505,"JAN 07, 2024",LAC @ LAL,L,39,4,13,0.308,3,7,0.429,4,5,0.8,2,2,4,9,1,0,5,3,15,-1,1,James Harden,LAC,LAL,LAC,3.5,Free Throws Made,28,19,24,13
22023,201935,22300505,"JAN 07, 2024",LAC @ LAL,L,39,4,13,0.308,3,7,0.429,4,5,0.8,2,2,4,9,1,0,5,3,15,-1,1,James Harden,LAC,LAL,LAC,12.0,FG Attempted,28,19,24,13
22023,201935,22300505,"JAN 07, 2024",LAC @ LAL,L,39,4,13,0.308,3,7,0.429,4,5,0.8,2,2,4,9,1,0,5,3,15,-1,1,James Harden,LAC,LAL,LAC,21.5,Pts+Rebs,28,19,24,13
22023,201935,22300505,"JAN 07, 2024",LAC @ LAL,L,39,4,13,0.308,3,7,0.429,4,5,0.8,2,2,4,9,1,0,5,3,15,-1,1,James Harden,LAC,LAL,LAC,25.5,Pts+Asts,28,19,24,13
22023,201935,22300505,"JAN 07, 2024",LAC @ LAL,L,39,4,13,0.308,3,7,0.429,4,5,0.8,2,2,4,9,1,0,5,3,15,-1,1,James Harden,LAC,LAL,LAC,14.0,Rebs+Asts,28,19,24,13
22023,201935,22300486,"JAN 05, 2024",LAC @ NOP,W,29,2,7,0.286,1,6,0.167,3,3,1.0,0,3,3,13,0,0,1,2,8,18,1,James Harden,LAC,NOP,LAC,16.5,Points,24,11,21,16
22023,201935,22300486,"JAN 05, 2024",LAC @ NOP,W,29,2,7,0.286,1,6,0.167,3,3,1.0,0,3,3,13,0,0,1,2,8,18,1,James Harden,LAC,NOP,LAC,5.0,Rebounds,24,11,21,16
22023,201935,22300486,"JAN 05, 2024",LAC @ NOP,W,29,2,7,0.286,1,6,0.167,3,3,1.0,0,3,3,13,0,0,1,2,8,18,1,James Harden,LAC,NOP,LAC,30.5,Pts+Rebs+Asts,24,11,21,16
22023,201935,22300486,"JAN 05, 2024",LAC @ NOP,W,29,2,7,0.286,1,6,0.167,3,3,1.0,0,3,3,13,0,0,1,2,8,18,1,James Harden,LAC,NOP,LAC,9.0,Assists,24,11,21,16
22023,201935,22300486,"JAN 05, 2024",LAC @ NOP,W,29,2,7,0.286,1,6,0.167,3,3,1.0,0,3,3,13,0,0,1,2,8,18,1,James Harden,LAC,NOP,LAC,38.0,Fantasy Score,24,11,21,16
22023,201935,22300486,"JAN 05, 2024",LAC @ NOP,W,29,2,7,0.286,1,6,0.167,3,3,1.0,0,3,3,13,0,0,1,2,8,18,1,James Harden,LAC,NOP,LAC,6.5,3-PT Attempted,24,11,21,16
22023,201935,22300486,"JAN 05, 2024",LAC @ NOP,W,29,2,7,0.286,1,6,0.167,3,3,1.0,0,3,3,13,0,0,1,2,8,18,1,James Harden,LAC,NOP,LAC,3.5,Free Throws Made,24,11,21,16
22023,201935,22300486,"JAN 05, 2024",LAC @ NOP,W,29,2,7,0.286,1,6,0.167,3,3,1.0,0,3,3,13,0,0,1,2,8,18,1,James Harden,LAC,NOP,LAC,12.0,FG Attempted,24,11,21,16
22023,201935,22300486,"JAN 05, 2024",LAC @ NOP,W,29,2,7,0.286,1,6,0.167,3,3,1.0,0,3,3,13,0,0,1,2,8,18,1,James Harden,LAC,NOP,LAC,21.5,Pts+Rebs,24,11,21,16
22023,201935,22300486,"JAN 05, 2024",LAC @ NOP,W,29,2,7,0.286,1,6,0.167,3,3,1.0,0,3,3,13,0,0,1,2,8,18,1,James Harden,LAC,NOP,LAC,25.5,Pts+Asts,24,11,21,16
22023,201935,22300486,"JAN 05, 2024",LAC @ NOP,W,29,2,7,0.286,1,6,0.167,3,3,1.0,0,3,3,13,0,0,1,2,8,18,1,James Harden,LAC,NOP,LAC,14.0,Rebs+Asts,24,11,21,16
22023,201935,22300473,"JAN 03, 2024",LAC @ PHX,W,36,7,13,0.538,4,7,0.571,4,4,1.0,0,5,5,11,0,1,4,2,22,0,1,James Harden,LAC,PHX,LAC,16.5,Points,38,27,33,16
22023,201935,22300473,"JAN 03, 2024",LAC @ PHX,W,36,7,13,0.538,4,7,0.571,4,4,1.0,0,5,5,11,0,1,4,2,22,0,1,James Harden,LAC,PHX,LAC,5.0,Rebounds,38,27,33,16
22023,201935,22300473,"JAN 03, 2024",LAC @ PHX,W,36,7,13,0.538,4,7,0.571,4,4,1.0,0,5,5,11,0,1,4,2,22,0,1,James Harden,LAC,PHX,LAC,30.5,Pts+Rebs+Asts,38,27,33,16
22023,201935,22300473,"JAN 03, 2024",LAC @ PHX,W,36,7,13,0.538,4,7,0.571,4,4,1.0,0,5,5,11,0,1,4,2,22,0,1,James Harden,LAC,PHX,LAC,9.0,Assists,38,27,33,16
22023,201935,22300473,"JAN 03, 2024",LAC @ PHX,W,36,7,13,0.538,4,7,0.571,4,4,1.0,0,5,5,11,0,1,4,2,22,0,1,James Harden,LAC,PHX,LAC,38.0,Fantasy Score,38,27,33,16
22023,201935,22300473,"JAN 03, 2024",LAC @ PHX,W,36,7,13,0.538,4,7,0.571,4,4,1.0,0,5,5,11,0,1,4,2,22,0,1,James Harden,LAC,PHX,LAC,6.5,3-PT Attempted,38,27,33,16
22023,201935,22300473,"JAN 03, 2024",LAC @ PHX,W,36,7,13,0.538,4,7,0.571,4,4,1.0,0,5,5,11,0,1,4,2,22,0,1,James Harden,LAC,PHX,LAC,3.5,Free Throws Made,38,27,33,16
22023,201935,22300473,"JAN 03, 2024",LAC @ PHX,W,36,7,13,0.538,4,7,0.571,4,4,1.0,0,5,5,11,0,1,4,2,22,0,1,James Harden,LAC,PHX,LAC,12.0,FG Attempted,38,27,33,16
22023,201935,22300473,"JAN 03, 2024",LAC @ PHX,W,36,7,13,0.538,4,7,0.571,4,4,1.0,0,5,5,11,0,1,4,2,22,0,1,James Harden,LAC,PHX,LAC,21.5,Pts+Rebs,38,27,33,16
22023,201935,22300473,"JAN 03, 2024",LAC @ PHX,W,36,7,13,0.538,4,7,0.571,4,4,1.0,0,5,5,11,0,1,4,2,22,0,1,James Harden,LAC,PHX,LAC,25.5,Pts+Asts,38,27,33,16
22023,201935,22300473,"JAN 03, 2024",LAC @ PHX,W,36,7,13,0.538,4,7,0.571,4,4,1.0,0,5,5,11,0,1,4,2,22,0,1,James Harden,LAC,PHX,LAC,14.0,Rebs+Asts,38,27,33,16
22023,201935,22300458,"JAN 01, 2024",LAC vs. MIA,W,31,5,8,0.625,3,5,0.6,2,2,1.0,0,4,4,10,1,2,2,1,15,26,1,James Harden,LAC,LAC,MIA,16.5,Points,29,19,25,14
22023,201935,22300458,"JAN 01, 2024",LAC vs. MIA,W,31,5,8,0.625,3,5,0.6,2,2,1.0,0,4,4,10,1,2,2,1,15,26,1,James Harden,LAC,LAC,MIA,5.0,Rebounds,29,19,25,14
22023,201935,22300458,"JAN 01, 2024",LAC vs. MIA,W,31,5,8,0.625,3,5,0.6,2,2,1.0,0,4,4,10,1,2,2,1,15,26,1,James Harden,LAC,LAC,MIA,30.5,Pts+Rebs+Asts,29,19,25,14
22023,201935,22300458,"JAN 01, 2024",LAC vs. MIA,W,31,5,8,0.625,3,5,0.6,2,2,1.0,0,4,4,10,1,2,2,1,15,26,1,James Harden,LAC,LAC,MIA,9.0,Assists,29,19,25,14
22023,201935,22300458,"JAN 01, 2024",LAC vs. MIA,W,31,5,8,0.625,3,5,0.6,2,2,1.0,0,4,4,10,1,2,2,1,15,26,1,James Harden,LAC,LAC,MIA,38.0,Fantasy Score,29,19,25,14
22023,201935,22300458,"JAN 01, 2024",LAC vs. MIA,W,31,5,8,0.625,3,5,0.6,2,2,1.0,0,4,4,10,1,2,2,1,15,26,1,James Harden,LAC,LAC,MIA,6.5,3-PT Attempted,29,19,25,14
22023,201935,22300458,"JAN 01, 2024",LAC vs. MIA,W,31,5,8,0.625,3,5,0.6,2,2,1.0,0,4,4,10,1,2,2,1,15,26,1,James Harden,LAC,LAC,MIA,3.5,Free Throws Made,29,19,25,14
22023,201935,22300458,"JAN 01, 2024",LAC vs. MIA,W,31,5,8,0.625,3,5,0.6,2,2,1.0,0,4,4,10,1,2,2,1,15,26,1,James Harden,LAC,LAC,MIA,12.0,FG Attempted,29,19,25,14
22023,201935,22300458,"JAN 01, 2024",LAC vs. MIA,W,31,5,8,0.625,3,5,0.6,2,2,1.0,0,4,4,10,1,2,2,1,15,26,1,James Harden,LAC,LAC,MIA,21.5,Pts+Rebs,29,19,25,14
22023,201935,22300458,"JAN 01, 2024",LAC vs. MIA,W,31,5,8,0.625,3,5,0.6,2,2,1.0,0,4,4,10,1,2,2,1,15,26,1,James Harden,LAC,LAC,MIA,25.5,Pts+Asts,29,19,25,14
22023,201935,22300458,"JAN 01, 2024",LAC vs. MIA,W,31,5,8,0.625,3,5,0.6,2,2,1.0,0,4,4,10,1,2,2,1,15,26,1,James Harden,LAC,LAC,MIA,14.0,Rebs+Asts,29,19,25,14
22023,201935,22300438,"DEC 29, 2023",LAC vs. MEM,W,44,4,13,0.308,2,9,0.222,6,8,0.75,0,4,4,13,0,3,5,1,16,16,1,James Harden,LAC,LAC,MEM,16.5,Points,33,20,29,17
22023,201935,22300438,"DEC 29, 2023",LAC vs. MEM,W,44,4,13,0.308,2,9,0.222,6,8,0.75,0,4,4,13,0,3,5,1,16,16,1,James Harden,LAC,LAC,MEM,5.0,Rebounds,33,20,29,17
22023,201935,22300438,"DEC 29, 2023",LAC vs. MEM,W,44,4,13,0.308,2,9,0.222,6,8,0.75,0,4,4,13,0,3,5,1,16,16,1,James Harden,LAC,LAC,MEM,30.5,Pts+Rebs+Asts,33,20,29,17
22023,201935,22300438,"DEC 29, 2023",LAC vs. MEM,W,44,4,13,0.308,2,9,0.222,6,8,0.75,0,4,4,13,0,3,5,1,16,16,1,James Harden,LAC,LAC,MEM,9.0,Assists,33,20,29,17
22023,201935,22300438,"DEC 29, 2023",LAC vs. MEM,W,44,4,13,0.308,2,9,0.222,6,8,0.75,0,4,4,13,0,3,5,1,16,16,1,James Harden,LAC,LAC,MEM,38.0,Fantasy Score,33,20,29,17
22023,201935,22300438,"DEC 29, 2023",LAC vs. MEM,W,44,4,13,0.308,2,9,0.222,6,8,0.75,0,4,4,13,0,3,5,1,16,16,1,James Harden,LAC,LAC,MEM,6.5,3-PT Attempted,33,20,29,17
22023,201935,22300438,"DEC 29, 2023",LAC vs. MEM,W,44,4,13,0.308,2,9,0.222,6,8,0.75,0,4,4,13,0,3,5,1,16,16,1,James Harden,LAC,LAC,MEM,3.5,Free Throws Made,33,20,29,17
22023,201935,22300438,"DEC 29, 2023",LAC vs. MEM,W,44,4,13,0.308,2,9,0.222,6,8,0.75,0,4,4,13,0,3,5,1,16,16,1,James Harden,LAC,LAC,MEM,12.0,FG Attempted,33,20,29,17
22023,201935,22300438,"DEC 29, 2023",LAC vs. MEM,W,44,4,13,0.308,2,9,0.222,6,8,0.75,0,4,4,13,0,3,5,1,16,16,1,James Harden,LAC,LAC,MEM,21.5,Pts+Rebs,33,20,29,17
22023,201935,22300438,"DEC 29, 2023",LAC vs. MEM,W,44,4,13,0.308,2,9,0.222,6,8,0.75,0,4,4,13,0,3,5,1,16,16,1,James Harden,LAC,LAC,MEM,25.5,Pts+Asts,33,20,29,17
22023,201935,22300438,"DEC 29, 2023",LAC vs. MEM,W,44,4,13,0.308,2,9,0.222,6,8,0.75,0,4,4,13,0,3,5,1,16,16,1,James Harden,LAC,LAC,MEM,14.0,Rebs+Asts,33,20,29,17
22023,201935,22300414,"DEC 26, 2023",LAC vs. CHA,W,40,8,16,0.5,6,12,0.5,7,8,0.875,0,6,6,8,2,1,4,2,29,20,1,James Harden,LAC,LAC,CHA,16.5,Points,43,35,37,14
22023,201935,22300414,"DEC 26, 2023",LAC vs. CHA,W,40,8,16,0.5,6,12,0.5,7,8,0.875,0,6,6,8,2,1,4,2,29,20,1,James Harden,LAC,LAC,CHA,5.0,Rebounds,43,35,37,14
22023,201935,22300414,"DEC 26, 2023",LAC vs. CHA,W,40,8,16,0.5,6,12,0.5,7,8,0.875,0,6,6,8,2,1,4,2,29,20,1,James Harden,LAC,LAC,CHA,30.5,Pts+Rebs+Asts,43,35,37,14
22023,201935,22300414,"DEC 26, 2023",LAC vs. CHA,W,40,8,16,0.5,6,12,0.5,7,8,0.875,0,6,6,8,2,1,4,2,29,20,1,James Harden,LAC,LAC,CHA,9.0,Assists,43,35,37,14
22023,201935,22300414,"DEC 26, 2023",LAC vs. CHA,W,40,8,16,0.5,6,12,0.5,7,8,0.875,0,6,6,8,2,1,4,2,29,20,1,James Harden,LAC,LAC,CHA,38.0,Fantasy Score,43,35,37,14
22023,201935,22300414,"DEC 26, 2023",LAC vs. CHA,W,40,8,16,0.5,6,12,0.5,7,8,0.875,0,6,6,8,2,1,4,2,29,20,1,James Harden,LAC,LAC,CHA,6.5,3-PT Attempted,43,35,37,14
22023,201935,22300414,"DEC 26, 2023",LAC vs. CHA,W,40,8,16,0.5,6,12,0.5,7,8,0.875,0,6,6,8,2,1,4,2,29,20,1,James Harden,LAC,LAC,CHA,3.5,Free Throws Made,43,35,37,14
22023,201935,22300414,"DEC 26, 2023",LAC vs. CHA,W,40,8,16,0.5,6,12,0.5,7,8,0.875,0,6,6,8,2,1,4,2,29,20,1,James Harden,LAC,LAC,CHA,12.0,FG Attempted,43,35,37,14
22023,201935,22300414,"DEC 26, 2023",LAC vs. CHA,W,40,8,16,0.5,6,12,0.5,7,8,0.875,0,6,6,8,2,1,4,2,29,20,1,James Harden,LAC,LAC,CHA,21.5,Pts+Rebs,43,35,37,14
22023,201935,22300414,"DEC 26, 2023",LAC vs. CHA,W,40,8,16,0.5,6,12,0.5,7,8,0.875,0,6,6,8,2,1,4,2,29,20,1,James Harden,LAC,LAC,CHA,25.5,Pts+Asts,43,35,37,14
22023,201935,22300414,"DEC 26, 2023",LAC vs. CHA,W,40,8,16,0.5,6,12,0.5,7,8,0.875,0,6,6,8,2,1,4,2,29,20,1,James Harden,LAC,LAC,CHA,14.0,Rebs+Asts,43,35,37,14
22023,201935,22300389,"DEC 23, 2023",LAC vs. BOS,L,29,6,13,0.462,2,5,0.4,0,0,0.0,0,4,4,9,1,0,4,4,14,-34,1,James Harden,LAC,LAC,BOS,16.5,Points,27,18,23,13
22023,201935,22300389,"DEC 23, 2023",LAC vs. BOS,L,29,6,13,0.462,2,5,0.4,0,0,0.0,0,4,4,9,1,0,4,4,14,-34,1,James Harden,LAC,LAC,BOS,5.0,Rebounds,27,18,23,13
22023,201935,22300389,"DEC 23, 2023",LAC vs. BOS,L,29,6,13,0.462,2,5,0.4,0,0,0.0,0,4,4,9,1,0,4,4,14,-34,1,James Harden,LAC,LAC,BOS,30.5,Pts+Rebs+Asts,27,18,23,13
22023,201935,22300389,"DEC 23, 2023",LAC vs. BOS,L,29,6,13,0.462,2,5,0.4,0,0,0.0,0,4,4,9,1,0,4,4,14,-34,1,James Harden,LAC,LAC,BOS,9.0,Assists,27,18,23,13
22023,201935,22300389,"DEC 23, 2023",LAC vs. BOS,L,29,6,13,0.462,2,5,0.4,0,0,0.0,0,4,4,9,1,0,4,4,14,-34,1,James Harden,LAC,LAC,BOS,38.0,Fantasy Score,27,18,23,13
22023,201935,22300389,"DEC 23, 2023",LAC vs. BOS,L,29,6,13,0.462,2,5,0.4,0,0,0.0,0,4,4,9,1,0,4,4,14,-34,1,James Harden,LAC,LAC,BOS,6.5,3-PT Attempted,27,18,23,13
22023,201935,22300389,"DEC 23, 2023",LAC vs. BOS,L,29,6,13,0.462,2,5,0.4,0,0,0.0,0,4,4,9,1,0,4,4,14,-34,1,James Harden,LAC,LAC,BOS,3.5,Free Throws Made,27,18,23,13
22023,201935,22300389,"DEC 23, 2023",LAC vs. BOS,L,29,6,13,0.462,2,5,0.4,0,0,0.0,0,4,4,9,1,0,4,4,14,-34,1,James Harden,LAC,LAC,BOS,12.0,FG Attempted,27,18,23,13
22023,201935,22300389,"DEC 23, 2023",LAC vs. BOS,L,29,6,13,0.462,2,5,0.4,0,0,0.0,0,4,4,9,1,0,4,4,14,-34,1,James Harden,LAC,LAC,BOS,21.5,Pts+Rebs,27,18,23,13
22023,201935,22300389,"DEC 23, 2023",LAC vs. BOS,L,29,6,13,0.462,2,5,0.4,0,0,0.0,0,4,4,9,1,0,4,4,14,-34,1,James Harden,LAC,LAC,BOS,25.5,Pts+Asts,27,18,23,13
22023,201935,22300389,"DEC 23, 2023",LAC vs. BOS,L,29,6,13,0.462,2,5,0.4,0,0,0.0,0,4,4,9,1,0,4,4,14,-34,1,James Harden,LAC,LAC,BOS,14.0,Rebs+Asts,27,18,23,13
22023,201935,22300379,"DEC 21, 2023",LAC @ OKC,L,34,7,18,0.389,4,9,0.444,5,6,0.833,2,7,9,6,3,1,3,1,23,-17,1,James Harden,LAC,OKC,LAC,16.5,Points,38,32,29,15
22023,201935,22300379,"DEC 21, 2023",LAC @ OKC,L,34,7,18,0.389,4,9,0.444,5,6,0.833,2,7,9,6,3,1,3,1,23,-17,1,James Harden,LAC,OKC,LAC,5.0,Rebounds,38,32,29,15
22023,201935,22300379,"DEC 21, 2023",LAC @ OKC,L,34,7,18,0.389,4,9,0.444,5,6,0.833,2,7,9,6,3,1,3,1,23,-17,1,James Harden,LAC,OKC,LAC,30.5,Pts+Rebs+Asts,38,32,29,15
22023,201935,22300379,"DEC 21, 2023",LAC @ OKC,L,34,7,18,0.389,4,9,0.444,5,6,0.833,2,7,9,6,3,1,3,1,23,-17,1,James Harden,LAC,OKC,LAC,9.0,Assists,38,32,29,15
22023,201935,22300379,"DEC 21, 2023",LAC @ OKC,L,34,7,18,0.389,4,9,0.444,5,6,0.833,2,7,9,6,3,1,3,1,23,-17,1,James Harden,LAC,OKC,LAC,38.0,Fantasy Score,38,32,29,15
22023,201935,22300379,"DEC 21, 2023",LAC @ OKC,L,34,7,18,0.389,4,9,0.444,5,6,0.833,2,7,9,6,3,1,3,1,23,-17,1,James Harden,LAC,OKC,LAC,6.5,3-PT Attempted,38,32,29,15
22023,201935,22300379,"DEC 21, 2023",LAC @ OKC,L,34,7,18,0.389,4,9,0.444,5,6,0.833,2,7,9,6,3,1,3,1,23,-17,1,James Harden,LAC,OKC,LAC,3.5,Free Throws Made,38,32,29,15
22023,201935,22300379,"DEC 21, 2023",LAC @ OKC,L,34,7,18,0.389,4,9,0.444,5,6,0.833,2,7,9,6,3,1,3,1,23,-17,1,James Harden,LAC,OKC,LAC,12.0,FG Attempted,38,32,29,15
22023,201935,22300379,"DEC 21, 2023",LAC @ OKC,L,34,7,18,0.389,4,9,0.444,5,6,0.833,2,7,9,6,3,1,3,1,23,-17,1,James Harden,LAC,OKC,LAC,21.5,Pts+Rebs,38,32,29,15
22023,201935,22300379,"DEC 21, 2023",LAC @ OKC,L,34,7,18,0.389,4,9,0.444,5,6,0.833,2,7,9,6,3,1,3,1,23,-17,1,James Harden,LAC,OKC,LAC,25.5,Pts+Asts,38,32,29,15
22023,201935,22300379,"DEC 21, 2023",LAC @ OKC,L,34,7,18,0.389,4,9,0.444,5,6,0.833,2,7,9,6,3,1,3,1,23,-17,1,James Harden,LAC,OKC,LAC,14.0,Rebs+Asts,38,32,29,15
22023,201935,22300372,"DEC 20, 2023",LAC @ DAL,W,39,4,12,0.333,2,8,0.25,7,8,0.875,0,5,5,11,0,2,4,3,17,10,1,James Harden,LAC,DAL,LAC,16.5,Points,33,22,28,16
22023,201935,22300372,"DEC 20, 2023",LAC @ DAL,W,39,4,12,0.333,2,8,0.25,7,8,0.875,0,5,5,11,0,2,4,3,17,10,1,James Harden,LAC,DAL,LAC,5.0,Rebounds,33,22,28,16
22023,201935,22300372,"DEC 20, 2023",LAC @ DAL,W,39,4,12,0.333,2,8,0.25,7,8,0.875,0,5,5,11,0,2,4,3,17,10,1,James Harden,LAC,DAL,LAC,30.5,Pts+Rebs+Asts,33,22,28,16
22023,201935,22300372,"DEC 20, 2023",LAC @ DAL,W,39,4,12,0.333,2,8,0.25,7,8,0.875,0,5,5,11,0,2,4,3,17,10,1,James Harden,LAC,DAL,LAC,9.0,Assists,33,22,28,16
22023,201935,22300372,"DEC 20, 2023",LAC @ DAL,W,39,4,12,0.333,2,8,0.25,7,8,0.875,0,5,5,11,0,2,4,3,17,10,1,James Harden,LAC,DAL,LAC,38.0,Fantasy Score,33,22,28,16
22023,201935,22300372,"DEC 20, 2023",LAC @ DAL,W,39,4,12,0.333,2,8,0.25,7,8,0.875,0,5,5,11,0,2,4,3,17,10,1,James Harden,LAC,DAL,LAC,6.5,3-PT Attempted,33,22,28,16
22023,201935,22300372,"DEC 20, 2023",LAC @ DAL,W,39,4,12,0.333,2,8,0.25,7,8,0.875,0,5,5,11,0,2,4,3,17,10,1,James Harden,LAC,DAL,LAC,3.5,Free Throws Made,33,22,28,16
22023,201935,22300372,"DEC 20, 2023",LAC @ DAL,W,39,4,12,0.333,2,8,0.25,7,8,0.875,0,5,5,11,0,2,4,3,17,10,1,James Harden,LAC,DAL,LAC,12.0,FG Attempted,33,22,28,16
22023,201935,22300372,"DEC 20, 2023",LAC @ DAL,W,39,4,12,0.333,2,8,0.25,7,8,0.875,0,5,5,11,0,2,4,3,17,10,1,James Harden,LAC,DAL,LAC,21.5,Pts+Rebs,33,22,28,16
22023,201935,22300372,"DEC 20, 2023",LAC @ DAL,W,39,4,12,0.333,2,8,0.25,7,8,0.875,0,5,5,11,0,2,4,3,17,10,1,James Harden,LAC,DAL,LAC,25.5,Pts+Asts,33,22,28,16
22023,201935,22300372,"DEC 20, 2023",LAC @ DAL,W,39,4,12,0.333,2,8,0.25,7,8,0.875,0,5,5,11,0,2,4,3,17,10,1,James Harden,LAC,DAL,LAC,14.0,Rebs+Asts,33,22,28,16
22023,201935,22300350,"DEC 18, 2023",LAC @ IND,W,28,12,16,0.75,8,11,0.727,3,3,1.0,0,3,3,9,1,1,1,2,35,32,1,James Harden,LAC,IND,LAC,16.5,Points,47,38,44,12
22023,201935,22300350,"DEC 18, 2023",LAC @ IND,W,28,12,16,0.75,8,11,0.727,3,3,1.0,0,3,3,9,1,1,1,2,35,32,1,James Harden,LAC,IND,LAC,5.0,Rebounds,47,38,44,12
22023,201935,22300350,"DEC 18, 2023",LAC @ IND,W,28,12,16,0.75,8,11,0.727,3,3,1.0,0,3,3,9,1,1,1,2,35,32,1,James Harden,LAC,IND,LAC,30.5,Pts+Rebs+Asts,47,38,44,12
22023,201935,22300350,"DEC 18, 2023",LAC @ IND,W,28,12,16,0.75,8,11,0.727,3,3,1.0,0,3,3,9,1,1,1,2,35,32,1,James Harden,LAC,IND,LAC,9.0,Assists,47,38,44,12
22023,201935,22300350,"DEC 18, 2023",LAC @ IND,W,28,12,16,0.75,8,11,0.727,3,3,1.0,0,3,3,9,1,1,1,2,35,32,1,James Harden,LAC,IND,LAC,38.0,Fantasy Score,47,38,44,12
22023,201935,22300350,"DEC 18, 2023",LAC @ IND,W,28,12,16,0.75,8,11,0.727,3,3,1.0,0,3,3,9,1,1,1,2,35,32,1,James Harden,LAC,IND,LAC,6.5,3-PT Attempted,47,38,44,12
22023,201935,22300350,"DEC 18, 2023",LAC @ IND,W,28,12,16,0.75,8,11,0.727,3,3,1.0,0,3,3,9,1,1,1,2,35,32,1,James Harden,LAC,IND,LAC,3.5,Free Throws Made,47,38,44,12
22023,201935,22300350,"DEC 18, 2023",LAC @ IND,W,28,12,16,0.75,8,11,0.727,3,3,1.0,0,3,3,9,1,1,1,2,35,32,1,James Harden,LAC,IND,LAC,12.0,FG Attempted,47,38,44,12
22023,201935,22300350,"DEC 18, 2023",LAC @ IND,W,28,12,16,0.75,8,11,0.727,3,3,1.0,0,3,3,9,1,1,1,2,35,32,1,James Harden,LAC,IND,LAC,21.5,Pts+Rebs,47,38,44,12
22023,201935,22300350,"DEC 18, 2023",LAC @ IND,W,28,12,16,0.75,8,11,0.727,3,3,1.0,0,3,3,9,1,1,1,2,35,32,1,James Harden,LAC,IND,LAC,25.5,Pts+Asts,47,38,44,12
22023,201935,22300350,"DEC 18, 2023",LAC @ IND,W,28,12,16,0.75,8,11,0.727,3,3,1.0,0,3,3,9,1,1,1,2,35,32,1,James Harden,LAC,IND,LAC,14.0,Rebs+Asts,47,38,44,12
22023,201935,22300343,"DEC 16, 2023",LAC vs. NYK,W,28,2,6,0.333,1,4,0.25,5,7,0.714,0,4,4,12,1,2,1,3,10,22,1,James Harden,LAC,LAC,NYK,16.5,Points,26,14,22,16
22023,201935,22300343,"DEC 16, 2023",LAC vs. NYK,W,28,2,6,0.333,1,4,0.25,5,7,0.714,0,4,4,12,1,2,1,3,10,22,1,James Harden,LAC,LAC,NYK,5.0,Rebounds,26,14,22,16
22023,201935,22300343,"DEC 16, 2023",LAC vs. NYK,W,28,2,6,0.333,1,4,0.25,5,7,0.714,0,4,4,12,1,2,1,3,10,22,1,James Harden,LAC,LAC,NYK,30.5,Pts+Rebs+Asts,26,14,22,16
22023,201935,22300343,"DEC 16, 2023",LAC vs. NYK,W,28,2,6,0.333,1,4,0.25,5,7,0.714,0,4,4,12,1,2,1,3,10,22,1,James Harden,LAC,LAC,NYK,9.0,Assists,26,14,22,16
22023,201935,22300343,"DEC 16, 2023",LAC vs. NYK,W,28,2,6,0.333,1,4,0.25,5,7,0.714,0,4,4,12,1,2,1,3,10,22,1,James Harden,LAC,LAC,NYK,38.0,Fantasy Score,26,14,22,16
22023,201935,22300343,"DEC 16, 2023",LAC vs. NYK,W,28,2,6,0.333,1,4,0.25,5,7,0.714,0,4,4,12,1,2,1,3,10,22,1,James Harden,LAC,LAC,NYK,6.5,3-PT Attempted,26,14,22,16
22023,201935,22300343,"DEC 16, 2023",LAC vs. NYK,W,28,2,6,0.333,1,4,0.25,5,7,0.714,0,4,4,12,1,2,1,3,10,22,1,James Harden,LAC,LAC,NYK,3.5,Free Throws Made,26,14,22,16
22023,201935,22300343,"DEC 16, 2023",LAC vs. NYK,W,28,2,6,0.333,1,4,0.25,5,7,0.714,0,4,4,12,1,2,1,3,10,22,1,James Harden,LAC,LAC,NYK,12.0,FG Attempted,26,14,22,16
22023,201935,22300343,"DEC 16, 2023",LAC vs. NYK,W,28,2,6,0.333,1,4,0.25,5,7,0.714,0,4,4,12,1,2,1,3,10,22,1,James Harden,LAC,LAC,NYK,21.5,Pts+Rebs,26,14,22,16
22023,201935,22300343,"DEC 16, 2023",LAC vs. NYK,W,28,2,6,0.333,1,4,0.25,5,7,0.714,0,4,4,12,1,2,1,3,10,22,1,James Harden,LAC,LAC,NYK,25.5,Pts+Asts,26,14,22,16
22023,201935,22300343,"DEC 16, 2023",LAC vs. NYK,W,28,2,6,0.333,1,4,0.25,5,7,0.714,0,4,4,12,1,2,1,3,10,22,1,James Harden,LAC,LAC,NYK,14.0,Rebs+Asts,26,14,22,16
22023,201935,22300325,"DEC 14, 2023",LAC vs. GSW,W,42,6,12,0.5,5,6,0.833,11,12,0.917,2,5,7,15,1,4,4,3,28,12,1,James Harden,LAC,LAC,GSW,16.5,Points,50,35,43,22
22023,201935,22300325,"DEC 14, 2023",LAC vs. GSW,W,42,6,12,0.5,5,6,0.833,11,12,0.917,2,5,7,15,1,4,4,3,28,12,1,James Harden,LAC,LAC,GSW,5.0,Rebounds,50,35,43,22
22023,201935,22300325,"DEC 14, 2023",LAC vs. GSW,W,42,6,12,0.5,5,6,0.833,11,12,0.917,2,5,7,15,1,4,4,3,28,12,1,James Harden,LAC,LAC,GSW,30.5,Pts+Rebs+Asts,50,35,43,22
22023,201935,22300325,"DEC 14, 2023",LAC vs. GSW,W,42,6,12,0.5,5,6,0.833,11,12,0.917,2,5,7,15,1,4,4,3,28,12,1,James Harden,LAC,LAC,GSW,9.0,Assists,50,35,43,22
22023,201935,22300325,"DEC 14, 2023",LAC vs. GSW,W,42,6,12,0.5,5,6,0.833,11,12,0.917,2,5,7,15,1,4,4,3,28,12,1,James Harden,LAC,LAC,GSW,38.0,Fantasy Score,50,35,43,22
22023,201935,22300325,"DEC 14, 2023",LAC vs. GSW,W,42,6,12,0.5,5,6,0.833,11,12,0.917,2,5,7,15,1,4,4,3,28,12,1,James Harden,LAC,LAC,GSW,6.5,3-PT Attempted,50,35,43,22
22023,201935,22300325,"DEC 14, 2023",LAC vs. GSW,W,42,6,12,0.5,5,6,0.833,11,12,0.917,2,5,7,15,1,4,4,3,28,12,1,James Harden,LAC,LAC,GSW,3.5,Free Throws Made,50,35,43,22
22023,201935,22300325,"DEC 14, 2023",LAC vs. GSW,W,42,6,12,0.5,5,6,0.833,11,12,0.917,2,5,7,15,1,4,4,3,28,12,1,James Harden,LAC,LAC,GSW,12.0,FG Attempted,50,35,43,22
22023,201935,22300325,"DEC 14, 2023",LAC vs. GSW,W,42,6,12,0.5,5,6,0.833,11,12,0.917,2,5,7,15,1,4,4,3,28,12,1,James Harden,LAC,LAC,GSW,21.5,Pts+Rebs,50,35,43,22
22023,201935,22300325,"DEC 14, 2023",LAC vs. GSW,W,42,6,12,0.5,5,6,0.833,11,12,0.917,2,5,7,15,1,4,4,3,28,12,1,James Harden,LAC,LAC,GSW,25.5,Pts+Asts,50,35,43,22
22023,201935,22300325,"DEC 14, 2023",LAC vs. GSW,W,42,6,12,0.5,5,6,0.833,11,12,0.917,2,5,7,15,1,4,4,3,28,12,1,James Harden,LAC,LAC,GSW,14.0,Rebs+Asts,50,35,43,22
22023,201935,22300309,"DEC 12, 2023",LAC vs. SAC,W,28,4,9,0.444,0,4,0.0,7,7,1.0,0,6,6,7,2,0,2,3,15,26,1,James Harden,LAC,LAC,SAC,16.5,Points,28,21,22,13
22023,201935,22300309,"DEC 12, 2023",LAC vs. SAC,W,28,4,9,0.444,0,4,0.0,7,7,1.0,0,6,6,7,2,0,2,3,15,26,1,James Harden,LAC,LAC,SAC,5.0,Rebounds,28,21,22,13
22023,201935,22300309,"DEC 12, 2023",LAC vs. SAC,W,28,4,9,0.444,0,4,0.0,7,7,1.0,0,6,6,7,2,0,2,3,15,26,1,James Harden,LAC,LAC,SAC,30.5,Pts+Rebs+Asts,28,21,22,13
22023,201935,22300309,"DEC 12, 2023",LAC vs. SAC,W,28,4,9,0.444,0,4,0.0,7,7,1.0,0,6,6,7,2,0,2,3,15,26,1,James Harden,LAC,LAC,SAC,9.0,Assists,28,21,22,13
22023,201935,22300309,"DEC 12, 2023",LAC vs. SAC,W,28,4,9,0.444,0,4,0.0,7,7,1.0,0,6,6,7,2,0,2,3,15,26,1,James Harden,LAC,LAC,SAC,38.0,Fantasy Score,28,21,22,13
22023,201935,22300309,"DEC 12, 2023",LAC vs. SAC,W,28,4,9,0.444,0,4,0.0,7,7,1.0,0,6,6,7,2,0,2,3,15,26,1,James Harden,LAC,LAC,SAC,6.5,3-PT Attempted,28,21,22,13
22023,201935,22300309,"DEC 12, 2023",LAC vs. SAC,W,28,4,9,0.444,0,4,0.0,7,7,1.0,0,6,6,7,2,0,2,3,15,26,1,James Harden,LAC,LAC,SAC,3.5,Free Throws Made,28,21,22,13
22023,201935,22300309,"DEC 12, 2023",LAC vs. SAC,W,28,4,9,0.444,0,4,0.0,7,7,1.0,0,6,6,7,2,0,2,3,15,26,1,James Harden,LAC,LAC,SAC,12.0,FG Attempted,28,21,22,13
22023,201935,22300309,"DEC 12, 2023",LAC vs. SAC,W,28,4,9,0.444,0,4,0.0,7,7,1.0,0,6,6,7,2,0,2,3,15,26,1,James Harden,LAC,LAC,SAC,21.5,Pts+Rebs,28,21,22,13
22023,201935,22300309,"DEC 12, 2023",LAC vs. SAC,W,28,4,9,0.444,0,4,0.0,7,7,1.0,0,6,6,7,2,0,2,3,15,26,1,James Harden,LAC,LAC,SAC,25.5,Pts+Asts,28,21,22,13
22023,201935,22300309,"DEC 12, 2023",LAC vs. SAC,W,28,4,9,0.444,0,4,0.0,7,7,1.0,0,6,6,7,2,0,2,3,15,26,1,James Harden,LAC,LAC,SAC,14.0,Rebs+Asts,28,21,22,13
22023,201935,22300304,"DEC 11, 2023",LAC vs. POR,W,37,7,14,0.5,3,6,0.5,3,3,1.0,0,7,7,7,1,2,3,2,20,3,1,James Harden,LAC,LAC,POR,16.5,Points,34,27,27,14
22023,201935,22300304,"DEC 11, 2023",LAC vs. POR,W,37,7,14,0.5,3,6,0.5,3,3,1.0,0,7,7,7,1,2,3,2,20,3,1,James Harden,LAC,LAC,POR,5.0,Rebounds,34,27,27,14
22023,201935,22300304,"DEC 11, 2023",LAC vs. POR,W,37,7,14,0.5,3,6,0.5,3,3,1.0,0,7,7,7,1,2,3,2,20,3,1,James Harden,LAC,LAC,POR,30.5,Pts+Rebs+Asts,34,27,27,14
22023,201935,22300304,"DEC 11, 2023",LAC vs. POR,W,37,7,14,0.5,3,6,0.5,3,3,1.0,0,7,7,7,1,2,3,2,20,3,1,James Harden,LAC,LAC,POR,9.0,Assists,34,27,27,14
22023,201935,22300304,"DEC 11, 2023",LAC vs. POR,W,37,7,14,0.5,3,6,0.5,3,3,1.0,0,7,7,7,1,2,3,2,20,3,1,James Harden,LAC,LAC,POR,38.0,Fantasy Score,34,27,27,14
22023,201935,22300304,"DEC 11, 2023",LAC vs. POR,W,37,7,14,0.5,3,6,0.5,3,3,1.0,0,7,7,7,1,2,3,2,20,3,1,James Harden,LAC,LAC,POR,6.5,3-PT Attempted,34,27,27,14
22023,201935,22300304,"DEC 11, 2023",LAC vs. POR,W,37,7,14,0.5,3,6,0.5,3,3,1.0,0,7,7,7,1,2,3,2,20,3,1,James Harden,LAC,LAC,POR,3.5,Free Throws Made,34,27,27,14
22023,201935,22300304,"DEC 11, 2023",LAC vs. POR,W,37,7,14,0.5,3,6,0.5,3,3,1.0,0,7,7,7,1,2,3,2,20,3,1,James Harden,LAC,LAC,POR,12.0,FG Attempted,34,27,27,14
22023,201935,22300304,"DEC 11, 2023",LAC vs. POR,W,37,7,14,0.5,3,6,0.5,3,3,1.0,0,7,7,7,1,2,3,2,20,3,1,James Harden,LAC,LAC,POR,21.5,Pts+Rebs,34,27,27,14
22023,201935,22300304,"DEC 11, 2023",LAC vs. POR,W,37,7,14,0.5,3,6,0.5,3,3,1.0,0,7,7,7,1,2,3,2,20,3,1,James Harden,LAC,LAC,POR,25.5,Pts+Asts,34,27,27,14
22023,201935,22300304,"DEC 11, 2023",LAC vs. POR,W,37,7,14,0.5,3,6,0.5,3,3,1.0,0,7,7,7,1,2,3,2,20,3,1,James Harden,LAC,LAC,POR,14.0,Rebs+Asts,34,27,27,14
22023,201935,22301225,"DEC 08, 2023",LAC @ UTA,W,34,2,8,0.25,2,6,0.333,6,7,0.857,0,7,7,8,0,1,2,2,12,18,1,James Harden,LAC,UTA,LAC,16.5,Points,27,19,20,15
22023,201935,22301225,"DEC 08, 2023",LAC @ UTA,W,34,2,8,0.25,2,6,0.333,6,7,0.857,0,7,7,8,0,1,2,2,12,18,1,James Harden,LAC,UTA,LAC,5.0,Rebounds,27,19,20,15
22023,201935,22301225,"DEC 08, 2023",LAC @ UTA,W,34,2,8,0.25,2,6,0.333,6,7,0.857,0,7,7,8,0,1,2,2,12,18,1,James Harden,LAC,UTA,LAC,30.5,Pts+Rebs+Asts,27,19,20,15
22023,201935,22301225,"DEC 08, 2023",LAC @ UTA,W,34,2,8,0.25,2,6,0.333,6,7,0.857,0,7,7,8,0,1,2,2,12,18,1,James Harden,LAC,UTA,LAC,9.0,Assists,27,19,20,15
22023,201935,22301225,"DEC 08, 2023",LAC @ UTA,W,34,2,8,0.25,2,6,0.333,6,7,0.857,0,7,7,8,0,1,2,2,12,18,1,James Harden,LAC,UTA,LAC,38.0,Fantasy Score,27,19,20,15
22023,201935,22301225,"DEC 08, 2023",LAC @ UTA,W,34,2,8,0.25,2,6,0.333,6,7,0.857,0,7,7,8,0,1,2,2,12,18,1,James Harden,LAC,UTA,LAC,6.5,3-PT Attempted,27,19,20,15
22023,201935,22301225,"DEC 08, 2023",LAC @ UTA,W,34,2,8,0.25,2,6,0.333,6,7,0.857,0,7,7,8,0,1,2,2,12,18,1,James Harden,LAC,UTA,LAC,3.5,Free Throws Made,27,19,20,15
22023,201935,22301225,"DEC 08, 2023",LAC @ UTA,W,34,2,8,0.25,2,6,0.333,6,7,0.857,0,7,7,8,0,1,2,2,12,18,1,James Harden,LAC,UTA,LAC,12.0,FG Attempted,27,19,20,15
22023,201935,22301225,"DEC 08, 2023",LAC @ UTA,W,34,2,8,0.25,2,6,0.333,6,7,0.857,0,7,7,8,0,1,2,2,12,18,1,James Harden,LAC,UTA,LAC,21.5,Pts+Rebs,27,19,20,15
22023,201935,22301225,"DEC 08, 2023",LAC @ UTA,W,34,2,8,0.25,2,6,0.333,6,7,0.857,0,7,7,8,0,1,2,2,12,18,1,James Harden,LAC,UTA,LAC,25.5,Pts+Asts,27,19,20,15
22023,201935,22301225,"DEC 08, 2023",LAC @ UTA,W,34,2,8,0.25,2,6,0.333,6,7,0.857,0,7,7,8,0,1,2,2,12,18,1,James Harden,LAC,UTA,LAC,14.0,Rebs+Asts,27,19,20,15
22023,201935,22301215,"DEC 06, 2023",LAC vs. DEN,W,32,6,10,0.6,2,3,0.667,6,7,0.857,0,1,1,11,3,1,4,0,20,6,1,James Harden,LAC,LAC,DEN,16.5,Points,32,21,31,12
22023,201935,22301215,"DEC 06, 2023",LAC vs. DEN,W,32,6,10,0.6,2,3,0.667,6,7,0.857,0,1,1,11,3,1,4,0,20,6,1,James Harden,LAC,LAC,DEN,5.0,Rebounds,32,21,31,12
22023,201935,22301215,"DEC 06, 2023",LAC vs. DEN,W,32,6,10,0.6,2,3,0.667,6,7,0.857,0,1,1,11,3,1,4,0,20,6,1,James Harden,LAC,LAC,DEN,30.5,Pts+Rebs+Asts,32,21,31,12
22023,201935,22301215,"DEC 06, 2023",LAC vs. DEN,W,32,6,10,0.6,2,3,0.667,6,7,0.857,0,1,1,11,3,1,4,0,20,6,1,James Harden,LAC,LAC,DEN,9.0,Assists,32,21,31,12
22023,201935,22301215,"DEC 06, 2023",LAC vs. DEN,W,32,6,10,0.6,2,3,0.667,6,7,0.857,0,1,1,11,3,1,4,0,20,6,1,James Harden,LAC,LAC,DEN,38.0,Fantasy Score,32,21,31,12
22023,201935,22301215,"DEC 06, 2023",LAC vs. DEN,W,32,6,10,0.6,2,3,0.667,6,7,0.857,0,1,1,11,3,1,4,0,20,6,1,James Harden,LAC,LAC,DEN,6.5,3-PT Attempted,32,21,31,12
22023,201935,22301215,"DEC 06, 2023",LAC vs. DEN,W,32,6,10,0.6,2,3,0.667,6,7,0.857,0,1,1,11,3,1,4,0,20,6,1,James Harden,LAC,LAC,DEN,3.5,Free Throws Made,32,21,31,12
22023,201935,22301215,"DEC 06, 2023",LAC vs. DEN,W,32,6,10,0.6,2,3,0.667,6,7,0.857,0,1,1,11,3,1,4,0,20,6,1,James Harden,LAC,LAC,DEN,12.0,FG Attempted,32,21,31,12
22023,201935,22301215,"DEC 06, 2023",LAC vs. DEN,W,32,6,10,0.6,2,3,0.667,6,7,0.857,0,1,1,11,3,1,4,0,20,6,1,James Harden,LAC,LAC,DEN,21.5,Pts+Rebs,32,21,31,12
22023,201935,22301215,"DEC 06, 2023",LAC vs. DEN,W,32,6,10,0.6,2,3,0.667,6,7,0.857,0,1,1,11,3,1,4,0,20,6,1,James Harden,LAC,LAC,DEN,25.5,Pts+Asts,32,21,31,12
22023,201935,22301215,"DEC 06, 2023",LAC vs. DEN,W,32,6,10,0.6,2,3,0.667,6,7,0.857,0,1,1,11,3,1,4,0,20,6,1,James Harden,LAC,LAC,DEN,14.0,Rebs+Asts,32,21,31,12
22023,201935,22300280,"DEC 02, 2023",LAC vs. GSW,W,35,7,14,0.5,2,7,0.286,5,5,1.0,0,5,5,9,1,0,1,4,21,0,1,James Harden,LAC,LAC,GSW,16.5,Points,35,26,30,14
22023,201935,22300280,"DEC 02, 2023",LAC vs. GSW,W,35,7,14,0.5,2,7,0.286,5,5,1.0,0,5,5,9,1,0,1,4,21,0,1,James Harden,LAC,LAC,GSW,5.0,Rebounds,35,26,30,14
22023,201935,22300280,"DEC 02, 2023",LAC vs. GSW,W,35,7,14,0.5,2,7,0.286,5,5,1.0,0,5,5,9,1,0,1,4,21,0,1,James Harden,LAC,LAC,GSW,30.5,Pts+Rebs+Asts,35,26,30,14
22023,201935,22300280,"DEC 02, 2023",LAC vs. GSW,W,35,7,14,0.5,2,7,0.286,5,5,1.0,0,5,5,9,1,0,1,4,21,0,1,James Harden,LAC,LAC,GSW,9.0,Assists,35,26,30,14
22023,201935,22300280,"DEC 02, 2023",LAC vs. GSW,W,35,7,14,0.5,2,7,0.286,5,5,1.0,0,5,5,9,1,0,1,4,21,0,1,James Harden,LAC,LAC,GSW,38.0,Fantasy Score,35,26,30,14
22023,201935,22300280,"DEC 02, 2023",LAC vs. GSW,W,35,7,14,0.5,2,7,0.286,5,5,1.0,0,5,5,9,1,0,1,4,21,0,1,James Harden,LAC,LAC,GSW,6.5,3-PT Attempted,35,26,30,14
22023,201935,22300280,"DEC 02, 2023",LAC vs. GSW,W,35,7,14,0.5,2,7,0.286,5,5,1.0,0,5,5,9,1,0,1,4,21,0,1,James Harden,LAC,LAC,GSW,3.5,Free Throws Made,35,26,30,14
22023,201935,22300280,"DEC 02, 2023",LAC vs. GSW,W,35,7,14,0.5,2,7,0.286,5,5,1.0,0,5,5,9,1,0,1,4,21,0,1,James Harden,LAC,LAC,GSW,12.0,FG Attempted,35,26,30,14
22023,201935,22300280,"DEC 02, 2023",LAC vs. GSW,W,35,7,14,0.5,2,7,0.286,5,5,1.0,0,5,5,9,1,0,1,4,21,0,1,James Harden,LAC,LAC,GSW,21.5,Pts+Rebs,35,26,30,14
22023,201935,22300280,"DEC 02, 2023",LAC vs. GSW,W,35,7,14,0.5,2,7,0.286,5,5,1.0,0,5,5,9,1,0,1,4,21,0,1,James Harden,LAC,LAC,GSW,25.5,Pts+Asts,35,26,30,14
22023,201935,22300280,"DEC 02, 2023",LAC vs. GSW,W,35,7,14,0.5,2,7,0.286,5,5,1.0,0,5,5,9,1,0,1,4,21,0,1,James Harden,LAC,LAC,GSW,14.0,Rebs+Asts,35,26,30,14
22023,201935,22300273,"NOV 30, 2023",LAC @ GSW,L,37,6,13,0.462,5,10,0.5,1,2,0.5,0,3,3,7,1,0,1,3,18,-1,1,James Harden,LAC,GSW,LAC,16.5,Points,28,21,25,10
22023,201935,22300273,"NOV 30, 2023",LAC @ GSW,L,37,6,13,0.462,5,10,0.5,1,2,0.5,0,3,3,7,1,0,1,3,18,-1,1,James Harden,LAC,GSW,LAC,5.0,Rebounds,28,21,25,10
22023,201935,22300273,"NOV 30, 2023",LAC @ GSW,L,37,6,13,0.462,5,10,0.5,1,2,0.5,0,3,3,7,1,0,1,3,18,-1,1,James Harden,LAC,GSW,LAC,30.5,Pts+Rebs+Asts,28,21,25,10
22023,201935,22300273,"NOV 30, 2023",LAC @ GSW,L,37,6,13,0.462,5,10,0.5,1,2,0.5,0,3,3,7,1,0,1,3,18,-1,1,James Harden,LAC,GSW,LAC,9.0,Assists,28,21,25,10
22023,201935,22300273,"NOV 30, 2023",LAC @ GSW,L,37,6,13,0.462,5,10,0.5,1,2,0.5,0,3,3,7,1,0,1,3,18,-1,1,James Harden,LAC,GSW,LAC,38.0,Fantasy Score,28,21,25,10
22023,201935,22300273,"NOV 30, 2023",LAC @ GSW,L,37,6,13,0.462,5,10,0.5,1,2,0.5,0,3,3,7,1,0,1,3,18,-1,1,James Harden,LAC,GSW,LAC,6.5,3-PT Attempted,28,21,25,10
22023,201935,22300273,"NOV 30, 2023",LAC @ GSW,L,37,6,13,0.462,5,10,0.5,1,2,0.5,0,3,3,7,1,0,1,3,18,-1,1,James Harden,LAC,GSW,LAC,3.5,Free Throws Made,28,21,25,10
22023,201935,22300273,"NOV 30, 2023",LAC @ GSW,L,37,6,13,0.462,5,10,0.5,1,2,0.5,0,3,3,7,1,0,1,3,18,-1,1,James Harden,LAC,GSW,LAC,12.0,FG Attempted,28,21,25,10
22023,201935,22300273,"NOV 30, 2023",LAC @ GSW,L,37,6,13,0.462,5,10,0.5,1,2,0.5,0,3,3,7,1,0,1,3,18,-1,1,James Harden,LAC,GSW,LAC,21.5,Pts+Rebs,28,21,25,10
22023,201935,22300273,"NOV 30, 2023",LAC @ GSW,L,37,6,13,0.462,5,10,0.5,1,2,0.5,0,3,3,7,1,0,1,3,18,-1,1,James Harden,LAC,GSW,LAC,25.5,Pts+Asts,28,21,25,10
22023,201935,22300273,"NOV 30, 2023",LAC @ GSW,L,37,6,13,0.462,5,10,0.5,1,2,0.5,0,3,3,7,1,0,1,3,18,-1,1,James Harden,LAC,GSW,LAC,14.0,Rebs+Asts,28,21,25,10
22023,201935,22300264,"NOV 29, 2023",LAC @ SAC,W,39,8,14,0.571,5,8,0.625,5,5,1.0,1,2,3,6,5,0,2,4,26,19,1,James Harden,LAC,SAC,LAC,16.5,Points,35,29,32,9
22023,201935,22300264,"NOV 29, 2023",LAC @ SAC,W,39,8,14,0.571,5,8,0.625,5,5,1.0,1,2,3,6,5,0,2,4,26,19,1,James Harden,LAC,SAC,LAC,5.0,Rebounds,35,29,32,9
22023,201935,22300264,"NOV 29, 2023",LAC @ SAC,W,39,8,14,0.571,5,8,0.625,5,5,1.0,1,2,3,6,5,0,2,4,26,19,1,James Harden,LAC,SAC,LAC,30.5,Pts+Rebs+Asts,35,29,32,9
22023,201935,22300264,"NOV 29, 2023",LAC @ SAC,W,39,8,14,0.571,5,8,0.625,5,5,1.0,1,2,3,6,5,0,2,4,26,19,1,James Harden,LAC,SAC,LAC,9.0,Assists,35,29,32,9
22023,201935,22300264,"NOV 29, 2023",LAC @ SAC,W,39,8,14,0.571,5,8,0.625,5,5,1.0,1,2,3,6,5,0,2,4,26,19,1,James Harden,LAC,SAC,LAC,38.0,Fantasy Score,35,29,32,9
22023,201935,22300264,"NOV 29, 2023",LAC @ SAC,W,39,8,14,0.571,5,8,0.625,5,5,1.0,1,2,3,6,5,0,2,4,26,19,1,James Harden,LAC,SAC,LAC,6.5,3-PT Attempted,35,29,32,9
22023,201935,22300264,"NOV 29, 2023",LAC @ SAC,W,39,8,14,0.571,5,8,0.625,5,5,1.0,1,2,3,6,5,0,2,4,26,19,1,James Harden,LAC,SAC,LAC,3.5,Free Throws Made,35,29,32,9
22023,201935,22300264,"NOV 29, 2023",LAC @ SAC,W,39,8,14,0.571,5,8,0.625,5,5,1.0,1,2,3,6,5,0,2,4,26,19,1,James Harden,LAC,SAC,LAC,12.0,FG Attempted,35,29,32,9
22023,201935,22300264,"NOV 29, 2023",LAC @ SAC,W,39,8,14,0.571,5,8,0.625,5,5,1.0,1,2,3,6,5,0,2,4,26,19,1,James Harden,LAC,SAC,LAC,21.5,Pts+Rebs,35,29,32,9
22023,201935,22300264,"NOV 29, 2023",LAC @ SAC,W,39,8,14,0.571,5,8,0.625,5,5,1.0,1,2,3,6,5,0,2,4,26,19,1,James Harden,LAC,SAC,LAC,25.5,Pts+Asts,35,29,32,9
22023,201935,22300264,"NOV 29, 2023",LAC @ SAC,W,39,8,14,0.571,5,8,0.625,5,5,1.0,1,2,3,6,5,0,2,4,26,19,1,James Harden,LAC,SAC,LAC,14.0,Rebs+Asts,35,29,32,9
22023,201935,22300257,"NOV 27, 2023",LAC vs. DEN,L,36,3,7,0.429,3,5,0.6,2,2,1.0,0,2,2,4,1,0,3,3,11,6,1,James Harden,LAC,LAC,DEN,16.5,Points,17,13,15,6
22023,201935,22300257,"NOV 27, 2023",LAC vs. DEN,L,36,3,7,0.429,3,5,0.6,2,2,1.0,0,2,2,4,1,0,3,3,11,6,1,James Harden,LAC,LAC,DEN,5.0,Rebounds,17,13,15,6
22023,201935,22300257,"NOV 27, 2023",LAC vs. DEN,L,36,3,7,0.429,3,5,0.6,2,2,1.0,0,2,2,4,1,0,3,3,11,6,1,James Harden,LAC,LAC,DEN,30.5,Pts+Rebs+Asts,17,13,15,6
22023,201935,22300257,"NOV 27, 2023",LAC vs. DEN,L,36,3,7,0.429,3,5,0.6,2,2,1.0,0,2,2,4,1,0,3,3,11,6,1,James Harden,LAC,LAC,DEN,9.0,Assists,17,13,15,6
22023,201935,22300257,"NOV 27, 2023",LAC vs. DEN,L,36,3,7,0.429,3,5,0.6,2,2,1.0,0,2,2,4,1,0,3,3,11,6,1,James Harden,LAC,LAC,DEN,38.0,Fantasy Score,17,13,15,6
22023,201935,22300257,"NOV 27, 2023",LAC vs. DEN,L,36,3,7,0.429,3,5,0.6,2,2,1.0,0,2,2,4,1,0,3,3,11,6,1,James Harden,LAC,LAC,DEN,6.5,3-PT Attempted,17,13,15,6
22023,201935,22300257,"NOV 27, 2023",LAC vs. DEN,L,36,3,7,0.429,3,5,0.6,2,2,1.0,0,2,2,4,1,0,3,3,11,6,1,James Harden,LAC,LAC,DEN,3.5,Free Throws Made,17,13,15,6
22023,201935,22300257,"NOV 27, 2023",LAC vs. DEN,L,36,3,7,0.429,3,5,0.6,2,2,1.0,0,2,2,4,1,0,3,3,11,6,1,James Harden,LAC,LAC,DEN,12.0,FG Attempted,17,13,15,6
22023,201935,22300257,"NOV 27, 2023",LAC vs. DEN,L,36,3,7,0.429,3,5,0.6,2,2,1.0,0,2,2,4,1,0,3,3,11,6,1,James Harden,LAC,LAC,DEN,21.5,Pts+Rebs,17,13,15,6
22023,201935,22300257,"NOV 27, 2023",LAC vs. DEN,L,36,3,7,0.429,3,5,0.6,2,2,1.0,0,2,2,4,1,0,3,3,11,6,1,James Harden,LAC,LAC,DEN,25.5,Pts+Asts,17,13,15,6
22023,201935,22300257,"NOV 27, 2023",LAC vs. DEN,L,36,3,7,0.429,3,5,0.6,2,2,1.0,0,2,2,4,1,0,3,3,11,6,1,James Harden,LAC,LAC,DEN,14.0,Rebs+Asts,17,13,15,6
22023,201935,22300244,"NOV 25, 2023",LAC vs. DAL,W,28,2,8,0.25,2,6,0.333,2,2,1.0,0,4,4,7,1,2,2,1,8,14,1,James Harden,LAC,LAC,DAL,16.5,Points,19,12,15,11
22023,201935,22300244,"NOV 25, 2023",LAC vs. DAL,W,28,2,8,0.25,2,6,0.333,2,2,1.0,0,4,4,7,1,2,2,1,8,14,1,James Harden,LAC,LAC,DAL,5.0,Rebounds,19,12,15,11
22023,201935,22300244,"NOV 25, 2023",LAC vs. DAL,W,28,2,8,0.25,2,6,0.333,2,2,1.0,0,4,4,7,1,2,2,1,8,14,1,James Harden,LAC,LAC,DAL,30.5,Pts+Rebs+Asts,19,12,15,11
22023,201935,22300244,"NOV 25, 2023",LAC vs. DAL,W,28,2,8,0.25,2,6,0.333,2,2,1.0,0,4,4,7,1,2,2,1,8,14,1,James Harden,LAC,LAC,DAL,9.0,Assists,19,12,15,11
22023,201935,22300244,"NOV 25, 2023",LAC vs. DAL,W,28,2,8,0.25,2,6,0.333,2,2,1.0,0,4,4,7,1,2,2,1,8,14,1,James Harden,LAC,LAC,DAL,38.0,Fantasy Score,19,12,15,11
22023,201935,22300244,"NOV 25, 2023",LAC vs. DAL,W,28,2,8,0.25,2,6,0.333,2,2,1.0,0,4,4,7,1,2,2,1,8,14,1,James Harden,LAC,LAC,DAL,6.5,3-PT Attempted,19,12,15,11
22023,201935,22300244,"NOV 25, 2023",LAC vs. DAL,W,28,2,8,0.25,2,6,0.333,2,2,1.0,0,4,4,7,1,2,2,1,8,14,1,James Harden,LAC,LAC,DAL,3.5,Free Throws Made,19,12,15,11
22023,201935,22300244,"NOV 25, 2023",LAC vs. DAL,W,28,2,8,0.25,2,6,0.333,2,2,1.0,0,4,4,7,1,2,2,1,8,14,1,James Harden,LAC,LAC,DAL,12.0,FG Attempted,19,12,15,11
22023,201935,22300244,"NOV 25, 2023",LAC vs. DAL,W,28,2,8,0.25,2,6,0.333,2,2,1.0,0,4,4,7,1,2,2,1,8,14,1,James Harden,LAC,LAC,DAL,21.5,Pts+Rebs,19,12,15,11
22023,201935,22300244,"NOV 25, 2023",LAC vs. DAL,W,28,2,8,0.25,2,6,0.333,2,2,1.0,0,4,4,7,1,2,2,1,8,14,1,James Harden,LAC,LAC,DAL,25.5,Pts+Asts,19,12,15,11
22023,201935,22300244,"NOV 25, 2023",LAC vs. DAL,W,28,2,8,0.25,2,6,0.333,2,2,1.0,0,4,4,7,1,2,2,1,8,14,1,James Harden,LAC,LAC,DAL,14.0,Rebs+Asts,19,12,15,11
22023,201935,22300052,"NOV 24, 2023",LAC vs. NOP,L,37,2,8,0.25,1,6,0.167,3,6,0.5,0,5,5,10,4,1,3,3,8,-6,1,James Harden,LAC,LAC,NOP,16.5,Points,23,13,18,15
22023,201935,22300052,"NOV 24, 2023",LAC vs. NOP,L,37,2,8,0.25,1,6,0.167,3,6,0.5,0,5,5,10,4,1,3,3,8,-6,1,James Harden,LAC,LAC,NOP,5.0,Rebounds,23,13,18,15
22023,201935,22300052,"NOV 24, 2023",LAC vs. NOP,L,37,2,8,0.25,1,6,0.167,3,6,0.5,0,5,5,10,4,1,3,3,8,-6,1,James Harden,LAC,LAC,NOP,30.5,Pts+Rebs+Asts,23,13,18,15
22023,201935,22300052,"NOV 24, 2023",LAC vs. NOP,L,37,2,8,0.25,1,6,0.167,3,6,0.5,0,5,5,10,4,1,3,3,8,-6,1,James Harden,LAC,LAC,NOP,9.0,Assists,23,13,18,15
22023,201935,22300052,"NOV 24, 2023",LAC vs. NOP,L,37,2,8,0.25,1,6,0.167,3,6,0.5,0,5,5,10,4,1,3,3,8,-6,1,James Harden,LAC,LAC,NOP,38.0,Fantasy Score,23,13,18,15
22023,201935,22300052,"NOV 24, 2023",LAC vs. NOP,L,37,2,8,0.25,1,6,0.167,3,6,0.5,0,5,5,10,4,1,3,3,8,-6,1,James Harden,LAC,LAC,NOP,6.5,3-PT Attempted,23,13,18,15
22023,201935,22300052,"NOV 24, 2023",LAC vs. NOP,L,37,2,8,0.25,1,6,0.167,3,6,0.5,0,5,5,10,4,1,3,3,8,-6,1,James Harden,LAC,LAC,NOP,3.5,Free Throws Made,23,13,18,15
22023,201935,22300052,"NOV 24, 2023",LAC vs. NOP,L,37,2,8,0.25,1,6,0.167,3,6,0.5,0,5,5,10,4,1,3,3,8,-6,1,James Harden,LAC,LAC,NOP,12.0,FG Attempted,23,13,18,15
22023,201935,22300052,"NOV 24, 2023",LAC vs. NOP,L,37,2,8,0.25,1,6,0.167,3,6,0.5,0,5,5,10,4,1,3,3,8,-6,1,James Harden,LAC,LAC,NOP,21.5,Pts+Rebs,23,13,18,15
22023,201935,22300052,"NOV 24, 2023",LAC vs. NOP,L,37,2,8,0.25,1,6,0.167,3,6,0.5,0,5,5,10,4,1,3,3,8,-6,1,James Harden,LAC,LAC,NOP,25.5,Pts+Asts,23,13,18,15
22023,201935,22300052,"NOV 24, 2023",LAC vs. NOP,L,37,2,8,0.25,1,6,0.167,3,6,0.5,0,5,5,10,4,1,3,3,8,-6,1,James Harden,LAC,LAC,NOP,14.0,Rebs+Asts,23,13,18,15
22023,201935,22300235,"NOV 22, 2023",LAC @ SAS,W,36,3,7,0.429,2,4,0.5,8,12,0.667,0,6,6,9,1,1,4,3,16,-2,1,James Harden,LAC,SAS,LAC,16.5,Points,31,22,25,15
22023,201935,22300235,"NOV 22, 2023",LAC @ SAS,W,36,3,7,0.429,2,4,0.5,8,12,0.667,0,6,6,9,1,1,4,3,16,-2,1,James Harden,LAC,SAS,LAC,5.0,Rebounds,31,22,25,15
22023,201935,22300235,"NOV 22, 2023",LAC @ SAS,W,36,3,7,0.429,2,4,0.5,8,12,0.667,0,6,6,9,1,1,4,3,16,-2,1,James Harden,LAC,SAS,LAC,30.5,Pts+Rebs+Asts,31,22,25,15
22023,201935,22300235,"NOV 22, 2023",LAC @ SAS,W,36,3,7,0.429,2,4,0.5,8,12,0.667,0,6,6,9,1,1,4,3,16,-2,1,James Harden,LAC,SAS,LAC,9.0,Assists,31,22,25,15
22023,201935,22300235,"NOV 22, 2023",LAC @ SAS,W,36,3,7,0.429,2,4,0.5,8,12,0.667,0,6,6,9,1,1,4,3,16,-2,1,James Harden,LAC,SAS,LAC,38.0,Fantasy Score,31,22,25,15
22023,201935,22300235,"NOV 22, 2023",LAC @ SAS,W,36,3,7,0.429,2,4,0.5,8,12,0.667,0,6,6,9,1,1,4,3,16,-2,1,James Harden,LAC,SAS,LAC,6.5,3-PT Attempted,31,22,25,15
22023,201935,22300235,"NOV 22, 2023",LAC @ SAS,W,36,3,7,0.429,2,4,0.5,8,12,0.667,0,6,6,9,1,1,4,3,16,-2,1,James Harden,LAC,SAS,LAC,3.5,Free Throws Made,31,22,25,15
22023,201935,22300235,"NOV 22, 2023",LAC @ SAS,W,36,3,7,0.429,2,4,0.5,8,12,0.667,0,6,6,9,1,1,4,3,16,-2,1,James Harden,LAC,SAS,LAC,12.0,FG Attempted,31,22,25,15
22023,201935,22300235,"NOV 22, 2023",LAC @ SAS,W,36,3,7,0.429,2,4,0.5,8,12,0.667,0,6,6,9,1,1,4,3,16,-2,1,James Harden,LAC,SAS,LAC,21.5,Pts+Rebs,31,22,25,15
22023,201935,22300235,"NOV 22, 2023",LAC @ SAS,W,36,3,7,0.429,2,4,0.5,8,12,0.667,0,6,6,9,1,1,4,3,16,-2,1,James Harden,LAC,SAS,LAC,25.5,Pts+Asts,31,22,25,15
22023,201935,22300235,"NOV 22, 2023",LAC @ SAS,W,36,3,7,0.429,2,4,0.5,8,12,0.667,0,6,6,9,1,1,4,3,16,-2,1,James Harden,LAC,SAS,LAC,14.0,Rebs+Asts,31,22,25,15
22023,201935,22300223,"NOV 20, 2023",LAC @ SAS,W,28,4,12,0.333,2,8,0.25,3,3,1.0,1,2,3,10,2,0,0,2,13,17,1,James Harden,LAC,SAS,LAC,16.5,Points,26,16,23,13
22023,201935,22300223,"NOV 20, 2023",LAC @ SAS,W,28,4,12,0.333,2,8,0.25,3,3,1.0,1,2,3,10,2,0,0,2,13,17,1,James Harden,LAC,SAS,LAC,5.0,Rebounds,26,16,23,13
22023,201935,22300223,"NOV 20, 2023",LAC @ SAS,W,28,4,12,0.333,2,8,0.25,3,3,1.0,1,2,3,10,2,0,0,2,13,17,1,James Harden,LAC,SAS,LAC,30.5,Pts+Rebs+Asts,26,16,23,13
22023,201935,22300223,"NOV 20, 2023",LAC @ SAS,W,28,4,12,0.333,2,8,0.25,3,3,1.0,1,2,3,10,2,0,0,2,13,17,1,James Harden,LAC,SAS,LAC,9.0,Assists,26,16,23,13
22023,201935,22300223,"NOV 20, 2023",LAC @ SAS,W,28,4,12,0.333,2,8,0.25,3,3,1.0,1,2,3,10,2,0,0,2,13,17,1,James Harden,LAC,SAS,LAC,38.0,Fantasy Score,26,16,23,13
22023,201935,22300223,"NOV 20, 2023",LAC @ SAS,W,28,4,12,0.333,2,8,0.25,3,3,1.0,1,2,3,10,2,0,0,2,13,17,1,James Harden,LAC,SAS,LAC,6.5,3-PT Attempted,26,16,23,13
22023,201935,22300223,"NOV 20, 2023",LAC @ SAS,W,28,4,12,0.333,2,8,0.25,3,3,1.0,1,2,3,10,2,0,0,2,13,17,1,James Harden,LAC,SAS,LAC,3.5,Free Throws Made,26,16,23,13
22023,201935,22300223,"NOV 20, 2023",LAC @ SAS,W,28,4,12,0.333,2,8,0.25,3,3,1.0,1,2,3,10,2,0,0,2,13,17,1,James Harden,LAC,SAS,LAC,12.0,FG Attempted,26,16,23,13
22023,201935,22300223,"NOV 20, 2023",LAC @ SAS,W,28,4,12,0.333,2,8,0.25,3,3,1.0,1,2,3,10,2,0,0,2,13,17,1,James Harden,LAC,SAS,LAC,21.5,Pts+Rebs,26,16,23,13
22023,201935,22300223,"NOV 20, 2023",LAC @ SAS,W,28,4,12,0.333,2,8,0.25,3,3,1.0,1,2,3,10,2,0,0,2,13,17,1,James Harden,LAC,SAS,LAC,25.5,Pts+Asts,26,16,23,13
22023,201935,22300223,"NOV 20, 2023",LAC @ SAS,W,28,4,12,0.333,2,8,0.25,3,3,1.0,1,2,3,10,2,0,0,2,13,17,1,James Harden,LAC,SAS,LAC,14.0,Rebs+Asts,26,16,23,13
22023,201935,22300037,"NOV 17, 2023",LAC vs. HOU,W,34,8,11,0.727,2,4,0.5,6,7,0.857,1,8,9,7,0,1,3,1,24,21,1,James Harden,LAC,LAC,HOU,16.5,Points,40,33,31,16
22023,201935,22300037,"NOV 17, 2023",LAC vs. HOU,W,34,8,11,0.727,2,4,0.5,6,7,0.857,1,8,9,7,0,1,3,1,24,21,1,James Harden,LAC,LAC,HOU,5.0,Rebounds,40,33,31,16
22023,201935,22300037,"NOV 17, 2023",LAC vs. HOU,W,34,8,11,0.727,2,4,0.5,6,7,0.857,1,8,9,7,0,1,3,1,24,21,1,James Harden,LAC,LAC,HOU,30.5,Pts+Rebs+Asts,40,33,31,16
22023,201935,22300037,"NOV 17, 2023",LAC vs. HOU,W,34,8,11,0.727,2,4,0.5,6,7,0.857,1,8,9,7,0,1,3,1,24,21,1,James Harden,LAC,LAC,HOU,9.0,Assists,40,33,31,16
22023,201935,22300037,"NOV 17, 2023",LAC vs. HOU,W,34,8,11,0.727,2,4,0.5,6,7,0.857,1,8,9,7,0,1,3,1,24,21,1,James Harden,LAC,LAC,HOU,38.0,Fantasy Score,40,33,31,16
22023,201935,22300037,"NOV 17, 2023",LAC vs. HOU,W,34,8,11,0.727,2,4,0.5,6,7,0.857,1,8,9,7,0,1,3,1,24,21,1,James Harden,LAC,LAC,HOU,6.5,3-PT Attempted,40,33,31,16
22023,201935,22300037,"NOV 17, 2023",LAC vs. HOU,W,34,8,11,0.727,2,4,0.5,6,7,0.857,1,8,9,7,0,1,3,1,24,21,1,James Harden,LAC,LAC,HOU,3.5,Free Throws Made,40,33,31,16
22023,201935,22300037,"NOV 17, 2023",LAC vs. HOU,W,34,8,11,0.727,2,4,0.5,6,7,0.857,1,8,9,7,0,1,3,1,24,21,1,James Harden,LAC,LAC,HOU,12.0,FG Attempted,40,33,31,16
22023,201935,22300037,"NOV 17, 2023",LAC vs. HOU,W,34,8,11,0.727,2,4,0.5,6,7,0.857,1,8,9,7,0,1,3,1,24,21,1,James Harden,LAC,LAC,HOU,21.5,Pts+Rebs,40,33,31,16
22023,201935,22300037,"NOV 17, 2023",LAC vs. HOU,W,34,8,11,0.727,2,4,0.5,6,7,0.857,1,8,9,7,0,1,3,1,24,21,1,James Harden,LAC,LAC,HOU,25.5,Pts+Asts,40,33,31,16
22023,201935,22300037,"NOV 17, 2023",LAC vs. HOU,W,34,8,11,0.727,2,4,0.5,6,7,0.857,1,8,9,7,0,1,3,1,24,21,1,James Harden,LAC,LAC,HOU,14.0,Rebs+Asts,40,33,31,16
22023,201935,22300024,"NOV 14, 2023",LAC @ DEN,L,35,7,15,0.467,3,8,0.375,4,4,1.0,0,2,2,4,0,0,1,3,21,-3,1,James Harden,LAC,DEN,LAC,16.5,Points,27,23,25,6
22023,201935,22300024,"NOV 14, 2023",LAC @ DEN,L,35,7,15,0.467,3,8,0.375,4,4,1.0,0,2,2,4,0,0,1,3,21,-3,1,James Harden,LAC,DEN,LAC,5.0,Rebounds,27,23,25,6
22023,201935,22300024,"NOV 14, 2023",LAC @ DEN,L,35,7,15,0.467,3,8,0.375,4,4,1.0,0,2,2,4,0,0,1,3,21,-3,1,James Harden,LAC,DEN,LAC,30.5,Pts+Rebs+Asts,27,23,25,6
22023,201935,22300024,"NOV 14, 2023",LAC @ DEN,L,35,7,15,0.467,3,8,0.375,4,4,1.0,0,2,2,4,0,0,1,3,21,-3,1,James Harden,LAC,DEN,LAC,9.0,Assists,27,23,25,6
22023,201935,22300024,"NOV 14, 2023",LAC @ DEN,L,35,7,15,0.467,3,8,0.375,4,4,1.0,0,2,2,4,0,0,1,3,21,-3,1,James Harden,LAC,DEN,LAC,38.0,Fantasy Score,27,23,25,6
22023,201935,22300024,"NOV 14, 2023",LAC @ DEN,L,35,7,15,0.467,3,8,0.375,4,4,1.0,0,2,2,4,0,0,1,3,21,-3,1,James Harden,LAC,DEN,LAC,6.5,3-PT Attempted,27,23,25,6
22023,201935,22300024,"NOV 14, 2023",LAC @ DEN,L,35,7,15,0.467,3,8,0.375,4,4,1.0,0,2,2,4,0,0,1,3,21,-3,1,James Harden,LAC,DEN,LAC,3.5,Free Throws Made,27,23,25,6
22023,201935,22300024,"NOV 14, 2023",LAC @ DEN,L,35,7,15,0.467,3,8,0.375,4,4,1.0,0,2,2,4,0,0,1,3,21,-3,1,James Harden,LAC,DEN,LAC,12.0,FG Attempted,27,23,25,6
22023,201935,22300024,"NOV 14, 2023",LAC @ DEN,L,35,7,15,0.467,3,8,0.375,4,4,1.0,0,2,2,4,0,0,1,3,21,-3,1,James Harden,LAC,DEN,LAC,21.5,Pts+Rebs,27,23,25,6
22023,201935,22300024,"NOV 14, 2023",LAC @ DEN,L,35,7,15,0.467,3,8,0.375,4,4,1.0,0,2,2,4,0,0,1,3,21,-3,1,James Harden,LAC,DEN,LAC,25.5,Pts+Asts,27,23,25,6
22023,201935,22300024,"NOV 14, 2023",LAC @ DEN,L,35,7,15,0.467,3,8,0.375,4,4,1.0,0,2,2,4,0,0,1,3,21,-3,1,James Harden,LAC,DEN,LAC,14.0,Rebs+Asts,27,23,25,6
22023,201935,22300179,"NOV 12, 2023",LAC vs. MEM,L,29,4,12,0.333,1,7,0.143,2,2,1.0,2,2,4,3,1,1,1,0,11,-28,1,James Harden,LAC,LAC,MEM,16.5,Points,18,15,14,7
22023,201935,22300179,"NOV 12, 2023",LAC vs. MEM,L,29,4,12,0.333,1,7,0.143,2,2,1.0,2,2,4,3,1,1,1,0,11,-28,1,James Harden,LAC,LAC,MEM,5.0,Rebounds,18,15,14,7
22023,201935,22300179,"NOV 12, 2023",LAC vs. MEM,L,29,4,12,0.333,1,7,0.143,2,2,1.0,2,2,4,3,1,1,1,0,11,-28,1,James Harden,LAC,LAC,MEM,30.5,Pts+Rebs+Asts,18,15,14,7
22023,201935,22300179,"NOV 12, 2023",LAC vs. MEM,L,29,4,12,0.333,1,7,0.143,2,2,1.0,2,2,4,3,1,1,1,0,11,-28,1,James Harden,LAC,LAC,MEM,9.0,Assists,18,15,14,7
22023,201935,22300179,"NOV 12, 2023",LAC vs. MEM,L,29,4,12,0.333,1,7,0.143,2,2,1.0,2,2,4,3,1,1,1,0,11,-28,1,James Harden,LAC,LAC,MEM,38.0,Fantasy Score,18,15,14,7
22023,201935,22300179,"NOV 12, 2023",LAC vs. MEM,L,29,4,12,0.333,1,7,0.143,2,2,1.0,2,2,4,3,1,1,1,0,11,-28,1,James Harden,LAC,LAC,MEM,6.5,3-PT Attempted,18,15,14,7
22023,201935,22300179,"NOV 12, 2023",LAC vs. MEM,L,29,4,12,0.333,1,7,0.143,2,2,1.0,2,2,4,3,1,1,1,0,11,-28,1,James Harden,LAC,LAC,MEM,3.5,Free Throws Made,18,15,14,7
22023,201935,22300179,"NOV 12, 2023",LAC vs. MEM,L,29,4,12,0.333,1,7,0.143,2,2,1.0,2,2,4,3,1,1,1,0,11,-28,1,James Harden,LAC,LAC,MEM,12.0,FG Attempted,18,15,14,7
22023,201935,22300179,"NOV 12, 2023",LAC vs. MEM,L,29,4,12,0.333,1,7,0.143,2,2,1.0,2,2,4,3,1,1,1,0,11,-28,1,James Harden,LAC,LAC,MEM,21.5,Pts+Rebs,18,15,14,7
22023,201935,22300179,"NOV 12, 2023",LAC vs. MEM,L,29,4,12,0.333,1,7,0.143,2,2,1.0,2,2,4,3,1,1,1,0,11,-28,1,James Harden,LAC,LAC,MEM,25.5,Pts+Asts,18,15,14,7
22023,201935,22300179,"NOV 12, 2023",LAC vs. MEM,L,29,4,12,0.333,1,7,0.143,2,2,1.0,2,2,4,3,1,1,1,0,11,-28,1,James Harden,LAC,LAC,MEM,14.0,Rebs+Asts,18,15,14,7
22023,201935,22300014,"NOV 10, 2023",LAC @ DAL,L,29,3,6,0.5,2,3,0.667,6,6,1.0,0,5,5,3,2,0,2,0,14,-6,1,James Harden,LAC,DAL,LAC,16.5,Points,22,19,17,8
22023,201935,22300014,"NOV 10, 2023",LAC @ DAL,L,29,3,6,0.5,2,3,0.667,6,6,1.0,0,5,5,3,2,0,2,0,14,-6,1,James Harden,LAC,DAL,LAC,5.0,Rebounds,22,19,17,8
22023,201935,22300014,"NOV 10, 2023",LAC @ DAL,L,29,3,6,0.5,2,3,0.667,6,6,1.0,0,5,5,3,2,0,2,0,14,-6,1,James Harden,LAC,DAL,LAC,30.5,Pts+Rebs+Asts,22,19,17,8
22023,201935,22300014,"NOV 10, 2023",LAC @ DAL,L,29,3,6,0.5,2,3,0.667,6,6,1.0,0,5,5,3,2,0,2,0,14,-6,1,James Harden,LAC,DAL,LAC,9.0,Assists,22,19,17,8
22023,201935,22300014,"NOV 10, 2023",LAC @ DAL,L,29,3,6,0.5,2,3,0.667,6,6,1.0,0,5,5,3,2,0,2,0,14,-6,1,James Harden,LAC,DAL,LAC,38.0,Fantasy Score,22,19,17,8
22023,201935,22300014,"NOV 10, 2023",LAC @ DAL,L,29,3,6,0.5,2,3,0.667,6,6,1.0,0,5,5,3,2,0,2,0,14,-6,1,James Harden,LAC,DAL,LAC,6.5,3-PT Attempted,22,19,17,8
22023,201935,22300014,"NOV 10, 2023",LAC @ DAL,L,29,3,6,0.5,2,3,0.667,6,6,1.0,0,5,5,3,2,0,2,0,14,-6,1,James Harden,LAC,DAL,LAC,3.5,Free Throws Made,22,19,17,8
22023,201935,22300014,"NOV 10, 2023",LAC @ DAL,L,29,3,6,0.5,2,3,0.667,6,6,1.0,0,5,5,3,2,0,2,0,14,-6,1,James Harden,LAC,DAL,LAC,12.0,FG Attempted,22,19,17,8
22023,201935,22300014,"NOV 10, 2023",LAC @ DAL,L,29,3,6,0.5,2,3,0.667,6,6,1.0,0,5,5,3,2,0,2,0,14,-6,1,James Harden,LAC,DAL,LAC,21.5,Pts+Rebs,22,19,17,8
22023,201935,22300014,"NOV 10, 2023",LAC @ DAL,L,29,3,6,0.5,2,3,0.667,6,6,1.0,0,5,5,3,2,0,2,0,14,-6,1,James Harden,LAC,DAL,LAC,25.5,Pts+Asts,22,19,17,8
22023,201935,22300014,"NOV 10, 2023",LAC @ DAL,L,29,3,6,0.5,2,3,0.667,6,6,1.0,0,5,5,3,2,0,2,0,14,-6,1,James Harden,LAC,DAL,LAC,14.0,Rebs+Asts,22,19,17,8
22023,201935,22300160,"NOV 08, 2023",LAC @ BKN,L,36,4,9,0.444,2,5,0.4,2,2,1.0,0,8,8,5,2,0,5,0,12,-15,1,James Harden,LAC,BKN,LAC,16.5,Points,25,20,17,13
22023,201935,22300160,"NOV 08, 2023",LAC @ BKN,L,36,4,9,0.444,2,5,0.4,2,2,1.0,0,8,8,5,2,0,5,0,12,-15,1,James Harden,LAC,BKN,LAC,5.0,Rebounds,25,20,17,13
22023,201935,22300160,"NOV 08, 2023",LAC @ BKN,L,36,4,9,0.444,2,5,0.4,2,2,1.0,0,8,8,5,2,0,5,0,12,-15,1,James Harden,LAC,BKN,LAC,30.5,Pts+Rebs+Asts,25,20,17,13
22023,201935,22300160,"NOV 08, 2023",LAC @ BKN,L,36,4,9,0.444,2,5,0.4,2,2,1.0,0,8,8,5,2,0,5,0,12,-15,1,James Harden,LAC,BKN,LAC,9.0,Assists,25,20,17,13
22023,201935,22300160,"NOV 08, 2023",LAC @ BKN,L,36,4,9,0.444,2,5,0.4,2,2,1.0,0,8,8,5,2,0,5,0,12,-15,1,James Harden,LAC,BKN,LAC,38.0,Fantasy Score,25,20,17,13
22023,201935,22300160,"NOV 08, 2023",LAC @ BKN,L,36,4,9,0.444,2,5,0.4,2,2,1.0,0,8,8,5,2,0,5,0,12,-15,1,James Harden,LAC,BKN,LAC,6.5,3-PT Attempted,25,20,17,13
22023,201935,22300160,"NOV 08, 2023",LAC @ BKN,L,36,4,9,0.444,2,5,0.4,2,2,1.0,0,8,8,5,2,0,5,0,12,-15,1,James Harden,LAC,BKN,LAC,3.5,Free Throws Made,25,20,17,13
22023,201935,22300160,"NOV 08, 2023",LAC @ BKN,L,36,4,9,0.444,2,5,0.4,2,2,1.0,0,8,8,5,2,0,5,0,12,-15,1,James Harden,LAC,BKN,LAC,12.0,FG Attempted,25,20,17,13
22023,201935,22300160,"NOV 08, 2023",LAC @ BKN,L,36,4,9,0.444,2,5,0.4,2,2,1.0,0,8,8,5,2,0,5,0,12,-15,1,James Harden,LAC,BKN,LAC,21.5,Pts+Rebs,25,20,17,13
22023,201935,22300160,"NOV 08, 2023",LAC @ BKN,L,36,4,9,0.444,2,5,0.4,2,2,1.0,0,8,8,5,2,0,5,0,12,-15,1,James Harden,LAC,BKN,LAC,25.5,Pts+Asts,25,20,17,13
22023,201935,22300160,"NOV 08, 2023",LAC @ BKN,L,36,4,9,0.444,2,5,0.4,2,2,1.0,0,8,8,5,2,0,5,0,12,-15,1,James Harden,LAC,BKN,LAC,14.0,Rebs+Asts,25,20,17,13
22023,201935,22300151,"NOV 06, 2023",LAC @ NYK,L,31,6,9,0.667,2,4,0.5,3,3,1.0,0,3,3,6,1,0,2,2,17,-18,1,James Harden,LAC,NYK,LAC,16.5,Points,26,20,23,9
22023,201935,22300151,"NOV 06, 2023",LAC @ NYK,L,31,6,9,0.667,2,4,0.5,3,3,1.0,0,3,3,6,1,0,2,2,17,-18,1,James Harden,LAC,NYK,LAC,5.0,Rebounds,26,20,23,9
22023,201935,22300151,"NOV 06, 2023",LAC @ NYK,L,31,6,9,0.667,2,4,0.5,3,3,1.0,0,3,3,6,1,0,2,2,17,-18,1,James Harden,LAC,NYK,LAC,30.5,Pts+Rebs+Asts,26,20,23,9
22023,201935,22300151,"NOV 06, 2023",LAC @ NYK,L,31,6,9,0.667,2,4,0.5,3,3,1.0,0,3,3,6,1,0,2,2,17,-18,1,James Harden,LAC,NYK,LAC,9.0,Assists,26,20,23,9
22023,201935,22300151,"NOV 06, 2023",LAC @ NYK,L,31,6,9,0.667,2,4,0.5,3,3,1.0,0,3,3,6,1,0,2,2,17,-18,1,James Harden,LAC,NYK,LAC,38.0,Fantasy Score,26,20,23,9
22023,201935,22300151,"NOV 06, 2023",LAC @ NYK,L,31,6,9,0.667,2,4,0.5,3,3,1.0,0,3,3,6,1,0,2,2,17,-18,1,James Harden,LAC,NYK,LAC,6.5,3-PT Attempted,26,20,23,9
22023,201935,22300151,"NOV 06, 2023",LAC @ NYK,L,31,6,9,0.667,2,4,0.5,3,3,1.0,0,3,3,6,1,0,2,2,17,-18,1,James Harden,LAC,NYK,LAC,3.5,Free Throws Made,26,20,23,9
22023,201935,22300151,"NOV 06, 2023",LAC @ NYK,L,31,6,9,0.667,2,4,0.5,3,3,1.0,0,3,3,6,1,0,2,2,17,-18,1,James Harden,LAC,NYK,LAC,12.0,FG Attempted,26,20,23,9
22023,201935,22300151,"NOV 06, 2023",LAC @ NYK,L,31,6,9,0.667,2,4,0.5,3,3,1.0,0,3,3,6,1,0,2,2,17,-18,1,James Harden,LAC,NYK,LAC,21.5,Pts+Rebs,26,20,23,9
22023,201935,22300151,"NOV 06, 2023",LAC @ NYK,L,31,6,9,0.667,2,4,0.5,3,3,1.0,0,3,3,6,1,0,2,2,17,-18,1,James Harden,LAC,NYK,LAC,25.5,Pts+Asts,26,20,23,9
22023,201935,22300151,"NOV 06, 2023",LAC @ NYK,L,31,6,9,0.667,2,4,0.5,3,3,1.0,0,3,3,6,1,0,2,2,17,-18,1,James Harden,LAC,NYK,LAC,14.0,Rebs+Asts,26,20,23,9
22023,1630702,22300556,"JAN 15, 2024",DAL vs. NOP,W,15,2,7,0.286,1,5,0.2,0,0,0.0,1,3,4,1,0,0,0,2,5,0,1,Jaden Hardy,DAL,DAL,NOP,,,10,9,6,5
22023,1630702,22300547,"JAN 13, 2024",DAL vs. NOP,L,23,3,8,0.375,2,4,0.5,0,0,0.0,0,2,2,1,0,0,2,1,8,-13,1,Jaden Hardy,DAL,DAL,NOP,,,11,10,9,3
22023,1630702,22300530,"JAN 11, 2024",DAL vs. NYK,W,23,2,8,0.25,0,2,0.0,4,5,0.8,0,6,6,4,0,0,0,2,8,14,1,Jaden Hardy,DAL,DAL,NYK,,,18,14,12,10
22023,1630702,22300515,"JAN 09, 2024",DAL vs. MEM,L,19,4,7,0.571,2,4,0.5,0,0,0.0,0,0,0,1,0,0,1,2,10,-11,1,Jaden Hardy,DAL,DAL,MEM,,,11,10,11,1
22023,1630702,22300501,"JAN 07, 2024",DAL vs. MIN,W,4,0,1,0.0,0,0,0.0,0,0,0.0,0,0,0,0,0,0,0,0,0,3,1,Jaden Hardy,DAL,DAL,MIN,,,0,0,0,0
22023,1630702,22300487,"JAN 05, 2024",DAL vs. POR,W,32,8,14,0.571,3,7,0.429,0,0,0.0,2,7,9,9,1,0,4,2,19,11,1,Jaden Hardy,DAL,DAL,POR,,,37,28,28,18
22023,1630702,22300472,"JAN 03, 2024",DAL vs. POR,W,11,4,10,0.4,1,6,0.167,2,3,0.667,0,1,1,1,0,1,0,0,11,2,1,Jaden Hardy,DAL,DAL,POR,,,13,12,12,2
22023,1630702,22300457,"JAN 01, 2024",DAL @ UTA,L,21,6,15,0.4,5,9,0.556,0,0,0.0,0,3,3,1,0,0,2,0,17,-22,1,Jaden Hardy,DAL,UTA,DAL,,,21,20,18,4
22023,1630702,22300444,"DEC 30, 2023",DAL @ GSW,W,24,4,8,0.5,1,5,0.2,0,0,0.0,0,2,2,0,0,0,1,2,9,7,1,Jaden Hardy,DAL,GSW,DAL,,,11,11,9,2
22023,1630702,22300423,"DEC 28, 2023",DAL @ MIN,L,31,7,18,0.389,3,8,0.375,0,0,0.0,0,2,2,1,1,1,0,2,17,0,1,Jaden Hardy,DAL,MIN,DAL,,,20,19,18,3
22023,1630702,22300405,"DEC 25, 2023",DAL @ PHX,W,13,1,4,0.25,1,3,0.333,0,0,0.0,0,2,2,1,0,0,0,0,3,4,1,Jaden Hardy,DAL,PHX,DAL,,,6,5,4,3
22023,1630702,22300398,"DEC 23, 2023",DAL vs. SAS,W,22,1,7,0.143,1,4,0.25,3,4,0.75,0,6,6,1,3,0,0,1,6,15,1,Jaden Hardy,DAL,DAL,SAS,,,13,12,7,7
22023,1630702,22300385,"DEC 22, 2023",DAL @ HOU,L,24,3,17,0.176,2,12,0.167,0,0,0.0,0,2,2,4,0,0,0,5,8,-33,1,Jaden Hardy,DAL,HOU,DAL,,,14,10,12,6
22023,1630702,22300372,"DEC 20, 2023",DAL vs. LAC,L,23,5,13,0.385,5,9,0.556,0,0,0.0,0,2,2,1,1,0,0,3,15,1,1,Jaden Hardy,DAL,DAL,LAC,,,18,17,16,3
22023,1630702,22300356,"DEC 18, 2023",DAL @ DEN,L,19,3,9,0.333,2,3,0.667,1,2,0.5,0,1,1,4,0,0,1,1,9,-13,1,Jaden Hardy,DAL,DEN,DAL,,,14,10,13,5
22023,1630702,22300341,"DEC 16, 2023",DAL @ POR,W,6,2,2,1.0,0,0,0.0,0,0,0.0,0,3,3,0,0,0,0,1,4,5,1,Jaden Hardy,DAL,POR,DAL,,,7,7,4,3
22023,1630702,22300321,"DEC 14, 2023",DAL vs. MIN,L,13,2,4,0.5,1,2,0.5,0,0,0.0,0,2,2,1,0,0,0,0,5,-1,1,Jaden Hardy,DAL,DAL,MIN,,,8,7,6,3
22023,1630702,22300306,"DEC 12, 2023",DAL vs. LAL,W,19,1,7,0.143,0,3,0.0,0,0,0.0,0,1,1,1,0,0,1,2,2,0,1,Jaden Hardy,DAL,DAL,LAL,,,4,3,3,2
22023,1630702,22300299,"DEC 11, 2023",DAL @ MEM,W,34,7,15,0.467,5,7,0.714,0,0,0.0,0,0,0,4,1,0,2,1,19,6,1,Jaden Hardy,DAL,MEM,DAL,,,23,19,23,4
22023,1630702,22301213,"DEC 06, 2023",DAL vs. UTA,W,8,3,7,0.429,2,4,0.5,0,0,0.0,2,1,3,4,0,0,1,1,8,10,1,Jaden Hardy,DAL,DAL,UTA,,,15,11,12,7
22023,1630702,22300287,"DEC 02, 2023",DAL vs. OKC,L,15,2,6,0.333,1,4,0.25,1,2,0.5,0,2,2,0,0,0,2,5,6,-17,1,Jaden Hardy,DAL,DAL,OKC,,,8,8,6,2
22023,1630702,22300277,"DEC 01, 2023",DAL vs. MEM,L,21,4,9,0.444,0,4,0.0,0,2,0.0,2,3,5,5,1,0,2,1,8,-10,1,Jaden Hardy,DAL,DAL,MEM,,,18,13,13,10
22023,1630702,22300059,"NOV 28, 2023",DAL vs. HOU,W,4,0,1,0.0,0,0,0.0,0,0,0.0,0,0,0,0,0,0,0,0,0,-2,1,Jaden Hardy,DAL,DAL,HOU,,,0,0,0,0
22023,1630702,22300244,"NOV 25, 2023",DAL @ LAC,L,8,1,3,0.333,0,1,0.0,2,2,1.0,2,2,4,1,0,0,1,0,4,1,1,Jaden Hardy,DAL,LAC,DAL,,,9,8,5,5
22023,1630702,22300238,"NOV 22, 2023",DAL @ LAL,W,7,1,5,0.2,0,1,0.0,0,0,0.0,0,0,0,0,0,0,0,0,2,-2,1,Jaden Hardy,DAL,LAL,DAL,,,2,2,2,0
22023,1630702,22300212,"NOV 19, 2023",DAL vs. SAC,L,10,1,4,0.25,1,2,0.5,1,2,0.5,0,0,0,0,1,0,1,2,4,0,1,Jaden Hardy,DAL,DAL,SAC,,,4,4,4,0
22023,1630702,22300192,"NOV 15, 2023",DAL @ WAS,W,4,1,2,0.5,0,0,0.0,0,1,0.0,0,0,0,0,1,0,1,0,2,-3,1,Jaden Hardy,DAL,WAS,DAL,,,2,2,2,0
22023,1630702,22300022,"NOV 14, 2023",DAL @ NOP,L,18,4,12,0.333,0,3,0.0,1,1,1.0,0,2,2,3,1,0,1,3,9,-2,1,Jaden Hardy,DAL,NOP,DAL,,,14,11,12,5
22023,1630702,22300183,"NOV 12, 2023",DAL @ NOP,W,7,3,6,0.5,1,4,0.25,0,0,0.0,1,1,2,2,0,0,0,1,7,-3,1,Jaden Hardy,DAL,NOP,DAL,,,11,9,9,4
22023,1630702,22300014,"NOV 10, 2023",DAL vs. LAC,W,12,5,8,0.625,1,2,0.5,0,1,0.0,0,2,2,0,0,0,2,1,11,-8,1,Jaden Hardy,DAL,DAL,LAC,,,13,13,11,2
22023,1630702,22300168,"NOV 08, 2023",DAL vs. TOR,L,12,2,4,0.5,1,3,0.333,1,2,0.5,0,1,1,2,0,0,0,0,6,-5,1,Jaden Hardy,DAL,DAL,TOR,,,9,7,8,3
22023,1630702,22300147,"NOV 06, 2023",DAL @ ORL,W,11,1,5,0.2,0,3,0.0,3,4,0.75,0,1,1,1,1,0,1,0,5,2,1,Jaden Hardy,DAL,ORL,DAL,,,7,6,6,2
22023,1630702,22300143,"NOV 05, 2023",DAL vs. CHA,W,15,3,7,0.429,1,4,0.25,7,8,0.875,0,4,4,0,0,0,0,1,14,9,1,Jaden Hardy,DAL,DAL,CHA,,,18,18,14,4
22023,1630702,22300006,"NOV 03, 2023",DAL @ DEN,L,14,2,6,0.333,2,4,0.5,0,0,0.0,1,2,3,3,0,0,0,2,6,8,1,Jaden Hardy,DAL,DEN,DAL,,,12,9,9,6
22023,1630702,22300124,"NOV 01, 2023",DAL vs. CHI,W,14,3,7,0.429,1,2,0.5,2,2,1.0,0,1,1,1,0,0,0,0,9,6,1,Jaden Hardy,DAL,DAL,CHI,,,11,10,10,2
22023,1630702,22300106,"OCT 30, 2023",DAL @ MEM,W,10,2,6,0.333,2,4,0.5,0,0,0.0,0,0,0,1,0,0,1,1,6,-7,1,Jaden Hardy,DAL,MEM,DAL,,,7,6,7,1
22023,1631199,22300211,"NOV 19, 2023",TOR vs. DET,W,4,0,0,0.0,0,0,0.0,0,0,0.0,0,0,0,1,0,0,0,2,0,-9,1,Ron Harper Jr.,TOR,TOR,DET,,,1,0,1,1
22023,203914,22300476,"JAN 03, 2024",ORL @ SAC,L,12,2,4,0.5,1,3,0.333,0,1,0.0,0,1,1,1,1,0,1,2,5,-8,1,Gary Harris,ORL,SAC,ORL,,,7,6,6,2
22023,203914,22300463,"JAN 02, 2024",ORL @ GSW,L,29,3,7,0.429,2,6,0.333,0,0,0.0,0,2,2,2,0,0,0,1,8,3,1,Gary Harris,ORL,GSW,ORL,,,12,10,10,4
22023,203914,22300450,"DEC 31, 2023",ORL @ PHX,L,32,2,7,0.286,1,6,0.167,0,0,0.0,0,2,2,2,0,0,0,1,5,7,1,Gary Harris,ORL,PHX,ORL,,,9,7,7,4
22023,203914,22300407,"DEC 26, 2023",ORL @ WAS,W,19,1,2,0.5,1,1,1.0,0,0,0.0,0,0,0,1,1,0,1,3,3,4,1,Gary Harris,ORL,WAS,ORL,,,4,3,4,1
22023,203914,22300391,"DEC 23, 2023",ORL @ IND,W,35,5,9,0.556,2,4,0.5,3,3,1.0,0,1,1,3,2,0,3,2,15,0,1,Gary Harris,ORL,IND,ORL,,,19,16,18,4
22023,203914,22300378,"DEC 21, 2023",ORL @ MIL,L,35,5,11,0.455,2,6,0.333,2,3,0.667,1,1,2,5,0,0,0,4,14,-11,1,Gary Harris,ORL,MIL,ORL,,,21,16,19,7
22023,203914,22300366,"DEC 20, 2023",ORL vs. MIA,L,20,0,2,0.0,0,2,0.0,0,0,0.0,3,0,3,1,2,0,0,3,0,4,1,Gary Harris,ORL,ORL,MIA,,,4,3,1,4
22023,203914,22300344,"DEC 17, 2023",ORL @ BOS,L,26,0,3,0.0,0,3,0.0,0,0,0.0,0,1,1,2,0,0,0,1,0,-26,1,Gary Harris,ORL,BOS,ORL,,,3,1,2,3
22023,203914,22300329,"DEC 15, 2023",ORL @ BOS,L,16,1,3,0.333,0,2,0.0,0,0,0.0,0,0,0,0,1,0,0,3,2,-10,1,Gary Harris,ORL,BOS,ORL,,,2,2,2,0
22023,203914,22300294,"DEC 11, 2023",ORL vs. CLE,W,26,1,3,0.333,1,3,0.333,0,0,0.0,0,1,1,2,0,1,0,2,3,1,1,Gary Harris,ORL,ORL,CLE,,,6,4,5,3
22023,203914,22301217,"DEC 08, 2023",ORL vs. DET,W,23,4,8,0.5,2,5,0.4,1,1,1.0,0,3,3,1,2,0,1,3,11,23,1,Gary Harris,ORL,ORL,DET,,,15,14,12,4
22023,203914,22301205,"DEC 06, 2023",ORL @ CLE,L,31,1,7,0.143,0,4,0.0,6,6,1.0,1,2,3,3,1,0,0,4,8,0,1,Gary Harris,ORL,CLE,ORL,,,14,11,11,6
22023,203914,22300282,"DEC 02, 2023",ORL @ BKN,L,21,2,8,0.25,0,5,0.0,0,0,0.0,0,1,1,2,0,0,0,1,4,-7,1,Gary Harris,ORL,BKN,ORL,,,7,5,6,3
22023,203914,22300274,"DEC 01, 2023",ORL vs. WAS,W,22,3,9,0.333,1,6,0.167,1,2,0.5,0,0,0,0,0,0,1,0,8,-11,1,Gary Harris,ORL,ORL,WAS,,,8,8,8,0
22023,203914,22300259,"NOV 29, 2023",ORL vs. WAS,W,19,2,2,1.0,2,2,1.0,2,3,0.667,0,2,2,4,2,0,1,3,8,20,1,Gary Harris,ORL,ORL,WAS,,,14,10,12,6
22023,203914,22300248,"NOV 26, 2023",ORL vs. CHA,W,24,2,6,0.333,1,5,0.2,0,0,0.0,0,0,0,6,1,0,0,2,5,5,1,Gary Harris,ORL,ORL,CHA,,,11,5,11,6
22023,203914,22300043,"NOV 24, 2023",ORL vs. BOS,W,19,1,3,0.333,1,3,0.333,1,1,1.0,2,1,3,0,0,0,2,1,4,9,1,Gary Harris,ORL,ORL,BOS,,,7,7,4,3
22023,203914,22300226,"NOV 22, 2023",ORL vs. DEN,W,23,1,7,0.143,1,6,0.167,2,2,1.0,0,3,3,3,3,0,0,2,5,1,1,Gary Harris,ORL,ORL,DEN,,,11,8,8,6
22023,203914,22300038,"NOV 21, 2023",ORL vs. TOR,W,23,4,7,0.571,2,5,0.4,0,0,0.0,0,1,1,1,1,0,0,3,10,18,1,Gary Harris,ORL,ORL,TOR,,,12,11,11,2
22023,203914,22300209,"NOV 19, 2023",ORL @ IND,W,22,4,6,0.667,3,3,1.0,2,2,1.0,0,0,0,2,2,0,0,1,13,10,1,Gary Harris,ORL,IND,ORL,,,15,13,15,2
22023,203914,22300033,"NOV 17, 2023",ORL @ CHI,W,29,5,10,0.5,3,7,0.429,2,2,1.0,2,4,6,2,1,2,0,3,15,5,1,Gary Harris,ORL,CHI,ORL,,,23,21,17,8
22023,203914,22300196,"NOV 15, 2023",ORL @ CHI,W,21,2,4,0.5,1,3,0.333,1,2,0.5,0,0,0,0,2,0,0,0,6,2,1,Gary Harris,ORL,CHI,ORL,,,6,6,6,0
22023,203914,22300130,"NOV 02, 2023",ORL @ UTA,W,14,0,2,0.0,0,2,0.0,0,0,0.0,0,0,0,1,0,1,0,1,0,6,1,Gary Harris,ORL,UTA,ORL,,,1,0,1,1
22023,203914,22300114,"OCT 31, 2023",ORL @ LAC,L,18,3,5,0.6,2,4,0.5,1,3,0.333,0,2,2,2,1,0,0,1,9,0,1,Gary Harris,ORL,LAC,ORL,,,13,11,11,4
22023,203914,22300111,"OCT 30, 2023",ORL @ LAL,L,21,6,6,1.0,5,5,1.0,0,0,0.0,1,2,3,3,0,0,3,0,17,4,1,Gary Harris,ORL,LAL,ORL,,,23,20,20,6
22023,203914,22300086,"OCT 27, 2023",ORL @ POR,W,19,1,5,0.2,1,3,0.333,0,0,0.0,0,1,1,1,0,0,1,0,3,2,1,Gary Harris,ORL,POR,ORL,,,5,4,4,2
22023,203914,22300066,"OCT 25, 2023",ORL vs. HOU,W,17,5,8,0.625,1,4,0.25,0,0,0.0,3,2,5,0,0,1,0,0,11,8,1,Gary Harris,ORL,ORL,HOU,,,16,16,11,5
22023,203925,22300558,"JAN 15, 2024",DET @ WAS,W,5,0,0,0.0,0,0,0.0,0,0,0.0,0,0,0,1,0,0,1,0,0,-10,1,Joe Harris,DET,WAS,DET,,,1,0,1,1
22023,203925,22300519,"JAN 10, 2024",DET vs. SAS,L,6,0,0,0.0,0,0,0.0,0,0,0.0,0,1,1,0,0,0,0,1,0,3,1,Joe Harris,DET,DET,SAS,,,1,1,0,1
22023,203925,22300512,"JAN 09, 2024",DET vs. SAC,L,9,3,5,0.6,3,5,0.6,0,0,0.0,0,1,1,0,0,0,0,2,9,2,1,Joe Harris,DET,DET,SAC,,,10,10,9,1
22023,203925,22300394,"DEC 23, 2023",DET @ BKN,L,7,0,0,0.0,0,0,0.0,0,0,0.0,0,1,1,0,0,0,0,0,0,-7,1,Joe Harris,DET,BKN,DET,,,1,1,0,1
22023,203925,22300352,"DEC 18, 2023",DET @ ATL,L,12,0,1,0.0,0,1,0.0,1,2,0.5,1,1,2,2,1,1,0,1,1,1,1,Joe Harris,DET,ATL,DET,,,5,3,3,4
22023,203925,22300334,"DEC 16, 2023",DET @ MIL,L,7,0,1,0.0,0,1,0.0,0,0,0.0,0,0,0,0,0,0,0,1,0,-4,1,Joe Harris,DET,MIL,DET,,,0,0,0,0
22023,203925,22300327,"DEC 15, 2023",DET @ PHI,L,11,1,3,0.333,1,3,0.333,0,0,0.0,0,1,1,1,0,0,0,1,3,-8,1,Joe Harris,DET,PHI,DET,,,5,4,4,2
22023,203925,22301217,"DEC 08, 2023",DET @ ORL,L,4,0,1,0.0,0,0,0.0,0,0,0.0,0,0,0,0,0,1,0,0,0,-7,1,Joe Harris,DET,ORL,DET,,,0,0,0,0
22023,203925,22300140,"NOV 05, 2023",DET vs. PHX,L,13,0,2,0.0,0,2,0.0,0,0,0.0,0,1,1,1,0,0,0,1,0,-5,1,Joe Harris,DET,DET,PHX,,,2,1,1,2
22023,203925,22300129,"NOV 02, 2023",DET @ NOP,L,24,3,8,0.375,2,6,0.333,0,0,0.0,1,2,3,1,1,0,1,4,8,6,1,Joe Harris,DET,NOP,DET,,,12,11,9,4
22023,203925,22300115,"NOV 01, 2023",DET vs. POR,L,17,4,7,0.571,3,6,0.5,0,0,0.0,1,1,2,1,0,0,0,1,11,-10,1,Joe Harris,DET,DET,POR,,,14,13,12,3
22023,203925,22300109,"OCT 30, 2023",DET @ OKC,L,10,0,1,0.0,0,0,0.0,0,0,0.0,0,0,0,1,0,0,1,2,0,-5,1,Joe Harris,DET,OKC,DET,,,1,0,1,1
22023,203925,22300088,"OCT 28, 2023",DET vs. CHI,W,11,1,2,0.5,1,2,0.5,0,0,0.0,0,1,1,1,0,0,1,0,3,1,1,Joe Harris,DET,DET,CHI,,,5,4,4,2
22023,203925,22300077,"OCT 27, 2023",DET @ CHA,W,11,1,3,0.333,0,1,0.0,0,0,0.0,0,0,0,1,1,0,0,2,2,3,1,Joe Harris,DET,CHA,DET,,,3,2,3,1
22023,203925,22300068,"OCT 25, 2023",DET @ MIA,L,12,0,2,0.0,0,2,0.0,0,0,0.0,0,0,0,0,0,0,0,2,0,-5,1,Joe Harris,DET,MIA,DET,,,0,0,0,0
22023,202699,22300555,"JAN 15, 2024",PHI vs. HOU,W,31,3,7,0.429,2,3,0.667,2,2,1.0,0,3,3,2,0,0,1,2,10,-1,1,Tobias Harris,PHI,PHI,HOU,16.5,Points,15,13,12,5
22023,202699,22300555,"JAN 15, 2024",PHI vs. HOU,W,31,3,7,0.429,2,3,0.667,2,2,1.0,0,3,3,2,0,0,1,2,10,-1,1,Tobias Harris,PHI,PHI,HOU,5.5,Rebounds,15,13,12,5
22023,202699,22300555,"JAN 15, 2024",PHI vs. HOU,W,31,3,7,0.429,2,3,0.667,2,2,1.0,0,3,3,2,0,0,1,2,10,-1,1,Tobias Harris,PHI,PHI,HOU,26.5,Pts+Rebs+Asts,15,13,12,5
22023,202699,22300555,"JAN 15, 2024",PHI vs. HOU,W,31,3,7,0.429,2,3,0.667,2,2,1.0,0,3,3,2,0,0,1,2,10,-1,1,Tobias Harris,PHI,PHI,HOU,29.5,Fantasy Score,15,13,12,5
22023,202699,22300555,"JAN 15, 2024",PHI vs. HOU,W,31,3,7,0.429,2,3,0.667,2,2,1.0,0,3,3,2,0,0,1,2,10,-1,1,Tobias Harris,PHI,PHI,HOU,22.5,Pts+Rebs,15,13,12,5
22023,202699,22300555,"JAN 15, 2024",PHI vs. HOU,W,31,3,7,0.429,2,3,0.667,2,2,1.0,0,3,3,2,0,0,1,2,10,-1,1,Tobias Harris,PHI,PHI,HOU,0.5,Dunks,15,13,12,5
22023,202699,22300555,"JAN 15, 2024",PHI vs. HOU,W,31,3,7,0.429,2,3,0.667,2,2,1.0,0,3,3,2,0,0,1,2,10,-1,1,Tobias Harris,PHI,PHI,HOU,20.5,Pts+Asts,15,13,12,5
22023,202699,22300555,"JAN 15, 2024",PHI vs. HOU,W,31,3,7,0.429,2,3,0.667,2,2,1.0,0,3,3,2,0,0,1,2,10,-1,1,Tobias Harris,PHI,PHI,HOU,1.5,3-PT Made,15,13,12,5
22023,202699,22300555,"JAN 15, 2024",PHI vs. HOU,W,31,3,7,0.429,2,3,0.667,2,2,1.0,0,3,3,2,0,0,1,2,10,-1,1,Tobias Harris,PHI,PHI,HOU,0.5,Blocked Shots,15,13,12,5
22023,202699,22300555,"JAN 15, 2024",PHI vs. HOU,W,31,3,7,0.429,2,3,0.667,2,2,1.0,0,3,3,2,0,0,1,2,10,-1,1,Tobias Harris,PHI,PHI,HOU,9.0,Rebs+Asts,15,13,12,5
22023,202699,22300532,"JAN 12, 2024",PHI vs. SAC,W,36,14,25,0.56,3,7,0.429,6,6,1.0,3,4,7,3,3,0,3,0,37,19,1,Tobias Harris,PHI,PHI,SAC,16.5,Points,47,44,40,10
22023,202699,22300532,"JAN 12, 2024",PHI vs. SAC,W,36,14,25,0.56,3,7,0.429,6,6,1.0,3,4,7,3,3,0,3,0,37,19,1,Tobias Harris,PHI,PHI,SAC,5.5,Rebounds,47,44,40,10
22023,202699,22300532,"JAN 12, 2024",PHI vs. SAC,W,36,14,25,0.56,3,7,0.429,6,6,1.0,3,4,7,3,3,0,3,0,37,19,1,Tobias Harris,PHI,PHI,SAC,26.5,Pts+Rebs+Asts,47,44,40,10
22023,202699,22300532,"JAN 12, 2024",PHI vs. SAC,W,36,14,25,0.56,3,7,0.429,6,6,1.0,3,4,7,3,3,0,3,0,37,19,1,Tobias Harris,PHI,PHI,SAC,29.5,Fantasy Score,47,44,40,10
22023,202699,22300532,"JAN 12, 2024",PHI vs. SAC,W,36,14,25,0.56,3,7,0.429,6,6,1.0,3,4,7,3,3,0,3,0,37,19,1,Tobias Harris,PHI,PHI,SAC,22.5,Pts+Rebs,47,44,40,10
22023,202699,22300532,"JAN 12, 2024",PHI vs. SAC,W,36,14,25,0.56,3,7,0.429,6,6,1.0,3,4,7,3,3,0,3,0,37,19,1,Tobias Harris,PHI,PHI,SAC,0.5,Dunks,47,44,40,10
22023,202699,22300532,"JAN 12, 2024",PHI vs. SAC,W,36,14,25,0.56,3,7,0.429,6,6,1.0,3,4,7,3,3,0,3,0,37,19,1,Tobias Harris,PHI,PHI,SAC,20.5,Pts+Asts,47,44,40,10
22023,202699,22300532,"JAN 12, 2024",PHI vs. SAC,W,36,14,25,0.56,3,7,0.429,6,6,1.0,3,4,7,3,3,0,3,0,37,19,1,Tobias Harris,PHI,PHI,SAC,1.5,3-PT Made,47,44,40,10
22023,202699,22300532,"JAN 12, 2024",PHI vs. SAC,W,36,14,25,0.56,3,7,0.429,6,6,1.0,3,4,7,3,3,0,3,0,37,19,1,Tobias Harris,PHI,PHI,SAC,0.5,Blocked Shots,47,44,40,10
22023,202699,22300532,"JAN 12, 2024",PHI vs. SAC,W,36,14,25,0.56,3,7,0.429,6,6,1.0,3,4,7,3,3,0,3,0,37,19,1,Tobias Harris,PHI,PHI,SAC,9.0,Rebs+Asts,47,44,40,10
22023,202699,22300521,"JAN 10, 2024",PHI @ ATL,L,41,12,24,0.5,1,2,0.5,7,7,1.0,2,8,10,4,0,1,1,2,32,1,1,Tobias Harris,PHI,ATL,PHI,16.5,Points,46,42,36,14
22023,202699,22300521,"JAN 10, 2024",PHI @ ATL,L,41,12,24,0.5,1,2,0.5,7,7,1.0,2,8,10,4,0,1,1,2,32,1,1,Tobias Harris,PHI,ATL,PHI,5.5,Rebounds,46,42,36,14
22023,202699,22300521,"JAN 10, 2024",PHI @ ATL,L,41,12,24,0.5,1,2,0.5,7,7,1.0,2,8,10,4,0,1,1,2,32,1,1,Tobias Harris,PHI,ATL,PHI,26.5,Pts+Rebs+Asts,46,42,36,14
22023,202699,22300521,"JAN 10, 2024",PHI @ ATL,L,41,12,24,0.5,1,2,0.5,7,7,1.0,2,8,10,4,0,1,1,2,32,1,1,Tobias Harris,PHI,ATL,PHI,29.5,Fantasy Score,46,42,36,14
22023,202699,22300521,"JAN 10, 2024",PHI @ ATL,L,41,12,24,0.5,1,2,0.5,7,7,1.0,2,8,10,4,0,1,1,2,32,1,1,Tobias Harris,PHI,ATL,PHI,22.5,Pts+Rebs,46,42,36,14
22023,202699,22300521,"JAN 10, 2024",PHI @ ATL,L,41,12,24,0.5,1,2,0.5,7,7,1.0,2,8,10,4,0,1,1,2,32,1,1,Tobias Harris,PHI,ATL,PHI,0.5,Dunks,46,42,36,14
22023,202699,22300521,"JAN 10, 2024",PHI @ ATL,L,41,12,24,0.5,1,2,0.5,7,7,1.0,2,8,10,4,0,1,1,2,32,1,1,Tobias Harris,PHI,ATL,PHI,20.5,Pts+Asts,46,42,36,14
22023,202699,22300521,"JAN 10, 2024",PHI @ ATL,L,41,12,24,0.5,1,2,0.5,7,7,1.0,2,8,10,4,0,1,1,2,32,1,1,Tobias Harris,PHI,ATL,PHI,1.5,3-PT Made,46,42,36,14
22023,202699,22300521,"JAN 10, 2024",PHI @ ATL,L,41,12,24,0.5,1,2,0.5,7,7,1.0,2,8,10,4,0,1,1,2,32,1,1,Tobias Harris,PHI,ATL,PHI,0.5,Blocked Shots,46,42,36,14
22023,202699,22300521,"JAN 10, 2024",PHI @ ATL,L,41,12,24,0.5,1,2,0.5,7,7,1.0,2,8,10,4,0,1,1,2,32,1,1,Tobias Harris,PHI,ATL,PHI,9.0,Rebs+Asts,46,42,36,14
22023,202699,22300483,"JAN 05, 2024",PHI vs. NYK,L,24,2,6,0.333,1,2,0.5,0,1,0.0,0,3,3,4,0,0,0,2,5,-1,1,Tobias Harris,PHI,PHI,NYK,16.5,Points,12,8,9,7
22023,202699,22300483,"JAN 05, 2024",PHI vs. NYK,L,24,2,6,0.333,1,2,0.5,0,1,0.0,0,3,3,4,0,0,0,2,5,-1,1,Tobias Harris,PHI,PHI,NYK,5.5,Rebounds,12,8,9,7
22023,202699,22300483,"JAN 05, 2024",PHI vs. NYK,L,24,2,6,0.333,1,2,0.5,0,1,0.0,0,3,3,4,0,0,0,2,5,-1,1,Tobias Harris,PHI,PHI,NYK,26.5,Pts+Rebs+Asts,12,8,9,7
22023,202699,22300483,"JAN 05, 2024",PHI vs. NYK,L,24,2,6,0.333,1,2,0.5,0,1,0.0,0,3,3,4,0,0,0,2,5,-1,1,Tobias Harris,PHI,PHI,NYK,29.5,Fantasy Score,12,8,9,7
22023,202699,22300483,"JAN 05, 2024",PHI vs. NYK,L,24,2,6,0.333,1,2,0.5,0,1,0.0,0,3,3,4,0,0,0,2,5,-1,1,Tobias Harris,PHI,PHI,NYK,22.5,Pts+Rebs,12,8,9,7
22023,202699,22300483,"JAN 05, 2024",PHI vs. NYK,L,24,2,6,0.333,1,2,0.5,0,1,0.0,0,3,3,4,0,0,0,2,5,-1,1,Tobias Harris,PHI,PHI,NYK,0.5,Dunks,12,8,9,7
22023,202699,22300483,"JAN 05, 2024",PHI vs. NYK,L,24,2,6,0.333,1,2,0.5,0,1,0.0,0,3,3,4,0,0,0,2,5,-1,1,Tobias Harris,PHI,PHI,NYK,20.5,Pts+Asts,12,8,9,7
22023,202699,22300483,"JAN 05, 2024",PHI vs. NYK,L,24,2,6,0.333,1,2,0.5,0,1,0.0,0,3,3,4,0,0,0,2,5,-1,1,Tobias Harris,PHI,PHI,NYK,1.5,3-PT Made,12,8,9,7
22023,202699,22300483,"JAN 05, 2024",PHI vs. NYK,L,24,2,6,0.333,1,2,0.5,0,1,0.0,0,3,3,4,0,0,0,2,5,-1,1,Tobias Harris,PHI,PHI,NYK,0.5,Blocked Shots,12,8,9,7
22023,202699,22300483,"JAN 05, 2024",PHI vs. NYK,L,24,2,6,0.333,1,2,0.5,0,1,0.0,0,3,3,4,0,0,0,2,5,-1,1,Tobias Harris,PHI,PHI,NYK,9.0,Rebs+Asts,12,8,9,7
22023,202699,22300459,"JAN 02, 2024",PHI vs. CHI,W,30,9,13,0.692,1,4,0.25,1,3,0.333,1,7,8,2,0,2,1,0,20,32,1,Tobias Harris,PHI,PHI,CHI,16.5,Points,30,28,22,10
22023,202699,22300459,"JAN 02, 2024",PHI vs. CHI,W,30,9,13,0.692,1,4,0.25,1,3,0.333,1,7,8,2,0,2,1,0,20,32,1,Tobias Harris,PHI,PHI,CHI,5.5,Rebounds,30,28,22,10
22023,202699,22300459,"JAN 02, 2024",PHI vs. CHI,W,30,9,13,0.692,1,4,0.25,1,3,0.333,1,7,8,2,0,2,1,0,20,32,1,Tobias Harris,PHI,PHI,CHI,26.5,Pts+Rebs+Asts,30,28,22,10
22023,202699,22300459,"JAN 02, 2024",PHI vs. CHI,W,30,9,13,0.692,1,4,0.25,1,3,0.333,1,7,8,2,0,2,1,0,20,32,1,Tobias Harris,PHI,PHI,CHI,29.5,Fantasy Score,30,28,22,10
22023,202699,22300459,"JAN 02, 2024",PHI vs. CHI,W,30,9,13,0.692,1,4,0.25,1,3,0.333,1,7,8,2,0,2,1,0,20,32,1,Tobias Harris,PHI,PHI,CHI,22.5,Pts+Rebs,30,28,22,10
22023,202699,22300459,"JAN 02, 2024",PHI vs. CHI,W,30,9,13,0.692,1,4,0.25,1,3,0.333,1,7,8,2,0,2,1,0,20,32,1,Tobias Harris,PHI,PHI,CHI,0.5,Dunks,30,28,22,10
22023,202699,22300459,"JAN 02, 2024",PHI vs. CHI,W,30,9,13,0.692,1,4,0.25,1,3,0.333,1,7,8,2,0,2,1,0,20,32,1,Tobias Harris,PHI,PHI,CHI,20.5,Pts+Asts,30,28,22,10
22023,202699,22300459,"JAN 02, 2024",PHI vs. CHI,W,30,9,13,0.692,1,4,0.25,1,3,0.333,1,7,8,2,0,2,1,0,20,32,1,Tobias Harris,PHI,PHI,CHI,1.5,3-PT Made,30,28,22,10
22023,202699,22300459,"JAN 02, 2024",PHI vs. CHI,W,30,9,13,0.692,1,4,0.25,1,3,0.333,1,7,8,2,0,2,1,0,20,32,1,Tobias Harris,PHI,PHI,CHI,0.5,Blocked Shots,30,28,22,10
22023,202699,22300459,"JAN 02, 2024",PHI vs. CHI,W,30,9,13,0.692,1,4,0.25,1,3,0.333,1,7,8,2,0,2,1,0,20,32,1,Tobias Harris,PHI,PHI,CHI,9.0,Rebs+Asts,30,28,22,10
22023,202699,22300442,"DEC 30, 2023",PHI @ CHI,L,34,6,16,0.375,0,3,0.0,3,4,0.75,3,4,7,4,0,1,0,1,15,-20,1,Tobias Harris,PHI,CHI,PHI,16.5,Points,26,22,19,11
22023,202699,22300442,"DEC 30, 2023",PHI @ CHI,L,34,6,16,0.375,0,3,0.0,3,4,0.75,3,4,7,4,0,1,0,1,15,-20,1,Tobias Harris,PHI,CHI,PHI,5.5,Rebounds,26,22,19,11
22023,202699,22300442,"DEC 30, 2023",PHI @ CHI,L,34,6,16,0.375,0,3,0.0,3,4,0.75,3,4,7,4,0,1,0,1,15,-20,1,Tobias Harris,PHI,CHI,PHI,26.5,Pts+Rebs+Asts,26,22,19,11
22023,202699,22300442,"DEC 30, 2023",PHI @ CHI,L,34,6,16,0.375,0,3,0.0,3,4,0.75,3,4,7,4,0,1,0,1,15,-20,1,Tobias Harris,PHI,CHI,PHI,29.5,Fantasy Score,26,22,19,11
22023,202699,22300442,"DEC 30, 2023",PHI @ CHI,L,34,6,16,0.375,0,3,0.0,3,4,0.75,3,4,7,4,0,1,0,1,15,-20,1,Tobias Harris,PHI,CHI,PHI,22.5,Pts+Rebs,26,22,19,11
22023,202699,22300442,"DEC 30, 2023",PHI @ CHI,L,34,6,16,0.375,0,3,0.0,3,4,0.75,3,4,7,4,0,1,0,1,15,-20,1,Tobias Harris,PHI,CHI,PHI,0.5,Dunks,26,22,19,11
22023,202699,22300442,"DEC 30, 2023",PHI @ CHI,L,34,6,16,0.375,0,3,0.0,3,4,0.75,3,4,7,4,0,1,0,1,15,-20,1,Tobias Harris,PHI,CHI,PHI,20.5,Pts+Asts,26,22,19,11
22023,202699,22300442,"DEC 30, 2023",PHI @ CHI,L,34,6,16,0.375,0,3,0.0,3,4,0.75,3,4,7,4,0,1,0,1,15,-20,1,Tobias Harris,PHI,CHI,PHI,1.5,3-PT Made,26,22,19,11
22023,202699,22300442,"DEC 30, 2023",PHI @ CHI,L,34,6,16,0.375,0,3,0.0,3,4,0.75,3,4,7,4,0,1,0,1,15,-20,1,Tobias Harris,PHI,CHI,PHI,0.5,Blocked Shots,26,22,19,11
22023,202699,22300442,"DEC 30, 2023",PHI @ CHI,L,34,6,16,0.375,0,3,0.0,3,4,0.75,3,4,7,4,0,1,0,1,15,-20,1,Tobias Harris,PHI,CHI,PHI,9.0,Rebs+Asts,26,22,19,11
22023,202699,22300434,"DEC 29, 2023",PHI @ HOU,W,35,10,18,0.556,2,6,0.333,0,0,0.0,1,3,4,7,4,3,3,3,22,5,1,Tobias Harris,PHI,HOU,PHI,16.5,Points,33,26,29,11
22023,202699,22300434,"DEC 29, 2023",PHI @ HOU,W,35,10,18,0.556,2,6,0.333,0,0,0.0,1,3,4,7,4,3,3,3,22,5,1,Tobias Harris,PHI,HOU,PHI,5.5,Rebounds,33,26,29,11
22023,202699,22300434,"DEC 29, 2023",PHI @ HOU,W,35,10,18,0.556,2,6,0.333,0,0,0.0,1,3,4,7,4,3,3,3,22,5,1,Tobias Harris,PHI,HOU,PHI,26.5,Pts+Rebs+Asts,33,26,29,11
22023,202699,22300434,"DEC 29, 2023",PHI @ HOU,W,35,10,18,0.556,2,6,0.333,0,0,0.0,1,3,4,7,4,3,3,3,22,5,1,Tobias Harris,PHI,HOU,PHI,29.5,Fantasy Score,33,26,29,11
22023,202699,22300434,"DEC 29, 2023",PHI @ HOU,W,35,10,18,0.556,2,6,0.333,0,0,0.0,1,3,4,7,4,3,3,3,22,5,1,Tobias Harris,PHI,HOU,PHI,22.5,Pts+Rebs,33,26,29,11
22023,202699,22300434,"DEC 29, 2023",PHI @ HOU,W,35,10,18,0.556,2,6,0.333,0,0,0.0,1,3,4,7,4,3,3,3,22,5,1,Tobias Harris,PHI,HOU,PHI,0.5,Dunks,33,26,29,11
22023,202699,22300434,"DEC 29, 2023",PHI @ HOU,W,35,10,18,0.556,2,6,0.333,0,0,0.0,1,3,4,7,4,3,3,3,22,5,1,Tobias Harris,PHI,HOU,PHI,20.5,Pts+Asts,33,26,29,11
22023,202699,22300434,"DEC 29, 2023",PHI @ HOU,W,35,10,18,0.556,2,6,0.333,0,0,0.0,1,3,4,7,4,3,3,3,22,5,1,Tobias Harris,PHI,HOU,PHI,1.5,3-PT Made,33,26,29,11
22023,202699,22300434,"DEC 29, 2023",PHI @ HOU,W,35,10,18,0.556,2,6,0.333,0,0,0.0,1,3,4,7,4,3,3,3,22,5,1,Tobias Harris,PHI,HOU,PHI,0.5,Blocked Shots,33,26,29,11
22023,202699,22300434,"DEC 29, 2023",PHI @ HOU,W,35,10,18,0.556,2,6,0.333,0,0,0.0,1,3,4,7,4,3,3,3,22,5,1,Tobias Harris,PHI,HOU,PHI,9.0,Rebs+Asts,33,26,29,11
22023,202699,22300415,"DEC 27, 2023",PHI @ ORL,W,33,10,23,0.435,1,5,0.2,1,1,1.0,1,6,7,2,1,0,0,0,22,20,1,Tobias Harris,PHI,ORL,PHI,16.5,Points,31,29,24,9
22023,202699,22300415,"DEC 27, 2023",PHI @ ORL,W,33,10,23,0.435,1,5,0.2,1,1,1.0,1,6,7,2,1,0,0,0,22,20,1,Tobias Harris,PHI,ORL,PHI,5.5,Rebounds,31,29,24,9
22023,202699,22300415,"DEC 27, 2023",PHI @ ORL,W,33,10,23,0.435,1,5,0.2,1,1,1.0,1,6,7,2,1,0,0,0,22,20,1,Tobias Harris,PHI,ORL,PHI,26.5,Pts+Rebs+Asts,31,29,24,9
22023,202699,22300415,"DEC 27, 2023",PHI @ ORL,W,33,10,23,0.435,1,5,0.2,1,1,1.0,1,6,7,2,1,0,0,0,22,20,1,Tobias Harris,PHI,ORL,PHI,29.5,Fantasy Score,31,29,24,9
22023,202699,22300415,"DEC 27, 2023",PHI @ ORL,W,33,10,23,0.435,1,5,0.2,1,1,1.0,1,6,7,2,1,0,0,0,22,20,1,Tobias Harris,PHI,ORL,PHI,22.5,Pts+Rebs,31,29,24,9
22023,202699,22300415,"DEC 27, 2023",PHI @ ORL,W,33,10,23,0.435,1,5,0.2,1,1,1.0,1,6,7,2,1,0,0,0,22,20,1,Tobias Harris,PHI,ORL,PHI,0.5,Dunks,31,29,24,9
22023,202699,22300415,"DEC 27, 2023",PHI @ ORL,W,33,10,23,0.435,1,5,0.2,1,1,1.0,1,6,7,2,1,0,0,0,22,20,1,Tobias Harris,PHI,ORL,PHI,20.5,Pts+Asts,31,29,24,9
22023,202699,22300415,"DEC 27, 2023",PHI @ ORL,W,33,10,23,0.435,1,5,0.2,1,1,1.0,1,6,7,2,1,0,0,0,22,20,1,Tobias Harris,PHI,ORL,PHI,1.5,3-PT Made,31,29,24,9
22023,202699,22300415,"DEC 27, 2023",PHI @ ORL,W,33,10,23,0.435,1,5,0.2,1,1,1.0,1,6,7,2,1,0,0,0,22,20,1,Tobias Harris,PHI,ORL,PHI,0.5,Blocked Shots,31,29,24,9
22023,202699,22300415,"DEC 27, 2023",PHI @ ORL,W,33,10,23,0.435,1,5,0.2,1,1,1.0,1,6,7,2,1,0,0,0,22,20,1,Tobias Harris,PHI,ORL,PHI,9.0,Rebs+Asts,31,29,24,9
22023,202699,22300404,"DEC 25, 2023",PHI @ MIA,L,42,10,18,0.556,4,7,0.571,3,3,1.0,1,6,7,6,1,0,2,3,27,2,1,Tobias Harris,PHI,MIA,PHI,16.5,Points,40,34,33,13
22023,202699,22300404,"DEC 25, 2023",PHI @ MIA,L,42,10,18,0.556,4,7,0.571,3,3,1.0,1,6,7,6,1,0,2,3,27,2,1,Tobias Harris,PHI,MIA,PHI,5.5,Rebounds,40,34,33,13
22023,202699,22300404,"DEC 25, 2023",PHI @ MIA,L,42,10,18,0.556,4,7,0.571,3,3,1.0,1,6,7,6,1,0,2,3,27,2,1,Tobias Harris,PHI,MIA,PHI,26.5,Pts+Rebs+Asts,40,34,33,13
22023,202699,22300404,"DEC 25, 2023",PHI @ MIA,L,42,10,18,0.556,4,7,0.571,3,3,1.0,1,6,7,6,1,0,2,3,27,2,1,Tobias Harris,PHI,MIA,PHI,29.5,Fantasy Score,40,34,33,13
22023,202699,22300404,"DEC 25, 2023",PHI @ MIA,L,42,10,18,0.556,4,7,0.571,3,3,1.0,1,6,7,6,1,0,2,3,27,2,1,Tobias Harris,PHI,MIA,PHI,22.5,Pts+Rebs,40,34,33,13
22023,202699,22300404,"DEC 25, 2023",PHI @ MIA,L,42,10,18,0.556,4,7,0.571,3,3,1.0,1,6,7,6,1,0,2,3,27,2,1,Tobias Harris,PHI,MIA,PHI,0.5,Dunks,40,34,33,13
22023,202699,22300404,"DEC 25, 2023",PHI @ MIA,L,42,10,18,0.556,4,7,0.571,3,3,1.0,1,6,7,6,1,0,2,3,27,2,1,Tobias Harris,PHI,MIA,PHI,20.5,Pts+Asts,40,34,33,13
22023,202699,22300404,"DEC 25, 2023",PHI @ MIA,L,42,10,18,0.556,4,7,0.571,3,3,1.0,1,6,7,6,1,0,2,3,27,2,1,Tobias Harris,PHI,MIA,PHI,1.5,3-PT Made,40,34,33,13
22023,202699,22300404,"DEC 25, 2023",PHI @ MIA,L,42,10,18,0.556,4,7,0.571,3,3,1.0,1,6,7,6,1,0,2,3,27,2,1,Tobias Harris,PHI,MIA,PHI,0.5,Blocked Shots,40,34,33,13
22023,202699,22300404,"DEC 25, 2023",PHI @ MIA,L,42,10,18,0.556,4,7,0.571,3,3,1.0,1,6,7,6,1,0,2,3,27,2,1,Tobias Harris,PHI,MIA,PHI,9.0,Rebs+Asts,40,34,33,13
22023,202699,22300382,"DEC 22, 2023",PHI vs. TOR,W,38,12,23,0.522,5,9,0.556,4,4,1.0,0,8,8,7,1,0,2,2,33,8,1,Tobias Harris,PHI,PHI,TOR,16.5,Points,48,41,40,15
22023,202699,22300382,"DEC 22, 2023",PHI vs. TOR,W,38,12,23,0.522,5,9,0.556,4,4,1.0,0,8,8,7,1,0,2,2,33,8,1,Tobias Harris,PHI,PHI,TOR,5.5,Rebounds,48,41,40,15
22023,202699,22300382,"DEC 22, 2023",PHI vs. TOR,W,38,12,23,0.522,5,9,0.556,4,4,1.0,0,8,8,7,1,0,2,2,33,8,1,Tobias Harris,PHI,PHI,TOR,26.5,Pts+Rebs+Asts,48,41,40,15
22023,202699,22300382,"DEC 22, 2023",PHI vs. TOR,W,38,12,23,0.522,5,9,0.556,4,4,1.0,0,8,8,7,1,0,2,2,33,8,1,Tobias Harris,PHI,PHI,TOR,29.5,Fantasy Score,48,41,40,15
22023,202699,22300382,"DEC 22, 2023",PHI vs. TOR,W,38,12,23,0.522,5,9,0.556,4,4,1.0,0,8,8,7,1,0,2,2,33,8,1,Tobias Harris,PHI,PHI,TOR,22.5,Pts+Rebs,48,41,40,15
22023,202699,22300382,"DEC 22, 2023",PHI vs. TOR,W,38,12,23,0.522,5,9,0.556,4,4,1.0,0,8,8,7,1,0,2,2,33,8,1,Tobias Harris,PHI,PHI,TOR,0.5,Dunks,48,41,40,15
22023,202699,22300382,"DEC 22, 2023",PHI vs. TOR,W,38,12,23,0.522,5,9,0.556,4,4,1.0,0,8,8,7,1,0,2,2,33,8,1,Tobias Harris,PHI,PHI,TOR,20.5,Pts+Asts,48,41,40,15
22023,202699,22300382,"DEC 22, 2023",PHI vs. TOR,W,38,12,23,0.522,5,9,0.556,4,4,1.0,0,8,8,7,1,0,2,2,33,8,1,Tobias Harris,PHI,PHI,TOR,1.5,3-PT Made,48,41,40,15
22023,202699,22300382,"DEC 22, 2023",PHI vs. TOR,W,38,12,23,0.522,5,9,0.556,4,4,1.0,0,8,8,7,1,0,2,2,33,8,1,Tobias Harris,PHI,PHI,TOR,0.5,Blocked Shots,48,41,40,15
22023,202699,22300382,"DEC 22, 2023",PHI vs. TOR,W,38,12,23,0.522,5,9,0.556,4,4,1.0,0,8,8,7,1,0,2,2,33,8,1,Tobias Harris,PHI,PHI,TOR,9.0,Rebs+Asts,48,41,40,15
22023,202699,22300367,"DEC 20, 2023",PHI vs. MIN,W,37,4,10,0.4,0,1,0.0,1,1,1.0,1,4,5,3,1,0,1,5,9,-2,1,Tobias Harris,PHI,PHI,MIN,16.5,Points,17,14,12,8
22023,202699,22300367,"DEC 20, 2023",PHI vs. MIN,W,37,4,10,0.4,0,1,0.0,1,1,1.0,1,4,5,3,1,0,1,5,9,-2,1,Tobias Harris,PHI,PHI,MIN,5.5,Rebounds,17,14,12,8
22023,202699,22300367,"DEC 20, 2023",PHI vs. MIN,W,37,4,10,0.4,0,1,0.0,1,1,1.0,1,4,5,3,1,0,1,5,9,-2,1,Tobias Harris,PHI,PHI,MIN,26.5,Pts+Rebs+Asts,17,14,12,8
22023,202699,22300367,"DEC 20, 2023",PHI vs. MIN,W,37,4,10,0.4,0,1,0.0,1,1,1.0,1,4,5,3,1,0,1,5,9,-2,1,Tobias Harris,PHI,PHI,MIN,29.5,Fantasy Score,17,14,12,8
22023,202699,22300367,"DEC 20, 2023",PHI vs. MIN,W,37,4,10,0.4,0,1,0.0,1,1,1.0,1,4,5,3,1,0,1,5,9,-2,1,Tobias Harris,PHI,PHI,MIN,22.5,Pts+Rebs,17,14,12,8
22023,202699,22300367,"DEC 20, 2023",PHI vs. MIN,W,37,4,10,0.4,0,1,0.0,1,1,1.0,1,4,5,3,1,0,1,5,9,-2,1,Tobias Harris,PHI,PHI,MIN,0.5,Dunks,17,14,12,8
22023,202699,22300367,"DEC 20, 2023",PHI vs. MIN,W,37,4,10,0.4,0,1,0.0,1,1,1.0,1,4,5,3,1,0,1,5,9,-2,1,Tobias Harris,PHI,PHI,MIN,20.5,Pts+Asts,17,14,12,8
22023,202699,22300367,"DEC 20, 2023",PHI vs. MIN,W,37,4,10,0.4,0,1,0.0,1,1,1.0,1,4,5,3,1,0,1,5,9,-2,1,Tobias Harris,PHI,PHI,MIN,1.5,3-PT Made,17,14,12,8
22023,202699,22300367,"DEC 20, 2023",PHI vs. MIN,W,37,4,10,0.4,0,1,0.0,1,1,1.0,1,4,5,3,1,0,1,5,9,-2,1,Tobias Harris,PHI,PHI,MIN,0.5,Blocked Shots,17,14,12,8
22023,202699,22300367,"DEC 20, 2023",PHI vs. MIN,W,37,4,10,0.4,0,1,0.0,1,1,1.0,1,4,5,3,1,0,1,5,9,-2,1,Tobias Harris,PHI,PHI,MIN,9.0,Rebs+Asts,17,14,12,8
22023,202699,22300351,"DEC 18, 2023",PHI vs. CHI,L,32,1,3,0.333,1,1,1.0,0,0,0.0,0,5,5,2,0,3,2,1,3,6,1,Tobias Harris,PHI,PHI,CHI,16.5,Points,10,8,5,7
22023,202699,22300351,"DEC 18, 2023",PHI vs. CHI,L,32,1,3,0.333,1,1,1.0,0,0,0.0,0,5,5,2,0,3,2,1,3,6,1,Tobias Harris,PHI,PHI,CHI,5.5,Rebounds,10,8,5,7
22023,202699,22300351,"DEC 18, 2023",PHI vs. CHI,L,32,1,3,0.333,1,1,1.0,0,0,0.0,0,5,5,2,0,3,2,1,3,6,1,Tobias Harris,PHI,PHI,CHI,26.5,Pts+Rebs+Asts,10,8,5,7
22023,202699,22300351,"DEC 18, 2023",PHI vs. CHI,L,32,1,3,0.333,1,1,1.0,0,0,0.0,0,5,5,2,0,3,2,1,3,6,1,Tobias Harris,PHI,PHI,CHI,29.5,Fantasy Score,10,8,5,7
22023,202699,22300351,"DEC 18, 2023",PHI vs. CHI,L,32,1,3,0.333,1,1,1.0,0,0,0.0,0,5,5,2,0,3,2,1,3,6,1,Tobias Harris,PHI,PHI,CHI,22.5,Pts+Rebs,10,8,5,7
22023,202699,22300351,"DEC 18, 2023",PHI vs. CHI,L,32,1,3,0.333,1,1,1.0,0,0,0.0,0,5,5,2,0,3,2,1,3,6,1,Tobias Harris,PHI,PHI,CHI,0.5,Dunks,10,8,5,7
22023,202699,22300351,"DEC 18, 2023",PHI vs. CHI,L,32,1,3,0.333,1,1,1.0,0,0,0.0,0,5,5,2,0,3,2,1,3,6,1,Tobias Harris,PHI,PHI,CHI,20.5,Pts+Asts,10,8,5,7
22023,202699,22300351,"DEC 18, 2023",PHI vs. CHI,L,32,1,3,0.333,1,1,1.0,0,0,0.0,0,5,5,2,0,3,2,1,3,6,1,Tobias Harris,PHI,PHI,CHI,1.5,3-PT Made,10,8,5,7
22023,202699,22300351,"DEC 18, 2023",PHI vs. CHI,L,32,1,3,0.333,1,1,1.0,0,0,0.0,0,5,5,2,0,3,2,1,3,6,1,Tobias Harris,PHI,PHI,CHI,0.5,Blocked Shots,10,8,5,7
22023,202699,22300351,"DEC 18, 2023",PHI vs. CHI,L,32,1,3,0.333,1,1,1.0,0,0,0.0,0,5,5,2,0,3,2,1,3,6,1,Tobias Harris,PHI,PHI,CHI,9.0,Rebs+Asts,10,8,5,7
22023,202699,22300335,"DEC 16, 2023",PHI @ CHA,W,25,6,10,0.6,1,3,0.333,2,2,1.0,1,4,5,4,0,1,1,0,15,36,1,Tobias Harris,PHI,CHA,PHI,16.5,Points,24,20,19,9
22023,202699,22300335,"DEC 16, 2023",PHI @ CHA,W,25,6,10,0.6,1,3,0.333,2,2,1.0,1,4,5,4,0,1,1,0,15,36,1,Tobias Harris,PHI,CHA,PHI,5.5,Rebounds,24,20,19,9
22023,202699,22300335,"DEC 16, 2023",PHI @ CHA,W,25,6,10,0.6,1,3,0.333,2,2,1.0,1,4,5,4,0,1,1,0,15,36,1,Tobias Harris,PHI,CHA,PHI,26.5,Pts+Rebs+Asts,24,20,19,9
22023,202699,22300335,"DEC 16, 2023",PHI @ CHA,W,25,6,10,0.6,1,3,0.333,2,2,1.0,1,4,5,4,0,1,1,0,15,36,1,Tobias Harris,PHI,CHA,PHI,29.5,Fantasy Score,24,20,19,9
22023,202699,22300335,"DEC 16, 2023",PHI @ CHA,W,25,6,10,0.6,1,3,0.333,2,2,1.0,1,4,5,4,0,1,1,0,15,36,1,Tobias Harris,PHI,CHA,PHI,22.5,Pts+Rebs,24,20,19,9
22023,202699,22300335,"DEC 16, 2023",PHI @ CHA,W,25,6,10,0.6,1,3,0.333,2,2,1.0,1,4,5,4,0,1,1,0,15,36,1,Tobias Harris,PHI,CHA,PHI,0.5,Dunks,24,20,19,9
22023,202699,22300335,"DEC 16, 2023",PHI @ CHA,W,25,6,10,0.6,1,3,0.333,2,2,1.0,1,4,5,4,0,1,1,0,15,36,1,Tobias Harris,PHI,CHA,PHI,20.5,Pts+Asts,24,20,19,9
22023,202699,22300335,"DEC 16, 2023",PHI @ CHA,W,25,6,10,0.6,1,3,0.333,2,2,1.0,1,4,5,4,0,1,1,0,15,36,1,Tobias Harris,PHI,CHA,PHI,1.5,3-PT Made,24,20,19,9
22023,202699,22300335,"DEC 16, 2023",PHI @ CHA,W,25,6,10,0.6,1,3,0.333,2,2,1.0,1,4,5,4,0,1,1,0,15,36,1,Tobias Harris,PHI,CHA,PHI,0.5,Blocked Shots,24,20,19,9
22023,202699,22300335,"DEC 16, 2023",PHI @ CHA,W,25,6,10,0.6,1,3,0.333,2,2,1.0,1,4,5,4,0,1,1,0,15,36,1,Tobias Harris,PHI,CHA,PHI,9.0,Rebs+Asts,24,20,19,9
22023,202699,22300327,"DEC 15, 2023",PHI vs. DET,W,24,4,8,0.5,1,3,0.333,4,4,1.0,2,5,7,2,3,1,2,3,13,24,1,Tobias Harris,PHI,PHI,DET,16.5,Points,22,20,15,9
22023,202699,22300327,"DEC 15, 2023",PHI vs. DET,W,24,4,8,0.5,1,3,0.333,4,4,1.0,2,5,7,2,3,1,2,3,13,24,1,Tobias Harris,PHI,PHI,DET,5.5,Rebounds,22,20,15,9
22023,202699,22300327,"DEC 15, 2023",PHI vs. DET,W,24,4,8,0.5,1,3,0.333,4,4,1.0,2,5,7,2,3,1,2,3,13,24,1,Tobias Harris,PHI,PHI,DET,26.5,Pts+Rebs+Asts,22,20,15,9
22023,202699,22300327,"DEC 15, 2023",PHI vs. DET,W,24,4,8,0.5,1,3,0.333,4,4,1.0,2,5,7,2,3,1,2,3,13,24,1,Tobias Harris,PHI,PHI,DET,29.5,Fantasy Score,22,20,15,9
22023,202699,22300327,"DEC 15, 2023",PHI vs. DET,W,24,4,8,0.5,1,3,0.333,4,4,1.0,2,5,7,2,3,1,2,3,13,24,1,Tobias Harris,PHI,PHI,DET,22.5,Pts+Rebs,22,20,15,9
22023,202699,22300327,"DEC 15, 2023",PHI vs. DET,W,24,4,8,0.5,1,3,0.333,4,4,1.0,2,5,7,2,3,1,2,3,13,24,1,Tobias Harris,PHI,PHI,DET,0.5,Dunks,22,20,15,9
22023,202699,22300327,"DEC 15, 2023",PHI vs. DET,W,24,4,8,0.5,1,3,0.333,4,4,1.0,2,5,7,2,3,1,2,3,13,24,1,Tobias Harris,PHI,PHI,DET,20.5,Pts+Asts,22,20,15,9
22023,202699,22300327,"DEC 15, 2023",PHI vs. DET,W,24,4,8,0.5,1,3,0.333,4,4,1.0,2,5,7,2,3,1,2,3,13,24,1,Tobias Harris,PHI,PHI,DET,1.5,3-PT Made,22,20,15,9
22023,202699,22300327,"DEC 15, 2023",PHI vs. DET,W,24,4,8,0.5,1,3,0.333,4,4,1.0,2,5,7,2,3,1,2,3,13,24,1,Tobias Harris,PHI,PHI,DET,0.5,Blocked Shots,22,20,15,9
22023,202699,22300327,"DEC 15, 2023",PHI vs. DET,W,24,4,8,0.5,1,3,0.333,4,4,1.0,2,5,7,2,3,1,2,3,13,24,1,Tobias Harris,PHI,PHI,DET,9.0,Rebs+Asts,22,20,15,9
22023,202699,22300310,"DEC 13, 2023",PHI @ DET,W,26,7,10,0.7,3,5,0.6,4,4,1.0,1,6,7,1,0,1,1,0,21,20,1,Tobias Harris,PHI,DET,PHI,16.5,Points,29,28,22,8
22023,202699,22300310,"DEC 13, 2023",PHI @ DET,W,26,7,10,0.7,3,5,0.6,4,4,1.0,1,6,7,1,0,1,1,0,21,20,1,Tobias Harris,PHI,DET,PHI,5.5,Rebounds,29,28,22,8
22023,202699,22300310,"DEC 13, 2023",PHI @ DET,W,26,7,10,0.7,3,5,0.6,4,4,1.0,1,6,7,1,0,1,1,0,21,20,1,Tobias Harris,PHI,DET,PHI,26.5,Pts+Rebs+Asts,29,28,22,8
22023,202699,22300310,"DEC 13, 2023",PHI @ DET,W,26,7,10,0.7,3,5,0.6,4,4,1.0,1,6,7,1,0,1,1,0,21,20,1,Tobias Harris,PHI,DET,PHI,29.5,Fantasy Score,29,28,22,8
22023,202699,22300310,"DEC 13, 2023",PHI @ DET,W,26,7,10,0.7,3,5,0.6,4,4,1.0,1,6,7,1,0,1,1,0,21,20,1,Tobias Harris,PHI,DET,PHI,22.5,Pts+Rebs,29,28,22,8
22023,202699,22300310,"DEC 13, 2023",PHI @ DET,W,26,7,10,0.7,3,5,0.6,4,4,1.0,1,6,7,1,0,1,1,0,21,20,1,Tobias Harris,PHI,DET,PHI,0.5,Dunks,29,28,22,8
22023,202699,22300310,"DEC 13, 2023",PHI @ DET,W,26,7,10,0.7,3,5,0.6,4,4,1.0,1,6,7,1,0,1,1,0,21,20,1,Tobias Harris,PHI,DET,PHI,20.5,Pts+Asts,29,28,22,8
22023,202699,22300310,"DEC 13, 2023",PHI @ DET,W,26,7,10,0.7,3,5,0.6,4,4,1.0,1,6,7,1,0,1,1,0,21,20,1,Tobias Harris,PHI,DET,PHI,1.5,3-PT Made,29,28,22,8
22023,202699,22300310,"DEC 13, 2023",PHI @ DET,W,26,7,10,0.7,3,5,0.6,4,4,1.0,1,6,7,1,0,1,1,0,21,20,1,Tobias Harris,PHI,DET,PHI,0.5,Blocked Shots,29,28,22,8
22023,202699,22300310,"DEC 13, 2023",PHI @ DET,W,26,7,10,0.7,3,5,0.6,4,4,1.0,1,6,7,1,0,1,1,0,21,20,1,Tobias Harris,PHI,DET,PHI,9.0,Rebs+Asts,29,28,22,8
22023,202699,22300295,"DEC 11, 2023",PHI vs. WAS,W,30,2,5,0.4,1,2,0.5,5,6,0.833,0,4,4,6,0,0,0,1,10,21,1,Tobias Harris,PHI,PHI,WAS,16.5,Points,20,14,16,10
22023,202699,22300295,"DEC 11, 2023",PHI vs. WAS,W,30,2,5,0.4,1,2,0.5,5,6,0.833,0,4,4,6,0,0,0,1,10,21,1,Tobias Harris,PHI,PHI,WAS,5.5,Rebounds,20,14,16,10
22023,202699,22300295,"DEC 11, 2023",PHI vs. WAS,W,30,2,5,0.4,1,2,0.5,5,6,0.833,0,4,4,6,0,0,0,1,10,21,1,Tobias Harris,PHI,PHI,WAS,26.5,Pts+Rebs+Asts,20,14,16,10
22023,202699,22300295,"DEC 11, 2023",PHI vs. WAS,W,30,2,5,0.4,1,2,0.5,5,6,0.833,0,4,4,6,0,0,0,1,10,21,1,Tobias Harris,PHI,PHI,WAS,29.5,Fantasy Score,20,14,16,10
22023,202699,22300295,"DEC 11, 2023",PHI vs. WAS,W,30,2,5,0.4,1,2,0.5,5,6,0.833,0,4,4,6,0,0,0,1,10,21,1,Tobias Harris,PHI,PHI,WAS,22.5,Pts+Rebs,20,14,16,10
22023,202699,22300295,"DEC 11, 2023",PHI vs. WAS,W,30,2,5,0.4,1,2,0.5,5,6,0.833,0,4,4,6,0,0,0,1,10,21,1,Tobias Harris,PHI,PHI,WAS,0.5,Dunks,20,14,16,10
22023,202699,22300295,"DEC 11, 2023",PHI vs. WAS,W,30,2,5,0.4,1,2,0.5,5,6,0.833,0,4,4,6,0,0,0,1,10,21,1,Tobias Harris,PHI,PHI,WAS,20.5,Pts+Asts,20,14,16,10
22023,202699,22300295,"DEC 11, 2023",PHI vs. WAS,W,30,2,5,0.4,1,2,0.5,5,6,0.833,0,4,4,6,0,0,0,1,10,21,1,Tobias Harris,PHI,PHI,WAS,1.5,3-PT Made,20,14,16,10
22023,202699,22300295,"DEC 11, 2023",PHI vs. WAS,W,30,2,5,0.4,1,2,0.5,5,6,0.833,0,4,4,6,0,0,0,1,10,21,1,Tobias Harris,PHI,PHI,WAS,0.5,Blocked Shots,20,14,16,10
22023,202699,22300295,"DEC 11, 2023",PHI vs. WAS,W,30,2,5,0.4,1,2,0.5,5,6,0.833,0,4,4,6,0,0,0,1,10,21,1,Tobias Harris,PHI,PHI,WAS,9.0,Rebs+Asts,20,14,16,10
22023,202699,22301218,"DEC 08, 2023",PHI vs. ATL,W,34,5,9,0.556,0,1,0.0,3,3,1.0,2,6,8,2,1,0,2,3,13,8,1,Tobias Harris,PHI,PHI,ATL,16.5,Points,23,21,15,10
22023,202699,22301218,"DEC 08, 2023",PHI vs. ATL,W,34,5,9,0.556,0,1,0.0,3,3,1.0,2,6,8,2,1,0,2,3,13,8,1,Tobias Harris,PHI,PHI,ATL,5.5,Rebounds,23,21,15,10
22023,202699,22301218,"DEC 08, 2023",PHI vs. ATL,W,34,5,9,0.556,0,1,0.0,3,3,1.0,2,6,8,2,1,0,2,3,13,8,1,Tobias Harris,PHI,PHI,ATL,26.5,Pts+Rebs+Asts,23,21,15,10
22023,202699,22301218,"DEC 08, 2023",PHI vs. ATL,W,34,5,9,0.556,0,1,0.0,3,3,1.0,2,6,8,2,1,0,2,3,13,8,1,Tobias Harris,PHI,PHI,ATL,29.5,Fantasy Score,23,21,15,10
22023,202699,22301218,"DEC 08, 2023",PHI vs. ATL,W,34,5,9,0.556,0,1,0.0,3,3,1.0,2,6,8,2,1,0,2,3,13,8,1,Tobias Harris,PHI,PHI,ATL,22.5,Pts+Rebs,23,21,15,10
22023,202699,22301218,"DEC 08, 2023",PHI vs. ATL,W,34,5,9,0.556,0,1,0.0,3,3,1.0,2,6,8,2,1,0,2,3,13,8,1,Tobias Harris,PHI,PHI,ATL,0.5,Dunks,23,21,15,10
22023,202699,22301218,"DEC 08, 2023",PHI vs. ATL,W,34,5,9,0.556,0,1,0.0,3,3,1.0,2,6,8,2,1,0,2,3,13,8,1,Tobias Harris,PHI,PHI,ATL,20.5,Pts+Asts,23,21,15,10
22023,202699,22301218,"DEC 08, 2023",PHI vs. ATL,W,34,5,9,0.556,0,1,0.0,3,3,1.0,2,6,8,2,1,0,2,3,13,8,1,Tobias Harris,PHI,PHI,ATL,1.5,3-PT Made,23,21,15,10
22023,202699,22301218,"DEC 08, 2023",PHI vs. ATL,W,34,5,9,0.556,0,1,0.0,3,3,1.0,2,6,8,2,1,0,2,3,13,8,1,Tobias Harris,PHI,PHI,ATL,0.5,Blocked Shots,23,21,15,10
22023,202699,22301218,"DEC 08, 2023",PHI vs. ATL,W,34,5,9,0.556,0,1,0.0,3,3,1.0,2,6,8,2,1,0,2,3,13,8,1,Tobias Harris,PHI,PHI,ATL,9.0,Rebs+Asts,23,21,15,10
22023,202699,22301208,"DEC 06, 2023",PHI @ WAS,W,35,3,9,0.333,0,1,0.0,0,0,0.0,2,4,6,1,2,0,0,2,6,10,1,Tobias Harris,PHI,WAS,PHI,16.5,Points,13,12,7,7
22023,202699,22301208,"DEC 06, 2023",PHI @ WAS,W,35,3,9,0.333,0,1,0.0,0,0,0.0,2,4,6,1,2,0,0,2,6,10,1,Tobias Harris,PHI,WAS,PHI,5.5,Rebounds,13,12,7,7
22023,202699,22301208,"DEC 06, 2023",PHI @ WAS,W,35,3,9,0.333,0,1,0.0,0,0,0.0,2,4,6,1,2,0,0,2,6,10,1,Tobias Harris,PHI,WAS,PHI,26.5,Pts+Rebs+Asts,13,12,7,7
22023,202699,22301208,"DEC 06, 2023",PHI @ WAS,W,35,3,9,0.333,0,1,0.0,0,0,0.0,2,4,6,1,2,0,0,2,6,10,1,Tobias Harris,PHI,WAS,PHI,29.5,Fantasy Score,13,12,7,7
22023,202699,22301208,"DEC 06, 2023",PHI @ WAS,W,35,3,9,0.333,0,1,0.0,0,0,0.0,2,4,6,1,2,0,0,2,6,10,1,Tobias Harris,PHI,WAS,PHI,22.5,Pts+Rebs,13,12,7,7
22023,202699,22301208,"DEC 06, 2023",PHI @ WAS,W,35,3,9,0.333,0,1,0.0,0,0,0.0,2,4,6,1,2,0,0,2,6,10,1,Tobias Harris,PHI,WAS,PHI,0.5,Dunks,13,12,7,7
22023,202699,22301208,"DEC 06, 2023",PHI @ WAS,W,35,3,9,0.333,0,1,0.0,0,0,0.0,2,4,6,1,2,0,0,2,6,10,1,Tobias Harris,PHI,WAS,PHI,20.5,Pts+Asts,13,12,7,7
22023,202699,22301208,"DEC 06, 2023",PHI @ WAS,W,35,3,9,0.333,0,1,0.0,0,0,0.0,2,4,6,1,2,0,0,2,6,10,1,Tobias Harris,PHI,WAS,PHI,1.5,3-PT Made,13,12,7,7
22023,202699,22301208,"DEC 06, 2023",PHI @ WAS,W,35,3,9,0.333,0,1,0.0,0,0,0.0,2,4,6,1,2,0,0,2,6,10,1,Tobias Harris,PHI,WAS,PHI,0.5,Blocked Shots,13,12,7,7
22023,202699,22301208,"DEC 06, 2023",PHI @ WAS,W,35,3,9,0.333,0,1,0.0,0,0,0.0,2,4,6,1,2,0,0,2,6,10,1,Tobias Harris,PHI,WAS,PHI,9.0,Rebs+Asts,13,12,7,7
22023,202699,22300275,"DEC 01, 2023",PHI @ BOS,L,38,6,16,0.375,1,1,1.0,1,3,0.333,3,2,5,3,4,0,4,1,14,-5,1,Tobias Harris,PHI,BOS,PHI,16.5,Points,22,19,17,8
22023,202699,22300275,"DEC 01, 2023",PHI @ BOS,L,38,6,16,0.375,1,1,1.0,1,3,0.333,3,2,5,3,4,0,4,1,14,-5,1,Tobias Harris,PHI,BOS,PHI,5.5,Rebounds,22,19,17,8
22023,202699,22300275,"DEC 01, 2023",PHI @ BOS,L,38,6,16,0.375,1,1,1.0,1,3,0.333,3,2,5,3,4,0,4,1,14,-5,1,Tobias Harris,PHI,BOS,PHI,26.5,Pts+Rebs+Asts,22,19,17,8
22023,202699,22300275,"DEC 01, 2023",PHI @ BOS,L,38,6,16,0.375,1,1,1.0,1,3,0.333,3,2,5,3,4,0,4,1,14,-5,1,Tobias Harris,PHI,BOS,PHI,29.5,Fantasy Score,22,19,17,8
22023,202699,22300275,"DEC 01, 2023",PHI @ BOS,L,38,6,16,0.375,1,1,1.0,1,3,0.333,3,2,5,3,4,0,4,1,14,-5,1,Tobias Harris,PHI,BOS,PHI,22.5,Pts+Rebs,22,19,17,8
22023,202699,22300275,"DEC 01, 2023",PHI @ BOS,L,38,6,16,0.375,1,1,1.0,1,3,0.333,3,2,5,3,4,0,4,1,14,-5,1,Tobias Harris,PHI,BOS,PHI,0.5,Dunks,22,19,17,8
22023,202699,22300275,"DEC 01, 2023",PHI @ BOS,L,38,6,16,0.375,1,1,1.0,1,3,0.333,3,2,5,3,4,0,4,1,14,-5,1,Tobias Harris,PHI,BOS,PHI,20.5,Pts+Asts,22,19,17,8
22023,202699,22300275,"DEC 01, 2023",PHI @ BOS,L,38,6,16,0.375,1,1,1.0,1,3,0.333,3,2,5,3,4,0,4,1,14,-5,1,Tobias Harris,PHI,BOS,PHI,1.5,3-PT Made,22,19,17,8
22023,202699,22300275,"DEC 01, 2023",PHI @ BOS,L,38,6,16,0.375,1,1,1.0,1,3,0.333,3,2,5,3,4,0,4,1,14,-5,1,Tobias Harris,PHI,BOS,PHI,0.5,Blocked Shots,22,19,17,8
22023,202699,22300275,"DEC 01, 2023",PHI @ BOS,L,38,6,16,0.375,1,1,1.0,1,3,0.333,3,2,5,3,4,0,4,1,14,-5,1,Tobias Harris,PHI,BOS,PHI,9.0,Rebs+Asts,22,19,17,8
22023,202699,22300262,"NOV 29, 2023",PHI @ NOP,L,29,5,10,0.5,0,2,0.0,2,2,1.0,0,4,4,2,0,0,5,2,12,-14,1,Tobias Harris,PHI,NOP,PHI,16.5,Points,18,16,14,6
22023,202699,22300262,"NOV 29, 2023",PHI @ NOP,L,29,5,10,0.5,0,2,0.0,2,2,1.0,0,4,4,2,0,0,5,2,12,-14,1,Tobias Harris,PHI,NOP,PHI,5.5,Rebounds,18,16,14,6
22023,202699,22300262,"NOV 29, 2023",PHI @ NOP,L,29,5,10,0.5,0,2,0.0,2,2,1.0,0,4,4,2,0,0,5,2,12,-14,1,Tobias Harris,PHI,NOP,PHI,26.5,Pts+Rebs+Asts,18,16,14,6
22023,202699,22300262,"NOV 29, 2023",PHI @ NOP,L,29,5,10,0.5,0,2,0.0,2,2,1.0,0,4,4,2,0,0,5,2,12,-14,1,Tobias Harris,PHI,NOP,PHI,29.5,Fantasy Score,18,16,14,6
22023,202699,22300262,"NOV 29, 2023",PHI @ NOP,L,29,5,10,0.5,0,2,0.0,2,2,1.0,0,4,4,2,0,0,5,2,12,-14,1,Tobias Harris,PHI,NOP,PHI,22.5,Pts+Rebs,18,16,14,6
22023,202699,22300262,"NOV 29, 2023",PHI @ NOP,L,29,5,10,0.5,0,2,0.0,2,2,1.0,0,4,4,2,0,0,5,2,12,-14,1,Tobias Harris,PHI,NOP,PHI,0.5,Dunks,18,16,14,6
22023,202699,22300262,"NOV 29, 2023",PHI @ NOP,L,29,5,10,0.5,0,2,0.0,2,2,1.0,0,4,4,2,0,0,5,2,12,-14,1,Tobias Harris,PHI,NOP,PHI,20.5,Pts+Asts,18,16,14,6
22023,202699,22300262,"NOV 29, 2023",PHI @ NOP,L,29,5,10,0.5,0,2,0.0,2,2,1.0,0,4,4,2,0,0,5,2,12,-14,1,Tobias Harris,PHI,NOP,PHI,1.5,3-PT Made,18,16,14,6
22023,202699,22300262,"NOV 29, 2023",PHI @ NOP,L,29,5,10,0.5,0,2,0.0,2,2,1.0,0,4,4,2,0,0,5,2,12,-14,1,Tobias Harris,PHI,NOP,PHI,0.5,Blocked Shots,18,16,14,6
22023,202699,22300262,"NOV 29, 2023",PHI @ NOP,L,29,5,10,0.5,0,2,0.0,2,2,1.0,0,4,4,2,0,0,5,2,12,-14,1,Tobias Harris,PHI,NOP,PHI,9.0,Rebs+Asts,18,16,14,6
22023,202699,22300255,"NOV 27, 2023",PHI vs. LAL,W,23,3,12,0.25,0,4,0.0,2,2,1.0,0,5,5,0,0,0,1,1,8,7,1,Tobias Harris,PHI,PHI,LAL,16.5,Points,13,13,8,5
22023,202699,22300255,"NOV 27, 2023",PHI vs. LAL,W,23,3,12,0.25,0,4,0.0,2,2,1.0,0,5,5,0,0,0,1,1,8,7,1,Tobias Harris,PHI,PHI,LAL,5.5,Rebounds,13,13,8,5
22023,202699,22300255,"NOV 27, 2023",PHI vs. LAL,W,23,3,12,0.25,0,4,0.0,2,2,1.0,0,5,5,0,0,0,1,1,8,7,1,Tobias Harris,PHI,PHI,LAL,26.5,Pts+Rebs+Asts,13,13,8,5
22023,202699,22300255,"NOV 27, 2023",PHI vs. LAL,W,23,3,12,0.25,0,4,0.0,2,2,1.0,0,5,5,0,0,0,1,1,8,7,1,Tobias Harris,PHI,PHI,LAL,29.5,Fantasy Score,13,13,8,5
22023,202699,22300255,"NOV 27, 2023",PHI vs. LAL,W,23,3,12,0.25,0,4,0.0,2,2,1.0,0,5,5,0,0,0,1,1,8,7,1,Tobias Harris,PHI,PHI,LAL,22.5,Pts+Rebs,13,13,8,5
22023,202699,22300255,"NOV 27, 2023",PHI vs. LAL,W,23,3,12,0.25,0,4,0.0,2,2,1.0,0,5,5,0,0,0,1,1,8,7,1,Tobias Harris,PHI,PHI,LAL,0.5,Dunks,13,13,8,5
22023,202699,22300255,"NOV 27, 2023",PHI vs. LAL,W,23,3,12,0.25,0,4,0.0,2,2,1.0,0,5,5,0,0,0,1,1,8,7,1,Tobias Harris,PHI,PHI,LAL,20.5,Pts+Asts,13,13,8,5
22023,202699,22300255,"NOV 27, 2023",PHI vs. LAL,W,23,3,12,0.25,0,4,0.0,2,2,1.0,0,5,5,0,0,0,1,1,8,7,1,Tobias Harris,PHI,PHI,LAL,1.5,3-PT Made,13,13,8,5
22023,202699,22300255,"NOV 27, 2023",PHI vs. LAL,W,23,3,12,0.25,0,4,0.0,2,2,1.0,0,5,5,0,0,0,1,1,8,7,1,Tobias Harris,PHI,PHI,LAL,0.5,Blocked Shots,13,13,8,5
22023,202699,22300255,"NOV 27, 2023",PHI vs. LAL,W,23,3,12,0.25,0,4,0.0,2,2,1.0,0,5,5,0,0,0,1,1,8,7,1,Tobias Harris,PHI,PHI,LAL,9.0,Rebs+Asts,13,13,8,5
22023,202699,22300239,"NOV 25, 2023",PHI @ OKC,W,31,6,13,0.462,1,5,0.2,3,3,1.0,0,5,5,6,0,0,3,3,16,20,1,Tobias Harris,PHI,OKC,PHI,16.5,Points,27,21,22,11
22023,202699,22300239,"NOV 25, 2023",PHI @ OKC,W,31,6,13,0.462,1,5,0.2,3,3,1.0,0,5,5,6,0,0,3,3,16,20,1,Tobias Harris,PHI,OKC,PHI,5.5,Rebounds,27,21,22,11
22023,202699,22300239,"NOV 25, 2023",PHI @ OKC,W,31,6,13,0.462,1,5,0.2,3,3,1.0,0,5,5,6,0,0,3,3,16,20,1,Tobias Harris,PHI,OKC,PHI,26.5,Pts+Rebs+Asts,27,21,22,11
22023,202699,22300239,"NOV 25, 2023",PHI @ OKC,W,31,6,13,0.462,1,5,0.2,3,3,1.0,0,5,5,6,0,0,3,3,16,20,1,Tobias Harris,PHI,OKC,PHI,29.5,Fantasy Score,27,21,22,11
22023,202699,22300239,"NOV 25, 2023",PHI @ OKC,W,31,6,13,0.462,1,5,0.2,3,3,1.0,0,5,5,6,0,0,3,3,16,20,1,Tobias Harris,PHI,OKC,PHI,22.5,Pts+Rebs,27,21,22,11
22023,202699,22300239,"NOV 25, 2023",PHI @ OKC,W,31,6,13,0.462,1,5,0.2,3,3,1.0,0,5,5,6,0,0,3,3,16,20,1,Tobias Harris,PHI,OKC,PHI,0.5,Dunks,27,21,22,11
22023,202699,22300239,"NOV 25, 2023",PHI @ OKC,W,31,6,13,0.462,1,5,0.2,3,3,1.0,0,5,5,6,0,0,3,3,16,20,1,Tobias Harris,PHI,OKC,PHI,20.5,Pts+Asts,27,21,22,11
22023,202699,22300239,"NOV 25, 2023",PHI @ OKC,W,31,6,13,0.462,1,5,0.2,3,3,1.0,0,5,5,6,0,0,3,3,16,20,1,Tobias Harris,PHI,OKC,PHI,1.5,3-PT Made,27,21,22,11
22023,202699,22300239,"NOV 25, 2023",PHI @ OKC,W,31,6,13,0.462,1,5,0.2,3,3,1.0,0,5,5,6,0,0,3,3,16,20,1,Tobias Harris,PHI,OKC,PHI,0.5,Blocked Shots,27,21,22,11
22023,202699,22300239,"NOV 25, 2023",PHI @ OKC,W,31,6,13,0.462,1,5,0.2,3,3,1.0,0,5,5,6,0,0,3,3,16,20,1,Tobias Harris,PHI,OKC,PHI,9.0,Rebs+Asts,27,21,22,11
22023,202699,22300232,"NOV 22, 2023",PHI @ MIN,L,32,4,11,0.364,0,3,0.0,7,8,0.875,1,5,6,2,0,1,1,1,15,-15,1,Tobias Harris,PHI,MIN,PHI,16.5,Points,23,21,17,8
22023,202699,22300232,"NOV 22, 2023",PHI @ MIN,L,32,4,11,0.364,0,3,0.0,7,8,0.875,1,5,6,2,0,1,1,1,15,-15,1,Tobias Harris,PHI,MIN,PHI,5.5,Rebounds,23,21,17,8
22023,202699,22300232,"NOV 22, 2023",PHI @ MIN,L,32,4,11,0.364,0,3,0.0,7,8,0.875,1,5,6,2,0,1,1,1,15,-15,1,Tobias Harris,PHI,MIN,PHI,26.5,Pts+Rebs+Asts,23,21,17,8
22023,202699,22300232,"NOV 22, 2023",PHI @ MIN,L,32,4,11,0.364,0,3,0.0,7,8,0.875,1,5,6,2,0,1,1,1,15,-15,1,Tobias Harris,PHI,MIN,PHI,29.5,Fantasy Score,23,21,17,8
22023,202699,22300232,"NOV 22, 2023",PHI @ MIN,L,32,4,11,0.364,0,3,0.0,7,8,0.875,1,5,6,2,0,1,1,1,15,-15,1,Tobias Harris,PHI,MIN,PHI,22.5,Pts+Rebs,23,21,17,8
22023,202699,22300232,"NOV 22, 2023",PHI @ MIN,L,32,4,11,0.364,0,3,0.0,7,8,0.875,1,5,6,2,0,1,1,1,15,-15,1,Tobias Harris,PHI,MIN,PHI,0.5,Dunks,23,21,17,8
22023,202699,22300232,"NOV 22, 2023",PHI @ MIN,L,32,4,11,0.364,0,3,0.0,7,8,0.875,1,5,6,2,0,1,1,1,15,-15,1,Tobias Harris,PHI,MIN,PHI,20.5,Pts+Asts,23,21,17,8
22023,202699,22300232,"NOV 22, 2023",PHI @ MIN,L,32,4,11,0.364,0,3,0.0,7,8,0.875,1,5,6,2,0,1,1,1,15,-15,1,Tobias Harris,PHI,MIN,PHI,1.5,3-PT Made,23,21,17,8
22023,202699,22300232,"NOV 22, 2023",PHI @ MIN,L,32,4,11,0.364,0,3,0.0,7,8,0.875,1,5,6,2,0,1,1,1,15,-15,1,Tobias Harris,PHI,MIN,PHI,0.5,Blocked Shots,23,21,17,8
22023,202699,22300232,"NOV 22, 2023",PHI @ MIN,L,32,4,11,0.364,0,3,0.0,7,8,0.875,1,5,6,2,0,1,1,1,15,-15,1,Tobias Harris,PHI,MIN,PHI,9.0,Rebs+Asts,23,21,17,8
22023,202699,22300040,"NOV 21, 2023",PHI vs. CLE,L,43,7,13,0.538,3,5,0.6,6,6,1.0,0,2,2,2,2,0,0,3,23,-6,1,Tobias Harris,PHI,PHI,CLE,16.5,Points,27,25,25,4
22023,202699,22300040,"NOV 21, 2023",PHI vs. CLE,L,43,7,13,0.538,3,5,0.6,6,6,1.0,0,2,2,2,2,0,0,3,23,-6,1,Tobias Harris,PHI,PHI,CLE,5.5,Rebounds,27,25,25,4
22023,202699,22300040,"NOV 21, 2023",PHI vs. CLE,L,43,7,13,0.538,3,5,0.6,6,6,1.0,0,2,2,2,2,0,0,3,23,-6,1,Tobias Harris,PHI,PHI,CLE,26.5,Pts+Rebs+Asts,27,25,25,4
22023,202699,22300040,"NOV 21, 2023",PHI vs. CLE,L,43,7,13,0.538,3,5,0.6,6,6,1.0,0,2,2,2,2,0,0,3,23,-6,1,Tobias Harris,PHI,PHI,CLE,29.5,Fantasy Score,27,25,25,4
22023,202699,22300040,"NOV 21, 2023",PHI vs. CLE,L,43,7,13,0.538,3,5,0.6,6,6,1.0,0,2,2,2,2,0,0,3,23,-6,1,Tobias Harris,PHI,PHI,CLE,22.5,Pts+Rebs,27,25,25,4
22023,202699,22300040,"NOV 21, 2023",PHI vs. CLE,L,43,7,13,0.538,3,5,0.6,6,6,1.0,0,2,2,2,2,0,0,3,23,-6,1,Tobias Harris,PHI,PHI,CLE,0.5,Dunks,27,25,25,4
22023,202699,22300040,"NOV 21, 2023",PHI vs. CLE,L,43,7,13,0.538,3,5,0.6,6,6,1.0,0,2,2,2,2,0,0,3,23,-6,1,Tobias Harris,PHI,PHI,CLE,20.5,Pts+Asts,27,25,25,4
22023,202699,22300040,"NOV 21, 2023",PHI vs. CLE,L,43,7,13,0.538,3,5,0.6,6,6,1.0,0,2,2,2,2,0,0,3,23,-6,1,Tobias Harris,PHI,PHI,CLE,1.5,3-PT Made,27,25,25,4
22023,202699,22300040,"NOV 21, 2023",PHI vs. CLE,L,43,7,13,0.538,3,5,0.6,6,6,1.0,0,2,2,2,2,0,0,3,23,-6,1,Tobias Harris,PHI,PHI,CLE,0.5,Blocked Shots,27,25,25,4
22023,202699,22300040,"NOV 21, 2023",PHI vs. CLE,L,43,7,13,0.538,3,5,0.6,6,6,1.0,0,2,2,2,2,0,0,3,23,-6,1,Tobias Harris,PHI,PHI,CLE,9.0,Rebs+Asts,27,25,25,4
22023,202699,22300208,"NOV 19, 2023",PHI @ BKN,W,32,5,13,0.385,0,4,0.0,0,0,0.0,1,4,5,1,2,0,0,0,10,14,1,Tobias Harris,PHI,BKN,PHI,16.5,Points,16,15,11,6
22023,202699,22300208,"NOV 19, 2023",PHI @ BKN,W,32,5,13,0.385,0,4,0.0,0,0,0.0,1,4,5,1,2,0,0,0,10,14,1,Tobias Harris,PHI,BKN,PHI,5.5,Rebounds,16,15,11,6
22023,202699,22300208,"NOV 19, 2023",PHI @ BKN,W,32,5,13,0.385,0,4,0.0,0,0,0.0,1,4,5,1,2,0,0,0,10,14,1,Tobias Harris,PHI,BKN,PHI,26.5,Pts+Rebs+Asts,16,15,11,6
22023,202699,22300208,"NOV 19, 2023",PHI @ BKN,W,32,5,13,0.385,0,4,0.0,0,0,0.0,1,4,5,1,2,0,0,0,10,14,1,Tobias Harris,PHI,BKN,PHI,29.5,Fantasy Score,16,15,11,6
22023,202699,22300208,"NOV 19, 2023",PHI @ BKN,W,32,5,13,0.385,0,4,0.0,0,0,0.0,1,4,5,1,2,0,0,0,10,14,1,Tobias Harris,PHI,BKN,PHI,22.5,Pts+Rebs,16,15,11,6
22023,202699,22300208,"NOV 19, 2023",PHI @ BKN,W,32,5,13,0.385,0,4,0.0,0,0,0.0,1,4,5,1,2,0,0,0,10,14,1,Tobias Harris,PHI,BKN,PHI,0.5,Dunks,16,15,11,6
22023,202699,22300208,"NOV 19, 2023",PHI @ BKN,W,32,5,13,0.385,0,4,0.0,0,0,0.0,1,4,5,1,2,0,0,0,10,14,1,Tobias Harris,PHI,BKN,PHI,20.5,Pts+Asts,16,15,11,6
22023,202699,22300208,"NOV 19, 2023",PHI @ BKN,W,32,5,13,0.385,0,4,0.0,0,0,0.0,1,4,5,1,2,0,0,0,10,14,1,Tobias Harris,PHI,BKN,PHI,1.5,3-PT Made,16,15,11,6
22023,202699,22300208,"NOV 19, 2023",PHI @ BKN,W,32,5,13,0.385,0,4,0.0,0,0,0.0,1,4,5,1,2,0,0,0,10,14,1,Tobias Harris,PHI,BKN,PHI,0.5,Blocked Shots,16,15,11,6
22023,202699,22300208,"NOV 19, 2023",PHI @ BKN,W,32,5,13,0.385,0,4,0.0,0,0,0.0,1,4,5,1,2,0,0,0,10,14,1,Tobias Harris,PHI,BKN,PHI,9.0,Rebs+Asts,16,15,11,6
22023,202699,22300029,"NOV 17, 2023",PHI @ ATL,W,38,12,20,0.6,3,5,0.6,2,2,1.0,1,9,10,4,1,0,1,1,29,-4,1,Tobias Harris,PHI,ATL,PHI,16.5,Points,43,39,33,14
22023,202699,22300029,"NOV 17, 2023",PHI @ ATL,W,38,12,20,0.6,3,5,0.6,2,2,1.0,1,9,10,4,1,0,1,1,29,-4,1,Tobias Harris,PHI,ATL,PHI,5.5,Rebounds,43,39,33,14
22023,202699,22300029,"NOV 17, 2023",PHI @ ATL,W,38,12,20,0.6,3,5,0.6,2,2,1.0,1,9,10,4,1,0,1,1,29,-4,1,Tobias Harris,PHI,ATL,PHI,26.5,Pts+Rebs+Asts,43,39,33,14
22023,202699,22300029,"NOV 17, 2023",PHI @ ATL,W,38,12,20,0.6,3,5,0.6,2,2,1.0,1,9,10,4,1,0,1,1,29,-4,1,Tobias Harris,PHI,ATL,PHI,29.5,Fantasy Score,43,39,33,14
22023,202699,22300029,"NOV 17, 2023",PHI @ ATL,W,38,12,20,0.6,3,5,0.6,2,2,1.0,1,9,10,4,1,0,1,1,29,-4,1,Tobias Harris,PHI,ATL,PHI,22.5,Pts+Rebs,43,39,33,14
22023,202699,22300029,"NOV 17, 2023",PHI @ ATL,W,38,12,20,0.6,3,5,0.6,2,2,1.0,1,9,10,4,1,0,1,1,29,-4,1,Tobias Harris,PHI,ATL,PHI,0.5,Dunks,43,39,33,14
22023,202699,22300029,"NOV 17, 2023",PHI @ ATL,W,38,12,20,0.6,3,5,0.6,2,2,1.0,1,9,10,4,1,0,1,1,29,-4,1,Tobias Harris,PHI,ATL,PHI,20.5,Pts+Asts,43,39,33,14
22023,202699,22300029,"NOV 17, 2023",PHI @ ATL,W,38,12,20,0.6,3,5,0.6,2,2,1.0,1,9,10,4,1,0,1,1,29,-4,1,Tobias Harris,PHI,ATL,PHI,1.5,3-PT Made,43,39,33,14
22023,202699,22300029,"NOV 17, 2023",PHI @ ATL,W,38,12,20,0.6,3,5,0.6,2,2,1.0,1,9,10,4,1,0,1,1,29,-4,1,Tobias Harris,PHI,ATL,PHI,0.5,Blocked Shots,43,39,33,14
22023,202699,22300029,"NOV 17, 2023",PHI @ ATL,W,38,12,20,0.6,3,5,0.6,2,2,1.0,1,9,10,4,1,0,1,1,29,-4,1,Tobias Harris,PHI,ATL,PHI,9.0,Rebs+Asts,43,39,33,14
22023,202699,22300194,"NOV 15, 2023",PHI vs. BOS,L,38,6,12,0.5,1,2,0.5,3,3,1.0,0,7,7,3,0,0,1,0,16,-1,1,Tobias Harris,PHI,PHI,BOS,16.5,Points,26,23,19,10
22023,202699,22300194,"NOV 15, 2023",PHI vs. BOS,L,38,6,12,0.5,1,2,0.5,3,3,1.0,0,7,7,3,0,0,1,0,16,-1,1,Tobias Harris,PHI,PHI,BOS,5.5,Rebounds,26,23,19,10
22023,202699,22300194,"NOV 15, 2023",PHI vs. BOS,L,38,6,12,0.5,1,2,0.5,3,3,1.0,0,7,7,3,0,0,1,0,16,-1,1,Tobias Harris,PHI,PHI,BOS,26.5,Pts+Rebs+Asts,26,23,19,10
22023,202699,22300194,"NOV 15, 2023",PHI vs. BOS,L,38,6,12,0.5,1,2,0.5,3,3,1.0,0,7,7,3,0,0,1,0,16,-1,1,Tobias Harris,PHI,PHI,BOS,29.5,Fantasy Score,26,23,19,10
22023,202699,22300194,"NOV 15, 2023",PHI vs. BOS,L,38,6,12,0.5,1,2,0.5,3,3,1.0,0,7,7,3,0,0,1,0,16,-1,1,Tobias Harris,PHI,PHI,BOS,22.5,Pts+Rebs,26,23,19,10
22023,202699,22300194,"NOV 15, 2023",PHI vs. BOS,L,38,6,12,0.5,1,2,0.5,3,3,1.0,0,7,7,3,0,0,1,0,16,-1,1,Tobias Harris,PHI,PHI,BOS,0.5,Dunks,26,23,19,10
22023,202699,22300194,"NOV 15, 2023",PHI vs. BOS,L,38,6,12,0.5,1,2,0.5,3,3,1.0,0,7,7,3,0,0,1,0,16,-1,1,Tobias Harris,PHI,PHI,BOS,20.5,Pts+Asts,26,23,19,10
22023,202699,22300194,"NOV 15, 2023",PHI vs. BOS,L,38,6,12,0.5,1,2,0.5,3,3,1.0,0,7,7,3,0,0,1,0,16,-1,1,Tobias Harris,PHI,PHI,BOS,1.5,3-PT Made,26,23,19,10
22023,202699,22300194,"NOV 15, 2023",PHI vs. BOS,L,38,6,12,0.5,1,2,0.5,3,3,1.0,0,7,7,3,0,0,1,0,16,-1,1,Tobias Harris,PHI,PHI,BOS,0.5,Blocked Shots,26,23,19,10
22023,202699,22300194,"NOV 15, 2023",PHI vs. BOS,L,38,6,12,0.5,1,2,0.5,3,3,1.0,0,7,7,3,0,0,1,0,16,-1,1,Tobias Harris,PHI,PHI,BOS,9.0,Rebs+Asts,26,23,19,10
22023,202699,22300019,"NOV 14, 2023",PHI vs. IND,L,37,11,17,0.647,0,1,0.0,0,1,0.0,0,7,7,3,1,0,1,3,22,-8,1,Tobias Harris,PHI,PHI,IND,16.5,Points,32,29,25,10
22023,202699,22300019,"NOV 14, 2023",PHI vs. IND,L,37,11,17,0.647,0,1,0.0,0,1,0.0,0,7,7,3,1,0,1,3,22,-8,1,Tobias Harris,PHI,PHI,IND,5.5,Rebounds,32,29,25,10
22023,202699,22300019,"NOV 14, 2023",PHI vs. IND,L,37,11,17,0.647,0,1,0.0,0,1,0.0,0,7,7,3,1,0,1,3,22,-8,1,Tobias Harris,PHI,PHI,IND,26.5,Pts+Rebs+Asts,32,29,25,10
22023,202699,22300019,"NOV 14, 2023",PHI vs. IND,L,37,11,17,0.647,0,1,0.0,0,1,0.0,0,7,7,3,1,0,1,3,22,-8,1,Tobias Harris,PHI,PHI,IND,29.5,Fantasy Score,32,29,25,10
22023,202699,22300019,"NOV 14, 2023",PHI vs. IND,L,37,11,17,0.647,0,1,0.0,0,1,0.0,0,7,7,3,1,0,1,3,22,-8,1,Tobias Harris,PHI,PHI,IND,22.5,Pts+Rebs,32,29,25,10
22023,202699,22300019,"NOV 14, 2023",PHI vs. IND,L,37,11,17,0.647,0,1,0.0,0,1,0.0,0,7,7,3,1,0,1,3,22,-8,1,Tobias Harris,PHI,PHI,IND,0.5,Dunks,32,29,25,10
22023,202699,22300019,"NOV 14, 2023",PHI vs. IND,L,37,11,17,0.647,0,1,0.0,0,1,0.0,0,7,7,3,1,0,1,3,22,-8,1,Tobias Harris,PHI,PHI,IND,20.5,Pts+Asts,32,29,25,10
22023,202699,22300019,"NOV 14, 2023",PHI vs. IND,L,37,11,17,0.647,0,1,0.0,0,1,0.0,0,7,7,3,1,0,1,3,22,-8,1,Tobias Harris,PHI,PHI,IND,1.5,3-PT Made,32,29,25,10
22023,202699,22300019,"NOV 14, 2023",PHI vs. IND,L,37,11,17,0.647,0,1,0.0,0,1,0.0,0,7,7,3,1,0,1,3,22,-8,1,Tobias Harris,PHI,PHI,IND,0.5,Blocked Shots,32,29,25,10
22023,202699,22300019,"NOV 14, 2023",PHI vs. IND,L,37,11,17,0.647,0,1,0.0,0,1,0.0,0,7,7,3,1,0,1,3,22,-8,1,Tobias Harris,PHI,PHI,IND,9.0,Rebs+Asts,32,29,25,10
22023,202699,22300180,"NOV 12, 2023",PHI vs. IND,W,36,9,20,0.45,0,3,0.0,0,0,0.0,4,5,9,4,0,0,1,2,18,12,1,Tobias Harris,PHI,PHI,IND,16.5,Points,31,27,22,13
22023,202699,22300180,"NOV 12, 2023",PHI vs. IND,W,36,9,20,0.45,0,3,0.0,0,0,0.0,4,5,9,4,0,0,1,2,18,12,1,Tobias Harris,PHI,PHI,IND,5.5,Rebounds,31,27,22,13
22023,202699,22300180,"NOV 12, 2023",PHI vs. IND,W,36,9,20,0.45,0,3,0.0,0,0,0.0,4,5,9,4,0,0,1,2,18,12,1,Tobias Harris,PHI,PHI,IND,26.5,Pts+Rebs+Asts,31,27,22,13
22023,202699,22300180,"NOV 12, 2023",PHI vs. IND,W,36,9,20,0.45,0,3,0.0,0,0,0.0,4,5,9,4,0,0,1,2,18,12,1,Tobias Harris,PHI,PHI,IND,29.5,Fantasy Score,31,27,22,13
22023,202699,22300180,"NOV 12, 2023",PHI vs. IND,W,36,9,20,0.45,0,3,0.0,0,0,0.0,4,5,9,4,0,0,1,2,18,12,1,Tobias Harris,PHI,PHI,IND,22.5,Pts+Rebs,31,27,22,13
22023,202699,22300180,"NOV 12, 2023",PHI vs. IND,W,36,9,20,0.45,0,3,0.0,0,0,0.0,4,5,9,4,0,0,1,2,18,12,1,Tobias Harris,PHI,PHI,IND,0.5,Dunks,31,27,22,13
22023,202699,22300180,"NOV 12, 2023",PHI vs. IND,W,36,9,20,0.45,0,3,0.0,0,0,0.0,4,5,9,4,0,0,1,2,18,12,1,Tobias Harris,PHI,PHI,IND,20.5,Pts+Asts,31,27,22,13
22023,202699,22300180,"NOV 12, 2023",PHI vs. IND,W,36,9,20,0.45,0,3,0.0,0,0,0.0,4,5,9,4,0,0,1,2,18,12,1,Tobias Harris,PHI,PHI,IND,1.5,3-PT Made,31,27,22,13
22023,202699,22300180,"NOV 12, 2023",PHI vs. IND,W,36,9,20,0.45,0,3,0.0,0,0,0.0,4,5,9,4,0,0,1,2,18,12,1,Tobias Harris,PHI,PHI,IND,0.5,Blocked Shots,31,27,22,13
22023,202699,22300180,"NOV 12, 2023",PHI vs. IND,W,36,9,20,0.45,0,3,0.0,0,0,0.0,4,5,9,4,0,0,1,2,18,12,1,Tobias Harris,PHI,PHI,IND,9.0,Rebs+Asts,31,27,22,13
22023,202699,22300008,"NOV 10, 2023",PHI @ DET,W,38,8,15,0.533,2,3,0.667,6,6,1.0,1,4,5,2,0,1,3,1,24,10,1,Tobias Harris,PHI,DET,PHI,16.5,Points,31,29,26,7
22023,202699,22300008,"NOV 10, 2023",PHI @ DET,W,38,8,15,0.533,2,3,0.667,6,6,1.0,1,4,5,2,0,1,3,1,24,10,1,Tobias Harris,PHI,DET,PHI,5.5,Rebounds,31,29,26,7
22023,202699,22300008,"NOV 10, 2023",PHI @ DET,W,38,8,15,0.533,2,3,0.667,6,6,1.0,1,4,5,2,0,1,3,1,24,10,1,Tobias Harris,PHI,DET,PHI,26.5,Pts+Rebs+Asts,31,29,26,7
22023,202699,22300008,"NOV 10, 2023",PHI @ DET,W,38,8,15,0.533,2,3,0.667,6,6,1.0,1,4,5,2,0,1,3,1,24,10,1,Tobias Harris,PHI,DET,PHI,29.5,Fantasy Score,31,29,26,7
22023,202699,22300008,"NOV 10, 2023",PHI @ DET,W,38,8,15,0.533,2,3,0.667,6,6,1.0,1,4,5,2,0,1,3,1,24,10,1,Tobias Harris,PHI,DET,PHI,22.5,Pts+Rebs,31,29,26,7
22023,202699,22300008,"NOV 10, 2023",PHI @ DET,W,38,8,15,0.533,2,3,0.667,6,6,1.0,1,4,5,2,0,1,3,1,24,10,1,Tobias Harris,PHI,DET,PHI,0.5,Dunks,31,29,26,7
22023,202699,22300008,"NOV 10, 2023",PHI @ DET,W,38,8,15,0.533,2,3,0.667,6,6,1.0,1,4,5,2,0,1,3,1,24,10,1,Tobias Harris,PHI,DET,PHI,20.5,Pts+Asts,31,29,26,7
22023,202699,22300008,"NOV 10, 2023",PHI @ DET,W,38,8,15,0.533,2,3,0.667,6,6,1.0,1,4,5,2,0,1,3,1,24,10,1,Tobias Harris,PHI,DET,PHI,1.5,3-PT Made,31,29,26,7
22023,202699,22300008,"NOV 10, 2023",PHI @ DET,W,38,8,15,0.533,2,3,0.667,6,6,1.0,1,4,5,2,0,1,3,1,24,10,1,Tobias Harris,PHI,DET,PHI,0.5,Blocked Shots,31,29,26,7
22023,202699,22300008,"NOV 10, 2023",PHI @ DET,W,38,8,15,0.533,2,3,0.667,6,6,1.0,1,4,5,2,0,1,3,1,24,10,1,Tobias Harris,PHI,DET,PHI,9.0,Rebs+Asts,31,29,26,7
22023,202699,22300159,"NOV 08, 2023",PHI vs. BOS,W,38,5,12,0.417,1,4,0.25,6,6,1.0,2,7,9,3,0,0,2,1,17,3,1,Tobias Harris,PHI,PHI,BOS,16.5,Points,29,26,20,12
22023,202699,22300159,"NOV 08, 2023",PHI vs. BOS,W,38,5,12,0.417,1,4,0.25,6,6,1.0,2,7,9,3,0,0,2,1,17,3,1,Tobias Harris,PHI,PHI,BOS,5.5,Rebounds,29,26,20,12
22023,202699,22300159,"NOV 08, 2023",PHI vs. BOS,W,38,5,12,0.417,1,4,0.25,6,6,1.0,2,7,9,3,0,0,2,1,17,3,1,Tobias Harris,PHI,PHI,BOS,26.5,Pts+Rebs+Asts,29,26,20,12
22023,202699,22300159,"NOV 08, 2023",PHI vs. BOS,W,38,5,12,0.417,1,4,0.25,6,6,1.0,2,7,9,3,0,0,2,1,17,3,1,Tobias Harris,PHI,PHI,BOS,29.5,Fantasy Score,29,26,20,12
22023,202699,22300159,"NOV 08, 2023",PHI vs. BOS,W,38,5,12,0.417,1,4,0.25,6,6,1.0,2,7,9,3,0,0,2,1,17,3,1,Tobias Harris,PHI,PHI,BOS,22.5,Pts+Rebs,29,26,20,12
22023,202699,22300159,"NOV 08, 2023",PHI vs. BOS,W,38,5,12,0.417,1,4,0.25,6,6,1.0,2,7,9,3,0,0,2,1,17,3,1,Tobias Harris,PHI,PHI,BOS,0.5,Dunks,29,26,20,12
22023,202699,22300159,"NOV 08, 2023",PHI vs. BOS,W,38,5,12,0.417,1,4,0.25,6,6,1.0,2,7,9,3,0,0,2,1,17,3,1,Tobias Harris,PHI,PHI,BOS,20.5,Pts+Asts,29,26,20,12
22023,202699,22300159,"NOV 08, 2023",PHI vs. BOS,W,38,5,12,0.417,1,4,0.25,6,6,1.0,2,7,9,3,0,0,2,1,17,3,1,Tobias Harris,PHI,PHI,BOS,1.5,3-PT Made,29,26,20,12
22023,202699,22300159,"NOV 08, 2023",PHI vs. BOS,W,38,5,12,0.417,1,4,0.25,6,6,1.0,2,7,9,3,0,0,2,1,17,3,1,Tobias Harris,PHI,PHI,BOS,0.5,Blocked Shots,29,26,20,12
22023,202699,22300159,"NOV 08, 2023",PHI vs. BOS,W,38,5,12,0.417,1,4,0.25,6,6,1.0,2,7,9,3,0,0,2,1,17,3,1,Tobias Harris,PHI,PHI,BOS,9.0,Rebs+Asts,29,26,20,12
22023,202699,22300148,"NOV 06, 2023",PHI vs. WAS,W,31,6,11,0.545,0,2,0.0,6,6,1.0,1,4,5,5,1,0,2,1,18,8,1,Tobias Harris,PHI,PHI,WAS,16.5,Points,28,23,23,10
22023,202699,22300148,"NOV 06, 2023",PHI vs. WAS,W,31,6,11,0.545,0,2,0.0,6,6,1.0,1,4,5,5,1,0,2,1,18,8,1,Tobias Harris,PHI,PHI,WAS,5.5,Rebounds,28,23,23,10
22023,202699,22300148,"NOV 06, 2023",PHI vs. WAS,W,31,6,11,0.545,0,2,0.0,6,6,1.0,1,4,5,5,1,0,2,1,18,8,1,Tobias Harris,PHI,PHI,WAS,26.5,Pts+Rebs+Asts,28,23,23,10
22023,202699,22300148,"NOV 06, 2023",PHI vs. WAS,W,31,6,11,0.545,0,2,0.0,6,6,1.0,1,4,5,5,1,0,2,1,18,8,1,Tobias Harris,PHI,PHI,WAS,29.5,Fantasy Score,28,23,23,10
22023,202699,22300148,"NOV 06, 2023",PHI vs. WAS,W,31,6,11,0.545,0,2,0.0,6,6,1.0,1,4,5,5,1,0,2,1,18,8,1,Tobias Harris,PHI,PHI,WAS,22.5,Pts+Rebs,28,23,23,10
22023,202699,22300148,"NOV 06, 2023",PHI vs. WAS,W,31,6,11,0.545,0,2,0.0,6,6,1.0,1,4,5,5,1,0,2,1,18,8,1,Tobias Harris,PHI,PHI,WAS,0.5,Dunks,28,23,23,10
22023,202699,22300148,"NOV 06, 2023",PHI vs. WAS,W,31,6,11,0.545,0,2,0.0,6,6,1.0,1,4,5,5,1,0,2,1,18,8,1,Tobias Harris,PHI,PHI,WAS,20.5,Pts+Asts,28,23,23,10
22023,202699,22300148,"NOV 06, 2023",PHI vs. WAS,W,31,6,11,0.545,0,2,0.0,6,6,1.0,1,4,5,5,1,0,2,1,18,8,1,Tobias Harris,PHI,PHI,WAS,1.5,3-PT Made,28,23,23,10
22023,202699,22300148,"NOV 06, 2023",PHI vs. WAS,W,31,6,11,0.545,0,2,0.0,6,6,1.0,1,4,5,5,1,0,2,1,18,8,1,Tobias Harris,PHI,PHI,WAS,0.5,Blocked Shots,28,23,23,10
22023,202699,22300148,"NOV 06, 2023",PHI vs. WAS,W,31,6,11,0.545,0,2,0.0,6,6,1.0,1,4,5,5,1,0,2,1,18,8,1,Tobias Harris,PHI,PHI,WAS,9.0,Rebs+Asts,28,23,23,10
22023,202699,22300132,"NOV 04, 2023",PHI vs. PHX,W,34,7,10,0.7,0,1,0.0,4,4,1.0,2,8,10,2,1,0,3,4,18,20,1,Tobias Harris,PHI,PHI,PHX,16.5,Points,30,28,20,12
22023,202699,22300132,"NOV 04, 2023",PHI vs. PHX,W,34,7,10,0.7,0,1,0.0,4,4,1.0,2,8,10,2,1,0,3,4,18,20,1,Tobias Harris,PHI,PHI,PHX,5.5,Rebounds,30,28,20,12
22023,202699,22300132,"NOV 04, 2023",PHI vs. PHX,W,34,7,10,0.7,0,1,0.0,4,4,1.0,2,8,10,2,1,0,3,4,18,20,1,Tobias Harris,PHI,PHI,PHX,26.5,Pts+Rebs+Asts,30,28,20,12
22023,202699,22300132,"NOV 04, 2023",PHI vs. PHX,W,34,7,10,0.7,0,1,0.0,4,4,1.0,2,8,10,2,1,0,3,4,18,20,1,Tobias Harris,PHI,PHI,PHX,29.5,Fantasy Score,30,28,20,12
22023,202699,22300132,"NOV 04, 2023",PHI vs. PHX,W,34,7,10,0.7,0,1,0.0,4,4,1.0,2,8,10,2,1,0,3,4,18,20,1,Tobias Harris,PHI,PHI,PHX,22.5,Pts+Rebs,30,28,20,12
22023,202699,22300132,"NOV 04, 2023",PHI vs. PHX,W,34,7,10,0.7,0,1,0.0,4,4,1.0,2,8,10,2,1,0,3,4,18,20,1,Tobias Harris,PHI,PHI,PHX,0.5,Dunks,30,28,20,12
22023,202699,22300132,"NOV 04, 2023",PHI vs. PHX,W,34,7,10,0.7,0,1,0.0,4,4,1.0,2,8,10,2,1,0,3,4,18,20,1,Tobias Harris,PHI,PHI,PHX,20.5,Pts+Asts,30,28,20,12
22023,202699,22300132,"NOV 04, 2023",PHI vs. PHX,W,34,7,10,0.7,0,1,0.0,4,4,1.0,2,8,10,2,1,0,3,4,18,20,1,Tobias Harris,PHI,PHI,PHX,1.5,3-PT Made,30,28,20,12
22023,202699,22300132,"NOV 04, 2023",PHI vs. PHX,W,34,7,10,0.7,0,1,0.0,4,4,1.0,2,8,10,2,1,0,3,4,18,20,1,Tobias Harris,PHI,PHI,PHX,0.5,Blocked Shots,30,28,20,12
22023,202699,22300132,"NOV 04, 2023",PHI vs. PHX,W,34,7,10,0.7,0,1,0.0,4,4,1.0,2,8,10,2,1,0,3,4,18,20,1,Tobias Harris,PHI,PHI,PHX,9.0,Rebs+Asts,30,28,20,12
22023,202699,22300128,"NOV 02, 2023",PHI vs. TOR,W,40,10,17,0.588,2,6,0.333,1,2,0.5,0,7,7,3,3,0,2,1,23,6,1,Tobias Harris,PHI,PHI,TOR,16.5,Points,33,30,26,10
22023,202699,22300128,"NOV 02, 2023",PHI vs. TOR,W,40,10,17,0.588,2,6,0.333,1,2,0.5,0,7,7,3,3,0,2,1,23,6,1,Tobias Harris,PHI,PHI,TOR,5.5,Rebounds,33,30,26,10
22023,202699,22300128,"NOV 02, 2023",PHI vs. TOR,W,40,10,17,0.588,2,6,0.333,1,2,0.5,0,7,7,3,3,0,2,1,23,6,1,Tobias Harris,PHI,PHI,TOR,26.5,Pts+Rebs+Asts,33,30,26,10
22023,202699,22300128,"NOV 02, 2023",PHI vs. TOR,W,40,10,17,0.588,2,6,0.333,1,2,0.5,0,7,7,3,3,0,2,1,23,6,1,Tobias Harris,PHI,PHI,TOR,29.5,Fantasy Score,33,30,26,10
22023,202699,22300128,"NOV 02, 2023",PHI vs. TOR,W,40,10,17,0.588,2,6,0.333,1,2,0.5,0,7,7,3,3,0,2,1,23,6,1,Tobias Harris,PHI,PHI,TOR,22.5,Pts+Rebs,33,30,26,10
22023,202699,22300128,"NOV 02, 2023",PHI vs. TOR,W,40,10,17,0.588,2,6,0.333,1,2,0.5,0,7,7,3,3,0,2,1,23,6,1,Tobias Harris,PHI,PHI,TOR,0.5,Dunks,33,30,26,10
22023,202699,22300128,"NOV 02, 2023",PHI vs. TOR,W,40,10,17,0.588,2,6,0.333,1,2,0.5,0,7,7,3,3,0,2,1,23,6,1,Tobias Harris,PHI,PHI,TOR,20.5,Pts+Asts,33,30,26,10
22023,202699,22300128,"NOV 02, 2023",PHI vs. TOR,W,40,10,17,0.588,2,6,0.333,1,2,0.5,0,7,7,3,3,0,2,1,23,6,1,Tobias Harris,PHI,PHI,TOR,1.5,3-PT Made,33,30,26,10
22023,202699,22300128,"NOV 02, 2023",PHI vs. TOR,W,40,10,17,0.588,2,6,0.333,1,2,0.5,0,7,7,3,3,0,2,1,23,6,1,Tobias Harris,PHI,PHI,TOR,0.5,Blocked Shots,33,30,26,10
22023,202699,22300128,"NOV 02, 2023",PHI vs. TOR,W,40,10,17,0.588,2,6,0.333,1,2,0.5,0,7,7,3,3,0,2,1,23,6,1,Tobias Harris,PHI,PHI,TOR,9.0,Rebs+Asts,33,30,26,10
22023,202699,22300098,"OCT 29, 2023",PHI vs. POR,W,38,8,11,0.727,2,4,0.5,6,7,0.857,0,5,5,2,1,2,3,3,24,31,1,Tobias Harris,PHI,PHI,POR,16.5,Points,31,29,26,7
22023,202699,22300098,"OCT 29, 2023",PHI vs. POR,W,38,8,11,0.727,2,4,0.5,6,7,0.857,0,5,5,2,1,2,3,3,24,31,1,Tobias Harris,PHI,PHI,POR,5.5,Rebounds,31,29,26,7
22023,202699,22300098,"OCT 29, 2023",PHI vs. POR,W,38,8,11,0.727,2,4,0.5,6,7,0.857,0,5,5,2,1,2,3,3,24,31,1,Tobias Harris,PHI,PHI,POR,26.5,Pts+Rebs+Asts,31,29,26,7
22023,202699,22300098,"OCT 29, 2023",PHI vs. POR,W,38,8,11,0.727,2,4,0.5,6,7,0.857,0,5,5,2,1,2,3,3,24,31,1,Tobias Harris,PHI,PHI,POR,29.5,Fantasy Score,31,29,26,7
22023,202699,22300098,"OCT 29, 2023",PHI vs. POR,W,38,8,11,0.727,2,4,0.5,6,7,0.857,0,5,5,2,1,2,3,3,24,31,1,Tobias Harris,PHI,PHI,POR,22.5,Pts+Rebs,31,29,26,7
22023,202699,22300098,"OCT 29, 2023",PHI vs. POR,W,38,8,11,0.727,2,4,0.5,6,7,0.857,0,5,5,2,1,2,3,3,24,31,1,Tobias Harris,PHI,PHI,POR,0.5,Dunks,31,29,26,7
22023,202699,22300098,"OCT 29, 2023",PHI vs. POR,W,38,8,11,0.727,2,4,0.5,6,7,0.857,0,5,5,2,1,2,3,3,24,31,1,Tobias Harris,PHI,PHI,POR,20.5,Pts+Asts,31,29,26,7
22023,202699,22300098,"OCT 29, 2023",PHI vs. POR,W,38,8,11,0.727,2,4,0.5,6,7,0.857,0,5,5,2,1,2,3,3,24,31,1,Tobias Harris,PHI,PHI,POR,1.5,3-PT Made,31,29,26,7
22023,202699,22300098,"OCT 29, 2023",PHI vs. POR,W,38,8,11,0.727,2,4,0.5,6,7,0.857,0,5,5,2,1,2,3,3,24,31,1,Tobias Harris,PHI,PHI,POR,0.5,Blocked Shots,31,29,26,7
22023,202699,22300098,"OCT 29, 2023",PHI vs. POR,W,38,8,11,0.727,2,4,0.5,6,7,0.857,0,5,5,2,1,2,3,3,24,31,1,Tobias Harris,PHI,PHI,POR,9.0,Rebs+Asts,31,29,26,7
22023,202699,22300092,"OCT 28, 2023",PHI @ TOR,W,36,4,10,0.4,1,4,0.25,6,7,0.857,1,1,2,2,2,2,2,1,15,0,1,Tobias Harris,PHI,TOR,PHI,16.5,Points,19,17,17,4
22023,202699,22300092,"OCT 28, 2023",PHI @ TOR,W,36,4,10,0.4,1,4,0.25,6,7,0.857,1,1,2,2,2,2,2,1,15,0,1,Tobias Harris,PHI,TOR,PHI,5.5,Rebounds,19,17,17,4
22023,202699,22300092,"OCT 28, 2023",PHI @ TOR,W,36,4,10,0.4,1,4,0.25,6,7,0.857,1,1,2,2,2,2,2,1,15,0,1,Tobias Harris,PHI,TOR,PHI,26.5,Pts+Rebs+Asts,19,17,17,4
22023,202699,22300092,"OCT 28, 2023",PHI @ TOR,W,36,4,10,0.4,1,4,0.25,6,7,0.857,1,1,2,2,2,2,2,1,15,0,1,Tobias Harris,PHI,TOR,PHI,29.5,Fantasy Score,19,17,17,4
22023,202699,22300092,"OCT 28, 2023",PHI @ TOR,W,36,4,10,0.4,1,4,0.25,6,7,0.857,1,1,2,2,2,2,2,1,15,0,1,Tobias Harris,PHI,TOR,PHI,22.5,Pts+Rebs,19,17,17,4
22023,202699,22300092,"OCT 28, 2023",PHI @ TOR,W,36,4,10,0.4,1,4,0.25,6,7,0.857,1,1,2,2,2,2,2,1,15,0,1,Tobias Harris,PHI,TOR,PHI,0.5,Dunks,19,17,17,4
22023,202699,22300092,"OCT 28, 2023",PHI @ TOR,W,36,4,10,0.4,1,4,0.25,6,7,0.857,1,1,2,2,2,2,2,1,15,0,1,Tobias Harris,PHI,TOR,PHI,20.5,Pts+Asts,19,17,17,4
22023,202699,22300092,"OCT 28, 2023",PHI @ TOR,W,36,4,10,0.4,1,4,0.25,6,7,0.857,1,1,2,2,2,2,2,1,15,0,1,Tobias Harris,PHI,TOR,PHI,1.5,3-PT Made,19,17,17,4
22023,202699,22300092,"OCT 28, 2023",PHI @ TOR,W,36,4,10,0.4,1,4,0.25,6,7,0.857,1,1,2,2,2,2,2,1,15,0,1,Tobias Harris,PHI,TOR,PHI,0.5,Blocked Shots,19,17,17,4
22023,202699,22300092,"OCT 28, 2023",PHI @ TOR,W,36,4,10,0.4,1,4,0.25,6,7,0.857,1,1,2,2,2,2,2,1,15,0,1,Tobias Harris,PHI,TOR,PHI,9.0,Rebs+Asts,19,17,17,4
22023,202699,22300075,"OCT 26, 2023",PHI @ MIL,L,37,8,9,0.889,3,3,1.0,1,2,0.5,0,7,7,2,0,0,2,2,20,-14,1,Tobias Harris,PHI,MIL,PHI,16.5,Points,29,27,22,9
22023,202699,22300075,"OCT 26, 2023",PHI @ MIL,L,37,8,9,0.889,3,3,1.0,1,2,0.5,0,7,7,2,0,0,2,2,20,-14,1,Tobias Harris,PHI,MIL,PHI,5.5,Rebounds,29,27,22,9
22023,202699,22300075,"OCT 26, 2023",PHI @ MIL,L,37,8,9,0.889,3,3,1.0,1,2,0.5,0,7,7,2,0,0,2,2,20,-14,1,Tobias Harris,PHI,MIL,PHI,26.5,Pts+Rebs+Asts,29,27,22,9
22023,202699,22300075,"OCT 26, 2023",PHI @ MIL,L,37,8,9,0.889,3,3,1.0,1,2,0.5,0,7,7,2,0,0,2,2,20,-14,1,Tobias Harris,PHI,MIL,PHI,29.5,Fantasy Score,29,27,22,9
22023,202699,22300075,"OCT 26, 2023",PHI @ MIL,L,37,8,9,0.889,3,3,1.0,1,2,0.5,0,7,7,2,0,0,2,2,20,-14,1,Tobias Harris,PHI,MIL,PHI,22.5,Pts+Rebs,29,27,22,9
22023,202699,22300075,"OCT 26, 2023",PHI @ MIL,L,37,8,9,0.889,3,3,1.0,1,2,0.5,0,7,7,2,0,0,2,2,20,-14,1,Tobias Harris,PHI,MIL,PHI,0.5,Dunks,29,27,22,9
22023,202699,22300075,"OCT 26, 2023",PHI @ MIL,L,37,8,9,0.889,3,3,1.0,1,2,0.5,0,7,7,2,0,0,2,2,20,-14,1,Tobias Harris,PHI,MIL,PHI,20.5,Pts+Asts,29,27,22,9
22023,202699,22300075,"OCT 26, 2023",PHI @ MIL,L,37,8,9,0.889,3,3,1.0,1,2,0.5,0,7,7,2,0,0,2,2,20,-14,1,Tobias Harris,PHI,MIL,PHI,1.5,3-PT Made,29,27,22,9
22023,202699,22300075,"OCT 26, 2023",PHI @ MIL,L,37,8,9,0.889,3,3,1.0,1,2,0.5,0,7,7,2,0,0,2,2,20,-14,1,Tobias Harris,PHI,MIL,PHI,0.5,Blocked Shots,29,27,22,9
22023,202699,22300075,"OCT 26, 2023",PHI @ MIL,L,37,8,9,0.889,3,3,1.0,1,2,0.5,0,7,7,2,0,0,2,2,20,-14,1,Tobias Harris,PHI,MIL,PHI,9.0,Rebs+Asts,29,27,22,9
22023,1628404,22300557,"JAN 15, 2024",NYK vs. ORL,L,24,2,7,0.286,0,2,0.0,0,0,0.0,1,5,6,1,0,0,1,2,4,-13,1,Josh Hart,NYK,NYK,ORL,,,11,10,5,7
22023,1628404,22300544,"JAN 13, 2024",NYK @ MEM,W,29,3,7,0.429,2,4,0.5,0,0,0.0,0,7,7,3,2,0,2,2,8,7,1,Josh Hart,NYK,MEM,NYK,,,18,15,11,10
22023,1628404,22300530,"JAN 11, 2024",NYK @ DAL,L,23,1,4,0.25,0,3,0.0,2,3,0.667,3,1,4,2,0,0,1,3,4,-11,1,Josh Hart,NYK,DAL,NYK,,,10,8,6,6
22023,1628404,22300514,"JAN 09, 2024",NYK vs. POR,W,26,1,4,0.25,0,2,0.0,0,0,0.0,1,6,7,4,0,0,3,3,2,12,1,Josh Hart,NYK,NYK,POR,,,13,9,6,11
22023,1628404,22300494,"JAN 06, 2024",NYK @ WAS,W,32,3,8,0.375,1,4,0.25,2,2,1.0,2,2,4,1,0,0,2,1,9,24,1,Josh Hart,NYK,WAS,NYK,,,14,13,10,5
22023,1628404,22300483,"JAN 05, 2024",NYK @ PHI,W,30,4,7,0.571,0,2,0.0,2,2,1.0,3,12,15,6,0,1,2,2,10,46,1,Josh Hart,NYK,PHI,NYK,,,31,25,16,21
22023,1628404,22300468,"JAN 03, 2024",NYK vs. CHI,W,25,1,5,0.2,1,2,0.5,0,0,0.0,1,4,5,3,0,0,2,2,3,2,1,Josh Hart,NYK,NYK,CHI,,,11,8,6,8
22023,1628404,22300451,"JAN 01, 2024",NYK vs. MIN,W,29,3,7,0.429,2,3,0.667,0,0,0.0,2,9,11,2,0,0,1,2,8,-12,1,Josh Hart,NYK,NYK,MIN,,,21,19,10,13
22023,1628404,22300441,"DEC 30, 2023",NYK @ IND,L,38,4,9,0.444,1,2,0.5,1,2,0.5,3,7,10,1,1,0,0,3,10,-19,1,Josh Hart,NYK,IND,NYK,,,21,20,11,11
22023,1628404,22300429,"DEC 29, 2023",NYK @ ORL,L,31,2,4,0.5,1,2,0.5,0,0,0.0,0,4,4,0,0,0,2,2,5,6,1,Josh Hart,NYK,ORL,NYK,,,9,9,5,4
22023,1628404,22300419,"DEC 27, 2023",NYK @ OKC,L,34,1,4,0.25,0,2,0.0,2,2,1.0,2,5,7,6,0,0,1,1,4,-4,1,Josh Hart,NYK,OKC,NYK,,,17,11,10,13
22023,1628404,22300401,"DEC 25, 2023",NYK vs. MIL,W,31,5,7,0.714,0,2,0.0,0,0,0.0,0,9,9,4,2,0,2,1,10,7,1,Josh Hart,NYK,NYK,MIL,,,23,19,14,13
22023,1628404,22300388,"DEC 23, 2023",NYK vs. MIL,L,26,1,6,0.167,0,3,0.0,0,0,0.0,0,2,2,3,1,0,1,3,2,-19,1,Josh Hart,NYK,NYK,MIL,,,7,4,5,5
22023,1628404,22300368,"DEC 20, 2023",NYK @ BKN,W,31,2,5,0.4,2,3,0.667,4,4,1.0,2,11,13,3,1,0,2,2,10,6,1,Josh Hart,NYK,BKN,NYK,,,26,23,13,16
22023,1628404,22300359,"DEC 18, 2023",NYK @ LAL,W,22,2,6,0.333,0,3,0.0,2,2,1.0,0,5,5,2,0,1,4,1,6,0,1,Josh Hart,NYK,LAL,NYK,,,13,11,8,7
22023,1628404,22300343,"DEC 16, 2023",NYK @ LAC,L,8,0,1,0.0,0,0,0.0,0,0,0.0,0,1,1,1,1,0,1,2,0,1,1,Josh Hart,NYK,LAC,NYK,,,2,1,1,2
22023,1628404,22300333,"DEC 15, 2023",NYK @ PHX,W,29,3,8,0.375,0,3,0.0,0,0,0.0,2,0,2,2,0,0,0,0,6,34,1,Josh Hart,NYK,PHX,NYK,,,10,8,8,4
22023,1628404,22300318,"DEC 13, 2023",NYK @ UTA,L,29,0,5,0.0,0,4,0.0,0,0,0.0,0,2,2,2,1,0,0,2,0,-7,1,Josh Hart,NYK,UTA,NYK,,,4,2,2,4
22023,1628404,22300297,"DEC 11, 2023",NYK vs. TOR,W,31,6,8,0.75,3,3,1.0,1,2,0.5,3,4,7,8,1,0,1,4,16,8,1,Josh Hart,NYK,NYK,TOR,,,31,23,24,15
22023,1628404,22301227,"DEC 08, 2023",NYK @ BOS,L,27,2,4,0.5,2,3,0.667,0,0,0.0,1,5,6,7,0,0,1,4,6,5,1,Josh Hart,NYK,BOS,NYK,,,19,12,13,13
22023,1628404,22301201,"DEC 05, 2023",NYK @ MIL,L,26,5,8,0.625,1,1,1.0,0,0,0.0,1,3,4,1,3,0,0,3,11,-14,1,Josh Hart,NYK,MIL,NYK,,,16,15,12,5
22023,1628404,22300276,"DEC 01, 2023",NYK @ TOR,W,31,7,11,0.636,3,4,0.75,0,0,0.0,3,5,8,2,0,1,3,3,17,11,1,Josh Hart,NYK,TOR,NYK,,,27,25,19,10
22023,1628404,22300268,"NOV 30, 2023",NYK vs. DET,W,32,2,3,0.667,1,2,0.5,2,4,0.5,0,7,7,2,2,0,1,2,7,6,1,Josh Hart,NYK,NYK,DET,,,16,14,9,9
22023,1628404,22300057,"NOV 28, 2023",NYK vs. CHA,W,30,7,10,0.7,2,3,0.667,1,1,1.0,1,5,6,2,1,1,1,2,17,25,1,Josh Hart,NYK,NYK,CHA,,,25,23,19,8
22023,1628404,22300247,"NOV 26, 2023",NYK vs. PHX,L,24,1,3,0.333,0,2,0.0,2,2,1.0,0,3,3,2,0,0,0,0,4,1,1,Josh Hart,NYK,NYK,PHX,,,9,7,6,5
22023,1628404,22300045,"NOV 24, 2023",NYK vs. MIA,W,26,4,7,0.571,1,3,0.333,1,1,1.0,1,7,8,4,1,0,1,1,10,5,1,Josh Hart,NYK,NYK,MIA,,,22,18,14,12
22023,1628404,22300221,"NOV 20, 2023",NYK @ MIN,L,24,2,6,0.333,0,2,0.0,0,0,0.0,1,1,2,1,2,0,0,0,4,-5,1,Josh Hart,NYK,MIN,NYK,,,7,6,5,3
22023,1628404,22300202,"NOV 18, 2023",NYK @ CHA,W,29,3,5,0.6,1,2,0.5,0,0,0.0,0,6,6,4,3,0,0,0,7,7,1,Josh Hart,NYK,CHA,NYK,,,17,13,11,10
22023,1628404,22300028,"NOV 17, 2023",NYK @ WAS,W,32,4,7,0.571,1,2,0.5,0,0,0.0,1,4,5,2,0,2,1,1,9,27,1,Josh Hart,NYK,WAS,NYK,,,16,14,11,7
22023,1628404,22300193,"NOV 15, 2023",NYK @ ATL,W,33,4,9,0.444,1,4,0.25,0,0,0.0,2,6,8,5,0,1,2,4,9,7,1,Josh Hart,NYK,ATL,NYK,,,22,17,14,13
22023,1628404,22300188,"NOV 13, 2023",NYK @ BOS,L,43,6,12,0.5,3,6,0.5,1,2,0.5,2,7,9,3,1,0,2,4,16,-10,1,Josh Hart,NYK,BOS,NYK,,,28,25,19,12
22023,1628404,22300177,"NOV 12, 2023",NYK vs. CHA,W,27,3,6,0.5,0,2,0.0,0,0,0.0,1,3,4,2,0,0,0,1,6,16,1,Josh Hart,NYK,NYK,CHA,,,12,10,8,6
22023,1628404,22300161,"NOV 08, 2023",NYK vs. SAS,W,24,1,3,0.333,1,2,0.5,0,0,0.0,0,5,5,0,1,0,0,0,3,-3,1,Josh Hart,NYK,NYK,SAS,,,8,8,3,5
22023,1628404,22300151,"NOV 06, 2023",NYK vs. LAC,W,32,4,9,0.444,1,4,0.25,1,1,1.0,0,3,3,7,2,0,2,2,10,13,1,Josh Hart,NYK,NYK,LAC,,,20,13,17,10
22023,1628404,22300002,"NOV 03, 2023",NYK @ MIL,L,36,2,9,0.222,0,4,0.0,2,2,1.0,2,8,10,5,3,1,0,4,6,1,1,Josh Hart,NYK,MIL,NYK,,,21,16,11,15
22023,1628404,22300120,"NOV 01, 2023",NYK vs. CLE,L,29,5,14,0.357,1,5,0.2,0,0,0.0,3,5,8,3,0,0,2,1,11,-5,1,Josh Hart,NYK,NYK,CLE,,,22,19,14,11
22023,1628404,22300112,"OCT 31, 2023",NYK @ CLE,W,28,2,6,0.333,1,3,0.333,0,0,0.0,0,7,7,3,0,0,1,2,5,2,1,Josh Hart,NYK,CLE,NYK,,,15,12,8,10
22023,1628404,22300090,"OCT 28, 2023",NYK @ NOP,L,21,1,5,0.2,1,3,0.333,0,0,0.0,2,8,10,2,1,0,2,2,3,-10,1,Josh Hart,NYK,NOP,NYK,,,15,13,5,12
22023,1628404,22300079,"OCT 27, 2023",NYK @ ATL,W,22,2,4,0.5,0,1,0.0,0,0,0.0,0,3,3,0,1,0,0,3,4,-2,1,Josh Hart,NYK,ATL,NYK,,,7,7,4,3
22023,1628404,22300065,"OCT 25, 2023",NYK vs. BOS,L,22,2,4,0.5,2,4,0.5,1,2,0.5,1,5,6,0,0,0,1,1,7,-1,1,Josh Hart,NYK,NYK,BOS,,,13,13,7,6
22023,1628392,22300557,"JAN 15, 2024",NYK vs. ORL,L,28,3,6,0.5,0,0,0.0,1,1,1.0,5,7,12,3,0,0,2,5,7,0,1,Isaiah Hartenstein,NYK,NYK,ORL,,,22,19,10,15
22023,1628392,22300544,"JAN 13, 2024",NYK @ MEM,W,42,5,6,0.833,0,0,0.0,2,4,0.5,7,13,20,2,2,4,3,1,12,7,1,Isaiah Hartenstein,NYK,MEM,NYK,,,34,32,14,22
22023,1628392,22300530,"JAN 11, 2024",NYK @ DAL,L,32,2,3,0.667,0,0,0.0,4,4,1.0,5,10,15,3,1,0,0,4,8,-7,1,Isaiah Hartenstein,NYK,DAL,NYK,,,26,23,11,18
22023,1628392,22300514,"JAN 09, 2024",NYK vs. POR,W,28,1,1,1.0,0,0,0.0,3,4,0.75,5,9,14,3,3,1,2,3,5,31,1,Isaiah Hartenstein,NYK,NYK,POR,,,22,19,8,17
22023,1628392,22300494,"JAN 06, 2024",NYK @ WAS,W,39,4,8,0.5,0,0,0.0,0,0,0.0,2,17,19,2,4,2,5,3,8,29,1,Isaiah Hartenstein,NYK,WAS,NYK,,,29,27,10,21
22023,1628392,22300483,"JAN 05, 2024",NYK @ PHI,W,35,8,9,0.889,0,0,0.0,1,2,0.5,1,5,6,5,2,2,1,4,17,26,1,Isaiah Hartenstein,NYK,PHI,NYK,,,28,23,22,11
22023,1628392,22300468,"JAN 03, 2024",NYK vs. CHI,W,37,4,6,0.667,0,0,0.0,2,3,0.667,7,13,20,1,0,5,2,2,10,32,1,Isaiah Hartenstein,NYK,NYK,CHI,,,31,30,11,21
22023,1628392,22300451,"JAN 01, 2024",NYK vs. MIN,W,39,2,3,0.667,0,0,0.0,3,4,0.75,4,5,9,3,3,3,1,3,7,10,1,Isaiah Hartenstein,NYK,NYK,MIN,,,19,16,10,12
22023,1628392,22300441,"DEC 30, 2023",NYK @ IND,L,33,1,3,0.333,0,0,0.0,0,0,0.0,2,7,9,6,4,0,1,3,2,-4,1,Isaiah Hartenstein,NYK,IND,NYK,,,17,11,8,15
22023,1628392,22300429,"DEC 29, 2023",NYK @ ORL,L,25,2,4,0.5,0,0,0.0,3,3,1.0,1,2,3,3,3,0,2,4,7,-18,1,Isaiah Hartenstein,NYK,ORL,NYK,,,13,10,10,6
22023,1628392,22300419,"DEC 27, 2023",NYK @ OKC,L,37,2,6,0.333,0,0,0.0,0,0,0.0,3,6,9,2,0,1,2,3,4,4,1,Isaiah Hartenstein,NYK,OKC,NYK,,,15,13,6,11
22023,1628392,22300401,"DEC 25, 2023",NYK vs. MIL,W,33,5,7,0.714,0,0,0.0,1,2,0.5,4,4,8,4,0,1,0,4,11,3,1,Isaiah Hartenstein,NYK,NYK,MIL,,,23,19,15,12
22023,1628392,22300388,"DEC 23, 2023",NYK vs. MIL,L,33,4,5,0.8,0,0,0.0,4,4,1.0,7,6,13,1,1,0,1,4,12,-14,1,Isaiah Hartenstein,NYK,NYK,MIL,,,26,25,13,14
22023,1628392,22300368,"DEC 20, 2023",NYK @ BKN,W,30,1,3,0.333,0,0,0.0,0,0,0.0,5,5,10,3,0,2,0,1,2,21,1,Isaiah Hartenstein,NYK,BKN,NYK,,,15,12,5,13
22023,1628392,22300359,"DEC 18, 2023",NYK @ LAL,W,39,3,4,0.75,0,0,0.0,3,6,0.5,7,10,17,2,2,2,1,3,9,15,1,Isaiah Hartenstein,NYK,LAL,NYK,,,28,26,11,19
22023,1628392,22300343,"DEC 16, 2023",NYK @ LAC,L,30,5,7,0.714,0,0,0.0,2,4,0.5,6,4,10,2,0,3,3,3,12,-9,1,Isaiah Hartenstein,NYK,LAC,NYK,,,24,22,14,12
22023,1628392,22300333,"DEC 15, 2023",NYK @ PHX,W,31,2,2,1.0,0,0,0.0,3,4,0.75,1,7,8,2,1,3,2,3,7,29,1,Isaiah Hartenstein,NYK,PHX,NYK,,,17,15,9,10
22023,1628392,22300318,"DEC 13, 2023",NYK @ UTA,L,29,3,4,0.75,0,0,0.0,1,1,1.0,3,3,6,0,0,2,0,3,7,5,1,Isaiah Hartenstein,NYK,UTA,NYK,,,13,13,7,6
22023,1628392,22300297,"DEC 11, 2023",NYK vs. TOR,W,27,4,7,0.571,0,0,0.0,3,4,0.75,5,3,8,2,2,1,2,4,11,0,1,Isaiah Hartenstein,NYK,NYK,TOR,,,21,19,13,10
22023,1628392,22301227,"DEC 08, 2023",NYK @ BOS,L,29,2,4,0.5,0,0,0.0,1,2,0.5,4,12,16,4,0,2,1,4,5,9,1,Isaiah Hartenstein,NYK,BOS,NYK,,,25,21,9,20
22023,1628392,22301201,"DEC 05, 2023",NYK @ MIL,L,18,2,3,0.667,0,0,0.0,0,0,0.0,4,3,7,5,0,2,1,2,4,-12,1,Isaiah Hartenstein,NYK,MIL,NYK,,,16,11,9,12
22023,1628392,22300276,"DEC 01, 2023",NYK @ TOR,W,16,1,3,0.333,0,0,0.0,2,3,0.667,2,6,8,0,0,1,0,1,4,7,1,Isaiah Hartenstein,NYK,TOR,NYK,,,12,12,4,8
22023,1628392,22300268,"NOV 30, 2023",NYK vs. DET,W,17,1,1,1.0,0,0,0.0,0,0,0.0,2,1,3,0,2,0,2,3,2,-2,1,Isaiah Hartenstein,NYK,NYK,DET,,,5,5,2,3
22023,1628392,22300057,"NOV 28, 2023",NYK vs. CHA,W,14,2,3,0.667,0,0,0.0,0,0,0.0,3,3,6,2,0,0,0,2,4,7,1,Isaiah Hartenstein,NYK,NYK,CHA,,,12,10,6,8
22023,1628392,22300247,"NOV 26, 2023",NYK vs. PHX,L,14,2,3,0.667,0,0,0.0,3,4,0.75,4,1,5,1,0,1,0,3,7,-2,1,Isaiah Hartenstein,NYK,NYK,PHX,,,13,12,8,6
22023,1628392,22300045,"NOV 24, 2023",NYK vs. MIA,W,28,1,3,0.333,0,0,0.0,0,0,0.0,1,4,5,1,2,1,1,3,2,18,1,Isaiah Hartenstein,NYK,NYK,MIA,,,8,7,3,6
22023,1628392,22300221,"NOV 20, 2023",NYK @ MIN,L,14,1,3,0.333,0,0,0.0,0,0,0.0,2,2,4,0,0,1,1,3,2,-6,1,Isaiah Hartenstein,NYK,MIN,NYK,,,6,6,2,4
22023,1628392,22300202,"NOV 18, 2023",NYK @ CHA,W,15,1,2,0.5,0,0,0.0,2,2,1.0,2,5,7,0,0,0,1,1,4,5,1,Isaiah Hartenstein,NYK,CHA,NYK,,,11,11,4,7
22023,1628392,22300028,"NOV 17, 2023",NYK @ WAS,W,20,1,3,0.333,0,0,0.0,1,2,0.5,3,5,8,2,1,1,1,4,3,4,1,Isaiah Hartenstein,NYK,WAS,NYK,,,13,11,5,10
22023,1628392,22300193,"NOV 15, 2023",NYK @ ATL,W,17,5,9,0.556,0,0,0.0,1,1,1.0,3,1,4,0,1,0,0,2,11,-5,1,Isaiah Hartenstein,NYK,ATL,NYK,,,15,15,11,4
22023,1628392,22300188,"NOV 13, 2023",NYK @ BOS,L,15,1,2,0.5,1,1,1.0,0,0,0.0,3,0,3,1,1,0,0,0,3,-2,1,Isaiah Hartenstein,NYK,BOS,NYK,,,7,6,4,4
22023,1628392,22300177,"NOV 12, 2023",NYK vs. CHA,W,18,2,3,0.667,0,0,0.0,2,4,0.5,2,4,6,1,1,2,2,6,6,24,1,Isaiah Hartenstein,NYK,NYK,CHA,,,13,12,7,7
22023,1628392,22300161,"NOV 08, 2023",NYK vs. SAS,W,15,6,9,0.667,0,0,0.0,1,1,1.0,3,0,3,0,2,0,0,4,13,-7,1,Isaiah Hartenstein,NYK,NYK,SAS,,,16,16,13,3
22023,1628392,22300151,"NOV 06, 2023",NYK vs. LAC,W,13,3,5,0.6,0,0,0.0,0,0,0.0,2,1,3,2,2,0,0,2,6,10,1,Isaiah Hartenstein,NYK,NYK,LAC,,,11,9,8,5
22023,1628392,22300002,"NOV 03, 2023",NYK @ MIL,L,18,2,3,0.667,0,0,0.0,0,0,0.0,1,2,3,0,0,0,2,3,4,-1,1,Isaiah Hartenstein,NYK,MIL,NYK,,,7,7,4,3
22023,1628392,22300120,"NOV 01, 2023",NYK vs. CLE,L,16,0,2,0.0,0,0,0.0,0,0,0.0,2,4,6,2,3,0,2,2,0,-5,1,Isaiah Hartenstein,NYK,NYK,CLE,,,8,6,2,8
22023,1628392,22300112,"OCT 31, 2023",NYK @ CLE,W,23,5,10,0.5,0,2,0.0,3,3,1.0,4,3,7,1,2,1,1,3,13,12,1,Isaiah Hartenstein,NYK,CLE,NYK,,,21,20,14,8
22023,1628392,22300090,"OCT 28, 2023",NYK @ NOP,L,15,1,1,1.0,0,0,0.0,2,4,0.5,1,2,3,1,0,0,0,0,4,-8,1,Isaiah Hartenstein,NYK,NOP,NYK,,,8,7,5,4
22023,1628392,22300079,"OCT 27, 2023",NYK @ ATL,W,10,3,4,0.75,0,0,0.0,2,4,0.5,1,1,2,1,1,1,1,4,8,-5,1,Isaiah Hartenstein,NYK,ATL,NYK,,,11,10,9,3
22023,1628392,22300065,"OCT 25, 2023",NYK vs. BOS,L,26,3,4,0.75,0,0,0.0,1,2,0.5,5,3,8,2,0,0,1,5,7,-5,1,Isaiah Hartenstein,NYK,NYK,BOS,,,17,15,9,10
22023,1630573,22300563,"JAN 15, 2024",BOS @ TOR,W,16,1,2,0.5,1,1,1.0,0,0,0.0,0,5,5,0,0,1,0,0,3,5,1,Sam Hauser,BOS,TOR,BOS,,,8,8,3,5
22023,1630573,22300542,"JAN 13, 2024",BOS vs. HOU,W,20,2,9,0.222,2,8,0.25,0,0,0.0,0,6,6,0,0,0,0,0,6,20,1,Sam Hauser,BOS,BOS,HOU,,,12,12,6,6
22023,1630573,22300528,"JAN 11, 2024",BOS @ MIL,L,24,4,8,0.5,4,8,0.5,3,3,1.0,1,3,4,0,1,0,1,1,15,-16,1,Sam Hauser,BOS,MIL,BOS,,,19,19,15,4
22023,1630573,22300517,"JAN 10, 2024",BOS vs. MIN,W,18,2,6,0.333,2,5,0.4,0,0,0.0,0,4,4,0,0,1,0,2,6,-2,1,Sam Hauser,BOS,BOS,MIN,,,10,10,6,4
22023,1630573,22300493,"JAN 06, 2024",BOS @ IND,W,16,2,6,0.333,1,5,0.2,0,0,0.0,0,4,4,1,0,0,1,4,5,2,1,Sam Hauser,BOS,IND,BOS,,,10,9,6,5
22023,1630573,22300479,"JAN 05, 2024",BOS vs. UTA,W,23,5,10,0.5,3,7,0.429,0,0,0.0,1,4,5,1,1,0,0,1,13,17,1,Sam Hauser,BOS,BOS,UTA,,,19,18,14,6
22023,1630573,22300462,"JAN 02, 2024",BOS @ OKC,L,10,2,3,0.667,2,3,0.667,0,0,0.0,0,1,1,0,0,0,0,0,6,-7,1,Sam Hauser,BOS,OKC,BOS,,,7,7,6,1
22023,1630573,22300448,"DEC 31, 2023",BOS @ SAS,W,20,4,6,0.667,3,5,0.6,0,0,0.0,0,4,4,1,0,0,1,2,11,15,1,Sam Hauser,BOS,SAS,BOS,,,16,15,12,5
22023,1630573,22300432,"DEC 29, 2023",BOS vs. TOR,W,34,3,7,0.429,3,7,0.429,0,0,0.0,0,9,9,1,0,1,0,2,9,-8,1,Sam Hauser,BOS,BOS,TOR,,,19,18,10,10
22023,1630573,22300421,"DEC 28, 2023",BOS vs. DET,W,18,2,6,0.333,1,4,0.25,0,0,0.0,1,2,3,1,0,0,1,0,5,-8,1,Sam Hauser,BOS,BOS,DET,,,9,8,6,4
22023,1630573,22300403,"DEC 25, 2023",BOS @ LAL,W,15,1,5,0.2,0,4,0.0,0,0,0.0,1,1,2,0,0,0,0,0,2,3,1,Sam Hauser,BOS,LAL,BOS,,,4,4,2,2
22023,1630573,22300389,"DEC 23, 2023",BOS @ LAC,W,19,1,5,0.2,1,5,0.2,0,0,0.0,0,2,2,4,0,0,0,3,3,11,1,Sam Hauser,BOS,LAC,BOS,,,9,5,7,6
22023,1630573,22300373,"DEC 20, 2023",BOS @ SAC,W,35,4,6,0.667,2,4,0.5,0,0,0.0,0,5,5,1,0,0,0,3,10,24,1,Sam Hauser,BOS,SAC,BOS,,,16,15,11,6
22023,1630573,22300362,"DEC 19, 2023",BOS @ GSW,L,21,0,7,0.0,0,6,0.0,0,0,0.0,1,2,3,1,0,0,0,2,0,1,1,Sam Hauser,BOS,GSW,BOS,,,4,3,1,4
22023,1630573,22300344,"DEC 17, 2023",BOS vs. ORL,W,17,2,5,0.4,0,3,0.0,0,0,0.0,1,1,2,0,1,0,1,0,4,12,1,Sam Hauser,BOS,BOS,ORL,,,6,6,4,2
22023,1630573,22300329,"DEC 15, 2023",BOS vs. ORL,W,32,4,8,0.5,3,6,0.5,0,0,0.0,2,5,7,4,4,0,1,1,11,19,1,Sam Hauser,BOS,BOS,ORL,,,22,18,15,11
22023,1630573,22300319,"DEC 14, 2023",BOS vs. CLE,W,18,3,3,1.0,3,3,1.0,0,0,0.0,0,0,0,1,0,0,0,2,9,9,1,Sam Hauser,BOS,BOS,CLE,,,10,9,10,1
22023,1630573,22300305,"DEC 12, 2023",BOS vs. CLE,W,20,3,5,0.6,3,4,0.75,0,0,0.0,1,2,3,1,0,0,0,1,9,14,1,Sam Hauser,BOS,BOS,CLE,,,13,12,10,4
22023,1630573,22301227,"DEC 08, 2023",BOS vs. NYK,W,21,0,5,0.0,0,5,0.0,1,2,0.5,1,2,3,1,0,1,0,1,1,-10,1,Sam Hauser,BOS,BOS,NYK,,,5,4,2,4
22023,1630573,22301202,"DEC 04, 2023",BOS @ IND,L,23,5,9,0.556,5,7,0.714,0,0,0.0,2,4,6,1,0,0,0,2,15,9,1,Sam Hauser,BOS,IND,BOS,,,22,21,16,7
22023,1630573,22300275,"DEC 01, 2023",BOS vs. PHI,W,26,3,5,0.6,3,4,0.75,2,2,1.0,1,4,5,1,1,1,3,2,11,-3,1,Sam Hauser,BOS,BOS,PHI,,,17,16,12,6
22023,1630573,22300053,"NOV 28, 2023",BOS vs. CHI,W,21,3,12,0.25,2,10,0.2,1,2,0.5,4,6,10,2,0,0,2,1,9,13,1,Sam Hauser,BOS,BOS,CHI,,,21,19,11,12
22023,1630573,22300246,"NOV 26, 2023",BOS vs. ATL,W,32,4,9,0.444,4,9,0.444,0,0,0.0,2,2,4,2,0,0,0,2,12,11,1,Sam Hauser,BOS,BOS,ATL,,,18,16,14,6
22023,1630573,22300043,"NOV 24, 2023",BOS @ ORL,L,25,4,6,0.667,2,4,0.5,0,0,0.0,1,1,2,0,0,0,1,0,10,-16,1,Sam Hauser,BOS,ORL,BOS,,,12,12,10,2
22023,1630573,22300228,"NOV 22, 2023",BOS vs. MIL,W,20,4,5,0.8,2,3,0.667,0,0,0.0,1,1,2,1,0,1,1,2,10,10,1,Sam Hauser,BOS,BOS,MIL,,,13,12,11,3
22023,1630573,22300217,"NOV 20, 2023",BOS @ CHA,L,37,1,9,0.111,1,9,0.111,0,0,0.0,0,1,1,1,0,0,1,3,3,-22,1,Sam Hauser,BOS,CHA,BOS,,,5,4,4,2
22023,1630573,22300213,"NOV 19, 2023",BOS @ MEM,W,22,5,8,0.625,5,7,0.714,0,0,0.0,0,4,4,0,2,0,0,0,15,17,1,Sam Hauser,BOS,MEM,BOS,,,19,19,15,4
22023,1630573,22300031,"NOV 17, 2023",BOS @ TOR,W,23,4,7,0.571,3,6,0.5,0,0,0.0,1,2,3,3,1,0,0,0,11,8,1,Sam Hauser,BOS,TOR,BOS,,,17,14,14,6
22023,1630573,22300194,"NOV 15, 2023",BOS @ PHI,W,35,3,9,0.333,2,8,0.25,0,0,0.0,1,1,2,2,0,1,0,2,8,4,1,Sam Hauser,BOS,PHI,BOS,,,12,10,10,4
22023,1630573,22300188,"NOV 13, 2023",BOS vs. NYK,W,21,4,6,0.667,4,6,0.667,0,0,0.0,0,4,4,2,0,0,0,0,12,6,1,Sam Hauser,BOS,BOS,NYK,,,18,16,14,6
22023,1630573,22300174,"NOV 11, 2023",BOS vs. TOR,W,18,4,6,0.667,4,6,0.667,0,0,0.0,0,4,4,0,0,0,0,2,12,-2,1,Sam Hauser,BOS,BOS,TOR,,,16,16,12,4
22023,1630573,22300010,"NOV 10, 2023",BOS vs. BKN,W,25,5,10,0.5,5,10,0.5,0,0,0.0,1,1,2,1,0,0,0,1,15,-1,1,Sam Hauser,BOS,BOS,BKN,,,18,17,16,3
22023,1630573,22300159,"NOV 08, 2023",BOS @ PHI,L,19,5,8,0.625,3,6,0.5,0,0,0.0,0,4,4,0,1,1,0,0,13,-6,1,Sam Hauser,BOS,PHI,BOS,,,17,17,13,4
22023,1630573,22300154,"NOV 06, 2023",BOS @ MIN,L,25,3,8,0.375,3,8,0.375,2,2,1.0,1,3,4,0,1,1,1,3,11,-3,1,Sam Hauser,BOS,MIN,BOS,,,15,15,11,4
22023,1630573,22300136,"NOV 04, 2023",BOS @ BKN,W,19,2,3,0.667,1,2,0.5,0,0,0.0,0,1,1,0,2,0,1,3,5,-5,1,Sam Hauser,BOS,BKN,BOS,,,6,6,5,1
22023,1630573,22300118,"NOV 01, 2023",BOS vs. IND,W,19,5,7,0.714,5,6,0.833,2,2,1.0,0,3,3,0,1,0,1,3,17,23,1,Sam Hauser,BOS,BOS,IND,,,20,20,17,3
22023,1630573,22300103,"OCT 30, 2023",BOS @ WAS,W,25,3,10,0.3,2,9,0.222,0,0,0.0,3,5,8,1,0,1,1,3,8,-10,1,Sam Hauser,BOS,WAS,BOS,,,17,16,9,9
22023,1630573,22300080,"OCT 27, 2023",BOS vs. MIA,W,10,1,2,0.5,1,2,0.5,0,0,0.0,0,1,1,0,0,0,0,1,3,6,1,Sam Hauser,BOS,BOS,MIA,,,4,4,3,1
22023,1630573,22300065,"OCT 25, 2023",BOS @ NYK,W,14,0,4,0.0,0,4,0.0,0,0,0.0,0,2,2,0,1,1,0,1,0,5,1,Sam Hauser,BOS,NYK,BOS,,,2,2,0,2
22023,1641722,22300556,"JAN 15, 2024",NOP @ DAL,L,21,3,4,0.75,1,2,0.5,2,2,1.0,0,1,1,0,1,0,0,3,9,8,1,Jordan Hawkins,NOP,DAL,NOP,,,10,10,9,1
22023,1641722,22300547,"JAN 13, 2024",NOP @ DAL,W,37,11,19,0.579,6,12,0.5,6,8,0.75,3,2,5,4,2,0,3,3,34,10,1,Jordan Hawkins,NOP,DAL,NOP,,,43,39,38,9
22023,1641722,22300539,"JAN 12, 2024",NOP @ DEN,L,2,0,0,0.0,0,0,0.0,0,0,0.0,0,0,0,0,0,0,0,0,0,6,1,Jordan Hawkins,NOP,DEN,NOP,,,0,0,0,0
22023,1641722,22300525,"JAN 10, 2024",NOP @ GSW,W,21,5,9,0.556,4,5,0.8,0,0,0.0,0,1,1,2,0,0,0,1,14,25,1,Jordan Hawkins,NOP,GSW,NOP,,,17,15,16,3
22023,1641722,22300500,"JAN 07, 2024",NOP @ SAC,W,24,5,9,0.556,1,5,0.2,1,2,0.5,0,3,3,2,0,1,2,2,12,3,1,Jordan Hawkins,NOP,SAC,NOP,,,17,15,14,5
22023,1641722,22300486,"JAN 05, 2024",NOP vs. LAC,L,6,4,7,0.571,3,3,1.0,2,2,1.0,0,1,1,0,0,0,0,0,13,12,1,Jordan Hawkins,NOP,NOP,LAC,,,14,14,13,1
22023,1641722,22300471,"JAN 03, 2024",NOP @ MIN,W,3,1,2,0.5,0,1,0.0,0,0,0.0,0,0,0,0,0,0,0,0,2,-1,1,Jordan Hawkins,NOP,MIN,NOP,,,2,2,2,0
22023,1641722,22300461,"JAN 02, 2024",NOP vs. BKN,W,26,3,13,0.231,2,8,0.25,3,4,0.75,0,0,0,1,0,2,0,0,11,14,1,Jordan Hawkins,NOP,NOP,BKN,,,12,11,12,1
22023,1641722,22300446,"DEC 31, 2023",NOP vs. LAL,W,8,0,1,0.0,0,1,0.0,1,1,1.0,0,2,2,1,0,0,0,1,1,4,1,Jordan Hawkins,NOP,NOP,LAL,,,4,3,2,3
22023,1641722,22300375,"DEC 21, 2023",NOP @ CLE,W,12,2,5,0.4,2,3,0.667,0,0,0.0,0,0,0,2,0,0,0,1,6,-4,1,Jordan Hawkins,NOP,CLE,NOP,,,8,6,8,2
22023,1641722,22300345,"DEC 17, 2023",NOP @ SAS,W,12,3,6,0.5,1,4,0.25,0,0,0.0,0,2,2,0,0,0,0,0,7,-1,1,Jordan Hawkins,NOP,SAS,NOP,,,9,9,7,2
22023,1641722,22300326,"DEC 15, 2023",NOP @ CHA,W,4,0,1,0.0,0,1,0.0,0,0,0.0,0,0,0,0,0,0,0,0,0,-3,1,Jordan Hawkins,NOP,CHA,NOP,,,0,0,0,0
22023,1641722,22300311,"DEC 13, 2023",NOP @ WAS,W,19,1,7,0.143,0,2,0.0,0,0,0.0,1,1,2,1,0,0,0,1,2,15,1,Jordan Hawkins,NOP,WAS,NOP,,,5,4,3,3
22023,1641722,22300301,"DEC 11, 2023",NOP vs. MIN,W,1,0,1,0.0,0,0,0.0,0,0,0.0,0,0,0,0,0,0,0,0,0,-3,1,Jordan Hawkins,NOP,NOP,MIN,,,0,0,0,0
22023,1641722,22301230,"DEC 07, 2023",NOP @ LAL,L,12,2,8,0.25,0,3,0.0,0,0,0.0,0,2,2,0,0,0,0,1,4,-5,1,Jordan Hawkins,NOP,LAL,NOP,,,6,6,4,2
22023,1641722,22300285,"DEC 02, 2023",NOP @ CHI,L,25,2,6,0.333,2,5,0.4,4,4,1.0,0,1,1,0,0,0,0,2,10,-9,1,Jordan Hawkins,NOP,CHI,NOP,,,11,11,10,1
22023,1641722,22300278,"DEC 01, 2023",NOP vs. SAS,W,15,1,3,0.333,1,2,0.5,0,0,0.0,0,0,0,0,0,0,1,1,3,-9,1,Jordan Hawkins,NOP,NOP,SAS,,,3,3,3,0
22023,1641722,22300262,"NOV 29, 2023",NOP vs. PHI,W,24,4,10,0.4,3,8,0.375,5,6,0.833,2,3,5,2,0,0,2,2,16,-7,1,Jordan Hawkins,NOP,NOP,PHI,,,23,21,18,7
22023,1641722,22300256,"NOV 27, 2023",NOP @ UTA,L,25,5,11,0.455,3,6,0.5,0,0,0.0,1,4,5,0,0,0,0,1,13,-8,1,Jordan Hawkins,NOP,UTA,NOP,,,18,18,13,5
22023,1641722,22300243,"NOV 25, 2023",NOP @ UTA,L,40,8,17,0.471,5,12,0.417,4,5,0.8,1,5,6,3,1,0,4,1,25,4,1,Jordan Hawkins,NOP,UTA,NOP,,,34,31,28,9
22023,1641722,22300052,"NOV 24, 2023",NOP @ LAC,W,20,3,5,0.6,2,4,0.5,0,0,0.0,0,4,4,1,0,0,0,1,8,3,1,Jordan Hawkins,NOP,LAC,NOP,,,13,12,9,5
22023,1641722,22300233,"NOV 22, 2023",NOP vs. SAC,W,21,3,9,0.333,2,8,0.25,5,5,1.0,1,1,2,3,0,0,0,3,13,2,1,Jordan Hawkins,NOP,NOP,SAC,,,18,15,16,5
22023,1641722,22300222,"NOV 20, 2023",NOP vs. SAC,W,29,3,11,0.273,2,5,0.4,1,1,1.0,1,4,5,2,0,0,1,2,9,8,1,Jordan Hawkins,NOP,NOP,SAC,,,16,14,11,7
22023,1641722,22300203,"NOV 18, 2023",NOP vs. MIN,L,37,6,12,0.5,3,8,0.375,0,0,0.0,1,1,2,4,1,0,1,4,15,-7,1,Jordan Hawkins,NOP,NOP,MIN,,,21,17,19,6
22023,1641722,22300034,"NOV 17, 2023",NOP vs. DEN,W,26,3,7,0.429,1,3,0.333,0,0,0.0,0,5,5,4,0,0,0,0,7,-3,1,Jordan Hawkins,NOP,NOP,DEN,,,16,12,11,9
22023,1641722,22300022,"NOV 14, 2023",NOP vs. DAL,W,33,8,17,0.471,5,12,0.417,4,4,1.0,2,4,6,3,0,0,0,3,25,13,1,Jordan Hawkins,NOP,NOP,DAL,,,34,31,28,9
22023,1641722,22300183,"NOV 12, 2023",NOP vs. DAL,L,28,3,13,0.231,2,9,0.222,2,2,1.0,0,2,2,2,0,0,2,1,10,-28,1,Jordan Hawkins,NOP,NOP,DAL,,,14,12,12,4
22023,1641722,22300011,"NOV 10, 2023",NOP @ HOU,L,41,4,11,0.364,3,8,0.375,3,4,0.75,0,7,7,1,2,0,3,6,14,1,1,Jordan Hawkins,NOP,HOU,NOP,,,22,21,15,8
22023,1641722,22300166,"NOV 08, 2023",NOP @ MIN,L,30,4,11,0.364,2,5,0.4,4,4,1.0,0,1,1,1,0,0,2,5,14,-19,1,Jordan Hawkins,NOP,MIN,NOP,,,16,15,15,2
22023,1641722,22300156,"NOV 06, 2023",NOP @ DEN,L,38,10,19,0.526,7,14,0.5,4,5,0.8,1,6,7,3,1,0,1,2,31,-15,1,Jordan Hawkins,NOP,DEN,NOP,,,41,38,34,10
22023,1641722,22300135,"NOV 04, 2023",NOP vs. ATL,L,24,5,11,0.455,4,8,0.5,1,1,1.0,0,5,5,0,1,0,1,3,15,-3,1,Jordan Hawkins,NOP,NOP,ATL,,,20,20,15,5
22023,1641722,22300129,"NOV 02, 2023",NOP vs. DET,W,29,1,7,0.143,1,5,0.2,3,3,1.0,0,1,1,0,0,0,1,0,6,-8,1,Jordan Hawkins,NOP,NOP,DET,,,7,7,6,1
22023,1641722,22300121,"NOV 01, 2023",NOP @ OKC,W,37,4,19,0.211,2,13,0.154,0,0,0.0,4,2,6,4,2,0,1,2,10,17,1,Jordan Hawkins,NOP,OKC,NOP,,,20,16,14,10
22023,1641722,22300108,"OCT 30, 2023",NOP vs. GSW,L,35,6,13,0.462,2,7,0.286,0,2,0.0,2,3,5,2,2,0,1,1,14,-14,1,Jordan Hawkins,NOP,NOP,GSW,,,21,19,16,7
22023,1641722,22300090,"OCT 28, 2023",NOP vs. NYK,W,18,3,7,0.429,3,6,0.5,0,0,0.0,0,4,4,1,0,0,1,0,9,1,1,Jordan Hawkins,NOP,NOP,NYK,,,14,13,10,5
22023,1641722,22300071,"OCT 25, 2023",NOP @ MEM,W,9,1,2,0.5,1,2,0.5,0,0,0.0,0,0,0,2,0,0,0,2,3,14,1,Jordan Hawkins,NOP,MEM,NOP,,,5,3,5,2
22023,1629637,22300531,"JAN 11, 2024",LAL vs. PHX,L,13,3,3,1.0,0,0,0.0,0,0,0.0,1,1,2,1,0,2,2,6,6,1,1,Jaxson Hayes,LAL,LAL,PHX,,,9,8,7,3
22023,1629637,22300475,"JAN 03, 2024",LAL vs. MIA,L,1,0,0,0.0,0,0,0.0,0,0,0.0,0,0,0,0,0,0,0,0,0,0,1,Jaxson Hayes,LAL,LAL,MIA,,,0,0,0,0
22023,1629637,22300446,"DEC 31, 2023",LAL @ NOP,L,10,0,1,0.0,0,0,0.0,0,0,0.0,0,2,2,0,0,0,0,2,0,-6,1,Jaxson Hayes,LAL,NOP,LAL,,,2,2,0,2
22023,1629637,22300428,"DEC 28, 2023",LAL vs. CHA,W,7,5,7,0.714,0,0,0.0,0,0,0.0,1,1,2,0,0,0,0,0,10,-2,1,Jaxson Hayes,LAL,LAL,CHA,,,12,12,10,2
22023,1629637,22300403,"DEC 25, 2023",LAL vs. BOS,L,9,0,1,0.0,0,0,0.0,0,2,0.0,0,1,1,0,0,0,0,0,0,-5,1,Jaxson Hayes,LAL,LAL,BOS,,,1,1,0,1
22023,1629637,22300397,"DEC 23, 2023",LAL @ OKC,W,6,0,0,0.0,0,0,0.0,0,0,0.0,0,0,0,1,0,0,0,0,0,6,1,Jaxson Hayes,LAL,OKC,LAL,,,1,0,1,1
22023,1629637,22300380,"DEC 21, 2023",LAL @ MIN,L,11,1,1,1.0,0,0,0.0,1,1,1.0,1,2,3,1,0,0,1,2,3,-8,1,Jaxson Hayes,LAL,MIN,LAL,,,7,6,4,4
22023,1629637,22300370,"DEC 20, 2023",LAL @ CHI,L,1,1,1,1.0,0,0,0.0,0,0,0.0,0,1,1,0,0,0,0,0,2,0,1,Jaxson Hayes,LAL,CHI,LAL,,,3,3,2,1
22023,1629637,22300359,"DEC 18, 2023",LAL vs. NYK,L,8,1,1,1.0,0,0,0.0,0,0,0.0,0,2,2,0,0,0,0,1,2,4,1,Jaxson Hayes,LAL,LAL,NYK,,,4,4,2,2
22023,1629637,22300331,"DEC 15, 2023",LAL @ SAS,L,20,3,4,0.75,0,0,0.0,2,3,0.667,3,4,7,0,1,1,0,5,8,-13,1,Jaxson Hayes,LAL,SAS,LAL,,,15,15,8,7
22023,1629637,22300316,"DEC 13, 2023",LAL @ SAS,W,7,2,3,0.667,0,0,0.0,0,0,0.0,0,1,1,0,0,0,1,1,4,2,1,Jaxson Hayes,LAL,SAS,LAL,,,5,5,4,1
22023,1629637,22300306,"DEC 12, 2023",LAL @ DAL,L,13,0,1,0.0,0,0,0.0,0,0,0.0,2,2,4,1,0,0,0,4,0,-1,1,Jaxson Hayes,LAL,DAL,LAL,,,5,4,1,5
22023,1629637,22301230,"DEC 07, 2023",LAL vs. NOP,W,17,2,3,0.667,0,1,0.0,0,1,0.0,0,4,4,0,0,0,1,4,4,9,1,Jaxson Hayes,LAL,LAL,NOP,,,8,8,4,4
22023,1629637,22301203,"DEC 05, 2023",LAL vs. PHX,W,9,0,2,0.0,0,0,0.0,0,0,0.0,1,1,2,0,1,0,0,2,0,4,1,Jaxson Hayes,LAL,LAL,PHX,,,2,2,0,2
22023,1629637,22300291,"DEC 02, 2023",LAL vs. HOU,W,6,1,2,0.5,0,1,0.0,0,0,0.0,0,0,0,0,0,0,0,3,2,-6,1,Jaxson Hayes,LAL,LAL,HOU,,,2,2,2,0
22023,1629637,22300258,"NOV 29, 2023",LAL @ DET,W,7,0,0,0.0,0,0,0.0,0,0,0.0,0,1,1,0,0,1,0,0,0,-4,1,Jaxson Hayes,LAL,DET,LAL,,,1,1,0,1
22023,1629637,22300255,"NOV 27, 2023",LAL @ PHI,L,19,3,6,0.5,0,2,0.0,1,1,1.0,2,0,2,1,0,1,2,3,7,-33,1,Jaxson Hayes,LAL,PHI,LAL,,,10,9,8,3
22023,1629637,22300242,"NOV 25, 2023",LAL @ CLE,W,21,5,5,1.0,0,0,0.0,0,0,0.0,0,3,3,1,0,1,1,3,10,14,1,Jaxson Hayes,LAL,CLE,LAL,,,14,13,11,4
22023,1629637,22300238,"NOV 22, 2023",LAL vs. DAL,L,11,1,1,1.0,0,0,0.0,0,2,0.0,1,3,4,0,0,0,0,1,2,7,1,Jaxson Hayes,LAL,LAL,DAL,,,6,6,2,4
22023,1629637,22300042,"NOV 21, 2023",LAL vs. UTA,W,19,4,4,1.0,0,0,0.0,2,3,0.667,0,2,2,1,0,1,2,1,10,-2,1,Jaxson Hayes,LAL,LAL,UTA,,,13,12,11,3
22023,1629637,22300216,"NOV 19, 2023",LAL vs. HOU,W,5,0,0,0.0,0,0,0.0,0,0,0.0,1,1,2,0,0,0,0,1,0,-4,1,Jaxson Hayes,LAL,LAL,HOU,,,2,2,0,2
22023,1629637,22300036,"NOV 17, 2023",LAL @ POR,W,8,0,0,0.0,0,0,0.0,0,1,0.0,0,1,1,0,1,0,0,0,0,5,1,Jaxson Hayes,LAL,POR,LAL,,,1,1,0,1
22023,1629637,22300198,"NOV 15, 2023",LAL vs. SAC,L,13,0,0,0.0,0,0,0.0,3,4,0.75,0,1,1,0,1,0,2,4,3,-2,1,Jaxson Hayes,LAL,LAL,SAC,,,4,4,3,1
22023,1629637,22300026,"NOV 14, 2023",LAL vs. MEM,W,21,4,4,1.0,0,0,0.0,3,4,0.75,1,0,1,1,1,3,0,2,11,6,1,Jaxson Hayes,LAL,LAL,MEM,,,13,12,12,2
22023,1629637,22300187,"NOV 12, 2023",LAL vs. POR,W,7,1,4,0.25,0,0,0.0,0,2,0.0,0,0,0,1,0,0,1,3,2,-11,1,Jaxson Hayes,LAL,LAL,POR,,,3,2,3,1
22023,1629637,22300015,"NOV 10, 2023",LAL @ PHX,W,5,1,1,1.0,0,0,0.0,0,0,0.0,0,1,1,0,0,0,1,1,2,-5,1,Jaxson Hayes,LAL,PHX,LAL,,,3,3,2,1
22023,1629637,22300134,"NOV 04, 2023",LAL @ ORL,L,11,1,4,0.25,0,0,0.0,0,0,0.0,1,0,1,1,0,1,2,3,2,-10,1,Jaxson Hayes,LAL,ORL,LAL,,,4,3,3,2
22023,1629637,22300127,"NOV 01, 2023",LAL vs. LAC,W,14,1,1,1.0,0,0,0.0,1,2,0.5,1,1,2,1,0,1,0,1,3,0,1,Jaxson Hayes,LAL,LAL,LAC,,,6,5,4,3
22023,1629637,22300111,"OCT 30, 2023",LAL vs. ORL,W,10,0,0,0.0,0,0,0.0,0,0,0.0,0,2,2,0,0,0,0,2,0,5,1,Jaxson Hayes,LAL,LAL,ORL,,,2,2,0,2
22023,1629637,22300100,"OCT 29, 2023",LAL @ SAC,L,7,1,1,1.0,0,0,0.0,2,2,1.0,0,2,2,0,0,0,0,1,4,1,1,Jaxson Hayes,LAL,SAC,LAL,,,6,6,4,2
22023,1629637,22300076,"OCT 26, 2023",LAL vs. PHX,W,6,0,0,0.0,0,0,0.0,0,0,0.0,0,2,2,0,1,0,2,3,0,3,1,Jaxson Hayes,LAL,LAL,PHX,,,2,2,0,2
22023,1629637,22300061,"OCT 24, 2023",LAL @ DEN,L,7,0,0,0.0,0,0,0.0,0,0,0.0,0,1,1,0,0,0,0,1,0,-7,1,Jaxson Hayes,LAL,DEN,LAL,,,1,1,0,1
22023,1630165,22300558,"JAN 15, 2024",DET @ WAS,W,24,2,4,0.5,0,1,0.0,0,0,0.0,0,1,1,6,0,0,1,1,4,-4,1,Killian Hayes,DET,WAS,DET,,,11,5,10,7
22023,1630165,22300534,"JAN 12, 2024",DET vs. HOU,L,29,2,6,0.333,0,2,0.0,1,1,1.0,0,4,4,8,1,1,1,1,5,-7,1,Killian Hayes,DET,DET,HOU,,,17,9,13,12
22023,1630165,22300519,"JAN 10, 2024",DET vs. SAS,L,32,2,8,0.25,0,0,0.0,0,0,0.0,1,3,4,12,0,0,1,1,4,-11,1,Killian Hayes,DET,DET,SAS,,,20,8,16,16
22023,1630165,22300512,"JAN 09, 2024",DET vs. SAC,L,31,1,4,0.25,0,1,0.0,2,2,1.0,1,3,4,7,1,0,6,2,4,-15,1,Killian Hayes,DET,DET,SAC,,,15,8,11,11
22023,1630165,22300502,"JAN 07, 2024",DET @ DEN,L,25,1,5,0.2,0,1,0.0,0,0,0.0,0,2,2,6,1,0,1,4,2,-10,1,Killian Hayes,DET,DEN,DET,,,10,4,8,8
22023,1630165,22300490,"JAN 05, 2024",DET @ GSW,L,16,0,3,0.0,0,2,0.0,0,0,0.0,0,1,1,5,2,0,0,0,0,-4,1,Killian Hayes,DET,GSW,DET,,,6,1,5,6
22023,1630165,22300474,"JAN 03, 2024",DET @ UTA,L,13,1,3,0.333,0,0,0.0,0,0,0.0,0,4,4,6,0,1,0,2,2,4,1,Killian Hayes,DET,UTA,DET,,,12,6,8,10
22023,1630165,22300453,"JAN 01, 2024",DET @ HOU,L,19,3,8,0.375,1,2,0.5,1,4,0.25,0,1,1,3,1,0,1,2,8,-2,1,Killian Hayes,DET,HOU,DET,,,12,9,11,4
22023,1630165,22300440,"DEC 30, 2023",DET vs. TOR,W,10,0,2,0.0,0,0,0.0,0,0,0.0,0,1,1,4,1,0,3,2,0,1,1,Killian Hayes,DET,DET,TOR,,,5,1,4,5
22023,1630165,22300421,"DEC 28, 2023",DET @ BOS,L,10,1,3,0.333,0,0,0.0,0,0,0.0,0,2,2,0,1,0,3,0,2,-10,1,Killian Hayes,DET,BOS,DET,,,4,4,2,2
22023,1630165,22300334,"DEC 16, 2023",DET @ MIL,L,14,1,4,0.25,0,0,0.0,0,0,0.0,0,4,4,5,0,0,1,0,2,-3,1,Killian Hayes,DET,MIL,DET,,,11,6,7,9
22023,1630165,22300327,"DEC 15, 2023",DET @ PHI,L,21,1,6,0.167,0,1,0.0,3,4,0.75,1,3,4,2,0,1,3,3,5,-28,1,Killian Hayes,DET,PHI,DET,,,11,9,7,6
22023,1630165,22300310,"DEC 13, 2023",DET vs. PHI,L,32,3,8,0.375,0,0,0.0,0,0,0.0,0,3,3,6,1,0,1,2,6,1,1,Killian Hayes,DET,DET,PHI,,,15,9,12,9
22023,1630165,22300293,"DEC 11, 2023",DET vs. IND,L,23,2,4,0.5,0,0,0.0,2,2,1.0,0,1,1,7,1,0,2,0,6,-4,1,Killian Hayes,DET,DET,IND,,,14,7,13,8
22023,1630165,22301217,"DEC 08, 2023",DET @ ORL,L,32,7,11,0.636,0,2,0.0,2,3,0.667,1,6,7,4,0,1,2,1,16,-22,1,Killian Hayes,DET,ORL,DET,,,27,23,20,11
22023,1630165,22301206,"DEC 06, 2023",DET vs. MEM,L,27,5,13,0.385,1,3,0.333,1,1,1.0,2,2,4,4,1,0,3,3,12,-6,1,Killian Hayes,DET,DET,MEM,,,20,16,16,8
22023,1630165,22300283,"DEC 02, 2023",DET vs. CLE,L,33,6,11,0.545,1,1,1.0,0,1,0.0,0,6,6,3,2,1,2,2,13,7,1,Killian Hayes,DET,DET,CLE,,,22,19,16,9
22023,1630165,22300268,"NOV 30, 2023",DET @ NYK,L,28,10,13,0.769,2,3,0.667,1,4,0.25,0,3,3,4,1,1,0,3,23,-3,1,Killian Hayes,DET,NYK,DET,,,30,26,27,7
22023,1630165,22300258,"NOV 29, 2023",DET vs. LAL,L,22,3,9,0.333,0,3,0.0,1,1,1.0,0,1,1,8,2,0,0,2,7,8,1,Killian Hayes,DET,DET,LAL,,,16,8,15,9
22023,1630165,22300253,"NOV 27, 2023",DET vs. WAS,L,16,0,1,0.0,0,0,0.0,0,0,0.0,1,3,4,3,0,3,0,1,0,-10,1,Killian Hayes,DET,DET,WAS,,,7,4,3,7
22023,1630165,22300047,"NOV 24, 2023",DET @ IND,L,17,3,6,0.5,0,0,0.0,0,0,0.0,0,1,1,3,0,0,0,0,6,-25,1,Killian Hayes,DET,IND,DET,,,10,7,9,4
22023,1630165,22300218,"NOV 20, 2023",DET vs. DEN,L,14,0,2,0.0,0,1,0.0,0,0,0.0,0,0,0,2,2,0,2,2,0,-5,1,Killian Hayes,DET,DET,DEN,,,2,0,2,2
22023,1630165,22300030,"NOV 17, 2023",DET @ CLE,L,22,2,6,0.333,0,2,0.0,0,0,0.0,0,0,0,2,1,1,0,0,4,-14,1,Killian Hayes,DET,CLE,DET,,,6,4,6,2
22023,1630165,22300018,"NOV 14, 2023",DET vs. ATL,L,23,3,8,0.375,1,3,0.333,1,2,0.5,0,3,3,5,1,2,1,2,8,12,1,Killian Hayes,DET,DET,ATL,,,16,11,13,8
22023,1630165,22300181,"NOV 12, 2023",DET @ CHI,L,25,3,8,0.375,1,3,0.333,0,0,0.0,0,3,3,3,0,0,0,1,7,-12,1,Killian Hayes,DET,CHI,DET,,,13,10,10,6
22023,1630165,22300008,"NOV 10, 2023",DET vs. PHI,L,39,8,17,0.471,2,6,0.333,5,7,0.714,0,5,5,6,2,0,2,1,23,-9,1,Killian Hayes,DET,DET,PHI,,,34,28,29,11
22023,1630165,22300165,"NOV 08, 2023",DET @ MIL,L,29,6,15,0.4,0,3,0.0,2,2,1.0,0,5,5,4,1,0,1,1,14,-2,1,Killian Hayes,DET,MIL,DET,,,23,19,18,9
22023,1630165,22300145,"NOV 06, 2023",DET vs. GSW,L,34,8,12,0.667,3,4,0.75,2,2,1.0,0,4,4,7,1,1,0,3,21,-6,1,Killian Hayes,DET,DET,GSW,,,32,25,28,11
22023,1630165,22300140,"NOV 05, 2023",DET vs. PHX,L,34,4,8,0.5,1,3,0.333,4,4,1.0,0,2,2,5,0,1,0,4,13,-22,1,Killian Hayes,DET,DET,PHX,,,20,15,18,7
22023,1630165,22300129,"NOV 02, 2023",DET @ NOP,L,39,4,8,0.5,2,4,0.5,0,0,0.0,3,2,5,9,1,0,0,4,10,10,1,Killian Hayes,DET,NOP,DET,,,24,15,19,14
22023,1630165,22300115,"NOV 01, 2023",DET vs. POR,L,26,0,6,0.0,0,1,0.0,0,0,0.0,0,3,3,1,3,0,1,2,0,6,1,Killian Hayes,DET,DET,POR,,,4,3,1,4
22023,1630165,22300109,"OCT 30, 2023",DET @ OKC,L,27,4,11,0.364,1,4,0.25,1,2,0.5,0,4,4,7,1,1,1,3,10,-15,1,Killian Hayes,DET,OKC,DET,,,21,14,17,11
22023,1630165,22300088,"OCT 28, 2023",DET vs. CHI,W,23,2,5,0.4,2,3,0.667,0,0,0.0,1,0,1,4,1,0,1,2,6,7,1,Killian Hayes,DET,DET,CHI,,,11,7,10,5
22023,1630165,22300077,"OCT 27, 2023",DET @ CHA,W,29,2,10,0.2,1,3,0.333,1,2,0.5,0,3,3,3,2,1,3,4,6,-7,1,Killian Hayes,DET,CHA,DET,,,12,9,9,6
22023,1630165,22300068,"OCT 25, 2023",DET @ MIA,L,31,4,12,0.333,0,6,0.0,2,3,0.667,0,1,1,3,2,1,1,2,10,1,1,Killian Hayes,DET,MIA,DET,,,14,11,13,4
22023,202330,22300414,"DEC 26, 2023",CHA @ LAC,L,24,3,8,0.375,0,2,0.0,2,2,1.0,1,1,2,5,1,0,1,2,8,-4,1,Gordon Hayward,CHA,LAC,CHA,,,15,10,13,7
22023,202330,22300390,"DEC 23, 2023",CHA vs. DEN,L,31,4,7,0.571,0,0,0.0,0,0,0.0,0,6,6,4,1,2,4,2,8,-3,1,Gordon Hayward,CHA,CHA,DEN,,,18,14,12,10
22023,202330,22300365,"DEC 20, 2023",CHA @ IND,L,24,3,5,0.6,1,1,1.0,4,6,0.667,0,1,1,3,0,0,2,0,11,-25,1,Gordon Hayward,CHA,IND,CHA,,,15,12,14,4
22023,202330,22300326,"DEC 15, 2023",CHA vs. NOP,L,34,4,10,0.4,1,4,0.25,0,0,0.0,0,3,3,4,1,1,1,2,9,0,1,Gordon Hayward,CHA,CHA,NOP,,,16,12,13,7
22023,202330,22300312,"DEC 13, 2023",CHA @ MIA,L,35,7,12,0.583,1,2,0.5,5,5,1.0,1,4,5,7,0,0,4,2,20,1,1,Gordon Hayward,CHA,MIA,CHA,,,32,25,27,12
22023,202330,22300292,"DEC 11, 2023",CHA vs. MIA,L,32,7,12,0.583,1,3,0.333,2,4,0.5,0,6,6,7,1,0,0,4,17,-13,1,Gordon Hayward,CHA,CHA,MIA,,,30,23,24,13
22023,202330,22301216,"DEC 08, 2023",CHA vs. TOR,W,35,10,15,0.667,1,2,0.5,3,4,0.75,3,1,4,4,1,0,3,1,24,2,1,Gordon Hayward,CHA,CHA,TOR,,,32,28,28,8
22023,202330,22301211,"DEC 06, 2023",CHA @ CHI,L,35,10,18,0.556,2,4,0.5,5,5,1.0,2,2,4,4,3,1,5,2,27,2,1,Gordon Hayward,CHA,CHI,CHA,,,35,31,31,8
22023,202330,22300281,"DEC 02, 2023",CHA vs. MIN,L,31,7,11,0.636,1,2,0.5,2,2,1.0,0,1,1,3,2,0,2,1,17,-14,1,Gordon Hayward,CHA,CHA,MIN,,,21,18,20,4
22023,202330,22300266,"NOV 30, 2023",CHA @ BKN,W,32,8,14,0.571,2,4,0.5,4,4,1.0,2,4,6,6,0,0,2,1,22,3,1,Gordon Hayward,CHA,BKN,CHA,,,34,28,28,12
22023,202330,22300057,"NOV 28, 2023",CHA @ NYK,L,28,2,7,0.286,0,2,0.0,0,0,0.0,2,4,6,6,0,0,2,1,4,-3,1,Gordon Hayward,CHA,NYK,CHA,,,16,10,10,12
22023,202330,22300248,"NOV 26, 2023",CHA @ ORL,L,33,4,11,0.364,2,4,0.5,0,2,0.0,0,5,5,2,0,1,3,1,10,-15,1,Gordon Hayward,CHA,ORL,CHA,,,17,15,12,7
22023,202330,22300225,"NOV 22, 2023",CHA vs. WAS,W,30,2,8,0.25,0,1,0.0,0,0,0.0,1,8,9,6,0,0,3,1,4,-18,1,Gordon Hayward,CHA,CHA,WAS,,,19,13,10,15
22023,202330,22300217,"NOV 20, 2023",CHA vs. BOS,W,39,6,15,0.4,1,2,0.5,7,8,0.875,3,2,5,4,1,1,2,3,20,20,1,Gordon Hayward,CHA,CHA,BOS,,,29,25,24,9
22023,202330,22300202,"NOV 18, 2023",CHA vs. NYK,L,32,1,7,0.143,0,2,0.0,2,2,1.0,0,3,3,4,2,0,0,3,4,-18,1,Gordon Hayward,CHA,CHA,NYK,,,11,7,8,7
22023,202330,22300027,"NOV 17, 2023",CHA vs. MIL,L,29,1,9,0.111,0,3,0.0,0,0,0.0,0,4,4,0,0,0,0,2,2,-27,1,Gordon Hayward,CHA,CHA,MIL,,,6,6,2,4
22023,202330,22300177,"NOV 12, 2023",CHA @ NYK,L,29,3,9,0.333,0,1,0.0,0,0,0.0,0,1,1,2,0,0,2,3,6,-16,1,Gordon Hayward,CHA,NYK,CHA,,,9,7,8,3
22023,202330,22300009,"NOV 10, 2023",CHA @ WAS,W,36,10,20,0.5,1,4,0.25,6,8,0.75,0,5,5,9,4,1,0,0,27,16,1,Gordon Hayward,CHA,WAS,CHA,,,41,32,36,14
22023,202330,22300157,"NOV 08, 2023",CHA vs. WAS,L,32,6,14,0.429,2,4,0.5,4,6,0.667,1,6,7,4,3,0,3,2,18,-8,1,Gordon Hayward,CHA,CHA,WAS,,,29,25,22,11
22023,202330,22300143,"NOV 05, 2023",CHA @ DAL,L,34,9,23,0.391,1,4,0.25,1,4,0.25,2,2,4,8,1,0,1,2,20,-4,1,Gordon Hayward,CHA,DAL,CHA,,,32,24,28,12
22023,202330,22300133,"NOV 04, 2023",CHA @ IND,W,34,10,17,0.588,1,2,0.5,2,2,1.0,1,5,6,3,0,2,1,3,23,-3,1,Gordon Hayward,CHA,IND,CHA,,,32,29,26,9
22023,202330,22300122,"NOV 01, 2023",CHA @ HOU,L,31,6,11,0.545,0,1,0.0,5,7,0.714,2,5,7,5,1,1,1,1,17,-3,1,Gordon Hayward,CHA,HOU,CHA,,,29,24,22,12
22023,202330,22300101,"OCT 30, 2023",CHA vs. BKN,L,31,6,11,0.545,2,2,1.0,1,1,1.0,0,0,0,5,2,1,0,4,15,-8,1,Gordon Hayward,CHA,CHA,BKN,,,20,15,20,5
22023,202330,22300077,"OCT 27, 2023",CHA vs. DET,L,34,6,15,0.4,2,4,0.5,5,6,0.833,1,8,9,4,3,0,3,2,19,-10,1,Gordon Hayward,CHA,CHA,DET,,,32,28,23,13
22023,202330,22300063,"OCT 25, 2023",CHA vs. ATL,W,33,4,8,0.5,0,1,0.0,2,3,0.667,3,5,8,7,1,1,6,1,10,15,1,Gordon Hayward,CHA,CHA,ATL,,,25,18,17,15
22023,1630703,22300554,"JAN 14, 2024",POR vs. PHX,L,40,11,31,0.355,4,9,0.444,7,9,0.778,4,3,7,9,3,0,3,3,33,-12,1,Scoot Henderson,POR,POR,PHX,,,49,40,42,16
22023,1630703,22300538,"JAN 12, 2024",POR @ MIN,L,25,3,4,0.75,0,0,0.0,2,7,0.286,0,2,2,4,0,0,6,2,8,-27,1,Scoot Henderson,POR,MIN,POR,,,14,10,12,6
22023,1630703,22300529,"JAN 11, 2024",POR @ OKC,L,31,4,21,0.19,1,9,0.111,4,6,0.667,2,4,6,2,1,0,3,3,13,-56,1,Scoot Henderson,POR,OKC,POR,,,21,19,15,8
22023,1630703,22300514,"JAN 09, 2024",POR @ NYK,L,25,3,8,0.375,1,3,0.333,1,2,0.5,0,3,3,4,1,0,3,2,8,-26,1,Scoot Henderson,POR,NYK,POR,,,15,11,12,7
22023,1630703,22300498,"JAN 07, 2024",POR @ BKN,W,30,3,8,0.375,2,3,0.667,2,2,1.0,1,2,3,4,0,0,2,2,10,-12,1,Scoot Henderson,POR,BKN,POR,,,17,13,14,7
22023,1630703,22300487,"JAN 05, 2024",POR @ DAL,L,33,7,15,0.467,3,7,0.429,0,0,0.0,1,2,3,10,1,0,1,0,17,-26,1,Scoot Henderson,POR,DAL,POR,,,30,20,27,13
22023,1630703,22300472,"JAN 03, 2024",POR @ DAL,L,33,2,11,0.182,1,4,0.25,2,4,0.5,1,4,5,7,0,0,6,4,7,-28,1,Scoot Henderson,POR,DAL,POR,,,19,12,14,12
22023,1630703,22300456,"JAN 01, 2024",POR @ PHX,L,34,7,18,0.389,1,3,0.333,2,4,0.5,0,3,3,6,1,2,5,1,17,-18,1,Scoot Henderson,POR,PHX,POR,,,26,20,23,9
22023,1630703,22300437,"DEC 29, 2023",POR vs. SAS,W,37,9,21,0.429,3,5,0.6,1,2,0.5,4,3,7,11,1,1,4,5,22,-2,1,Scoot Henderson,POR,POR,SAS,,,40,29,33,18
22023,1630703,22300427,"DEC 28, 2023",POR vs. SAS,L,36,8,23,0.348,3,7,0.429,6,6,1.0,2,1,3,4,1,0,6,5,25,-6,1,Scoot Henderson,POR,POR,SAS,,,32,28,29,7
22023,1630703,22300413,"DEC 26, 2023",POR vs. SAC,W,28,6,15,0.4,1,3,0.333,4,4,1.0,1,0,1,11,0,0,1,2,17,21,1,Scoot Henderson,POR,POR,SAC,,,29,18,28,12
22023,1630703,22300399,"DEC 23, 2023",POR @ GSW,L,23,4,9,0.444,2,4,0.5,2,4,0.5,0,1,1,2,3,0,2,4,12,-12,1,Scoot Henderson,POR,GSW,POR,,,15,13,14,3
22023,1630703,22300381,"DEC 21, 2023",POR vs. WAS,L,26,0,5,0.0,0,0,0.0,4,4,1.0,0,4,4,2,0,0,1,3,4,7,1,Scoot Henderson,POR,POR,WAS,,,10,8,6,6
22023,1630703,22300363,"DEC 19, 2023",POR vs. PHX,W,30,3,9,0.333,0,2,0.0,3,3,1.0,1,3,4,5,0,0,5,4,9,-5,1,Scoot Henderson,POR,POR,PHX,,,18,13,14,9
22023,1630703,22300348,"DEC 17, 2023",POR vs. GSW,L,22,4,9,0.444,1,4,0.25,5,5,1.0,0,1,1,2,1,0,1,2,14,0,1,Scoot Henderson,POR,POR,GSW,,,17,15,16,3
22023,1630703,22300341,"DEC 16, 2023",POR vs. DAL,L,24,5,10,0.5,1,1,1.0,2,2,1.0,0,3,3,2,0,1,3,3,13,-8,1,Scoot Henderson,POR,POR,DAL,,,18,16,15,5
22023,1630703,22300323,"DEC 14, 2023",POR vs. UTA,L,35,9,21,0.429,2,7,0.286,3,3,1.0,0,2,2,10,1,0,4,1,23,0,1,Scoot Henderson,POR,POR,UTA,,,35,25,33,12
22023,1630703,22300304,"DEC 11, 2023",POR @ LAC,L,30,8,16,0.5,3,4,0.75,0,0,0.0,1,3,4,6,0,2,3,5,19,11,1,Scoot Henderson,POR,LAC,POR,,,29,23,25,10
22023,1630703,22301226,"DEC 08, 2023",POR vs. DAL,L,30,4,17,0.235,0,6,0.0,2,3,0.667,1,2,3,3,0,0,4,4,10,-19,1,Scoot Henderson,POR,POR,DAL,,,16,13,13,6
22023,1630703,22301214,"DEC 06, 2023",POR @ GSW,L,26,4,9,0.444,0,3,0.0,1,2,0.5,2,0,2,4,1,0,1,5,9,-15,1,Scoot Henderson,POR,GSW,POR,,,15,11,13,6
22023,1630703,22300289,"DEC 02, 2023",POR @ UTA,L,21,6,15,0.4,2,5,0.4,3,4,0.75,2,3,5,3,1,0,2,5,17,-5,1,Scoot Henderson,POR,UTA,POR,,,25,22,20,8
22023,1630703,22300265,"NOV 30, 2023",POR @ CLE,W,22,1,8,0.125,0,5,0.0,0,0,0.0,0,1,1,7,0,0,3,2,2,12,1,Scoot Henderson,POR,CLE,POR,,,10,3,9,8
22023,1630703,22300254,"NOV 27, 2023",POR @ IND,W,22,4,10,0.4,2,3,0.667,3,6,0.5,1,2,3,1,1,0,4,5,13,10,1,Scoot Henderson,POR,IND,POR,,,17,16,14,4
22023,1630703,22300245,"NOV 26, 2023",POR @ MIL,L,27,5,10,0.5,3,4,0.75,0,0,0.0,1,3,4,1,0,0,2,5,13,2,1,Scoot Henderson,POR,MIL,POR,,,18,17,14,5
22023,1630703,22300237,"NOV 22, 2023",POR vs. UTA,W,17,1,7,0.143,0,3,0.0,1,2,0.5,1,2,3,7,0,0,3,4,3,15,1,Scoot Henderson,POR,POR,UTA,,,13,6,10,10
22023,1630703,22300115,"NOV 01, 2023",POR @ DET,W,20,4,10,0.4,1,3,0.333,2,2,1.0,0,0,0,7,0,0,3,2,11,-11,1,Scoot Henderson,POR,DET,POR,,,18,11,18,7
22023,1630703,22300105,"OCT 30, 2023",POR @ TOR,W,34,4,12,0.333,0,6,0.0,3,4,0.75,0,4,4,7,2,0,4,6,11,1,1,Scoot Henderson,POR,TOR,POR,,,22,15,18,11
22023,1630703,22300098,"OCT 29, 2023",POR @ PHI,L,27,2,7,0.286,0,4,0.0,0,0,0.0,0,1,1,3,0,1,4,5,4,-17,1,Scoot Henderson,POR,PHI,POR,,,8,5,7,4
22023,1630703,22300086,"OCT 27, 2023",POR vs. ORL,L,25,3,12,0.25,1,5,0.2,0,0,0.0,2,1,3,2,1,0,5,5,7,-3,1,Scoot Henderson,POR,POR,ORL,,,12,10,9,5
22023,1630703,22300074,"OCT 25, 2023",POR @ LAC,L,36,5,11,0.455,0,3,0.0,1,1,1.0,1,2,3,4,0,0,4,2,11,-16,1,Scoot Henderson,POR,LAC,POR,,,18,14,15,7
22023,1641707,22300540,"JAN 12, 2024",UTA vs. TOR,W,4,2,2,1.0,2,2,1.0,0,0,0.0,0,1,1,1,1,0,0,1,6,5,1,Taylor Hendricks,UTA,UTA,TOR,,,8,7,7,2
22023,1641707,22300524,"JAN 10, 2024",UTA vs. DEN,W,3,0,1,0.0,0,1,0.0,0,0,0.0,0,0,0,0,0,1,1,0,0,-5,1,Taylor Hendricks,UTA,UTA,DEN,,,0,0,0,0
22023,1641707,22300412,"DEC 26, 2023",UTA @ SAS,W,2,0,3,0.0,0,2,0.0,0,0,0.0,0,1,1,0,0,0,1,0,0,-7,1,Taylor Hendricks,UTA,SAS,UTA,,,1,1,0,1
22023,1641707,22300374,"DEC 21, 2023",UTA @ DET,W,16,3,5,0.6,1,2,0.5,0,0,0.0,3,1,4,0,0,1,0,0,7,7,1,Taylor Hendricks,UTA,DET,UTA,,,11,11,7,4
22023,1641707,22300357,"DEC 18, 2023",UTA vs. BKN,W,7,0,1,0.0,0,1,0.0,0,0,0.0,0,2,2,1,0,0,1,1,0,-8,1,Taylor Hendricks,UTA,UTA,BKN,,,3,2,1,3
22023,1641707,22300342,"DEC 16, 2023",UTA @ SAC,L,21,3,8,0.375,2,5,0.4,4,5,0.8,1,2,3,1,1,0,0,0,12,8,1,Taylor Hendricks,UTA,SAC,UTA,,,16,15,13,4
22023,1641707,22300323,"DEC 14, 2023",UTA @ POR,W,25,4,9,0.444,2,5,0.4,0,0,0.0,3,4,7,0,1,0,2,1,10,-21,1,Taylor Hendricks,UTA,POR,UTA,,,17,17,10,7
22023,1641707,22300318,"DEC 13, 2023",UTA vs. NYK,W,20,2,7,0.286,1,3,0.333,0,0,0.0,2,2,4,1,2,1,1,3,5,25,1,Taylor Hendricks,UTA,UTA,NYK,,,10,9,6,5
22023,1641707,22300302,"DEC 11, 2023",UTA @ OKC,L,26,3,6,0.5,1,4,0.25,1,1,1.0,0,2,2,2,1,1,0,2,8,5,1,Taylor Hendricks,UTA,OKC,UTA,,,12,10,10,4
22023,1641707,22301225,"DEC 08, 2023",UTA vs. LAC,L,12,0,3,0.0,0,2,0.0,0,0,0.0,0,0,0,0,1,0,1,0,0,4,1,Taylor Hendricks,UTA,UTA,LAC,,,0,0,0,0
22023,1641707,22301213,"DEC 06, 2023",UTA @ DAL,L,25,4,6,0.667,2,4,0.5,0,0,0.0,1,1,2,0,2,1,2,3,10,-10,1,Taylor Hendricks,UTA,DAL,UTA,,,12,12,10,2
22023,1641707,22300289,"DEC 02, 2023",UTA vs. POR,W,18,2,7,0.286,1,4,0.25,0,0,0.0,1,1,2,0,0,2,0,1,5,1,1,Taylor Hendricks,UTA,UTA,POR,,,7,7,5,2
22023,1641707,22300072,"OCT 25, 2023",UTA vs. SAC,L,2,0,0,0.0,0,0,0.0,1,2,0.5,0,1,1,0,0,0,0,0,1,2,1,Taylor Hendricks,UTA,UTA,SAC,,,2,2,1,1
22023,1629639,22300562,"JAN 15, 2024",MIA @ BKN,W,38,11,22,0.5,4,11,0.364,3,4,0.75,1,10,11,2,0,0,4,3,29,16,1,Tyler Herro,MIA,BKN,MIA,,,42,40,31,13
22023,1629639,22300551,"JAN 14, 2024",MIA vs. CHA,W,28,7,15,0.467,4,9,0.444,3,4,0.75,1,6,7,4,1,0,3,1,21,12,1,Tyler Herro,MIA,MIA,CHA,,,32,28,25,11
22023,1629639,22300522,"JAN 10, 2024",MIA vs. OKC,L,36,7,21,0.333,1,5,0.2,2,4,0.5,0,5,5,6,3,0,1,1,17,9,1,Tyler Herro,MIA,MIA,OKC,,,28,22,23,11
22023,1629639,22300509,"JAN 08, 2024",MIA vs. HOU,W,34,10,20,0.5,5,10,0.5,3,3,1.0,2,1,3,3,0,0,1,2,28,1,1,Tyler Herro,MIA,MIA,HOU,,,34,31,31,6
22023,1629639,22300489,"JAN 05, 2024",MIA @ PHX,L,35,4,17,0.235,1,7,0.143,0,0,0.0,0,4,4,6,0,0,1,2,9,-25,1,Tyler Herro,MIA,PHX,MIA,,,19,13,15,10
22023,1629639,22300475,"JAN 03, 2024",MIA @ LAL,W,28,7,19,0.368,4,8,0.5,3,3,1.0,0,6,6,4,3,0,2,3,21,5,1,Tyler Herro,MIA,LAL,MIA,,,31,27,25,10
22023,1629639,22300458,"JAN 01, 2024",MIA @ LAC,L,35,4,13,0.308,4,8,0.5,0,0,0.0,0,6,6,6,2,0,3,1,12,-29,1,Tyler Herro,MIA,LAC,MIA,,,24,18,18,12
22023,1629639,22300439,"DEC 30, 2023",MIA @ UTA,L,39,9,22,0.409,2,7,0.286,5,5,1.0,2,4,6,6,1,1,1,2,25,-1,1,Tyler Herro,MIA,UTA,MIA,,,37,31,31,12
22023,1629639,22300426,"DEC 28, 2023",MIA @ GSW,W,31,10,18,0.556,3,7,0.429,3,4,0.75,0,7,7,2,1,0,2,0,26,11,1,Tyler Herro,MIA,GSW,MIA,,,35,33,28,9
22023,1629639,22300404,"DEC 25, 2023",MIA vs. PHI,W,38,8,25,0.32,4,11,0.364,2,3,0.667,2,4,6,5,1,1,4,1,22,-5,1,Tyler Herro,MIA,MIA,PHI,,,33,28,27,11
22023,1629639,22300384,"DEC 22, 2023",MIA vs. ATL,W,34,11,21,0.524,7,13,0.538,1,2,0.5,0,7,7,2,1,0,4,1,30,7,1,Tyler Herro,MIA,MIA,ATL,,,39,37,32,9
22023,1629639,22300366,"DEC 20, 2023",MIA @ ORL,W,36,10,17,0.588,4,5,0.8,4,4,1.0,1,7,8,7,0,0,4,1,28,10,1,Tyler Herro,MIA,ORL,MIA,,,43,36,35,15
22023,1629639,22300353,"DEC 18, 2023",MIA vs. MIN,L,33,10,18,0.556,1,6,0.167,4,4,1.0,1,2,3,2,2,0,2,1,25,-1,1,Tyler Herro,MIA,MIA,MIN,,,30,28,27,5
22023,1629639,22300164,"NOV 08, 2023",MIA @ MEM,W,8,2,4,0.5,0,0,0.0,2,3,0.667,0,1,1,2,1,0,0,2,6,6,1,Tyler Herro,MIA,MEM,MIA,,,9,7,8,3
22023,1629639,22300150,"NOV 06, 2023",MIA vs. LAL,W,34,8,20,0.4,2,10,0.2,4,4,1.0,1,4,5,5,3,0,6,1,22,-9,1,Tyler Herro,MIA,MIA,LAL,,,32,27,27,10
22023,1629639,22300003,"NOV 03, 2023",MIA vs. WAS,W,37,9,17,0.529,4,7,0.571,2,2,1.0,0,10,10,9,2,0,3,3,24,7,1,Tyler Herro,MIA,MIA,WAS,,,43,34,33,19
22023,1629639,22300119,"NOV 01, 2023",MIA vs. BKN,L,36,12,23,0.522,6,10,0.6,0,1,0.0,0,3,3,5,0,0,3,2,30,-1,1,Tyler Herro,MIA,MIA,BKN,,,38,33,35,8
22023,1629639,22300107,"OCT 30, 2023",MIA @ MIL,L,42,12,21,0.571,2,5,0.4,9,10,0.9,1,7,8,3,1,0,3,1,35,-3,1,Tyler Herro,MIA,MIL,MIA,,,46,43,38,11
22023,1629639,22300093,"OCT 28, 2023",MIA @ MIN,L,40,8,23,0.348,4,10,0.4,2,2,1.0,0,5,5,4,0,0,0,1,22,-16,1,Tyler Herro,MIA,MIN,MIA,,,31,27,26,9
22023,1629639,22300080,"OCT 27, 2023",MIA @ BOS,L,40,10,20,0.5,5,12,0.417,3,3,1.0,1,5,6,6,1,0,3,2,28,-1,1,Tyler Herro,MIA,BOS,MIA,,,40,34,34,12
22023,1629639,22300068,"OCT 25, 2023",MIA vs. DET,W,35,7,24,0.292,2,7,0.286,0,0,0.0,0,2,2,3,3,0,2,1,16,6,1,Tyler Herro,MIA,MIA,DET,,,21,18,19,5
22023,1627741,22300564,"JAN 15, 2024",IND @ UTA,L,23,5,8,0.625,3,5,0.6,1,1,1.0,1,1,2,1,0,0,1,1,14,-24,1,Buddy Hield,IND,UTA,IND,,,17,16,15,3
22023,1627741,22300550,"JAN 14, 2024",IND @ DEN,L,28,6,13,0.462,2,9,0.222,2,2,1.0,0,2,2,1,2,0,1,2,16,1,1,Buddy Hield,IND,DEN,IND,,,19,18,17,3
22023,1627741,22300533,"JAN 12, 2024",IND @ ATL,W,23,7,11,0.636,4,6,0.667,0,0,0.0,0,3,3,2,0,3,2,3,18,14,1,Buddy Hield,IND,ATL,IND,,,23,21,20,5
22023,1627741,22300520,"JAN 10, 2024",IND vs. WAS,W,19,0,5,0.0,0,3,0.0,0,0,0.0,1,2,3,4,0,0,1,1,0,12,1,Buddy Hield,IND,IND,WAS,,,7,3,4,7
22023,1627741,22300507,"JAN 08, 2024",IND vs. BOS,W,25,6,11,0.545,3,7,0.429,0,0,0.0,1,3,4,3,1,1,1,3,15,7,1,Buddy Hield,IND,IND,BOS,,,22,19,18,7
22023,1627741,22300493,"JAN 06, 2024",IND vs. BOS,L,31,6,16,0.375,3,10,0.3,0,0,0.0,0,2,2,3,0,0,0,3,15,-5,1,Buddy Hield,IND,IND,BOS,,,20,17,18,5
22023,1627741,22300480,"JAN 05, 2024",IND vs. ATL,W,17,4,9,0.444,3,8,0.375,0,0,0.0,0,3,3,1,0,0,1,4,11,9,1,Buddy Hield,IND,IND,ATL,,,15,14,12,4
22023,1627741,22300466,"JAN 03, 2024",IND vs. MIL,W,13,3,8,0.375,2,4,0.5,2,3,0.667,0,0,0,0,1,0,0,1,10,1,1,Buddy Hield,IND,IND,MIL,,,10,10,10,0
22023,1627741,22300454,"JAN 01, 2024",IND @ MIL,W,21,0,6,0.0,0,4,0.0,0,0,0.0,2,1,3,0,0,0,0,2,0,4,1,Buddy Hield,IND,MIL,IND,,,3,3,0,3
22023,1627741,22300441,"DEC 30, 2023",IND vs. NYK,W,18,2,3,0.667,1,2,0.5,1,1,1.0,0,2,2,1,1,0,1,1,6,4,1,Buddy Hield,IND,IND,NYK,,,9,8,7,3
22023,1627741,22300422,"DEC 28, 2023",IND @ CHI,W,33,7,13,0.538,5,10,0.5,0,0,0.0,0,6,6,2,1,1,3,3,19,22,1,Buddy Hield,IND,CHI,IND,,,27,25,21,8
22023,1627741,22300409,"DEC 26, 2023",IND @ HOU,W,33,4,14,0.286,3,11,0.273,0,0,0.0,1,4,5,5,0,0,0,1,11,-10,1,Buddy Hield,IND,HOU,IND,,,21,16,16,10
22023,1627741,22300391,"DEC 23, 2023",IND vs. ORL,L,38,7,15,0.467,5,11,0.455,1,1,1.0,1,6,7,1,1,1,2,4,20,11,1,Buddy Hield,IND,IND,ORL,,,28,27,21,8
22023,1627741,22300377,"DEC 21, 2023",IND @ MEM,L,32,5,14,0.357,5,13,0.385,0,0,0.0,2,4,6,4,2,0,2,2,15,4,1,Buddy Hield,IND,MEM,IND,,,25,21,19,10
22023,1627741,22300365,"DEC 20, 2023",IND vs. CHA,W,26,8,13,0.615,4,8,0.5,5,5,1.0,2,2,4,3,1,3,2,2,25,10,1,Buddy Hield,IND,IND,CHA,,,32,29,28,7
22023,1627741,22300350,"DEC 18, 2023",IND vs. LAC,L,30,5,9,0.556,3,7,0.429,1,2,0.5,0,0,0,4,0,1,2,2,14,-12,1,Buddy Hield,IND,IND,LAC,,,18,14,18,4
22023,1627741,22300338,"DEC 16, 2023",IND @ MIN,L,18,0,4,0.0,0,3,0.0,0,0,0.0,0,1,1,2,0,0,3,1,0,-11,1,Buddy Hield,IND,MIN,IND,,,3,1,2,3
22023,1627741,22300328,"DEC 15, 2023",IND @ WAS,L,27,4,14,0.286,3,11,0.273,0,0,0.0,0,3,3,3,2,3,2,1,11,-15,1,Buddy Hield,IND,WAS,IND,,,17,14,14,6
22023,1627741,22300315,"DEC 13, 2023",IND @ MIL,L,27,3,9,0.333,1,6,0.167,0,0,0.0,2,1,3,2,0,0,1,1,7,-10,1,Buddy Hield,IND,MIL,IND,,,12,10,9,5
22023,1627741,22300293,"DEC 11, 2023",IND @ DET,W,31,6,9,0.667,4,7,0.571,0,0,0.0,0,3,3,2,1,0,0,1,16,2,1,Buddy Hield,IND,DET,IND,,,21,19,18,5
22023,1627741,22301229,"DEC 07, 2023",IND @ MIL,W,30,3,11,0.273,0,6,0.0,2,2,1.0,4,7,11,2,2,1,2,3,8,0,1,Buddy Hield,IND,MIL,IND,,,21,19,10,13
22023,1627741,22301202,"DEC 04, 2023",IND vs. BOS,W,32,7,11,0.636,4,6,0.667,3,4,0.75,2,0,2,2,2,0,1,2,21,29,1,Buddy Hield,IND,IND,BOS,,,25,23,23,4
22023,1627741,22300284,"DEC 02, 2023",IND @ MIA,W,24,3,7,0.429,1,4,0.25,0,0,0.0,0,1,1,2,2,0,1,3,7,20,1,Buddy Hield,IND,MIA,IND,,,10,8,9,3
22023,1627741,22300267,"NOV 30, 2023",IND @ MIA,L,31,5,16,0.313,2,11,0.182,0,0,0.0,1,4,5,5,1,2,1,6,12,-13,1,Buddy Hield,IND,MIA,IND,,,22,17,17,10
22023,1627741,22300254,"NOV 27, 2023",IND vs. POR,L,24,3,10,0.3,1,6,0.167,2,2,1.0,0,1,1,3,1,1,2,1,9,4,1,Buddy Hield,IND,IND,POR,,,13,10,12,4
22023,1627741,22300047,"NOV 24, 2023",IND vs. DET,W,28,6,11,0.545,3,6,0.5,3,3,1.0,0,4,4,0,0,0,0,2,18,-7,1,Buddy Hield,IND,IND,DET,,,22,22,18,4
22023,1627741,22300230,"NOV 22, 2023",IND vs. TOR,L,35,12,17,0.706,7,12,0.583,0,0,0.0,0,2,2,5,2,1,1,2,31,10,1,Buddy Hield,IND,IND,TOR,,,38,33,36,7
22023,1627741,22300039,"NOV 21, 2023",IND @ ATL,W,31,9,11,0.818,6,6,1.0,0,0,0.0,1,1,2,1,0,0,1,3,24,20,1,Buddy Hield,IND,ATL,IND,,,27,26,25,3
22023,1627741,22300209,"NOV 19, 2023",IND vs. ORL,L,15,1,4,0.25,1,4,0.25,0,0,0.0,0,1,1,2,0,0,1,4,3,-15,1,Buddy Hield,IND,IND,ORL,,,6,4,5,3
22023,1627741,22300019,"NOV 14, 2023",IND @ PHI,W,29,1,5,0.2,0,3,0.0,0,0,0.0,0,2,2,1,1,0,5,2,2,10,1,Buddy Hield,IND,PHI,IND,,,5,4,3,3
22023,1627741,22300180,"NOV 12, 2023",IND @ PHI,L,21,6,14,0.429,4,8,0.5,0,0,0.0,1,3,4,3,1,1,0,0,16,-1,1,Buddy Hield,IND,PHI,IND,,,23,20,19,7
22023,1627741,22300171,"NOV 09, 2023",IND vs. MIL,W,22,4,14,0.286,2,11,0.182,1,1,1.0,0,2,2,2,1,0,2,3,11,-21,1,Buddy Hield,IND,IND,MIL,,,15,13,13,4
22023,1627741,22300158,"NOV 08, 2023",IND vs. UTA,W,22,4,16,0.25,2,12,0.167,0,0,0.0,0,3,3,1,1,1,1,2,10,10,1,Buddy Hield,IND,IND,UTA,,,14,13,11,4
22023,1627741,22300146,"NOV 06, 2023",IND vs. SAS,W,21,7,8,0.875,5,6,0.833,0,0,0.0,0,2,2,2,1,0,4,1,19,22,1,Buddy Hield,IND,IND,SAS,,,23,21,21,4
22023,1627741,22300133,"NOV 04, 2023",IND vs. CHA,L,26,7,15,0.467,5,13,0.385,0,1,0.0,2,4,6,2,0,2,2,1,19,-1,1,Buddy Hield,IND,IND,CHA,,,27,25,21,8
22023,1627741,22300001,"NOV 03, 2023",IND vs. CLE,W,30,5,9,0.556,4,7,0.571,0,0,0.0,0,5,5,2,0,1,1,2,14,16,1,Buddy Hield,IND,IND,CLE,,,21,19,16,7
22023,1627741,22300118,"NOV 01, 2023",IND @ BOS,L,24,3,8,0.375,1,4,0.25,0,0,0.0,1,3,4,5,1,0,1,3,7,-16,1,Buddy Hield,IND,BOS,IND,,,16,11,12,9
22023,1627741,22300102,"OCT 30, 2023",IND vs. CHI,L,19,4,12,0.333,3,8,0.375,0,0,0.0,3,2,5,4,0,0,2,0,11,-2,1,Buddy Hield,IND,IND,CHI,,,20,16,15,9
22023,1627741,22300091,"OCT 28, 2023",IND @ CLE,W,19,4,12,0.333,2,7,0.286,0,0,0.0,0,1,1,4,0,1,1,1,10,6,1,Buddy Hield,IND,CLE,IND,,,15,11,14,5
22023,1627741,22300064,"OCT 25, 2023",IND vs. WAS,W,25,5,9,0.556,4,7,0.571,0,0,0.0,0,2,2,5,1,1,1,0,14,15,1,Buddy Hield,IND,IND,WAS,,,21,16,19,7
22023,1629312,22300562,"JAN 15, 2024",MIA @ BKN,W,12,0,2,0.0,0,1,0.0,0,0,0.0,0,1,1,0,0,0,0,2,0,-16,1,Haywood Highsmith,MIA,BKN,MIA,,,1,1,0,1
22023,1629312,22300551,"JAN 14, 2024",MIA vs. CHA,W,31,3,5,0.6,1,1,1.0,0,0,0.0,0,2,2,2,2,1,0,0,7,11,1,Haywood Highsmith,MIA,MIA,CHA,,,11,9,9,4
22023,1629312,22300535,"JAN 12, 2024",MIA vs. ORL,W,32,2,5,0.4,1,3,0.333,2,2,1.0,2,6,8,1,1,0,1,2,7,-5,1,Haywood Highsmith,MIA,MIA,ORL,,,16,15,8,9
22023,1629312,22300522,"JAN 10, 2024",MIA vs. OKC,L,35,7,14,0.5,5,7,0.714,0,0,0.0,2,3,5,2,1,0,0,2,19,-1,1,Haywood Highsmith,MIA,MIA,OKC,,,26,24,21,7
22023,1629312,22300509,"JAN 08, 2024",MIA vs. HOU,W,16,1,2,0.5,1,2,0.5,0,0,0.0,0,3,3,0,0,0,0,0,3,-4,1,Haywood Highsmith,MIA,MIA,HOU,,,6,6,3,3
22023,1629312,22300439,"DEC 30, 2023",MIA @ UTA,L,26,1,5,0.2,0,4,0.0,2,2,1.0,0,6,6,1,2,1,2,2,4,4,1,Haywood Highsmith,MIA,UTA,MIA,,,11,10,5,7
22023,1629312,22300426,"DEC 28, 2023",MIA @ GSW,W,18,1,3,0.333,1,2,0.5,0,0,0.0,0,0,0,0,1,0,0,4,3,4,1,Haywood Highsmith,MIA,GSW,MIA,,,3,3,3,0
22023,1629312,22300384,"DEC 22, 2023",MIA vs. ATL,W,10,2,6,0.333,1,3,0.333,0,0,0.0,3,2,5,2,0,0,0,2,5,-4,1,Haywood Highsmith,MIA,MIA,ATL,,,12,10,7,7
22023,1629312,22300366,"DEC 20, 2023",MIA @ ORL,W,30,5,12,0.417,4,9,0.444,1,2,0.5,4,2,6,2,2,0,1,3,15,6,1,Haywood Highsmith,MIA,ORL,MIA,,,23,21,17,8
22023,1629312,22300353,"DEC 18, 2023",MIA vs. MIN,L,12,0,0,0.0,0,0,0.0,0,0,0.0,1,0,1,1,1,1,1,2,0,-10,1,Haywood Highsmith,MIA,MIA,MIN,,,2,1,1,2
22023,1629312,22300337,"DEC 16, 2023",MIA vs. CHI,W,14,1,2,0.5,0,1,0.0,0,1,0.0,1,0,1,1,0,0,0,2,2,-10,1,Haywood Highsmith,MIA,MIA,CHI,,,4,3,3,2
22023,1629312,22300284,"DEC 02, 2023",MIA vs. IND,L,3,0,1,0.0,0,1,0.0,0,0,0.0,0,0,0,0,0,0,1,1,0,-1,1,Haywood Highsmith,MIA,MIA,IND,,,0,0,0,0
22023,1629312,22300267,"NOV 30, 2023",MIA vs. IND,W,15,1,2,0.5,0,1,0.0,0,0,0.0,0,1,1,1,0,0,1,4,2,-12,1,Haywood Highsmith,MIA,MIA,IND,,,4,3,3,2
22023,1629312,22300240,"NOV 25, 2023",MIA @ BKN,L,15,3,7,0.429,2,3,0.667,0,0,0.0,1,3,4,0,0,1,1,2,8,-22,1,Haywood Highsmith,MIA,BKN,MIA,,,12,12,8,4
22023,1629312,22300045,"NOV 24, 2023",MIA @ NYK,L,24,1,6,0.167,1,5,0.2,2,2,1.0,0,3,3,3,2,0,2,1,5,10,1,Haywood Highsmith,MIA,NYK,MIA,,,11,8,8,6
22023,1629312,22300229,"NOV 22, 2023",MIA @ CLE,W,25,4,6,0.667,2,3,0.667,0,0,0.0,1,5,6,5,1,2,0,4,10,18,1,Haywood Highsmith,MIA,CLE,MIA,,,21,16,15,11
22023,1629312,22300220,"NOV 20, 2023",MIA @ CHI,W,20,3,4,0.75,1,1,1.0,0,0,0.0,1,1,2,3,1,0,1,3,7,1,1,Haywood Highsmith,MIA,CHI,MIA,,,12,9,10,5
22023,1629312,22300204,"NOV 18, 2023",MIA @ CHI,L,24,0,4,0.0,0,3,0.0,0,0,0.0,1,2,3,0,3,0,4,1,0,20,1,Haywood Highsmith,MIA,CHI,MIA,,,3,3,0,3
22023,1629312,22300200,"NOV 16, 2023",MIA vs. BKN,W,23,2,5,0.4,0,3,0.0,2,2,1.0,0,1,1,0,0,0,1,3,6,3,1,Haywood Highsmith,MIA,MIA,BKN,,,7,7,6,1
22023,1629312,22300017,"NOV 14, 2023",MIA @ CHA,W,33,5,8,0.625,2,5,0.4,0,0,0.0,1,3,4,2,5,2,0,1,12,6,1,Haywood Highsmith,MIA,CHA,MIA,,,18,16,14,6
22023,1629312,22300184,"NOV 12, 2023",MIA @ SAS,W,26,0,4,0.0,0,3,0.0,0,0,0.0,1,3,4,1,0,0,0,3,0,-20,1,Haywood Highsmith,MIA,SAS,MIA,,,5,4,1,5
22023,1629312,22300175,"NOV 11, 2023",MIA @ ATL,W,34,3,13,0.231,0,5,0.0,5,7,0.714,1,5,6,5,2,1,1,2,11,10,1,Haywood Highsmith,MIA,ATL,MIA,,,22,17,16,11
22023,1629312,22300164,"NOV 08, 2023",MIA @ MEM,W,27,5,7,0.714,2,4,0.5,2,2,1.0,2,0,2,1,1,3,0,2,14,12,1,Haywood Highsmith,MIA,MEM,MIA,,,17,16,15,3
22023,1629312,22300150,"NOV 06, 2023",MIA vs. LAL,W,22,2,6,0.333,1,5,0.2,0,0,0.0,0,1,1,0,1,1,0,2,5,10,1,Haywood Highsmith,MIA,MIA,LAL,,,6,6,5,1
22023,1629312,22300003,"NOV 03, 2023",MIA vs. WAS,W,22,3,4,0.75,2,3,0.667,0,0,0.0,0,0,0,0,0,0,2,3,8,10,1,Haywood Highsmith,MIA,MIA,WAS,,,8,8,8,0
22023,1629312,22300119,"NOV 01, 2023",MIA vs. BKN,L,22,3,5,0.6,3,4,0.75,0,0,0.0,0,4,4,2,1,1,1,0,9,-9,1,Haywood Highsmith,MIA,MIA,BKN,,,15,13,11,6
22023,1630207,22300385,"DEC 22, 2023",HOU vs. DAL,W,10,1,3,0.333,1,2,0.5,0,0,0.0,1,1,2,1,0,0,1,3,3,-5,1,Nate Hinton,HOU,HOU,DAL,,,6,5,4,3
22023,1630207,22300291,"DEC 02, 2023",HOU @ LAL,L,3,0,1,0.0,0,0,0.0,0,0,0.0,0,2,2,0,0,0,0,1,0,8,1,Nate Hinton,HOU,LAL,HOU,,,2,2,0,2
22023,1630207,22300263,"NOV 29, 2023",HOU @ DEN,L,6,1,1,1.0,1,1,1.0,0,0,0.0,1,0,1,0,0,0,0,0,3,7,1,Nate Hinton,HOU,DEN,HOU,,,4,4,3,1
22023,1630207,22300153,"NOV 06, 2023",HOU vs. SAC,W,7,2,4,0.5,2,2,1.0,0,0,0.0,0,0,0,0,0,0,0,1,6,-11,1,Nate Hinton,HOU,HOU,SAC,,,6,6,6,0
22023,1630207,22300137,"NOV 04, 2023",HOU vs. SAC,W,1,0,0,0.0,0,0,0.0,0,0,0.0,0,0,0,0,0,0,0,0,0,0,1,Nate Hinton,HOU,HOU,SAC,,,0,0,0,0
22023,1641793,22300331,"DEC 15, 2023",LAL @ SAS,L,8,2,3,0.667,1,2,0.5,0,0,0.0,0,0,0,3,0,0,0,0,5,5,1,D'Moi Hodge,LAL,SAS,LAL,,,8,5,8,3
22023,1641793,22300271,"NOV 30, 2023",LAL @ OKC,L,4,0,1,0.0,0,1,0.0,0,0,0.0,0,0,0,0,0,0,0,0,0,-5,1,D'Moi Hodge,LAL,OKC,LAL,,,0,0,0,0
22023,1641793,22300258,"NOV 29, 2023",LAL @ DET,W,5,1,3,0.333,1,2,0.5,0,0,0.0,0,0,0,0,1,0,0,1,3,-7,1,D'Moi Hodge,LAL,DET,LAL,,,3,3,3,0
22023,1641793,22300255,"NOV 27, 2023",LAL @ PHI,L,8,1,3,0.333,1,3,0.333,0,0,0.0,0,0,0,1,0,0,0,1,3,-17,1,D'Moi Hodge,LAL,PHI,LAL,,,4,3,4,1
22023,1641793,22300198,"NOV 15, 2023",LAL vs. SAC,L,1,0,0,0.0,0,0,0.0,0,0,0.0,0,0,0,0,0,0,0,0,0,-4,1,D'Moi Hodge,LAL,LAL,SAC,,,0,0,0,0
22023,1641793,22300163,"NOV 08, 2023",LAL @ HOU,L,10,1,3,0.333,0,2,0.0,1,2,0.5,0,0,0,1,0,1,1,1,3,-4,1,D'Moi Hodge,LAL,HOU,LAL,,,4,3,4,1
22023,1641793,22300134,"NOV 04, 2023",LAL @ ORL,L,4,0,2,0.0,0,2,0.0,0,0,0.0,0,0,0,0,0,0,0,1,0,-3,1,D'Moi Hodge,LAL,ORL,LAL,,,0,0,0,0
22023,1628988,22300555,"JAN 15, 2024",HOU @ PHI,L,6,0,1,0.0,0,1,0.0,0,0,0.0,0,1,1,1,0,0,0,0,0,-5,1,Aaron Holiday,HOU,PHI,HOU,,,2,1,1,2
22023,1628988,22300542,"JAN 13, 2024",HOU @ BOS,L,9,2,6,0.333,0,3,0.0,1,2,0.5,0,0,0,1,0,0,0,0,5,-13,1,Aaron Holiday,HOU,BOS,HOU,,,6,5,6,1
22023,1628988,22300534,"JAN 12, 2024",HOU @ DET,W,3,0,0,0.0,0,0,0.0,0,0,0.0,0,1,1,0,0,0,0,0,0,-9,1,Aaron Holiday,HOU,DET,HOU,,,1,1,0,1
22023,1628988,22300523,"JAN 10, 2024",HOU @ CHI,L,11,1,3,0.333,0,1,0.0,2,2,1.0,1,1,2,0,2,0,2,0,4,-1,1,Aaron Holiday,HOU,CHI,HOU,,,6,6,4,2
22023,1628988,22300509,"JAN 08, 2024",HOU @ MIA,L,23,2,6,0.333,1,5,0.2,3,3,1.0,0,4,4,1,1,0,0,2,8,10,1,Aaron Holiday,HOU,MIA,HOU,,,13,12,9,5
22023,1628988,22300496,"JAN 06, 2024",HOU vs. MIL,W,21,4,7,0.571,3,5,0.6,0,0,0.0,0,1,1,0,0,0,2,1,11,3,1,Aaron Holiday,HOU,HOU,MIL,,,12,12,11,1
22023,1628988,22300485,"JAN 05, 2024",HOU vs. MIN,L,19,2,3,0.667,1,1,1.0,0,0,0.0,0,2,2,2,0,0,0,0,5,-14,1,Aaron Holiday,HOU,HOU,MIN,,,9,7,7,4
22023,1628988,22300469,"JAN 03, 2024",HOU vs. BKN,W,14,1,5,0.2,1,3,0.333,0,0,0.0,0,1,1,3,0,0,1,2,3,-5,1,Aaron Holiday,HOU,HOU,BKN,,,7,4,6,4
22023,1628988,22300453,"JAN 01, 2024",HOU vs. DET,W,11,0,3,0.0,0,1,0.0,0,0,0.0,1,2,3,4,0,0,0,1,0,8,1,Aaron Holiday,HOU,HOU,DET,,,7,3,4,7
22023,1628988,22300434,"DEC 29, 2023",HOU vs. PHI,L,15,2,6,0.333,0,2,0.0,0,0,0.0,1,1,2,3,2,0,3,2,4,-5,1,Aaron Holiday,HOU,HOU,PHI,,,9,6,7,5
22023,1628988,22300418,"DEC 27, 2023",HOU vs. PHX,L,24,4,13,0.308,3,8,0.375,2,2,1.0,0,2,2,2,0,0,2,2,13,-3,1,Aaron Holiday,HOU,HOU,PHX,,,17,15,15,4
22023,1628988,22300409,"DEC 26, 2023",HOU vs. IND,L,25,6,10,0.6,3,6,0.5,0,0,0.0,0,3,3,1,1,0,1,1,15,9,1,Aaron Holiday,HOU,HOU,IND,,,19,18,16,4
22023,1628988,22300392,"DEC 23, 2023",HOU @ NOP,W,15,1,2,0.5,1,2,0.5,2,2,1.0,0,1,1,1,1,0,1,0,5,2,1,Aaron Holiday,HOU,NOP,HOU,,,7,6,6,2
22023,1628988,22300385,"DEC 22, 2023",HOU vs. DAL,W,15,1,3,0.333,1,3,0.333,0,0,0.0,0,3,3,0,0,0,2,0,3,-5,1,Aaron Holiday,HOU,HOU,DAL,,,6,6,3,3
22023,1628988,22300371,"DEC 20, 2023",HOU vs. ATL,L,26,3,8,0.375,2,5,0.4,0,0,0.0,0,2,2,0,0,0,2,1,8,2,1,Aaron Holiday,HOU,HOU,ATL,,,10,10,8,2
22023,1628988,22300349,"DEC 18, 2023",HOU @ CLE,L,17,5,9,0.556,2,5,0.4,2,2,1.0,1,1,2,0,0,0,0,4,14,3,1,Aaron Holiday,HOU,CLE,HOU,,,16,16,14,2
22023,1628988,22300346,"DEC 17, 2023",HOU @ MIL,L,13,0,3,0.0,0,1,0.0,0,0,0.0,0,1,1,2,1,0,2,2,0,-3,1,Aaron Holiday,HOU,MIL,HOU,,,3,1,2,3
22023,1628988,22300332,"DEC 15, 2023",HOU @ MEM,W,19,1,5,0.2,1,3,0.333,1,1,1.0,1,1,2,0,1,1,0,1,4,7,1,Aaron Holiday,HOU,MEM,HOU,,,6,6,4,2
22023,1628988,22300314,"DEC 13, 2023",HOU vs. MEM,W,14,2,6,0.333,2,3,0.667,0,0,0.0,0,0,0,2,0,1,1,2,6,-9,1,Aaron Holiday,HOU,HOU,MEM,,,8,6,8,2
22023,1628988,22300298,"DEC 11, 2023",HOU vs. SAS,W,15,1,6,0.167,1,5,0.2,4,4,1.0,1,1,2,0,0,0,0,2,7,14,1,Aaron Holiday,HOU,HOU,SAS,,,9,9,7,2
22023,1628988,22301224,"DEC 08, 2023",HOU @ DEN,W,16,3,5,0.6,2,2,1.0,0,1,0.0,0,1,1,1,0,0,2,1,8,19,1,Aaron Holiday,HOU,DEN,HOU,,,10,9,9,2
22023,1628988,22301212,"DEC 06, 2023",HOU vs. OKC,W,27,8,13,0.615,6,7,0.857,0,0,0.0,1,5,6,4,1,0,0,3,22,-5,1,Aaron Holiday,HOU,HOU,OKC,,,32,28,26,10
22023,1628988,22300291,"DEC 02, 2023",HOU @ LAL,L,14,5,6,0.833,1,2,0.5,0,0,0.0,1,0,1,3,0,0,0,2,11,6,1,Aaron Holiday,HOU,LAL,HOU,,,15,12,14,4
22023,1628988,22300263,"NOV 29, 2023",HOU @ DEN,L,35,4,10,0.4,0,5,0.0,1,1,1.0,0,3,3,5,0,0,0,2,9,-16,1,Aaron Holiday,HOU,DEN,HOU,,,17,12,14,8
22023,1628988,22300059,"NOV 28, 2023",HOU @ DAL,L,21,3,8,0.375,2,4,0.5,0,0,0.0,1,3,4,4,0,0,1,3,8,-6,1,Aaron Holiday,HOU,DAL,HOU,,,16,12,12,8
22023,1628988,22300048,"NOV 24, 2023",HOU vs. DEN,W,15,3,4,0.75,1,1,1.0,0,0,0.0,0,0,0,0,1,1,0,2,7,2,1,Aaron Holiday,HOU,HOU,DEN,,,7,7,7,0
22023,1628988,22300231,"NOV 22, 2023",HOU vs. MEM,W,17,3,6,0.5,1,4,0.25,0,0,0.0,0,3,3,2,0,0,0,3,7,2,1,Aaron Holiday,HOU,HOU,MEM,,,12,10,9,5
22023,1628988,22300224,"NOV 20, 2023",HOU @ GSW,L,28,4,5,0.8,3,4,0.75,2,3,0.667,0,4,4,1,4,0,0,3,13,8,1,Aaron Holiday,HOU,GSW,HOU,,,18,17,14,5
22023,1628988,22300216,"NOV 19, 2023",HOU @ LAL,L,15,0,3,0.0,0,2,0.0,0,0,0.0,0,0,0,5,0,0,1,4,0,2,1,Aaron Holiday,HOU,LAL,HOU,,,5,0,5,5
22023,1628988,22300037,"NOV 17, 2023",HOU @ LAC,L,18,2,3,0.667,1,2,0.5,0,0,0.0,0,1,1,2,1,0,0,2,5,9,1,Aaron Holiday,HOU,LAC,HOU,,,8,6,7,3
22023,1628988,22300182,"NOV 12, 2023",HOU vs. DEN,W,17,2,8,0.25,1,5,0.2,0,0,0.0,0,2,2,2,0,0,0,1,5,8,1,Aaron Holiday,HOU,HOU,DEN,,,9,7,7,4
22023,1628988,22300011,"NOV 10, 2023",HOU vs. NOP,W,14,1,5,0.2,1,3,0.333,2,2,1.0,0,0,0,2,1,0,0,0,5,8,1,Aaron Holiday,HOU,HOU,NOP,,,7,5,7,2
22023,1628988,22300163,"NOV 08, 2023",HOU vs. LAL,W,23,3,6,0.5,1,2,0.5,0,0,0.0,0,2,2,3,0,0,0,3,7,12,1,Aaron Holiday,HOU,HOU,LAL,,,12,9,10,5
22023,1628988,22300153,"NOV 06, 2023",HOU vs. SAC,W,21,6,6,1.0,0,0,0.0,1,1,1.0,0,3,3,1,1,0,2,1,13,16,1,Aaron Holiday,HOU,HOU,SAC,,,17,16,14,4
22023,1628988,22300137,"NOV 04, 2023",HOU vs. SAC,W,19,0,4,0.0,0,2,0.0,0,0,0.0,1,2,3,0,0,0,1,1,0,-1,1,Aaron Holiday,HOU,HOU,SAC,,,3,3,0,3
22023,1628988,22300122,"NOV 01, 2023",HOU vs. CHA,W,11,2,2,1.0,2,2,1.0,0,0,0.0,0,1,1,1,0,0,1,1,6,-1,1,Aaron Holiday,HOU,HOU,CHA,,,8,7,7,2
22023,1628988,22300066,"OCT 25, 2023",HOU @ ORL,L,5,0,3,0.0,0,1,0.0,0,0,0.0,0,0,0,0,0,0,0,0,0,-9,1,Aaron Holiday,HOU,ORL,HOU,,,0,0,0,0
22023,201950,22300563,"JAN 15, 2024",BOS @ TOR,W,34,7,14,0.5,4,6,0.667,4,4,1.0,1,5,6,7,1,2,1,2,22,4,1,Jrue Holiday,BOS,TOR,BOS,,,35,28,29,13
22023,201950,22300542,"JAN 13, 2024",BOS vs. HOU,W,26,4,10,0.4,1,4,0.25,2,2,1.0,2,4,6,3,0,0,1,2,11,22,1,Jrue Holiday,BOS,BOS,HOU,,,20,17,14,9
22023,201950,22300528,"JAN 11, 2024",BOS @ MIL,L,19,2,9,0.222,0,4,0.0,2,2,1.0,1,3,4,2,0,0,1,1,6,-31,1,Jrue Holiday,BOS,MIL,BOS,,,12,10,8,6
22023,201950,22300517,"JAN 10, 2024",BOS vs. MIN,W,40,5,15,0.333,2,10,0.2,0,0,0.0,1,4,5,4,2,1,2,3,12,8,1,Jrue Holiday,BOS,BOS,MIN,,,21,17,16,9
22023,201950,22300507,"JAN 08, 2024",BOS @ IND,L,38,9,16,0.563,3,6,0.5,0,0,0.0,1,5,6,6,1,0,3,2,21,0,1,Jrue Holiday,BOS,IND,BOS,,,33,27,27,12
22023,201950,22300493,"JAN 06, 2024",BOS @ IND,W,37,3,9,0.333,1,5,0.2,1,2,0.5,1,5,6,5,1,0,2,2,8,6,1,Jrue Holiday,BOS,IND,BOS,,,19,14,13,11
22023,201950,22300479,"JAN 05, 2024",BOS vs. UTA,W,24,6,8,0.75,2,3,0.667,0,0,0.0,1,5,6,1,0,2,2,1,14,22,1,Jrue Holiday,BOS,BOS,UTA,,,21,20,15,7
22023,201950,22300462,"JAN 02, 2024",BOS @ OKC,L,31,2,8,0.25,2,5,0.4,1,2,0.5,1,4,5,7,1,0,3,1,7,-15,1,Jrue Holiday,BOS,OKC,BOS,,,19,12,14,12
22023,201950,22300432,"DEC 29, 2023",BOS vs. TOR,W,32,5,15,0.333,3,5,0.6,2,4,0.5,0,2,2,3,0,0,1,1,15,8,1,Jrue Holiday,BOS,BOS,TOR,,,20,17,18,5
22023,201950,22300421,"DEC 28, 2023",BOS vs. DET,W,44,4,9,0.444,0,2,0.0,4,5,0.8,2,7,9,3,1,1,3,1,12,1,1,Jrue Holiday,BOS,BOS,DET,,,24,21,15,12
22023,201950,22300403,"DEC 25, 2023",BOS @ LAL,W,38,7,10,0.7,3,5,0.6,1,1,1.0,2,5,7,7,1,1,2,1,18,15,1,Jrue Holiday,BOS,LAL,BOS,,,32,25,25,14
22023,201950,22300389,"DEC 23, 2023",BOS @ LAC,W,28,8,12,0.667,4,6,0.667,0,0,0.0,3,3,6,7,1,0,1,1,20,22,1,Jrue Holiday,BOS,LAC,BOS,,,33,26,27,13
22023,201950,22300373,"DEC 20, 2023",BOS @ SAC,W,34,7,13,0.538,4,6,0.667,3,3,1.0,2,6,8,10,2,1,3,1,21,17,1,Jrue Holiday,BOS,SAC,BOS,,,39,29,31,18
22023,201950,22300362,"DEC 19, 2023",BOS @ GSW,L,36,5,12,0.417,1,5,0.2,2,2,1.0,1,6,7,1,2,0,1,5,13,-14,1,Jrue Holiday,BOS,GSW,BOS,,,21,20,14,8
22023,201950,22300344,"DEC 17, 2023",BOS vs. ORL,W,34,6,12,0.5,2,5,0.4,0,0,0.0,1,5,6,0,0,2,3,2,14,17,1,Jrue Holiday,BOS,BOS,ORL,,,20,20,14,6
22023,201950,22300329,"DEC 15, 2023",BOS vs. ORL,W,28,2,7,0.286,2,3,0.667,0,0,0.0,1,3,4,4,2,1,0,2,6,12,1,Jrue Holiday,BOS,BOS,ORL,,,14,10,10,8
22023,201950,22300319,"DEC 14, 2023",BOS vs. CLE,W,37,7,11,0.636,1,3,0.333,0,0,0.0,2,1,3,4,0,0,2,2,15,11,1,Jrue Holiday,BOS,BOS,CLE,,,22,18,19,7
22023,201950,22300305,"DEC 12, 2023",BOS vs. CLE,W,34,4,7,0.571,3,5,0.6,0,0,0.0,2,2,4,2,3,1,1,3,11,2,1,Jrue Holiday,BOS,BOS,CLE,,,17,15,13,6
22023,201950,22301227,"DEC 08, 2023",BOS vs. NYK,W,35,7,11,0.636,1,3,0.333,1,1,1.0,0,6,6,5,2,1,1,1,16,7,1,Jrue Holiday,BOS,BOS,NYK,,,27,22,21,11
22023,201950,22301202,"DEC 04, 2023",BOS @ IND,L,38,3,9,0.333,1,5,0.2,2,2,1.0,1,5,6,3,1,1,1,1,9,-15,1,Jrue Holiday,BOS,IND,BOS,,,18,15,12,9
22023,201950,22300275,"DEC 01, 2023",BOS vs. PHI,W,35,4,11,0.364,3,5,0.6,2,2,1.0,0,5,5,6,1,0,3,2,13,7,1,Jrue Holiday,BOS,BOS,PHI,,,24,18,19,11
22023,201950,22300053,"NOV 28, 2023",BOS vs. CHI,W,33,5,8,0.625,4,5,0.8,0,0,0.0,1,6,7,9,1,0,3,3,14,19,1,Jrue Holiday,BOS,BOS,CHI,,,30,21,23,16
22023,201950,22300228,"NOV 22, 2023",BOS vs. MIL,W,35,1,8,0.125,1,5,0.2,2,2,1.0,1,7,8,1,1,1,2,3,5,-1,1,Jrue Holiday,BOS,BOS,MIL,,,14,13,6,9
22023,201950,22300217,"NOV 20, 2023",BOS @ CHA,L,37,5,11,0.455,1,3,0.333,0,2,0.0,3,3,6,5,1,2,7,1,11,-4,1,Jrue Holiday,BOS,CHA,BOS,,,22,17,16,11
22023,201950,22300213,"NOV 19, 2023",BOS @ MEM,W,37,2,7,0.286,1,3,0.333,2,2,1.0,2,4,6,4,0,0,2,1,7,-9,1,Jrue Holiday,BOS,MEM,BOS,,,17,13,11,10
22023,201950,22300031,"NOV 17, 2023",BOS @ TOR,W,35,5,14,0.357,2,4,0.5,2,2,1.0,2,6,8,5,0,0,1,2,14,-2,1,Jrue Holiday,BOS,TOR,BOS,,,27,22,19,13
22023,201950,22300194,"NOV 15, 2023",BOS @ PHI,W,35,8,18,0.444,2,9,0.222,0,1,0.0,2,8,10,3,1,2,1,0,18,16,1,Jrue Holiday,BOS,PHI,BOS,,,31,28,21,13
22023,201950,22300188,"NOV 13, 2023",BOS vs. NYK,W,37,5,9,0.556,3,5,0.6,1,1,1.0,4,3,7,2,0,0,2,2,14,5,1,Jrue Holiday,BOS,BOS,NYK,,,23,21,16,9
22023,201950,22300174,"NOV 11, 2023",BOS vs. TOR,W,30,4,9,0.444,0,2,0.0,0,0,0.0,0,3,3,7,1,2,4,2,8,22,1,Jrue Holiday,BOS,BOS,TOR,,,18,11,15,10
22023,201950,22300010,"NOV 10, 2023",BOS vs. BKN,W,33,6,14,0.429,1,5,0.2,0,0,0.0,3,9,12,9,2,0,0,2,13,26,1,Jrue Holiday,BOS,BOS,BKN,,,34,25,22,21
22023,201950,22300159,"NOV 08, 2023",BOS @ PHI,L,35,4,9,0.444,2,3,0.667,2,2,1.0,1,4,5,5,1,0,2,1,12,13,1,Jrue Holiday,BOS,PHI,BOS,,,22,17,17,10
22023,201950,22300154,"NOV 06, 2023",BOS @ MIN,L,42,4,16,0.25,0,4,0.0,4,6,0.667,3,8,11,6,1,0,3,3,12,-19,1,Jrue Holiday,BOS,MIN,BOS,,,29,23,18,17
22023,201950,22300136,"NOV 04, 2023",BOS @ BKN,W,40,6,15,0.4,4,9,0.444,2,2,1.0,4,5,9,10,0,1,3,1,18,14,1,Jrue Holiday,BOS,BKN,BOS,,,37,27,28,19
22023,201950,22300118,"NOV 01, 2023",BOS vs. IND,W,25,6,9,0.667,3,4,0.75,0,0,0.0,0,7,7,4,0,1,1,0,15,20,1,Jrue Holiday,BOS,BOS,IND,,,26,22,19,11
22023,201950,22300103,"OCT 30, 2023",BOS @ WAS,W,27,4,7,0.571,1,3,0.333,2,2,1.0,1,4,5,3,1,2,1,1,11,28,1,Jrue Holiday,BOS,WAS,BOS,,,19,16,14,8
22023,201950,22300080,"OCT 27, 2023",BOS vs. MIA,W,36,7,13,0.538,1,4,0.25,2,2,1.0,2,8,10,7,0,1,1,2,17,4,1,Jrue Holiday,BOS,BOS,MIA,,,34,27,24,17
22023,201950,22300065,"OCT 25, 2023",BOS @ NYK,W,35,4,10,0.4,1,5,0.2,0,0,0.0,2,2,4,2,0,3,2,3,9,3,1,Jrue Holiday,BOS,NYK,BOS,,,15,13,11,6
22023,203200,22300550,"JAN 14, 2024",DEN vs. IND,W,0,0,0,0.0,0,0,0.0,0,0,0.0,0,0,0,0,0,0,0,0,0,0,1,Justin Holiday,DEN,DEN,IND,,,0,0,0,0
22023,203200,22300539,"JAN 12, 2024",DEN vs. NOP,W,2,0,0,0.0,0,0,0.0,0,0,0.0,0,0,0,0,0,0,1,0,0,-6,1,Justin Holiday,DEN,DEN,NOP,,,0,0,0,0
22023,203200,22300524,"JAN 10, 2024",DEN @ UTA,L,12,1,3,0.333,1,3,0.333,0,0,0.0,0,0,0,1,1,0,0,2,3,11,1,Justin Holiday,DEN,UTA,DEN,,,4,3,4,1
22023,203200,22300502,"JAN 07, 2024",DEN vs. DET,W,4,0,0,0.0,0,0,0.0,0,0,0.0,0,0,0,0,0,0,0,0,0,-3,1,Justin Holiday,DEN,DEN,DET,,,0,0,0,0
22023,203200,22300488,"JAN 05, 2024",DEN vs. ORL,L,10,0,1,0.0,0,1,0.0,0,0,0.0,0,1,1,1,0,0,0,1,0,4,1,Justin Holiday,DEN,DEN,ORL,,,2,1,1,2
22023,203200,22300435,"DEC 29, 2023",DEN vs. OKC,L,16,0,3,0.0,0,2,0.0,0,0,0.0,0,1,1,2,0,0,0,1,0,-19,1,Justin Holiday,DEN,DEN,OKC,,,3,1,2,3
22023,203200,22300425,"DEC 28, 2023",DEN vs. MEM,W,18,3,5,0.6,2,3,0.667,0,0,0.0,0,2,2,1,2,0,0,2,8,1,1,Justin Holiday,DEN,DEN,MEM,,,11,10,9,3
22023,203200,22300356,"DEC 18, 2023",DEN vs. DAL,W,5,0,2,0.0,0,0,0.0,0,0,0.0,0,1,1,0,0,1,0,1,0,-6,1,Justin Holiday,DEN,DEN,DAL,,,1,1,0,1
22023,203200,22300340,"DEC 16, 2023",DEN vs. OKC,L,25,2,4,0.5,2,3,0.667,0,0,0.0,0,1,1,2,0,0,1,0,6,-8,1,Justin Holiday,DEN,DEN,OKC,,,9,7,8,3
22023,203200,22300322,"DEC 14, 2023",DEN vs. BKN,W,27,1,6,0.167,0,5,0.0,0,0,0.0,0,1,1,2,4,0,1,2,2,20,1,Justin Holiday,DEN,DEN,BKN,,,5,3,4,3
22023,203200,22300307,"DEC 12, 2023",DEN @ CHI,W,23,3,4,0.75,2,3,0.667,0,0,0.0,1,0,1,2,0,0,0,3,8,4,1,Justin Holiday,DEN,CHI,DEN,,,11,9,10,3
22023,203200,22301224,"DEC 08, 2023",DEN vs. HOU,L,6,1,1,1.0,0,0,0.0,0,0,0.0,0,0,0,0,1,0,0,1,2,-12,1,Justin Holiday,DEN,DEN,HOU,,,2,2,2,0
22023,203200,22300290,"DEC 02, 2023",DEN @ SAC,L,12,0,1,0.0,0,0,0.0,0,0,0.0,0,3,3,0,0,0,0,2,0,-3,1,Justin Holiday,DEN,SAC,DEN,,,3,3,0,3
22023,203200,22300279,"DEC 01, 2023",DEN @ PHX,W,25,6,8,0.75,3,5,0.6,0,0,0.0,1,1,2,4,1,0,0,2,15,8,1,Justin Holiday,DEN,PHX,DEN,,,21,17,19,6
22023,203200,22300263,"NOV 29, 2023",DEN vs. HOU,W,27,4,7,0.571,3,5,0.6,0,0,0.0,1,2,3,4,2,0,0,2,11,27,1,Justin Holiday,DEN,DEN,HOU,,,18,14,15,7
22023,203200,22300257,"NOV 27, 2023",DEN @ LAC,W,34,5,8,0.625,2,4,0.5,0,0,0.0,1,5,6,1,1,0,3,2,12,5,1,Justin Holiday,DEN,LAC,DEN,,,19,18,13,7
22023,203200,22300252,"NOV 26, 2023",DEN vs. SAS,W,27,2,5,0.4,1,4,0.25,0,0,0.0,0,2,2,3,1,0,0,2,5,15,1,Justin Holiday,DEN,DEN,SAS,,,10,7,8,5
22023,203200,22300048,"NOV 24, 2023",DEN @ HOU,L,13,1,2,0.5,1,2,0.5,0,0,0.0,0,0,0,0,1,0,0,2,3,9,1,Justin Holiday,DEN,HOU,DEN,,,3,3,3,0
22023,203200,22300226,"NOV 22, 2023",DEN @ ORL,L,0,0,0,0.0,0,0,0.0,0,0,0.0,0,0,0,0,0,0,0,0,0,0,1,Justin Holiday,DEN,ORL,DEN,,,0,0,0,0
22023,203200,22300210,"NOV 19, 2023",DEN @ CLE,L,17,2,3,0.667,2,3,0.667,0,0,0.0,0,1,1,1,0,0,0,2,6,1,1,Justin Holiday,DEN,CLE,DEN,,,8,7,7,2
22023,203200,22300024,"NOV 14, 2023",DEN vs. LAC,W,2,0,0,0.0,0,0,0.0,0,0,0.0,0,0,0,1,0,0,0,0,0,-1,1,Justin Holiday,DEN,DEN,LAC,,,1,0,1,1
22023,203200,22300169,"NOV 08, 2023",DEN vs. GSW,W,8,1,2,0.5,1,2,0.5,0,0,0.0,0,3,3,0,0,0,0,1,3,2,1,Justin Holiday,DEN,DEN,GSW,,,6,6,3,3
22023,203200,22300123,"NOV 01, 2023",DEN @ MIN,L,6,1,2,0.5,1,2,0.5,0,0,0.0,0,1,1,0,0,0,0,0,3,2,1,Justin Holiday,DEN,MIN,DEN,,,4,4,3,1
22023,203200,22300095,"OCT 29, 2023",DEN @ OKC,W,3,0,0,0.0,0,0,0.0,0,0,0.0,0,0,0,0,0,0,0,0,0,0,1,Justin Holiday,DEN,OKC,DEN,,,0,0,0,0
22023,1626158,22300515,"JAN 09, 2024",DAL vs. MEM,L,3,0,0,0.0,0,0,0.0,0,0,0.0,1,0,1,1,0,0,0,0,0,0,1,Richaun Holmes,DAL,DAL,MEM,,,2,1,1,2
22023,1626158,22300457,"JAN 01, 2024",DAL @ UTA,L,7,1,1,1.0,0,0,0.0,0,0,0.0,0,1,1,0,0,0,0,0,2,-13,1,Richaun Holmes,DAL,UTA,DAL,,,3,3,2,1
22023,1626158,22300385,"DEC 22, 2023",DAL @ HOU,L,22,7,12,0.583,0,0,0.0,2,3,0.667,5,3,8,1,1,0,1,2,16,10,1,Richaun Holmes,DAL,HOU,DAL,,,25,24,17,9
22023,1626158,22300356,"DEC 18, 2023",DAL @ DEN,L,7,1,5,0.2,0,0,0.0,0,0,0.0,2,3,5,0,0,0,0,0,2,0,1,Richaun Holmes,DAL,DEN,DAL,,,7,7,2,5
22023,1626158,22300321,"DEC 14, 2023",DAL vs. MIN,L,3,0,0,0.0,0,0,0.0,0,0,0.0,0,0,0,0,0,0,0,0,0,-4,1,Richaun Holmes,DAL,DAL,MIN,,,0,0,0,0
22023,1626158,22300306,"DEC 12, 2023",DAL vs. LAL,W,15,1,3,0.333,0,0,0.0,2,3,0.667,3,4,7,2,0,0,2,3,4,-4,1,Richaun Holmes,DAL,DAL,LAL,,,13,11,6,9
22023,1626158,22301213,"DEC 06, 2023",DAL vs. UTA,W,6,1,1,1.0,0,0,0.0,0,0,0.0,0,0,0,0,0,1,1,0,2,4,1,Richaun Holmes,DAL,DAL,UTA,,,2,2,2,0
22023,1626158,22300287,"DEC 02, 2023",DAL vs. OKC,L,5,0,0,0.0,0,0,0.0,1,2,0.5,0,1,1,0,0,0,0,0,1,-9,1,Richaun Holmes,DAL,DAL,OKC,,,2,2,1,1
22023,1626158,22300277,"DEC 01, 2023",DAL vs. MEM,L,18,2,4,0.5,0,0,0.0,1,2,0.5,3,4,7,2,1,2,1,1,5,5,1,Richaun Holmes,DAL,DAL,MEM,,,14,12,7,9
22023,1626158,22300059,"NOV 28, 2023",DAL vs. HOU,W,13,1,1,1.0,0,0,0.0,0,0,0.0,0,3,3,0,0,0,2,4,2,2,1,Richaun Holmes,DAL,DAL,HOU,,,5,5,2,3
22023,1626158,22300244,"NOV 25, 2023",DAL @ LAC,L,21,0,4,0.0,0,0,0.0,0,2,0.0,2,3,5,1,0,2,0,3,0,-6,1,Richaun Holmes,DAL,LAC,DAL,,,6,5,1,6
22023,1626158,22300238,"NOV 22, 2023",DAL @ LAL,W,23,1,2,0.5,0,0,0.0,2,4,0.5,3,7,10,1,0,1,0,3,4,3,1,Richaun Holmes,DAL,LAL,DAL,,,15,14,5,11
22023,1626158,22300212,"NOV 19, 2023",DAL vs. SAC,L,5,3,3,1.0,0,0,0.0,1,2,0.5,2,0,2,0,0,0,0,1,7,5,1,Richaun Holmes,DAL,DAL,SAC,,,9,9,7,2
22023,1626158,22300192,"NOV 15, 2023",DAL @ WAS,W,2,0,1,0.0,0,0,0.0,0,0,0.0,0,0,0,0,0,0,1,0,0,-5,1,Richaun Holmes,DAL,WAS,DAL,,,0,0,0,0
22023,1626158,22300022,"NOV 14, 2023",DAL @ NOP,L,12,3,6,0.5,0,0,0.0,0,0,0.0,3,4,7,0,0,0,1,2,6,8,1,Richaun Holmes,DAL,NOP,DAL,,,13,13,6,7
22023,1626158,22300183,"NOV 12, 2023",DAL @ NOP,W,4,1,1,1.0,0,0,0.0,0,0,0.0,0,1,1,0,0,0,0,1,2,-8,1,Richaun Holmes,DAL,NOP,DAL,,,3,3,2,1
22023,1626158,22300168,"NOV 08, 2023",DAL vs. TOR,L,7,1,2,0.5,0,0,0.0,0,0,0.0,2,1,3,1,0,0,1,2,2,1,1,Richaun Holmes,DAL,DAL,TOR,,,6,5,3,4
22023,1631096,22300565,"JAN 15, 2024",OKC @ LAL,L,30,4,9,0.444,1,4,0.25,0,0,0.0,1,7,8,4,1,3,3,5,9,-8,1,Chet Holmgren,OKC,LAL,OKC,17.5,Points,21,17,13,12
22023,1631096,22300565,"JAN 15, 2024",OKC @ LAL,L,30,4,9,0.444,1,4,0.25,0,0,0.0,1,7,8,4,1,3,3,5,9,-8,1,Chet Holmgren,OKC,LAL,OKC,7.5,Rebounds,21,17,13,12
22023,1631096,22300565,"JAN 15, 2024",OKC @ LAL,L,30,4,9,0.444,1,4,0.25,0,0,0.0,1,7,8,4,1,3,3,5,9,-8,1,Chet Holmgren,OKC,LAL,OKC,27.5,Pts+Rebs+Asts,21,17,13,12
22023,1631096,22300565,"JAN 15, 2024",OKC @ LAL,L,30,4,9,0.444,1,4,0.25,0,0,0.0,1,7,8,4,1,3,3,5,9,-8,1,Chet Holmgren,OKC,LAL,OKC,37.0,Fantasy Score,21,17,13,12
22023,1631096,22300565,"JAN 15, 2024",OKC @ LAL,L,30,4,9,0.444,1,4,0.25,0,0,0.0,1,7,8,4,1,3,3,5,9,-8,1,Chet Holmgren,OKC,LAL,OKC,6.0,Defensive Rebounds,21,17,13,12
22023,1631096,22300565,"JAN 15, 2024",OKC @ LAL,L,30,4,9,0.444,1,4,0.25,0,0,0.0,1,7,8,4,1,3,3,5,9,-8,1,Chet Holmgren,OKC,LAL,OKC,2.5,Free Throws Made,21,17,13,12
22023,1631096,22300565,"JAN 15, 2024",OKC @ LAL,L,30,4,9,0.444,1,4,0.25,0,0,0.0,1,7,8,4,1,3,3,5,9,-8,1,Chet Holmgren,OKC,LAL,OKC,13.0,FG Attempted,21,17,13,12
22023,1631096,22300565,"JAN 15, 2024",OKC @ LAL,L,30,4,9,0.444,1,4,0.25,0,0,0.0,1,7,8,4,1,3,3,5,9,-8,1,Chet Holmgren,OKC,LAL,OKC,24.5,Pts+Rebs,21,17,13,12
22023,1631096,22300565,"JAN 15, 2024",OKC @ LAL,L,30,4,9,0.444,1,4,0.25,0,0,0.0,1,7,8,4,1,3,3,5,9,-8,1,Chet Holmgren,OKC,LAL,OKC,1.5,Dunks,21,17,13,12
22023,1631096,22300565,"JAN 15, 2024",OKC @ LAL,L,30,4,9,0.444,1,4,0.25,0,0,0.0,1,7,8,4,1,3,3,5,9,-8,1,Chet Holmgren,OKC,LAL,OKC,19.5,Pts+Asts,21,17,13,12
22023,1631096,22300565,"JAN 15, 2024",OKC @ LAL,L,30,4,9,0.444,1,4,0.25,0,0,0.0,1,7,8,4,1,3,3,5,9,-8,1,Chet Holmgren,OKC,LAL,OKC,1.5,3-PT Made,21,17,13,12
22023,1631096,22300565,"JAN 15, 2024",OKC @ LAL,L,30,4,9,0.444,1,4,0.25,0,0,0.0,1,7,8,4,1,3,3,5,9,-8,1,Chet Holmgren,OKC,LAL,OKC,0.5,Steals,21,17,13,12
22023,1631096,22300565,"JAN 15, 2024",OKC @ LAL,L,30,4,9,0.444,1,4,0.25,0,0,0.0,1,7,8,4,1,3,3,5,9,-8,1,Chet Holmgren,OKC,LAL,OKC,10.0,Rebs+Asts,21,17,13,12
22023,1631096,22300546,"JAN 13, 2024",OKC vs. ORL,W,32,7,14,0.5,1,5,0.2,0,0,0.0,2,6,8,3,1,2,2,0,15,5,1,Chet Holmgren,OKC,OKC,ORL,17.5,Points,26,23,18,11
22023,1631096,22300546,"JAN 13, 2024",OKC vs. ORL,W,32,7,14,0.5,1,5,0.2,0,0,0.0,2,6,8,3,1,2,2,0,15,5,1,Chet Holmgren,OKC,OKC,ORL,7.5,Rebounds,26,23,18,11
22023,1631096,22300546,"JAN 13, 2024",OKC vs. ORL,W,32,7,14,0.5,1,5,0.2,0,0,0.0,2,6,8,3,1,2,2,0,15,5,1,Chet Holmgren,OKC,OKC,ORL,27.5,Pts+Rebs+Asts,26,23,18,11
22023,1631096,22300546,"JAN 13, 2024",OKC vs. ORL,W,32,7,14,0.5,1,5,0.2,0,0,0.0,2,6,8,3,1,2,2,0,15,5,1,Chet Holmgren,OKC,OKC,ORL,37.0,Fantasy Score,26,23,18,11
22023,1631096,22300546,"JAN 13, 2024",OKC vs. ORL,W,32,7,14,0.5,1,5,0.2,0,0,0.0,2,6,8,3,1,2,2,0,15,5,1,Chet Holmgren,OKC,OKC,ORL,6.0,Defensive Rebounds,26,23,18,11
22023,1631096,22300546,"JAN 13, 2024",OKC vs. ORL,W,32,7,14,0.5,1,5,0.2,0,0,0.0,2,6,8,3,1,2,2,0,15,5,1,Chet Holmgren,OKC,OKC,ORL,2.5,Free Throws Made,26,23,18,11
22023,1631096,22300546,"JAN 13, 2024",OKC vs. ORL,W,32,7,14,0.5,1,5,0.2,0,0,0.0,2,6,8,3,1,2,2,0,15,5,1,Chet Holmgren,OKC,OKC,ORL,13.0,FG Attempted,26,23,18,11
22023,1631096,22300546,"JAN 13, 2024",OKC vs. ORL,W,32,7,14,0.5,1,5,0.2,0,0,0.0,2,6,8,3,1,2,2,0,15,5,1,Chet Holmgren,OKC,OKC,ORL,24.5,Pts+Rebs,26,23,18,11
22023,1631096,22300546,"JAN 13, 2024",OKC vs. ORL,W,32,7,14,0.5,1,5,0.2,0,0,0.0,2,6,8,3,1,2,2,0,15,5,1,Chet Holmgren,OKC,OKC,ORL,1.5,Dunks,26,23,18,11
22023,1631096,22300546,"JAN 13, 2024",OKC vs. ORL,W,32,7,14,0.5,1,5,0.2,0,0,0.0,2,6,8,3,1,2,2,0,15,5,1,Chet Holmgren,OKC,OKC,ORL,19.5,Pts+Asts,26,23,18,11
22023,1631096,22300546,"JAN 13, 2024",OKC vs. ORL,W,32,7,14,0.5,1,5,0.2,0,0,0.0,2,6,8,3,1,2,2,0,15,5,1,Chet Holmgren,OKC,OKC,ORL,1.5,3-PT Made,26,23,18,11
22023,1631096,22300546,"JAN 13, 2024",OKC vs. ORL,W,32,7,14,0.5,1,5,0.2,0,0,0.0,2,6,8,3,1,2,2,0,15,5,1,Chet Holmgren,OKC,OKC,ORL,0.5,Steals,26,23,18,11
22023,1631096,22300546,"JAN 13, 2024",OKC vs. ORL,W,32,7,14,0.5,1,5,0.2,0,0,0.0,2,6,8,3,1,2,2,0,15,5,1,Chet Holmgren,OKC,OKC,ORL,10.0,Rebs+Asts,26,23,18,11
22023,1631096,22300529,"JAN 11, 2024",OKC vs. POR,W,20,9,13,0.692,1,3,0.333,0,2,0.0,1,3,4,3,1,0,0,2,19,41,1,Chet Holmgren,OKC,OKC,POR,17.5,Points,26,23,22,7
22023,1631096,22300529,"JAN 11, 2024",OKC vs. POR,W,20,9,13,0.692,1,3,0.333,0,2,0.0,1,3,4,3,1,0,0,2,19,41,1,Chet Holmgren,OKC,OKC,POR,7.5,Rebounds,26,23,22,7
22023,1631096,22300529,"JAN 11, 2024",OKC vs. POR,W,20,9,13,0.692,1,3,0.333,0,2,0.0,1,3,4,3,1,0,0,2,19,41,1,Chet Holmgren,OKC,OKC,POR,27.5,Pts+Rebs+Asts,26,23,22,7
22023,1631096,22300529,"JAN 11, 2024",OKC vs. POR,W,20,9,13,0.692,1,3,0.333,0,2,0.0,1,3,4,3,1,0,0,2,19,41,1,Chet Holmgren,OKC,OKC,POR,37.0,Fantasy Score,26,23,22,7
22023,1631096,22300529,"JAN 11, 2024",OKC vs. POR,W,20,9,13,0.692,1,3,0.333,0,2,0.0,1,3,4,3,1,0,0,2,19,41,1,Chet Holmgren,OKC,OKC,POR,6.0,Defensive Rebounds,26,23,22,7
22023,1631096,22300529,"JAN 11, 2024",OKC vs. POR,W,20,9,13,0.692,1,3,0.333,0,2,0.0,1,3,4,3,1,0,0,2,19,41,1,Chet Holmgren,OKC,OKC,POR,2.5,Free Throws Made,26,23,22,7
22023,1631096,22300529,"JAN 11, 2024",OKC vs. POR,W,20,9,13,0.692,1,3,0.333,0,2,0.0,1,3,4,3,1,0,0,2,19,41,1,Chet Holmgren,OKC,OKC,POR,13.0,FG Attempted,26,23,22,7
22023,1631096,22300529,"JAN 11, 2024",OKC vs. POR,W,20,9,13,0.692,1,3,0.333,0,2,0.0,1,3,4,3,1,0,0,2,19,41,1,Chet Holmgren,OKC,OKC,POR,24.5,Pts+Rebs,26,23,22,7
22023,1631096,22300529,"JAN 11, 2024",OKC vs. POR,W,20,9,13,0.692,1,3,0.333,0,2,0.0,1,3,4,3,1,0,0,2,19,41,1,Chet Holmgren,OKC,OKC,POR,1.5,Dunks,26,23,22,7
22023,1631096,22300529,"JAN 11, 2024",OKC vs. POR,W,20,9,13,0.692,1,3,0.333,0,2,0.0,1,3,4,3,1,0,0,2,19,41,1,Chet Holmgren,OKC,OKC,POR,19.5,Pts+Asts,26,23,22,7
22023,1631096,22300529,"JAN 11, 2024",OKC vs. POR,W,20,9,13,0.692,1,3,0.333,0,2,0.0,1,3,4,3,1,0,0,2,19,41,1,Chet Holmgren,OKC,OKC,POR,1.5,3-PT Made,26,23,22,7
22023,1631096,22300529,"JAN 11, 2024",OKC vs. POR,W,20,9,13,0.692,1,3,0.333,0,2,0.0,1,3,4,3,1,0,0,2,19,41,1,Chet Holmgren,OKC,OKC,POR,0.5,Steals,26,23,22,7
22023,1631096,22300529,"JAN 11, 2024",OKC vs. POR,W,20,9,13,0.692,1,3,0.333,0,2,0.0,1,3,4,3,1,0,0,2,19,41,1,Chet Holmgren,OKC,OKC,POR,10.0,Rebs+Asts,26,23,22,7
22023,1631096,22300522,"JAN 10, 2024",OKC @ MIA,W,33,10,15,0.667,1,5,0.2,2,3,0.667,0,9,9,2,0,3,2,4,23,3,1,Chet Holmgren,OKC,MIA,OKC,17.5,Points,34,32,25,11
22023,1631096,22300522,"JAN 10, 2024",OKC @ MIA,W,33,10,15,0.667,1,5,0.2,2,3,0.667,0,9,9,2,0,3,2,4,23,3,1,Chet Holmgren,OKC,MIA,OKC,7.5,Rebounds,34,32,25,11
22023,1631096,22300522,"JAN 10, 2024",OKC @ MIA,W,33,10,15,0.667,1,5,0.2,2,3,0.667,0,9,9,2,0,3,2,4,23,3,1,Chet Holmgren,OKC,MIA,OKC,27.5,Pts+Rebs+Asts,34,32,25,11
22023,1631096,22300522,"JAN 10, 2024",OKC @ MIA,W,33,10,15,0.667,1,5,0.2,2,3,0.667,0,9,9,2,0,3,2,4,23,3,1,Chet Holmgren,OKC,MIA,OKC,37.0,Fantasy Score,34,32,25,11
22023,1631096,22300522,"JAN 10, 2024",OKC @ MIA,W,33,10,15,0.667,1,5,0.2,2,3,0.667,0,9,9,2,0,3,2,4,23,3,1,Chet Holmgren,OKC,MIA,OKC,6.0,Defensive Rebounds,34,32,25,11
22023,1631096,22300522,"JAN 10, 2024",OKC @ MIA,W,33,10,15,0.667,1,5,0.2,2,3,0.667,0,9,9,2,0,3,2,4,23,3,1,Chet Holmgren,OKC,MIA,OKC,2.5,Free Throws Made,34,32,25,11
22023,1631096,22300522,"JAN 10, 2024",OKC @ MIA,W,33,10,15,0.667,1,5,0.2,2,3,0.667,0,9,9,2,0,3,2,4,23,3,1,Chet Holmgren,OKC,MIA,OKC,13.0,FG Attempted,34,32,25,11
22023,1631096,22300522,"JAN 10, 2024",OKC @ MIA,W,33,10,15,0.667,1,5,0.2,2,3,0.667,0,9,9,2,0,3,2,4,23,3,1,Chet Holmgren,OKC,MIA,OKC,24.5,Pts+Rebs,34,32,25,11
22023,1631096,22300522,"JAN 10, 2024",OKC @ MIA,W,33,10,15,0.667,1,5,0.2,2,3,0.667,0,9,9,2,0,3,2,4,23,3,1,Chet Holmgren,OKC,MIA,OKC,1.5,Dunks,34,32,25,11
22023,1631096,22300522,"JAN 10, 2024",OKC @ MIA,W,33,10,15,0.667,1,5,0.2,2,3,0.667,0,9,9,2,0,3,2,4,23,3,1,Chet Holmgren,OKC,MIA,OKC,19.5,Pts+Asts,34,32,25,11
22023,1631096,22300522,"JAN 10, 2024",OKC @ MIA,W,33,10,15,0.667,1,5,0.2,2,3,0.667,0,9,9,2,0,3,2,4,23,3,1,Chet Holmgren,OKC,MIA,OKC,1.5,3-PT Made,34,32,25,11
22023,1631096,22300522,"JAN 10, 2024",OKC @ MIA,W,33,10,15,0.667,1,5,0.2,2,3,0.667,0,9,9,2,0,3,2,4,23,3,1,Chet Holmgren,OKC,MIA,OKC,0.5,Steals,34,32,25,11
22023,1631096,22300522,"JAN 10, 2024",OKC @ MIA,W,33,10,15,0.667,1,5,0.2,2,3,0.667,0,9,9,2,0,3,2,4,23,3,1,Chet Holmgren,OKC,MIA,OKC,10.0,Rebs+Asts,34,32,25,11
22023,1631096,22300508,"JAN 08, 2024",OKC @ WAS,W,32,11,14,0.786,4,5,0.8,5,8,0.625,1,3,4,5,0,2,0,3,31,1,1,Chet Holmgren,OKC,WAS,OKC,17.5,Points,40,35,36,9
22023,1631096,22300508,"JAN 08, 2024",OKC @ WAS,W,32,11,14,0.786,4,5,0.8,5,8,0.625,1,3,4,5,0,2,0,3,31,1,1,Chet Holmgren,OKC,WAS,OKC,7.5,Rebounds,40,35,36,9
22023,1631096,22300508,"JAN 08, 2024",OKC @ WAS,W,32,11,14,0.786,4,5,0.8,5,8,0.625,1,3,4,5,0,2,0,3,31,1,1,Chet Holmgren,OKC,WAS,OKC,27.5,Pts+Rebs+Asts,40,35,36,9
22023,1631096,22300508,"JAN 08, 2024",OKC @ WAS,W,32,11,14,0.786,4,5,0.8,5,8,0.625,1,3,4,5,0,2,0,3,31,1,1,Chet Holmgren,OKC,WAS,OKC,37.0,Fantasy Score,40,35,36,9
22023,1631096,22300508,"JAN 08, 2024",OKC @ WAS,W,32,11,14,0.786,4,5,0.8,5,8,0.625,1,3,4,5,0,2,0,3,31,1,1,Chet Holmgren,OKC,WAS,OKC,6.0,Defensive Rebounds,40,35,36,9
22023,1631096,22300508,"JAN 08, 2024",OKC @ WAS,W,32,11,14,0.786,4,5,0.8,5,8,0.625,1,3,4,5,0,2,0,3,31,1,1,Chet Holmgren,OKC,WAS,OKC,2.5,Free Throws Made,40,35,36,9
22023,1631096,22300508,"JAN 08, 2024",OKC @ WAS,W,32,11,14,0.786,4,5,0.8,5,8,0.625,1,3,4,5,0,2,0,3,31,1,1,Chet Holmgren,OKC,WAS,OKC,13.0,FG Attempted,40,35,36,9
22023,1631096,22300508,"JAN 08, 2024",OKC @ WAS,W,32,11,14,0.786,4,5,0.8,5,8,0.625,1,3,4,5,0,2,0,3,31,1,1,Chet Holmgren,OKC,WAS,OKC,24.5,Pts+Rebs,40,35,36,9
22023,1631096,22300508,"JAN 08, 2024",OKC @ WAS,W,32,11,14,0.786,4,5,0.8,5,8,0.625,1,3,4,5,0,2,0,3,31,1,1,Chet Holmgren,OKC,WAS,OKC,1.5,Dunks,40,35,36,9
22023,1631096,22300508,"JAN 08, 2024",OKC @ WAS,W,32,11,14,0.786,4,5,0.8,5,8,0.625,1,3,4,5,0,2,0,3,31,1,1,Chet Holmgren,OKC,WAS,OKC,19.5,Pts+Asts,40,35,36,9
22023,1631096,22300508,"JAN 08, 2024",OKC @ WAS,W,32,11,14,0.786,4,5,0.8,5,8,0.625,1,3,4,5,0,2,0,3,31,1,1,Chet Holmgren,OKC,WAS,OKC,1.5,3-PT Made,40,35,36,9
22023,1631096,22300508,"JAN 08, 2024",OKC @ WAS,W,32,11,14,0.786,4,5,0.8,5,8,0.625,1,3,4,5,0,2,0,3,31,1,1,Chet Holmgren,OKC,WAS,OKC,0.5,Steals,40,35,36,9
22023,1631096,22300508,"JAN 08, 2024",OKC @ WAS,W,32,11,14,0.786,4,5,0.8,5,8,0.625,1,3,4,5,0,2,0,3,31,1,1,Chet Holmgren,OKC,WAS,OKC,10.0,Rebs+Asts,40,35,36,9
22023,1631096,22300481,"JAN 05, 2024",OKC @ BKN,L,35,8,15,0.533,0,4,0.0,1,2,0.5,3,3,6,3,1,1,1,3,17,-3,1,Chet Holmgren,OKC,BKN,OKC,17.5,Points,26,23,20,9
22023,1631096,22300481,"JAN 05, 2024",OKC @ BKN,L,35,8,15,0.533,0,4,0.0,1,2,0.5,3,3,6,3,1,1,1,3,17,-3,1,Chet Holmgren,OKC,BKN,OKC,7.5,Rebounds,26,23,20,9
22023,1631096,22300481,"JAN 05, 2024",OKC @ BKN,L,35,8,15,0.533,0,4,0.0,1,2,0.5,3,3,6,3,1,1,1,3,17,-3,1,Chet Holmgren,OKC,BKN,OKC,27.5,Pts+Rebs+Asts,26,23,20,9
22023,1631096,22300481,"JAN 05, 2024",OKC @ BKN,L,35,8,15,0.533,0,4,0.0,1,2,0.5,3,3,6,3,1,1,1,3,17,-3,1,Chet Holmgren,OKC,BKN,OKC,37.0,Fantasy Score,26,23,20,9
22023,1631096,22300481,"JAN 05, 2024",OKC @ BKN,L,35,8,15,0.533,0,4,0.0,1,2,0.5,3,3,6,3,1,1,1,3,17,-3,1,Chet Holmgren,OKC,BKN,OKC,6.0,Defensive Rebounds,26,23,20,9
22023,1631096,22300481,"JAN 05, 2024",OKC @ BKN,L,35,8,15,0.533,0,4,0.0,1,2,0.5,3,3,6,3,1,1,1,3,17,-3,1,Chet Holmgren,OKC,BKN,OKC,2.5,Free Throws Made,26,23,20,9
22023,1631096,22300481,"JAN 05, 2024",OKC @ BKN,L,35,8,15,0.533,0,4,0.0,1,2,0.5,3,3,6,3,1,1,1,3,17,-3,1,Chet Holmgren,OKC,BKN,OKC,13.0,FG Attempted,26,23,20,9
22023,1631096,22300481,"JAN 05, 2024",OKC @ BKN,L,35,8,15,0.533,0,4,0.0,1,2,0.5,3,3,6,3,1,1,1,3,17,-3,1,Chet Holmgren,OKC,BKN,OKC,24.5,Pts+Rebs,26,23,20,9
22023,1631096,22300481,"JAN 05, 2024",OKC @ BKN,L,35,8,15,0.533,0,4,0.0,1,2,0.5,3,3,6,3,1,1,1,3,17,-3,1,Chet Holmgren,OKC,BKN,OKC,1.5,Dunks,26,23,20,9
22023,1631096,22300481,"JAN 05, 2024",OKC @ BKN,L,35,8,15,0.533,0,4,0.0,1,2,0.5,3,3,6,3,1,1,1,3,17,-3,1,Chet Holmgren,OKC,BKN,OKC,19.5,Pts+Asts,26,23,20,9
22023,1631096,22300481,"JAN 05, 2024",OKC @ BKN,L,35,8,15,0.533,0,4,0.0,1,2,0.5,3,3,6,3,1,1,1,3,17,-3,1,Chet Holmgren,OKC,BKN,OKC,1.5,3-PT Made,26,23,20,9
22023,1631096,22300481,"JAN 05, 2024",OKC @ BKN,L,35,8,15,0.533,0,4,0.0,1,2,0.5,3,3,6,3,1,1,1,3,17,-3,1,Chet Holmgren,OKC,BKN,OKC,0.5,Steals,26,23,20,9
22023,1631096,22300481,"JAN 05, 2024",OKC @ BKN,L,35,8,15,0.533,0,4,0.0,1,2,0.5,3,3,6,3,1,1,1,3,17,-3,1,Chet Holmgren,OKC,BKN,OKC,10.0,Rebs+Asts,26,23,20,9
22023,1631096,22300467,"JAN 03, 2024",OKC @ ATL,L,25,5,9,0.556,2,5,0.4,0,0,0.0,0,3,3,1,0,0,4,1,12,-1,1,Chet Holmgren,OKC,ATL,OKC,17.5,Points,16,15,13,4
22023,1631096,22300467,"JAN 03, 2024",OKC @ ATL,L,25,5,9,0.556,2,5,0.4,0,0,0.0,0,3,3,1,0,0,4,1,12,-1,1,Chet Holmgren,OKC,ATL,OKC,7.5,Rebounds,16,15,13,4
22023,1631096,22300467,"JAN 03, 2024",OKC @ ATL,L,25,5,9,0.556,2,5,0.4,0,0,0.0,0,3,3,1,0,0,4,1,12,-1,1,Chet Holmgren,OKC,ATL,OKC,27.5,Pts+Rebs+Asts,16,15,13,4
22023,1631096,22300467,"JAN 03, 2024",OKC @ ATL,L,25,5,9,0.556,2,5,0.4,0,0,0.0,0,3,3,1,0,0,4,1,12,-1,1,Chet Holmgren,OKC,ATL,OKC,37.0,Fantasy Score,16,15,13,4
22023,1631096,22300467,"JAN 03, 2024",OKC @ ATL,L,25,5,9,0.556,2,5,0.4,0,0,0.0,0,3,3,1,0,0,4,1,12,-1,1,Chet Holmgren,OKC,ATL,OKC,6.0,Defensive Rebounds,16,15,13,4
22023,1631096,22300467,"JAN 03, 2024",OKC @ ATL,L,25,5,9,0.556,2,5,0.4,0,0,0.0,0,3,3,1,0,0,4,1,12,-1,1,Chet Holmgren,OKC,ATL,OKC,2.5,Free Throws Made,16,15,13,4
22023,1631096,22300467,"JAN 03, 2024",OKC @ ATL,L,25,5,9,0.556,2,5,0.4,0,0,0.0,0,3,3,1,0,0,4,1,12,-1,1,Chet Holmgren,OKC,ATL,OKC,13.0,FG Attempted,16,15,13,4
22023,1631096,22300467,"JAN 03, 2024",OKC @ ATL,L,25,5,9,0.556,2,5,0.4,0,0,0.0,0,3,3,1,0,0,4,1,12,-1,1,Chet Holmgren,OKC,ATL,OKC,24.5,Pts+Rebs,16,15,13,4
22023,1631096,22300467,"JAN 03, 2024",OKC @ ATL,L,25,5,9,0.556,2,5,0.4,0,0,0.0,0,3,3,1,0,0,4,1,12,-1,1,Chet Holmgren,OKC,ATL,OKC,1.5,Dunks,16,15,13,4
22023,1631096,22300467,"JAN 03, 2024",OKC @ ATL,L,25,5,9,0.556,2,5,0.4,0,0,0.0,0,3,3,1,0,0,4,1,12,-1,1,Chet Holmgren,OKC,ATL,OKC,19.5,Pts+Asts,16,15,13,4
22023,1631096,22300467,"JAN 03, 2024",OKC @ ATL,L,25,5,9,0.556,2,5,0.4,0,0,0.0,0,3,3,1,0,0,4,1,12,-1,1,Chet Holmgren,OKC,ATL,OKC,1.5,3-PT Made,16,15,13,4
22023,1631096,22300467,"JAN 03, 2024",OKC @ ATL,L,25,5,9,0.556,2,5,0.4,0,0,0.0,0,3,3,1,0,0,4,1,12,-1,1,Chet Holmgren,OKC,ATL,OKC,0.5,Steals,16,15,13,4
22023,1631096,22300467,"JAN 03, 2024",OKC @ ATL,L,25,5,9,0.556,2,5,0.4,0,0,0.0,0,3,3,1,0,0,4,1,12,-1,1,Chet Holmgren,OKC,ATL,OKC,10.0,Rebs+Asts,16,15,13,4
22023,1631096,22300462,"JAN 02, 2024",OKC vs. BOS,W,33,5,9,0.556,3,5,0.6,1,2,0.5,0,3,3,7,0,4,1,1,14,4,1,Chet Holmgren,OKC,OKC,BOS,17.5,Points,24,17,21,10
22023,1631096,22300462,"JAN 02, 2024",OKC vs. BOS,W,33,5,9,0.556,3,5,0.6,1,2,0.5,0,3,3,7,0,4,1,1,14,4,1,Chet Holmgren,OKC,OKC,BOS,7.5,Rebounds,24,17,21,10
22023,1631096,22300462,"JAN 02, 2024",OKC vs. BOS,W,33,5,9,0.556,3,5,0.6,1,2,0.5,0,3,3,7,0,4,1,1,14,4,1,Chet Holmgren,OKC,OKC,BOS,27.5,Pts+Rebs+Asts,24,17,21,10
22023,1631096,22300462,"JAN 02, 2024",OKC vs. BOS,W,33,5,9,0.556,3,5,0.6,1,2,0.5,0,3,3,7,0,4,1,1,14,4,1,Chet Holmgren,OKC,OKC,BOS,37.0,Fantasy Score,24,17,21,10
22023,1631096,22300462,"JAN 02, 2024",OKC vs. BOS,W,33,5,9,0.556,3,5,0.6,1,2,0.5,0,3,3,7,0,4,1,1,14,4,1,Chet Holmgren,OKC,OKC,BOS,6.0,Defensive Rebounds,24,17,21,10
22023,1631096,22300462,"JAN 02, 2024",OKC vs. BOS,W,33,5,9,0.556,3,5,0.6,1,2,0.5,0,3,3,7,0,4,1,1,14,4,1,Chet Holmgren,OKC,OKC,BOS,2.5,Free Throws Made,24,17,21,10
22023,1631096,22300462,"JAN 02, 2024",OKC vs. BOS,W,33,5,9,0.556,3,5,0.6,1,2,0.5,0,3,3,7,0,4,1,1,14,4,1,Chet Holmgren,OKC,OKC,BOS,13.0,FG Attempted,24,17,21,10
22023,1631096,22300462,"JAN 02, 2024",OKC vs. BOS,W,33,5,9,0.556,3,5,0.6,1,2,0.5,0,3,3,7,0,4,1,1,14,4,1,Chet Holmgren,OKC,OKC,BOS,24.5,Pts+Rebs,24,17,21,10
22023,1631096,22300462,"JAN 02, 2024",OKC vs. BOS,W,33,5,9,0.556,3,5,0.6,1,2,0.5,0,3,3,7,0,4,1,1,14,4,1,Chet Holmgren,OKC,OKC,BOS,1.5,Dunks,24,17,21,10
22023,1631096,22300462,"JAN 02, 2024",OKC vs. BOS,W,33,5,9,0.556,3,5,0.6,1,2,0.5,0,3,3,7,0,4,1,1,14,4,1,Chet Holmgren,OKC,OKC,BOS,19.5,Pts+Asts,24,17,21,10
22023,1631096,22300462,"JAN 02, 2024",OKC vs. BOS,W,33,5,9,0.556,3,5,0.6,1,2,0.5,0,3,3,7,0,4,1,1,14,4,1,Chet Holmgren,OKC,OKC,BOS,1.5,3-PT Made,24,17,21,10
22023,1631096,22300462,"JAN 02, 2024",OKC vs. BOS,W,33,5,9,0.556,3,5,0.6,1,2,0.5,0,3,3,7,0,4,1,1,14,4,1,Chet Holmgren,OKC,OKC,BOS,0.5,Steals,24,17,21,10
22023,1631096,22300462,"JAN 02, 2024",OKC vs. BOS,W,33,5,9,0.556,3,5,0.6,1,2,0.5,0,3,3,7,0,4,1,1,14,4,1,Chet Holmgren,OKC,OKC,BOS,10.0,Rebs+Asts,24,17,21,10
22023,1631096,22300447,"DEC 31, 2023",OKC vs. BKN,W,32,7,10,0.7,3,5,0.6,1,2,0.5,0,10,10,3,0,2,3,3,18,16,1,Chet Holmgren,OKC,OKC,BKN,17.5,Points,31,28,21,13
22023,1631096,22300447,"DEC 31, 2023",OKC vs. BKN,W,32,7,10,0.7,3,5,0.6,1,2,0.5,0,10,10,3,0,2,3,3,18,16,1,Chet Holmgren,OKC,OKC,BKN,7.5,Rebounds,31,28,21,13
22023,1631096,22300447,"DEC 31, 2023",OKC vs. BKN,W,32,7,10,0.7,3,5,0.6,1,2,0.5,0,10,10,3,0,2,3,3,18,16,1,Chet Holmgren,OKC,OKC,BKN,27.5,Pts+Rebs+Asts,31,28,21,13
22023,1631096,22300447,"DEC 31, 2023",OKC vs. BKN,W,32,7,10,0.7,3,5,0.6,1,2,0.5,0,10,10,3,0,2,3,3,18,16,1,Chet Holmgren,OKC,OKC,BKN,37.0,Fantasy Score,31,28,21,13
22023,1631096,22300447,"DEC 31, 2023",OKC vs. BKN,W,32,7,10,0.7,3,5,0.6,1,2,0.5,0,10,10,3,0,2,3,3,18,16,1,Chet Holmgren,OKC,OKC,BKN,6.0,Defensive Rebounds,31,28,21,13
22023,1631096,22300447,"DEC 31, 2023",OKC vs. BKN,W,32,7,10,0.7,3,5,0.6,1,2,0.5,0,10,10,3,0,2,3,3,18,16,1,Chet Holmgren,OKC,OKC,BKN,2.5,Free Throws Made,31,28,21,13
22023,1631096,22300447,"DEC 31, 2023",OKC vs. BKN,W,32,7,10,0.7,3,5,0.6,1,2,0.5,0,10,10,3,0,2,3,3,18,16,1,Chet Holmgren,OKC,OKC,BKN,13.0,FG Attempted,31,28,21,13
22023,1631096,22300447,"DEC 31, 2023",OKC vs. BKN,W,32,7,10,0.7,3,5,0.6,1,2,0.5,0,10,10,3,0,2,3,3,18,16,1,Chet Holmgren,OKC,OKC,BKN,24.5,Pts+Rebs,31,28,21,13
22023,1631096,22300447,"DEC 31, 2023",OKC vs. BKN,W,32,7,10,0.7,3,5,0.6,1,2,0.5,0,10,10,3,0,2,3,3,18,16,1,Chet Holmgren,OKC,OKC,BKN,1.5,Dunks,31,28,21,13
22023,1631096,22300447,"DEC 31, 2023",OKC vs. BKN,W,32,7,10,0.7,3,5,0.6,1,2,0.5,0,10,10,3,0,2,3,3,18,16,1,Chet Holmgren,OKC,OKC,BKN,19.5,Pts+Asts,31,28,21,13
22023,1631096,22300447,"DEC 31, 2023",OKC vs. BKN,W,32,7,10,0.7,3,5,0.6,1,2,0.5,0,10,10,3,0,2,3,3,18,16,1,Chet Holmgren,OKC,OKC,BKN,1.5,3-PT Made,31,28,21,13
22023,1631096,22300447,"DEC 31, 2023",OKC vs. BKN,W,32,7,10,0.7,3,5,0.6,1,2,0.5,0,10,10,3,0,2,3,3,18,16,1,Chet Holmgren,OKC,OKC,BKN,0.5,Steals,31,28,21,13
22023,1631096,22300447,"DEC 31, 2023",OKC vs. BKN,W,32,7,10,0.7,3,5,0.6,1,2,0.5,0,10,10,3,0,2,3,3,18,16,1,Chet Holmgren,OKC,OKC,BKN,10.0,Rebs+Asts,31,28,21,13
22023,1631096,22300435,"DEC 29, 2023",OKC @ DEN,W,28,9,14,0.643,4,4,1.0,2,2,1.0,3,3,6,3,0,2,2,1,24,9,1,Chet Holmgren,OKC,DEN,OKC,17.5,Points,33,30,27,9
22023,1631096,22300435,"DEC 29, 2023",OKC @ DEN,W,28,9,14,0.643,4,4,1.0,2,2,1.0,3,3,6,3,0,2,2,1,24,9,1,Chet Holmgren,OKC,DEN,OKC,7.5,Rebounds,33,30,27,9
22023,1631096,22300435,"DEC 29, 2023",OKC @ DEN,W,28,9,14,0.643,4,4,1.0,2,2,1.0,3,3,6,3,0,2,2,1,24,9,1,Chet Holmgren,OKC,DEN,OKC,27.5,Pts+Rebs+Asts,33,30,27,9
22023,1631096,22300435,"DEC 29, 2023",OKC @ DEN,W,28,9,14,0.643,4,4,1.0,2,2,1.0,3,3,6,3,0,2,2,1,24,9,1,Chet Holmgren,OKC,DEN,OKC,37.0,Fantasy Score,33,30,27,9
22023,1631096,22300435,"DEC 29, 2023",OKC @ DEN,W,28,9,14,0.643,4,4,1.0,2,2,1.0,3,3,6,3,0,2,2,1,24,9,1,Chet Holmgren,OKC,DEN,OKC,6.0,Defensive Rebounds,33,30,27,9
22023,1631096,22300435,"DEC 29, 2023",OKC @ DEN,W,28,9,14,0.643,4,4,1.0,2,2,1.0,3,3,6,3,0,2,2,1,24,9,1,Chet Holmgren,OKC,DEN,OKC,2.5,Free Throws Made,33,30,27,9
22023,1631096,22300435,"DEC 29, 2023",OKC @ DEN,W,28,9,14,0.643,4,4,1.0,2,2,1.0,3,3,6,3,0,2,2,1,24,9,1,Chet Holmgren,OKC,DEN,OKC,13.0,FG Attempted,33,30,27,9
22023,1631096,22300435,"DEC 29, 2023",OKC @ DEN,W,28,9,14,0.643,4,4,1.0,2,2,1.0,3,3,6,3,0,2,2,1,24,9,1,Chet Holmgren,OKC,DEN,OKC,24.5,Pts+Rebs,33,30,27,9
22023,1631096,22300435,"DEC 29, 2023",OKC @ DEN,W,28,9,14,0.643,4,4,1.0,2,2,1.0,3,3,6,3,0,2,2,1,24,9,1,Chet Holmgren,OKC,DEN,OKC,1.5,Dunks,33,30,27,9
22023,1631096,22300435,"DEC 29, 2023",OKC @ DEN,W,28,9,14,0.643,4,4,1.0,2,2,1.0,3,3,6,3,0,2,2,1,24,9,1,Chet Holmgren,OKC,DEN,OKC,19.5,Pts+Asts,33,30,27,9
22023,1631096,22300435,"DEC 29, 2023",OKC @ DEN,W,28,9,14,0.643,4,4,1.0,2,2,1.0,3,3,6,3,0,2,2,1,24,9,1,Chet Holmgren,OKC,DEN,OKC,1.5,3-PT Made,33,30,27,9
22023,1631096,22300435,"DEC 29, 2023",OKC @ DEN,W,28,9,14,0.643,4,4,1.0,2,2,1.0,3,3,6,3,0,2,2,1,24,9,1,Chet Holmgren,OKC,DEN,OKC,0.5,Steals,33,30,27,9
22023,1631096,22300435,"DEC 29, 2023",OKC @ DEN,W,28,9,14,0.643,4,4,1.0,2,2,1.0,3,3,6,3,0,2,2,1,24,9,1,Chet Holmgren,OKC,DEN,OKC,10.0,Rebs+Asts,33,30,27,9
22023,1631096,22300419,"DEC 27, 2023",OKC vs. NYK,W,30,9,14,0.643,1,4,0.25,3,4,0.75,1,4,5,1,0,4,0,4,22,4,1,Chet Holmgren,OKC,OKC,NYK,17.5,Points,28,27,23,6
22023,1631096,22300419,"DEC 27, 2023",OKC vs. NYK,W,30,9,14,0.643,1,4,0.25,3,4,0.75,1,4,5,1,0,4,0,4,22,4,1,Chet Holmgren,OKC,OKC,NYK,7.5,Rebounds,28,27,23,6
22023,1631096,22300419,"DEC 27, 2023",OKC vs. NYK,W,30,9,14,0.643,1,4,0.25,3,4,0.75,1,4,5,1,0,4,0,4,22,4,1,Chet Holmgren,OKC,OKC,NYK,27.5,Pts+Rebs+Asts,28,27,23,6
22023,1631096,22300419,"DEC 27, 2023",OKC vs. NYK,W,30,9,14,0.643,1,4,0.25,3,4,0.75,1,4,5,1,0,4,0,4,22,4,1,Chet Holmgren,OKC,OKC,NYK,37.0,Fantasy Score,28,27,23,6
22023,1631096,22300419,"DEC 27, 2023",OKC vs. NYK,W,30,9,14,0.643,1,4,0.25,3,4,0.75,1,4,5,1,0,4,0,4,22,4,1,Chet Holmgren,OKC,OKC,NYK,6.0,Defensive Rebounds,28,27,23,6
22023,1631096,22300419,"DEC 27, 2023",OKC vs. NYK,W,30,9,14,0.643,1,4,0.25,3,4,0.75,1,4,5,1,0,4,0,4,22,4,1,Chet Holmgren,OKC,OKC,NYK,2.5,Free Throws Made,28,27,23,6
22023,1631096,22300419,"DEC 27, 2023",OKC vs. NYK,W,30,9,14,0.643,1,4,0.25,3,4,0.75,1,4,5,1,0,4,0,4,22,4,1,Chet Holmgren,OKC,OKC,NYK,13.0,FG Attempted,28,27,23,6
22023,1631096,22300419,"DEC 27, 2023",OKC vs. NYK,W,30,9,14,0.643,1,4,0.25,3,4,0.75,1,4,5,1,0,4,0,4,22,4,1,Chet Holmgren,OKC,OKC,NYK,24.5,Pts+Rebs,28,27,23,6
22023,1631096,22300419,"DEC 27, 2023",OKC vs. NYK,W,30,9,14,0.643,1,4,0.25,3,4,0.75,1,4,5,1,0,4,0,4,22,4,1,Chet Holmgren,OKC,OKC,NYK,1.5,Dunks,28,27,23,6
22023,1631096,22300419,"DEC 27, 2023",OKC vs. NYK,W,30,9,14,0.643,1,4,0.25,3,4,0.75,1,4,5,1,0,4,0,4,22,4,1,Chet Holmgren,OKC,OKC,NYK,19.5,Pts+Asts,28,27,23,6
22023,1631096,22300419,"DEC 27, 2023",OKC vs. NYK,W,30,9,14,0.643,1,4,0.25,3,4,0.75,1,4,5,1,0,4,0,4,22,4,1,Chet Holmgren,OKC,OKC,NYK,1.5,3-PT Made,28,27,23,6
22023,1631096,22300419,"DEC 27, 2023",OKC vs. NYK,W,30,9,14,0.643,1,4,0.25,3,4,0.75,1,4,5,1,0,4,0,4,22,4,1,Chet Holmgren,OKC,OKC,NYK,0.5,Steals,28,27,23,6
22023,1631096,22300419,"DEC 27, 2023",OKC vs. NYK,W,30,9,14,0.643,1,4,0.25,3,4,0.75,1,4,5,1,0,4,0,4,22,4,1,Chet Holmgren,OKC,OKC,NYK,10.0,Rebs+Asts,28,27,23,6
22023,1631096,22300411,"DEC 26, 2023",OKC vs. MIN,W,29,8,13,0.615,3,6,0.5,1,2,0.5,0,4,4,5,0,1,1,4,20,17,1,Chet Holmgren,OKC,OKC,MIN,17.5,Points,29,24,25,9
22023,1631096,22300411,"DEC 26, 2023",OKC vs. MIN,W,29,8,13,0.615,3,6,0.5,1,2,0.5,0,4,4,5,0,1,1,4,20,17,1,Chet Holmgren,OKC,OKC,MIN,7.5,Rebounds,29,24,25,9
22023,1631096,22300411,"DEC 26, 2023",OKC vs. MIN,W,29,8,13,0.615,3,6,0.5,1,2,0.5,0,4,4,5,0,1,1,4,20,17,1,Chet Holmgren,OKC,OKC,MIN,27.5,Pts+Rebs+Asts,29,24,25,9
22023,1631096,22300411,"DEC 26, 2023",OKC vs. MIN,W,29,8,13,0.615,3,6,0.5,1,2,0.5,0,4,4,5,0,1,1,4,20,17,1,Chet Holmgren,OKC,OKC,MIN,37.0,Fantasy Score,29,24,25,9
22023,1631096,22300411,"DEC 26, 2023",OKC vs. MIN,W,29,8,13,0.615,3,6,0.5,1,2,0.5,0,4,4,5,0,1,1,4,20,17,1,Chet Holmgren,OKC,OKC,MIN,6.0,Defensive Rebounds,29,24,25,9
22023,1631096,22300411,"DEC 26, 2023",OKC vs. MIN,W,29,8,13,0.615,3,6,0.5,1,2,0.5,0,4,4,5,0,1,1,4,20,17,1,Chet Holmgren,OKC,OKC,MIN,2.5,Free Throws Made,29,24,25,9
22023,1631096,22300411,"DEC 26, 2023",OKC vs. MIN,W,29,8,13,0.615,3,6,0.5,1,2,0.5,0,4,4,5,0,1,1,4,20,17,1,Chet Holmgren,OKC,OKC,MIN,13.0,FG Attempted,29,24,25,9
22023,1631096,22300411,"DEC 26, 2023",OKC vs. MIN,W,29,8,13,0.615,3,6,0.5,1,2,0.5,0,4,4,5,0,1,1,4,20,17,1,Chet Holmgren,OKC,OKC,MIN,24.5,Pts+Rebs,29,24,25,9
22023,1631096,22300411,"DEC 26, 2023",OKC vs. MIN,W,29,8,13,0.615,3,6,0.5,1,2,0.5,0,4,4,5,0,1,1,4,20,17,1,Chet Holmgren,OKC,OKC,MIN,1.5,Dunks,29,24,25,9
22023,1631096,22300411,"DEC 26, 2023",OKC vs. MIN,W,29,8,13,0.615,3,6,0.5,1,2,0.5,0,4,4,5,0,1,1,4,20,17,1,Chet Holmgren,OKC,OKC,MIN,19.5,Pts+Asts,29,24,25,9
22023,1631096,22300411,"DEC 26, 2023",OKC vs. MIN,W,29,8,13,0.615,3,6,0.5,1,2,0.5,0,4,4,5,0,1,1,4,20,17,1,Chet Holmgren,OKC,OKC,MIN,1.5,3-PT Made,29,24,25,9
22023,1631096,22300411,"DEC 26, 2023",OKC vs. MIN,W,29,8,13,0.615,3,6,0.5,1,2,0.5,0,4,4,5,0,1,1,4,20,17,1,Chet Holmgren,OKC,OKC,MIN,0.5,Steals,29,24,25,9
22023,1631096,22300411,"DEC 26, 2023",OKC vs. MIN,W,29,8,13,0.615,3,6,0.5,1,2,0.5,0,4,4,5,0,1,1,4,20,17,1,Chet Holmgren,OKC,OKC,MIN,10.0,Rebs+Asts,29,24,25,9
22023,1631096,22300397,"DEC 23, 2023",OKC vs. LAL,L,34,8,18,0.444,1,6,0.167,2,5,0.4,4,6,10,0,1,3,0,1,19,-7,1,Chet Holmgren,OKC,OKC,LAL,17.5,Points,29,29,19,10
22023,1631096,22300397,"DEC 23, 2023",OKC vs. LAL,L,34,8,18,0.444,1,6,0.167,2,5,0.4,4,6,10,0,1,3,0,1,19,-7,1,Chet Holmgren,OKC,OKC,LAL,7.5,Rebounds,29,29,19,10
22023,1631096,22300397,"DEC 23, 2023",OKC vs. LAL,L,34,8,18,0.444,1,6,0.167,2,5,0.4,4,6,10,0,1,3,0,1,19,-7,1,Chet Holmgren,OKC,OKC,LAL,27.5,Pts+Rebs+Asts,29,29,19,10
22023,1631096,22300397,"DEC 23, 2023",OKC vs. LAL,L,34,8,18,0.444,1,6,0.167,2,5,0.4,4,6,10,0,1,3,0,1,19,-7,1,Chet Holmgren,OKC,OKC,LAL,37.0,Fantasy Score,29,29,19,10
22023,1631096,22300397,"DEC 23, 2023",OKC vs. LAL,L,34,8,18,0.444,1,6,0.167,2,5,0.4,4,6,10,0,1,3,0,1,19,-7,1,Chet Holmgren,OKC,OKC,LAL,6.0,Defensive Rebounds,29,29,19,10
22023,1631096,22300397,"DEC 23, 2023",OKC vs. LAL,L,34,8,18,0.444,1,6,0.167,2,5,0.4,4,6,10,0,1,3,0,1,19,-7,1,Chet Holmgren,OKC,OKC,LAL,2.5,Free Throws Made,29,29,19,10
22023,1631096,22300397,"DEC 23, 2023",OKC vs. LAL,L,34,8,18,0.444,1,6,0.167,2,5,0.4,4,6,10,0,1,3,0,1,19,-7,1,Chet Holmgren,OKC,OKC,LAL,13.0,FG Attempted,29,29,19,10
22023,1631096,22300397,"DEC 23, 2023",OKC vs. LAL,L,34,8,18,0.444,1,6,0.167,2,5,0.4,4,6,10,0,1,3,0,1,19,-7,1,Chet Holmgren,OKC,OKC,LAL,24.5,Pts+Rebs,29,29,19,10
22023,1631096,22300397,"DEC 23, 2023",OKC vs. LAL,L,34,8,18,0.444,1,6,0.167,2,5,0.4,4,6,10,0,1,3,0,1,19,-7,1,Chet Holmgren,OKC,OKC,LAL,1.5,Dunks,29,29,19,10
22023,1631096,22300397,"DEC 23, 2023",OKC vs. LAL,L,34,8,18,0.444,1,6,0.167,2,5,0.4,4,6,10,0,1,3,0,1,19,-7,1,Chet Holmgren,OKC,OKC,LAL,19.5,Pts+Asts,29,29,19,10
22023,1631096,22300397,"DEC 23, 2023",OKC vs. LAL,L,34,8,18,0.444,1,6,0.167,2,5,0.4,4,6,10,0,1,3,0,1,19,-7,1,Chet Holmgren,OKC,OKC,LAL,1.5,3-PT Made,29,29,19,10
22023,1631096,22300397,"DEC 23, 2023",OKC vs. LAL,L,34,8,18,0.444,1,6,0.167,2,5,0.4,4,6,10,0,1,3,0,1,19,-7,1,Chet Holmgren,OKC,OKC,LAL,0.5,Steals,29,29,19,10
22023,1631096,22300397,"DEC 23, 2023",OKC vs. LAL,L,34,8,18,0.444,1,6,0.167,2,5,0.4,4,6,10,0,1,3,0,1,19,-7,1,Chet Holmgren,OKC,OKC,LAL,10.0,Rebs+Asts,29,29,19,10
22023,1631096,22300379,"DEC 21, 2023",OKC vs. LAC,W,30,9,11,0.818,2,3,0.667,3,3,1.0,0,6,6,7,0,0,1,1,23,17,1,Chet Holmgren,OKC,OKC,LAC,17.5,Points,36,29,30,13
22023,1631096,22300379,"DEC 21, 2023",OKC vs. LAC,W,30,9,11,0.818,2,3,0.667,3,3,1.0,0,6,6,7,0,0,1,1,23,17,1,Chet Holmgren,OKC,OKC,LAC,7.5,Rebounds,36,29,30,13
22023,1631096,22300379,"DEC 21, 2023",OKC vs. LAC,W,30,9,11,0.818,2,3,0.667,3,3,1.0,0,6,6,7,0,0,1,1,23,17,1,Chet Holmgren,OKC,OKC,LAC,27.5,Pts+Rebs+Asts,36,29,30,13
22023,1631096,22300379,"DEC 21, 2023",OKC vs. LAC,W,30,9,11,0.818,2,3,0.667,3,3,1.0,0,6,6,7,0,0,1,1,23,17,1,Chet Holmgren,OKC,OKC,LAC,37.0,Fantasy Score,36,29,30,13
22023,1631096,22300379,"DEC 21, 2023",OKC vs. LAC,W,30,9,11,0.818,2,3,0.667,3,3,1.0,0,6,6,7,0,0,1,1,23,17,1,Chet Holmgren,OKC,OKC,LAC,6.0,Defensive Rebounds,36,29,30,13
22023,1631096,22300379,"DEC 21, 2023",OKC vs. LAC,W,30,9,11,0.818,2,3,0.667,3,3,1.0,0,6,6,7,0,0,1,1,23,17,1,Chet Holmgren,OKC,OKC,LAC,2.5,Free Throws Made,36,29,30,13
22023,1631096,22300379,"DEC 21, 2023",OKC vs. LAC,W,30,9,11,0.818,2,3,0.667,3,3,1.0,0,6,6,7,0,0,1,1,23,17,1,Chet Holmgren,OKC,OKC,LAC,13.0,FG Attempted,36,29,30,13
22023,1631096,22300379,"DEC 21, 2023",OKC vs. LAC,W,30,9,11,0.818,2,3,0.667,3,3,1.0,0,6,6,7,0,0,1,1,23,17,1,Chet Holmgren,OKC,OKC,LAC,24.5,Pts+Rebs,36,29,30,13
22023,1631096,22300379,"DEC 21, 2023",OKC vs. LAC,W,30,9,11,0.818,2,3,0.667,3,3,1.0,0,6,6,7,0,0,1,1,23,17,1,Chet Holmgren,OKC,OKC,LAC,1.5,Dunks,36,29,30,13
22023,1631096,22300379,"DEC 21, 2023",OKC vs. LAC,W,30,9,11,0.818,2,3,0.667,3,3,1.0,0,6,6,7,0,0,1,1,23,17,1,Chet Holmgren,OKC,OKC,LAC,19.5,Pts+Asts,36,29,30,13
22023,1631096,22300379,"DEC 21, 2023",OKC vs. LAC,W,30,9,11,0.818,2,3,0.667,3,3,1.0,0,6,6,7,0,0,1,1,23,17,1,Chet Holmgren,OKC,OKC,LAC,1.5,3-PT Made,36,29,30,13
22023,1631096,22300379,"DEC 21, 2023",OKC vs. LAC,W,30,9,11,0.818,2,3,0.667,3,3,1.0,0,6,6,7,0,0,1,1,23,17,1,Chet Holmgren,OKC,OKC,LAC,0.5,Steals,36,29,30,13
22023,1631096,22300379,"DEC 21, 2023",OKC vs. LAC,W,30,9,11,0.818,2,3,0.667,3,3,1.0,0,6,6,7,0,0,1,1,23,17,1,Chet Holmgren,OKC,OKC,LAC,10.0,Rebs+Asts,36,29,30,13
22023,1631096,22300355,"DEC 18, 2023",OKC vs. MEM,W,25,7,14,0.5,2,4,0.5,1,1,1.0,2,4,6,2,1,7,2,2,17,13,1,Chet Holmgren,OKC,OKC,MEM,17.5,Points,25,23,19,8
22023,1631096,22300355,"DEC 18, 2023",OKC vs. MEM,W,25,7,14,0.5,2,4,0.5,1,1,1.0,2,4,6,2,1,7,2,2,17,13,1,Chet Holmgren,OKC,OKC,MEM,7.5,Rebounds,25,23,19,8
22023,1631096,22300355,"DEC 18, 2023",OKC vs. MEM,W,25,7,14,0.5,2,4,0.5,1,1,1.0,2,4,6,2,1,7,2,2,17,13,1,Chet Holmgren,OKC,OKC,MEM,27.5,Pts+Rebs+Asts,25,23,19,8
22023,1631096,22300355,"DEC 18, 2023",OKC vs. MEM,W,25,7,14,0.5,2,4,0.5,1,1,1.0,2,4,6,2,1,7,2,2,17,13,1,Chet Holmgren,OKC,OKC,MEM,37.0,Fantasy Score,25,23,19,8
22023,1631096,22300355,"DEC 18, 2023",OKC vs. MEM,W,25,7,14,0.5,2,4,0.5,1,1,1.0,2,4,6,2,1,7,2,2,17,13,1,Chet Holmgren,OKC,OKC,MEM,6.0,Defensive Rebounds,25,23,19,8
22023,1631096,22300355,"DEC 18, 2023",OKC vs. MEM,W,25,7,14,0.5,2,4,0.5,1,1,1.0,2,4,6,2,1,7,2,2,17,13,1,Chet Holmgren,OKC,OKC,MEM,2.5,Free Throws Made,25,23,19,8
22023,1631096,22300355,"DEC 18, 2023",OKC vs. MEM,W,25,7,14,0.5,2,4,0.5,1,1,1.0,2,4,6,2,1,7,2,2,17,13,1,Chet Holmgren,OKC,OKC,MEM,13.0,FG Attempted,25,23,19,8
22023,1631096,22300355,"DEC 18, 2023",OKC vs. MEM,W,25,7,14,0.5,2,4,0.5,1,1,1.0,2,4,6,2,1,7,2,2,17,13,1,Chet Holmgren,OKC,OKC,MEM,24.5,Pts+Rebs,25,23,19,8
22023,1631096,22300355,"DEC 18, 2023",OKC vs. MEM,W,25,7,14,0.5,2,4,0.5,1,1,1.0,2,4,6,2,1,7,2,2,17,13,1,Chet Holmgren,OKC,OKC,MEM,1.5,Dunks,25,23,19,8
22023,1631096,22300355,"DEC 18, 2023",OKC vs. MEM,W,25,7,14,0.5,2,4,0.5,1,1,1.0,2,4,6,2,1,7,2,2,17,13,1,Chet Holmgren,OKC,OKC,MEM,19.5,Pts+Asts,25,23,19,8
22023,1631096,22300355,"DEC 18, 2023",OKC vs. MEM,W,25,7,14,0.5,2,4,0.5,1,1,1.0,2,4,6,2,1,7,2,2,17,13,1,Chet Holmgren,OKC,OKC,MEM,1.5,3-PT Made,25,23,19,8
22023,1631096,22300355,"DEC 18, 2023",OKC vs. MEM,W,25,7,14,0.5,2,4,0.5,1,1,1.0,2,4,6,2,1,7,2,2,17,13,1,Chet Holmgren,OKC,OKC,MEM,0.5,Steals,25,23,19,8
22023,1631096,22300355,"DEC 18, 2023",OKC vs. MEM,W,25,7,14,0.5,2,4,0.5,1,1,1.0,2,4,6,2,1,7,2,2,17,13,1,Chet Holmgren,OKC,OKC,MEM,10.0,Rebs+Asts,25,23,19,8
22023,1631096,22300340,"DEC 16, 2023",OKC @ DEN,W,32,6,12,0.5,1,4,0.25,4,6,0.667,1,10,11,1,0,8,1,3,17,10,1,Chet Holmgren,OKC,DEN,OKC,17.5,Points,29,28,18,12
22023,1631096,22300340,"DEC 16, 2023",OKC @ DEN,W,32,6,12,0.5,1,4,0.25,4,6,0.667,1,10,11,1,0,8,1,3,17,10,1,Chet Holmgren,OKC,DEN,OKC,7.5,Rebounds,29,28,18,12
22023,1631096,22300340,"DEC 16, 2023",OKC @ DEN,W,32,6,12,0.5,1,4,0.25,4,6,0.667,1,10,11,1,0,8,1,3,17,10,1,Chet Holmgren,OKC,DEN,OKC,27.5,Pts+Rebs+Asts,29,28,18,12
22023,1631096,22300340,"DEC 16, 2023",OKC @ DEN,W,32,6,12,0.5,1,4,0.25,4,6,0.667,1,10,11,1,0,8,1,3,17,10,1,Chet Holmgren,OKC,DEN,OKC,37.0,Fantasy Score,29,28,18,12
22023,1631096,22300340,"DEC 16, 2023",OKC @ DEN,W,32,6,12,0.5,1,4,0.25,4,6,0.667,1,10,11,1,0,8,1,3,17,10,1,Chet Holmgren,OKC,DEN,OKC,6.0,Defensive Rebounds,29,28,18,12
22023,1631096,22300340,"DEC 16, 2023",OKC @ DEN,W,32,6,12,0.5,1,4,0.25,4,6,0.667,1,10,11,1,0,8,1,3,17,10,1,Chet Holmgren,OKC,DEN,OKC,2.5,Free Throws Made,29,28,18,12
22023,1631096,22300340,"DEC 16, 2023",OKC @ DEN,W,32,6,12,0.5,1,4,0.25,4,6,0.667,1,10,11,1,0,8,1,3,17,10,1,Chet Holmgren,OKC,DEN,OKC,13.0,FG Attempted,29,28,18,12
22023,1631096,22300340,"DEC 16, 2023",OKC @ DEN,W,32,6,12,0.5,1,4,0.25,4,6,0.667,1,10,11,1,0,8,1,3,17,10,1,Chet Holmgren,OKC,DEN,OKC,24.5,Pts+Rebs,29,28,18,12
22023,1631096,22300340,"DEC 16, 2023",OKC @ DEN,W,32,6,12,0.5,1,4,0.25,4,6,0.667,1,10,11,1,0,8,1,3,17,10,1,Chet Holmgren,OKC,DEN,OKC,1.5,Dunks,29,28,18,12
22023,1631096,22300340,"DEC 16, 2023",OKC @ DEN,W,32,6,12,0.5,1,4,0.25,4,6,0.667,1,10,11,1,0,8,1,3,17,10,1,Chet Holmgren,OKC,DEN,OKC,19.5,Pts+Asts,29,28,18,12
22023,1631096,22300340,"DEC 16, 2023",OKC @ DEN,W,32,6,12,0.5,1,4,0.25,4,6,0.667,1,10,11,1,0,8,1,3,17,10,1,Chet Holmgren,OKC,DEN,OKC,1.5,3-PT Made,29,28,18,12
22023,1631096,22300340,"DEC 16, 2023",OKC @ DEN,W,32,6,12,0.5,1,4,0.25,4,6,0.667,1,10,11,1,0,8,1,3,17,10,1,Chet Holmgren,OKC,DEN,OKC,0.5,Steals,29,28,18,12
22023,1631096,22300340,"DEC 16, 2023",OKC @ DEN,W,32,6,12,0.5,1,4,0.25,4,6,0.667,1,10,11,1,0,8,1,3,17,10,1,Chet Holmgren,OKC,DEN,OKC,10.0,Rebs+Asts,29,28,18,12
22023,1631096,22300324,"DEC 14, 2023",OKC @ SAC,L,30,6,12,0.5,0,2,0.0,2,2,1.0,2,9,11,1,0,3,1,4,14,-10,1,Chet Holmgren,OKC,SAC,OKC,17.5,Points,26,25,15,12
22023,1631096,22300324,"DEC 14, 2023",OKC @ SAC,L,30,6,12,0.5,0,2,0.0,2,2,1.0,2,9,11,1,0,3,1,4,14,-10,1,Chet Holmgren,OKC,SAC,OKC,7.5,Rebounds,26,25,15,12
22023,1631096,22300324,"DEC 14, 2023",OKC @ SAC,L,30,6,12,0.5,0,2,0.0,2,2,1.0,2,9,11,1,0,3,1,4,14,-10,1,Chet Holmgren,OKC,SAC,OKC,27.5,Pts+Rebs+Asts,26,25,15,12
22023,1631096,22300324,"DEC 14, 2023",OKC @ SAC,L,30,6,12,0.5,0,2,0.0,2,2,1.0,2,9,11,1,0,3,1,4,14,-10,1,Chet Holmgren,OKC,SAC,OKC,37.0,Fantasy Score,26,25,15,12
22023,1631096,22300324,"DEC 14, 2023",OKC @ SAC,L,30,6,12,0.5,0,2,0.0,2,2,1.0,2,9,11,1,0,3,1,4,14,-10,1,Chet Holmgren,OKC,SAC,OKC,6.0,Defensive Rebounds,26,25,15,12
22023,1631096,22300324,"DEC 14, 2023",OKC @ SAC,L,30,6,12,0.5,0,2,0.0,2,2,1.0,2,9,11,1,0,3,1,4,14,-10,1,Chet Holmgren,OKC,SAC,OKC,2.5,Free Throws Made,26,25,15,12
22023,1631096,22300324,"DEC 14, 2023",OKC @ SAC,L,30,6,12,0.5,0,2,0.0,2,2,1.0,2,9,11,1,0,3,1,4,14,-10,1,Chet Holmgren,OKC,SAC,OKC,13.0,FG Attempted,26,25,15,12
22023,1631096,22300324,"DEC 14, 2023",OKC @ SAC,L,30,6,12,0.5,0,2,0.0,2,2,1.0,2,9,11,1,0,3,1,4,14,-10,1,Chet Holmgren,OKC,SAC,OKC,24.5,Pts+Rebs,26,25,15,12
22023,1631096,22300324,"DEC 14, 2023",OKC @ SAC,L,30,6,12,0.5,0,2,0.0,2,2,1.0,2,9,11,1,0,3,1,4,14,-10,1,Chet Holmgren,OKC,SAC,OKC,1.5,Dunks,26,25,15,12
22023,1631096,22300324,"DEC 14, 2023",OKC @ SAC,L,30,6,12,0.5,0,2,0.0,2,2,1.0,2,9,11,1,0,3,1,4,14,-10,1,Chet Holmgren,OKC,SAC,OKC,19.5,Pts+Asts,26,25,15,12
22023,1631096,22300324,"DEC 14, 2023",OKC @ SAC,L,30,6,12,0.5,0,2,0.0,2,2,1.0,2,9,11,1,0,3,1,4,14,-10,1,Chet Holmgren,OKC,SAC,OKC,1.5,3-PT Made,26,25,15,12
22023,1631096,22300324,"DEC 14, 2023",OKC @ SAC,L,30,6,12,0.5,0,2,0.0,2,2,1.0,2,9,11,1,0,3,1,4,14,-10,1,Chet Holmgren,OKC,SAC,OKC,0.5,Steals,26,25,15,12
22023,1631096,22300324,"DEC 14, 2023",OKC @ SAC,L,30,6,12,0.5,0,2,0.0,2,2,1.0,2,9,11,1,0,3,1,4,14,-10,1,Chet Holmgren,OKC,SAC,OKC,10.0,Rebs+Asts,26,25,15,12
22023,1631096,22300302,"DEC 11, 2023",OKC vs. UTA,W,25,6,9,0.667,2,3,0.667,2,2,1.0,2,6,8,2,1,2,3,2,16,24,1,Chet Holmgren,OKC,OKC,UTA,17.5,Points,26,24,18,10
22023,1631096,22300302,"DEC 11, 2023",OKC vs. UTA,W,25,6,9,0.667,2,3,0.667,2,2,1.0,2,6,8,2,1,2,3,2,16,24,1,Chet Holmgren,OKC,OKC,UTA,7.5,Rebounds,26,24,18,10
22023,1631096,22300302,"DEC 11, 2023",OKC vs. UTA,W,25,6,9,0.667,2,3,0.667,2,2,1.0,2,6,8,2,1,2,3,2,16,24,1,Chet Holmgren,OKC,OKC,UTA,27.5,Pts+Rebs+Asts,26,24,18,10
22023,1631096,22300302,"DEC 11, 2023",OKC vs. UTA,W,25,6,9,0.667,2,3,0.667,2,2,1.0,2,6,8,2,1,2,3,2,16,24,1,Chet Holmgren,OKC,OKC,UTA,37.0,Fantasy Score,26,24,18,10
22023,1631096,22300302,"DEC 11, 2023",OKC vs. UTA,W,25,6,9,0.667,2,3,0.667,2,2,1.0,2,6,8,2,1,2,3,2,16,24,1,Chet Holmgren,OKC,OKC,UTA,6.0,Defensive Rebounds,26,24,18,10
22023,1631096,22300302,"DEC 11, 2023",OKC vs. UTA,W,25,6,9,0.667,2,3,0.667,2,2,1.0,2,6,8,2,1,2,3,2,16,24,1,Chet Holmgren,OKC,OKC,UTA,2.5,Free Throws Made,26,24,18,10
22023,1631096,22300302,"DEC 11, 2023",OKC vs. UTA,W,25,6,9,0.667,2,3,0.667,2,2,1.0,2,6,8,2,1,2,3,2,16,24,1,Chet Holmgren,OKC,OKC,UTA,13.0,FG Attempted,26,24,18,10
22023,1631096,22300302,"DEC 11, 2023",OKC vs. UTA,W,25,6,9,0.667,2,3,0.667,2,2,1.0,2,6,8,2,1,2,3,2,16,24,1,Chet Holmgren,OKC,OKC,UTA,24.5,Pts+Rebs,26,24,18,10
22023,1631096,22300302,"DEC 11, 2023",OKC vs. UTA,W,25,6,9,0.667,2,3,0.667,2,2,1.0,2,6,8,2,1,2,3,2,16,24,1,Chet Holmgren,OKC,OKC,UTA,1.5,Dunks,26,24,18,10
22023,1631096,22300302,"DEC 11, 2023",OKC vs. UTA,W,25,6,9,0.667,2,3,0.667,2,2,1.0,2,6,8,2,1,2,3,2,16,24,1,Chet Holmgren,OKC,OKC,UTA,19.5,Pts+Asts,26,24,18,10
22023,1631096,22300302,"DEC 11, 2023",OKC vs. UTA,W,25,6,9,0.667,2,3,0.667,2,2,1.0,2,6,8,2,1,2,3,2,16,24,1,Chet Holmgren,OKC,OKC,UTA,1.5,3-PT Made,26,24,18,10
22023,1631096,22300302,"DEC 11, 2023",OKC vs. UTA,W,25,6,9,0.667,2,3,0.667,2,2,1.0,2,6,8,2,1,2,3,2,16,24,1,Chet Holmgren,OKC,OKC,UTA,0.5,Steals,26,24,18,10
22023,1631096,22300302,"DEC 11, 2023",OKC vs. UTA,W,25,6,9,0.667,2,3,0.667,2,2,1.0,2,6,8,2,1,2,3,2,16,24,1,Chet Holmgren,OKC,OKC,UTA,10.0,Rebs+Asts,26,24,18,10
22023,1631096,22301222,"DEC 08, 2023",OKC vs. GSW,W,35,6,12,0.5,1,4,0.25,8,8,1.0,2,5,7,1,0,3,3,4,21,-3,1,Chet Holmgren,OKC,OKC,GSW,17.5,Points,29,28,22,8
22023,1631096,22301222,"DEC 08, 2023",OKC vs. GSW,W,35,6,12,0.5,1,4,0.25,8,8,1.0,2,5,7,1,0,3,3,4,21,-3,1,Chet Holmgren,OKC,OKC,GSW,7.5,Rebounds,29,28,22,8
22023,1631096,22301222,"DEC 08, 2023",OKC vs. GSW,W,35,6,12,0.5,1,4,0.25,8,8,1.0,2,5,7,1,0,3,3,4,21,-3,1,Chet Holmgren,OKC,OKC,GSW,27.5,Pts+Rebs+Asts,29,28,22,8
22023,1631096,22301222,"DEC 08, 2023",OKC vs. GSW,W,35,6,12,0.5,1,4,0.25,8,8,1.0,2,5,7,1,0,3,3,4,21,-3,1,Chet Holmgren,OKC,OKC,GSW,37.0,Fantasy Score,29,28,22,8
22023,1631096,22301222,"DEC 08, 2023",OKC vs. GSW,W,35,6,12,0.5,1,4,0.25,8,8,1.0,2,5,7,1,0,3,3,4,21,-3,1,Chet Holmgren,OKC,OKC,GSW,6.0,Defensive Rebounds,29,28,22,8
22023,1631096,22301222,"DEC 08, 2023",OKC vs. GSW,W,35,6,12,0.5,1,4,0.25,8,8,1.0,2,5,7,1,0,3,3,4,21,-3,1,Chet Holmgren,OKC,OKC,GSW,2.5,Free Throws Made,29,28,22,8
22023,1631096,22301222,"DEC 08, 2023",OKC vs. GSW,W,35,6,12,0.5,1,4,0.25,8,8,1.0,2,5,7,1,0,3,3,4,21,-3,1,Chet Holmgren,OKC,OKC,GSW,13.0,FG Attempted,29,28,22,8
22023,1631096,22301222,"DEC 08, 2023",OKC vs. GSW,W,35,6,12,0.5,1,4,0.25,8,8,1.0,2,5,7,1,0,3,3,4,21,-3,1,Chet Holmgren,OKC,OKC,GSW,24.5,Pts+Rebs,29,28,22,8
22023,1631096,22301222,"DEC 08, 2023",OKC vs. GSW,W,35,6,12,0.5,1,4,0.25,8,8,1.0,2,5,7,1,0,3,3,4,21,-3,1,Chet Holmgren,OKC,OKC,GSW,1.5,Dunks,29,28,22,8
22023,1631096,22301222,"DEC 08, 2023",OKC vs. GSW,W,35,6,12,0.5,1,4,0.25,8,8,1.0,2,5,7,1,0,3,3,4,21,-3,1,Chet Holmgren,OKC,OKC,GSW,19.5,Pts+Asts,29,28,22,8
22023,1631096,22301222,"DEC 08, 2023",OKC vs. GSW,W,35,6,12,0.5,1,4,0.25,8,8,1.0,2,5,7,1,0,3,3,4,21,-3,1,Chet Holmgren,OKC,OKC,GSW,1.5,3-PT Made,29,28,22,8
22023,1631096,22301222,"DEC 08, 2023",OKC vs. GSW,W,35,6,12,0.5,1,4,0.25,8,8,1.0,2,5,7,1,0,3,3,4,21,-3,1,Chet Holmgren,OKC,OKC,GSW,0.5,Steals,29,28,22,8
22023,1631096,22301222,"DEC 08, 2023",OKC vs. GSW,W,35,6,12,0.5,1,4,0.25,8,8,1.0,2,5,7,1,0,3,3,4,21,-3,1,Chet Holmgren,OKC,OKC,GSW,10.0,Rebs+Asts,29,28,22,8
22023,1631096,22301212,"DEC 06, 2023",OKC @ HOU,L,26,2,9,0.222,0,4,0.0,0,0,0.0,1,4,5,2,1,6,1,2,4,-16,1,Chet Holmgren,OKC,HOU,OKC,17.5,Points,11,9,6,7
22023,1631096,22301212,"DEC 06, 2023",OKC @ HOU,L,26,2,9,0.222,0,4,0.0,0,0,0.0,1,4,5,2,1,6,1,2,4,-16,1,Chet Holmgren,OKC,HOU,OKC,7.5,Rebounds,11,9,6,7
22023,1631096,22301212,"DEC 06, 2023",OKC @ HOU,L,26,2,9,0.222,0,4,0.0,0,0,0.0,1,4,5,2,1,6,1,2,4,-16,1,Chet Holmgren,OKC,HOU,OKC,27.5,Pts+Rebs+Asts,11,9,6,7
22023,1631096,22301212,"DEC 06, 2023",OKC @ HOU,L,26,2,9,0.222,0,4,0.0,0,0,0.0,1,4,5,2,1,6,1,2,4,-16,1,Chet Holmgren,OKC,HOU,OKC,37.0,Fantasy Score,11,9,6,7
22023,1631096,22301212,"DEC 06, 2023",OKC @ HOU,L,26,2,9,0.222,0,4,0.0,0,0,0.0,1,4,5,2,1,6,1,2,4,-16,1,Chet Holmgren,OKC,HOU,OKC,6.0,Defensive Rebounds,11,9,6,7
22023,1631096,22301212,"DEC 06, 2023",OKC @ HOU,L,26,2,9,0.222,0,4,0.0,0,0,0.0,1,4,5,2,1,6,1,2,4,-16,1,Chet Holmgren,OKC,HOU,OKC,2.5,Free Throws Made,11,9,6,7
22023,1631096,22301212,"DEC 06, 2023",OKC @ HOU,L,26,2,9,0.222,0,4,0.0,0,0,0.0,1,4,5,2,1,6,1,2,4,-16,1,Chet Holmgren,OKC,HOU,OKC,13.0,FG Attempted,11,9,6,7
22023,1631096,22301212,"DEC 06, 2023",OKC @ HOU,L,26,2,9,0.222,0,4,0.0,0,0,0.0,1,4,5,2,1,6,1,2,4,-16,1,Chet Holmgren,OKC,HOU,OKC,24.5,Pts+Rebs,11,9,6,7
22023,1631096,22301212,"DEC 06, 2023",OKC @ HOU,L,26,2,9,0.222,0,4,0.0,0,0,0.0,1,4,5,2,1,6,1,2,4,-16,1,Chet Holmgren,OKC,HOU,OKC,1.5,Dunks,11,9,6,7
22023,1631096,22301212,"DEC 06, 2023",OKC @ HOU,L,26,2,9,0.222,0,4,0.0,0,0,0.0,1,4,5,2,1,6,1,2,4,-16,1,Chet Holmgren,OKC,HOU,OKC,19.5,Pts+Asts,11,9,6,7
22023,1631096,22301212,"DEC 06, 2023",OKC @ HOU,L,26,2,9,0.222,0,4,0.0,0,0,0.0,1,4,5,2,1,6,1,2,4,-16,1,Chet Holmgren,OKC,HOU,OKC,1.5,3-PT Made,11,9,6,7
22023,1631096,22301212,"DEC 06, 2023",OKC @ HOU,L,26,2,9,0.222,0,4,0.0,0,0,0.0,1,4,5,2,1,6,1,2,4,-16,1,Chet Holmgren,OKC,HOU,OKC,0.5,Steals,11,9,6,7
22023,1631096,22301212,"DEC 06, 2023",OKC @ HOU,L,26,2,9,0.222,0,4,0.0,0,0,0.0,1,4,5,2,1,6,1,2,4,-16,1,Chet Holmgren,OKC,HOU,OKC,10.0,Rebs+Asts,11,9,6,7
22023,1631096,22300287,"DEC 02, 2023",OKC @ DAL,W,30,4,10,0.4,0,3,0.0,3,4,0.75,3,8,11,3,1,4,2,3,11,4,1,Chet Holmgren,OKC,DAL,OKC,17.5,Points,25,22,14,14
22023,1631096,22300287,"DEC 02, 2023",OKC @ DAL,W,30,4,10,0.4,0,3,0.0,3,4,0.75,3,8,11,3,1,4,2,3,11,4,1,Chet Holmgren,OKC,DAL,OKC,7.5,Rebounds,25,22,14,14
22023,1631096,22300287,"DEC 02, 2023",OKC @ DAL,W,30,4,10,0.4,0,3,0.0,3,4,0.75,3,8,11,3,1,4,2,3,11,4,1,Chet Holmgren,OKC,DAL,OKC,27.5,Pts+Rebs+Asts,25,22,14,14
22023,1631096,22300287,"DEC 02, 2023",OKC @ DAL,W,30,4,10,0.4,0,3,0.0,3,4,0.75,3,8,11,3,1,4,2,3,11,4,1,Chet Holmgren,OKC,DAL,OKC,37.0,Fantasy Score,25,22,14,14
22023,1631096,22300287,"DEC 02, 2023",OKC @ DAL,W,30,4,10,0.4,0,3,0.0,3,4,0.75,3,8,11,3,1,4,2,3,11,4,1,Chet Holmgren,OKC,DAL,OKC,6.0,Defensive Rebounds,25,22,14,14
22023,1631096,22300287,"DEC 02, 2023",OKC @ DAL,W,30,4,10,0.4,0,3,0.0,3,4,0.75,3,8,11,3,1,4,2,3,11,4,1,Chet Holmgren,OKC,DAL,OKC,2.5,Free Throws Made,25,22,14,14
22023,1631096,22300287,"DEC 02, 2023",OKC @ DAL,W,30,4,10,0.4,0,3,0.0,3,4,0.75,3,8,11,3,1,4,2,3,11,4,1,Chet Holmgren,OKC,DAL,OKC,13.0,FG Attempted,25,22,14,14
22023,1631096,22300287,"DEC 02, 2023",OKC @ DAL,W,30,4,10,0.4,0,3,0.0,3,4,0.75,3,8,11,3,1,4,2,3,11,4,1,Chet Holmgren,OKC,DAL,OKC,24.5,Pts+Rebs,25,22,14,14
22023,1631096,22300287,"DEC 02, 2023",OKC @ DAL,W,30,4,10,0.4,0,3,0.0,3,4,0.75,3,8,11,3,1,4,2,3,11,4,1,Chet Holmgren,OKC,DAL,OKC,1.5,Dunks,25,22,14,14
22023,1631096,22300287,"DEC 02, 2023",OKC @ DAL,W,30,4,10,0.4,0,3,0.0,3,4,0.75,3,8,11,3,1,4,2,3,11,4,1,Chet Holmgren,OKC,DAL,OKC,19.5,Pts+Asts,25,22,14,14
22023,1631096,22300287,"DEC 02, 2023",OKC @ DAL,W,30,4,10,0.4,0,3,0.0,3,4,0.75,3,8,11,3,1,4,2,3,11,4,1,Chet Holmgren,OKC,DAL,OKC,1.5,3-PT Made,25,22,14,14
22023,1631096,22300287,"DEC 02, 2023",OKC @ DAL,W,30,4,10,0.4,0,3,0.0,3,4,0.75,3,8,11,3,1,4,2,3,11,4,1,Chet Holmgren,OKC,DAL,OKC,0.5,Steals,25,22,14,14
22023,1631096,22300287,"DEC 02, 2023",OKC @ DAL,W,30,4,10,0.4,0,3,0.0,3,4,0.75,3,8,11,3,1,4,2,3,11,4,1,Chet Holmgren,OKC,DAL,OKC,10.0,Rebs+Asts,25,22,14,14
22023,1631096,22300271,"NOV 30, 2023",OKC vs. LAL,W,28,8,15,0.533,1,6,0.167,1,1,1.0,1,4,5,1,2,0,2,3,18,16,1,Chet Holmgren,OKC,OKC,LAL,17.5,Points,24,23,19,6
22023,1631096,22300271,"NOV 30, 2023",OKC vs. LAL,W,28,8,15,0.533,1,6,0.167,1,1,1.0,1,4,5,1,2,0,2,3,18,16,1,Chet Holmgren,OKC,OKC,LAL,7.5,Rebounds,24,23,19,6
22023,1631096,22300271,"NOV 30, 2023",OKC vs. LAL,W,28,8,15,0.533,1,6,0.167,1,1,1.0,1,4,5,1,2,0,2,3,18,16,1,Chet Holmgren,OKC,OKC,LAL,27.5,Pts+Rebs+Asts,24,23,19,6
22023,1631096,22300271,"NOV 30, 2023",OKC vs. LAL,W,28,8,15,0.533,1,6,0.167,1,1,1.0,1,4,5,1,2,0,2,3,18,16,1,Chet Holmgren,OKC,OKC,LAL,37.0,Fantasy Score,24,23,19,6
22023,1631096,22300271,"NOV 30, 2023",OKC vs. LAL,W,28,8,15,0.533,1,6,0.167,1,1,1.0,1,4,5,1,2,0,2,3,18,16,1,Chet Holmgren,OKC,OKC,LAL,6.0,Defensive Rebounds,24,23,19,6
22023,1631096,22300271,"NOV 30, 2023",OKC vs. LAL,W,28,8,15,0.533,1,6,0.167,1,1,1.0,1,4,5,1,2,0,2,3,18,16,1,Chet Holmgren,OKC,OKC,LAL,2.5,Free Throws Made,24,23,19,6
22023,1631096,22300271,"NOV 30, 2023",OKC vs. LAL,W,28,8,15,0.533,1,6,0.167,1,1,1.0,1,4,5,1,2,0,2,3,18,16,1,Chet Holmgren,OKC,OKC,LAL,13.0,FG Attempted,24,23,19,6
22023,1631096,22300271,"NOV 30, 2023",OKC vs. LAL,W,28,8,15,0.533,1,6,0.167,1,1,1.0,1,4,5,1,2,0,2,3,18,16,1,Chet Holmgren,OKC,OKC,LAL,24.5,Pts+Rebs,24,23,19,6
22023,1631096,22300271,"NOV 30, 2023",OKC vs. LAL,W,28,8,15,0.533,1,6,0.167,1,1,1.0,1,4,5,1,2,0,2,3,18,16,1,Chet Holmgren,OKC,OKC,LAL,1.5,Dunks,24,23,19,6
22023,1631096,22300271,"NOV 30, 2023",OKC vs. LAL,W,28,8,15,0.533,1,6,0.167,1,1,1.0,1,4,5,1,2,0,2,3,18,16,1,Chet Holmgren,OKC,OKC,LAL,19.5,Pts+Asts,24,23,19,6
22023,1631096,22300271,"NOV 30, 2023",OKC vs. LAL,W,28,8,15,0.533,1,6,0.167,1,1,1.0,1,4,5,1,2,0,2,3,18,16,1,Chet Holmgren,OKC,OKC,LAL,1.5,3-PT Made,24,23,19,6
22023,1631096,22300271,"NOV 30, 2023",OKC vs. LAL,W,28,8,15,0.533,1,6,0.167,1,1,1.0,1,4,5,1,2,0,2,3,18,16,1,Chet Holmgren,OKC,OKC,LAL,0.5,Steals,24,23,19,6
22023,1631096,22300271,"NOV 30, 2023",OKC vs. LAL,W,28,8,15,0.533,1,6,0.167,1,1,1.0,1,4,5,1,2,0,2,3,18,16,1,Chet Holmgren,OKC,OKC,LAL,10.0,Rebs+Asts,24,23,19,6
22023,1631096,22300058,"NOV 28, 2023",OKC @ MIN,L,34,6,20,0.3,3,8,0.375,1,2,0.5,2,6,8,6,1,1,0,2,16,-4,1,Chet Holmgren,OKC,MIN,OKC,17.5,Points,30,24,22,14
22023,1631096,22300058,"NOV 28, 2023",OKC @ MIN,L,34,6,20,0.3,3,8,0.375,1,2,0.5,2,6,8,6,1,1,0,2,16,-4,1,Chet Holmgren,OKC,MIN,OKC,7.5,Rebounds,30,24,22,14
22023,1631096,22300058,"NOV 28, 2023",OKC @ MIN,L,34,6,20,0.3,3,8,0.375,1,2,0.5,2,6,8,6,1,1,0,2,16,-4,1,Chet Holmgren,OKC,MIN,OKC,27.5,Pts+Rebs+Asts,30,24,22,14
22023,1631096,22300058,"NOV 28, 2023",OKC @ MIN,L,34,6,20,0.3,3,8,0.375,1,2,0.5,2,6,8,6,1,1,0,2,16,-4,1,Chet Holmgren,OKC,MIN,OKC,37.0,Fantasy Score,30,24,22,14
22023,1631096,22300058,"NOV 28, 2023",OKC @ MIN,L,34,6,20,0.3,3,8,0.375,1,2,0.5,2,6,8,6,1,1,0,2,16,-4,1,Chet Holmgren,OKC,MIN,OKC,6.0,Defensive Rebounds,30,24,22,14
22023,1631096,22300058,"NOV 28, 2023",OKC @ MIN,L,34,6,20,0.3,3,8,0.375,1,2,0.5,2,6,8,6,1,1,0,2,16,-4,1,Chet Holmgren,OKC,MIN,OKC,2.5,Free Throws Made,30,24,22,14
22023,1631096,22300058,"NOV 28, 2023",OKC @ MIN,L,34,6,20,0.3,3,8,0.375,1,2,0.5,2,6,8,6,1,1,0,2,16,-4,1,Chet Holmgren,OKC,MIN,OKC,13.0,FG Attempted,30,24,22,14
22023,1631096,22300058,"NOV 28, 2023",OKC @ MIN,L,34,6,20,0.3,3,8,0.375,1,2,0.5,2,6,8,6,1,1,0,2,16,-4,1,Chet Holmgren,OKC,MIN,OKC,24.5,Pts+Rebs,30,24,22,14
22023,1631096,22300058,"NOV 28, 2023",OKC @ MIN,L,34,6,20,0.3,3,8,0.375,1,2,0.5,2,6,8,6,1,1,0,2,16,-4,1,Chet Holmgren,OKC,MIN,OKC,1.5,Dunks,30,24,22,14
22023,1631096,22300058,"NOV 28, 2023",OKC @ MIN,L,34,6,20,0.3,3,8,0.375,1,2,0.5,2,6,8,6,1,1,0,2,16,-4,1,Chet Holmgren,OKC,MIN,OKC,19.5,Pts+Asts,30,24,22,14
22023,1631096,22300058,"NOV 28, 2023",OKC @ MIN,L,34,6,20,0.3,3,8,0.375,1,2,0.5,2,6,8,6,1,1,0,2,16,-4,1,Chet Holmgren,OKC,MIN,OKC,1.5,3-PT Made,30,24,22,14
22023,1631096,22300058,"NOV 28, 2023",OKC @ MIN,L,34,6,20,0.3,3,8,0.375,1,2,0.5,2,6,8,6,1,1,0,2,16,-4,1,Chet Holmgren,OKC,MIN,OKC,0.5,Steals,30,24,22,14
22023,1631096,22300058,"NOV 28, 2023",OKC @ MIN,L,34,6,20,0.3,3,8,0.375,1,2,0.5,2,6,8,6,1,1,0,2,16,-4,1,Chet Holmgren,OKC,MIN,OKC,10.0,Rebs+Asts,30,24,22,14
22023,1631096,22300239,"NOV 25, 2023",OKC vs. PHI,L,32,13,21,0.619,5,11,0.455,2,2,1.0,1,5,6,2,0,3,1,3,33,4,1,Chet Holmgren,OKC,OKC,PHI,17.5,Points,41,39,35,8
22023,1631096,22300239,"NOV 25, 2023",OKC vs. PHI,L,32,13,21,0.619,5,11,0.455,2,2,1.0,1,5,6,2,0,3,1,3,33,4,1,Chet Holmgren,OKC,OKC,PHI,7.5,Rebounds,41,39,35,8
22023,1631096,22300239,"NOV 25, 2023",OKC vs. PHI,L,32,13,21,0.619,5,11,0.455,2,2,1.0,1,5,6,2,0,3,1,3,33,4,1,Chet Holmgren,OKC,OKC,PHI,27.5,Pts+Rebs+Asts,41,39,35,8
22023,1631096,22300239,"NOV 25, 2023",OKC vs. PHI,L,32,13,21,0.619,5,11,0.455,2,2,1.0,1,5,6,2,0,3,1,3,33,4,1,Chet Holmgren,OKC,OKC,PHI,37.0,Fantasy Score,41,39,35,8
22023,1631096,22300239,"NOV 25, 2023",OKC vs. PHI,L,32,13,21,0.619,5,11,0.455,2,2,1.0,1,5,6,2,0,3,1,3,33,4,1,Chet Holmgren,OKC,OKC,PHI,6.0,Defensive Rebounds,41,39,35,8
22023,1631096,22300239,"NOV 25, 2023",OKC vs. PHI,L,32,13,21,0.619,5,11,0.455,2,2,1.0,1,5,6,2,0,3,1,3,33,4,1,Chet Holmgren,OKC,OKC,PHI,2.5,Free Throws Made,41,39,35,8
22023,1631096,22300239,"NOV 25, 2023",OKC vs. PHI,L,32,13,21,0.619,5,11,0.455,2,2,1.0,1,5,6,2,0,3,1,3,33,4,1,Chet Holmgren,OKC,OKC,PHI,13.0,FG Attempted,41,39,35,8
22023,1631096,22300239,"NOV 25, 2023",OKC vs. PHI,L,32,13,21,0.619,5,11,0.455,2,2,1.0,1,5,6,2,0,3,1,3,33,4,1,Chet Holmgren,OKC,OKC,PHI,24.5,Pts+Rebs,41,39,35,8
22023,1631096,22300239,"NOV 25, 2023",OKC vs. PHI,L,32,13,21,0.619,5,11,0.455,2,2,1.0,1,5,6,2,0,3,1,3,33,4,1,Chet Holmgren,OKC,OKC,PHI,1.5,Dunks,41,39,35,8
22023,1631096,22300239,"NOV 25, 2023",OKC vs. PHI,L,32,13,21,0.619,5,11,0.455,2,2,1.0,1,5,6,2,0,3,1,3,33,4,1,Chet Holmgren,OKC,OKC,PHI,19.5,Pts+Asts,41,39,35,8
22023,1631096,22300239,"NOV 25, 2023",OKC vs. PHI,L,32,13,21,0.619,5,11,0.455,2,2,1.0,1,5,6,2,0,3,1,3,33,4,1,Chet Holmgren,OKC,OKC,PHI,1.5,3-PT Made,41,39,35,8
22023,1631096,22300239,"NOV 25, 2023",OKC vs. PHI,L,32,13,21,0.619,5,11,0.455,2,2,1.0,1,5,6,2,0,3,1,3,33,4,1,Chet Holmgren,OKC,OKC,PHI,0.5,Steals,41,39,35,8
22023,1631096,22300239,"NOV 25, 2023",OKC vs. PHI,L,32,13,21,0.619,5,11,0.455,2,2,1.0,1,5,6,2,0,3,1,3,33,4,1,Chet Holmgren,OKC,OKC,PHI,10.0,Rebs+Asts,41,39,35,8
22023,1631096,22300234,"NOV 22, 2023",OKC vs. CHI,W,32,5,11,0.455,0,3,0.0,8,11,0.727,5,8,13,2,1,4,2,3,18,18,1,Chet Holmgren,OKC,OKC,CHI,17.5,Points,33,31,20,15
22023,1631096,22300234,"NOV 22, 2023",OKC vs. CHI,W,32,5,11,0.455,0,3,0.0,8,11,0.727,5,8,13,2,1,4,2,3,18,18,1,Chet Holmgren,OKC,OKC,CHI,7.5,Rebounds,33,31,20,15
22023,1631096,22300234,"NOV 22, 2023",OKC vs. CHI,W,32,5,11,0.455,0,3,0.0,8,11,0.727,5,8,13,2,1,4,2,3,18,18,1,Chet Holmgren,OKC,OKC,CHI,27.5,Pts+Rebs+Asts,33,31,20,15
22023,1631096,22300234,"NOV 22, 2023",OKC vs. CHI,W,32,5,11,0.455,0,3,0.0,8,11,0.727,5,8,13,2,1,4,2,3,18,18,1,Chet Holmgren,OKC,OKC,CHI,37.0,Fantasy Score,33,31,20,15
22023,1631096,22300234,"NOV 22, 2023",OKC vs. CHI,W,32,5,11,0.455,0,3,0.0,8,11,0.727,5,8,13,2,1,4,2,3,18,18,1,Chet Holmgren,OKC,OKC,CHI,6.0,Defensive Rebounds,33,31,20,15
22023,1631096,22300234,"NOV 22, 2023",OKC vs. CHI,W,32,5,11,0.455,0,3,0.0,8,11,0.727,5,8,13,2,1,4,2,3,18,18,1,Chet Holmgren,OKC,OKC,CHI,2.5,Free Throws Made,33,31,20,15
22023,1631096,22300234,"NOV 22, 2023",OKC vs. CHI,W,32,5,11,0.455,0,3,0.0,8,11,0.727,5,8,13,2,1,4,2,3,18,18,1,Chet Holmgren,OKC,OKC,CHI,13.0,FG Attempted,33,31,20,15
22023,1631096,22300234,"NOV 22, 2023",OKC vs. CHI,W,32,5,11,0.455,0,3,0.0,8,11,0.727,5,8,13,2,1,4,2,3,18,18,1,Chet Holmgren,OKC,OKC,CHI,24.5,Pts+Rebs,33,31,20,15
22023,1631096,22300234,"NOV 22, 2023",OKC vs. CHI,W,32,5,11,0.455,0,3,0.0,8,11,0.727,5,8,13,2,1,4,2,3,18,18,1,Chet Holmgren,OKC,OKC,CHI,1.5,Dunks,33,31,20,15
22023,1631096,22300234,"NOV 22, 2023",OKC vs. CHI,W,32,5,11,0.455,0,3,0.0,8,11,0.727,5,8,13,2,1,4,2,3,18,18,1,Chet Holmgren,OKC,OKC,CHI,19.5,Pts+Asts,33,31,20,15
22023,1631096,22300234,"NOV 22, 2023",OKC vs. CHI,W,32,5,11,0.455,0,3,0.0,8,11,0.727,5,8,13,2,1,4,2,3,18,18,1,Chet Holmgren,OKC,OKC,CHI,1.5,3-PT Made,33,31,20,15
22023,1631096,22300234,"NOV 22, 2023",OKC vs. CHI,W,32,5,11,0.455,0,3,0.0,8,11,0.727,5,8,13,2,1,4,2,3,18,18,1,Chet Holmgren,OKC,OKC,CHI,0.5,Steals,33,31,20,15
22023,1631096,22300234,"NOV 22, 2023",OKC vs. CHI,W,32,5,11,0.455,0,3,0.0,8,11,0.727,5,8,13,2,1,4,2,3,18,18,1,Chet Holmgren,OKC,OKC,CHI,10.0,Rebs+Asts,33,31,20,15
22023,1631096,22300215,"NOV 19, 2023",OKC @ POR,W,20,6,6,1.0,2,2,1.0,2,2,1.0,0,6,6,0,0,2,0,1,16,10,1,Chet Holmgren,OKC,POR,OKC,17.5,Points,22,22,16,6
22023,1631096,22300215,"NOV 19, 2023",OKC @ POR,W,20,6,6,1.0,2,2,1.0,2,2,1.0,0,6,6,0,0,2,0,1,16,10,1,Chet Holmgren,OKC,POR,OKC,7.5,Rebounds,22,22,16,6
22023,1631096,22300215,"NOV 19, 2023",OKC @ POR,W,20,6,6,1.0,2,2,1.0,2,2,1.0,0,6,6,0,0,2,0,1,16,10,1,Chet Holmgren,OKC,POR,OKC,27.5,Pts+Rebs+Asts,22,22,16,6
22023,1631096,22300215,"NOV 19, 2023",OKC @ POR,W,20,6,6,1.0,2,2,1.0,2,2,1.0,0,6,6,0,0,2,0,1,16,10,1,Chet Holmgren,OKC,POR,OKC,37.0,Fantasy Score,22,22,16,6
22023,1631096,22300215,"NOV 19, 2023",OKC @ POR,W,20,6,6,1.0,2,2,1.0,2,2,1.0,0,6,6,0,0,2,0,1,16,10,1,Chet Holmgren,OKC,POR,OKC,6.0,Defensive Rebounds,22,22,16,6
22023,1631096,22300215,"NOV 19, 2023",OKC @ POR,W,20,6,6,1.0,2,2,1.0,2,2,1.0,0,6,6,0,0,2,0,1,16,10,1,Chet Holmgren,OKC,POR,OKC,2.5,Free Throws Made,22,22,16,6
22023,1631096,22300215,"NOV 19, 2023",OKC @ POR,W,20,6,6,1.0,2,2,1.0,2,2,1.0,0,6,6,0,0,2,0,1,16,10,1,Chet Holmgren,OKC,POR,OKC,13.0,FG Attempted,22,22,16,6
22023,1631096,22300215,"NOV 19, 2023",OKC @ POR,W,20,6,6,1.0,2,2,1.0,2,2,1.0,0,6,6,0,0,2,0,1,16,10,1,Chet Holmgren,OKC,POR,OKC,24.5,Pts+Rebs,22,22,16,6
22023,1631096,22300215,"NOV 19, 2023",OKC @ POR,W,20,6,6,1.0,2,2,1.0,2,2,1.0,0,6,6,0,0,2,0,1,16,10,1,Chet Holmgren,OKC,POR,OKC,1.5,Dunks,22,22,16,6
22023,1631096,22300215,"NOV 19, 2023",OKC @ POR,W,20,6,6,1.0,2,2,1.0,2,2,1.0,0,6,6,0,0,2,0,1,16,10,1,Chet Holmgren,OKC,POR,OKC,19.5,Pts+Asts,22,22,16,6
22023,1631096,22300215,"NOV 19, 2023",OKC @ POR,W,20,6,6,1.0,2,2,1.0,2,2,1.0,0,6,6,0,0,2,0,1,16,10,1,Chet Holmgren,OKC,POR,OKC,1.5,3-PT Made,22,22,16,6
22023,1631096,22300215,"NOV 19, 2023",OKC @ POR,W,20,6,6,1.0,2,2,1.0,2,2,1.0,0,6,6,0,0,2,0,1,16,10,1,Chet Holmgren,OKC,POR,OKC,0.5,Steals,22,22,16,6
22023,1631096,22300215,"NOV 19, 2023",OKC @ POR,W,20,6,6,1.0,2,2,1.0,2,2,1.0,0,6,6,0,0,2,0,1,16,10,1,Chet Holmgren,OKC,POR,OKC,10.0,Rebs+Asts,22,22,16,6
22023,1631096,22300207,"NOV 18, 2023",OKC @ GSW,W,37,14,22,0.636,2,5,0.4,6,7,0.857,4,6,10,5,2,2,4,2,36,9,1,Chet Holmgren,OKC,GSW,OKC,17.5,Points,51,46,41,15
22023,1631096,22300207,"NOV 18, 2023",OKC @ GSW,W,37,14,22,0.636,2,5,0.4,6,7,0.857,4,6,10,5,2,2,4,2,36,9,1,Chet Holmgren,OKC,GSW,OKC,7.5,Rebounds,51,46,41,15
22023,1631096,22300207,"NOV 18, 2023",OKC @ GSW,W,37,14,22,0.636,2,5,0.4,6,7,0.857,4,6,10,5,2,2,4,2,36,9,1,Chet Holmgren,OKC,GSW,OKC,27.5,Pts+Rebs+Asts,51,46,41,15
22023,1631096,22300207,"NOV 18, 2023",OKC @ GSW,W,37,14,22,0.636,2,5,0.4,6,7,0.857,4,6,10,5,2,2,4,2,36,9,1,Chet Holmgren,OKC,GSW,OKC,37.0,Fantasy Score,51,46,41,15
22023,1631096,22300207,"NOV 18, 2023",OKC @ GSW,W,37,14,22,0.636,2,5,0.4,6,7,0.857,4,6,10,5,2,2,4,2,36,9,1,Chet Holmgren,OKC,GSW,OKC,6.0,Defensive Rebounds,51,46,41,15
22023,1631096,22300207,"NOV 18, 2023",OKC @ GSW,W,37,14,22,0.636,2,5,0.4,6,7,0.857,4,6,10,5,2,2,4,2,36,9,1,Chet Holmgren,OKC,GSW,OKC,2.5,Free Throws Made,51,46,41,15
22023,1631096,22300207,"NOV 18, 2023",OKC @ GSW,W,37,14,22,0.636,2,5,0.4,6,7,0.857,4,6,10,5,2,2,4,2,36,9,1,Chet Holmgren,OKC,GSW,OKC,13.0,FG Attempted,51,46,41,15
22023,1631096,22300207,"NOV 18, 2023",OKC @ GSW,W,37,14,22,0.636,2,5,0.4,6,7,0.857,4,6,10,5,2,2,4,2,36,9,1,Chet Holmgren,OKC,GSW,OKC,24.5,Pts+Rebs,51,46,41,15
22023,1631096,22300207,"NOV 18, 2023",OKC @ GSW,W,37,14,22,0.636,2,5,0.4,6,7,0.857,4,6,10,5,2,2,4,2,36,9,1,Chet Holmgren,OKC,GSW,OKC,1.5,Dunks,51,46,41,15
22023,1631096,22300207,"NOV 18, 2023",OKC @ GSW,W,37,14,22,0.636,2,5,0.4,6,7,0.857,4,6,10,5,2,2,4,2,36,9,1,Chet Holmgren,OKC,GSW,OKC,19.5,Pts+Asts,51,46,41,15
22023,1631096,22300207,"NOV 18, 2023",OKC @ GSW,W,37,14,22,0.636,2,5,0.4,6,7,0.857,4,6,10,5,2,2,4,2,36,9,1,Chet Holmgren,OKC,GSW,OKC,1.5,3-PT Made,51,46,41,15
22023,1631096,22300207,"NOV 18, 2023",OKC @ GSW,W,37,14,22,0.636,2,5,0.4,6,7,0.857,4,6,10,5,2,2,4,2,36,9,1,Chet Holmgren,OKC,GSW,OKC,0.5,Steals,51,46,41,15
22023,1631096,22300207,"NOV 18, 2023",OKC @ GSW,W,37,14,22,0.636,2,5,0.4,6,7,0.857,4,6,10,5,2,2,4,2,36,9,1,Chet Holmgren,OKC,GSW,OKC,10.0,Rebs+Asts,51,46,41,15
22023,1631096,22300201,"NOV 16, 2023",OKC @ GSW,W,27,4,7,0.571,0,2,0.0,5,5,1.0,1,9,10,2,0,2,4,2,13,-1,1,Chet Holmgren,OKC,GSW,OKC,17.5,Points,25,23,15,12
22023,1631096,22300201,"NOV 16, 2023",OKC @ GSW,W,27,4,7,0.571,0,2,0.0,5,5,1.0,1,9,10,2,0,2,4,2,13,-1,1,Chet Holmgren,OKC,GSW,OKC,7.5,Rebounds,25,23,15,12
22023,1631096,22300201,"NOV 16, 2023",OKC @ GSW,W,27,4,7,0.571,0,2,0.0,5,5,1.0,1,9,10,2,0,2,4,2,13,-1,1,Chet Holmgren,OKC,GSW,OKC,27.5,Pts+Rebs+Asts,25,23,15,12
22023,1631096,22300201,"NOV 16, 2023",OKC @ GSW,W,27,4,7,0.571,0,2,0.0,5,5,1.0,1,9,10,2,0,2,4,2,13,-1,1,Chet Holmgren,OKC,GSW,OKC,37.0,Fantasy Score,25,23,15,12
22023,1631096,22300201,"NOV 16, 2023",OKC @ GSW,W,27,4,7,0.571,0,2,0.0,5,5,1.0,1,9,10,2,0,2,4,2,13,-1,1,Chet Holmgren,OKC,GSW,OKC,6.0,Defensive Rebounds,25,23,15,12
22023,1631096,22300201,"NOV 16, 2023",OKC @ GSW,W,27,4,7,0.571,0,2,0.0,5,5,1.0,1,9,10,2,0,2,4,2,13,-1,1,Chet Holmgren,OKC,GSW,OKC,2.5,Free Throws Made,25,23,15,12
22023,1631096,22300201,"NOV 16, 2023",OKC @ GSW,W,27,4,7,0.571,0,2,0.0,5,5,1.0,1,9,10,2,0,2,4,2,13,-1,1,Chet Holmgren,OKC,GSW,OKC,13.0,FG Attempted,25,23,15,12
22023,1631096,22300201,"NOV 16, 2023",OKC @ GSW,W,27,4,7,0.571,0,2,0.0,5,5,1.0,1,9,10,2,0,2,4,2,13,-1,1,Chet Holmgren,OKC,GSW,OKC,24.5,Pts+Rebs,25,23,15,12
22023,1631096,22300201,"NOV 16, 2023",OKC @ GSW,W,27,4,7,0.571,0,2,0.0,5,5,1.0,1,9,10,2,0,2,4,2,13,-1,1,Chet Holmgren,OKC,GSW,OKC,1.5,Dunks,25,23,15,12
22023,1631096,22300201,"NOV 16, 2023",OKC @ GSW,W,27,4,7,0.571,0,2,0.0,5,5,1.0,1,9,10,2,0,2,4,2,13,-1,1,Chet Holmgren,OKC,GSW,OKC,19.5,Pts+Asts,25,23,15,12
22023,1631096,22300201,"NOV 16, 2023",OKC @ GSW,W,27,4,7,0.571,0,2,0.0,5,5,1.0,1,9,10,2,0,2,4,2,13,-1,1,Chet Holmgren,OKC,GSW,OKC,1.5,3-PT Made,25,23,15,12
22023,1631096,22300201,"NOV 16, 2023",OKC @ GSW,W,27,4,7,0.571,0,2,0.0,5,5,1.0,1,9,10,2,0,2,4,2,13,-1,1,Chet Holmgren,OKC,GSW,OKC,0.5,Steals,25,23,15,12
22023,1631096,22300201,"NOV 16, 2023",OKC @ GSW,W,27,4,7,0.571,0,2,0.0,5,5,1.0,1,9,10,2,0,2,4,2,13,-1,1,Chet Holmgren,OKC,GSW,OKC,10.0,Rebs+Asts,25,23,15,12
22023,1631096,22300021,"NOV 14, 2023",OKC vs. SAS,W,30,3,10,0.3,1,5,0.2,2,2,1.0,0,7,7,3,2,1,2,2,9,30,1,Chet Holmgren,OKC,OKC,SAS,17.5,Points,19,16,12,10
22023,1631096,22300021,"NOV 14, 2023",OKC vs. SAS,W,30,3,10,0.3,1,5,0.2,2,2,1.0,0,7,7,3,2,1,2,2,9,30,1,Chet Holmgren,OKC,OKC,SAS,7.5,Rebounds,19,16,12,10
22023,1631096,22300021,"NOV 14, 2023",OKC vs. SAS,W,30,3,10,0.3,1,5,0.2,2,2,1.0,0,7,7,3,2,1,2,2,9,30,1,Chet Holmgren,OKC,OKC,SAS,27.5,Pts+Rebs+Asts,19,16,12,10
22023,1631096,22300021,"NOV 14, 2023",OKC vs. SAS,W,30,3,10,0.3,1,5,0.2,2,2,1.0,0,7,7,3,2,1,2,2,9,30,1,Chet Holmgren,OKC,OKC,SAS,37.0,Fantasy Score,19,16,12,10
22023,1631096,22300021,"NOV 14, 2023",OKC vs. SAS,W,30,3,10,0.3,1,5,0.2,2,2,1.0,0,7,7,3,2,1,2,2,9,30,1,Chet Holmgren,OKC,OKC,SAS,6.0,Defensive Rebounds,19,16,12,10
22023,1631096,22300021,"NOV 14, 2023",OKC vs. SAS,W,30,3,10,0.3,1,5,0.2,2,2,1.0,0,7,7,3,2,1,2,2,9,30,1,Chet Holmgren,OKC,OKC,SAS,2.5,Free Throws Made,19,16,12,10
22023,1631096,22300021,"NOV 14, 2023",OKC vs. SAS,W,30,3,10,0.3,1,5,0.2,2,2,1.0,0,7,7,3,2,1,2,2,9,30,1,Chet Holmgren,OKC,OKC,SAS,13.0,FG Attempted,19,16,12,10
22023,1631096,22300021,"NOV 14, 2023",OKC vs. SAS,W,30,3,10,0.3,1,5,0.2,2,2,1.0,0,7,7,3,2,1,2,2,9,30,1,Chet Holmgren,OKC,OKC,SAS,24.5,Pts+Rebs,19,16,12,10
22023,1631096,22300021,"NOV 14, 2023",OKC vs. SAS,W,30,3,10,0.3,1,5,0.2,2,2,1.0,0,7,7,3,2,1,2,2,9,30,1,Chet Holmgren,OKC,OKC,SAS,1.5,Dunks,19,16,12,10
22023,1631096,22300021,"NOV 14, 2023",OKC vs. SAS,W,30,3,10,0.3,1,5,0.2,2,2,1.0,0,7,7,3,2,1,2,2,9,30,1,Chet Holmgren,OKC,OKC,SAS,19.5,Pts+Asts,19,16,12,10
22023,1631096,22300021,"NOV 14, 2023",OKC vs. SAS,W,30,3,10,0.3,1,5,0.2,2,2,1.0,0,7,7,3,2,1,2,2,9,30,1,Chet Holmgren,OKC,OKC,SAS,1.5,3-PT Made,19,16,12,10
22023,1631096,22300021,"NOV 14, 2023",OKC vs. SAS,W,30,3,10,0.3,1,5,0.2,2,2,1.0,0,7,7,3,2,1,2,2,9,30,1,Chet Holmgren,OKC,OKC,SAS,0.5,Steals,19,16,12,10
22023,1631096,22300021,"NOV 14, 2023",OKC vs. SAS,W,30,3,10,0.3,1,5,0.2,2,2,1.0,0,7,7,3,2,1,2,2,9,30,1,Chet Holmgren,OKC,OKC,SAS,10.0,Rebs+Asts,19,16,12,10
22023,1631096,22300185,"NOV 12, 2023",OKC @ PHX,W,33,5,10,0.5,3,6,0.5,5,5,1.0,0,6,6,4,0,2,0,3,18,27,1,Chet Holmgren,OKC,PHX,OKC,17.5,Points,28,24,22,10
22023,1631096,22300185,"NOV 12, 2023",OKC @ PHX,W,33,5,10,0.5,3,6,0.5,5,5,1.0,0,6,6,4,0,2,0,3,18,27,1,Chet Holmgren,OKC,PHX,OKC,7.5,Rebounds,28,24,22,10
22023,1631096,22300185,"NOV 12, 2023",OKC @ PHX,W,33,5,10,0.5,3,6,0.5,5,5,1.0,0,6,6,4,0,2,0,3,18,27,1,Chet Holmgren,OKC,PHX,OKC,27.5,Pts+Rebs+Asts,28,24,22,10
22023,1631096,22300185,"NOV 12, 2023",OKC @ PHX,W,33,5,10,0.5,3,6,0.5,5,5,1.0,0,6,6,4,0,2,0,3,18,27,1,Chet Holmgren,OKC,PHX,OKC,37.0,Fantasy Score,28,24,22,10
22023,1631096,22300185,"NOV 12, 2023",OKC @ PHX,W,33,5,10,0.5,3,6,0.5,5,5,1.0,0,6,6,4,0,2,0,3,18,27,1,Chet Holmgren,OKC,PHX,OKC,6.0,Defensive Rebounds,28,24,22,10
22023,1631096,22300185,"NOV 12, 2023",OKC @ PHX,W,33,5,10,0.5,3,6,0.5,5,5,1.0,0,6,6,4,0,2,0,3,18,27,1,Chet Holmgren,OKC,PHX,OKC,2.5,Free Throws Made,28,24,22,10
22023,1631096,22300185,"NOV 12, 2023",OKC @ PHX,W,33,5,10,0.5,3,6,0.5,5,5,1.0,0,6,6,4,0,2,0,3,18,27,1,Chet Holmgren,OKC,PHX,OKC,13.0,FG Attempted,28,24,22,10
22023,1631096,22300185,"NOV 12, 2023",OKC @ PHX,W,33,5,10,0.5,3,6,0.5,5,5,1.0,0,6,6,4,0,2,0,3,18,27,1,Chet Holmgren,OKC,PHX,OKC,24.5,Pts+Rebs,28,24,22,10
22023,1631096,22300185,"NOV 12, 2023",OKC @ PHX,W,33,5,10,0.5,3,6,0.5,5,5,1.0,0,6,6,4,0,2,0,3,18,27,1,Chet Holmgren,OKC,PHX,OKC,1.5,Dunks,28,24,22,10
22023,1631096,22300185,"NOV 12, 2023",OKC @ PHX,W,33,5,10,0.5,3,6,0.5,5,5,1.0,0,6,6,4,0,2,0,3,18,27,1,Chet Holmgren,OKC,PHX,OKC,19.5,Pts+Asts,28,24,22,10
22023,1631096,22300185,"NOV 12, 2023",OKC @ PHX,W,33,5,10,0.5,3,6,0.5,5,5,1.0,0,6,6,4,0,2,0,3,18,27,1,Chet Holmgren,OKC,PHX,OKC,1.5,3-PT Made,28,24,22,10
22023,1631096,22300185,"NOV 12, 2023",OKC @ PHX,W,33,5,10,0.5,3,6,0.5,5,5,1.0,0,6,6,4,0,2,0,3,18,27,1,Chet Holmgren,OKC,PHX,OKC,0.5,Steals,28,24,22,10
22023,1631096,22300185,"NOV 12, 2023",OKC @ PHX,W,33,5,10,0.5,3,6,0.5,5,5,1.0,0,6,6,4,0,2,0,3,18,27,1,Chet Holmgren,OKC,PHX,OKC,10.0,Rebs+Asts,28,24,22,10
22023,1631096,22300016,"NOV 10, 2023",OKC @ SAC,L,30,5,12,0.417,0,3,0.0,2,3,0.667,1,6,7,1,1,1,4,2,12,-13,1,Chet Holmgren,OKC,SAC,OKC,17.5,Points,20,19,13,8
22023,1631096,22300016,"NOV 10, 2023",OKC @ SAC,L,30,5,12,0.417,0,3,0.0,2,3,0.667,1,6,7,1,1,1,4,2,12,-13,1,Chet Holmgren,OKC,SAC,OKC,7.5,Rebounds,20,19,13,8
22023,1631096,22300016,"NOV 10, 2023",OKC @ SAC,L,30,5,12,0.417,0,3,0.0,2,3,0.667,1,6,7,1,1,1,4,2,12,-13,1,Chet Holmgren,OKC,SAC,OKC,27.5,Pts+Rebs+Asts,20,19,13,8
22023,1631096,22300016,"NOV 10, 2023",OKC @ SAC,L,30,5,12,0.417,0,3,0.0,2,3,0.667,1,6,7,1,1,1,4,2,12,-13,1,Chet Holmgren,OKC,SAC,OKC,37.0,Fantasy Score,20,19,13,8
22023,1631096,22300016,"NOV 10, 2023",OKC @ SAC,L,30,5,12,0.417,0,3,0.0,2,3,0.667,1,6,7,1,1,1,4,2,12,-13,1,Chet Holmgren,OKC,SAC,OKC,6.0,Defensive Rebounds,20,19,13,8
22023,1631096,22300016,"NOV 10, 2023",OKC @ SAC,L,30,5,12,0.417,0,3,0.0,2,3,0.667,1,6,7,1,1,1,4,2,12,-13,1,Chet Holmgren,OKC,SAC,OKC,2.5,Free Throws Made,20,19,13,8
22023,1631096,22300016,"NOV 10, 2023",OKC @ SAC,L,30,5,12,0.417,0,3,0.0,2,3,0.667,1,6,7,1,1,1,4,2,12,-13,1,Chet Holmgren,OKC,SAC,OKC,13.0,FG Attempted,20,19,13,8
22023,1631096,22300016,"NOV 10, 2023",OKC @ SAC,L,30,5,12,0.417,0,3,0.0,2,3,0.667,1,6,7,1,1,1,4,2,12,-13,1,Chet Holmgren,OKC,SAC,OKC,24.5,Pts+Rebs,20,19,13,8
22023,1631096,22300016,"NOV 10, 2023",OKC @ SAC,L,30,5,12,0.417,0,3,0.0,2,3,0.667,1,6,7,1,1,1,4,2,12,-13,1,Chet Holmgren,OKC,SAC,OKC,1.5,Dunks,20,19,13,8
22023,1631096,22300016,"NOV 10, 2023",OKC @ SAC,L,30,5,12,0.417,0,3,0.0,2,3,0.667,1,6,7,1,1,1,4,2,12,-13,1,Chet Holmgren,OKC,SAC,OKC,19.5,Pts+Asts,20,19,13,8
22023,1631096,22300016,"NOV 10, 2023",OKC @ SAC,L,30,5,12,0.417,0,3,0.0,2,3,0.667,1,6,7,1,1,1,4,2,12,-13,1,Chet Holmgren,OKC,SAC,OKC,1.5,3-PT Made,20,19,13,8
22023,1631096,22300016,"NOV 10, 2023",OKC @ SAC,L,30,5,12,0.417,0,3,0.0,2,3,0.667,1,6,7,1,1,1,4,2,12,-13,1,Chet Holmgren,OKC,SAC,OKC,0.5,Steals,20,19,13,8
22023,1631096,22300016,"NOV 10, 2023",OKC @ SAC,L,30,5,12,0.417,0,3,0.0,2,3,0.667,1,6,7,1,1,1,4,2,12,-13,1,Chet Holmgren,OKC,SAC,OKC,10.0,Rebs+Asts,20,19,13,8
22023,1631096,22300167,"NOV 08, 2023",OKC vs. CLE,W,29,7,10,0.7,1,1,1.0,0,0,0.0,3,4,7,2,1,3,2,4,15,3,1,Chet Holmgren,OKC,OKC,CLE,17.5,Points,24,22,17,9
22023,1631096,22300167,"NOV 08, 2023",OKC vs. CLE,W,29,7,10,0.7,1,1,1.0,0,0,0.0,3,4,7,2,1,3,2,4,15,3,1,Chet Holmgren,OKC,OKC,CLE,7.5,Rebounds,24,22,17,9
22023,1631096,22300167,"NOV 08, 2023",OKC vs. CLE,W,29,7,10,0.7,1,1,1.0,0,0,0.0,3,4,7,2,1,3,2,4,15,3,1,Chet Holmgren,OKC,OKC,CLE,27.5,Pts+Rebs+Asts,24,22,17,9
22023,1631096,22300167,"NOV 08, 2023",OKC vs. CLE,W,29,7,10,0.7,1,1,1.0,0,0,0.0,3,4,7,2,1,3,2,4,15,3,1,Chet Holmgren,OKC,OKC,CLE,37.0,Fantasy Score,24,22,17,9
22023,1631096,22300167,"NOV 08, 2023",OKC vs. CLE,W,29,7,10,0.7,1,1,1.0,0,0,0.0,3,4,7,2,1,3,2,4,15,3,1,Chet Holmgren,OKC,OKC,CLE,6.0,Defensive Rebounds,24,22,17,9
22023,1631096,22300167,"NOV 08, 2023",OKC vs. CLE,W,29,7,10,0.7,1,1,1.0,0,0,0.0,3,4,7,2,1,3,2,4,15,3,1,Chet Holmgren,OKC,OKC,CLE,2.5,Free Throws Made,24,22,17,9
22023,1631096,22300167,"NOV 08, 2023",OKC vs. CLE,W,29,7,10,0.7,1,1,1.0,0,0,0.0,3,4,7,2,1,3,2,4,15,3,1,Chet Holmgren,OKC,OKC,CLE,13.0,FG Attempted,24,22,17,9
22023,1631096,22300167,"NOV 08, 2023",OKC vs. CLE,W,29,7,10,0.7,1,1,1.0,0,0,0.0,3,4,7,2,1,3,2,4,15,3,1,Chet Holmgren,OKC,OKC,CLE,24.5,Pts+Rebs,24,22,17,9
22023,1631096,22300167,"NOV 08, 2023",OKC vs. CLE,W,29,7,10,0.7,1,1,1.0,0,0,0.0,3,4,7,2,1,3,2,4,15,3,1,Chet Holmgren,OKC,OKC,CLE,1.5,Dunks,24,22,17,9
22023,1631096,22300167,"NOV 08, 2023",OKC vs. CLE,W,29,7,10,0.7,1,1,1.0,0,0,0.0,3,4,7,2,1,3,2,4,15,3,1,Chet Holmgren,OKC,OKC,CLE,19.5,Pts+Asts,24,22,17,9
22023,1631096,22300167,"NOV 08, 2023",OKC vs. CLE,W,29,7,10,0.7,1,1,1.0,0,0,0.0,3,4,7,2,1,3,2,4,15,3,1,Chet Holmgren,OKC,OKC,CLE,1.5,3-PT Made,24,22,17,9
22023,1631096,22300167,"NOV 08, 2023",OKC vs. CLE,W,29,7,10,0.7,1,1,1.0,0,0,0.0,3,4,7,2,1,3,2,4,15,3,1,Chet Holmgren,OKC,OKC,CLE,0.5,Steals,24,22,17,9
22023,1631096,22300167,"NOV 08, 2023",OKC vs. CLE,W,29,7,10,0.7,1,1,1.0,0,0,0.0,3,4,7,2,1,3,2,4,15,3,1,Chet Holmgren,OKC,OKC,CLE,10.0,Rebs+Asts,24,22,17,9
22023,1631096,22300155,"NOV 06, 2023",OKC vs. ATL,W,34,4,14,0.286,1,3,0.333,7,7,1.0,3,9,12,3,1,3,1,3,16,4,1,Chet Holmgren,OKC,OKC,ATL,17.5,Points,31,28,19,15
22023,1631096,22300155,"NOV 06, 2023",OKC vs. ATL,W,34,4,14,0.286,1,3,0.333,7,7,1.0,3,9,12,3,1,3,1,3,16,4,1,Chet Holmgren,OKC,OKC,ATL,7.5,Rebounds,31,28,19,15
22023,1631096,22300155,"NOV 06, 2023",OKC vs. ATL,W,34,4,14,0.286,1,3,0.333,7,7,1.0,3,9,12,3,1,3,1,3,16,4,1,Chet Holmgren,OKC,OKC,ATL,27.5,Pts+Rebs+Asts,31,28,19,15
22023,1631096,22300155,"NOV 06, 2023",OKC vs. ATL,W,34,4,14,0.286,1,3,0.333,7,7,1.0,3,9,12,3,1,3,1,3,16,4,1,Chet Holmgren,OKC,OKC,ATL,37.0,Fantasy Score,31,28,19,15
22023,1631096,22300155,"NOV 06, 2023",OKC vs. ATL,W,34,4,14,0.286,1,3,0.333,7,7,1.0,3,9,12,3,1,3,1,3,16,4,1,Chet Holmgren,OKC,OKC,ATL,6.0,Defensive Rebounds,31,28,19,15
22023,1631096,22300155,"NOV 06, 2023",OKC vs. ATL,W,34,4,14,0.286,1,3,0.333,7,7,1.0,3,9,12,3,1,3,1,3,16,4,1,Chet Holmgren,OKC,OKC,ATL,2.5,Free Throws Made,31,28,19,15
22023,1631096,22300155,"NOV 06, 2023",OKC vs. ATL,W,34,4,14,0.286,1,3,0.333,7,7,1.0,3,9,12,3,1,3,1,3,16,4,1,Chet Holmgren,OKC,OKC,ATL,13.0,FG Attempted,31,28,19,15
22023,1631096,22300155,"NOV 06, 2023",OKC vs. ATL,W,34,4,14,0.286,1,3,0.333,7,7,1.0,3,9,12,3,1,3,1,3,16,4,1,Chet Holmgren,OKC,OKC,ATL,24.5,Pts+Rebs,31,28,19,15
22023,1631096,22300155,"NOV 06, 2023",OKC vs. ATL,W,34,4,14,0.286,1,3,0.333,7,7,1.0,3,9,12,3,1,3,1,3,16,4,1,Chet Holmgren,OKC,OKC,ATL,1.5,Dunks,31,28,19,15
22023,1631096,22300155,"NOV 06, 2023",OKC vs. ATL,W,34,4,14,0.286,1,3,0.333,7,7,1.0,3,9,12,3,1,3,1,3,16,4,1,Chet Holmgren,OKC,OKC,ATL,19.5,Pts+Asts,31,28,19,15
22023,1631096,22300155,"NOV 06, 2023",OKC vs. ATL,W,34,4,14,0.286,1,3,0.333,7,7,1.0,3,9,12,3,1,3,1,3,16,4,1,Chet Holmgren,OKC,OKC,ATL,1.5,3-PT Made,31,28,19,15
22023,1631096,22300155,"NOV 06, 2023",OKC vs. ATL,W,34,4,14,0.286,1,3,0.333,7,7,1.0,3,9,12,3,1,3,1,3,16,4,1,Chet Holmgren,OKC,OKC,ATL,0.5,Steals,31,28,19,15
22023,1631096,22300155,"NOV 06, 2023",OKC vs. ATL,W,34,4,14,0.286,1,3,0.333,7,7,1.0,3,9,12,3,1,3,1,3,16,4,1,Chet Holmgren,OKC,OKC,ATL,10.0,Rebs+Asts,31,28,19,15
22023,1631096,22300005,"NOV 03, 2023",OKC vs. GSW,L,32,7,9,0.778,2,2,1.0,8,8,1.0,3,5,8,5,1,1,2,4,24,-1,1,Chet Holmgren,OKC,OKC,GSW,17.5,Points,37,32,29,13
22023,1631096,22300005,"NOV 03, 2023",OKC vs. GSW,L,32,7,9,0.778,2,2,1.0,8,8,1.0,3,5,8,5,1,1,2,4,24,-1,1,Chet Holmgren,OKC,OKC,GSW,7.5,Rebounds,37,32,29,13
22023,1631096,22300005,"NOV 03, 2023",OKC vs. GSW,L,32,7,9,0.778,2,2,1.0,8,8,1.0,3,5,8,5,1,1,2,4,24,-1,1,Chet Holmgren,OKC,OKC,GSW,27.5,Pts+Rebs+Asts,37,32,29,13
22023,1631096,22300005,"NOV 03, 2023",OKC vs. GSW,L,32,7,9,0.778,2,2,1.0,8,8,1.0,3,5,8,5,1,1,2,4,24,-1,1,Chet Holmgren,OKC,OKC,GSW,37.0,Fantasy Score,37,32,29,13
22023,1631096,22300005,"NOV 03, 2023",OKC vs. GSW,L,32,7,9,0.778,2,2,1.0,8,8,1.0,3,5,8,5,1,1,2,4,24,-1,1,Chet Holmgren,OKC,OKC,GSW,6.0,Defensive Rebounds,37,32,29,13
22023,1631096,22300005,"NOV 03, 2023",OKC vs. GSW,L,32,7,9,0.778,2,2,1.0,8,8,1.0,3,5,8,5,1,1,2,4,24,-1,1,Chet Holmgren,OKC,OKC,GSW,2.5,Free Throws Made,37,32,29,13
22023,1631096,22300005,"NOV 03, 2023",OKC vs. GSW,L,32,7,9,0.778,2,2,1.0,8,8,1.0,3,5,8,5,1,1,2,4,24,-1,1,Chet Holmgren,OKC,OKC,GSW,13.0,FG Attempted,37,32,29,13
22023,1631096,22300005,"NOV 03, 2023",OKC vs. GSW,L,32,7,9,0.778,2,2,1.0,8,8,1.0,3,5,8,5,1,1,2,4,24,-1,1,Chet Holmgren,OKC,OKC,GSW,24.5,Pts+Rebs,37,32,29,13
22023,1631096,22300005,"NOV 03, 2023",OKC vs. GSW,L,32,7,9,0.778,2,2,1.0,8,8,1.0,3,5,8,5,1,1,2,4,24,-1,1,Chet Holmgren,OKC,OKC,GSW,1.5,Dunks,37,32,29,13
22023,1631096,22300005,"NOV 03, 2023",OKC vs. GSW,L,32,7,9,0.778,2,2,1.0,8,8,1.0,3,5,8,5,1,1,2,4,24,-1,1,Chet Holmgren,OKC,OKC,GSW,19.5,Pts+Asts,37,32,29,13
22023,1631096,22300005,"NOV 03, 2023",OKC vs. GSW,L,32,7,9,0.778,2,2,1.0,8,8,1.0,3,5,8,5,1,1,2,4,24,-1,1,Chet Holmgren,OKC,OKC,GSW,1.5,3-PT Made,37,32,29,13
22023,1631096,22300005,"NOV 03, 2023",OKC vs. GSW,L,32,7,9,0.778,2,2,1.0,8,8,1.0,3,5,8,5,1,1,2,4,24,-1,1,Chet Holmgren,OKC,OKC,GSW,0.5,Steals,37,32,29,13
22023,1631096,22300005,"NOV 03, 2023",OKC vs. GSW,L,32,7,9,0.778,2,2,1.0,8,8,1.0,3,5,8,5,1,1,2,4,24,-1,1,Chet Holmgren,OKC,OKC,GSW,10.0,Rebs+Asts,37,32,29,13
22023,1631096,22300121,"NOV 01, 2023",OKC vs. NOP,L,37,8,14,0.571,1,5,0.2,2,2,1.0,3,8,11,3,1,2,5,4,19,-3,1,Chet Holmgren,OKC,OKC,NOP,17.5,Points,33,30,22,14
22023,1631096,22300121,"NOV 01, 2023",OKC vs. NOP,L,37,8,14,0.571,1,5,0.2,2,2,1.0,3,8,11,3,1,2,5,4,19,-3,1,Chet Holmgren,OKC,OKC,NOP,7.5,Rebounds,33,30,22,14
22023,1631096,22300121,"NOV 01, 2023",OKC vs. NOP,L,37,8,14,0.571,1,5,0.2,2,2,1.0,3,8,11,3,1,2,5,4,19,-3,1,Chet Holmgren,OKC,OKC,NOP,27.5,Pts+Rebs+Asts,33,30,22,14
22023,1631096,22300121,"NOV 01, 2023",OKC vs. NOP,L,37,8,14,0.571,1,5,0.2,2,2,1.0,3,8,11,3,1,2,5,4,19,-3,1,Chet Holmgren,OKC,OKC,NOP,37.0,Fantasy Score,33,30,22,14
22023,1631096,22300121,"NOV 01, 2023",OKC vs. NOP,L,37,8,14,0.571,1,5,0.2,2,2,1.0,3,8,11,3,1,2,5,4,19,-3,1,Chet Holmgren,OKC,OKC,NOP,6.0,Defensive Rebounds,33,30,22,14
22023,1631096,22300121,"NOV 01, 2023",OKC vs. NOP,L,37,8,14,0.571,1,5,0.2,2,2,1.0,3,8,11,3,1,2,5,4,19,-3,1,Chet Holmgren,OKC,OKC,NOP,2.5,Free Throws Made,33,30,22,14
22023,1631096,22300121,"NOV 01, 2023",OKC vs. NOP,L,37,8,14,0.571,1,5,0.2,2,2,1.0,3,8,11,3,1,2,5,4,19,-3,1,Chet Holmgren,OKC,OKC,NOP,13.0,FG Attempted,33,30,22,14
22023,1631096,22300121,"NOV 01, 2023",OKC vs. NOP,L,37,8,14,0.571,1,5,0.2,2,2,1.0,3,8,11,3,1,2,5,4,19,-3,1,Chet Holmgren,OKC,OKC,NOP,24.5,Pts+Rebs,33,30,22,14
22023,1631096,22300121,"NOV 01, 2023",OKC vs. NOP,L,37,8,14,0.571,1,5,0.2,2,2,1.0,3,8,11,3,1,2,5,4,19,-3,1,Chet Holmgren,OKC,OKC,NOP,1.5,Dunks,33,30,22,14
22023,1631096,22300121,"NOV 01, 2023",OKC vs. NOP,L,37,8,14,0.571,1,5,0.2,2,2,1.0,3,8,11,3,1,2,5,4,19,-3,1,Chet Holmgren,OKC,OKC,NOP,19.5,Pts+Asts,33,30,22,14
22023,1631096,22300121,"NOV 01, 2023",OKC vs. NOP,L,37,8,14,0.571,1,5,0.2,2,2,1.0,3,8,11,3,1,2,5,4,19,-3,1,Chet Holmgren,OKC,OKC,NOP,1.5,3-PT Made,33,30,22,14
22023,1631096,22300121,"NOV 01, 2023",OKC vs. NOP,L,37,8,14,0.571,1,5,0.2,2,2,1.0,3,8,11,3,1,2,5,4,19,-3,1,Chet Holmgren,OKC,OKC,NOP,0.5,Steals,33,30,22,14
22023,1631096,22300121,"NOV 01, 2023",OKC vs. NOP,L,37,8,14,0.571,1,5,0.2,2,2,1.0,3,8,11,3,1,2,5,4,19,-3,1,Chet Holmgren,OKC,OKC,NOP,10.0,Rebs+Asts,33,30,22,14
22023,1631096,22300109,"OCT 30, 2023",OKC vs. DET,W,24,4,5,0.8,4,5,0.8,2,2,1.0,0,4,4,3,2,4,3,5,14,9,1,Chet Holmgren,OKC,OKC,DET,17.5,Points,21,18,17,7
22023,1631096,22300109,"OCT 30, 2023",OKC vs. DET,W,24,4,5,0.8,4,5,0.8,2,2,1.0,0,4,4,3,2,4,3,5,14,9,1,Chet Holmgren,OKC,OKC,DET,7.5,Rebounds,21,18,17,7
22023,1631096,22300109,"OCT 30, 2023",OKC vs. DET,W,24,4,5,0.8,4,5,0.8,2,2,1.0,0,4,4,3,2,4,3,5,14,9,1,Chet Holmgren,OKC,OKC,DET,27.5,Pts+Rebs+Asts,21,18,17,7
22023,1631096,22300109,"OCT 30, 2023",OKC vs. DET,W,24,4,5,0.8,4,5,0.8,2,2,1.0,0,4,4,3,2,4,3,5,14,9,1,Chet Holmgren,OKC,OKC,DET,37.0,Fantasy Score,21,18,17,7
22023,1631096,22300109,"OCT 30, 2023",OKC vs. DET,W,24,4,5,0.8,4,5,0.8,2,2,1.0,0,4,4,3,2,4,3,5,14,9,1,Chet Holmgren,OKC,OKC,DET,6.0,Defensive Rebounds,21,18,17,7
22023,1631096,22300109,"OCT 30, 2023",OKC vs. DET,W,24,4,5,0.8,4,5,0.8,2,2,1.0,0,4,4,3,2,4,3,5,14,9,1,Chet Holmgren,OKC,OKC,DET,2.5,Free Throws Made,21,18,17,7
22023,1631096,22300109,"OCT 30, 2023",OKC vs. DET,W,24,4,5,0.8,4,5,0.8,2,2,1.0,0,4,4,3,2,4,3,5,14,9,1,Chet Holmgren,OKC,OKC,DET,13.0,FG Attempted,21,18,17,7
22023,1631096,22300109,"OCT 30, 2023",OKC vs. DET,W,24,4,5,0.8,4,5,0.8,2,2,1.0,0,4,4,3,2,4,3,5,14,9,1,Chet Holmgren,OKC,OKC,DET,24.5,Pts+Rebs,21,18,17,7
22023,1631096,22300109,"OCT 30, 2023",OKC vs. DET,W,24,4,5,0.8,4,5,0.8,2,2,1.0,0,4,4,3,2,4,3,5,14,9,1,Chet Holmgren,OKC,OKC,DET,1.5,Dunks,21,18,17,7
22023,1631096,22300109,"OCT 30, 2023",OKC vs. DET,W,24,4,5,0.8,4,5,0.8,2,2,1.0,0,4,4,3,2,4,3,5,14,9,1,Chet Holmgren,OKC,OKC,DET,19.5,Pts+Asts,21,18,17,7
22023,1631096,22300109,"OCT 30, 2023",OKC vs. DET,W,24,4,5,0.8,4,5,0.8,2,2,1.0,0,4,4,3,2,4,3,5,14,9,1,Chet Holmgren,OKC,OKC,DET,1.5,3-PT Made,21,18,17,7
22023,1631096,22300109,"OCT 30, 2023",OKC vs. DET,W,24,4,5,0.8,4,5,0.8,2,2,1.0,0,4,4,3,2,4,3,5,14,9,1,Chet Holmgren,OKC,OKC,DET,0.5,Steals,21,18,17,7
22023,1631096,22300109,"OCT 30, 2023",OKC vs. DET,W,24,4,5,0.8,4,5,0.8,2,2,1.0,0,4,4,3,2,4,3,5,14,9,1,Chet Holmgren,OKC,OKC,DET,10.0,Rebs+Asts,21,18,17,7
22023,1631096,22300095,"OCT 29, 2023",OKC vs. DEN,L,26,7,12,0.583,1,4,0.25,4,4,1.0,2,2,4,0,0,0,1,2,19,-23,1,Chet Holmgren,OKC,OKC,DEN,17.5,Points,23,23,19,4
22023,1631096,22300095,"OCT 29, 2023",OKC vs. DEN,L,26,7,12,0.583,1,4,0.25,4,4,1.0,2,2,4,0,0,0,1,2,19,-23,1,Chet Holmgren,OKC,OKC,DEN,7.5,Rebounds,23,23,19,4
22023,1631096,22300095,"OCT 29, 2023",OKC vs. DEN,L,26,7,12,0.583,1,4,0.25,4,4,1.0,2,2,4,0,0,0,1,2,19,-23,1,Chet Holmgren,OKC,OKC,DEN,27.5,Pts+Rebs+Asts,23,23,19,4
22023,1631096,22300095,"OCT 29, 2023",OKC vs. DEN,L,26,7,12,0.583,1,4,0.25,4,4,1.0,2,2,4,0,0,0,1,2,19,-23,1,Chet Holmgren,OKC,OKC,DEN,37.0,Fantasy Score,23,23,19,4
22023,1631096,22300095,"OCT 29, 2023",OKC vs. DEN,L,26,7,12,0.583,1,4,0.25,4,4,1.0,2,2,4,0,0,0,1,2,19,-23,1,Chet Holmgren,OKC,OKC,DEN,6.0,Defensive Rebounds,23,23,19,4
22023,1631096,22300095,"OCT 29, 2023",OKC vs. DEN,L,26,7,12,0.583,1,4,0.25,4,4,1.0,2,2,4,0,0,0,1,2,19,-23,1,Chet Holmgren,OKC,OKC,DEN,2.5,Free Throws Made,23,23,19,4
22023,1631096,22300095,"OCT 29, 2023",OKC vs. DEN,L,26,7,12,0.583,1,4,0.25,4,4,1.0,2,2,4,0,0,0,1,2,19,-23,1,Chet Holmgren,OKC,OKC,DEN,13.0,FG Attempted,23,23,19,4
22023,1631096,22300095,"OCT 29, 2023",OKC vs. DEN,L,26,7,12,0.583,1,4,0.25,4,4,1.0,2,2,4,0,0,0,1,2,19,-23,1,Chet Holmgren,OKC,OKC,DEN,24.5,Pts+Rebs,23,23,19,4
22023,1631096,22300095,"OCT 29, 2023",OKC vs. DEN,L,26,7,12,0.583,1,4,0.25,4,4,1.0,2,2,4,0,0,0,1,2,19,-23,1,Chet Holmgren,OKC,OKC,DEN,1.5,Dunks,23,23,19,4
22023,1631096,22300095,"OCT 29, 2023",OKC vs. DEN,L,26,7,12,0.583,1,4,0.25,4,4,1.0,2,2,4,0,0,0,1,2,19,-23,1,Chet Holmgren,OKC,OKC,DEN,19.5,Pts+Asts,23,23,19,4
22023,1631096,22300095,"OCT 29, 2023",OKC vs. DEN,L,26,7,12,0.583,1,4,0.25,4,4,1.0,2,2,4,0,0,0,1,2,19,-23,1,Chet Holmgren,OKC,OKC,DEN,1.5,3-PT Made,23,23,19,4
22023,1631096,22300095,"OCT 29, 2023",OKC vs. DEN,L,26,7,12,0.583,1,4,0.25,4,4,1.0,2,2,4,0,0,0,1,2,19,-23,1,Chet Holmgren,OKC,OKC,DEN,0.5,Steals,23,23,19,4
22023,1631096,22300095,"OCT 29, 2023",OKC vs. DEN,L,26,7,12,0.583,1,4,0.25,4,4,1.0,2,2,4,0,0,0,1,2,19,-23,1,Chet Holmgren,OKC,OKC,DEN,10.0,Rebs+Asts,23,23,19,4
22023,1631096,22300081,"OCT 27, 2023",OKC @ CLE,W,31,5,9,0.556,3,4,0.75,3,4,0.75,1,12,13,2,1,7,1,3,16,6,1,Chet Holmgren,OKC,CLE,OKC,17.5,Points,31,29,18,15
22023,1631096,22300081,"OCT 27, 2023",OKC @ CLE,W,31,5,9,0.556,3,4,0.75,3,4,0.75,1,12,13,2,1,7,1,3,16,6,1,Chet Holmgren,OKC,CLE,OKC,7.5,Rebounds,31,29,18,15
22023,1631096,22300081,"OCT 27, 2023",OKC @ CLE,W,31,5,9,0.556,3,4,0.75,3,4,0.75,1,12,13,2,1,7,1,3,16,6,1,Chet Holmgren,OKC,CLE,OKC,27.5,Pts+Rebs+Asts,31,29,18,15
22023,1631096,22300081,"OCT 27, 2023",OKC @ CLE,W,31,5,9,0.556,3,4,0.75,3,4,0.75,1,12,13,2,1,7,1,3,16,6,1,Chet Holmgren,OKC,CLE,OKC,37.0,Fantasy Score,31,29,18,15
22023,1631096,22300081,"OCT 27, 2023",OKC @ CLE,W,31,5,9,0.556,3,4,0.75,3,4,0.75,1,12,13,2,1,7,1,3,16,6,1,Chet Holmgren,OKC,CLE,OKC,6.0,Defensive Rebounds,31,29,18,15
22023,1631096,22300081,"OCT 27, 2023",OKC @ CLE,W,31,5,9,0.556,3,4,0.75,3,4,0.75,1,12,13,2,1,7,1,3,16,6,1,Chet Holmgren,OKC,CLE,OKC,2.5,Free Throws Made,31,29,18,15
22023,1631096,22300081,"OCT 27, 2023",OKC @ CLE,W,31,5,9,0.556,3,4,0.75,3,4,0.75,1,12,13,2,1,7,1,3,16,6,1,Chet Holmgren,OKC,CLE,OKC,13.0,FG Attempted,31,29,18,15
22023,1631096,22300081,"OCT 27, 2023",OKC @ CLE,W,31,5,9,0.556,3,4,0.75,3,4,0.75,1,12,13,2,1,7,1,3,16,6,1,Chet Holmgren,OKC,CLE,OKC,24.5,Pts+Rebs,31,29,18,15
22023,1631096,22300081,"OCT 27, 2023",OKC @ CLE,W,31,5,9,0.556,3,4,0.75,3,4,0.75,1,12,13,2,1,7,1,3,16,6,1,Chet Holmgren,OKC,CLE,OKC,1.5,Dunks,31,29,18,15
22023,1631096,22300081,"OCT 27, 2023",OKC @ CLE,W,31,5,9,0.556,3,4,0.75,3,4,0.75,1,12,13,2,1,7,1,3,16,6,1,Chet Holmgren,OKC,CLE,OKC,19.5,Pts+Asts,31,29,18,15
22023,1631096,22300081,"OCT 27, 2023",OKC @ CLE,W,31,5,9,0.556,3,4,0.75,3,4,0.75,1,12,13,2,1,7,1,3,16,6,1,Chet Holmgren,OKC,CLE,OKC,1.5,3-PT Made,31,29,18,15
22023,1631096,22300081,"OCT 27, 2023",OKC @ CLE,W,31,5,9,0.556,3,4,0.75,3,4,0.75,1,12,13,2,1,7,1,3,16,6,1,Chet Holmgren,OKC,CLE,OKC,0.5,Steals,31,29,18,15
22023,1631096,22300081,"OCT 27, 2023",OKC @ CLE,W,31,5,9,0.556,3,4,0.75,3,4,0.75,1,12,13,2,1,7,1,3,16,6,1,Chet Holmgren,OKC,CLE,OKC,10.0,Rebs+Asts,31,29,18,15
22023,1631096,22300070,"OCT 25, 2023",OKC @ CHI,W,25,4,7,0.571,2,3,0.667,1,3,0.333,0,4,4,3,1,0,1,3,11,14,1,Chet Holmgren,OKC,CHI,OKC,17.5,Points,18,15,14,7
22023,1631096,22300070,"OCT 25, 2023",OKC @ CHI,W,25,4,7,0.571,2,3,0.667,1,3,0.333,0,4,4,3,1,0,1,3,11,14,1,Chet Holmgren,OKC,CHI,OKC,7.5,Rebounds,18,15,14,7
22023,1631096,22300070,"OCT 25, 2023",OKC @ CHI,W,25,4,7,0.571,2,3,0.667,1,3,0.333,0,4,4,3,1,0,1,3,11,14,1,Chet Holmgren,OKC,CHI,OKC,27.5,Pts+Rebs+Asts,18,15,14,7
22023,1631096,22300070,"OCT 25, 2023",OKC @ CHI,W,25,4,7,0.571,2,3,0.667,1,3,0.333,0,4,4,3,1,0,1,3,11,14,1,Chet Holmgren,OKC,CHI,OKC,37.0,Fantasy Score,18,15,14,7
22023,1631096,22300070,"OCT 25, 2023",OKC @ CHI,W,25,4,7,0.571,2,3,0.667,1,3,0.333,0,4,4,3,1,0,1,3,11,14,1,Chet Holmgren,OKC,CHI,OKC,6.0,Defensive Rebounds,18,15,14,7
22023,1631096,22300070,"OCT 25, 2023",OKC @ CHI,W,25,4,7,0.571,2,3,0.667,1,3,0.333,0,4,4,3,1,0,1,3,11,14,1,Chet Holmgren,OKC,CHI,OKC,2.5,Free Throws Made,18,15,14,7
22023,1631096,22300070,"OCT 25, 2023",OKC @ CHI,W,25,4,7,0.571,2,3,0.667,1,3,0.333,0,4,4,3,1,0,1,3,11,14,1,Chet Holmgren,OKC,CHI,OKC,13.0,FG Attempted,18,15,14,7
22023,1631096,22300070,"OCT 25, 2023",OKC @ CHI,W,25,4,7,0.571,2,3,0.667,1,3,0.333,0,4,4,3,1,0,1,3,11,14,1,Chet Holmgren,OKC,CHI,OKC,24.5,Pts+Rebs,18,15,14,7
22023,1631096,22300070,"OCT 25, 2023",OKC @ CHI,W,25,4,7,0.571,2,3,0.667,1,3,0.333,0,4,4,3,1,0,1,3,11,14,1,Chet Holmgren,OKC,CHI,OKC,1.5,Dunks,18,15,14,7
22023,1631096,22300070,"OCT 25, 2023",OKC @ CHI,W,25,4,7,0.571,2,3,0.667,1,3,0.333,0,4,4,3,1,0,1,3,11,14,1,Chet Holmgren,OKC,CHI,OKC,19.5,Pts+Asts,18,15,14,7
22023,1631096,22300070,"OCT 25, 2023",OKC @ CHI,W,25,4,7,0.571,2,3,0.667,1,3,0.333,0,4,4,3,1,0,1,3,11,14,1,Chet Holmgren,OKC,CHI,OKC,1.5,3-PT Made,18,15,14,7
22023,1631096,22300070,"OCT 25, 2023",OKC @ CHI,W,25,4,7,0.571,2,3,0.667,1,3,0.333,0,4,4,3,1,0,1,3,11,14,1,Chet Holmgren,OKC,CHI,OKC,0.5,Steals,18,15,14,7
22023,1631096,22300070,"OCT 25, 2023",OKC @ CHI,W,25,4,7,0.571,2,3,0.667,1,3,0.333,0,4,4,3,1,0,1,3,11,14,1,Chet Holmgren,OKC,CHI,OKC,10.0,Rebs+Asts,18,15,14,7
22023,1641720,22300531,"JAN 11, 2024",LAL vs. PHX,L,5,1,3,0.333,0,0,0.0,0,0,0.0,0,0,0,0,0,0,0,0,2,4,1,Jalen Hood-Schifino,LAL,LAL,PHX,,,2,2,2,0
22023,1641720,22300475,"JAN 03, 2024",LAL vs. MIA,L,6,0,4,0.0,0,0,0.0,0,0,0.0,1,1,2,0,0,0,0,1,0,-1,1,Jalen Hood-Schifino,LAL,LAL,MIA,,,2,2,0,2
22023,1641720,22300446,"DEC 31, 2023",LAL @ NOP,L,5,1,1,1.0,0,0,0.0,0,0,0.0,0,0,0,0,1,0,0,0,2,2,1,Jalen Hood-Schifino,LAL,NOP,LAL,,,2,2,2,0
22023,1641720,22300428,"DEC 28, 2023",LAL vs. CHA,W,7,1,5,0.2,0,1,0.0,0,0,0.0,0,0,0,1,1,0,1,1,2,-2,1,Jalen Hood-Schifino,LAL,LAL,CHA,,,3,2,3,1
22023,1641720,22301230,"DEC 07, 2023",LAL vs. NOP,W,8,0,3,0.0,0,0,0.0,1,2,0.5,1,3,4,1,0,1,1,1,1,6,1,Jalen Hood-Schifino,LAL,LAL,NOP,,,6,5,2,5
22023,1641720,22300291,"DEC 02, 2023",LAL vs. HOU,W,3,0,2,0.0,0,1,0.0,0,0,0.0,0,0,0,0,0,0,0,0,0,-8,1,Jalen Hood-Schifino,LAL,LAL,HOU,,,0,0,0,0
22023,1641720,22300271,"NOV 30, 2023",LAL @ OKC,L,19,1,6,0.167,0,3,0.0,1,2,0.5,0,1,1,0,0,0,1,3,3,-15,1,Jalen Hood-Schifino,LAL,OKC,LAL,,,4,4,3,1
22023,1641720,22300258,"NOV 29, 2023",LAL @ DET,W,11,3,4,0.75,1,2,0.5,3,6,0.5,0,1,1,1,0,0,1,2,10,-6,1,Jalen Hood-Schifino,LAL,DET,LAL,,,12,11,11,2
22023,1641720,22300255,"NOV 27, 2023",LAL @ PHI,L,11,0,3,0.0,0,2,0.0,0,0,0.0,0,0,0,2,0,0,1,1,0,-17,1,Jalen Hood-Schifino,LAL,PHI,LAL,,,2,0,2,2
22023,201143,22300563,"JAN 15, 2024",BOS @ TOR,W,35,4,10,0.4,2,4,0.5,0,0,0.0,2,9,11,2,1,0,1,3,10,1,1,Al Horford,BOS,TOR,BOS,,,23,21,12,13
22023,201143,22300542,"JAN 13, 2024",BOS vs. HOU,W,20,2,3,0.667,1,2,0.5,2,2,1.0,0,4,4,1,0,1,0,0,7,29,1,Al Horford,BOS,BOS,HOU,,,12,11,8,5
22023,201143,22300517,"JAN 10, 2024",BOS vs. MIN,W,38,3,8,0.375,3,6,0.5,0,0,0.0,1,7,8,5,0,0,1,3,9,2,1,Al Horford,BOS,BOS,MIN,,,22,17,14,13
22023,201143,22300507,"JAN 08, 2024",BOS @ IND,L,32,4,5,0.8,3,4,0.75,0,0,0.0,0,6,6,0,0,1,1,1,11,-9,1,Al Horford,BOS,IND,BOS,,,17,17,11,6
22023,201143,22300493,"JAN 06, 2024",BOS @ IND,W,30,4,8,0.5,2,5,0.4,0,2,0.0,1,6,7,8,1,2,2,1,10,10,1,Al Horford,BOS,IND,BOS,,,25,17,18,15
22023,201143,22300462,"JAN 02, 2024",BOS @ OKC,L,20,3,5,0.6,1,3,0.333,0,0,0.0,0,2,2,3,1,5,0,0,7,-13,1,Al Horford,BOS,OKC,BOS,,,12,9,10,5
22023,201143,22300448,"DEC 31, 2023",BOS @ SAS,W,20,3,5,0.6,1,3,0.333,0,0,0.0,1,6,7,4,0,0,0,0,7,17,1,Al Horford,BOS,SAS,BOS,,,18,14,11,11
22023,201143,22300421,"DEC 28, 2023",BOS vs. DET,W,37,3,4,0.75,2,3,0.667,0,0,0.0,2,3,5,3,1,1,1,1,8,10,1,Al Horford,BOS,BOS,DET,,,16,13,11,8
22023,201143,22300403,"DEC 25, 2023",BOS @ LAL,W,23,2,4,0.5,2,4,0.5,0,0,0.0,0,6,6,1,0,1,0,3,6,1,1,Al Horford,BOS,LAL,BOS,,,13,12,7,7
22023,201143,22300389,"DEC 23, 2023",BOS @ LAC,W,27,2,6,0.333,2,5,0.4,0,0,0.0,0,8,8,5,1,2,0,2,6,24,1,Al Horford,BOS,LAC,BOS,,,19,14,11,13
22023,201143,22300362,"DEC 19, 2023",BOS @ GSW,L,38,4,14,0.286,3,10,0.3,2,2,1.0,2,10,12,6,0,1,2,1,13,-8,1,Al Horford,BOS,GSW,BOS,,,31,25,19,18
22023,201143,22300344,"DEC 17, 2023",BOS vs. ORL,W,24,3,7,0.429,2,3,0.667,0,0,0.0,1,7,8,2,0,1,0,2,8,19,1,Al Horford,BOS,BOS,ORL,,,18,16,10,10
22023,201143,22300319,"DEC 14, 2023",BOS vs. CLE,W,24,3,4,0.75,1,2,0.5,0,0,0.0,3,7,10,3,0,1,0,1,7,9,1,Al Horford,BOS,BOS,CLE,,,20,17,10,13
22023,201143,22300305,"DEC 12, 2023",BOS vs. CLE,W,22,1,3,0.333,0,2,0.0,0,0,0.0,2,3,5,1,1,0,0,0,2,13,1,Al Horford,BOS,BOS,CLE,,,8,7,3,6
22023,201143,22301227,"DEC 08, 2023",BOS vs. NYK,W,27,5,8,0.625,3,6,0.5,1,1,1.0,2,8,10,2,0,0,2,1,14,9,1,Al Horford,BOS,BOS,NYK,,,26,24,16,12
22023,201143,22301202,"DEC 04, 2023",BOS @ IND,L,31,1,3,0.333,0,1,0.0,0,0,0.0,2,5,7,4,0,1,2,1,2,-2,1,Al Horford,BOS,IND,BOS,,,13,9,6,11
22023,201143,22300275,"DEC 01, 2023",BOS vs. PHI,W,33,7,9,0.778,2,4,0.5,4,4,1.0,2,4,6,3,1,2,1,4,20,10,1,Al Horford,BOS,BOS,PHI,,,29,26,23,9
22023,201143,22300053,"NOV 28, 2023",BOS vs. CHI,W,28,6,8,0.75,4,6,0.667,0,0,0.0,0,9,9,6,2,3,3,3,16,18,1,Al Horford,BOS,BOS,CHI,,,31,25,22,15
22023,201143,22300246,"NOV 26, 2023",BOS vs. ATL,W,32,3,8,0.375,0,5,0.0,0,0,0.0,3,12,15,3,1,2,0,1,6,17,1,Al Horford,BOS,BOS,ATL,,,24,21,9,18
22023,201143,22300043,"NOV 24, 2023",BOS @ ORL,L,33,1,5,0.2,1,5,0.2,0,0,0.0,0,5,5,3,0,0,1,4,3,-26,1,Al Horford,BOS,ORL,BOS,,,11,8,6,8
22023,201143,22300228,"NOV 22, 2023",BOS vs. MIL,W,31,4,7,0.571,2,3,0.667,1,1,1.0,1,7,8,6,0,1,0,1,11,5,1,Al Horford,BOS,BOS,MIL,,,25,19,17,14
22023,201143,22300213,"NOV 19, 2023",BOS @ MEM,W,22,2,5,0.4,1,3,0.333,0,0,0.0,2,1,3,2,0,0,0,2,5,2,1,Al Horford,BOS,MEM,BOS,,,10,8,7,5
22023,201143,22300031,"NOV 17, 2023",BOS @ TOR,W,23,4,5,0.8,3,4,0.75,0,0,0.0,1,3,4,2,0,0,0,1,11,-3,1,Al Horford,BOS,TOR,BOS,,,17,15,13,6
22023,201143,22300194,"NOV 15, 2023",BOS @ PHI,W,29,5,9,0.556,4,8,0.5,0,0,0.0,1,7,8,3,0,5,0,2,14,14,1,Al Horford,BOS,PHI,BOS,,,25,22,17,11
22023,201143,22300188,"NOV 13, 2023",BOS vs. NYK,W,22,1,2,0.5,0,1,0.0,0,0,0.0,0,4,4,0,0,0,1,2,2,2,1,Al Horford,BOS,BOS,NYK,,,6,6,2,4
22023,201143,22300174,"NOV 11, 2023",BOS vs. TOR,W,24,3,5,0.6,1,3,0.333,0,0,0.0,1,6,7,4,0,0,0,2,7,11,1,Al Horford,BOS,BOS,TOR,,,18,14,11,11
22023,201143,22300159,"NOV 08, 2023",BOS @ PHI,L,26,1,6,0.167,1,6,0.167,0,0,0.0,0,5,5,3,0,2,1,1,3,-23,1,Al Horford,BOS,PHI,BOS,,,11,8,6,8
22023,201143,22300154,"NOV 06, 2023",BOS @ MIN,L,36,1,5,0.2,1,4,0.25,0,0,0.0,2,3,5,4,1,0,2,4,3,7,1,Al Horford,BOS,MIN,BOS,,,12,8,7,9
22023,201143,22300136,"NOV 04, 2023",BOS @ BKN,W,30,4,7,0.571,0,3,0.0,0,0,0.0,2,5,7,3,1,1,0,1,8,29,1,Al Horford,BOS,BKN,BOS,,,18,15,11,10
22023,201143,22300118,"NOV 01, 2023",BOS vs. IND,W,11,1,3,0.333,1,1,1.0,2,2,1.0,2,2,4,0,1,1,1,0,5,7,1,Al Horford,BOS,BOS,IND,,,9,9,5,4
22023,201143,22300103,"OCT 30, 2023",BOS @ WAS,W,16,4,9,0.444,0,3,0.0,0,0,0.0,4,1,5,1,2,0,0,1,8,4,1,Al Horford,BOS,WAS,BOS,,,14,13,9,6
22023,201143,22300080,"OCT 27, 2023",BOS vs. MIA,W,25,0,6,0.0,0,2,0.0,0,0,0.0,3,7,10,2,0,1,3,1,0,7,1,Al Horford,BOS,BOS,MIA,,,12,10,2,12
22023,201143,22300065,"OCT 25, 2023",BOS @ NYK,W,26,3,4,0.75,2,3,0.667,0,0,0.0,3,4,7,2,0,0,3,2,8,-7,1,Al Horford,BOS,NYK,BOS,,,17,15,10,9
22023,1629659,22300479,"JAN 05, 2024",UTA @ BOS,L,12,4,10,0.4,0,1,0.0,3,6,0.5,0,1,1,0,2,0,0,1,11,3,1,Talen Horton-Tucker,UTA,BOS,UTA,,,12,12,11,1
22023,1629659,22300424,"DEC 28, 2023",UTA @ NOP,L,6,0,3,0.0,0,1,0.0,2,2,1.0,0,0,0,0,0,0,0,0,2,0,1,Talen Horton-Tucker,UTA,NOP,UTA,,,2,2,2,0
22023,1629659,22300364,"DEC 20, 2023",UTA @ CLE,L,30,6,13,0.462,0,1,0.0,7,8,0.875,0,1,1,11,1,0,1,3,19,5,1,Talen Horton-Tucker,UTA,CLE,UTA,,,31,20,30,12
22023,1629659,22300357,"DEC 18, 2023",UTA vs. BKN,W,31,11,19,0.579,5,7,0.714,0,0,0.0,0,3,3,6,2,0,1,2,27,18,1,Talen Horton-Tucker,UTA,UTA,BKN,,,36,30,33,9
22023,1629659,22300342,"DEC 16, 2023",UTA @ SAC,L,26,4,11,0.364,2,4,0.5,2,3,0.667,1,2,3,5,3,0,1,0,12,-2,1,Talen Horton-Tucker,UTA,SAC,UTA,,,20,15,17,8
22023,1629659,22300323,"DEC 14, 2023",UTA @ POR,W,30,9,19,0.474,0,6,0.0,5,6,0.833,1,1,2,4,4,0,3,2,23,31,1,Talen Horton-Tucker,UTA,POR,UTA,,,29,25,27,6
22023,1629659,22300318,"DEC 13, 2023",UTA vs. NYK,W,24,7,14,0.5,1,3,0.333,0,2,0.0,0,4,4,3,0,0,2,2,15,-8,1,Talen Horton-Tucker,UTA,UTA,NYK,,,22,19,18,7
22023,1629659,22300302,"DEC 11, 2023",UTA @ OKC,L,15,3,7,0.429,1,3,0.333,4,4,1.0,0,1,1,2,0,1,2,5,11,-19,1,Talen Horton-Tucker,UTA,OKC,UTA,,,14,12,13,3
22023,1629659,22301225,"DEC 08, 2023",UTA vs. LAC,L,22,6,11,0.545,1,4,0.25,2,3,0.667,0,1,1,5,1,1,2,0,15,4,1,Talen Horton-Tucker,UTA,UTA,LAC,,,21,16,20,6
22023,1629659,22301213,"DEC 06, 2023",UTA @ DAL,L,16,4,9,0.444,3,3,1.0,0,0,0.0,0,2,2,1,0,0,1,1,11,-2,1,Talen Horton-Tucker,UTA,DAL,UTA,,,14,13,12,3
22023,1629659,22300289,"DEC 02, 2023",UTA vs. POR,W,21,5,8,0.625,3,5,0.6,1,2,0.5,0,2,2,4,3,0,1,3,14,5,1,Talen Horton-Tucker,UTA,UTA,POR,,,20,16,18,6
22023,1629659,22300270,"NOV 30, 2023",UTA @ MIN,L,19,3,7,0.429,1,3,0.333,0,0,0.0,0,1,1,1,0,0,0,1,7,1,1,Talen Horton-Tucker,UTA,MIN,UTA,,,9,8,8,2
22023,1629659,22300261,"NOV 29, 2023",UTA @ MEM,L,24,2,12,0.167,1,5,0.2,0,0,0.0,1,3,4,3,1,1,2,2,5,-7,1,Talen Horton-Tucker,UTA,MEM,UTA,,,12,9,8,7
22023,1629659,22300256,"NOV 27, 2023",UTA vs. NOP,W,19,2,9,0.222,0,3,0.0,1,1,1.0,0,3,3,7,0,0,0,2,5,0,1,Talen Horton-Tucker,UTA,UTA,NOP,,,15,8,12,10
22023,1629659,22300243,"NOV 25, 2023",UTA vs. NOP,W,22,2,5,0.4,1,3,0.333,0,0,0.0,0,3,3,4,0,0,2,1,5,9,1,Talen Horton-Tucker,UTA,UTA,NOP,,,12,8,9,7
22023,1629659,22300237,"NOV 22, 2023",UTA @ POR,L,14,1,4,0.25,0,2,0.0,3,4,0.75,0,0,0,1,0,0,3,4,5,-15,1,Talen Horton-Tucker,UTA,POR,UTA,,,6,5,6,1
22023,1629659,22300042,"NOV 21, 2023",UTA @ LAL,L,23,1,10,0.1,0,5,0.0,4,4,1.0,0,3,3,7,2,1,1,1,6,-16,1,Talen Horton-Tucker,UTA,LAL,UTA,,,16,9,13,10
22023,1629659,22300214,"NOV 19, 2023",UTA vs. PHX,L,29,9,18,0.5,4,10,0.4,3,3,1.0,2,2,4,3,2,0,1,4,25,1,1,Talen Horton-Tucker,UTA,UTA,PHX,,,32,29,28,7
22023,1629659,22300035,"NOV 17, 2023",UTA vs. PHX,L,19,2,5,0.4,1,4,0.25,4,4,1.0,0,3,3,4,0,1,3,4,9,-5,1,Talen Horton-Tucker,UTA,UTA,PHX,,,16,12,13,7
22023,1629659,22300023,"NOV 14, 2023",UTA vs. POR,W,21,2,5,0.4,0,1,0.0,0,0,0.0,1,2,3,3,1,0,2,3,4,8,1,Talen Horton-Tucker,UTA,UTA,POR,,,10,7,7,6
22023,1629659,22300012,"NOV 10, 2023",UTA @ MEM,W,18,4,7,0.571,3,5,0.6,2,2,1.0,1,2,3,2,1,1,1,2,13,5,1,Talen Horton-Tucker,UTA,MEM,UTA,,,18,16,15,5
22023,1629659,22300158,"NOV 08, 2023",UTA @ IND,L,20,3,8,0.375,0,1,0.0,0,0,0.0,2,2,4,5,0,1,4,1,6,2,1,Talen Horton-Tucker,UTA,IND,UTA,,,15,10,11,9
22023,1629659,22300152,"NOV 06, 2023",UTA @ CHI,L,23,2,5,0.4,1,3,0.333,0,0,0.0,0,6,6,4,0,0,5,0,5,-7,1,Talen Horton-Tucker,UTA,CHI,UTA,,,15,11,9,10
22023,1629659,22300138,"NOV 04, 2023",UTA @ MIN,L,24,6,20,0.3,2,6,0.333,0,0,0.0,2,2,4,5,2,1,2,1,14,-10,1,Talen Horton-Tucker,UTA,MIN,UTA,,,23,18,19,9
22023,1629659,22300130,"NOV 02, 2023",UTA vs. ORL,L,31,7,14,0.5,1,4,0.25,0,0,0.0,0,3,3,8,3,1,2,4,15,3,1,Talen Horton-Tucker,UTA,UTA,ORL,,,26,18,23,11
22023,1629659,22300125,"NOV 01, 2023",UTA vs. MEM,W,23,4,8,0.5,0,3,0.0,1,1,1.0,1,4,5,7,0,0,5,3,9,2,1,Talen Horton-Tucker,UTA,UTA,MEM,,,21,14,16,12
22023,1629659,22300110,"OCT 30, 2023",UTA @ DEN,L,30,7,12,0.583,2,3,0.667,0,0,0.0,0,3,3,8,0,0,1,4,16,2,1,Talen Horton-Tucker,UTA,DEN,UTA,,,27,19,24,11
22023,1629659,22300094,"OCT 28, 2023",UTA @ PHX,L,16,1,7,0.143,0,3,0.0,2,4,0.5,0,0,0,1,1,0,0,4,4,-13,1,Talen Horton-Tucker,UTA,PHX,UTA,,,5,4,5,1
22023,1629659,22300085,"OCT 27, 2023",UTA vs. LAC,W,27,3,10,0.3,2,5,0.4,2,2,1.0,0,3,3,8,3,1,2,1,10,4,1,Talen Horton-Tucker,UTA,UTA,LAC,,,21,13,18,11
22023,1629659,22300072,"OCT 25, 2023",UTA vs. SAC,L,22,3,9,0.333,2,4,0.5,0,0,0.0,0,1,1,4,0,1,1,1,8,-5,1,Talen Horton-Tucker,UTA,UTA,SAC,,,13,9,12,5
22023,1627863,22300555,"JAN 15, 2024",PHI vs. HOU,W,18,2,4,0.5,1,1,1.0,1,1,1.0,2,3,5,1,0,0,0,4,6,9,1,Danuel House Jr.,PHI,PHI,HOU,,,12,11,7,6
22023,1627863,22300532,"JAN 12, 2024",PHI vs. SAC,W,14,1,2,0.5,0,1,0.0,2,2,1.0,0,2,2,1,0,0,0,3,4,12,1,Danuel House Jr.,PHI,PHI,SAC,,,7,6,5,3
22023,1627863,22300483,"JAN 05, 2024",PHI vs. NYK,L,22,1,3,0.333,0,1,0.0,0,0,0.0,0,4,4,1,1,0,0,1,2,-27,1,Danuel House Jr.,PHI,PHI,NYK,,,7,6,3,5
22023,1627863,22300459,"JAN 02, 2024",PHI vs. CHI,W,15,2,5,0.4,0,2,0.0,1,1,1.0,0,0,0,1,0,0,1,1,5,-2,1,Danuel House Jr.,PHI,PHI,CHI,,,6,5,6,1
22023,1627863,22300434,"DEC 29, 2023",PHI @ HOU,W,12,0,0,0.0,0,0,0.0,0,0,0.0,0,2,2,0,0,0,0,1,0,5,1,Danuel House Jr.,PHI,HOU,PHI,,,2,2,0,2
22023,1627863,22300415,"DEC 27, 2023",PHI @ ORL,W,7,0,0,0.0,0,0,0.0,0,0,0.0,1,0,1,0,0,0,1,0,0,1,1,Danuel House Jr.,PHI,ORL,PHI,,,1,1,0,1
22023,1627863,22300404,"DEC 25, 2023",PHI @ MIA,L,6,0,3,0.0,0,2,0.0,1,2,0.5,0,0,0,0,1,0,1,0,1,-12,1,Danuel House Jr.,PHI,MIA,PHI,,,1,1,1,0
22023,1627863,22300382,"DEC 22, 2023",PHI vs. TOR,W,23,1,1,1.0,0,0,0.0,1,2,0.5,0,1,1,1,0,0,2,2,3,17,1,Danuel House Jr.,PHI,PHI,TOR,,,5,4,4,2
22023,1627863,22300367,"DEC 20, 2023",PHI vs. MIN,W,17,0,1,0.0,0,0,0.0,0,0,0.0,0,1,1,0,0,0,0,1,0,10,1,Danuel House Jr.,PHI,PHI,MIN,,,1,1,0,1
22023,1627863,22300351,"DEC 18, 2023",PHI vs. CHI,L,7,1,1,1.0,1,1,1.0,0,0,0.0,0,0,0,0,0,0,0,0,3,-3,1,Danuel House Jr.,PHI,PHI,CHI,,,3,3,3,0
22023,1627863,22300335,"DEC 16, 2023",PHI @ CHA,W,7,3,3,1.0,2,2,1.0,2,2,1.0,0,1,1,2,0,0,0,0,10,6,1,Danuel House Jr.,PHI,CHA,PHI,,,13,11,12,3
22023,1627863,22300327,"DEC 15, 2023",PHI vs. DET,W,12,1,5,0.2,1,3,0.333,0,0,0.0,3,1,4,2,0,0,0,2,3,0,1,Danuel House Jr.,PHI,PHI,DET,,,9,7,5,6
22023,1627863,22300310,"DEC 13, 2023",PHI @ DET,W,7,0,3,0.0,0,1,0.0,0,0,0.0,0,0,0,1,0,0,0,0,0,-12,1,Danuel House Jr.,PHI,DET,PHI,,,1,0,1,1
22023,1627863,22300295,"DEC 11, 2023",PHI vs. WAS,W,9,3,4,0.75,3,4,0.75,1,2,0.5,0,1,1,1,0,0,0,0,10,4,1,Danuel House Jr.,PHI,PHI,WAS,,,12,11,11,2
22023,1627863,22300232,"NOV 22, 2023",PHI @ MIN,L,17,1,5,0.2,0,3,0.0,1,2,0.5,0,2,2,2,3,0,1,2,3,-2,1,Danuel House Jr.,PHI,MIN,PHI,,,7,5,5,4
22023,1627863,22300040,"NOV 21, 2023",PHI vs. CLE,L,12,2,5,0.4,1,2,0.5,2,2,1.0,0,0,0,0,0,0,1,0,7,3,1,Danuel House Jr.,PHI,PHI,CLE,,,7,7,7,0
22023,1627863,22300208,"NOV 19, 2023",PHI @ BKN,W,14,1,4,0.25,1,2,0.5,0,0,0.0,2,1,3,3,1,0,0,3,3,2,1,Danuel House Jr.,PHI,BKN,PHI,,,9,6,6,6
22023,1627863,22300029,"NOV 17, 2023",PHI @ ATL,W,18,5,8,0.625,1,4,0.25,3,3,1.0,1,2,3,1,0,0,1,1,14,10,1,Danuel House Jr.,PHI,ATL,PHI,,,18,17,15,4
22023,1627863,22300194,"NOV 15, 2023",PHI vs. BOS,L,3,0,1,0.0,0,1,0.0,0,0,0.0,0,0,0,0,0,0,0,0,0,-8,1,Danuel House Jr.,PHI,PHI,BOS,,,0,0,0,0
22023,1627863,22300019,"NOV 14, 2023",PHI vs. IND,L,18,0,0,0.0,0,0,0.0,0,0,0.0,0,1,1,0,0,0,2,3,0,12,1,Danuel House Jr.,PHI,PHI,IND,,,1,1,0,1
22023,1627863,22300180,"NOV 12, 2023",PHI vs. IND,W,16,1,1,1.0,1,1,1.0,1,2,0.5,0,1,1,0,0,0,1,0,4,15,1,Danuel House Jr.,PHI,PHI,IND,,,5,5,4,1
22023,1627863,22300148,"NOV 06, 2023",PHI vs. WAS,W,7,1,2,0.5,0,1,0.0,1,1,1.0,0,0,0,0,0,0,2,0,3,-9,1,Danuel House Jr.,PHI,PHI,WAS,,,3,3,3,0
22023,1627863,22300098,"OCT 29, 2023",PHI vs. POR,W,10,1,2,0.5,0,1,0.0,0,0,0.0,1,1,2,2,1,0,1,0,2,-3,1,Danuel House Jr.,PHI,PHI,POR,,,6,4,4,4
22023,1627863,22300092,"OCT 28, 2023",PHI @ TOR,W,12,1,3,0.333,0,1,0.0,0,0,0.0,0,2,2,0,0,1,0,1,2,7,1,Danuel House Jr.,PHI,TOR,PHI,,,4,4,2,2
22023,1631216,22300557,"JAN 15, 2024",ORL @ NYK,W,21,1,7,0.143,1,7,0.143,4,5,0.8,1,0,1,0,0,0,0,4,7,-11,1,Caleb Houstan,ORL,NYK,ORL,,,8,8,7,1
22023,1631216,22300546,"JAN 13, 2024",ORL @ OKC,L,35,5,13,0.385,4,12,0.333,0,0,0.0,1,2,3,2,1,0,3,0,14,-13,1,Caleb Houstan,ORL,OKC,ORL,,,19,17,16,5
22023,1631216,22300535,"JAN 12, 2024",ORL @ MIA,L,32,3,9,0.333,3,9,0.333,0,0,0.0,1,1,2,3,0,0,0,4,9,2,1,Caleb Houstan,ORL,MIA,ORL,,,14,11,12,5
22023,1631216,22300513,"JAN 09, 2024",ORL vs. MIN,L,34,3,12,0.25,2,10,0.2,0,0,0.0,3,4,7,2,0,0,0,2,8,-18,1,Caleb Houstan,ORL,ORL,MIN,,,17,15,10,9
22023,1631216,22300499,"JAN 07, 2024",ORL vs. ATL,W,36,8,15,0.533,7,14,0.5,2,3,0.667,1,1,2,4,1,0,0,2,25,13,1,Caleb Houstan,ORL,ORL,ATL,,,31,27,29,6
22023,1631216,22300488,"JAN 05, 2024",ORL @ DEN,W,24,3,6,0.5,2,5,0.4,0,2,0.0,0,0,0,1,0,0,0,3,8,2,1,Caleb Houstan,ORL,DEN,ORL,,,9,8,9,1
22023,1631216,22300476,"JAN 03, 2024",ORL @ SAC,L,31,4,6,0.667,4,6,0.667,3,3,1.0,0,2,2,1,4,0,1,2,15,6,1,Caleb Houstan,ORL,SAC,ORL,,,18,17,16,3
22023,1631216,22300463,"JAN 02, 2024",ORL @ GSW,L,8,2,3,0.667,2,3,0.667,0,0,0.0,0,1,1,0,0,0,0,1,6,-6,1,Caleb Houstan,ORL,GSW,ORL,,,7,7,6,1
22023,1631216,22300450,"DEC 31, 2023",ORL @ PHX,L,7,0,0,0.0,0,0,0.0,0,0,0.0,0,0,0,0,0,0,0,0,0,8,1,Caleb Houstan,ORL,PHX,ORL,,,0,0,0,0
22023,1631216,22300429,"DEC 29, 2023",ORL vs. NYK,W,21,0,5,0.0,0,5,0.0,0,0,0.0,2,0,2,0,0,0,1,1,0,-3,1,Caleb Houstan,ORL,ORL,NYK,,,2,2,0,2
22023,1631216,22300415,"DEC 27, 2023",ORL vs. PHI,L,26,2,4,0.5,2,4,0.5,1,1,1.0,2,4,6,2,0,0,2,2,7,-10,1,Caleb Houstan,ORL,ORL,PHI,,,15,13,9,8
22023,1631216,22300407,"DEC 26, 2023",ORL @ WAS,W,12,0,0,0.0,0,0,0.0,0,0,0.0,0,1,1,0,0,0,0,0,0,0,1,Caleb Houstan,ORL,WAS,ORL,,,1,1,0,1
22023,1631216,22300391,"DEC 23, 2023",ORL @ IND,W,21,2,4,0.5,2,4,0.5,0,0,0.0,1,2,3,0,1,0,1,3,6,17,1,Caleb Houstan,ORL,IND,ORL,,,9,9,6,3
22023,1631216,22300378,"DEC 21, 2023",ORL @ MIL,L,18,0,3,0.0,0,3,0.0,0,0,0.0,0,1,1,0,0,1,0,2,0,10,1,Caleb Houstan,ORL,MIL,ORL,,,1,1,0,1
22023,1631216,22300366,"DEC 20, 2023",ORL vs. MIA,L,15,3,10,0.3,3,10,0.3,0,0,0.0,0,0,0,0,0,0,0,0,9,4,1,Caleb Houstan,ORL,ORL,MIA,,,9,9,9,0
22023,1631216,22300344,"DEC 17, 2023",ORL @ BOS,L,16,2,4,0.5,1,3,0.333,3,3,1.0,2,1,3,0,0,0,0,2,8,-11,1,Caleb Houstan,ORL,BOS,ORL,,,11,11,8,3
22023,1631216,22300329,"DEC 15, 2023",ORL @ BOS,L,11,2,5,0.4,1,4,0.25,0,0,0.0,1,1,2,1,0,0,0,0,5,-6,1,Caleb Houstan,ORL,BOS,ORL,,,8,7,6,3
22023,1631216,22301217,"DEC 08, 2023",ORL vs. DET,W,25,2,6,0.333,2,6,0.333,0,0,0.0,0,4,4,1,0,0,0,1,6,9,1,Caleb Houstan,ORL,ORL,DET,,,11,10,7,5
22023,1631216,22301205,"DEC 06, 2023",ORL @ CLE,L,11,0,2,0.0,0,1,0.0,0,0,0.0,1,2,3,0,0,0,0,1,0,-13,1,Caleb Houstan,ORL,CLE,ORL,,,3,3,0,3
22023,1631216,22300282,"DEC 02, 2023",ORL @ BKN,L,16,1,3,0.333,1,3,0.333,0,0,0.0,0,0,0,0,0,0,0,1,3,-13,1,Caleb Houstan,ORL,BKN,ORL,,,3,3,3,0
22023,1631216,22300259,"NOV 29, 2023",ORL vs. WAS,W,10,3,3,1.0,3,3,1.0,0,0,0.0,0,3,3,1,0,0,1,3,9,-4,1,Caleb Houstan,ORL,ORL,WAS,,,13,12,10,4
22023,1631216,22300248,"NOV 26, 2023",ORL vs. CHA,W,12,1,2,0.5,1,2,0.5,3,3,1.0,1,1,2,0,0,0,0,2,6,17,1,Caleb Houstan,ORL,ORL,CHA,,,8,8,6,2
22023,1631216,22300043,"NOV 24, 2023",ORL vs. BOS,W,9,0,0,0.0,0,0,0.0,0,0,0.0,1,1,2,0,1,0,0,0,0,15,1,Caleb Houstan,ORL,ORL,BOS,,,2,2,0,2
22023,1631216,22300038,"NOV 21, 2023",ORL vs. TOR,W,4,0,1,0.0,0,1,0.0,0,0,0.0,0,1,1,1,1,0,0,0,0,-4,1,Caleb Houstan,ORL,ORL,TOR,,,2,1,1,2
22023,1631216,22300209,"NOV 19, 2023",ORL @ IND,W,8,0,1,0.0,0,1,0.0,0,0,0.0,0,0,0,2,0,0,2,1,0,-18,1,Caleb Houstan,ORL,IND,ORL,,,2,0,2,2
22023,1631216,22300033,"NOV 17, 2023",ORL @ CHI,W,6,1,1,1.0,1,1,1.0,0,0,0.0,0,2,2,0,0,0,0,0,3,0,1,Caleb Houstan,ORL,CHI,ORL,,,5,5,3,2
22023,1631216,22300020,"NOV 14, 2023",ORL @ BKN,L,5,1,1,1.0,1,1,1.0,0,0,0.0,0,0,0,0,0,0,0,1,3,-8,1,Caleb Houstan,ORL,BKN,ORL,,,3,3,3,0
22023,1631216,22300147,"NOV 06, 2023",ORL vs. DAL,L,14,1,2,0.5,1,2,0.5,0,0,0.0,0,1,1,0,0,0,0,1,3,-2,1,Caleb Houstan,ORL,ORL,DAL,,,4,4,3,1
22023,1631216,22300134,"NOV 04, 2023",ORL vs. LAL,W,3,0,0,0.0,0,0,0.0,0,0,0.0,0,1,1,1,0,0,0,0,0,3,1,Caleb Houstan,ORL,ORL,LAL,,,2,1,1,2
22023,1631216,22300114,"OCT 31, 2023",ORL @ LAC,L,4,2,5,0.4,1,4,0.25,1,1,1.0,0,0,0,0,0,0,0,0,6,-1,1,Caleb Houstan,ORL,LAC,ORL,,,6,6,6,0
22023,1631216,22300066,"OCT 25, 2023",ORL vs. HOU,W,5,1,2,0.5,1,2,0.5,0,0,0.0,0,1,1,0,0,0,0,0,3,9,1,Caleb Houstan,ORL,ORL,HOU,,,4,4,3,1
22023,1641724,22300415,"DEC 27, 2023",ORL vs. PHI,L,1,1,1,1.0,1,1,1.0,0,0,0.0,0,0,0,0,0,0,0,0,3,3,1,Jett Howard,ORL,ORL,PHI,,,3,3,3,0
22023,1641724,22300344,"DEC 17, 2023",ORL @ BOS,L,2,1,2,0.5,1,1,1.0,0,0,0.0,0,0,0,0,0,0,0,0,3,4,1,Jett Howard,ORL,BOS,ORL,,,3,3,3,0
22023,1641724,22300329,"DEC 15, 2023",ORL @ BOS,L,3,0,1,0.0,0,1,0.0,0,0,0.0,0,1,1,0,0,0,0,0,0,3,1,Jett Howard,ORL,BOS,ORL,,,1,1,0,1
22023,1641724,22301217,"DEC 08, 2023",ORL vs. DET,W,5,2,2,1.0,1,1,1.0,1,2,0.5,0,1,1,1,0,0,0,1,6,3,1,Jett Howard,ORL,ORL,DET,,,8,7,7,2
22023,1641724,22300209,"NOV 19, 2023",ORL @ IND,W,7,0,2,0.0,0,2,0.0,0,0,0.0,0,0,0,1,0,0,2,0,0,-11,1,Jett Howard,ORL,IND,ORL,,,1,0,1,1
22023,1641724,22300020,"NOV 14, 2023",ORL @ BKN,L,4,0,4,0.0,0,4,0.0,0,0,0.0,0,0,0,0,0,0,0,0,0,-4,1,Jett Howard,ORL,BKN,ORL,,,0,0,0,0
22023,1641724,22300134,"NOV 04, 2023",ORL vs. LAL,W,3,0,2,0.0,0,1,0.0,0,0,0.0,1,0,1,0,0,0,0,0,0,3,1,Jett Howard,ORL,ORL,LAL,,,1,1,0,1
22023,1641724,22300114,"OCT 31, 2023",ORL @ LAC,L,4,1,1,1.0,0,0,0.0,0,0,0.0,0,1,1,0,0,0,0,0,2,-1,1,Jett Howard,ORL,LAC,ORL,,,3,3,2,1
22023,1641724,22300066,"OCT 25, 2023",ORL vs. HOU,W,5,0,1,0.0,0,1,0.0,0,0,0.0,0,0,0,1,0,0,0,0,0,9,1,Jett Howard,ORL,ORL,HOU,,,1,0,1,1
22023,1628989,22300552,"JAN 14, 2024",SAC @ MIL,L,39,10,14,0.714,6,9,0.667,0,0,0.0,0,10,10,3,1,0,1,4,26,4,1,Kevin Huerter,SAC,MIL,SAC,,,39,36,29,13
22023,1628989,22300518,"JAN 10, 2024",SAC @ CHA,W,1,0,0,0.0,0,0,0.0,0,0,0.0,0,0,0,0,0,0,0,1,0,-2,1,Kevin Huerter,SAC,CHA,SAC,,,0,0,0,0
22023,1628989,22300512,"JAN 09, 2024",SAC @ DET,W,29,2,11,0.182,0,6,0.0,0,0,0.0,0,5,5,5,1,1,0,1,4,16,1,Kevin Huerter,SAC,DET,SAC,,,14,9,9,10
22023,1628989,22300500,"JAN 07, 2024",SAC vs. NOP,L,24,6,10,0.6,2,6,0.333,3,4,0.75,1,0,1,3,1,1,0,0,17,-3,1,Kevin Huerter,SAC,SAC,NOP,,,21,18,20,4
22023,1628989,22300492,"JAN 05, 2024",SAC vs. TOR,W,14,1,2,0.5,1,2,0.5,0,0,0.0,0,2,2,3,0,0,0,1,3,3,1,Kevin Huerter,SAC,SAC,TOR,,,8,5,6,5
22023,1628989,22300476,"JAN 03, 2024",SAC vs. ORL,W,18,0,5,0.0,0,4,0.0,2,2,1.0,1,6,7,2,0,0,1,1,2,4,1,Kevin Huerter,SAC,SAC,ORL,,,11,9,4,9
22023,1628989,22300464,"JAN 02, 2024",SAC vs. CHA,L,12,1,4,0.25,0,2,0.0,2,2,1.0,0,2,2,0,0,0,0,3,4,-1,1,Kevin Huerter,SAC,SAC,CHA,,,6,6,4,2
22023,1628989,22300449,"DEC 31, 2023",SAC @ MEM,W,17,4,9,0.444,1,3,0.333,0,0,0.0,0,0,0,0,0,0,0,1,9,16,1,Kevin Huerter,SAC,MEM,SAC,,,9,9,9,0
22023,1628989,22300431,"DEC 29, 2023",SAC @ ATL,W,10,3,6,0.5,1,3,0.333,0,0,0.0,0,3,3,1,0,0,0,0,7,-5,1,Kevin Huerter,SAC,ATL,SAC,,,11,10,8,4
22023,1628989,22300413,"DEC 26, 2023",SAC @ POR,L,22,2,8,0.25,1,5,0.2,0,0,0.0,1,1,2,2,0,1,0,1,5,5,1,Kevin Huerter,SAC,POR,SAC,,,9,7,7,4
22023,1628989,22300400,"DEC 23, 2023",SAC vs. MIN,L,15,1,7,0.143,0,2,0.0,0,0,0.0,0,1,1,1,0,0,1,3,2,-19,1,Kevin Huerter,SAC,SAC,MIN,,,4,3,3,2
22023,1628989,22300387,"DEC 22, 2023",SAC vs. PHX,W,27,5,9,0.556,2,6,0.333,1,1,1.0,1,1,2,5,1,0,1,1,13,22,1,Kevin Huerter,SAC,SAC,PHX,,,20,15,18,7
22023,1628989,22300373,"DEC 20, 2023",SAC vs. BOS,L,16,3,5,0.6,1,2,0.5,0,1,0.0,0,1,1,0,0,0,0,1,7,-7,1,Kevin Huerter,SAC,SAC,BOS,,,8,8,7,1
22023,1628989,22300358,"DEC 18, 2023",SAC vs. WAS,W,23,4,8,0.5,1,4,0.25,2,2,1.0,0,4,4,2,0,1,0,4,11,14,1,Kevin Huerter,SAC,SAC,WAS,,,17,15,13,6
22023,1628989,22300342,"DEC 16, 2023",SAC vs. UTA,W,25,4,6,0.667,2,4,0.5,1,2,0.5,1,2,3,5,0,0,0,4,11,26,1,Kevin Huerter,SAC,SAC,UTA,,,19,14,16,8
22023,1628989,22300324,"DEC 14, 2023",SAC vs. OKC,W,20,2,8,0.25,0,3,0.0,0,0,0.0,1,1,2,2,2,1,1,1,4,-10,1,Kevin Huerter,SAC,SAC,OKC,,,8,6,6,4
22023,1628989,22300309,"DEC 12, 2023",SAC @ LAC,L,17,1,8,0.125,1,4,0.25,0,0,0.0,0,4,4,3,1,0,0,1,3,-8,1,Kevin Huerter,SAC,LAC,SAC,,,10,7,6,7
22023,1628989,22300303,"DEC 11, 2023",SAC vs. BKN,W,17,2,6,0.333,2,5,0.4,0,0,0.0,0,1,1,1,0,0,0,4,6,2,1,Kevin Huerter,SAC,SAC,BKN,,,8,7,7,2
22023,1628989,22301228,"DEC 08, 2023",SAC @ PHX,W,17,0,4,0.0,0,3,0.0,1,1,1.0,0,3,3,1,1,0,0,3,1,-1,1,Kevin Huerter,SAC,PHX,SAC,,,5,4,2,4
22023,1628989,22301204,"DEC 04, 2023",SAC vs. NOP,L,32,5,10,0.5,2,7,0.286,0,0,0.0,1,4,5,2,0,0,0,2,12,11,1,Kevin Huerter,SAC,SAC,NOP,,,19,17,14,7
22023,1628989,22300290,"DEC 02, 2023",SAC vs. DEN,W,29,6,10,0.6,4,6,0.667,0,0,0.0,0,6,6,2,1,1,2,0,16,-4,1,Kevin Huerter,SAC,SAC,DEN,,,24,22,18,8
22023,1628989,22300264,"NOV 29, 2023",SAC vs. LAC,L,26,3,7,0.429,1,5,0.2,0,0,0.0,1,4,5,5,0,0,2,3,7,3,1,Kevin Huerter,SAC,SAC,LAC,,,17,12,12,10
22023,1628989,22300060,"NOV 28, 2023",SAC vs. GSW,W,33,8,14,0.571,4,7,0.571,1,2,0.5,3,6,9,5,0,0,1,5,21,2,1,Kevin Huerter,SAC,SAC,GSW,,,35,30,26,14
22023,1628989,22300050,"NOV 24, 2023",SAC @ MIN,W,24,4,8,0.5,2,5,0.4,0,0,0.0,1,1,2,3,0,1,0,1,10,17,1,Kevin Huerter,SAC,MIN,SAC,,,15,12,13,5
22023,1628989,22300233,"NOV 22, 2023",SAC @ NOP,L,27,2,10,0.2,2,7,0.286,2,2,1.0,0,7,7,2,0,0,0,3,8,-7,1,Kevin Huerter,SAC,NOP,SAC,,,17,15,10,9
22023,1628989,22300222,"NOV 20, 2023",SAC @ NOP,L,23,4,10,0.4,2,8,0.25,0,0,0.0,0,0,0,3,0,0,0,1,10,-25,1,Kevin Huerter,SAC,NOP,SAC,,,13,10,13,3
22023,1628989,22300032,"NOV 17, 2023",SAC @ SAS,W,25,4,9,0.444,1,4,0.25,0,0,0.0,0,1,1,2,3,0,0,2,9,-1,1,Kevin Huerter,SAC,SAS,SAC,,,12,10,11,3
22023,1628989,22300198,"NOV 15, 2023",SAC @ LAL,W,38,10,16,0.625,6,11,0.545,2,2,1.0,0,4,4,7,2,0,0,2,28,21,1,Kevin Huerter,SAC,LAL,SAC,,,39,32,35,11
22023,1628989,22300191,"NOV 13, 2023",SAC vs. CLE,W,29,7,11,0.636,6,9,0.667,0,0,0.0,1,1,2,2,0,0,0,4,20,5,1,Kevin Huerter,SAC,SAC,CLE,,,24,22,22,4
22023,1628989,22300016,"NOV 10, 2023",SAC vs. OKC,W,34,11,19,0.579,4,10,0.4,2,2,1.0,0,9,9,2,3,1,2,4,28,8,1,Kevin Huerter,SAC,SAC,OKC,,,39,37,30,11
22023,1628989,22300170,"NOV 08, 2023",SAC vs. POR,W,39,5,13,0.385,4,9,0.444,3,3,1.0,0,5,5,4,2,0,3,2,17,2,1,Kevin Huerter,SAC,SAC,POR,,,26,22,21,9
22023,1628989,22300153,"NOV 06, 2023",SAC @ HOU,L,25,5,10,0.5,3,8,0.375,0,1,0.0,0,3,3,2,1,0,3,0,13,-26,1,Kevin Huerter,SAC,HOU,SAC,,,18,16,15,5
22023,1628989,22300137,"NOV 04, 2023",SAC @ HOU,L,16,2,8,0.25,0,3,0.0,0,0,0.0,2,2,4,2,1,0,1,3,4,-13,1,Kevin Huerter,SAC,HOU,SAC,,,10,8,6,6
22023,1628989,22300126,"NOV 01, 2023",SAC @ GSW,L,27,4,11,0.364,1,5,0.2,2,2,1.0,2,7,9,3,1,0,1,3,11,2,1,Kevin Huerter,SAC,GSW,SAC,,,23,20,14,12
22023,1628989,22300100,"OCT 29, 2023",SAC vs. LAL,W,37,4,12,0.333,3,7,0.429,1,2,0.5,0,7,7,4,0,2,0,3,12,11,1,Kevin Huerter,SAC,SAC,LAL,,,23,19,16,11
22023,1628989,22300087,"OCT 27, 2023",SAC vs. GSW,L,16,0,5,0.0,0,5,0.0,0,0,0.0,0,2,2,2,0,1,0,0,0,-2,1,Kevin Huerter,SAC,SAC,GSW,,,4,2,2,4
22023,1628989,22300072,"OCT 25, 2023",SAC @ UTA,W,24,3,9,0.333,1,5,0.2,0,0,0.0,2,3,5,2,0,0,1,3,7,6,1,Kevin Huerter,SAC,UTA,SAC,,,14,12,9,7
22023,1630643,22300539,"JAN 12, 2024",DEN vs. NOP,W,2,0,0,0.0,0,0,0.0,0,0,0.0,0,1,1,0,0,0,0,1,0,-6,1,Jay Huff,DEN,DEN,NOP,,,1,1,0,1
22023,1630643,22300524,"JAN 10, 2024",DEN @ UTA,L,6,1,2,0.5,0,1,0.0,0,0,0.0,0,0,0,1,0,0,1,1,2,12,1,Jay Huff,DEN,UTA,DEN,,,3,2,3,1
22023,1630643,22300502,"JAN 07, 2024",DEN vs. DET,W,2,0,1,0.0,0,1,0.0,0,0,0.0,0,0,0,0,0,0,0,1,0,-6,1,Jay Huff,DEN,DEN,DET,,,0,0,0,0
22023,1630643,22300257,"NOV 27, 2023",DEN @ LAC,W,0,0,0,0.0,0,0,0.0,0,0,0.0,0,0,0,0,0,0,0,0,0,0,1,Jay Huff,DEN,LAC,DEN,,,0,0,0,0
22023,1630643,22300252,"NOV 26, 2023",DEN vs. SAS,W,2,1,1,1.0,0,0,0.0,0,0,0.0,0,0,0,0,0,0,0,0,2,-4,1,Jay Huff,DEN,DEN,SAS,,,2,2,2,0
22023,1629631,22300371,"DEC 20, 2023",ATL @ HOU,W,28,5,10,0.5,1,4,0.25,0,0,0.0,0,1,1,3,0,0,0,2,11,-19,1,De'Andre Hunter,ATL,HOU,ATL,,,15,12,14,4
22023,1629631,22300352,"DEC 18, 2023",ATL vs. DET,W,29,7,15,0.467,5,6,0.833,0,0,0.0,1,5,6,2,1,2,4,5,19,9,1,De'Andre Hunter,ATL,ATL,DET,,,27,25,21,8
22023,1629631,22300336,"DEC 16, 2023",ATL @ CLE,L,26,5,7,0.714,2,2,1.0,6,6,1.0,0,2,2,0,1,0,0,1,18,-3,1,De'Andre Hunter,ATL,CLE,ATL,,,20,20,18,2
22023,1629631,22301218,"DEC 08, 2023",ATL @ PHI,L,37,9,18,0.5,4,7,0.571,2,2,1.0,1,6,7,1,0,0,3,2,24,-13,1,De'Andre Hunter,ATL,PHI,ATL,,,32,31,25,8
22023,1629631,22301209,"DEC 06, 2023",ATL vs. BKN,L,36,6,15,0.4,1,3,0.333,1,1,1.0,0,4,4,2,0,0,1,1,14,3,1,De'Andre Hunter,ATL,ATL,BKN,,,20,18,16,6
22023,1629631,22300286,"DEC 02, 2023",ATL @ MIL,L,31,3,10,0.3,0,2,0.0,6,6,1.0,0,1,1,0,2,0,2,2,12,6,1,De'Andre Hunter,ATL,MIL,ATL,,,13,13,12,1
22023,1629631,22300272,"NOV 30, 2023",ATL @ SAS,W,22,3,8,0.375,2,4,0.5,4,4,1.0,0,6,6,2,1,0,3,6,12,-5,1,De'Andre Hunter,ATL,SAS,ATL,,,20,18,14,8
22023,1629631,22300055,"NOV 28, 2023",ATL @ CLE,L,26,5,12,0.417,1,6,0.167,7,7,1.0,0,4,4,2,0,0,0,4,18,-18,1,De'Andre Hunter,ATL,CLE,ATL,,,24,22,20,6
22023,1629631,22300246,"NOV 26, 2023",ATL @ BOS,L,40,7,14,0.5,5,11,0.455,5,5,1.0,0,4,4,2,1,1,2,4,24,-11,1,De'Andre Hunter,ATL,BOS,ATL,,,30,28,26,6
22023,1629631,22300241,"NOV 25, 2023",ATL @ WAS,W,31,7,11,0.636,3,5,0.6,3,3,1.0,1,3,4,0,2,0,2,4,20,21,1,De'Andre Hunter,ATL,WAS,ATL,,,24,24,20,4
22023,1629631,22300227,"NOV 22, 2023",ATL vs. BKN,W,39,8,16,0.5,2,7,0.286,7,7,1.0,3,8,11,0,1,2,1,3,25,-3,1,De'Andre Hunter,ATL,ATL,BKN,,,36,36,25,11
22023,1629631,22300039,"NOV 21, 2023",ATL vs. IND,L,27,3,7,0.429,1,2,0.5,0,0,0.0,2,2,4,1,1,0,3,2,7,-11,1,De'Andre Hunter,ATL,ATL,IND,,,12,11,8,5
22023,1629631,22300029,"NOV 17, 2023",ATL vs. PHI,L,18,4,7,0.571,1,2,0.5,0,0,0.0,0,1,1,0,0,0,0,1,9,-10,1,De'Andre Hunter,ATL,ATL,PHI,,,10,10,9,1
22023,1629631,22300193,"NOV 15, 2023",ATL vs. NYK,L,26,2,7,0.286,1,3,0.333,0,0,0.0,1,1,2,1,0,0,1,3,5,-12,1,De'Andre Hunter,ATL,ATL,NYK,,,8,7,6,3
22023,1629631,22300018,"NOV 14, 2023",ATL @ DET,W,35,6,14,0.429,2,5,0.4,2,3,0.667,2,3,5,5,1,0,1,3,16,2,1,De'Andre Hunter,ATL,DET,ATL,,,26,21,21,10
22023,1629631,22300175,"NOV 11, 2023",ATL vs. MIA,L,36,4,11,0.364,0,4,0.0,2,2,1.0,0,5,5,2,1,1,3,4,10,-9,1,De'Andre Hunter,ATL,ATL,MIA,,,17,15,12,7
22023,1629631,22300172,"NOV 09, 2023",ATL @ ORL,W,26,3,9,0.333,2,5,0.4,4,5,0.8,0,0,0,1,1,1,2,4,12,6,1,De'Andre Hunter,ATL,ORL,ATL,,,13,12,13,1
22023,1629631,22300155,"NOV 06, 2023",ATL @ OKC,L,33,2,13,0.154,1,7,0.143,3,4,0.75,0,2,2,0,0,0,0,2,8,-3,1,De'Andre Hunter,ATL,OKC,ATL,,,10,10,8,2
22023,1629631,22300135,"NOV 04, 2023",ATL @ NOP,W,30,1,3,0.333,1,2,0.5,1,2,0.5,1,4,5,1,0,1,2,3,4,17,1,De'Andre Hunter,ATL,NOP,ATL,,,10,9,5,6
22023,1629631,22300117,"NOV 01, 2023",ATL vs. WAS,W,33,8,16,0.5,2,7,0.286,5,6,0.833,0,7,7,3,2,0,5,5,23,3,1,De'Andre Hunter,ATL,ATL,WAS,,,33,30,26,10
22023,1629631,22300104,"OCT 30, 2023",ATL vs. MIN,W,30,6,10,0.6,3,5,0.6,1,2,0.5,0,4,4,2,1,0,0,0,16,4,1,De'Andre Hunter,ATL,ATL,MIN,,,22,20,18,6
22023,1629631,22300097,"OCT 29, 2023",ATL @ MIL,W,24,6,10,0.6,2,4,0.5,1,1,1.0,1,2,3,1,4,0,2,3,15,17,1,De'Andre Hunter,ATL,MIL,ATL,,,19,18,16,4
22023,1629631,22300079,"OCT 27, 2023",ATL vs. NYK,L,32,8,13,0.615,3,7,0.429,8,8,1.0,0,6,6,1,0,1,0,3,27,-1,1,De'Andre Hunter,ATL,ATL,NYK,,,34,33,28,7
22023,1629631,22300063,"OCT 25, 2023",ATL @ CHA,L,31,4,9,0.444,1,4,0.25,0,1,0.0,2,2,4,1,0,0,0,6,9,-13,1,De'Andre Hunter,ATL,CHA,ATL,,,14,13,10,5
22023,1630538,22300486,"JAN 05, 2024",LAC @ NOP,W,6,0,3,0.0,0,0,0.0,0,0,0.0,0,0,0,1,0,1,0,1,0,-12,1,Bones Hyland,LAC,NOP,LAC,,,1,0,1,1
22023,1630538,22300389,"DEC 23, 2023",LAC vs. BOS,L,8,1,4,0.25,0,2,0.0,0,0,0.0,0,0,0,0,0,0,0,0,2,-11,1,Bones Hyland,LAC,LAC,BOS,,,2,2,2,0
22023,1630538,22300379,"DEC 21, 2023",LAC @ OKC,L,10,2,4,0.5,1,1,1.0,1,2,0.5,0,0,0,2,1,0,1,0,6,1,1,Bones Hyland,LAC,OKC,LAC,,,8,6,8,2
22023,1630538,22300309,"DEC 12, 2023",LAC vs. SAC,W,9,2,8,0.25,2,4,0.5,0,0,0.0,0,1,1,1,0,0,0,0,6,-12,1,Bones Hyland,LAC,LAC,SAC,,,8,7,7,2
22023,1630538,22300273,"NOV 30, 2023",LAC @ GSW,L,4,0,1,0.0,0,1,0.0,0,0,0.0,0,0,0,0,0,0,0,1,0,0,1,Bones Hyland,LAC,GSW,LAC,,,0,0,0,0
22023,1630538,22300264,"NOV 29, 2023",LAC @ SAC,W,1,0,0,0.0,0,0,0.0,0,0,0.0,0,0,0,0,1,0,0,0,0,0,1,Bones Hyland,LAC,SAC,LAC,,,0,0,0,0
22023,1630538,22300244,"NOV 25, 2023",LAC vs. DAL,W,4,1,4,0.25,1,3,0.333,0,0,0.0,0,0,0,0,0,0,2,0,3,-1,1,Bones Hyland,LAC,LAC,DAL,,,3,3,3,0
22023,1630538,22300223,"NOV 20, 2023",LAC @ SAS,W,4,1,3,0.333,1,2,0.5,0,0,0.0,0,1,1,1,0,0,1,0,3,3,1,Bones Hyland,LAC,SAS,LAC,,,5,4,4,2
22023,1630538,22300014,"NOV 10, 2023",LAC @ DAL,L,29,5,9,0.556,1,5,0.2,6,6,1.0,1,3,4,6,1,0,2,5,17,8,1,Bones Hyland,LAC,DAL,LAC,,,27,21,23,10
22023,1630538,22300160,"NOV 08, 2023",LAC @ BKN,L,6,2,6,0.333,0,2,0.0,0,0,0.0,1,1,2,0,0,0,1,0,4,-2,1,Bones Hyland,LAC,BKN,LAC,,,6,6,4,2
22023,1630538,22300151,"NOV 06, 2023",LAC @ NYK,L,22,2,9,0.222,1,4,0.25,0,0,0.0,0,1,1,4,1,0,3,2,5,-5,1,Bones Hyland,LAC,NYK,LAC,,,10,6,9,5
22023,1630538,22300127,"NOV 01, 2023",LAC @ LAL,L,34,2,7,0.286,0,3,0.0,0,0,0.0,0,1,1,5,1,0,0,3,4,8,1,Bones Hyland,LAC,LAL,LAC,,,10,5,9,6
22023,1630538,22300114,"OCT 31, 2023",LAC vs. ORL,W,32,6,14,0.429,4,7,0.571,1,2,0.5,0,0,0,3,1,0,1,4,17,8,1,Bones Hyland,LAC,LAC,ORL,,,20,17,20,3
22023,1630538,22300099,"OCT 29, 2023",LAC vs. SAS,W,21,7,14,0.5,4,8,0.5,0,0,0.0,0,3,3,1,1,0,4,1,18,10,1,Bones Hyland,LAC,LAC,SAS,,,22,21,19,4
22023,1630538,22300085,"OCT 27, 2023",LAC @ UTA,L,22,5,10,0.5,2,5,0.4,0,0,0.0,0,2,2,1,1,0,3,2,12,-1,1,Bones Hyland,LAC,UTA,LAC,,,15,14,13,3
22023,1630538,22300074,"OCT 25, 2023",LAC vs. POR,W,22,6,11,0.545,3,8,0.375,2,2,1.0,0,0,0,3,0,0,2,4,17,-4,1,Bones Hyland,LAC,LAC,POR,,,20,17,20,3
22023,204060,22300557,"JAN 15, 2024",ORL @ NYK,W,20,3,6,0.5,0,1,0.0,0,0,0.0,0,1,1,4,0,0,1,2,6,6,1,Joe Ingles,ORL,NYK,ORL,,,11,7,10,5
22023,204060,22300535,"JAN 12, 2024",ORL @ MIA,L,20,5,10,0.5,4,8,0.5,0,1,0.0,0,0,0,6,3,0,2,2,14,0,1,Joe Ingles,ORL,MIA,ORL,,,20,14,20,6
22023,204060,22300329,"DEC 15, 2023",ORL @ BOS,L,6,0,1,0.0,0,0,0.0,0,0,0.0,1,1,2,2,0,0,0,0,0,-12,1,Joe Ingles,ORL,BOS,ORL,,,4,2,2,4
22023,204060,22300294,"DEC 11, 2023",ORL vs. CLE,W,20,2,5,0.4,2,4,0.5,6,6,1.0,1,3,4,3,0,1,1,2,12,-2,1,Joe Ingles,ORL,ORL,CLE,,,19,16,15,7
22023,204060,22301217,"DEC 08, 2023",ORL vs. DET,W,16,2,6,0.333,2,3,0.667,0,0,0.0,0,4,4,5,0,0,0,1,6,15,1,Joe Ingles,ORL,ORL,DET,,,15,10,11,9
22023,204060,22301205,"DEC 06, 2023",ORL @ CLE,L,17,0,1,0.0,0,1,0.0,0,0,0.0,0,4,4,3,1,0,0,3,0,-7,1,Joe Ingles,ORL,CLE,ORL,,,7,4,3,7
22023,204060,22300282,"DEC 02, 2023",ORL @ BKN,L,16,1,2,0.5,1,1,1.0,2,3,0.667,1,1,2,2,1,0,1,2,5,-10,1,Joe Ingles,ORL,BKN,ORL,,,9,7,7,4
22023,204060,22300274,"DEC 01, 2023",ORL vs. WAS,W,25,5,11,0.455,3,7,0.429,1,1,1.0,0,3,3,7,0,0,0,3,14,13,1,Joe Ingles,ORL,ORL,WAS,,,24,17,21,10
22023,204060,22300259,"NOV 29, 2023",ORL vs. WAS,W,20,5,7,0.714,1,1,1.0,1,1,1.0,0,4,4,6,1,0,2,1,12,16,1,Joe Ingles,ORL,ORL,WAS,,,22,16,18,10
22023,204060,22300248,"NOV 26, 2023",ORL vs. CHA,W,15,0,3,0.0,0,1,0.0,0,0,0.0,0,2,2,1,1,0,2,2,0,0,1,Joe Ingles,ORL,ORL,CHA,,,3,2,1,3
22023,204060,22300043,"NOV 24, 2023",ORL vs. BOS,W,21,2,3,0.667,1,1,1.0,0,0,0.0,1,4,5,2,0,0,2,1,5,2,1,Joe Ingles,ORL,ORL,BOS,,,12,10,7,7
22023,204060,22300226,"NOV 22, 2023",ORL vs. DEN,W,17,4,4,1.0,2,2,1.0,2,2,1.0,0,1,1,7,1,0,0,3,12,9,1,Joe Ingles,ORL,ORL,DEN,,,20,13,19,8
22023,204060,22300038,"NOV 21, 2023",ORL vs. TOR,W,13,2,3,0.667,1,2,0.5,1,1,1.0,1,1,2,1,0,0,1,2,6,6,1,Joe Ingles,ORL,ORL,TOR,,,9,8,7,3
22023,204060,22300209,"NOV 19, 2023",ORL @ IND,W,18,0,2,0.0,0,2,0.0,0,0,0.0,0,4,4,6,3,0,2,1,0,4,1,Joe Ingles,ORL,IND,ORL,,,10,4,6,10
22023,204060,22300033,"NOV 17, 2023",ORL @ CHI,W,26,3,8,0.375,2,7,0.286,0,0,0.0,0,1,1,5,1,0,1,1,8,16,1,Joe Ingles,ORL,CHI,ORL,,,14,9,13,6
22023,204060,22300196,"NOV 15, 2023",ORL @ CHI,W,18,1,3,0.333,1,3,0.333,0,0,0.0,0,2,2,1,0,0,0,1,3,3,1,Joe Ingles,ORL,CHI,ORL,,,6,5,4,3
22023,204060,22300020,"NOV 14, 2023",ORL @ BKN,L,21,4,4,1.0,3,3,1.0,0,0,0.0,1,2,3,4,1,1,1,1,11,-10,1,Joe Ingles,ORL,BKN,ORL,,,18,14,15,7
22023,204060,22300173,"NOV 11, 2023",ORL vs. MIL,W,23,1,5,0.2,1,4,0.25,2,2,1.0,1,2,3,5,0,0,0,1,5,8,1,Joe Ingles,ORL,ORL,MIL,,,13,8,10,8
22023,204060,22300172,"NOV 09, 2023",ORL vs. ATL,L,18,1,6,0.167,1,3,0.333,0,0,0.0,2,1,3,5,3,1,0,1,3,27,1,Joe Ingles,ORL,ORL,ATL,,,11,6,8,8
22023,204060,22300147,"NOV 06, 2023",ORL vs. DAL,L,21,1,2,0.5,0,0,0.0,0,0,0.0,0,5,5,3,0,0,2,1,2,3,1,Joe Ingles,ORL,ORL,DAL,,,10,7,5,8
22023,204060,22300134,"NOV 04, 2023",ORL vs. LAL,W,25,2,6,0.333,2,5,0.4,1,1,1.0,0,3,3,3,1,0,2,2,7,7,1,Joe Ingles,ORL,ORL,LAL,,,13,10,10,6
22023,204060,22300130,"NOV 02, 2023",ORL @ UTA,W,24,1,5,0.2,1,4,0.25,1,2,0.5,1,1,2,1,1,0,0,0,4,-4,1,Joe Ingles,ORL,UTA,ORL,,,7,6,5,3
22023,204060,22300114,"OCT 31, 2023",ORL @ LAC,L,13,0,1,0.0,0,1,0.0,0,0,0.0,0,1,1,1,0,0,0,0,0,-4,1,Joe Ingles,ORL,LAC,ORL,,,2,1,1,2
22023,204060,22300111,"OCT 30, 2023",ORL @ LAL,L,12,1,2,0.5,0,0,0.0,0,0,0.0,1,0,1,3,2,0,1,2,2,-2,1,Joe Ingles,ORL,LAL,ORL,,,6,3,5,4
22023,204060,22300086,"OCT 27, 2023",ORL @ POR,W,15,0,1,0.0,0,1,0.0,0,0,0.0,0,1,1,1,1,0,1,3,0,3,1,Joe Ingles,ORL,POR,ORL,,,2,1,1,2
22023,204060,22300066,"OCT 25, 2023",ORL vs. HOU,W,18,0,3,0.0,0,3,0.0,0,0,0.0,0,4,4,5,0,0,1,3,0,9,1,Joe Ingles,ORL,ORL,HOU,,,9,4,5,9
22023,1627742,22300556,"JAN 15, 2024",NOP @ DAL,L,32,3,14,0.214,0,4,0.0,6,8,0.75,0,5,5,5,1,0,1,3,12,-19,1,Brandon Ingram,NOP,DAL,NOP,,,22,17,17,10
22023,1627742,22300539,"JAN 12, 2024",NOP @ DEN,L,34,4,11,0.364,0,1,0.0,1,2,0.5,0,4,4,6,0,0,2,2,9,-14,1,Brandon Ingram,NOP,DEN,NOP,,,19,13,15,10
22023,1627742,22300525,"JAN 10, 2024",NOP @ GSW,W,23,5,12,0.417,1,3,0.333,2,2,1.0,1,4,5,1,1,0,2,4,13,7,1,Brandon Ingram,NOP,GSW,NOP,,,19,18,14,6
22023,1627742,22300500,"JAN 07, 2024",NOP @ SAC,W,30,6,12,0.5,1,3,0.333,2,2,1.0,0,4,4,8,1,1,1,0,15,34,1,Brandon Ingram,NOP,SAC,NOP,,,27,19,23,12
22023,1627742,22300486,"JAN 05, 2024",NOP vs. LAC,L,30,3,9,0.333,0,1,0.0,6,7,0.857,0,1,1,4,0,0,2,2,12,-12,1,Brandon Ingram,NOP,NOP,LAC,,,17,13,16,5
22023,1627742,22300471,"JAN 03, 2024",NOP @ MIN,W,32,7,11,0.636,1,3,0.333,4,5,0.8,0,4,4,7,2,0,3,3,19,13,1,Brandon Ingram,NOP,MIN,NOP,,,30,23,26,11
22023,1627742,22300461,"JAN 02, 2024",NOP vs. BKN,W,25,5,9,0.556,2,2,1.0,0,0,0.0,1,4,5,5,0,1,1,2,12,20,1,Brandon Ingram,NOP,NOP,BKN,,,22,17,17,10
22023,1627742,22300446,"DEC 31, 2023",NOP vs. LAL,W,38,10,18,0.556,4,7,0.571,2,5,0.4,1,4,5,8,3,2,3,3,26,17,1,Brandon Ingram,NOP,NOP,LAL,,,39,31,34,13
22023,1627742,22300424,"DEC 28, 2023",NOP vs. UTA,W,36,9,18,0.5,1,2,0.5,7,7,1.0,1,2,3,5,1,2,1,3,26,4,1,Brandon Ingram,NOP,NOP,UTA,,,34,29,31,8
22023,1627742,22300410,"DEC 26, 2023",NOP vs. MEM,L,42,9,20,0.45,2,4,0.5,4,4,1.0,2,4,6,7,3,4,3,3,24,-7,1,Brandon Ingram,NOP,NOP,MEM,,,37,30,31,13
22023,1627742,22300392,"DEC 23, 2023",NOP vs. HOU,L,36,6,12,0.5,0,2,0.0,7,9,0.778,1,2,3,5,0,2,0,2,19,2,1,Brandon Ingram,NOP,NOP,HOU,,,27,22,24,8
22023,1627742,22300375,"DEC 21, 2023",NOP @ CLE,W,28,6,12,0.5,1,3,0.333,4,4,1.0,1,6,7,6,0,0,3,2,17,12,1,Brandon Ingram,NOP,CLE,NOP,,,30,24,23,13
22023,1627742,22300360,"DEC 19, 2023",NOP vs. MEM,L,37,11,18,0.611,1,1,1.0,11,12,0.917,1,3,4,6,2,0,2,4,34,0,1,Brandon Ingram,NOP,NOP,MEM,,,44,38,40,10
22023,1627742,22300345,"DEC 17, 2023",NOP @ SAS,W,27,10,17,0.588,5,7,0.714,1,1,1.0,0,3,3,4,1,1,1,1,26,23,1,Brandon Ingram,NOP,SAS,NOP,,,33,29,30,7
22023,1627742,22300326,"DEC 15, 2023",NOP @ CHA,W,32,3,8,0.375,0,1,0.0,2,2,1.0,0,3,3,7,0,0,9,3,8,5,1,Brandon Ingram,NOP,CHA,NOP,,,18,11,15,10
22023,1627742,22300311,"DEC 13, 2023",NOP @ WAS,W,31,14,23,0.609,1,4,0.25,11,12,0.917,1,1,2,3,0,1,1,2,40,12,1,Brandon Ingram,NOP,WAS,NOP,,,45,42,43,5
22023,1627742,22300301,"DEC 11, 2023",NOP vs. MIN,W,29,5,13,0.385,2,5,0.4,8,9,0.889,0,3,3,5,0,0,4,2,20,13,1,Brandon Ingram,NOP,NOP,MIN,,,28,23,25,8
22023,1627742,22301230,"DEC 07, 2023",NOP @ LAL,L,31,4,13,0.308,0,3,0.0,1,2,0.5,1,2,3,7,0,0,3,3,9,-33,1,Brandon Ingram,NOP,LAL,NOP,,,19,12,16,10
22023,1627742,22301204,"DEC 04, 2023",NOP @ SAC,W,40,10,20,0.5,3,6,0.5,7,9,0.778,2,6,8,6,1,0,2,2,30,3,1,Brandon Ingram,NOP,SAC,NOP,,,44,38,36,14
22023,1627742,22300285,"DEC 02, 2023",NOP @ CHI,L,36,10,15,0.667,0,0,0.0,3,6,0.5,0,6,6,6,3,0,2,1,23,1,1,Brandon Ingram,NOP,CHI,NOP,,,35,29,29,12
22023,1627742,22300278,"DEC 01, 2023",NOP vs. SAS,W,34,3,14,0.214,0,4,0.0,8,8,1.0,0,5,5,7,1,0,4,3,14,10,1,Brandon Ingram,NOP,NOP,SAS,,,26,19,21,12
22023,1627742,22300262,"NOV 29, 2023",NOP vs. PHI,W,35,4,7,0.571,2,4,0.5,5,5,1.0,0,4,4,6,1,1,1,1,15,10,1,Brandon Ingram,NOP,NOP,PHI,,,25,19,21,10
22023,1627742,22300256,"NOV 27, 2023",NOP @ UTA,L,35,11,22,0.5,0,2,0.0,3,4,0.75,0,4,4,5,0,0,2,3,25,4,1,Brandon Ingram,NOP,UTA,NOP,,,34,29,30,9
22023,1627742,22300243,"NOV 25, 2023",NOP @ UTA,L,37,10,22,0.455,1,4,0.25,5,8,0.625,1,5,6,8,1,0,1,4,26,3,1,Brandon Ingram,NOP,UTA,NOP,,,40,32,34,14
22023,1627742,22300052,"NOV 24, 2023",NOP @ LAC,W,35,12,21,0.571,2,5,0.4,4,6,0.667,0,4,4,5,0,0,3,3,30,13,1,Brandon Ingram,NOP,LAC,NOP,,,39,34,35,9
22023,1627742,22300233,"NOV 22, 2023",NOP vs. SAC,W,30,9,18,0.5,1,4,0.25,4,4,1.0,0,4,4,3,1,0,2,5,23,0,1,Brandon Ingram,NOP,NOP,SAC,,,30,27,26,7
22023,1627742,22300222,"NOV 20, 2023",NOP vs. SAC,W,26,11,18,0.611,5,5,1.0,4,4,1.0,0,4,4,3,0,0,1,0,31,33,1,Brandon Ingram,NOP,NOP,SAC,,,38,35,34,7
22023,1627742,22300203,"NOV 18, 2023",NOP vs. MIN,L,34,11,24,0.458,1,6,0.167,7,9,0.778,2,5,7,4,1,0,4,0,30,3,1,Brandon Ingram,NOP,NOP,MIN,,,41,37,34,11
22023,1627742,22300034,"NOV 17, 2023",NOP vs. DEN,W,38,9,19,0.474,2,4,0.5,1,1,1.0,1,2,3,8,1,0,2,3,21,-5,1,Brandon Ingram,NOP,NOP,DEN,,,32,24,29,11
22023,1627742,22300022,"NOV 14, 2023",NOP vs. DAL,W,36,11,20,0.55,1,5,0.2,2,2,1.0,1,8,9,7,2,0,2,0,25,17,1,Brandon Ingram,NOP,NOP,DAL,,,41,34,32,16
22023,1627742,22300183,"NOV 12, 2023",NOP vs. DAL,L,31,9,17,0.529,1,3,0.333,1,4,0.25,0,5,5,5,0,0,1,2,20,-10,1,Brandon Ingram,NOP,NOP,DAL,,,30,25,25,10
22023,1627742,22300011,"NOV 10, 2023",NOP @ HOU,L,39,11,24,0.458,3,11,0.273,6,9,0.667,0,6,6,5,0,1,4,2,31,1,1,Brandon Ingram,NOP,HOU,NOP,,,42,37,36,11
22023,1627742,22300166,"NOV 08, 2023",NOP @ MIN,L,32,11,25,0.44,1,6,0.167,1,1,1.0,0,3,3,6,0,0,2,1,24,-24,1,Brandon Ingram,NOP,MIN,NOP,,,33,27,30,9
22023,1627742,22300156,"NOV 06, 2023",NOP @ DEN,L,36,10,22,0.455,0,4,0.0,2,2,1.0,1,1,2,5,0,0,5,1,22,-29,1,Brandon Ingram,NOP,DEN,NOP,,,29,24,27,7
22023,1627742,22300135,"NOV 04, 2023",NOP vs. ATL,L,32,6,10,0.6,1,3,0.333,3,3,1.0,1,6,7,3,0,1,1,1,16,-10,1,Brandon Ingram,NOP,NOP,ATL,,,26,23,19,10
22023,1627742,22300090,"OCT 28, 2023",NOP vs. NYK,W,32,11,17,0.647,1,3,0.333,3,4,0.75,2,5,7,3,1,0,5,4,26,5,1,Brandon Ingram,NOP,NOP,NYK,,,36,33,29,10
22023,1627742,22300071,"OCT 25, 2023",NOP @ MEM,W,36,7,18,0.389,0,3,0.0,5,6,0.833,0,7,7,6,2,0,5,3,19,-2,1,Brandon Ingram,NOP,MEM,NOP,,,32,26,25,13
22023,202681,22300556,"JAN 15, 2024",DAL vs. NOP,W,41,13,28,0.464,3,9,0.333,13,15,0.867,0,7,7,7,0,1,3,1,42,7,1,Kyrie Irving,DAL,DAL,NOP,,,56,49,49,14
22023,202681,22300547,"JAN 13, 2024",DAL vs. NOP,L,40,12,27,0.444,5,14,0.357,4,4,1.0,0,5,5,6,1,0,1,2,33,-8,1,Kyrie Irving,DAL,DAL,NOP,,,44,38,39,11
22023,202681,22300530,"JAN 11, 2024",DAL vs. NYK,W,40,15,26,0.577,6,10,0.6,8,9,0.889,0,4,4,10,2,0,5,3,44,9,1,Kyrie Irving,DAL,DAL,NYK,,,58,48,54,14
22023,202681,22300515,"JAN 09, 2024",DAL vs. MEM,L,40,11,25,0.44,2,7,0.286,9,10,0.9,4,4,8,4,4,1,3,3,33,-2,1,Kyrie Irving,DAL,DAL,MEM,,,45,41,37,12
22023,202681,22300501,"JAN 07, 2024",DAL vs. MIN,W,39,14,27,0.519,6,8,0.75,1,1,1.0,5,3,8,5,3,2,3,2,35,6,1,Kyrie Irving,DAL,DAL,MIN,,,48,43,40,13
22023,202681,22300487,"JAN 05, 2024",DAL vs. POR,W,29,10,18,0.556,3,7,0.429,1,1,1.0,0,9,9,5,2,2,1,0,24,27,1,Kyrie Irving,DAL,DAL,POR,,,38,33,29,14
22023,202681,22300472,"JAN 03, 2024",DAL vs. POR,W,29,10,19,0.526,4,8,0.5,5,6,0.833,1,8,9,5,2,0,1,0,29,20,1,Kyrie Irving,DAL,DAL,POR,,,43,38,34,14
22023,202681,22300457,"JAN 01, 2024",DAL @ UTA,L,32,6,14,0.429,2,3,0.667,0,1,0.0,1,8,9,4,0,1,1,3,14,-15,1,Kyrie Irving,DAL,UTA,DAL,,,27,23,18,13
22023,202681,22301226,"DEC 08, 2023",DAL @ POR,W,13,4,6,0.667,0,0,0.0,3,3,1.0,0,2,2,2,1,0,0,1,11,-10,1,Kyrie Irving,DAL,POR,DAL,,,15,13,13,4
22023,202681,22301213,"DEC 06, 2023",DAL vs. UTA,W,27,11,16,0.688,4,7,0.571,0,0,0.0,0,3,3,4,3,0,1,2,26,26,1,Kyrie Irving,DAL,DAL,UTA,,,33,29,30,7
22023,202681,22300277,"DEC 01, 2023",DAL vs. MEM,L,36,3,15,0.2,0,5,0.0,4,5,0.8,0,5,5,5,0,0,1,2,10,-6,1,Kyrie Irving,DAL,DAL,MEM,,,20,15,15,10
22023,202681,22300059,"NOV 28, 2023",DAL vs. HOU,W,36,8,22,0.364,2,7,0.286,9,9,1.0,1,1,2,5,1,1,0,1,27,-9,1,Kyrie Irving,DAL,DAL,HOU,,,34,29,32,7
22023,202681,22300244,"NOV 25, 2023",DAL @ LAC,L,32,11,22,0.5,3,7,0.429,1,1,1.0,0,6,6,3,1,0,1,3,26,1,1,Kyrie Irving,DAL,LAC,DAL,,,35,32,29,9
22023,202681,22300238,"NOV 22, 2023",DAL @ LAL,W,35,11,22,0.5,4,8,0.5,2,2,1.0,1,5,6,2,2,0,2,0,28,14,1,Kyrie Irving,DAL,LAL,DAL,,,36,34,30,8
22023,202681,22300212,"NOV 19, 2023",DAL vs. SAC,L,33,8,17,0.471,2,6,0.333,5,5,1.0,0,2,2,1,0,0,1,2,23,-19,1,Kyrie Irving,DAL,DAL,SAC,,,26,25,24,3
22023,202681,22300205,"NOV 18, 2023",DAL @ MIL,L,34,16,29,0.552,3,10,0.3,4,4,1.0,1,3,4,6,1,0,2,4,39,13,1,Kyrie Irving,DAL,MIL,DAL,,,49,43,45,10
22023,202681,22300022,"NOV 14, 2023",DAL @ NOP,L,26,6,13,0.462,3,7,0.429,2,4,0.5,1,1,2,6,0,0,1,1,17,-14,1,Kyrie Irving,DAL,NOP,DAL,,,25,19,23,8
22023,202681,22300183,"NOV 12, 2023",DAL @ NOP,W,29,13,20,0.65,7,10,0.7,2,2,1.0,1,5,6,7,0,1,1,1,35,9,1,Kyrie Irving,DAL,NOP,DAL,,,48,41,42,13
22023,202681,22300014,"NOV 10, 2023",DAL vs. LAC,W,28,8,19,0.421,5,9,0.556,6,6,1.0,3,3,6,3,2,0,2,1,27,12,1,Kyrie Irving,DAL,DAL,LAC,,,36,33,30,9
22023,202681,22300168,"NOV 08, 2023",DAL vs. TOR,L,36,8,19,0.421,3,7,0.429,3,3,1.0,0,4,4,5,0,0,1,2,22,4,1,Kyrie Irving,DAL,DAL,TOR,,,31,26,27,9
22023,202681,22300147,"NOV 06, 2023",DAL @ ORL,W,37,8,20,0.4,2,6,0.333,3,5,0.6,1,5,6,10,3,0,3,2,21,18,1,Kyrie Irving,DAL,ORL,DAL,,,37,27,31,16
22023,202681,22300143,"NOV 05, 2023",DAL vs. CHA,W,34,6,14,0.429,2,6,0.333,4,4,1.0,0,3,3,10,1,1,2,3,18,8,1,Kyrie Irving,DAL,DAL,CHA,,,31,21,28,13
22023,202681,22300006,"NOV 03, 2023",DAL @ DEN,L,35,9,15,0.6,1,5,0.2,3,4,0.75,0,1,1,7,4,2,3,1,22,-12,1,Kyrie Irving,DAL,DEN,DAL,,,30,23,29,8
22023,202681,22300084,"OCT 27, 2023",DAL vs. BKN,W,34,6,17,0.353,1,4,0.25,4,4,1.0,1,6,7,6,0,0,0,2,17,-7,1,Kyrie Irving,DAL,DAL,BKN,,,30,24,23,13
22023,202681,22300073,"OCT 25, 2023",DAL @ SAS,W,36,10,24,0.417,1,8,0.125,1,1,1.0,0,2,2,6,1,0,2,3,22,1,1,Kyrie Irving,DAL,SAS,DAL,,,30,24,28,8
22023,1628371,22300557,"JAN 15, 2024",ORL @ NYK,W,16,2,4,0.5,1,2,0.5,0,0,0.0,1,6,7,0,0,1,0,1,5,15,1,Jonathan Isaac,ORL,NYK,ORL,,,12,12,5,7
22023,1628371,22300546,"JAN 13, 2024",ORL @ OKC,L,15,0,1,0.0,0,0,0.0,6,8,0.75,2,3,5,1,0,0,0,3,6,-7,1,Jonathan Isaac,ORL,OKC,ORL,,,12,11,7,6
22023,1628371,22300391,"DEC 23, 2023",ORL @ IND,W,12,2,3,0.667,0,1,0.0,0,0,0.0,0,1,1,1,0,3,0,0,4,9,1,Jonathan Isaac,ORL,IND,ORL,,,6,5,5,2
22023,1628371,22300378,"DEC 21, 2023",ORL @ MIL,L,14,2,7,0.286,0,0,0.0,0,1,0.0,3,1,4,0,1,3,1,2,4,6,1,Jonathan Isaac,ORL,MIL,ORL,,,8,8,4,4
22023,1628371,22300366,"DEC 20, 2023",ORL vs. MIA,L,12,4,7,0.571,1,2,0.5,0,0,0.0,1,3,4,1,1,0,1,3,9,-10,1,Jonathan Isaac,ORL,ORL,MIA,,,14,13,10,5
22023,1628371,22300344,"DEC 17, 2023",ORL @ BOS,L,17,2,5,0.4,2,4,0.5,2,2,1.0,0,2,2,0,1,1,0,0,8,-17,1,Jonathan Isaac,ORL,BOS,ORL,,,10,10,8,2
22023,1628371,22300329,"DEC 15, 2023",ORL @ BOS,L,16,3,5,0.6,1,2,0.5,0,0,0.0,1,3,4,0,0,0,0,1,7,-13,1,Jonathan Isaac,ORL,BOS,ORL,,,11,11,7,4
22023,1628371,22300294,"DEC 11, 2023",ORL vs. CLE,W,13,3,6,0.5,1,3,0.333,0,0,0.0,1,3,4,0,2,0,0,0,7,8,1,Jonathan Isaac,ORL,ORL,CLE,,,11,11,7,4
22023,1628371,22300274,"DEC 01, 2023",ORL vs. WAS,W,7,1,2,0.5,0,1,0.0,1,1,1.0,1,4,5,0,0,1,0,1,3,10,1,Jonathan Isaac,ORL,ORL,WAS,,,8,8,3,5
22023,1628371,22300043,"NOV 24, 2023",ORL vs. BOS,W,16,1,2,0.5,0,1,0.0,3,4,0.75,3,4,7,0,0,0,0,3,5,17,1,Jonathan Isaac,ORL,ORL,BOS,,,12,12,5,7
22023,1628371,22300226,"NOV 22, 2023",ORL vs. DEN,W,14,4,6,0.667,0,2,0.0,1,1,1.0,2,4,6,1,1,1,1,1,9,6,1,Jonathan Isaac,ORL,ORL,DEN,,,16,15,10,7
22023,1628371,22300038,"NOV 21, 2023",ORL vs. TOR,W,12,4,6,0.667,0,2,0.0,1,2,0.5,1,2,3,0,1,2,2,0,9,9,1,Jonathan Isaac,ORL,ORL,TOR,,,12,12,9,3
22023,1628371,22300209,"NOV 19, 2023",ORL @ IND,W,14,2,5,0.4,0,0,0.0,1,2,0.5,1,2,3,0,1,1,0,1,5,-1,1,Jonathan Isaac,ORL,IND,ORL,,,8,8,5,3
22023,1628371,22300033,"NOV 17, 2023",ORL @ CHI,W,20,6,8,0.75,2,4,0.5,4,4,1.0,3,6,9,1,1,1,1,2,18,10,1,Jonathan Isaac,ORL,CHI,ORL,,,28,27,19,10
22023,1628371,22300196,"NOV 15, 2023",ORL @ CHI,W,17,1,4,0.25,0,1,0.0,2,2,1.0,1,6,7,0,2,2,1,0,4,4,1,Jonathan Isaac,ORL,CHI,ORL,,,11,11,4,7
22023,1628371,22300020,"NOV 14, 2023",ORL @ BKN,L,12,1,4,0.25,1,4,0.25,0,0,0.0,0,3,3,1,2,1,2,1,3,2,1,Jonathan Isaac,ORL,BKN,ORL,,,7,6,4,4
22023,1628371,22300173,"NOV 11, 2023",ORL vs. MIL,W,17,3,10,0.3,2,4,0.5,2,2,1.0,3,2,5,0,2,2,0,4,10,9,1,Jonathan Isaac,ORL,ORL,MIL,,,15,15,10,5
22023,1628371,22300172,"NOV 09, 2023",ORL vs. ATL,L,16,3,8,0.375,1,4,0.25,5,7,0.714,1,6,7,0,0,2,0,1,12,-2,1,Jonathan Isaac,ORL,ORL,ATL,,,19,19,12,7
22023,1628371,22300134,"NOV 04, 2023",ORL vs. LAL,W,11,0,3,0.0,0,2,0.0,0,0,0.0,0,0,0,0,0,1,1,2,0,-7,1,Jonathan Isaac,ORL,ORL,LAL,,,0,0,0,0
22023,1628371,22300130,"NOV 02, 2023",ORL @ UTA,W,12,1,4,0.25,0,3,0.0,1,1,1.0,1,2,3,1,1,3,0,1,3,8,1,Jonathan Isaac,ORL,UTA,ORL,,,7,6,4,4
22023,1628371,22300111,"OCT 30, 2023",ORL @ LAL,L,11,1,3,0.333,1,3,0.333,0,0,0.0,0,3,3,0,1,0,0,1,3,-1,1,Jonathan Isaac,ORL,LAL,ORL,,,6,6,3,3
22023,1628371,22300086,"OCT 27, 2023",ORL @ POR,W,8,0,2,0.0,0,1,0.0,0,0,0.0,0,2,2,1,1,0,0,1,0,-3,1,Jonathan Isaac,ORL,POR,ORL,,,3,2,1,3
22023,1628371,22300066,"OCT 25, 2023",ORL vs. HOU,W,14,4,6,0.667,1,3,0.333,2,3,0.667,1,3,4,0,0,2,2,2,11,12,1,Jonathan Isaac,ORL,ORL,HOU,,,15,15,11,4
22023,1631093,22300558,"JAN 15, 2024",DET @ WAS,W,32,9,18,0.5,2,7,0.286,4,7,0.571,1,6,7,6,0,3,5,0,24,3,1,Jaden Ivey,DET,WAS,DET,,,37,31,30,13
22023,1631093,22300534,"JAN 12, 2024",DET vs. HOU,L,28,8,19,0.421,1,6,0.167,1,4,0.25,5,2,7,8,0,1,3,3,18,7,1,Jaden Ivey,DET,DET,HOU,,,33,25,26,15
22023,1631093,22300519,"JAN 10, 2024",DET vs. SAS,L,30,7,18,0.389,2,10,0.2,3,5,0.6,0,3,3,5,2,2,1,0,19,-5,1,Jaden Ivey,DET,DET,SAS,,,27,22,24,8
22023,1631093,22300512,"JAN 09, 2024",DET vs. SAC,L,33,7,17,0.412,2,9,0.222,6,8,0.75,5,0,5,6,2,0,4,4,22,-15,1,Jaden Ivey,DET,DET,SAC,,,33,27,28,11
22023,1631093,22300502,"JAN 07, 2024",DET @ DEN,L,27,4,11,0.364,0,6,0.0,5,8,0.625,1,3,4,6,1,0,4,2,13,-16,1,Jaden Ivey,DET,DEN,DET,,,23,17,19,10
22023,1631093,22300490,"JAN 05, 2024",DET @ GSW,L,24,5,10,0.5,2,5,0.4,0,0,0.0,2,2,4,3,0,1,4,6,12,-1,1,Jaden Ivey,DET,GSW,DET,,,19,16,15,7
22023,1631093,22300474,"JAN 03, 2024",DET @ UTA,L,22,4,8,0.5,2,3,0.667,1,2,0.5,0,1,1,2,0,0,2,2,11,0,1,Jaden Ivey,DET,UTA,DET,,,14,12,13,3
22023,1631093,22300453,"JAN 01, 2024",DET @ HOU,L,26,6,10,0.6,3,4,0.75,4,4,1.0,4,2,6,3,0,0,2,1,19,-19,1,Jaden Ivey,DET,HOU,DET,,,28,25,22,9
22023,1631093,22300440,"DEC 30, 2023",DET vs. TOR,W,29,1,5,0.2,1,3,0.333,9,12,0.75,4,1,5,4,1,0,1,2,12,3,1,Jaden Ivey,DET,DET,TOR,,,21,17,16,9
22023,1631093,22300421,"DEC 28, 2023",DET @ BOS,L,33,8,15,0.533,3,5,0.6,3,5,0.6,5,5,10,4,0,1,3,6,22,8,1,Jaden Ivey,DET,BOS,DET,,,36,32,26,14
22023,1631093,22300406,"DEC 26, 2023",DET vs. BKN,L,28,3,12,0.25,0,2,0.0,3,6,0.5,2,1,3,4,3,1,1,5,9,12,1,Jaden Ivey,DET,DET,BKN,,,16,12,13,7
22023,1631093,22300394,"DEC 23, 2023",DET @ BKN,L,35,6,11,0.545,3,6,0.5,8,10,0.8,0,6,6,7,0,2,3,4,23,6,1,Jaden Ivey,DET,BKN,DET,,,36,29,30,13
22023,1631093,22300374,"DEC 21, 2023",DET vs. UTA,L,35,9,16,0.563,2,5,0.4,4,4,1.0,2,3,5,7,3,2,5,4,24,5,1,Jaden Ivey,DET,DET,UTA,,,36,29,31,12
22023,1631093,22300352,"DEC 18, 2023",DET @ ATL,L,29,6,13,0.462,0,2,0.0,3,5,0.6,2,6,8,4,0,0,2,6,15,-12,1,Jaden Ivey,DET,ATL,DET,,,27,23,19,12
22023,1631093,22300334,"DEC 16, 2023",DET @ MIL,L,28,5,17,0.294,2,6,0.333,1,2,0.5,1,3,4,2,1,1,1,0,13,-32,1,Jaden Ivey,DET,MIL,DET,,,19,17,15,6
22023,1631093,22300327,"DEC 15, 2023",DET @ PHI,L,29,4,12,0.333,0,2,0.0,5,5,1.0,1,3,4,4,0,0,5,3,13,-6,1,Jaden Ivey,DET,PHI,DET,,,21,17,17,8
22023,1631093,22300310,"DEC 13, 2023",DET vs. PHI,L,21,2,8,0.25,0,3,0.0,3,6,0.5,0,2,2,1,0,1,0,2,7,-21,1,Jaden Ivey,DET,DET,PHI,,,10,9,8,3
22023,1631093,22300293,"DEC 11, 2023",DET vs. IND,L,34,7,15,0.467,0,3,0.0,4,4,1.0,1,2,3,2,1,0,2,2,18,-4,1,Jaden Ivey,DET,DET,IND,,,23,21,20,5
22023,1631093,22301217,"DEC 08, 2023",DET @ ORL,L,21,2,7,0.286,0,4,0.0,4,4,1.0,0,2,2,0,0,0,0,2,8,-14,1,Jaden Ivey,DET,ORL,DET,,,10,10,8,2
22023,1631093,22301206,"DEC 06, 2023",DET vs. MEM,L,24,4,8,0.5,1,3,0.333,0,0,0.0,0,3,3,2,3,2,1,0,9,-10,1,Jaden Ivey,DET,DET,MEM,,,14,12,11,5
22023,1631093,22300283,"DEC 02, 2023",DET vs. CLE,L,29,2,7,0.286,0,3,0.0,3,4,0.75,0,2,2,1,0,0,1,3,7,-1,1,Jaden Ivey,DET,DET,CLE,,,10,9,8,3
22023,1631093,22300268,"NOV 30, 2023",DET @ NYK,L,13,1,2,0.5,1,1,1.0,2,2,1.0,0,2,2,1,0,1,1,3,5,4,1,Jaden Ivey,DET,NYK,DET,,,8,7,6,3
22023,1631093,22300258,"NOV 29, 2023",DET vs. LAL,L,19,1,6,0.167,1,2,0.5,4,4,1.0,0,1,1,3,1,0,1,6,7,-17,1,Jaden Ivey,DET,DET,LAL,,,11,8,10,4
22023,1631093,22300253,"NOV 27, 2023",DET vs. WAS,L,33,6,12,0.5,2,3,0.667,1,2,0.5,2,5,7,7,1,1,3,3,15,2,1,Jaden Ivey,DET,DET,WAS,,,29,22,22,14
22023,1631093,22300047,"NOV 24, 2023",DET @ IND,L,32,9,16,0.563,1,6,0.167,6,9,0.667,2,0,2,3,1,1,3,3,25,-15,1,Jaden Ivey,DET,IND,DET,,,30,27,28,5
22023,1631093,22300218,"NOV 20, 2023",DET vs. DEN,L,30,7,8,0.875,1,1,1.0,2,2,1.0,1,3,4,3,1,0,4,2,17,8,1,Jaden Ivey,DET,DET,DEN,,,24,21,20,7
22023,1631093,22300211,"NOV 19, 2023",DET @ TOR,L,28,3,10,0.3,0,5,0.0,3,4,0.75,0,3,3,4,0,0,0,1,9,0,1,Jaden Ivey,DET,TOR,DET,,,16,12,13,7
22023,1631093,22300030,"NOV 17, 2023",DET @ CLE,L,29,4,6,0.667,1,2,0.5,2,2,1.0,1,1,2,3,1,0,6,3,11,-10,1,Jaden Ivey,DET,CLE,DET,,,16,13,14,5
22023,1631093,22300018,"NOV 14, 2023",DET vs. ATL,L,21,4,7,0.571,1,2,0.5,2,4,0.5,3,2,5,5,1,0,1,1,11,1,1,Jaden Ivey,DET,DET,ATL,,,21,16,16,10
22023,1631093,22300181,"NOV 12, 2023",DET @ CHI,L,11,2,4,0.5,0,2,0.0,2,2,1.0,0,0,0,2,1,0,2,1,6,9,1,Jaden Ivey,DET,CHI,DET,,,8,6,8,2
22023,1631093,22300129,"NOV 02, 2023",DET @ NOP,L,22,4,6,0.667,1,3,0.333,3,4,0.75,3,4,7,0,0,1,2,4,12,-9,1,Jaden Ivey,DET,NOP,DET,,,19,19,12,7
22023,1631093,22300115,"NOV 01, 2023",DET vs. POR,L,22,3,7,0.429,1,3,0.333,3,3,1.0,0,2,2,2,1,1,1,3,10,-14,1,Jaden Ivey,DET,DET,POR,,,14,12,12,4
22023,1631093,22300109,"OCT 30, 2023",DET @ OKC,L,19,7,13,0.538,4,6,0.667,2,2,1.0,1,1,2,3,1,1,1,5,20,-4,1,Jaden Ivey,DET,OKC,DET,,,25,22,23,5
22023,1631093,22300088,"OCT 28, 2023",DET vs. CHI,W,22,3,6,0.5,1,2,0.5,0,0,0.0,0,0,0,3,1,0,2,0,7,5,1,Jaden Ivey,DET,DET,CHI,,,10,7,10,3
22023,1631093,22300077,"OCT 27, 2023",DET @ CHA,W,23,8,14,0.571,2,6,0.333,0,0,0.0,0,2,2,4,1,0,2,4,18,-2,1,Jaden Ivey,DET,CHA,DET,,,24,20,22,6
22023,1631093,22300068,"OCT 25, 2023",DET @ MIA,L,17,1,7,0.143,0,2,0.0,2,3,0.667,0,2,2,3,0,0,3,3,4,-2,1,Jaden Ivey,DET,MIA,DET,,,9,6,7,5
22023,1641713,22300560,"JAN 15, 2024",MEM vs. GSW,W,29,6,9,0.667,5,8,0.625,6,8,0.75,1,5,6,1,2,2,2,3,23,23,1,GG Jackson,MEM,MEM,GSW,,,30,29,24,7
22023,1641713,22300544,"JAN 13, 2024",MEM vs. NYK,L,27,9,14,0.643,2,4,0.5,0,0,0.0,2,4,6,1,0,2,2,0,20,2,1,GG Jackson,MEM,MEM,NYK,,,27,26,21,7
22023,1641713,22300537,"JAN 12, 2024",MEM vs. LAC,L,9,1,5,0.2,0,1,0.0,2,3,0.667,3,2,5,1,0,0,0,1,4,8,1,GG Jackson,MEM,MEM,LAC,,,10,9,5,6
22023,1641713,22300515,"JAN 09, 2024",MEM @ DAL,W,2,0,2,0.0,0,1,0.0,0,0,0.0,0,0,0,0,0,0,0,0,0,-3,1,GG Jackson,MEM,DAL,MEM,,,0,0,0,0
22023,1641713,22300355,"DEC 18, 2023",MEM @ OKC,L,12,3,6,0.5,2,3,0.667,0,0,0.0,0,0,0,0,0,1,0,2,8,9,1,GG Jackson,MEM,OKC,MEM,,,8,8,8,0
22023,1641713,22300044,"NOV 24, 2023",MEM vs. PHX,L,2,0,1,0.0,0,1,0.0,0,0,0.0,0,0,0,0,1,0,1,0,0,-4,1,GG Jackson,MEM,MEM,PHX,,,0,0,0,0
22023,1641713,22300231,"NOV 22, 2023",MEM @ HOU,L,4,0,3,0.0,0,1,0.0,0,0,0.0,1,2,3,0,0,0,0,0,0,3,1,GG Jackson,MEM,HOU,MEM,,,3,3,0,3
22023,1641713,22300106,"OCT 30, 2023",MEM vs. DAL,L,1,0,0,0.0,0,0,0.0,0,0,0.0,0,0,0,0,0,0,0,0,0,0,1,GG Jackson,MEM,MEM,DAL,,,0,0,0,0
22023,1630543,22300564,"JAN 15, 2024",IND @ UTA,L,8,0,2,0.0,0,0,0.0,1,2,0.5,1,3,4,1,0,1,1,4,1,-5,1,Isaiah Jackson,IND,UTA,IND,,,6,5,2,5
22023,1630543,22300550,"JAN 14, 2024",IND @ DEN,L,20,6,9,0.667,0,0,0.0,0,0,0.0,3,4,7,1,2,0,2,3,12,-3,1,Isaiah Jackson,IND,DEN,IND,,,20,19,13,8
22023,1630543,22300533,"JAN 12, 2024",IND @ ATL,W,18,6,7,0.857,0,0,0.0,0,0,0.0,1,4,5,2,4,3,2,3,12,11,1,Isaiah Jackson,IND,ATL,IND,,,19,17,14,7
22023,1630543,22300520,"JAN 10, 2024",IND vs. WAS,W,17,4,4,1.0,0,0,0.0,4,6,0.667,2,1,3,1,1,3,2,3,12,4,1,Isaiah Jackson,IND,IND,WAS,,,16,15,13,4
22023,1630543,22300507,"JAN 08, 2024",IND vs. BOS,W,7,0,0,0.0,0,0,0.0,0,0,0.0,1,1,2,0,0,2,0,1,0,-2,1,Isaiah Jackson,IND,IND,BOS,,,2,2,0,2
22023,1630543,22300493,"JAN 06, 2024",IND vs. BOS,L,9,2,3,0.667,0,0,0.0,0,0,0.0,1,2,3,0,0,0,0,4,4,-8,1,Isaiah Jackson,IND,IND,BOS,,,7,7,4,3
22023,1630543,22300480,"JAN 05, 2024",IND vs. ATL,W,7,1,2,0.5,0,0,0.0,0,2,0.0,1,2,3,0,0,0,1,3,2,12,1,Isaiah Jackson,IND,IND,ATL,,,5,5,2,3
22023,1630543,22300466,"JAN 03, 2024",IND vs. MIL,W,18,4,6,0.667,0,0,0.0,1,1,1.0,2,2,4,3,1,0,1,3,9,-3,1,Isaiah Jackson,IND,IND,MIL,,,16,13,12,7
22023,1630543,22300454,"JAN 01, 2024",IND @ MIL,W,20,6,9,0.667,0,0,0.0,6,7,0.857,2,7,9,1,1,0,2,5,18,29,1,Isaiah Jackson,IND,MIL,IND,,,28,27,19,10
22023,1630543,22300441,"DEC 30, 2023",IND vs. NYK,W,9,1,1,1.0,0,0,0.0,0,0,0.0,0,1,1,0,0,1,1,2,2,-2,1,Isaiah Jackson,IND,IND,NYK,,,3,3,2,1
22023,1630543,22300422,"DEC 28, 2023",IND @ CHI,W,11,1,1,1.0,0,0,0.0,1,3,0.333,0,0,0,1,1,0,1,0,3,-5,1,Isaiah Jackson,IND,CHI,IND,,,4,3,4,1
22023,1630543,22300409,"DEC 26, 2023",IND @ HOU,W,20,3,3,1.0,0,0,0.0,5,5,1.0,3,5,8,0,1,3,1,3,11,3,1,Isaiah Jackson,IND,HOU,IND,,,19,19,11,8
22023,1630543,22300391,"DEC 23, 2023",IND vs. ORL,L,6,0,2,0.0,0,0,0.0,0,0,0.0,2,1,3,0,0,0,0,4,0,-8,1,Isaiah Jackson,IND,IND,ORL,,,3,3,0,3
22023,1630543,22300377,"DEC 21, 2023",IND @ MEM,L,12,1,2,0.5,0,0,0.0,0,0,0.0,1,2,3,0,0,1,0,2,2,-11,1,Isaiah Jackson,IND,MEM,IND,,,5,5,2,3
22023,1630543,22300365,"DEC 20, 2023",IND vs. CHA,W,15,4,7,0.571,0,1,0.0,2,3,0.667,1,2,3,1,1,2,1,3,10,9,1,Isaiah Jackson,IND,IND,CHA,,,14,13,11,4
22023,1630543,22300350,"DEC 18, 2023",IND vs. LAC,L,25,6,9,0.667,0,0,0.0,3,5,0.6,2,2,4,2,0,1,0,1,15,-21,1,Isaiah Jackson,IND,IND,LAC,,,21,19,17,6
22023,1630543,22300338,"DEC 16, 2023",IND @ MIN,L,20,6,6,1.0,0,0,0.0,0,0,0.0,1,2,3,4,3,2,1,3,12,-11,1,Isaiah Jackson,IND,MIN,IND,,,19,15,16,7
22023,1630543,22300328,"DEC 15, 2023",IND @ WAS,L,20,10,13,0.769,0,0,0.0,0,0,0.0,6,7,13,1,0,1,1,5,20,0,1,Isaiah Jackson,IND,WAS,IND,,,34,33,21,14
22023,1630543,22300315,"DEC 13, 2023",IND @ MIL,L,13,3,4,0.75,0,0,0.0,3,4,0.75,0,3,3,1,1,2,1,3,9,-4,1,Isaiah Jackson,IND,MIL,IND,,,13,12,10,4
22023,1630543,22300293,"DEC 11, 2023",IND @ DET,W,17,5,6,0.833,0,0,0.0,0,0,0.0,2,3,5,0,0,0,0,3,10,-4,1,Isaiah Jackson,IND,DET,IND,,,15,15,10,5
22023,1630543,22301229,"DEC 07, 2023",IND @ MIL,W,16,5,7,0.714,0,0,0.0,1,1,1.0,1,5,6,0,1,0,1,1,11,14,1,Isaiah Jackson,IND,MIL,IND,,,17,17,11,6
22023,1630543,22300284,"DEC 02, 2023",IND @ MIA,W,8,3,3,1.0,0,0,0.0,2,2,1.0,0,3,3,1,0,1,0,1,8,-6,1,Isaiah Jackson,IND,MIA,IND,,,12,11,9,4
22023,1630543,22300267,"NOV 30, 2023",IND @ MIA,L,6,0,0,0.0,0,0,0.0,0,0,0.0,0,1,1,1,1,0,0,3,0,-2,1,Isaiah Jackson,IND,MIA,IND,,,2,1,1,2
22023,1630543,22300254,"NOV 27, 2023",IND vs. POR,L,10,1,2,0.5,0,0,0.0,0,0,0.0,1,4,5,1,0,1,1,3,2,1,1,Isaiah Jackson,IND,IND,POR,,,8,7,3,6
22023,1630543,22300047,"NOV 24, 2023",IND vs. DET,W,19,3,8,0.375,0,1,0.0,2,2,1.0,4,2,6,1,0,3,1,4,8,5,1,Isaiah Jackson,IND,IND,DET,,,15,14,9,7
22023,1630543,22300039,"NOV 21, 2023",IND @ ATL,W,12,1,1,1.0,0,0,0.0,0,0,0.0,1,4,5,1,0,4,1,5,2,8,1,Isaiah Jackson,IND,ATL,IND,,,8,7,3,6
22023,1630543,22300209,"NOV 19, 2023",IND vs. ORL,L,12,1,2,0.5,0,0,0.0,4,6,0.667,1,2,3,1,3,1,0,2,6,17,1,Isaiah Jackson,IND,IND,ORL,,,10,9,7,4
22023,1630543,22300019,"NOV 14, 2023",IND @ PHI,W,17,1,4,0.25,0,0,0.0,5,8,0.625,5,4,9,2,0,1,1,4,7,-2,1,Isaiah Jackson,IND,PHI,IND,,,18,16,9,11
22023,1630543,22300171,"NOV 09, 2023",IND vs. MIL,W,11,1,2,0.5,0,0,0.0,1,2,0.5,1,2,3,0,1,2,0,3,3,-12,1,Isaiah Jackson,IND,IND,MIL,,,6,6,3,3
22023,1630543,22300146,"NOV 06, 2023",IND vs. SAS,W,15,3,3,1.0,0,0,0.0,1,1,1.0,2,1,3,1,0,2,0,5,7,12,1,Isaiah Jackson,IND,IND,SAS,,,11,10,8,4
22023,1630543,22300118,"NOV 01, 2023",IND @ BOS,L,19,3,5,0.6,0,0,0.0,1,2,0.5,0,3,3,1,0,4,1,1,7,-18,1,Isaiah Jackson,IND,BOS,IND,,,11,10,8,4
22023,1630543,22300064,"OCT 25, 2023",IND vs. WAS,W,11,2,4,0.5,0,0,0.0,0,0,0.0,1,3,4,0,0,0,0,2,4,3,1,Isaiah Jackson,IND,IND,WAS,,,8,8,4,4
22023,202704,22300550,"JAN 14, 2024",DEN vs. IND,W,23,3,3,1.0,0,0,0.0,3,4,0.75,0,0,0,4,1,0,3,1,9,4,1,Reggie Jackson,DEN,DEN,IND,8.5,Points,13,9,13,4
22023,202704,22300550,"JAN 14, 2024",DEN vs. IND,W,23,3,3,1.0,0,0,0.0,3,4,0.75,0,0,0,4,1,0,3,1,9,4,1,Reggie Jackson,DEN,DEN,IND,10.5,Pts+Rebs,13,9,13,4
22023,202704,22300550,"JAN 14, 2024",DEN vs. IND,W,23,3,3,1.0,0,0,0.0,3,4,0.75,0,0,0,4,1,0,3,1,9,4,1,Reggie Jackson,DEN,DEN,IND,12.5,Pts+Asts,13,9,13,4
22023,202704,22300550,"JAN 14, 2024",DEN vs. IND,W,23,3,3,1.0,0,0,0.0,3,4,0.75,0,0,0,4,1,0,3,1,9,4,1,Reggie Jackson,DEN,DEN,IND,0.5,Blks+Stls,13,9,13,4
22023,202704,22300539,"JAN 12, 2024",DEN vs. NOP,W,24,5,10,0.5,2,5,0.4,0,0,0.0,0,2,2,0,1,0,3,1,12,4,1,Reggie Jackson,DEN,DEN,NOP,8.5,Points,14,14,12,2
22023,202704,22300539,"JAN 12, 2024",DEN vs. NOP,W,24,5,10,0.5,2,5,0.4,0,0,0.0,0,2,2,0,1,0,3,1,12,4,1,Reggie Jackson,DEN,DEN,NOP,10.5,Pts+Rebs,14,14,12,2
22023,202704,22300539,"JAN 12, 2024",DEN vs. NOP,W,24,5,10,0.5,2,5,0.4,0,0,0.0,0,2,2,0,1,0,3,1,12,4,1,Reggie Jackson,DEN,DEN,NOP,12.5,Pts+Asts,14,14,12,2
22023,202704,22300539,"JAN 12, 2024",DEN vs. NOP,W,24,5,10,0.5,2,5,0.4,0,0,0.0,0,2,2,0,1,0,3,1,12,4,1,Reggie Jackson,DEN,DEN,NOP,0.5,Blks+Stls,14,14,12,2
22023,202704,22300524,"JAN 10, 2024",DEN @ UTA,L,20,2,7,0.286,1,4,0.25,0,0,0.0,0,0,0,2,0,0,0,2,5,3,1,Reggie Jackson,DEN,UTA,DEN,8.5,Points,7,5,7,2
22023,202704,22300524,"JAN 10, 2024",DEN @ UTA,L,20,2,7,0.286,1,4,0.25,0,0,0.0,0,0,0,2,0,0,0,2,5,3,1,Reggie Jackson,DEN,UTA,DEN,10.5,Pts+Rebs,7,5,7,2
22023,202704,22300524,"JAN 10, 2024",DEN @ UTA,L,20,2,7,0.286,1,4,0.25,0,0,0.0,0,0,0,2,0,0,0,2,5,3,1,Reggie Jackson,DEN,UTA,DEN,12.5,Pts+Asts,7,5,7,2
22023,202704,22300524,"JAN 10, 2024",DEN @ UTA,L,20,2,7,0.286,1,4,0.25,0,0,0.0,0,0,0,2,0,0,0,2,5,3,1,Reggie Jackson,DEN,UTA,DEN,0.5,Blks+Stls,7,5,7,2
22023,202704,22300502,"JAN 07, 2024",DEN vs. DET,W,21,5,7,0.714,1,1,1.0,2,2,1.0,2,1,3,9,1,0,1,5,13,14,1,Reggie Jackson,DEN,DEN,DET,8.5,Points,25,16,22,12
22023,202704,22300502,"JAN 07, 2024",DEN vs. DET,W,21,5,7,0.714,1,1,1.0,2,2,1.0,2,1,3,9,1,0,1,5,13,14,1,Reggie Jackson,DEN,DEN,DET,10.5,Pts+Rebs,25,16,22,12
22023,202704,22300502,"JAN 07, 2024",DEN vs. DET,W,21,5,7,0.714,1,1,1.0,2,2,1.0,2,1,3,9,1,0,1,5,13,14,1,Reggie Jackson,DEN,DEN,DET,12.5,Pts+Asts,25,16,22,12
22023,202704,22300502,"JAN 07, 2024",DEN vs. DET,W,21,5,7,0.714,1,1,1.0,2,2,1.0,2,1,3,9,1,0,1,5,13,14,1,Reggie Jackson,DEN,DEN,DET,0.5,Blks+Stls,25,16,22,12
22023,202704,22300488,"JAN 05, 2024",DEN vs. ORL,L,17,5,12,0.417,1,5,0.2,0,0,0.0,1,2,3,3,0,0,1,0,11,1,1,Reggie Jackson,DEN,DEN,ORL,8.5,Points,17,14,14,6
22023,202704,22300488,"JAN 05, 2024",DEN vs. ORL,L,17,5,12,0.417,1,5,0.2,0,0,0.0,1,2,3,3,0,0,1,0,11,1,1,Reggie Jackson,DEN,DEN,ORL,10.5,Pts+Rebs,17,14,14,6
22023,202704,22300488,"JAN 05, 2024",DEN vs. ORL,L,17,5,12,0.417,1,5,0.2,0,0,0.0,1,2,3,3,0,0,1,0,11,1,1,Reggie Jackson,DEN,DEN,ORL,12.5,Pts+Asts,17,14,14,6
22023,202704,22300488,"JAN 05, 2024",DEN vs. ORL,L,17,5,12,0.417,1,5,0.2,0,0,0.0,1,2,3,3,0,0,1,0,11,1,1,Reggie Jackson,DEN,DEN,ORL,0.5,Blks+Stls,17,14,14,6
22023,202704,22300478,"JAN 04, 2024",DEN @ GSW,W,16,1,6,0.167,0,0,0.0,0,0,0.0,0,0,0,3,0,0,1,0,2,-6,1,Reggie Jackson,DEN,GSW,DEN,8.5,Points,5,2,5,3
22023,202704,22300478,"JAN 04, 2024",DEN @ GSW,W,16,1,6,0.167,0,0,0.0,0,0,0.0,0,0,0,3,0,0,1,0,2,-6,1,Reggie Jackson,DEN,GSW,DEN,10.5,Pts+Rebs,5,2,5,3
22023,202704,22300478,"JAN 04, 2024",DEN @ GSW,W,16,1,6,0.167,0,0,0.0,0,0,0.0,0,0,0,3,0,0,1,0,2,-6,1,Reggie Jackson,DEN,GSW,DEN,12.5,Pts+Asts,5,2,5,3
22023,202704,22300478,"JAN 04, 2024",DEN @ GSW,W,16,1,6,0.167,0,0,0.0,0,0,0.0,0,0,0,3,0,0,1,0,2,-6,1,Reggie Jackson,DEN,GSW,DEN,0.5,Blks+Stls,5,2,5,3
22023,202704,22300455,"JAN 01, 2024",DEN vs. CHA,W,17,6,11,0.545,2,3,0.667,1,2,0.5,0,4,4,4,1,0,0,2,15,-2,1,Reggie Jackson,DEN,DEN,CHA,8.5,Points,23,19,19,8
22023,202704,22300455,"JAN 01, 2024",DEN vs. CHA,W,17,6,11,0.545,2,3,0.667,1,2,0.5,0,4,4,4,1,0,0,2,15,-2,1,Reggie Jackson,DEN,DEN,CHA,10.5,Pts+Rebs,23,19,19,8
22023,202704,22300455,"JAN 01, 2024",DEN vs. CHA,W,17,6,11,0.545,2,3,0.667,1,2,0.5,0,4,4,4,1,0,0,2,15,-2,1,Reggie Jackson,DEN,DEN,CHA,12.5,Pts+Asts,23,19,19,8
22023,202704,22300455,"JAN 01, 2024",DEN vs. CHA,W,17,6,11,0.545,2,3,0.667,1,2,0.5,0,4,4,4,1,0,0,2,15,-2,1,Reggie Jackson,DEN,DEN,CHA,0.5,Blks+Stls,23,19,19,8
22023,202704,22300435,"DEC 29, 2023",DEN vs. OKC,L,15,3,10,0.3,2,5,0.4,0,0,0.0,0,2,2,3,1,0,0,0,8,1,1,Reggie Jackson,DEN,DEN,OKC,8.5,Points,13,10,11,5
22023,202704,22300435,"DEC 29, 2023",DEN vs. OKC,L,15,3,10,0.3,2,5,0.4,0,0,0.0,0,2,2,3,1,0,0,0,8,1,1,Reggie Jackson,DEN,DEN,OKC,10.5,Pts+Rebs,13,10,11,5
22023,202704,22300435,"DEC 29, 2023",DEN vs. OKC,L,15,3,10,0.3,2,5,0.4,0,0,0.0,0,2,2,3,1,0,0,0,8,1,1,Reggie Jackson,DEN,DEN,OKC,12.5,Pts+Asts,13,10,11,5
22023,202704,22300435,"DEC 29, 2023",DEN vs. OKC,L,15,3,10,0.3,2,5,0.4,0,0,0.0,0,2,2,3,1,0,0,0,8,1,1,Reggie Jackson,DEN,DEN,OKC,0.5,Blks+Stls,13,10,11,5
22023,202704,22300425,"DEC 28, 2023",DEN vs. MEM,W,17,3,7,0.429,1,1,1.0,2,2,1.0,1,1,2,7,1,0,3,1,9,15,1,Reggie Jackson,DEN,DEN,MEM,8.5,Points,18,11,16,9
22023,202704,22300425,"DEC 28, 2023",DEN vs. MEM,W,17,3,7,0.429,1,1,1.0,2,2,1.0,1,1,2,7,1,0,3,1,9,15,1,Reggie Jackson,DEN,DEN,MEM,10.5,Pts+Rebs,18,11,16,9
22023,202704,22300425,"DEC 28, 2023",DEN vs. MEM,W,17,3,7,0.429,1,1,1.0,2,2,1.0,1,1,2,7,1,0,3,1,9,15,1,Reggie Jackson,DEN,DEN,MEM,12.5,Pts+Asts,18,11,16,9
22023,202704,22300425,"DEC 28, 2023",DEN vs. MEM,W,17,3,7,0.429,1,1,1.0,2,2,1.0,1,1,2,7,1,0,3,1,9,15,1,Reggie Jackson,DEN,DEN,MEM,0.5,Blks+Stls,18,11,16,9
22023,202704,22300402,"DEC 25, 2023",DEN vs. GSW,W,15,0,2,0.0,0,0,0.0,2,2,1.0,0,0,0,3,0,0,4,1,2,-14,1,Reggie Jackson,DEN,DEN,GSW,8.5,Points,5,2,5,3
22023,202704,22300402,"DEC 25, 2023",DEN vs. GSW,W,15,0,2,0.0,0,0,0.0,2,2,1.0,0,0,0,3,0,0,4,1,2,-14,1,Reggie Jackson,DEN,DEN,GSW,10.5,Pts+Rebs,5,2,5,3
22023,202704,22300402,"DEC 25, 2023",DEN vs. GSW,W,15,0,2,0.0,0,0,0.0,2,2,1.0,0,0,0,3,0,0,4,1,2,-14,1,Reggie Jackson,DEN,DEN,GSW,12.5,Pts+Asts,5,2,5,3
22023,202704,22300402,"DEC 25, 2023",DEN vs. GSW,W,15,0,2,0.0,0,0,0.0,2,2,1.0,0,0,0,3,0,0,4,1,2,-14,1,Reggie Jackson,DEN,DEN,GSW,0.5,Blks+Stls,5,2,5,3
22023,202704,22300390,"DEC 23, 2023",DEN @ CHA,W,15,1,9,0.111,0,3,0.0,0,0,0.0,0,3,3,4,1,0,2,3,2,0,1,Reggie Jackson,DEN,CHA,DEN,8.5,Points,9,5,6,7
22023,202704,22300390,"DEC 23, 2023",DEN @ CHA,W,15,1,9,0.111,0,3,0.0,0,0,0.0,0,3,3,4,1,0,2,3,2,0,1,Reggie Jackson,DEN,CHA,DEN,10.5,Pts+Rebs,9,5,6,7
22023,202704,22300390,"DEC 23, 2023",DEN @ CHA,W,15,1,9,0.111,0,3,0.0,0,0,0.0,0,3,3,4,1,0,2,3,2,0,1,Reggie Jackson,DEN,CHA,DEN,12.5,Pts+Asts,9,5,6,7
22023,202704,22300390,"DEC 23, 2023",DEN @ CHA,W,15,1,9,0.111,0,3,0.0,0,0,0.0,0,3,3,4,1,0,2,3,2,0,1,Reggie Jackson,DEN,CHA,DEN,0.5,Blks+Stls,9,5,6,7
22023,202704,22300383,"DEC 22, 2023",DEN @ BKN,W,16,4,13,0.308,0,5,0.0,0,0,0.0,0,2,2,3,0,0,1,4,8,-15,1,Reggie Jackson,DEN,BKN,DEN,8.5,Points,13,10,11,5
22023,202704,22300383,"DEC 22, 2023",DEN @ BKN,W,16,4,13,0.308,0,5,0.0,0,0,0.0,0,2,2,3,0,0,1,4,8,-15,1,Reggie Jackson,DEN,BKN,DEN,10.5,Pts+Rebs,13,10,11,5
22023,202704,22300383,"DEC 22, 2023",DEN @ BKN,W,16,4,13,0.308,0,5,0.0,0,0,0.0,0,2,2,3,0,0,1,4,8,-15,1,Reggie Jackson,DEN,BKN,DEN,12.5,Pts+Asts,13,10,11,5
22023,202704,22300383,"DEC 22, 2023",DEN @ BKN,W,16,4,13,0.308,0,5,0.0,0,0,0.0,0,2,2,3,0,0,1,4,8,-15,1,Reggie Jackson,DEN,BKN,DEN,0.5,Blks+Stls,13,10,11,5
22023,202704,22300369,"DEC 20, 2023",DEN @ TOR,W,17,3,7,0.429,0,3,0.0,1,2,0.5,1,1,2,4,0,0,1,1,7,-5,1,Reggie Jackson,DEN,TOR,DEN,8.5,Points,13,9,11,6
22023,202704,22300369,"DEC 20, 2023",DEN @ TOR,W,17,3,7,0.429,0,3,0.0,1,2,0.5,1,1,2,4,0,0,1,1,7,-5,1,Reggie Jackson,DEN,TOR,DEN,10.5,Pts+Rebs,13,9,11,6
22023,202704,22300369,"DEC 20, 2023",DEN @ TOR,W,17,3,7,0.429,0,3,0.0,1,2,0.5,1,1,2,4,0,0,1,1,7,-5,1,Reggie Jackson,DEN,TOR,DEN,12.5,Pts+Asts,13,9,11,6
22023,202704,22300369,"DEC 20, 2023",DEN @ TOR,W,17,3,7,0.429,0,3,0.0,1,2,0.5,1,1,2,4,0,0,1,1,7,-5,1,Reggie Jackson,DEN,TOR,DEN,0.5,Blks+Stls,13,9,11,6
22023,202704,22300356,"DEC 18, 2023",DEN vs. DAL,W,19,9,12,0.75,1,3,0.333,1,1,1.0,0,1,1,4,0,0,0,2,20,14,1,Reggie Jackson,DEN,DEN,DAL,8.5,Points,25,21,24,5
22023,202704,22300356,"DEC 18, 2023",DEN vs. DAL,W,19,9,12,0.75,1,3,0.333,1,1,1.0,0,1,1,4,0,0,0,2,20,14,1,Reggie Jackson,DEN,DEN,DAL,10.5,Pts+Rebs,25,21,24,5
22023,202704,22300356,"DEC 18, 2023",DEN vs. DAL,W,19,9,12,0.75,1,3,0.333,1,1,1.0,0,1,1,4,0,0,0,2,20,14,1,Reggie Jackson,DEN,DEN,DAL,12.5,Pts+Asts,25,21,24,5
22023,202704,22300356,"DEC 18, 2023",DEN vs. DAL,W,19,9,12,0.75,1,3,0.333,1,1,1.0,0,1,1,4,0,0,0,2,20,14,1,Reggie Jackson,DEN,DEN,DAL,0.5,Blks+Stls,25,21,24,5
22023,202704,22300340,"DEC 16, 2023",DEN vs. OKC,L,22,3,10,0.3,1,4,0.25,0,0,0.0,1,2,3,3,0,0,1,4,7,4,1,Reggie Jackson,DEN,DEN,OKC,8.5,Points,13,10,10,6
22023,202704,22300340,"DEC 16, 2023",DEN vs. OKC,L,22,3,10,0.3,1,4,0.25,0,0,0.0,1,2,3,3,0,0,1,4,7,4,1,Reggie Jackson,DEN,DEN,OKC,10.5,Pts+Rebs,13,10,10,6
22023,202704,22300340,"DEC 16, 2023",DEN vs. OKC,L,22,3,10,0.3,1,4,0.25,0,0,0.0,1,2,3,3,0,0,1,4,7,4,1,Reggie Jackson,DEN,DEN,OKC,12.5,Pts+Asts,13,10,10,6
22023,202704,22300340,"DEC 16, 2023",DEN vs. OKC,L,22,3,10,0.3,1,4,0.25,0,0,0.0,1,2,3,3,0,0,1,4,7,4,1,Reggie Jackson,DEN,DEN,OKC,0.5,Blks+Stls,13,10,10,6
22023,202704,22300322,"DEC 14, 2023",DEN vs. BKN,W,23,4,13,0.308,2,4,0.5,2,2,1.0,0,0,0,4,2,0,1,3,12,8,1,Reggie Jackson,DEN,DEN,BKN,8.5,Points,16,12,16,4
22023,202704,22300322,"DEC 14, 2023",DEN vs. BKN,W,23,4,13,0.308,2,4,0.5,2,2,1.0,0,0,0,4,2,0,1,3,12,8,1,Reggie Jackson,DEN,DEN,BKN,10.5,Pts+Rebs,16,12,16,4
22023,202704,22300322,"DEC 14, 2023",DEN vs. BKN,W,23,4,13,0.308,2,4,0.5,2,2,1.0,0,0,0,4,2,0,1,3,12,8,1,Reggie Jackson,DEN,DEN,BKN,12.5,Pts+Asts,16,12,16,4
22023,202704,22300322,"DEC 14, 2023",DEN vs. BKN,W,23,4,13,0.308,2,4,0.5,2,2,1.0,0,0,0,4,2,0,1,3,12,8,1,Reggie Jackson,DEN,DEN,BKN,0.5,Blks+Stls,16,12,16,4
22023,202704,22300307,"DEC 12, 2023",DEN @ CHI,W,32,9,16,0.563,5,8,0.625,2,2,1.0,0,2,2,6,0,0,2,4,25,13,1,Reggie Jackson,DEN,CHI,DEN,8.5,Points,33,27,31,8
22023,202704,22300307,"DEC 12, 2023",DEN @ CHI,W,32,9,16,0.563,5,8,0.625,2,2,1.0,0,2,2,6,0,0,2,4,25,13,1,Reggie Jackson,DEN,CHI,DEN,10.5,Pts+Rebs,33,27,31,8
22023,202704,22300307,"DEC 12, 2023",DEN @ CHI,W,32,9,16,0.563,5,8,0.625,2,2,1.0,0,2,2,6,0,0,2,4,25,13,1,Reggie Jackson,DEN,CHI,DEN,12.5,Pts+Asts,33,27,31,8
22023,202704,22300307,"DEC 12, 2023",DEN @ CHI,W,32,9,16,0.563,5,8,0.625,2,2,1.0,0,2,2,6,0,0,2,4,25,13,1,Reggie Jackson,DEN,CHI,DEN,0.5,Blks+Stls,33,27,31,8
22023,202704,22300296,"DEC 11, 2023",DEN @ ATL,W,19,5,10,0.5,1,5,0.2,1,1,1.0,0,1,1,6,0,0,1,0,12,-5,1,Reggie Jackson,DEN,ATL,DEN,8.5,Points,19,13,18,7
22023,202704,22300296,"DEC 11, 2023",DEN @ ATL,W,19,5,10,0.5,1,5,0.2,1,1,1.0,0,1,1,6,0,0,1,0,12,-5,1,Reggie Jackson,DEN,ATL,DEN,10.5,Pts+Rebs,19,13,18,7
22023,202704,22300296,"DEC 11, 2023",DEN @ ATL,W,19,5,10,0.5,1,5,0.2,1,1,1.0,0,1,1,6,0,0,1,0,12,-5,1,Reggie Jackson,DEN,ATL,DEN,12.5,Pts+Asts,19,13,18,7
22023,202704,22300296,"DEC 11, 2023",DEN @ ATL,W,19,5,10,0.5,1,5,0.2,1,1,1.0,0,1,1,6,0,0,1,0,12,-5,1,Reggie Jackson,DEN,ATL,DEN,0.5,Blks+Stls,19,13,18,7
22023,202704,22301224,"DEC 08, 2023",DEN vs. HOU,L,25,2,8,0.25,0,4,0.0,2,2,1.0,1,2,3,6,0,0,0,2,6,4,1,Reggie Jackson,DEN,DEN,HOU,8.5,Points,15,9,12,9
22023,202704,22301224,"DEC 08, 2023",DEN vs. HOU,L,25,2,8,0.25,0,4,0.0,2,2,1.0,1,2,3,6,0,0,0,2,6,4,1,Reggie Jackson,DEN,DEN,HOU,10.5,Pts+Rebs,15,9,12,9
22023,202704,22301224,"DEC 08, 2023",DEN vs. HOU,L,25,2,8,0.25,0,4,0.0,2,2,1.0,1,2,3,6,0,0,0,2,6,4,1,Reggie Jackson,DEN,DEN,HOU,12.5,Pts+Asts,15,9,12,9
22023,202704,22301224,"DEC 08, 2023",DEN vs. HOU,L,25,2,8,0.25,0,4,0.0,2,2,1.0,1,2,3,6,0,0,0,2,6,4,1,Reggie Jackson,DEN,DEN,HOU,0.5,Blks+Stls,15,9,12,9
22023,202704,22301215,"DEC 06, 2023",DEN @ LAC,L,19,4,10,0.4,3,4,0.75,3,4,0.75,0,1,1,3,1,0,2,1,14,-11,1,Reggie Jackson,DEN,LAC,DEN,8.5,Points,18,15,17,4
22023,202704,22301215,"DEC 06, 2023",DEN @ LAC,L,19,4,10,0.4,3,4,0.75,3,4,0.75,0,1,1,3,1,0,2,1,14,-11,1,Reggie Jackson,DEN,LAC,DEN,10.5,Pts+Rebs,18,15,17,4
22023,202704,22301215,"DEC 06, 2023",DEN @ LAC,L,19,4,10,0.4,3,4,0.75,3,4,0.75,0,1,1,3,1,0,2,1,14,-11,1,Reggie Jackson,DEN,LAC,DEN,12.5,Pts+Asts,18,15,17,4
22023,202704,22301215,"DEC 06, 2023",DEN @ LAC,L,19,4,10,0.4,3,4,0.75,3,4,0.75,0,1,1,3,1,0,2,1,14,-11,1,Reggie Jackson,DEN,LAC,DEN,0.5,Blks+Stls,18,15,17,4
22023,202704,22300290,"DEC 02, 2023",DEN @ SAC,L,33,9,18,0.5,2,6,0.333,0,0,0.0,0,1,1,8,1,0,2,3,20,-14,1,Reggie Jackson,DEN,SAC,DEN,8.5,Points,29,21,28,9
22023,202704,22300290,"DEC 02, 2023",DEN @ SAC,L,33,9,18,0.5,2,6,0.333,0,0,0.0,0,1,1,8,1,0,2,3,20,-14,1,Reggie Jackson,DEN,SAC,DEN,10.5,Pts+Rebs,29,21,28,9
22023,202704,22300290,"DEC 02, 2023",DEN @ SAC,L,33,9,18,0.5,2,6,0.333,0,0,0.0,0,1,1,8,1,0,2,3,20,-14,1,Reggie Jackson,DEN,SAC,DEN,12.5,Pts+Asts,29,21,28,9
22023,202704,22300290,"DEC 02, 2023",DEN @ SAC,L,33,9,18,0.5,2,6,0.333,0,0,0.0,0,1,1,8,1,0,2,3,20,-14,1,Reggie Jackson,DEN,SAC,DEN,0.5,Blks+Stls,29,21,28,9
22023,202704,22300279,"DEC 01, 2023",DEN @ PHX,W,29,8,11,0.727,3,4,0.75,1,2,0.5,0,2,2,4,0,0,1,3,20,0,1,Reggie Jackson,DEN,PHX,DEN,8.5,Points,26,22,24,6
22023,202704,22300279,"DEC 01, 2023",DEN @ PHX,W,29,8,11,0.727,3,4,0.75,1,2,0.5,0,2,2,4,0,0,1,3,20,0,1,Reggie Jackson,DEN,PHX,DEN,10.5,Pts+Rebs,26,22,24,6
22023,202704,22300279,"DEC 01, 2023",DEN @ PHX,W,29,8,11,0.727,3,4,0.75,1,2,0.5,0,2,2,4,0,0,1,3,20,0,1,Reggie Jackson,DEN,PHX,DEN,12.5,Pts+Asts,26,22,24,6
22023,202704,22300279,"DEC 01, 2023",DEN @ PHX,W,29,8,11,0.727,3,4,0.75,1,2,0.5,0,2,2,4,0,0,1,3,20,0,1,Reggie Jackson,DEN,PHX,DEN,0.5,Blks+Stls,26,22,24,6
22023,202704,22300263,"NOV 29, 2023",DEN vs. HOU,W,24,6,14,0.429,2,7,0.286,0,0,0.0,0,2,2,2,0,1,0,3,14,-1,1,Reggie Jackson,DEN,DEN,HOU,8.5,Points,18,16,16,4
22023,202704,22300263,"NOV 29, 2023",DEN vs. HOU,W,24,6,14,0.429,2,7,0.286,0,0,0.0,0,2,2,2,0,1,0,3,14,-1,1,Reggie Jackson,DEN,DEN,HOU,10.5,Pts+Rebs,18,16,16,4
22023,202704,22300263,"NOV 29, 2023",DEN vs. HOU,W,24,6,14,0.429,2,7,0.286,0,0,0.0,0,2,2,2,0,1,0,3,14,-1,1,Reggie Jackson,DEN,DEN,HOU,12.5,Pts+Asts,18,16,16,4
22023,202704,22300263,"NOV 29, 2023",DEN vs. HOU,W,24,6,14,0.429,2,7,0.286,0,0,0.0,0,2,2,2,0,1,0,3,14,-1,1,Reggie Jackson,DEN,DEN,HOU,0.5,Blks+Stls,18,16,16,4
22023,202704,22300257,"NOV 27, 2023",DEN @ LAC,W,40,15,19,0.789,3,4,0.75,2,4,0.5,1,4,5,13,2,0,2,3,35,25,1,Reggie Jackson,DEN,LAC,DEN,8.5,Points,53,40,48,18
22023,202704,22300257,"NOV 27, 2023",DEN @ LAC,W,40,15,19,0.789,3,4,0.75,2,4,0.5,1,4,5,13,2,0,2,3,35,25,1,Reggie Jackson,DEN,LAC,DEN,10.5,Pts+Rebs,53,40,48,18
22023,202704,22300257,"NOV 27, 2023",DEN @ LAC,W,40,15,19,0.789,3,4,0.75,2,4,0.5,1,4,5,13,2,0,2,3,35,25,1,Reggie Jackson,DEN,LAC,DEN,12.5,Pts+Asts,53,40,48,18
22023,202704,22300257,"NOV 27, 2023",DEN @ LAC,W,40,15,19,0.789,3,4,0.75,2,4,0.5,1,4,5,13,2,0,2,3,35,25,1,Reggie Jackson,DEN,LAC,DEN,0.5,Blks+Stls,53,40,48,18
22023,202704,22300252,"NOV 26, 2023",DEN vs. SAS,W,28,7,10,0.7,3,3,1.0,3,3,1.0,2,5,7,6,1,0,4,5,20,15,1,Reggie Jackson,DEN,DEN,SAS,8.5,Points,33,27,26,13
22023,202704,22300252,"NOV 26, 2023",DEN vs. SAS,W,28,7,10,0.7,3,3,1.0,3,3,1.0,2,5,7,6,1,0,4,5,20,15,1,Reggie Jackson,DEN,DEN,SAS,10.5,Pts+Rebs,33,27,26,13
22023,202704,22300252,"NOV 26, 2023",DEN vs. SAS,W,28,7,10,0.7,3,3,1.0,3,3,1.0,2,5,7,6,1,0,4,5,20,15,1,Reggie Jackson,DEN,DEN,SAS,12.5,Pts+Asts,33,27,26,13
22023,202704,22300252,"NOV 26, 2023",DEN vs. SAS,W,28,7,10,0.7,3,3,1.0,3,3,1.0,2,5,7,6,1,0,4,5,20,15,1,Reggie Jackson,DEN,DEN,SAS,0.5,Blks+Stls,33,27,26,13
22023,202704,22300048,"NOV 24, 2023",DEN @ HOU,L,25,1,7,0.143,0,2,0.0,0,0,0.0,2,2,4,3,0,1,6,0,2,-26,1,Reggie Jackson,DEN,HOU,DEN,8.5,Points,9,6,5,7
22023,202704,22300048,"NOV 24, 2023",DEN @ HOU,L,25,1,7,0.143,0,2,0.0,0,0,0.0,2,2,4,3,0,1,6,0,2,-26,1,Reggie Jackson,DEN,HOU,DEN,10.5,Pts+Rebs,9,6,5,7
22023,202704,22300048,"NOV 24, 2023",DEN @ HOU,L,25,1,7,0.143,0,2,0.0,0,0,0.0,2,2,4,3,0,1,6,0,2,-26,1,Reggie Jackson,DEN,HOU,DEN,12.5,Pts+Asts,9,6,5,7
22023,202704,22300048,"NOV 24, 2023",DEN @ HOU,L,25,1,7,0.143,0,2,0.0,0,0,0.0,2,2,4,3,0,1,6,0,2,-26,1,Reggie Jackson,DEN,HOU,DEN,0.5,Blks+Stls,9,6,5,7
22023,202704,22300226,"NOV 22, 2023",DEN @ ORL,L,34,5,15,0.333,3,7,0.429,1,1,1.0,1,3,4,9,0,0,1,1,14,-8,1,Reggie Jackson,DEN,ORL,DEN,8.5,Points,27,18,23,13
22023,202704,22300226,"NOV 22, 2023",DEN @ ORL,L,34,5,15,0.333,3,7,0.429,1,1,1.0,1,3,4,9,0,0,1,1,14,-8,1,Reggie Jackson,DEN,ORL,DEN,10.5,Pts+Rebs,27,18,23,13
22023,202704,22300226,"NOV 22, 2023",DEN @ ORL,L,34,5,15,0.333,3,7,0.429,1,1,1.0,1,3,4,9,0,0,1,1,14,-8,1,Reggie Jackson,DEN,ORL,DEN,12.5,Pts+Asts,27,18,23,13
22023,202704,22300226,"NOV 22, 2023",DEN @ ORL,L,34,5,15,0.333,3,7,0.429,1,1,1.0,1,3,4,9,0,0,1,1,14,-8,1,Reggie Jackson,DEN,ORL,DEN,0.5,Blks+Stls,27,18,23,13
22023,202704,22300218,"NOV 20, 2023",DEN @ DET,W,32,9,15,0.6,1,3,0.333,2,3,0.667,0,3,3,6,1,1,0,2,21,3,1,Reggie Jackson,DEN,DET,DEN,8.5,Points,30,24,27,9
22023,202704,22300218,"NOV 20, 2023",DEN @ DET,W,32,9,15,0.6,1,3,0.333,2,3,0.667,0,3,3,6,1,1,0,2,21,3,1,Reggie Jackson,DEN,DET,DEN,10.5,Pts+Rebs,30,24,27,9
22023,202704,22300218,"NOV 20, 2023",DEN @ DET,W,32,9,15,0.6,1,3,0.333,2,3,0.667,0,3,3,6,1,1,0,2,21,3,1,Reggie Jackson,DEN,DET,DEN,12.5,Pts+Asts,30,24,27,9
22023,202704,22300218,"NOV 20, 2023",DEN @ DET,W,32,9,15,0.6,1,3,0.333,2,3,0.667,0,3,3,6,1,1,0,2,21,3,1,Reggie Jackson,DEN,DET,DEN,0.5,Blks+Stls,30,24,27,9
22023,202704,22300210,"NOV 19, 2023",DEN @ CLE,L,21,3,5,0.6,1,1,1.0,0,0,0.0,0,0,0,1,2,0,2,2,7,-28,1,Reggie Jackson,DEN,CLE,DEN,8.5,Points,8,7,8,1
22023,202704,22300210,"NOV 19, 2023",DEN @ CLE,L,21,3,5,0.6,1,1,1.0,0,0,0.0,0,0,0,1,2,0,2,2,7,-28,1,Reggie Jackson,DEN,CLE,DEN,10.5,Pts+Rebs,8,7,8,1
22023,202704,22300210,"NOV 19, 2023",DEN @ CLE,L,21,3,5,0.6,1,1,1.0,0,0,0.0,0,0,0,1,2,0,2,2,7,-28,1,Reggie Jackson,DEN,CLE,DEN,12.5,Pts+Asts,8,7,8,1
22023,202704,22300210,"NOV 19, 2023",DEN @ CLE,L,21,3,5,0.6,1,1,1.0,0,0,0.0,0,0,0,1,2,0,2,2,7,-28,1,Reggie Jackson,DEN,CLE,DEN,0.5,Blks+Stls,8,7,8,1
22023,202704,22300034,"NOV 17, 2023",DEN @ NOP,L,33,6,12,0.5,2,7,0.286,0,0,0.0,1,1,2,3,0,0,4,2,14,-4,1,Reggie Jackson,DEN,NOP,DEN,8.5,Points,19,16,17,5
22023,202704,22300034,"NOV 17, 2023",DEN @ NOP,L,33,6,12,0.5,2,7,0.286,0,0,0.0,1,1,2,3,0,0,4,2,14,-4,1,Reggie Jackson,DEN,NOP,DEN,10.5,Pts+Rebs,19,16,17,5
22023,202704,22300034,"NOV 17, 2023",DEN @ NOP,L,33,6,12,0.5,2,7,0.286,0,0,0.0,1,1,2,3,0,0,4,2,14,-4,1,Reggie Jackson,DEN,NOP,DEN,12.5,Pts+Asts,19,16,17,5
22023,202704,22300034,"NOV 17, 2023",DEN @ NOP,L,33,6,12,0.5,2,7,0.286,0,0,0.0,1,1,2,3,0,0,4,2,14,-4,1,Reggie Jackson,DEN,NOP,DEN,0.5,Blks+Stls,19,16,17,5
22023,202704,22300024,"NOV 14, 2023",DEN vs. LAC,W,30,7,11,0.636,0,1,0.0,4,6,0.667,0,3,3,4,0,1,2,3,18,9,1,Reggie Jackson,DEN,DEN,LAC,8.5,Points,25,21,22,7
22023,202704,22300024,"NOV 14, 2023",DEN vs. LAC,W,30,7,11,0.636,0,1,0.0,4,6,0.667,0,3,3,4,0,1,2,3,18,9,1,Reggie Jackson,DEN,DEN,LAC,10.5,Pts+Rebs,25,21,22,7
22023,202704,22300024,"NOV 14, 2023",DEN vs. LAC,W,30,7,11,0.636,0,1,0.0,4,6,0.667,0,3,3,4,0,1,2,3,18,9,1,Reggie Jackson,DEN,DEN,LAC,12.5,Pts+Asts,25,21,22,7
22023,202704,22300024,"NOV 14, 2023",DEN vs. LAC,W,30,7,11,0.636,0,1,0.0,4,6,0.667,0,3,3,4,0,1,2,3,18,9,1,Reggie Jackson,DEN,DEN,LAC,0.5,Blks+Stls,25,21,22,7
22023,202704,22300182,"NOV 12, 2023",DEN @ HOU,L,28,6,12,0.5,2,5,0.4,0,0,0.0,0,4,4,2,0,0,1,2,14,-3,1,Reggie Jackson,DEN,HOU,DEN,8.5,Points,20,18,16,6
22023,202704,22300182,"NOV 12, 2023",DEN @ HOU,L,28,6,12,0.5,2,5,0.4,0,0,0.0,0,4,4,2,0,0,1,2,14,-3,1,Reggie Jackson,DEN,HOU,DEN,10.5,Pts+Rebs,20,18,16,6
22023,202704,22300182,"NOV 12, 2023",DEN @ HOU,L,28,6,12,0.5,2,5,0.4,0,0,0.0,0,4,4,2,0,0,1,2,14,-3,1,Reggie Jackson,DEN,HOU,DEN,12.5,Pts+Asts,20,18,16,6
22023,202704,22300182,"NOV 12, 2023",DEN @ HOU,L,28,6,12,0.5,2,5,0.4,0,0,0.0,0,4,4,2,0,0,1,2,14,-3,1,Reggie Jackson,DEN,HOU,DEN,0.5,Blks+Stls,20,18,16,6
22023,202704,22300169,"NOV 08, 2023",DEN vs. GSW,W,32,8,17,0.471,3,7,0.429,1,2,0.5,0,2,2,6,0,0,0,5,20,13,1,Reggie Jackson,DEN,DEN,GSW,8.5,Points,28,22,26,8
22023,202704,22300169,"NOV 08, 2023",DEN vs. GSW,W,32,8,17,0.471,3,7,0.429,1,2,0.5,0,2,2,6,0,0,0,5,20,13,1,Reggie Jackson,DEN,DEN,GSW,10.5,Pts+Rebs,28,22,26,8
22023,202704,22300169,"NOV 08, 2023",DEN vs. GSW,W,32,8,17,0.471,3,7,0.429,1,2,0.5,0,2,2,6,0,0,0,5,20,13,1,Reggie Jackson,DEN,DEN,GSW,12.5,Pts+Asts,28,22,26,8
22023,202704,22300169,"NOV 08, 2023",DEN vs. GSW,W,32,8,17,0.471,3,7,0.429,1,2,0.5,0,2,2,6,0,0,0,5,20,13,1,Reggie Jackson,DEN,DEN,GSW,0.5,Blks+Stls,28,22,26,8
22023,202704,22300156,"NOV 06, 2023",DEN vs. NOP,W,24,2,8,0.25,1,4,0.25,2,2,1.0,0,1,1,4,0,0,0,1,7,16,1,Reggie Jackson,DEN,DEN,NOP,8.5,Points,12,8,11,5
22023,202704,22300156,"NOV 06, 2023",DEN vs. NOP,W,24,2,8,0.25,1,4,0.25,2,2,1.0,0,1,1,4,0,0,0,1,7,16,1,Reggie Jackson,DEN,DEN,NOP,10.5,Pts+Rebs,12,8,11,5
22023,202704,22300156,"NOV 06, 2023",DEN vs. NOP,W,24,2,8,0.25,1,4,0.25,2,2,1.0,0,1,1,4,0,0,0,1,7,16,1,Reggie Jackson,DEN,DEN,NOP,12.5,Pts+Asts,12,8,11,5
22023,202704,22300156,"NOV 06, 2023",DEN vs. NOP,W,24,2,8,0.25,1,4,0.25,2,2,1.0,0,1,1,4,0,0,0,1,7,16,1,Reggie Jackson,DEN,DEN,NOP,0.5,Blks+Stls,12,8,11,5
22023,202704,22300139,"NOV 04, 2023",DEN vs. CHI,W,25,6,10,0.6,3,5,0.6,1,2,0.5,0,1,1,3,0,1,1,0,16,14,1,Reggie Jackson,DEN,DEN,CHI,8.5,Points,20,17,19,4
22023,202704,22300139,"NOV 04, 2023",DEN vs. CHI,W,25,6,10,0.6,3,5,0.6,1,2,0.5,0,1,1,3,0,1,1,0,16,14,1,Reggie Jackson,DEN,DEN,CHI,10.5,Pts+Rebs,20,17,19,4
22023,202704,22300139,"NOV 04, 2023",DEN vs. CHI,W,25,6,10,0.6,3,5,0.6,1,2,0.5,0,1,1,3,0,1,1,0,16,14,1,Reggie Jackson,DEN,DEN,CHI,12.5,Pts+Asts,20,17,19,4
22023,202704,22300139,"NOV 04, 2023",DEN vs. CHI,W,25,6,10,0.6,3,5,0.6,1,2,0.5,0,1,1,3,0,1,1,0,16,14,1,Reggie Jackson,DEN,DEN,CHI,0.5,Blks+Stls,20,17,19,4
22023,202704,22300006,"NOV 03, 2023",DEN vs. DAL,W,20,3,10,0.3,1,4,0.25,1,2,0.5,0,1,1,2,4,0,3,1,8,5,1,Reggie Jackson,DEN,DEN,DAL,8.5,Points,11,9,10,3
22023,202704,22300006,"NOV 03, 2023",DEN vs. DAL,W,20,3,10,0.3,1,4,0.25,1,2,0.5,0,1,1,2,4,0,3,1,8,5,1,Reggie Jackson,DEN,DEN,DAL,10.5,Pts+Rebs,11,9,10,3
22023,202704,22300006,"NOV 03, 2023",DEN vs. DAL,W,20,3,10,0.3,1,4,0.25,1,2,0.5,0,1,1,2,4,0,3,1,8,5,1,Reggie Jackson,DEN,DEN,DAL,12.5,Pts+Asts,11,9,10,3
22023,202704,22300006,"NOV 03, 2023",DEN vs. DAL,W,20,3,10,0.3,1,4,0.25,1,2,0.5,0,1,1,2,4,0,3,1,8,5,1,Reggie Jackson,DEN,DEN,DAL,0.5,Blks+Stls,11,9,10,3
22023,202704,22300123,"NOV 01, 2023",DEN @ MIN,L,19,1,4,0.25,0,1,0.0,0,0,0.0,0,0,0,5,2,1,1,0,2,-4,1,Reggie Jackson,DEN,MIN,DEN,8.5,Points,7,2,7,5
22023,202704,22300123,"NOV 01, 2023",DEN @ MIN,L,19,1,4,0.25,0,1,0.0,0,0,0.0,0,0,0,5,2,1,1,0,2,-4,1,Reggie Jackson,DEN,MIN,DEN,10.5,Pts+Rebs,7,2,7,5
22023,202704,22300123,"NOV 01, 2023",DEN @ MIN,L,19,1,4,0.25,0,1,0.0,0,0,0.0,0,0,0,5,2,1,1,0,2,-4,1,Reggie Jackson,DEN,MIN,DEN,12.5,Pts+Asts,7,2,7,5
22023,202704,22300123,"NOV 01, 2023",DEN @ MIN,L,19,1,4,0.25,0,1,0.0,0,0,0.0,0,0,0,5,2,1,1,0,2,-4,1,Reggie Jackson,DEN,MIN,DEN,0.5,Blks+Stls,7,2,7,5
22023,202704,22300110,"OCT 30, 2023",DEN vs. UTA,W,19,2,6,0.333,0,3,0.0,0,1,0.0,1,3,4,1,0,0,1,2,4,9,1,Reggie Jackson,DEN,DEN,UTA,8.5,Points,9,8,5,5
22023,202704,22300110,"OCT 30, 2023",DEN vs. UTA,W,19,2,6,0.333,0,3,0.0,0,1,0.0,1,3,4,1,0,0,1,2,4,9,1,Reggie Jackson,DEN,DEN,UTA,10.5,Pts+Rebs,9,8,5,5
22023,202704,22300110,"OCT 30, 2023",DEN vs. UTA,W,19,2,6,0.333,0,3,0.0,0,1,0.0,1,3,4,1,0,0,1,2,4,9,1,Reggie Jackson,DEN,DEN,UTA,12.5,Pts+Asts,9,8,5,5
22023,202704,22300110,"OCT 30, 2023",DEN vs. UTA,W,19,2,6,0.333,0,3,0.0,0,1,0.0,1,3,4,1,0,0,1,2,4,9,1,Reggie Jackson,DEN,DEN,UTA,0.5,Blks+Stls,9,8,5,5
22023,202704,22300095,"OCT 29, 2023",DEN @ OKC,W,22,2,3,0.667,1,2,0.5,0,0,0.0,0,0,0,6,2,0,2,4,5,13,1,Reggie Jackson,DEN,OKC,DEN,8.5,Points,11,5,11,6
22023,202704,22300095,"OCT 29, 2023",DEN @ OKC,W,22,2,3,0.667,1,2,0.5,0,0,0.0,0,0,0,6,2,0,2,4,5,13,1,Reggie Jackson,DEN,OKC,DEN,10.5,Pts+Rebs,11,5,11,6
22023,202704,22300095,"OCT 29, 2023",DEN @ OKC,W,22,2,3,0.667,1,2,0.5,0,0,0.0,0,0,0,6,2,0,2,4,5,13,1,Reggie Jackson,DEN,OKC,DEN,12.5,Pts+Asts,11,5,11,6
22023,202704,22300095,"OCT 29, 2023",DEN @ OKC,W,22,2,3,0.667,1,2,0.5,0,0,0.0,0,0,0,6,2,0,2,4,5,13,1,Reggie Jackson,DEN,OKC,DEN,0.5,Blks+Stls,11,5,11,6
22023,202704,22300078,"OCT 27, 2023",DEN @ MEM,W,22,7,13,0.538,2,5,0.4,0,0,0.0,0,2,2,6,0,1,0,0,16,-4,1,Reggie Jackson,DEN,MEM,DEN,8.5,Points,24,18,22,8
22023,202704,22300078,"OCT 27, 2023",DEN @ MEM,W,22,7,13,0.538,2,5,0.4,0,0,0.0,0,2,2,6,0,1,0,0,16,-4,1,Reggie Jackson,DEN,MEM,DEN,10.5,Pts+Rebs,24,18,22,8
22023,202704,22300078,"OCT 27, 2023",DEN @ MEM,W,22,7,13,0.538,2,5,0.4,0,0,0.0,0,2,2,6,0,1,0,0,16,-4,1,Reggie Jackson,DEN,MEM,DEN,12.5,Pts+Asts,24,18,22,8
22023,202704,22300078,"OCT 27, 2023",DEN @ MEM,W,22,7,13,0.538,2,5,0.4,0,0,0.0,0,2,2,6,0,1,0,0,16,-4,1,Reggie Jackson,DEN,MEM,DEN,0.5,Blks+Stls,24,18,22,8
22023,202704,22300061,"OCT 24, 2023",DEN vs. LAL,W,24,3,8,0.375,2,5,0.4,0,0,0.0,0,3,3,1,1,0,2,0,8,11,1,Reggie Jackson,DEN,DEN,LAL,8.5,Points,12,11,9,4
22023,202704,22300061,"OCT 24, 2023",DEN vs. LAL,W,24,3,8,0.375,2,5,0.4,0,0,0.0,0,3,3,1,1,0,2,0,8,11,1,Reggie Jackson,DEN,DEN,LAL,10.5,Pts+Rebs,12,11,9,4
22023,202704,22300061,"OCT 24, 2023",DEN vs. LAL,W,24,3,8,0.375,2,5,0.4,0,0,0.0,0,3,3,1,1,0,2,0,8,11,1,Reggie Jackson,DEN,DEN,LAL,12.5,Pts+Asts,12,11,9,4
22023,202704,22300061,"OCT 24, 2023",DEN vs. LAL,W,24,3,8,0.375,2,5,0.4,0,0,0.0,0,3,3,1,1,0,2,0,8,11,1,Reggie Jackson,DEN,DEN,LAL,0.5,Blks+Stls,12,11,9,4
22023,1641748,22300552,"JAN 14, 2024",MIL vs. SAC,W,10,0,0,0.0,0,0,0.0,0,0,0.0,0,0,0,1,0,0,2,5,0,2,1,Andre Jackson Jr.,MIL,MIL,SAC,,,1,0,1,1
22023,1641748,22300545,"JAN 13, 2024",MIL vs. GSW,W,28,5,8,0.625,0,0,0.0,0,0,0.0,6,4,10,2,0,1,1,1,10,0,1,Andre Jackson Jr.,MIL,MIL,GSW,,,22,20,12,12
22023,1641748,22300528,"JAN 11, 2024",MIL vs. BOS,W,16,0,2,0.0,0,2,0.0,0,0,0.0,2,2,4,4,0,0,0,5,0,19,1,Andre Jackson Jr.,MIL,MIL,BOS,,,8,4,4,8
22023,1641748,22300510,"JAN 08, 2024",MIL vs. UTA,L,26,2,6,0.333,1,2,0.5,2,2,1.0,2,3,5,3,0,2,1,2,7,-6,1,Andre Jackson Jr.,MIL,MIL,UTA,,,15,12,10,8
22023,1641748,22300496,"JAN 06, 2024",MIL @ HOU,L,12,0,1,0.0,0,1,0.0,1,1,1.0,0,2,2,0,2,0,0,3,1,3,1,Andre Jackson Jr.,MIL,HOU,MIL,,,3,3,1,2
22023,1641748,22300477,"JAN 04, 2024",MIL @ SAS,W,5,0,0,0.0,0,0,0.0,0,0,0.0,0,1,1,0,0,0,0,1,0,-5,1,Andre Jackson Jr.,MIL,SAS,MIL,,,1,1,0,1
22023,1641748,22300466,"JAN 03, 2024",MIL @ IND,L,14,3,4,0.75,1,2,0.5,0,0,0.0,0,2,2,2,0,0,1,1,7,14,1,Andre Jackson Jr.,MIL,IND,MIL,,,11,9,9,4
22023,1641748,22300454,"JAN 01, 2024",MIL vs. IND,L,5,0,0,0.0,0,0,0.0,0,0,0.0,0,1,1,0,0,0,0,1,0,-12,1,Andre Jackson Jr.,MIL,MIL,IND,,,1,1,0,1
22023,1641748,22300433,"DEC 29, 2023",MIL @ CLE,W,3,0,0,0.0,0,0,0.0,0,0,0.0,0,0,0,0,0,0,1,0,0,-7,1,Andre Jackson Jr.,MIL,CLE,MIL,,,0,0,0,0
22023,1641748,22300417,"DEC 27, 2023",MIL @ BKN,W,2,0,2,0.0,0,1,0.0,0,0,0.0,0,0,0,0,0,0,0,2,0,1,1,Andre Jackson Jr.,MIL,BKN,MIL,,,0,0,0,0
22023,1641748,22300401,"DEC 25, 2023",MIL @ NYK,L,14,0,2,0.0,0,1,0.0,2,2,1.0,1,1,2,1,1,0,0,2,2,-4,1,Andre Jackson Jr.,MIL,NYK,MIL,,,5,4,3,3
22023,1641748,22300388,"DEC 23, 2023",MIL @ NYK,W,11,0,0,0.0,0,0,0.0,0,0,0.0,2,0,2,2,0,0,1,1,0,-2,1,Andre Jackson Jr.,MIL,NYK,MIL,,,4,2,2,4
22023,1641748,22300378,"DEC 21, 2023",MIL vs. ORL,W,7,0,1,0.0,0,1,0.0,0,0,0.0,0,0,0,0,0,0,0,0,0,-8,1,Andre Jackson Jr.,MIL,MIL,ORL,,,0,0,0,0
22023,1641748,22300361,"DEC 19, 2023",MIL vs. SAS,W,15,2,4,0.5,2,3,0.667,1,2,0.5,2,1,3,2,1,0,1,2,7,-1,1,Andre Jackson Jr.,MIL,MIL,SAS,,,12,10,9,5
22023,1641748,22300346,"DEC 17, 2023",MIL vs. HOU,W,36,4,6,0.667,1,3,0.333,0,0,0.0,4,2,6,4,0,0,1,6,9,3,1,Andre Jackson Jr.,MIL,MIL,HOU,,,19,15,13,10
22023,1641748,22300334,"DEC 16, 2023",MIL vs. DET,W,26,4,8,0.5,2,5,0.4,0,0,0.0,1,7,8,1,0,0,1,4,10,2,1,Andre Jackson Jr.,MIL,MIL,DET,,,19,18,11,9
22023,1641748,22300315,"DEC 13, 2023",MIL vs. IND,W,14,1,2,0.5,0,1,0.0,0,0,0.0,1,1,2,2,0,0,0,4,2,1,1,Andre Jackson Jr.,MIL,MIL,IND,,,6,4,4,4
22023,1641748,22301229,"DEC 07, 2023",MIL vs. IND,L,1,0,0,0.0,0,0,0.0,0,0,0.0,0,0,0,0,0,0,0,1,0,-4,1,Andre Jackson Jr.,MIL,MIL,IND,,,0,0,0,0
22023,1641748,22301201,"DEC 05, 2023",MIL vs. NYK,W,0,0,0,0.0,0,0,0.0,0,0,0.0,0,0,0,0,0,0,0,0,0,0,1,Andre Jackson Jr.,MIL,MIL,NYK,,,0,0,0,0
22023,1641748,22300269,"NOV 30, 2023",MIL @ CHI,L,12,2,3,0.667,0,1,0.0,0,0,0.0,1,0,1,1,2,0,1,1,4,-8,1,Andre Jackson Jr.,MIL,CHI,MIL,,,6,5,5,2
22023,1641748,22300056,"NOV 28, 2023",MIL @ MIA,W,3,2,2,1.0,2,2,1.0,0,0,0.0,1,0,1,0,0,0,0,0,6,-3,1,Andre Jackson Jr.,MIL,MIA,MIL,,,7,7,6,1
22023,1641748,22300245,"NOV 26, 2023",MIL vs. POR,W,12,0,0,0.0,0,0,0.0,0,0,0.0,0,1,1,0,0,0,0,0,0,-11,1,Andre Jackson Jr.,MIL,MIL,POR,,,1,1,0,1
22023,1641748,22300049,"NOV 24, 2023",MIL vs. WAS,W,9,0,0,0.0,0,0,0.0,0,0,0.0,0,1,1,1,0,0,0,4,0,0,1,Andre Jackson Jr.,MIL,MIL,WAS,,,2,1,1,2
22023,1641748,22300228,"NOV 22, 2023",MIL @ BOS,L,8,3,4,0.75,1,1,1.0,0,0,0.0,1,0,1,0,0,0,1,2,7,-2,1,Andre Jackson Jr.,MIL,BOS,MIL,,,8,8,7,1
22023,1641748,22300219,"NOV 20, 2023",MIL @ WAS,W,1,0,0,0.0,0,0,0.0,0,0,0.0,1,0,1,0,0,0,0,0,0,-5,1,Andre Jackson Jr.,MIL,WAS,MIL,,,1,1,0,1
22023,1641748,22300205,"NOV 18, 2023",MIL vs. DAL,W,12,0,1,0.0,0,0,0.0,0,0,0.0,0,0,0,2,0,0,0,1,0,-11,1,Andre Jackson Jr.,MIL,MIL,DAL,,,2,0,2,2
22023,1641748,22300027,"NOV 17, 2023",MIL @ CHA,W,8,2,2,1.0,2,2,1.0,0,0,0.0,0,1,1,2,0,0,1,1,6,2,1,Andre Jackson Jr.,MIL,CHA,MIL,,,9,7,8,3
22023,1641748,22300195,"NOV 15, 2023",MIL @ TOR,W,17,0,1,0.0,0,0,0.0,0,0,0.0,2,0,2,1,0,0,2,2,0,9,1,Andre Jackson Jr.,MIL,TOR,MIL,,,3,2,1,3
22023,1641748,22300190,"NOV 13, 2023",MIL vs. CHI,W,13,2,4,0.5,1,3,0.333,0,0,0.0,2,1,3,0,0,0,0,1,5,2,1,Andre Jackson Jr.,MIL,MIL,CHI,,,8,8,5,3
22023,1641748,22300173,"NOV 11, 2023",MIL @ ORL,L,14,2,3,0.667,0,1,0.0,0,0,0.0,1,2,3,0,0,0,2,2,4,2,1,Andre Jackson Jr.,MIL,ORL,MIL,,,7,7,4,3
22023,1641748,22300171,"NOV 09, 2023",MIL @ IND,L,5,0,0,0.0,0,0,0.0,0,0,0.0,0,0,0,0,0,0,0,2,0,7,1,Andre Jackson Jr.,MIL,IND,MIL,,,0,0,0,0
22023,1641748,22300165,"NOV 08, 2023",MIL vs. DET,W,4,0,0,0.0,0,0,0.0,0,0,0.0,0,0,0,0,1,0,0,3,0,0,1,Andre Jackson Jr.,MIL,MIL,DET,,,0,0,0,0
22023,1641748,22300116,"NOV 01, 2023",MIL @ TOR,L,6,1,1,1.0,0,0,0.0,0,0,0.0,0,1,1,3,1,0,0,2,2,4,1,Andre Jackson Jr.,MIL,TOR,MIL,,,6,3,5,4
22023,1641748,22300097,"OCT 29, 2023",MIL vs. ATL,L,7,0,1,0.0,0,1,0.0,0,0,0.0,1,3,4,1,1,0,1,2,0,5,1,Andre Jackson Jr.,MIL,MIL,ATL,,,5,4,1,5
22023,1628991,22300560,"JAN 15, 2024",MEM vs. GSW,W,33,4,20,0.2,3,14,0.214,7,8,0.875,0,5,5,5,4,1,1,1,18,-9,1,Jaren Jackson Jr.,MEM,MEM,GSW,,,28,23,23,10
22023,1628991,22300537,"JAN 12, 2024",MEM vs. LAC,L,30,6,20,0.3,1,8,0.125,8,10,0.8,2,4,6,1,1,1,1,1,21,-14,1,Jaren Jackson Jr.,MEM,MEM,LAC,,,28,27,22,7
22023,1628991,22300503,"JAN 07, 2024",MEM @ PHX,W,32,11,20,0.55,3,8,0.375,3,4,0.75,1,9,10,6,0,1,2,5,28,25,1,Jaren Jackson Jr.,MEM,PHX,MEM,,,44,38,34,16
22023,1628991,22300491,"JAN 05, 2024",MEM @ LAL,W,30,11,14,0.786,5,6,0.833,4,4,1.0,0,9,9,1,0,3,3,5,31,1,1,Jaren Jackson Jr.,MEM,LAL,MEM,,,41,40,32,10
22023,1628991,22300470,"JAN 03, 2024",MEM vs. TOR,L,37,7,18,0.389,4,8,0.5,6,6,1.0,1,3,4,0,1,4,3,1,24,5,1,Jaren Jackson Jr.,MEM,MEM,TOR,,,28,28,24,4
22023,1628991,22300460,"JAN 02, 2024",MEM vs. SAS,W,32,3,14,0.214,1,4,0.25,3,4,0.75,1,6,7,1,3,4,1,4,10,2,1,Jaren Jackson Jr.,MEM,MEM,SAS,,,18,17,11,8
22023,1628991,22300449,"DEC 31, 2023",MEM vs. SAC,L,29,6,14,0.429,1,4,0.25,5,6,0.833,0,3,3,1,1,0,0,3,18,-13,1,Jaren Jackson Jr.,MEM,MEM,SAC,,,22,21,19,4
22023,1628991,22300438,"DEC 29, 2023",MEM @ LAC,L,37,8,17,0.471,4,6,0.667,2,2,1.0,0,2,2,4,2,2,1,5,22,-11,1,Jaren Jackson Jr.,MEM,LAC,MEM,,,28,24,26,6
22023,1628991,22300425,"DEC 28, 2023",MEM @ DEN,L,28,5,15,0.333,1,3,0.333,3,4,0.75,1,3,4,2,2,0,0,1,14,-11,1,Jaren Jackson Jr.,MEM,DEN,MEM,,,20,18,16,6
22023,1628991,22300410,"DEC 26, 2023",MEM @ NOP,W,39,5,11,0.455,0,3,0.0,9,10,0.9,1,9,10,1,1,1,3,5,19,6,1,Jaren Jackson Jr.,MEM,NOP,MEM,,,30,29,20,11
22023,1628991,22300393,"DEC 23, 2023",MEM @ ATL,W,24,8,10,0.8,1,2,0.5,3,4,0.75,2,0,2,0,0,0,2,5,20,0,1,Jaren Jackson Jr.,MEM,ATL,MEM,,,22,22,20,2
22023,1628991,22300377,"DEC 21, 2023",MEM vs. IND,W,33,8,10,0.8,2,4,0.5,3,3,1.0,2,6,8,1,1,0,7,4,21,-8,1,Jaren Jackson Jr.,MEM,MEM,IND,,,30,29,22,9
22023,1628991,22300360,"DEC 19, 2023",MEM @ NOP,W,30,6,10,0.6,1,3,0.333,11,15,0.733,1,5,6,0,0,3,2,4,24,-2,1,Jaren Jackson Jr.,MEM,NOP,MEM,,,30,30,24,6
22023,1628991,22300355,"DEC 18, 2023",MEM @ OKC,L,25,3,7,0.429,1,4,0.25,4,5,0.8,0,5,5,1,1,0,2,3,11,-15,1,Jaren Jackson Jr.,MEM,OKC,MEM,,,17,16,12,6
22023,1628991,22300332,"DEC 15, 2023",MEM vs. HOU,L,33,8,23,0.348,0,7,0.0,6,7,0.857,1,2,3,2,0,4,1,5,22,-5,1,Jaren Jackson Jr.,MEM,MEM,HOU,,,27,25,24,5
22023,1628991,22300314,"DEC 13, 2023",MEM @ HOU,L,40,15,24,0.625,3,8,0.375,11,13,0.846,1,6,7,2,4,1,3,4,44,-1,1,Jaren Jackson Jr.,MEM,HOU,MEM,,,53,51,46,9
22023,1628991,22300299,"DEC 11, 2023",MEM vs. DAL,L,42,15,29,0.517,6,10,0.6,5,5,1.0,0,4,4,2,2,2,2,3,41,-2,1,Jaren Jackson Jr.,MEM,MEM,DAL,,,47,45,43,6
22023,1628991,22301221,"DEC 08, 2023",MEM vs. MIN,L,29,7,14,0.5,3,4,0.75,4,4,1.0,1,1,2,1,1,1,2,5,21,-19,1,Jaren Jackson Jr.,MEM,MEM,MIN,,,24,23,22,3
22023,1628991,22301206,"DEC 06, 2023",MEM @ DET,W,35,10,20,0.5,2,6,0.333,2,3,0.667,0,4,4,0,0,3,0,3,24,15,1,Jaren Jackson Jr.,MEM,DET,MEM,,,28,28,24,4
22023,1628991,22300288,"DEC 02, 2023",MEM @ PHX,L,35,13,21,0.619,2,5,0.4,9,10,0.9,1,8,9,2,1,1,4,4,37,-7,1,Jaren Jackson Jr.,MEM,PHX,MEM,,,48,46,39,11
22023,1628991,22300277,"DEC 01, 2023",MEM @ DAL,W,14,2,8,0.25,0,3,0.0,0,0,0.0,1,3,4,2,0,2,1,5,4,0,1,Jaren Jackson Jr.,MEM,DAL,MEM,,,10,8,6,6
22023,1628991,22300261,"NOV 29, 2023",MEM vs. UTA,W,35,8,19,0.421,0,3,0.0,4,4,1.0,3,3,6,1,1,6,1,2,20,14,1,Jaren Jackson Jr.,MEM,MEM,UTA,,,27,26,21,7
22023,1628991,22300249,"NOV 26, 2023",MEM vs. MIN,L,37,4,14,0.286,2,6,0.333,8,10,0.8,0,4,4,3,1,3,2,3,18,-9,1,Jaren Jackson Jr.,MEM,MEM,MIN,,,25,22,21,7
22023,1628991,22300044,"NOV 24, 2023",MEM vs. PHX,L,29,5,13,0.385,1,4,0.25,2,4,0.5,4,3,7,2,1,0,3,5,13,-12,1,Jaren Jackson Jr.,MEM,MEM,PHX,,,22,20,15,9
22023,1628991,22300231,"NOV 22, 2023",MEM @ HOU,L,37,7,21,0.333,0,4,0.0,9,12,0.75,1,6,7,0,1,1,2,4,23,-20,1,Jaren Jackson Jr.,MEM,HOU,MEM,,,30,30,23,7
22023,1628991,22300213,"NOV 19, 2023",MEM vs. BOS,L,34,5,12,0.417,1,3,0.333,6,7,0.857,2,6,8,1,1,1,2,5,17,-1,1,Jaren Jackson Jr.,MEM,MEM,BOS,,,26,25,18,9
22023,1628991,22300206,"NOV 18, 2023",MEM @ SAS,W,27,7,20,0.35,2,8,0.25,11,12,0.917,3,2,5,0,1,1,2,3,27,10,1,Jaren Jackson Jr.,MEM,SAS,MEM,,,32,32,27,5
22023,1628991,22300026,"NOV 14, 2023",MEM @ LAL,L,22,3,16,0.188,2,6,0.333,0,0,0.0,2,0,2,2,0,1,1,2,8,-16,1,Jaren Jackson Jr.,MEM,LAL,MEM,,,12,10,10,4
22023,1628991,22300179,"NOV 12, 2023",MEM @ LAC,W,29,3,15,0.2,0,3,0.0,6,6,1.0,0,4,4,1,1,1,3,4,12,-3,1,Jaren Jackson Jr.,MEM,LAC,MEM,,,17,16,13,5
22023,1628991,22300012,"NOV 10, 2023",MEM vs. UTA,L,23,7,13,0.538,0,2,0.0,0,0,0.0,2,2,4,2,0,0,2,2,14,-11,1,Jaren Jackson Jr.,MEM,MEM,UTA,,,20,18,16,6
22023,1628991,22300164,"NOV 08, 2023",MEM vs. MIA,L,33,9,18,0.5,2,8,0.25,8,10,0.8,2,2,4,2,0,1,1,5,28,-5,1,Jaren Jackson Jr.,MEM,MEM,MIA,,,34,32,30,6
22023,1628991,22300144,"NOV 05, 2023",MEM @ POR,W,37,11,18,0.611,1,4,0.25,4,6,0.667,3,4,7,2,1,1,2,1,27,11,1,Jaren Jackson Jr.,MEM,POR,MEM,,,36,34,29,9
22023,1628991,22300007,"NOV 03, 2023",MEM @ POR,L,38,11,17,0.647,5,8,0.625,3,6,0.5,2,8,10,3,1,3,4,1,30,3,1,Jaren Jackson Jr.,MEM,POR,MEM,,,43,40,33,13
22023,1628991,22300125,"NOV 01, 2023",MEM @ UTA,L,26,5,17,0.294,1,8,0.125,8,8,1.0,3,5,8,2,0,1,2,3,19,-25,1,Jaren Jackson Jr.,MEM,UTA,MEM,,,29,27,21,10
22023,1628991,22300106,"OCT 30, 2023",MEM vs. DAL,L,34,10,20,0.5,3,6,0.5,7,9,0.778,2,7,9,4,0,2,1,3,30,-25,1,Jaren Jackson Jr.,MEM,MEM,DAL,,,43,39,34,13
22023,1628991,22300089,"OCT 28, 2023",MEM @ WAS,L,31,4,12,0.333,2,4,0.5,6,6,1.0,0,5,5,2,1,1,1,4,16,5,1,Jaren Jackson Jr.,MEM,WAS,MEM,,,23,21,18,7
22023,1628991,22300078,"OCT 27, 2023",MEM vs. DEN,L,28,9,13,0.692,2,2,1.0,1,2,0.5,2,7,9,2,0,3,0,5,21,-1,1,Jaren Jackson Jr.,MEM,MEM,DEN,,,32,30,23,11
22023,1628991,22300071,"OCT 25, 2023",MEM vs. NOP,L,36,2,9,0.222,0,5,0.0,4,4,1.0,1,4,5,3,0,5,3,5,8,-1,1,Jaren Jackson Jr.,MEM,MEM,NOP,,,16,13,11,8
22023,1631218,22300560,"JAN 15, 2024",GSW @ MEM,L,10,0,2,0.0,0,0,0.0,0,0,0.0,0,2,2,1,0,1,0,2,0,-6,1,Trayce Jackson-Davis,GSW,MEM,GSW,,,3,2,1,3
22023,1631218,22300545,"JAN 13, 2024",GSW @ MIL,L,18,6,8,0.75,0,0,0.0,0,2,0.0,0,2,2,1,1,1,0,0,12,-13,1,Trayce Jackson-Davis,GSW,MIL,GSW,,,15,14,13,3
22023,1631218,22300536,"JAN 12, 2024",GSW @ CHI,W,17,4,5,0.8,0,0,0.0,5,7,0.714,3,4,7,2,1,1,1,2,13,13,1,Trayce Jackson-Davis,GSW,CHI,GSW,,,22,20,15,9
22023,1631218,22300525,"JAN 10, 2024",GSW vs. NOP,L,22,9,11,0.818,0,0,0.0,1,1,1.0,3,2,5,1,1,1,1,1,19,-16,1,Trayce Jackson-Davis,GSW,GSW,NOP,,,25,24,20,6
22023,1631218,22300504,"JAN 07, 2024",GSW vs. TOR,L,27,8,9,0.889,0,0,0.0,0,0,0.0,3,8,11,2,0,3,0,0,16,-3,1,Trayce Jackson-Davis,GSW,GSW,TOR,,,29,27,18,13
22023,1631218,22300490,"JAN 05, 2024",GSW vs. DET,W,23,5,5,1.0,0,0,0.0,1,1,1.0,2,7,9,0,0,1,2,2,11,-2,1,Trayce Jackson-Davis,GSW,GSW,DET,,,20,20,11,9
22023,1631218,22300478,"JAN 04, 2024",GSW vs. DEN,L,21,2,4,0.5,0,0,0.0,0,0,0.0,2,0,2,2,0,0,2,4,4,0,1,Trayce Jackson-Davis,GSW,GSW,DEN,,,8,6,6,4
22023,1631218,22300463,"JAN 02, 2024",GSW vs. ORL,W,24,3,4,0.75,0,0,0.0,4,6,0.667,2,2,4,2,1,2,3,1,10,-1,1,Trayce Jackson-Davis,GSW,GSW,ORL,,,16,14,12,6
22023,1631218,22300444,"DEC 30, 2023",GSW vs. DAL,L,29,8,11,0.727,0,0,0.0,1,3,0.333,3,3,6,2,1,0,1,4,17,-4,1,Trayce Jackson-Davis,GSW,GSW,DAL,,,25,23,19,8
22023,1631218,22300426,"DEC 28, 2023",GSW vs. MIA,L,26,4,9,0.444,0,0,0.0,2,2,1.0,4,7,11,1,0,2,1,1,10,8,1,Trayce Jackson-Davis,GSW,GSW,MIA,,,22,21,11,12
22023,1631218,22300402,"DEC 25, 2023",GSW @ DEN,L,15,3,4,0.75,0,0,0.0,2,2,1.0,0,3,3,1,0,0,0,5,8,-4,1,Trayce Jackson-Davis,GSW,DEN,GSW,,,12,11,9,4
22023,1631218,22300399,"DEC 23, 2023",GSW vs. POR,W,17,6,7,0.857,0,0,0.0,1,4,0.25,1,4,5,3,1,0,2,2,13,-1,1,Trayce Jackson-Davis,GSW,GSW,POR,,,21,18,16,8
22023,1631218,22300386,"DEC 22, 2023",GSW vs. WAS,W,25,5,7,0.714,0,0,0.0,0,0,0.0,5,10,15,3,0,1,1,2,10,10,1,Trayce Jackson-Davis,GSW,GSW,WAS,,,28,25,13,18
22023,1631218,22300362,"DEC 19, 2023",GSW vs. BOS,W,29,5,7,0.714,0,0,0.0,0,0,0.0,4,9,13,1,0,3,1,3,10,25,1,Trayce Jackson-Davis,GSW,GSW,BOS,,,24,23,11,14
22023,1631218,22300348,"DEC 17, 2023",GSW @ POR,W,18,6,9,0.667,0,0,0.0,2,2,1.0,5,3,8,3,2,1,2,2,14,8,1,Trayce Jackson-Davis,GSW,POR,GSW,,,25,22,17,11
22023,1631218,22300325,"DEC 14, 2023",GSW @ LAC,L,5,1,3,0.333,0,0,0.0,0,0,0.0,3,0,3,0,0,0,0,0,2,-11,1,Trayce Jackson-Davis,GSW,LAC,GSW,,,5,5,2,3
22023,1631218,22300308,"DEC 12, 2023",GSW @ PHX,L,7,1,1,1.0,0,0,0.0,0,0,0.0,0,0,0,0,1,1,0,1,2,-6,1,Trayce Jackson-Davis,GSW,PHX,GSW,,,2,2,2,0
22023,1631218,22300051,"NOV 24, 2023",GSW vs. SAS,W,5,0,1,0.0,0,0,0.0,2,2,1.0,0,0,0,0,0,1,1,1,2,1,1,Trayce Jackson-Davis,GSW,GSW,SAS,,,2,2,2,0
22023,1631218,22300236,"NOV 22, 2023",GSW @ PHX,L,15,2,3,0.667,0,0,0.0,2,5,0.4,2,2,4,0,1,0,1,3,6,-5,1,Trayce Jackson-Davis,GSW,PHX,GSW,,,10,10,6,4
22023,1631218,22300224,"NOV 20, 2023",GSW vs. HOU,W,4,0,0,0.0,0,0,0.0,0,0,0.0,0,0,0,0,0,0,0,0,0,1,1,Trayce Jackson-Davis,GSW,GSW,HOU,,,0,0,0,0
22023,1631218,22300201,"NOV 16, 2023",GSW vs. OKC,L,5,0,0,0.0,0,0,0.0,0,0,0.0,0,0,0,0,0,1,0,0,0,1,1,Trayce Jackson-Davis,GSW,GSW,OKC,,,0,0,0,0
22023,1631218,22300025,"NOV 14, 2023",GSW vs. MIN,L,12,0,1,0.0,0,0,0.0,2,2,1.0,0,2,2,3,0,0,2,2,2,-2,1,Trayce Jackson-Davis,GSW,GSW,MIN,,,7,4,5,5
22023,1631218,22300186,"NOV 12, 2023",GSW vs. MIN,L,1,1,1,1.0,0,0,0.0,0,0,0.0,0,0,0,1,0,0,0,0,2,6,1,Trayce Jackson-Davis,GSW,GSW,MIN,,,3,2,3,1
22023,1631218,22300176,"NOV 11, 2023",GSW vs. CLE,L,6,0,1,0.0,0,0,0.0,1,2,0.5,1,0,1,0,0,0,0,1,1,4,1,Trayce Jackson-Davis,GSW,GSW,CLE,,,2,2,1,1
22023,1631218,22300169,"NOV 08, 2023",GSW @ DEN,L,18,2,3,0.667,0,0,0.0,4,5,0.8,0,2,2,1,0,0,0,4,8,4,1,Trayce Jackson-Davis,GSW,DEN,GSW,,,11,10,9,3
22023,1631218,22300145,"NOV 06, 2023",GSW @ DET,W,0,0,0,0.0,0,0,0.0,0,0,0.0,0,0,0,0,0,0,0,0,0,1,1,Trayce Jackson-Davis,GSW,DET,GSW,,,0,0,0,0
22023,1631218,22300142,"NOV 05, 2023",GSW @ CLE,L,12,2,3,0.667,0,0,0.0,1,5,0.2,1,3,4,1,1,1,0,4,5,8,1,Trayce Jackson-Davis,GSW,CLE,GSW,,,10,9,6,5
22023,1631218,22300126,"NOV 01, 2023",GSW vs. SAC,W,0,0,0,0.0,0,0,0.0,0,0,0.0,0,0,0,0,0,0,0,0,0,0,1,Trayce Jackson-Davis,GSW,GSW,SAC,,,0,0,0,0
22023,1631218,22300108,"OCT 30, 2023",GSW @ NOP,W,20,5,9,0.556,0,0,0.0,3,4,0.75,7,2,9,0,0,4,2,2,13,11,1,Trayce Jackson-Davis,GSW,NOP,GSW,,,22,22,13,9
22023,1631218,22300087,"OCT 27, 2023",GSW @ SAC,W,5,0,0,0.0,0,0,0.0,0,0,0.0,0,1,1,0,0,0,0,1,0,7,1,Trayce Jackson-Davis,GSW,SAC,GSW,,,1,1,0,1
22023,2544,22300565,"JAN 15, 2024",LAL vs. OKC,W,39,12,20,0.6,1,2,0.5,0,1,0.0,0,7,7,6,0,0,5,1,25,2,1,LeBron James,LAL,LAL,OKC,,,38,32,31,13
22023,2544,22300531,"JAN 11, 2024",LAL vs. PHX,L,24,3,11,0.273,0,4,0.0,4,7,0.571,0,5,5,9,1,0,4,1,10,-25,1,LeBron James,LAL,LAL,PHX,,,24,15,19,14
22023,2544,22300516,"JAN 09, 2024",LAL vs. TOR,W,35,8,17,0.471,2,5,0.4,4,6,0.667,0,5,5,12,1,1,3,0,22,0,1,LeBron James,LAL,LAL,TOR,,,39,27,34,17
22023,2544,22300505,"JAN 07, 2024",LAL vs. LAC,W,38,11,19,0.579,1,3,0.333,2,3,0.667,1,7,8,7,1,0,4,2,25,5,1,LeBron James,LAL,LAL,LAC,,,40,33,32,15
22023,2544,22300491,"JAN 05, 2024",LAL vs. MEM,L,39,11,24,0.458,4,9,0.444,6,10,0.6,2,3,5,7,5,0,4,0,32,-8,1,LeBron James,LAL,LAL,MEM,,,44,37,39,12
22023,2544,22300475,"JAN 03, 2024",LAL vs. MIA,L,38,6,18,0.333,0,6,0.0,0,0,0.0,0,6,6,9,0,0,2,2,12,-20,1,LeBron James,LAL,LAL,MIA,,,27,18,21,15
22023,2544,22300446,"DEC 31, 2023",LAL @ NOP,L,37,12,24,0.5,3,7,0.429,7,8,0.875,0,5,5,8,0,1,4,2,34,-11,1,LeBron James,LAL,NOP,LAL,,,47,39,42,13
22023,2544,22300443,"DEC 30, 2023",LAL @ MIN,L,39,10,21,0.476,1,4,0.25,5,7,0.714,0,3,3,6,3,1,1,2,26,-5,1,LeBron James,LAL,MIN,LAL,,,35,29,32,9
22023,2544,22300428,"DEC 28, 2023",LAL vs. CHA,W,25,7,13,0.538,2,5,0.4,1,1,1.0,0,4,4,11,0,0,3,0,17,1,1,LeBron James,LAL,LAL,CHA,,,32,21,28,15
22023,2544,22300403,"DEC 25, 2023",LAL vs. BOS,L,37,5,14,0.357,1,2,0.5,5,6,0.833,0,9,9,8,0,0,3,1,16,-11,1,LeBron James,LAL,LAL,BOS,,,33,25,24,17
22023,2544,22300397,"DEC 23, 2023",LAL @ OKC,W,37,13,20,0.65,5,5,1.0,9,9,1.0,2,5,7,7,2,2,3,0,40,10,1,LeBron James,LAL,OKC,LAL,,,54,47,47,14
22023,2544,22300370,"DEC 20, 2023",LAL @ CHI,L,37,10,18,0.556,1,3,0.333,4,4,1.0,2,8,10,9,1,2,5,0,25,-11,1,LeBron James,LAL,CHI,LAL,,,44,35,34,19
22023,2544,22300359,"DEC 18, 2023",LAL vs. NYK,L,39,10,23,0.435,2,8,0.25,3,4,0.75,1,10,11,11,1,0,2,1,25,-13,1,LeBron James,LAL,LAL,NYK,,,47,36,36,22
22023,2544,22300331,"DEC 15, 2023",LAL @ SAS,L,36,7,17,0.412,2,6,0.333,7,10,0.7,2,5,7,14,2,0,2,1,23,-28,1,LeBron James,LAL,SAS,LAL,,,44,30,37,21
22023,2544,22300306,"DEC 12, 2023",LAL @ DAL,L,40,14,27,0.519,3,8,0.375,2,3,0.667,2,6,8,9,3,1,4,1,33,-4,1,LeBron James,LAL,DAL,LAL,,,50,41,42,17
22023,2544,22301230,"DEC 07, 2023",LAL vs. NOP,W,23,9,12,0.75,4,4,1.0,8,8,1.0,0,5,5,8,0,0,0,1,30,36,1,LeBron James,LAL,LAL,NOP,,,43,35,38,13
22023,2544,22301203,"DEC 05, 2023",LAL vs. PHX,W,40,12,25,0.48,2,4,0.5,5,6,0.833,3,5,8,11,5,0,2,3,31,12,1,LeBron James,LAL,LAL,PHX,,,50,39,42,19
22023,2544,22300291,"DEC 02, 2023",LAL vs. HOU,W,35,7,17,0.412,0,4,0.0,2,5,0.4,0,4,4,7,1,1,5,0,16,16,1,LeBron James,LAL,LAL,HOU,,,27,20,23,11
22023,2544,22300271,"NOV 30, 2023",LAL @ OKC,L,35,7,12,0.583,4,8,0.5,3,4,0.75,2,10,12,6,1,1,5,1,21,-18,1,LeBron James,LAL,OKC,LAL,,,39,33,27,18
22023,2544,22300258,"NOV 29, 2023",LAL @ DET,W,29,9,19,0.474,2,6,0.333,5,5,1.0,2,6,8,3,0,0,1,0,25,26,1,LeBron James,LAL,DET,LAL,,,36,33,28,11
22023,2544,22300255,"NOV 27, 2023",LAL @ PHI,L,30,8,12,0.667,1,1,1.0,1,2,0.5,0,0,0,5,1,1,1,0,18,-30,1,LeBron James,LAL,PHI,LAL,,,23,18,23,5
22023,2544,22300242,"NOV 25, 2023",LAL @ CLE,W,36,8,23,0.348,1,9,0.111,5,7,0.714,1,5,6,6,2,2,4,1,22,2,1,LeBron James,LAL,CLE,LAL,,,34,28,28,12
22023,2544,22300238,"NOV 22, 2023",LAL vs. DAL,L,36,9,19,0.474,4,9,0.444,4,7,0.571,2,7,9,7,0,0,3,0,26,7,1,LeBron James,LAL,LAL,DAL,,,42,35,33,16
22023,2544,22300042,"NOV 21, 2023",LAL vs. UTA,W,24,6,10,0.6,3,5,0.6,2,2,1.0,1,6,7,9,0,0,2,0,17,14,1,LeBron James,LAL,LAL,UTA,,,33,24,26,16
22023,2544,22300216,"NOV 19, 2023",LAL vs. HOU,W,40,14,19,0.737,2,5,0.4,7,9,0.778,1,5,6,8,3,0,2,0,37,2,1,LeBron James,LAL,LAL,HOU,,,51,43,45,14
22023,2544,22300036,"NOV 17, 2023",LAL @ POR,W,35,13,22,0.591,5,9,0.556,4,6,0.667,0,5,5,9,2,0,3,3,35,19,1,LeBron James,LAL,POR,LAL,,,49,40,44,14
22023,2544,22300198,"NOV 15, 2023",LAL vs. SAC,L,35,9,15,0.6,3,7,0.429,7,8,0.875,2,8,10,12,4,1,6,1,28,0,1,LeBron James,LAL,LAL,SAC,,,50,38,40,22
22023,2544,22300026,"NOV 14, 2023",LAL vs. MEM,W,23,6,11,0.545,3,6,0.5,1,2,0.5,0,9,9,6,1,0,4,1,16,15,1,LeBron James,LAL,LAL,MEM,,,31,25,22,15
22023,2544,22300015,"NOV 10, 2023",LAL @ PHX,W,36,11,17,0.647,3,4,0.75,7,11,0.636,1,10,11,6,1,1,4,1,32,2,1,LeBron James,LAL,PHX,LAL,,,49,43,38,17
22023,2544,22300163,"NOV 08, 2023",LAL @ HOU,L,27,7,13,0.538,0,2,0.0,4,5,0.8,1,5,6,2,0,0,3,1,18,-24,1,LeBron James,LAL,HOU,LAL,,,26,24,20,8
22023,2544,22300150,"NOV 06, 2023",LAL @ MIA,L,37,13,23,0.565,0,4,0.0,4,4,1.0,0,4,4,3,1,3,5,4,30,6,1,LeBron James,LAL,MIA,LAL,,,37,34,33,7
22023,2544,22300134,"NOV 04, 2023",LAL @ ORL,L,35,8,15,0.533,2,5,0.4,6,7,0.857,1,8,9,5,3,0,3,1,24,12,1,LeBron James,LAL,ORL,LAL,,,38,33,29,14
22023,2544,22300127,"NOV 01, 2023",LAL vs. LAC,W,42,13,19,0.684,4,8,0.5,5,10,0.5,0,12,12,7,1,2,4,3,35,6,1,LeBron James,LAL,LAL,LAC,,,54,47,42,19
22023,2544,22300111,"OCT 30, 2023",LAL vs. ORL,W,33,7,17,0.412,2,6,0.333,3,4,0.75,0,3,3,4,3,1,5,0,19,5,1,LeBron James,LAL,LAL,ORL,,,26,22,23,7
22023,2544,22300100,"OCT 29, 2023",LAL @ SAC,L,39,11,19,0.579,3,8,0.375,2,6,0.333,0,15,15,8,0,0,8,2,27,-5,1,LeBron James,LAL,SAC,LAL,,,50,42,35,23
22023,2544,22300076,"OCT 26, 2023",LAL vs. PHX,W,35,7,14,0.5,1,5,0.2,6,8,0.75,1,7,8,9,2,2,5,1,21,22,1,LeBron James,LAL,LAL,PHX,,,38,29,30,17
22023,2544,22300061,"OCT 24, 2023",LAL @ DEN,L,29,10,16,0.625,1,4,0.25,0,1,0.0,1,7,8,5,1,0,0,1,21,7,1,LeBron James,LAL,DEN,LAL,,,34,29,26,13
22023,1631170,22300551,"JAN 14, 2024",MIA vs. CHA,W,15,7,11,0.636,0,0,0.0,1,1,1.0,1,4,5,2,1,0,0,1,15,8,1,Jaime Jaquez Jr.,MIA,MIA,CHA,,,22,20,17,7
22023,1631170,22300535,"JAN 12, 2024",MIA vs. ORL,W,37,8,16,0.5,0,2,0.0,3,3,1.0,4,3,7,3,1,0,3,3,19,-4,1,Jaime Jaquez Jr.,MIA,MIA,ORL,,,29,26,22,10
22023,1631170,22300522,"JAN 10, 2024",MIA vs. OKC,L,34,6,9,0.667,3,5,0.6,6,9,0.667,0,5,5,2,0,0,3,4,21,-4,1,Jaime Jaquez Jr.,MIA,MIA,OKC,,,28,26,23,7
22023,1631170,22300509,"JAN 08, 2024",MIA vs. HOU,W,39,5,11,0.455,1,2,0.5,3,4,0.75,0,4,4,4,1,0,2,1,14,6,1,Jaime Jaquez Jr.,MIA,MIA,HOU,,,22,18,18,8
22023,1631170,22300489,"JAN 05, 2024",MIA @ PHX,L,35,5,7,0.714,0,2,0.0,0,0,0.0,1,2,3,1,2,0,3,4,10,-18,1,Jaime Jaquez Jr.,MIA,PHX,MIA,,,14,13,11,4
22023,1631170,22300475,"JAN 03, 2024",MIA @ LAL,W,39,7,14,0.5,2,6,0.333,0,0,0.0,0,0,0,8,1,1,2,1,16,24,1,Jaime Jaquez Jr.,MIA,LAL,MIA,,,24,16,24,8
22023,1631170,22300458,"JAN 01, 2024",MIA @ LAC,L,38,6,13,0.462,0,3,0.0,3,4,0.75,3,1,4,2,4,0,2,2,15,-17,1,Jaime Jaquez Jr.,MIA,LAC,MIA,,,21,19,17,6
22023,1631170,22300439,"DEC 30, 2023",MIA @ UTA,L,35,2,9,0.222,0,4,0.0,5,5,1.0,0,1,1,1,0,0,2,4,9,-16,1,Jaime Jaquez Jr.,MIA,UTA,MIA,,,11,10,10,2
22023,1631170,22300426,"DEC 28, 2023",MIA @ GSW,W,39,7,15,0.467,2,5,0.4,1,2,0.5,1,4,5,6,1,0,2,2,17,8,1,Jaime Jaquez Jr.,MIA,GSW,MIA,,,28,22,23,11
22023,1631170,22300404,"DEC 25, 2023",MIA vs. PHI,W,39,11,15,0.733,1,3,0.333,8,8,1.0,5,5,10,1,2,0,0,3,31,-1,1,Jaime Jaquez Jr.,MIA,MIA,PHI,,,42,41,32,11
22023,1631170,22300384,"DEC 22, 2023",MIA vs. ATL,W,37,7,14,0.5,1,1,1.0,4,5,0.8,4,3,7,1,1,1,2,4,19,11,1,Jaime Jaquez Jr.,MIA,MIA,ATL,,,27,26,20,8
22023,1631170,22300366,"DEC 20, 2023",MIA @ ORL,W,34,3,10,0.3,0,3,0.0,4,6,0.667,2,1,3,1,1,1,1,1,10,-8,1,Jaime Jaquez Jr.,MIA,ORL,MIA,,,14,13,11,4
22023,1631170,22300353,"DEC 18, 2023",MIA vs. MIN,L,30,3,8,0.375,0,1,0.0,2,2,1.0,1,2,3,0,2,2,3,4,8,-1,1,Jaime Jaquez Jr.,MIA,MIA,MIN,,,11,11,8,3
22023,1631170,22300337,"DEC 16, 2023",MIA vs. CHI,W,35,8,14,0.571,1,3,0.333,1,1,1.0,1,4,5,4,2,0,2,1,18,8,1,Jaime Jaquez Jr.,MIA,MIA,CHI,,,27,23,22,9
22023,1631170,22300320,"DEC 14, 2023",MIA vs. CHI,L,34,6,14,0.429,1,4,0.25,9,10,0.9,0,4,4,4,0,0,2,4,22,3,1,Jaime Jaquez Jr.,MIA,MIA,CHI,,,30,26,26,8
22023,1631170,22300312,"DEC 13, 2023",MIA vs. CHA,W,33,7,16,0.438,2,2,1.0,1,1,1.0,2,4,6,8,1,0,2,0,17,-3,1,Jaime Jaquez Jr.,MIA,MIA,CHA,,,31,23,25,14
22023,1631170,22300292,"DEC 11, 2023",MIA @ CHA,W,24,5,8,0.625,2,3,0.667,6,6,1.0,0,0,0,1,0,0,2,6,18,-2,1,Jaime Jaquez Jr.,MIA,CHA,MIA,,,19,18,19,1
22023,1631170,22301220,"DEC 08, 2023",MIA vs. CLE,L,35,7,13,0.538,0,2,0.0,0,0,0.0,1,2,3,3,0,1,3,3,14,1,1,Jaime Jaquez Jr.,MIA,MIA,CLE,,,20,17,17,6
22023,1631170,22301207,"DEC 06, 2023",MIA @ TOR,W,32,6,13,0.462,1,4,0.25,2,2,1.0,0,0,0,2,0,0,2,2,15,-16,1,Jaime Jaquez Jr.,MIA,TOR,MIA,,,17,15,17,2
22023,1631170,22300284,"DEC 02, 2023",MIA vs. IND,L,29,4,9,0.444,1,2,0.5,2,5,0.4,0,3,3,3,2,0,0,1,11,-6,1,Jaime Jaquez Jr.,MIA,MIA,IND,,,17,14,14,6
22023,1631170,22300267,"NOV 30, 2023",MIA vs. IND,W,33,8,13,0.615,1,3,0.333,7,7,1.0,0,5,5,1,1,0,3,3,24,18,1,Jaime Jaquez Jr.,MIA,MIA,IND,,,30,29,25,6
22023,1631170,22300056,"NOV 28, 2023",MIA vs. MIL,L,33,7,9,0.778,0,1,0.0,0,0,0.0,1,3,4,6,1,1,1,5,14,5,1,Jaime Jaquez Jr.,MIA,MIA,MIL,,,24,18,20,10
22023,1631170,22300240,"NOV 25, 2023",MIA @ BKN,L,31,8,15,0.533,2,3,0.667,0,0,0.0,1,4,5,4,1,0,2,1,18,-18,1,Jaime Jaquez Jr.,MIA,BKN,MIA,,,27,23,22,9
22023,1631170,22300045,"NOV 24, 2023",MIA @ NYK,L,35,6,17,0.353,1,6,0.167,2,2,1.0,3,2,5,4,1,0,0,3,15,-18,1,Jaime Jaquez Jr.,MIA,NYK,MIA,,,24,20,19,9
22023,1631170,22300229,"NOV 22, 2023",MIA @ CLE,W,28,7,10,0.7,4,4,1.0,4,5,0.8,2,6,8,1,1,0,6,1,22,16,1,Jaime Jaquez Jr.,MIA,CLE,MIA,,,31,30,23,9
22023,1631170,22300220,"NOV 20, 2023",MIA @ CHI,W,33,8,13,0.615,3,4,0.75,0,0,0.0,2,1,3,4,2,0,0,1,19,24,1,Jaime Jaquez Jr.,MIA,CHI,MIA,,,26,22,23,7
22023,1631170,22300204,"NOV 18, 2023",MIA @ CHI,L,27,2,4,0.5,1,1,1.0,1,2,0.5,1,2,3,0,0,0,3,4,6,-25,1,Jaime Jaquez Jr.,MIA,CHI,MIA,,,9,9,6,3
22023,1631170,22300200,"NOV 16, 2023",MIA vs. BKN,W,33,4,9,0.444,2,5,0.4,0,0,0.0,0,4,4,5,0,0,1,3,10,4,1,Jaime Jaquez Jr.,MIA,MIA,BKN,,,19,14,15,9
22023,1631170,22300017,"NOV 14, 2023",MIA @ CHA,W,33,8,13,0.615,1,3,0.333,0,0,0.0,4,1,5,1,0,0,1,3,17,6,1,Jaime Jaquez Jr.,MIA,CHA,MIA,,,23,22,18,6
22023,1631170,22300184,"NOV 12, 2023",MIA @ SAS,W,32,4,10,0.4,1,2,0.5,2,2,1.0,1,5,6,3,3,1,1,1,11,10,1,Jaime Jaquez Jr.,MIA,SAS,MIA,,,20,17,14,9
22023,1631170,22300175,"NOV 11, 2023",MIA @ ATL,W,38,8,17,0.471,2,7,0.286,2,2,1.0,1,2,3,4,1,0,3,3,20,2,1,Jaime Jaquez Jr.,MIA,ATL,MIA,,,27,23,24,7
22023,1631170,22300164,"NOV 08, 2023",MIA @ MEM,W,21,4,5,0.8,1,1,1.0,2,3,0.667,0,3,3,2,2,0,0,5,11,-6,1,Jaime Jaquez Jr.,MIA,MEM,MIA,,,16,14,13,5
22023,1631170,22300150,"NOV 06, 2023",MIA vs. LAL,W,18,4,7,0.571,1,4,0.25,0,0,0.0,1,1,2,1,1,0,1,1,9,0,1,Jaime Jaquez Jr.,MIA,MIA,LAL,,,12,11,10,3
22023,1631170,22300003,"NOV 03, 2023",MIA vs. WAS,W,22,4,5,0.8,0,1,0.0,1,1,1.0,3,2,5,3,1,0,0,1,9,3,1,Jaime Jaquez Jr.,MIA,MIA,WAS,,,17,14,12,8
22023,1631170,22300119,"NOV 01, 2023",MIA vs. BKN,L,19,1,9,0.111,0,6,0.0,0,0,0.0,2,2,4,1,2,1,2,4,2,7,1,Jaime Jaquez Jr.,MIA,MIA,BKN,,,7,6,3,5
22023,1631170,22300107,"OCT 30, 2023",MIA @ MIL,L,23,3,9,0.333,2,5,0.4,0,0,0.0,1,1,2,3,1,1,0,2,8,-7,1,Jaime Jaquez Jr.,MIA,MIL,MIA,,,13,10,11,5
22023,1631170,22300093,"OCT 28, 2023",MIA @ MIN,L,18,3,4,0.75,1,2,0.5,0,0,0.0,0,3,3,1,0,0,3,0,7,5,1,Jaime Jaquez Jr.,MIA,MIN,MIA,,,11,10,8,4
22023,1631170,22300080,"OCT 27, 2023",MIA @ BOS,L,14,0,2,0.0,0,1,0.0,0,0,0.0,0,2,2,2,0,0,1,2,0,-8,1,Jaime Jaquez Jr.,MIA,BOS,MIA,,,4,2,2,4
22023,1631170,22300068,"OCT 25, 2023",MIA vs. DET,W,13,3,3,1.0,0,0,0.0,0,0,0.0,0,2,2,2,2,0,1,2,6,4,1,Jaime Jaquez Jr.,MIA,MIA,DET,,,10,8,8,4
22023,1629610,22300368,"DEC 20, 2023",NYK @ BKN,W,3,2,3,0.667,0,0,0.0,0,0,0.0,0,0,0,0,0,0,0,1,4,-6,1,DaQuan Jeffries,NYK,BKN,NYK,,,4,4,4,0
22023,1629610,22300343,"DEC 16, 2023",NYK @ LAC,L,6,0,1,0.0,0,1,0.0,0,0,0.0,0,2,2,1,0,0,0,0,0,2,1,DaQuan Jeffries,NYK,LAC,NYK,,,3,2,1,3
22023,1629610,22300333,"DEC 15, 2023",NYK @ PHX,W,1,0,0,0.0,0,0,0.0,0,0,0.0,0,0,0,0,0,0,0,0,0,-1,1,DaQuan Jeffries,NYK,PHX,NYK,,,0,0,0,0
22023,1629610,22300057,"NOV 28, 2023",NYK vs. CHA,W,1,0,0,0.0,0,0,0.0,0,0,0.0,0,0,0,0,0,0,0,0,0,-1,1,DaQuan Jeffries,NYK,NYK,CHA,,,0,0,0,0
22023,1629610,22300221,"NOV 20, 2023",NYK @ MIN,L,3,0,3,0.0,0,1,0.0,0,2,0.0,0,1,1,0,0,0,0,0,0,0,1,DaQuan Jeffries,NYK,MIN,NYK,,,1,1,0,1
22023,1629610,22300028,"NOV 17, 2023",NYK @ WAS,W,2,0,0,0.0,0,0,0.0,0,0,0.0,0,0,0,0,0,0,0,0,0,1,1,DaQuan Jeffries,NYK,WAS,NYK,,,0,0,0,0
22023,1629610,22300177,"NOV 12, 2023",NYK vs. CHA,W,3,1,1,1.0,0,0,0.0,0,0,0.0,0,0,0,1,0,0,0,0,2,-7,1,DaQuan Jeffries,NYK,NYK,CHA,,,3,2,3,1
22023,1629610,22300161,"NOV 08, 2023",NYK vs. SAS,W,2,0,1,0.0,0,1,0.0,0,0,0.0,0,1,1,0,0,0,1,0,0,-2,1,DaQuan Jeffries,NYK,NYK,SAS,,,1,1,0,1
22023,1629610,22300112,"OCT 31, 2023",NYK @ CLE,W,4,0,1,0.0,0,1,0.0,0,0,0.0,0,0,0,0,0,0,0,1,0,-5,1,DaQuan Jeffries,NYK,CLE,NYK,,,0,0,0,0
22023,1629610,22300090,"OCT 28, 2023",NYK @ NOP,L,3,2,2,1.0,1,1,1.0,0,0,0.0,0,1,1,0,0,0,0,0,5,10,1,DaQuan Jeffries,NYK,NOP,NYK,,,6,6,5,1
22023,1629660,22300081,"OCT 27, 2023",CLE vs. OKC,L,9,1,3,0.333,0,1,0.0,0,0,0.0,1,0,1,3,0,0,1,1,2,-7,1,Ty Jerome,CLE,CLE,OKC,,,6,3,5,4
22023,1629660,22300067,"OCT 25, 2023",CLE @ BKN,W,6,1,1,1.0,0,0,0.0,0,0,0.0,0,0,0,0,0,0,0,1,2,-7,1,Ty Jerome,CLE,BKN,CLE,,,2,2,2,0
22023,1630198,22300565,"JAN 15, 2024",OKC @ LAL,L,20,2,10,0.2,0,6,0.0,0,0,0.0,2,5,7,1,2,0,1,1,4,4,1,Isaiah Joe,OKC,LAL,OKC,,,12,11,5,8
22023,1630198,22300546,"JAN 13, 2024",OKC vs. ORL,W,16,4,8,0.5,1,4,0.25,0,0,0.0,0,2,2,1,0,0,1,1,9,1,1,Isaiah Joe,OKC,OKC,ORL,,,12,11,10,3
22023,1630198,22300529,"JAN 11, 2024",OKC vs. POR,W,7,0,0,0.0,0,0,0.0,0,0,0.0,0,1,1,1,1,0,0,0,0,10,1,Isaiah Joe,OKC,OKC,POR,,,2,1,1,2
22023,1630198,22300522,"JAN 10, 2024",OKC @ MIA,W,22,4,7,0.571,3,6,0.5,0,0,0.0,1,1,2,0,0,0,1,1,11,-4,1,Isaiah Joe,OKC,MIA,OKC,,,13,13,11,2
22023,1630198,22300508,"JAN 08, 2024",OKC @ WAS,W,21,6,10,0.6,4,7,0.571,0,0,0.0,1,3,4,3,0,0,1,0,16,-5,1,Isaiah Joe,OKC,WAS,OKC,,,23,20,19,7
22023,1630198,22300481,"JAN 05, 2024",OKC @ BKN,L,20,1,5,0.2,1,3,0.333,0,0,0.0,0,1,1,1,0,1,1,1,3,3,1,Isaiah Joe,OKC,BKN,OKC,,,5,4,4,2
22023,1630198,22300467,"JAN 03, 2024",OKC @ ATL,L,18,4,8,0.5,1,5,0.2,0,0,0.0,1,0,1,1,1,0,2,2,9,-3,1,Isaiah Joe,OKC,ATL,OKC,,,11,10,10,2
22023,1630198,22300462,"JAN 02, 2024",OKC vs. BOS,W,13,4,5,0.8,2,3,0.667,0,0,0.0,0,3,3,0,0,0,1,1,10,-4,1,Isaiah Joe,OKC,OKC,BOS,,,13,13,10,3
22023,1630198,22300447,"DEC 31, 2023",OKC vs. BKN,W,16,2,2,1.0,2,2,1.0,1,2,0.5,0,1,1,0,0,0,2,1,7,7,1,Isaiah Joe,OKC,OKC,BKN,,,8,8,7,1
22023,1630198,22300435,"DEC 29, 2023",OKC @ DEN,W,13,2,6,0.333,1,5,0.2,0,0,0.0,0,1,1,1,0,0,0,0,5,11,1,Isaiah Joe,OKC,DEN,OKC,,,7,6,6,2
22023,1630198,22300419,"DEC 27, 2023",OKC vs. NYK,W,16,3,6,0.5,2,4,0.5,0,0,0.0,0,2,2,0,0,0,0,1,8,3,1,Isaiah Joe,OKC,OKC,NYK,,,10,10,8,2
22023,1630198,22300411,"DEC 26, 2023",OKC vs. MIN,W,16,3,4,0.75,2,3,0.667,0,0,0.0,1,1,2,2,0,0,0,3,8,9,1,Isaiah Joe,OKC,OKC,MIN,,,12,10,10,4
22023,1630198,22300397,"DEC 23, 2023",OKC vs. LAL,L,20,3,11,0.273,1,6,0.167,0,0,0.0,1,4,5,1,0,2,2,1,7,-20,1,Isaiah Joe,OKC,OKC,LAL,,,13,12,8,6
22023,1630198,22300379,"DEC 21, 2023",OKC vs. LAC,W,25,4,8,0.5,3,7,0.429,0,0,0.0,1,1,2,0,0,1,0,2,11,-11,1,Isaiah Joe,OKC,OKC,LAC,,,13,13,11,2
22023,1630198,22300355,"DEC 18, 2023",OKC vs. MEM,W,19,2,5,0.4,1,3,0.333,0,0,0.0,1,3,4,3,1,0,0,1,5,11,1,Isaiah Joe,OKC,OKC,MEM,,,12,9,8,7
22023,1630198,22300340,"DEC 16, 2023",OKC @ DEN,W,27,4,7,0.571,1,4,0.25,3,4,0.75,0,2,2,1,1,1,3,1,12,12,1,Isaiah Joe,OKC,DEN,OKC,,,15,14,13,3
22023,1630198,22300324,"DEC 14, 2023",OKC @ SAC,L,15,2,7,0.286,1,5,0.2,1,1,1.0,0,1,1,0,0,0,0,1,6,-6,1,Isaiah Joe,OKC,SAC,OKC,,,7,7,6,1
22023,1630198,22300302,"DEC 11, 2023",OKC vs. UTA,W,15,3,8,0.375,3,7,0.429,0,0,0.0,0,0,0,1,0,1,0,1,9,18,1,Isaiah Joe,OKC,OKC,UTA,,,10,9,10,1
22023,1630198,22301222,"DEC 08, 2023",OKC vs. GSW,W,23,1,4,0.25,0,3,0.0,3,3,1.0,0,1,1,1,3,0,0,1,5,28,1,Isaiah Joe,OKC,OKC,GSW,,,7,6,6,2
22023,1630198,22301212,"DEC 06, 2023",OKC @ HOU,L,14,1,5,0.2,1,4,0.25,0,0,0.0,0,1,1,0,0,0,1,1,3,3,1,Isaiah Joe,OKC,HOU,OKC,,,4,4,3,1
22023,1630198,22300287,"DEC 02, 2023",OKC @ DAL,W,25,2,6,0.333,2,5,0.4,0,0,0.0,1,6,7,2,0,0,0,1,6,10,1,Isaiah Joe,OKC,DAL,OKC,,,15,13,8,9
22023,1630198,22300271,"NOV 30, 2023",OKC vs. LAL,W,20,4,8,0.5,2,6,0.333,0,0,0.0,0,5,5,0,1,3,0,0,10,19,1,Isaiah Joe,OKC,OKC,LAL,,,15,15,10,5
22023,1630198,22300058,"NOV 28, 2023",OKC @ MIN,L,24,3,7,0.429,1,5,0.2,2,2,1.0,0,1,1,3,3,0,0,2,9,11,1,Isaiah Joe,OKC,MIN,OKC,,,13,10,12,4
22023,1630198,22300239,"NOV 25, 2023",OKC vs. PHI,L,26,4,14,0.286,3,12,0.25,2,2,1.0,0,3,3,2,0,0,0,3,13,3,1,Isaiah Joe,OKC,OKC,PHI,,,18,16,15,5
22023,1630198,22300234,"NOV 22, 2023",OKC vs. CHI,W,27,6,9,0.667,5,7,0.714,3,3,1.0,0,1,1,0,0,1,0,0,20,11,1,Isaiah Joe,OKC,OKC,CHI,,,21,21,20,1
22023,1630198,22300215,"NOV 19, 2023",OKC @ POR,W,14,5,6,0.833,5,6,0.833,0,0,0.0,0,1,1,1,1,0,1,0,15,20,1,Isaiah Joe,OKC,POR,OKC,,,17,16,16,2
22023,1630198,22300207,"NOV 18, 2023",OKC @ GSW,W,27,4,9,0.444,2,4,0.5,0,0,0.0,0,4,4,3,1,1,0,2,10,17,1,Isaiah Joe,OKC,GSW,OKC,,,17,14,13,7
22023,1630198,22300201,"NOV 16, 2023",OKC @ GSW,W,25,7,7,1.0,7,7,1.0,2,3,0.667,0,5,5,0,1,0,0,1,23,21,1,Isaiah Joe,OKC,GSW,OKC,,,28,28,23,5
22023,1630198,22300021,"NOV 14, 2023",OKC vs. SAS,W,14,3,5,0.6,2,3,0.667,0,0,0.0,0,2,2,1,2,0,0,1,8,12,1,Isaiah Joe,OKC,OKC,SAS,,,11,10,9,3
22023,1630198,22300185,"NOV 12, 2023",OKC @ PHX,W,16,1,3,0.333,1,2,0.5,0,0,0.0,0,1,1,1,1,1,0,1,3,-13,1,Isaiah Joe,OKC,PHX,OKC,,,5,4,4,2
22023,1630198,22300016,"NOV 10, 2023",OKC @ SAC,L,20,3,9,0.333,3,8,0.375,0,0,0.0,0,1,1,0,1,0,1,0,9,13,1,Isaiah Joe,OKC,SAC,OKC,,,10,10,9,1
22023,1630198,22300167,"NOV 08, 2023",OKC vs. CLE,W,18,2,7,0.286,2,6,0.333,0,0,0.0,0,3,3,0,0,0,1,4,6,8,1,Isaiah Joe,OKC,OKC,CLE,,,9,9,6,3
22023,1630198,22300155,"NOV 06, 2023",OKC vs. ATL,W,20,4,8,0.5,4,8,0.5,0,0,0.0,0,3,3,3,0,0,0,1,12,5,1,Isaiah Joe,OKC,OKC,ATL,,,18,15,15,6
22023,1630198,22300005,"NOV 03, 2023",OKC vs. GSW,L,26,4,6,0.667,3,5,0.6,5,6,0.833,0,0,0,1,0,0,1,0,16,-2,1,Isaiah Joe,OKC,OKC,GSW,,,17,16,17,1
22023,1630198,22300121,"NOV 01, 2023",OKC vs. NOP,L,14,2,7,0.286,2,7,0.286,3,3,1.0,0,1,1,1,0,0,0,0,9,-6,1,Isaiah Joe,OKC,OKC,NOP,,,11,10,10,2
22023,1630198,22300109,"OCT 30, 2023",OKC vs. DET,W,20,3,6,0.5,3,5,0.6,0,0,0.0,0,0,0,0,0,0,1,1,9,2,1,Isaiah Joe,OKC,OKC,DET,,,9,9,9,0
22023,1630198,22300095,"OCT 29, 2023",OKC vs. DEN,L,17,2,7,0.286,1,4,0.25,0,0,0.0,0,2,2,1,4,0,1,3,5,-5,1,Isaiah Joe,OKC,OKC,DEN,,,8,7,6,3
22023,1630198,22300081,"OCT 27, 2023",OKC @ CLE,W,22,2,10,0.2,1,7,0.143,0,1,0.0,0,3,3,2,0,0,1,1,5,12,1,Isaiah Joe,OKC,CLE,OKC,,,10,8,7,5
22023,1630198,22300070,"OCT 25, 2023",OKC @ CHI,W,22,4,8,0.5,3,6,0.5,3,4,0.75,1,4,5,2,1,0,2,2,14,14,1,Isaiah Joe,OKC,CHI,OKC,,,21,19,16,7
22023,1629661,22300562,"JAN 15, 2024",BKN vs. MIA,L,23,3,13,0.231,0,8,0.0,0,0,0.0,0,2,2,0,0,0,0,3,6,-12,1,Cameron Johnson,BKN,BKN,MIA,,,8,8,6,2
22023,1629661,22300527,"JAN 11, 2024",BKN @ CLE,L,23,1,7,0.143,1,5,0.2,0,2,0.0,1,1,2,1,1,0,3,3,3,-11,1,Cameron Johnson,BKN,CLE,BKN,,,6,5,4,3
22023,1629661,22300498,"JAN 07, 2024",BKN vs. POR,L,34,5,11,0.455,3,8,0.375,4,5,0.8,1,5,6,3,1,1,0,3,17,-3,1,Cameron Johnson,BKN,BKN,POR,,,26,23,20,9
22023,1629661,22300481,"JAN 05, 2024",BKN vs. OKC,W,32,3,15,0.2,3,10,0.3,0,0,0.0,1,2,3,2,1,0,0,4,9,-6,1,Cameron Johnson,BKN,BKN,OKC,,,14,12,11,5
22023,1629661,22300469,"JAN 03, 2024",BKN @ HOU,L,32,6,13,0.462,3,6,0.5,0,2,0.0,0,6,6,5,0,1,0,0,15,-5,1,Cameron Johnson,BKN,HOU,BKN,,,26,21,20,11
22023,1629661,22300461,"JAN 02, 2024",BKN @ NOP,L,26,6,12,0.5,5,9,0.556,0,0,0.0,0,4,4,2,1,0,1,2,17,-16,1,Cameron Johnson,BKN,NOP,BKN,,,23,21,19,6
22023,1629661,22300447,"DEC 31, 2023",BKN @ OKC,L,34,5,11,0.455,2,6,0.333,1,2,0.5,1,5,6,0,1,0,1,4,13,-8,1,Cameron Johnson,BKN,OKC,BKN,,,19,19,13,6
22023,1629661,22300430,"DEC 29, 2023",BKN @ WAS,L,33,6,11,0.545,3,5,0.6,1,1,1.0,1,6,7,3,0,0,1,1,16,6,1,Cameron Johnson,BKN,WAS,BKN,,,26,23,19,10
22023,1629661,22300406,"DEC 26, 2023",BKN @ DET,W,26,9,13,0.692,4,6,0.667,2,4,0.5,0,2,2,1,1,0,0,0,24,-6,1,Cameron Johnson,BKN,DET,BKN,,,27,26,25,3
22023,1629661,22300394,"DEC 23, 2023",BKN vs. DET,W,28,6,10,0.6,2,5,0.4,4,4,1.0,0,2,2,2,2,0,1,3,18,6,1,Cameron Johnson,BKN,BKN,DET,,,22,20,20,4
22023,1629661,22300383,"DEC 22, 2023",BKN vs. DEN,L,25,6,9,0.667,3,6,0.5,2,3,0.667,0,1,1,2,1,0,1,2,17,-13,1,Cameron Johnson,BKN,BKN,DEN,,,20,18,19,3
22023,1629661,22300368,"DEC 20, 2023",BKN vs. NYK,L,28,8,14,0.571,4,6,0.667,0,1,0.0,0,4,4,2,0,0,0,3,20,-5,1,Cameron Johnson,BKN,BKN,NYK,,,26,24,22,6
22023,1629661,22300357,"DEC 18, 2023",BKN @ UTA,L,27,2,9,0.222,1,5,0.2,2,2,1.0,1,4,5,1,1,0,1,1,7,-6,1,Cameron Johnson,BKN,UTA,BKN,,,13,12,8,6
22023,1629661,22300339,"DEC 16, 2023",BKN @ GSW,L,29,5,12,0.417,3,7,0.429,0,1,0.0,0,2,2,5,0,0,0,4,13,-2,1,Cameron Johnson,BKN,GSW,BKN,,,20,15,18,7
22023,1629661,22300322,"DEC 14, 2023",BKN @ DEN,L,22,4,10,0.4,2,7,0.286,0,0,0.0,1,2,3,0,0,0,1,2,10,-6,1,Cameron Johnson,BKN,DEN,BKN,,,13,13,10,3
22023,1629661,22300317,"DEC 13, 2023",BKN @ PHX,W,34,5,10,0.5,3,7,0.429,2,2,1.0,1,4,5,4,2,2,1,1,15,2,1,Cameron Johnson,BKN,PHX,BKN,,,24,20,19,9
22023,1629661,22300303,"DEC 11, 2023",BKN @ SAC,L,32,6,13,0.462,3,4,0.75,0,0,0.0,0,4,4,2,1,0,1,0,15,-5,1,Cameron Johnson,BKN,SAC,BKN,,,21,19,17,6
22023,1629661,22301219,"DEC 08, 2023",BKN vs. WAS,W,25,3,8,0.375,1,5,0.2,0,0,0.0,2,3,5,0,0,0,1,3,7,14,1,Cameron Johnson,BKN,BKN,WAS,,,12,12,7,5
22023,1629661,22301209,"DEC 06, 2023",BKN @ ATL,W,30,7,13,0.538,3,6,0.5,0,0,0.0,1,5,6,3,1,0,0,2,17,-5,1,Cameron Johnson,BKN,ATL,BKN,,,26,23,20,9
22023,1629661,22300282,"DEC 02, 2023",BKN vs. ORL,W,30,5,10,0.5,3,6,0.5,1,2,0.5,3,4,7,3,0,0,0,2,14,10,1,Cameron Johnson,BKN,BKN,ORL,,,24,21,17,10
22023,1629661,22300266,"NOV 30, 2023",BKN vs. CHA,L,28,6,18,0.333,3,9,0.333,0,0,0.0,6,0,6,2,0,0,2,1,15,-4,1,Cameron Johnson,BKN,BKN,CHA,,,23,21,17,8
22023,1629661,22300054,"NOV 28, 2023",BKN vs. TOR,W,27,6,11,0.545,1,4,0.25,5,5,1.0,1,8,9,3,0,0,2,1,18,8,1,Cameron Johnson,BKN,BKN,TOR,,,30,27,21,12
22023,1629661,22300250,"NOV 26, 2023",BKN vs. CHI,W,22,4,8,0.5,2,5,0.4,0,0,0.0,2,2,4,6,0,0,0,2,10,-1,1,Cameron Johnson,BKN,BKN,CHI,,,20,14,16,10
22023,1629661,22300240,"NOV 25, 2023",BKN vs. MIA,W,35,8,13,0.615,2,6,0.333,1,2,0.5,1,9,10,5,2,0,1,2,19,29,1,Cameron Johnson,BKN,BKN,MIA,,,34,29,24,15
22023,1629661,22300227,"NOV 22, 2023",BKN @ ATL,L,38,8,13,0.615,5,8,0.625,2,2,1.0,2,3,5,5,2,0,2,1,23,12,1,Cameron Johnson,BKN,ATL,BKN,,,33,28,28,10
22023,1629661,22300208,"NOV 19, 2023",BKN vs. PHI,L,28,3,12,0.25,1,5,0.2,2,2,1.0,3,2,5,2,0,1,2,2,9,-28,1,Cameron Johnson,BKN,BKN,PHI,,,16,14,11,7
22023,1629661,22300200,"NOV 16, 2023",BKN @ MIA,L,27,5,10,0.5,3,6,0.5,3,3,1.0,0,4,4,3,1,0,1,5,16,18,1,Cameron Johnson,BKN,MIA,BKN,,,23,20,19,7
22023,1629661,22300020,"NOV 14, 2023",BKN vs. ORL,W,29,7,11,0.636,3,7,0.429,3,4,0.75,1,4,5,2,3,0,1,1,20,21,1,Cameron Johnson,BKN,BKN,ORL,,,27,25,22,7
22023,1629661,22300178,"NOV 12, 2023",BKN vs. WAS,W,35,5,16,0.313,2,11,0.182,2,2,1.0,1,5,6,1,0,0,3,0,14,15,1,Cameron Johnson,BKN,BKN,WAS,,,21,20,15,7
22023,1629661,22300010,"NOV 10, 2023",BKN @ BOS,L,25,4,13,0.308,3,6,0.5,0,0,0.0,2,3,5,0,0,0,1,3,11,-22,1,Cameron Johnson,BKN,BOS,BKN,,,16,16,11,5
22023,1629661,22300067,"OCT 25, 2023",BKN vs. CLE,L,26,5,10,0.5,1,4,0.25,1,2,0.5,2,3,5,3,2,0,2,1,12,-1,1,Cameron Johnson,BKN,BKN,CLE,,,20,17,15,8
22023,1630552,22300559,"JAN 15, 2024",ATL vs. SAS,W,38,7,13,0.538,1,2,0.5,1,1,1.0,0,10,10,7,6,0,5,3,16,16,1,Jalen Johnson,ATL,ATL,SAS,,,33,26,23,17
22023,1630552,22300543,"JAN 13, 2024",ATL vs. WAS,L,36,2,7,0.286,1,3,0.333,0,0,0.0,0,6,6,3,0,2,4,3,5,-23,1,Jalen Johnson,ATL,ATL,WAS,,,14,11,8,9
22023,1630552,22300533,"JAN 12, 2024",ATL vs. IND,L,32,7,11,0.636,1,2,0.5,1,3,0.333,0,4,4,3,2,0,3,3,16,-17,1,Jalen Johnson,ATL,ATL,IND,,,23,20,19,7
22023,1630552,22300521,"JAN 10, 2024",ATL vs. PHI,W,41,8,13,0.615,3,4,0.75,6,6,1.0,2,14,16,7,1,2,1,3,25,6,1,Jalen Johnson,ATL,ATL,PHI,,,48,41,32,23
22023,1630552,22300499,"JAN 07, 2024",ATL @ ORL,L,40,6,12,0.5,0,4,0.0,0,0,0.0,1,10,11,4,0,1,3,6,12,-20,1,Jalen Johnson,ATL,ORL,ATL,,,27,23,16,15
22023,1630552,22300480,"JAN 05, 2024",ATL @ IND,L,29,5,11,0.455,1,4,0.25,1,1,1.0,1,7,8,3,1,0,0,1,12,-26,1,Jalen Johnson,ATL,IND,ATL,,,23,20,15,11
22023,1630552,22300467,"JAN 03, 2024",ATL vs. OKC,W,29,11,18,0.611,2,4,0.5,4,4,1.0,1,6,7,3,4,0,1,5,28,-1,1,Jalen Johnson,ATL,ATL,OKC,,,38,35,31,10
22023,1630552,22300445,"DEC 31, 2023",ATL @ WAS,W,37,9,12,0.75,2,4,0.5,4,5,0.8,0,13,13,4,0,0,1,2,24,-13,1,Jalen Johnson,ATL,WAS,ATL,,,41,37,28,17
22023,1630552,22300431,"DEC 29, 2023",ATL vs. SAC,L,35,5,12,0.417,1,4,0.25,5,6,0.833,2,13,15,4,0,1,4,2,16,-7,1,Jalen Johnson,ATL,ATL,SAC,,,35,31,20,19
22023,1630552,22300408,"DEC 26, 2023",ATL @ CHI,L,29,5,8,0.625,0,1,0.0,0,0,0.0,3,6,9,4,1,0,2,1,10,-9,1,Jalen Johnson,ATL,CHI,ATL,,,23,19,14,13
22023,1630552,22300241,"NOV 25, 2023",ATL @ WAS,W,8,3,4,0.75,1,2,0.5,1,2,0.5,1,0,1,1,2,1,0,0,8,7,1,Jalen Johnson,ATL,WAS,ATL,,,10,9,9,2
22023,1630552,22300227,"NOV 22, 2023",ATL vs. BKN,W,40,3,7,0.429,1,2,0.5,0,0,0.0,0,6,6,3,2,1,5,3,7,-15,1,Jalen Johnson,ATL,ATL,BKN,,,16,13,10,9
22023,1630552,22300039,"NOV 21, 2023",ATL vs. IND,L,33,6,12,0.5,0,2,0.0,5,5,1.0,1,6,7,6,2,1,1,2,17,-4,1,Jalen Johnson,ATL,ATL,IND,,,30,24,23,13
22023,1630552,22300029,"NOV 17, 2023",ATL vs. PHI,L,36,7,12,0.583,0,2,0.0,4,4,1.0,1,9,10,2,1,3,0,2,18,3,1,Jalen Johnson,ATL,ATL,PHI,,,30,28,20,12
22023,1630552,22300193,"NOV 15, 2023",ATL vs. NYK,L,31,7,9,0.778,4,4,1.0,0,0,0.0,0,5,5,0,0,2,3,1,18,-13,1,Jalen Johnson,ATL,ATL,NYK,,,23,23,18,5
22023,1630552,22300018,"NOV 14, 2023",ATL @ DET,W,36,6,9,0.667,2,2,1.0,2,2,1.0,1,4,5,1,1,1,2,2,16,0,1,Jalen Johnson,ATL,DET,ATL,,,22,21,17,6
22023,1630552,22300175,"NOV 11, 2023",ATL vs. MIA,L,22,4,8,0.5,1,3,0.333,0,0,0.0,0,4,4,2,0,0,3,2,9,-6,1,Jalen Johnson,ATL,ATL,MIA,,,15,13,11,6
22023,1630552,22300172,"NOV 09, 2023",ATL @ ORL,W,31,7,9,0.778,2,4,0.5,3,4,0.75,2,7,9,2,0,1,3,4,19,15,1,Jalen Johnson,ATL,ORL,ATL,,,30,28,21,11
22023,1630552,22300155,"NOV 06, 2023",ATL @ OKC,L,34,6,15,0.4,0,4,0.0,1,2,0.5,6,6,12,5,3,1,0,2,13,-16,1,Jalen Johnson,ATL,OKC,ATL,,,30,25,18,17
22023,1630552,22300135,"NOV 04, 2023",ATL @ NOP,W,36,8,13,0.615,2,3,0.667,3,4,0.75,2,9,11,4,0,0,1,3,21,19,1,Jalen Johnson,ATL,NOP,ATL,,,36,32,25,15
22023,1630552,22300117,"NOV 01, 2023",ATL vs. WAS,W,24,3,7,0.429,0,2,0.0,2,2,1.0,4,7,11,2,0,0,5,2,8,10,1,Jalen Johnson,ATL,ATL,WAS,,,21,19,10,13
22023,1630552,22300104,"OCT 30, 2023",ATL vs. MIN,W,33,5,7,0.714,1,2,0.5,1,1,1.0,1,4,5,3,1,1,2,3,12,19,1,Jalen Johnson,ATL,ATL,MIN,,,20,17,15,8
22023,1630552,22300097,"OCT 29, 2023",ATL @ MIL,W,26,6,10,0.6,2,3,0.667,0,0,0.0,1,6,7,1,2,1,2,4,14,14,1,Jalen Johnson,ATL,MIL,ATL,,,22,21,15,8
22023,1630552,22300079,"OCT 27, 2023",ATL vs. NYK,L,30,5,8,0.625,0,2,0.0,1,3,0.333,0,9,9,2,1,1,3,2,11,-1,1,Jalen Johnson,ATL,ATL,NYK,,,22,20,13,11
22023,1630552,22300063,"OCT 25, 2023",ATL @ CHA,L,29,9,13,0.692,1,3,0.333,2,4,0.5,0,7,7,2,2,1,0,1,21,8,1,Jalen Johnson,ATL,CHA,ATL,,,30,28,23,9
22023,1629640,22300559,"JAN 15, 2024",SAS @ ATL,L,26,1,11,0.091,0,5,0.0,3,5,0.6,2,4,6,0,1,0,5,4,5,-4,1,Keldon Johnson,SAS,ATL,SAS,,,11,11,5,6
22023,1629640,22300548,"JAN 13, 2024",SAS vs. CHI,L,30,8,14,0.571,4,5,0.8,6,6,1.0,0,4,4,5,0,1,2,2,26,-1,1,Keldon Johnson,SAS,SAS,CHI,,,35,30,31,9
22023,1629640,22300541,"JAN 12, 2024",SAS vs. CHA,W,19,3,11,0.273,2,7,0.286,2,2,1.0,0,2,2,1,1,0,2,2,10,6,1,Keldon Johnson,SAS,SAS,CHA,,,13,12,11,3
22023,1629640,22300519,"JAN 10, 2024",SAS @ DET,W,25,4,8,0.5,1,2,0.5,8,8,1.0,0,1,1,3,2,1,0,2,17,12,1,Keldon Johnson,SAS,DET,SAS,,,21,18,20,4
22023,1629640,22300497,"JAN 07, 2024",SAS @ CLE,L,33,6,16,0.375,3,6,0.5,3,4,0.75,3,1,4,2,1,0,0,3,18,-12,1,Keldon Johnson,SAS,CLE,SAS,,,24,22,20,6
22023,1629640,22300477,"JAN 04, 2024",SAS vs. MIL,L,30,5,17,0.294,2,8,0.25,2,2,1.0,2,8,10,1,0,0,1,1,14,7,1,Keldon Johnson,SAS,SAS,MIL,,,25,24,15,11
22023,1629640,22300460,"JAN 02, 2024",SAS @ MEM,L,31,7,16,0.438,1,4,0.25,4,5,0.8,1,5,6,4,1,0,3,4,19,-15,1,Keldon Johnson,SAS,MEM,SAS,,,29,25,23,10
22023,1629640,22300437,"DEC 29, 2023",SAS @ POR,L,32,9,18,0.5,3,8,0.375,8,11,0.727,2,5,7,7,1,0,1,4,29,6,1,Keldon Johnson,SAS,POR,SAS,,,43,36,36,14
22023,1629640,22300427,"DEC 28, 2023",SAS @ POR,W,31,4,11,0.364,1,6,0.167,0,0,0.0,0,3,3,2,1,0,2,5,9,1,1,Keldon Johnson,SAS,POR,SAS,,,14,12,11,5
22023,1629640,22300412,"DEC 26, 2023",SAS vs. UTA,L,30,9,20,0.45,3,7,0.429,5,6,0.833,2,2,4,3,0,0,1,0,26,-14,1,Keldon Johnson,SAS,SAS,UTA,,,33,30,29,7
22023,1629640,22300398,"DEC 23, 2023",SAS @ DAL,L,23,6,16,0.375,2,8,0.25,2,4,0.5,2,3,5,2,0,0,2,2,16,-8,1,Keldon Johnson,SAS,DAL,SAS,,,23,21,18,7
22023,1629640,22300376,"DEC 21, 2023",SAS @ CHI,L,32,5,13,0.385,0,2,0.0,1,3,0.333,2,4,6,2,0,0,3,3,11,-10,1,Keldon Johnson,SAS,CHI,SAS,,,19,17,13,8
22023,1629640,22300361,"DEC 19, 2023",SAS @ MIL,L,35,9,13,0.692,0,1,0.0,10,12,0.833,2,10,12,1,0,0,5,2,28,-5,1,Keldon Johnson,SAS,MIL,SAS,,,41,40,29,13
22023,1629640,22300345,"DEC 17, 2023",SAS vs. NOP,L,32,6,18,0.333,0,4,0.0,1,2,0.5,4,4,8,3,4,0,5,2,13,-30,1,Keldon Johnson,SAS,SAS,NOP,,,24,21,16,11
22023,1629640,22300331,"DEC 15, 2023",SAS vs. LAL,W,31,6,16,0.375,3,8,0.375,2,2,1.0,1,1,2,6,0,0,2,1,17,4,1,Keldon Johnson,SAS,SAS,LAL,,,25,19,23,8
22023,1629640,22300316,"DEC 13, 2023",SAS vs. LAL,L,36,10,14,0.714,4,4,1.0,4,4,1.0,1,4,5,8,0,0,1,3,28,1,1,Keldon Johnson,SAS,SAS,LAL,,,41,33,36,13
22023,1629640,22300298,"DEC 11, 2023",SAS @ HOU,L,37,3,14,0.214,0,9,0.0,6,6,1.0,2,5,7,2,4,0,3,1,12,-18,1,Keldon Johnson,SAS,HOU,SAS,,,21,19,14,9
22023,1629640,22301223,"DEC 08, 2023",SAS vs. CHI,L,35,6,11,0.545,6,11,0.545,2,2,1.0,0,2,2,5,0,1,0,3,20,-7,1,Keldon Johnson,SAS,SAS,CHI,,,27,22,25,7
22023,1629640,22301210,"DEC 06, 2023",SAS @ MIN,L,32,8,15,0.533,1,2,0.5,4,5,0.8,1,9,10,3,2,1,4,4,21,-3,1,Keldon Johnson,SAS,MIN,SAS,,,34,31,24,13
22023,1629640,22300278,"DEC 01, 2023",SAS @ NOP,L,33,4,7,0.571,1,3,0.333,2,2,1.0,1,6,7,3,1,0,2,2,11,-7,1,Keldon Johnson,SAS,NOP,SAS,,,21,18,14,10
22023,1629640,22300272,"NOV 30, 2023",SAS vs. ATL,L,33,8,15,0.533,2,3,0.667,4,5,0.8,4,7,11,3,1,0,2,2,22,-1,1,Keldon Johnson,SAS,SAS,ATL,,,36,33,25,14
22023,1629640,22300252,"NOV 26, 2023",SAS @ DEN,L,31,3,7,0.429,0,2,0.0,4,5,0.8,0,1,1,2,0,0,0,1,10,-16,1,Keldon Johnson,SAS,DEN,SAS,,,13,11,12,3
22023,1629640,22300051,"NOV 24, 2023",SAS @ GSW,L,34,8,13,0.615,3,7,0.429,3,5,0.6,4,8,12,4,2,0,3,3,22,5,1,Keldon Johnson,SAS,GSW,SAS,,,38,34,26,16
22023,1629640,22300235,"NOV 22, 2023",SAS vs. LAC,L,36,5,13,0.385,2,8,0.25,3,3,1.0,2,1,3,6,0,1,0,4,15,0,1,Keldon Johnson,SAS,SAS,LAC,,,24,18,21,9
22023,1629640,22300223,"NOV 20, 2023",SAS vs. LAC,L,32,9,16,0.563,2,8,0.25,2,4,0.5,2,8,10,5,1,0,1,2,22,-10,1,Keldon Johnson,SAS,SAS,LAC,,,37,32,27,15
22023,1629640,22300206,"NOV 18, 2023",SAS vs. MEM,L,33,8,14,0.571,4,7,0.571,2,3,0.667,0,3,3,1,0,0,0,1,22,-13,1,Keldon Johnson,SAS,SAS,MEM,,,26,25,23,4
22023,1629640,22300032,"NOV 17, 2023",SAS vs. SAC,L,36,7,16,0.438,5,9,0.556,2,2,1.0,0,9,9,7,1,1,3,1,21,-12,1,Keldon Johnson,SAS,SAS,SAC,,,37,30,28,16
22023,1629640,22300184,"NOV 12, 2023",SAS vs. MIA,L,37,8,18,0.444,3,10,0.3,1,1,1.0,0,12,12,6,1,1,1,2,20,7,1,Keldon Johnson,SAS,SAS,MIA,,,38,32,26,18
22023,1629640,22300013,"NOV 10, 2023",SAS vs. MIN,L,33,2,10,0.2,0,3,0.0,2,4,0.5,0,5,5,1,0,0,1,2,6,-9,1,Keldon Johnson,SAS,SAS,MIN,,,12,11,7,6
22023,1629640,22300161,"NOV 08, 2023",SAS @ NYK,L,33,4,9,0.444,1,4,0.25,0,2,0.0,0,7,7,8,0,0,3,4,9,-21,1,Keldon Johnson,SAS,NYK,SAS,,,24,16,17,15
22023,1629640,22300146,"NOV 06, 2023",SAS @ IND,L,23,6,12,0.5,0,0,0.0,4,5,0.8,1,2,3,3,0,0,1,1,16,-19,1,Keldon Johnson,SAS,IND,SAS,,,22,19,19,6
22023,1629640,22300141,"NOV 05, 2023",SAS vs. TOR,L,38,11,18,0.611,2,4,0.5,2,2,1.0,1,5,6,3,2,0,0,1,26,-17,1,Keldon Johnson,SAS,SAS,TOR,,,35,32,29,9
22023,1629640,22300131,"NOV 02, 2023",SAS @ PHX,W,35,3,11,0.273,1,6,0.167,0,0,0.0,1,6,7,6,2,1,0,5,7,11,1,Keldon Johnson,SAS,PHX,SAS,,,20,14,13,13
22023,1629640,22300113,"OCT 31, 2023",SAS @ PHX,W,33,10,20,0.5,4,9,0.444,3,4,0.75,1,2,3,4,2,0,0,1,27,1,1,Keldon Johnson,SAS,PHX,SAS,,,34,30,31,7
22023,1629640,22300099,"OCT 29, 2023",SAS @ LAC,L,24,1,9,0.111,1,5,0.2,2,2,1.0,0,5,5,1,1,0,0,4,5,-27,1,Keldon Johnson,SAS,LAC,SAS,,,11,10,6,6
22023,1629640,22300083,"OCT 27, 2023",SAS vs. HOU,W,35,8,14,0.571,3,7,0.429,1,2,0.5,2,2,4,4,0,1,3,5,20,-2,1,Keldon Johnson,SAS,SAS,HOU,,,28,24,24,8
22023,1629640,22300073,"OCT 25, 2023",SAS vs. DAL,L,32,7,15,0.467,1,3,0.333,2,3,0.667,2,7,9,7,0,0,3,4,17,0,1,Keldon Johnson,SAS,SAS,DAL,,,33,26,24,16
22023,1630553,22300417,"DEC 27, 2023",BKN vs. MIL,L,21,3,8,0.375,2,4,0.5,4,4,1.0,0,1,1,1,1,1,1,1,12,-18,1,Keon Johnson,BKN,BKN,MIL,,,14,13,13,2
22023,1641749,22300529,"JAN 11, 2024",OKC vs. POR,W,18,2,5,0.4,0,1,0.0,0,0,0.0,1,2,3,2,0,0,2,1,4,13,1,Keyontae Johnson,OKC,OKC,POR,,,9,7,6,5
22023,1641749,22300095,"OCT 29, 2023",OKC vs. DEN,L,6,0,1,0.0,0,0,0.0,0,0,0.0,0,0,0,0,0,0,0,0,0,-2,1,Keyontae Johnson,OKC,OKC,DEN,,,0,0,0,0
22023,203999,22300550,"JAN 14, 2024",DEN vs. IND,W,33,12,13,0.923,0,0,0.0,1,2,0.5,3,9,12,9,2,1,7,3,25,10,1,Nikola Jokic,DEN,DEN,IND,24.5,Points,46,37,34,21
22023,203999,22300550,"JAN 14, 2024",DEN vs. IND,W,33,12,13,0.923,0,0,0.0,1,2,0.5,3,9,12,9,2,1,7,3,25,10,1,Nikola Jokic,DEN,DEN,IND,11.0,Rebounds,46,37,34,21
22023,203999,22300550,"JAN 14, 2024",DEN vs. IND,W,33,12,13,0.923,0,0,0.0,1,2,0.5,3,9,12,9,2,1,7,3,25,10,1,Nikola Jokic,DEN,DEN,IND,45.0,Pts+Rebs+Asts,46,37,34,21
22023,203999,22300550,"JAN 14, 2024",DEN vs. IND,W,33,12,13,0.923,0,0,0.0,1,2,0.5,3,9,12,9,2,1,7,3,25,10,1,Nikola Jokic,DEN,DEN,IND,9.0,Assists,46,37,34,21
22023,203999,22300550,"JAN 14, 2024",DEN vs. IND,W,33,12,13,0.923,0,0,0.0,1,2,0.5,3,9,12,9,2,1,7,3,25,10,1,Nikola Jokic,DEN,DEN,IND,53.5,Fantasy Score,46,37,34,21
22023,203999,22300550,"JAN 14, 2024",DEN vs. IND,W,33,12,13,0.923,0,0,0.0,1,2,0.5,3,9,12,9,2,1,7,3,25,10,1,Nikola Jokic,DEN,DEN,IND,35.5,Pts+Rebs,46,37,34,21
22023,203999,22300550,"JAN 14, 2024",DEN vs. IND,W,33,12,13,0.923,0,0,0.0,1,2,0.5,3,9,12,9,2,1,7,3,25,10,1,Nikola Jokic,DEN,DEN,IND,34.0,Pts+Asts,46,37,34,21
22023,203999,22300550,"JAN 14, 2024",DEN vs. IND,W,33,12,13,0.923,0,0,0.0,1,2,0.5,3,9,12,9,2,1,7,3,25,10,1,Nikola Jokic,DEN,DEN,IND,20.0,Rebs+Asts,46,37,34,21
22023,203999,22300539,"JAN 12, 2024",DEN vs. NOP,W,32,11,17,0.647,1,2,0.5,4,4,1.0,3,7,10,14,0,1,2,4,27,12,1,Nikola Jokic,DEN,DEN,NOP,24.5,Points,51,37,41,24
22023,203999,22300539,"JAN 12, 2024",DEN vs. NOP,W,32,11,17,0.647,1,2,0.5,4,4,1.0,3,7,10,14,0,1,2,4,27,12,1,Nikola Jokic,DEN,DEN,NOP,11.0,Rebounds,51,37,41,24
22023,203999,22300539,"JAN 12, 2024",DEN vs. NOP,W,32,11,17,0.647,1,2,0.5,4,4,1.0,3,7,10,14,0,1,2,4,27,12,1,Nikola Jokic,DEN,DEN,NOP,45.0,Pts+Rebs+Asts,51,37,41,24
22023,203999,22300539,"JAN 12, 2024",DEN vs. NOP,W,32,11,17,0.647,1,2,0.5,4,4,1.0,3,7,10,14,0,1,2,4,27,12,1,Nikola Jokic,DEN,DEN,NOP,9.0,Assists,51,37,41,24
22023,203999,22300539,"JAN 12, 2024",DEN vs. NOP,W,32,11,17,0.647,1,2,0.5,4,4,1.0,3,7,10,14,0,1,2,4,27,12,1,Nikola Jokic,DEN,DEN,NOP,53.5,Fantasy Score,51,37,41,24
22023,203999,22300539,"JAN 12, 2024",DEN vs. NOP,W,32,11,17,0.647,1,2,0.5,4,4,1.0,3,7,10,14,0,1,2,4,27,12,1,Nikola Jokic,DEN,DEN,NOP,35.5,Pts+Rebs,51,37,41,24
22023,203999,22300539,"JAN 12, 2024",DEN vs. NOP,W,32,11,17,0.647,1,2,0.5,4,4,1.0,3,7,10,14,0,1,2,4,27,12,1,Nikola Jokic,DEN,DEN,NOP,34.0,Pts+Asts,51,37,41,24
22023,203999,22300539,"JAN 12, 2024",DEN vs. NOP,W,32,11,17,0.647,1,2,0.5,4,4,1.0,3,7,10,14,0,1,2,4,27,12,1,Nikola Jokic,DEN,DEN,NOP,20.0,Rebs+Asts,51,37,41,24
22023,203999,22300524,"JAN 10, 2024",DEN @ UTA,L,30,8,9,0.889,1,1,1.0,10,12,0.833,1,10,11,6,1,0,6,3,27,-21,1,Nikola Jokic,DEN,UTA,DEN,24.5,Points,44,38,33,17
22023,203999,22300524,"JAN 10, 2024",DEN @ UTA,L,30,8,9,0.889,1,1,1.0,10,12,0.833,1,10,11,6,1,0,6,3,27,-21,1,Nikola Jokic,DEN,UTA,DEN,11.0,Rebounds,44,38,33,17
22023,203999,22300524,"JAN 10, 2024",DEN @ UTA,L,30,8,9,0.889,1,1,1.0,10,12,0.833,1,10,11,6,1,0,6,3,27,-21,1,Nikola Jokic,DEN,UTA,DEN,45.0,Pts+Rebs+Asts,44,38,33,17
22023,203999,22300524,"JAN 10, 2024",DEN @ UTA,L,30,8,9,0.889,1,1,1.0,10,12,0.833,1,10,11,6,1,0,6,3,27,-21,1,Nikola Jokic,DEN,UTA,DEN,9.0,Assists,44,38,33,17
22023,203999,22300524,"JAN 10, 2024",DEN @ UTA,L,30,8,9,0.889,1,1,1.0,10,12,0.833,1,10,11,6,1,0,6,3,27,-21,1,Nikola Jokic,DEN,UTA,DEN,53.5,Fantasy Score,44,38,33,17
22023,203999,22300524,"JAN 10, 2024",DEN @ UTA,L,30,8,9,0.889,1,1,1.0,10,12,0.833,1,10,11,6,1,0,6,3,27,-21,1,Nikola Jokic,DEN,UTA,DEN,35.5,Pts+Rebs,44,38,33,17
22023,203999,22300524,"JAN 10, 2024",DEN @ UTA,L,30,8,9,0.889,1,1,1.0,10,12,0.833,1,10,11,6,1,0,6,3,27,-21,1,Nikola Jokic,DEN,UTA,DEN,34.0,Pts+Asts,44,38,33,17
22023,203999,22300524,"JAN 10, 2024",DEN @ UTA,L,30,8,9,0.889,1,1,1.0,10,12,0.833,1,10,11,6,1,0,6,3,27,-21,1,Nikola Jokic,DEN,UTA,DEN,20.0,Rebs+Asts,44,38,33,17
22023,203999,22300502,"JAN 07, 2024",DEN vs. DET,W,25,2,3,0.667,0,0,0.0,0,0,0.0,0,7,7,16,0,5,2,4,4,16,1,Nikola Jokic,DEN,DEN,DET,24.5,Points,27,11,20,23
22023,203999,22300502,"JAN 07, 2024",DEN vs. DET,W,25,2,3,0.667,0,0,0.0,0,0,0.0,0,7,7,16,0,5,2,4,4,16,1,Nikola Jokic,DEN,DEN,DET,11.0,Rebounds,27,11,20,23
22023,203999,22300502,"JAN 07, 2024",DEN vs. DET,W,25,2,3,0.667,0,0,0.0,0,0,0.0,0,7,7,16,0,5,2,4,4,16,1,Nikola Jokic,DEN,DEN,DET,45.0,Pts+Rebs+Asts,27,11,20,23
22023,203999,22300502,"JAN 07, 2024",DEN vs. DET,W,25,2,3,0.667,0,0,0.0,0,0,0.0,0,7,7,16,0,5,2,4,4,16,1,Nikola Jokic,DEN,DEN,DET,9.0,Assists,27,11,20,23
22023,203999,22300502,"JAN 07, 2024",DEN vs. DET,W,25,2,3,0.667,0,0,0.0,0,0,0.0,0,7,7,16,0,5,2,4,4,16,1,Nikola Jokic,DEN,DEN,DET,53.5,Fantasy Score,27,11,20,23
22023,203999,22300502,"JAN 07, 2024",DEN vs. DET,W,25,2,3,0.667,0,0,0.0,0,0,0.0,0,7,7,16,0,5,2,4,4,16,1,Nikola Jokic,DEN,DEN,DET,35.5,Pts+Rebs,27,11,20,23
22023,203999,22300502,"JAN 07, 2024",DEN vs. DET,W,25,2,3,0.667,0,0,0.0,0,0,0.0,0,7,7,16,0,5,2,4,4,16,1,Nikola Jokic,DEN,DEN,DET,34.0,Pts+Asts,27,11,20,23
22023,203999,22300502,"JAN 07, 2024",DEN vs. DET,W,25,2,3,0.667,0,0,0.0,0,0,0.0,0,7,7,16,0,5,2,4,4,16,1,Nikola Jokic,DEN,DEN,DET,20.0,Rebs+Asts,27,11,20,23
22023,203999,22300488,"JAN 05, 2024",DEN vs. ORL,L,37,13,19,0.684,0,1,0.0,3,4,0.75,0,4,4,8,3,0,2,3,29,-4,1,Nikola Jokic,DEN,DEN,ORL,24.5,Points,41,33,37,12
22023,203999,22300488,"JAN 05, 2024",DEN vs. ORL,L,37,13,19,0.684,0,1,0.0,3,4,0.75,0,4,4,8,3,0,2,3,29,-4,1,Nikola Jokic,DEN,DEN,ORL,11.0,Rebounds,41,33,37,12
22023,203999,22300488,"JAN 05, 2024",DEN vs. ORL,L,37,13,19,0.684,0,1,0.0,3,4,0.75,0,4,4,8,3,0,2,3,29,-4,1,Nikola Jokic,DEN,DEN,ORL,45.0,Pts+Rebs+Asts,41,33,37,12
22023,203999,22300488,"JAN 05, 2024",DEN vs. ORL,L,37,13,19,0.684,0,1,0.0,3,4,0.75,0,4,4,8,3,0,2,3,29,-4,1,Nikola Jokic,DEN,DEN,ORL,9.0,Assists,41,33,37,12
22023,203999,22300488,"JAN 05, 2024",DEN vs. ORL,L,37,13,19,0.684,0,1,0.0,3,4,0.75,0,4,4,8,3,0,2,3,29,-4,1,Nikola Jokic,DEN,DEN,ORL,53.5,Fantasy Score,41,33,37,12
22023,203999,22300488,"JAN 05, 2024",DEN vs. ORL,L,37,13,19,0.684,0,1,0.0,3,4,0.75,0,4,4,8,3,0,2,3,29,-4,1,Nikola Jokic,DEN,DEN,ORL,35.5,Pts+Rebs,41,33,37,12
22023,203999,22300488,"JAN 05, 2024",DEN vs. ORL,L,37,13,19,0.684,0,1,0.0,3,4,0.75,0,4,4,8,3,0,2,3,29,-4,1,Nikola Jokic,DEN,DEN,ORL,34.0,Pts+Asts,41,33,37,12
22023,203999,22300488,"JAN 05, 2024",DEN vs. ORL,L,37,13,19,0.684,0,1,0.0,3,4,0.75,0,4,4,8,3,0,2,3,29,-4,1,Nikola Jokic,DEN,DEN,ORL,20.0,Rebs+Asts,41,33,37,12
22023,203999,22300478,"JAN 04, 2024",DEN @ GSW,W,38,13,16,0.813,2,2,1.0,6,7,0.857,2,7,9,10,2,1,4,2,34,4,1,Nikola Jokic,DEN,GSW,DEN,24.5,Points,53,43,44,19
22023,203999,22300478,"JAN 04, 2024",DEN @ GSW,W,38,13,16,0.813,2,2,1.0,6,7,0.857,2,7,9,10,2,1,4,2,34,4,1,Nikola Jokic,DEN,GSW,DEN,11.0,Rebounds,53,43,44,19
22023,203999,22300478,"JAN 04, 2024",DEN @ GSW,W,38,13,16,0.813,2,2,1.0,6,7,0.857,2,7,9,10,2,1,4,2,34,4,1,Nikola Jokic,DEN,GSW,DEN,45.0,Pts+Rebs+Asts,53,43,44,19
22023,203999,22300478,"JAN 04, 2024",DEN @ GSW,W,38,13,16,0.813,2,2,1.0,6,7,0.857,2,7,9,10,2,1,4,2,34,4,1,Nikola Jokic,DEN,GSW,DEN,9.0,Assists,53,43,44,19
22023,203999,22300478,"JAN 04, 2024",DEN @ GSW,W,38,13,16,0.813,2,2,1.0,6,7,0.857,2,7,9,10,2,1,4,2,34,4,1,Nikola Jokic,DEN,GSW,DEN,53.5,Fantasy Score,53,43,44,19
22023,203999,22300478,"JAN 04, 2024",DEN @ GSW,W,38,13,16,0.813,2,2,1.0,6,7,0.857,2,7,9,10,2,1,4,2,34,4,1,Nikola Jokic,DEN,GSW,DEN,35.5,Pts+Rebs,53,43,44,19
22023,203999,22300478,"JAN 04, 2024",DEN @ GSW,W,38,13,16,0.813,2,2,1.0,6,7,0.857,2,7,9,10,2,1,4,2,34,4,1,Nikola Jokic,DEN,GSW,DEN,34.0,Pts+Asts,53,43,44,19
22023,203999,22300478,"JAN 04, 2024",DEN @ GSW,W,38,13,16,0.813,2,2,1.0,6,7,0.857,2,7,9,10,2,1,4,2,34,4,1,Nikola Jokic,DEN,GSW,DEN,20.0,Rebs+Asts,53,43,44,19
22023,203999,22300455,"JAN 01, 2024",DEN vs. CHA,W,28,6,7,0.857,0,0,0.0,1,1,1.0,0,11,11,6,1,1,3,2,13,27,1,Nikola Jokic,DEN,DEN,CHA,24.5,Points,30,24,19,17
22023,203999,22300455,"JAN 01, 2024",DEN vs. CHA,W,28,6,7,0.857,0,0,0.0,1,1,1.0,0,11,11,6,1,1,3,2,13,27,1,Nikola Jokic,DEN,DEN,CHA,11.0,Rebounds,30,24,19,17
22023,203999,22300455,"JAN 01, 2024",DEN vs. CHA,W,28,6,7,0.857,0,0,0.0,1,1,1.0,0,11,11,6,1,1,3,2,13,27,1,Nikola Jokic,DEN,DEN,CHA,45.0,Pts+Rebs+Asts,30,24,19,17
22023,203999,22300455,"JAN 01, 2024",DEN vs. CHA,W,28,6,7,0.857,0,0,0.0,1,1,1.0,0,11,11,6,1,1,3,2,13,27,1,Nikola Jokic,DEN,DEN,CHA,9.0,Assists,30,24,19,17
22023,203999,22300455,"JAN 01, 2024",DEN vs. CHA,W,28,6,7,0.857,0,0,0.0,1,1,1.0,0,11,11,6,1,1,3,2,13,27,1,Nikola Jokic,DEN,DEN,CHA,53.5,Fantasy Score,30,24,19,17
22023,203999,22300455,"JAN 01, 2024",DEN vs. CHA,W,28,6,7,0.857,0,0,0.0,1,1,1.0,0,11,11,6,1,1,3,2,13,27,1,Nikola Jokic,DEN,DEN,CHA,35.5,Pts+Rebs,30,24,19,17
22023,203999,22300455,"JAN 01, 2024",DEN vs. CHA,W,28,6,7,0.857,0,0,0.0,1,1,1.0,0,11,11,6,1,1,3,2,13,27,1,Nikola Jokic,DEN,DEN,CHA,34.0,Pts+Asts,30,24,19,17
22023,203999,22300455,"JAN 01, 2024",DEN vs. CHA,W,28,6,7,0.857,0,0,0.0,1,1,1.0,0,11,11,6,1,1,3,2,13,27,1,Nikola Jokic,DEN,DEN,CHA,20.0,Rebs+Asts,30,24,19,17
22023,203999,22300435,"DEC 29, 2023",DEN vs. OKC,L,32,9,10,0.9,1,1,1.0,0,0,0.0,2,8,10,7,1,1,7,2,19,-19,1,Nikola Jokic,DEN,DEN,OKC,24.5,Points,36,29,26,17
22023,203999,22300435,"DEC 29, 2023",DEN vs. OKC,L,32,9,10,0.9,1,1,1.0,0,0,0.0,2,8,10,7,1,1,7,2,19,-19,1,Nikola Jokic,DEN,DEN,OKC,11.0,Rebounds,36,29,26,17
22023,203999,22300435,"DEC 29, 2023",DEN vs. OKC,L,32,9,10,0.9,1,1,1.0,0,0,0.0,2,8,10,7,1,1,7,2,19,-19,1,Nikola Jokic,DEN,DEN,OKC,45.0,Pts+Rebs+Asts,36,29,26,17
22023,203999,22300435,"DEC 29, 2023",DEN vs. OKC,L,32,9,10,0.9,1,1,1.0,0,0,0.0,2,8,10,7,1,1,7,2,19,-19,1,Nikola Jokic,DEN,DEN,OKC,9.0,Assists,36,29,26,17
22023,203999,22300435,"DEC 29, 2023",DEN vs. OKC,L,32,9,10,0.9,1,1,1.0,0,0,0.0,2,8,10,7,1,1,7,2,19,-19,1,Nikola Jokic,DEN,DEN,OKC,53.5,Fantasy Score,36,29,26,17
22023,203999,22300435,"DEC 29, 2023",DEN vs. OKC,L,32,9,10,0.9,1,1,1.0,0,0,0.0,2,8,10,7,1,1,7,2,19,-19,1,Nikola Jokic,DEN,DEN,OKC,35.5,Pts+Rebs,36,29,26,17
22023,203999,22300435,"DEC 29, 2023",DEN vs. OKC,L,32,9,10,0.9,1,1,1.0,0,0,0.0,2,8,10,7,1,1,7,2,19,-19,1,Nikola Jokic,DEN,DEN,OKC,34.0,Pts+Asts,36,29,26,17
22023,203999,22300435,"DEC 29, 2023",DEN vs. OKC,L,32,9,10,0.9,1,1,1.0,0,0,0.0,2,8,10,7,1,1,7,2,19,-19,1,Nikola Jokic,DEN,DEN,OKC,20.0,Rebs+Asts,36,29,26,17
22023,203999,22300425,"DEC 28, 2023",DEN vs. MEM,W,30,11,11,1.0,1,1,1.0,3,3,1.0,0,14,14,10,0,2,3,1,26,25,1,Nikola Jokic,DEN,DEN,MEM,24.5,Points,50,40,36,24
22023,203999,22300425,"DEC 28, 2023",DEN vs. MEM,W,30,11,11,1.0,1,1,1.0,3,3,1.0,0,14,14,10,0,2,3,1,26,25,1,Nikola Jokic,DEN,DEN,MEM,11.0,Rebounds,50,40,36,24
22023,203999,22300425,"DEC 28, 2023",DEN vs. MEM,W,30,11,11,1.0,1,1,1.0,3,3,1.0,0,14,14,10,0,2,3,1,26,25,1,Nikola Jokic,DEN,DEN,MEM,45.0,Pts+Rebs+Asts,50,40,36,24
22023,203999,22300425,"DEC 28, 2023",DEN vs. MEM,W,30,11,11,1.0,1,1,1.0,3,3,1.0,0,14,14,10,0,2,3,1,26,25,1,Nikola Jokic,DEN,DEN,MEM,9.0,Assists,50,40,36,24
22023,203999,22300425,"DEC 28, 2023",DEN vs. MEM,W,30,11,11,1.0,1,1,1.0,3,3,1.0,0,14,14,10,0,2,3,1,26,25,1,Nikola Jokic,DEN,DEN,MEM,53.5,Fantasy Score,50,40,36,24
22023,203999,22300425,"DEC 28, 2023",DEN vs. MEM,W,30,11,11,1.0,1,1,1.0,3,3,1.0,0,14,14,10,0,2,3,1,26,25,1,Nikola Jokic,DEN,DEN,MEM,35.5,Pts+Rebs,50,40,36,24
22023,203999,22300425,"DEC 28, 2023",DEN vs. MEM,W,30,11,11,1.0,1,1,1.0,3,3,1.0,0,14,14,10,0,2,3,1,26,25,1,Nikola Jokic,DEN,DEN,MEM,34.0,Pts+Asts,50,40,36,24
22023,203999,22300425,"DEC 28, 2023",DEN vs. MEM,W,30,11,11,1.0,1,1,1.0,3,3,1.0,0,14,14,10,0,2,3,1,26,25,1,Nikola Jokic,DEN,DEN,MEM,20.0,Rebs+Asts,50,40,36,24
22023,203999,22300402,"DEC 25, 2023",DEN vs. GSW,W,39,4,12,0.333,0,2,0.0,18,18,1.0,4,10,14,8,0,0,3,2,26,21,1,Nikola Jokic,DEN,DEN,GSW,24.5,Points,48,40,34,22
22023,203999,22300402,"DEC 25, 2023",DEN vs. GSW,W,39,4,12,0.333,0,2,0.0,18,18,1.0,4,10,14,8,0,0,3,2,26,21,1,Nikola Jokic,DEN,DEN,GSW,11.0,Rebounds,48,40,34,22
22023,203999,22300402,"DEC 25, 2023",DEN vs. GSW,W,39,4,12,0.333,0,2,0.0,18,18,1.0,4,10,14,8,0,0,3,2,26,21,1,Nikola Jokic,DEN,DEN,GSW,45.0,Pts+Rebs+Asts,48,40,34,22
22023,203999,22300402,"DEC 25, 2023",DEN vs. GSW,W,39,4,12,0.333,0,2,0.0,18,18,1.0,4,10,14,8,0,0,3,2,26,21,1,Nikola Jokic,DEN,DEN,GSW,9.0,Assists,48,40,34,22
22023,203999,22300402,"DEC 25, 2023",DEN vs. GSW,W,39,4,12,0.333,0,2,0.0,18,18,1.0,4,10,14,8,0,0,3,2,26,21,1,Nikola Jokic,DEN,DEN,GSW,53.5,Fantasy Score,48,40,34,22
22023,203999,22300402,"DEC 25, 2023",DEN vs. GSW,W,39,4,12,0.333,0,2,0.0,18,18,1.0,4,10,14,8,0,0,3,2,26,21,1,Nikola Jokic,DEN,DEN,GSW,35.5,Pts+Rebs,48,40,34,22
22023,203999,22300402,"DEC 25, 2023",DEN vs. GSW,W,39,4,12,0.333,0,2,0.0,18,18,1.0,4,10,14,8,0,0,3,2,26,21,1,Nikola Jokic,DEN,DEN,GSW,34.0,Pts+Asts,48,40,34,22
22023,203999,22300402,"DEC 25, 2023",DEN vs. GSW,W,39,4,12,0.333,0,2,0.0,18,18,1.0,4,10,14,8,0,0,3,2,26,21,1,Nikola Jokic,DEN,DEN,GSW,20.0,Rebs+Asts,48,40,34,22
22023,203999,22300390,"DEC 23, 2023",DEN @ CHA,W,36,8,14,0.571,0,2,0.0,2,2,1.0,2,8,10,9,1,1,3,6,18,12,1,Nikola Jokic,DEN,CHA,DEN,24.5,Points,37,28,27,19
22023,203999,22300390,"DEC 23, 2023",DEN @ CHA,W,36,8,14,0.571,0,2,0.0,2,2,1.0,2,8,10,9,1,1,3,6,18,12,1,Nikola Jokic,DEN,CHA,DEN,11.0,Rebounds,37,28,27,19
22023,203999,22300390,"DEC 23, 2023",DEN @ CHA,W,36,8,14,0.571,0,2,0.0,2,2,1.0,2,8,10,9,1,1,3,6,18,12,1,Nikola Jokic,DEN,CHA,DEN,45.0,Pts+Rebs+Asts,37,28,27,19
22023,203999,22300390,"DEC 23, 2023",DEN @ CHA,W,36,8,14,0.571,0,2,0.0,2,2,1.0,2,8,10,9,1,1,3,6,18,12,1,Nikola Jokic,DEN,CHA,DEN,9.0,Assists,37,28,27,19
22023,203999,22300390,"DEC 23, 2023",DEN @ CHA,W,36,8,14,0.571,0,2,0.0,2,2,1.0,2,8,10,9,1,1,3,6,18,12,1,Nikola Jokic,DEN,CHA,DEN,53.5,Fantasy Score,37,28,27,19
22023,203999,22300390,"DEC 23, 2023",DEN @ CHA,W,36,8,14,0.571,0,2,0.0,2,2,1.0,2,8,10,9,1,1,3,6,18,12,1,Nikola Jokic,DEN,CHA,DEN,35.5,Pts+Rebs,37,28,27,19
22023,203999,22300390,"DEC 23, 2023",DEN @ CHA,W,36,8,14,0.571,0,2,0.0,2,2,1.0,2,8,10,9,1,1,3,6,18,12,1,Nikola Jokic,DEN,CHA,DEN,34.0,Pts+Asts,37,28,27,19
22023,203999,22300390,"DEC 23, 2023",DEN @ CHA,W,36,8,14,0.571,0,2,0.0,2,2,1.0,2,8,10,9,1,1,3,6,18,12,1,Nikola Jokic,DEN,CHA,DEN,20.0,Rebs+Asts,37,28,27,19
22023,203999,22300383,"DEC 22, 2023",DEN @ BKN,W,34,12,17,0.706,2,2,1.0,5,5,1.0,2,9,11,7,3,2,0,4,31,29,1,Nikola Jokic,DEN,BKN,DEN,24.5,Points,49,42,38,18
22023,203999,22300383,"DEC 22, 2023",DEN @ BKN,W,34,12,17,0.706,2,2,1.0,5,5,1.0,2,9,11,7,3,2,0,4,31,29,1,Nikola Jokic,DEN,BKN,DEN,11.0,Rebounds,49,42,38,18
22023,203999,22300383,"DEC 22, 2023",DEN @ BKN,W,34,12,17,0.706,2,2,1.0,5,5,1.0,2,9,11,7,3,2,0,4,31,29,1,Nikola Jokic,DEN,BKN,DEN,45.0,Pts+Rebs+Asts,49,42,38,18
22023,203999,22300383,"DEC 22, 2023",DEN @ BKN,W,34,12,17,0.706,2,2,1.0,5,5,1.0,2,9,11,7,3,2,0,4,31,29,1,Nikola Jokic,DEN,BKN,DEN,9.0,Assists,49,42,38,18
22023,203999,22300383,"DEC 22, 2023",DEN @ BKN,W,34,12,17,0.706,2,2,1.0,5,5,1.0,2,9,11,7,3,2,0,4,31,29,1,Nikola Jokic,DEN,BKN,DEN,53.5,Fantasy Score,49,42,38,18
22023,203999,22300383,"DEC 22, 2023",DEN @ BKN,W,34,12,17,0.706,2,2,1.0,5,5,1.0,2,9,11,7,3,2,0,4,31,29,1,Nikola Jokic,DEN,BKN,DEN,35.5,Pts+Rebs,49,42,38,18
22023,203999,22300383,"DEC 22, 2023",DEN @ BKN,W,34,12,17,0.706,2,2,1.0,5,5,1.0,2,9,11,7,3,2,0,4,31,29,1,Nikola Jokic,DEN,BKN,DEN,34.0,Pts+Asts,49,42,38,18
22023,203999,22300383,"DEC 22, 2023",DEN @ BKN,W,34,12,17,0.706,2,2,1.0,5,5,1.0,2,9,11,7,3,2,0,4,31,29,1,Nikola Jokic,DEN,BKN,DEN,20.0,Rebs+Asts,49,42,38,18
22023,203999,22300369,"DEC 20, 2023",DEN @ TOR,W,38,13,23,0.565,3,5,0.6,2,3,0.667,5,10,15,6,0,2,2,2,31,15,1,Nikola Jokic,DEN,TOR,DEN,24.5,Points,52,46,37,21
22023,203999,22300369,"DEC 20, 2023",DEN @ TOR,W,38,13,23,0.565,3,5,0.6,2,3,0.667,5,10,15,6,0,2,2,2,31,15,1,Nikola Jokic,DEN,TOR,DEN,11.0,Rebounds,52,46,37,21
22023,203999,22300369,"DEC 20, 2023",DEN @ TOR,W,38,13,23,0.565,3,5,0.6,2,3,0.667,5,10,15,6,0,2,2,2,31,15,1,Nikola Jokic,DEN,TOR,DEN,45.0,Pts+Rebs+Asts,52,46,37,21
22023,203999,22300369,"DEC 20, 2023",DEN @ TOR,W,38,13,23,0.565,3,5,0.6,2,3,0.667,5,10,15,6,0,2,2,2,31,15,1,Nikola Jokic,DEN,TOR,DEN,9.0,Assists,52,46,37,21
22023,203999,22300369,"DEC 20, 2023",DEN @ TOR,W,38,13,23,0.565,3,5,0.6,2,3,0.667,5,10,15,6,0,2,2,2,31,15,1,Nikola Jokic,DEN,TOR,DEN,53.5,Fantasy Score,52,46,37,21
22023,203999,22300369,"DEC 20, 2023",DEN @ TOR,W,38,13,23,0.565,3,5,0.6,2,3,0.667,5,10,15,6,0,2,2,2,31,15,1,Nikola Jokic,DEN,TOR,DEN,35.5,Pts+Rebs,52,46,37,21
22023,203999,22300369,"DEC 20, 2023",DEN @ TOR,W,38,13,23,0.565,3,5,0.6,2,3,0.667,5,10,15,6,0,2,2,2,31,15,1,Nikola Jokic,DEN,TOR,DEN,34.0,Pts+Asts,52,46,37,21
22023,203999,22300369,"DEC 20, 2023",DEN @ TOR,W,38,13,23,0.565,3,5,0.6,2,3,0.667,5,10,15,6,0,2,2,2,31,15,1,Nikola Jokic,DEN,TOR,DEN,20.0,Rebs+Asts,52,46,37,21
22023,203999,22300356,"DEC 18, 2023",DEN vs. DAL,W,28,3,8,0.375,0,1,0.0,2,2,1.0,1,8,9,7,2,0,2,2,8,16,1,Nikola Jokic,DEN,DEN,DAL,24.5,Points,24,17,15,16
22023,203999,22300356,"DEC 18, 2023",DEN vs. DAL,W,28,3,8,0.375,0,1,0.0,2,2,1.0,1,8,9,7,2,0,2,2,8,16,1,Nikola Jokic,DEN,DEN,DAL,11.0,Rebounds,24,17,15,16
22023,203999,22300356,"DEC 18, 2023",DEN vs. DAL,W,28,3,8,0.375,0,1,0.0,2,2,1.0,1,8,9,7,2,0,2,2,8,16,1,Nikola Jokic,DEN,DEN,DAL,45.0,Pts+Rebs+Asts,24,17,15,16
22023,203999,22300356,"DEC 18, 2023",DEN vs. DAL,W,28,3,8,0.375,0,1,0.0,2,2,1.0,1,8,9,7,2,0,2,2,8,16,1,Nikola Jokic,DEN,DEN,DAL,9.0,Assists,24,17,15,16
22023,203999,22300356,"DEC 18, 2023",DEN vs. DAL,W,28,3,8,0.375,0,1,0.0,2,2,1.0,1,8,9,7,2,0,2,2,8,16,1,Nikola Jokic,DEN,DEN,DAL,53.5,Fantasy Score,24,17,15,16
22023,203999,22300356,"DEC 18, 2023",DEN vs. DAL,W,28,3,8,0.375,0,1,0.0,2,2,1.0,1,8,9,7,2,0,2,2,8,16,1,Nikola Jokic,DEN,DEN,DAL,35.5,Pts+Rebs,24,17,15,16
22023,203999,22300356,"DEC 18, 2023",DEN vs. DAL,W,28,3,8,0.375,0,1,0.0,2,2,1.0,1,8,9,7,2,0,2,2,8,16,1,Nikola Jokic,DEN,DEN,DAL,34.0,Pts+Asts,24,17,15,16
22023,203999,22300356,"DEC 18, 2023",DEN vs. DAL,W,28,3,8,0.375,0,1,0.0,2,2,1.0,1,8,9,7,2,0,2,2,8,16,1,Nikola Jokic,DEN,DEN,DAL,20.0,Rebs+Asts,24,17,15,16
22023,203999,22300340,"DEC 16, 2023",DEN vs. OKC,L,37,8,15,0.533,1,2,0.5,7,8,0.875,4,2,6,12,2,0,3,3,24,-9,1,Nikola Jokic,DEN,DEN,OKC,24.5,Points,42,30,36,18
22023,203999,22300340,"DEC 16, 2023",DEN vs. OKC,L,37,8,15,0.533,1,2,0.5,7,8,0.875,4,2,6,12,2,0,3,3,24,-9,1,Nikola Jokic,DEN,DEN,OKC,11.0,Rebounds,42,30,36,18
22023,203999,22300340,"DEC 16, 2023",DEN vs. OKC,L,37,8,15,0.533,1,2,0.5,7,8,0.875,4,2,6,12,2,0,3,3,24,-9,1,Nikola Jokic,DEN,DEN,OKC,45.0,Pts+Rebs+Asts,42,30,36,18
22023,203999,22300340,"DEC 16, 2023",DEN vs. OKC,L,37,8,15,0.533,1,2,0.5,7,8,0.875,4,2,6,12,2,0,3,3,24,-9,1,Nikola Jokic,DEN,DEN,OKC,9.0,Assists,42,30,36,18
22023,203999,22300340,"DEC 16, 2023",DEN vs. OKC,L,37,8,15,0.533,1,2,0.5,7,8,0.875,4,2,6,12,2,0,3,3,24,-9,1,Nikola Jokic,DEN,DEN,OKC,53.5,Fantasy Score,42,30,36,18
22023,203999,22300340,"DEC 16, 2023",DEN vs. OKC,L,37,8,15,0.533,1,2,0.5,7,8,0.875,4,2,6,12,2,0,3,3,24,-9,1,Nikola Jokic,DEN,DEN,OKC,35.5,Pts+Rebs,42,30,36,18
22023,203999,22300340,"DEC 16, 2023",DEN vs. OKC,L,37,8,15,0.533,1,2,0.5,7,8,0.875,4,2,6,12,2,0,3,3,24,-9,1,Nikola Jokic,DEN,DEN,OKC,34.0,Pts+Asts,42,30,36,18
22023,203999,22300340,"DEC 16, 2023",DEN vs. OKC,L,37,8,15,0.533,1,2,0.5,7,8,0.875,4,2,6,12,2,0,3,3,24,-9,1,Nikola Jokic,DEN,DEN,OKC,20.0,Rebs+Asts,42,30,36,18
22023,203999,22300322,"DEC 14, 2023",DEN vs. BKN,W,30,8,12,0.667,0,2,0.0,10,12,0.833,1,13,14,10,1,0,1,2,26,21,1,Nikola Jokic,DEN,DEN,BKN,24.5,Points,50,40,36,24
22023,203999,22300322,"DEC 14, 2023",DEN vs. BKN,W,30,8,12,0.667,0,2,0.0,10,12,0.833,1,13,14,10,1,0,1,2,26,21,1,Nikola Jokic,DEN,DEN,BKN,11.0,Rebounds,50,40,36,24
22023,203999,22300322,"DEC 14, 2023",DEN vs. BKN,W,30,8,12,0.667,0,2,0.0,10,12,0.833,1,13,14,10,1,0,1,2,26,21,1,Nikola Jokic,DEN,DEN,BKN,45.0,Pts+Rebs+Asts,50,40,36,24
22023,203999,22300322,"DEC 14, 2023",DEN vs. BKN,W,30,8,12,0.667,0,2,0.0,10,12,0.833,1,13,14,10,1,0,1,2,26,21,1,Nikola Jokic,DEN,DEN,BKN,9.0,Assists,50,40,36,24
22023,203999,22300322,"DEC 14, 2023",DEN vs. BKN,W,30,8,12,0.667,0,2,0.0,10,12,0.833,1,13,14,10,1,0,1,2,26,21,1,Nikola Jokic,DEN,DEN,BKN,53.5,Fantasy Score,50,40,36,24
22023,203999,22300322,"DEC 14, 2023",DEN vs. BKN,W,30,8,12,0.667,0,2,0.0,10,12,0.833,1,13,14,10,1,0,1,2,26,21,1,Nikola Jokic,DEN,DEN,BKN,35.5,Pts+Rebs,50,40,36,24
22023,203999,22300322,"DEC 14, 2023",DEN vs. BKN,W,30,8,12,0.667,0,2,0.0,10,12,0.833,1,13,14,10,1,0,1,2,26,21,1,Nikola Jokic,DEN,DEN,BKN,34.0,Pts+Asts,50,40,36,24
22023,203999,22300322,"DEC 14, 2023",DEN vs. BKN,W,30,8,12,0.667,0,2,0.0,10,12,0.833,1,13,14,10,1,0,1,2,26,21,1,Nikola Jokic,DEN,DEN,BKN,20.0,Rebs+Asts,50,40,36,24
22023,203999,22300307,"DEC 12, 2023",DEN @ CHI,W,16,2,5,0.4,0,0,0.0,0,0,0.0,3,6,9,6,0,0,0,1,4,5,1,Nikola Jokic,DEN,CHI,DEN,24.5,Points,19,13,10,15
22023,203999,22300307,"DEC 12, 2023",DEN @ CHI,W,16,2,5,0.4,0,0,0.0,0,0,0.0,3,6,9,6,0,0,0,1,4,5,1,Nikola Jokic,DEN,CHI,DEN,11.0,Rebounds,19,13,10,15
22023,203999,22300307,"DEC 12, 2023",DEN @ CHI,W,16,2,5,0.4,0,0,0.0,0,0,0.0,3,6,9,6,0,0,0,1,4,5,1,Nikola Jokic,DEN,CHI,DEN,45.0,Pts+Rebs+Asts,19,13,10,15
22023,203999,22300307,"DEC 12, 2023",DEN @ CHI,W,16,2,5,0.4,0,0,0.0,0,0,0.0,3,6,9,6,0,0,0,1,4,5,1,Nikola Jokic,DEN,CHI,DEN,9.0,Assists,19,13,10,15
22023,203999,22300307,"DEC 12, 2023",DEN @ CHI,W,16,2,5,0.4,0,0,0.0,0,0,0.0,3,6,9,6,0,0,0,1,4,5,1,Nikola Jokic,DEN,CHI,DEN,53.5,Fantasy Score,19,13,10,15
22023,203999,22300307,"DEC 12, 2023",DEN @ CHI,W,16,2,5,0.4,0,0,0.0,0,0,0.0,3,6,9,6,0,0,0,1,4,5,1,Nikola Jokic,DEN,CHI,DEN,35.5,Pts+Rebs,19,13,10,15
22023,203999,22300307,"DEC 12, 2023",DEN @ CHI,W,16,2,5,0.4,0,0,0.0,0,0,0.0,3,6,9,6,0,0,0,1,4,5,1,Nikola Jokic,DEN,CHI,DEN,34.0,Pts+Asts,19,13,10,15
22023,203999,22300307,"DEC 12, 2023",DEN @ CHI,W,16,2,5,0.4,0,0,0.0,0,0,0.0,3,6,9,6,0,0,0,1,4,5,1,Nikola Jokic,DEN,CHI,DEN,20.0,Rebs+Asts,19,13,10,15
22023,203999,22300296,"DEC 11, 2023",DEN @ ATL,W,36,9,13,0.692,1,1,1.0,6,7,0.857,2,6,8,9,3,2,1,3,25,8,1,Nikola Jokic,DEN,ATL,DEN,24.5,Points,42,33,34,17
22023,203999,22300296,"DEC 11, 2023",DEN @ ATL,W,36,9,13,0.692,1,1,1.0,6,7,0.857,2,6,8,9,3,2,1,3,25,8,1,Nikola Jokic,DEN,ATL,DEN,11.0,Rebounds,42,33,34,17
22023,203999,22300296,"DEC 11, 2023",DEN @ ATL,W,36,9,13,0.692,1,1,1.0,6,7,0.857,2,6,8,9,3,2,1,3,25,8,1,Nikola Jokic,DEN,ATL,DEN,45.0,Pts+Rebs+Asts,42,33,34,17
22023,203999,22300296,"DEC 11, 2023",DEN @ ATL,W,36,9,13,0.692,1,1,1.0,6,7,0.857,2,6,8,9,3,2,1,3,25,8,1,Nikola Jokic,DEN,ATL,DEN,9.0,Assists,42,33,34,17
22023,203999,22300296,"DEC 11, 2023",DEN @ ATL,W,36,9,13,0.692,1,1,1.0,6,7,0.857,2,6,8,9,3,2,1,3,25,8,1,Nikola Jokic,DEN,ATL,DEN,53.5,Fantasy Score,42,33,34,17
22023,203999,22300296,"DEC 11, 2023",DEN @ ATL,W,36,9,13,0.692,1,1,1.0,6,7,0.857,2,6,8,9,3,2,1,3,25,8,1,Nikola Jokic,DEN,ATL,DEN,35.5,Pts+Rebs,42,33,34,17
22023,203999,22300296,"DEC 11, 2023",DEN @ ATL,W,36,9,13,0.692,1,1,1.0,6,7,0.857,2,6,8,9,3,2,1,3,25,8,1,Nikola Jokic,DEN,ATL,DEN,34.0,Pts+Asts,42,33,34,17
22023,203999,22300296,"DEC 11, 2023",DEN @ ATL,W,36,9,13,0.692,1,1,1.0,6,7,0.857,2,6,8,9,3,2,1,3,25,8,1,Nikola Jokic,DEN,ATL,DEN,20.0,Rebs+Asts,42,33,34,17
22023,203999,22301224,"DEC 08, 2023",DEN vs. HOU,L,34,9,26,0.346,1,2,0.5,4,7,0.571,7,9,16,5,0,2,3,5,23,3,1,Nikola Jokic,DEN,DEN,HOU,24.5,Points,44,39,28,21
22023,203999,22301224,"DEC 08, 2023",DEN vs. HOU,L,34,9,26,0.346,1,2,0.5,4,7,0.571,7,9,16,5,0,2,3,5,23,3,1,Nikola Jokic,DEN,DEN,HOU,11.0,Rebounds,44,39,28,21
22023,203999,22301224,"DEC 08, 2023",DEN vs. HOU,L,34,9,26,0.346,1,2,0.5,4,7,0.571,7,9,16,5,0,2,3,5,23,3,1,Nikola Jokic,DEN,DEN,HOU,45.0,Pts+Rebs+Asts,44,39,28,21
22023,203999,22301224,"DEC 08, 2023",DEN vs. HOU,L,34,9,26,0.346,1,2,0.5,4,7,0.571,7,9,16,5,0,2,3,5,23,3,1,Nikola Jokic,DEN,DEN,HOU,9.0,Assists,44,39,28,21
22023,203999,22301224,"DEC 08, 2023",DEN vs. HOU,L,34,9,26,0.346,1,2,0.5,4,7,0.571,7,9,16,5,0,2,3,5,23,3,1,Nikola Jokic,DEN,DEN,HOU,53.5,Fantasy Score,44,39,28,21
22023,203999,22301224,"DEC 08, 2023",DEN vs. HOU,L,34,9,26,0.346,1,2,0.5,4,7,0.571,7,9,16,5,0,2,3,5,23,3,1,Nikola Jokic,DEN,DEN,HOU,35.5,Pts+Rebs,44,39,28,21
22023,203999,22301224,"DEC 08, 2023",DEN vs. HOU,L,34,9,26,0.346,1,2,0.5,4,7,0.571,7,9,16,5,0,2,3,5,23,3,1,Nikola Jokic,DEN,DEN,HOU,34.0,Pts+Asts,44,39,28,21
22023,203999,22301224,"DEC 08, 2023",DEN vs. HOU,L,34,9,26,0.346,1,2,0.5,4,7,0.571,7,9,16,5,0,2,3,5,23,3,1,Nikola Jokic,DEN,DEN,HOU,20.0,Rebs+Asts,44,39,28,21
22023,203999,22301215,"DEC 06, 2023",DEN @ LAC,L,37,9,32,0.281,2,7,0.286,2,2,1.0,5,10,15,10,1,0,4,2,22,1,1,Nikola Jokic,DEN,LAC,DEN,24.5,Points,47,37,32,25
22023,203999,22301215,"DEC 06, 2023",DEN @ LAC,L,37,9,32,0.281,2,7,0.286,2,2,1.0,5,10,15,10,1,0,4,2,22,1,1,Nikola Jokic,DEN,LAC,DEN,11.0,Rebounds,47,37,32,25
22023,203999,22301215,"DEC 06, 2023",DEN @ LAC,L,37,9,32,0.281,2,7,0.286,2,2,1.0,5,10,15,10,1,0,4,2,22,1,1,Nikola Jokic,DEN,LAC,DEN,45.0,Pts+Rebs+Asts,47,37,32,25
22023,203999,22301215,"DEC 06, 2023",DEN @ LAC,L,37,9,32,0.281,2,7,0.286,2,2,1.0,5,10,15,10,1,0,4,2,22,1,1,Nikola Jokic,DEN,LAC,DEN,9.0,Assists,47,37,32,25
22023,203999,22301215,"DEC 06, 2023",DEN @ LAC,L,37,9,32,0.281,2,7,0.286,2,2,1.0,5,10,15,10,1,0,4,2,22,1,1,Nikola Jokic,DEN,LAC,DEN,53.5,Fantasy Score,47,37,32,25
22023,203999,22301215,"DEC 06, 2023",DEN @ LAC,L,37,9,32,0.281,2,7,0.286,2,2,1.0,5,10,15,10,1,0,4,2,22,1,1,Nikola Jokic,DEN,LAC,DEN,35.5,Pts+Rebs,47,37,32,25
22023,203999,22301215,"DEC 06, 2023",DEN @ LAC,L,37,9,32,0.281,2,7,0.286,2,2,1.0,5,10,15,10,1,0,4,2,22,1,1,Nikola Jokic,DEN,LAC,DEN,34.0,Pts+Asts,47,37,32,25
22023,203999,22301215,"DEC 06, 2023",DEN @ LAC,L,37,9,32,0.281,2,7,0.286,2,2,1.0,5,10,15,10,1,0,4,2,22,1,1,Nikola Jokic,DEN,LAC,DEN,20.0,Rebs+Asts,47,37,32,25
22023,203999,22300290,"DEC 02, 2023",DEN @ SAC,L,38,13,23,0.565,1,4,0.25,9,12,0.75,2,11,13,14,2,1,0,3,36,11,1,Nikola Jokic,DEN,SAC,DEN,24.5,Points,63,49,50,27
22023,203999,22300290,"DEC 02, 2023",DEN @ SAC,L,38,13,23,0.565,1,4,0.25,9,12,0.75,2,11,13,14,2,1,0,3,36,11,1,Nikola Jokic,DEN,SAC,DEN,11.0,Rebounds,63,49,50,27
22023,203999,22300290,"DEC 02, 2023",DEN @ SAC,L,38,13,23,0.565,1,4,0.25,9,12,0.75,2,11,13,14,2,1,0,3,36,11,1,Nikola Jokic,DEN,SAC,DEN,45.0,Pts+Rebs+Asts,63,49,50,27
22023,203999,22300290,"DEC 02, 2023",DEN @ SAC,L,38,13,23,0.565,1,4,0.25,9,12,0.75,2,11,13,14,2,1,0,3,36,11,1,Nikola Jokic,DEN,SAC,DEN,9.0,Assists,63,49,50,27
22023,203999,22300290,"DEC 02, 2023",DEN @ SAC,L,38,13,23,0.565,1,4,0.25,9,12,0.75,2,11,13,14,2,1,0,3,36,11,1,Nikola Jokic,DEN,SAC,DEN,53.5,Fantasy Score,63,49,50,27
22023,203999,22300290,"DEC 02, 2023",DEN @ SAC,L,38,13,23,0.565,1,4,0.25,9,12,0.75,2,11,13,14,2,1,0,3,36,11,1,Nikola Jokic,DEN,SAC,DEN,35.5,Pts+Rebs,63,49,50,27
22023,203999,22300290,"DEC 02, 2023",DEN @ SAC,L,38,13,23,0.565,1,4,0.25,9,12,0.75,2,11,13,14,2,1,0,3,36,11,1,Nikola Jokic,DEN,SAC,DEN,34.0,Pts+Asts,63,49,50,27
22023,203999,22300290,"DEC 02, 2023",DEN @ SAC,L,38,13,23,0.565,1,4,0.25,9,12,0.75,2,11,13,14,2,1,0,3,36,11,1,Nikola Jokic,DEN,SAC,DEN,20.0,Rebs+Asts,63,49,50,27
22023,203999,22300279,"DEC 01, 2023",DEN @ PHX,W,35,9,18,0.5,0,3,0.0,3,6,0.5,1,4,5,16,1,2,3,4,21,6,1,Nikola Jokic,DEN,PHX,DEN,24.5,Points,42,26,37,21
22023,203999,22300279,"DEC 01, 2023",DEN @ PHX,W,35,9,18,0.5,0,3,0.0,3,6,0.5,1,4,5,16,1,2,3,4,21,6,1,Nikola Jokic,DEN,PHX,DEN,11.0,Rebounds,42,26,37,21
22023,203999,22300279,"DEC 01, 2023",DEN @ PHX,W,35,9,18,0.5,0,3,0.0,3,6,0.5,1,4,5,16,1,2,3,4,21,6,1,Nikola Jokic,DEN,PHX,DEN,45.0,Pts+Rebs+Asts,42,26,37,21
22023,203999,22300279,"DEC 01, 2023",DEN @ PHX,W,35,9,18,0.5,0,3,0.0,3,6,0.5,1,4,5,16,1,2,3,4,21,6,1,Nikola Jokic,DEN,PHX,DEN,9.0,Assists,42,26,37,21
22023,203999,22300279,"DEC 01, 2023",DEN @ PHX,W,35,9,18,0.5,0,3,0.0,3,6,0.5,1,4,5,16,1,2,3,4,21,6,1,Nikola Jokic,DEN,PHX,DEN,53.5,Fantasy Score,42,26,37,21
22023,203999,22300279,"DEC 01, 2023",DEN @ PHX,W,35,9,18,0.5,0,3,0.0,3,6,0.5,1,4,5,16,1,2,3,4,21,6,1,Nikola Jokic,DEN,PHX,DEN,35.5,Pts+Rebs,42,26,37,21
22023,203999,22300279,"DEC 01, 2023",DEN @ PHX,W,35,9,18,0.5,0,3,0.0,3,6,0.5,1,4,5,16,1,2,3,4,21,6,1,Nikola Jokic,DEN,PHX,DEN,34.0,Pts+Asts,42,26,37,21
22023,203999,22300279,"DEC 01, 2023",DEN @ PHX,W,35,9,18,0.5,0,3,0.0,3,6,0.5,1,4,5,16,1,2,3,4,21,6,1,Nikola Jokic,DEN,PHX,DEN,20.0,Rebs+Asts,42,26,37,21
22023,203999,22300263,"NOV 29, 2023",DEN vs. HOU,W,33,12,19,0.632,1,2,0.5,7,8,0.875,6,4,10,15,1,0,0,2,32,29,1,Nikola Jokic,DEN,DEN,HOU,24.5,Points,57,42,47,25
22023,203999,22300263,"NOV 29, 2023",DEN vs. HOU,W,33,12,19,0.632,1,2,0.5,7,8,0.875,6,4,10,15,1,0,0,2,32,29,1,Nikola Jokic,DEN,DEN,HOU,11.0,Rebounds,57,42,47,25
22023,203999,22300263,"NOV 29, 2023",DEN vs. HOU,W,33,12,19,0.632,1,2,0.5,7,8,0.875,6,4,10,15,1,0,0,2,32,29,1,Nikola Jokic,DEN,DEN,HOU,45.0,Pts+Rebs+Asts,57,42,47,25
22023,203999,22300263,"NOV 29, 2023",DEN vs. HOU,W,33,12,19,0.632,1,2,0.5,7,8,0.875,6,4,10,15,1,0,0,2,32,29,1,Nikola Jokic,DEN,DEN,HOU,9.0,Assists,57,42,47,25
22023,203999,22300263,"NOV 29, 2023",DEN vs. HOU,W,33,12,19,0.632,1,2,0.5,7,8,0.875,6,4,10,15,1,0,0,2,32,29,1,Nikola Jokic,DEN,DEN,HOU,53.5,Fantasy Score,57,42,47,25
22023,203999,22300263,"NOV 29, 2023",DEN vs. HOU,W,33,12,19,0.632,1,2,0.5,7,8,0.875,6,4,10,15,1,0,0,2,32,29,1,Nikola Jokic,DEN,DEN,HOU,35.5,Pts+Rebs,57,42,47,25
22023,203999,22300263,"NOV 29, 2023",DEN vs. HOU,W,33,12,19,0.632,1,2,0.5,7,8,0.875,6,4,10,15,1,0,0,2,32,29,1,Nikola Jokic,DEN,DEN,HOU,34.0,Pts+Asts,57,42,47,25
22023,203999,22300263,"NOV 29, 2023",DEN vs. HOU,W,33,12,19,0.632,1,2,0.5,7,8,0.875,6,4,10,15,1,0,0,2,32,29,1,Nikola Jokic,DEN,DEN,HOU,20.0,Rebs+Asts,57,42,47,25
22023,203999,22300252,"NOV 26, 2023",DEN vs. SAS,W,34,17,29,0.586,0,0,0.0,5,5,1.0,5,6,11,9,1,0,5,3,39,14,1,Nikola Jokic,DEN,DEN,SAS,24.5,Points,59,50,48,20
22023,203999,22300252,"NOV 26, 2023",DEN vs. SAS,W,34,17,29,0.586,0,0,0.0,5,5,1.0,5,6,11,9,1,0,5,3,39,14,1,Nikola Jokic,DEN,DEN,SAS,11.0,Rebounds,59,50,48,20
22023,203999,22300252,"NOV 26, 2023",DEN vs. SAS,W,34,17,29,0.586,0,0,0.0,5,5,1.0,5,6,11,9,1,0,5,3,39,14,1,Nikola Jokic,DEN,DEN,SAS,45.0,Pts+Rebs+Asts,59,50,48,20
22023,203999,22300252,"NOV 26, 2023",DEN vs. SAS,W,34,17,29,0.586,0,0,0.0,5,5,1.0,5,6,11,9,1,0,5,3,39,14,1,Nikola Jokic,DEN,DEN,SAS,9.0,Assists,59,50,48,20
22023,203999,22300252,"NOV 26, 2023",DEN vs. SAS,W,34,17,29,0.586,0,0,0.0,5,5,1.0,5,6,11,9,1,0,5,3,39,14,1,Nikola Jokic,DEN,DEN,SAS,53.5,Fantasy Score,59,50,48,20
22023,203999,22300252,"NOV 26, 2023",DEN vs. SAS,W,34,17,29,0.586,0,0,0.0,5,5,1.0,5,6,11,9,1,0,5,3,39,14,1,Nikola Jokic,DEN,DEN,SAS,35.5,Pts+Rebs,59,50,48,20
22023,203999,22300252,"NOV 26, 2023",DEN vs. SAS,W,34,17,29,0.586,0,0,0.0,5,5,1.0,5,6,11,9,1,0,5,3,39,14,1,Nikola Jokic,DEN,DEN,SAS,34.0,Pts+Asts,59,50,48,20
22023,203999,22300252,"NOV 26, 2023",DEN vs. SAS,W,34,17,29,0.586,0,0,0.0,5,5,1.0,5,6,11,9,1,0,5,3,39,14,1,Nikola Jokic,DEN,DEN,SAS,20.0,Rebs+Asts,59,50,48,20
22023,203999,22300048,"NOV 24, 2023",DEN @ HOU,L,42,14,31,0.452,3,8,0.375,7,11,0.636,6,13,19,8,3,0,3,3,38,-12,1,Nikola Jokic,DEN,HOU,DEN,24.5,Points,65,57,46,27
22023,203999,22300048,"NOV 24, 2023",DEN @ HOU,L,42,14,31,0.452,3,8,0.375,7,11,0.636,6,13,19,8,3,0,3,3,38,-12,1,Nikola Jokic,DEN,HOU,DEN,11.0,Rebounds,65,57,46,27
22023,203999,22300048,"NOV 24, 2023",DEN @ HOU,L,42,14,31,0.452,3,8,0.375,7,11,0.636,6,13,19,8,3,0,3,3,38,-12,1,Nikola Jokic,DEN,HOU,DEN,45.0,Pts+Rebs+Asts,65,57,46,27
22023,203999,22300048,"NOV 24, 2023",DEN @ HOU,L,42,14,31,0.452,3,8,0.375,7,11,0.636,6,13,19,8,3,0,3,3,38,-12,1,Nikola Jokic,DEN,HOU,DEN,9.0,Assists,65,57,46,27
22023,203999,22300048,"NOV 24, 2023",DEN @ HOU,L,42,14,31,0.452,3,8,0.375,7,11,0.636,6,13,19,8,3,0,3,3,38,-12,1,Nikola Jokic,DEN,HOU,DEN,53.5,Fantasy Score,65,57,46,27
22023,203999,22300048,"NOV 24, 2023",DEN @ HOU,L,42,14,31,0.452,3,8,0.375,7,11,0.636,6,13,19,8,3,0,3,3,38,-12,1,Nikola Jokic,DEN,HOU,DEN,35.5,Pts+Rebs,65,57,46,27
22023,203999,22300048,"NOV 24, 2023",DEN @ HOU,L,42,14,31,0.452,3,8,0.375,7,11,0.636,6,13,19,8,3,0,3,3,38,-12,1,Nikola Jokic,DEN,HOU,DEN,34.0,Pts+Asts,65,57,46,27
22023,203999,22300048,"NOV 24, 2023",DEN @ HOU,L,42,14,31,0.452,3,8,0.375,7,11,0.636,6,13,19,8,3,0,3,3,38,-12,1,Nikola Jokic,DEN,HOU,DEN,20.0,Rebs+Asts,65,57,46,27
22023,203999,22300226,"NOV 22, 2023",DEN @ ORL,L,36,12,18,0.667,1,2,0.5,5,5,1.0,5,8,13,12,3,2,1,4,30,4,1,Nikola Jokic,DEN,ORL,DEN,24.5,Points,55,43,42,25
22023,203999,22300226,"NOV 22, 2023",DEN @ ORL,L,36,12,18,0.667,1,2,0.5,5,5,1.0,5,8,13,12,3,2,1,4,30,4,1,Nikola Jokic,DEN,ORL,DEN,11.0,Rebounds,55,43,42,25
22023,203999,22300226,"NOV 22, 2023",DEN @ ORL,L,36,12,18,0.667,1,2,0.5,5,5,1.0,5,8,13,12,3,2,1,4,30,4,1,Nikola Jokic,DEN,ORL,DEN,45.0,Pts+Rebs+Asts,55,43,42,25
22023,203999,22300226,"NOV 22, 2023",DEN @ ORL,L,36,12,18,0.667,1,2,0.5,5,5,1.0,5,8,13,12,3,2,1,4,30,4,1,Nikola Jokic,DEN,ORL,DEN,9.0,Assists,55,43,42,25
22023,203999,22300226,"NOV 22, 2023",DEN @ ORL,L,36,12,18,0.667,1,2,0.5,5,5,1.0,5,8,13,12,3,2,1,4,30,4,1,Nikola Jokic,DEN,ORL,DEN,53.5,Fantasy Score,55,43,42,25
22023,203999,22300226,"NOV 22, 2023",DEN @ ORL,L,36,12,18,0.667,1,2,0.5,5,5,1.0,5,8,13,12,3,2,1,4,30,4,1,Nikola Jokic,DEN,ORL,DEN,35.5,Pts+Rebs,55,43,42,25
22023,203999,22300226,"NOV 22, 2023",DEN @ ORL,L,36,12,18,0.667,1,2,0.5,5,5,1.0,5,8,13,12,3,2,1,4,30,4,1,Nikola Jokic,DEN,ORL,DEN,34.0,Pts+Asts,55,43,42,25
22023,203999,22300226,"NOV 22, 2023",DEN @ ORL,L,36,12,18,0.667,1,2,0.5,5,5,1.0,5,8,13,12,3,2,1,4,30,4,1,Nikola Jokic,DEN,ORL,DEN,20.0,Rebs+Asts,55,43,42,25
22023,203999,22300218,"NOV 20, 2023",DEN @ DET,W,15,4,8,0.5,1,4,0.25,0,0,0.0,0,5,5,5,0,1,1,1,9,-4,1,Nikola Jokic,DEN,DET,DEN,24.5,Points,19,14,14,10
22023,203999,22300218,"NOV 20, 2023",DEN @ DET,W,15,4,8,0.5,1,4,0.25,0,0,0.0,0,5,5,5,0,1,1,1,9,-4,1,Nikola Jokic,DEN,DET,DEN,11.0,Rebounds,19,14,14,10
22023,203999,22300218,"NOV 20, 2023",DEN @ DET,W,15,4,8,0.5,1,4,0.25,0,0,0.0,0,5,5,5,0,1,1,1,9,-4,1,Nikola Jokic,DEN,DET,DEN,45.0,Pts+Rebs+Asts,19,14,14,10
22023,203999,22300218,"NOV 20, 2023",DEN @ DET,W,15,4,8,0.5,1,4,0.25,0,0,0.0,0,5,5,5,0,1,1,1,9,-4,1,Nikola Jokic,DEN,DET,DEN,9.0,Assists,19,14,14,10
22023,203999,22300218,"NOV 20, 2023",DEN @ DET,W,15,4,8,0.5,1,4,0.25,0,0,0.0,0,5,5,5,0,1,1,1,9,-4,1,Nikola Jokic,DEN,DET,DEN,53.5,Fantasy Score,19,14,14,10
22023,203999,22300218,"NOV 20, 2023",DEN @ DET,W,15,4,8,0.5,1,4,0.25,0,0,0.0,0,5,5,5,0,1,1,1,9,-4,1,Nikola Jokic,DEN,DET,DEN,35.5,Pts+Rebs,19,14,14,10
22023,203999,22300218,"NOV 20, 2023",DEN @ DET,W,15,4,8,0.5,1,4,0.25,0,0,0.0,0,5,5,5,0,1,1,1,9,-4,1,Nikola Jokic,DEN,DET,DEN,34.0,Pts+Asts,19,14,14,10
22023,203999,22300218,"NOV 20, 2023",DEN @ DET,W,15,4,8,0.5,1,4,0.25,0,0,0.0,0,5,5,5,0,1,1,1,9,-4,1,Nikola Jokic,DEN,DET,DEN,20.0,Rebs+Asts,19,14,14,10
22023,203999,22300210,"NOV 19, 2023",DEN @ CLE,L,28,8,13,0.615,0,0,0.0,2,5,0.4,1,9,10,7,1,1,3,5,18,-16,1,Nikola Jokic,DEN,CLE,DEN,24.5,Points,35,28,25,17
22023,203999,22300210,"NOV 19, 2023",DEN @ CLE,L,28,8,13,0.615,0,0,0.0,2,5,0.4,1,9,10,7,1,1,3,5,18,-16,1,Nikola Jokic,DEN,CLE,DEN,11.0,Rebounds,35,28,25,17
22023,203999,22300210,"NOV 19, 2023",DEN @ CLE,L,28,8,13,0.615,0,0,0.0,2,5,0.4,1,9,10,7,1,1,3,5,18,-16,1,Nikola Jokic,DEN,CLE,DEN,45.0,Pts+Rebs+Asts,35,28,25,17
22023,203999,22300210,"NOV 19, 2023",DEN @ CLE,L,28,8,13,0.615,0,0,0.0,2,5,0.4,1,9,10,7,1,1,3,5,18,-16,1,Nikola Jokic,DEN,CLE,DEN,9.0,Assists,35,28,25,17
22023,203999,22300210,"NOV 19, 2023",DEN @ CLE,L,28,8,13,0.615,0,0,0.0,2,5,0.4,1,9,10,7,1,1,3,5,18,-16,1,Nikola Jokic,DEN,CLE,DEN,53.5,Fantasy Score,35,28,25,17
22023,203999,22300210,"NOV 19, 2023",DEN @ CLE,L,28,8,13,0.615,0,0,0.0,2,5,0.4,1,9,10,7,1,1,3,5,18,-16,1,Nikola Jokic,DEN,CLE,DEN,35.5,Pts+Rebs,35,28,25,17
22023,203999,22300210,"NOV 19, 2023",DEN @ CLE,L,28,8,13,0.615,0,0,0.0,2,5,0.4,1,9,10,7,1,1,3,5,18,-16,1,Nikola Jokic,DEN,CLE,DEN,34.0,Pts+Asts,35,28,25,17
22023,203999,22300210,"NOV 19, 2023",DEN @ CLE,L,28,8,13,0.615,0,0,0.0,2,5,0.4,1,9,10,7,1,1,3,5,18,-16,1,Nikola Jokic,DEN,CLE,DEN,20.0,Rebs+Asts,35,28,25,17
22023,203999,22300034,"NOV 17, 2023",DEN @ NOP,L,36,10,20,0.5,1,8,0.125,5,5,1.0,2,14,16,18,1,1,4,2,26,5,1,Nikola Jokic,DEN,NOP,DEN,24.5,Points,60,42,44,34
22023,203999,22300034,"NOV 17, 2023",DEN @ NOP,L,36,10,20,0.5,1,8,0.125,5,5,1.0,2,14,16,18,1,1,4,2,26,5,1,Nikola Jokic,DEN,NOP,DEN,11.0,Rebounds,60,42,44,34
22023,203999,22300034,"NOV 17, 2023",DEN @ NOP,L,36,10,20,0.5,1,8,0.125,5,5,1.0,2,14,16,18,1,1,4,2,26,5,1,Nikola Jokic,DEN,NOP,DEN,45.0,Pts+Rebs+Asts,60,42,44,34
22023,203999,22300034,"NOV 17, 2023",DEN @ NOP,L,36,10,20,0.5,1,8,0.125,5,5,1.0,2,14,16,18,1,1,4,2,26,5,1,Nikola Jokic,DEN,NOP,DEN,9.0,Assists,60,42,44,34
22023,203999,22300034,"NOV 17, 2023",DEN @ NOP,L,36,10,20,0.5,1,8,0.125,5,5,1.0,2,14,16,18,1,1,4,2,26,5,1,Nikola Jokic,DEN,NOP,DEN,53.5,Fantasy Score,60,42,44,34
22023,203999,22300034,"NOV 17, 2023",DEN @ NOP,L,36,10,20,0.5,1,8,0.125,5,5,1.0,2,14,16,18,1,1,4,2,26,5,1,Nikola Jokic,DEN,NOP,DEN,35.5,Pts+Rebs,60,42,44,34
22023,203999,22300034,"NOV 17, 2023",DEN @ NOP,L,36,10,20,0.5,1,8,0.125,5,5,1.0,2,14,16,18,1,1,4,2,26,5,1,Nikola Jokic,DEN,NOP,DEN,34.0,Pts+Asts,60,42,44,34
22023,203999,22300034,"NOV 17, 2023",DEN @ NOP,L,36,10,20,0.5,1,8,0.125,5,5,1.0,2,14,16,18,1,1,4,2,26,5,1,Nikola Jokic,DEN,NOP,DEN,20.0,Rebs+Asts,60,42,44,34
22023,203999,22300024,"NOV 14, 2023",DEN vs. LAC,W,36,8,23,0.348,2,7,0.286,14,14,1.0,3,13,16,9,1,0,4,2,32,3,1,Nikola Jokic,DEN,DEN,LAC,24.5,Points,57,48,41,25
22023,203999,22300024,"NOV 14, 2023",DEN vs. LAC,W,36,8,23,0.348,2,7,0.286,14,14,1.0,3,13,16,9,1,0,4,2,32,3,1,Nikola Jokic,DEN,DEN,LAC,11.0,Rebounds,57,48,41,25
22023,203999,22300024,"NOV 14, 2023",DEN vs. LAC,W,36,8,23,0.348,2,7,0.286,14,14,1.0,3,13,16,9,1,0,4,2,32,3,1,Nikola Jokic,DEN,DEN,LAC,45.0,Pts+Rebs+Asts,57,48,41,25
22023,203999,22300024,"NOV 14, 2023",DEN vs. LAC,W,36,8,23,0.348,2,7,0.286,14,14,1.0,3,13,16,9,1,0,4,2,32,3,1,Nikola Jokic,DEN,DEN,LAC,9.0,Assists,57,48,41,25
22023,203999,22300024,"NOV 14, 2023",DEN vs. LAC,W,36,8,23,0.348,2,7,0.286,14,14,1.0,3,13,16,9,1,0,4,2,32,3,1,Nikola Jokic,DEN,DEN,LAC,53.5,Fantasy Score,57,48,41,25
22023,203999,22300024,"NOV 14, 2023",DEN vs. LAC,W,36,8,23,0.348,2,7,0.286,14,14,1.0,3,13,16,9,1,0,4,2,32,3,1,Nikola Jokic,DEN,DEN,LAC,35.5,Pts+Rebs,57,48,41,25
22023,203999,22300024,"NOV 14, 2023",DEN vs. LAC,W,36,8,23,0.348,2,7,0.286,14,14,1.0,3,13,16,9,1,0,4,2,32,3,1,Nikola Jokic,DEN,DEN,LAC,34.0,Pts+Asts,57,48,41,25
22023,203999,22300024,"NOV 14, 2023",DEN vs. LAC,W,36,8,23,0.348,2,7,0.286,14,14,1.0,3,13,16,9,1,0,4,2,32,3,1,Nikola Jokic,DEN,DEN,LAC,20.0,Rebs+Asts,57,48,41,25
22023,203999,22300182,"NOV 12, 2023",DEN @ HOU,L,38,13,26,0.5,2,6,0.333,8,8,1.0,6,15,21,11,0,1,3,3,36,12,1,Nikola Jokic,DEN,HOU,DEN,24.5,Points,68,57,47,32
22023,203999,22300182,"NOV 12, 2023",DEN @ HOU,L,38,13,26,0.5,2,6,0.333,8,8,1.0,6,15,21,11,0,1,3,3,36,12,1,Nikola Jokic,DEN,HOU,DEN,11.0,Rebounds,68,57,47,32
22023,203999,22300182,"NOV 12, 2023",DEN @ HOU,L,38,13,26,0.5,2,6,0.333,8,8,1.0,6,15,21,11,0,1,3,3,36,12,1,Nikola Jokic,DEN,HOU,DEN,45.0,Pts+Rebs+Asts,68,57,47,32
22023,203999,22300182,"NOV 12, 2023",DEN @ HOU,L,38,13,26,0.5,2,6,0.333,8,8,1.0,6,15,21,11,0,1,3,3,36,12,1,Nikola Jokic,DEN,HOU,DEN,9.0,Assists,68,57,47,32
22023,203999,22300182,"NOV 12, 2023",DEN @ HOU,L,38,13,26,0.5,2,6,0.333,8,8,1.0,6,15,21,11,0,1,3,3,36,12,1,Nikola Jokic,DEN,HOU,DEN,53.5,Fantasy Score,68,57,47,32
22023,203999,22300182,"NOV 12, 2023",DEN @ HOU,L,38,13,26,0.5,2,6,0.333,8,8,1.0,6,15,21,11,0,1,3,3,36,12,1,Nikola Jokic,DEN,HOU,DEN,35.5,Pts+Rebs,68,57,47,32
22023,203999,22300182,"NOV 12, 2023",DEN @ HOU,L,38,13,26,0.5,2,6,0.333,8,8,1.0,6,15,21,11,0,1,3,3,36,12,1,Nikola Jokic,DEN,HOU,DEN,34.0,Pts+Asts,68,57,47,32
22023,203999,22300182,"NOV 12, 2023",DEN @ HOU,L,38,13,26,0.5,2,6,0.333,8,8,1.0,6,15,21,11,0,1,3,3,36,12,1,Nikola Jokic,DEN,HOU,DEN,20.0,Rebs+Asts,68,57,47,32
22023,203999,22300169,"NOV 08, 2023",DEN vs. GSW,W,37,14,25,0.56,1,8,0.125,6,10,0.6,3,10,13,5,3,1,3,3,35,3,1,Nikola Jokic,DEN,DEN,GSW,24.5,Points,53,48,40,18
22023,203999,22300169,"NOV 08, 2023",DEN vs. GSW,W,37,14,25,0.56,1,8,0.125,6,10,0.6,3,10,13,5,3,1,3,3,35,3,1,Nikola Jokic,DEN,DEN,GSW,11.0,Rebounds,53,48,40,18
22023,203999,22300169,"NOV 08, 2023",DEN vs. GSW,W,37,14,25,0.56,1,8,0.125,6,10,0.6,3,10,13,5,3,1,3,3,35,3,1,Nikola Jokic,DEN,DEN,GSW,45.0,Pts+Rebs+Asts,53,48,40,18
22023,203999,22300169,"NOV 08, 2023",DEN vs. GSW,W,37,14,25,0.56,1,8,0.125,6,10,0.6,3,10,13,5,3,1,3,3,35,3,1,Nikola Jokic,DEN,DEN,GSW,9.0,Assists,53,48,40,18
22023,203999,22300169,"NOV 08, 2023",DEN vs. GSW,W,37,14,25,0.56,1,8,0.125,6,10,0.6,3,10,13,5,3,1,3,3,35,3,1,Nikola Jokic,DEN,DEN,GSW,53.5,Fantasy Score,53,48,40,18
22023,203999,22300169,"NOV 08, 2023",DEN vs. GSW,W,37,14,25,0.56,1,8,0.125,6,10,0.6,3,10,13,5,3,1,3,3,35,3,1,Nikola Jokic,DEN,DEN,GSW,35.5,Pts+Rebs,53,48,40,18
22023,203999,22300169,"NOV 08, 2023",DEN vs. GSW,W,37,14,25,0.56,1,8,0.125,6,10,0.6,3,10,13,5,3,1,3,3,35,3,1,Nikola Jokic,DEN,DEN,GSW,34.0,Pts+Asts,53,48,40,18
22023,203999,22300169,"NOV 08, 2023",DEN vs. GSW,W,37,14,25,0.56,1,8,0.125,6,10,0.6,3,10,13,5,3,1,3,3,35,3,1,Nikola Jokic,DEN,DEN,GSW,20.0,Rebs+Asts,53,48,40,18
22023,203999,22300156,"NOV 06, 2023",DEN vs. NOP,W,36,15,24,0.625,2,6,0.333,3,5,0.6,3,11,14,12,1,1,2,1,35,16,1,Nikola Jokic,DEN,DEN,NOP,24.5,Points,61,49,47,26
22023,203999,22300156,"NOV 06, 2023",DEN vs. NOP,W,36,15,24,0.625,2,6,0.333,3,5,0.6,3,11,14,12,1,1,2,1,35,16,1,Nikola Jokic,DEN,DEN,NOP,11.0,Rebounds,61,49,47,26
22023,203999,22300156,"NOV 06, 2023",DEN vs. NOP,W,36,15,24,0.625,2,6,0.333,3,5,0.6,3,11,14,12,1,1,2,1,35,16,1,Nikola Jokic,DEN,DEN,NOP,45.0,Pts+Rebs+Asts,61,49,47,26
22023,203999,22300156,"NOV 06, 2023",DEN vs. NOP,W,36,15,24,0.625,2,6,0.333,3,5,0.6,3,11,14,12,1,1,2,1,35,16,1,Nikola Jokic,DEN,DEN,NOP,9.0,Assists,61,49,47,26
22023,203999,22300156,"NOV 06, 2023",DEN vs. NOP,W,36,15,24,0.625,2,6,0.333,3,5,0.6,3,11,14,12,1,1,2,1,35,16,1,Nikola Jokic,DEN,DEN,NOP,53.5,Fantasy Score,61,49,47,26
22023,203999,22300156,"NOV 06, 2023",DEN vs. NOP,W,36,15,24,0.625,2,6,0.333,3,5,0.6,3,11,14,12,1,1,2,1,35,16,1,Nikola Jokic,DEN,DEN,NOP,35.5,Pts+Rebs,61,49,47,26
22023,203999,22300156,"NOV 06, 2023",DEN vs. NOP,W,36,15,24,0.625,2,6,0.333,3,5,0.6,3,11,14,12,1,1,2,1,35,16,1,Nikola Jokic,DEN,DEN,NOP,34.0,Pts+Asts,61,49,47,26
22023,203999,22300156,"NOV 06, 2023",DEN vs. NOP,W,36,15,24,0.625,2,6,0.333,3,5,0.6,3,11,14,12,1,1,2,1,35,16,1,Nikola Jokic,DEN,DEN,NOP,20.0,Rebs+Asts,61,49,47,26
22023,203999,22300139,"NOV 04, 2023",DEN vs. CHI,W,33,9,16,0.563,1,3,0.333,9,9,1.0,4,12,16,9,3,0,1,3,28,33,1,Nikola Jokic,DEN,DEN,CHI,24.5,Points,53,44,37,25
22023,203999,22300139,"NOV 04, 2023",DEN vs. CHI,W,33,9,16,0.563,1,3,0.333,9,9,1.0,4,12,16,9,3,0,1,3,28,33,1,Nikola Jokic,DEN,DEN,CHI,11.0,Rebounds,53,44,37,25
22023,203999,22300139,"NOV 04, 2023",DEN vs. CHI,W,33,9,16,0.563,1,3,0.333,9,9,1.0,4,12,16,9,3,0,1,3,28,33,1,Nikola Jokic,DEN,DEN,CHI,45.0,Pts+Rebs+Asts,53,44,37,25
22023,203999,22300139,"NOV 04, 2023",DEN vs. CHI,W,33,9,16,0.563,1,3,0.333,9,9,1.0,4,12,16,9,3,0,1,3,28,33,1,Nikola Jokic,DEN,DEN,CHI,9.0,Assists,53,44,37,25
22023,203999,22300139,"NOV 04, 2023",DEN vs. CHI,W,33,9,16,0.563,1,3,0.333,9,9,1.0,4,12,16,9,3,0,1,3,28,33,1,Nikola Jokic,DEN,DEN,CHI,53.5,Fantasy Score,53,44,37,25
22023,203999,22300139,"NOV 04, 2023",DEN vs. CHI,W,33,9,16,0.563,1,3,0.333,9,9,1.0,4,12,16,9,3,0,1,3,28,33,1,Nikola Jokic,DEN,DEN,CHI,35.5,Pts+Rebs,53,44,37,25
22023,203999,22300139,"NOV 04, 2023",DEN vs. CHI,W,33,9,16,0.563,1,3,0.333,9,9,1.0,4,12,16,9,3,0,1,3,28,33,1,Nikola Jokic,DEN,DEN,CHI,34.0,Pts+Asts,53,44,37,25
22023,203999,22300139,"NOV 04, 2023",DEN vs. CHI,W,33,9,16,0.563,1,3,0.333,9,9,1.0,4,12,16,9,3,0,1,3,28,33,1,Nikola Jokic,DEN,DEN,CHI,20.0,Rebs+Asts,53,44,37,25
22023,203999,22300006,"NOV 03, 2023",DEN vs. DAL,W,36,14,16,0.875,2,2,1.0,3,5,0.6,7,7,14,9,1,1,4,3,33,17,1,Nikola Jokic,DEN,DEN,DAL,24.5,Points,56,47,42,23
22023,203999,22300006,"NOV 03, 2023",DEN vs. DAL,W,36,14,16,0.875,2,2,1.0,3,5,0.6,7,7,14,9,1,1,4,3,33,17,1,Nikola Jokic,DEN,DEN,DAL,11.0,Rebounds,56,47,42,23
22023,203999,22300006,"NOV 03, 2023",DEN vs. DAL,W,36,14,16,0.875,2,2,1.0,3,5,0.6,7,7,14,9,1,1,4,3,33,17,1,Nikola Jokic,DEN,DEN,DAL,45.0,Pts+Rebs+Asts,56,47,42,23
22023,203999,22300006,"NOV 03, 2023",DEN vs. DAL,W,36,14,16,0.875,2,2,1.0,3,5,0.6,7,7,14,9,1,1,4,3,33,17,1,Nikola Jokic,DEN,DEN,DAL,9.0,Assists,56,47,42,23
22023,203999,22300006,"NOV 03, 2023",DEN vs. DAL,W,36,14,16,0.875,2,2,1.0,3,5,0.6,7,7,14,9,1,1,4,3,33,17,1,Nikola Jokic,DEN,DEN,DAL,53.5,Fantasy Score,56,47,42,23
22023,203999,22300006,"NOV 03, 2023",DEN vs. DAL,W,36,14,16,0.875,2,2,1.0,3,5,0.6,7,7,14,9,1,1,4,3,33,17,1,Nikola Jokic,DEN,DEN,DAL,35.5,Pts+Rebs,56,47,42,23
22023,203999,22300006,"NOV 03, 2023",DEN vs. DAL,W,36,14,16,0.875,2,2,1.0,3,5,0.6,7,7,14,9,1,1,4,3,33,17,1,Nikola Jokic,DEN,DEN,DAL,34.0,Pts+Asts,56,47,42,23
22023,203999,22300006,"NOV 03, 2023",DEN vs. DAL,W,36,14,16,0.875,2,2,1.0,3,5,0.6,7,7,14,9,1,1,4,3,33,17,1,Nikola Jokic,DEN,DEN,DAL,20.0,Rebs+Asts,56,47,42,23
22023,203999,22300123,"NOV 01, 2023",DEN @ MIN,L,30,11,23,0.478,1,6,0.167,2,2,1.0,2,8,10,3,0,0,5,0,25,-19,1,Nikola Jokic,DEN,MIN,DEN,24.5,Points,38,35,28,13
22023,203999,22300123,"NOV 01, 2023",DEN @ MIN,L,30,11,23,0.478,1,6,0.167,2,2,1.0,2,8,10,3,0,0,5,0,25,-19,1,Nikola Jokic,DEN,MIN,DEN,11.0,Rebounds,38,35,28,13
22023,203999,22300123,"NOV 01, 2023",DEN @ MIN,L,30,11,23,0.478,1,6,0.167,2,2,1.0,2,8,10,3,0,0,5,0,25,-19,1,Nikola Jokic,DEN,MIN,DEN,45.0,Pts+Rebs+Asts,38,35,28,13
22023,203999,22300123,"NOV 01, 2023",DEN @ MIN,L,30,11,23,0.478,1,6,0.167,2,2,1.0,2,8,10,3,0,0,5,0,25,-19,1,Nikola Jokic,DEN,MIN,DEN,9.0,Assists,38,35,28,13
22023,203999,22300123,"NOV 01, 2023",DEN @ MIN,L,30,11,23,0.478,1,6,0.167,2,2,1.0,2,8,10,3,0,0,5,0,25,-19,1,Nikola Jokic,DEN,MIN,DEN,53.5,Fantasy Score,38,35,28,13
22023,203999,22300123,"NOV 01, 2023",DEN @ MIN,L,30,11,23,0.478,1,6,0.167,2,2,1.0,2,8,10,3,0,0,5,0,25,-19,1,Nikola Jokic,DEN,MIN,DEN,35.5,Pts+Rebs,38,35,28,13
22023,203999,22300123,"NOV 01, 2023",DEN @ MIN,L,30,11,23,0.478,1,6,0.167,2,2,1.0,2,8,10,3,0,0,5,0,25,-19,1,Nikola Jokic,DEN,MIN,DEN,34.0,Pts+Asts,38,35,28,13
22023,203999,22300123,"NOV 01, 2023",DEN @ MIN,L,30,11,23,0.478,1,6,0.167,2,2,1.0,2,8,10,3,0,0,5,0,25,-19,1,Nikola Jokic,DEN,MIN,DEN,20.0,Rebs+Asts,38,35,28,13
22023,203999,22300110,"OCT 30, 2023",DEN vs. UTA,W,35,12,16,0.75,1,3,0.333,2,5,0.4,1,9,10,11,0,2,1,3,27,13,1,Nikola Jokic,DEN,DEN,UTA,24.5,Points,48,37,38,21
22023,203999,22300110,"OCT 30, 2023",DEN vs. UTA,W,35,12,16,0.75,1,3,0.333,2,5,0.4,1,9,10,11,0,2,1,3,27,13,1,Nikola Jokic,DEN,DEN,UTA,11.0,Rebounds,48,37,38,21
22023,203999,22300110,"OCT 30, 2023",DEN vs. UTA,W,35,12,16,0.75,1,3,0.333,2,5,0.4,1,9,10,11,0,2,1,3,27,13,1,Nikola Jokic,DEN,DEN,UTA,45.0,Pts+Rebs+Asts,48,37,38,21
22023,203999,22300110,"OCT 30, 2023",DEN vs. UTA,W,35,12,16,0.75,1,3,0.333,2,5,0.4,1,9,10,11,0,2,1,3,27,13,1,Nikola Jokic,DEN,DEN,UTA,9.0,Assists,48,37,38,21
22023,203999,22300110,"OCT 30, 2023",DEN vs. UTA,W,35,12,16,0.75,1,3,0.333,2,5,0.4,1,9,10,11,0,2,1,3,27,13,1,Nikola Jokic,DEN,DEN,UTA,53.5,Fantasy Score,48,37,38,21
22023,203999,22300110,"OCT 30, 2023",DEN vs. UTA,W,35,12,16,0.75,1,3,0.333,2,5,0.4,1,9,10,11,0,2,1,3,27,13,1,Nikola Jokic,DEN,DEN,UTA,35.5,Pts+Rebs,48,37,38,21
22023,203999,22300110,"OCT 30, 2023",DEN vs. UTA,W,35,12,16,0.75,1,3,0.333,2,5,0.4,1,9,10,11,0,2,1,3,27,13,1,Nikola Jokic,DEN,DEN,UTA,34.0,Pts+Asts,48,37,38,21
22023,203999,22300110,"OCT 30, 2023",DEN vs. UTA,W,35,12,16,0.75,1,3,0.333,2,5,0.4,1,9,10,11,0,2,1,3,27,13,1,Nikola Jokic,DEN,DEN,UTA,20.0,Rebs+Asts,48,37,38,21
22023,203999,22300095,"OCT 29, 2023",DEN @ OKC,W,30,12,16,0.75,1,2,0.5,3,3,1.0,2,12,14,5,0,0,4,3,28,21,1,Nikola Jokic,DEN,OKC,DEN,24.5,Points,47,42,33,19
22023,203999,22300095,"OCT 29, 2023",DEN @ OKC,W,30,12,16,0.75,1,2,0.5,3,3,1.0,2,12,14,5,0,0,4,3,28,21,1,Nikola Jokic,DEN,OKC,DEN,11.0,Rebounds,47,42,33,19
22023,203999,22300095,"OCT 29, 2023",DEN @ OKC,W,30,12,16,0.75,1,2,0.5,3,3,1.0,2,12,14,5,0,0,4,3,28,21,1,Nikola Jokic,DEN,OKC,DEN,45.0,Pts+Rebs+Asts,47,42,33,19
22023,203999,22300095,"OCT 29, 2023",DEN @ OKC,W,30,12,16,0.75,1,2,0.5,3,3,1.0,2,12,14,5,0,0,4,3,28,21,1,Nikola Jokic,DEN,OKC,DEN,9.0,Assists,47,42,33,19
22023,203999,22300095,"OCT 29, 2023",DEN @ OKC,W,30,12,16,0.75,1,2,0.5,3,3,1.0,2,12,14,5,0,0,4,3,28,21,1,Nikola Jokic,DEN,OKC,DEN,53.5,Fantasy Score,47,42,33,19
22023,203999,22300095,"OCT 29, 2023",DEN @ OKC,W,30,12,16,0.75,1,2,0.5,3,3,1.0,2,12,14,5,0,0,4,3,28,21,1,Nikola Jokic,DEN,OKC,DEN,35.5,Pts+Rebs,47,42,33,19
22023,203999,22300095,"OCT 29, 2023",DEN @ OKC,W,30,12,16,0.75,1,2,0.5,3,3,1.0,2,12,14,5,0,0,4,3,28,21,1,Nikola Jokic,DEN,OKC,DEN,34.0,Pts+Asts,47,42,33,19
22023,203999,22300095,"OCT 29, 2023",DEN @ OKC,W,30,12,16,0.75,1,2,0.5,3,3,1.0,2,12,14,5,0,0,4,3,28,21,1,Nikola Jokic,DEN,OKC,DEN,20.0,Rebs+Asts,47,42,33,19
22023,203999,22300078,"OCT 27, 2023",DEN @ MEM,W,35,8,14,0.571,1,4,0.25,5,6,0.833,3,9,12,7,1,1,9,1,22,6,1,Nikola Jokic,DEN,MEM,DEN,24.5,Points,41,34,29,19
22023,203999,22300078,"OCT 27, 2023",DEN @ MEM,W,35,8,14,0.571,1,4,0.25,5,6,0.833,3,9,12,7,1,1,9,1,22,6,1,Nikola Jokic,DEN,MEM,DEN,11.0,Rebounds,41,34,29,19
22023,203999,22300078,"OCT 27, 2023",DEN @ MEM,W,35,8,14,0.571,1,4,0.25,5,6,0.833,3,9,12,7,1,1,9,1,22,6,1,Nikola Jokic,DEN,MEM,DEN,45.0,Pts+Rebs+Asts,41,34,29,19
22023,203999,22300078,"OCT 27, 2023",DEN @ MEM,W,35,8,14,0.571,1,4,0.25,5,6,0.833,3,9,12,7,1,1,9,1,22,6,1,Nikola Jokic,DEN,MEM,DEN,9.0,Assists,41,34,29,19
22023,203999,22300078,"OCT 27, 2023",DEN @ MEM,W,35,8,14,0.571,1,4,0.25,5,6,0.833,3,9,12,7,1,1,9,1,22,6,1,Nikola Jokic,DEN,MEM,DEN,53.5,Fantasy Score,41,34,29,19
22023,203999,22300078,"OCT 27, 2023",DEN @ MEM,W,35,8,14,0.571,1,4,0.25,5,6,0.833,3,9,12,7,1,1,9,1,22,6,1,Nikola Jokic,DEN,MEM,DEN,35.5,Pts+Rebs,41,34,29,19
22023,203999,22300078,"OCT 27, 2023",DEN @ MEM,W,35,8,14,0.571,1,4,0.25,5,6,0.833,3,9,12,7,1,1,9,1,22,6,1,Nikola Jokic,DEN,MEM,DEN,34.0,Pts+Asts,41,34,29,19
22023,203999,22300078,"OCT 27, 2023",DEN @ MEM,W,35,8,14,0.571,1,4,0.25,5,6,0.833,3,9,12,7,1,1,9,1,22,6,1,Nikola Jokic,DEN,MEM,DEN,20.0,Rebs+Asts,41,34,29,19
22023,203999,22300061,"OCT 24, 2023",DEN vs. LAL,W,36,12,22,0.545,3,5,0.6,2,4,0.5,3,10,13,11,1,1,2,2,29,15,1,Nikola Jokic,DEN,DEN,LAL,24.5,Points,53,42,40,24
22023,203999,22300061,"OCT 24, 2023",DEN vs. LAL,W,36,12,22,0.545,3,5,0.6,2,4,0.5,3,10,13,11,1,1,2,2,29,15,1,Nikola Jokic,DEN,DEN,LAL,11.0,Rebounds,53,42,40,24
22023,203999,22300061,"OCT 24, 2023",DEN vs. LAL,W,36,12,22,0.545,3,5,0.6,2,4,0.5,3,10,13,11,1,1,2,2,29,15,1,Nikola Jokic,DEN,DEN,LAL,45.0,Pts+Rebs+Asts,53,42,40,24
22023,203999,22300061,"OCT 24, 2023",DEN vs. LAL,W,36,12,22,0.545,3,5,0.6,2,4,0.5,3,10,13,11,1,1,2,2,29,15,1,Nikola Jokic,DEN,DEN,LAL,9.0,Assists,53,42,40,24
22023,203999,22300061,"OCT 24, 2023",DEN vs. LAL,W,36,12,22,0.545,3,5,0.6,2,4,0.5,3,10,13,11,1,1,2,2,29,15,1,Nikola Jokic,DEN,DEN,LAL,53.5,Fantasy Score,53,42,40,24
22023,203999,22300061,"OCT 24, 2023",DEN vs. LAL,W,36,12,22,0.545,3,5,0.6,2,4,0.5,3,10,13,11,1,1,2,2,29,15,1,Nikola Jokic,DEN,DEN,LAL,35.5,Pts+Rebs,53,42,40,24
22023,203999,22300061,"OCT 24, 2023",DEN vs. LAL,W,36,12,22,0.545,3,5,0.6,2,4,0.5,3,10,13,11,1,1,2,2,29,15,1,Nikola Jokic,DEN,DEN,LAL,34.0,Pts+Asts,53,42,40,24
22023,203999,22300061,"OCT 24, 2023",DEN vs. LAL,W,36,12,22,0.545,3,5,0.6,2,4,0.5,3,10,13,11,1,1,2,2,29,15,1,Nikola Jokic,DEN,DEN,LAL,20.0,Rebs+Asts,53,42,40,24
22023,1641732,22300532,"JAN 12, 2024",SAC @ PHI,L,9,0,4,0.0,0,1,0.0,0,0,0.0,1,2,3,3,1,0,1,3,0,6,1,Colby Jones,SAC,PHI,SAC,,,6,3,3,6
22023,1641732,22300518,"JAN 10, 2024",SAC @ CHA,W,14,0,2,0.0,0,2,0.0,0,0,0.0,1,0,1,0,0,0,0,0,0,1,1,Colby Jones,SAC,CHA,SAC,,,1,1,0,1
22023,1641732,22300500,"JAN 07, 2024",SAC vs. NOP,L,10,2,5,0.4,0,2,0.0,0,0,0.0,0,1,1,4,1,0,0,1,4,12,1,Colby Jones,SAC,SAC,NOP,,,9,5,8,5
22023,1641732,22300400,"DEC 23, 2023",SAC vs. MIN,L,2,0,0,0.0,0,0,0.0,0,0,0.0,0,1,1,0,0,0,0,0,0,3,1,Colby Jones,SAC,SAC,MIN,,,1,1,0,1
22023,1641732,22300358,"DEC 18, 2023",SAC vs. WAS,W,4,1,3,0.333,0,0,0.0,0,0,0.0,1,0,1,0,0,0,0,1,2,-6,1,Colby Jones,SAC,SAC,WAS,,,3,3,2,1
22023,1641732,22300303,"DEC 11, 2023",SAC vs. BKN,W,1,0,0,0.0,0,0,0.0,0,0,0.0,0,0,0,0,0,0,0,1,0,-6,1,Colby Jones,SAC,SAC,BKN,,,0,0,0,0
22023,1641732,22300264,"NOV 29, 2023",SAC vs. LAC,L,1,1,2,0.5,0,1,0.0,0,0,0.0,1,0,1,0,0,0,1,0,2,0,1,Colby Jones,SAC,SAC,LAC,,,3,3,2,1
22023,1641732,22300222,"NOV 20, 2023",SAC @ NOP,L,14,4,8,0.5,0,2,0.0,0,1,0.0,0,1,1,0,1,0,0,2,8,-1,1,Colby Jones,SAC,NOP,SAC,,,9,9,8,1
22023,1641732,22300212,"NOV 19, 2023",SAC @ DAL,W,4,0,1,0.0,0,1,0.0,0,0,0.0,0,0,0,0,0,0,0,2,0,-3,1,Colby Jones,SAC,DAL,SAC,,,0,0,0,0
22023,1641732,22300191,"NOV 13, 2023",SAC vs. CLE,W,1,0,0,0.0,0,0,0.0,0,0,0.0,0,0,0,0,0,0,0,0,0,-5,1,Colby Jones,SAC,SAC,CLE,,,0,0,0,0
22023,1641732,22300153,"NOV 06, 2023",SAC @ HOU,L,13,4,6,0.667,0,0,0.0,2,2,1.0,3,2,5,1,0,0,0,1,10,4,1,Colby Jones,SAC,HOU,SAC,,,16,15,11,6
22023,1641732,22300137,"NOV 04, 2023",SAC @ HOU,L,18,2,7,0.286,1,4,0.25,0,0,0.0,1,2,3,0,0,0,3,1,5,0,1,Colby Jones,SAC,HOU,SAC,,,8,8,5,3
22023,1641732,22300126,"NOV 01, 2023",SAC @ GSW,L,17,2,4,0.5,0,0,0.0,0,0,0.0,1,2,3,1,1,1,0,3,4,-5,1,Colby Jones,SAC,GSW,SAC,,,8,7,5,4
22023,1641732,22300087,"OCT 27, 2023",SAC vs. GSW,L,0,0,0,0.0,0,0,0.0,0,0,0.0,0,0,0,0,0,0,0,0,0,2,1,Colby Jones,SAC,SAC,GSW,,,0,0,0,0
22023,1641732,22300072,"OCT 25, 2023",SAC @ UTA,W,1,0,0,0.0,0,0,0.0,0,0,0.0,0,1,1,0,0,0,0,0,0,-2,1,Colby Jones,SAC,UTA,SAC,,,1,1,0,1
22023,1627745,22300482,"JAN 05, 2024",CLE vs. WAS,W,5,1,1,1.0,0,0,0.0,0,0,0.0,0,1,1,0,0,0,0,0,2,1,1,Damian Jones,CLE,CLE,WAS,,,3,3,2,1
22023,1627745,22300465,"JAN 03, 2024",CLE vs. WAS,W,6,2,3,0.667,0,1,0.0,0,0,0.0,0,1,1,0,0,1,0,0,4,-1,1,Damian Jones,CLE,CLE,WAS,,,5,5,4,1
22023,1627745,22300396,"DEC 23, 2023",CLE @ CHI,W,12,2,4,0.5,1,2,0.5,1,1,1.0,0,2,2,1,1,0,1,5,6,16,1,Damian Jones,CLE,CHI,CLE,,,9,8,7,3
22023,1627745,22300375,"DEC 21, 2023",CLE vs. NOP,L,4,1,1,1.0,0,0,0.0,0,0,0.0,0,1,1,0,0,0,0,0,2,2,1,Damian Jones,CLE,CLE,NOP,,,3,3,2,1
22023,1627745,22301220,"DEC 08, 2023",CLE @ MIA,W,3,0,0,0.0,0,0,0.0,0,0,0.0,0,1,1,0,0,0,1,1,0,-12,1,Damian Jones,CLE,MIA,CLE,,,1,1,0,1
22023,1627745,22300229,"NOV 22, 2023",CLE vs. MIA,L,12,1,5,0.2,0,0,0.0,0,0,0.0,2,1,3,1,1,1,1,0,2,-11,1,Damian Jones,CLE,CLE,MIA,,,6,5,3,4
22023,1627745,22300210,"NOV 19, 2023",CLE vs. DEN,W,3,0,0,0.0,0,0,0.0,0,0,0.0,0,0,0,0,0,0,0,0,0,-10,1,Damian Jones,CLE,CLE,DEN,,,0,0,0,0
22023,1627745,22300030,"NOV 17, 2023",CLE vs. DET,W,1,0,0,0.0,0,0,0.0,0,0,0.0,0,0,0,0,0,0,0,0,0,-2,1,Damian Jones,CLE,CLE,DET,,,0,0,0,0
22023,1627745,22300199,"NOV 15, 2023",CLE @ POR,W,2,0,0,0.0,0,0,0.0,0,0,0.0,0,0,0,0,0,0,0,0,0,0,1,Damian Jones,CLE,POR,CLE,,,0,0,0,0
22023,1627745,22300176,"NOV 11, 2023",CLE @ GSW,W,1,0,0,0.0,0,0,0.0,0,0,0.0,0,0,0,0,0,0,0,0,0,-6,1,Damian Jones,CLE,GSW,CLE,,,0,0,0,0
22023,1627745,22300142,"NOV 05, 2023",CLE vs. GSW,W,1,0,0,0.0,0,0,0.0,0,0,0.0,0,0,0,0,0,0,0,0,0,-2,1,Damian Jones,CLE,CLE,GSW,,,0,0,0,0
22023,1627745,22300112,"OCT 31, 2023",CLE vs. NYK,L,5,1,1,1.0,0,0,0.0,0,0,0.0,0,1,1,0,0,0,0,0,2,2,1,Damian Jones,CLE,CLE,NYK,,,3,3,2,1
22023,1627745,22300091,"OCT 28, 2023",CLE vs. IND,L,6,0,0,0.0,0,0,0.0,0,0,0.0,2,1,3,0,0,0,0,0,0,-1,1,Damian Jones,CLE,CLE,IND,,,3,3,0,3
22023,1627745,22300081,"OCT 27, 2023",CLE vs. OKC,L,10,0,0,0.0,0,0,0.0,1,2,0.5,0,3,3,0,0,1,0,0,1,5,1,Damian Jones,CLE,CLE,OKC,,,4,4,1,3
22023,1627745,22300067,"OCT 25, 2023",CLE @ BKN,W,11,2,2,1.0,0,0,0.0,0,0,0.0,0,0,0,2,0,0,2,3,4,-7,1,Damian Jones,CLE,BKN,CLE,,,6,4,6,2
22023,1630529,22300556,"JAN 15, 2024",NOP @ DAL,L,29,4,5,0.8,1,1,1.0,1,1,1.0,1,2,3,3,0,0,0,2,10,-14,1,Herbert Jones,NOP,DAL,NOP,,,16,13,13,6
22023,1630529,22300547,"JAN 13, 2024",NOP @ DAL,W,32,5,13,0.385,1,3,0.333,4,6,0.667,2,3,5,3,0,2,1,5,15,4,1,Herbert Jones,NOP,DAL,NOP,,,23,20,18,8
22023,1630529,22300539,"JAN 12, 2024",NOP @ DEN,L,19,3,4,0.75,2,2,1.0,0,0,0.0,0,1,1,1,0,1,1,1,8,-2,1,Herbert Jones,NOP,DEN,NOP,,,10,9,9,2
22023,1630529,22300525,"JAN 10, 2024",NOP @ GSW,W,23,4,7,0.571,4,7,0.571,0,0,0.0,1,4,5,4,1,2,1,1,12,10,1,Herbert Jones,NOP,GSW,NOP,,,21,17,16,9
22023,1630529,22300500,"JAN 07, 2024",NOP @ SAC,W,26,3,7,0.429,1,3,0.333,2,2,1.0,1,2,3,2,0,1,1,1,9,34,1,Herbert Jones,NOP,SAC,NOP,,,14,12,11,5
22023,1630529,22300486,"JAN 05, 2024",NOP vs. LAC,L,25,3,6,0.5,1,2,0.5,2,2,1.0,0,0,0,2,1,1,0,1,9,-10,1,Herbert Jones,NOP,NOP,LAC,,,11,9,11,2
22023,1630529,22300471,"JAN 03, 2024",NOP @ MIN,W,37,6,11,0.545,4,5,0.8,0,0,0.0,0,3,3,2,1,1,3,3,16,10,1,Herbert Jones,NOP,MIN,NOP,,,21,19,18,5
22023,1630529,22300461,"JAN 02, 2024",NOP vs. BKN,W,24,5,10,0.5,2,4,0.5,2,2,1.0,2,2,4,1,2,1,3,1,14,19,1,Herbert Jones,NOP,NOP,BKN,,,19,18,15,5
22023,1630529,22300446,"DEC 31, 2023",NOP vs. LAL,W,29,5,9,0.556,3,5,0.6,0,0,0.0,3,1,4,1,0,0,0,3,13,8,1,Herbert Jones,NOP,NOP,LAL,,,18,17,14,5
22023,1630529,22300424,"DEC 28, 2023",NOP vs. UTA,W,29,3,4,0.75,0,1,0.0,0,0,0.0,0,3,3,1,0,1,1,4,6,6,1,Herbert Jones,NOP,NOP,UTA,,,10,9,7,4
22023,1630529,22300410,"DEC 26, 2023",NOP vs. MEM,L,32,2,8,0.25,0,4,0.0,0,0,0.0,0,3,3,3,1,0,0,1,4,0,1,Herbert Jones,NOP,NOP,MEM,,,10,7,7,6
22023,1630529,22300392,"DEC 23, 2023",NOP vs. HOU,L,18,2,8,0.25,2,4,0.5,0,0,0.0,3,0,3,1,0,0,0,1,6,-13,1,Herbert Jones,NOP,NOP,HOU,,,10,9,7,4
22023,1630529,22300375,"DEC 21, 2023",NOP @ CLE,W,30,3,7,0.429,0,1,0.0,1,1,1.0,1,0,1,4,0,1,0,1,7,5,1,Herbert Jones,NOP,CLE,NOP,,,12,8,11,5
22023,1630529,22300360,"DEC 19, 2023",NOP vs. MEM,L,30,3,10,0.3,1,5,0.2,0,0,0.0,0,1,1,2,0,0,1,3,7,0,1,Herbert Jones,NOP,NOP,MEM,,,10,8,9,3
22023,1630529,22300345,"DEC 17, 2023",NOP @ SAS,W,19,0,5,0.0,0,3,0.0,2,2,1.0,1,0,1,3,1,0,2,3,2,2,1,Herbert Jones,NOP,SAS,NOP,,,6,3,5,4
22023,1630529,22300326,"DEC 15, 2023",NOP @ CHA,W,28,3,4,0.75,1,2,0.5,4,6,0.667,1,1,2,1,1,1,0,1,11,2,1,Herbert Jones,NOP,CHA,NOP,,,14,13,12,3
22023,1630529,22300311,"DEC 13, 2023",NOP @ WAS,W,20,3,9,0.333,0,1,0.0,0,0,0.0,1,1,2,1,2,0,1,3,6,-17,1,Herbert Jones,NOP,WAS,NOP,,,9,8,7,3
22023,1630529,22300301,"DEC 11, 2023",NOP vs. MIN,W,32,2,7,0.286,1,3,0.333,2,3,0.667,3,7,10,5,0,0,0,4,7,20,1,Herbert Jones,NOP,NOP,MIN,,,22,17,12,15
22023,1630529,22301230,"DEC 07, 2023",NOP @ LAL,L,26,4,10,0.4,0,3,0.0,2,2,1.0,4,3,7,1,2,1,1,4,10,-22,1,Herbert Jones,NOP,LAL,NOP,,,18,17,11,8
22023,1630529,22301204,"DEC 04, 2023",NOP @ SAC,W,35,8,13,0.615,3,5,0.6,4,4,1.0,3,2,5,5,0,2,1,5,23,-3,1,Herbert Jones,NOP,SAC,NOP,,,33,28,28,10
22023,1630529,22300285,"DEC 02, 2023",NOP @ CHI,L,36,4,11,0.364,0,4,0.0,9,10,0.9,4,3,7,4,3,1,2,1,17,5,1,Herbert Jones,NOP,CHI,NOP,,,28,24,21,11
22023,1630529,22300278,"DEC 01, 2023",NOP vs. SAS,W,31,6,8,0.75,3,4,0.75,2,2,1.0,2,2,4,0,3,1,1,1,17,14,1,Herbert Jones,NOP,NOP,SAS,,,21,21,17,4
22023,1630529,22300262,"NOV 29, 2023",NOP vs. PHI,W,33,3,8,0.375,0,3,0.0,1,1,1.0,1,2,3,6,0,0,5,2,7,14,1,Herbert Jones,NOP,NOP,PHI,,,16,10,13,9
22023,1630529,22300256,"NOV 27, 2023",NOP @ UTA,L,32,4,7,0.571,2,5,0.4,0,0,0.0,0,4,4,0,1,0,3,4,10,-10,1,Herbert Jones,NOP,UTA,NOP,,,14,14,10,4
22023,1630529,22300243,"NOV 25, 2023",NOP @ UTA,L,26,6,11,0.545,1,4,0.25,0,0,0.0,1,0,1,1,1,1,1,3,13,-18,1,Herbert Jones,NOP,UTA,NOP,,,15,14,14,2
22023,1630529,22300052,"NOV 24, 2023",NOP @ LAC,W,24,5,7,0.714,3,4,0.75,1,2,0.5,2,2,4,4,1,1,3,5,14,22,1,Herbert Jones,NOP,LAC,NOP,,,22,18,18,8
22023,1630529,22300233,"NOV 22, 2023",NOP vs. SAC,W,39,1,6,0.167,0,4,0.0,5,6,0.833,0,5,5,3,3,1,2,4,7,-8,1,Herbert Jones,NOP,NOP,SAC,,,15,12,10,8
22023,1630529,22300222,"NOV 20, 2023",NOP vs. SAC,W,27,7,9,0.778,1,2,0.5,3,4,0.75,1,6,7,4,1,2,1,4,18,39,1,Herbert Jones,NOP,NOP,SAC,,,29,25,22,11
22023,1630529,22300203,"NOV 18, 2023",NOP vs. MIN,L,28,3,7,0.429,3,4,0.75,4,4,1.0,1,3,4,8,2,2,0,6,13,11,1,Herbert Jones,NOP,NOP,MIN,,,25,17,21,12
22023,1630529,22300034,"NOV 17, 2023",NOP vs. DEN,W,37,3,8,0.375,0,1,0.0,2,2,1.0,0,5,5,4,3,1,1,2,8,-2,1,Herbert Jones,NOP,NOP,DEN,,,17,13,12,9
22023,1630529,22300022,"NOV 14, 2023",NOP vs. DAL,W,31,6,8,0.75,2,4,0.5,5,6,0.833,1,3,4,4,5,2,2,5,19,8,1,Herbert Jones,NOP,NOP,DAL,,,27,23,23,8
22023,1630529,22300156,"NOV 06, 2023",NOP @ DEN,L,31,1,3,0.333,0,2,0.0,2,2,1.0,0,2,2,2,2,0,1,2,4,-23,1,Herbert Jones,NOP,DEN,NOP,,,8,6,6,4
22023,1630529,22300135,"NOV 04, 2023",NOP vs. ATL,L,33,6,13,0.462,1,5,0.2,0,0,0.0,1,1,2,1,3,1,3,1,13,-26,1,Herbert Jones,NOP,NOP,ATL,,,16,15,14,3
22023,1630529,22300129,"NOV 02, 2023",NOP vs. DET,W,34,6,7,0.857,0,1,0.0,9,9,1.0,0,5,5,3,3,4,0,4,21,10,1,Herbert Jones,NOP,NOP,DET,,,29,26,24,8
22023,1630529,22300121,"NOV 01, 2023",NOP @ OKC,W,31,2,9,0.222,1,6,0.167,0,0,0.0,0,6,6,1,0,1,1,5,5,10,1,Herbert Jones,NOP,OKC,NOP,,,12,11,6,7
22023,1630529,22300108,"OCT 30, 2023",NOP vs. GSW,L,22,1,5,0.2,0,4,0.0,2,2,1.0,0,2,2,1,2,1,0,4,4,-22,1,Herbert Jones,NOP,NOP,GSW,,,7,6,5,3
22023,1630529,22300090,"OCT 28, 2023",NOP vs. NYK,W,28,4,6,0.667,2,2,1.0,0,0,0.0,0,2,2,1,0,3,1,5,10,6,1,Herbert Jones,NOP,NOP,NYK,,,13,12,11,3
22023,1630529,22300071,"OCT 25, 2023",NOP @ MEM,W,38,4,8,0.5,2,3,0.667,3,5,0.6,3,5,8,3,1,1,3,3,13,2,1,Herbert Jones,NOP,MEM,NOP,,,24,21,16,11
22023,1630200,22300559,"JAN 15, 2024",SAS @ ATL,L,30,3,8,0.375,0,1,0.0,0,0,0.0,0,1,1,12,3,0,3,0,6,5,1,Tre Jones,SAS,ATL,SAS,,,19,7,18,13
22023,1630200,22300548,"JAN 13, 2024",SAS vs. CHI,L,32,10,13,0.769,4,6,0.667,6,6,1.0,1,8,9,4,0,0,1,2,30,-14,1,Tre Jones,SAS,SAS,CHI,,,43,39,34,13
22023,1630200,22300541,"JAN 12, 2024",SAS vs. CHA,W,22,2,4,0.5,0,1,0.0,2,2,1.0,0,3,3,7,1,0,0,3,6,19,1,Tre Jones,SAS,SAS,CHA,,,16,9,13,10
22023,1630200,22300519,"JAN 10, 2024",SAS @ DET,W,27,5,9,0.556,0,1,0.0,1,1,1.0,0,2,2,5,0,1,2,2,11,17,1,Tre Jones,SAS,DET,SAS,,,18,13,16,7
22023,1630200,22300497,"JAN 07, 2024",SAS @ CLE,L,34,7,8,0.875,2,2,1.0,2,2,1.0,0,2,2,4,2,0,2,1,18,11,1,Tre Jones,SAS,CLE,SAS,,,24,20,22,6
22023,1630200,22300477,"JAN 04, 2024",SAS vs. MIL,L,35,7,13,0.538,0,2,0.0,4,4,1.0,2,3,5,6,1,0,3,2,18,-9,1,Tre Jones,SAS,SAS,MIL,,,29,23,24,11
22023,1630200,22300460,"JAN 02, 2024",SAS @ MEM,L,25,1,6,0.167,0,3,0.0,0,0,0.0,0,4,4,4,1,0,0,2,2,8,1,Tre Jones,SAS,MEM,SAS,,,10,6,6,8
22023,1630200,22300448,"DEC 31, 2023",SAS vs. BOS,L,22,4,10,0.4,0,5,0.0,0,0,0.0,1,3,4,2,0,0,1,3,8,-11,1,Tre Jones,SAS,SAS,BOS,,,14,12,10,6
22023,1630200,22300437,"DEC 29, 2023",SAS @ POR,L,27,7,9,0.778,0,0,0.0,0,0,0.0,3,5,8,5,0,0,3,2,14,14,1,Tre Jones,SAS,POR,SAS,,,27,22,19,13
22023,1630200,22300427,"DEC 28, 2023",SAS @ POR,W,26,2,6,0.333,0,2,0.0,4,4,1.0,3,2,5,6,1,0,1,0,8,1,1,Tre Jones,SAS,POR,SAS,,,19,13,14,11
22023,1630200,22300412,"DEC 26, 2023",SAS vs. UTA,L,27,3,7,0.429,0,1,0.0,0,1,0.0,3,1,4,7,2,0,0,1,6,-7,1,Tre Jones,SAS,SAS,UTA,,,17,10,13,11
22023,1630200,22300398,"DEC 23, 2023",SAS @ DAL,L,18,4,8,0.5,1,4,0.25,0,0,0.0,0,1,1,4,0,0,1,1,9,-23,1,Tre Jones,SAS,DAL,SAS,,,14,10,13,5
22023,1630200,22300376,"DEC 21, 2023",SAS @ CHI,L,21,4,6,0.667,1,1,1.0,0,0,0.0,0,1,1,3,1,0,5,0,9,-11,1,Tre Jones,SAS,CHI,SAS,,,13,10,12,4
22023,1630200,22300361,"DEC 19, 2023",SAS @ MIL,L,24,7,11,0.636,0,1,0.0,0,0,0.0,0,1,1,5,1,0,2,1,14,-12,1,Tre Jones,SAS,MIL,SAS,,,20,15,19,6
22023,1630200,22300345,"DEC 17, 2023",SAS vs. NOP,L,16,2,5,0.4,0,2,0.0,0,0,0.0,0,0,0,5,0,0,0,1,4,-14,1,Tre Jones,SAS,SAS,NOP,,,9,4,9,5
22023,1630200,22300316,"DEC 13, 2023",SAS vs. LAL,L,22,3,5,0.6,0,2,0.0,0,0,0.0,0,1,1,5,0,0,2,0,6,-11,1,Tre Jones,SAS,SAS,LAL,,,12,7,11,6
22023,1630200,22300298,"DEC 11, 2023",SAS @ HOU,L,16,0,1,0.0,0,1,0.0,3,5,0.6,0,0,0,2,2,0,0,1,3,-4,1,Tre Jones,SAS,HOU,SAS,,,5,3,5,2
22023,1630200,22301223,"DEC 08, 2023",SAS vs. CHI,L,28,6,7,0.857,2,2,1.0,4,4,1.0,0,5,5,8,1,0,1,2,18,12,1,Tre Jones,SAS,SAS,CHI,,,31,23,26,13
22023,1630200,22301210,"DEC 06, 2023",SAS @ MIN,L,26,2,8,0.25,0,3,0.0,0,0,0.0,0,2,2,5,1,0,0,2,4,-11,1,Tre Jones,SAS,MIN,SAS,,,11,6,9,7
22023,1630200,22300278,"DEC 01, 2023",SAS @ NOP,L,23,4,9,0.444,2,4,0.5,0,0,0.0,1,2,3,3,0,0,2,1,10,-10,1,Tre Jones,SAS,NOP,SAS,,,16,13,13,6
22023,1630200,22300272,"NOV 30, 2023",SAS vs. ATL,L,24,1,5,0.2,1,3,0.333,0,1,0.0,0,2,2,7,0,0,2,1,3,-2,1,Tre Jones,SAS,SAS,ATL,,,12,5,10,9
22023,1630200,22300252,"NOV 26, 2023",SAS @ DEN,L,22,4,8,0.5,0,1,0.0,2,2,1.0,0,4,4,6,0,0,1,2,10,14,1,Tre Jones,SAS,DEN,SAS,,,20,14,16,10
22023,1630200,22300051,"NOV 24, 2023",SAS @ GSW,L,17,3,5,0.6,1,1,1.0,0,0,0.0,0,5,5,2,2,0,1,1,7,-10,1,Tre Jones,SAS,GSW,SAS,,,14,12,9,7
22023,1630200,22300235,"NOV 22, 2023",SAS vs. LAC,L,20,2,7,0.286,0,2,0.0,0,0,0.0,0,2,2,1,3,0,1,1,4,-6,1,Tre Jones,SAS,SAS,LAC,,,7,6,5,3
22023,1630200,22300223,"NOV 20, 2023",SAS vs. LAC,L,23,4,10,0.4,1,3,0.333,2,2,1.0,2,0,2,5,0,0,3,1,11,-12,1,Tre Jones,SAS,SAS,LAC,,,18,13,16,7
22023,1630200,22300206,"NOV 18, 2023",SAS vs. MEM,L,21,1,4,0.25,0,1,0.0,0,1,0.0,0,0,0,3,0,0,1,1,2,-18,1,Tre Jones,SAS,SAS,MEM,,,5,2,5,3
22023,1630200,22300013,"NOV 10, 2023",SAS vs. MIN,L,26,4,8,0.5,0,1,0.0,0,0,0.0,0,4,4,4,1,1,2,1,8,7,1,Tre Jones,SAS,SAS,MIN,,,16,12,12,8
22023,1630200,22300161,"NOV 08, 2023",SAS @ NYK,L,25,6,11,0.545,0,2,0.0,0,1,0.0,0,1,1,5,1,1,0,0,12,-2,1,Tre Jones,SAS,NYK,SAS,,,18,13,17,6
22023,1630200,22300146,"NOV 06, 2023",SAS @ IND,L,19,1,5,0.2,0,2,0.0,2,2,1.0,1,0,1,8,0,0,1,1,4,-21,1,Tre Jones,SAS,IND,SAS,,,13,5,12,9
22023,1630200,22300141,"NOV 05, 2023",SAS vs. TOR,L,32,3,10,0.3,0,2,0.0,0,0,0.0,1,2,3,6,0,1,4,4,6,-7,1,Tre Jones,SAS,SAS,TOR,,,15,9,12,9
22023,1630200,22300131,"NOV 02, 2023",SAS @ PHX,W,28,3,8,0.375,2,4,0.5,4,4,1.0,1,4,5,10,1,0,1,3,12,19,1,Tre Jones,SAS,PHX,SAS,,,27,17,22,15
22023,1630200,22300113,"OCT 31, 2023",SAS @ PHX,W,24,3,4,0.75,0,1,0.0,4,4,1.0,0,2,2,3,1,1,0,0,10,13,1,Tre Jones,SAS,PHX,SAS,,,15,12,13,5
22023,1630200,22300099,"OCT 29, 2023",SAS @ LAC,L,20,1,4,0.25,1,2,0.5,2,2,1.0,0,2,2,4,1,0,4,3,5,0,1,Tre Jones,SAS,LAC,SAS,,,11,7,9,6
22023,1630200,22300083,"OCT 27, 2023",SAS vs. HOU,W,33,3,8,0.375,0,3,0.0,0,0,0.0,3,3,6,8,2,0,0,0,6,14,1,Tre Jones,SAS,SAS,HOU,,,20,12,14,14
22023,1630200,22300073,"OCT 25, 2023",SAS vs. DAL,L,25,5,7,0.714,2,3,0.667,4,4,1.0,1,4,5,6,0,0,1,0,16,1,1,Tre Jones,SAS,SAS,DAL,,,27,21,22,11
22023,1626145,22300558,"JAN 15, 2024",WAS vs. DET,L,31,9,19,0.474,4,10,0.4,0,0,0.0,2,4,6,7,1,0,0,0,22,-15,1,Tyus Jones,WAS,WAS,DET,,,35,28,29,13
22023,1626145,22300543,"JAN 13, 2024",WAS @ ATL,W,26,4,9,0.444,0,3,0.0,0,0,0.0,1,2,3,7,1,1,0,0,8,18,1,Tyus Jones,WAS,ATL,WAS,,,18,11,15,10
22023,1626145,22300520,"JAN 10, 2024",WAS @ IND,L,34,5,12,0.417,1,5,0.2,0,0,0.0,1,3,4,4,0,1,2,2,11,-5,1,Tyus Jones,WAS,IND,WAS,,,19,15,15,8
22023,1626145,22300508,"JAN 08, 2024",WAS vs. OKC,L,31,7,10,0.7,3,5,0.6,1,2,0.5,0,0,0,9,3,0,2,1,18,0,1,Tyus Jones,WAS,WAS,OKC,,,27,18,27,9
22023,1626145,22300494,"JAN 06, 2024",WAS vs. NYK,L,28,4,13,0.308,2,6,0.333,1,2,0.5,0,1,1,8,0,0,2,0,11,-1,1,Tyus Jones,WAS,WAS,NYK,,,20,12,19,9
22023,1626145,22300482,"JAN 05, 2024",WAS @ CLE,L,26,6,10,0.6,4,6,0.667,0,0,0.0,0,1,1,5,2,0,1,0,16,-17,1,Tyus Jones,WAS,CLE,WAS,,,22,17,21,6
22023,1626145,22300465,"JAN 03, 2024",WAS @ CLE,L,21,4,11,0.364,1,2,0.5,0,0,0.0,0,2,2,2,1,1,0,0,9,-12,1,Tyus Jones,WAS,CLE,WAS,,,13,11,11,4
22023,1626145,22300445,"DEC 31, 2023",WAS vs. ATL,L,27,5,11,0.455,3,7,0.429,1,1,1.0,0,0,0,8,1,1,1,1,14,5,1,Tyus Jones,WAS,WAS,ATL,,,22,14,22,8
22023,1626145,22300430,"DEC 29, 2023",WAS vs. BKN,W,31,6,9,0.667,0,0,0.0,0,0,0.0,1,3,4,6,0,0,0,0,12,-12,1,Tyus Jones,WAS,WAS,BKN,,,22,16,18,10
22023,1626145,22300416,"DEC 27, 2023",WAS vs. TOR,L,31,5,12,0.417,1,6,0.167,0,0,0.0,1,1,2,5,2,0,1,2,11,-20,1,Tyus Jones,WAS,WAS,TOR,,,18,13,16,7
22023,1626145,22300407,"DEC 26, 2023",WAS vs. ORL,L,34,8,13,0.615,4,6,0.667,2,2,1.0,0,6,6,6,1,1,2,0,22,0,1,Tyus Jones,WAS,WAS,ORL,,,34,28,28,12
22023,1626145,22300386,"DEC 22, 2023",WAS @ GSW,L,25,6,8,0.75,2,2,1.0,0,0,0.0,1,2,3,6,1,0,0,0,14,-12,1,Tyus Jones,WAS,GSW,WAS,,,23,17,20,9
22023,1626145,22300381,"DEC 21, 2023",WAS @ POR,W,36,9,15,0.6,5,7,0.714,1,2,0.5,0,3,3,3,1,0,2,1,24,6,1,Tyus Jones,WAS,POR,WAS,,,30,27,27,6
22023,1626145,22300358,"DEC 18, 2023",WAS @ SAC,L,28,7,10,0.7,2,2,1.0,0,0,0.0,0,1,1,9,1,0,0,0,16,-20,1,Tyus Jones,WAS,SAC,WAS,,,26,17,25,10
22023,1626145,22300347,"DEC 17, 2023",WAS @ PHX,L,39,9,15,0.6,4,6,0.667,0,0,0.0,0,4,4,11,6,1,1,0,22,6,1,Tyus Jones,WAS,PHX,WAS,,,37,26,33,15
22023,1626145,22300328,"DEC 15, 2023",WAS vs. IND,W,29,6,7,0.857,1,2,0.5,0,0,0.0,0,10,10,11,2,2,2,2,13,7,1,Tyus Jones,WAS,WAS,IND,,,34,23,24,21
22023,1626145,22300311,"DEC 13, 2023",WAS vs. NOP,L,26,2,6,0.333,2,5,0.4,0,0,0.0,0,0,0,4,1,0,1,0,6,1,1,Tyus Jones,WAS,WAS,NOP,,,10,6,10,4
22023,1626145,22300295,"DEC 11, 2023",WAS @ PHI,L,21,4,9,0.444,1,5,0.2,0,0,0.0,0,5,5,3,1,0,2,0,9,-17,1,Tyus Jones,WAS,PHI,WAS,,,17,14,12,8
22023,1626145,22301219,"DEC 08, 2023",WAS @ BKN,L,28,6,10,0.6,0,1,0.0,2,2,1.0,0,2,2,3,1,1,1,0,14,-20,1,Tyus Jones,WAS,BKN,WAS,,,19,16,17,5
22023,1626145,22301208,"DEC 06, 2023",WAS vs. PHI,L,31,8,11,0.727,2,4,0.5,2,2,1.0,0,3,3,8,1,2,1,0,20,-9,1,Tyus Jones,WAS,WAS,PHI,,,31,23,28,11
22023,1626145,22300274,"DEC 01, 2023",WAS @ ORL,L,26,5,10,0.5,3,5,0.6,0,0,0.0,0,3,3,6,2,0,0,2,13,-4,1,Tyus Jones,WAS,ORL,WAS,,,22,16,19,9
22023,1626145,22300259,"NOV 29, 2023",WAS @ ORL,L,21,3,10,0.3,0,2,0.0,1,2,0.5,0,3,3,4,2,0,0,1,7,-8,1,Tyus Jones,WAS,ORL,WAS,,,14,10,11,7
22023,1626145,22300253,"NOV 27, 2023",WAS @ DET,W,26,5,9,0.556,1,3,0.333,1,2,0.5,1,2,3,4,0,0,0,0,12,7,1,Tyus Jones,WAS,DET,WAS,,,19,15,16,7
22023,1626145,22300241,"NOV 25, 2023",WAS vs. ATL,L,24,2,6,0.333,0,3,0.0,0,0,0.0,1,1,2,4,0,0,2,1,4,-18,1,Tyus Jones,WAS,WAS,ATL,,,10,6,8,6
22023,1626145,22300049,"NOV 24, 2023",WAS @ MIL,L,31,9,14,0.643,1,4,0.25,3,3,1.0,0,7,7,7,1,0,0,0,22,3,1,Tyus Jones,WAS,MIL,WAS,,,36,29,29,14
22023,1626145,22300225,"NOV 22, 2023",WAS @ CHA,L,35,6,12,0.5,1,2,0.5,0,0,0.0,0,1,1,7,2,0,0,1,13,10,1,Tyus Jones,WAS,CHA,WAS,,,21,14,20,8
22023,1626145,22300219,"NOV 20, 2023",WAS vs. MIL,L,26,9,13,0.692,0,1,0.0,0,0,0.0,0,2,2,3,0,0,0,0,18,9,1,Tyus Jones,WAS,WAS,MIL,,,23,20,21,5
22023,1626145,22300028,"NOV 17, 2023",WAS vs. NYK,L,30,4,7,0.571,1,2,0.5,2,2,1.0,0,3,3,5,1,0,1,0,11,-18,1,Tyus Jones,WAS,WAS,NYK,,,19,14,16,8
22023,1626145,22300192,"NOV 15, 2023",WAS vs. DAL,L,22,6,7,0.857,0,1,0.0,0,0,0.0,0,3,3,2,0,0,0,1,12,-20,1,Tyus Jones,WAS,WAS,DAL,,,17,15,14,5
22023,1626145,22300189,"NOV 13, 2023",WAS @ TOR,L,31,4,11,0.364,2,5,0.4,0,0,0.0,0,3,3,8,0,0,0,1,10,9,1,Tyus Jones,WAS,TOR,WAS,,,21,13,18,11
22023,1626145,22300178,"NOV 12, 2023",WAS @ BKN,L,23,0,5,0.0,0,1,0.0,0,0,0.0,0,1,1,1,2,0,1,1,0,-16,1,Tyus Jones,WAS,BKN,WAS,,,2,1,1,2
22023,1626145,22300009,"NOV 10, 2023",WAS vs. CHA,L,34,6,12,0.5,2,4,0.5,2,3,0.667,0,4,4,4,0,1,0,2,16,-29,1,Tyus Jones,WAS,WAS,CHA,,,24,20,20,8
22023,1626145,22300157,"NOV 08, 2023",WAS @ CHA,W,19,1,6,0.167,0,2,0.0,0,0,0.0,1,5,6,4,1,0,1,1,2,-8,1,Tyus Jones,WAS,CHA,WAS,,,12,8,6,10
22023,1626145,22300148,"NOV 06, 2023",WAS @ PHI,L,33,5,13,0.385,2,4,0.5,0,0,0.0,0,1,1,6,2,0,0,2,12,-3,1,Tyus Jones,WAS,PHI,WAS,,,19,13,18,7
22023,1626145,22300003,"NOV 03, 2023",WAS @ MIA,L,24,3,5,0.6,1,2,0.5,0,0,0.0,0,2,2,5,0,0,2,1,7,-14,1,Tyus Jones,WAS,MIA,WAS,,,14,9,12,7
22023,1626145,22300117,"NOV 01, 2023",WAS @ ATL,L,22,3,6,0.5,0,3,0.0,0,0,0.0,0,1,1,3,1,0,1,1,6,-23,1,Tyus Jones,WAS,ATL,WAS,,,10,7,9,4
22023,1626145,22300103,"OCT 30, 2023",WAS vs. BOS,L,27,5,9,0.556,1,4,0.25,0,0,0.0,0,3,3,7,1,0,2,0,11,-31,1,Tyus Jones,WAS,WAS,BOS,,,21,14,18,10
22023,1626145,22300089,"OCT 28, 2023",WAS vs. MEM,W,28,5,12,0.417,4,8,0.5,0,0,0.0,2,0,2,7,2,0,0,2,14,5,1,Tyus Jones,WAS,WAS,MEM,,,23,16,21,9
22023,1626145,22300064,"OCT 25, 2023",WAS @ IND,L,28,7,12,0.583,2,4,0.5,0,1,0.0,1,2,3,6,1,1,2,1,16,-17,1,Tyus Jones,WAS,IND,WAS,,,25,19,22,9
22023,1627884,22300547,"JAN 13, 2024",DAL vs. NOP,L,28,8,10,0.8,3,5,0.6,5,5,1.0,0,4,4,1,0,0,1,4,24,-20,1,Derrick Jones Jr.,DAL,DAL,NOP,,,29,28,25,5
22023,1627884,22300530,"JAN 11, 2024",DAL vs. NYK,W,35,4,10,0.4,1,5,0.2,0,2,0.0,1,3,4,1,0,1,1,2,9,-6,1,Derrick Jones Jr.,DAL,DAL,NYK,,,14,13,10,5
22023,1627884,22300515,"JAN 09, 2024",DAL vs. MEM,L,36,5,9,0.556,0,1,0.0,1,1,1.0,0,4,4,2,0,1,0,1,11,-10,1,Derrick Jones Jr.,DAL,DAL,MEM,,,17,15,13,6
22023,1627884,22300501,"JAN 07, 2024",DAL vs. MIN,W,35,5,12,0.417,1,6,0.167,1,2,0.5,5,5,10,1,1,3,1,2,12,2,1,Derrick Jones Jr.,DAL,DAL,MIN,,,23,22,13,11
22023,1627884,22300487,"JAN 05, 2024",DAL vs. POR,W,20,5,6,0.833,2,3,0.667,0,0,0.0,0,3,3,0,3,0,3,4,12,18,1,Derrick Jones Jr.,DAL,DAL,POR,,,15,15,12,3
22023,1627884,22300472,"JAN 03, 2024",DAL vs. POR,W,23,2,3,0.667,0,0,0.0,1,2,0.5,0,0,0,1,2,2,1,2,5,23,1,Derrick Jones Jr.,DAL,DAL,POR,,,6,5,6,1
22023,1627884,22300457,"JAN 01, 2024",DAL @ UTA,L,24,2,4,0.5,1,3,0.333,1,2,0.5,1,2,3,0,1,1,2,1,6,-18,1,Derrick Jones Jr.,DAL,UTA,DAL,,,9,9,6,3
22023,1627884,22300444,"DEC 30, 2023",DAL @ GSW,W,24,3,7,0.429,0,3,0.0,1,2,0.5,2,3,5,1,2,1,1,1,7,-5,1,Derrick Jones Jr.,DAL,GSW,DAL,,,13,12,8,6
22023,1627884,22300423,"DEC 28, 2023",DAL @ MIN,L,30,3,9,0.333,1,3,0.333,8,8,1.0,3,6,9,0,3,1,1,5,15,3,1,Derrick Jones Jr.,DAL,MIN,DAL,,,24,24,15,9
22023,1627884,22300420,"DEC 27, 2023",DAL vs. CLE,L,36,5,13,0.385,0,4,0.0,2,2,1.0,2,3,5,1,1,3,2,3,12,-8,1,Derrick Jones Jr.,DAL,DAL,CLE,,,18,17,13,6
22023,1627884,22300405,"DEC 25, 2023",DAL @ PHX,W,35,9,18,0.5,3,8,0.375,2,4,0.5,2,1,3,1,1,0,0,3,23,15,1,Derrick Jones Jr.,DAL,PHX,DAL,,,27,26,24,4
22023,1627884,22300398,"DEC 23, 2023",DAL vs. SAS,W,24,4,7,0.571,3,5,0.6,0,0,0.0,2,2,4,1,0,0,0,2,11,5,1,Derrick Jones Jr.,DAL,DAL,SAS,,,16,15,12,5
22023,1627884,22300385,"DEC 22, 2023",DAL @ HOU,L,22,1,4,0.25,0,1,0.0,1,2,0.5,2,2,4,1,0,0,1,3,3,-21,1,Derrick Jones Jr.,DAL,HOU,DAL,,,8,7,4,5
22023,1627884,22300372,"DEC 20, 2023",DAL vs. LAC,L,39,6,11,0.545,2,4,0.5,5,5,1.0,3,0,3,2,1,2,0,2,19,1,1,Derrick Jones Jr.,DAL,DAL,LAC,,,24,22,21,5
22023,1627884,22300356,"DEC 18, 2023",DAL @ DEN,L,24,3,9,0.333,0,5,0.0,0,0,0.0,0,1,1,1,2,0,1,0,6,-11,1,Derrick Jones Jr.,DAL,DEN,DAL,,,8,7,7,2
22023,1627884,22300341,"DEC 16, 2023",DAL @ POR,W,33,6,11,0.545,2,6,0.333,4,5,0.8,1,0,1,4,2,0,1,1,18,-3,1,Derrick Jones Jr.,DAL,POR,DAL,,,23,19,22,5
22023,1627884,22300321,"DEC 14, 2023",DAL vs. MIN,L,30,1,8,0.125,1,6,0.167,0,0,0.0,0,4,4,0,2,0,0,3,3,-25,1,Derrick Jones Jr.,DAL,DAL,MIN,,,7,7,3,4
22023,1627884,22300299,"DEC 11, 2023",DAL @ MEM,W,6,2,4,0.5,0,2,0.0,1,1,1.0,0,2,2,0,0,3,0,0,5,6,1,Derrick Jones Jr.,DAL,MEM,DAL,,,7,7,5,2
22023,1627884,22301226,"DEC 08, 2023",DAL @ POR,W,39,6,12,0.5,1,7,0.143,1,2,0.5,4,4,8,1,2,2,1,2,14,21,1,Derrick Jones Jr.,DAL,POR,DAL,,,23,22,15,9
22023,1627884,22301213,"DEC 06, 2023",DAL vs. UTA,W,25,4,5,0.8,1,2,0.5,3,5,0.6,1,3,4,1,1,2,0,3,12,28,1,Derrick Jones Jr.,DAL,DAL,UTA,,,17,16,13,5
22023,1627884,22300287,"DEC 02, 2023",DAL vs. OKC,L,33,8,15,0.533,6,12,0.5,2,2,1.0,1,3,4,1,1,1,3,3,24,-1,1,Derrick Jones Jr.,DAL,DAL,OKC,,,29,28,25,5
22023,1627884,22300277,"DEC 01, 2023",DAL vs. MEM,L,31,6,14,0.429,4,7,0.571,0,0,0.0,3,1,4,1,1,0,1,1,16,-23,1,Derrick Jones Jr.,DAL,DAL,MEM,,,21,20,17,5
22023,1627884,22300059,"NOV 28, 2023",DAL vs. HOU,W,34,5,7,0.714,2,3,0.667,3,3,1.0,3,3,6,1,1,0,0,4,15,11,1,Derrick Jones Jr.,DAL,DAL,HOU,,,22,21,16,7
22023,1627884,22300244,"NOV 25, 2023",DAL @ LAC,L,20,1,5,0.2,1,3,0.333,1,2,0.5,0,1,1,1,1,1,0,1,4,-26,1,Derrick Jones Jr.,DAL,LAC,DAL,,,6,5,5,2
22023,1627884,22300238,"NOV 22, 2023",DAL @ LAL,W,19,2,4,0.5,2,4,0.5,0,0,0.0,1,1,2,0,0,2,0,4,6,-10,1,Derrick Jones Jr.,DAL,LAL,DAL,,,8,8,6,2
22023,1627884,22300212,"NOV 19, 2023",DAL vs. SAC,L,19,2,4,0.5,1,2,0.5,1,1,1.0,0,2,2,0,0,0,1,0,6,-20,1,Derrick Jones Jr.,DAL,DAL,SAC,,,8,8,6,2
22023,1627884,22300205,"NOV 18, 2023",DAL @ MIL,L,19,0,7,0.0,0,2,0.0,0,0,0.0,2,6,8,1,0,0,2,1,0,0,1,Derrick Jones Jr.,DAL,MIL,DAL,,,9,8,1,9
22023,1627884,22300192,"NOV 15, 2023",DAL @ WAS,W,26,8,11,0.727,2,5,0.4,2,3,0.667,1,6,7,1,1,2,2,4,20,5,1,Derrick Jones Jr.,DAL,WAS,DAL,,,28,27,21,8
22023,1627884,22300022,"NOV 14, 2023",DAL @ NOP,L,18,2,4,0.5,1,3,0.333,2,2,1.0,2,1,3,2,0,1,1,1,7,-10,1,Derrick Jones Jr.,DAL,NOP,DAL,,,12,10,9,5
22023,1627884,22300183,"NOV 12, 2023",DAL @ NOP,W,22,2,6,0.333,2,6,0.333,1,2,0.5,0,1,1,2,0,0,1,0,7,8,1,Derrick Jones Jr.,DAL,NOP,DAL,,,10,8,9,3
22023,1627884,22300014,"NOV 10, 2023",DAL vs. LAC,W,29,4,10,0.4,1,4,0.25,2,2,1.0,4,6,10,3,3,0,0,1,11,36,1,Derrick Jones Jr.,DAL,DAL,LAC,,,24,21,14,13
22023,1627884,22300168,"NOV 08, 2023",DAL vs. TOR,L,29,6,8,0.75,3,5,0.6,0,0,0.0,1,4,5,1,0,3,3,3,15,11,1,Derrick Jones Jr.,DAL,DAL,TOR,,,21,20,16,6
22023,1627884,22300147,"NOV 06, 2023",DAL @ ORL,W,28,2,5,0.4,1,3,0.333,0,0,0.0,1,3,4,1,0,2,1,3,5,2,1,Derrick Jones Jr.,DAL,ORL,DAL,,,10,9,6,5
22023,1627884,22300143,"NOV 05, 2023",DAL vs. CHA,W,17,0,2,0.0,0,1,0.0,0,0,0.0,0,0,0,1,1,1,1,1,0,3,1,Derrick Jones Jr.,DAL,DAL,CHA,,,1,0,1,1
22023,1627884,22300006,"NOV 03, 2023",DAL @ DEN,L,17,3,5,0.6,1,3,0.333,0,0,0.0,1,0,1,1,2,0,0,0,7,-16,1,Derrick Jones Jr.,DAL,DEN,DAL,,,9,8,8,2
22023,1627884,22300124,"NOV 01, 2023",DAL vs. CHI,W,31,7,13,0.538,3,9,0.333,0,0,0.0,1,4,5,1,0,0,0,2,17,11,1,Derrick Jones Jr.,DAL,DAL,CHI,,,23,22,18,6
22023,1627884,22300106,"OCT 30, 2023",DAL @ MEM,W,27,7,10,0.7,4,6,0.667,4,6,0.667,0,4,4,0,0,0,1,0,22,12,1,Derrick Jones Jr.,DAL,MEM,DAL,,,26,26,22,4
22023,1627884,22300084,"OCT 27, 2023",DAL vs. BKN,W,14,2,5,0.4,0,2,0.0,0,0,0.0,0,1,1,1,0,0,1,1,4,1,1,Derrick Jones Jr.,DAL,DAL,BKN,,,6,5,5,2
22023,1627884,22300073,"OCT 25, 2023",DAL @ SAS,W,12,0,3,0.0,0,2,0.0,1,2,0.5,0,1,1,0,0,0,1,0,1,-1,1,Derrick Jones Jr.,DAL,SAS,DAL,,,2,2,1,1
22023,201599,22300550,"JAN 14, 2024",DEN vs. IND,W,7,0,0,0.0,0,0,0.0,0,0,0.0,0,2,2,1,0,0,2,4,0,-4,1,DeAndre Jordan,DEN,DEN,IND,,,3,2,1,3
22023,201599,22300539,"JAN 12, 2024",DEN vs. NOP,W,14,2,2,1.0,0,0,0.0,2,2,1.0,1,6,7,1,0,1,0,1,6,6,1,DeAndre Jordan,DEN,DEN,NOP,,,14,13,7,8
22023,201599,22300524,"JAN 10, 2024",DEN @ UTA,L,8,1,3,0.333,0,0,0.0,3,4,0.75,2,3,5,0,0,1,0,0,5,-4,1,DeAndre Jordan,DEN,UTA,DEN,,,10,10,5,5
22023,201599,22300502,"JAN 07, 2024",DEN vs. DET,W,21,3,3,1.0,0,0,0.0,3,5,0.6,0,7,7,1,0,1,3,5,9,7,1,DeAndre Jordan,DEN,DEN,DET,,,17,16,10,8
22023,201599,22300435,"DEC 29, 2023",DEN vs. OKC,L,13,3,4,0.75,0,0,0.0,0,0,0.0,3,5,8,1,1,0,1,0,6,-1,1,DeAndre Jordan,DEN,DEN,OKC,,,15,14,7,9
22023,201599,22300425,"DEC 28, 2023",DEN vs. MEM,W,13,2,3,0.667,0,0,0.0,0,0,0.0,5,4,9,2,0,2,0,3,4,9,1,DeAndre Jordan,DEN,DEN,MEM,,,15,13,6,11
22023,201599,22300383,"DEC 22, 2023",DEN @ BKN,W,6,1,1,1.0,0,0,0.0,0,0,0.0,0,0,0,0,0,0,0,0,2,-9,1,DeAndre Jordan,DEN,BKN,DEN,,,2,2,2,0
22023,201599,22300340,"DEC 16, 2023",DEN vs. OKC,L,6,1,2,0.5,0,0,0.0,0,0,0.0,3,4,7,1,0,0,0,1,2,5,1,DeAndre Jordan,DEN,DEN,OKC,,,10,9,3,8
22023,201599,22300322,"DEC 14, 2023",DEN vs. BKN,W,12,1,2,0.5,0,0,0.0,0,0,0.0,2,2,4,0,0,1,1,2,2,-2,1,DeAndre Jordan,DEN,DEN,BKN,,,6,6,2,4
22023,201599,22300307,"DEC 12, 2023",DEN @ CHI,W,25,2,4,0.5,0,0,0.0,5,10,0.5,4,6,10,2,1,2,2,5,9,-6,1,DeAndre Jordan,DEN,CHI,DEN,,,21,19,11,12
22023,201599,22301224,"DEC 08, 2023",DEN vs. HOU,L,12,1,2,0.5,0,0,0.0,0,0,0.0,1,3,4,2,1,0,1,2,2,-2,1,DeAndre Jordan,DEN,DEN,HOU,,,8,6,4,6
22023,201599,22301215,"DEC 06, 2023",DEN @ LAC,L,11,2,6,0.333,0,0,0.0,0,0,0.0,3,2,5,0,0,1,0,0,4,-8,1,DeAndre Jordan,DEN,LAC,DEN,,,9,9,4,5
22023,201599,22300290,"DEC 02, 2023",DEN @ SAC,L,10,2,6,0.333,0,0,0.0,0,2,0.0,2,2,4,0,0,0,1,0,4,-17,1,DeAndre Jordan,DEN,SAC,DEN,,,8,8,4,4
22023,201599,22300279,"DEC 01, 2023",DEN @ PHX,W,13,1,1,1.0,0,0,0.0,0,1,0.0,0,2,2,0,0,0,2,2,2,2,1,DeAndre Jordan,DEN,PHX,DEN,,,4,4,2,2
22023,201599,22300263,"NOV 29, 2023",DEN vs. HOU,W,6,1,1,1.0,0,0,0.0,0,2,0.0,1,0,1,0,0,0,0,0,2,-11,1,DeAndre Jordan,DEN,DEN,HOU,,,3,3,2,1
22023,201599,22300257,"NOV 27, 2023",DEN @ LAC,W,34,8,11,0.727,0,0,0.0,5,11,0.455,3,10,13,5,2,1,2,3,21,17,1,DeAndre Jordan,DEN,LAC,DEN,,,39,34,26,18
22023,201599,22300252,"NOV 26, 2023",DEN vs. SAS,W,12,3,3,1.0,0,0,0.0,0,3,0.0,1,5,6,1,0,0,1,3,6,2,1,DeAndre Jordan,DEN,DEN,SAS,,,13,12,7,7
22023,201599,22300139,"NOV 04, 2023",DEN vs. CHI,W,12,0,0,0.0,0,0,0.0,1,2,0.5,1,0,1,1,0,0,1,2,1,-10,1,DeAndre Jordan,DEN,DEN,CHI,,,3,2,2,2
22023,202709,22300560,"JAN 15, 2024",GSW @ MEM,L,7,0,1,0.0,0,1,0.0,0,0,0.0,0,0,0,1,0,0,0,0,0,-7,1,Cory Joseph,GSW,MEM,GSW,,,1,0,1,1
22023,202709,22300545,"JAN 13, 2024",GSW @ MIL,L,18,1,2,0.5,1,2,0.5,0,0,0.0,0,3,3,2,0,1,1,1,3,-11,1,Cory Joseph,GSW,MIL,GSW,,,8,6,5,5
22023,202709,22300536,"JAN 12, 2024",GSW @ CHI,W,13,1,3,0.333,0,1,0.0,0,0,0.0,0,1,1,2,0,0,0,1,2,4,1,Cory Joseph,GSW,CHI,GSW,,,5,3,4,3
22023,202709,22300525,"JAN 10, 2024",GSW vs. NOP,L,17,1,3,0.333,0,2,0.0,0,0,0.0,2,1,3,2,0,0,2,2,2,-22,1,Cory Joseph,GSW,GSW,NOP,,,7,5,4,5
22023,202709,22300504,"JAN 07, 2024",GSW vs. TOR,L,14,0,2,0.0,0,1,0.0,0,0,0.0,0,0,0,2,0,0,1,1,0,-3,1,Cory Joseph,GSW,GSW,TOR,,,2,0,2,2
22023,202709,22300490,"JAN 05, 2024",GSW vs. DET,W,9,1,2,0.5,1,2,0.5,0,0,0.0,0,0,0,2,0,0,0,0,3,3,1,Cory Joseph,GSW,GSW,DET,,,5,3,5,2
22023,202709,22300426,"DEC 28, 2023",GSW vs. MIA,L,2,0,0,0.0,0,0,0.0,0,0,0.0,0,0,0,0,0,0,0,1,0,3,1,Cory Joseph,GSW,GSW,MIA,,,0,0,0,0
22023,202709,22300399,"DEC 23, 2023",GSW vs. POR,W,4,0,1,0.0,0,1,0.0,0,0,0.0,0,0,0,1,0,0,1,0,0,1,1,Cory Joseph,GSW,GSW,POR,,,1,0,1,1
22023,202709,22300386,"DEC 22, 2023",GSW vs. WAS,W,14,0,3,0.0,0,1,0.0,0,0,0.0,0,1,1,0,1,0,1,3,0,-7,1,Cory Joseph,GSW,GSW,WAS,,,1,1,0,1
22023,202709,22300362,"DEC 19, 2023",GSW vs. BOS,W,6,2,3,0.667,0,1,0.0,0,0,0.0,0,1,1,0,0,1,0,0,4,2,1,Cory Joseph,GSW,GSW,BOS,,,5,5,4,1
22023,202709,22301222,"DEC 08, 2023",GSW @ OKC,L,13,1,3,0.333,0,1,0.0,0,0,0.0,0,1,1,3,0,0,0,0,2,3,1,Cory Joseph,GSW,OKC,GSW,,,6,3,5,4
22023,202709,22300280,"DEC 02, 2023",GSW @ LAC,L,16,0,2,0.0,0,2,0.0,0,0,0.0,0,0,0,3,0,0,0,2,0,1,1,Cory Joseph,GSW,LAC,GSW,,,3,0,3,3
22023,202709,22300273,"NOV 30, 2023",GSW vs. LAC,W,22,0,2,0.0,0,2,0.0,1,2,0.5,0,2,2,2,0,0,0,1,1,12,1,Cory Joseph,GSW,GSW,LAC,,,5,3,3,4
22023,202709,22300060,"NOV 28, 2023",GSW @ SAC,L,8,1,2,0.5,0,0,0.0,2,2,1.0,0,3,3,3,0,0,0,0,4,1,1,Cory Joseph,GSW,SAC,GSW,,,10,7,7,6
22023,202709,22300236,"NOV 22, 2023",GSW @ PHX,L,16,1,3,0.333,0,2,0.0,1,2,0.5,0,0,0,4,2,0,1,3,3,12,1,Cory Joseph,GSW,PHX,GSW,,,7,3,7,4
22023,202709,22300201,"NOV 16, 2023",GSW vs. OKC,L,20,1,7,0.143,1,6,0.167,0,0,0.0,1,1,2,2,0,1,0,0,3,-16,1,Cory Joseph,GSW,GSW,OKC,,,7,5,5,4
22023,202709,22300025,"NOV 14, 2023",GSW vs. MIN,L,13,2,6,0.333,2,3,0.667,0,1,0.0,0,0,0,4,0,0,2,1,6,6,1,Cory Joseph,GSW,GSW,MIN,,,10,6,10,4
22023,202709,22300176,"NOV 11, 2023",GSW vs. CLE,L,2,1,2,0.5,1,2,0.5,0,0,0.0,0,0,0,1,0,0,2,1,3,6,1,Cory Joseph,GSW,GSW,CLE,,,4,3,4,1
22023,202709,22300142,"NOV 05, 2023",GSW @ CLE,L,3,0,0,0.0,0,0,0.0,0,0,0.0,0,0,0,0,1,0,0,0,0,3,1,Cory Joseph,GSW,CLE,GSW,,,0,0,0,0
22023,202709,22300108,"OCT 30, 2023",GSW @ NOP,W,5,0,1,0.0,0,1,0.0,0,0,0.0,0,1,1,1,0,0,0,2,0,0,1,Cory Joseph,GSW,NOP,GSW,,,2,1,1,2
22023,202709,22300062,"OCT 24, 2023",GSW vs. PHX,L,4,0,0,0.0,0,0,0.0,0,0,0.0,1,0,1,1,0,0,0,0,0,-12,1,Cory Joseph,GSW,GSW,PHX,,,2,1,1,2
22023,1631107,22300562,"JAN 15, 2024",MIA @ BKN,W,19,2,4,0.5,1,3,0.333,0,0,0.0,0,3,3,2,0,0,0,0,5,17,1,Nikola Jovic,MIA,BKN,MIA,,,10,8,7,5
22023,1631107,22300551,"JAN 14, 2024",MIA vs. CHA,W,28,2,6,0.333,1,2,0.5,0,0,0.0,1,6,7,2,0,2,3,3,5,13,1,Nikola Jovic,MIA,MIA,CHA,,,14,12,7,9
22023,1631107,22300535,"JAN 12, 2024",MIA vs. ORL,W,25,1,8,0.125,1,4,0.25,1,2,0.5,0,3,3,4,0,0,2,2,4,-1,1,Nikola Jovic,MIA,MIA,ORL,,,11,7,8,7
22023,1631107,22300522,"JAN 10, 2024",MIA vs. OKC,L,33,5,8,0.625,3,5,0.6,2,2,1.0,0,5,5,4,1,1,1,3,15,13,1,Nikola Jovic,MIA,MIA,OKC,,,24,20,19,9
22023,1631107,22300509,"JAN 08, 2024",MIA vs. HOU,W,21,2,9,0.222,1,5,0.2,1,4,0.25,3,5,8,6,2,2,2,3,6,7,1,Nikola Jovic,MIA,MIA,HOU,,,20,14,12,14
22023,1631107,22300489,"JAN 05, 2024",MIA @ PHX,L,24,1,3,0.333,1,3,0.333,0,0,0.0,1,3,4,1,0,0,0,0,3,-10,1,Nikola Jovic,MIA,PHX,MIA,,,8,7,4,5
22023,1631107,22300475,"JAN 03, 2024",MIA @ LAL,W,28,6,11,0.545,3,5,0.6,0,0,0.0,1,7,8,1,1,0,0,4,15,3,1,Nikola Jovic,MIA,LAL,MIA,,,24,23,16,9
22023,1631107,22300458,"JAN 01, 2024",MIA @ LAC,L,3,1,2,0.5,1,2,0.5,0,0,0.0,0,0,0,1,0,0,0,0,3,3,1,Nikola Jovic,MIA,LAC,MIA,,,4,3,4,1
22023,1631107,22300439,"DEC 30, 2023",MIA @ UTA,L,10,2,2,1.0,2,2,1.0,0,0,0.0,1,1,2,1,0,0,1,5,6,2,1,Nikola Jovic,MIA,UTA,MIA,,,9,8,7,3
22023,1631107,22300426,"DEC 28, 2023",MIA @ GSW,W,20,4,5,0.8,0,1,0.0,3,5,0.6,2,1,3,3,1,1,0,3,11,10,1,Nikola Jovic,MIA,GSW,MIA,,,17,14,14,6
22023,1631107,22301207,"DEC 06, 2023",MIA @ TOR,W,3,0,1,0.0,0,1,0.0,0,0,0.0,0,2,2,0,0,0,1,2,0,-3,1,Nikola Jovic,MIA,TOR,MIA,,,2,2,0,2
22023,1631107,22300240,"NOV 25, 2023",MIA @ BKN,L,17,0,3,0.0,0,1,0.0,1,2,0.5,1,5,6,5,0,0,2,5,1,-5,1,Nikola Jovic,MIA,BKN,MIA,,,12,7,6,11
22023,1631107,22300107,"OCT 30, 2023",MIA @ MIL,L,7,1,2,0.5,1,1,1.0,2,2,1.0,0,4,4,0,0,0,2,0,5,9,1,Nikola Jovic,MIA,MIL,MIA,,,9,9,5,4
22023,1631107,22300093,"OCT 28, 2023",MIA @ MIN,L,21,3,6,0.5,2,4,0.5,0,0,0.0,0,11,11,4,1,0,0,2,8,6,1,Nikola Jovic,MIA,MIN,MIA,,,23,19,12,15
22023,1630548,22300342,"DEC 16, 2023",UTA @ SAC,L,4,0,2,0.0,0,2,0.0,0,0,0.0,0,0,0,1,0,0,0,0,0,-1,1,Johnny Juzang,UTA,SAC,UTA,,,1,0,1,1
22023,1628379,22300560,"JAN 15, 2024",MEM vs. GSW,W,32,2,9,0.222,2,7,0.286,5,5,1.0,1,1,2,5,1,0,1,1,11,15,1,Luke Kennard,MEM,MEM,GSW,,,18,13,16,7
22023,1628379,22300544,"JAN 13, 2024",MEM vs. NYK,L,33,6,13,0.462,2,8,0.25,0,0,0.0,0,3,3,2,0,0,0,2,14,-1,1,Luke Kennard,MEM,MEM,NYK,,,19,17,16,5
22023,1628379,22300537,"JAN 12, 2024",MEM vs. LAC,L,29,4,7,0.571,3,5,0.6,0,0,0.0,1,6,7,6,0,0,1,2,11,-13,1,Luke Kennard,MEM,MEM,LAC,,,24,18,17,13
22023,1628379,22300515,"JAN 09, 2024",MEM @ DAL,W,23,5,7,0.714,3,4,0.75,1,1,1.0,1,4,5,4,1,0,2,2,14,-3,1,Luke Kennard,MEM,DAL,MEM,,,23,19,18,9
22023,1628379,22300503,"JAN 07, 2024",MEM @ PHX,W,22,3,5,0.6,3,3,1.0,0,0,0.0,0,3,3,3,0,0,0,2,9,2,1,Luke Kennard,MEM,PHX,MEM,,,15,12,12,6
22023,1628379,22300491,"JAN 05, 2024",MEM @ LAL,W,20,0,4,0.0,0,3,0.0,0,0,0.0,1,2,3,4,1,0,0,0,0,0,1,Luke Kennard,MEM,LAL,MEM,,,7,3,4,7
22023,1628379,22300470,"JAN 03, 2024",MEM vs. TOR,L,19,1,5,0.2,0,4,0.0,0,0,0.0,0,1,1,0,0,0,0,1,2,-17,1,Luke Kennard,MEM,MEM,TOR,,,3,3,2,1
22023,1628379,22300460,"JAN 02, 2024",MEM vs. SAS,W,21,3,7,0.429,3,7,0.429,3,3,1.0,1,4,5,3,0,0,0,2,12,16,1,Luke Kennard,MEM,MEM,SAS,,,20,17,15,8
22023,1628379,22300449,"DEC 31, 2023",MEM vs. SAC,L,20,6,9,0.667,5,8,0.625,0,0,0.0,0,3,3,2,0,0,1,2,17,-7,1,Luke Kennard,MEM,MEM,SAC,,,22,20,19,5
22023,1628379,22300026,"NOV 14, 2023",MEM @ LAL,L,6,0,5,0.0,0,3,0.0,0,0,0.0,1,2,3,0,0,0,0,0,0,-6,1,Luke Kennard,MEM,LAL,MEM,,,3,3,0,3
22023,1628379,22300179,"NOV 12, 2023",MEM @ LAC,W,24,4,5,0.8,4,5,0.8,1,1,1.0,0,1,1,2,1,0,0,1,13,-1,1,Luke Kennard,MEM,LAC,MEM,,,16,14,15,3
22023,1628379,22300012,"NOV 10, 2023",MEM vs. UTA,L,21,5,11,0.455,4,9,0.444,0,0,0.0,0,1,1,1,0,1,0,1,14,-13,1,Luke Kennard,MEM,MEM,UTA,,,16,15,15,2
22023,1628379,22300164,"NOV 08, 2023",MEM vs. MIA,L,27,4,7,0.571,3,6,0.5,2,2,1.0,0,2,2,3,1,0,3,1,13,7,1,Luke Kennard,MEM,MEM,MIA,,,18,15,16,5
22023,1628379,22300144,"NOV 05, 2023",MEM @ POR,W,32,5,9,0.556,4,6,0.667,1,1,1.0,0,5,5,2,1,0,1,0,15,30,1,Luke Kennard,MEM,POR,MEM,,,22,20,17,7
22023,1628379,22300007,"NOV 03, 2023",MEM @ POR,L,27,2,7,0.286,1,4,0.25,0,0,0.0,1,7,8,3,0,0,0,1,5,-10,1,Luke Kennard,MEM,POR,MEM,,,16,13,8,11
22023,1628379,22300125,"NOV 01, 2023",MEM @ UTA,L,21,1,9,0.111,1,8,0.125,0,0,0.0,0,1,1,3,2,0,0,0,3,-19,1,Luke Kennard,MEM,UTA,MEM,,,7,4,6,4
22023,1628379,22300071,"OCT 25, 2023",MEM vs. NOP,L,15,0,5,0.0,0,5,0.0,3,3,1.0,1,1,2,2,0,0,1,0,3,-14,1,Luke Kennard,MEM,MEM,NOP,,,7,5,5,4
22023,1631117,22300564,"JAN 15, 2024",UTA vs. IND,W,25,2,2,1.0,0,0,0.0,0,2,0.0,1,4,5,1,0,5,1,0,4,7,1,Walker Kessler,UTA,UTA,IND,,,10,9,5,6
22023,1631117,22300549,"JAN 13, 2024",UTA vs. LAL,W,14,2,4,0.5,0,0,0.0,0,2,0.0,2,4,6,0,0,1,0,2,4,-12,1,Walker Kessler,UTA,UTA,LAL,,,10,10,4,6
22023,1631117,22300540,"JAN 12, 2024",UTA vs. TOR,W,20,5,5,1.0,0,0,0.0,2,4,0.5,2,4,6,1,1,3,0,4,12,7,1,Walker Kessler,UTA,UTA,TOR,,,19,18,13,7
22023,1631117,22300524,"JAN 10, 2024",UTA vs. DEN,W,15,4,4,1.0,0,0,0.0,0,0,0.0,2,2,4,1,2,1,1,4,8,10,1,Walker Kessler,UTA,UTA,DEN,,,13,12,9,5
22023,1631117,22300510,"JAN 08, 2024",UTA @ MIL,W,21,3,4,0.75,0,0,0.0,2,4,0.5,2,4,6,0,1,2,0,1,8,10,1,Walker Kessler,UTA,MIL,UTA,,,14,14,8,6
22023,1631117,22300495,"JAN 06, 2024",UTA @ PHI,W,19,4,4,1.0,0,0,0.0,2,2,1.0,1,3,4,0,1,0,0,2,10,5,1,Walker Kessler,UTA,PHI,UTA,,,14,14,10,4
22023,1631117,22300479,"JAN 05, 2024",UTA @ BOS,L,14,2,3,0.667,0,0,0.0,0,0,0.0,1,6,7,0,0,0,0,2,4,-4,1,Walker Kessler,UTA,BOS,UTA,,,11,11,4,7
22023,1631117,22300474,"JAN 03, 2024",UTA vs. DET,W,29,4,6,0.667,0,0,0.0,0,0,0.0,3,5,8,1,0,6,0,4,8,15,1,Walker Kessler,UTA,UTA,DET,,,17,16,9,9
22023,1631117,22300457,"JAN 01, 2024",UTA vs. DAL,W,27,5,6,0.833,0,1,0.0,1,2,0.5,0,10,10,0,1,4,1,2,11,37,1,Walker Kessler,UTA,UTA,DAL,,,21,21,11,10
22023,1631117,22300439,"DEC 30, 2023",UTA vs. MIA,W,23,5,5,1.0,0,0,0.0,0,0,0.0,0,8,8,0,0,2,0,1,10,10,1,Walker Kessler,UTA,UTA,MIA,,,18,18,10,8
22023,1631117,22300424,"DEC 28, 2023",UTA @ NOP,L,29,5,5,1.0,1,1,1.0,0,0,0.0,3,1,4,0,2,1,2,2,11,9,1,Walker Kessler,UTA,NOP,UTA,,,15,15,11,4
22023,1631117,22300412,"DEC 26, 2023",UTA @ SAS,W,18,5,10,0.5,1,1,1.0,0,0,0.0,3,4,7,1,1,4,1,2,11,1,1,Walker Kessler,UTA,SAS,UTA,,,19,18,12,8
22023,1631117,22300395,"DEC 23, 2023",UTA @ TOR,W,25,5,6,0.833,0,0,0.0,0,0,0.0,3,5,8,1,0,2,1,2,10,17,1,Walker Kessler,UTA,TOR,UTA,,,19,18,11,9
22023,1631117,22300374,"DEC 21, 2023",UTA @ DET,W,20,2,3,0.667,0,0,0.0,0,1,0.0,5,5,10,1,0,4,1,1,4,17,1,Walker Kessler,UTA,DET,UTA,,,15,14,5,11
22023,1631117,22300364,"DEC 20, 2023",UTA @ CLE,L,30,5,8,0.625,0,1,0.0,0,0,0.0,1,4,5,0,2,1,2,2,10,5,1,Walker Kessler,UTA,CLE,UTA,,,15,15,10,5
22023,1631117,22300357,"DEC 18, 2023",UTA vs. BKN,W,32,6,8,0.75,0,0,0.0,2,4,0.5,3,11,14,0,0,5,1,1,14,9,1,Walker Kessler,UTA,UTA,BKN,,,28,28,14,14
22023,1631117,22300342,"DEC 16, 2023",UTA @ SAC,L,18,0,0,0.0,0,0,0.0,2,4,0.5,1,2,3,1,0,1,1,2,2,-28,1,Walker Kessler,UTA,SAC,UTA,,,6,5,3,4
22023,1631117,22300323,"DEC 14, 2023",UTA @ POR,W,26,5,6,0.833,0,1,0.0,0,0,0.0,2,8,10,4,1,7,1,0,10,23,1,Walker Kessler,UTA,POR,UTA,,,24,20,14,14
22023,1631117,22300318,"DEC 13, 2023",UTA vs. NYK,W,23,4,7,0.571,0,0,0.0,1,3,0.333,4,5,9,1,0,3,2,3,9,3,1,Walker Kessler,UTA,UTA,NYK,,,19,18,10,10
22023,1631117,22301225,"DEC 08, 2023",UTA vs. LAC,L,31,4,9,0.444,0,0,0.0,0,0,0.0,4,8,12,3,2,5,2,2,8,-10,1,Walker Kessler,UTA,UTA,LAC,,,23,20,11,15
22023,1631117,22301213,"DEC 06, 2023",UTA @ DAL,L,27,3,7,0.429,0,0,0.0,0,0,0.0,4,4,8,0,1,0,2,4,6,-15,1,Walker Kessler,UTA,DAL,UTA,,,14,14,6,8
22023,1631117,22300289,"DEC 02, 2023",UTA vs. POR,W,25,6,6,1.0,0,0,0.0,0,0,0.0,4,4,8,0,0,2,2,1,12,-5,1,Walker Kessler,UTA,UTA,POR,,,20,20,12,8
22023,1631117,22300270,"NOV 30, 2023",UTA @ MIN,L,27,3,6,0.5,0,2,0.0,1,2,0.5,0,5,5,2,1,3,1,1,7,-7,1,Walker Kessler,UTA,MIN,UTA,,,14,12,9,7
22023,1631117,22300261,"NOV 29, 2023",UTA @ MEM,L,28,4,11,0.364,0,2,0.0,1,2,0.5,3,5,8,2,1,6,1,0,9,-2,1,Walker Kessler,UTA,MEM,UTA,,,19,17,11,10
22023,1631117,22300256,"NOV 27, 2023",UTA vs. NOP,W,26,7,9,0.778,0,0,0.0,0,1,0.0,1,7,8,3,0,2,0,4,14,3,1,Walker Kessler,UTA,UTA,NOP,,,25,22,17,11
22023,1631117,22300243,"NOV 25, 2023",UTA vs. NOP,W,21,5,10,0.5,0,1,0.0,1,1,1.0,6,5,11,0,1,2,3,5,11,-1,1,Walker Kessler,UTA,UTA,NOP,,,22,22,11,11
22023,1631117,22300152,"NOV 06, 2023",UTA @ CHI,L,31,5,12,0.417,1,2,0.5,4,6,0.667,11,4,15,0,0,4,1,3,15,-14,1,Walker Kessler,UTA,CHI,UTA,,,30,30,15,15
22023,1631117,22300138,"NOV 04, 2023",UTA @ MIN,L,22,2,3,0.667,0,0,0.0,0,0,0.0,1,3,4,0,0,3,0,0,4,-14,1,Walker Kessler,UTA,MIN,UTA,,,8,8,4,4
22023,1631117,22300130,"NOV 02, 2023",UTA vs. ORL,L,25,2,6,0.333,0,0,0.0,0,0,0.0,3,7,10,1,0,5,1,2,4,-10,1,Walker Kessler,UTA,UTA,ORL,,,15,14,5,11
22023,1631117,22300125,"NOV 01, 2023",UTA vs. MEM,W,18,1,4,0.25,0,0,0.0,2,4,0.5,1,3,4,0,0,2,0,2,4,-13,1,Walker Kessler,UTA,UTA,MEM,,,8,8,4,4
22023,1631117,22300110,"OCT 30, 2023",UTA @ DEN,L,29,10,11,0.909,0,0,0.0,2,3,0.667,3,10,13,0,0,1,2,4,22,-2,1,Walker Kessler,UTA,DEN,UTA,,,35,35,22,13
22023,1631117,22300094,"OCT 28, 2023",UTA @ PHX,L,23,1,4,0.25,0,2,0.0,0,0,0.0,2,3,5,1,0,1,3,3,2,-17,1,Walker Kessler,UTA,PHX,UTA,,,8,7,3,6
22023,1631117,22300085,"OCT 27, 2023",UTA vs. LAC,W,21,3,6,0.5,1,2,0.5,0,0,0.0,2,2,4,0,0,0,0,0,7,6,1,Walker Kessler,UTA,UTA,LAC,,,11,11,7,4
22023,1631117,22300072,"OCT 25, 2023",UTA vs. SAC,L,22,4,5,0.8,0,0,0.0,0,0,0.0,4,4,8,0,0,1,1,3,8,-14,1,Walker Kessler,UTA,UTA,SAC,,,16,16,8,8
22023,1630296,22300539,"JAN 12, 2024",DEN vs. NOP,W,1,0,0,0.0,0,0,0.0,0,0,0.0,0,0,0,0,0,0,1,0,0,-4,1,Braxton Key,DEN,DEN,NOP,,,0,0,0,0
22023,1630296,22300524,"JAN 10, 2024",DEN @ UTA,L,6,1,1,1.0,0,0,0.0,0,0,0.0,1,0,1,1,1,0,0,0,2,12,1,Braxton Key,DEN,UTA,DEN,,,4,3,3,2
22023,1630296,22300502,"JAN 07, 2024",DEN vs. DET,W,2,0,0,0.0,0,0,0.0,2,2,1.0,0,1,1,0,0,0,0,0,2,-6,1,Braxton Key,DEN,DEN,DET,,,3,3,2,1
22023,1630296,22300488,"JAN 05, 2024",DEN vs. ORL,L,6,1,3,0.333,1,2,0.5,0,0,0.0,0,2,2,1,0,0,0,1,3,6,1,Braxton Key,DEN,DEN,ORL,,,6,5,4,3
22023,1630296,22300455,"JAN 01, 2024",DEN vs. CHA,W,4,0,1,0.0,0,0,0.0,0,0,0.0,0,1,1,0,1,0,0,0,0,-6,1,Braxton Key,DEN,DEN,CHA,,,1,1,0,1
22023,1630296,22300435,"DEC 29, 2023",DEN vs. OKC,L,3,1,2,0.5,0,0,0.0,1,1,1.0,0,0,0,0,0,0,0,0,3,-6,1,Braxton Key,DEN,DEN,OKC,,,3,3,3,0
22023,1630296,22300425,"DEC 28, 2023",DEN vs. MEM,W,7,1,2,0.5,0,0,0.0,0,0,0.0,1,1,2,1,0,0,0,0,2,8,1,Braxton Key,DEN,DEN,MEM,,,5,4,3,3
22023,1630296,22300263,"NOV 29, 2023",DEN vs. HOU,W,3,0,0,0.0,0,0,0.0,1,2,0.5,0,1,1,1,0,0,0,1,1,-9,1,Braxton Key,DEN,DEN,HOU,,,3,2,2,2
22023,1630296,22300252,"NOV 26, 2023",DEN vs. SAS,W,2,0,1,0.0,0,1,0.0,0,0,0.0,0,1,1,1,0,0,0,0,0,-4,1,Braxton Key,DEN,DEN,SAS,,,2,1,1,2
22023,1630296,22300156,"NOV 06, 2023",DEN vs. NOP,W,1,0,0,0.0,0,0,0.0,0,0,0.0,0,0,0,0,0,0,0,0,0,3,1,Braxton Key,DEN,DEN,NOP,,,0,0,0,0
22023,1630296,22300123,"NOV 01, 2023",DEN @ MIN,L,5,0,2,0.0,0,0,0.0,0,0,0.0,0,0,0,3,0,0,0,2,0,0,1,Braxton Key,DEN,MIN,DEN,,,3,0,3,3
22023,1630296,22300095,"OCT 29, 2023",DEN @ OKC,W,3,1,2,0.5,0,1,0.0,0,0,0.0,0,1,1,0,0,0,0,0,2,0,1,Braxton Key,DEN,OKC,DEN,,,3,3,2,1
22023,1630296,22300061,"OCT 24, 2023",DEN vs. LAL,W,1,0,0,0.0,0,0,0.0,0,0,0.0,0,0,0,0,0,0,0,0,0,0,1,Braxton Key,DEN,DEN,LAL,,,0,0,0,0
22023,1630557,22300558,"JAN 15, 2024",WAS vs. DET,L,15,3,5,0.6,2,3,0.667,0,0,0.0,0,2,2,3,0,0,1,3,8,-6,1,Corey Kispert,WAS,WAS,DET,,,13,10,11,5
22023,1630557,22300543,"JAN 13, 2024",WAS @ ATL,W,18,4,8,0.5,3,5,0.6,0,0,0.0,1,3,4,2,0,0,1,3,11,8,1,Corey Kispert,WAS,ATL,WAS,,,17,15,13,6
22023,1630557,22300520,"JAN 10, 2024",WAS @ IND,L,30,6,11,0.545,3,8,0.375,0,0,0.0,2,1,3,2,0,0,1,0,15,-11,1,Corey Kispert,WAS,IND,WAS,,,20,18,17,5
22023,1630557,22300508,"JAN 08, 2024",WAS vs. OKC,L,18,4,5,0.8,3,4,0.75,0,0,0.0,0,1,1,2,0,0,1,1,11,-7,1,Corey Kispert,WAS,WAS,OKC,,,14,12,13,3
22023,1630557,22300494,"JAN 06, 2024",WAS vs. NYK,L,15,3,4,0.75,1,2,0.5,1,1,1.0,0,2,2,1,0,1,4,0,8,-20,1,Corey Kispert,WAS,WAS,NYK,,,11,10,9,3
22023,1630557,22300482,"JAN 05, 2024",WAS @ CLE,L,20,6,12,0.5,1,6,0.167,0,0,0.0,0,1,1,1,0,1,2,2,13,-7,1,Corey Kispert,WAS,CLE,WAS,,,15,14,14,2
22023,1630557,22300465,"JAN 03, 2024",WAS @ CLE,L,20,4,9,0.444,0,5,0.0,4,6,0.667,0,1,1,0,0,0,0,0,12,-21,1,Corey Kispert,WAS,CLE,WAS,,,13,13,12,1
22023,1630557,22300445,"DEC 31, 2023",WAS vs. ATL,L,18,5,10,0.5,1,5,0.2,4,5,0.8,0,0,0,4,0,0,0,0,15,-4,1,Corey Kispert,WAS,WAS,ATL,,,19,15,19,4
22023,1630557,22300430,"DEC 29, 2023",WAS vs. BKN,W,17,6,10,0.6,3,7,0.429,0,0,0.0,0,0,0,0,0,0,0,2,15,15,1,Corey Kispert,WAS,WAS,BKN,,,15,15,15,0
22023,1630557,22300416,"DEC 27, 2023",WAS vs. TOR,L,21,5,8,0.625,2,5,0.4,1,1,1.0,1,1,2,2,1,0,2,2,13,-13,1,Corey Kispert,WAS,WAS,TOR,,,17,15,15,4
22023,1630557,22300407,"DEC 26, 2023",WAS vs. ORL,L,19,6,8,0.75,3,5,0.6,0,2,0.0,0,4,4,1,0,0,0,1,15,6,1,Corey Kispert,WAS,WAS,ORL,,,20,19,16,5
22023,1630557,22300386,"DEC 22, 2023",WAS @ GSW,L,25,7,15,0.467,2,7,0.286,2,2,1.0,0,1,1,0,0,1,1,3,18,-20,1,Corey Kispert,WAS,GSW,WAS,,,19,19,18,1
22023,1630557,22300381,"DEC 21, 2023",WAS @ POR,W,22,3,8,0.375,2,6,0.333,1,1,1.0,0,0,0,2,0,0,0,0,9,0,1,Corey Kispert,WAS,POR,WAS,,,11,9,11,2
22023,1630557,22300358,"DEC 18, 2023",WAS @ SAC,L,21,2,6,0.333,2,5,0.4,1,2,0.5,0,3,3,3,0,0,2,1,7,4,1,Corey Kispert,WAS,SAC,WAS,,,13,10,10,6
22023,1630557,22300347,"DEC 17, 2023",WAS @ PHX,L,25,2,9,0.222,2,7,0.286,0,0,0.0,0,0,0,1,0,1,0,2,6,-16,1,Corey Kispert,WAS,PHX,WAS,,,7,6,7,1
22023,1630557,22300328,"DEC 15, 2023",WAS vs. IND,W,28,9,14,0.643,3,7,0.429,2,3,0.667,0,1,1,1,1,1,1,2,23,21,1,Corey Kispert,WAS,WAS,IND,,,25,24,24,2
22023,1630557,22300311,"DEC 13, 2023",WAS vs. NOP,L,21,4,7,0.571,3,6,0.5,1,2,0.5,0,3,3,0,0,1,1,2,12,-35,1,Corey Kispert,WAS,WAS,NOP,,,15,15,12,3
22023,1630557,22300295,"DEC 11, 2023",WAS @ PHI,L,23,3,6,0.5,1,3,0.333,2,4,0.5,1,1,2,1,0,0,3,4,9,-21,1,Corey Kispert,WAS,PHI,WAS,,,12,11,10,3
22023,1630557,22301219,"DEC 08, 2023",WAS @ BKN,L,21,3,11,0.273,1,7,0.143,0,0,0.0,0,2,2,2,0,1,0,2,7,-11,1,Corey Kispert,WAS,BKN,WAS,,,11,9,9,4
22023,1630557,22301208,"DEC 06, 2023",WAS vs. PHI,L,25,5,7,0.714,4,5,0.8,2,2,1.0,0,3,3,1,1,0,1,1,16,6,1,Corey Kispert,WAS,WAS,PHI,,,20,19,17,4
22023,1630557,22300274,"DEC 01, 2023",WAS @ ORL,L,23,4,11,0.364,4,6,0.667,3,4,0.75,0,1,1,3,0,0,0,2,15,-2,1,Corey Kispert,WAS,ORL,WAS,,,19,16,18,4
22023,1630557,22300259,"NOV 29, 2023",WAS @ ORL,L,20,4,7,0.571,2,5,0.4,3,5,0.6,0,1,1,2,2,0,1,1,13,-18,1,Corey Kispert,WAS,ORL,WAS,,,16,14,15,3
22023,1630557,22300253,"NOV 27, 2023",WAS @ DET,W,19,4,7,0.571,0,1,0.0,0,0,0.0,0,5,5,1,1,0,0,4,8,13,1,Corey Kispert,WAS,DET,WAS,,,14,13,9,6
22023,1630557,22300241,"NOV 25, 2023",WAS vs. ATL,L,28,3,14,0.214,1,10,0.1,3,3,1.0,0,1,1,2,0,0,0,2,10,-28,1,Corey Kispert,WAS,WAS,ATL,,,13,11,12,3
22023,1630557,22300049,"NOV 24, 2023",WAS @ MIL,L,33,7,12,0.583,6,10,0.6,0,0,0.0,0,5,5,1,0,0,3,3,20,-2,1,Corey Kispert,WAS,MIL,WAS,,,26,25,21,6
22023,1630557,22300225,"NOV 22, 2023",WAS @ CHA,L,18,2,7,0.286,1,4,0.25,1,1,1.0,1,3,4,1,0,0,1,1,6,-3,1,Corey Kispert,WAS,CHA,WAS,,,11,10,7,5
22023,1630557,22300219,"NOV 20, 2023",WAS vs. MIL,L,21,5,9,0.556,1,4,0.25,1,2,0.5,1,1,2,1,1,0,0,1,12,-7,1,Corey Kispert,WAS,WAS,MIL,,,15,14,13,3
22023,1630557,22300028,"NOV 17, 2023",WAS vs. NYK,L,26,3,5,0.6,1,3,0.333,1,1,1.0,2,1,3,1,1,0,0,1,8,1,1,Corey Kispert,WAS,WAS,NYK,,,12,11,9,4
22023,1630557,22300192,"NOV 15, 2023",WAS vs. DAL,L,26,3,8,0.375,3,7,0.429,3,4,0.75,0,1,1,4,0,0,0,3,12,2,1,Corey Kispert,WAS,WAS,DAL,,,17,13,16,5
22023,1630557,22300189,"NOV 13, 2023",WAS @ TOR,L,24,3,7,0.429,2,5,0.4,2,2,1.0,1,1,2,3,1,0,2,2,10,-7,1,Corey Kispert,WAS,TOR,WAS,,,15,12,13,5
22023,1630557,22300178,"NOV 12, 2023",WAS @ BKN,L,27,2,8,0.25,0,5,0.0,4,4,1.0,1,2,3,4,1,0,1,1,8,4,1,Corey Kispert,WAS,BKN,WAS,,,15,11,12,7
22023,1630557,22300009,"NOV 10, 2023",WAS vs. CHA,L,16,5,6,0.833,3,3,1.0,2,2,1.0,0,4,4,0,0,0,0,2,15,-6,1,Corey Kispert,WAS,WAS,CHA,,,19,19,15,4
22023,1630557,22300157,"NOV 08, 2023",WAS @ CHA,W,23,5,9,0.556,2,4,0.5,0,0,0.0,1,2,3,3,1,0,2,2,12,6,1,Corey Kispert,WAS,CHA,WAS,,,18,15,15,6
22023,1630557,22300148,"NOV 06, 2023",WAS @ PHI,L,14,0,2,0.0,0,2,0.0,3,4,0.75,0,1,1,0,0,0,2,2,3,-22,1,Corey Kispert,WAS,PHI,WAS,,,4,4,3,1
22023,1630557,22300117,"NOV 01, 2023",WAS @ ATL,L,14,1,5,0.2,0,4,0.0,0,0,0.0,0,0,0,1,0,0,0,1,2,0,1,Corey Kispert,WAS,ATL,WAS,,,3,2,3,1
22023,1630557,22300103,"OCT 30, 2023",WAS vs. BOS,L,24,3,6,0.5,3,6,0.5,0,2,0.0,0,2,2,0,0,0,2,1,9,-13,1,Corey Kispert,WAS,WAS,BOS,,,11,11,9,2
22023,1630557,22300089,"OCT 28, 2023",WAS vs. MEM,W,32,8,14,0.571,5,10,0.5,1,1,1.0,0,3,3,1,0,0,2,2,22,5,1,Corey Kispert,WAS,WAS,MEM,,,26,25,23,4
22023,1630557,22300064,"OCT 25, 2023",WAS @ IND,L,24,4,11,0.364,1,5,0.2,2,2,1.0,2,3,5,1,0,0,1,1,11,-8,1,Corey Kispert,WAS,IND,WAS,,,17,16,12,6
22023,1628467,22300556,"JAN 15, 2024",DAL vs. NOP,W,19,1,3,0.333,0,2,0.0,2,2,1.0,0,5,5,1,0,2,1,5,4,-12,1,Maxi Kleber,DAL,DAL,NOP,,,10,9,5,6
22023,1628467,22300547,"JAN 13, 2024",DAL vs. NOP,L,11,1,3,0.333,0,2,0.0,0,0,0.0,1,1,2,1,1,0,1,0,2,5,1,Maxi Kleber,DAL,DAL,NOP,,,5,4,3,3
22023,1628467,22300168,"NOV 08, 2023",DAL vs. TOR,L,15,0,0,0.0,0,0,0.0,4,8,0.5,0,2,2,4,0,0,2,2,4,-7,1,Maxi Kleber,DAL,DAL,TOR,,,10,6,8,6
22023,1628467,22300124,"NOV 01, 2023",DAL vs. CHI,W,4,0,2,0.0,0,1,0.0,0,0,0.0,0,2,2,0,0,0,0,0,0,-1,1,Maxi Kleber,DAL,DAL,CHI,,,2,2,0,2
22023,1628467,22300106,"OCT 30, 2023",DAL @ MEM,W,22,2,4,0.5,1,3,0.333,2,2,1.0,1,4,5,2,1,0,2,2,7,7,1,Maxi Kleber,DAL,MEM,DAL,,,14,12,9,7
22023,1628467,22300084,"OCT 27, 2023",DAL vs. BKN,W,26,0,3,0.0,0,0,0.0,0,0,0.0,1,4,5,2,0,0,0,1,0,10,1,Maxi Kleber,DAL,DAL,BKN,,,7,5,2,7
22023,1628467,22300073,"OCT 25, 2023",DAL @ SAS,W,23,2,7,0.286,2,5,0.4,0,0,0.0,2,5,7,2,0,1,0,3,6,-12,1,Maxi Kleber,DAL,SAS,DAL,,,15,13,8,9
22023,1628995,22300558,"JAN 15, 2024",DET @ WAS,W,33,1,7,0.143,1,4,0.25,2,2,1.0,2,0,2,1,0,0,1,0,5,7,1,Kevin Knox II,DET,WAS,DET,,,8,7,6,3
22023,1628995,22300534,"JAN 12, 2024",DET vs. HOU,L,35,7,9,0.778,2,4,0.5,3,3,1.0,0,7,7,2,1,2,1,1,19,-1,1,Kevin Knox II,DET,DET,HOU,,,28,26,21,9
22023,1628995,22300519,"JAN 10, 2024",DET vs. SAS,L,24,5,11,0.455,2,5,0.4,0,0,0.0,3,1,4,0,0,0,0,2,12,-17,1,Kevin Knox II,DET,DET,SAS,,,16,16,12,4
22023,1628995,22300512,"JAN 09, 2024",DET vs. SAC,L,20,3,8,0.375,1,4,0.25,1,1,1.0,1,1,2,1,1,0,2,1,8,-5,1,Kevin Knox II,DET,DET,SAC,,,11,10,9,3
22023,1628995,22300502,"JAN 07, 2024",DET @ DEN,L,20,4,8,0.5,1,3,0.333,3,4,0.75,2,1,3,1,0,0,0,0,12,-13,1,Kevin Knox II,DET,DEN,DET,,,16,15,13,4
22023,1628995,22300490,"JAN 05, 2024",DET @ GSW,L,23,7,13,0.538,4,8,0.5,0,0,0.0,0,1,1,3,1,2,0,3,18,-6,1,Kevin Knox II,DET,GSW,DET,,,22,19,21,4
22023,1628995,22300474,"JAN 03, 2024",DET @ UTA,L,13,2,5,0.4,0,2,0.0,0,0,0.0,1,0,1,2,0,0,0,1,4,6,1,Kevin Knox II,DET,UTA,DET,,,7,5,6,3
22023,1628995,22300453,"JAN 01, 2024",DET @ HOU,L,23,4,7,0.571,1,4,0.25,2,2,1.0,0,3,3,0,0,0,0,2,11,-5,1,Kevin Knox II,DET,HOU,DET,,,14,14,11,3
22023,1628995,22300440,"DEC 30, 2023",DET vs. TOR,W,31,7,14,0.5,3,8,0.375,0,0,0.0,0,2,2,2,1,1,1,2,17,1,1,Kevin Knox II,DET,DET,TOR,,,21,19,19,4
22023,1628995,22300421,"DEC 28, 2023",DET @ BOS,L,18,3,9,0.333,0,6,0.0,0,0,0.0,0,2,2,0,1,0,0,3,6,9,1,Kevin Knox II,DET,BOS,DET,,,8,8,6,2
22023,1628995,22300406,"DEC 26, 2023",DET vs. BKN,L,12,1,4,0.25,0,1,0.0,1,1,1.0,1,2,3,0,0,0,1,2,3,-11,1,Kevin Knox II,DET,DET,BKN,,,6,6,3,3
22023,1628995,22300394,"DEC 23, 2023",DET @ BKN,L,24,5,6,0.833,3,3,1.0,1,1,1.0,0,1,1,0,0,0,0,2,14,-11,1,Kevin Knox II,DET,BKN,DET,,,15,15,14,1
22023,1628995,22300334,"DEC 16, 2023",DET @ MIL,L,9,0,2,0.0,0,1,0.0,0,0,0.0,0,0,0,0,1,0,0,2,0,0,1,Kevin Knox II,DET,MIL,DET,,,0,0,0,0
22023,1628995,22300310,"DEC 13, 2023",DET vs. PHI,L,10,2,5,0.4,1,4,0.25,2,2,1.0,0,2,2,2,0,1,2,0,7,8,1,Kevin Knox II,DET,DET,PHI,,,11,9,9,4
22023,1628995,22300293,"DEC 11, 2023",DET vs. IND,L,1,0,0,0.0,0,0,0.0,0,0,0.0,0,0,0,0,0,0,0,0,0,-2,1,Kevin Knox II,DET,DET,IND,,,0,0,0,0
22023,1628995,22301217,"DEC 08, 2023",DET @ ORL,L,5,0,0,0.0,0,0,0.0,0,0,0.0,0,1,1,0,0,0,1,0,0,-3,1,Kevin Knox II,DET,ORL,DET,,,1,1,0,1
22023,1628995,22300268,"NOV 30, 2023",DET @ NYK,L,9,1,3,0.333,0,2,0.0,1,1,1.0,0,0,0,0,0,0,2,1,3,-10,1,Kevin Knox II,DET,NYK,DET,,,3,3,3,0
22023,1628995,22300258,"NOV 29, 2023",DET vs. LAL,L,6,1,1,1.0,1,1,1.0,0,0,0.0,0,0,0,0,0,0,0,0,3,4,1,Kevin Knox II,DET,DET,LAL,,,3,3,3,0
22023,1628995,22300211,"NOV 19, 2023",DET @ TOR,L,26,2,11,0.182,1,5,0.2,1,2,0.5,1,3,4,0,1,0,2,3,6,-22,1,Kevin Knox II,DET,TOR,DET,,,10,10,6,4
22023,1628995,22300030,"NOV 17, 2023",DET @ CLE,L,31,5,10,0.5,1,4,0.25,0,0,0.0,3,7,10,1,2,1,0,3,11,15,1,Kevin Knox II,DET,CLE,DET,,,22,21,12,11
22023,1628995,22300018,"NOV 14, 2023",DET vs. ATL,L,29,5,8,0.625,2,4,0.5,0,0,0.0,1,3,4,1,0,0,2,3,12,-6,1,Kevin Knox II,DET,DET,ATL,,,17,16,13,5
22023,1628995,22300181,"NOV 12, 2023",DET @ CHI,L,24,7,8,0.875,4,5,0.8,0,0,0.0,0,3,3,1,1,0,0,2,18,-3,1,Kevin Knox II,DET,CHI,DET,,,22,21,19,4
22023,1629723,22300544,"JAN 13, 2024",MEM vs. NYK,L,20,0,4,0.0,0,3,0.0,0,0,0.0,1,2,3,1,1,2,0,1,0,-9,1,John Konchar,MEM,MEM,NYK,,,4,3,1,4
22023,1629723,22300537,"JAN 12, 2024",MEM vs. LAC,L,6,0,1,0.0,0,1,0.0,0,0,0.0,0,1,1,1,0,0,0,1,0,-11,1,John Konchar,MEM,MEM,LAC,,,2,1,1,2
22023,1629723,22300515,"JAN 09, 2024",MEM @ DAL,W,25,1,3,0.333,0,2,0.0,2,2,1.0,3,4,7,3,0,1,0,0,4,18,1,John Konchar,MEM,DAL,MEM,,,14,11,7,10
22023,1629723,22300503,"JAN 07, 2024",MEM @ PHX,W,3,0,1,0.0,0,1,0.0,0,0,0.0,0,1,1,0,0,0,0,0,0,-5,1,John Konchar,MEM,PHX,MEM,,,1,1,0,1
22023,1629723,22300470,"JAN 03, 2024",MEM vs. TOR,L,8,0,2,0.0,0,0,0.0,0,0,0.0,0,2,2,1,2,1,1,0,0,2,1,John Konchar,MEM,MEM,TOR,,,3,2,1,3
22023,1629723,22300460,"JAN 02, 2024",MEM vs. SAS,W,0,0,0,0.0,0,0,0.0,0,0,0.0,0,0,0,0,0,0,0,0,0,-4,1,John Konchar,MEM,MEM,SAS,,,0,0,0,0
22023,1629723,22300449,"DEC 31, 2023",MEM vs. SAC,L,5,0,0,0.0,0,0,0.0,0,0,0.0,0,0,0,0,0,0,0,0,0,-6,1,John Konchar,MEM,MEM,SAC,,,0,0,0,0
22023,1629723,22300425,"DEC 28, 2023",MEM @ DEN,L,25,4,9,0.444,1,5,0.2,1,1,1.0,3,4,7,3,2,1,1,1,10,-30,1,John Konchar,MEM,DEN,MEM,,,20,17,13,10
22023,1629723,22300393,"DEC 23, 2023",MEM @ ATL,W,13,2,3,0.667,1,2,0.5,0,0,0.0,1,4,5,2,0,2,0,1,5,3,1,John Konchar,MEM,ATL,MEM,,,12,10,7,7
22023,1629723,22300377,"DEC 21, 2023",MEM vs. IND,W,21,2,4,0.5,2,4,0.5,0,0,0.0,1,5,6,1,1,2,0,1,6,11,1,John Konchar,MEM,MEM,IND,,,13,12,7,7
22023,1629723,22300360,"DEC 19, 2023",MEM @ NOP,W,22,0,2,0.0,0,2,0.0,0,0,0.0,1,7,8,0,0,0,1,3,0,-6,1,John Konchar,MEM,NOP,MEM,,,8,8,0,8
22023,1629723,22300355,"DEC 18, 2023",MEM @ OKC,L,17,1,3,0.333,1,3,0.333,2,2,1.0,1,1,2,2,2,0,2,2,5,-20,1,John Konchar,MEM,OKC,MEM,,,9,7,7,4
22023,1629723,22300314,"DEC 13, 2023",MEM @ HOU,L,7,0,1,0.0,0,1,0.0,0,0,0.0,0,0,0,1,1,0,0,0,0,-13,1,John Konchar,MEM,HOU,MEM,,,1,0,1,1
22023,1629723,22300299,"DEC 11, 2023",MEM vs. DAL,L,25,2,5,0.4,2,5,0.4,0,0,0.0,2,4,6,2,1,1,2,2,6,-2,1,John Konchar,MEM,MEM,DAL,,,14,12,8,8
22023,1629723,22301221,"DEC 08, 2023",MEM vs. MIN,L,17,1,5,0.2,1,4,0.25,0,0,0.0,0,3,3,0,1,1,0,1,3,-13,1,John Konchar,MEM,MEM,MIN,,,6,6,3,3
22023,1629723,22301206,"DEC 06, 2023",MEM @ DET,W,22,3,4,0.75,2,2,1.0,1,2,0.5,1,6,7,2,2,1,0,0,9,22,1,John Konchar,MEM,DET,MEM,,,18,16,11,9
22023,1629723,22300288,"DEC 02, 2023",MEM @ PHX,L,20,2,5,0.4,0,2,0.0,2,2,1.0,2,2,4,0,1,1,2,0,6,-2,1,John Konchar,MEM,PHX,MEM,,,10,10,6,4
22023,1629723,22300277,"DEC 01, 2023",MEM @ DAL,W,2,0,0,0.0,0,0,0.0,0,0,0.0,0,0,0,0,0,0,0,1,0,-4,1,John Konchar,MEM,DAL,MEM,,,0,0,0,0
22023,1629723,22300249,"NOV 26, 2023",MEM vs. MIN,L,2,0,0,0.0,0,0,0.0,0,0,0.0,0,0,0,0,0,0,0,0,0,-3,1,John Konchar,MEM,MEM,MIN,,,0,0,0,0
22023,1629723,22300044,"NOV 24, 2023",MEM vs. PHX,L,18,0,2,0.0,0,1,0.0,1,2,0.5,0,3,3,1,0,0,0,1,1,-3,1,John Konchar,MEM,MEM,PHX,,,5,4,2,4
22023,1629723,22300231,"NOV 22, 2023",MEM @ HOU,L,29,0,6,0.0,0,4,0.0,0,0,0.0,5,6,11,2,0,2,0,3,0,-11,1,John Konchar,MEM,HOU,MEM,,,13,11,2,13
22023,1629723,22300213,"NOV 19, 2023",MEM vs. BOS,L,26,1,3,0.333,0,0,0.0,0,0,0.0,2,3,5,3,1,1,1,2,2,-13,1,John Konchar,MEM,MEM,BOS,,,10,7,5,8
22023,1629723,22300206,"NOV 18, 2023",MEM @ SAS,W,23,2,5,0.4,1,4,0.25,0,0,0.0,0,3,3,2,1,1,1,2,5,-7,1,John Konchar,MEM,SAS,MEM,,,10,8,7,5
22023,1629723,22300026,"NOV 14, 2023",MEM @ LAL,L,18,2,4,0.5,2,3,0.667,0,0,0.0,1,2,3,6,1,0,0,1,6,0,1,John Konchar,MEM,LAL,MEM,,,15,9,12,9
22023,1629723,22300179,"NOV 12, 2023",MEM @ LAC,W,5,0,1,0.0,0,1,0.0,0,0,0.0,0,2,2,0,0,0,1,2,0,-12,1,John Konchar,MEM,LAC,MEM,,,2,2,0,2
22023,1629723,22300012,"NOV 10, 2023",MEM vs. UTA,L,21,2,6,0.333,2,4,0.5,0,0,0.0,0,1,1,2,2,0,0,0,6,-7,1,John Konchar,MEM,MEM,UTA,,,9,7,8,3
22023,1629723,22300007,"NOV 03, 2023",MEM @ POR,L,11,1,2,0.5,0,0,0.0,0,0,0.0,0,1,1,0,0,1,0,0,2,13,1,John Konchar,MEM,POR,MEM,,,3,3,2,1
22023,1629723,22300125,"NOV 01, 2023",MEM @ UTA,L,18,3,6,0.5,1,2,0.5,0,0,0.0,3,4,7,2,0,0,0,1,7,-8,1,John Konchar,MEM,UTA,MEM,,,16,14,9,9
22023,1629723,22300106,"OCT 30, 2023",MEM vs. DAL,L,19,1,2,0.5,1,2,0.5,0,0,0.0,1,3,4,1,0,0,0,2,3,-3,1,John Konchar,MEM,MEM,DAL,,,8,7,4,5
22023,1629723,22300089,"OCT 28, 2023",MEM @ WAS,L,22,2,4,0.5,1,3,0.333,0,0,0.0,3,6,9,1,2,2,1,0,5,1,1,John Konchar,MEM,WAS,MEM,,,15,14,6,10
22023,1629723,22300078,"OCT 27, 2023",MEM vs. DEN,L,30,1,2,0.5,0,1,0.0,0,0,0.0,0,6,6,2,1,2,0,1,2,3,1,John Konchar,MEM,MEM,DEN,,,10,8,4,8
22023,1627788,22300555,"JAN 15, 2024",PHI vs. HOU,W,6,1,2,0.5,0,0,0.0,0,1,0.0,0,0,0,0,0,0,0,0,2,-10,1,Furkan Korkmaz,PHI,PHI,HOU,,,2,2,2,0
22023,1627788,22300532,"JAN 12, 2024",PHI vs. SAC,W,3,1,3,0.333,1,2,0.5,0,0,0.0,0,0,0,0,1,0,0,0,3,1,1,Furkan Korkmaz,PHI,PHI,SAC,,,3,3,3,0
22023,1627788,22300442,"DEC 30, 2023",PHI @ CHI,L,2,1,1,1.0,0,0,0.0,0,0,0.0,0,0,0,0,0,0,0,0,2,5,1,Furkan Korkmaz,PHI,CHI,PHI,,,2,2,2,0
22023,1627788,22300382,"DEC 22, 2023",PHI vs. TOR,W,7,1,1,1.0,0,0,0.0,0,0,0.0,0,1,1,0,0,0,0,0,2,-7,1,Furkan Korkmaz,PHI,PHI,TOR,,,3,3,2,1
22023,1627788,22300367,"DEC 20, 2023",PHI vs. MIN,W,2,0,1,0.0,0,0,0.0,0,0,0.0,0,0,0,0,0,0,0,0,0,2,1,Furkan Korkmaz,PHI,PHI,MIN,,,0,0,0,0
22023,1627788,22300335,"DEC 16, 2023",PHI @ CHA,W,4,0,0,0.0,0,0,0.0,0,0,0.0,0,0,0,1,0,0,0,0,0,6,1,Furkan Korkmaz,PHI,CHA,PHI,,,1,0,1,1
22023,1627788,22300327,"DEC 15, 2023",PHI vs. DET,W,7,1,3,0.333,1,3,0.333,0,0,0.0,0,1,1,1,0,0,0,1,3,-6,1,Furkan Korkmaz,PHI,PHI,DET,,,5,4,4,2
22023,1627788,22300310,"DEC 13, 2023",PHI @ DET,W,5,0,1,0.0,0,1,0.0,0,0,0.0,0,0,0,0,0,0,0,0,0,-6,1,Furkan Korkmaz,PHI,DET,PHI,,,0,0,0,0
22023,1627788,22300295,"DEC 11, 2023",PHI vs. WAS,W,9,0,0,0.0,0,0,0.0,2,2,1.0,0,0,0,2,1,0,1,1,2,4,1,Furkan Korkmaz,PHI,PHI,WAS,,,4,2,4,2
22023,1627788,22300275,"DEC 01, 2023",PHI @ BOS,L,15,0,4,0.0,0,3,0.0,0,0,0.0,0,1,1,0,1,0,0,3,0,4,1,Furkan Korkmaz,PHI,BOS,PHI,,,1,1,0,1
22023,1627788,22300262,"NOV 29, 2023",PHI @ NOP,L,2,0,0,0.0,0,0,0.0,0,0,0.0,0,0,0,0,0,0,0,0,0,6,1,Furkan Korkmaz,PHI,NOP,PHI,,,0,0,0,0
22023,1627788,22300255,"NOV 27, 2023",PHI vs. LAL,W,5,2,4,0.5,0,1,0.0,1,1,1.0,0,0,0,3,2,0,0,0,5,13,1,Furkan Korkmaz,PHI,PHI,LAL,,,8,5,8,3
22023,1627788,22300232,"NOV 22, 2023",PHI @ MIN,L,6,1,2,0.5,1,2,0.5,0,0,0.0,0,1,1,0,1,0,0,0,3,8,1,Furkan Korkmaz,PHI,MIN,PHI,,,4,4,3,1
22023,1627788,22300208,"NOV 19, 2023",PHI @ BKN,W,4,1,3,0.333,0,2,0.0,1,1,1.0,0,0,0,0,0,0,0,1,3,-1,1,Furkan Korkmaz,PHI,BKN,PHI,,,3,3,3,0
22023,1627788,22300194,"NOV 15, 2023",PHI vs. BOS,L,3,0,1,0.0,0,1,0.0,0,0,0.0,0,0,0,0,0,0,0,0,0,-8,1,Furkan Korkmaz,PHI,PHI,BOS,,,0,0,0,0
22023,1627788,22300019,"NOV 14, 2023",PHI vs. IND,L,2,0,0,0.0,0,0,0.0,0,0,0.0,0,0,0,0,0,0,1,0,0,2,1,Furkan Korkmaz,PHI,PHI,IND,,,0,0,0,0
22023,1627788,22300180,"NOV 12, 2023",PHI vs. IND,W,5,0,1,0.0,0,0,0.0,0,0,0.0,0,0,0,0,1,0,1,0,0,-2,1,Furkan Korkmaz,PHI,PHI,IND,,,0,0,0,0
22023,1627788,22300008,"NOV 10, 2023",PHI @ DET,W,2,0,1,0.0,0,0,0.0,0,0,0.0,0,0,0,0,0,0,0,0,0,-9,1,Furkan Korkmaz,PHI,DET,PHI,,,0,0,0,0
22023,1627788,22300159,"NOV 08, 2023",PHI vs. BOS,W,3,0,2,0.0,0,0,0.0,0,0,0.0,0,0,0,0,0,0,1,0,0,-4,1,Furkan Korkmaz,PHI,PHI,BOS,,,0,0,0,0
22023,1627788,22300148,"NOV 06, 2023",PHI vs. WAS,W,14,0,2,0.0,0,2,0.0,1,2,0.5,1,2,3,2,0,0,1,1,1,6,1,Furkan Korkmaz,PHI,PHI,WAS,,,6,4,3,5
22023,1627788,22300132,"NOV 04, 2023",PHI vs. PHX,W,18,2,2,1.0,1,1,1.0,0,0,0.0,0,2,2,1,1,0,1,2,5,-3,1,Furkan Korkmaz,PHI,PHI,PHX,,,8,7,6,3
22023,1627788,22300128,"NOV 02, 2023",PHI vs. TOR,W,22,4,7,0.571,1,2,0.5,1,1,1.0,0,1,1,0,3,0,1,0,10,16,1,Furkan Korkmaz,PHI,PHI,TOR,,,11,11,10,1
22023,1627788,22300098,"OCT 29, 2023",PHI vs. POR,W,3,1,1,1.0,1,1,1.0,1,2,0.5,0,0,0,0,0,0,0,0,4,3,1,Furkan Korkmaz,PHI,PHI,POR,,,4,4,4,0
22023,1628436,22300563,"JAN 15, 2024",BOS @ TOR,W,18,2,2,1.0,0,0,0.0,0,0,0.0,0,3,3,0,0,1,0,1,4,12,1,Luke Kornet,BOS,TOR,BOS,,,7,7,4,3
22023,1628436,22300542,"JAN 13, 2024",BOS vs. HOU,W,14,1,2,0.5,0,0,0.0,0,0,0.0,1,1,2,0,0,1,0,5,2,0,1,Luke Kornet,BOS,BOS,HOU,,,4,4,2,2
22023,1628436,22300528,"JAN 11, 2024",BOS @ MIL,L,10,0,0,0.0,0,0,0.0,0,0,0.0,0,0,0,1,0,0,0,1,0,-16,1,Luke Kornet,BOS,MIL,BOS,,,1,0,1,1
22023,1628436,22300517,"JAN 10, 2024",BOS vs. MIN,W,18,3,4,0.75,0,0,0.0,2,2,1.0,2,3,5,0,0,1,0,1,8,6,1,Luke Kornet,BOS,BOS,MIN,,,13,13,8,5
22023,1628436,22300507,"JAN 08, 2024",BOS @ IND,L,10,1,4,0.25,0,0,0.0,3,4,0.75,2,0,2,2,0,2,1,2,5,-3,1,Luke Kornet,BOS,IND,BOS,,,9,7,7,4
22023,1628436,22300493,"JAN 06, 2024",BOS @ IND,W,16,1,2,0.5,0,0,0.0,2,2,1.0,3,1,4,3,1,0,1,1,4,3,1,Luke Kornet,BOS,IND,BOS,,,11,8,7,7
22023,1628436,22300479,"JAN 05, 2024",BOS vs. UTA,W,11,1,3,0.333,0,0,0.0,0,0,0.0,4,3,7,0,1,1,1,1,2,13,1,Luke Kornet,BOS,BOS,UTA,,,9,9,2,7
22023,1628436,22300462,"JAN 02, 2024",BOS @ OKC,L,15,0,2,0.0,0,0,0.0,0,0,0.0,2,0,2,0,1,1,0,0,0,-1,1,Luke Kornet,BOS,OKC,BOS,,,2,2,0,2
22023,1628436,22300448,"DEC 31, 2023",BOS @ SAS,W,16,5,7,0.714,0,0,0.0,2,2,1.0,3,1,4,2,0,2,0,1,12,6,1,Luke Kornet,BOS,SAS,BOS,,,18,16,14,6
22023,1628436,22300432,"DEC 29, 2023",BOS vs. TOR,W,33,9,11,0.818,0,0,0.0,2,2,1.0,5,3,8,3,0,3,1,3,20,-2,1,Luke Kornet,BOS,BOS,TOR,,,31,28,23,11
22023,1628436,22300305,"DEC 12, 2023",BOS vs. CLE,W,8,1,3,0.333,0,0,0.0,2,2,1.0,3,1,4,0,0,0,0,0,4,2,1,Luke Kornet,BOS,BOS,CLE,,,8,8,4,4
22023,1628436,22301227,"DEC 08, 2023",BOS vs. NYK,W,11,2,3,0.667,0,0,0.0,0,0,0.0,1,0,1,1,0,0,0,0,4,-8,1,Luke Kornet,BOS,BOS,NYK,,,6,5,5,2
22023,1628436,22301202,"DEC 04, 2023",BOS @ IND,L,17,3,5,0.6,0,0,0.0,0,0,0.0,4,0,4,2,1,4,1,2,6,-8,1,Luke Kornet,BOS,IND,BOS,,,12,10,8,6
22023,1628436,22300275,"DEC 01, 2023",BOS vs. PHI,W,8,0,0,0.0,0,0,0.0,0,0,0.0,0,1,1,0,0,0,0,1,0,-9,1,Luke Kornet,BOS,BOS,PHI,,,1,1,0,1
22023,1628436,22300053,"NOV 28, 2023",BOS vs. CHI,W,19,2,3,0.667,0,0,0.0,0,0,0.0,2,1,3,0,0,3,1,3,4,9,1,Luke Kornet,BOS,BOS,CHI,,,7,7,4,3
22023,1628436,22300246,"NOV 26, 2023",BOS vs. ATL,W,9,2,2,1.0,0,0,0.0,0,0,0.0,1,1,2,0,1,1,0,1,4,-6,1,Luke Kornet,BOS,BOS,ATL,,,6,6,4,2
22023,1628436,22300043,"NOV 24, 2023",BOS @ ORL,L,25,5,6,0.833,0,0,0.0,2,2,1.0,2,4,6,1,2,2,1,2,12,-2,1,Luke Kornet,BOS,ORL,BOS,,,19,18,13,7
22023,1628436,22300217,"NOV 20, 2023",BOS @ CHA,L,19,2,2,1.0,0,0,0.0,0,0,0.0,0,3,3,0,0,1,0,0,4,25,1,Luke Kornet,BOS,CHA,BOS,,,7,7,4,3
22023,1628436,22300194,"NOV 15, 2023",BOS @ PHI,W,19,4,4,1.0,0,0,0.0,1,2,0.5,3,3,6,1,1,0,2,2,9,-4,1,Luke Kornet,BOS,PHI,BOS,,,16,15,10,7
22023,1628436,22300174,"NOV 11, 2023",BOS vs. TOR,W,9,1,1,1.0,0,0,0.0,0,0,0.0,0,5,5,1,0,0,0,1,2,3,1,Luke Kornet,BOS,BOS,TOR,,,8,7,3,6
22023,1628436,22300010,"NOV 10, 2023",BOS vs. BKN,W,18,3,5,0.6,0,0,0.0,1,1,1.0,6,3,9,1,0,1,0,1,7,-2,1,Luke Kornet,BOS,BOS,BKN,,,17,16,8,10
22023,1628436,22300159,"NOV 08, 2023",BOS @ PHI,L,3,0,0,0.0,0,0,0.0,0,0,0.0,0,0,0,0,0,0,0,0,0,-3,1,Luke Kornet,BOS,PHI,BOS,,,0,0,0,0
22023,1628436,22300154,"NOV 06, 2023",BOS @ MIN,L,16,1,2,0.5,0,0,0.0,3,4,0.75,1,0,1,0,2,0,0,2,5,4,1,Luke Kornet,BOS,MIN,BOS,,,6,6,5,1
22023,1628436,22300136,"NOV 04, 2023",BOS @ BKN,W,15,5,5,1.0,0,0,0.0,1,1,1.0,0,7,7,0,1,0,0,3,11,7,1,Luke Kornet,BOS,BKN,BOS,,,18,18,11,7
22023,1628436,22300118,"NOV 01, 2023",BOS vs. IND,W,6,1,1,1.0,0,0,0.0,0,0,0.0,1,1,2,0,0,0,0,0,2,7,1,Luke Kornet,BOS,BOS,IND,,,4,4,2,2
22023,1628436,22300103,"OCT 30, 2023",BOS @ WAS,W,11,0,0,0.0,0,0,0.0,0,0,0.0,0,1,1,1,0,0,1,1,0,-11,1,Luke Kornet,BOS,WAS,BOS,,,2,1,1,2
22023,1628436,22300065,"OCT 25, 2023",BOS @ NYK,W,8,0,1,0.0,0,0,0.0,0,0,0.0,1,0,1,2,0,1,0,0,0,-1,1,Luke Kornet,BOS,NYK,BOS,,,3,1,2,3
22023,1630228,22300560,"JAN 15, 2024",GSW @ MEM,L,29,9,18,0.5,1,5,0.2,1,1,1.0,2,9,11,0,0,0,3,3,20,-9,1,Jonathan Kuminga,GSW,MEM,GSW,,,31,31,20,11
22023,1630228,22300545,"JAN 13, 2024",GSW @ MIL,L,30,10,18,0.556,2,3,0.667,6,6,1.0,0,3,3,2,1,1,0,2,28,-18,1,Jonathan Kuminga,GSW,MIL,GSW,,,33,31,30,5
22023,1630228,22300536,"JAN 12, 2024",GSW @ CHI,W,24,9,12,0.75,4,4,1.0,2,3,0.667,0,5,5,1,1,0,0,2,24,6,1,Jonathan Kuminga,GSW,CHI,GSW,,,30,29,25,6
22023,1630228,22300525,"JAN 10, 2024",GSW vs. NOP,L,28,4,7,0.571,0,1,0.0,4,6,0.667,0,3,3,4,0,1,3,3,12,-20,1,Jonathan Kuminga,GSW,GSW,NOP,,,19,15,16,7
22023,1630228,22300504,"JAN 07, 2024",GSW vs. TOR,L,25,5,13,0.385,1,5,0.2,2,2,1.0,1,3,4,4,1,1,1,0,13,-5,1,Jonathan Kuminga,GSW,GSW,TOR,,,21,17,17,8
22023,1630228,22300490,"JAN 05, 2024",GSW vs. DET,W,36,4,8,0.5,0,1,0.0,3,3,1.0,0,6,6,1,0,0,4,2,11,16,1,Jonathan Kuminga,GSW,GSW,DET,,,18,17,12,7
22023,1630228,22300478,"JAN 04, 2024",GSW vs. DEN,L,19,5,7,0.714,0,1,0.0,6,7,0.857,1,3,4,4,0,0,1,1,16,6,1,Jonathan Kuminga,GSW,GSW,DEN,,,24,20,20,8
22023,1630228,22300463,"JAN 02, 2024",GSW vs. ORL,W,34,7,14,0.5,1,5,0.2,4,5,0.8,2,4,6,4,0,2,1,2,19,10,1,Jonathan Kuminga,GSW,GSW,ORL,,,29,25,23,10
22023,1630228,22300444,"DEC 30, 2023",GSW vs. DAL,L,25,6,12,0.5,1,5,0.2,3,4,0.75,5,4,9,3,1,0,1,3,16,-9,1,Jonathan Kuminga,GSW,GSW,DAL,,,28,25,19,12
22023,1630228,22300426,"DEC 28, 2023",GSW vs. MIA,L,24,5,11,0.455,0,3,0.0,0,0,0.0,1,4,5,1,0,0,6,0,10,-26,1,Jonathan Kuminga,GSW,GSW,MIA,,,16,15,11,6
22023,1630228,22300402,"DEC 25, 2023",GSW @ DEN,L,23,4,8,0.5,0,1,0.0,5,8,0.625,0,5,5,2,0,0,1,1,13,-24,1,Jonathan Kuminga,GSW,DEN,GSW,,,20,18,15,7
22023,1630228,22300399,"DEC 23, 2023",GSW vs. POR,W,30,3,7,0.429,0,2,0.0,5,5,1.0,1,5,6,5,0,0,0,0,11,18,1,Jonathan Kuminga,GSW,GSW,POR,,,22,17,16,11
22023,1630228,22300386,"DEC 22, 2023",GSW vs. WAS,W,27,9,11,0.818,1,2,0.5,3,3,1.0,2,2,4,3,1,0,1,2,22,9,1,Jonathan Kuminga,GSW,GSW,WAS,,,29,26,25,7
22023,1630228,22300362,"DEC 19, 2023",GSW vs. BOS,W,34,8,13,0.615,1,4,0.25,0,2,0.0,4,3,7,2,2,0,1,0,17,3,1,Jonathan Kuminga,GSW,GSW,BOS,,,26,24,19,9
22023,1630228,22300348,"DEC 17, 2023",GSW @ POR,W,19,5,7,0.714,2,3,0.667,0,4,0.0,2,2,4,0,1,0,1,3,12,4,1,Jonathan Kuminga,GSW,POR,GSW,,,16,16,12,4
22023,1630228,22300339,"DEC 16, 2023",GSW vs. BKN,W,21,3,6,0.5,0,0,0.0,4,4,1.0,2,2,4,2,0,1,1,1,10,4,1,Jonathan Kuminga,GSW,GSW,BKN,,,16,14,12,6
22023,1630228,22300325,"DEC 14, 2023",GSW @ LAC,L,25,5,10,0.5,2,3,0.667,3,3,1.0,0,5,5,1,1,0,1,4,15,5,1,Jonathan Kuminga,GSW,LAC,GSW,,,21,20,16,6
22023,1630228,22300308,"DEC 12, 2023",GSW @ PHX,L,29,6,10,0.6,1,3,0.333,3,7,0.429,2,4,6,0,1,0,1,4,16,13,1,Jonathan Kuminga,GSW,PHX,GSW,,,22,22,16,6
22023,1630228,22301222,"DEC 08, 2023",GSW @ OKC,L,29,10,21,0.476,3,6,0.5,1,1,1.0,6,6,12,0,0,0,3,6,24,-15,1,Jonathan Kuminga,GSW,OKC,GSW,,,36,36,24,12
22023,1630228,22301214,"DEC 06, 2023",GSW vs. POR,W,17,6,6,1.0,0,0,0.0,1,2,0.5,0,1,1,1,2,0,0,2,13,13,1,Jonathan Kuminga,GSW,GSW,POR,,,15,14,14,2
22023,1630228,22300280,"DEC 02, 2023",GSW @ LAC,L,16,2,6,0.333,1,3,0.333,1,2,0.5,0,2,2,0,0,0,1,0,6,5,1,Jonathan Kuminga,GSW,LAC,GSW,,,8,8,6,2
22023,1630228,22300273,"NOV 30, 2023",GSW vs. LAC,W,23,6,8,0.75,3,5,0.6,2,4,0.5,1,5,6,3,1,1,1,0,17,13,1,Jonathan Kuminga,GSW,GSW,LAC,,,26,23,20,9
22023,1630228,22300060,"NOV 28, 2023",GSW @ SAC,L,10,0,3,0.0,0,1,0.0,0,0,0.0,0,1,1,0,0,0,2,3,0,4,1,Jonathan Kuminga,GSW,SAC,GSW,,,1,1,0,1
22023,1630228,22300051,"NOV 24, 2023",GSW vs. SAS,W,20,5,7,0.714,1,2,0.5,1,2,0.5,0,1,1,2,0,0,1,0,12,-1,1,Jonathan Kuminga,GSW,GSW,SAS,,,15,13,14,3
22023,1630228,22300236,"NOV 22, 2023",GSW @ PHX,L,21,3,7,0.429,0,1,0.0,1,2,0.5,0,1,1,2,1,0,0,5,7,-1,1,Jonathan Kuminga,GSW,PHX,GSW,,,10,8,9,3
22023,1630228,22300224,"NOV 20, 2023",GSW vs. HOU,W,18,3,7,0.429,1,3,0.333,0,2,0.0,0,3,3,1,0,0,1,3,7,8,1,Jonathan Kuminga,GSW,GSW,HOU,,,11,10,8,4
22023,1630228,22300207,"NOV 18, 2023",GSW vs. OKC,L,20,6,10,0.6,0,2,0.0,1,2,0.5,2,3,5,2,1,1,3,2,13,-18,1,Jonathan Kuminga,GSW,GSW,OKC,,,20,18,15,7
22023,1630228,22300201,"NOV 16, 2023",GSW vs. OKC,L,27,8,13,0.615,1,4,0.25,4,5,0.8,0,6,6,2,0,1,4,0,21,-11,1,Jonathan Kuminga,GSW,GSW,OKC,,,29,27,23,8
22023,1630228,22300025,"NOV 14, 2023",GSW vs. MIN,L,16,2,3,0.667,0,1,0.0,1,2,0.5,1,1,2,1,0,0,1,2,5,-1,1,Jonathan Kuminga,GSW,GSW,MIN,,,8,7,6,3
22023,1630228,22300186,"NOV 12, 2023",GSW vs. MIN,L,24,2,11,0.182,0,3,0.0,6,7,0.857,2,1,3,0,2,0,0,2,10,5,1,Jonathan Kuminga,GSW,GSW,MIN,,,13,13,10,3
22023,1630228,22300176,"NOV 11, 2023",GSW vs. CLE,L,21,2,7,0.286,0,1,0.0,8,11,0.727,0,3,3,0,0,0,0,4,12,-1,1,Jonathan Kuminga,GSW,GSW,CLE,,,15,15,12,3
22023,1630228,22300169,"NOV 08, 2023",GSW @ DEN,L,19,4,12,0.333,0,1,0.0,2,2,1.0,2,2,4,2,0,0,0,1,10,9,1,Jonathan Kuminga,GSW,DEN,GSW,,,16,14,12,6
22023,1630228,22300145,"NOV 06, 2023",GSW @ DET,W,19,2,8,0.25,0,3,0.0,6,8,0.75,0,1,1,0,1,1,1,3,10,0,1,Jonathan Kuminga,GSW,DET,GSW,,,11,11,10,1
22023,1630228,22300142,"NOV 05, 2023",GSW @ CLE,L,20,5,14,0.357,1,4,0.25,4,5,0.8,1,2,3,0,0,2,1,2,15,-9,1,Jonathan Kuminga,GSW,CLE,GSW,,,18,18,15,3
22023,1630228,22300005,"NOV 03, 2023",GSW @ OKC,W,22,9,15,0.6,0,2,0.0,1,2,0.5,1,1,2,1,0,0,3,2,19,3,1,Jonathan Kuminga,GSW,OKC,GSW,,,22,21,20,3
22023,1630228,22300126,"NOV 01, 2023",GSW vs. SAC,W,17,4,9,0.444,1,2,0.5,3,3,1.0,0,1,1,1,1,0,0,2,12,3,1,Jonathan Kuminga,GSW,GSW,SAC,,,14,13,13,2
22023,1630228,22300096,"OCT 29, 2023",GSW @ HOU,W,19,3,8,0.375,1,3,0.333,2,3,0.667,0,2,2,1,1,0,3,4,9,4,1,Jonathan Kuminga,GSW,HOU,GSW,,,12,11,10,3
22023,1630228,22300087,"OCT 27, 2023",GSW @ SAC,W,26,5,11,0.455,1,3,0.333,1,2,0.5,1,4,5,0,0,0,2,3,12,9,1,Jonathan Kuminga,GSW,SAC,GSW,,,17,17,12,5
22023,1630228,22300062,"OCT 24, 2023",GSW vs. PHX,L,20,4,8,0.5,0,0,0.0,4,6,0.667,3,3,6,1,2,1,2,5,12,4,1,Jonathan Kuminga,GSW,GSW,PHX,,,19,18,13,7
22023,1628398,22300558,"JAN 15, 2024",WAS vs. DET,L,33,7,21,0.333,3,9,0.333,4,4,1.0,0,8,8,4,3,2,0,2,21,-17,1,Kyle Kuzma,WAS,WAS,DET,,,33,29,25,12
22023,1628398,22300543,"JAN 13, 2024",WAS @ ATL,W,27,10,20,0.5,3,5,0.6,6,7,0.857,3,3,6,4,0,1,2,0,29,21,1,Kyle Kuzma,WAS,ATL,WAS,,,39,35,33,10
22023,1628398,22300520,"JAN 10, 2024",WAS @ IND,L,34,4,15,0.267,0,4,0.0,3,3,1.0,3,8,11,5,2,0,4,0,11,-8,1,Kyle Kuzma,WAS,IND,WAS,,,27,22,16,16
22023,1628398,22300508,"JAN 08, 2024",WAS vs. OKC,L,37,10,24,0.417,0,5,0.0,2,2,1.0,4,11,15,5,0,0,2,1,22,1,1,Kyle Kuzma,WAS,WAS,OKC,,,42,37,27,20
22023,1628398,22300494,"JAN 06, 2024",WAS vs. NYK,L,32,10,21,0.476,4,10,0.4,3,4,0.75,0,2,2,2,0,1,3,3,27,-8,1,Kyle Kuzma,WAS,WAS,NYK,,,31,29,29,4
22023,1628398,22300482,"JAN 05, 2024",WAS @ CLE,L,25,4,14,0.286,1,4,0.25,0,0,0.0,1,1,2,2,1,0,7,2,9,-20,1,Kyle Kuzma,WAS,CLE,WAS,,,13,11,11,4
22023,1628398,22300465,"JAN 03, 2024",WAS @ CLE,L,23,7,12,0.583,2,6,0.333,0,0,0.0,0,2,2,3,1,0,1,1,16,-22,1,Kyle Kuzma,WAS,CLE,WAS,,,21,18,19,5
22023,1628398,22300445,"DEC 31, 2023",WAS vs. ATL,L,34,15,31,0.484,7,18,0.389,1,1,1.0,2,6,8,5,0,0,2,4,38,0,1,Kyle Kuzma,WAS,WAS,ATL,,,51,46,43,13
22023,1628398,22300430,"DEC 29, 2023",WAS vs. BKN,W,31,11,22,0.5,4,10,0.4,0,0,0.0,1,7,8,2,0,1,2,1,26,-9,1,Kyle Kuzma,WAS,WAS,BKN,,,36,34,28,10
22023,1628398,22300416,"DEC 27, 2023",WAS vs. TOR,L,30,6,13,0.462,1,5,0.2,1,2,0.5,2,2,4,7,0,0,5,3,14,-21,1,Kyle Kuzma,WAS,WAS,TOR,,,25,18,21,11
22023,1628398,22300407,"DEC 26, 2023",WAS vs. ORL,L,36,6,18,0.333,2,8,0.25,3,3,1.0,1,3,4,6,0,1,6,5,17,8,1,Kyle Kuzma,WAS,WAS,ORL,,,27,21,23,10
22023,1628398,22300386,"DEC 22, 2023",WAS @ GSW,L,25,3,11,0.273,1,5,0.2,0,1,0.0,0,9,9,3,0,0,3,2,7,-5,1,Kyle Kuzma,WAS,GSW,WAS,,,19,16,10,12
22023,1628398,22300381,"DEC 21, 2023",WAS @ POR,W,37,11,22,0.5,3,7,0.429,7,10,0.7,2,6,8,6,1,0,3,0,32,4,1,Kyle Kuzma,WAS,POR,WAS,,,46,40,38,14
22023,1628398,22300358,"DEC 18, 2023",WAS @ SAC,L,29,8,16,0.5,3,7,0.429,8,8,1.0,0,8,8,1,0,1,3,1,27,-23,1,Kyle Kuzma,WAS,SAC,WAS,,,36,35,28,9
22023,1628398,22300347,"DEC 17, 2023",WAS @ PHX,L,34,7,22,0.318,3,13,0.231,0,2,0.0,1,6,7,2,0,2,2,6,17,0,1,Kyle Kuzma,WAS,PHX,WAS,,,26,24,19,9
22023,1628398,22300328,"DEC 15, 2023",WAS vs. IND,W,30,11,23,0.478,4,9,0.444,5,8,0.625,0,5,5,4,1,0,3,3,31,12,1,Kyle Kuzma,WAS,WAS,IND,,,40,36,35,9
22023,1628398,22300311,"DEC 13, 2023",WAS vs. NOP,L,30,10,19,0.526,4,8,0.5,3,4,0.75,0,7,7,4,1,1,2,1,27,-6,1,Kyle Kuzma,WAS,WAS,NOP,,,38,34,31,11
22023,1628398,22300295,"DEC 11, 2023",WAS @ PHI,L,27,9,17,0.529,1,2,0.5,2,4,0.5,2,7,9,1,0,0,2,0,21,-28,1,Kyle Kuzma,WAS,PHI,WAS,,,31,30,22,10
22023,1628398,22301219,"DEC 08, 2023",WAS @ BKN,L,30,8,17,0.471,1,4,0.25,0,1,0.0,1,2,3,2,0,0,3,2,17,-23,1,Kyle Kuzma,WAS,BKN,WAS,,,22,20,19,5
22023,1628398,22301208,"DEC 06, 2023",WAS vs. PHI,L,34,7,16,0.438,2,5,0.4,0,0,0.0,0,3,3,7,0,1,1,3,16,-12,1,Kyle Kuzma,WAS,WAS,PHI,,,26,19,23,10
22023,1628398,22300274,"DEC 01, 2023",WAS @ ORL,L,37,10,18,0.556,2,6,0.333,5,6,0.833,1,5,6,1,1,2,6,6,27,-7,1,Kyle Kuzma,WAS,ORL,WAS,,,34,33,28,7
22023,1628398,22300259,"NOV 29, 2023",WAS @ ORL,L,35,9,20,0.45,1,4,0.25,4,5,0.8,0,3,3,6,0,0,4,1,23,-11,1,Kyle Kuzma,WAS,ORL,WAS,,,32,26,29,9
22023,1628398,22300253,"NOV 27, 2023",WAS @ DET,W,35,10,23,0.435,2,7,0.286,10,11,0.909,0,12,12,8,0,0,1,0,32,18,1,Kyle Kuzma,WAS,DET,WAS,,,52,44,40,20
22023,1628398,22300241,"NOV 25, 2023",WAS vs. ATL,L,25,4,10,0.4,2,5,0.4,2,2,1.0,2,5,7,8,0,0,5,1,12,-25,1,Kyle Kuzma,WAS,WAS,ATL,,,27,19,20,15
22023,1628398,22300049,"NOV 24, 2023",WAS @ MIL,L,31,9,22,0.409,3,8,0.375,1,1,1.0,1,3,4,4,0,2,1,3,22,-1,1,Kyle Kuzma,WAS,MIL,WAS,,,30,26,26,8
22023,1628398,22300225,"NOV 22, 2023",WAS @ CHA,L,35,12,22,0.545,3,6,0.5,1,1,1.0,0,9,9,10,1,2,2,4,28,13,1,Kyle Kuzma,WAS,CHA,WAS,,,47,37,38,19
22023,1628398,22300219,"NOV 20, 2023",WAS vs. MIL,L,31,10,15,0.667,2,5,0.4,0,0,0.0,0,3,3,13,2,1,2,2,22,3,1,Kyle Kuzma,WAS,WAS,MIL,,,38,25,35,16
22023,1628398,22300028,"NOV 17, 2023",WAS vs. NYK,L,32,8,21,0.381,3,8,0.375,0,0,0.0,0,4,4,5,0,0,2,3,19,-20,1,Kyle Kuzma,WAS,WAS,NYK,,,28,23,24,9
22023,1628398,22300192,"NOV 15, 2023",WAS vs. DAL,L,30,6,18,0.333,2,6,0.333,8,10,0.8,2,4,6,3,0,0,2,1,22,-24,1,Kyle Kuzma,WAS,WAS,DAL,,,31,28,25,9
22023,1628398,22300189,"NOV 13, 2023",WAS @ TOR,L,38,14,25,0.56,4,7,0.571,2,3,0.667,1,2,3,3,0,0,6,5,34,1,1,Kyle Kuzma,WAS,TOR,WAS,,,40,37,37,6
22023,1628398,22300178,"NOV 12, 2023",WAS @ BKN,L,31,4,16,0.25,0,5,0.0,7,10,0.7,0,4,4,3,1,2,1,2,15,-29,1,Kyle Kuzma,WAS,BKN,WAS,,,22,19,18,7
22023,1628398,22300009,"NOV 10, 2023",WAS vs. CHA,L,29,7,17,0.412,2,5,0.4,1,1,1.0,1,5,6,1,0,0,3,1,17,-19,1,Kyle Kuzma,WAS,WAS,CHA,,,24,23,18,7
22023,1628398,22300157,"NOV 08, 2023",WAS @ CHA,W,31,13,24,0.542,4,11,0.364,3,3,1.0,3,6,9,4,0,0,2,1,33,8,1,Kyle Kuzma,WAS,CHA,WAS,,,46,42,37,13
22023,1628398,22300148,"NOV 06, 2023",WAS @ PHI,L,30,12,20,0.6,4,5,0.8,0,1,0.0,2,4,6,4,0,1,2,2,28,-3,1,Kyle Kuzma,WAS,PHI,WAS,,,38,34,32,10
22023,1628398,22300003,"NOV 03, 2023",WAS @ MIA,L,31,8,19,0.421,4,9,0.444,2,2,1.0,1,3,4,3,0,0,5,3,22,-20,1,Kyle Kuzma,WAS,MIA,WAS,,,29,26,25,7
22023,1628398,22300117,"NOV 01, 2023",WAS @ ATL,L,25,11,21,0.524,1,6,0.167,2,3,0.667,0,9,9,6,0,0,1,1,25,-16,1,Kyle Kuzma,WAS,ATL,WAS,,,40,34,31,15
22023,1628398,22300103,"OCT 30, 2023",WAS vs. BOS,L,26,9,15,0.6,3,6,0.5,0,0,0.0,0,5,5,4,0,0,2,0,21,-24,1,Kyle Kuzma,WAS,WAS,BOS,,,30,26,25,9
22023,1628398,22300089,"OCT 28, 2023",WAS vs. MEM,W,36,9,23,0.391,1,10,0.1,2,3,0.667,3,10,13,2,1,0,0,2,21,-1,1,Kyle Kuzma,WAS,WAS,MEM,,,36,34,23,15
22023,1628398,22300064,"OCT 25, 2023",WAS @ IND,L,25,9,18,0.5,1,4,0.25,6,6,1.0,1,1,2,0,0,2,0,0,25,-10,1,Kyle Kuzma,WAS,IND,WAS,,,27,27,25,2
22023,1631222,22300544,"JAN 13, 2024",MEM vs. NYK,L,1,0,0,0.0,0,0,0.0,2,2,1.0,0,0,0,0,0,0,0,0,2,-2,1,Jake LaRavia,MEM,MEM,NYK,,,2,2,2,0
22023,1631222,22300537,"JAN 12, 2024",MEM vs. LAC,L,20,5,10,0.5,2,4,0.5,0,0,0.0,2,2,4,1,0,1,0,4,12,5,1,Jake LaRavia,MEM,MEM,LAC,,,17,16,13,5
22023,1631222,22300515,"JAN 09, 2024",MEM @ DAL,W,2,0,1,0.0,0,0,0.0,0,0,0.0,0,1,1,0,0,0,0,0,0,-3,1,Jake LaRavia,MEM,DAL,MEM,,,1,1,0,1
22023,1631222,22300355,"DEC 18, 2023",MEM @ OKC,L,12,1,4,0.25,1,4,0.25,0,0,0.0,2,1,3,0,0,0,0,0,3,9,1,Jake LaRavia,MEM,OKC,MEM,,,6,6,3,3
22023,1631222,22300332,"DEC 15, 2023",MEM vs. HOU,L,10,1,2,0.5,0,1,0.0,0,0,0.0,0,0,0,1,0,0,1,4,2,-6,1,Jake LaRavia,MEM,MEM,HOU,,,3,2,3,1
22023,1631222,22300314,"DEC 13, 2023",MEM @ HOU,L,15,2,6,0.333,0,3,0.0,0,0,0.0,0,0,0,2,0,0,1,3,4,-14,1,Jake LaRavia,MEM,HOU,MEM,,,6,4,6,2
22023,1631222,22300125,"NOV 01, 2023",MEM @ UTA,L,9,2,4,0.5,0,2,0.0,0,0,0.0,0,0,0,0,0,0,0,0,4,3,1,Jake LaRavia,MEM,UTA,MEM,,,4,4,4,0
22023,1631222,22300106,"OCT 30, 2023",MEM vs. DAL,L,6,0,1,0.0,0,1,0.0,0,0,0.0,0,0,0,0,0,0,0,3,0,-9,1,Jake LaRavia,MEM,MEM,DAL,,,0,0,0,0
22023,1631222,22300089,"OCT 28, 2023",MEM @ WAS,L,16,2,9,0.222,1,5,0.2,0,0,0.0,0,1,1,1,0,0,0,0,5,-11,1,Jake LaRavia,MEM,WAS,MEM,,,7,6,6,2
22023,1631222,22300078,"OCT 27, 2023",MEM vs. DEN,L,16,2,3,0.667,1,2,0.5,1,2,0.5,3,2,5,0,0,0,2,1,6,6,1,Jake LaRavia,MEM,MEM,DEN,,,11,11,6,5
22023,1631222,22300071,"OCT 25, 2023",MEM vs. NOP,L,15,1,3,0.333,0,2,0.0,0,0,0.0,0,2,2,1,1,0,0,4,2,-11,1,Jake LaRavia,MEM,MEM,NOP,,,5,4,3,3
22023,203897,22300561,"JAN 15, 2024",CHI @ CLE,L,35,7,14,0.5,3,6,0.5,0,0,0.0,0,4,4,4,0,0,3,3,17,-18,1,Zach LaVine,CHI,CLE,CHI,,,25,21,21,8
22023,203897,22300548,"JAN 13, 2024",CHI @ SAS,W,36,3,8,0.375,1,5,0.2,3,4,0.75,0,6,6,7,1,0,2,3,10,12,1,Zach LaVine,CHI,SAS,CHI,,,23,16,17,13
22023,203897,22300536,"JAN 12, 2024",CHI vs. GSW,L,35,9,15,0.6,4,8,0.5,3,3,1.0,0,8,8,7,0,1,1,3,25,2,1,Zach LaVine,CHI,CHI,GSW,,,40,33,32,15
22023,203897,22300523,"JAN 10, 2024",CHI vs. HOU,W,41,8,15,0.533,4,8,0.5,5,6,0.833,1,12,13,7,3,1,4,5,25,15,1,Zach LaVine,CHI,CHI,HOU,,,45,38,32,20
22023,203897,22300506,"JAN 08, 2024",CHI @ CHA,W,36,2,8,0.25,2,6,0.333,3,4,0.75,1,2,3,5,0,2,2,1,9,-5,1,Zach LaVine,CHI,CHA,CHI,,,17,12,14,8
22023,203897,22300484,"JAN 05, 2024",CHI vs. CHA,W,30,6,11,0.545,1,5,0.2,2,3,0.667,0,5,5,4,0,0,2,1,15,4,1,Zach LaVine,CHI,CHI,CHA,,,24,20,19,9
22023,203897,22300053,"NOV 28, 2023",CHI @ BOS,L,25,1,9,0.111,0,3,0.0,0,0,0.0,1,1,2,4,2,0,0,1,2,-22,1,Zach LaVine,CHI,BOS,CHI,,,8,4,6,6
22023,203897,22300250,"NOV 26, 2023",CHI @ BKN,L,39,8,18,0.444,1,5,0.2,3,4,0.75,0,6,6,4,0,0,0,1,20,1,1,Zach LaVine,CHI,BKN,CHI,,,30,26,24,10
22023,203897,22300046,"NOV 24, 2023",CHI @ TOR,L,38,16,23,0.696,4,8,0.5,0,0,0.0,0,4,4,3,1,0,5,4,36,-2,1,Zach LaVine,CHI,TOR,CHI,,,43,40,39,7
22023,203897,22300220,"NOV 20, 2023",CHI vs. MIA,L,35,5,9,0.556,2,6,0.333,1,1,1.0,0,3,3,5,0,0,1,1,13,-24,1,Zach LaVine,CHI,CHI,MIA,,,21,16,18,8
22023,203897,22300204,"NOV 18, 2023",CHI vs. MIA,W,35,5,10,0.5,3,7,0.429,0,0,0.0,0,8,8,6,3,1,1,2,13,-2,1,Zach LaVine,CHI,CHI,MIA,,,27,21,19,14
22023,203897,22300033,"NOV 17, 2023",CHI vs. ORL,L,41,12,20,0.6,4,11,0.364,6,7,0.857,0,6,6,3,1,0,3,4,34,2,1,Zach LaVine,CHI,CHI,ORL,,,43,40,37,9
22023,203897,22300196,"NOV 15, 2023",CHI vs. ORL,L,36,6,16,0.375,4,7,0.571,3,4,0.75,0,6,6,3,1,0,3,2,19,3,1,Zach LaVine,CHI,CHI,ORL,,,28,25,22,9
22023,203897,22300190,"NOV 13, 2023",CHI @ MIL,L,39,5,19,0.263,2,10,0.2,8,8,1.0,1,7,8,5,1,1,1,1,20,-6,1,Zach LaVine,CHI,MIL,CHI,,,33,28,25,13
22023,203897,22300181,"NOV 12, 2023",CHI vs. DET,W,34,6,14,0.429,1,6,0.167,6,6,1.0,0,3,3,2,1,0,0,1,19,1,1,Zach LaVine,CHI,CHI,DET,,,24,22,21,5
22023,203897,22300162,"NOV 08, 2023",CHI vs. PHX,L,41,7,13,0.538,3,6,0.5,5,7,0.714,1,7,8,8,1,0,3,2,22,-14,1,Zach LaVine,CHI,CHI,PHX,,,38,30,30,16
22023,203897,22300152,"NOV 06, 2023",CHI vs. UTA,W,31,8,17,0.471,2,5,0.4,6,7,0.857,0,2,2,3,1,0,2,3,24,18,1,Zach LaVine,CHI,CHI,UTA,,,29,26,27,5
22023,203897,22300139,"NOV 04, 2023",CHI @ DEN,L,31,4,12,0.333,1,5,0.2,3,4,0.75,0,4,4,4,1,0,3,2,12,-27,1,Zach LaVine,CHI,DEN,CHI,,,20,16,16,8
22023,203897,22300004,"NOV 03, 2023",CHI vs. BKN,L,38,10,21,0.476,1,6,0.167,3,4,0.75,1,6,7,5,1,1,2,2,24,8,1,Zach LaVine,CHI,CHI,BKN,,,36,31,29,12
22023,203897,22300124,"NOV 01, 2023",CHI @ DAL,L,36,7,17,0.412,5,9,0.556,3,3,1.0,0,2,2,1,2,0,0,2,22,-6,1,Zach LaVine,CHI,DAL,CHI,,,25,24,23,3
22023,203897,22300102,"OCT 30, 2023",CHI @ IND,W,36,6,17,0.353,1,6,0.167,10,11,0.909,0,5,5,1,0,0,1,1,23,2,1,Zach LaVine,CHI,IND,CHI,,,29,28,24,6
22023,203897,22300088,"OCT 28, 2023",CHI @ DET,L,37,19,33,0.576,7,13,0.538,6,8,0.75,2,3,5,0,1,0,4,2,51,-8,1,Zach LaVine,CHI,DET,CHI,,,56,56,51,5
22023,203897,22300082,"OCT 27, 2023",CHI vs. TOR,W,38,3,14,0.214,0,6,0.0,2,2,1.0,0,5,5,1,0,1,3,3,8,-23,1,Zach LaVine,CHI,CHI,TOR,,,14,13,9,6
22023,203897,22300070,"OCT 25, 2023",CHI vs. OKC,L,25,4,16,0.25,2,9,0.222,6,6,1.0,0,4,4,3,0,0,4,3,16,1,1,Zach LaVine,CHI,CHI,OKC,,,23,20,19,7
22023,1629111,22300555,"JAN 15, 2024",HOU @ PHI,L,9,2,2,1.0,0,0,0.0,0,0,0.0,1,0,1,0,1,3,0,0,4,17,1,Jock Landale,HOU,PHI,HOU,,,5,5,4,1
22023,1629111,22300542,"JAN 13, 2024",HOU @ BOS,L,12,1,6,0.167,0,3,0.0,0,0,0.0,3,0,3,1,0,0,0,0,2,-6,1,Jock Landale,HOU,BOS,HOU,,,6,5,3,4
22023,1629111,22300485,"JAN 05, 2024",HOU vs. MIN,L,5,0,1,0.0,0,1,0.0,0,0,0.0,0,0,0,0,0,1,0,0,0,-4,1,Jock Landale,HOU,HOU,MIN,,,0,0,0,0
22023,1629111,22300453,"JAN 01, 2024",HOU vs. DET,W,7,0,0,0.0,0,0,0.0,0,0,0.0,0,0,0,0,0,0,0,0,0,-5,1,Jock Landale,HOU,HOU,DET,,,0,0,0,0
22023,1629111,22300434,"DEC 29, 2023",HOU vs. PHI,L,8,2,5,0.4,0,0,0.0,2,2,1.0,1,0,1,0,0,1,0,4,6,-6,1,Jock Landale,HOU,HOU,PHI,,,7,7,6,1
22023,1629111,22300418,"DEC 27, 2023",HOU vs. PHX,L,12,2,4,0.5,0,0,0.0,1,2,0.5,3,2,5,0,0,0,0,2,5,4,1,Jock Landale,HOU,HOU,PHX,,,10,10,5,5
22023,1629111,22300385,"DEC 22, 2023",HOU vs. DAL,W,16,1,5,0.2,0,3,0.0,1,2,0.5,3,1,4,2,0,1,0,1,3,-9,1,Jock Landale,HOU,HOU,DAL,,,9,7,5,6
22023,1629111,22300349,"DEC 18, 2023",HOU @ CLE,L,4,0,0,0.0,0,0,0.0,0,0,0.0,0,1,1,0,1,0,0,1,0,-4,1,Jock Landale,HOU,CLE,HOU,,,1,1,0,1
22023,1629111,22300332,"DEC 15, 2023",HOU @ MEM,W,8,0,0,0.0,0,0,0.0,0,0,0.0,1,0,1,0,0,0,0,1,0,4,1,Jock Landale,HOU,MEM,HOU,,,1,1,0,1
22023,1629111,22300314,"DEC 13, 2023",HOU vs. MEM,W,10,1,2,0.5,0,0,0.0,0,0,0.0,2,1,3,0,0,0,0,2,2,13,1,Jock Landale,HOU,HOU,MEM,,,5,5,2,3
22023,1629111,22300291,"DEC 02, 2023",HOU @ LAL,L,3,0,0,0.0,0,0,0.0,0,0,0.0,0,0,0,0,0,1,0,0,0,8,1,Jock Landale,HOU,LAL,HOU,,,0,0,0,0
22023,1629111,22300263,"NOV 29, 2023",HOU @ DEN,L,14,2,4,0.5,0,1,0.0,2,2,1.0,0,1,1,0,1,0,1,2,6,4,1,Jock Landale,HOU,DEN,HOU,,,7,7,6,1
22023,1629111,22300231,"NOV 22, 2023",HOU vs. MEM,W,4,1,1,1.0,0,0,0.0,0,0,0.0,0,1,1,0,0,0,0,0,2,-3,1,Jock Landale,HOU,HOU,MEM,,,3,3,2,1
22023,1629111,22300224,"NOV 20, 2023",HOU @ GSW,L,4,0,1,0.0,0,0,0.0,0,0,0.0,0,1,1,0,0,0,0,0,0,-7,1,Jock Landale,HOU,GSW,HOU,,,1,1,0,1
22023,1629111,22300216,"NOV 19, 2023",HOU @ LAL,L,4,0,0,0.0,0,0,0.0,0,0,0.0,1,0,1,1,0,0,1,1,0,-6,1,Jock Landale,HOU,LAL,HOU,,,2,1,1,2
22023,1629111,22300037,"NOV 17, 2023",HOU @ LAC,L,7,1,2,0.5,0,0,0.0,0,0,0.0,0,3,3,0,0,0,1,0,2,15,1,Jock Landale,HOU,LAC,HOU,,,5,5,2,3
22023,1629111,22300182,"NOV 12, 2023",HOU vs. DEN,W,2,0,0,0.0,0,0,0.0,0,0,0.0,1,0,1,0,0,0,0,1,0,-4,1,Jock Landale,HOU,HOU,DEN,,,1,1,0,1
22023,1629111,22300011,"NOV 10, 2023",HOU vs. NOP,W,7,0,2,0.0,0,0,0.0,0,0,0.0,1,2,3,0,0,0,0,0,0,3,1,Jock Landale,HOU,HOU,NOP,,,3,3,0,3
22023,1629111,22300163,"NOV 08, 2023",HOU vs. LAL,W,12,1,3,0.333,0,1,0.0,0,0,0.0,1,2,3,0,0,1,1,0,2,6,1,Jock Landale,HOU,HOU,LAL,,,5,5,2,3
22023,1629111,22300153,"NOV 06, 2023",HOU vs. SAC,W,16,2,3,0.667,1,2,0.5,0,0,0.0,1,0,1,1,1,0,2,2,5,6,1,Jock Landale,HOU,HOU,SAC,,,7,6,6,2
22023,1629111,22300137,"NOV 04, 2023",HOU vs. SAC,W,12,0,1,0.0,0,1,0.0,0,0,0.0,1,2,3,3,1,0,0,1,0,-6,1,Jock Landale,HOU,HOU,SAC,,,6,3,3,6
22023,1629111,22300122,"NOV 01, 2023",HOU vs. CHA,W,19,1,7,0.143,0,3,0.0,2,2,1.0,3,2,5,1,1,1,1,1,4,2,1,Jock Landale,HOU,HOU,CHA,,,10,9,5,6
22023,1629111,22300066,"OCT 25, 2023",HOU @ ORL,L,9,1,2,0.5,1,2,0.5,0,0,0.0,0,0,0,2,0,0,1,1,3,-7,1,Jock Landale,HOU,ORL,HOU,,,5,3,5,2
22023,1630639,22300556,"JAN 15, 2024",DAL vs. NOP,W,14,1,3,0.333,1,2,0.5,0,0,0.0,1,0,1,0,0,1,0,1,3,-1,1,A.J. Lawson,DAL,DAL,NOP,,,4,4,3,1
22023,1630639,22300547,"JAN 13, 2024",DAL vs. NOP,L,6,1,3,0.333,0,1,0.0,1,1,1.0,0,1,1,1,0,0,1,0,3,4,1,A.J. Lawson,DAL,DAL,NOP,,,5,4,4,2
22023,1630639,22300515,"JAN 09, 2024",DAL vs. MEM,L,5,1,3,0.333,1,2,0.5,0,0,0.0,1,1,2,0,0,0,0,1,3,-3,1,A.J. Lawson,DAL,DAL,MEM,,,5,5,3,2
22023,1630639,22300487,"JAN 05, 2024",DAL vs. POR,W,25,4,8,0.5,1,4,0.25,5,6,0.833,1,4,5,2,2,0,2,5,14,21,1,A.J. Lawson,DAL,DAL,POR,,,21,19,16,7
22023,1630639,22300472,"JAN 03, 2024",DAL vs. POR,W,8,1,4,0.25,1,1,1.0,0,0,0.0,0,0,0,0,1,0,0,1,3,-3,1,A.J. Lawson,DAL,DAL,POR,,,3,3,3,0
22023,1630639,22300405,"DEC 25, 2023",DAL @ PHX,W,5,0,2,0.0,0,2,0.0,0,0,0.0,0,1,1,0,0,0,0,0,0,-1,1,A.J. Lawson,DAL,PHX,DAL,,,1,1,0,1
22023,1630639,22300398,"DEC 23, 2023",DAL vs. SAS,W,31,7,10,0.7,3,4,0.75,0,0,0.0,3,4,7,3,2,0,1,2,17,16,1,A.J. Lawson,DAL,DAL,SAS,,,27,24,20,10
22023,1630639,22300385,"DEC 22, 2023",DAL @ HOU,L,23,3,4,0.75,0,1,0.0,2,2,1.0,0,2,2,1,4,0,3,0,8,2,1,A.J. Lawson,DAL,HOU,DAL,,,11,10,9,3
22023,1630639,22300372,"DEC 20, 2023",DAL vs. LAC,L,1,0,0,0.0,0,0,0.0,0,0,0.0,0,0,0,0,0,0,0,0,0,0,1,A.J. Lawson,DAL,DAL,LAC,,,0,0,0,0
22023,1630639,22300356,"DEC 18, 2023",DAL @ DEN,L,15,2,4,0.5,1,2,0.5,1,2,0.5,1,1,2,0,0,0,1,2,6,-9,1,A.J. Lawson,DAL,DEN,DAL,,,8,8,6,2
22023,1630639,22300341,"DEC 16, 2023",DAL @ POR,W,1,0,0,0.0,0,0,0.0,0,0,0.0,0,0,0,0,0,0,0,0,0,0,1,A.J. Lawson,DAL,POR,DAL,,,0,0,0,0
22023,1630639,22300321,"DEC 14, 2023",DAL vs. MIN,L,2,1,1,1.0,0,0,0.0,0,0,0.0,0,0,0,0,0,0,0,0,2,1,1,A.J. Lawson,DAL,DAL,MIN,,,2,2,2,0
22023,1630639,22300306,"DEC 12, 2023",DAL vs. LAL,W,0,0,0,0.0,0,0,0.0,0,0,0.0,0,0,0,0,0,0,0,0,0,-3,1,A.J. Lawson,DAL,DAL,LAL,,,0,0,0,0
22023,1630639,22300299,"DEC 11, 2023",DAL @ MEM,W,14,2,7,0.286,0,4,0.0,0,0,0.0,1,0,1,1,0,0,1,0,4,1,1,A.J. Lawson,DAL,MEM,DAL,,,6,5,5,2
22023,1630639,22301226,"DEC 08, 2023",DAL @ POR,W,7,1,3,0.333,0,2,0.0,0,0,0.0,0,1,1,0,0,0,0,1,2,-4,1,A.J. Lawson,DAL,POR,DAL,,,3,3,2,1
22023,1630639,22301213,"DEC 06, 2023",DAL vs. UTA,W,7,2,2,1.0,0,0,0.0,0,0,0.0,1,0,1,0,0,0,0,0,4,7,1,A.J. Lawson,DAL,DAL,UTA,,,5,5,4,1
22023,1630639,22300287,"DEC 02, 2023",DAL vs. OKC,L,19,4,10,0.4,3,7,0.429,1,2,0.5,0,0,0,2,0,1,0,1,12,9,1,A.J. Lawson,DAL,DAL,OKC,,,14,12,14,2
22023,1630639,22300277,"DEC 01, 2023",DAL vs. MEM,L,4,0,1,0.0,0,1,0.0,1,2,0.5,0,1,1,0,0,0,0,0,1,4,1,A.J. Lawson,DAL,DAL,MEM,,,2,2,1,1
22023,1627747,22300561,"JAN 15, 2024",CLE vs. CHI,W,30,6,17,0.353,4,10,0.4,0,0,0.0,1,6,7,7,0,0,3,2,16,8,1,Caris LeVert,CLE,CLE,CHI,,,30,23,23,14
22023,1627747,22300527,"JAN 11, 2024",CLE vs. BKN,W,35,5,14,0.357,3,9,0.333,8,12,0.667,0,3,3,1,1,2,1,2,21,0,1,Caris LeVert,CLE,CLE,BKN,,,25,24,22,4
22023,1627747,22300497,"JAN 07, 2024",CLE vs. SAS,W,26,9,13,0.692,4,5,0.8,1,3,0.333,0,2,2,3,2,0,4,2,23,3,1,Caris LeVert,CLE,CLE,SAS,,,28,25,26,5
22023,1627747,22300482,"JAN 05, 2024",CLE vs. WAS,W,27,3,7,0.429,1,2,0.5,4,4,1.0,0,4,4,11,2,0,2,0,11,13,1,Caris LeVert,CLE,CLE,WAS,,,26,15,22,15
22023,1627747,22300465,"JAN 03, 2024",CLE vs. WAS,W,23,9,18,0.5,3,6,0.5,0,0,0.0,2,3,5,5,1,1,0,1,21,22,1,Caris LeVert,CLE,CLE,WAS,,,31,26,26,10
22023,1627747,22300452,"JAN 01, 2024",CLE @ TOR,L,29,12,20,0.6,2,7,0.286,5,5,1.0,0,4,4,4,0,0,0,0,31,1,1,Caris LeVert,CLE,TOR,CLE,,,39,35,35,8
22023,1627747,22300433,"DEC 29, 2023",CLE vs. MIL,L,28,3,14,0.214,0,6,0.0,0,0,0.0,0,1,1,4,1,0,2,2,6,-3,1,Caris LeVert,CLE,CLE,MIL,,,11,7,10,5
22023,1627747,22300420,"DEC 27, 2023",CLE @ DAL,W,28,9,19,0.474,6,11,0.545,5,8,0.625,0,2,2,7,0,0,2,3,29,-16,1,Caris LeVert,CLE,DAL,CLE,,,38,31,36,9
22023,1627747,22300375,"DEC 21, 2023",CLE vs. NOP,L,23,3,9,0.333,1,4,0.25,2,2,1.0,0,0,0,4,1,0,1,1,9,-24,1,Caris LeVert,CLE,CLE,NOP,,,13,9,13,4
22023,1627747,22300364,"DEC 20, 2023",CLE vs. UTA,W,27,6,15,0.4,4,7,0.571,7,8,0.875,0,3,3,7,1,0,0,3,23,11,1,Caris LeVert,CLE,CLE,UTA,,,33,26,30,10
22023,1627747,22300349,"DEC 18, 2023",CLE vs. HOU,W,27,5,13,0.385,1,6,0.167,1,2,0.5,1,6,7,5,2,0,3,0,12,-3,1,Caris LeVert,CLE,CLE,HOU,,,24,19,17,12
22023,1627747,22300336,"DEC 16, 2023",CLE vs. ATL,W,25,6,15,0.4,1,4,0.25,1,2,0.5,2,3,5,1,1,1,3,1,14,-1,1,Caris LeVert,CLE,CLE,ATL,,,20,19,15,6
22023,1627747,22300319,"DEC 14, 2023",CLE @ BOS,L,35,9,16,0.563,3,6,0.5,5,6,0.833,1,2,3,5,3,1,1,2,26,-1,1,Caris LeVert,CLE,BOS,CLE,,,34,29,31,8
22023,1627747,22300305,"DEC 12, 2023",CLE @ BOS,L,23,5,11,0.455,1,4,0.25,0,0,0.0,0,2,2,3,0,1,2,1,11,-5,1,Caris LeVert,CLE,BOS,CLE,,,16,13,14,5
22023,1627747,22300265,"NOV 30, 2023",CLE vs. POR,L,26,2,9,0.222,1,4,0.25,0,0,0.0,1,1,2,2,0,0,2,3,5,-17,1,Caris LeVert,CLE,CLE,POR,,,9,7,7,4
22023,1627747,22300055,"NOV 28, 2023",CLE vs. ATL,W,30,4,8,0.5,2,5,0.4,0,0,0.0,0,3,3,1,1,0,4,3,10,14,1,Caris LeVert,CLE,CLE,ATL,,,14,13,11,4
22023,1627747,22300251,"NOV 26, 2023",CLE vs. TOR,W,22,3,10,0.3,1,4,0.25,0,0,0.0,0,3,3,1,0,0,0,1,7,6,1,Caris LeVert,CLE,CLE,TOR,,,11,10,8,4
22023,1627747,22300242,"NOV 25, 2023",CLE vs. LAL,L,26,3,9,0.333,0,4,0.0,0,0,0.0,0,1,1,8,1,0,0,2,6,-2,1,Caris LeVert,CLE,CLE,LAL,,,15,7,14,9
22023,1627747,22300229,"NOV 22, 2023",CLE vs. MIA,L,18,4,8,0.5,2,3,0.667,2,2,1.0,0,2,2,3,0,1,2,0,12,-17,1,Caris LeVert,CLE,CLE,MIA,,,17,14,15,5
22023,1627747,22300030,"NOV 17, 2023",CLE vs. DET,W,33,4,14,0.286,1,6,0.167,1,2,0.5,0,1,1,1,2,0,0,0,10,11,1,Caris LeVert,CLE,CLE,DET,,,12,11,11,2
22023,1627747,22300199,"NOV 15, 2023",CLE @ POR,W,33,8,17,0.471,1,7,0.143,0,0,0.0,1,7,8,6,2,1,1,2,17,7,1,Caris LeVert,CLE,POR,CLE,,,31,25,23,14
22023,1627747,22300191,"NOV 13, 2023",CLE @ SAC,L,28,7,13,0.538,2,3,0.667,5,6,0.833,1,2,3,1,0,0,2,3,21,-7,1,Caris LeVert,CLE,SAC,CLE,,,25,24,22,4
22023,1627747,22300176,"NOV 11, 2023",CLE @ GSW,W,36,8,18,0.444,2,7,0.286,4,5,0.8,2,3,5,3,4,1,0,1,22,23,1,Caris LeVert,CLE,GSW,CLE,,,30,27,25,8
22023,1627747,22300167,"NOV 08, 2023",CLE @ OKC,L,34,7,14,0.5,2,6,0.333,13,16,0.813,0,5,5,5,0,0,3,5,29,-14,1,Caris LeVert,CLE,OKC,CLE,,,39,34,34,10
22023,1627747,22300142,"NOV 05, 2023",CLE vs. GSW,W,32,3,6,0.5,0,3,0.0,2,2,1.0,0,5,5,2,2,0,1,0,8,6,1,Caris LeVert,CLE,CLE,GSW,,,15,13,10,7
22023,1627747,22300001,"NOV 03, 2023",CLE @ IND,L,30,5,12,0.417,0,4,0.0,3,4,0.75,0,5,5,4,0,1,1,2,13,-1,1,Caris LeVert,CLE,IND,CLE,,,22,18,17,9
22023,1627747,22300120,"NOV 01, 2023",CLE @ NYK,W,31,6,14,0.429,3,4,0.75,4,4,1.0,0,6,6,5,1,0,3,3,19,10,1,Caris LeVert,CLE,NYK,CLE,,,30,25,24,11
22023,1627747,22300091,"OCT 28, 2023",CLE vs. IND,L,44,12,28,0.429,4,10,0.4,3,9,0.333,2,3,5,8,1,0,2,2,31,-2,1,Caris LeVert,CLE,CLE,IND,,,44,36,39,13
22023,1627747,22300081,"OCT 27, 2023",CLE vs. OKC,L,31,7,16,0.438,3,9,0.333,0,0,0.0,0,2,2,2,1,1,1,1,17,-3,1,Caris LeVert,CLE,CLE,OKC,,,21,19,19,4
22023,1627747,22300067,"OCT 25, 2023",CLE @ BKN,W,31,4,17,0.235,3,8,0.375,0,0,0.0,0,3,3,5,1,1,0,1,11,-6,1,Caris LeVert,CLE,BKN,CLE,,,19,14,16,8
22023,1630240,22300511,"JAN 08, 2024",PHX @ LAC,L,5,0,1,0.0,0,0,0.0,2,2,1.0,1,0,1,0,0,0,1,0,2,-3,1,Saben Lee,PHX,LAC,PHX,,,3,3,2,1
22023,1630240,22300503,"JAN 07, 2024",PHX vs. MEM,L,4,0,0,0.0,0,0,0.0,1,2,0.5,1,0,1,0,0,1,0,1,1,-8,1,Saben Lee,PHX,PHX,MEM,,,2,2,1,1
22023,1630240,22300489,"JAN 05, 2024",PHX vs. MIA,W,2,0,0,0.0,0,0,0.0,0,2,0.0,0,0,0,0,1,0,0,0,0,-5,1,Saben Lee,PHX,PHX,MIA,,,0,0,0,0
22023,1630240,22300436,"DEC 29, 2023",PHX vs. CHA,W,14,0,1,0.0,0,0,0.0,1,2,0.5,0,0,0,3,1,0,0,1,1,11,1,Saben Lee,PHX,PHX,CHA,,,4,1,4,3
22023,1630240,22300418,"DEC 27, 2023",PHX @ HOU,W,12,2,2,1.0,0,0,0.0,5,5,1.0,0,2,2,1,0,0,2,1,9,3,1,Saben Lee,PHX,HOU,PHX,,,12,11,10,3
22023,1630240,22300387,"DEC 22, 2023",PHX @ SAC,L,20,2,8,0.25,0,3,0.0,2,2,1.0,1,2,3,4,1,1,1,2,6,11,1,Saben Lee,PHX,SAC,PHX,,,13,9,10,7
22023,1630240,22301228,"DEC 08, 2023",PHX vs. SAC,L,1,1,1,1.0,0,0,0.0,2,2,1.0,0,0,0,0,0,0,0,0,4,4,1,Saben Lee,PHX,PHX,SAC,,,4,4,4,0
22023,1630240,22300140,"NOV 05, 2023",PHX @ DET,W,3,2,3,0.667,0,0,0.0,0,0,0.0,1,0,1,0,0,0,0,0,4,-5,1,Saben Lee,PHX,DET,PHX,,,5,5,4,1
22023,1630240,22300132,"NOV 04, 2023",PHX @ PHI,L,4,0,1,0.0,0,0,0.0,0,0,0.0,1,1,2,1,0,0,0,1,0,3,1,Saben Lee,PHX,PHI,PHX,,,3,2,1,3
22023,1630240,22300094,"OCT 28, 2023",PHX vs. UTA,W,4,1,2,0.5,0,1,0.0,0,0,0.0,0,0,0,2,0,1,0,0,2,-4,1,Saben Lee,PHX,PHX,UTA,,,4,2,4,2
22023,203458,22300552,"JAN 14, 2024",SAC @ MIL,L,11,2,4,0.5,0,1,0.0,0,0,0.0,3,2,5,1,0,0,0,3,4,-7,1,Alex Len,SAC,MIL,SAC,,,10,9,5,6
22023,203458,22300532,"JAN 12, 2024",SAC @ PHI,L,8,1,1,1.0,0,0,0.0,0,0,0.0,2,2,4,1,0,0,0,1,2,-1,1,Alex Len,SAC,PHI,SAC,,,7,6,3,5
22023,203458,22300518,"JAN 10, 2024",SAC @ CHA,W,16,4,6,0.667,0,0,0.0,0,0,0.0,4,6,10,1,1,1,1,2,8,28,1,Alex Len,SAC,CHA,SAC,,,19,18,9,11
22023,203458,22300512,"JAN 09, 2024",SAC @ DET,W,10,3,3,1.0,0,0,0.0,0,1,0.0,1,2,3,0,0,1,1,1,6,-7,1,Alex Len,SAC,DET,SAC,,,9,9,6,3
22023,203458,22300500,"JAN 07, 2024",SAC vs. NOP,L,10,0,2,0.0,0,0,0.0,0,0,0.0,1,0,1,3,1,0,0,1,0,14,1,Alex Len,SAC,SAC,NOP,,,4,1,3,4
22023,203458,22300464,"JAN 02, 2024",SAC vs. CHA,L,13,1,1,1.0,0,0,0.0,1,2,0.5,0,4,4,3,0,0,1,2,3,-1,1,Alex Len,SAC,SAC,CHA,,,10,7,6,7
22023,203458,22300449,"DEC 31, 2023",SAC @ MEM,W,12,0,1,0.0,0,0,0.0,0,0,0.0,4,5,9,1,0,1,2,3,0,10,1,Alex Len,SAC,MEM,SAC,,,10,9,1,10
22023,203458,22300431,"DEC 29, 2023",SAC @ ATL,W,13,1,2,0.5,0,0,0.0,0,0,0.0,1,3,4,4,0,0,0,0,2,11,1,Alex Len,SAC,ATL,SAC,,,10,6,6,8
22023,203458,22300413,"DEC 26, 2023",SAC @ POR,L,2,0,0,0.0,0,0,0.0,0,0,0.0,0,0,0,0,0,0,0,0,0,2,1,Alex Len,SAC,POR,SAC,,,0,0,0,0
22023,203458,22300191,"NOV 13, 2023",SAC vs. CLE,W,6,1,2,0.5,0,0,0.0,0,0,0.0,0,0,0,3,0,0,0,0,2,4,1,Alex Len,SAC,SAC,CLE,,,5,2,5,3
22023,203458,22300016,"NOV 10, 2023",SAC vs. OKC,W,10,1,1,1.0,0,0,0.0,1,2,0.5,3,3,6,0,0,2,2,1,3,-1,1,Alex Len,SAC,SAC,OKC,,,9,9,3,6
22023,203458,22300170,"NOV 08, 2023",SAC vs. POR,W,13,4,4,1.0,0,0,0.0,2,5,0.4,3,3,6,1,1,2,0,1,10,8,1,Alex Len,SAC,SAC,POR,,,17,16,11,7
22023,203458,22300153,"NOV 06, 2023",SAC @ HOU,L,8,0,1,0.0,0,1,0.0,0,0,0.0,1,2,3,1,0,1,0,0,0,10,1,Alex Len,SAC,HOU,SAC,,,4,3,1,4
22023,203458,22300137,"NOV 04, 2023",SAC @ HOU,L,3,0,0,0.0,0,0,0.0,0,0,0.0,0,1,1,0,0,0,0,0,0,1,1,Alex Len,SAC,HOU,SAC,,,1,1,0,1
22023,203458,22300072,"OCT 25, 2023",SAC @ UTA,W,2,0,0,0.0,0,0,0.0,0,0,0.0,0,0,0,0,0,0,0,0,0,-2,1,Alex Len,SAC,UTA,SAC,,,0,0,0,0
22023,202695,22300553,"JAN 14, 2024",LAC @ MIN,L,37,9,19,0.474,2,3,0.667,6,6,1.0,0,9,9,4,2,0,1,4,26,-13,1,Kawhi Leonard,LAC,MIN,LAC,26.0,Points,39,35,30,13
22023,202695,22300553,"JAN 14, 2024",LAC @ MIN,L,37,9,19,0.474,2,3,0.667,6,6,1.0,0,9,9,4,2,0,1,4,26,-13,1,Kawhi Leonard,LAC,MIN,LAC,7.0,Rebounds,39,35,30,13
22023,202695,22300553,"JAN 14, 2024",LAC @ MIN,L,37,9,19,0.474,2,3,0.667,6,6,1.0,0,9,9,4,2,0,1,4,26,-13,1,Kawhi Leonard,LAC,MIN,LAC,36.5,Pts+Rebs+Asts,39,35,30,13
22023,202695,22300553,"JAN 14, 2024",LAC @ MIN,L,37,9,19,0.474,2,3,0.667,6,6,1.0,0,9,9,4,2,0,1,4,26,-13,1,Kawhi Leonard,LAC,MIN,LAC,44.5,Fantasy Score,39,35,30,13
22023,202695,22300553,"JAN 14, 2024",LAC @ MIN,L,37,9,19,0.474,2,3,0.667,6,6,1.0,0,9,9,4,2,0,1,4,26,-13,1,Kawhi Leonard,LAC,MIN,LAC,4.0,Free Throws Made,39,35,30,13
22023,202695,22300553,"JAN 14, 2024",LAC @ MIN,L,37,9,19,0.474,2,3,0.667,6,6,1.0,0,9,9,4,2,0,1,4,26,-13,1,Kawhi Leonard,LAC,MIN,LAC,18.0,FG Attempted,39,35,30,13
22023,202695,22300553,"JAN 14, 2024",LAC @ MIN,L,37,9,19,0.474,2,3,0.667,6,6,1.0,0,9,9,4,2,0,1,4,26,-13,1,Kawhi Leonard,LAC,MIN,LAC,33.5,Pts+Rebs,39,35,30,13
22023,202695,22300553,"JAN 14, 2024",LAC @ MIN,L,37,9,19,0.474,2,3,0.667,6,6,1.0,0,9,9,4,2,0,1,4,26,-13,1,Kawhi Leonard,LAC,MIN,LAC,29.5,Pts+Asts,39,35,30,13
22023,202695,22300553,"JAN 14, 2024",LAC @ MIN,L,37,9,19,0.474,2,3,0.667,6,6,1.0,0,9,9,4,2,0,1,4,26,-13,1,Kawhi Leonard,LAC,MIN,LAC,10.5,Rebs+Asts,39,35,30,13
22023,202695,22300537,"JAN 12, 2024",LAC @ MEM,W,29,10,16,0.625,2,5,0.4,0,0,0.0,0,7,7,4,2,2,1,3,22,11,1,Kawhi Leonard,LAC,MEM,LAC,26.0,Points,33,29,26,11
22023,202695,22300537,"JAN 12, 2024",LAC @ MEM,W,29,10,16,0.625,2,5,0.4,0,0,0.0,0,7,7,4,2,2,1,3,22,11,1,Kawhi Leonard,LAC,MEM,LAC,7.0,Rebounds,33,29,26,11
22023,202695,22300537,"JAN 12, 2024",LAC @ MEM,W,29,10,16,0.625,2,5,0.4,0,0,0.0,0,7,7,4,2,2,1,3,22,11,1,Kawhi Leonard,LAC,MEM,LAC,36.5,Pts+Rebs+Asts,33,29,26,11
22023,202695,22300537,"JAN 12, 2024",LAC @ MEM,W,29,10,16,0.625,2,5,0.4,0,0,0.0,0,7,7,4,2,2,1,3,22,11,1,Kawhi Leonard,LAC,MEM,LAC,44.5,Fantasy Score,33,29,26,11
22023,202695,22300537,"JAN 12, 2024",LAC @ MEM,W,29,10,16,0.625,2,5,0.4,0,0,0.0,0,7,7,4,2,2,1,3,22,11,1,Kawhi Leonard,LAC,MEM,LAC,4.0,Free Throws Made,33,29,26,11
22023,202695,22300537,"JAN 12, 2024",LAC @ MEM,W,29,10,16,0.625,2,5,0.4,0,0,0.0,0,7,7,4,2,2,1,3,22,11,1,Kawhi Leonard,LAC,MEM,LAC,18.0,FG Attempted,33,29,26,11
22023,202695,22300537,"JAN 12, 2024",LAC @ MEM,W,29,10,16,0.625,2,5,0.4,0,0,0.0,0,7,7,4,2,2,1,3,22,11,1,Kawhi Leonard,LAC,MEM,LAC,33.5,Pts+Rebs,33,29,26,11
22023,202695,22300537,"JAN 12, 2024",LAC @ MEM,W,29,10,16,0.625,2,5,0.4,0,0,0.0,0,7,7,4,2,2,1,3,22,11,1,Kawhi Leonard,LAC,MEM,LAC,29.5,Pts+Asts,33,29,26,11
22023,202695,22300537,"JAN 12, 2024",LAC @ MEM,W,29,10,16,0.625,2,5,0.4,0,0,0.0,0,7,7,4,2,2,1,3,22,11,1,Kawhi Leonard,LAC,MEM,LAC,10.5,Rebs+Asts,33,29,26,11
22023,202695,22300526,"JAN 10, 2024",LAC vs. TOR,W,38,10,18,0.556,2,4,0.5,7,7,1.0,2,1,3,7,1,2,0,3,29,-5,1,Kawhi Leonard,LAC,LAC,TOR,26.0,Points,39,32,36,10
22023,202695,22300526,"JAN 10, 2024",LAC vs. TOR,W,38,10,18,0.556,2,4,0.5,7,7,1.0,2,1,3,7,1,2,0,3,29,-5,1,Kawhi Leonard,LAC,LAC,TOR,7.0,Rebounds,39,32,36,10
22023,202695,22300526,"JAN 10, 2024",LAC vs. TOR,W,38,10,18,0.556,2,4,0.5,7,7,1.0,2,1,3,7,1,2,0,3,29,-5,1,Kawhi Leonard,LAC,LAC,TOR,36.5,Pts+Rebs+Asts,39,32,36,10
22023,202695,22300526,"JAN 10, 2024",LAC vs. TOR,W,38,10,18,0.556,2,4,0.5,7,7,1.0,2,1,3,7,1,2,0,3,29,-5,1,Kawhi Leonard,LAC,LAC,TOR,44.5,Fantasy Score,39,32,36,10
22023,202695,22300526,"JAN 10, 2024",LAC vs. TOR,W,38,10,18,0.556,2,4,0.5,7,7,1.0,2,1,3,7,1,2,0,3,29,-5,1,Kawhi Leonard,LAC,LAC,TOR,4.0,Free Throws Made,39,32,36,10
22023,202695,22300526,"JAN 10, 2024",LAC vs. TOR,W,38,10,18,0.556,2,4,0.5,7,7,1.0,2,1,3,7,1,2,0,3,29,-5,1,Kawhi Leonard,LAC,LAC,TOR,18.0,FG Attempted,39,32,36,10
22023,202695,22300526,"JAN 10, 2024",LAC vs. TOR,W,38,10,18,0.556,2,4,0.5,7,7,1.0,2,1,3,7,1,2,0,3,29,-5,1,Kawhi Leonard,LAC,LAC,TOR,33.5,Pts+Rebs,39,32,36,10
22023,202695,22300526,"JAN 10, 2024",LAC vs. TOR,W,38,10,18,0.556,2,4,0.5,7,7,1.0,2,1,3,7,1,2,0,3,29,-5,1,Kawhi Leonard,LAC,LAC,TOR,29.5,Pts+Asts,39,32,36,10
22023,202695,22300526,"JAN 10, 2024",LAC vs. TOR,W,38,10,18,0.556,2,4,0.5,7,7,1.0,2,1,3,7,1,2,0,3,29,-5,1,Kawhi Leonard,LAC,LAC,TOR,10.5,Rebs+Asts,39,32,36,10
22023,202695,22300511,"JAN 08, 2024",LAC vs. PHX,W,32,8,15,0.533,1,3,0.333,0,0,0.0,0,3,3,2,5,1,3,1,17,11,1,Kawhi Leonard,LAC,LAC,PHX,26.0,Points,22,20,19,5
22023,202695,22300511,"JAN 08, 2024",LAC vs. PHX,W,32,8,15,0.533,1,3,0.333,0,0,0.0,0,3,3,2,5,1,3,1,17,11,1,Kawhi Leonard,LAC,LAC,PHX,7.0,Rebounds,22,20,19,5
22023,202695,22300511,"JAN 08, 2024",LAC vs. PHX,W,32,8,15,0.533,1,3,0.333,0,0,0.0,0,3,3,2,5,1,3,1,17,11,1,Kawhi Leonard,LAC,LAC,PHX,36.5,Pts+Rebs+Asts,22,20,19,5
22023,202695,22300511,"JAN 08, 2024",LAC vs. PHX,W,32,8,15,0.533,1,3,0.333,0,0,0.0,0,3,3,2,5,1,3,1,17,11,1,Kawhi Leonard,LAC,LAC,PHX,44.5,Fantasy Score,22,20,19,5
22023,202695,22300511,"JAN 08, 2024",LAC vs. PHX,W,32,8,15,0.533,1,3,0.333,0,0,0.0,0,3,3,2,5,1,3,1,17,11,1,Kawhi Leonard,LAC,LAC,PHX,4.0,Free Throws Made,22,20,19,5
22023,202695,22300511,"JAN 08, 2024",LAC vs. PHX,W,32,8,15,0.533,1,3,0.333,0,0,0.0,0,3,3,2,5,1,3,1,17,11,1,Kawhi Leonard,LAC,LAC,PHX,18.0,FG Attempted,22,20,19,5
22023,202695,22300511,"JAN 08, 2024",LAC vs. PHX,W,32,8,15,0.533,1,3,0.333,0,0,0.0,0,3,3,2,5,1,3,1,17,11,1,Kawhi Leonard,LAC,LAC,PHX,33.5,Pts+Rebs,22,20,19,5
22023,202695,22300511,"JAN 08, 2024",LAC vs. PHX,W,32,8,15,0.533,1,3,0.333,0,0,0.0,0,3,3,2,5,1,3,1,17,11,1,Kawhi Leonard,LAC,LAC,PHX,29.5,Pts+Asts,22,20,19,5
22023,202695,22300511,"JAN 08, 2024",LAC vs. PHX,W,32,8,15,0.533,1,3,0.333,0,0,0.0,0,3,3,2,5,1,3,1,17,11,1,Kawhi Leonard,LAC,LAC,PHX,10.5,Rebs+Asts,22,20,19,5
22023,202695,22300505,"JAN 07, 2024",LAC @ LAL,L,35,6,17,0.353,2,7,0.286,1,2,0.5,0,8,8,2,3,2,3,4,15,4,1,Kawhi Leonard,LAC,LAL,LAC,26.0,Points,25,23,17,10
22023,202695,22300505,"JAN 07, 2024",LAC @ LAL,L,35,6,17,0.353,2,7,0.286,1,2,0.5,0,8,8,2,3,2,3,4,15,4,1,Kawhi Leonard,LAC,LAL,LAC,7.0,Rebounds,25,23,17,10
22023,202695,22300505,"JAN 07, 2024",LAC @ LAL,L,35,6,17,0.353,2,7,0.286,1,2,0.5,0,8,8,2,3,2,3,4,15,4,1,Kawhi Leonard,LAC,LAL,LAC,36.5,Pts+Rebs+Asts,25,23,17,10
22023,202695,22300505,"JAN 07, 2024",LAC @ LAL,L,35,6,17,0.353,2,7,0.286,1,2,0.5,0,8,8,2,3,2,3,4,15,4,1,Kawhi Leonard,LAC,LAL,LAC,44.5,Fantasy Score,25,23,17,10
22023,202695,22300505,"JAN 07, 2024",LAC @ LAL,L,35,6,17,0.353,2,7,0.286,1,2,0.5,0,8,8,2,3,2,3,4,15,4,1,Kawhi Leonard,LAC,LAL,LAC,4.0,Free Throws Made,25,23,17,10
22023,202695,22300505,"JAN 07, 2024",LAC @ LAL,L,35,6,17,0.353,2,7,0.286,1,2,0.5,0,8,8,2,3,2,3,4,15,4,1,Kawhi Leonard,LAC,LAL,LAC,18.0,FG Attempted,25,23,17,10
22023,202695,22300505,"JAN 07, 2024",LAC @ LAL,L,35,6,17,0.353,2,7,0.286,1,2,0.5,0,8,8,2,3,2,3,4,15,4,1,Kawhi Leonard,LAC,LAL,LAC,33.5,Pts+Rebs,25,23,17,10
22023,202695,22300505,"JAN 07, 2024",LAC @ LAL,L,35,6,17,0.353,2,7,0.286,1,2,0.5,0,8,8,2,3,2,3,4,15,4,1,Kawhi Leonard,LAC,LAL,LAC,29.5,Pts+Asts,25,23,17,10
22023,202695,22300505,"JAN 07, 2024",LAC @ LAL,L,35,6,17,0.353,2,7,0.286,1,2,0.5,0,8,8,2,3,2,3,4,15,4,1,Kawhi Leonard,LAC,LAL,LAC,10.5,Rebs+Asts,25,23,17,10
22023,202695,22300486,"JAN 05, 2024",LAC @ NOP,W,30,7,15,0.467,2,4,0.5,3,4,0.75,2,7,9,2,1,1,2,1,19,6,1,Kawhi Leonard,LAC,NOP,LAC,26.0,Points,30,28,21,11
22023,202695,22300486,"JAN 05, 2024",LAC @ NOP,W,30,7,15,0.467,2,4,0.5,3,4,0.75,2,7,9,2,1,1,2,1,19,6,1,Kawhi Leonard,LAC,NOP,LAC,7.0,Rebounds,30,28,21,11
22023,202695,22300486,"JAN 05, 2024",LAC @ NOP,W,30,7,15,0.467,2,4,0.5,3,4,0.75,2,7,9,2,1,1,2,1,19,6,1,Kawhi Leonard,LAC,NOP,LAC,36.5,Pts+Rebs+Asts,30,28,21,11
22023,202695,22300486,"JAN 05, 2024",LAC @ NOP,W,30,7,15,0.467,2,4,0.5,3,4,0.75,2,7,9,2,1,1,2,1,19,6,1,Kawhi Leonard,LAC,NOP,LAC,44.5,Fantasy Score,30,28,21,11
22023,202695,22300486,"JAN 05, 2024",LAC @ NOP,W,30,7,15,0.467,2,4,0.5,3,4,0.75,2,7,9,2,1,1,2,1,19,6,1,Kawhi Leonard,LAC,NOP,LAC,4.0,Free Throws Made,30,28,21,11
22023,202695,22300486,"JAN 05, 2024",LAC @ NOP,W,30,7,15,0.467,2,4,0.5,3,4,0.75,2,7,9,2,1,1,2,1,19,6,1,Kawhi Leonard,LAC,NOP,LAC,18.0,FG Attempted,30,28,21,11
22023,202695,22300486,"JAN 05, 2024",LAC @ NOP,W,30,7,15,0.467,2,4,0.5,3,4,0.75,2,7,9,2,1,1,2,1,19,6,1,Kawhi Leonard,LAC,NOP,LAC,33.5,Pts+Rebs,30,28,21,11
22023,202695,22300486,"JAN 05, 2024",LAC @ NOP,W,30,7,15,0.467,2,4,0.5,3,4,0.75,2,7,9,2,1,1,2,1,19,6,1,Kawhi Leonard,LAC,NOP,LAC,29.5,Pts+Asts,30,28,21,11
22023,202695,22300486,"JAN 05, 2024",LAC @ NOP,W,30,7,15,0.467,2,4,0.5,3,4,0.75,2,7,9,2,1,1,2,1,19,6,1,Kawhi Leonard,LAC,NOP,LAC,10.5,Rebs+Asts,30,28,21,11
22023,202695,22300473,"JAN 03, 2024",LAC @ PHX,W,40,9,16,0.563,4,6,0.667,8,8,1.0,2,6,8,3,2,2,2,1,30,11,1,Kawhi Leonard,LAC,PHX,LAC,26.0,Points,41,38,33,11
22023,202695,22300473,"JAN 03, 2024",LAC @ PHX,W,40,9,16,0.563,4,6,0.667,8,8,1.0,2,6,8,3,2,2,2,1,30,11,1,Kawhi Leonard,LAC,PHX,LAC,7.0,Rebounds,41,38,33,11
22023,202695,22300473,"JAN 03, 2024",LAC @ PHX,W,40,9,16,0.563,4,6,0.667,8,8,1.0,2,6,8,3,2,2,2,1,30,11,1,Kawhi Leonard,LAC,PHX,LAC,36.5,Pts+Rebs+Asts,41,38,33,11
22023,202695,22300473,"JAN 03, 2024",LAC @ PHX,W,40,9,16,0.563,4,6,0.667,8,8,1.0,2,6,8,3,2,2,2,1,30,11,1,Kawhi Leonard,LAC,PHX,LAC,44.5,Fantasy Score,41,38,33,11
22023,202695,22300473,"JAN 03, 2024",LAC @ PHX,W,40,9,16,0.563,4,6,0.667,8,8,1.0,2,6,8,3,2,2,2,1,30,11,1,Kawhi Leonard,LAC,PHX,LAC,4.0,Free Throws Made,41,38,33,11
22023,202695,22300473,"JAN 03, 2024",LAC @ PHX,W,40,9,16,0.563,4,6,0.667,8,8,1.0,2,6,8,3,2,2,2,1,30,11,1,Kawhi Leonard,LAC,PHX,LAC,18.0,FG Attempted,41,38,33,11
22023,202695,22300473,"JAN 03, 2024",LAC @ PHX,W,40,9,16,0.563,4,6,0.667,8,8,1.0,2,6,8,3,2,2,2,1,30,11,1,Kawhi Leonard,LAC,PHX,LAC,33.5,Pts+Rebs,41,38,33,11
22023,202695,22300473,"JAN 03, 2024",LAC @ PHX,W,40,9,16,0.563,4,6,0.667,8,8,1.0,2,6,8,3,2,2,2,1,30,11,1,Kawhi Leonard,LAC,PHX,LAC,29.5,Pts+Asts,41,38,33,11
22023,202695,22300473,"JAN 03, 2024",LAC @ PHX,W,40,9,16,0.563,4,6,0.667,8,8,1.0,2,6,8,3,2,2,2,1,30,11,1,Kawhi Leonard,LAC,PHX,LAC,10.5,Rebs+Asts,41,38,33,11
22023,202695,22300458,"JAN 01, 2024",LAC vs. MIA,W,34,10,19,0.526,2,5,0.4,2,3,0.667,1,5,6,5,4,1,2,0,24,24,1,Kawhi Leonard,LAC,LAC,MIA,26.0,Points,35,30,29,11
22023,202695,22300458,"JAN 01, 2024",LAC vs. MIA,W,34,10,19,0.526,2,5,0.4,2,3,0.667,1,5,6,5,4,1,2,0,24,24,1,Kawhi Leonard,LAC,LAC,MIA,7.0,Rebounds,35,30,29,11
22023,202695,22300458,"JAN 01, 2024",LAC vs. MIA,W,34,10,19,0.526,2,5,0.4,2,3,0.667,1,5,6,5,4,1,2,0,24,24,1,Kawhi Leonard,LAC,LAC,MIA,36.5,Pts+Rebs+Asts,35,30,29,11
22023,202695,22300458,"JAN 01, 2024",LAC vs. MIA,W,34,10,19,0.526,2,5,0.4,2,3,0.667,1,5,6,5,4,1,2,0,24,24,1,Kawhi Leonard,LAC,LAC,MIA,44.5,Fantasy Score,35,30,29,11
22023,202695,22300458,"JAN 01, 2024",LAC vs. MIA,W,34,10,19,0.526,2,5,0.4,2,3,0.667,1,5,6,5,4,1,2,0,24,24,1,Kawhi Leonard,LAC,LAC,MIA,4.0,Free Throws Made,35,30,29,11
22023,202695,22300458,"JAN 01, 2024",LAC vs. MIA,W,34,10,19,0.526,2,5,0.4,2,3,0.667,1,5,6,5,4,1,2,0,24,24,1,Kawhi Leonard,LAC,LAC,MIA,18.0,FG Attempted,35,30,29,11
22023,202695,22300458,"JAN 01, 2024",LAC vs. MIA,W,34,10,19,0.526,2,5,0.4,2,3,0.667,1,5,6,5,4,1,2,0,24,24,1,Kawhi Leonard,LAC,LAC,MIA,33.5,Pts+Rebs,35,30,29,11
22023,202695,22300458,"JAN 01, 2024",LAC vs. MIA,W,34,10,19,0.526,2,5,0.4,2,3,0.667,1,5,6,5,4,1,2,0,24,24,1,Kawhi Leonard,LAC,LAC,MIA,29.5,Pts+Asts,35,30,29,11
22023,202695,22300458,"JAN 01, 2024",LAC vs. MIA,W,34,10,19,0.526,2,5,0.4,2,3,0.667,1,5,6,5,4,1,2,0,24,24,1,Kawhi Leonard,LAC,LAC,MIA,10.5,Rebs+Asts,35,30,29,11
22023,202695,22300372,"DEC 20, 2023",LAC @ DAL,W,37,12,22,0.545,1,6,0.167,5,5,1.0,3,7,10,5,1,1,0,0,30,7,1,Kawhi Leonard,LAC,DAL,LAC,26.0,Points,45,40,35,15
22023,202695,22300372,"DEC 20, 2023",LAC @ DAL,W,37,12,22,0.545,1,6,0.167,5,5,1.0,3,7,10,5,1,1,0,0,30,7,1,Kawhi Leonard,LAC,DAL,LAC,7.0,Rebounds,45,40,35,15
22023,202695,22300372,"DEC 20, 2023",LAC @ DAL,W,37,12,22,0.545,1,6,0.167,5,5,1.0,3,7,10,5,1,1,0,0,30,7,1,Kawhi Leonard,LAC,DAL,LAC,36.5,Pts+Rebs+Asts,45,40,35,15
22023,202695,22300372,"DEC 20, 2023",LAC @ DAL,W,37,12,22,0.545,1,6,0.167,5,5,1.0,3,7,10,5,1,1,0,0,30,7,1,Kawhi Leonard,LAC,DAL,LAC,44.5,Fantasy Score,45,40,35,15
22023,202695,22300372,"DEC 20, 2023",LAC @ DAL,W,37,12,22,0.545,1,6,0.167,5,5,1.0,3,7,10,5,1,1,0,0,30,7,1,Kawhi Leonard,LAC,DAL,LAC,4.0,Free Throws Made,45,40,35,15
22023,202695,22300372,"DEC 20, 2023",LAC @ DAL,W,37,12,22,0.545,1,6,0.167,5,5,1.0,3,7,10,5,1,1,0,0,30,7,1,Kawhi Leonard,LAC,DAL,LAC,18.0,FG Attempted,45,40,35,15
22023,202695,22300372,"DEC 20, 2023",LAC @ DAL,W,37,12,22,0.545,1,6,0.167,5,5,1.0,3,7,10,5,1,1,0,0,30,7,1,Kawhi Leonard,LAC,DAL,LAC,33.5,Pts+Rebs,45,40,35,15
22023,202695,22300372,"DEC 20, 2023",LAC @ DAL,W,37,12,22,0.545,1,6,0.167,5,5,1.0,3,7,10,5,1,1,0,0,30,7,1,Kawhi Leonard,LAC,DAL,LAC,29.5,Pts+Asts,45,40,35,15
22023,202695,22300372,"DEC 20, 2023",LAC @ DAL,W,37,12,22,0.545,1,6,0.167,5,5,1.0,3,7,10,5,1,1,0,0,30,7,1,Kawhi Leonard,LAC,DAL,LAC,10.5,Rebs+Asts,45,40,35,15
22023,202695,22300350,"DEC 18, 2023",LAC @ IND,W,27,12,18,0.667,2,5,0.4,2,2,1.0,1,1,2,1,1,0,3,2,28,27,1,Kawhi Leonard,LAC,IND,LAC,26.0,Points,31,30,29,3
22023,202695,22300350,"DEC 18, 2023",LAC @ IND,W,27,12,18,0.667,2,5,0.4,2,2,1.0,1,1,2,1,1,0,3,2,28,27,1,Kawhi Leonard,LAC,IND,LAC,7.0,Rebounds,31,30,29,3
22023,202695,22300350,"DEC 18, 2023",LAC @ IND,W,27,12,18,0.667,2,5,0.4,2,2,1.0,1,1,2,1,1,0,3,2,28,27,1,Kawhi Leonard,LAC,IND,LAC,36.5,Pts+Rebs+Asts,31,30,29,3
22023,202695,22300350,"DEC 18, 2023",LAC @ IND,W,27,12,18,0.667,2,5,0.4,2,2,1.0,1,1,2,1,1,0,3,2,28,27,1,Kawhi Leonard,LAC,IND,LAC,44.5,Fantasy Score,31,30,29,3
22023,202695,22300350,"DEC 18, 2023",LAC @ IND,W,27,12,18,0.667,2,5,0.4,2,2,1.0,1,1,2,1,1,0,3,2,28,27,1,Kawhi Leonard,LAC,IND,LAC,4.0,Free Throws Made,31,30,29,3
22023,202695,22300350,"DEC 18, 2023",LAC @ IND,W,27,12,18,0.667,2,5,0.4,2,2,1.0,1,1,2,1,1,0,3,2,28,27,1,Kawhi Leonard,LAC,IND,LAC,18.0,FG Attempted,31,30,29,3
22023,202695,22300350,"DEC 18, 2023",LAC @ IND,W,27,12,18,0.667,2,5,0.4,2,2,1.0,1,1,2,1,1,0,3,2,28,27,1,Kawhi Leonard,LAC,IND,LAC,33.5,Pts+Rebs,31,30,29,3
22023,202695,22300350,"DEC 18, 2023",LAC @ IND,W,27,12,18,0.667,2,5,0.4,2,2,1.0,1,1,2,1,1,0,3,2,28,27,1,Kawhi Leonard,LAC,IND,LAC,29.5,Pts+Asts,31,30,29,3
22023,202695,22300350,"DEC 18, 2023",LAC @ IND,W,27,12,18,0.667,2,5,0.4,2,2,1.0,1,1,2,1,1,0,3,2,28,27,1,Kawhi Leonard,LAC,IND,LAC,10.5,Rebs+Asts,31,30,29,3
22023,202695,22300343,"DEC 16, 2023",LAC vs. NYK,W,30,12,16,0.75,5,6,0.833,7,7,1.0,1,6,7,4,2,0,0,1,36,15,1,Kawhi Leonard,LAC,LAC,NYK,26.0,Points,47,43,40,11
22023,202695,22300343,"DEC 16, 2023",LAC vs. NYK,W,30,12,16,0.75,5,6,0.833,7,7,1.0,1,6,7,4,2,0,0,1,36,15,1,Kawhi Leonard,LAC,LAC,NYK,7.0,Rebounds,47,43,40,11
22023,202695,22300343,"DEC 16, 2023",LAC vs. NYK,W,30,12,16,0.75,5,6,0.833,7,7,1.0,1,6,7,4,2,0,0,1,36,15,1,Kawhi Leonard,LAC,LAC,NYK,36.5,Pts+Rebs+Asts,47,43,40,11
22023,202695,22300343,"DEC 16, 2023",LAC vs. NYK,W,30,12,16,0.75,5,6,0.833,7,7,1.0,1,6,7,4,2,0,0,1,36,15,1,Kawhi Leonard,LAC,LAC,NYK,44.5,Fantasy Score,47,43,40,11
22023,202695,22300343,"DEC 16, 2023",LAC vs. NYK,W,30,12,16,0.75,5,6,0.833,7,7,1.0,1,6,7,4,2,0,0,1,36,15,1,Kawhi Leonard,LAC,LAC,NYK,4.0,Free Throws Made,47,43,40,11
22023,202695,22300343,"DEC 16, 2023",LAC vs. NYK,W,30,12,16,0.75,5,6,0.833,7,7,1.0,1,6,7,4,2,0,0,1,36,15,1,Kawhi Leonard,LAC,LAC,NYK,18.0,FG Attempted,47,43,40,11
22023,202695,22300343,"DEC 16, 2023",LAC vs. NYK,W,30,12,16,0.75,5,6,0.833,7,7,1.0,1,6,7,4,2,0,0,1,36,15,1,Kawhi Leonard,LAC,LAC,NYK,33.5,Pts+Rebs,47,43,40,11
22023,202695,22300343,"DEC 16, 2023",LAC vs. NYK,W,30,12,16,0.75,5,6,0.833,7,7,1.0,1,6,7,4,2,0,0,1,36,15,1,Kawhi Leonard,LAC,LAC,NYK,29.5,Pts+Asts,47,43,40,11
22023,202695,22300343,"DEC 16, 2023",LAC vs. NYK,W,30,12,16,0.75,5,6,0.833,7,7,1.0,1,6,7,4,2,0,0,1,36,15,1,Kawhi Leonard,LAC,LAC,NYK,10.5,Rebs+Asts,47,43,40,11
22023,202695,22300325,"DEC 14, 2023",LAC vs. GSW,W,39,9,16,0.563,2,4,0.5,7,9,0.778,3,5,8,2,1,1,2,2,27,-1,1,Kawhi Leonard,LAC,LAC,GSW,26.0,Points,37,35,29,10
22023,202695,22300325,"DEC 14, 2023",LAC vs. GSW,W,39,9,16,0.563,2,4,0.5,7,9,0.778,3,5,8,2,1,1,2,2,27,-1,1,Kawhi Leonard,LAC,LAC,GSW,7.0,Rebounds,37,35,29,10
22023,202695,22300325,"DEC 14, 2023",LAC vs. GSW,W,39,9,16,0.563,2,4,0.5,7,9,0.778,3,5,8,2,1,1,2,2,27,-1,1,Kawhi Leonard,LAC,LAC,GSW,36.5,Pts+Rebs+Asts,37,35,29,10
22023,202695,22300325,"DEC 14, 2023",LAC vs. GSW,W,39,9,16,0.563,2,4,0.5,7,9,0.778,3,5,8,2,1,1,2,2,27,-1,1,Kawhi Leonard,LAC,LAC,GSW,44.5,Fantasy Score,37,35,29,10
22023,202695,22300325,"DEC 14, 2023",LAC vs. GSW,W,39,9,16,0.563,2,4,0.5,7,9,0.778,3,5,8,2,1,1,2,2,27,-1,1,Kawhi Leonard,LAC,LAC,GSW,4.0,Free Throws Made,37,35,29,10
22023,202695,22300325,"DEC 14, 2023",LAC vs. GSW,W,39,9,16,0.563,2,4,0.5,7,9,0.778,3,5,8,2,1,1,2,2,27,-1,1,Kawhi Leonard,LAC,LAC,GSW,18.0,FG Attempted,37,35,29,10
22023,202695,22300325,"DEC 14, 2023",LAC vs. GSW,W,39,9,16,0.563,2,4,0.5,7,9,0.778,3,5,8,2,1,1,2,2,27,-1,1,Kawhi Leonard,LAC,LAC,GSW,33.5,Pts+Rebs,37,35,29,10
22023,202695,22300325,"DEC 14, 2023",LAC vs. GSW,W,39,9,16,0.563,2,4,0.5,7,9,0.778,3,5,8,2,1,1,2,2,27,-1,1,Kawhi Leonard,LAC,LAC,GSW,29.5,Pts+Asts,37,35,29,10
22023,202695,22300325,"DEC 14, 2023",LAC vs. GSW,W,39,9,16,0.563,2,4,0.5,7,9,0.778,3,5,8,2,1,1,2,2,27,-1,1,Kawhi Leonard,LAC,LAC,GSW,10.5,Rebs+Asts,37,35,29,10
22023,202695,22300309,"DEC 12, 2023",LAC vs. SAC,W,31,11,14,0.786,2,3,0.667,7,7,1.0,0,4,4,3,1,1,1,0,31,21,1,Kawhi Leonard,LAC,LAC,SAC,26.0,Points,38,35,34,7
22023,202695,22300309,"DEC 12, 2023",LAC vs. SAC,W,31,11,14,0.786,2,3,0.667,7,7,1.0,0,4,4,3,1,1,1,0,31,21,1,Kawhi Leonard,LAC,LAC,SAC,7.0,Rebounds,38,35,34,7
22023,202695,22300309,"DEC 12, 2023",LAC vs. SAC,W,31,11,14,0.786,2,3,0.667,7,7,1.0,0,4,4,3,1,1,1,0,31,21,1,Kawhi Leonard,LAC,LAC,SAC,36.5,Pts+Rebs+Asts,38,35,34,7
22023,202695,22300309,"DEC 12, 2023",LAC vs. SAC,W,31,11,14,0.786,2,3,0.667,7,7,1.0,0,4,4,3,1,1,1,0,31,21,1,Kawhi Leonard,LAC,LAC,SAC,44.5,Fantasy Score,38,35,34,7
22023,202695,22300309,"DEC 12, 2023",LAC vs. SAC,W,31,11,14,0.786,2,3,0.667,7,7,1.0,0,4,4,3,1,1,1,0,31,21,1,Kawhi Leonard,LAC,LAC,SAC,4.0,Free Throws Made,38,35,34,7
22023,202695,22300309,"DEC 12, 2023",LAC vs. SAC,W,31,11,14,0.786,2,3,0.667,7,7,1.0,0,4,4,3,1,1,1,0,31,21,1,Kawhi Leonard,LAC,LAC,SAC,18.0,FG Attempted,38,35,34,7
22023,202695,22300309,"DEC 12, 2023",LAC vs. SAC,W,31,11,14,0.786,2,3,0.667,7,7,1.0,0,4,4,3,1,1,1,0,31,21,1,Kawhi Leonard,LAC,LAC,SAC,33.5,Pts+Rebs,38,35,34,7
22023,202695,22300309,"DEC 12, 2023",LAC vs. SAC,W,31,11,14,0.786,2,3,0.667,7,7,1.0,0,4,4,3,1,1,1,0,31,21,1,Kawhi Leonard,LAC,LAC,SAC,29.5,Pts+Asts,38,35,34,7
22023,202695,22300309,"DEC 12, 2023",LAC vs. SAC,W,31,11,14,0.786,2,3,0.667,7,7,1.0,0,4,4,3,1,1,1,0,31,21,1,Kawhi Leonard,LAC,LAC,SAC,10.5,Rebs+Asts,38,35,34,7
22023,202695,22300304,"DEC 11, 2023",LAC vs. POR,W,39,11,19,0.579,3,8,0.375,9,9,1.0,0,6,6,5,3,0,1,2,34,13,1,Kawhi Leonard,LAC,LAC,POR,26.0,Points,45,40,39,11
22023,202695,22300304,"DEC 11, 2023",LAC vs. POR,W,39,11,19,0.579,3,8,0.375,9,9,1.0,0,6,6,5,3,0,1,2,34,13,1,Kawhi Leonard,LAC,LAC,POR,7.0,Rebounds,45,40,39,11
22023,202695,22300304,"DEC 11, 2023",LAC vs. POR,W,39,11,19,0.579,3,8,0.375,9,9,1.0,0,6,6,5,3,0,1,2,34,13,1,Kawhi Leonard,LAC,LAC,POR,36.5,Pts+Rebs+Asts,45,40,39,11
22023,202695,22300304,"DEC 11, 2023",LAC vs. POR,W,39,11,19,0.579,3,8,0.375,9,9,1.0,0,6,6,5,3,0,1,2,34,13,1,Kawhi Leonard,LAC,LAC,POR,44.5,Fantasy Score,45,40,39,11
22023,202695,22300304,"DEC 11, 2023",LAC vs. POR,W,39,11,19,0.579,3,8,0.375,9,9,1.0,0,6,6,5,3,0,1,2,34,13,1,Kawhi Leonard,LAC,LAC,POR,4.0,Free Throws Made,45,40,39,11
22023,202695,22300304,"DEC 11, 2023",LAC vs. POR,W,39,11,19,0.579,3,8,0.375,9,9,1.0,0,6,6,5,3,0,1,2,34,13,1,Kawhi Leonard,LAC,LAC,POR,18.0,FG Attempted,45,40,39,11
22023,202695,22300304,"DEC 11, 2023",LAC vs. POR,W,39,11,19,0.579,3,8,0.375,9,9,1.0,0,6,6,5,3,0,1,2,34,13,1,Kawhi Leonard,LAC,LAC,POR,33.5,Pts+Rebs,45,40,39,11
22023,202695,22300304,"DEC 11, 2023",LAC vs. POR,W,39,11,19,0.579,3,8,0.375,9,9,1.0,0,6,6,5,3,0,1,2,34,13,1,Kawhi Leonard,LAC,LAC,POR,29.5,Pts+Asts,45,40,39,11
22023,202695,22300304,"DEC 11, 2023",LAC vs. POR,W,39,11,19,0.579,3,8,0.375,9,9,1.0,0,6,6,5,3,0,1,2,34,13,1,Kawhi Leonard,LAC,LAC,POR,10.5,Rebs+Asts,45,40,39,11
22023,202695,22301225,"DEC 08, 2023",LAC @ UTA,W,38,14,23,0.609,6,8,0.75,7,7,1.0,3,2,5,5,0,1,2,1,41,18,1,Kawhi Leonard,LAC,UTA,LAC,26.0,Points,51,46,46,10
22023,202695,22301225,"DEC 08, 2023",LAC @ UTA,W,38,14,23,0.609,6,8,0.75,7,7,1.0,3,2,5,5,0,1,2,1,41,18,1,Kawhi Leonard,LAC,UTA,LAC,7.0,Rebounds,51,46,46,10
22023,202695,22301225,"DEC 08, 2023",LAC @ UTA,W,38,14,23,0.609,6,8,0.75,7,7,1.0,3,2,5,5,0,1,2,1,41,18,1,Kawhi Leonard,LAC,UTA,LAC,36.5,Pts+Rebs+Asts,51,46,46,10
22023,202695,22301225,"DEC 08, 2023",LAC @ UTA,W,38,14,23,0.609,6,8,0.75,7,7,1.0,3,2,5,5,0,1,2,1,41,18,1,Kawhi Leonard,LAC,UTA,LAC,44.5,Fantasy Score,51,46,46,10
22023,202695,22301225,"DEC 08, 2023",LAC @ UTA,W,38,14,23,0.609,6,8,0.75,7,7,1.0,3,2,5,5,0,1,2,1,41,18,1,Kawhi Leonard,LAC,UTA,LAC,4.0,Free Throws Made,51,46,46,10
22023,202695,22301225,"DEC 08, 2023",LAC @ UTA,W,38,14,23,0.609,6,8,0.75,7,7,1.0,3,2,5,5,0,1,2,1,41,18,1,Kawhi Leonard,LAC,UTA,LAC,18.0,FG Attempted,51,46,46,10
22023,202695,22301225,"DEC 08, 2023",LAC @ UTA,W,38,14,23,0.609,6,8,0.75,7,7,1.0,3,2,5,5,0,1,2,1,41,18,1,Kawhi Leonard,LAC,UTA,LAC,33.5,Pts+Rebs,51,46,46,10
22023,202695,22301225,"DEC 08, 2023",LAC @ UTA,W,38,14,23,0.609,6,8,0.75,7,7,1.0,3,2,5,5,0,1,2,1,41,18,1,Kawhi Leonard,LAC,UTA,LAC,29.5,Pts+Asts,51,46,46,10
22023,202695,22301225,"DEC 08, 2023",LAC @ UTA,W,38,14,23,0.609,6,8,0.75,7,7,1.0,3,2,5,5,0,1,2,1,41,18,1,Kawhi Leonard,LAC,UTA,LAC,10.5,Rebs+Asts,51,46,46,10
22023,202695,22301215,"DEC 06, 2023",LAC vs. DEN,W,38,8,16,0.5,1,3,0.333,0,0,0.0,1,3,4,5,1,1,2,2,17,-8,1,Kawhi Leonard,LAC,LAC,DEN,26.0,Points,26,21,22,9
22023,202695,22301215,"DEC 06, 2023",LAC vs. DEN,W,38,8,16,0.5,1,3,0.333,0,0,0.0,1,3,4,5,1,1,2,2,17,-8,1,Kawhi Leonard,LAC,LAC,DEN,7.0,Rebounds,26,21,22,9
22023,202695,22301215,"DEC 06, 2023",LAC vs. DEN,W,38,8,16,0.5,1,3,0.333,0,0,0.0,1,3,4,5,1,1,2,2,17,-8,1,Kawhi Leonard,LAC,LAC,DEN,36.5,Pts+Rebs+Asts,26,21,22,9
22023,202695,22301215,"DEC 06, 2023",LAC vs. DEN,W,38,8,16,0.5,1,3,0.333,0,0,0.0,1,3,4,5,1,1,2,2,17,-8,1,Kawhi Leonard,LAC,LAC,DEN,44.5,Fantasy Score,26,21,22,9
22023,202695,22301215,"DEC 06, 2023",LAC vs. DEN,W,38,8,16,0.5,1,3,0.333,0,0,0.0,1,3,4,5,1,1,2,2,17,-8,1,Kawhi Leonard,LAC,LAC,DEN,4.0,Free Throws Made,26,21,22,9
22023,202695,22301215,"DEC 06, 2023",LAC vs. DEN,W,38,8,16,0.5,1,3,0.333,0,0,0.0,1,3,4,5,1,1,2,2,17,-8,1,Kawhi Leonard,LAC,LAC,DEN,18.0,FG Attempted,26,21,22,9
22023,202695,22301215,"DEC 06, 2023",LAC vs. DEN,W,38,8,16,0.5,1,3,0.333,0,0,0.0,1,3,4,5,1,1,2,2,17,-8,1,Kawhi Leonard,LAC,LAC,DEN,33.5,Pts+Rebs,26,21,22,9
22023,202695,22301215,"DEC 06, 2023",LAC vs. DEN,W,38,8,16,0.5,1,3,0.333,0,0,0.0,1,3,4,5,1,1,2,2,17,-8,1,Kawhi Leonard,LAC,LAC,DEN,29.5,Pts+Asts,26,21,22,9
22023,202695,22301215,"DEC 06, 2023",LAC vs. DEN,W,38,8,16,0.5,1,3,0.333,0,0,0.0,1,3,4,5,1,1,2,2,17,-8,1,Kawhi Leonard,LAC,LAC,DEN,10.5,Rebs+Asts,26,21,22,9
22023,202695,22300280,"DEC 02, 2023",LAC vs. GSW,W,39,9,16,0.563,2,5,0.4,0,0,0.0,0,8,8,7,1,0,3,2,20,8,1,Kawhi Leonard,LAC,LAC,GSW,26.0,Points,35,28,27,15
22023,202695,22300280,"DEC 02, 2023",LAC vs. GSW,W,39,9,16,0.563,2,5,0.4,0,0,0.0,0,8,8,7,1,0,3,2,20,8,1,Kawhi Leonard,LAC,LAC,GSW,7.0,Rebounds,35,28,27,15
22023,202695,22300280,"DEC 02, 2023",LAC vs. GSW,W,39,9,16,0.563,2,5,0.4,0,0,0.0,0,8,8,7,1,0,3,2,20,8,1,Kawhi Leonard,LAC,LAC,GSW,36.5,Pts+Rebs+Asts,35,28,27,15
22023,202695,22300280,"DEC 02, 2023",LAC vs. GSW,W,39,9,16,0.563,2,5,0.4,0,0,0.0,0,8,8,7,1,0,3,2,20,8,1,Kawhi Leonard,LAC,LAC,GSW,44.5,Fantasy Score,35,28,27,15
22023,202695,22300280,"DEC 02, 2023",LAC vs. GSW,W,39,9,16,0.563,2,5,0.4,0,0,0.0,0,8,8,7,1,0,3,2,20,8,1,Kawhi Leonard,LAC,LAC,GSW,4.0,Free Throws Made,35,28,27,15
22023,202695,22300280,"DEC 02, 2023",LAC vs. GSW,W,39,9,16,0.563,2,5,0.4,0,0,0.0,0,8,8,7,1,0,3,2,20,8,1,Kawhi Leonard,LAC,LAC,GSW,18.0,FG Attempted,35,28,27,15
22023,202695,22300280,"DEC 02, 2023",LAC vs. GSW,W,39,9,16,0.563,2,5,0.4,0,0,0.0,0,8,8,7,1,0,3,2,20,8,1,Kawhi Leonard,LAC,LAC,GSW,33.5,Pts+Rebs,35,28,27,15
22023,202695,22300280,"DEC 02, 2023",LAC vs. GSW,W,39,9,16,0.563,2,5,0.4,0,0,0.0,0,8,8,7,1,0,3,2,20,8,1,Kawhi Leonard,LAC,LAC,GSW,29.5,Pts+Asts,35,28,27,15
22023,202695,22300280,"DEC 02, 2023",LAC vs. GSW,W,39,9,16,0.563,2,5,0.4,0,0,0.0,0,8,8,7,1,0,3,2,20,8,1,Kawhi Leonard,LAC,LAC,GSW,10.5,Rebs+Asts,35,28,27,15
22023,202695,22300273,"NOV 30, 2023",LAC @ GSW,L,35,9,17,0.529,2,2,1.0,3,4,0.75,1,6,7,0,2,0,0,2,23,2,1,Kawhi Leonard,LAC,GSW,LAC,26.0,Points,30,30,23,7
22023,202695,22300273,"NOV 30, 2023",LAC @ GSW,L,35,9,17,0.529,2,2,1.0,3,4,0.75,1,6,7,0,2,0,0,2,23,2,1,Kawhi Leonard,LAC,GSW,LAC,7.0,Rebounds,30,30,23,7
22023,202695,22300273,"NOV 30, 2023",LAC @ GSW,L,35,9,17,0.529,2,2,1.0,3,4,0.75,1,6,7,0,2,0,0,2,23,2,1,Kawhi Leonard,LAC,GSW,LAC,36.5,Pts+Rebs+Asts,30,30,23,7
22023,202695,22300273,"NOV 30, 2023",LAC @ GSW,L,35,9,17,0.529,2,2,1.0,3,4,0.75,1,6,7,0,2,0,0,2,23,2,1,Kawhi Leonard,LAC,GSW,LAC,44.5,Fantasy Score,30,30,23,7
22023,202695,22300273,"NOV 30, 2023",LAC @ GSW,L,35,9,17,0.529,2,2,1.0,3,4,0.75,1,6,7,0,2,0,0,2,23,2,1,Kawhi Leonard,LAC,GSW,LAC,4.0,Free Throws Made,30,30,23,7
22023,202695,22300273,"NOV 30, 2023",LAC @ GSW,L,35,9,17,0.529,2,2,1.0,3,4,0.75,1,6,7,0,2,0,0,2,23,2,1,Kawhi Leonard,LAC,GSW,LAC,18.0,FG Attempted,30,30,23,7
22023,202695,22300273,"NOV 30, 2023",LAC @ GSW,L,35,9,17,0.529,2,2,1.0,3,4,0.75,1,6,7,0,2,0,0,2,23,2,1,Kawhi Leonard,LAC,GSW,LAC,33.5,Pts+Rebs,30,30,23,7
22023,202695,22300273,"NOV 30, 2023",LAC @ GSW,L,35,9,17,0.529,2,2,1.0,3,4,0.75,1,6,7,0,2,0,0,2,23,2,1,Kawhi Leonard,LAC,GSW,LAC,29.5,Pts+Asts,30,30,23,7
22023,202695,22300273,"NOV 30, 2023",LAC @ GSW,L,35,9,17,0.529,2,2,1.0,3,4,0.75,1,6,7,0,2,0,0,2,23,2,1,Kawhi Leonard,LAC,GSW,LAC,10.5,Rebs+Asts,30,30,23,7
22023,202695,22300264,"NOV 29, 2023",LAC @ SAC,W,37,14,18,0.778,2,3,0.667,4,6,0.667,0,9,9,3,1,2,0,2,34,20,1,Kawhi Leonard,LAC,SAC,LAC,26.0,Points,46,43,37,12
22023,202695,22300264,"NOV 29, 2023",LAC @ SAC,W,37,14,18,0.778,2,3,0.667,4,6,0.667,0,9,9,3,1,2,0,2,34,20,1,Kawhi Leonard,LAC,SAC,LAC,7.0,Rebounds,46,43,37,12
22023,202695,22300264,"NOV 29, 2023",LAC @ SAC,W,37,14,18,0.778,2,3,0.667,4,6,0.667,0,9,9,3,1,2,0,2,34,20,1,Kawhi Leonard,LAC,SAC,LAC,36.5,Pts+Rebs+Asts,46,43,37,12
22023,202695,22300264,"NOV 29, 2023",LAC @ SAC,W,37,14,18,0.778,2,3,0.667,4,6,0.667,0,9,9,3,1,2,0,2,34,20,1,Kawhi Leonard,LAC,SAC,LAC,44.5,Fantasy Score,46,43,37,12
22023,202695,22300264,"NOV 29, 2023",LAC @ SAC,W,37,14,18,0.778,2,3,0.667,4,6,0.667,0,9,9,3,1,2,0,2,34,20,1,Kawhi Leonard,LAC,SAC,LAC,4.0,Free Throws Made,46,43,37,12
22023,202695,22300264,"NOV 29, 2023",LAC @ SAC,W,37,14,18,0.778,2,3,0.667,4,6,0.667,0,9,9,3,1,2,0,2,34,20,1,Kawhi Leonard,LAC,SAC,LAC,18.0,FG Attempted,46,43,37,12
22023,202695,22300264,"NOV 29, 2023",LAC @ SAC,W,37,14,18,0.778,2,3,0.667,4,6,0.667,0,9,9,3,1,2,0,2,34,20,1,Kawhi Leonard,LAC,SAC,LAC,33.5,Pts+Rebs,46,43,37,12
22023,202695,22300264,"NOV 29, 2023",LAC @ SAC,W,37,14,18,0.778,2,3,0.667,4,6,0.667,0,9,9,3,1,2,0,2,34,20,1,Kawhi Leonard,LAC,SAC,LAC,29.5,Pts+Asts,46,43,37,12
22023,202695,22300264,"NOV 29, 2023",LAC @ SAC,W,37,14,18,0.778,2,3,0.667,4,6,0.667,0,9,9,3,1,2,0,2,34,20,1,Kawhi Leonard,LAC,SAC,LAC,10.5,Rebs+Asts,46,43,37,12
22023,202695,22300257,"NOV 27, 2023",LAC vs. DEN,L,39,10,26,0.385,2,5,0.4,9,9,1.0,1,7,8,3,1,2,2,0,31,-5,1,Kawhi Leonard,LAC,LAC,DEN,26.0,Points,42,39,34,11
22023,202695,22300257,"NOV 27, 2023",LAC vs. DEN,L,39,10,26,0.385,2,5,0.4,9,9,1.0,1,7,8,3,1,2,2,0,31,-5,1,Kawhi Leonard,LAC,LAC,DEN,7.0,Rebounds,42,39,34,11
22023,202695,22300257,"NOV 27, 2023",LAC vs. DEN,L,39,10,26,0.385,2,5,0.4,9,9,1.0,1,7,8,3,1,2,2,0,31,-5,1,Kawhi Leonard,LAC,LAC,DEN,36.5,Pts+Rebs+Asts,42,39,34,11
22023,202695,22300257,"NOV 27, 2023",LAC vs. DEN,L,39,10,26,0.385,2,5,0.4,9,9,1.0,1,7,8,3,1,2,2,0,31,-5,1,Kawhi Leonard,LAC,LAC,DEN,44.5,Fantasy Score,42,39,34,11
22023,202695,22300257,"NOV 27, 2023",LAC vs. DEN,L,39,10,26,0.385,2,5,0.4,9,9,1.0,1,7,8,3,1,2,2,0,31,-5,1,Kawhi Leonard,LAC,LAC,DEN,4.0,Free Throws Made,42,39,34,11
22023,202695,22300257,"NOV 27, 2023",LAC vs. DEN,L,39,10,26,0.385,2,5,0.4,9,9,1.0,1,7,8,3,1,2,2,0,31,-5,1,Kawhi Leonard,LAC,LAC,DEN,18.0,FG Attempted,42,39,34,11
22023,202695,22300257,"NOV 27, 2023",LAC vs. DEN,L,39,10,26,0.385,2,5,0.4,9,9,1.0,1,7,8,3,1,2,2,0,31,-5,1,Kawhi Leonard,LAC,LAC,DEN,33.5,Pts+Rebs,42,39,34,11
22023,202695,22300257,"NOV 27, 2023",LAC vs. DEN,L,39,10,26,0.385,2,5,0.4,9,9,1.0,1,7,8,3,1,2,2,0,31,-5,1,Kawhi Leonard,LAC,LAC,DEN,29.5,Pts+Asts,42,39,34,11
22023,202695,22300257,"NOV 27, 2023",LAC vs. DEN,L,39,10,26,0.385,2,5,0.4,9,9,1.0,1,7,8,3,1,2,2,0,31,-5,1,Kawhi Leonard,LAC,LAC,DEN,10.5,Rebs+Asts,42,39,34,11
22023,202695,22300244,"NOV 25, 2023",LAC vs. DAL,W,29,2,12,0.167,0,5,0.0,4,4,1.0,0,6,6,3,0,2,2,1,8,24,1,Kawhi Leonard,LAC,LAC,DAL,26.0,Points,17,14,11,9
22023,202695,22300244,"NOV 25, 2023",LAC vs. DAL,W,29,2,12,0.167,0,5,0.0,4,4,1.0,0,6,6,3,0,2,2,1,8,24,1,Kawhi Leonard,LAC,LAC,DAL,7.0,Rebounds,17,14,11,9
22023,202695,22300244,"NOV 25, 2023",LAC vs. DAL,W,29,2,12,0.167,0,5,0.0,4,4,1.0,0,6,6,3,0,2,2,1,8,24,1,Kawhi Leonard,LAC,LAC,DAL,36.5,Pts+Rebs+Asts,17,14,11,9
22023,202695,22300244,"NOV 25, 2023",LAC vs. DAL,W,29,2,12,0.167,0,5,0.0,4,4,1.0,0,6,6,3,0,2,2,1,8,24,1,Kawhi Leonard,LAC,LAC,DAL,44.5,Fantasy Score,17,14,11,9
22023,202695,22300244,"NOV 25, 2023",LAC vs. DAL,W,29,2,12,0.167,0,5,0.0,4,4,1.0,0,6,6,3,0,2,2,1,8,24,1,Kawhi Leonard,LAC,LAC,DAL,4.0,Free Throws Made,17,14,11,9
22023,202695,22300244,"NOV 25, 2023",LAC vs. DAL,W,29,2,12,0.167,0,5,0.0,4,4,1.0,0,6,6,3,0,2,2,1,8,24,1,Kawhi Leonard,LAC,LAC,DAL,18.0,FG Attempted,17,14,11,9
22023,202695,22300244,"NOV 25, 2023",LAC vs. DAL,W,29,2,12,0.167,0,5,0.0,4,4,1.0,0,6,6,3,0,2,2,1,8,24,1,Kawhi Leonard,LAC,LAC,DAL,33.5,Pts+Rebs,17,14,11,9
22023,202695,22300244,"NOV 25, 2023",LAC vs. DAL,W,29,2,12,0.167,0,5,0.0,4,4,1.0,0,6,6,3,0,2,2,1,8,24,1,Kawhi Leonard,LAC,LAC,DAL,29.5,Pts+Asts,17,14,11,9
22023,202695,22300244,"NOV 25, 2023",LAC vs. DAL,W,29,2,12,0.167,0,5,0.0,4,4,1.0,0,6,6,3,0,2,2,1,8,24,1,Kawhi Leonard,LAC,LAC,DAL,10.5,Rebs+Asts,17,14,11,9
22023,202695,22300052,"NOV 24, 2023",LAC vs. NOP,L,34,8,17,0.471,1,7,0.143,3,4,0.75,1,7,8,3,1,1,1,0,20,-15,1,Kawhi Leonard,LAC,LAC,NOP,26.0,Points,31,28,23,11
22023,202695,22300052,"NOV 24, 2023",LAC vs. NOP,L,34,8,17,0.471,1,7,0.143,3,4,0.75,1,7,8,3,1,1,1,0,20,-15,1,Kawhi Leonard,LAC,LAC,NOP,7.0,Rebounds,31,28,23,11
22023,202695,22300052,"NOV 24, 2023",LAC vs. NOP,L,34,8,17,0.471,1,7,0.143,3,4,0.75,1,7,8,3,1,1,1,0,20,-15,1,Kawhi Leonard,LAC,LAC,NOP,36.5,Pts+Rebs+Asts,31,28,23,11
22023,202695,22300052,"NOV 24, 2023",LAC vs. NOP,L,34,8,17,0.471,1,7,0.143,3,4,0.75,1,7,8,3,1,1,1,0,20,-15,1,Kawhi Leonard,LAC,LAC,NOP,44.5,Fantasy Score,31,28,23,11
22023,202695,22300052,"NOV 24, 2023",LAC vs. NOP,L,34,8,17,0.471,1,7,0.143,3,4,0.75,1,7,8,3,1,1,1,0,20,-15,1,Kawhi Leonard,LAC,LAC,NOP,4.0,Free Throws Made,31,28,23,11
22023,202695,22300052,"NOV 24, 2023",LAC vs. NOP,L,34,8,17,0.471,1,7,0.143,3,4,0.75,1,7,8,3,1,1,1,0,20,-15,1,Kawhi Leonard,LAC,LAC,NOP,18.0,FG Attempted,31,28,23,11
22023,202695,22300052,"NOV 24, 2023",LAC vs. NOP,L,34,8,17,0.471,1,7,0.143,3,4,0.75,1,7,8,3,1,1,1,0,20,-15,1,Kawhi Leonard,LAC,LAC,NOP,33.5,Pts+Rebs,31,28,23,11
22023,202695,22300052,"NOV 24, 2023",LAC vs. NOP,L,34,8,17,0.471,1,7,0.143,3,4,0.75,1,7,8,3,1,1,1,0,20,-15,1,Kawhi Leonard,LAC,LAC,NOP,29.5,Pts+Asts,31,28,23,11
22023,202695,22300052,"NOV 24, 2023",LAC vs. NOP,L,34,8,17,0.471,1,7,0.143,3,4,0.75,1,7,8,3,1,1,1,0,20,-15,1,Kawhi Leonard,LAC,LAC,NOP,10.5,Rebs+Asts,31,28,23,11
22023,202695,22300235,"NOV 22, 2023",LAC @ SAS,W,36,10,17,0.588,2,6,0.333,4,4,1.0,0,4,4,4,2,0,1,3,26,-2,1,Kawhi Leonard,LAC,SAS,LAC,26.0,Points,34,30,30,8
22023,202695,22300235,"NOV 22, 2023",LAC @ SAS,W,36,10,17,0.588,2,6,0.333,4,4,1.0,0,4,4,4,2,0,1,3,26,-2,1,Kawhi Leonard,LAC,SAS,LAC,7.0,Rebounds,34,30,30,8
22023,202695,22300235,"NOV 22, 2023",LAC @ SAS,W,36,10,17,0.588,2,6,0.333,4,4,1.0,0,4,4,4,2,0,1,3,26,-2,1,Kawhi Leonard,LAC,SAS,LAC,36.5,Pts+Rebs+Asts,34,30,30,8
22023,202695,22300235,"NOV 22, 2023",LAC @ SAS,W,36,10,17,0.588,2,6,0.333,4,4,1.0,0,4,4,4,2,0,1,3,26,-2,1,Kawhi Leonard,LAC,SAS,LAC,44.5,Fantasy Score,34,30,30,8
22023,202695,22300235,"NOV 22, 2023",LAC @ SAS,W,36,10,17,0.588,2,6,0.333,4,4,1.0,0,4,4,4,2,0,1,3,26,-2,1,Kawhi Leonard,LAC,SAS,LAC,4.0,Free Throws Made,34,30,30,8
22023,202695,22300235,"NOV 22, 2023",LAC @ SAS,W,36,10,17,0.588,2,6,0.333,4,4,1.0,0,4,4,4,2,0,1,3,26,-2,1,Kawhi Leonard,LAC,SAS,LAC,18.0,FG Attempted,34,30,30,8
22023,202695,22300235,"NOV 22, 2023",LAC @ SAS,W,36,10,17,0.588,2,6,0.333,4,4,1.0,0,4,4,4,2,0,1,3,26,-2,1,Kawhi Leonard,LAC,SAS,LAC,33.5,Pts+Rebs,34,30,30,8
22023,202695,22300235,"NOV 22, 2023",LAC @ SAS,W,36,10,17,0.588,2,6,0.333,4,4,1.0,0,4,4,4,2,0,1,3,26,-2,1,Kawhi Leonard,LAC,SAS,LAC,29.5,Pts+Asts,34,30,30,8
22023,202695,22300235,"NOV 22, 2023",LAC @ SAS,W,36,10,17,0.588,2,6,0.333,4,4,1.0,0,4,4,4,2,0,1,3,26,-2,1,Kawhi Leonard,LAC,SAS,LAC,10.5,Rebs+Asts,34,30,30,8
22023,202695,22300223,"NOV 20, 2023",LAC @ SAS,W,28,8,17,0.471,2,6,0.333,3,3,1.0,2,2,4,3,1,1,0,0,21,17,1,Kawhi Leonard,LAC,SAS,LAC,26.0,Points,28,25,24,7
22023,202695,22300223,"NOV 20, 2023",LAC @ SAS,W,28,8,17,0.471,2,6,0.333,3,3,1.0,2,2,4,3,1,1,0,0,21,17,1,Kawhi Leonard,LAC,SAS,LAC,7.0,Rebounds,28,25,24,7
22023,202695,22300223,"NOV 20, 2023",LAC @ SAS,W,28,8,17,0.471,2,6,0.333,3,3,1.0,2,2,4,3,1,1,0,0,21,17,1,Kawhi Leonard,LAC,SAS,LAC,36.5,Pts+Rebs+Asts,28,25,24,7
22023,202695,22300223,"NOV 20, 2023",LAC @ SAS,W,28,8,17,0.471,2,6,0.333,3,3,1.0,2,2,4,3,1,1,0,0,21,17,1,Kawhi Leonard,LAC,SAS,LAC,44.5,Fantasy Score,28,25,24,7
22023,202695,22300223,"NOV 20, 2023",LAC @ SAS,W,28,8,17,0.471,2,6,0.333,3,3,1.0,2,2,4,3,1,1,0,0,21,17,1,Kawhi Leonard,LAC,SAS,LAC,4.0,Free Throws Made,28,25,24,7
22023,202695,22300223,"NOV 20, 2023",LAC @ SAS,W,28,8,17,0.471,2,6,0.333,3,3,1.0,2,2,4,3,1,1,0,0,21,17,1,Kawhi Leonard,LAC,SAS,LAC,18.0,FG Attempted,28,25,24,7
22023,202695,22300223,"NOV 20, 2023",LAC @ SAS,W,28,8,17,0.471,2,6,0.333,3,3,1.0,2,2,4,3,1,1,0,0,21,17,1,Kawhi Leonard,LAC,SAS,LAC,33.5,Pts+Rebs,28,25,24,7
22023,202695,22300223,"NOV 20, 2023",LAC @ SAS,W,28,8,17,0.471,2,6,0.333,3,3,1.0,2,2,4,3,1,1,0,0,21,17,1,Kawhi Leonard,LAC,SAS,LAC,29.5,Pts+Asts,28,25,24,7
22023,202695,22300223,"NOV 20, 2023",LAC @ SAS,W,28,8,17,0.471,2,6,0.333,3,3,1.0,2,2,4,3,1,1,0,0,21,17,1,Kawhi Leonard,LAC,SAS,LAC,10.5,Rebs+Asts,28,25,24,7
22023,202695,22300037,"NOV 17, 2023",LAC vs. HOU,W,37,8,16,0.5,3,6,0.5,7,8,0.875,1,7,8,2,5,1,3,3,26,18,1,Kawhi Leonard,LAC,LAC,HOU,26.0,Points,36,34,28,10
22023,202695,22300037,"NOV 17, 2023",LAC vs. HOU,W,37,8,16,0.5,3,6,0.5,7,8,0.875,1,7,8,2,5,1,3,3,26,18,1,Kawhi Leonard,LAC,LAC,HOU,7.0,Rebounds,36,34,28,10
22023,202695,22300037,"NOV 17, 2023",LAC vs. HOU,W,37,8,16,0.5,3,6,0.5,7,8,0.875,1,7,8,2,5,1,3,3,26,18,1,Kawhi Leonard,LAC,LAC,HOU,36.5,Pts+Rebs+Asts,36,34,28,10
22023,202695,22300037,"NOV 17, 2023",LAC vs. HOU,W,37,8,16,0.5,3,6,0.5,7,8,0.875,1,7,8,2,5,1,3,3,26,18,1,Kawhi Leonard,LAC,LAC,HOU,44.5,Fantasy Score,36,34,28,10
22023,202695,22300037,"NOV 17, 2023",LAC vs. HOU,W,37,8,16,0.5,3,6,0.5,7,8,0.875,1,7,8,2,5,1,3,3,26,18,1,Kawhi Leonard,LAC,LAC,HOU,4.0,Free Throws Made,36,34,28,10
22023,202695,22300037,"NOV 17, 2023",LAC vs. HOU,W,37,8,16,0.5,3,6,0.5,7,8,0.875,1,7,8,2,5,1,3,3,26,18,1,Kawhi Leonard,LAC,LAC,HOU,18.0,FG Attempted,36,34,28,10
22023,202695,22300037,"NOV 17, 2023",LAC vs. HOU,W,37,8,16,0.5,3,6,0.5,7,8,0.875,1,7,8,2,5,1,3,3,26,18,1,Kawhi Leonard,LAC,LAC,HOU,33.5,Pts+Rebs,36,34,28,10
22023,202695,22300037,"NOV 17, 2023",LAC vs. HOU,W,37,8,16,0.5,3,6,0.5,7,8,0.875,1,7,8,2,5,1,3,3,26,18,1,Kawhi Leonard,LAC,LAC,HOU,29.5,Pts+Asts,36,34,28,10
22023,202695,22300037,"NOV 17, 2023",LAC vs. HOU,W,37,8,16,0.5,3,6,0.5,7,8,0.875,1,7,8,2,5,1,3,3,26,18,1,Kawhi Leonard,LAC,LAC,HOU,10.5,Rebs+Asts,36,34,28,10
22023,202695,22300024,"NOV 14, 2023",LAC @ DEN,L,38,5,14,0.357,2,3,0.667,3,4,0.75,0,2,2,2,5,0,3,1,15,0,1,Kawhi Leonard,LAC,DEN,LAC,26.0,Points,19,17,17,4
22023,202695,22300024,"NOV 14, 2023",LAC @ DEN,L,38,5,14,0.357,2,3,0.667,3,4,0.75,0,2,2,2,5,0,3,1,15,0,1,Kawhi Leonard,LAC,DEN,LAC,7.0,Rebounds,19,17,17,4
22023,202695,22300024,"NOV 14, 2023",LAC @ DEN,L,38,5,14,0.357,2,3,0.667,3,4,0.75,0,2,2,2,5,0,3,1,15,0,1,Kawhi Leonard,LAC,DEN,LAC,36.5,Pts+Rebs+Asts,19,17,17,4
22023,202695,22300024,"NOV 14, 2023",LAC @ DEN,L,38,5,14,0.357,2,3,0.667,3,4,0.75,0,2,2,2,5,0,3,1,15,0,1,Kawhi Leonard,LAC,DEN,LAC,44.5,Fantasy Score,19,17,17,4
22023,202695,22300024,"NOV 14, 2023",LAC @ DEN,L,38,5,14,0.357,2,3,0.667,3,4,0.75,0,2,2,2,5,0,3,1,15,0,1,Kawhi Leonard,LAC,DEN,LAC,4.0,Free Throws Made,19,17,17,4
22023,202695,22300024,"NOV 14, 2023",LAC @ DEN,L,38,5,14,0.357,2,3,0.667,3,4,0.75,0,2,2,2,5,0,3,1,15,0,1,Kawhi Leonard,LAC,DEN,LAC,18.0,FG Attempted,19,17,17,4
22023,202695,22300024,"NOV 14, 2023",LAC @ DEN,L,38,5,14,0.357,2,3,0.667,3,4,0.75,0,2,2,2,5,0,3,1,15,0,1,Kawhi Leonard,LAC,DEN,LAC,33.5,Pts+Rebs,19,17,17,4
22023,202695,22300024,"NOV 14, 2023",LAC @ DEN,L,38,5,14,0.357,2,3,0.667,3,4,0.75,0,2,2,2,5,0,3,1,15,0,1,Kawhi Leonard,LAC,DEN,LAC,29.5,Pts+Asts,19,17,17,4
22023,202695,22300024,"NOV 14, 2023",LAC @ DEN,L,38,5,14,0.357,2,3,0.667,3,4,0.75,0,2,2,2,5,0,3,1,15,0,1,Kawhi Leonard,LAC,DEN,LAC,10.5,Rebs+Asts,19,17,17,4
22023,202695,22300179,"NOV 12, 2023",LAC vs. MEM,L,37,6,16,0.375,1,4,0.25,1,2,0.5,1,4,5,3,1,2,0,3,14,-18,1,Kawhi Leonard,LAC,LAC,MEM,26.0,Points,22,19,17,8
22023,202695,22300179,"NOV 12, 2023",LAC vs. MEM,L,37,6,16,0.375,1,4,0.25,1,2,0.5,1,4,5,3,1,2,0,3,14,-18,1,Kawhi Leonard,LAC,LAC,MEM,7.0,Rebounds,22,19,17,8
22023,202695,22300179,"NOV 12, 2023",LAC vs. MEM,L,37,6,16,0.375,1,4,0.25,1,2,0.5,1,4,5,3,1,2,0,3,14,-18,1,Kawhi Leonard,LAC,LAC,MEM,36.5,Pts+Rebs+Asts,22,19,17,8
22023,202695,22300179,"NOV 12, 2023",LAC vs. MEM,L,37,6,16,0.375,1,4,0.25,1,2,0.5,1,4,5,3,1,2,0,3,14,-18,1,Kawhi Leonard,LAC,LAC,MEM,44.5,Fantasy Score,22,19,17,8
22023,202695,22300179,"NOV 12, 2023",LAC vs. MEM,L,37,6,16,0.375,1,4,0.25,1,2,0.5,1,4,5,3,1,2,0,3,14,-18,1,Kawhi Leonard,LAC,LAC,MEM,4.0,Free Throws Made,22,19,17,8
22023,202695,22300179,"NOV 12, 2023",LAC vs. MEM,L,37,6,16,0.375,1,4,0.25,1,2,0.5,1,4,5,3,1,2,0,3,14,-18,1,Kawhi Leonard,LAC,LAC,MEM,18.0,FG Attempted,22,19,17,8
22023,202695,22300179,"NOV 12, 2023",LAC vs. MEM,L,37,6,16,0.375,1,4,0.25,1,2,0.5,1,4,5,3,1,2,0,3,14,-18,1,Kawhi Leonard,LAC,LAC,MEM,33.5,Pts+Rebs,22,19,17,8
22023,202695,22300179,"NOV 12, 2023",LAC vs. MEM,L,37,6,16,0.375,1,4,0.25,1,2,0.5,1,4,5,3,1,2,0,3,14,-18,1,Kawhi Leonard,LAC,LAC,MEM,29.5,Pts+Asts,22,19,17,8
22023,202695,22300179,"NOV 12, 2023",LAC vs. MEM,L,37,6,16,0.375,1,4,0.25,1,2,0.5,1,4,5,3,1,2,0,3,14,-18,1,Kawhi Leonard,LAC,LAC,MEM,10.5,Rebs+Asts,22,19,17,8
22023,202695,22300014,"NOV 10, 2023",LAC @ DAL,L,29,8,15,0.533,2,4,0.5,8,8,1.0,1,2,3,4,0,0,2,2,26,-8,1,Kawhi Leonard,LAC,DAL,LAC,26.0,Points,33,29,30,7
22023,202695,22300014,"NOV 10, 2023",LAC @ DAL,L,29,8,15,0.533,2,4,0.5,8,8,1.0,1,2,3,4,0,0,2,2,26,-8,1,Kawhi Leonard,LAC,DAL,LAC,7.0,Rebounds,33,29,30,7
22023,202695,22300014,"NOV 10, 2023",LAC @ DAL,L,29,8,15,0.533,2,4,0.5,8,8,1.0,1,2,3,4,0,0,2,2,26,-8,1,Kawhi Leonard,LAC,DAL,LAC,36.5,Pts+Rebs+Asts,33,29,30,7
22023,202695,22300014,"NOV 10, 2023",LAC @ DAL,L,29,8,15,0.533,2,4,0.5,8,8,1.0,1,2,3,4,0,0,2,2,26,-8,1,Kawhi Leonard,LAC,DAL,LAC,44.5,Fantasy Score,33,29,30,7
22023,202695,22300014,"NOV 10, 2023",LAC @ DAL,L,29,8,15,0.533,2,4,0.5,8,8,1.0,1,2,3,4,0,0,2,2,26,-8,1,Kawhi Leonard,LAC,DAL,LAC,4.0,Free Throws Made,33,29,30,7
22023,202695,22300014,"NOV 10, 2023",LAC @ DAL,L,29,8,15,0.533,2,4,0.5,8,8,1.0,1,2,3,4,0,0,2,2,26,-8,1,Kawhi Leonard,LAC,DAL,LAC,18.0,FG Attempted,33,29,30,7
22023,202695,22300014,"NOV 10, 2023",LAC @ DAL,L,29,8,15,0.533,2,4,0.5,8,8,1.0,1,2,3,4,0,0,2,2,26,-8,1,Kawhi Leonard,LAC,DAL,LAC,33.5,Pts+Rebs,33,29,30,7
22023,202695,22300014,"NOV 10, 2023",LAC @ DAL,L,29,8,15,0.533,2,4,0.5,8,8,1.0,1,2,3,4,0,0,2,2,26,-8,1,Kawhi Leonard,LAC,DAL,LAC,29.5,Pts+Asts,33,29,30,7
22023,202695,22300014,"NOV 10, 2023",LAC @ DAL,L,29,8,15,0.533,2,4,0.5,8,8,1.0,1,2,3,4,0,0,2,2,26,-8,1,Kawhi Leonard,LAC,DAL,LAC,10.5,Rebs+Asts,33,29,30,7
22023,202695,22300160,"NOV 08, 2023",LAC @ BKN,L,36,7,16,0.438,1,6,0.167,2,2,1.0,0,6,6,2,2,1,1,1,17,3,1,Kawhi Leonard,LAC,BKN,LAC,26.0,Points,25,23,19,8
22023,202695,22300160,"NOV 08, 2023",LAC @ BKN,L,36,7,16,0.438,1,6,0.167,2,2,1.0,0,6,6,2,2,1,1,1,17,3,1,Kawhi Leonard,LAC,BKN,LAC,7.0,Rebounds,25,23,19,8
22023,202695,22300160,"NOV 08, 2023",LAC @ BKN,L,36,7,16,0.438,1,6,0.167,2,2,1.0,0,6,6,2,2,1,1,1,17,3,1,Kawhi Leonard,LAC,BKN,LAC,36.5,Pts+Rebs+Asts,25,23,19,8
22023,202695,22300160,"NOV 08, 2023",LAC @ BKN,L,36,7,16,0.438,1,6,0.167,2,2,1.0,0,6,6,2,2,1,1,1,17,3,1,Kawhi Leonard,LAC,BKN,LAC,44.5,Fantasy Score,25,23,19,8
22023,202695,22300160,"NOV 08, 2023",LAC @ BKN,L,36,7,16,0.438,1,6,0.167,2,2,1.0,0,6,6,2,2,1,1,1,17,3,1,Kawhi Leonard,LAC,BKN,LAC,4.0,Free Throws Made,25,23,19,8
22023,202695,22300160,"NOV 08, 2023",LAC @ BKN,L,36,7,16,0.438,1,6,0.167,2,2,1.0,0,6,6,2,2,1,1,1,17,3,1,Kawhi Leonard,LAC,BKN,LAC,18.0,FG Attempted,25,23,19,8
22023,202695,22300160,"NOV 08, 2023",LAC @ BKN,L,36,7,16,0.438,1,6,0.167,2,2,1.0,0,6,6,2,2,1,1,1,17,3,1,Kawhi Leonard,LAC,BKN,LAC,33.5,Pts+Rebs,25,23,19,8
22023,202695,22300160,"NOV 08, 2023",LAC @ BKN,L,36,7,16,0.438,1,6,0.167,2,2,1.0,0,6,6,2,2,1,1,1,17,3,1,Kawhi Leonard,LAC,BKN,LAC,29.5,Pts+Asts,25,23,19,8
22023,202695,22300160,"NOV 08, 2023",LAC @ BKN,L,36,7,16,0.438,1,6,0.167,2,2,1.0,0,6,6,2,2,1,1,1,17,3,1,Kawhi Leonard,LAC,BKN,LAC,10.5,Rebs+Asts,25,23,19,8
22023,202695,22300151,"NOV 06, 2023",LAC @ NYK,L,32,8,16,0.5,2,6,0.333,0,0,0.0,2,3,5,3,0,0,0,2,18,-12,1,Kawhi Leonard,LAC,NYK,LAC,26.0,Points,26,23,21,8
22023,202695,22300151,"NOV 06, 2023",LAC @ NYK,L,32,8,16,0.5,2,6,0.333,0,0,0.0,2,3,5,3,0,0,0,2,18,-12,1,Kawhi Leonard,LAC,NYK,LAC,7.0,Rebounds,26,23,21,8
22023,202695,22300151,"NOV 06, 2023",LAC @ NYK,L,32,8,16,0.5,2,6,0.333,0,0,0.0,2,3,5,3,0,0,0,2,18,-12,1,Kawhi Leonard,LAC,NYK,LAC,36.5,Pts+Rebs+Asts,26,23,21,8
22023,202695,22300151,"NOV 06, 2023",LAC @ NYK,L,32,8,16,0.5,2,6,0.333,0,0,0.0,2,3,5,3,0,0,0,2,18,-12,1,Kawhi Leonard,LAC,NYK,LAC,44.5,Fantasy Score,26,23,21,8
22023,202695,22300151,"NOV 06, 2023",LAC @ NYK,L,32,8,16,0.5,2,6,0.333,0,0,0.0,2,3,5,3,0,0,0,2,18,-12,1,Kawhi Leonard,LAC,NYK,LAC,4.0,Free Throws Made,26,23,21,8
22023,202695,22300151,"NOV 06, 2023",LAC @ NYK,L,32,8,16,0.5,2,6,0.333,0,0,0.0,2,3,5,3,0,0,0,2,18,-12,1,Kawhi Leonard,LAC,NYK,LAC,18.0,FG Attempted,26,23,21,8
22023,202695,22300151,"NOV 06, 2023",LAC @ NYK,L,32,8,16,0.5,2,6,0.333,0,0,0.0,2,3,5,3,0,0,0,2,18,-12,1,Kawhi Leonard,LAC,NYK,LAC,33.5,Pts+Rebs,26,23,21,8
22023,202695,22300151,"NOV 06, 2023",LAC @ NYK,L,32,8,16,0.5,2,6,0.333,0,0,0.0,2,3,5,3,0,0,0,2,18,-12,1,Kawhi Leonard,LAC,NYK,LAC,29.5,Pts+Asts,26,23,21,8
22023,202695,22300151,"NOV 06, 2023",LAC @ NYK,L,32,8,16,0.5,2,6,0.333,0,0,0.0,2,3,5,3,0,0,0,2,18,-12,1,Kawhi Leonard,LAC,NYK,LAC,10.5,Rebs+Asts,26,23,21,8
22023,202695,22300127,"NOV 01, 2023",LAC @ LAL,L,41,15,28,0.536,5,11,0.455,3,6,0.5,1,5,6,5,2,0,2,2,38,4,1,Kawhi Leonard,LAC,LAL,LAC,26.0,Points,49,44,43,11
22023,202695,22300127,"NOV 01, 2023",LAC @ LAL,L,41,15,28,0.536,5,11,0.455,3,6,0.5,1,5,6,5,2,0,2,2,38,4,1,Kawhi Leonard,LAC,LAL,LAC,7.0,Rebounds,49,44,43,11
22023,202695,22300127,"NOV 01, 2023",LAC @ LAL,L,41,15,28,0.536,5,11,0.455,3,6,0.5,1,5,6,5,2,0,2,2,38,4,1,Kawhi Leonard,LAC,LAL,LAC,36.5,Pts+Rebs+Asts,49,44,43,11
22023,202695,22300127,"NOV 01, 2023",LAC @ LAL,L,41,15,28,0.536,5,11,0.455,3,6,0.5,1,5,6,5,2,0,2,2,38,4,1,Kawhi Leonard,LAC,LAL,LAC,44.5,Fantasy Score,49,44,43,11
22023,202695,22300127,"NOV 01, 2023",LAC @ LAL,L,41,15,28,0.536,5,11,0.455,3,6,0.5,1,5,6,5,2,0,2,2,38,4,1,Kawhi Leonard,LAC,LAL,LAC,4.0,Free Throws Made,49,44,43,11
22023,202695,22300127,"NOV 01, 2023",LAC @ LAL,L,41,15,28,0.536,5,11,0.455,3,6,0.5,1,5,6,5,2,0,2,2,38,4,1,Kawhi Leonard,LAC,LAL,LAC,18.0,FG Attempted,49,44,43,11
22023,202695,22300127,"NOV 01, 2023",LAC @ LAL,L,41,15,28,0.536,5,11,0.455,3,6,0.5,1,5,6,5,2,0,2,2,38,4,1,Kawhi Leonard,LAC,LAL,LAC,33.5,Pts+Rebs,49,44,43,11
22023,202695,22300127,"NOV 01, 2023",LAC @ LAL,L,41,15,28,0.536,5,11,0.455,3,6,0.5,1,5,6,5,2,0,2,2,38,4,1,Kawhi Leonard,LAC,LAL,LAC,29.5,Pts+Asts,49,44,43,11
22023,202695,22300127,"NOV 01, 2023",LAC @ LAL,L,41,15,28,0.536,5,11,0.455,3,6,0.5,1,5,6,5,2,0,2,2,38,4,1,Kawhi Leonard,LAC,LAL,LAC,10.5,Rebs+Asts,49,44,43,11
22023,202695,22300114,"OCT 31, 2023",LAC vs. ORL,W,33,3,11,0.273,0,3,0.0,2,2,1.0,2,6,8,3,2,0,1,1,8,18,1,Kawhi Leonard,LAC,LAC,ORL,26.0,Points,19,16,11,11
22023,202695,22300114,"OCT 31, 2023",LAC vs. ORL,W,33,3,11,0.273,0,3,0.0,2,2,1.0,2,6,8,3,2,0,1,1,8,18,1,Kawhi Leonard,LAC,LAC,ORL,7.0,Rebounds,19,16,11,11
22023,202695,22300114,"OCT 31, 2023",LAC vs. ORL,W,33,3,11,0.273,0,3,0.0,2,2,1.0,2,6,8,3,2,0,1,1,8,18,1,Kawhi Leonard,LAC,LAC,ORL,36.5,Pts+Rebs+Asts,19,16,11,11
22023,202695,22300114,"OCT 31, 2023",LAC vs. ORL,W,33,3,11,0.273,0,3,0.0,2,2,1.0,2,6,8,3,2,0,1,1,8,18,1,Kawhi Leonard,LAC,LAC,ORL,44.5,Fantasy Score,19,16,11,11
22023,202695,22300114,"OCT 31, 2023",LAC vs. ORL,W,33,3,11,0.273,0,3,0.0,2,2,1.0,2,6,8,3,2,0,1,1,8,18,1,Kawhi Leonard,LAC,LAC,ORL,4.0,Free Throws Made,19,16,11,11
22023,202695,22300114,"OCT 31, 2023",LAC vs. ORL,W,33,3,11,0.273,0,3,0.0,2,2,1.0,2,6,8,3,2,0,1,1,8,18,1,Kawhi Leonard,LAC,LAC,ORL,18.0,FG Attempted,19,16,11,11
22023,202695,22300114,"OCT 31, 2023",LAC vs. ORL,W,33,3,11,0.273,0,3,0.0,2,2,1.0,2,6,8,3,2,0,1,1,8,18,1,Kawhi Leonard,LAC,LAC,ORL,33.5,Pts+Rebs,19,16,11,11
22023,202695,22300114,"OCT 31, 2023",LAC vs. ORL,W,33,3,11,0.273,0,3,0.0,2,2,1.0,2,6,8,3,2,0,1,1,8,18,1,Kawhi Leonard,LAC,LAC,ORL,29.5,Pts+Asts,19,16,11,11
22023,202695,22300114,"OCT 31, 2023",LAC vs. ORL,W,33,3,11,0.273,0,3,0.0,2,2,1.0,2,6,8,3,2,0,1,1,8,18,1,Kawhi Leonard,LAC,LAC,ORL,10.5,Rebs+Asts,19,16,11,11
22023,202695,22300099,"OCT 29, 2023",LAC vs. SAS,W,28,6,13,0.462,3,7,0.429,6,7,0.857,0,3,3,4,2,0,3,2,21,24,1,Kawhi Leonard,LAC,LAC,SAS,26.0,Points,28,24,25,7
22023,202695,22300099,"OCT 29, 2023",LAC vs. SAS,W,28,6,13,0.462,3,7,0.429,6,7,0.857,0,3,3,4,2,0,3,2,21,24,1,Kawhi Leonard,LAC,LAC,SAS,7.0,Rebounds,28,24,25,7
22023,202695,22300099,"OCT 29, 2023",LAC vs. SAS,W,28,6,13,0.462,3,7,0.429,6,7,0.857,0,3,3,4,2,0,3,2,21,24,1,Kawhi Leonard,LAC,LAC,SAS,36.5,Pts+Rebs+Asts,28,24,25,7
22023,202695,22300099,"OCT 29, 2023",LAC vs. SAS,W,28,6,13,0.462,3,7,0.429,6,7,0.857,0,3,3,4,2,0,3,2,21,24,1,Kawhi Leonard,LAC,LAC,SAS,44.5,Fantasy Score,28,24,25,7
22023,202695,22300099,"OCT 29, 2023",LAC vs. SAS,W,28,6,13,0.462,3,7,0.429,6,7,0.857,0,3,3,4,2,0,3,2,21,24,1,Kawhi Leonard,LAC,LAC,SAS,4.0,Free Throws Made,28,24,25,7
22023,202695,22300099,"OCT 29, 2023",LAC vs. SAS,W,28,6,13,0.462,3,7,0.429,6,7,0.857,0,3,3,4,2,0,3,2,21,24,1,Kawhi Leonard,LAC,LAC,SAS,18.0,FG Attempted,28,24,25,7
22023,202695,22300099,"OCT 29, 2023",LAC vs. SAS,W,28,6,13,0.462,3,7,0.429,6,7,0.857,0,3,3,4,2,0,3,2,21,24,1,Kawhi Leonard,LAC,LAC,SAS,33.5,Pts+Rebs,28,24,25,7
22023,202695,22300099,"OCT 29, 2023",LAC vs. SAS,W,28,6,13,0.462,3,7,0.429,6,7,0.857,0,3,3,4,2,0,3,2,21,24,1,Kawhi Leonard,LAC,LAC,SAS,29.5,Pts+Asts,28,24,25,7
22023,202695,22300099,"OCT 29, 2023",LAC vs. SAS,W,28,6,13,0.462,3,7,0.429,6,7,0.857,0,3,3,4,2,0,3,2,21,24,1,Kawhi Leonard,LAC,LAC,SAS,10.5,Rebs+Asts,28,24,25,7
22023,202695,22300085,"OCT 27, 2023",LAC @ UTA,L,37,10,22,0.455,4,10,0.4,1,3,0.333,3,6,9,5,2,0,1,1,25,9,1,Kawhi Leonard,LAC,UTA,LAC,26.0,Points,39,34,30,14
22023,202695,22300085,"OCT 27, 2023",LAC @ UTA,L,37,10,22,0.455,4,10,0.4,1,3,0.333,3,6,9,5,2,0,1,1,25,9,1,Kawhi Leonard,LAC,UTA,LAC,7.0,Rebounds,39,34,30,14
22023,202695,22300085,"OCT 27, 2023",LAC @ UTA,L,37,10,22,0.455,4,10,0.4,1,3,0.333,3,6,9,5,2,0,1,1,25,9,1,Kawhi Leonard,LAC,UTA,LAC,36.5,Pts+Rebs+Asts,39,34,30,14
22023,202695,22300085,"OCT 27, 2023",LAC @ UTA,L,37,10,22,0.455,4,10,0.4,1,3,0.333,3,6,9,5,2,0,1,1,25,9,1,Kawhi Leonard,LAC,UTA,LAC,44.5,Fantasy Score,39,34,30,14
22023,202695,22300085,"OCT 27, 2023",LAC @ UTA,L,37,10,22,0.455,4,10,0.4,1,3,0.333,3,6,9,5,2,0,1,1,25,9,1,Kawhi Leonard,LAC,UTA,LAC,4.0,Free Throws Made,39,34,30,14
22023,202695,22300085,"OCT 27, 2023",LAC @ UTA,L,37,10,22,0.455,4,10,0.4,1,3,0.333,3,6,9,5,2,0,1,1,25,9,1,Kawhi Leonard,LAC,UTA,LAC,18.0,FG Attempted,39,34,30,14
22023,202695,22300085,"OCT 27, 2023",LAC @ UTA,L,37,10,22,0.455,4,10,0.4,1,3,0.333,3,6,9,5,2,0,1,1,25,9,1,Kawhi Leonard,LAC,UTA,LAC,33.5,Pts+Rebs,39,34,30,14
22023,202695,22300085,"OCT 27, 2023",LAC @ UTA,L,37,10,22,0.455,4,10,0.4,1,3,0.333,3,6,9,5,2,0,1,1,25,9,1,Kawhi Leonard,LAC,UTA,LAC,29.5,Pts+Asts,39,34,30,14
22023,202695,22300085,"OCT 27, 2023",LAC @ UTA,L,37,10,22,0.455,4,10,0.4,1,3,0.333,3,6,9,5,2,0,1,1,25,9,1,Kawhi Leonard,LAC,UTA,LAC,10.5,Rebs+Asts,39,34,30,14
22023,202695,22300074,"OCT 25, 2023",LAC vs. POR,W,29,9,17,0.529,5,5,1.0,0,0,0.0,1,4,5,6,1,1,4,2,23,25,1,Kawhi Leonard,LAC,LAC,POR,26.0,Points,34,28,29,11
22023,202695,22300074,"OCT 25, 2023",LAC vs. POR,W,29,9,17,0.529,5,5,1.0,0,0,0.0,1,4,5,6,1,1,4,2,23,25,1,Kawhi Leonard,LAC,LAC,POR,7.0,Rebounds,34,28,29,11
22023,202695,22300074,"OCT 25, 2023",LAC vs. POR,W,29,9,17,0.529,5,5,1.0,0,0,0.0,1,4,5,6,1,1,4,2,23,25,1,Kawhi Leonard,LAC,LAC,POR,36.5,Pts+Rebs+Asts,34,28,29,11
22023,202695,22300074,"OCT 25, 2023",LAC vs. POR,W,29,9,17,0.529,5,5,1.0,0,0,0.0,1,4,5,6,1,1,4,2,23,25,1,Kawhi Leonard,LAC,LAC,POR,44.5,Fantasy Score,34,28,29,11
22023,202695,22300074,"OCT 25, 2023",LAC vs. POR,W,29,9,17,0.529,5,5,1.0,0,0,0.0,1,4,5,6,1,1,4,2,23,25,1,Kawhi Leonard,LAC,LAC,POR,4.0,Free Throws Made,34,28,29,11
22023,202695,22300074,"OCT 25, 2023",LAC vs. POR,W,29,9,17,0.529,5,5,1.0,0,0,0.0,1,4,5,6,1,1,4,2,23,25,1,Kawhi Leonard,LAC,LAC,POR,18.0,FG Attempted,34,28,29,11
22023,202695,22300074,"OCT 25, 2023",LAC vs. POR,W,29,9,17,0.529,5,5,1.0,0,0,0.0,1,4,5,6,1,1,4,2,23,25,1,Kawhi Leonard,LAC,LAC,POR,33.5,Pts+Rebs,34,28,29,11
22023,202695,22300074,"OCT 25, 2023",LAC vs. POR,W,29,9,17,0.529,5,5,1.0,0,0,0.0,1,4,5,6,1,1,4,2,23,25,1,Kawhi Leonard,LAC,LAC,POR,29.5,Pts+Asts,34,28,29,11
22023,202695,22300074,"OCT 25, 2023",LAC vs. POR,W,29,9,17,0.529,5,5,1.0,0,0,0.0,1,4,5,6,1,1,4,2,23,25,1,Kawhi Leonard,LAC,LAC,POR,10.5,Rebs+Asts,34,28,29,11
22023,1641721,22300370,"DEC 20, 2023",LAL @ CHI,L,1,0,0,0.0,0,0,0.0,0,0,0.0,0,0,0,0,0,0,0,0,0,0,1,Maxwell Lewis,LAL,CHI,LAL,,,0,0,0,0
22023,1641721,22301230,"DEC 07, 2023",LAL vs. NOP,W,8,1,4,0.25,1,2,0.5,0,0,0.0,0,1,1,1,0,0,1,0,3,6,1,Maxwell Lewis,LAL,LAL,NOP,,,5,4,4,2
22023,1641721,22300291,"DEC 02, 2023",LAL vs. HOU,W,3,0,1,0.0,0,1,0.0,0,0,0.0,0,0,0,0,0,0,0,1,0,-7,1,Maxwell Lewis,LAL,LAL,HOU,,,0,0,0,0
22023,1641721,22300271,"NOV 30, 2023",LAL @ OKC,L,4,0,0,0.0,0,0,0.0,0,0,0.0,0,0,0,0,0,0,0,0,0,-5,1,Maxwell Lewis,LAL,OKC,LAL,,,0,0,0,0
22023,1641721,22300258,"NOV 29, 2023",LAL @ DET,W,7,0,0,0.0,0,0,0.0,0,0,0.0,0,0,0,2,2,0,0,1,0,-3,1,Maxwell Lewis,LAL,DET,LAL,,,2,0,2,2
22023,1641721,22300255,"NOV 27, 2023",LAL @ PHI,L,8,0,1,0.0,0,0,0.0,0,0,0.0,1,0,1,0,0,0,2,0,0,-17,1,Maxwell Lewis,LAL,PHI,LAL,,,1,1,0,1
22023,1641721,22300036,"NOV 17, 2023",LAL @ POR,W,1,0,0,0.0,0,0,0.0,0,0,0.0,0,0,0,0,0,0,0,0,0,0,1,Maxwell Lewis,LAL,POR,LAL,,,0,0,0,0
22023,1641721,22300198,"NOV 15, 2023",LAL vs. SAC,L,1,0,0,0.0,0,0,0.0,0,0,0.0,0,0,0,0,0,0,1,0,0,-4,1,Maxwell Lewis,LAL,LAL,SAC,,,0,0,0,0
22023,1641721,22300026,"NOV 14, 2023",LAL vs. MEM,W,5,0,1,0.0,0,0,0.0,0,0,0.0,0,0,0,0,0,0,0,0,0,5,1,Maxwell Lewis,LAL,LAL,MEM,,,0,0,0,0
22023,1641721,22300163,"NOV 08, 2023",LAL @ HOU,L,8,0,2,0.0,0,0,0.0,0,0,0.0,0,1,1,0,0,0,0,0,0,-5,1,Maxwell Lewis,LAL,HOU,LAL,,,1,1,0,1
22023,1641721,22300134,"NOV 04, 2023",LAL @ ORL,L,4,0,0,0.0,0,0,0.0,0,0,0.0,0,0,0,0,0,0,1,0,0,-3,1,Maxwell Lewis,LAL,ORL,LAL,,,0,0,0,0
22023,1641721,22300061,"OCT 24, 2023",LAL @ DEN,L,1,0,0,0.0,0,0,0.0,0,0,0.0,0,0,0,0,0,0,0,0,0,0,1,Maxwell Lewis,LAL,DEN,LAL,,,0,0,0,0
22023,1630184,22300547,"JAN 13, 2024",NOP @ DAL,W,7,0,2,0.0,0,1,0.0,2,2,1.0,0,2,2,0,0,0,1,0,2,-3,1,Kira Lewis Jr.,NOP,DAL,NOP,,,4,4,2,2
22023,1630184,22300461,"JAN 02, 2024",NOP vs. BKN,W,5,1,3,0.333,0,2,0.0,0,0,0.0,1,0,1,0,0,0,1,0,2,-3,1,Kira Lewis Jr.,NOP,NOP,BKN,,,3,3,2,1
22023,1630184,22300311,"DEC 13, 2023",NOP @ WAS,W,4,0,1,0.0,0,1,0.0,0,0,0.0,0,1,1,0,0,0,0,0,0,-8,1,Kira Lewis Jr.,NOP,WAS,NOP,,,1,1,0,1
22023,1630184,22301230,"DEC 07, 2023",NOP @ LAL,L,6,1,3,0.333,0,1,0.0,0,0,0.0,0,0,0,0,0,0,1,0,2,-3,1,Kira Lewis Jr.,NOP,LAL,NOP,,,2,2,2,0
22023,1630184,22300222,"NOV 20, 2023",NOP vs. SAC,W,6,1,3,0.333,1,2,0.5,0,0,0.0,0,0,0,2,1,0,0,1,3,-3,1,Kira Lewis Jr.,NOP,NOP,SAC,,,5,3,5,2
22023,1630184,22300022,"NOV 14, 2023",NOP vs. DAL,W,2,1,1,1.0,0,0,0.0,0,0,0.0,0,0,0,0,0,0,0,0,2,0,1,Kira Lewis Jr.,NOP,NOP,DAL,,,2,2,2,0
22023,1630184,22300183,"NOV 12, 2023",NOP vs. DAL,L,8,2,5,0.4,0,0,0.0,1,1,1.0,1,0,1,4,0,0,1,0,5,14,1,Kira Lewis Jr.,NOP,NOP,DAL,,,10,6,9,5
22023,1630184,22300166,"NOV 08, 2023",NOP @ MIN,L,19,1,7,0.143,0,1,0.0,0,0,0.0,1,2,3,2,0,0,1,2,2,7,1,Kira Lewis Jr.,NOP,MIN,NOP,,,7,5,4,5
22023,1630184,22300156,"NOV 06, 2023",NOP @ DEN,L,9,1,2,0.5,0,1,0.0,0,0,0.0,0,0,0,0,0,0,0,1,2,0,1,Kira Lewis Jr.,NOP,DEN,NOP,,,2,2,2,0
22023,1630184,22300135,"NOV 04, 2023",NOP vs. ATL,L,10,0,3,0.0,0,2,0.0,0,0,0.0,0,0,0,4,1,0,0,1,0,-4,1,Kira Lewis Jr.,NOP,NOP,ATL,,,4,0,4,4
22023,1630184,22300129,"NOV 02, 2023",NOP vs. DET,W,20,1,5,0.2,0,1,0.0,4,4,1.0,0,3,3,4,1,0,1,1,6,15,1,Kira Lewis Jr.,NOP,NOP,DET,,,13,9,10,7
22023,1630184,22300121,"NOV 01, 2023",NOP @ OKC,W,10,2,4,0.5,1,2,0.5,0,0,0.0,0,0,0,0,2,0,1,0,5,-8,1,Kira Lewis Jr.,NOP,OKC,NOP,,,5,5,5,0
22023,1630184,22300108,"OCT 30, 2023",NOP vs. GSW,L,16,4,6,0.667,0,2,0.0,3,4,0.75,1,0,1,2,0,0,0,1,11,-13,1,Kira Lewis Jr.,NOP,NOP,GSW,,,14,12,13,3
22023,1630184,22300090,"OCT 28, 2023",NOP vs. NYK,W,10,1,4,0.25,0,2,0.0,0,0,0.0,0,2,2,0,0,0,0,0,2,-10,1,Kira Lewis Jr.,NOP,NOP,NYK,,,4,4,2,2
22023,1630184,22300071,"OCT 25, 2023",NOP @ MEM,W,11,0,3,0.0,0,2,0.0,0,0,0.0,0,0,0,0,0,1,1,1,0,0,1,Kira Lewis Jr.,NOP,MEM,NOP,,,0,0,0,0
22023,1630604,22300539,"JAN 12, 2024",NOP @ DEN,L,2,0,0,0.0,0,0,0.0,0,0,0.0,0,1,1,1,0,0,0,0,0,6,1,E.J. Liddell,NOP,DEN,NOP,,,2,1,1,2
22023,1630604,22300525,"JAN 10, 2024",NOP @ GSW,W,3,0,1,0.0,0,1,0.0,0,0,0.0,0,0,0,0,0,0,0,0,0,-2,1,E.J. Liddell,NOP,GSW,NOP,,,0,0,0,0
22023,1630604,22300500,"JAN 07, 2024",NOP @ SAC,W,4,0,0,0.0,0,0,0.0,0,0,0.0,0,0,0,0,0,1,1,1,0,-7,1,E.J. Liddell,NOP,SAC,NOP,,,0,0,0,0
22023,1630604,22300166,"NOV 08, 2023",NOP @ MIN,L,5,1,3,0.333,0,2,0.0,2,2,1.0,0,0,0,0,0,1,1,1,4,6,1,E.J. Liddell,NOP,MIN,NOP,,,4,4,4,0
22023,1630604,22300135,"NOV 04, 2023",NOP vs. ATL,L,1,0,0,0.0,0,0,0.0,0,0,0.0,0,0,0,0,0,0,0,0,0,-1,1,E.J. Liddell,NOP,NOP,ATL,,,0,0,0,0
22023,1630604,22300090,"OCT 28, 2023",NOP vs. NYK,W,2,0,1,0.0,0,1,0.0,0,0,0.0,0,2,2,0,0,0,0,0,0,-10,1,E.J. Liddell,NOP,NOP,NYK,,,2,2,0,2
22023,203081,22300552,"JAN 14, 2024",MIL vs. SAC,W,41,9,23,0.391,5,13,0.385,6,6,1.0,0,4,4,8,0,0,4,0,29,-6,1,Damian Lillard,MIL,MIL,SAC,,,41,33,37,12
22023,203081,22300545,"JAN 13, 2024",MIL vs. GSW,W,38,9,19,0.474,2,5,0.4,7,7,1.0,0,6,6,7,2,0,1,1,27,21,1,Damian Lillard,MIL,MIL,GSW,,,40,33,34,13
22023,203081,22300528,"JAN 11, 2024",MIL vs. BOS,W,27,6,12,0.5,3,8,0.375,6,6,1.0,0,4,4,4,0,0,0,1,21,25,1,Damian Lillard,MIL,MIL,BOS,,,29,25,25,8
22023,203081,22300496,"JAN 06, 2024",MIL @ HOU,L,38,5,16,0.313,1,8,0.125,7,10,0.7,0,2,2,8,2,0,1,1,18,-11,1,Damian Lillard,MIL,HOU,MIL,,,28,20,26,10
22023,203081,22300477,"JAN 04, 2024",MIL @ SAS,W,39,10,19,0.526,1,6,0.167,4,4,1.0,1,3,4,10,1,0,0,3,25,11,1,Damian Lillard,MIL,SAS,MIL,,,39,29,35,14
22023,203081,22300466,"JAN 03, 2024",MIL @ IND,L,36,6,18,0.333,2,8,0.25,9,10,0.9,1,1,2,5,3,0,2,3,23,-22,1,Damian Lillard,MIL,IND,MIL,,,30,25,28,7
22023,203081,22300454,"JAN 01, 2024",MIL vs. IND,L,38,3,16,0.188,1,9,0.111,6,6,1.0,1,6,7,5,0,0,1,3,13,4,1,Damian Lillard,MIL,MIL,IND,,,25,20,18,12
22023,203081,22300433,"DEC 29, 2023",MIL @ CLE,W,34,9,16,0.563,2,6,0.333,11,11,1.0,0,2,2,4,0,0,2,3,31,14,1,Damian Lillard,MIL,CLE,MIL,,,37,33,35,6
22023,203081,22300417,"DEC 27, 2023",MIL @ BKN,W,29,4,10,0.4,3,9,0.333,1,1,1.0,0,3,3,4,0,0,4,0,12,2,1,Damian Lillard,MIL,BKN,MIL,,,19,15,16,7
22023,203081,22300401,"DEC 25, 2023",MIL @ NYK,L,38,10,21,0.476,4,13,0.308,8,9,0.889,0,1,1,8,1,0,4,2,32,-6,1,Damian Lillard,MIL,NYK,MIL,,,41,33,40,9
22023,203081,22300388,"DEC 23, 2023",MIL @ NYK,W,34,6,16,0.375,3,7,0.429,4,5,0.8,3,6,9,7,1,0,3,3,19,3,1,Damian Lillard,MIL,NYK,MIL,,,35,28,26,16
22023,203081,22300378,"DEC 21, 2023",MIL vs. ORL,W,35,5,17,0.294,4,8,0.5,10,10,1.0,0,5,5,8,0,0,3,1,24,9,1,Damian Lillard,MIL,MIL,ORL,,,37,29,32,13
22023,203081,22300361,"DEC 19, 2023",MIL vs. SAS,W,35,14,22,0.636,7,12,0.583,5,5,1.0,0,3,3,4,3,0,1,0,40,26,1,Damian Lillard,MIL,MIL,SAS,,,47,43,44,7
22023,203081,22300346,"DEC 17, 2023",MIL vs. HOU,W,37,11,19,0.579,5,8,0.625,12,13,0.923,0,5,5,11,3,0,3,2,39,10,1,Damian Lillard,MIL,MIL,HOU,,,55,44,50,16
22023,203081,22300334,"DEC 16, 2023",MIL vs. DET,W,30,11,22,0.5,6,14,0.429,5,5,1.0,0,4,4,5,0,1,2,3,33,26,1,Damian Lillard,MIL,MIL,DET,,,42,37,38,9
22023,203081,22300315,"DEC 13, 2023",MIL vs. IND,W,36,6,14,0.429,2,8,0.25,7,9,0.778,0,4,4,6,1,0,4,2,21,15,1,Damian Lillard,MIL,MIL,IND,,,31,25,27,10
22023,203081,22300300,"DEC 11, 2023",MIL vs. CHI,W,41,3,17,0.176,2,9,0.222,6,7,0.857,0,4,4,9,0,1,2,2,14,0,1,Damian Lillard,MIL,MIL,CHI,,,27,18,23,13
22023,203081,22301229,"DEC 07, 2023",MIL vs. IND,L,42,7,20,0.35,4,9,0.444,6,6,1.0,0,7,7,7,1,1,3,2,24,6,1,Damian Lillard,MIL,MIL,IND,,,38,31,31,14
22023,203081,22301201,"DEC 05, 2023",MIL vs. NYK,W,34,8,13,0.615,5,7,0.714,7,8,0.875,1,2,3,7,1,1,3,4,28,17,1,Damian Lillard,MIL,MIL,NYK,,,38,31,35,10
22023,203081,22300286,"DEC 02, 2023",MIL vs. ATL,W,38,10,16,0.625,3,6,0.5,2,2,1.0,1,5,6,9,1,0,4,3,25,14,1,Damian Lillard,MIL,MIL,ATL,,,40,31,34,15
22023,203081,22300269,"NOV 30, 2023",MIL @ CHI,L,43,7,16,0.438,1,6,0.167,3,4,0.75,1,4,5,13,2,1,7,1,18,9,1,Damian Lillard,MIL,CHI,MIL,,,36,23,31,18
22023,203081,22300056,"NOV 28, 2023",MIL @ MIA,W,37,9,18,0.5,4,9,0.444,10,10,1.0,2,2,4,9,0,0,1,1,32,13,1,Damian Lillard,MIL,MIA,MIL,,,45,36,41,13
22023,203081,22300245,"NOV 26, 2023",MIL vs. POR,W,37,7,21,0.333,4,12,0.333,13,14,0.929,1,4,5,4,2,0,3,2,31,15,1,Damian Lillard,MIL,MIL,POR,,,40,36,35,9
22023,203081,22300049,"NOV 24, 2023",MIL vs. WAS,W,37,11,18,0.611,2,5,0.4,7,8,0.875,1,5,6,10,0,0,1,1,31,1,1,Damian Lillard,MIL,MIL,WAS,,,47,37,41,16
22023,203081,22300228,"NOV 22, 2023",MIL @ BOS,L,38,11,24,0.458,3,10,0.3,2,2,1.0,0,5,5,5,2,0,3,2,27,9,1,Damian Lillard,MIL,BOS,MIL,,,37,32,32,10
22023,203081,22300219,"NOV 20, 2023",MIL @ WAS,W,33,5,14,0.357,3,6,0.5,9,11,0.818,1,4,5,7,0,0,1,1,22,6,1,Damian Lillard,MIL,WAS,MIL,,,34,27,29,12
22023,203081,22300205,"NOV 18, 2023",MIL vs. DAL,W,38,7,18,0.389,4,11,0.364,9,10,0.9,0,3,3,12,1,0,1,2,27,-6,1,Damian Lillard,MIL,MIL,DAL,,,42,30,39,15
22023,203081,22300027,"NOV 17, 2023",MIL @ CHA,W,31,9,18,0.5,5,10,0.5,4,4,1.0,0,5,5,5,1,0,2,2,27,10,1,Damian Lillard,MIL,CHA,MIL,,,37,32,32,10
22023,203081,22300195,"NOV 15, 2023",MIL @ TOR,W,31,9,18,0.5,4,10,0.4,15,16,0.938,0,4,4,13,2,0,4,1,37,25,1,Damian Lillard,MIL,TOR,MIL,,,54,41,50,17
22023,203081,22300190,"NOV 13, 2023",MIL vs. CHI,W,32,3,17,0.176,1,9,0.111,5,5,1.0,2,1,3,5,0,0,5,0,12,-6,1,Damian Lillard,MIL,MIL,CHI,,,20,15,17,8
22023,203081,22300165,"NOV 08, 2023",MIL vs. DET,W,34,10,25,0.4,2,12,0.167,12,13,0.923,0,2,2,3,3,0,1,1,34,5,1,Damian Lillard,MIL,MIL,DET,,,39,36,37,5
22023,203081,22300149,"NOV 06, 2023",MIL @ BKN,W,34,5,15,0.333,2,8,0.25,9,10,0.9,2,4,6,7,1,0,1,1,21,-14,1,Damian Lillard,MIL,BKN,MIL,,,34,27,28,13
22023,203081,22300002,"NOV 03, 2023",MIL vs. NYK,W,36,7,15,0.467,4,7,0.571,12,12,1.0,0,4,4,4,1,1,4,0,30,2,1,Damian Lillard,MIL,MIL,NYK,,,38,34,34,8
22023,203081,22300116,"NOV 01, 2023",MIL @ TOR,L,31,4,9,0.444,1,4,0.25,6,7,0.857,0,2,2,6,0,0,2,1,15,-26,1,Damian Lillard,MIL,TOR,MIL,,,23,17,21,8
22023,203081,22300107,"OCT 30, 2023",MIL vs. MIA,W,35,7,14,0.5,2,7,0.286,9,11,0.818,1,4,5,4,1,0,4,2,25,2,1,Damian Lillard,MIL,MIL,MIA,,,34,30,29,9
22023,203081,22300097,"OCT 29, 2023",MIL vs. ATL,L,29,2,12,0.167,2,8,0.25,0,0,0.0,1,3,4,5,2,0,6,2,6,-29,1,Damian Lillard,MIL,MIL,ATL,,,15,10,11,9
22023,203081,22300075,"OCT 26, 2023",MIL vs. PHI,W,37,9,20,0.45,4,12,0.333,17,17,1.0,0,8,8,4,0,0,0,2,39,12,1,Damian Lillard,MIL,MIL,PHI,,,51,47,43,12
22023,1629642,22300531,"JAN 11, 2024",PHX @ LAL,W,4,1,1,1.0,0,0,0.0,1,1,1.0,0,0,0,0,0,0,1,0,3,-5,1,Nassir Little,PHX,LAL,PHX,,,3,3,3,0
22023,1629642,22300418,"DEC 27, 2023",PHX @ HOU,W,16,3,6,0.5,0,3,0.0,1,1,1.0,0,6,6,0,0,0,1,1,7,2,1,Nassir Little,PHX,HOU,PHX,,,13,13,7,6
22023,1629642,22300405,"DEC 25, 2023",PHX vs. DAL,L,3,0,0,0.0,0,0,0.0,0,0,0.0,0,0,0,0,0,0,0,1,0,-6,1,Nassir Little,PHX,PHX,DAL,,,0,0,0,0
22023,1629642,22300387,"DEC 22, 2023",PHX @ SAC,L,16,3,8,0.375,0,3,0.0,0,0,0.0,0,0,0,0,1,0,1,3,6,0,1,Nassir Little,PHX,SAC,PHX,,,6,6,6,0
22023,1629642,22300363,"DEC 19, 2023",PHX @ POR,L,19,1,2,0.5,1,1,1.0,1,2,0.5,0,2,2,0,0,0,0,1,4,-12,1,Nassir Little,PHX,POR,PHX,,,6,6,4,2
22023,1629642,22300347,"DEC 17, 2023",PHX vs. WAS,W,23,2,3,0.667,1,2,0.5,0,0,0.0,2,5,7,1,0,0,1,2,5,-9,1,Nassir Little,PHX,PHX,WAS,,,13,12,6,8
22023,1629642,22300333,"DEC 15, 2023",PHX vs. NYK,L,26,2,5,0.4,1,3,0.333,0,0,0.0,2,2,4,1,0,0,0,2,5,-5,1,Nassir Little,PHX,PHX,NYK,,,10,9,6,5
22023,1629642,22300317,"DEC 13, 2023",PHX vs. BKN,L,27,4,7,0.571,2,5,0.4,0,0,0.0,2,5,7,3,0,0,2,2,10,13,1,Nassir Little,PHX,PHX,BKN,,,20,17,13,10
22023,1629642,22301228,"DEC 08, 2023",PHX vs. SAC,L,4,0,0,0.0,0,0,0.0,0,0,0.0,0,1,1,0,0,0,0,0,0,-1,1,Nassir Little,PHX,PHX,SAC,,,1,1,0,1
22023,1629642,22301203,"DEC 05, 2023",PHX @ LAL,L,14,2,4,0.5,1,1,1.0,0,0,0.0,1,1,2,2,0,0,1,1,5,-11,1,Nassir Little,PHX,LAL,PHX,,,9,7,7,4
22023,1629642,22300288,"DEC 02, 2023",PHX vs. MEM,W,15,1,5,0.2,0,2,0.0,2,2,1.0,1,1,2,2,0,0,1,0,4,-1,1,Nassir Little,PHX,PHX,MEM,,,8,6,6,4
22023,1629642,22300279,"DEC 01, 2023",PHX vs. DEN,L,19,1,1,1.0,0,0,0.0,0,0,0.0,0,2,2,0,0,1,0,0,2,-6,1,Nassir Little,PHX,PHX,DEN,,,4,4,2,2
22023,1629642,22300247,"NOV 26, 2023",PHX @ NYK,W,20,4,9,0.444,3,6,0.5,0,0,0.0,0,2,2,0,0,2,1,1,11,-15,1,Nassir Little,PHX,NYK,PHX,,,13,13,11,2
22023,1629642,22300044,"NOV 24, 2023",PHX @ MEM,W,16,0,1,0.0,0,1,0.0,2,2,1.0,0,4,4,0,1,0,1,2,2,1,1,Nassir Little,PHX,MEM,PHX,,,6,6,2,4
22023,1629642,22300236,"NOV 22, 2023",PHX vs. GSW,W,27,4,9,0.444,0,3,0.0,2,2,1.0,1,4,5,3,2,0,0,1,10,-9,1,Nassir Little,PHX,PHX,GSW,,,18,15,13,8
22023,1629642,22300041,"NOV 21, 2023",PHX vs. POR,W,22,4,6,0.667,1,3,0.333,4,4,1.0,2,3,5,0,1,1,0,1,13,2,1,Nassir Little,PHX,PHX,POR,,,18,18,13,5
22023,1629642,22300214,"NOV 19, 2023",PHX @ UTA,W,20,4,7,0.571,2,5,0.4,0,2,0.0,2,1,3,2,0,3,0,4,10,2,1,Nassir Little,PHX,UTA,PHX,,,15,13,12,5
22023,1629642,22300035,"NOV 17, 2023",PHX @ UTA,W,11,2,3,0.667,1,2,0.5,0,0,0.0,0,1,1,1,0,0,0,0,5,8,1,Nassir Little,PHX,UTA,PHX,,,7,6,6,2
22023,1629642,22300197,"NOV 15, 2023",PHX vs. MIN,W,4,1,1,1.0,0,0,0.0,0,0,0.0,0,0,0,0,0,0,0,1,2,-3,1,Nassir Little,PHX,PHX,MIN,,,2,2,2,0
22023,1629642,22300132,"NOV 04, 2023",PHX @ PHI,L,4,0,0,0.0,0,0,0.0,2,2,1.0,1,0,1,0,0,0,0,0,2,3,1,Nassir Little,PHX,PHI,PHX,,,3,3,2,1
22023,1629642,22300113,"OCT 31, 2023",PHX vs. SAS,L,18,2,3,0.667,2,2,1.0,0,0,0.0,0,2,2,1,2,0,1,5,6,2,1,Nassir Little,PHX,PHX,SAS,,,9,8,7,3
22023,1629642,22300094,"OCT 28, 2023",PHX vs. UTA,W,21,3,8,0.375,0,5,0.0,0,0,0.0,0,1,1,0,1,0,0,2,6,-1,1,Nassir Little,PHX,PHX,UTA,,,7,7,6,1
22023,1629642,22300076,"OCT 26, 2023",PHX @ LAL,L,13,0,2,0.0,0,2,0.0,2,2,1.0,0,2,2,0,1,1,1,0,2,-9,1,Nassir Little,PHX,LAL,PHX,,,4,4,2,2
22023,1629642,22300062,"OCT 24, 2023",PHX @ GSW,W,3,1,1,1.0,1,1,1.0,0,0,0.0,0,1,1,0,1,0,0,1,3,-3,1,Nassir Little,PHX,GSW,PHX,,,4,4,3,1
22023,1641726,22300556,"JAN 15, 2024",DAL vs. NOP,W,26,2,2,1.0,0,0,0.0,2,2,1.0,7,5,12,1,0,0,2,4,6,-2,1,Dereck Lively II,DAL,DAL,NOP,,,19,18,7,13
22023,1641726,22300472,"JAN 03, 2024",DAL vs. POR,W,19,0,1,0.0,0,0,0.0,0,0,0.0,1,3,4,4,2,3,0,1,0,23,1,Dereck Lively II,DAL,DAL,POR,,,8,4,4,8
22023,1641726,22300457,"JAN 01, 2024",DAL @ UTA,L,25,5,8,0.625,0,0,0.0,0,0,0.0,2,4,6,2,1,1,0,1,10,-3,1,Dereck Lively II,DAL,UTA,DAL,,,18,16,12,8
22023,1641726,22300444,"DEC 30, 2023",DAL @ GSW,W,35,5,7,0.714,0,0,0.0,2,3,0.667,1,13,14,1,0,0,1,2,12,12,1,Dereck Lively II,DAL,GSW,DAL,,,27,26,13,15
22023,1641726,22300423,"DEC 28, 2023",DAL @ MIN,L,15,1,4,0.25,0,0,0.0,0,0,0.0,3,1,4,2,0,0,2,5,2,-16,1,Dereck Lively II,DAL,MIN,DAL,,,8,6,4,6
22023,1641726,22300420,"DEC 27, 2023",DAL vs. CLE,L,25,2,2,1.0,0,0,0.0,0,1,0.0,2,2,4,1,0,2,1,4,4,-7,1,Dereck Lively II,DAL,DAL,CLE,,,9,8,5,5
22023,1641726,22300405,"DEC 25, 2023",DAL @ PHX,W,32,8,9,0.889,0,0,0.0,4,9,0.444,3,7,10,1,0,0,1,3,20,18,1,Dereck Lively II,DAL,PHX,DAL,,,31,30,21,11
22023,1641726,22300341,"DEC 16, 2023",DAL @ POR,W,6,0,1,0.0,0,0,0.0,0,0,0.0,1,1,2,0,0,0,0,0,0,-4,1,Dereck Lively II,DAL,POR,DAL,,,2,2,0,2
22023,1641726,22300321,"DEC 14, 2023",DAL vs. MIN,L,32,7,9,0.778,0,0,0.0,1,2,0.5,3,3,6,0,1,2,2,3,15,-12,1,Dereck Lively II,DAL,DAL,MIN,,,21,21,15,6
22023,1641726,22300306,"DEC 12, 2023",DAL vs. LAL,W,30,4,7,0.571,0,0,0.0,0,0,0.0,4,4,8,0,2,3,1,4,8,8,1,Dereck Lively II,DAL,DAL,LAL,,,16,16,8,8
22023,1641726,22300299,"DEC 11, 2023",DAL @ MEM,W,35,8,9,0.889,0,0,0.0,0,0,0.0,5,11,16,2,0,1,4,3,16,5,1,Dereck Lively II,DAL,MEM,DAL,,,34,32,18,18
22023,1641726,22301226,"DEC 08, 2023",DAL @ POR,W,28,5,6,0.833,0,0,0.0,0,0,0.0,1,8,9,2,1,2,2,4,10,6,1,Dereck Lively II,DAL,POR,DAL,,,21,19,12,11
22023,1641726,22301213,"DEC 06, 2023",DAL vs. UTA,W,24,5,6,0.833,0,0,0.0,0,0,0.0,1,3,4,1,1,2,0,2,10,26,1,Dereck Lively II,DAL,DAL,UTA,,,15,14,11,5
22023,1641726,22300287,"DEC 02, 2023",DAL vs. OKC,L,39,9,9,1.0,0,0,0.0,2,5,0.4,6,10,16,0,1,7,2,2,20,12,1,Dereck Lively II,DAL,DAL,OKC,,,36,36,20,16
22023,1641726,22300277,"DEC 01, 2023",DAL vs. MEM,L,23,2,5,0.4,0,0,0.0,0,0,0.0,1,4,5,1,1,2,2,1,4,-8,1,Dereck Lively II,DAL,DAL,MEM,,,10,9,5,6
22023,1641726,22300059,"NOV 28, 2023",DAL vs. HOU,W,28,4,4,1.0,0,0,0.0,0,0,0.0,2,3,5,2,0,2,0,5,8,-2,1,Dereck Lively II,DAL,DAL,HOU,,,15,13,10,7
22023,1641726,22300238,"NOV 22, 2023",DAL @ LAL,W,19,1,3,0.333,0,0,0.0,0,0,0.0,4,6,10,3,0,0,1,0,2,1,1,Dereck Lively II,DAL,LAL,DAL,,,15,12,5,13
22023,1641726,22300212,"NOV 19, 2023",DAL vs. SAC,L,29,3,6,0.5,0,0,0.0,0,0,0.0,5,4,9,0,1,2,1,3,6,-16,1,Dereck Lively II,DAL,DAL,SAC,,,15,15,6,9
22023,1641726,22300205,"NOV 18, 2023",DAL @ MIL,L,24,3,4,0.75,0,0,0.0,0,0,0.0,3,7,10,2,0,1,3,5,6,-1,1,Dereck Lively II,DAL,MIL,DAL,,,18,16,8,12
22023,1641726,22300192,"NOV 15, 2023",DAL @ WAS,W,24,7,8,0.875,0,0,0.0,3,3,1.0,4,5,9,2,1,2,1,2,17,16,1,Dereck Lively II,DAL,WAS,DAL,,,28,26,19,11
22023,1641726,22300022,"NOV 14, 2023",DAL @ NOP,L,21,1,2,0.5,0,1,0.0,2,2,1.0,3,6,9,2,0,0,0,2,4,-8,1,Dereck Lively II,DAL,NOP,DAL,,,15,13,6,11
22023,1641726,22300183,"NOV 12, 2023",DAL @ NOP,W,26,4,5,0.8,0,0,0.0,2,4,0.5,1,1,2,0,1,2,1,5,10,13,1,Dereck Lively II,DAL,NOP,DAL,,,12,12,10,2
22023,1641726,22300014,"NOV 10, 2023",DAL vs. LAC,W,26,3,8,0.375,0,0,0.0,0,0,0.0,2,2,4,1,0,1,1,6,6,15,1,Dereck Lively II,DAL,DAL,LAC,,,11,10,7,5
22023,1641726,22300147,"NOV 06, 2023",DAL @ ORL,W,16,4,5,0.8,0,0,0.0,2,2,1.0,2,3,5,0,1,1,2,5,10,1,1,Dereck Lively II,DAL,ORL,DAL,,,15,15,10,5
22023,1641726,22300143,"NOV 05, 2023",DAL vs. CHA,W,32,7,9,0.778,0,0,0.0,1,2,0.5,3,11,14,1,0,1,2,4,15,1,1,Dereck Lively II,DAL,DAL,CHA,,,30,29,16,15
22023,1641726,22300006,"NOV 03, 2023",DAL @ DEN,L,25,2,3,0.667,0,1,0.0,0,0,0.0,1,3,4,0,1,1,0,2,4,-10,1,Dereck Lively II,DAL,DEN,DAL,,,8,8,4,4
22023,1641726,22300124,"NOV 01, 2023",DAL vs. CHI,W,33,3,5,0.6,0,0,0.0,1,4,0.25,7,6,13,6,2,1,1,3,7,15,1,Dereck Lively II,DAL,DAL,CHI,,,26,20,13,19
22023,1641726,22300106,"OCT 30, 2023",DAL @ MEM,W,14,1,2,0.5,0,0,0.0,0,0,0.0,1,5,6,0,0,1,0,5,2,-2,1,Dereck Lively II,DAL,MEM,DAL,,,8,8,2,6
22023,1641726,22300084,"OCT 27, 2023",DAL vs. BKN,W,17,4,4,1.0,0,0,0.0,1,2,0.5,1,1,2,0,0,1,1,0,9,1,1,Dereck Lively II,DAL,DAL,BKN,,,11,11,9,2
22023,1641726,22300073,"OCT 25, 2023",DAL @ SAS,W,31,7,8,0.875,0,0,0.0,2,3,0.667,5,5,10,1,1,1,1,4,16,20,1,Dereck Lively II,DAL,SAS,DAL,,,27,26,17,11
22023,1630587,22300534,"JAN 12, 2024",DET vs. HOU,L,16,1,4,0.25,1,4,0.25,0,0,0.0,0,0,0,1,0,2,0,3,3,-3,1,Isaiah Livers,DET,DET,HOU,,,4,3,4,1
22023,1630587,22300519,"JAN 10, 2024",DET vs. SAS,L,17,2,3,0.667,2,3,0.667,0,0,0.0,2,2,4,1,1,0,0,1,6,-6,1,Isaiah Livers,DET,DET,SAS,,,11,10,7,5
22023,1630587,22300512,"JAN 09, 2024",DET vs. SAC,L,15,1,3,0.333,1,2,0.5,0,0,0.0,1,0,1,2,0,0,0,0,3,-7,1,Isaiah Livers,DET,DET,SAC,,,6,4,5,3
22023,1630587,22300502,"JAN 07, 2024",DET @ DEN,L,31,4,8,0.5,1,2,0.5,2,2,1.0,2,3,5,1,1,0,0,5,11,-1,1,Isaiah Livers,DET,DEN,DET,,,17,16,12,6
22023,1630587,22300490,"JAN 05, 2024",DET @ GSW,L,22,2,3,0.667,1,2,0.5,0,0,0.0,0,1,1,1,1,0,0,2,5,-7,1,Isaiah Livers,DET,GSW,DET,,,7,6,6,2
22023,1630587,22300474,"JAN 03, 2024",DET @ UTA,L,36,4,7,0.571,1,4,0.25,1,1,1.0,3,1,4,0,2,0,1,4,10,-13,1,Isaiah Livers,DET,UTA,DET,,,14,14,10,4
22023,1630587,22300453,"JAN 01, 2024",DET @ HOU,L,13,1,2,0.5,0,0,0.0,0,0,0.0,0,0,0,0,0,0,0,0,2,-11,1,Isaiah Livers,DET,HOU,DET,,,2,2,2,0
22023,1630587,22300440,"DEC 30, 2023",DET vs. TOR,W,17,1,2,0.5,1,2,0.5,0,0,0.0,0,1,1,1,0,0,1,3,3,1,1,Isaiah Livers,DET,DET,TOR,,,5,4,4,2
22023,1630587,22300421,"DEC 28, 2023",DET @ BOS,L,23,3,7,0.429,2,6,0.333,1,4,0.25,0,1,1,2,0,1,3,2,9,-13,1,Isaiah Livers,DET,BOS,DET,,,12,10,11,3
22023,1630587,22300374,"DEC 21, 2023",DET vs. UTA,L,13,0,3,0.0,0,3,0.0,0,0,0.0,1,2,3,1,0,0,1,2,0,-7,1,Isaiah Livers,DET,DET,UTA,,,4,3,1,4
22023,1630587,22300352,"DEC 18, 2023",DET @ ATL,L,4,0,3,0.0,0,1,0.0,0,0,0.0,0,0,0,0,0,0,0,0,0,-4,1,Isaiah Livers,DET,ATL,DET,,,0,0,0,0
22023,1630587,22300334,"DEC 16, 2023",DET @ MIL,L,27,1,8,0.125,0,5,0.0,0,0,0.0,2,2,4,1,3,1,0,1,2,-17,1,Isaiah Livers,DET,MIL,DET,,,7,6,3,5
22023,1630587,22300327,"DEC 15, 2023",DET @ PHI,L,25,1,4,0.25,0,2,0.0,1,2,0.5,0,3,3,2,1,1,0,4,3,5,1,Isaiah Livers,DET,PHI,DET,,,8,6,5,5
22023,1630587,22300310,"DEC 13, 2023",DET vs. PHI,L,27,1,4,0.25,0,2,0.0,0,0,0.0,0,3,3,0,1,0,0,1,2,-16,1,Isaiah Livers,DET,DET,PHI,,,5,5,2,3
22023,1630587,22300293,"DEC 11, 2023",DET vs. IND,L,17,2,5,0.4,2,5,0.4,2,2,1.0,0,2,2,3,2,0,0,1,8,6,1,Isaiah Livers,DET,DET,IND,,,13,10,11,5
22023,1630587,22301217,"DEC 08, 2023",DET @ ORL,L,12,0,5,0.0,0,3,0.0,0,0,0.0,0,1,1,1,0,0,0,2,0,-11,1,Isaiah Livers,DET,ORL,DET,,,2,1,1,2
22023,1630587,22301206,"DEC 06, 2023",DET vs. MEM,L,19,2,5,0.4,1,4,0.25,0,0,0.0,0,1,1,1,0,0,0,2,5,-17,1,Isaiah Livers,DET,DET,MEM,,,7,6,6,2
22023,1630587,22300283,"DEC 02, 2023",DET vs. CLE,L,14,0,1,0.0,0,1,0.0,0,0,0.0,0,0,0,0,0,0,2,1,0,-22,1,Isaiah Livers,DET,DET,CLE,,,0,0,0,0
22023,1630587,22300268,"NOV 30, 2023",DET @ NYK,L,27,2,8,0.25,1,5,0.2,1,3,0.333,2,2,4,1,0,0,2,2,6,4,1,Isaiah Livers,DET,NYK,DET,,,11,10,7,5
22023,1630587,22300258,"NOV 29, 2023",DET vs. LAL,L,22,5,8,0.625,4,6,0.667,0,0,0.0,0,3,3,2,0,0,2,2,14,-12,1,Isaiah Livers,DET,DET,LAL,,,19,17,16,5
22023,1630587,22300253,"NOV 27, 2023",DET vs. WAS,L,23,3,11,0.273,2,8,0.25,0,0,0.0,0,1,1,3,1,0,2,1,8,-26,1,Isaiah Livers,DET,DET,WAS,,,12,9,11,4
22023,1630587,22300047,"NOV 24, 2023",DET @ IND,L,26,3,5,0.6,2,4,0.5,0,0,0.0,0,2,2,0,0,0,0,2,8,-15,1,Isaiah Livers,DET,IND,DET,,,10,10,8,2
22023,1630587,22300218,"NOV 20, 2023",DET vs. DEN,L,23,1,7,0.143,0,3,0.0,4,4,1.0,2,2,4,1,0,0,2,2,6,-7,1,Isaiah Livers,DET,DET,DEN,,,11,10,7,5
22023,1641753,22300545,"JAN 13, 2024",MIL vs. GSW,W,1,0,0,0.0,0,0,0.0,0,0,0.0,0,0,0,0,0,0,0,0,0,0,1,Chris Livingston,MIL,MIL,GSW,,,0,0,0,0
22023,1641753,22300528,"JAN 11, 2024",MIL vs. BOS,W,9,1,1,1.0,0,0,0.0,0,0,0.0,0,2,2,1,0,0,1,0,2,-2,1,Chris Livingston,MIL,MIL,BOS,,,5,4,3,3
22023,1641753,22300510,"JAN 08, 2024",MIL vs. UTA,L,15,2,5,0.4,0,0,0.0,2,2,1.0,1,1,2,0,1,0,1,1,6,0,1,Chris Livingston,MIL,MIL,UTA,,,8,8,6,2
22023,1641753,22300466,"JAN 03, 2024",MIL @ IND,L,2,0,0,0.0,0,0,0.0,0,0,0.0,0,1,1,1,0,0,0,0,0,5,1,Chris Livingston,MIL,IND,MIL,,,2,1,1,2
22023,1641753,22300417,"DEC 27, 2023",MIL @ BKN,W,1,1,1,1.0,0,0,0.0,0,0,0.0,0,1,1,1,0,0,0,0,2,6,1,Chris Livingston,MIL,BKN,MIL,,,4,3,3,2
22023,1641753,22300388,"DEC 23, 2023",MIL @ NYK,W,0,0,0,0.0,0,0,0.0,0,0,0.0,0,0,0,0,0,0,0,0,0,0,1,Chris Livingston,MIL,NYK,MIL,,,0,0,0,0
22023,1641753,22300346,"DEC 17, 2023",MIL vs. HOU,W,0,0,0,0.0,0,0,0.0,0,0,0.0,0,0,0,0,0,0,0,0,0,-3,1,Chris Livingston,MIL,MIL,HOU,,,0,0,0,0
22023,1641753,22300334,"DEC 16, 2023",MIL vs. DET,W,9,1,1,1.0,0,0,0.0,0,0,0.0,0,3,3,0,0,0,0,2,2,0,1,Chris Livingston,MIL,MIL,DET,,,5,5,2,3
22023,1641753,22301201,"DEC 05, 2023",MIL vs. NYK,W,2,0,1,0.0,0,0,0.0,0,0,0.0,1,1,2,0,1,0,1,0,0,4,1,Chris Livingston,MIL,MIL,NYK,,,2,2,0,2
22023,1641753,22300173,"NOV 11, 2023",MIL @ ORL,L,4,0,0,0.0,0,0,0.0,0,0,0.0,0,0,0,0,0,0,0,0,0,-4,1,Chris Livingston,MIL,ORL,MIL,,,0,0,0,0
22023,1641753,22300116,"NOV 01, 2023",MIL @ TOR,L,6,2,2,1.0,1,1,1.0,0,0,0.0,0,0,0,1,0,0,0,0,5,6,1,Chris Livingston,MIL,TOR,MIL,,,6,5,6,1
22023,1631254,22300459,"JAN 02, 2024",PHI vs. CHI,W,4,0,2,0.0,0,0,0.0,0,0,0.0,0,2,2,0,0,0,2,0,0,-10,1,Kenneth Lofton Jr.,PHI,PHI,CHI,,,2,2,0,2
22023,1631254,22301221,"DEC 08, 2023",MEM vs. MIN,L,4,1,3,0.333,1,2,0.5,2,2,1.0,0,0,0,2,1,0,0,0,5,0,1,Kenneth Lofton Jr.,MEM,MEM,MIN,,,7,5,7,2
22023,1631254,22301206,"DEC 06, 2023",MEM @ DET,W,0,0,0,0.0,0,0,0.0,0,0,0.0,0,1,1,0,0,0,0,0,0,0,1,Kenneth Lofton Jr.,MEM,DET,MEM,,,1,1,0,1
22023,1631254,22300277,"DEC 01, 2023",MEM @ DAL,W,2,0,2,0.0,0,0,0.0,0,0,0.0,0,2,2,0,0,0,0,0,0,-4,1,Kenneth Lofton Jr.,MEM,DAL,MEM,,,2,2,0,2
22023,1631254,22300249,"NOV 26, 2023",MEM vs. MIN,L,2,1,1,1.0,0,0,0.0,0,0,0.0,0,0,0,0,0,0,0,0,2,-3,1,Kenneth Lofton Jr.,MEM,MEM,MIN,,,2,2,2,0
22023,1631254,22300044,"NOV 24, 2023",MEM vs. PHX,L,2,1,1,1.0,0,0,0.0,0,0,0.0,0,0,0,0,0,0,0,1,2,-4,1,Kenneth Lofton Jr.,MEM,MEM,PHX,,,2,2,2,0
22023,1631254,22300231,"NOV 22, 2023",MEM @ HOU,L,4,1,4,0.25,0,1,0.0,1,1,1.0,0,0,0,2,0,1,0,0,3,3,1,Kenneth Lofton Jr.,MEM,HOU,MEM,,,5,3,5,2
22023,1631254,22300213,"NOV 19, 2023",MEM vs. BOS,L,13,2,5,0.4,0,1,0.0,2,2,1.0,0,2,2,1,0,0,2,0,6,1,1,Kenneth Lofton Jr.,MEM,MEM,BOS,,,9,8,7,3
22023,1631254,22300206,"NOV 18, 2023",MEM @ SAS,W,12,1,3,0.333,0,1,0.0,0,0,0.0,0,1,1,2,0,0,1,3,2,-6,1,Kenneth Lofton Jr.,MEM,SAS,MEM,,,5,3,4,3
22023,1631254,22300026,"NOV 14, 2023",MEM @ LAL,L,5,0,2,0.0,0,1,0.0,0,0,0.0,0,0,0,0,0,0,0,0,0,-5,1,Kenneth Lofton Jr.,MEM,LAL,MEM,,,0,0,0,0
22023,1631254,22300012,"NOV 10, 2023",MEM vs. UTA,L,12,0,2,0.0,0,1,0.0,0,0,0.0,0,2,2,0,0,1,1,3,0,11,1,Kenneth Lofton Jr.,MEM,MEM,UTA,,,2,2,0,2
22023,1631254,22300164,"NOV 08, 2023",MEM vs. MIA,L,7,1,3,0.333,0,0,0.0,0,0,0.0,0,0,0,1,0,0,0,1,2,2,1,Kenneth Lofton Jr.,MEM,MEM,MIA,,,3,2,3,1
22023,1631254,22300144,"NOV 05, 2023",MEM @ POR,W,10,2,3,0.667,1,2,0.5,0,1,0.0,0,2,2,3,0,1,0,0,5,4,1,Kenneth Lofton Jr.,MEM,POR,MEM,,,10,7,8,5
22023,1631254,22300125,"NOV 01, 2023",MEM @ UTA,L,19,4,7,0.571,1,1,1.0,3,9,0.333,2,3,5,2,2,0,1,5,12,5,1,Kenneth Lofton Jr.,MEM,UTA,MEM,,,19,17,14,7
22023,1631254,22300106,"OCT 30, 2023",MEM vs. DAL,L,1,0,0,0.0,0,0,0.0,0,0,0.0,0,0,0,0,0,0,0,0,0,0,1,Kenneth Lofton Jr.,MEM,MEM,DAL,,,0,0,0,0
22023,1631254,22300089,"OCT 28, 2023",MEM @ WAS,L,5,0,1,0.0,0,0,0.0,0,0,0.0,0,0,0,1,0,0,1,2,0,1,1,Kenneth Lofton Jr.,MEM,WAS,MEM,,,1,0,1,1
22023,1626172,22300560,"JAN 15, 2024",GSW @ MEM,L,18,4,4,1.0,0,0,0.0,0,0,0.0,1,4,5,2,1,0,1,1,8,-1,1,Kevon Looney,GSW,MEM,GSW,,,15,13,10,7
22023,1626172,22300545,"JAN 13, 2024",GSW @ MIL,L,18,3,6,0.5,0,0,0.0,0,0,0.0,4,2,6,3,0,1,0,2,6,7,1,Kevon Looney,GSW,MIL,GSW,,,15,12,9,9
22023,1626172,22300536,"JAN 12, 2024",GSW @ CHI,W,27,4,4,1.0,0,0,0.0,1,2,0.5,3,2,5,1,0,1,0,2,9,-7,1,Kevon Looney,GSW,CHI,GSW,,,15,14,10,6
22023,1626172,22300525,"JAN 10, 2024",GSW vs. NOP,L,19,3,3,1.0,0,0,0.0,1,2,0.5,2,5,7,0,0,1,0,4,7,-3,1,Kevon Looney,GSW,GSW,NOP,,,14,14,7,7
22023,1626172,22300504,"JAN 07, 2024",GSW vs. TOR,L,17,4,6,0.667,0,0,0.0,2,2,1.0,7,0,7,2,0,0,1,2,10,-7,1,Kevon Looney,GSW,GSW,TOR,,,19,17,12,9
22023,1626172,22300490,"JAN 05, 2024",GSW vs. DET,W,12,1,1,1.0,0,0,0.0,2,2,1.0,1,3,4,1,0,0,0,2,4,6,1,Kevon Looney,GSW,GSW,DET,,,9,8,5,5
22023,1626172,22300478,"JAN 04, 2024",GSW vs. DEN,L,22,3,4,0.75,0,0,0.0,1,1,1.0,2,2,4,3,0,0,0,5,7,-2,1,Kevon Looney,GSW,GSW,DEN,,,14,11,10,7
22023,1626172,22300463,"JAN 02, 2024",GSW vs. ORL,W,17,1,2,0.5,0,0,0.0,3,4,0.75,1,4,5,2,0,0,0,4,5,10,1,Kevon Looney,GSW,GSW,ORL,,,12,10,7,7
22023,1626172,22300444,"DEC 30, 2023",GSW vs. DAL,L,11,2,2,1.0,0,0,0.0,1,2,0.5,2,1,3,1,0,0,0,2,5,-7,1,Kevon Looney,GSW,GSW,DAL,,,9,8,6,4
22023,1626172,22300426,"DEC 28, 2023",GSW vs. MIA,L,14,2,2,1.0,0,0,0.0,1,3,0.333,3,2,5,0,0,1,0,3,5,-9,1,Kevon Looney,GSW,GSW,MIA,,,10,10,5,5
22023,1626172,22300402,"DEC 25, 2023",GSW @ DEN,L,22,2,3,0.667,0,0,0.0,0,0,0.0,0,3,3,2,0,0,1,3,4,-9,1,Kevon Looney,GSW,DEN,GSW,,,9,7,6,5
22023,1626172,22300399,"DEC 23, 2023",GSW vs. POR,W,22,2,3,0.667,0,0,0.0,2,2,1.0,6,5,11,7,0,0,3,2,6,15,1,Kevon Looney,GSW,GSW,POR,,,24,17,13,18
22023,1626172,22300386,"DEC 22, 2023",GSW vs. WAS,W,11,2,3,0.667,0,0,0.0,1,1,1.0,2,3,5,0,0,0,0,2,5,1,1,Kevon Looney,GSW,GSW,WAS,,,10,10,5,5
22023,1626172,22300362,"DEC 19, 2023",GSW vs. BOS,W,14,1,2,0.5,0,0,0.0,1,1,1.0,1,5,6,2,0,0,1,0,3,-19,1,Kevon Looney,GSW,GSW,BOS,,,11,9,5,8
22023,1626172,22300348,"DEC 17, 2023",GSW @ POR,W,15,2,5,0.4,0,0,0.0,0,0,0.0,1,3,4,2,1,1,0,2,4,-2,1,Kevon Looney,GSW,POR,GSW,,,10,8,6,6
22023,1626172,22300339,"DEC 16, 2023",GSW vs. BKN,W,27,2,5,0.4,0,0,0.0,0,0,0.0,1,6,7,3,1,0,0,2,4,6,1,Kevon Looney,GSW,GSW,BKN,,,14,11,7,10
22023,1626172,22300325,"DEC 14, 2023",GSW @ LAC,L,26,4,7,0.571,0,0,0.0,0,0,0.0,5,2,7,5,1,0,1,2,8,0,1,Kevon Looney,GSW,LAC,GSW,,,20,15,13,12
22023,1626172,22300308,"DEC 12, 2023",GSW @ PHX,L,11,0,0,0.0,0,0,0.0,0,0,0.0,2,3,5,2,1,0,0,2,0,-13,1,Kevon Looney,GSW,PHX,GSW,,,7,5,2,7
22023,1626172,22301222,"DEC 08, 2023",GSW @ OKC,L,16,2,2,1.0,0,0,0.0,1,3,0.333,1,3,4,2,0,0,2,1,5,3,1,Kevon Looney,GSW,OKC,GSW,,,11,9,7,6
22023,1626172,22301214,"DEC 06, 2023",GSW vs. POR,W,16,2,6,0.333,0,0,0.0,2,2,1.0,2,6,8,0,1,0,0,2,6,-7,1,Kevon Looney,GSW,GSW,POR,,,14,14,6,8
22023,1626172,22300280,"DEC 02, 2023",GSW @ LAC,L,18,3,3,1.0,0,0,0.0,1,2,0.5,0,8,8,3,0,1,1,1,7,3,1,Kevon Looney,GSW,LAC,GSW,,,18,15,10,11
22023,1626172,22300273,"NOV 30, 2023",GSW vs. LAC,W,13,0,4,0.0,0,0,0.0,2,2,1.0,2,3,5,2,0,0,0,2,2,-6,1,Kevon Looney,GSW,GSW,LAC,,,9,7,4,7
22023,1626172,22300060,"NOV 28, 2023",GSW @ SAC,L,29,0,1,0.0,0,0,0.0,2,4,0.5,1,4,5,2,1,0,0,4,2,5,1,Kevon Looney,GSW,SAC,GSW,,,9,7,4,7
22023,1626172,22300051,"NOV 24, 2023",GSW vs. SAS,W,24,2,3,0.667,0,0,0.0,2,3,0.667,1,7,8,4,2,0,2,3,6,-3,1,Kevon Looney,GSW,GSW,SAS,,,18,14,10,12
22023,1626172,22300236,"NOV 22, 2023",GSW @ PHX,L,17,3,5,0.6,0,0,0.0,0,0,0.0,1,5,6,2,1,0,2,4,6,-5,1,Kevon Looney,GSW,PHX,GSW,,,14,12,8,8
22023,1626172,22300224,"NOV 20, 2023",GSW vs. HOU,W,22,2,4,0.5,0,0,0.0,3,4,0.75,1,4,5,3,0,0,0,3,7,2,1,Kevon Looney,GSW,GSW,HOU,,,15,12,10,8
22023,1626172,22300207,"NOV 18, 2023",GSW vs. OKC,L,35,3,6,0.5,0,0,0.0,0,0,0.0,7,9,16,5,0,1,1,0,6,-1,1,Kevon Looney,GSW,GSW,OKC,,,27,22,11,21
22023,1626172,22300201,"NOV 16, 2023",GSW vs. OKC,L,19,6,9,0.667,0,0,0.0,1,2,0.5,7,4,11,1,1,0,1,3,13,-17,1,Kevon Looney,GSW,GSW,OKC,,,25,24,14,12
22023,1626172,22300025,"NOV 14, 2023",GSW vs. MIN,L,32,1,4,0.25,0,0,0.0,0,0,0.0,6,6,12,3,1,0,0,2,2,2,1,Kevon Looney,GSW,GSW,MIN,,,17,14,5,15
22023,1626172,22300186,"NOV 12, 2023",GSW vs. MIN,L,19,1,3,0.333,0,0,0.0,0,0,0.0,5,1,6,0,1,0,0,3,2,-12,1,Kevon Looney,GSW,GSW,MIN,,,8,8,2,6
22023,1626172,22300176,"NOV 11, 2023",GSW vs. CLE,L,24,1,2,0.5,0,0,0.0,0,0,0.0,3,10,13,2,0,0,1,5,2,-3,1,Kevon Looney,GSW,GSW,CLE,,,17,15,4,15
22023,1626172,22300169,"NOV 08, 2023",GSW @ DEN,L,30,4,4,1.0,0,0,0.0,2,3,0.667,2,6,8,4,1,0,2,5,10,-6,1,Kevon Looney,GSW,DEN,GSW,,,22,18,14,12
22023,1626172,22300145,"NOV 06, 2023",GSW @ DET,W,25,5,6,0.833,0,0,0.0,0,0,0.0,2,4,6,1,0,2,2,4,10,5,1,Kevon Looney,GSW,DET,GSW,,,17,16,11,7
22023,1626172,22300142,"NOV 05, 2023",GSW @ CLE,L,15,1,2,0.5,0,0,0.0,0,0,0.0,5,6,11,5,0,0,0,1,2,-6,1,Kevon Looney,GSW,CLE,GSW,,,18,13,7,16
22023,1626172,22300005,"NOV 03, 2023",GSW @ OKC,W,11,1,2,0.5,0,0,0.0,2,2,1.0,1,2,3,4,1,1,2,4,4,-5,1,Kevon Looney,GSW,OKC,GSW,,,11,7,8,7
22023,1626172,22300126,"NOV 01, 2023",GSW vs. SAC,W,23,3,4,0.75,0,0,0.0,0,0,0.0,2,7,9,6,1,0,0,2,6,0,1,Kevon Looney,GSW,GSW,SAC,,,21,15,12,15
22023,1626172,22300108,"OCT 30, 2023",GSW @ NOP,W,25,3,5,0.6,0,0,0.0,2,2,1.0,2,5,7,1,1,0,1,2,8,19,1,Kevon Looney,GSW,NOP,GSW,,,16,15,9,8
22023,1626172,22300096,"OCT 29, 2023",GSW @ HOU,W,27,2,3,0.667,0,0,0.0,1,2,0.5,2,9,11,1,1,1,1,2,5,5,1,Kevon Looney,GSW,HOU,GSW,,,17,16,6,12
22023,1626172,22300087,"OCT 27, 2023",GSW @ SAC,W,28,4,6,0.667,0,0,0.0,0,0,0.0,3,9,12,6,3,1,1,3,8,4,1,Kevon Looney,GSW,SAC,GSW,,,26,20,14,18
22023,1626172,22300062,"OCT 24, 2023",GSW vs. PHX,L,28,3,6,0.5,0,0,0.0,1,1,1.0,5,6,11,1,0,0,2,2,7,-11,1,Kevon Looney,GSW,GSW,PHX,,,19,18,8,12
22023,201572,22300552,"JAN 14, 2024",MIL vs. SAC,W,40,7,15,0.467,3,6,0.5,0,0,0.0,1,8,9,3,0,3,0,2,17,5,1,Brook Lopez,MIL,MIL,SAC,,,29,26,20,12
22023,201572,22300545,"JAN 13, 2024",MIL vs. GSW,W,34,5,9,0.556,1,5,0.2,0,0,0.0,2,6,8,6,0,2,1,1,11,7,1,Brook Lopez,MIL,MIL,GSW,,,25,19,17,14
22023,201572,22300528,"JAN 11, 2024",MIL vs. BOS,W,28,6,8,0.75,2,4,0.5,1,2,0.5,1,4,5,3,0,2,1,3,15,20,1,Brook Lopez,MIL,MIL,BOS,,,23,20,18,8
22023,201572,22300510,"JAN 08, 2024",MIL vs. UTA,L,38,5,11,0.455,3,6,0.5,0,0,0.0,1,5,6,3,0,2,0,2,13,-9,1,Brook Lopez,MIL,MIL,UTA,,,22,19,16,9
22023,201572,22300496,"JAN 06, 2024",MIL @ HOU,L,31,3,9,0.333,1,6,0.167,0,0,0.0,0,5,5,0,1,1,0,2,7,11,1,Brook Lopez,MIL,HOU,MIL,,,12,12,7,5
22023,201572,22300477,"JAN 04, 2024",MIL @ SAS,W,33,4,10,0.4,1,5,0.2,0,0,0.0,0,4,4,1,0,3,4,4,9,8,1,Brook Lopez,MIL,SAS,MIL,,,14,13,10,5
22023,201572,22300466,"JAN 03, 2024",MIL @ IND,L,28,6,11,0.545,2,4,0.5,2,3,0.667,3,2,5,1,0,0,2,3,16,-22,1,Brook Lopez,MIL,IND,MIL,,,22,21,17,6
22023,201572,22300454,"JAN 01, 2024",MIL vs. IND,L,38,8,17,0.471,2,6,0.333,3,4,0.75,1,4,5,1,0,4,0,3,21,6,1,Brook Lopez,MIL,MIL,IND,,,27,26,22,6
22023,201572,22300433,"DEC 29, 2023",MIL @ CLE,W,36,4,10,0.4,1,3,0.333,0,0,0.0,3,7,10,2,0,6,0,3,9,9,1,Brook Lopez,MIL,CLE,MIL,,,21,19,11,12
22023,201572,22300417,"DEC 27, 2023",MIL @ BKN,W,25,1,7,0.143,0,6,0.0,0,0,0.0,2,4,6,2,0,3,0,3,2,-3,1,Brook Lopez,MIL,BKN,MIL,,,10,8,4,8
22023,201572,22300401,"DEC 25, 2023",MIL @ NYK,L,27,5,9,0.556,2,6,0.333,2,2,1.0,2,4,6,1,1,2,0,2,14,-6,1,Brook Lopez,MIL,NYK,MIL,,,21,20,15,7
22023,201572,22300388,"DEC 23, 2023",MIL @ NYK,W,35,1,7,0.143,0,2,0.0,3,4,0.75,1,2,3,1,0,1,0,3,5,15,1,Brook Lopez,MIL,NYK,MIL,,,9,8,6,4
22023,201572,22300378,"DEC 21, 2023",MIL vs. ORL,W,37,5,7,0.714,2,4,0.5,2,2,1.0,0,7,7,0,2,2,2,5,14,17,1,Brook Lopez,MIL,MIL,ORL,,,21,21,14,7
22023,201572,22300361,"DEC 19, 2023",MIL vs. SAS,W,32,6,14,0.429,0,5,0.0,2,2,1.0,5,0,5,1,0,6,0,3,14,13,1,Brook Lopez,MIL,MIL,SAS,,,20,19,15,6
22023,201572,22300346,"DEC 17, 2023",MIL vs. HOU,W,31,6,13,0.462,3,8,0.375,3,3,1.0,1,5,6,0,0,1,0,2,18,6,1,Brook Lopez,MIL,MIL,HOU,,,24,24,18,6
22023,201572,22300334,"DEC 16, 2023",MIL vs. DET,W,26,2,3,0.667,1,2,0.5,0,0,0.0,0,1,1,1,0,5,2,3,5,23,1,Brook Lopez,MIL,MIL,DET,,,7,6,6,2
22023,201572,22300315,"DEC 13, 2023",MIL vs. IND,W,33,1,6,0.167,0,2,0.0,4,4,1.0,2,1,3,1,0,6,1,5,6,1,1,Brook Lopez,MIL,MIL,IND,,,10,9,7,4
22023,201572,22300300,"DEC 11, 2023",MIL vs. CHI,W,40,6,11,0.545,2,6,0.333,5,6,0.833,2,1,3,3,1,3,1,4,19,-1,1,Brook Lopez,MIL,MIL,CHI,,,25,22,22,6
22023,201572,22301229,"DEC 07, 2023",MIL vs. IND,L,37,7,17,0.412,3,10,0.3,1,3,0.333,2,4,6,2,0,4,1,5,18,-3,1,Brook Lopez,MIL,MIL,IND,,,26,24,20,8
22023,201572,22301201,"DEC 05, 2023",MIL vs. NYK,W,34,4,8,0.5,1,4,0.25,0,0,0.0,2,6,8,3,3,3,0,4,9,28,1,Brook Lopez,MIL,MIL,NYK,,,20,17,12,11
22023,201572,22300286,"DEC 02, 2023",MIL vs. ATL,W,33,3,7,0.429,1,4,0.25,4,6,0.667,1,1,2,4,0,4,2,2,11,2,1,Brook Lopez,MIL,MIL,ATL,,,17,13,15,6
22023,201572,22300269,"NOV 30, 2023",MIL @ CHI,L,39,7,12,0.583,6,10,0.6,0,0,0.0,0,4,4,0,0,0,1,5,20,2,1,Brook Lopez,MIL,CHI,MIL,,,24,24,20,4
22023,201572,22300056,"NOV 28, 2023",MIL @ MIA,W,32,5,10,0.5,0,4,0.0,2,2,1.0,1,3,4,4,0,1,2,4,12,9,1,Brook Lopez,MIL,MIA,MIL,,,20,16,16,8
22023,201572,22300245,"NOV 26, 2023",MIL vs. POR,W,31,4,11,0.364,2,6,0.333,0,0,0.0,1,5,6,3,3,4,0,3,10,3,1,Brook Lopez,MIL,MIL,POR,,,19,16,13,9
22023,201572,22300049,"NOV 24, 2023",MIL vs. WAS,W,32,14,17,0.824,4,7,0.571,7,7,1.0,0,6,6,1,2,3,1,2,39,8,1,Brook Lopez,MIL,MIL,WAS,,,46,45,40,7
22023,201572,22300228,"NOV 22, 2023",MIL @ BOS,L,34,12,18,0.667,2,5,0.4,2,3,0.667,5,2,7,1,1,1,0,3,28,7,1,Brook Lopez,MIL,BOS,MIL,,,36,35,29,8
22023,201572,22300219,"NOV 20, 2023",MIL @ WAS,W,32,7,12,0.583,1,4,0.25,1,1,1.0,4,5,9,1,0,5,1,0,16,13,1,Brook Lopez,MIL,WAS,MIL,,,26,25,17,10
22023,201572,22300205,"NOV 18, 2023",MIL vs. DAL,W,34,3,8,0.375,1,6,0.167,5,5,1.0,0,3,3,0,1,2,0,1,12,8,1,Brook Lopez,MIL,MIL,DAL,,,15,15,12,3
22023,201572,22300027,"NOV 17, 2023",MIL @ CHA,W,33,7,8,0.875,1,2,0.5,0,0,0.0,2,5,7,2,0,6,1,3,15,30,1,Brook Lopez,MIL,CHA,MIL,,,24,22,17,9
22023,201572,22300195,"NOV 15, 2023",MIL @ TOR,W,33,4,10,0.4,1,3,0.333,1,1,1.0,2,6,8,4,1,7,0,2,10,26,1,Brook Lopez,MIL,TOR,MIL,,,22,18,14,12
22023,201572,22300190,"NOV 13, 2023",MIL vs. CHI,W,29,4,8,0.5,2,6,0.333,1,3,0.333,0,5,5,0,0,3,2,3,11,-10,1,Brook Lopez,MIL,MIL,CHI,,,16,16,11,5
22023,201572,22300173,"NOV 11, 2023",MIL @ ORL,L,21,3,7,0.429,2,5,0.4,1,2,0.5,0,3,3,1,1,2,1,1,9,-7,1,Brook Lopez,MIL,ORL,MIL,,,13,12,10,4
22023,201572,22300171,"NOV 09, 2023",MIL @ IND,L,29,1,7,0.143,0,4,0.0,0,0,0.0,0,1,1,0,2,3,0,2,2,-15,1,Brook Lopez,MIL,IND,MIL,,,3,3,2,1
22023,201572,22300165,"NOV 08, 2023",MIL vs. DET,W,26,5,8,0.625,4,6,0.667,0,0,0.0,0,6,6,0,0,4,3,4,14,4,1,Brook Lopez,MIL,MIL,DET,,,20,20,14,6
22023,201572,22300149,"NOV 06, 2023",MIL @ BKN,W,27,2,6,0.333,0,3,0.0,0,0,0.0,4,3,7,2,0,0,0,3,4,-15,1,Brook Lopez,MIL,BKN,MIL,,,13,11,6,9
22023,201572,22300002,"NOV 03, 2023",MIL vs. NYK,W,36,4,15,0.267,4,10,0.4,1,2,0.5,0,5,5,0,1,9,1,2,13,1,1,Brook Lopez,MIL,MIL,NYK,,,18,18,13,5
22023,201572,22300116,"NOV 01, 2023",MIL @ TOR,L,17,1,8,0.125,0,4,0.0,4,4,1.0,2,1,3,0,2,1,0,0,6,-22,1,Brook Lopez,MIL,TOR,MIL,,,9,9,6,3
22023,201572,22300107,"OCT 30, 2023",MIL vs. MIA,W,29,5,9,0.556,1,4,0.25,0,0,0.0,3,4,7,3,1,1,2,3,11,-10,1,Brook Lopez,MIL,MIL,MIA,,,21,18,14,10
22023,201572,22300097,"OCT 29, 2023",MIL vs. ATL,L,20,5,11,0.455,2,5,0.4,1,1,1.0,1,2,3,1,1,0,0,0,13,-22,1,Brook Lopez,MIL,MIL,ATL,,,17,16,14,4
22023,201572,22300075,"OCT 26, 2023",MIL vs. PHI,W,29,5,7,0.714,3,4,0.75,0,0,0.0,1,1,2,0,0,0,2,4,13,11,1,Brook Lopez,MIL,MIL,PHI,,,15,15,13,2
22023,201577,22300510,"JAN 08, 2024",MIL vs. UTA,L,1,0,0,0.0,0,0,0.0,0,0,0.0,0,0,0,0,0,0,0,0,0,0,1,Robin Lopez,MIL,MIL,UTA,,,0,0,0,0
22023,201577,22300466,"JAN 03, 2024",MIL @ IND,L,2,0,0,0.0,0,0,0.0,0,0,0.0,0,1,1,0,0,0,0,0,0,5,1,Robin Lopez,MIL,IND,MIL,,,1,1,0,1
22023,201577,22300417,"DEC 27, 2023",MIL @ BKN,W,1,1,1,1.0,1,1,1.0,0,0,0.0,0,0,0,0,0,0,0,0,3,6,1,Robin Lopez,MIL,BKN,MIL,,,3,3,3,0
22023,201577,22300361,"DEC 19, 2023",MIL vs. SAS,W,2,1,1,1.0,1,1,1.0,0,0,0.0,0,1,1,0,0,0,0,0,3,-2,1,Robin Lopez,MIL,MIL,SAS,,,4,4,3,1
22023,201577,22300334,"DEC 16, 2023",MIL vs. DET,W,6,0,2,0.0,0,1,0.0,0,0,0.0,0,0,0,1,0,1,0,0,0,0,1,Robin Lopez,MIL,MIL,DET,,,1,0,1,1
22023,201577,22300315,"DEC 13, 2023",MIL vs. IND,W,1,0,0,0.0,0,0,0.0,0,0,0.0,0,0,0,0,0,0,0,1,0,-9,1,Robin Lopez,MIL,MIL,IND,,,0,0,0,0
22023,201577,22301201,"DEC 05, 2023",MIL vs. NYK,W,2,0,1,0.0,0,1,0.0,0,0,0.0,0,0,0,0,0,0,0,0,0,4,1,Robin Lopez,MIL,MIL,NYK,,,0,0,0,0
22023,201577,22300219,"NOV 20, 2023",MIL @ WAS,W,1,0,0,0.0,0,0,0.0,0,0,0.0,0,0,0,0,0,0,0,2,0,-5,1,Robin Lopez,MIL,WAS,MIL,,,0,0,0,0
22023,201577,22300195,"NOV 15, 2023",MIL @ TOR,W,2,0,0,0.0,0,0,0.0,0,0,0.0,0,0,0,0,0,0,0,0,0,-7,1,Robin Lopez,MIL,TOR,MIL,,,0,0,0,0
22023,201577,22300097,"OCT 29, 2023",MIL vs. ATL,L,6,0,0,0.0,0,0,0.0,2,2,1.0,0,0,0,1,0,0,1,0,2,10,1,Robin Lopez,MIL,MIL,ATL,,,3,2,3,1
22023,201567,22300535,"JAN 12, 2024",MIA vs. ORL,W,16,2,6,0.333,1,4,0.25,0,1,0.0,1,2,3,1,1,0,1,3,5,-3,1,Kevin Love,MIA,MIA,ORL,,,9,8,6,4
22023,201567,22300522,"JAN 10, 2024",MIA vs. OKC,L,20,3,6,0.5,0,2,0.0,6,6,1.0,1,4,5,2,0,0,1,0,12,-14,1,Kevin Love,MIA,MIA,OKC,,,19,17,14,7
22023,201567,22300509,"JAN 08, 2024",MIA vs. HOU,W,23,4,7,0.571,1,3,0.333,6,7,0.857,3,4,7,4,1,0,1,2,15,5,1,Kevin Love,MIA,MIA,HOU,,,26,22,19,11
22023,201567,22300489,"JAN 05, 2024",MIA @ PHX,L,20,6,9,0.667,3,6,0.5,5,6,0.833,3,4,7,2,0,0,2,4,20,-3,1,Kevin Love,MIA,PHX,MIA,,,29,27,22,9
22023,201567,22300475,"JAN 03, 2024",MIA @ LAL,W,28,4,7,0.571,0,1,0.0,2,6,0.333,3,11,14,3,1,1,0,3,10,11,1,Kevin Love,MIA,LAL,MIA,,,27,24,13,17
22023,201567,22300458,"JAN 01, 2024",MIA @ LAC,L,23,7,11,0.636,1,5,0.2,2,2,1.0,2,2,4,3,0,2,1,2,17,5,1,Kevin Love,MIA,LAC,MIA,,,24,21,20,7
22023,201567,22300439,"DEC 30, 2023",MIA @ UTA,L,20,4,11,0.364,2,8,0.25,2,4,0.5,2,4,6,2,0,0,1,1,12,-7,1,Kevin Love,MIA,UTA,MIA,,,20,18,14,8
22023,201567,22300426,"DEC 28, 2023",MIA @ GSW,W,13,2,5,0.4,1,3,0.333,3,3,1.0,0,7,7,4,0,0,1,1,8,2,1,Kevin Love,MIA,GSW,MIA,,,19,15,12,11
22023,201567,22300404,"DEC 25, 2023",MIA vs. PHI,W,16,2,3,0.667,1,2,0.5,3,4,0.75,1,9,10,5,0,0,1,0,8,8,1,Kevin Love,MIA,MIA,PHI,,,23,18,13,15
22023,201567,22300384,"DEC 22, 2023",MIA vs. ATL,W,10,1,4,0.25,1,4,0.25,3,4,0.75,0,0,0,1,0,0,0,3,6,-1,1,Kevin Love,MIA,MIA,ATL,,,7,6,7,1
22023,201567,22300353,"DEC 18, 2023",MIA vs. MIN,L,24,3,7,0.429,3,7,0.429,0,0,0.0,0,10,10,4,1,0,0,2,9,1,1,Kevin Love,MIA,MIA,MIN,,,23,19,13,14
22023,201567,22300337,"DEC 16, 2023",MIA vs. CHI,W,26,8,12,0.667,6,10,0.6,0,0,0.0,1,6,7,1,1,0,1,2,22,19,1,Kevin Love,MIA,MIA,CHI,,,30,29,23,8
22023,201567,22300320,"DEC 14, 2023",MIA vs. CHI,L,22,5,12,0.417,3,8,0.375,3,4,0.75,1,8,9,4,1,0,2,1,16,5,1,Kevin Love,MIA,MIA,CHI,,,29,25,20,13
22023,201567,22300312,"DEC 13, 2023",MIA vs. CHA,W,20,1,9,0.111,0,6,0.0,1,2,0.5,0,8,8,1,2,1,2,1,3,10,1,Kevin Love,MIA,MIA,CHA,,,12,11,4,9
22023,201567,22300292,"DEC 11, 2023",MIA @ CHA,W,21,7,11,0.636,4,8,0.5,1,1,1.0,1,5,6,1,1,0,0,1,19,8,1,Kevin Love,MIA,CHA,MIA,,,26,25,20,7
22023,201567,22301220,"DEC 08, 2023",MIA vs. CLE,L,28,5,9,0.556,4,8,0.5,0,0,0.0,0,12,12,3,1,1,1,3,14,6,1,Kevin Love,MIA,MIA,CLE,,,29,26,17,15
22023,201567,22301207,"DEC 06, 2023",MIA @ TOR,W,15,2,5,0.4,1,4,0.25,3,3,1.0,1,1,2,4,0,0,0,2,8,-18,1,Kevin Love,MIA,TOR,MIA,,,14,10,12,6
22023,201567,22300284,"DEC 02, 2023",MIA vs. IND,L,19,4,6,0.667,3,5,0.6,3,3,1.0,0,1,1,5,0,0,0,4,14,-9,1,Kevin Love,MIA,MIA,IND,,,20,15,19,6
22023,201567,22300267,"NOV 30, 2023",MIA vs. IND,W,17,1,1,1.0,0,0,0.0,3,4,0.75,1,7,8,6,1,0,0,2,5,10,1,Kevin Love,MIA,MIA,IND,,,19,13,11,14
22023,201567,22300056,"NOV 28, 2023",MIA vs. MIL,L,26,2,11,0.182,2,5,0.4,0,0,0.0,4,6,10,4,0,0,0,2,6,-4,1,Kevin Love,MIA,MIA,MIL,,,20,16,10,14
22023,201567,22300240,"NOV 25, 2023",MIA @ BKN,L,17,3,4,0.75,0,0,0.0,2,2,1.0,3,7,10,2,0,0,1,2,8,9,1,Kevin Love,MIA,BKN,MIA,,,20,18,10,12
22023,201567,22300045,"NOV 24, 2023",MIA @ NYK,L,18,2,7,0.286,1,6,0.167,2,2,1.0,1,5,6,1,0,0,2,1,7,-1,1,Kevin Love,MIA,NYK,MIA,,,14,13,8,7
22023,201567,22300220,"NOV 20, 2023",MIA @ CHI,W,15,4,6,0.667,3,5,0.6,0,0,0.0,0,8,8,1,0,0,1,2,11,17,1,Kevin Love,MIA,CHI,MIA,,,20,19,12,9
22023,201567,22300204,"NOV 18, 2023",MIA @ CHI,L,12,2,7,0.286,1,6,0.167,0,2,0.0,1,5,6,2,0,0,0,2,5,-4,1,Kevin Love,MIA,CHI,MIA,,,13,11,7,8
22023,201567,22300200,"NOV 16, 2023",MIA vs. BKN,W,16,2,4,0.5,1,3,0.333,2,2,1.0,1,8,9,4,0,0,0,2,7,16,1,Kevin Love,MIA,MIA,BKN,,,20,16,11,13
22023,201567,22300017,"NOV 14, 2023",MIA @ CHA,W,14,0,5,0.0,0,5,0.0,3,4,0.75,0,3,3,1,0,0,0,1,3,2,1,Kevin Love,MIA,CHA,MIA,,,7,6,4,4
22023,201567,22300184,"NOV 12, 2023",MIA @ SAS,W,14,3,8,0.375,2,7,0.286,4,4,1.0,0,2,2,0,0,0,0,2,12,-6,1,Kevin Love,MIA,SAS,MIA,,,14,14,12,2
22023,201567,22300175,"NOV 11, 2023",MIA @ ATL,W,14,2,4,0.5,1,3,0.333,2,2,1.0,0,4,4,2,0,0,1,0,7,10,1,Kevin Love,MIA,ATL,MIA,,,13,11,9,6
22023,201567,22300107,"OCT 30, 2023",MIA @ MIL,L,18,1,6,0.167,1,5,0.2,0,0,0.0,0,5,5,3,0,0,2,1,3,-10,1,Kevin Love,MIA,MIL,MIA,,,11,8,6,8
22023,201567,22300080,"OCT 27, 2023",MIA @ BOS,L,21,3,7,0.429,2,4,0.5,1,2,0.5,2,7,9,2,1,0,0,1,9,13,1,Kevin Love,MIA,BOS,MIA,,,20,18,11,11
22023,201567,22300068,"OCT 25, 2023",MIA vs. DET,W,28,4,9,0.444,3,6,0.5,2,2,1.0,2,8,10,2,0,0,1,5,13,5,1,Kevin Love,MIA,MIA,DET,,,25,23,15,12
22023,200768,22300562,"JAN 15, 2024",MIA @ BKN,W,24,1,5,0.2,0,2,0.0,0,0,0.0,0,4,4,5,1,0,1,3,2,14,1,Kyle Lowry,MIA,BKN,MIA,,,11,6,7,9
22023,200768,22300551,"JAN 14, 2024",MIA vs. CHA,W,26,0,3,0.0,0,1,0.0,0,0,0.0,0,4,4,3,0,1,2,1,0,7,1,Kyle Lowry,MIA,MIA,CHA,,,7,4,3,7
22023,200768,22300509,"JAN 08, 2024",MIA vs. HOU,W,16,2,3,0.667,1,1,1.0,1,2,0.5,1,2,3,1,0,2,1,1,6,5,1,Kyle Lowry,MIA,MIA,HOU,,,10,9,7,4
22023,200768,22300489,"JAN 05, 2024",MIA @ PHX,L,23,2,7,0.286,2,6,0.333,0,0,0.0,1,2,3,4,0,0,4,2,6,-18,1,Kyle Lowry,MIA,PHX,MIA,,,13,9,10,7
22023,200768,22300475,"JAN 03, 2024",MIA @ LAL,W,26,3,6,0.5,2,5,0.4,2,2,1.0,0,3,3,6,4,0,1,2,10,6,1,Kyle Lowry,MIA,LAL,MIA,,,19,13,16,9
22023,200768,22300458,"JAN 01, 2024",MIA @ LAC,L,24,3,5,0.6,0,1,0.0,2,2,1.0,1,0,1,3,0,0,3,3,8,-19,1,Kyle Lowry,MIA,LAC,MIA,,,12,9,11,4
22023,200768,22300404,"DEC 25, 2023",MIA vs. PHI,W,33,5,7,0.714,1,3,0.333,1,1,1.0,0,1,1,4,1,2,3,4,12,0,1,Kyle Lowry,MIA,MIA,PHI,,,17,13,16,5
22023,200768,22300384,"DEC 22, 2023",MIA vs. ATL,W,22,1,2,0.5,1,2,0.5,0,0,0.0,0,4,4,3,0,0,2,2,3,9,1,Kyle Lowry,MIA,MIA,ATL,,,10,7,6,7
22023,200768,22300366,"DEC 20, 2023",MIA @ ORL,W,18,1,2,0.5,1,2,0.5,0,0,0.0,0,0,0,2,0,0,0,1,3,2,1,Kyle Lowry,MIA,ORL,MIA,,,5,3,5,2
22023,200768,22300337,"DEC 16, 2023",MIA vs. CHI,W,32,3,7,0.429,1,3,0.333,3,4,0.75,0,3,3,7,0,1,0,2,10,8,1,Kyle Lowry,MIA,MIA,CHI,,,20,13,17,10
22023,200768,22300320,"DEC 14, 2023",MIA vs. CHI,L,39,6,12,0.5,4,9,0.444,1,1,1.0,1,2,3,3,1,0,1,5,17,-14,1,Kyle Lowry,MIA,MIA,CHI,,,23,20,20,6
22023,200768,22300312,"DEC 13, 2023",MIA vs. CHA,W,24,5,5,1.0,4,4,1.0,3,3,1.0,0,2,2,1,2,0,2,2,17,14,1,Kyle Lowry,MIA,MIA,CHA,,,20,19,18,3
22023,200768,22300292,"DEC 11, 2023",MIA @ CHA,W,35,1,6,0.167,1,4,0.25,0,2,0.0,1,4,5,5,2,0,1,3,3,6,1,Kyle Lowry,MIA,CHA,MIA,,,13,8,8,10
22023,200768,22301220,"DEC 08, 2023",MIA vs. CLE,L,32,6,13,0.462,3,9,0.333,2,3,0.667,0,2,2,5,2,0,3,1,17,-8,1,Kyle Lowry,MIA,MIA,CLE,,,24,19,22,7
22023,200768,22301207,"DEC 06, 2023",MIA @ TOR,W,28,1,4,0.25,1,4,0.25,0,0,0.0,0,4,4,3,0,2,2,2,3,7,1,Kyle Lowry,MIA,TOR,MIA,,,10,7,6,7
22023,200768,22300284,"DEC 02, 2023",MIA vs. IND,L,29,0,4,0.0,0,3,0.0,4,4,1.0,1,7,8,2,0,0,0,2,4,-9,1,Kyle Lowry,MIA,MIA,IND,,,14,12,6,10
22023,200768,22300267,"NOV 30, 2023",MIA vs. IND,W,25,6,10,0.6,3,6,0.5,0,0,0.0,1,2,3,3,0,1,0,5,15,-11,1,Kyle Lowry,MIA,MIA,IND,,,21,18,18,6
22023,200768,22300056,"NOV 28, 2023",MIA vs. MIL,L,34,7,10,0.7,3,5,0.6,4,4,1.0,0,4,4,6,1,1,1,5,21,-4,1,Kyle Lowry,MIA,MIA,MIL,,,31,25,27,10
22023,200768,22300240,"NOV 25, 2023",MIA @ BKN,L,30,3,10,0.3,2,7,0.286,1,2,0.5,1,2,3,4,2,0,3,2,9,-19,1,Kyle Lowry,MIA,BKN,MIA,,,16,12,13,7
22023,200768,22300045,"NOV 24, 2023",MIA @ NYK,L,33,4,9,0.444,2,5,0.4,0,0,0.0,3,5,8,2,2,0,1,3,10,3,1,Kyle Lowry,MIA,NYK,MIA,,,20,18,12,10
22023,200768,22300229,"NOV 22, 2023",MIA @ CLE,W,29,9,15,0.6,7,10,0.7,3,4,0.75,0,1,1,3,0,0,0,3,28,21,1,Kyle Lowry,MIA,CLE,MIA,,,32,29,31,4
22023,200768,22300220,"NOV 20, 2023",MIA @ CHI,W,27,3,6,0.5,2,4,0.5,0,0,0.0,1,4,5,6,0,0,1,1,8,15,1,Kyle Lowry,MIA,CHI,MIA,,,19,13,14,11
22023,200768,22300204,"NOV 18, 2023",MIA @ CHI,L,32,3,10,0.3,2,7,0.286,0,0,0.0,0,3,3,5,3,0,1,3,8,14,1,Kyle Lowry,MIA,CHI,MIA,,,16,11,13,8
22023,200768,22300200,"NOV 16, 2023",MIA vs. BKN,W,24,1,4,0.25,1,1,1.0,0,0,0.0,1,2,3,3,3,0,0,3,3,7,1,Kyle Lowry,MIA,MIA,BKN,,,9,6,6,6
22023,200768,22300017,"NOV 14, 2023",MIA @ CHA,W,15,0,1,0.0,0,1,0.0,0,0,0.0,0,1,1,2,0,0,0,4,0,-5,1,Kyle Lowry,MIA,CHA,MIA,,,3,1,2,3
22023,200768,22300175,"NOV 11, 2023",MIA @ ATL,W,33,4,8,0.5,4,6,0.667,5,5,1.0,0,2,2,4,1,0,3,1,17,10,1,Kyle Lowry,MIA,ATL,MIA,,,23,19,21,6
22023,200768,22300164,"NOV 08, 2023",MIA @ MEM,W,35,5,11,0.455,4,7,0.571,3,3,1.0,3,8,11,9,1,0,4,4,17,20,1,Kyle Lowry,MIA,MEM,MIA,,,37,28,26,20
22023,200768,22300150,"NOV 06, 2023",MIA vs. LAL,W,33,2,6,0.333,1,5,0.2,0,0,0.0,2,2,4,5,1,0,0,2,5,2,1,Kyle Lowry,MIA,MIA,LAL,,,14,9,10,9
22023,200768,22300003,"NOV 03, 2023",MIA vs. WAS,W,26,1,4,0.25,1,4,0.25,0,0,0.0,2,1,3,7,2,0,2,1,3,2,1,Kyle Lowry,MIA,MIA,WAS,,,13,6,10,10
22023,200768,22300119,"NOV 01, 2023",MIA vs. BKN,L,30,2,5,0.4,2,5,0.4,0,0,0.0,0,3,3,3,2,1,2,3,6,7,1,Kyle Lowry,MIA,MIA,BKN,,,12,9,9,6
22023,200768,22300107,"OCT 30, 2023",MIA @ MIL,L,28,3,6,0.5,2,5,0.4,0,0,0.0,0,4,4,4,2,0,2,4,8,-11,1,Kyle Lowry,MIA,MIL,MIA,,,16,12,12,8
22023,200768,22300093,"OCT 28, 2023",MIA @ MIN,L,32,1,6,0.167,1,5,0.2,0,0,0.0,1,3,4,7,1,0,4,1,3,-20,1,Kyle Lowry,MIA,MIN,MIA,,,14,7,10,11
22023,200768,22300080,"OCT 27, 2023",MIA @ BOS,L,32,5,7,0.714,3,4,0.75,0,0,0.0,1,7,8,5,0,1,1,3,13,-1,1,Kyle Lowry,MIA,BOS,MIA,,,26,21,18,13
22023,200768,22300068,"OCT 25, 2023",MIA vs. DET,W,32,0,1,0.0,0,0,0.0,0,0,0.0,0,2,2,2,2,1,0,4,0,4,1,Kyle Lowry,MIA,MIA,DET,,,4,2,2,4
22023,1641754,22300543,"JAN 13, 2024",ATL vs. WAS,L,5,0,1,0.0,0,0,0.0,1,2,0.5,0,2,2,0,0,0,0,1,1,1,1,Seth Lundy,ATL,ATL,WAS,,,3,3,1,2
22023,1641754,22300533,"JAN 12, 2024",ATL vs. IND,L,4,0,1,0.0,0,1,0.0,2,2,1.0,0,0,0,0,0,0,0,0,2,2,1,Seth Lundy,ATL,ATL,IND,,,2,2,2,0
22023,1641754,22300480,"JAN 05, 2024",ATL @ IND,L,7,1,2,0.5,1,2,0.5,0,0,0.0,0,0,0,0,0,0,0,0,3,-2,1,Seth Lundy,ATL,IND,ATL,,,3,3,3,0
22023,1641754,22300408,"DEC 26, 2023",ATL @ CHI,L,1,0,1,0.0,0,1,0.0,0,0,0.0,0,0,0,0,0,0,1,0,0,-4,1,Seth Lundy,ATL,CHI,ATL,,,0,0,0,0
22023,1641754,22300393,"DEC 23, 2023",ATL vs. MEM,L,19,1,7,0.143,1,6,0.167,0,0,0.0,1,1,2,0,0,0,0,2,3,-9,1,Seth Lundy,ATL,ATL,MEM,,,5,5,3,2
22023,1641754,22300352,"DEC 18, 2023",ATL vs. DET,W,9,0,1,0.0,0,1,0.0,0,0,0.0,0,1,1,0,0,0,0,2,0,1,1,Seth Lundy,ATL,ATL,DET,,,1,1,0,1
22023,1641754,22300330,"DEC 15, 2023",ATL @ TOR,W,1,1,1,1.0,0,0,0.0,0,0,0.0,0,0,0,0,0,0,0,1,2,-3,1,Seth Lundy,ATL,TOR,ATL,,,2,2,2,0
22023,1626168,22300552,"JAN 14, 2024",SAC @ MIL,L,33,3,8,0.375,3,7,0.429,0,0,0.0,1,6,7,2,0,0,0,3,9,10,1,Trey Lyles,SAC,MIL,SAC,,,18,16,11,9
22023,1626168,22300532,"JAN 12, 2024",SAC @ PHI,L,22,2,8,0.25,1,5,0.2,0,0,0.0,2,1,3,0,0,0,0,1,5,-6,1,Trey Lyles,SAC,PHI,SAC,,,8,8,5,3
22023,1626168,22300518,"JAN 10, 2024",SAC @ CHA,W,21,2,4,0.5,2,4,0.5,2,4,0.5,1,4,5,2,0,0,1,1,8,27,1,Trey Lyles,SAC,CHA,SAC,,,15,13,10,7
22023,1626168,22300512,"JAN 09, 2024",SAC @ DET,W,32,1,4,0.25,1,3,0.333,3,4,0.75,1,7,8,3,0,0,1,2,6,31,1,Trey Lyles,SAC,DET,SAC,,,17,14,9,11
22023,1626168,22300492,"JAN 05, 2024",SAC vs. TOR,W,15,4,6,0.667,4,5,0.8,0,0,0.0,0,3,3,1,0,0,0,2,12,1,1,Trey Lyles,SAC,SAC,TOR,,,16,15,13,4
22023,1626168,22300476,"JAN 03, 2024",SAC vs. ORL,W,22,4,6,0.667,2,3,0.667,0,0,0.0,3,0,3,0,0,1,0,3,10,-1,1,Trey Lyles,SAC,SAC,ORL,,,13,13,10,3
22023,1626168,22300464,"JAN 02, 2024",SAC vs. CHA,L,17,3,6,0.5,3,5,0.6,0,0,0.0,0,3,3,1,0,0,0,0,9,-2,1,Trey Lyles,SAC,SAC,CHA,,,13,12,10,4
22023,1626168,22300449,"DEC 31, 2023",SAC @ MEM,W,19,4,4,1.0,3,3,1.0,1,1,1.0,0,3,3,0,1,0,1,1,12,17,1,Trey Lyles,SAC,MEM,SAC,,,15,15,12,3
22023,1626168,22300431,"DEC 29, 2023",SAC @ ATL,W,25,7,12,0.583,4,9,0.444,1,1,1.0,0,6,6,1,0,0,2,3,19,4,1,Trey Lyles,SAC,ATL,SAC,,,26,25,20,7
22023,1626168,22300413,"DEC 26, 2023",SAC @ POR,L,14,0,0,0.0,0,0,0.0,0,0,0.0,0,2,2,2,0,2,0,1,0,-9,1,Trey Lyles,SAC,POR,SAC,,,4,2,2,4
22023,1626168,22300400,"DEC 23, 2023",SAC vs. MIN,L,27,4,8,0.5,1,4,0.25,1,3,0.333,3,4,7,3,0,0,1,1,10,7,1,Trey Lyles,SAC,SAC,MIN,,,20,17,13,10
22023,1626168,22300387,"DEC 22, 2023",SAC vs. PHX,W,11,0,1,0.0,0,0,0.0,0,0,0.0,1,3,4,0,0,0,1,1,0,4,1,Trey Lyles,SAC,SAC,PHX,,,4,4,0,4
22023,1626168,22300373,"DEC 20, 2023",SAC vs. BOS,L,27,4,7,0.571,3,6,0.5,0,0,0.0,1,4,5,3,0,1,0,1,11,-19,1,Trey Lyles,SAC,SAC,BOS,,,19,16,14,8
22023,1626168,22300358,"DEC 18, 2023",SAC vs. WAS,W,18,0,3,0.0,0,3,0.0,0,0,0.0,0,2,2,0,0,0,0,0,0,-4,1,Trey Lyles,SAC,SAC,WAS,,,2,2,0,2
22023,1626168,22300342,"DEC 16, 2023",SAC vs. UTA,W,18,0,2,0.0,0,2,0.0,0,0,0.0,1,7,8,0,0,1,2,4,0,1,1,Trey Lyles,SAC,SAC,UTA,,,8,8,0,8
22023,1626168,22300324,"DEC 14, 2023",SAC vs. OKC,W,19,2,5,0.4,1,4,0.25,0,0,0.0,1,6,7,1,0,1,0,2,5,22,1,Trey Lyles,SAC,SAC,OKC,,,13,12,6,8
22023,1626168,22300309,"DEC 12, 2023",SAC @ LAC,L,20,1,4,0.25,0,3,0.0,1,2,0.5,1,5,6,3,1,0,0,1,3,-19,1,Trey Lyles,SAC,LAC,SAC,,,12,9,6,9
22023,1626168,22300303,"DEC 11, 2023",SAC vs. BKN,W,23,6,7,0.857,5,6,0.833,0,0,0.0,0,6,6,1,0,1,0,0,17,9,1,Trey Lyles,SAC,SAC,BKN,,,24,23,18,7
22023,1626168,22301228,"DEC 08, 2023",SAC @ PHX,W,13,2,6,0.333,1,4,0.25,0,0,0.0,0,6,6,2,0,0,0,1,5,9,1,Trey Lyles,SAC,PHX,SAC,,,13,11,7,8
22023,1626168,22301204,"DEC 04, 2023",SAC vs. NOP,L,16,1,4,0.25,0,3,0.0,3,4,0.75,0,1,1,6,0,0,0,3,5,-2,1,Trey Lyles,SAC,SAC,NOP,,,12,6,11,7
22023,1626168,22300290,"DEC 02, 2023",SAC vs. DEN,W,18,3,8,0.375,0,3,0.0,1,1,1.0,2,2,4,1,0,0,0,2,7,-1,1,Trey Lyles,SAC,SAC,DEN,,,12,11,8,5
22023,1626168,22300264,"NOV 29, 2023",SAC vs. LAC,L,18,1,5,0.2,0,3,0.0,0,2,0.0,2,3,5,2,0,0,2,2,2,4,1,Trey Lyles,SAC,SAC,LAC,,,9,7,4,7
22023,1626168,22300060,"NOV 28, 2023",SAC vs. GSW,W,24,2,6,0.333,1,4,0.25,6,9,0.667,3,3,6,0,0,1,1,2,11,4,1,Trey Lyles,SAC,SAC,GSW,,,17,17,11,6
22023,1626168,22300050,"NOV 24, 2023",SAC @ MIN,W,19,3,6,0.5,3,6,0.5,0,0,0.0,1,6,7,0,0,0,1,1,9,15,1,Trey Lyles,SAC,MIN,SAC,,,16,16,9,7
22023,1626168,22300233,"NOV 22, 2023",SAC @ NOP,L,28,4,8,0.5,3,7,0.429,1,1,1.0,0,8,8,0,0,0,3,5,12,-9,1,Trey Lyles,SAC,NOP,SAC,,,20,20,12,8
22023,1630177,22300057,"NOV 28, 2023",CHA @ NYK,L,5,0,2,0.0,0,1,0.0,0,0,0.0,0,0,0,2,0,0,0,1,0,-1,1,Theo Maledon,CHA,NYK,CHA,,,2,0,2,2
22023,1630177,22300248,"NOV 26, 2023",CHA @ ORL,L,4,0,0,0.0,0,0,0.0,0,0,0.0,0,0,0,3,0,0,0,0,0,1,1,Theo Maledon,CHA,ORL,CHA,,,3,0,3,3
22023,1630177,22300027,"NOV 17, 2023",CHA vs. MIL,L,4,0,0,0.0,0,0,0.0,0,0,0.0,0,0,0,0,0,0,1,0,0,-11,1,Theo Maledon,CHA,CHA,MIL,,,0,0,0,0
22023,1630177,22300017,"NOV 14, 2023",CHA vs. MIA,L,23,0,5,0.0,0,2,0.0,2,2,1.0,0,3,3,3,0,0,2,1,2,3,1,Theo Maledon,CHA,CHA,MIA,,,8,5,5,6
22023,1630177,22300177,"NOV 12, 2023",CHA @ NYK,L,25,2,12,0.167,2,7,0.286,0,0,0.0,2,0,2,4,0,0,2,3,6,-20,1,Theo Maledon,CHA,NYK,CHA,,,12,8,10,6
22023,1630177,22300009,"NOV 10, 2023",CHA @ WAS,W,16,2,5,0.4,0,1,0.0,0,0,0.0,1,4,5,4,1,0,2,1,4,1,1,Theo Maledon,CHA,WAS,CHA,,,13,9,8,9
22023,1630177,22300157,"NOV 08, 2023",CHA vs. WAS,L,18,4,7,0.571,1,2,0.5,0,0,0.0,0,1,1,0,1,0,1,2,9,-21,1,Theo Maledon,CHA,CHA,WAS,,,10,10,9,1
22023,1630177,22300143,"NOV 05, 2023",CHA @ DAL,L,21,4,9,0.444,1,6,0.167,0,0,0.0,0,0,0,4,0,0,1,1,9,-7,1,Theo Maledon,CHA,DAL,CHA,,,13,9,13,4
22023,1630177,22300133,"NOV 04, 2023",CHA @ IND,W,14,0,3,0.0,0,2,0.0,0,0,0.0,0,0,0,0,0,0,1,4,0,4,1,Theo Maledon,CHA,IND,CHA,,,0,0,0,0
22023,1630177,22300122,"NOV 01, 2023",CHA @ HOU,L,21,2,7,0.286,1,2,0.5,0,0,0.0,1,5,6,2,1,0,3,2,5,4,1,Theo Maledon,CHA,HOU,CHA,,,13,11,7,8
22023,1630177,22300101,"OCT 30, 2023",CHA vs. BKN,L,20,2,9,0.222,0,5,0.0,5,5,1.0,0,1,1,2,2,0,0,0,9,-3,1,Theo Maledon,CHA,CHA,BKN,,,12,10,11,3
22023,1630177,22300077,"OCT 27, 2023",CHA vs. DET,L,14,1,2,0.5,0,0,0.0,4,5,0.8,0,2,2,0,2,0,1,0,6,-2,1,Theo Maledon,CHA,CHA,DET,,,8,8,6,2
22023,1630177,22300063,"OCT 25, 2023",CHA vs. ATL,W,16,2,5,0.4,0,2,0.0,0,0,0.0,0,3,3,4,0,0,1,3,4,-5,1,Theo Maledon,CHA,CHA,ATL,,,11,7,8,7
22023,1630572,22300559,"JAN 15, 2024",SAS @ ATL,L,1,0,1,0.0,0,1,0.0,0,0,0.0,0,0,0,0,0,0,0,0,0,-4,1,Sandro Mamukelashvili,SAS,ATL,SAS,,,0,0,0,0
22023,1630572,22300548,"JAN 13, 2024",SAS vs. CHI,L,18,3,7,0.429,1,3,0.333,1,2,0.5,3,5,8,1,1,2,0,5,8,-6,1,Sandro Mamukelashvili,SAS,SAS,CHI,,,17,16,9,9
22023,1630572,22300541,"JAN 12, 2024",SAS vs. CHA,W,10,0,1,0.0,0,0,0.0,1,2,0.5,1,1,2,0,0,1,0,1,1,2,1,Sandro Mamukelashvili,SAS,SAS,CHA,,,3,3,1,2
22023,1630572,22300519,"JAN 10, 2024",SAS @ DET,W,2,0,0,0.0,0,0,0.0,0,0,0.0,0,0,0,0,0,0,0,0,0,1,1,Sandro Mamukelashvili,SAS,DET,SAS,,,0,0,0,0
22023,1630572,22300477,"JAN 04, 2024",SAS vs. MIL,L,3,0,0,0.0,0,0,0.0,0,0,0.0,0,0,0,2,0,0,0,0,0,-1,1,Sandro Mamukelashvili,SAS,SAS,MIL,,,2,0,2,2
22023,1630572,22300460,"JAN 02, 2024",SAS @ MEM,L,2,1,1,1.0,1,1,1.0,0,0,0.0,0,0,0,0,0,1,1,0,3,4,1,Sandro Mamukelashvili,SAS,MEM,SAS,,,3,3,3,0
22023,1630572,22300448,"DEC 31, 2023",SAS vs. BOS,L,20,3,9,0.333,1,5,0.2,0,0,0.0,2,5,7,4,0,0,0,1,7,-9,1,Sandro Mamukelashvili,SAS,SAS,BOS,,,18,14,11,11
22023,1630572,22300437,"DEC 29, 2023",SAS @ POR,L,8,1,2,0.5,0,1,0.0,0,0,0.0,0,1,1,2,0,0,0,1,2,8,1,Sandro Mamukelashvili,SAS,POR,SAS,,,5,3,4,3
22023,1630572,22300427,"DEC 28, 2023",SAS @ POR,W,1,0,1,0.0,0,1,0.0,0,0,0.0,0,0,0,0,0,0,0,0,0,-2,1,Sandro Mamukelashvili,SAS,POR,SAS,,,0,0,0,0
22023,1630572,22300412,"DEC 26, 2023",SAS vs. UTA,L,2,0,1,0.0,0,0,0.0,0,0,0.0,0,1,1,0,0,0,0,0,0,7,1,Sandro Mamukelashvili,SAS,SAS,UTA,,,1,1,0,1
22023,1630572,22300398,"DEC 23, 2023",SAS @ DAL,L,15,4,6,0.667,1,3,0.333,5,6,0.833,3,2,5,3,0,1,1,1,14,4,1,Sandro Mamukelashvili,SAS,DAL,SAS,,,22,19,17,8
22023,1630572,22300376,"DEC 21, 2023",SAS @ CHI,L,3,0,0,0.0,0,0,0.0,0,0,0.0,0,1,1,0,0,0,0,0,0,1,1,Sandro Mamukelashvili,SAS,CHI,SAS,,,1,1,0,1
22023,1630572,22300361,"DEC 19, 2023",SAS @ MIL,L,15,1,5,0.2,1,4,0.25,0,0,0.0,1,7,8,3,1,2,2,1,3,-7,1,Sandro Mamukelashvili,SAS,MIL,SAS,,,14,11,6,11
22023,1630572,22300345,"DEC 17, 2023",SAS vs. NOP,L,8,1,4,0.25,0,3,0.0,0,0,0.0,0,0,0,2,0,0,1,0,2,-4,1,Sandro Mamukelashvili,SAS,SAS,NOP,,,4,2,4,2
22023,1630572,22300331,"DEC 15, 2023",SAS vs. LAL,W,2,1,1,1.0,1,1,1.0,0,0,0.0,0,0,0,0,0,0,0,0,3,-3,1,Sandro Mamukelashvili,SAS,SAS,LAL,,,3,3,3,0
22023,1630572,22300298,"DEC 11, 2023",SAS @ HOU,L,4,0,0,0.0,0,0,0.0,0,0,0.0,0,1,1,0,0,0,0,1,0,0,1,Sandro Mamukelashvili,SAS,HOU,SAS,,,1,1,0,1
22023,1630572,22300278,"DEC 01, 2023",SAS @ NOP,L,6,1,3,0.333,1,2,0.5,0,0,0.0,1,0,1,1,0,0,0,1,3,0,1,Sandro Mamukelashvili,SAS,NOP,SAS,,,5,4,4,2
22023,1630572,22300252,"NOV 26, 2023",SAS @ DEN,L,7,0,0,0.0,0,0,0.0,0,0,0.0,0,0,0,2,1,0,0,1,0,8,1,Sandro Mamukelashvili,SAS,DEN,SAS,,,2,0,2,2
22023,1630572,22300206,"NOV 18, 2023",SAS vs. MEM,L,11,2,5,0.4,1,2,0.5,0,0,0.0,0,2,2,1,0,1,1,3,5,-4,1,Sandro Mamukelashvili,SAS,SAS,MEM,,,8,7,6,3
22023,1630572,22300032,"NOV 17, 2023",SAS vs. SAC,L,12,1,2,0.5,0,0,0.0,4,4,1.0,1,2,3,3,0,0,1,1,6,21,1,Sandro Mamukelashvili,SAS,SAS,SAC,,,12,9,9,6
22023,1630572,22300161,"NOV 08, 2023",SAS @ NYK,L,3,0,1,0.0,0,1,0.0,0,0,0.0,1,0,1,0,0,0,0,1,0,0,1,Sandro Mamukelashvili,SAS,NYK,SAS,,,1,1,0,1
22023,1630572,22300146,"NOV 06, 2023",SAS @ IND,L,9,2,4,0.5,0,2,0.0,1,2,0.5,2,2,4,1,0,0,0,0,5,-6,1,Sandro Mamukelashvili,SAS,IND,SAS,,,10,9,6,5
22023,1630572,22300099,"OCT 29, 2023",SAS @ LAC,L,7,0,0,0.0,0,0,0.0,0,0,0.0,1,1,2,0,1,0,1,1,0,-13,1,Sandro Mamukelashvili,SAS,LAC,SAS,,,2,2,0,2
22023,1629611,22300553,"JAN 14, 2024",LAC @ MIN,L,19,1,2,0.5,0,1,0.0,0,0,0.0,2,1,3,0,0,0,0,3,2,-6,1,Terance Mann,LAC,MIN,LAC,7.5,Points,5,5,2,3
22023,1629611,22300553,"JAN 14, 2024",LAC @ MIN,L,19,1,2,0.5,0,1,0.0,0,0,0.0,2,1,3,0,0,0,0,3,2,-6,1,Terance Mann,LAC,MIN,LAC,3.5,Rebounds,5,5,2,3
22023,1629611,22300553,"JAN 14, 2024",LAC @ MIN,L,19,1,2,0.5,0,1,0.0,0,0,0.0,2,1,3,0,0,0,0,3,2,-6,1,Terance Mann,LAC,MIN,LAC,11.5,Pts+Rebs,5,5,2,3
22023,1629611,22300553,"JAN 14, 2024",LAC @ MIN,L,19,1,2,0.5,0,1,0.0,0,0,0.0,2,1,3,0,0,0,0,3,2,-6,1,Terance Mann,LAC,MIN,LAC,0.5,Turnovers,5,5,2,3
22023,1629611,22300537,"JAN 12, 2024",LAC @ MEM,W,26,3,8,0.375,1,4,0.25,0,0,0.0,2,3,5,0,0,0,1,0,7,2,1,Terance Mann,LAC,MEM,LAC,7.5,Points,12,12,7,5
22023,1629611,22300537,"JAN 12, 2024",LAC @ MEM,W,26,3,8,0.375,1,4,0.25,0,0,0.0,2,3,5,0,0,0,1,0,7,2,1,Terance Mann,LAC,MEM,LAC,3.5,Rebounds,12,12,7,5
22023,1629611,22300537,"JAN 12, 2024",LAC @ MEM,W,26,3,8,0.375,1,4,0.25,0,0,0.0,2,3,5,0,0,0,1,0,7,2,1,Terance Mann,LAC,MEM,LAC,11.5,Pts+Rebs,12,12,7,5
22023,1629611,22300537,"JAN 12, 2024",LAC @ MEM,W,26,3,8,0.375,1,4,0.25,0,0,0.0,2,3,5,0,0,0,1,0,7,2,1,Terance Mann,LAC,MEM,LAC,0.5,Turnovers,12,12,7,5
22023,1629611,22300526,"JAN 10, 2024",LAC vs. TOR,W,24,5,5,1.0,3,3,1.0,0,0,0.0,2,0,2,1,0,0,1,1,13,6,1,Terance Mann,LAC,LAC,TOR,7.5,Points,16,15,14,3
22023,1629611,22300526,"JAN 10, 2024",LAC vs. TOR,W,24,5,5,1.0,3,3,1.0,0,0,0.0,2,0,2,1,0,0,1,1,13,6,1,Terance Mann,LAC,LAC,TOR,3.5,Rebounds,16,15,14,3
22023,1629611,22300526,"JAN 10, 2024",LAC vs. TOR,W,24,5,5,1.0,3,3,1.0,0,0,0.0,2,0,2,1,0,0,1,1,13,6,1,Terance Mann,LAC,LAC,TOR,11.5,Pts+Rebs,16,15,14,3
22023,1629611,22300526,"JAN 10, 2024",LAC vs. TOR,W,24,5,5,1.0,3,3,1.0,0,0,0.0,2,0,2,1,0,0,1,1,13,6,1,Terance Mann,LAC,LAC,TOR,0.5,Turnovers,16,15,14,3
22023,1629611,22300511,"JAN 08, 2024",LAC vs. PHX,W,28,5,9,0.556,3,6,0.5,1,2,0.5,3,2,5,3,0,0,1,2,14,14,1,Terance Mann,LAC,LAC,PHX,7.5,Points,22,19,17,8
22023,1629611,22300511,"JAN 08, 2024",LAC vs. PHX,W,28,5,9,0.556,3,6,0.5,1,2,0.5,3,2,5,3,0,0,1,2,14,14,1,Terance Mann,LAC,LAC,PHX,3.5,Rebounds,22,19,17,8
22023,1629611,22300511,"JAN 08, 2024",LAC vs. PHX,W,28,5,9,0.556,3,6,0.5,1,2,0.5,3,2,5,3,0,0,1,2,14,14,1,Terance Mann,LAC,LAC,PHX,11.5,Pts+Rebs,22,19,17,8
22023,1629611,22300511,"JAN 08, 2024",LAC vs. PHX,W,28,5,9,0.556,3,6,0.5,1,2,0.5,3,2,5,3,0,0,1,2,14,14,1,Terance Mann,LAC,LAC,PHX,0.5,Turnovers,22,19,17,8
22023,1629611,22300505,"JAN 07, 2024",LAC @ LAL,L,25,2,5,0.4,2,3,0.667,0,0,0.0,0,0,0,3,0,0,1,2,6,1,1,Terance Mann,LAC,LAL,LAC,7.5,Points,9,6,9,3
22023,1629611,22300505,"JAN 07, 2024",LAC @ LAL,L,25,2,5,0.4,2,3,0.667,0,0,0.0,0,0,0,3,0,0,1,2,6,1,1,Terance Mann,LAC,LAL,LAC,3.5,Rebounds,9,6,9,3
22023,1629611,22300505,"JAN 07, 2024",LAC @ LAL,L,25,2,5,0.4,2,3,0.667,0,0,0.0,0,0,0,3,0,0,1,2,6,1,1,Terance Mann,LAC,LAL,LAC,11.5,Pts+Rebs,9,6,9,3
22023,1629611,22300505,"JAN 07, 2024",LAC @ LAL,L,25,2,5,0.4,2,3,0.667,0,0,0.0,0,0,0,3,0,0,1,2,6,1,1,Terance Mann,LAC,LAL,LAC,0.5,Turnovers,9,6,9,3
22023,1629611,22300486,"JAN 05, 2024",LAC @ NOP,W,17,2,3,0.667,2,3,0.667,2,2,1.0,1,2,3,1,1,0,0,2,8,11,1,Terance Mann,LAC,NOP,LAC,7.5,Points,12,11,9,4
22023,1629611,22300486,"JAN 05, 2024",LAC @ NOP,W,17,2,3,0.667,2,3,0.667,2,2,1.0,1,2,3,1,1,0,0,2,8,11,1,Terance Mann,LAC,NOP,LAC,3.5,Rebounds,12,11,9,4
22023,1629611,22300486,"JAN 05, 2024",LAC @ NOP,W,17,2,3,0.667,2,3,0.667,2,2,1.0,1,2,3,1,1,0,0,2,8,11,1,Terance Mann,LAC,NOP,LAC,11.5,Pts+Rebs,12,11,9,4
22023,1629611,22300486,"JAN 05, 2024",LAC @ NOP,W,17,2,3,0.667,2,3,0.667,2,2,1.0,1,2,3,1,1,0,0,2,8,11,1,Terance Mann,LAC,NOP,LAC,0.5,Turnovers,12,11,9,4
22023,1629611,22300473,"JAN 03, 2024",LAC @ PHX,W,23,5,8,0.625,2,4,0.5,0,0,0.0,2,1,3,1,2,0,0,1,12,17,1,Terance Mann,LAC,PHX,LAC,7.5,Points,16,15,13,4
22023,1629611,22300473,"JAN 03, 2024",LAC @ PHX,W,23,5,8,0.625,2,4,0.5,0,0,0.0,2,1,3,1,2,0,0,1,12,17,1,Terance Mann,LAC,PHX,LAC,3.5,Rebounds,16,15,13,4
22023,1629611,22300473,"JAN 03, 2024",LAC @ PHX,W,23,5,8,0.625,2,4,0.5,0,0,0.0,2,1,3,1,2,0,0,1,12,17,1,Terance Mann,LAC,PHX,LAC,11.5,Pts+Rebs,16,15,13,4
22023,1629611,22300473,"JAN 03, 2024",LAC @ PHX,W,23,5,8,0.625,2,4,0.5,0,0,0.0,2,1,3,1,2,0,0,1,12,17,1,Terance Mann,LAC,PHX,LAC,0.5,Turnovers,16,15,13,4
22023,1629611,22300458,"JAN 01, 2024",LAC vs. MIA,W,18,5,7,0.714,1,2,0.5,1,1,1.0,1,2,3,0,0,0,1,2,12,8,1,Terance Mann,LAC,LAC,MIA,7.5,Points,15,15,12,3
22023,1629611,22300458,"JAN 01, 2024",LAC vs. MIA,W,18,5,7,0.714,1,2,0.5,1,1,1.0,1,2,3,0,0,0,1,2,12,8,1,Terance Mann,LAC,LAC,MIA,3.5,Rebounds,15,15,12,3
22023,1629611,22300458,"JAN 01, 2024",LAC vs. MIA,W,18,5,7,0.714,1,2,0.5,1,1,1.0,1,2,3,0,0,0,1,2,12,8,1,Terance Mann,LAC,LAC,MIA,11.5,Pts+Rebs,15,15,12,3
22023,1629611,22300458,"JAN 01, 2024",LAC vs. MIA,W,18,5,7,0.714,1,2,0.5,1,1,1.0,1,2,3,0,0,0,1,2,12,8,1,Terance Mann,LAC,LAC,MIA,0.5,Turnovers,15,15,12,3
22023,1629611,22300438,"DEC 29, 2023",LAC vs. MEM,W,23,3,10,0.3,0,6,0.0,5,6,0.833,1,2,3,2,1,0,0,1,11,10,1,Terance Mann,LAC,LAC,MEM,7.5,Points,16,14,13,5
22023,1629611,22300438,"DEC 29, 2023",LAC vs. MEM,W,23,3,10,0.3,0,6,0.0,5,6,0.833,1,2,3,2,1,0,0,1,11,10,1,Terance Mann,LAC,LAC,MEM,3.5,Rebounds,16,14,13,5
22023,1629611,22300438,"DEC 29, 2023",LAC vs. MEM,W,23,3,10,0.3,0,6,0.0,5,6,0.833,1,2,3,2,1,0,0,1,11,10,1,Terance Mann,LAC,LAC,MEM,11.5,Pts+Rebs,16,14,13,5
22023,1629611,22300438,"DEC 29, 2023",LAC vs. MEM,W,23,3,10,0.3,0,6,0.0,5,6,0.833,1,2,3,2,1,0,0,1,11,10,1,Terance Mann,LAC,LAC,MEM,0.5,Turnovers,16,14,13,5
22023,1629611,22300414,"DEC 26, 2023",LAC vs. CHA,W,20,1,4,0.25,0,1,0.0,2,2,1.0,1,0,1,0,0,0,1,2,4,2,1,Terance Mann,LAC,LAC,CHA,7.5,Points,5,5,4,1
22023,1629611,22300414,"DEC 26, 2023",LAC vs. CHA,W,20,1,4,0.25,0,1,0.0,2,2,1.0,1,0,1,0,0,0,1,2,4,2,1,Terance Mann,LAC,LAC,CHA,3.5,Rebounds,5,5,4,1
22023,1629611,22300414,"DEC 26, 2023",LAC vs. CHA,W,20,1,4,0.25,0,1,0.0,2,2,1.0,1,0,1,0,0,0,1,2,4,2,1,Terance Mann,LAC,LAC,CHA,11.5,Pts+Rebs,5,5,4,1
22023,1629611,22300414,"DEC 26, 2023",LAC vs. CHA,W,20,1,4,0.25,0,1,0.0,2,2,1.0,1,0,1,0,0,0,1,2,4,2,1,Terance Mann,LAC,LAC,CHA,0.5,Turnovers,5,5,4,1
22023,1629611,22300389,"DEC 23, 2023",LAC vs. BOS,L,24,0,10,0.0,0,6,0.0,0,0,0.0,1,3,4,3,0,0,0,2,0,-33,1,Terance Mann,LAC,LAC,BOS,7.5,Points,7,4,3,7
22023,1629611,22300389,"DEC 23, 2023",LAC vs. BOS,L,24,0,10,0.0,0,6,0.0,0,0,0.0,1,3,4,3,0,0,0,2,0,-33,1,Terance Mann,LAC,LAC,BOS,3.5,Rebounds,7,4,3,7
22023,1629611,22300389,"DEC 23, 2023",LAC vs. BOS,L,24,0,10,0.0,0,6,0.0,0,0,0.0,1,3,4,3,0,0,0,2,0,-33,1,Terance Mann,LAC,LAC,BOS,11.5,Pts+Rebs,7,4,3,7
22023,1629611,22300389,"DEC 23, 2023",LAC vs. BOS,L,24,0,10,0.0,0,6,0.0,0,0,0.0,1,3,4,3,0,0,0,2,0,-33,1,Terance Mann,LAC,LAC,BOS,0.5,Turnovers,7,4,3,7
22023,1629611,22300379,"DEC 21, 2023",LAC @ OKC,L,24,2,8,0.25,1,4,0.25,0,0,0.0,0,1,1,1,3,1,1,3,5,-31,1,Terance Mann,LAC,OKC,LAC,7.5,Points,7,6,6,2
22023,1629611,22300379,"DEC 21, 2023",LAC @ OKC,L,24,2,8,0.25,1,4,0.25,0,0,0.0,0,1,1,1,3,1,1,3,5,-31,1,Terance Mann,LAC,OKC,LAC,3.5,Rebounds,7,6,6,2
22023,1629611,22300379,"DEC 21, 2023",LAC @ OKC,L,24,2,8,0.25,1,4,0.25,0,0,0.0,0,1,1,1,3,1,1,3,5,-31,1,Terance Mann,LAC,OKC,LAC,11.5,Pts+Rebs,7,6,6,2
22023,1629611,22300379,"DEC 21, 2023",LAC @ OKC,L,24,2,8,0.25,1,4,0.25,0,0,0.0,0,1,1,1,3,1,1,3,5,-31,1,Terance Mann,LAC,OKC,LAC,0.5,Turnovers,7,6,6,2
22023,1629611,22300372,"DEC 20, 2023",LAC @ DAL,W,29,3,8,0.375,1,2,0.5,0,0,0.0,1,3,4,1,0,1,1,3,7,1,1,Terance Mann,LAC,DAL,LAC,7.5,Points,12,11,8,5
22023,1629611,22300372,"DEC 20, 2023",LAC @ DAL,W,29,3,8,0.375,1,2,0.5,0,0,0.0,1,3,4,1,0,1,1,3,7,1,1,Terance Mann,LAC,DAL,LAC,3.5,Rebounds,12,11,8,5
22023,1629611,22300372,"DEC 20, 2023",LAC @ DAL,W,29,3,8,0.375,1,2,0.5,0,0,0.0,1,3,4,1,0,1,1,3,7,1,1,Terance Mann,LAC,DAL,LAC,11.5,Pts+Rebs,12,11,8,5
22023,1629611,22300372,"DEC 20, 2023",LAC @ DAL,W,29,3,8,0.375,1,2,0.5,0,0,0.0,1,3,4,1,0,1,1,3,7,1,1,Terance Mann,LAC,DAL,LAC,0.5,Turnovers,12,11,8,5
22023,1629611,22300350,"DEC 18, 2023",LAC @ IND,W,28,2,5,0.4,0,3,0.0,0,0,0.0,1,1,2,1,0,1,1,0,4,10,1,Terance Mann,LAC,IND,LAC,7.5,Points,7,6,5,3
22023,1629611,22300350,"DEC 18, 2023",LAC @ IND,W,28,2,5,0.4,0,3,0.0,0,0,0.0,1,1,2,1,0,1,1,0,4,10,1,Terance Mann,LAC,IND,LAC,3.5,Rebounds,7,6,5,3
22023,1629611,22300350,"DEC 18, 2023",LAC @ IND,W,28,2,5,0.4,0,3,0.0,0,0,0.0,1,1,2,1,0,1,1,0,4,10,1,Terance Mann,LAC,IND,LAC,11.5,Pts+Rebs,7,6,5,3
22023,1629611,22300350,"DEC 18, 2023",LAC @ IND,W,28,2,5,0.4,0,3,0.0,0,0,0.0,1,1,2,1,0,1,1,0,4,10,1,Terance Mann,LAC,IND,LAC,0.5,Turnovers,7,6,5,3
22023,1629611,22300343,"DEC 16, 2023",LAC vs. NYK,W,27,4,8,0.5,2,4,0.5,3,3,1.0,0,1,1,4,0,0,0,1,13,19,1,Terance Mann,LAC,LAC,NYK,7.5,Points,18,14,17,5
22023,1629611,22300343,"DEC 16, 2023",LAC vs. NYK,W,27,4,8,0.5,2,4,0.5,3,3,1.0,0,1,1,4,0,0,0,1,13,19,1,Terance Mann,LAC,LAC,NYK,3.5,Rebounds,18,14,17,5
22023,1629611,22300343,"DEC 16, 2023",LAC vs. NYK,W,27,4,8,0.5,2,4,0.5,3,3,1.0,0,1,1,4,0,0,0,1,13,19,1,Terance Mann,LAC,LAC,NYK,11.5,Pts+Rebs,18,14,17,5
22023,1629611,22300343,"DEC 16, 2023",LAC vs. NYK,W,27,4,8,0.5,2,4,0.5,3,3,1.0,0,1,1,4,0,0,0,1,13,19,1,Terance Mann,LAC,LAC,NYK,0.5,Turnovers,18,14,17,5
22023,1629611,22300325,"DEC 14, 2023",LAC vs. GSW,W,20,1,5,0.2,0,4,0.0,0,0,0.0,1,2,3,2,1,0,0,1,2,-22,1,Terance Mann,LAC,LAC,GSW,7.5,Points,7,5,4,5
22023,1629611,22300325,"DEC 14, 2023",LAC vs. GSW,W,20,1,5,0.2,0,4,0.0,0,0,0.0,1,2,3,2,1,0,0,1,2,-22,1,Terance Mann,LAC,LAC,GSW,3.5,Rebounds,7,5,4,5
22023,1629611,22300325,"DEC 14, 2023",LAC vs. GSW,W,20,1,5,0.2,0,4,0.0,0,0,0.0,1,2,3,2,1,0,0,1,2,-22,1,Terance Mann,LAC,LAC,GSW,11.5,Pts+Rebs,7,5,4,5
22023,1629611,22300325,"DEC 14, 2023",LAC vs. GSW,W,20,1,5,0.2,0,4,0.0,0,0,0.0,1,2,3,2,1,0,0,1,2,-22,1,Terance Mann,LAC,LAC,GSW,0.5,Turnovers,7,5,4,5
22023,1629611,22300309,"DEC 12, 2023",LAC vs. SAC,W,30,3,6,0.5,2,3,0.667,2,2,1.0,1,4,5,2,1,0,1,1,10,7,1,Terance Mann,LAC,LAC,SAC,7.5,Points,17,15,12,7
22023,1629611,22300309,"DEC 12, 2023",LAC vs. SAC,W,30,3,6,0.5,2,3,0.667,2,2,1.0,1,4,5,2,1,0,1,1,10,7,1,Terance Mann,LAC,LAC,SAC,3.5,Rebounds,17,15,12,7
22023,1629611,22300309,"DEC 12, 2023",LAC vs. SAC,W,30,3,6,0.5,2,3,0.667,2,2,1.0,1,4,5,2,1,0,1,1,10,7,1,Terance Mann,LAC,LAC,SAC,11.5,Pts+Rebs,17,15,12,7
22023,1629611,22300309,"DEC 12, 2023",LAC vs. SAC,W,30,3,6,0.5,2,3,0.667,2,2,1.0,1,4,5,2,1,0,1,1,10,7,1,Terance Mann,LAC,LAC,SAC,0.5,Turnovers,17,15,12,7
22023,1629611,22300304,"DEC 11, 2023",LAC vs. POR,W,29,3,6,0.5,1,4,0.25,2,2,1.0,2,1,3,4,0,0,0,2,9,5,1,Terance Mann,LAC,LAC,POR,7.5,Points,16,12,13,7
22023,1629611,22300304,"DEC 11, 2023",LAC vs. POR,W,29,3,6,0.5,1,4,0.25,2,2,1.0,2,1,3,4,0,0,0,2,9,5,1,Terance Mann,LAC,LAC,POR,3.5,Rebounds,16,12,13,7
22023,1629611,22300304,"DEC 11, 2023",LAC vs. POR,W,29,3,6,0.5,1,4,0.25,2,2,1.0,2,1,3,4,0,0,0,2,9,5,1,Terance Mann,LAC,LAC,POR,11.5,Pts+Rebs,16,12,13,7
22023,1629611,22300304,"DEC 11, 2023",LAC vs. POR,W,29,3,6,0.5,1,4,0.25,2,2,1.0,2,1,3,4,0,0,0,2,9,5,1,Terance Mann,LAC,LAC,POR,0.5,Turnovers,16,12,13,7
22023,1629611,22301225,"DEC 08, 2023",LAC @ UTA,W,30,4,9,0.444,2,5,0.4,0,2,0.0,1,3,4,1,1,1,2,3,10,17,1,Terance Mann,LAC,UTA,LAC,7.5,Points,15,14,11,5
22023,1629611,22301225,"DEC 08, 2023",LAC @ UTA,W,30,4,9,0.444,2,5,0.4,0,2,0.0,1,3,4,1,1,1,2,3,10,17,1,Terance Mann,LAC,UTA,LAC,3.5,Rebounds,15,14,11,5
22023,1629611,22301225,"DEC 08, 2023",LAC @ UTA,W,30,4,9,0.444,2,5,0.4,0,2,0.0,1,3,4,1,1,1,2,3,10,17,1,Terance Mann,LAC,UTA,LAC,11.5,Pts+Rebs,15,14,11,5
22023,1629611,22301225,"DEC 08, 2023",LAC @ UTA,W,30,4,9,0.444,2,5,0.4,0,2,0.0,1,3,4,1,1,1,2,3,10,17,1,Terance Mann,LAC,UTA,LAC,0.5,Turnovers,15,14,11,5
22023,1629611,22301215,"DEC 06, 2023",LAC vs. DEN,W,20,1,2,0.5,0,0,0.0,0,0,0.0,0,1,1,0,0,0,0,1,2,-16,1,Terance Mann,LAC,LAC,DEN,7.5,Points,3,3,2,1
22023,1629611,22301215,"DEC 06, 2023",LAC vs. DEN,W,20,1,2,0.5,0,0,0.0,0,0,0.0,0,1,1,0,0,0,0,1,2,-16,1,Terance Mann,LAC,LAC,DEN,3.5,Rebounds,3,3,2,1
22023,1629611,22301215,"DEC 06, 2023",LAC vs. DEN,W,20,1,2,0.5,0,0,0.0,0,0,0.0,0,1,1,0,0,0,0,1,2,-16,1,Terance Mann,LAC,LAC,DEN,11.5,Pts+Rebs,3,3,2,1
22023,1629611,22301215,"DEC 06, 2023",LAC vs. DEN,W,20,1,2,0.5,0,0,0.0,0,0,0.0,0,1,1,0,0,0,0,1,2,-16,1,Terance Mann,LAC,LAC,DEN,0.5,Turnovers,3,3,2,1
22023,1629611,22300280,"DEC 02, 2023",LAC vs. GSW,W,24,1,6,0.167,1,5,0.2,0,0,0.0,1,1,2,2,1,0,0,1,3,-5,1,Terance Mann,LAC,LAC,GSW,7.5,Points,7,5,5,4
22023,1629611,22300280,"DEC 02, 2023",LAC vs. GSW,W,24,1,6,0.167,1,5,0.2,0,0,0.0,1,1,2,2,1,0,0,1,3,-5,1,Terance Mann,LAC,LAC,GSW,3.5,Rebounds,7,5,5,4
22023,1629611,22300280,"DEC 02, 2023",LAC vs. GSW,W,24,1,6,0.167,1,5,0.2,0,0,0.0,1,1,2,2,1,0,0,1,3,-5,1,Terance Mann,LAC,LAC,GSW,11.5,Pts+Rebs,7,5,5,4
22023,1629611,22300280,"DEC 02, 2023",LAC vs. GSW,W,24,1,6,0.167,1,5,0.2,0,0,0.0,1,1,2,2,1,0,0,1,3,-5,1,Terance Mann,LAC,LAC,GSW,0.5,Turnovers,7,5,5,4
22023,1629611,22300273,"NOV 30, 2023",LAC @ GSW,L,34,4,10,0.4,1,4,0.25,0,0,0.0,3,2,5,1,1,0,2,1,9,13,1,Terance Mann,LAC,GSW,LAC,7.5,Points,15,14,10,6
22023,1629611,22300273,"NOV 30, 2023",LAC @ GSW,L,34,4,10,0.4,1,4,0.25,0,0,0.0,3,2,5,1,1,0,2,1,9,13,1,Terance Mann,LAC,GSW,LAC,3.5,Rebounds,15,14,10,6
22023,1629611,22300273,"NOV 30, 2023",LAC @ GSW,L,34,4,10,0.4,1,4,0.25,0,0,0.0,3,2,5,1,1,0,2,1,9,13,1,Terance Mann,LAC,GSW,LAC,11.5,Pts+Rebs,15,14,10,6
22023,1629611,22300273,"NOV 30, 2023",LAC @ GSW,L,34,4,10,0.4,1,4,0.25,0,0,0.0,3,2,5,1,1,0,2,1,9,13,1,Terance Mann,LAC,GSW,LAC,0.5,Turnovers,15,14,10,6
22023,1629611,22300264,"NOV 29, 2023",LAC @ SAC,W,31,8,12,0.667,1,3,0.333,1,1,1.0,0,3,3,1,0,0,0,1,18,12,1,Terance Mann,LAC,SAC,LAC,7.5,Points,22,21,19,4
22023,1629611,22300264,"NOV 29, 2023",LAC @ SAC,W,31,8,12,0.667,1,3,0.333,1,1,1.0,0,3,3,1,0,0,0,1,18,12,1,Terance Mann,LAC,SAC,LAC,3.5,Rebounds,22,21,19,4
22023,1629611,22300264,"NOV 29, 2023",LAC @ SAC,W,31,8,12,0.667,1,3,0.333,1,1,1.0,0,3,3,1,0,0,0,1,18,12,1,Terance Mann,LAC,SAC,LAC,11.5,Pts+Rebs,22,21,19,4
22023,1629611,22300264,"NOV 29, 2023",LAC @ SAC,W,31,8,12,0.667,1,3,0.333,1,1,1.0,0,3,3,1,0,0,0,1,18,12,1,Terance Mann,LAC,SAC,LAC,0.5,Turnovers,22,21,19,4
22023,1629611,22300257,"NOV 27, 2023",LAC vs. DEN,L,30,2,3,0.667,0,1,0.0,1,2,0.5,1,2,3,0,0,1,1,2,5,-11,1,Terance Mann,LAC,LAC,DEN,7.5,Points,8,8,5,3
22023,1629611,22300257,"NOV 27, 2023",LAC vs. DEN,L,30,2,3,0.667,0,1,0.0,1,2,0.5,1,2,3,0,0,1,1,2,5,-11,1,Terance Mann,LAC,LAC,DEN,3.5,Rebounds,8,8,5,3
22023,1629611,22300257,"NOV 27, 2023",LAC vs. DEN,L,30,2,3,0.667,0,1,0.0,1,2,0.5,1,2,3,0,0,1,1,2,5,-11,1,Terance Mann,LAC,LAC,DEN,11.5,Pts+Rebs,8,8,5,3
22023,1629611,22300257,"NOV 27, 2023",LAC vs. DEN,L,30,2,3,0.667,0,1,0.0,1,2,0.5,1,2,3,0,0,1,1,2,5,-11,1,Terance Mann,LAC,LAC,DEN,0.5,Turnovers,8,8,5,3
22023,1629611,22300244,"NOV 25, 2023",LAC vs. DAL,W,32,7,14,0.5,0,4,0.0,3,4,0.75,2,1,3,1,0,1,0,0,17,19,1,Terance Mann,LAC,LAC,DAL,7.5,Points,21,20,18,4
22023,1629611,22300244,"NOV 25, 2023",LAC vs. DAL,W,32,7,14,0.5,0,4,0.0,3,4,0.75,2,1,3,1,0,1,0,0,17,19,1,Terance Mann,LAC,LAC,DAL,3.5,Rebounds,21,20,18,4
22023,1629611,22300244,"NOV 25, 2023",LAC vs. DAL,W,32,7,14,0.5,0,4,0.0,3,4,0.75,2,1,3,1,0,1,0,0,17,19,1,Terance Mann,LAC,LAC,DAL,11.5,Pts+Rebs,21,20,18,4
22023,1629611,22300244,"NOV 25, 2023",LAC vs. DAL,W,32,7,14,0.5,0,4,0.0,3,4,0.75,2,1,3,1,0,1,0,0,17,19,1,Terance Mann,LAC,LAC,DAL,0.5,Turnovers,21,20,18,4
22023,1629611,22300052,"NOV 24, 2023",LAC vs. NOP,L,24,3,4,0.75,1,1,1.0,0,0,0.0,0,2,2,5,2,1,0,5,7,-4,1,Terance Mann,LAC,LAC,NOP,7.5,Points,14,9,12,7
22023,1629611,22300052,"NOV 24, 2023",LAC vs. NOP,L,24,3,4,0.75,1,1,1.0,0,0,0.0,0,2,2,5,2,1,0,5,7,-4,1,Terance Mann,LAC,LAC,NOP,3.5,Rebounds,14,9,12,7
22023,1629611,22300052,"NOV 24, 2023",LAC vs. NOP,L,24,3,4,0.75,1,1,1.0,0,0,0.0,0,2,2,5,2,1,0,5,7,-4,1,Terance Mann,LAC,LAC,NOP,11.5,Pts+Rebs,14,9,12,7
22023,1629611,22300052,"NOV 24, 2023",LAC vs. NOP,L,24,3,4,0.75,1,1,1.0,0,0,0.0,0,2,2,5,2,1,0,5,7,-4,1,Terance Mann,LAC,LAC,NOP,0.5,Turnovers,14,9,12,7
22023,1629611,22300235,"NOV 22, 2023",LAC @ SAS,W,23,2,5,0.4,0,3,0.0,2,4,0.5,0,2,2,1,2,1,1,3,6,3,1,Terance Mann,LAC,SAS,LAC,7.5,Points,9,8,7,3
22023,1629611,22300235,"NOV 22, 2023",LAC @ SAS,W,23,2,5,0.4,0,3,0.0,2,4,0.5,0,2,2,1,2,1,1,3,6,3,1,Terance Mann,LAC,SAS,LAC,3.5,Rebounds,9,8,7,3
22023,1629611,22300235,"NOV 22, 2023",LAC @ SAS,W,23,2,5,0.4,0,3,0.0,2,4,0.5,0,2,2,1,2,1,1,3,6,3,1,Terance Mann,LAC,SAS,LAC,11.5,Pts+Rebs,9,8,7,3
22023,1629611,22300235,"NOV 22, 2023",LAC @ SAS,W,23,2,5,0.4,0,3,0.0,2,4,0.5,0,2,2,1,2,1,1,3,6,3,1,Terance Mann,LAC,SAS,LAC,0.5,Turnovers,9,8,7,3
22023,1629611,22300223,"NOV 20, 2023",LAC @ SAS,W,25,0,6,0.0,0,4,0.0,0,0,0.0,0,6,6,2,4,0,1,0,0,7,1,Terance Mann,LAC,SAS,LAC,7.5,Points,8,6,2,8
22023,1629611,22300223,"NOV 20, 2023",LAC @ SAS,W,25,0,6,0.0,0,4,0.0,0,0,0.0,0,6,6,2,4,0,1,0,0,7,1,Terance Mann,LAC,SAS,LAC,3.5,Rebounds,8,6,2,8
22023,1629611,22300223,"NOV 20, 2023",LAC @ SAS,W,25,0,6,0.0,0,4,0.0,0,0,0.0,0,6,6,2,4,0,1,0,0,7,1,Terance Mann,LAC,SAS,LAC,11.5,Pts+Rebs,8,6,2,8
22023,1629611,22300223,"NOV 20, 2023",LAC @ SAS,W,25,0,6,0.0,0,4,0.0,0,0,0.0,0,6,6,2,4,0,1,0,0,7,1,Terance Mann,LAC,SAS,LAC,0.5,Turnovers,8,6,2,8
22023,1629611,22300037,"NOV 17, 2023",LAC vs. HOU,W,21,0,3,0.0,0,2,0.0,1,2,0.5,1,5,6,3,1,1,0,3,1,15,1,Terance Mann,LAC,LAC,HOU,7.5,Points,10,7,4,9
22023,1629611,22300037,"NOV 17, 2023",LAC vs. HOU,W,21,0,3,0.0,0,2,0.0,1,2,0.5,1,5,6,3,1,1,0,3,1,15,1,Terance Mann,LAC,LAC,HOU,3.5,Rebounds,10,7,4,9
22023,1629611,22300037,"NOV 17, 2023",LAC vs. HOU,W,21,0,3,0.0,0,2,0.0,1,2,0.5,1,5,6,3,1,1,0,3,1,15,1,Terance Mann,LAC,LAC,HOU,11.5,Pts+Rebs,10,7,4,9
22023,1629611,22300037,"NOV 17, 2023",LAC vs. HOU,W,21,0,3,0.0,0,2,0.0,1,2,0.5,1,5,6,3,1,1,0,3,1,15,1,Terance Mann,LAC,LAC,HOU,0.5,Turnovers,10,7,4,9
22023,1629611,22300024,"NOV 14, 2023",LAC @ DEN,L,28,0,1,0.0,0,0,0.0,0,0,0.0,4,2,6,5,0,0,1,3,0,-3,1,Terance Mann,LAC,DEN,LAC,7.5,Points,11,6,5,11
22023,1629611,22300024,"NOV 14, 2023",LAC @ DEN,L,28,0,1,0.0,0,0,0.0,0,0,0.0,4,2,6,5,0,0,1,3,0,-3,1,Terance Mann,LAC,DEN,LAC,3.5,Rebounds,11,6,5,11
22023,1629611,22300024,"NOV 14, 2023",LAC @ DEN,L,28,0,1,0.0,0,0,0.0,0,0,0.0,4,2,6,5,0,0,1,3,0,-3,1,Terance Mann,LAC,DEN,LAC,11.5,Pts+Rebs,11,6,5,11
22023,1629611,22300024,"NOV 14, 2023",LAC @ DEN,L,28,0,1,0.0,0,0,0.0,0,0,0.0,4,2,6,5,0,0,1,3,0,-3,1,Terance Mann,LAC,DEN,LAC,0.5,Turnovers,11,6,5,11
22023,1629611,22300179,"NOV 12, 2023",LAC vs. MEM,L,27,3,7,0.429,1,3,0.333,0,0,0.0,1,2,3,3,0,0,1,2,7,13,1,Terance Mann,LAC,LAC,MEM,7.5,Points,13,10,10,6
22023,1629611,22300179,"NOV 12, 2023",LAC vs. MEM,L,27,3,7,0.429,1,3,0.333,0,0,0.0,1,2,3,3,0,0,1,2,7,13,1,Terance Mann,LAC,LAC,MEM,3.5,Rebounds,13,10,10,6
22023,1629611,22300179,"NOV 12, 2023",LAC vs. MEM,L,27,3,7,0.429,1,3,0.333,0,0,0.0,1,2,3,3,0,0,1,2,7,13,1,Terance Mann,LAC,LAC,MEM,11.5,Pts+Rebs,13,10,10,6
22023,1629611,22300179,"NOV 12, 2023",LAC vs. MEM,L,27,3,7,0.429,1,3,0.333,0,0,0.0,1,2,3,3,0,0,1,2,7,13,1,Terance Mann,LAC,LAC,MEM,0.5,Turnovers,13,10,10,6
22023,1629611,22300014,"NOV 10, 2023",LAC @ DAL,L,29,5,8,0.625,1,3,0.333,0,0,0.0,3,3,6,3,0,0,0,4,11,-10,1,Terance Mann,LAC,DAL,LAC,7.5,Points,20,17,14,9
22023,1629611,22300014,"NOV 10, 2023",LAC @ DAL,L,29,5,8,0.625,1,3,0.333,0,0,0.0,3,3,6,3,0,0,0,4,11,-10,1,Terance Mann,LAC,DAL,LAC,3.5,Rebounds,20,17,14,9
22023,1629611,22300014,"NOV 10, 2023",LAC @ DAL,L,29,5,8,0.625,1,3,0.333,0,0,0.0,3,3,6,3,0,0,0,4,11,-10,1,Terance Mann,LAC,DAL,LAC,11.5,Pts+Rebs,20,17,14,9
22023,1629611,22300014,"NOV 10, 2023",LAC @ DAL,L,29,5,8,0.625,1,3,0.333,0,0,0.0,3,3,6,3,0,0,0,4,11,-10,1,Terance Mann,LAC,DAL,LAC,0.5,Turnovers,20,17,14,9
22023,1629611,22300160,"NOV 08, 2023",LAC @ BKN,L,19,0,2,0.0,0,2,0.0,0,0,0.0,0,4,4,1,0,0,2,1,0,-2,1,Terance Mann,LAC,BKN,LAC,7.5,Points,5,4,1,5
22023,1629611,22300160,"NOV 08, 2023",LAC @ BKN,L,19,0,2,0.0,0,2,0.0,0,0,0.0,0,4,4,1,0,0,2,1,0,-2,1,Terance Mann,LAC,BKN,LAC,3.5,Rebounds,5,4,1,5
22023,1629611,22300160,"NOV 08, 2023",LAC @ BKN,L,19,0,2,0.0,0,2,0.0,0,0,0.0,0,4,4,1,0,0,2,1,0,-2,1,Terance Mann,LAC,BKN,LAC,11.5,Pts+Rebs,5,4,1,5
22023,1629611,22300160,"NOV 08, 2023",LAC @ BKN,L,19,0,2,0.0,0,2,0.0,0,0,0.0,0,4,4,1,0,0,2,1,0,-2,1,Terance Mann,LAC,BKN,LAC,0.5,Turnovers,5,4,1,5
22023,1630544,22300529,"JAN 11, 2024",OKC vs. POR,W,18,4,5,0.8,3,4,0.75,0,0,0.0,1,6,7,4,0,0,1,0,11,13,1,Tre Mann,OKC,OKC,POR,,,22,18,15,11
22023,1630544,22300419,"DEC 27, 2023",OKC vs. NYK,W,6,0,3,0.0,0,2,0.0,0,0,0.0,0,0,0,1,0,0,0,0,0,-5,1,Tre Mann,OKC,OKC,NYK,,,1,0,1,1
22023,1630544,22300411,"DEC 26, 2023",OKC vs. MIN,W,2,0,0,0.0,0,0,0.0,0,0,0.0,0,0,0,0,0,0,0,0,0,-2,1,Tre Mann,OKC,OKC,MIN,,,0,0,0,0
22023,1630544,22300379,"DEC 21, 2023",OKC vs. LAC,W,2,0,0,0.0,0,0,0.0,0,0,0.0,0,0,0,1,0,0,0,0,0,1,1,Tre Mann,OKC,OKC,LAC,,,1,0,1,1
22023,1630544,22300355,"DEC 18, 2023",OKC vs. MEM,W,7,0,0,0.0,0,0,0.0,0,0,0.0,0,0,0,2,0,0,1,0,0,-12,1,Tre Mann,OKC,OKC,MEM,,,2,0,2,2
22023,1630544,22300302,"DEC 11, 2023",OKC vs. UTA,W,13,2,6,0.333,0,1,0.0,0,0,0.0,0,2,2,0,0,0,1,2,4,-21,1,Tre Mann,OKC,OKC,UTA,,,6,6,4,2
22023,1630544,22301212,"DEC 06, 2023",OKC @ HOU,L,24,4,8,0.5,2,4,0.5,0,0,0.0,0,3,3,4,2,0,1,0,10,7,1,Tre Mann,OKC,HOU,OKC,,,17,13,14,7
22023,1630544,22300271,"NOV 30, 2023",OKC vs. LAL,W,3,0,0,0.0,0,0,0.0,0,0,0.0,0,1,1,2,0,0,0,0,0,3,1,Tre Mann,OKC,OKC,LAL,,,3,1,2,3
22023,1630544,22300215,"NOV 19, 2023",OKC @ POR,W,24,3,7,0.429,1,3,0.333,0,0,0.0,2,3,5,2,0,0,3,1,7,17,1,Tre Mann,OKC,POR,OKC,,,14,12,9,7
22023,1630544,22300021,"NOV 14, 2023",OKC vs. SAS,W,9,2,4,0.5,1,3,0.333,0,0,0.0,0,2,2,2,1,0,1,0,5,7,1,Tre Mann,OKC,OKC,SAS,,,9,7,7,4
22023,1630544,22300109,"OCT 30, 2023",OKC vs. DET,W,2,0,0,0.0,0,0,0.0,0,0,0.0,0,0,0,0,0,0,0,0,0,-8,1,Tre Mann,OKC,OKC,DET,,,0,0,0,0
22023,1630544,22300095,"OCT 29, 2023",OKC vs. DEN,L,8,5,7,0.714,1,2,0.5,1,1,1.0,1,3,4,1,0,0,1,0,12,-5,1,Tre Mann,OKC,OKC,DEN,,,17,16,13,5
22023,1630544,22300070,"OCT 25, 2023",OKC @ CHI,W,2,0,0,0.0,0,0,0.0,0,0,0.0,0,0,0,1,0,0,0,0,0,0,1,Tre Mann,OKC,CHI,OKC,,,1,0,1,1
22023,1626246,22300542,"JAN 13, 2024",HOU @ BOS,L,7,1,4,0.25,0,0,0.0,0,1,0.0,1,2,3,0,0,0,0,1,2,0,1,Boban Marjanovic,HOU,BOS,HOU,,,5,5,2,3
22023,1626246,22300485,"JAN 05, 2024",HOU vs. MIN,L,4,1,3,0.333,0,0,0.0,0,0,0.0,2,1,3,0,0,0,0,0,2,-3,1,Boban Marjanovic,HOU,HOU,MIN,,,5,5,2,3
22023,1626246,22300453,"JAN 01, 2024",HOU vs. DET,W,6,0,2,0.0,0,1,0.0,0,0,0.0,0,1,1,1,0,0,0,1,0,-10,1,Boban Marjanovic,HOU,HOU,DET,,,2,1,1,2
22023,1626246,22300163,"NOV 08, 2023",HOU vs. LAL,W,6,3,4,0.75,0,0,0.0,0,1,0.0,2,5,7,0,0,0,0,1,6,3,1,Boban Marjanovic,HOU,HOU,LAL,,,13,13,6,7
22023,1626246,22300153,"NOV 06, 2023",HOU vs. SAC,W,7,0,3,0.0,0,1,0.0,0,0,0.0,0,1,1,2,0,1,0,0,0,-11,1,Boban Marjanovic,HOU,HOU,SAC,,,3,1,2,3
22023,1626246,22300083,"OCT 27, 2023",HOU @ SAS,L,7,2,2,1.0,0,0,0.0,0,0,0.0,0,0,0,1,0,0,0,1,4,3,1,Boban Marjanovic,HOU,SAS,HOU,,,5,4,5,1
22023,1628374,22300564,"JAN 15, 2024",UTA vs. IND,W,28,10,15,0.667,2,4,0.5,10,10,1.0,2,8,10,3,0,0,1,1,32,25,1,Lauri Markkanen,UTA,UTA,IND,,,45,42,35,13
22023,1628374,22300549,"JAN 13, 2024",UTA vs. LAL,W,33,8,16,0.5,3,6,0.5,10,11,0.909,2,7,9,5,2,1,0,0,29,16,1,Lauri Markkanen,UTA,UTA,LAL,,,43,38,34,14
22023,1628374,22300540,"JAN 12, 2024",UTA vs. TOR,W,29,7,11,0.636,4,6,0.667,4,5,0.8,3,6,9,2,1,0,3,2,22,19,1,Lauri Markkanen,UTA,UTA,TOR,,,33,31,24,11
22023,1628374,22300524,"JAN 10, 2024",UTA vs. DEN,W,32,6,13,0.462,2,5,0.4,12,12,1.0,2,10,12,2,0,1,0,2,26,17,1,Lauri Markkanen,UTA,UTA,DEN,,,40,38,28,14
22023,1628374,22300510,"JAN 08, 2024",UTA @ MIL,W,32,5,15,0.333,4,10,0.4,7,8,0.875,4,10,14,2,1,2,0,1,21,8,1,Lauri Markkanen,UTA,MIL,UTA,,,37,35,23,16
22023,1628374,22300495,"JAN 06, 2024",UTA @ PHI,W,35,12,19,0.632,5,9,0.556,4,5,0.8,4,9,13,1,0,1,1,2,33,8,1,Lauri Markkanen,UTA,PHI,UTA,,,47,46,34,14
22023,1628374,22300479,"JAN 05, 2024",UTA @ BOS,L,23,7,16,0.438,2,7,0.286,1,2,0.5,4,1,5,5,0,0,0,1,17,-14,1,Lauri Markkanen,UTA,BOS,UTA,,,27,22,22,10
22023,1628374,22300474,"JAN 03, 2024",UTA vs. DET,W,38,10,18,0.556,4,8,0.5,7,8,0.875,2,5,7,0,0,1,1,1,31,12,1,Lauri Markkanen,UTA,UTA,DET,,,38,38,31,7
22023,1628374,22300457,"JAN 01, 2024",UTA vs. DAL,W,25,6,12,0.5,4,8,0.5,1,1,1.0,2,2,4,1,1,1,1,0,17,8,1,Lauri Markkanen,UTA,UTA,DAL,,,22,21,18,5
22023,1628374,22300439,"DEC 30, 2023",UTA vs. MIA,W,26,4,13,0.308,1,8,0.125,3,4,0.75,2,3,5,1,2,0,0,4,12,1,1,Lauri Markkanen,UTA,UTA,MIA,,,18,17,13,6
22023,1628374,22300424,"DEC 28, 2023",UTA @ NOP,L,35,7,19,0.368,3,12,0.25,7,7,1.0,6,4,10,5,1,0,2,0,24,2,1,Lauri Markkanen,UTA,NOP,UTA,,,39,34,29,15
22023,1628374,22300412,"DEC 26, 2023",UTA @ SAS,W,31,12,17,0.706,5,9,0.556,2,2,1.0,3,9,12,2,1,0,1,3,31,20,1,Lauri Markkanen,UTA,SAS,UTA,,,45,43,33,14
22023,1628374,22300395,"DEC 23, 2023",UTA @ TOR,W,39,12,21,0.571,4,10,0.4,2,2,1.0,2,7,9,5,3,0,1,2,30,9,1,Lauri Markkanen,UTA,TOR,UTA,,,44,39,35,14
22023,1628374,22300364,"DEC 20, 2023",UTA @ CLE,L,36,8,18,0.444,3,9,0.333,7,8,0.875,2,8,10,1,0,0,0,3,26,-7,1,Lauri Markkanen,UTA,CLE,UTA,,,37,36,27,11
22023,1628374,22300357,"DEC 18, 2023",UTA vs. BKN,W,29,6,14,0.429,1,5,0.2,7,7,1.0,1,9,10,4,0,1,2,1,20,15,1,Lauri Markkanen,UTA,UTA,BKN,,,34,30,24,14
22023,1628374,22300342,"DEC 16, 2023",UTA @ SAC,L,28,7,13,0.538,2,5,0.4,2,2,1.0,1,5,6,3,0,0,2,2,18,-2,1,Lauri Markkanen,UTA,SAC,UTA,,,27,24,21,9
22023,1628374,22300318,"DEC 13, 2023",UTA vs. NYK,W,25,7,13,0.538,4,8,0.5,5,7,0.714,0,7,7,0,0,0,0,2,23,-14,1,Lauri Markkanen,UTA,UTA,NYK,,,30,30,23,7
22023,1628374,22300237,"NOV 22, 2023",UTA @ POR,L,34,9,18,0.5,1,6,0.167,5,6,0.833,3,5,8,0,3,0,2,2,24,-1,1,Lauri Markkanen,UTA,POR,UTA,,,32,32,24,8
22023,1628374,22300042,"NOV 21, 2023",UTA @ LAL,L,23,4,10,0.4,2,7,0.286,0,0,0.0,1,7,8,0,1,0,0,2,10,-9,1,Lauri Markkanen,UTA,LAL,UTA,,,18,18,10,8
22023,1628374,22300214,"NOV 19, 2023",UTA vs. PHX,L,50,15,27,0.556,2,10,0.2,6,9,0.667,7,10,17,0,2,2,1,3,38,2,1,Lauri Markkanen,UTA,UTA,PHX,,,55,55,38,17
22023,1628374,22300035,"NOV 17, 2023",UTA vs. PHX,L,40,5,12,0.417,1,4,0.25,10,12,0.833,0,2,2,0,1,2,0,1,21,1,1,Lauri Markkanen,UTA,UTA,PHX,,,23,23,21,2
22023,1628374,22300023,"NOV 14, 2023",UTA vs. POR,W,31,8,18,0.444,2,9,0.222,3,4,0.75,1,8,9,0,1,1,0,1,21,9,1,Lauri Markkanen,UTA,UTA,POR,,,30,30,21,9
22023,1628374,22300012,"NOV 10, 2023",UTA @ MEM,W,37,8,13,0.615,4,9,0.444,6,6,1.0,0,7,7,1,2,2,3,3,26,-1,1,Lauri Markkanen,UTA,MEM,UTA,,,34,33,27,8
22023,1628374,22300158,"NOV 08, 2023",UTA @ IND,L,35,8,16,0.5,3,5,0.6,5,6,0.833,5,4,9,0,1,1,1,1,24,-12,1,Lauri Markkanen,UTA,IND,UTA,,,33,33,24,9
22023,1628374,22300152,"NOV 06, 2023",UTA @ CHI,L,34,8,15,0.533,5,12,0.417,8,8,1.0,1,4,5,3,0,1,1,2,29,-12,1,Lauri Markkanen,UTA,CHI,UTA,,,37,34,32,8
22023,1628374,22300138,"NOV 04, 2023",UTA @ MIN,L,35,7,20,0.35,4,11,0.364,4,5,0.8,4,4,8,1,0,1,2,4,22,-16,1,Lauri Markkanen,UTA,MIN,UTA,,,31,30,23,9
22023,1628374,22300130,"NOV 02, 2023",UTA vs. ORL,L,33,9,17,0.529,4,10,0.4,0,2,0.0,1,6,7,1,2,0,3,4,22,2,1,Lauri Markkanen,UTA,UTA,ORL,,,30,29,23,8
22023,1628374,22300125,"NOV 01, 2023",UTA vs. MEM,W,28,6,11,0.545,4,6,0.667,3,3,1.0,1,10,11,1,1,0,0,5,19,10,1,Lauri Markkanen,UTA,UTA,MEM,,,31,30,20,12
22023,1628374,22300110,"OCT 30, 2023",UTA @ DEN,L,38,10,24,0.417,5,13,0.385,2,2,1.0,5,9,14,5,0,1,2,2,27,3,1,Lauri Markkanen,UTA,DEN,UTA,,,46,41,32,19
22023,1628374,22300094,"OCT 28, 2023",UTA @ PHX,L,28,7,13,0.538,5,7,0.714,0,0,0.0,0,3,3,0,1,2,1,1,19,-21,1,Lauri Markkanen,UTA,PHX,UTA,,,22,22,19,3
22023,1628374,22300085,"OCT 27, 2023",UTA vs. LAC,W,35,12,23,0.522,5,13,0.385,6,6,1.0,5,7,12,3,0,0,3,2,35,11,1,Lauri Markkanen,UTA,UTA,LAC,,,50,47,38,15
22023,1628374,22300072,"OCT 25, 2023",UTA vs. SAC,L,32,6,15,0.4,2,6,0.333,5,6,0.833,2,8,10,1,2,0,1,1,19,-7,1,Lauri Markkanen,UTA,UTA,SAC,,,30,29,20,11
22023,1630230,22300556,"JAN 15, 2024",NOP @ DAL,L,9,0,1,0.0,0,0,0.0,0,0,0.0,0,1,1,0,1,0,1,5,0,15,1,Naji Marshall,NOP,DAL,NOP,,,1,1,0,1
22023,1630230,22300547,"JAN 13, 2024",NOP @ DAL,W,31,5,12,0.417,2,4,0.5,1,2,0.5,1,5,6,1,0,0,2,3,13,-7,1,Naji Marshall,NOP,DAL,NOP,,,20,19,14,7
22023,1630230,22300539,"JAN 12, 2024",NOP @ DEN,L,12,2,5,0.4,0,2,0.0,2,2,1.0,1,1,2,0,0,0,0,0,6,-5,1,Naji Marshall,NOP,DEN,NOP,,,8,8,6,2
22023,1630230,22300525,"JAN 10, 2024",NOP @ GSW,W,13,5,6,0.833,0,0,0.0,2,2,1.0,0,3,3,2,1,0,1,1,12,1,1,Naji Marshall,NOP,GSW,NOP,,,17,15,14,5
22023,1630230,22300500,"JAN 07, 2024",NOP @ SAC,W,22,3,4,0.75,1,1,1.0,4,4,1.0,2,4,6,2,0,0,1,2,11,20,1,Naji Marshall,NOP,SAC,NOP,,,19,17,13,8
22023,1630230,22300486,"JAN 05, 2024",NOP vs. LAC,L,17,4,9,0.444,1,1,1.0,0,0,0.0,3,0,3,1,1,0,2,2,9,3,1,Naji Marshall,NOP,NOP,LAC,,,13,12,10,4
22023,1630230,22300471,"JAN 03, 2024",NOP @ MIN,W,14,1,4,0.25,0,2,0.0,0,0,0.0,0,2,2,0,1,0,0,4,2,-10,1,Naji Marshall,NOP,MIN,NOP,,,4,4,2,2
22023,1630230,22300461,"JAN 02, 2024",NOP vs. BKN,W,16,2,6,0.333,0,2,0.0,2,2,1.0,1,1,2,1,1,1,0,0,6,8,1,Naji Marshall,NOP,NOP,BKN,,,9,8,7,3
22023,1630230,22300446,"DEC 31, 2023",NOP vs. LAL,W,21,3,8,0.375,0,3,0.0,0,0,0.0,2,3,5,3,0,0,0,2,6,10,1,Naji Marshall,NOP,NOP,LAL,,,14,11,9,8
22023,1630230,22300424,"DEC 28, 2023",NOP vs. UTA,W,16,4,5,0.8,1,1,1.0,0,0,0.0,0,2,2,2,0,0,3,1,9,4,1,Naji Marshall,NOP,NOP,UTA,,,13,11,11,4
22023,1630230,22300410,"DEC 26, 2023",NOP vs. MEM,L,14,1,5,0.2,0,3,0.0,0,0,0.0,0,1,1,1,0,0,1,2,2,-6,1,Naji Marshall,NOP,NOP,MEM,,,4,3,3,2
22023,1630230,22300392,"DEC 23, 2023",NOP vs. HOU,L,12,2,2,1.0,0,0,0.0,2,3,0.667,1,1,2,2,0,0,0,1,6,4,1,Naji Marshall,NOP,NOP,HOU,,,10,8,8,4
22023,1630230,22300375,"DEC 21, 2023",NOP @ CLE,W,22,4,11,0.364,1,4,0.25,5,7,0.714,3,3,6,3,1,0,1,1,14,16,1,Naji Marshall,NOP,CLE,NOP,,,23,20,17,9
22023,1630230,22300360,"DEC 19, 2023",NOP vs. MEM,L,17,1,7,0.143,1,4,0.25,0,0,0.0,1,1,2,1,0,0,1,0,3,-11,1,Naji Marshall,NOP,NOP,MEM,,,6,5,4,3
22023,1630230,22300345,"DEC 17, 2023",NOP @ SAS,W,20,4,6,0.667,3,4,0.75,0,2,0.0,0,3,3,7,2,0,2,3,11,32,1,Naji Marshall,NOP,SAS,NOP,,,21,14,18,10
22023,1630230,22300326,"DEC 15, 2023",NOP @ CHA,W,13,1,4,0.25,1,2,0.5,0,0,0.0,0,1,1,1,0,0,0,0,3,-11,1,Naji Marshall,NOP,CHA,NOP,,,5,4,4,2
22023,1630230,22300311,"DEC 13, 2023",NOP @ WAS,W,28,6,11,0.545,2,5,0.4,2,2,1.0,0,4,4,7,2,0,1,1,16,37,1,Naji Marshall,NOP,WAS,NOP,,,27,20,23,11
22023,1630230,22300301,"DEC 11, 2023",NOP vs. MIN,W,14,2,4,0.5,1,2,0.5,0,0,0.0,0,5,5,1,0,1,1,2,5,-10,1,Naji Marshall,NOP,NOP,MIN,,,11,10,6,6
22023,1630230,22301230,"DEC 07, 2023",NOP @ LAL,L,12,1,2,0.5,1,1,1.0,2,2,1.0,2,2,4,0,0,0,1,1,5,-17,1,Naji Marshall,NOP,LAL,NOP,,,9,9,5,4
22023,1630230,22301204,"DEC 04, 2023",NOP @ SAC,W,13,1,3,0.333,0,2,0.0,2,2,1.0,2,2,4,2,1,0,1,1,4,7,1,Naji Marshall,NOP,SAC,NOP,,,10,8,6,6
22023,1630230,22300285,"DEC 02, 2023",NOP @ CHI,L,27,2,7,0.286,1,4,0.25,2,2,1.0,2,1,3,2,1,0,1,3,7,-8,1,Naji Marshall,NOP,CHI,NOP,,,12,10,9,5
22023,1630230,22300278,"DEC 01, 2023",NOP vs. SAS,W,19,3,4,0.75,1,1,1.0,3,3,1.0,2,4,6,0,0,0,2,1,10,5,1,Naji Marshall,NOP,NOP,SAS,,,16,16,10,6
22023,1630230,22300262,"NOV 29, 2023",NOP vs. PHI,W,19,1,4,0.25,1,3,0.333,1,2,0.5,2,1,3,3,1,1,1,1,4,-3,1,Naji Marshall,NOP,NOP,PHI,,,10,7,7,6
22023,1630230,22300256,"NOV 27, 2023",NOP @ UTA,L,28,6,12,0.5,1,3,0.333,1,2,0.5,2,7,9,3,3,0,1,3,14,6,1,Naji Marshall,NOP,UTA,NOP,,,26,23,17,12
22023,1630230,22300243,"NOV 25, 2023",NOP @ UTA,L,21,2,6,0.333,1,2,0.5,0,0,0.0,0,3,3,4,0,0,0,1,5,-2,1,Naji Marshall,NOP,UTA,NOP,,,12,8,9,7
22023,1630230,22300052,"NOV 24, 2023",NOP @ LAC,W,27,0,7,0.0,0,3,0.0,5,6,0.833,2,6,8,1,0,0,0,1,5,-3,1,Naji Marshall,NOP,LAC,NOP,,,14,13,6,9
22023,1630230,22300233,"NOV 22, 2023",NOP vs. SAC,W,20,4,5,0.8,2,2,1.0,2,3,0.667,2,4,6,4,1,1,1,0,12,25,1,Naji Marshall,NOP,NOP,SAC,,,22,18,16,10
22023,1630230,22300222,"NOV 20, 2023",NOP vs. SAC,W,26,5,11,0.455,1,5,0.2,0,0,0.0,1,6,7,4,1,0,3,2,11,2,1,Naji Marshall,NOP,NOP,SAC,,,22,18,15,11
22023,1630230,22300203,"NOV 18, 2023",NOP vs. MIN,L,24,2,4,0.5,1,2,0.5,2,3,0.667,0,1,1,1,1,0,2,2,7,-7,1,Naji Marshall,NOP,NOP,MIN,,,9,8,8,2
22023,1630230,22300034,"NOV 17, 2023",NOP vs. DEN,W,18,4,6,0.667,4,5,0.8,0,0,0.0,0,5,5,1,1,0,2,0,12,-1,1,Naji Marshall,NOP,NOP,DEN,,,18,17,13,6
22023,1630230,22300022,"NOV 14, 2023",NOP vs. DAL,W,21,5,9,0.556,1,4,0.25,5,5,1.0,2,2,4,2,1,2,1,2,16,2,1,Naji Marshall,NOP,NOP,DAL,,,22,20,18,6
22023,1630230,22300183,"NOV 12, 2023",NOP vs. DAL,L,14,2,3,0.667,1,1,1.0,3,3,1.0,1,1,2,2,0,0,2,2,8,4,1,Naji Marshall,NOP,NOP,DAL,,,12,10,10,4
22023,1628997,22300562,"JAN 15, 2024",MIA @ BKN,W,34,3,8,0.375,1,4,0.25,2,2,1.0,0,3,3,1,1,1,1,1,9,-9,1,Caleb Martin,MIA,BKN,MIA,,,13,12,10,4
22023,1628997,22300551,"JAN 14, 2024",MIA vs. CHA,W,25,1,5,0.2,0,2,0.0,0,0,0.0,0,3,3,2,1,0,1,2,2,13,1,Caleb Martin,MIA,MIA,CHA,,,7,5,4,5
22023,1628997,22300535,"JAN 12, 2024",MIA vs. ORL,W,24,3,6,0.5,1,2,0.5,4,4,1.0,0,4,4,2,1,0,0,1,11,3,1,Caleb Martin,MIA,MIA,ORL,,,17,15,13,6
22023,1628997,22300404,"DEC 25, 2023",MIA vs. PHI,W,9,0,0,0.0,0,0,0.0,1,2,0.5,1,4,5,1,0,0,2,1,1,-5,1,Caleb Martin,MIA,MIA,PHI,,,7,6,2,6
22023,1628997,22300384,"DEC 22, 2023",MIA vs. ATL,W,35,4,9,0.444,2,4,0.5,1,1,1.0,2,6,8,2,1,1,0,4,11,-1,1,Caleb Martin,MIA,MIA,ATL,,,21,19,13,10
22023,1628997,22300366,"DEC 20, 2023",MIA @ ORL,W,18,1,3,0.333,1,1,1.0,2,2,1.0,0,5,5,0,1,0,1,2,5,3,1,Caleb Martin,MIA,ORL,MIA,,,10,10,5,5
22023,1628997,22300353,"DEC 18, 2023",MIA vs. MIN,L,22,1,5,0.2,0,1,0.0,0,0,0.0,1,2,3,3,2,0,1,1,2,3,1,Caleb Martin,MIA,MIA,MIN,,,8,5,5,6
22023,1628997,22300337,"DEC 16, 2023",MIA vs. CHI,W,37,6,8,0.75,0,0,0.0,5,8,0.625,2,2,4,2,2,0,2,4,17,9,1,Caleb Martin,MIA,MIA,CHI,,,23,21,19,6
22023,1628997,22300320,"DEC 14, 2023",MIA vs. CHI,L,39,7,13,0.538,3,4,0.75,0,0,0.0,2,10,12,4,0,0,1,3,17,-9,1,Caleb Martin,MIA,MIA,CHI,,,33,29,21,16
22023,1628997,22300312,"DEC 13, 2023",MIA vs. CHA,W,36,4,13,0.308,1,3,0.333,0,0,0.0,3,3,6,4,0,1,4,2,9,5,1,Caleb Martin,MIA,MIA,CHA,,,19,15,13,10
22023,1628997,22300292,"DEC 11, 2023",MIA @ CHA,W,39,7,14,0.5,1,4,0.25,5,7,0.714,2,7,9,5,0,0,3,3,20,0,1,Caleb Martin,MIA,CHA,MIA,,,34,29,25,14
22023,1628997,22301220,"DEC 08, 2023",MIA vs. CLE,L,34,6,15,0.4,3,8,0.375,0,2,0.0,1,5,6,4,0,2,1,5,15,-18,1,Caleb Martin,MIA,MIA,CLE,,,25,21,19,10
22023,1628997,22301207,"DEC 06, 2023",MIA @ TOR,W,31,9,16,0.563,4,7,0.571,2,4,0.5,2,10,12,3,0,1,0,1,24,17,1,Caleb Martin,MIA,TOR,MIA,,,39,36,27,15
22023,1628997,22300284,"DEC 02, 2023",MIA vs. IND,L,35,8,15,0.533,2,4,0.5,0,0,0.0,1,1,2,3,1,0,3,3,18,-8,1,Caleb Martin,MIA,MIA,IND,,,23,20,21,5
22023,1628997,22300267,"NOV 30, 2023",MIA vs. IND,W,25,5,9,0.556,0,2,0.0,4,6,0.667,2,3,5,3,1,0,4,4,14,15,1,Caleb Martin,MIA,MIA,IND,,,22,19,17,8
22023,1628997,22300056,"NOV 28, 2023",MIA vs. MIL,L,26,6,11,0.545,2,3,0.667,0,0,0.0,0,1,1,1,1,0,0,2,14,5,1,Caleb Martin,MIA,MIA,MIL,,,16,15,15,2
22023,1628997,22300240,"NOV 25, 2023",MIA @ BKN,L,31,9,18,0.5,1,4,0.25,3,3,1.0,4,3,7,3,0,0,2,2,22,8,1,Caleb Martin,MIA,BKN,MIA,,,32,29,25,10
22023,1628997,22300045,"NOV 24, 2023",MIA @ NYK,L,18,1,5,0.2,0,3,0.0,0,0,0.0,0,3,3,1,1,0,0,3,2,-1,1,Caleb Martin,MIA,NYK,MIA,,,6,5,3,4
22023,1628997,22300229,"NOV 22, 2023",MIA @ CLE,W,26,5,12,0.417,2,5,0.4,2,2,1.0,0,3,3,1,3,0,1,0,14,12,1,Caleb Martin,MIA,CLE,MIA,,,18,17,15,4
22023,1628997,22300220,"NOV 20, 2023",MIA @ CHI,W,21,1,6,0.167,0,3,0.0,0,0,0.0,0,4,4,2,1,0,0,1,2,3,1,Caleb Martin,MIA,CHI,MIA,,,8,6,4,6
22023,1628997,22300204,"NOV 18, 2023",MIA @ CHI,L,15,2,9,0.222,1,4,0.25,0,0,0.0,1,1,2,0,1,0,1,1,5,-14,1,Caleb Martin,MIA,CHI,MIA,,,7,7,5,2
22023,1628997,22300200,"NOV 16, 2023",MIA vs. BKN,W,12,2,4,0.5,2,3,0.667,0,0,0.0,1,0,1,2,0,0,1,2,6,-5,1,Caleb Martin,MIA,MIA,BKN,,,9,7,8,3
22023,1628997,22300068,"OCT 25, 2023",MIA vs. DET,W,20,1,7,0.143,0,3,0.0,0,0,0.0,1,2,3,1,1,0,0,1,2,-5,1,Caleb Martin,MIA,MIA,DET,,,6,5,3,4
22023,1628998,22300551,"JAN 14, 2024",CHA @ MIA,L,23,1,3,0.333,1,2,0.5,0,0,0.0,2,0,2,2,0,2,3,1,3,-8,1,Cody Martin,CHA,MIA,CHA,,,7,5,5,4
22023,1628998,22300484,"JAN 05, 2024",CHA @ CHI,L,36,5,11,0.455,3,7,0.429,0,0,0.0,2,3,5,2,2,0,1,4,13,-14,1,Cody Martin,CHA,CHI,CHA,,,20,18,15,7
22023,1628998,22300464,"JAN 02, 2024",CHA @ SAC,W,33,4,10,0.4,1,5,0.2,1,2,0.5,0,2,2,2,1,0,1,2,10,-8,1,Cody Martin,CHA,SAC,CHA,,,14,12,12,4
22023,1628998,22300455,"JAN 01, 2024",CHA @ DEN,L,25,0,6,0.0,0,3,0.0,2,4,0.5,1,2,3,6,2,2,0,0,2,-2,1,Cody Martin,CHA,DEN,CHA,,,11,5,8,9
22023,1628998,22300436,"DEC 29, 2023",CHA @ PHX,L,27,5,10,0.5,3,4,0.75,0,0,0.0,3,1,4,1,2,1,1,1,13,-10,1,Cody Martin,CHA,PHX,CHA,,,18,17,14,5
22023,1628998,22300428,"DEC 28, 2023",CHA @ LAL,L,20,2,7,0.286,0,3,0.0,1,4,0.25,2,2,4,2,1,0,2,1,5,-19,1,Cody Martin,CHA,LAL,CHA,,,11,9,7,6
22023,1628998,22300414,"DEC 26, 2023",CHA @ LAC,L,25,3,8,0.375,1,2,0.5,0,0,0.0,0,2,2,2,4,1,0,2,7,3,1,Cody Martin,CHA,LAC,CHA,,,11,9,9,4
22023,1628998,22300390,"DEC 23, 2023",CHA vs. DEN,L,17,3,5,0.6,0,0,0.0,0,0,0.0,0,0,0,0,0,0,1,1,6,5,1,Cody Martin,CHA,CHA,DEN,,,6,6,6,0
22023,1630231,22300555,"JAN 15, 2024",PHI vs. HOU,W,6,0,1,0.0,0,0,0.0,0,0,0.0,0,1,1,0,0,0,0,1,0,-10,1,KJ Martin,PHI,PHI,HOU,,,1,1,0,1
22023,1630231,22300532,"JAN 12, 2024",PHI vs. SAC,W,3,1,1,1.0,0,0,0.0,0,0,0.0,0,0,0,0,0,0,0,0,2,1,1,KJ Martin,PHI,PHI,SAC,,,2,2,2,0
22023,1630231,22300521,"JAN 10, 2024",PHI @ ATL,L,6,0,0,0.0,0,0,0.0,0,0,0.0,0,0,0,0,0,0,1,1,0,2,1,KJ Martin,PHI,ATL,PHI,,,0,0,0,0
22023,1630231,22300495,"JAN 06, 2024",PHI vs. UTA,L,17,4,7,0.571,0,1,0.0,1,2,0.5,1,1,2,1,1,0,0,4,9,-1,1,KJ Martin,PHI,PHI,UTA,,,12,11,10,3
22023,1630231,22300483,"JAN 05, 2024",PHI vs. NYK,L,7,0,0,0.0,0,0,0.0,0,0,0.0,0,0,0,0,0,0,0,2,0,-12,1,KJ Martin,PHI,PHI,NYK,,,0,0,0,0
22023,1630231,22300459,"JAN 02, 2024",PHI vs. CHI,W,9,0,3,0.0,0,0,0.0,0,0,0.0,0,0,0,1,0,0,0,0,0,-17,1,KJ Martin,PHI,PHI,CHI,,,1,0,1,1
22023,1630231,22300442,"DEC 30, 2023",PHI @ CHI,L,8,1,2,0.5,0,1,0.0,0,0,0.0,0,1,1,0,0,0,0,0,2,4,1,KJ Martin,PHI,CHI,PHI,,,3,3,2,1
22023,1630231,22300415,"DEC 27, 2023",PHI @ ORL,W,1,0,0,0.0,0,0,0.0,0,0,0.0,0,0,0,0,0,0,0,0,0,-3,1,KJ Martin,PHI,ORL,PHI,,,0,0,0,0
22023,1630231,22300404,"DEC 25, 2023",PHI @ MIA,L,6,1,1,1.0,0,0,0.0,0,0,0.0,0,0,0,1,1,0,0,0,2,-7,1,KJ Martin,PHI,MIA,PHI,,,3,2,3,1
22023,1630231,22300382,"DEC 22, 2023",PHI vs. TOR,W,1,0,0,0.0,0,0,0.0,0,0,0.0,0,0,0,0,0,0,0,0,0,-3,1,KJ Martin,PHI,PHI,TOR,,,0,0,0,0
22023,1630231,22300367,"DEC 20, 2023",PHI vs. MIN,W,7,1,1,1.0,0,0,0.0,1,2,0.5,0,0,0,0,0,0,0,1,3,11,1,KJ Martin,PHI,PHI,MIN,,,3,3,3,0
22023,1630231,22300335,"DEC 16, 2023",PHI @ CHA,W,4,0,0,0.0,0,0,0.0,0,0,0.0,0,0,0,2,2,0,0,1,0,6,1,KJ Martin,PHI,CHA,PHI,,,2,0,2,2
22023,1630231,22300327,"DEC 15, 2023",PHI vs. DET,W,7,2,3,0.667,0,0,0.0,0,0,0.0,1,0,1,1,0,0,0,0,4,-6,1,KJ Martin,PHI,PHI,DET,,,6,5,5,2
22023,1630231,22300310,"DEC 13, 2023",PHI @ DET,W,4,1,1,1.0,0,0,0.0,0,0,0.0,1,1,2,1,1,0,0,0,2,-6,1,KJ Martin,PHI,DET,PHI,,,5,4,3,3
22023,1630231,22300295,"DEC 11, 2023",PHI vs. WAS,W,6,1,1,1.0,0,0,0.0,0,0,0.0,0,1,1,1,0,0,0,1,2,3,1,KJ Martin,PHI,PHI,WAS,,,4,3,3,2
22023,1630231,22300275,"DEC 01, 2023",PHI @ BOS,L,13,1,5,0.2,0,0,0.0,0,0,0.0,0,2,2,0,2,0,0,1,2,0,1,KJ Martin,PHI,BOS,PHI,,,4,4,2,2
22023,1630231,22300262,"NOV 29, 2023",PHI @ NOP,L,17,2,4,0.5,0,1,0.0,0,0,0.0,0,2,2,2,0,0,2,4,4,4,1,KJ Martin,PHI,NOP,PHI,,,8,6,6,4
22023,1630231,22300255,"NOV 27, 2023",PHI vs. LAL,W,5,0,0,0.0,0,0,0.0,1,2,0.5,1,1,2,0,0,0,0,1,1,13,1,KJ Martin,PHI,PHI,LAL,,,3,3,1,2
22023,1630231,22300232,"NOV 22, 2023",PHI @ MIN,L,6,1,2,0.5,0,0,0.0,1,2,0.5,0,1,1,0,1,0,0,2,3,8,1,KJ Martin,PHI,MIN,PHI,,,4,4,3,1
22023,1630231,22300208,"NOV 19, 2023",PHI @ BKN,W,4,0,0,0.0,0,0,0.0,0,0,0.0,1,0,1,0,0,0,0,1,0,-1,1,KJ Martin,PHI,BKN,PHI,,,1,1,0,1
22023,1630231,22300019,"NOV 14, 2023",PHI vs. IND,L,1,0,0,0.0,0,0,0.0,0,0,0.0,0,0,0,0,0,0,0,0,0,0,1,KJ Martin,PHI,PHI,IND,,,0,0,0,0
22023,1630231,22300148,"NOV 06, 2023",PHI vs. WAS,W,4,0,1,0.0,0,0,0.0,0,0,0.0,0,1,1,1,0,0,0,0,0,-6,1,KJ Martin,PHI,PHI,WAS,,,2,1,1,2
22023,1630231,22300132,"NOV 04, 2023",PHI vs. PHX,W,2,0,0,0.0,0,0,0.0,0,0,0.0,0,0,0,0,0,0,1,1,0,-5,1,KJ Martin,PHI,PHI,PHX,,,0,0,0,0
22023,1630231,22300128,"NOV 02, 2023",PHI vs. TOR,W,1,0,0,0.0,0,0,0.0,0,0,0.0,0,0,0,0,0,0,0,1,0,-2,1,KJ Martin,PHI,PHI,TOR,,,0,0,0,0
22023,1630231,22300099,"OCT 29, 2023",LAC vs. SAS,W,18,4,6,0.667,1,3,0.333,1,2,0.5,0,2,2,0,1,1,2,1,10,13,1,KJ Martin,LAC,LAC,SAS,,,12,12,10,2
22023,1630231,22300074,"OCT 25, 2023",LAC vs. POR,W,14,0,4,0.0,0,2,0.0,0,0,0.0,1,0,1,1,1,0,0,2,0,-17,1,KJ Martin,LAC,LAC,POR,,,2,1,1,2
22023,1629726,22300559,"JAN 15, 2024",ATL vs. SAS,W,13,2,4,0.5,2,4,0.5,0,0,0.0,0,0,0,0,0,0,0,0,6,17,1,Garrison Mathews,ATL,ATL,SAS,,,6,6,6,0
22023,1629726,22300543,"JAN 13, 2024",ATL vs. WAS,L,15,3,6,0.5,2,5,0.4,0,2,0.0,0,2,2,1,0,0,1,1,8,-4,1,Garrison Mathews,ATL,ATL,WAS,,,11,10,9,3
22023,1629726,22300499,"JAN 07, 2024",ATL @ ORL,L,2,0,0,0.0,0,0,0.0,0,0,0.0,0,0,0,0,0,0,0,0,0,-1,1,Garrison Mathews,ATL,ORL,ATL,,,0,0,0,0
22023,1629726,22300480,"JAN 05, 2024",ATL @ IND,L,19,2,3,0.667,2,3,0.667,0,0,0.0,1,2,3,2,0,0,1,1,6,-9,1,Garrison Mathews,ATL,IND,ATL,,,11,9,8,5
22023,1629726,22300467,"JAN 03, 2024",ATL vs. OKC,W,17,2,3,0.667,1,2,0.5,0,1,0.0,0,0,0,2,0,0,1,1,5,-8,1,Garrison Mathews,ATL,ATL,OKC,,,7,5,7,2
22023,1629726,22300445,"DEC 31, 2023",ATL @ WAS,W,14,0,0,0.0,0,0,0.0,0,0,0.0,1,1,2,1,0,1,0,1,0,4,1,Garrison Mathews,ATL,WAS,ATL,,,3,2,1,3
22023,1629726,22300431,"DEC 29, 2023",ATL vs. SAC,L,8,1,2,0.5,1,2,0.5,0,0,0.0,0,1,1,0,1,0,0,1,3,7,1,Garrison Mathews,ATL,ATL,SAC,,,4,4,3,1
22023,1629726,22300408,"DEC 26, 2023",ATL @ CHI,L,13,2,2,1.0,2,2,1.0,0,0,0.0,0,1,1,0,0,0,0,3,6,-3,1,Garrison Mathews,ATL,CHI,ATL,,,7,7,6,1
22023,1629726,22300393,"DEC 23, 2023",ATL vs. MEM,L,14,0,3,0.0,0,2,0.0,0,0,0.0,0,1,1,1,1,0,0,3,0,-6,1,Garrison Mathews,ATL,ATL,MEM,,,2,1,1,2
22023,1629726,22300384,"DEC 22, 2023",ATL @ MIA,L,18,0,3,0.0,0,3,0.0,0,0,0.0,0,1,1,1,0,0,0,4,0,-2,1,Garrison Mathews,ATL,MIA,ATL,,,2,1,1,2
22023,1629726,22300371,"DEC 20, 2023",ATL @ HOU,W,17,2,4,0.5,2,4,0.5,0,0,0.0,0,1,1,0,0,0,1,1,6,16,1,Garrison Mathews,ATL,HOU,ATL,,,7,7,6,1
22023,1629726,22300352,"DEC 18, 2023",ATL vs. DET,W,23,2,5,0.4,2,5,0.4,0,1,0.0,1,2,3,0,0,2,2,5,6,-8,1,Garrison Mathews,ATL,ATL,DET,,,9,9,6,3
22023,1629726,22300336,"DEC 16, 2023",ATL @ CLE,L,14,2,2,1.0,2,2,1.0,0,0,0.0,0,0,0,0,0,0,1,4,6,-10,1,Garrison Mathews,ATL,CLE,ATL,,,6,6,6,0
22023,1629726,22300330,"DEC 15, 2023",ATL @ TOR,W,18,2,2,1.0,2,2,1.0,0,0,0.0,0,1,1,0,1,0,0,2,6,1,1,Garrison Mathews,ATL,TOR,ATL,,,7,7,6,1
22023,1629726,22300313,"DEC 13, 2023",ATL @ TOR,L,19,2,2,1.0,2,2,1.0,0,0,0.0,0,2,2,0,1,0,0,2,6,3,1,Garrison Mathews,ATL,TOR,ATL,,,8,8,6,2
22023,1629726,22300296,"DEC 11, 2023",ATL vs. DEN,L,17,1,5,0.2,1,5,0.2,0,0,0.0,0,0,0,1,1,0,0,1,3,-9,1,Garrison Mathews,ATL,ATL,DEN,,,4,3,4,1
22023,1629726,22301218,"DEC 08, 2023",ATL @ PHI,L,3,0,1,0.0,0,1,0.0,0,0,0.0,0,1,1,0,0,0,0,0,0,-8,1,Garrison Mathews,ATL,PHI,ATL,,,1,1,0,1
22023,1629726,22301209,"DEC 06, 2023",ATL vs. BKN,L,7,0,0,0.0,0,0,0.0,0,0,0.0,0,1,1,0,1,0,1,3,0,-10,1,Garrison Mathews,ATL,ATL,BKN,,,1,1,0,1
22023,1629726,22300286,"DEC 02, 2023",ATL @ MIL,L,7,0,0,0.0,0,0,0.0,0,0,0.0,1,0,1,0,0,0,1,1,0,-5,1,Garrison Mathews,ATL,MIL,ATL,,,1,1,0,1
22023,1629726,22300272,"NOV 30, 2023",ATL @ SAS,W,12,1,4,0.25,1,4,0.25,0,0,0.0,0,1,1,0,1,0,0,1,3,0,1,Garrison Mathews,ATL,SAS,ATL,,,4,4,3,1
22023,1629726,22300055,"NOV 28, 2023",ATL @ CLE,L,4,0,1,0.0,0,1,0.0,0,0,0.0,0,1,1,0,0,0,0,0,0,0,1,Garrison Mathews,ATL,CLE,ATL,,,1,1,0,1
22023,1629726,22300241,"NOV 25, 2023",ATL @ WAS,W,14,2,3,0.667,2,3,0.667,0,0,0.0,1,1,2,1,0,0,0,1,6,1,1,Garrison Mathews,ATL,WAS,ATL,,,9,8,7,3
22023,1629726,22300018,"NOV 14, 2023",ATL @ DET,W,2,1,1,1.0,1,1,1.0,0,0,0.0,0,1,1,0,0,0,0,0,3,5,1,Garrison Mathews,ATL,DET,ATL,,,4,4,3,1
22023,1629726,22300155,"NOV 06, 2023",ATL @ OKC,L,4,0,2,0.0,0,2,0.0,0,0,0.0,0,1,1,0,0,0,0,0,0,-5,1,Garrison Mathews,ATL,OKC,ATL,,,1,1,0,1
22023,1629726,22300135,"NOV 04, 2023",ATL @ NOP,W,4,0,0,0.0,0,0,0.0,0,0,0.0,0,0,0,0,0,0,0,1,0,-6,1,Garrison Mathews,ATL,NOP,ATL,,,0,0,0,0
22023,1631097,22300564,"JAN 15, 2024",IND @ UTA,L,25,5,10,0.5,0,1,0.0,1,1,1.0,1,0,1,2,0,0,0,1,11,-18,1,Bennedict Mathurin,IND,UTA,IND,,,14,12,13,3
22023,1631097,22300550,"JAN 14, 2024",IND @ DEN,L,22,3,9,0.333,1,3,0.333,5,5,1.0,1,2,3,2,0,0,2,3,12,-7,1,Bennedict Mathurin,IND,DEN,IND,,,17,15,14,5
22023,1631097,22300533,"JAN 12, 2024",IND @ ATL,W,27,6,9,0.667,0,1,0.0,3,5,0.6,1,0,1,3,0,0,5,2,15,16,1,Bennedict Mathurin,IND,ATL,IND,,,19,16,18,4
22023,1631097,22300520,"JAN 10, 2024",IND vs. WAS,W,28,4,13,0.308,0,1,0.0,8,8,1.0,2,5,7,0,1,0,1,2,16,6,1,Bennedict Mathurin,IND,IND,WAS,,,23,23,16,7
22023,1631097,22300507,"JAN 08, 2024",IND vs. BOS,W,29,8,15,0.533,5,9,0.556,5,7,0.714,0,4,4,3,2,0,2,4,26,-2,1,Bennedict Mathurin,IND,IND,BOS,,,33,30,29,7
22023,1631097,22300493,"JAN 06, 2024",IND vs. BOS,L,35,7,14,0.5,0,3,0.0,6,9,0.667,2,2,4,2,2,1,2,2,20,-21,1,Bennedict Mathurin,IND,IND,BOS,,,26,24,22,6
22023,1631097,22300480,"JAN 05, 2024",IND vs. ATL,W,18,6,9,0.667,2,4,0.5,4,4,1.0,1,2,3,4,0,0,0,2,18,11,1,Bennedict Mathurin,IND,IND,ATL,,,25,21,22,7
22023,1631097,22300466,"JAN 03, 2024",IND vs. MIL,W,25,6,9,0.667,2,2,1.0,2,2,1.0,0,1,1,3,0,0,1,4,16,-3,1,Bennedict Mathurin,IND,IND,MIL,,,20,17,19,4
22023,1631097,22300454,"JAN 01, 2024",IND @ MIL,W,36,9,15,0.6,1,5,0.2,6,9,0.667,3,10,13,0,0,0,1,3,25,22,1,Bennedict Mathurin,IND,MIL,IND,,,38,38,25,13
22023,1631097,22300441,"DEC 30, 2023",IND vs. NYK,W,26,7,10,0.7,3,5,0.6,3,3,1.0,0,0,0,0,0,0,2,0,20,11,1,Bennedict Mathurin,IND,IND,NYK,,,20,20,20,0
22023,1631097,22300422,"DEC 28, 2023",IND @ CHI,W,26,5,9,0.556,1,3,0.333,4,5,0.8,2,3,5,1,0,1,3,1,15,2,1,Bennedict Mathurin,IND,CHI,IND,,,21,20,16,6
22023,1631097,22300409,"DEC 26, 2023",IND @ HOU,W,24,3,9,0.333,2,5,0.4,2,2,1.0,0,4,4,0,1,0,3,2,10,-6,1,Bennedict Mathurin,IND,HOU,IND,,,14,14,10,4
22023,1631097,22300391,"DEC 23, 2023",IND vs. ORL,L,16,1,5,0.2,0,2,0.0,0,0,0.0,0,2,2,1,0,0,1,1,2,-24,1,Bennedict Mathurin,IND,IND,ORL,,,5,4,3,3
22023,1631097,22300377,"DEC 21, 2023",IND @ MEM,L,19,3,10,0.3,0,4,0.0,0,0,0.0,2,2,4,3,1,0,1,0,6,-22,1,Bennedict Mathurin,IND,MEM,IND,,,13,10,9,7
22023,1631097,22300365,"DEC 20, 2023",IND vs. CHA,W,28,5,7,0.714,4,6,0.667,0,0,0.0,0,2,2,1,1,0,2,2,14,10,1,Bennedict Mathurin,IND,IND,CHA,,,17,16,15,3
22023,1631097,22300350,"DEC 18, 2023",IND vs. LAC,L,35,12,20,0.6,3,7,0.429,7,7,1.0,2,4,6,2,1,0,1,3,34,-11,1,Bennedict Mathurin,IND,IND,LAC,,,42,40,36,8
22023,1631097,22300338,"DEC 16, 2023",IND @ MIN,L,23,3,11,0.273,0,1,0.0,0,0,0.0,0,1,1,3,0,1,1,1,6,8,1,Bennedict Mathurin,IND,MIN,IND,,,10,7,9,4
22023,1631097,22300328,"DEC 15, 2023",IND @ WAS,L,22,4,9,0.444,1,1,1.0,4,4,1.0,1,2,3,2,1,0,2,2,13,-14,1,Bennedict Mathurin,IND,WAS,IND,,,18,16,15,5
22023,1631097,22300315,"DEC 13, 2023",IND @ MIL,L,25,2,8,0.25,0,3,0.0,10,10,1.0,0,1,1,1,0,0,3,3,14,-15,1,Bennedict Mathurin,IND,MIL,IND,,,16,15,15,2
22023,1631097,22300293,"DEC 11, 2023",IND @ DET,W,37,10,17,0.588,3,5,0.6,7,8,0.875,3,4,7,8,2,0,2,3,30,8,1,Bennedict Mathurin,IND,DET,IND,,,45,37,38,15
22023,1631097,22301229,"DEC 07, 2023",IND @ MIL,W,24,3,12,0.25,0,2,0.0,3,3,1.0,2,4,6,1,0,1,2,4,9,17,1,Bennedict Mathurin,IND,MIL,IND,,,16,15,10,7
22023,1631097,22301202,"DEC 04, 2023",IND vs. BOS,W,27,5,14,0.357,4,7,0.571,2,2,1.0,1,4,5,2,0,0,1,1,16,-6,1,Bennedict Mathurin,IND,IND,BOS,,,23,21,18,7
22023,1631097,22300284,"DEC 02, 2023",IND @ MIA,W,25,6,10,0.6,2,3,0.667,2,3,0.667,1,4,5,4,0,0,4,4,16,-4,1,Bennedict Mathurin,IND,MIA,IND,,,25,21,20,9
22023,1631097,22300267,"NOV 30, 2023",IND @ MIA,L,24,5,7,0.714,0,0,0.0,2,2,1.0,0,3,3,0,0,0,1,1,12,-14,1,Bennedict Mathurin,IND,MIA,IND,,,15,15,12,3
22023,1631097,22300254,"NOV 27, 2023",IND vs. POR,L,22,4,10,0.4,0,2,0.0,3,5,0.6,1,3,4,0,0,0,2,3,11,-9,1,Bennedict Mathurin,IND,IND,POR,,,15,15,11,4
22023,1631097,22300047,"NOV 24, 2023",IND vs. DET,W,31,6,12,0.5,1,2,0.5,2,2,1.0,1,1,2,0,1,0,1,4,15,27,1,Bennedict Mathurin,IND,IND,DET,,,17,17,15,2
22023,1631097,22300230,"NOV 22, 2023",IND vs. TOR,L,24,2,7,0.286,0,1,0.0,1,2,0.5,0,0,0,2,1,1,0,1,5,-10,1,Bennedict Mathurin,IND,IND,TOR,,,7,5,7,2
22023,1631097,22300039,"NOV 21, 2023",IND @ ATL,W,20,7,10,0.7,2,4,0.5,3,4,0.75,0,2,2,1,0,0,0,2,19,-1,1,Bennedict Mathurin,IND,ATL,IND,,,22,21,20,3
22023,1631097,22300209,"NOV 19, 2023",IND vs. ORL,L,25,4,12,0.333,1,3,0.333,5,5,1.0,0,6,6,3,1,0,0,6,14,-7,1,Bennedict Mathurin,IND,IND,ORL,,,23,20,17,9
22023,1631097,22300019,"NOV 14, 2023",IND @ PHI,W,16,3,8,0.375,2,4,0.5,0,0,0.0,0,0,0,0,0,0,2,0,8,3,1,Bennedict Mathurin,IND,PHI,IND,,,8,8,8,0
22023,1631097,22300180,"NOV 12, 2023",IND @ PHI,L,26,4,11,0.364,0,3,0.0,1,3,0.333,1,4,5,1,0,1,1,1,9,-24,1,Bennedict Mathurin,IND,PHI,IND,,,15,14,10,6
22023,1631097,22300171,"NOV 09, 2023",IND vs. MIL,W,36,9,18,0.5,3,7,0.429,5,6,0.833,4,7,11,2,1,1,1,1,26,14,1,Bennedict Mathurin,IND,IND,MIL,,,39,37,28,13
22023,1631097,22300158,"NOV 08, 2023",IND vs. UTA,W,38,9,18,0.5,4,7,0.571,0,0,0.0,5,4,9,4,2,0,3,1,22,18,1,Bennedict Mathurin,IND,IND,UTA,,,35,31,26,13
22023,1631097,22300146,"NOV 06, 2023",IND vs. SAS,W,22,4,8,0.5,0,2,0.0,2,2,1.0,1,2,3,2,1,0,1,2,10,14,1,Bennedict Mathurin,IND,IND,SAS,,,15,13,12,5
22023,1631097,22300133,"NOV 04, 2023",IND vs. CHA,L,24,3,11,0.273,0,2,0.0,2,2,1.0,4,1,5,5,1,0,3,1,8,6,1,Bennedict Mathurin,IND,IND,CHA,,,18,13,13,10
22023,1631097,22300001,"NOV 03, 2023",IND vs. CLE,W,24,2,7,0.286,1,2,0.5,0,3,0.0,1,2,3,5,1,0,1,1,5,-4,1,Bennedict Mathurin,IND,IND,CLE,,,13,8,10,8
22023,1631097,22300118,"NOV 01, 2023",IND @ BOS,L,15,4,7,0.571,0,3,0.0,0,0,0.0,0,1,1,0,0,0,0,1,8,-24,1,Bennedict Mathurin,IND,BOS,IND,,,9,9,8,1
22023,1631097,22300102,"OCT 30, 2023",IND vs. CHI,L,28,4,11,0.364,1,4,0.25,6,6,1.0,1,3,4,0,0,0,2,5,15,-7,1,Bennedict Mathurin,IND,IND,CHI,,,19,19,15,4
22023,1631097,22300091,"OCT 28, 2023",IND @ CLE,W,17,5,10,0.5,1,3,0.333,2,3,0.667,0,0,0,1,0,0,0,0,13,-11,1,Bennedict Mathurin,IND,CLE,IND,,,14,13,14,1
22023,1631097,22300064,"OCT 25, 2023",IND vs. WAS,W,26,6,15,0.4,2,6,0.333,4,4,1.0,0,4,4,5,2,0,2,1,18,14,1,Bennedict Mathurin,IND,IND,WAS,,,27,22,23,9
22023,202083,22300499,"JAN 07, 2024",ATL @ ORL,L,9,0,0,0.0,0,0,0.0,0,0,0.0,0,1,1,0,0,1,0,1,0,11,1,Wesley Matthews,ATL,ORL,ATL,,,1,1,0,1
22023,202083,22300408,"DEC 26, 2023",ATL @ CHI,L,6,0,0,0.0,0,0,0.0,0,0,0.0,0,0,0,1,0,1,1,1,0,-1,1,Wesley Matthews,ATL,CHI,ATL,,,1,0,1,1
22023,202083,22300384,"DEC 22, 2023",ATL @ MIA,L,7,0,1,0.0,0,1,0.0,0,0,0.0,0,1,1,0,0,0,0,1,0,-3,1,Wesley Matthews,ATL,MIA,ATL,,,1,1,0,1
22023,202083,22300371,"DEC 20, 2023",ATL @ HOU,W,8,0,2,0.0,0,1,0.0,1,2,0.5,0,2,2,0,0,0,0,1,1,2,1,Wesley Matthews,ATL,HOU,ATL,,,3,3,1,2
22023,202083,22300352,"DEC 18, 2023",ATL vs. DET,W,15,1,2,0.5,0,1,0.0,0,0,0.0,0,2,2,1,1,1,1,1,2,-9,1,Wesley Matthews,ATL,ATL,DET,,,5,4,3,3
22023,202083,22300336,"DEC 16, 2023",ATL @ CLE,L,20,1,2,0.5,0,1,0.0,0,0,0.0,0,2,2,1,0,0,0,3,2,8,1,Wesley Matthews,ATL,CLE,ATL,,,5,4,3,3
22023,202083,22300313,"DEC 13, 2023",ATL @ TOR,L,14,1,6,0.167,1,4,0.25,2,2,1.0,1,1,2,1,2,0,0,3,5,-11,1,Wesley Matthews,ATL,TOR,ATL,,,8,7,6,3
22023,202083,22300296,"DEC 11, 2023",ATL vs. DEN,L,18,1,5,0.2,0,4,0.0,0,0,0.0,1,4,5,1,2,0,2,1,2,-2,1,Wesley Matthews,ATL,ATL,DEN,,,8,7,3,6
22023,202083,22301218,"DEC 08, 2023",ATL @ PHI,L,10,0,3,0.0,0,1,0.0,3,3,1.0,0,0,0,0,0,0,0,0,3,-13,1,Wesley Matthews,ATL,PHI,ATL,,,3,3,3,0
22023,202083,22301209,"DEC 06, 2023",ATL vs. BKN,L,11,0,1,0.0,0,1,0.0,4,4,1.0,0,1,1,0,1,0,0,2,4,-1,1,Wesley Matthews,ATL,ATL,BKN,,,5,5,4,1
22023,202083,22300286,"DEC 02, 2023",ATL @ MIL,L,12,0,2,0.0,0,2,0.0,1,2,0.5,0,1,1,0,2,0,0,0,1,-13,1,Wesley Matthews,ATL,MIL,ATL,,,2,2,1,1
22023,202083,22300272,"NOV 30, 2023",ATL @ SAS,W,15,1,1,1.0,1,1,1.0,0,0,0.0,0,0,0,2,0,1,0,1,3,1,1,Wesley Matthews,ATL,SAS,ATL,,,5,3,5,2
22023,202083,22300055,"NOV 28, 2023",ATL @ CLE,L,16,0,3,0.0,0,3,0.0,0,0,0.0,0,3,3,2,0,0,0,0,0,1,1,Wesley Matthews,ATL,CLE,ATL,,,5,3,2,5
22023,202083,22300246,"NOV 26, 2023",ATL @ BOS,L,8,1,3,0.333,0,2,0.0,0,0,0.0,0,0,0,0,0,0,0,1,2,-1,1,Wesley Matthews,ATL,BOS,ATL,,,2,2,2,0
22023,202083,22300241,"NOV 25, 2023",ATL @ WAS,W,8,0,1,0.0,0,1,0.0,0,0,0.0,0,0,0,1,0,0,0,0,0,-6,1,Wesley Matthews,ATL,WAS,ATL,,,1,0,1,1
22023,202083,22300039,"NOV 21, 2023",ATL vs. IND,L,9,1,2,0.5,1,2,0.5,0,0,0.0,0,1,1,1,0,0,1,3,3,1,1,Wesley Matthews,ATL,ATL,IND,,,5,4,4,2
22023,202083,22300029,"NOV 17, 2023",ATL vs. PHI,L,10,0,2,0.0,0,2,0.0,2,4,0.5,0,0,0,0,0,0,0,2,2,-8,1,Wesley Matthews,ATL,ATL,PHI,,,2,2,2,0
22023,202083,22300193,"NOV 15, 2023",ATL vs. NYK,L,10,1,1,1.0,1,1,1.0,0,0,0.0,1,2,3,1,1,0,0,2,3,2,1,Wesley Matthews,ATL,ATL,NYK,,,7,6,4,4
22023,202083,22300175,"NOV 11, 2023",ATL vs. MIA,L,7,2,2,1.0,2,2,1.0,1,2,0.5,1,1,2,0,0,0,1,3,7,1,1,Wesley Matthews,ATL,ATL,MIA,,,9,9,7,2
22023,1630178,22300555,"JAN 15, 2024",PHI vs. HOU,W,35,8,18,0.444,6,10,0.6,5,5,1.0,0,1,1,7,0,0,2,4,27,19,1,Tyrese Maxey,PHI,PHI,HOU,25.5,Points,35,28,34,8
22023,1630178,22300555,"JAN 15, 2024",PHI vs. HOU,W,35,8,18,0.444,6,10,0.6,5,5,1.0,0,1,1,7,0,0,2,4,27,19,1,Tyrese Maxey,PHI,PHI,HOU,35.5,Pts+Rebs+Asts,35,28,34,8
22023,1630178,22300555,"JAN 15, 2024",PHI vs. HOU,W,35,8,18,0.444,6,10,0.6,5,5,1.0,0,1,1,7,0,0,2,4,27,19,1,Tyrese Maxey,PHI,PHI,HOU,6.5,Assists,35,28,34,8
22023,1630178,22300555,"JAN 15, 2024",PHI vs. HOU,W,35,8,18,0.444,6,10,0.6,5,5,1.0,0,1,1,7,0,0,2,4,27,19,1,Tyrese Maxey,PHI,PHI,HOU,42.0,Fantasy Score,35,28,34,8
22023,1630178,22300555,"JAN 15, 2024",PHI vs. HOU,W,35,8,18,0.444,6,10,0.6,5,5,1.0,0,1,1,7,0,0,2,4,27,19,1,Tyrese Maxey,PHI,PHI,HOU,7.5,3-PT Attempted,35,28,34,8
22023,1630178,22300555,"JAN 15, 2024",PHI vs. HOU,W,35,8,18,0.444,6,10,0.6,5,5,1.0,0,1,1,7,0,0,2,4,27,19,1,Tyrese Maxey,PHI,PHI,HOU,4.5,Free Throws Made,35,28,34,8
22023,1630178,22300555,"JAN 15, 2024",PHI vs. HOU,W,35,8,18,0.444,6,10,0.6,5,5,1.0,0,1,1,7,0,0,2,4,27,19,1,Tyrese Maxey,PHI,PHI,HOU,18.5,FG Attempted,35,28,34,8
22023,1630178,22300555,"JAN 15, 2024",PHI vs. HOU,W,35,8,18,0.444,6,10,0.6,5,5,1.0,0,1,1,7,0,0,2,4,27,19,1,Tyrese Maxey,PHI,PHI,HOU,28.5,Pts+Rebs,35,28,34,8
22023,1630178,22300555,"JAN 15, 2024",PHI vs. HOU,W,35,8,18,0.444,6,10,0.6,5,5,1.0,0,1,1,7,0,0,2,4,27,19,1,Tyrese Maxey,PHI,PHI,HOU,32.5,Pts+Asts,35,28,34,8
22023,1630178,22300555,"JAN 15, 2024",PHI vs. HOU,W,35,8,18,0.444,6,10,0.6,5,5,1.0,0,1,1,7,0,0,2,4,27,19,1,Tyrese Maxey,PHI,PHI,HOU,9.5,Rebs+Asts,35,28,34,8
22023,1630178,22300555,"JAN 15, 2024",PHI vs. HOU,W,35,8,18,0.444,6,10,0.6,5,5,1.0,0,1,1,7,0,0,2,4,27,19,1,Tyrese Maxey,PHI,PHI,HOU,1.5,Blks+Stls,35,28,34,8
22023,1630178,22300532,"JAN 12, 2024",PHI vs. SAC,W,40,6,17,0.353,3,6,0.5,6,6,1.0,0,3,3,4,3,2,3,3,21,17,1,Tyrese Maxey,PHI,PHI,SAC,25.5,Points,28,24,25,7
22023,1630178,22300532,"JAN 12, 2024",PHI vs. SAC,W,40,6,17,0.353,3,6,0.5,6,6,1.0,0,3,3,4,3,2,3,3,21,17,1,Tyrese Maxey,PHI,PHI,SAC,35.5,Pts+Rebs+Asts,28,24,25,7
22023,1630178,22300532,"JAN 12, 2024",PHI vs. SAC,W,40,6,17,0.353,3,6,0.5,6,6,1.0,0,3,3,4,3,2,3,3,21,17,1,Tyrese Maxey,PHI,PHI,SAC,6.5,Assists,28,24,25,7
22023,1630178,22300532,"JAN 12, 2024",PHI vs. SAC,W,40,6,17,0.353,3,6,0.5,6,6,1.0,0,3,3,4,3,2,3,3,21,17,1,Tyrese Maxey,PHI,PHI,SAC,42.0,Fantasy Score,28,24,25,7
22023,1630178,22300532,"JAN 12, 2024",PHI vs. SAC,W,40,6,17,0.353,3,6,0.5,6,6,1.0,0,3,3,4,3,2,3,3,21,17,1,Tyrese Maxey,PHI,PHI,SAC,7.5,3-PT Attempted,28,24,25,7
22023,1630178,22300532,"JAN 12, 2024",PHI vs. SAC,W,40,6,17,0.353,3,6,0.5,6,6,1.0,0,3,3,4,3,2,3,3,21,17,1,Tyrese Maxey,PHI,PHI,SAC,4.5,Free Throws Made,28,24,25,7
22023,1630178,22300532,"JAN 12, 2024",PHI vs. SAC,W,40,6,17,0.353,3,6,0.5,6,6,1.0,0,3,3,4,3,2,3,3,21,17,1,Tyrese Maxey,PHI,PHI,SAC,18.5,FG Attempted,28,24,25,7
22023,1630178,22300532,"JAN 12, 2024",PHI vs. SAC,W,40,6,17,0.353,3,6,0.5,6,6,1.0,0,3,3,4,3,2,3,3,21,17,1,Tyrese Maxey,PHI,PHI,SAC,28.5,Pts+Rebs,28,24,25,7
22023,1630178,22300532,"JAN 12, 2024",PHI vs. SAC,W,40,6,17,0.353,3,6,0.5,6,6,1.0,0,3,3,4,3,2,3,3,21,17,1,Tyrese Maxey,PHI,PHI,SAC,32.5,Pts+Asts,28,24,25,7
22023,1630178,22300532,"JAN 12, 2024",PHI vs. SAC,W,40,6,17,0.353,3,6,0.5,6,6,1.0,0,3,3,4,3,2,3,3,21,17,1,Tyrese Maxey,PHI,PHI,SAC,9.5,Rebs+Asts,28,24,25,7
22023,1630178,22300532,"JAN 12, 2024",PHI vs. SAC,W,40,6,17,0.353,3,6,0.5,6,6,1.0,0,3,3,4,3,2,3,3,21,17,1,Tyrese Maxey,PHI,PHI,SAC,1.5,Blks+Stls,28,24,25,7
22023,1630178,22300521,"JAN 10, 2024",PHI @ ATL,L,43,12,29,0.414,4,11,0.364,7,9,0.778,1,7,8,9,4,0,3,6,35,2,1,Tyrese Maxey,PHI,ATL,PHI,25.5,Points,52,43,44,17
22023,1630178,22300521,"JAN 10, 2024",PHI @ ATL,L,43,12,29,0.414,4,11,0.364,7,9,0.778,1,7,8,9,4,0,3,6,35,2,1,Tyrese Maxey,PHI,ATL,PHI,35.5,Pts+Rebs+Asts,52,43,44,17
22023,1630178,22300521,"JAN 10, 2024",PHI @ ATL,L,43,12,29,0.414,4,11,0.364,7,9,0.778,1,7,8,9,4,0,3,6,35,2,1,Tyrese Maxey,PHI,ATL,PHI,6.5,Assists,52,43,44,17
22023,1630178,22300521,"JAN 10, 2024",PHI @ ATL,L,43,12,29,0.414,4,11,0.364,7,9,0.778,1,7,8,9,4,0,3,6,35,2,1,Tyrese Maxey,PHI,ATL,PHI,42.0,Fantasy Score,52,43,44,17
22023,1630178,22300521,"JAN 10, 2024",PHI @ ATL,L,43,12,29,0.414,4,11,0.364,7,9,0.778,1,7,8,9,4,0,3,6,35,2,1,Tyrese Maxey,PHI,ATL,PHI,7.5,3-PT Attempted,52,43,44,17
22023,1630178,22300521,"JAN 10, 2024",PHI @ ATL,L,43,12,29,0.414,4,11,0.364,7,9,0.778,1,7,8,9,4,0,3,6,35,2,1,Tyrese Maxey,PHI,ATL,PHI,4.5,Free Throws Made,52,43,44,17
22023,1630178,22300521,"JAN 10, 2024",PHI @ ATL,L,43,12,29,0.414,4,11,0.364,7,9,0.778,1,7,8,9,4,0,3,6,35,2,1,Tyrese Maxey,PHI,ATL,PHI,18.5,FG Attempted,52,43,44,17
22023,1630178,22300521,"JAN 10, 2024",PHI @ ATL,L,43,12,29,0.414,4,11,0.364,7,9,0.778,1,7,8,9,4,0,3,6,35,2,1,Tyrese Maxey,PHI,ATL,PHI,28.5,Pts+Rebs,52,43,44,17
22023,1630178,22300521,"JAN 10, 2024",PHI @ ATL,L,43,12,29,0.414,4,11,0.364,7,9,0.778,1,7,8,9,4,0,3,6,35,2,1,Tyrese Maxey,PHI,ATL,PHI,32.5,Pts+Asts,52,43,44,17
22023,1630178,22300521,"JAN 10, 2024",PHI @ ATL,L,43,12,29,0.414,4,11,0.364,7,9,0.778,1,7,8,9,4,0,3,6,35,2,1,Tyrese Maxey,PHI,ATL,PHI,9.5,Rebs+Asts,52,43,44,17
22023,1630178,22300521,"JAN 10, 2024",PHI @ ATL,L,43,12,29,0.414,4,11,0.364,7,9,0.778,1,7,8,9,4,0,3,6,35,2,1,Tyrese Maxey,PHI,ATL,PHI,1.5,Blks+Stls,52,43,44,17
22023,1630178,22300495,"JAN 06, 2024",PHI vs. UTA,L,42,9,24,0.375,1,8,0.125,6,6,1.0,1,0,1,9,3,1,3,0,25,-14,1,Tyrese Maxey,PHI,PHI,UTA,25.5,Points,35,26,34,10
22023,1630178,22300495,"JAN 06, 2024",PHI vs. UTA,L,42,9,24,0.375,1,8,0.125,6,6,1.0,1,0,1,9,3,1,3,0,25,-14,1,Tyrese Maxey,PHI,PHI,UTA,35.5,Pts+Rebs+Asts,35,26,34,10
22023,1630178,22300495,"JAN 06, 2024",PHI vs. UTA,L,42,9,24,0.375,1,8,0.125,6,6,1.0,1,0,1,9,3,1,3,0,25,-14,1,Tyrese Maxey,PHI,PHI,UTA,6.5,Assists,35,26,34,10
22023,1630178,22300495,"JAN 06, 2024",PHI vs. UTA,L,42,9,24,0.375,1,8,0.125,6,6,1.0,1,0,1,9,3,1,3,0,25,-14,1,Tyrese Maxey,PHI,PHI,UTA,42.0,Fantasy Score,35,26,34,10
22023,1630178,22300495,"JAN 06, 2024",PHI vs. UTA,L,42,9,24,0.375,1,8,0.125,6,6,1.0,1,0,1,9,3,1,3,0,25,-14,1,Tyrese Maxey,PHI,PHI,UTA,7.5,3-PT Attempted,35,26,34,10
22023,1630178,22300495,"JAN 06, 2024",PHI vs. UTA,L,42,9,24,0.375,1,8,0.125,6,6,1.0,1,0,1,9,3,1,3,0,25,-14,1,Tyrese Maxey,PHI,PHI,UTA,4.5,Free Throws Made,35,26,34,10
22023,1630178,22300495,"JAN 06, 2024",PHI vs. UTA,L,42,9,24,0.375,1,8,0.125,6,6,1.0,1,0,1,9,3,1,3,0,25,-14,1,Tyrese Maxey,PHI,PHI,UTA,18.5,FG Attempted,35,26,34,10
22023,1630178,22300495,"JAN 06, 2024",PHI vs. UTA,L,42,9,24,0.375,1,8,0.125,6,6,1.0,1,0,1,9,3,1,3,0,25,-14,1,Tyrese Maxey,PHI,PHI,UTA,28.5,Pts+Rebs,35,26,34,10
22023,1630178,22300495,"JAN 06, 2024",PHI vs. UTA,L,42,9,24,0.375,1,8,0.125,6,6,1.0,1,0,1,9,3,1,3,0,25,-14,1,Tyrese Maxey,PHI,PHI,UTA,32.5,Pts+Asts,35,26,34,10
22023,1630178,22300495,"JAN 06, 2024",PHI vs. UTA,L,42,9,24,0.375,1,8,0.125,6,6,1.0,1,0,1,9,3,1,3,0,25,-14,1,Tyrese Maxey,PHI,PHI,UTA,9.5,Rebs+Asts,35,26,34,10
22023,1630178,22300495,"JAN 06, 2024",PHI vs. UTA,L,42,9,24,0.375,1,8,0.125,6,6,1.0,1,0,1,9,3,1,3,0,25,-14,1,Tyrese Maxey,PHI,PHI,UTA,1.5,Blks+Stls,35,26,34,10
22023,1630178,22300483,"JAN 05, 2024",PHI vs. NYK,L,36,9,20,0.45,1,7,0.143,8,10,0.8,1,3,4,9,2,1,1,1,27,-28,1,Tyrese Maxey,PHI,PHI,NYK,25.5,Points,40,31,36,13
22023,1630178,22300483,"JAN 05, 2024",PHI vs. NYK,L,36,9,20,0.45,1,7,0.143,8,10,0.8,1,3,4,9,2,1,1,1,27,-28,1,Tyrese Maxey,PHI,PHI,NYK,35.5,Pts+Rebs+Asts,40,31,36,13
22023,1630178,22300483,"JAN 05, 2024",PHI vs. NYK,L,36,9,20,0.45,1,7,0.143,8,10,0.8,1,3,4,9,2,1,1,1,27,-28,1,Tyrese Maxey,PHI,PHI,NYK,6.5,Assists,40,31,36,13
22023,1630178,22300483,"JAN 05, 2024",PHI vs. NYK,L,36,9,20,0.45,1,7,0.143,8,10,0.8,1,3,4,9,2,1,1,1,27,-28,1,Tyrese Maxey,PHI,PHI,NYK,42.0,Fantasy Score,40,31,36,13
22023,1630178,22300483,"JAN 05, 2024",PHI vs. NYK,L,36,9,20,0.45,1,7,0.143,8,10,0.8,1,3,4,9,2,1,1,1,27,-28,1,Tyrese Maxey,PHI,PHI,NYK,7.5,3-PT Attempted,40,31,36,13
22023,1630178,22300483,"JAN 05, 2024",PHI vs. NYK,L,36,9,20,0.45,1,7,0.143,8,10,0.8,1,3,4,9,2,1,1,1,27,-28,1,Tyrese Maxey,PHI,PHI,NYK,4.5,Free Throws Made,40,31,36,13
22023,1630178,22300483,"JAN 05, 2024",PHI vs. NYK,L,36,9,20,0.45,1,7,0.143,8,10,0.8,1,3,4,9,2,1,1,1,27,-28,1,Tyrese Maxey,PHI,PHI,NYK,18.5,FG Attempted,40,31,36,13
22023,1630178,22300483,"JAN 05, 2024",PHI vs. NYK,L,36,9,20,0.45,1,7,0.143,8,10,0.8,1,3,4,9,2,1,1,1,27,-28,1,Tyrese Maxey,PHI,PHI,NYK,28.5,Pts+Rebs,40,31,36,13
22023,1630178,22300483,"JAN 05, 2024",PHI vs. NYK,L,36,9,20,0.45,1,7,0.143,8,10,0.8,1,3,4,9,2,1,1,1,27,-28,1,Tyrese Maxey,PHI,PHI,NYK,32.5,Pts+Asts,40,31,36,13
22023,1630178,22300483,"JAN 05, 2024",PHI vs. NYK,L,36,9,20,0.45,1,7,0.143,8,10,0.8,1,3,4,9,2,1,1,1,27,-28,1,Tyrese Maxey,PHI,PHI,NYK,9.5,Rebs+Asts,40,31,36,13
22023,1630178,22300483,"JAN 05, 2024",PHI vs. NYK,L,36,9,20,0.45,1,7,0.143,8,10,0.8,1,3,4,9,2,1,1,1,27,-28,1,Tyrese Maxey,PHI,PHI,NYK,1.5,Blks+Stls,40,31,36,13
22023,1630178,22300459,"JAN 02, 2024",PHI vs. CHI,W,29,6,12,0.5,4,7,0.571,5,6,0.833,0,1,1,5,0,0,1,2,21,24,1,Tyrese Maxey,PHI,PHI,CHI,25.5,Points,27,22,26,6
22023,1630178,22300459,"JAN 02, 2024",PHI vs. CHI,W,29,6,12,0.5,4,7,0.571,5,6,0.833,0,1,1,5,0,0,1,2,21,24,1,Tyrese Maxey,PHI,PHI,CHI,35.5,Pts+Rebs+Asts,27,22,26,6
22023,1630178,22300459,"JAN 02, 2024",PHI vs. CHI,W,29,6,12,0.5,4,7,0.571,5,6,0.833,0,1,1,5,0,0,1,2,21,24,1,Tyrese Maxey,PHI,PHI,CHI,6.5,Assists,27,22,26,6
22023,1630178,22300459,"JAN 02, 2024",PHI vs. CHI,W,29,6,12,0.5,4,7,0.571,5,6,0.833,0,1,1,5,0,0,1,2,21,24,1,Tyrese Maxey,PHI,PHI,CHI,42.0,Fantasy Score,27,22,26,6
22023,1630178,22300459,"JAN 02, 2024",PHI vs. CHI,W,29,6,12,0.5,4,7,0.571,5,6,0.833,0,1,1,5,0,0,1,2,21,24,1,Tyrese Maxey,PHI,PHI,CHI,7.5,3-PT Attempted,27,22,26,6
22023,1630178,22300459,"JAN 02, 2024",PHI vs. CHI,W,29,6,12,0.5,4,7,0.571,5,6,0.833,0,1,1,5,0,0,1,2,21,24,1,Tyrese Maxey,PHI,PHI,CHI,4.5,Free Throws Made,27,22,26,6
22023,1630178,22300459,"JAN 02, 2024",PHI vs. CHI,W,29,6,12,0.5,4,7,0.571,5,6,0.833,0,1,1,5,0,0,1,2,21,24,1,Tyrese Maxey,PHI,PHI,CHI,18.5,FG Attempted,27,22,26,6
22023,1630178,22300459,"JAN 02, 2024",PHI vs. CHI,W,29,6,12,0.5,4,7,0.571,5,6,0.833,0,1,1,5,0,0,1,2,21,24,1,Tyrese Maxey,PHI,PHI,CHI,28.5,Pts+Rebs,27,22,26,6
22023,1630178,22300459,"JAN 02, 2024",PHI vs. CHI,W,29,6,12,0.5,4,7,0.571,5,6,0.833,0,1,1,5,0,0,1,2,21,24,1,Tyrese Maxey,PHI,PHI,CHI,32.5,Pts+Asts,27,22,26,6
22023,1630178,22300459,"JAN 02, 2024",PHI vs. CHI,W,29,6,12,0.5,4,7,0.571,5,6,0.833,0,1,1,5,0,0,1,2,21,24,1,Tyrese Maxey,PHI,PHI,CHI,9.5,Rebs+Asts,27,22,26,6
22023,1630178,22300459,"JAN 02, 2024",PHI vs. CHI,W,29,6,12,0.5,4,7,0.571,5,6,0.833,0,1,1,5,0,0,1,2,21,24,1,Tyrese Maxey,PHI,PHI,CHI,1.5,Blks+Stls,27,22,26,6
22023,1630178,22300442,"DEC 30, 2023",PHI @ CHI,L,35,8,22,0.364,2,8,0.25,2,5,0.4,0,0,0,7,1,0,2,4,20,-12,1,Tyrese Maxey,PHI,CHI,PHI,25.5,Points,27,20,27,7
22023,1630178,22300442,"DEC 30, 2023",PHI @ CHI,L,35,8,22,0.364,2,8,0.25,2,5,0.4,0,0,0,7,1,0,2,4,20,-12,1,Tyrese Maxey,PHI,CHI,PHI,35.5,Pts+Rebs+Asts,27,20,27,7
22023,1630178,22300442,"DEC 30, 2023",PHI @ CHI,L,35,8,22,0.364,2,8,0.25,2,5,0.4,0,0,0,7,1,0,2,4,20,-12,1,Tyrese Maxey,PHI,CHI,PHI,6.5,Assists,27,20,27,7
22023,1630178,22300442,"DEC 30, 2023",PHI @ CHI,L,35,8,22,0.364,2,8,0.25,2,5,0.4,0,0,0,7,1,0,2,4,20,-12,1,Tyrese Maxey,PHI,CHI,PHI,42.0,Fantasy Score,27,20,27,7
22023,1630178,22300442,"DEC 30, 2023",PHI @ CHI,L,35,8,22,0.364,2,8,0.25,2,5,0.4,0,0,0,7,1,0,2,4,20,-12,1,Tyrese Maxey,PHI,CHI,PHI,7.5,3-PT Attempted,27,20,27,7
22023,1630178,22300442,"DEC 30, 2023",PHI @ CHI,L,35,8,22,0.364,2,8,0.25,2,5,0.4,0,0,0,7,1,0,2,4,20,-12,1,Tyrese Maxey,PHI,CHI,PHI,4.5,Free Throws Made,27,20,27,7
22023,1630178,22300442,"DEC 30, 2023",PHI @ CHI,L,35,8,22,0.364,2,8,0.25,2,5,0.4,0,0,0,7,1,0,2,4,20,-12,1,Tyrese Maxey,PHI,CHI,PHI,18.5,FG Attempted,27,20,27,7
22023,1630178,22300442,"DEC 30, 2023",PHI @ CHI,L,35,8,22,0.364,2,8,0.25,2,5,0.4,0,0,0,7,1,0,2,4,20,-12,1,Tyrese Maxey,PHI,CHI,PHI,28.5,Pts+Rebs,27,20,27,7
22023,1630178,22300442,"DEC 30, 2023",PHI @ CHI,L,35,8,22,0.364,2,8,0.25,2,5,0.4,0,0,0,7,1,0,2,4,20,-12,1,Tyrese Maxey,PHI,CHI,PHI,32.5,Pts+Asts,27,20,27,7
22023,1630178,22300442,"DEC 30, 2023",PHI @ CHI,L,35,8,22,0.364,2,8,0.25,2,5,0.4,0,0,0,7,1,0,2,4,20,-12,1,Tyrese Maxey,PHI,CHI,PHI,9.5,Rebs+Asts,27,20,27,7
22023,1630178,22300442,"DEC 30, 2023",PHI @ CHI,L,35,8,22,0.364,2,8,0.25,2,5,0.4,0,0,0,7,1,0,2,4,20,-12,1,Tyrese Maxey,PHI,CHI,PHI,1.5,Blks+Stls,27,20,27,7
22023,1630178,22300434,"DEC 29, 2023",PHI @ HOU,W,41,13,26,0.5,2,9,0.222,14,15,0.933,1,3,4,4,0,1,1,1,42,0,1,Tyrese Maxey,PHI,HOU,PHI,25.5,Points,50,46,46,8
22023,1630178,22300434,"DEC 29, 2023",PHI @ HOU,W,41,13,26,0.5,2,9,0.222,14,15,0.933,1,3,4,4,0,1,1,1,42,0,1,Tyrese Maxey,PHI,HOU,PHI,35.5,Pts+Rebs+Asts,50,46,46,8
22023,1630178,22300434,"DEC 29, 2023",PHI @ HOU,W,41,13,26,0.5,2,9,0.222,14,15,0.933,1,3,4,4,0,1,1,1,42,0,1,Tyrese Maxey,PHI,HOU,PHI,6.5,Assists,50,46,46,8
22023,1630178,22300434,"DEC 29, 2023",PHI @ HOU,W,41,13,26,0.5,2,9,0.222,14,15,0.933,1,3,4,4,0,1,1,1,42,0,1,Tyrese Maxey,PHI,HOU,PHI,42.0,Fantasy Score,50,46,46,8
22023,1630178,22300434,"DEC 29, 2023",PHI @ HOU,W,41,13,26,0.5,2,9,0.222,14,15,0.933,1,3,4,4,0,1,1,1,42,0,1,Tyrese Maxey,PHI,HOU,PHI,7.5,3-PT Attempted,50,46,46,8
22023,1630178,22300434,"DEC 29, 2023",PHI @ HOU,W,41,13,26,0.5,2,9,0.222,14,15,0.933,1,3,4,4,0,1,1,1,42,0,1,Tyrese Maxey,PHI,HOU,PHI,4.5,Free Throws Made,50,46,46,8
22023,1630178,22300434,"DEC 29, 2023",PHI @ HOU,W,41,13,26,0.5,2,9,0.222,14,15,0.933,1,3,4,4,0,1,1,1,42,0,1,Tyrese Maxey,PHI,HOU,PHI,18.5,FG Attempted,50,46,46,8
22023,1630178,22300434,"DEC 29, 2023",PHI @ HOU,W,41,13,26,0.5,2,9,0.222,14,15,0.933,1,3,4,4,0,1,1,1,42,0,1,Tyrese Maxey,PHI,HOU,PHI,28.5,Pts+Rebs,50,46,46,8
22023,1630178,22300434,"DEC 29, 2023",PHI @ HOU,W,41,13,26,0.5,2,9,0.222,14,15,0.933,1,3,4,4,0,1,1,1,42,0,1,Tyrese Maxey,PHI,HOU,PHI,32.5,Pts+Asts,50,46,46,8
22023,1630178,22300434,"DEC 29, 2023",PHI @ HOU,W,41,13,26,0.5,2,9,0.222,14,15,0.933,1,3,4,4,0,1,1,1,42,0,1,Tyrese Maxey,PHI,HOU,PHI,9.5,Rebs+Asts,50,46,46,8
22023,1630178,22300434,"DEC 29, 2023",PHI @ HOU,W,41,13,26,0.5,2,9,0.222,14,15,0.933,1,3,4,4,0,1,1,1,42,0,1,Tyrese Maxey,PHI,HOU,PHI,1.5,Blks+Stls,50,46,46,8
22023,1630178,22300415,"DEC 27, 2023",PHI @ ORL,W,34,9,18,0.5,3,6,0.5,2,3,0.667,1,5,6,2,0,1,1,2,23,17,1,Tyrese Maxey,PHI,ORL,PHI,25.5,Points,31,29,25,8
22023,1630178,22300415,"DEC 27, 2023",PHI @ ORL,W,34,9,18,0.5,3,6,0.5,2,3,0.667,1,5,6,2,0,1,1,2,23,17,1,Tyrese Maxey,PHI,ORL,PHI,35.5,Pts+Rebs+Asts,31,29,25,8
22023,1630178,22300415,"DEC 27, 2023",PHI @ ORL,W,34,9,18,0.5,3,6,0.5,2,3,0.667,1,5,6,2,0,1,1,2,23,17,1,Tyrese Maxey,PHI,ORL,PHI,6.5,Assists,31,29,25,8
22023,1630178,22300415,"DEC 27, 2023",PHI @ ORL,W,34,9,18,0.5,3,6,0.5,2,3,0.667,1,5,6,2,0,1,1,2,23,17,1,Tyrese Maxey,PHI,ORL,PHI,42.0,Fantasy Score,31,29,25,8
22023,1630178,22300415,"DEC 27, 2023",PHI @ ORL,W,34,9,18,0.5,3,6,0.5,2,3,0.667,1,5,6,2,0,1,1,2,23,17,1,Tyrese Maxey,PHI,ORL,PHI,7.5,3-PT Attempted,31,29,25,8
22023,1630178,22300415,"DEC 27, 2023",PHI @ ORL,W,34,9,18,0.5,3,6,0.5,2,3,0.667,1,5,6,2,0,1,1,2,23,17,1,Tyrese Maxey,PHI,ORL,PHI,4.5,Free Throws Made,31,29,25,8
22023,1630178,22300415,"DEC 27, 2023",PHI @ ORL,W,34,9,18,0.5,3,6,0.5,2,3,0.667,1,5,6,2,0,1,1,2,23,17,1,Tyrese Maxey,PHI,ORL,PHI,18.5,FG Attempted,31,29,25,8
22023,1630178,22300415,"DEC 27, 2023",PHI @ ORL,W,34,9,18,0.5,3,6,0.5,2,3,0.667,1,5,6,2,0,1,1,2,23,17,1,Tyrese Maxey,PHI,ORL,PHI,28.5,Pts+Rebs,31,29,25,8
22023,1630178,22300415,"DEC 27, 2023",PHI @ ORL,W,34,9,18,0.5,3,6,0.5,2,3,0.667,1,5,6,2,0,1,1,2,23,17,1,Tyrese Maxey,PHI,ORL,PHI,32.5,Pts+Asts,31,29,25,8
22023,1630178,22300415,"DEC 27, 2023",PHI @ ORL,W,34,9,18,0.5,3,6,0.5,2,3,0.667,1,5,6,2,0,1,1,2,23,17,1,Tyrese Maxey,PHI,ORL,PHI,9.5,Rebs+Asts,31,29,25,8
22023,1630178,22300415,"DEC 27, 2023",PHI @ ORL,W,34,9,18,0.5,3,6,0.5,2,3,0.667,1,5,6,2,0,1,1,2,23,17,1,Tyrese Maxey,PHI,ORL,PHI,1.5,Blks+Stls,31,29,25,8
22023,1630178,22300404,"DEC 25, 2023",PHI @ MIA,L,44,4,20,0.2,1,8,0.125,3,6,0.5,0,3,3,5,1,1,0,4,12,3,1,Tyrese Maxey,PHI,MIA,PHI,25.5,Points,20,15,17,8
22023,1630178,22300404,"DEC 25, 2023",PHI @ MIA,L,44,4,20,0.2,1,8,0.125,3,6,0.5,0,3,3,5,1,1,0,4,12,3,1,Tyrese Maxey,PHI,MIA,PHI,35.5,Pts+Rebs+Asts,20,15,17,8
22023,1630178,22300404,"DEC 25, 2023",PHI @ MIA,L,44,4,20,0.2,1,8,0.125,3,6,0.5,0,3,3,5,1,1,0,4,12,3,1,Tyrese Maxey,PHI,MIA,PHI,6.5,Assists,20,15,17,8
22023,1630178,22300404,"DEC 25, 2023",PHI @ MIA,L,44,4,20,0.2,1,8,0.125,3,6,0.5,0,3,3,5,1,1,0,4,12,3,1,Tyrese Maxey,PHI,MIA,PHI,42.0,Fantasy Score,20,15,17,8
22023,1630178,22300404,"DEC 25, 2023",PHI @ MIA,L,44,4,20,0.2,1,8,0.125,3,6,0.5,0,3,3,5,1,1,0,4,12,3,1,Tyrese Maxey,PHI,MIA,PHI,7.5,3-PT Attempted,20,15,17,8
22023,1630178,22300404,"DEC 25, 2023",PHI @ MIA,L,44,4,20,0.2,1,8,0.125,3,6,0.5,0,3,3,5,1,1,0,4,12,3,1,Tyrese Maxey,PHI,MIA,PHI,4.5,Free Throws Made,20,15,17,8
22023,1630178,22300404,"DEC 25, 2023",PHI @ MIA,L,44,4,20,0.2,1,8,0.125,3,6,0.5,0,3,3,5,1,1,0,4,12,3,1,Tyrese Maxey,PHI,MIA,PHI,18.5,FG Attempted,20,15,17,8
22023,1630178,22300404,"DEC 25, 2023",PHI @ MIA,L,44,4,20,0.2,1,8,0.125,3,6,0.5,0,3,3,5,1,1,0,4,12,3,1,Tyrese Maxey,PHI,MIA,PHI,28.5,Pts+Rebs,20,15,17,8
22023,1630178,22300404,"DEC 25, 2023",PHI @ MIA,L,44,4,20,0.2,1,8,0.125,3,6,0.5,0,3,3,5,1,1,0,4,12,3,1,Tyrese Maxey,PHI,MIA,PHI,32.5,Pts+Asts,20,15,17,8
22023,1630178,22300404,"DEC 25, 2023",PHI @ MIA,L,44,4,20,0.2,1,8,0.125,3,6,0.5,0,3,3,5,1,1,0,4,12,3,1,Tyrese Maxey,PHI,MIA,PHI,9.5,Rebs+Asts,20,15,17,8
22023,1630178,22300404,"DEC 25, 2023",PHI @ MIA,L,44,4,20,0.2,1,8,0.125,3,6,0.5,0,3,3,5,1,1,0,4,12,3,1,Tyrese Maxey,PHI,MIA,PHI,1.5,Blks+Stls,20,15,17,8
22023,1630178,22300382,"DEC 22, 2023",PHI vs. TOR,W,41,13,22,0.591,4,10,0.4,3,3,1.0,0,4,4,10,0,0,3,3,33,17,1,Tyrese Maxey,PHI,PHI,TOR,25.5,Points,47,37,43,14
22023,1630178,22300382,"DEC 22, 2023",PHI vs. TOR,W,41,13,22,0.591,4,10,0.4,3,3,1.0,0,4,4,10,0,0,3,3,33,17,1,Tyrese Maxey,PHI,PHI,TOR,35.5,Pts+Rebs+Asts,47,37,43,14
22023,1630178,22300382,"DEC 22, 2023",PHI vs. TOR,W,41,13,22,0.591,4,10,0.4,3,3,1.0,0,4,4,10,0,0,3,3,33,17,1,Tyrese Maxey,PHI,PHI,TOR,6.5,Assists,47,37,43,14
22023,1630178,22300382,"DEC 22, 2023",PHI vs. TOR,W,41,13,22,0.591,4,10,0.4,3,3,1.0,0,4,4,10,0,0,3,3,33,17,1,Tyrese Maxey,PHI,PHI,TOR,42.0,Fantasy Score,47,37,43,14
22023,1630178,22300382,"DEC 22, 2023",PHI vs. TOR,W,41,13,22,0.591,4,10,0.4,3,3,1.0,0,4,4,10,0,0,3,3,33,17,1,Tyrese Maxey,PHI,PHI,TOR,7.5,3-PT Attempted,47,37,43,14
22023,1630178,22300382,"DEC 22, 2023",PHI vs. TOR,W,41,13,22,0.591,4,10,0.4,3,3,1.0,0,4,4,10,0,0,3,3,33,17,1,Tyrese Maxey,PHI,PHI,TOR,4.5,Free Throws Made,47,37,43,14
22023,1630178,22300382,"DEC 22, 2023",PHI vs. TOR,W,41,13,22,0.591,4,10,0.4,3,3,1.0,0,4,4,10,0,0,3,3,33,17,1,Tyrese Maxey,PHI,PHI,TOR,18.5,FG Attempted,47,37,43,14
22023,1630178,22300382,"DEC 22, 2023",PHI vs. TOR,W,41,13,22,0.591,4,10,0.4,3,3,1.0,0,4,4,10,0,0,3,3,33,17,1,Tyrese Maxey,PHI,PHI,TOR,28.5,Pts+Rebs,47,37,43,14
22023,1630178,22300382,"DEC 22, 2023",PHI vs. TOR,W,41,13,22,0.591,4,10,0.4,3,3,1.0,0,4,4,10,0,0,3,3,33,17,1,Tyrese Maxey,PHI,PHI,TOR,32.5,Pts+Asts,47,37,43,14
22023,1630178,22300382,"DEC 22, 2023",PHI vs. TOR,W,41,13,22,0.591,4,10,0.4,3,3,1.0,0,4,4,10,0,0,3,3,33,17,1,Tyrese Maxey,PHI,PHI,TOR,9.5,Rebs+Asts,47,37,43,14
22023,1630178,22300382,"DEC 22, 2023",PHI vs. TOR,W,41,13,22,0.591,4,10,0.4,3,3,1.0,0,4,4,10,0,0,3,3,33,17,1,Tyrese Maxey,PHI,PHI,TOR,1.5,Blks+Stls,47,37,43,14
22023,1630178,22300367,"DEC 20, 2023",PHI vs. MIN,W,37,12,24,0.5,5,12,0.417,6,6,1.0,0,1,1,5,0,0,5,4,35,1,1,Tyrese Maxey,PHI,PHI,MIN,25.5,Points,41,36,40,6
22023,1630178,22300367,"DEC 20, 2023",PHI vs. MIN,W,37,12,24,0.5,5,12,0.417,6,6,1.0,0,1,1,5,0,0,5,4,35,1,1,Tyrese Maxey,PHI,PHI,MIN,35.5,Pts+Rebs+Asts,41,36,40,6
22023,1630178,22300367,"DEC 20, 2023",PHI vs. MIN,W,37,12,24,0.5,5,12,0.417,6,6,1.0,0,1,1,5,0,0,5,4,35,1,1,Tyrese Maxey,PHI,PHI,MIN,6.5,Assists,41,36,40,6
22023,1630178,22300367,"DEC 20, 2023",PHI vs. MIN,W,37,12,24,0.5,5,12,0.417,6,6,1.0,0,1,1,5,0,0,5,4,35,1,1,Tyrese Maxey,PHI,PHI,MIN,42.0,Fantasy Score,41,36,40,6
22023,1630178,22300367,"DEC 20, 2023",PHI vs. MIN,W,37,12,24,0.5,5,12,0.417,6,6,1.0,0,1,1,5,0,0,5,4,35,1,1,Tyrese Maxey,PHI,PHI,MIN,7.5,3-PT Attempted,41,36,40,6
22023,1630178,22300367,"DEC 20, 2023",PHI vs. MIN,W,37,12,24,0.5,5,12,0.417,6,6,1.0,0,1,1,5,0,0,5,4,35,1,1,Tyrese Maxey,PHI,PHI,MIN,4.5,Free Throws Made,41,36,40,6
22023,1630178,22300367,"DEC 20, 2023",PHI vs. MIN,W,37,12,24,0.5,5,12,0.417,6,6,1.0,0,1,1,5,0,0,5,4,35,1,1,Tyrese Maxey,PHI,PHI,MIN,18.5,FG Attempted,41,36,40,6
22023,1630178,22300367,"DEC 20, 2023",PHI vs. MIN,W,37,12,24,0.5,5,12,0.417,6,6,1.0,0,1,1,5,0,0,5,4,35,1,1,Tyrese Maxey,PHI,PHI,MIN,28.5,Pts+Rebs,41,36,40,6
22023,1630178,22300367,"DEC 20, 2023",PHI vs. MIN,W,37,12,24,0.5,5,12,0.417,6,6,1.0,0,1,1,5,0,0,5,4,35,1,1,Tyrese Maxey,PHI,PHI,MIN,32.5,Pts+Asts,41,36,40,6
22023,1630178,22300367,"DEC 20, 2023",PHI vs. MIN,W,37,12,24,0.5,5,12,0.417,6,6,1.0,0,1,1,5,0,0,5,4,35,1,1,Tyrese Maxey,PHI,PHI,MIN,9.5,Rebs+Asts,41,36,40,6
22023,1630178,22300367,"DEC 20, 2023",PHI vs. MIN,W,37,12,24,0.5,5,12,0.417,6,6,1.0,0,1,1,5,0,0,5,4,35,1,1,Tyrese Maxey,PHI,PHI,MIN,1.5,Blks+Stls,41,36,40,6
22023,1630178,22300351,"DEC 18, 2023",PHI vs. CHI,L,39,9,23,0.391,5,11,0.455,6,6,1.0,2,3,5,8,1,0,3,3,29,11,1,Tyrese Maxey,PHI,PHI,CHI,25.5,Points,42,34,37,13
22023,1630178,22300351,"DEC 18, 2023",PHI vs. CHI,L,39,9,23,0.391,5,11,0.455,6,6,1.0,2,3,5,8,1,0,3,3,29,11,1,Tyrese Maxey,PHI,PHI,CHI,35.5,Pts+Rebs+Asts,42,34,37,13
22023,1630178,22300351,"DEC 18, 2023",PHI vs. CHI,L,39,9,23,0.391,5,11,0.455,6,6,1.0,2,3,5,8,1,0,3,3,29,11,1,Tyrese Maxey,PHI,PHI,CHI,6.5,Assists,42,34,37,13
22023,1630178,22300351,"DEC 18, 2023",PHI vs. CHI,L,39,9,23,0.391,5,11,0.455,6,6,1.0,2,3,5,8,1,0,3,3,29,11,1,Tyrese Maxey,PHI,PHI,CHI,42.0,Fantasy Score,42,34,37,13
22023,1630178,22300351,"DEC 18, 2023",PHI vs. CHI,L,39,9,23,0.391,5,11,0.455,6,6,1.0,2,3,5,8,1,0,3,3,29,11,1,Tyrese Maxey,PHI,PHI,CHI,7.5,3-PT Attempted,42,34,37,13
22023,1630178,22300351,"DEC 18, 2023",PHI vs. CHI,L,39,9,23,0.391,5,11,0.455,6,6,1.0,2,3,5,8,1,0,3,3,29,11,1,Tyrese Maxey,PHI,PHI,CHI,4.5,Free Throws Made,42,34,37,13
22023,1630178,22300351,"DEC 18, 2023",PHI vs. CHI,L,39,9,23,0.391,5,11,0.455,6,6,1.0,2,3,5,8,1,0,3,3,29,11,1,Tyrese Maxey,PHI,PHI,CHI,18.5,FG Attempted,42,34,37,13
22023,1630178,22300351,"DEC 18, 2023",PHI vs. CHI,L,39,9,23,0.391,5,11,0.455,6,6,1.0,2,3,5,8,1,0,3,3,29,11,1,Tyrese Maxey,PHI,PHI,CHI,28.5,Pts+Rebs,42,34,37,13
22023,1630178,22300351,"DEC 18, 2023",PHI vs. CHI,L,39,9,23,0.391,5,11,0.455,6,6,1.0,2,3,5,8,1,0,3,3,29,11,1,Tyrese Maxey,PHI,PHI,CHI,32.5,Pts+Asts,42,34,37,13
22023,1630178,22300351,"DEC 18, 2023",PHI vs. CHI,L,39,9,23,0.391,5,11,0.455,6,6,1.0,2,3,5,8,1,0,3,3,29,11,1,Tyrese Maxey,PHI,PHI,CHI,9.5,Rebs+Asts,42,34,37,13
22023,1630178,22300351,"DEC 18, 2023",PHI vs. CHI,L,39,9,23,0.391,5,11,0.455,6,6,1.0,2,3,5,8,1,0,3,3,29,11,1,Tyrese Maxey,PHI,PHI,CHI,1.5,Blks+Stls,42,34,37,13
22023,1630178,22300335,"DEC 16, 2023",PHI @ CHA,W,33,8,13,0.615,5,8,0.625,0,0,0.0,0,2,2,7,2,1,0,1,21,43,1,Tyrese Maxey,PHI,CHA,PHI,25.5,Points,30,23,28,9
22023,1630178,22300335,"DEC 16, 2023",PHI @ CHA,W,33,8,13,0.615,5,8,0.625,0,0,0.0,0,2,2,7,2,1,0,1,21,43,1,Tyrese Maxey,PHI,CHA,PHI,35.5,Pts+Rebs+Asts,30,23,28,9
22023,1630178,22300335,"DEC 16, 2023",PHI @ CHA,W,33,8,13,0.615,5,8,0.625,0,0,0.0,0,2,2,7,2,1,0,1,21,43,1,Tyrese Maxey,PHI,CHA,PHI,6.5,Assists,30,23,28,9
22023,1630178,22300335,"DEC 16, 2023",PHI @ CHA,W,33,8,13,0.615,5,8,0.625,0,0,0.0,0,2,2,7,2,1,0,1,21,43,1,Tyrese Maxey,PHI,CHA,PHI,42.0,Fantasy Score,30,23,28,9
22023,1630178,22300335,"DEC 16, 2023",PHI @ CHA,W,33,8,13,0.615,5,8,0.625,0,0,0.0,0,2,2,7,2,1,0,1,21,43,1,Tyrese Maxey,PHI,CHA,PHI,7.5,3-PT Attempted,30,23,28,9
22023,1630178,22300335,"DEC 16, 2023",PHI @ CHA,W,33,8,13,0.615,5,8,0.625,0,0,0.0,0,2,2,7,2,1,0,1,21,43,1,Tyrese Maxey,PHI,CHA,PHI,4.5,Free Throws Made,30,23,28,9
22023,1630178,22300335,"DEC 16, 2023",PHI @ CHA,W,33,8,13,0.615,5,8,0.625,0,0,0.0,0,2,2,7,2,1,0,1,21,43,1,Tyrese Maxey,PHI,CHA,PHI,18.5,FG Attempted,30,23,28,9
22023,1630178,22300335,"DEC 16, 2023",PHI @ CHA,W,33,8,13,0.615,5,8,0.625,0,0,0.0,0,2,2,7,2,1,0,1,21,43,1,Tyrese Maxey,PHI,CHA,PHI,28.5,Pts+Rebs,30,23,28,9
22023,1630178,22300335,"DEC 16, 2023",PHI @ CHA,W,33,8,13,0.615,5,8,0.625,0,0,0.0,0,2,2,7,2,1,0,1,21,43,1,Tyrese Maxey,PHI,CHA,PHI,32.5,Pts+Asts,30,23,28,9
22023,1630178,22300335,"DEC 16, 2023",PHI @ CHA,W,33,8,13,0.615,5,8,0.625,0,0,0.0,0,2,2,7,2,1,0,1,21,43,1,Tyrese Maxey,PHI,CHA,PHI,9.5,Rebs+Asts,30,23,28,9
22023,1630178,22300335,"DEC 16, 2023",PHI @ CHA,W,33,8,13,0.615,5,8,0.625,0,0,0.0,0,2,2,7,2,1,0,1,21,43,1,Tyrese Maxey,PHI,CHA,PHI,1.5,Blks+Stls,30,23,28,9
22023,1630178,22300327,"DEC 15, 2023",PHI vs. DET,W,27,7,16,0.438,1,6,0.167,4,5,0.8,0,1,1,4,2,0,1,1,19,37,1,Tyrese Maxey,PHI,PHI,DET,25.5,Points,24,20,23,5
22023,1630178,22300327,"DEC 15, 2023",PHI vs. DET,W,27,7,16,0.438,1,6,0.167,4,5,0.8,0,1,1,4,2,0,1,1,19,37,1,Tyrese Maxey,PHI,PHI,DET,35.5,Pts+Rebs+Asts,24,20,23,5
22023,1630178,22300327,"DEC 15, 2023",PHI vs. DET,W,27,7,16,0.438,1,6,0.167,4,5,0.8,0,1,1,4,2,0,1,1,19,37,1,Tyrese Maxey,PHI,PHI,DET,6.5,Assists,24,20,23,5
22023,1630178,22300327,"DEC 15, 2023",PHI vs. DET,W,27,7,16,0.438,1,6,0.167,4,5,0.8,0,1,1,4,2,0,1,1,19,37,1,Tyrese Maxey,PHI,PHI,DET,42.0,Fantasy Score,24,20,23,5
22023,1630178,22300327,"DEC 15, 2023",PHI vs. DET,W,27,7,16,0.438,1,6,0.167,4,5,0.8,0,1,1,4,2,0,1,1,19,37,1,Tyrese Maxey,PHI,PHI,DET,7.5,3-PT Attempted,24,20,23,5
22023,1630178,22300327,"DEC 15, 2023",PHI vs. DET,W,27,7,16,0.438,1,6,0.167,4,5,0.8,0,1,1,4,2,0,1,1,19,37,1,Tyrese Maxey,PHI,PHI,DET,4.5,Free Throws Made,24,20,23,5
22023,1630178,22300327,"DEC 15, 2023",PHI vs. DET,W,27,7,16,0.438,1,6,0.167,4,5,0.8,0,1,1,4,2,0,1,1,19,37,1,Tyrese Maxey,PHI,PHI,DET,18.5,FG Attempted,24,20,23,5
22023,1630178,22300327,"DEC 15, 2023",PHI vs. DET,W,27,7,16,0.438,1,6,0.167,4,5,0.8,0,1,1,4,2,0,1,1,19,37,1,Tyrese Maxey,PHI,PHI,DET,28.5,Pts+Rebs,24,20,23,5
22023,1630178,22300327,"DEC 15, 2023",PHI vs. DET,W,27,7,16,0.438,1,6,0.167,4,5,0.8,0,1,1,4,2,0,1,1,19,37,1,Tyrese Maxey,PHI,PHI,DET,32.5,Pts+Asts,24,20,23,5
22023,1630178,22300327,"DEC 15, 2023",PHI vs. DET,W,27,7,16,0.438,1,6,0.167,4,5,0.8,0,1,1,4,2,0,1,1,19,37,1,Tyrese Maxey,PHI,PHI,DET,9.5,Rebs+Asts,24,20,23,5
22023,1630178,22300327,"DEC 15, 2023",PHI vs. DET,W,27,7,16,0.438,1,6,0.167,4,5,0.8,0,1,1,4,2,0,1,1,19,37,1,Tyrese Maxey,PHI,PHI,DET,1.5,Blks+Stls,24,20,23,5
22023,1630178,22300310,"DEC 13, 2023",PHI @ DET,W,33,2,13,0.154,0,6,0.0,5,6,0.833,1,3,4,9,0,0,1,1,9,22,1,Tyrese Maxey,PHI,DET,PHI,25.5,Points,22,13,18,13
22023,1630178,22300310,"DEC 13, 2023",PHI @ DET,W,33,2,13,0.154,0,6,0.0,5,6,0.833,1,3,4,9,0,0,1,1,9,22,1,Tyrese Maxey,PHI,DET,PHI,35.5,Pts+Rebs+Asts,22,13,18,13
22023,1630178,22300310,"DEC 13, 2023",PHI @ DET,W,33,2,13,0.154,0,6,0.0,5,6,0.833,1,3,4,9,0,0,1,1,9,22,1,Tyrese Maxey,PHI,DET,PHI,6.5,Assists,22,13,18,13
22023,1630178,22300310,"DEC 13, 2023",PHI @ DET,W,33,2,13,0.154,0,6,0.0,5,6,0.833,1,3,4,9,0,0,1,1,9,22,1,Tyrese Maxey,PHI,DET,PHI,42.0,Fantasy Score,22,13,18,13
22023,1630178,22300310,"DEC 13, 2023",PHI @ DET,W,33,2,13,0.154,0,6,0.0,5,6,0.833,1,3,4,9,0,0,1,1,9,22,1,Tyrese Maxey,PHI,DET,PHI,7.5,3-PT Attempted,22,13,18,13
22023,1630178,22300310,"DEC 13, 2023",PHI @ DET,W,33,2,13,0.154,0,6,0.0,5,6,0.833,1,3,4,9,0,0,1,1,9,22,1,Tyrese Maxey,PHI,DET,PHI,4.5,Free Throws Made,22,13,18,13
22023,1630178,22300310,"DEC 13, 2023",PHI @ DET,W,33,2,13,0.154,0,6,0.0,5,6,0.833,1,3,4,9,0,0,1,1,9,22,1,Tyrese Maxey,PHI,DET,PHI,18.5,FG Attempted,22,13,18,13
22023,1630178,22300310,"DEC 13, 2023",PHI @ DET,W,33,2,13,0.154,0,6,0.0,5,6,0.833,1,3,4,9,0,0,1,1,9,22,1,Tyrese Maxey,PHI,DET,PHI,28.5,Pts+Rebs,22,13,18,13
22023,1630178,22300310,"DEC 13, 2023",PHI @ DET,W,33,2,13,0.154,0,6,0.0,5,6,0.833,1,3,4,9,0,0,1,1,9,22,1,Tyrese Maxey,PHI,DET,PHI,32.5,Pts+Asts,22,13,18,13
22023,1630178,22300310,"DEC 13, 2023",PHI @ DET,W,33,2,13,0.154,0,6,0.0,5,6,0.833,1,3,4,9,0,0,1,1,9,22,1,Tyrese Maxey,PHI,DET,PHI,9.5,Rebs+Asts,22,13,18,13
22023,1630178,22300310,"DEC 13, 2023",PHI @ DET,W,33,2,13,0.154,0,6,0.0,5,6,0.833,1,3,4,9,0,0,1,1,9,22,1,Tyrese Maxey,PHI,DET,PHI,1.5,Blks+Stls,22,13,18,13
22023,1630178,22300295,"DEC 11, 2023",PHI vs. WAS,W,25,8,13,0.615,5,9,0.556,3,3,1.0,0,1,1,6,0,0,2,1,24,26,1,Tyrese Maxey,PHI,PHI,WAS,25.5,Points,31,25,30,7
22023,1630178,22300295,"DEC 11, 2023",PHI vs. WAS,W,25,8,13,0.615,5,9,0.556,3,3,1.0,0,1,1,6,0,0,2,1,24,26,1,Tyrese Maxey,PHI,PHI,WAS,35.5,Pts+Rebs+Asts,31,25,30,7
22023,1630178,22300295,"DEC 11, 2023",PHI vs. WAS,W,25,8,13,0.615,5,9,0.556,3,3,1.0,0,1,1,6,0,0,2,1,24,26,1,Tyrese Maxey,PHI,PHI,WAS,6.5,Assists,31,25,30,7
22023,1630178,22300295,"DEC 11, 2023",PHI vs. WAS,W,25,8,13,0.615,5,9,0.556,3,3,1.0,0,1,1,6,0,0,2,1,24,26,1,Tyrese Maxey,PHI,PHI,WAS,42.0,Fantasy Score,31,25,30,7
22023,1630178,22300295,"DEC 11, 2023",PHI vs. WAS,W,25,8,13,0.615,5,9,0.556,3,3,1.0,0,1,1,6,0,0,2,1,24,26,1,Tyrese Maxey,PHI,PHI,WAS,7.5,3-PT Attempted,31,25,30,7
22023,1630178,22300295,"DEC 11, 2023",PHI vs. WAS,W,25,8,13,0.615,5,9,0.556,3,3,1.0,0,1,1,6,0,0,2,1,24,26,1,Tyrese Maxey,PHI,PHI,WAS,4.5,Free Throws Made,31,25,30,7
22023,1630178,22300295,"DEC 11, 2023",PHI vs. WAS,W,25,8,13,0.615,5,9,0.556,3,3,1.0,0,1,1,6,0,0,2,1,24,26,1,Tyrese Maxey,PHI,PHI,WAS,18.5,FG Attempted,31,25,30,7
22023,1630178,22300295,"DEC 11, 2023",PHI vs. WAS,W,25,8,13,0.615,5,9,0.556,3,3,1.0,0,1,1,6,0,0,2,1,24,26,1,Tyrese Maxey,PHI,PHI,WAS,28.5,Pts+Rebs,31,25,30,7
22023,1630178,22300295,"DEC 11, 2023",PHI vs. WAS,W,25,8,13,0.615,5,9,0.556,3,3,1.0,0,1,1,6,0,0,2,1,24,26,1,Tyrese Maxey,PHI,PHI,WAS,32.5,Pts+Asts,31,25,30,7
22023,1630178,22300295,"DEC 11, 2023",PHI vs. WAS,W,25,8,13,0.615,5,9,0.556,3,3,1.0,0,1,1,6,0,0,2,1,24,26,1,Tyrese Maxey,PHI,PHI,WAS,9.5,Rebs+Asts,31,25,30,7
22023,1630178,22300295,"DEC 11, 2023",PHI vs. WAS,W,25,8,13,0.615,5,9,0.556,3,3,1.0,0,1,1,6,0,0,2,1,24,26,1,Tyrese Maxey,PHI,PHI,WAS,1.5,Blks+Stls,31,25,30,7
22023,1630178,22301218,"DEC 08, 2023",PHI vs. ATL,W,39,8,18,0.444,4,8,0.5,10,12,0.833,0,2,2,7,1,1,0,3,30,-1,1,Tyrese Maxey,PHI,PHI,ATL,25.5,Points,39,32,37,9
22023,1630178,22301218,"DEC 08, 2023",PHI vs. ATL,W,39,8,18,0.444,4,8,0.5,10,12,0.833,0,2,2,7,1,1,0,3,30,-1,1,Tyrese Maxey,PHI,PHI,ATL,35.5,Pts+Rebs+Asts,39,32,37,9
22023,1630178,22301218,"DEC 08, 2023",PHI vs. ATL,W,39,8,18,0.444,4,8,0.5,10,12,0.833,0,2,2,7,1,1,0,3,30,-1,1,Tyrese Maxey,PHI,PHI,ATL,6.5,Assists,39,32,37,9
22023,1630178,22301218,"DEC 08, 2023",PHI vs. ATL,W,39,8,18,0.444,4,8,0.5,10,12,0.833,0,2,2,7,1,1,0,3,30,-1,1,Tyrese Maxey,PHI,PHI,ATL,42.0,Fantasy Score,39,32,37,9
22023,1630178,22301218,"DEC 08, 2023",PHI vs. ATL,W,39,8,18,0.444,4,8,0.5,10,12,0.833,0,2,2,7,1,1,0,3,30,-1,1,Tyrese Maxey,PHI,PHI,ATL,7.5,3-PT Attempted,39,32,37,9
22023,1630178,22301218,"DEC 08, 2023",PHI vs. ATL,W,39,8,18,0.444,4,8,0.5,10,12,0.833,0,2,2,7,1,1,0,3,30,-1,1,Tyrese Maxey,PHI,PHI,ATL,4.5,Free Throws Made,39,32,37,9
22023,1630178,22301218,"DEC 08, 2023",PHI vs. ATL,W,39,8,18,0.444,4,8,0.5,10,12,0.833,0,2,2,7,1,1,0,3,30,-1,1,Tyrese Maxey,PHI,PHI,ATL,18.5,FG Attempted,39,32,37,9
22023,1630178,22301218,"DEC 08, 2023",PHI vs. ATL,W,39,8,18,0.444,4,8,0.5,10,12,0.833,0,2,2,7,1,1,0,3,30,-1,1,Tyrese Maxey,PHI,PHI,ATL,28.5,Pts+Rebs,39,32,37,9
22023,1630178,22301218,"DEC 08, 2023",PHI vs. ATL,W,39,8,18,0.444,4,8,0.5,10,12,0.833,0,2,2,7,1,1,0,3,30,-1,1,Tyrese Maxey,PHI,PHI,ATL,32.5,Pts+Asts,39,32,37,9
22023,1630178,22301218,"DEC 08, 2023",PHI vs. ATL,W,39,8,18,0.444,4,8,0.5,10,12,0.833,0,2,2,7,1,1,0,3,30,-1,1,Tyrese Maxey,PHI,PHI,ATL,9.5,Rebs+Asts,39,32,37,9
22023,1630178,22301218,"DEC 08, 2023",PHI vs. ATL,W,39,8,18,0.444,4,8,0.5,10,12,0.833,0,2,2,7,1,1,0,3,30,-1,1,Tyrese Maxey,PHI,PHI,ATL,1.5,Blks+Stls,39,32,37,9
22023,1630178,22301208,"DEC 06, 2023",PHI @ WAS,W,38,10,20,0.5,2,6,0.333,4,4,1.0,0,1,1,7,1,0,0,2,26,12,1,Tyrese Maxey,PHI,WAS,PHI,25.5,Points,34,27,33,8
22023,1630178,22301208,"DEC 06, 2023",PHI @ WAS,W,38,10,20,0.5,2,6,0.333,4,4,1.0,0,1,1,7,1,0,0,2,26,12,1,Tyrese Maxey,PHI,WAS,PHI,35.5,Pts+Rebs+Asts,34,27,33,8
22023,1630178,22301208,"DEC 06, 2023",PHI @ WAS,W,38,10,20,0.5,2,6,0.333,4,4,1.0,0,1,1,7,1,0,0,2,26,12,1,Tyrese Maxey,PHI,WAS,PHI,6.5,Assists,34,27,33,8
22023,1630178,22301208,"DEC 06, 2023",PHI @ WAS,W,38,10,20,0.5,2,6,0.333,4,4,1.0,0,1,1,7,1,0,0,2,26,12,1,Tyrese Maxey,PHI,WAS,PHI,42.0,Fantasy Score,34,27,33,8
22023,1630178,22301208,"DEC 06, 2023",PHI @ WAS,W,38,10,20,0.5,2,6,0.333,4,4,1.0,0,1,1,7,1,0,0,2,26,12,1,Tyrese Maxey,PHI,WAS,PHI,7.5,3-PT Attempted,34,27,33,8
22023,1630178,22301208,"DEC 06, 2023",PHI @ WAS,W,38,10,20,0.5,2,6,0.333,4,4,1.0,0,1,1,7,1,0,0,2,26,12,1,Tyrese Maxey,PHI,WAS,PHI,4.5,Free Throws Made,34,27,33,8
22023,1630178,22301208,"DEC 06, 2023",PHI @ WAS,W,38,10,20,0.5,2,6,0.333,4,4,1.0,0,1,1,7,1,0,0,2,26,12,1,Tyrese Maxey,PHI,WAS,PHI,18.5,FG Attempted,34,27,33,8
22023,1630178,22301208,"DEC 06, 2023",PHI @ WAS,W,38,10,20,0.5,2,6,0.333,4,4,1.0,0,1,1,7,1,0,0,2,26,12,1,Tyrese Maxey,PHI,WAS,PHI,28.5,Pts+Rebs,34,27,33,8
22023,1630178,22301208,"DEC 06, 2023",PHI @ WAS,W,38,10,20,0.5,2,6,0.333,4,4,1.0,0,1,1,7,1,0,0,2,26,12,1,Tyrese Maxey,PHI,WAS,PHI,32.5,Pts+Asts,34,27,33,8
22023,1630178,22301208,"DEC 06, 2023",PHI @ WAS,W,38,10,20,0.5,2,6,0.333,4,4,1.0,0,1,1,7,1,0,0,2,26,12,1,Tyrese Maxey,PHI,WAS,PHI,9.5,Rebs+Asts,34,27,33,8
22023,1630178,22301208,"DEC 06, 2023",PHI @ WAS,W,38,10,20,0.5,2,6,0.333,4,4,1.0,0,1,1,7,1,0,0,2,26,12,1,Tyrese Maxey,PHI,WAS,PHI,1.5,Blks+Stls,34,27,33,8
22023,1630178,22300262,"NOV 29, 2023",PHI @ NOP,L,38,13,25,0.52,3,10,0.3,4,4,1.0,0,1,1,3,2,0,4,2,33,-11,1,Tyrese Maxey,PHI,NOP,PHI,25.5,Points,37,34,36,4
22023,1630178,22300262,"NOV 29, 2023",PHI @ NOP,L,38,13,25,0.52,3,10,0.3,4,4,1.0,0,1,1,3,2,0,4,2,33,-11,1,Tyrese Maxey,PHI,NOP,PHI,35.5,Pts+Rebs+Asts,37,34,36,4
22023,1630178,22300262,"NOV 29, 2023",PHI @ NOP,L,38,13,25,0.52,3,10,0.3,4,4,1.0,0,1,1,3,2,0,4,2,33,-11,1,Tyrese Maxey,PHI,NOP,PHI,6.5,Assists,37,34,36,4
22023,1630178,22300262,"NOV 29, 2023",PHI @ NOP,L,38,13,25,0.52,3,10,0.3,4,4,1.0,0,1,1,3,2,0,4,2,33,-11,1,Tyrese Maxey,PHI,NOP,PHI,42.0,Fantasy Score,37,34,36,4
22023,1630178,22300262,"NOV 29, 2023",PHI @ NOP,L,38,13,25,0.52,3,10,0.3,4,4,1.0,0,1,1,3,2,0,4,2,33,-11,1,Tyrese Maxey,PHI,NOP,PHI,7.5,3-PT Attempted,37,34,36,4
22023,1630178,22300262,"NOV 29, 2023",PHI @ NOP,L,38,13,25,0.52,3,10,0.3,4,4,1.0,0,1,1,3,2,0,4,2,33,-11,1,Tyrese Maxey,PHI,NOP,PHI,4.5,Free Throws Made,37,34,36,4
22023,1630178,22300262,"NOV 29, 2023",PHI @ NOP,L,38,13,25,0.52,3,10,0.3,4,4,1.0,0,1,1,3,2,0,4,2,33,-11,1,Tyrese Maxey,PHI,NOP,PHI,18.5,FG Attempted,37,34,36,4
22023,1630178,22300262,"NOV 29, 2023",PHI @ NOP,L,38,13,25,0.52,3,10,0.3,4,4,1.0,0,1,1,3,2,0,4,2,33,-11,1,Tyrese Maxey,PHI,NOP,PHI,28.5,Pts+Rebs,37,34,36,4
22023,1630178,22300262,"NOV 29, 2023",PHI @ NOP,L,38,13,25,0.52,3,10,0.3,4,4,1.0,0,1,1,3,2,0,4,2,33,-11,1,Tyrese Maxey,PHI,NOP,PHI,32.5,Pts+Asts,37,34,36,4
22023,1630178,22300262,"NOV 29, 2023",PHI @ NOP,L,38,13,25,0.52,3,10,0.3,4,4,1.0,0,1,1,3,2,0,4,2,33,-11,1,Tyrese Maxey,PHI,NOP,PHI,9.5,Rebs+Asts,37,34,36,4
22023,1630178,22300262,"NOV 29, 2023",PHI @ NOP,L,38,13,25,0.52,3,10,0.3,4,4,1.0,0,1,1,3,2,0,4,2,33,-11,1,Tyrese Maxey,PHI,NOP,PHI,1.5,Blks+Stls,37,34,36,4
22023,1630178,22300255,"NOV 27, 2023",PHI vs. LAL,W,36,9,20,0.45,5,12,0.417,8,9,0.889,0,3,3,8,1,0,0,2,31,25,1,Tyrese Maxey,PHI,PHI,LAL,25.5,Points,42,34,39,11
22023,1630178,22300255,"NOV 27, 2023",PHI vs. LAL,W,36,9,20,0.45,5,12,0.417,8,9,0.889,0,3,3,8,1,0,0,2,31,25,1,Tyrese Maxey,PHI,PHI,LAL,35.5,Pts+Rebs+Asts,42,34,39,11
22023,1630178,22300255,"NOV 27, 2023",PHI vs. LAL,W,36,9,20,0.45,5,12,0.417,8,9,0.889,0,3,3,8,1,0,0,2,31,25,1,Tyrese Maxey,PHI,PHI,LAL,6.5,Assists,42,34,39,11
22023,1630178,22300255,"NOV 27, 2023",PHI vs. LAL,W,36,9,20,0.45,5,12,0.417,8,9,0.889,0,3,3,8,1,0,0,2,31,25,1,Tyrese Maxey,PHI,PHI,LAL,42.0,Fantasy Score,42,34,39,11
22023,1630178,22300255,"NOV 27, 2023",PHI vs. LAL,W,36,9,20,0.45,5,12,0.417,8,9,0.889,0,3,3,8,1,0,0,2,31,25,1,Tyrese Maxey,PHI,PHI,LAL,7.5,3-PT Attempted,42,34,39,11
22023,1630178,22300255,"NOV 27, 2023",PHI vs. LAL,W,36,9,20,0.45,5,12,0.417,8,9,0.889,0,3,3,8,1,0,0,2,31,25,1,Tyrese Maxey,PHI,PHI,LAL,4.5,Free Throws Made,42,34,39,11
22023,1630178,22300255,"NOV 27, 2023",PHI vs. LAL,W,36,9,20,0.45,5,12,0.417,8,9,0.889,0,3,3,8,1,0,0,2,31,25,1,Tyrese Maxey,PHI,PHI,LAL,18.5,FG Attempted,42,34,39,11
22023,1630178,22300255,"NOV 27, 2023",PHI vs. LAL,W,36,9,20,0.45,5,12,0.417,8,9,0.889,0,3,3,8,1,0,0,2,31,25,1,Tyrese Maxey,PHI,PHI,LAL,28.5,Pts+Rebs,42,34,39,11
22023,1630178,22300255,"NOV 27, 2023",PHI vs. LAL,W,36,9,20,0.45,5,12,0.417,8,9,0.889,0,3,3,8,1,0,0,2,31,25,1,Tyrese Maxey,PHI,PHI,LAL,32.5,Pts+Asts,42,34,39,11
22023,1630178,22300255,"NOV 27, 2023",PHI vs. LAL,W,36,9,20,0.45,5,12,0.417,8,9,0.889,0,3,3,8,1,0,0,2,31,25,1,Tyrese Maxey,PHI,PHI,LAL,9.5,Rebs+Asts,42,34,39,11
22023,1630178,22300255,"NOV 27, 2023",PHI vs. LAL,W,36,9,20,0.45,5,12,0.417,8,9,0.889,0,3,3,8,1,0,0,2,31,25,1,Tyrese Maxey,PHI,PHI,LAL,1.5,Blks+Stls,42,34,39,11
22023,1630178,22300239,"NOV 25, 2023",PHI @ OKC,W,41,8,17,0.471,3,9,0.333,9,11,0.818,1,7,8,3,0,1,1,5,28,6,1,Tyrese Maxey,PHI,OKC,PHI,25.5,Points,39,36,31,11
22023,1630178,22300239,"NOV 25, 2023",PHI @ OKC,W,41,8,17,0.471,3,9,0.333,9,11,0.818,1,7,8,3,0,1,1,5,28,6,1,Tyrese Maxey,PHI,OKC,PHI,35.5,Pts+Rebs+Asts,39,36,31,11
22023,1630178,22300239,"NOV 25, 2023",PHI @ OKC,W,41,8,17,0.471,3,9,0.333,9,11,0.818,1,7,8,3,0,1,1,5,28,6,1,Tyrese Maxey,PHI,OKC,PHI,6.5,Assists,39,36,31,11
22023,1630178,22300239,"NOV 25, 2023",PHI @ OKC,W,41,8,17,0.471,3,9,0.333,9,11,0.818,1,7,8,3,0,1,1,5,28,6,1,Tyrese Maxey,PHI,OKC,PHI,42.0,Fantasy Score,39,36,31,11
22023,1630178,22300239,"NOV 25, 2023",PHI @ OKC,W,41,8,17,0.471,3,9,0.333,9,11,0.818,1,7,8,3,0,1,1,5,28,6,1,Tyrese Maxey,PHI,OKC,PHI,7.5,3-PT Attempted,39,36,31,11
22023,1630178,22300239,"NOV 25, 2023",PHI @ OKC,W,41,8,17,0.471,3,9,0.333,9,11,0.818,1,7,8,3,0,1,1,5,28,6,1,Tyrese Maxey,PHI,OKC,PHI,4.5,Free Throws Made,39,36,31,11
22023,1630178,22300239,"NOV 25, 2023",PHI @ OKC,W,41,8,17,0.471,3,9,0.333,9,11,0.818,1,7,8,3,0,1,1,5,28,6,1,Tyrese Maxey,PHI,OKC,PHI,18.5,FG Attempted,39,36,31,11
22023,1630178,22300239,"NOV 25, 2023",PHI @ OKC,W,41,8,17,0.471,3,9,0.333,9,11,0.818,1,7,8,3,0,1,1,5,28,6,1,Tyrese Maxey,PHI,OKC,PHI,28.5,Pts+Rebs,39,36,31,11
22023,1630178,22300239,"NOV 25, 2023",PHI @ OKC,W,41,8,17,0.471,3,9,0.333,9,11,0.818,1,7,8,3,0,1,1,5,28,6,1,Tyrese Maxey,PHI,OKC,PHI,32.5,Pts+Asts,39,36,31,11
22023,1630178,22300239,"NOV 25, 2023",PHI @ OKC,W,41,8,17,0.471,3,9,0.333,9,11,0.818,1,7,8,3,0,1,1,5,28,6,1,Tyrese Maxey,PHI,OKC,PHI,9.5,Rebs+Asts,39,36,31,11
22023,1630178,22300239,"NOV 25, 2023",PHI @ OKC,W,41,8,17,0.471,3,9,0.333,9,11,0.818,1,7,8,3,0,1,1,5,28,6,1,Tyrese Maxey,PHI,OKC,PHI,1.5,Blks+Stls,39,36,31,11
22023,1630178,22300232,"NOV 22, 2023",PHI @ MIN,L,34,7,19,0.368,0,5,0.0,2,4,0.5,2,3,5,8,0,1,3,0,16,-18,1,Tyrese Maxey,PHI,MIN,PHI,25.5,Points,29,21,24,13
22023,1630178,22300232,"NOV 22, 2023",PHI @ MIN,L,34,7,19,0.368,0,5,0.0,2,4,0.5,2,3,5,8,0,1,3,0,16,-18,1,Tyrese Maxey,PHI,MIN,PHI,35.5,Pts+Rebs+Asts,29,21,24,13
22023,1630178,22300232,"NOV 22, 2023",PHI @ MIN,L,34,7,19,0.368,0,5,0.0,2,4,0.5,2,3,5,8,0,1,3,0,16,-18,1,Tyrese Maxey,PHI,MIN,PHI,6.5,Assists,29,21,24,13
22023,1630178,22300232,"NOV 22, 2023",PHI @ MIN,L,34,7,19,0.368,0,5,0.0,2,4,0.5,2,3,5,8,0,1,3,0,16,-18,1,Tyrese Maxey,PHI,MIN,PHI,42.0,Fantasy Score,29,21,24,13
22023,1630178,22300232,"NOV 22, 2023",PHI @ MIN,L,34,7,19,0.368,0,5,0.0,2,4,0.5,2,3,5,8,0,1,3,0,16,-18,1,Tyrese Maxey,PHI,MIN,PHI,7.5,3-PT Attempted,29,21,24,13
22023,1630178,22300232,"NOV 22, 2023",PHI @ MIN,L,34,7,19,0.368,0,5,0.0,2,4,0.5,2,3,5,8,0,1,3,0,16,-18,1,Tyrese Maxey,PHI,MIN,PHI,4.5,Free Throws Made,29,21,24,13
22023,1630178,22300232,"NOV 22, 2023",PHI @ MIN,L,34,7,19,0.368,0,5,0.0,2,4,0.5,2,3,5,8,0,1,3,0,16,-18,1,Tyrese Maxey,PHI,MIN,PHI,18.5,FG Attempted,29,21,24,13
22023,1630178,22300232,"NOV 22, 2023",PHI @ MIN,L,34,7,19,0.368,0,5,0.0,2,4,0.5,2,3,5,8,0,1,3,0,16,-18,1,Tyrese Maxey,PHI,MIN,PHI,28.5,Pts+Rebs,29,21,24,13
22023,1630178,22300232,"NOV 22, 2023",PHI @ MIN,L,34,7,19,0.368,0,5,0.0,2,4,0.5,2,3,5,8,0,1,3,0,16,-18,1,Tyrese Maxey,PHI,MIN,PHI,32.5,Pts+Asts,29,21,24,13
22023,1630178,22300232,"NOV 22, 2023",PHI @ MIN,L,34,7,19,0.368,0,5,0.0,2,4,0.5,2,3,5,8,0,1,3,0,16,-18,1,Tyrese Maxey,PHI,MIN,PHI,9.5,Rebs+Asts,29,21,24,13
22023,1630178,22300232,"NOV 22, 2023",PHI @ MIN,L,34,7,19,0.368,0,5,0.0,2,4,0.5,2,3,5,8,0,1,3,0,16,-18,1,Tyrese Maxey,PHI,MIN,PHI,1.5,Blks+Stls,29,21,24,13
22023,1630178,22300040,"NOV 21, 2023",PHI vs. CLE,L,47,11,28,0.393,3,12,0.25,5,7,0.714,0,4,4,6,1,0,1,2,30,-8,1,Tyrese Maxey,PHI,PHI,CLE,25.5,Points,40,34,36,10
22023,1630178,22300040,"NOV 21, 2023",PHI vs. CLE,L,47,11,28,0.393,3,12,0.25,5,7,0.714,0,4,4,6,1,0,1,2,30,-8,1,Tyrese Maxey,PHI,PHI,CLE,35.5,Pts+Rebs+Asts,40,34,36,10
22023,1630178,22300040,"NOV 21, 2023",PHI vs. CLE,L,47,11,28,0.393,3,12,0.25,5,7,0.714,0,4,4,6,1,0,1,2,30,-8,1,Tyrese Maxey,PHI,PHI,CLE,6.5,Assists,40,34,36,10
22023,1630178,22300040,"NOV 21, 2023",PHI vs. CLE,L,47,11,28,0.393,3,12,0.25,5,7,0.714,0,4,4,6,1,0,1,2,30,-8,1,Tyrese Maxey,PHI,PHI,CLE,42.0,Fantasy Score,40,34,36,10
22023,1630178,22300040,"NOV 21, 2023",PHI vs. CLE,L,47,11,28,0.393,3,12,0.25,5,7,0.714,0,4,4,6,1,0,1,2,30,-8,1,Tyrese Maxey,PHI,PHI,CLE,7.5,3-PT Attempted,40,34,36,10
22023,1630178,22300040,"NOV 21, 2023",PHI vs. CLE,L,47,11,28,0.393,3,12,0.25,5,7,0.714,0,4,4,6,1,0,1,2,30,-8,1,Tyrese Maxey,PHI,PHI,CLE,4.5,Free Throws Made,40,34,36,10
22023,1630178,22300040,"NOV 21, 2023",PHI vs. CLE,L,47,11,28,0.393,3,12,0.25,5,7,0.714,0,4,4,6,1,0,1,2,30,-8,1,Tyrese Maxey,PHI,PHI,CLE,18.5,FG Attempted,40,34,36,10
22023,1630178,22300040,"NOV 21, 2023",PHI vs. CLE,L,47,11,28,0.393,3,12,0.25,5,7,0.714,0,4,4,6,1,0,1,2,30,-8,1,Tyrese Maxey,PHI,PHI,CLE,28.5,Pts+Rebs,40,34,36,10
22023,1630178,22300040,"NOV 21, 2023",PHI vs. CLE,L,47,11,28,0.393,3,12,0.25,5,7,0.714,0,4,4,6,1,0,1,2,30,-8,1,Tyrese Maxey,PHI,PHI,CLE,32.5,Pts+Asts,40,34,36,10
22023,1630178,22300040,"NOV 21, 2023",PHI vs. CLE,L,47,11,28,0.393,3,12,0.25,5,7,0.714,0,4,4,6,1,0,1,2,30,-8,1,Tyrese Maxey,PHI,PHI,CLE,9.5,Rebs+Asts,40,34,36,10
22023,1630178,22300040,"NOV 21, 2023",PHI vs. CLE,L,47,11,28,0.393,3,12,0.25,5,7,0.714,0,4,4,6,1,0,1,2,30,-8,1,Tyrese Maxey,PHI,PHI,CLE,1.5,Blks+Stls,40,34,36,10
22023,1630178,22300208,"NOV 19, 2023",PHI @ BKN,W,36,8,20,0.4,6,11,0.545,3,3,1.0,1,1,2,10,0,0,1,0,25,21,1,Tyrese Maxey,PHI,BKN,PHI,25.5,Points,37,27,35,12
22023,1630178,22300208,"NOV 19, 2023",PHI @ BKN,W,36,8,20,0.4,6,11,0.545,3,3,1.0,1,1,2,10,0,0,1,0,25,21,1,Tyrese Maxey,PHI,BKN,PHI,35.5,Pts+Rebs+Asts,37,27,35,12
22023,1630178,22300208,"NOV 19, 2023",PHI @ BKN,W,36,8,20,0.4,6,11,0.545,3,3,1.0,1,1,2,10,0,0,1,0,25,21,1,Tyrese Maxey,PHI,BKN,PHI,6.5,Assists,37,27,35,12
22023,1630178,22300208,"NOV 19, 2023",PHI @ BKN,W,36,8,20,0.4,6,11,0.545,3,3,1.0,1,1,2,10,0,0,1,0,25,21,1,Tyrese Maxey,PHI,BKN,PHI,42.0,Fantasy Score,37,27,35,12
22023,1630178,22300208,"NOV 19, 2023",PHI @ BKN,W,36,8,20,0.4,6,11,0.545,3,3,1.0,1,1,2,10,0,0,1,0,25,21,1,Tyrese Maxey,PHI,BKN,PHI,7.5,3-PT Attempted,37,27,35,12
22023,1630178,22300208,"NOV 19, 2023",PHI @ BKN,W,36,8,20,0.4,6,11,0.545,3,3,1.0,1,1,2,10,0,0,1,0,25,21,1,Tyrese Maxey,PHI,BKN,PHI,4.5,Free Throws Made,37,27,35,12
22023,1630178,22300208,"NOV 19, 2023",PHI @ BKN,W,36,8,20,0.4,6,11,0.545,3,3,1.0,1,1,2,10,0,0,1,0,25,21,1,Tyrese Maxey,PHI,BKN,PHI,18.5,FG Attempted,37,27,35,12
22023,1630178,22300208,"NOV 19, 2023",PHI @ BKN,W,36,8,20,0.4,6,11,0.545,3,3,1.0,1,1,2,10,0,0,1,0,25,21,1,Tyrese Maxey,PHI,BKN,PHI,28.5,Pts+Rebs,37,27,35,12
22023,1630178,22300208,"NOV 19, 2023",PHI @ BKN,W,36,8,20,0.4,6,11,0.545,3,3,1.0,1,1,2,10,0,0,1,0,25,21,1,Tyrese Maxey,PHI,BKN,PHI,32.5,Pts+Asts,37,27,35,12
22023,1630178,22300208,"NOV 19, 2023",PHI @ BKN,W,36,8,20,0.4,6,11,0.545,3,3,1.0,1,1,2,10,0,0,1,0,25,21,1,Tyrese Maxey,PHI,BKN,PHI,9.5,Rebs+Asts,37,27,35,12
22023,1630178,22300208,"NOV 19, 2023",PHI @ BKN,W,36,8,20,0.4,6,11,0.545,3,3,1.0,1,1,2,10,0,0,1,0,25,21,1,Tyrese Maxey,PHI,BKN,PHI,1.5,Blks+Stls,37,27,35,12
22023,1630178,22300029,"NOV 17, 2023",PHI @ ATL,W,40,5,13,0.385,3,6,0.5,6,6,1.0,0,4,4,8,2,0,2,1,19,1,1,Tyrese Maxey,PHI,ATL,PHI,25.5,Points,31,23,27,12
22023,1630178,22300029,"NOV 17, 2023",PHI @ ATL,W,40,5,13,0.385,3,6,0.5,6,6,1.0,0,4,4,8,2,0,2,1,19,1,1,Tyrese Maxey,PHI,ATL,PHI,35.5,Pts+Rebs+Asts,31,23,27,12
22023,1630178,22300029,"NOV 17, 2023",PHI @ ATL,W,40,5,13,0.385,3,6,0.5,6,6,1.0,0,4,4,8,2,0,2,1,19,1,1,Tyrese Maxey,PHI,ATL,PHI,6.5,Assists,31,23,27,12
22023,1630178,22300029,"NOV 17, 2023",PHI @ ATL,W,40,5,13,0.385,3,6,0.5,6,6,1.0,0,4,4,8,2,0,2,1,19,1,1,Tyrese Maxey,PHI,ATL,PHI,42.0,Fantasy Score,31,23,27,12
22023,1630178,22300029,"NOV 17, 2023",PHI @ ATL,W,40,5,13,0.385,3,6,0.5,6,6,1.0,0,4,4,8,2,0,2,1,19,1,1,Tyrese Maxey,PHI,ATL,PHI,7.5,3-PT Attempted,31,23,27,12
22023,1630178,22300029,"NOV 17, 2023",PHI @ ATL,W,40,5,13,0.385,3,6,0.5,6,6,1.0,0,4,4,8,2,0,2,1,19,1,1,Tyrese Maxey,PHI,ATL,PHI,4.5,Free Throws Made,31,23,27,12
22023,1630178,22300029,"NOV 17, 2023",PHI @ ATL,W,40,5,13,0.385,3,6,0.5,6,6,1.0,0,4,4,8,2,0,2,1,19,1,1,Tyrese Maxey,PHI,ATL,PHI,18.5,FG Attempted,31,23,27,12
22023,1630178,22300029,"NOV 17, 2023",PHI @ ATL,W,40,5,13,0.385,3,6,0.5,6,6,1.0,0,4,4,8,2,0,2,1,19,1,1,Tyrese Maxey,PHI,ATL,PHI,28.5,Pts+Rebs,31,23,27,12
22023,1630178,22300029,"NOV 17, 2023",PHI @ ATL,W,40,5,13,0.385,3,6,0.5,6,6,1.0,0,4,4,8,2,0,2,1,19,1,1,Tyrese Maxey,PHI,ATL,PHI,32.5,Pts+Asts,31,23,27,12
22023,1630178,22300029,"NOV 17, 2023",PHI @ ATL,W,40,5,13,0.385,3,6,0.5,6,6,1.0,0,4,4,8,2,0,2,1,19,1,1,Tyrese Maxey,PHI,ATL,PHI,9.5,Rebs+Asts,31,23,27,12
22023,1630178,22300029,"NOV 17, 2023",PHI @ ATL,W,40,5,13,0.385,3,6,0.5,6,6,1.0,0,4,4,8,2,0,2,1,19,1,1,Tyrese Maxey,PHI,ATL,PHI,1.5,Blks+Stls,31,23,27,12
22023,1630178,22300194,"NOV 15, 2023",PHI vs. BOS,L,39,6,15,0.4,3,7,0.429,5,5,1.0,0,3,3,4,0,0,2,3,20,9,1,Tyrese Maxey,PHI,PHI,BOS,25.5,Points,27,23,24,7
22023,1630178,22300194,"NOV 15, 2023",PHI vs. BOS,L,39,6,15,0.4,3,7,0.429,5,5,1.0,0,3,3,4,0,0,2,3,20,9,1,Tyrese Maxey,PHI,PHI,BOS,35.5,Pts+Rebs+Asts,27,23,24,7
22023,1630178,22300194,"NOV 15, 2023",PHI vs. BOS,L,39,6,15,0.4,3,7,0.429,5,5,1.0,0,3,3,4,0,0,2,3,20,9,1,Tyrese Maxey,PHI,PHI,BOS,6.5,Assists,27,23,24,7
22023,1630178,22300194,"NOV 15, 2023",PHI vs. BOS,L,39,6,15,0.4,3,7,0.429,5,5,1.0,0,3,3,4,0,0,2,3,20,9,1,Tyrese Maxey,PHI,PHI,BOS,42.0,Fantasy Score,27,23,24,7
22023,1630178,22300194,"NOV 15, 2023",PHI vs. BOS,L,39,6,15,0.4,3,7,0.429,5,5,1.0,0,3,3,4,0,0,2,3,20,9,1,Tyrese Maxey,PHI,PHI,BOS,7.5,3-PT Attempted,27,23,24,7
22023,1630178,22300194,"NOV 15, 2023",PHI vs. BOS,L,39,6,15,0.4,3,7,0.429,5,5,1.0,0,3,3,4,0,0,2,3,20,9,1,Tyrese Maxey,PHI,PHI,BOS,4.5,Free Throws Made,27,23,24,7
22023,1630178,22300194,"NOV 15, 2023",PHI vs. BOS,L,39,6,15,0.4,3,7,0.429,5,5,1.0,0,3,3,4,0,0,2,3,20,9,1,Tyrese Maxey,PHI,PHI,BOS,18.5,FG Attempted,27,23,24,7
22023,1630178,22300194,"NOV 15, 2023",PHI vs. BOS,L,39,6,15,0.4,3,7,0.429,5,5,1.0,0,3,3,4,0,0,2,3,20,9,1,Tyrese Maxey,PHI,PHI,BOS,28.5,Pts+Rebs,27,23,24,7
22023,1630178,22300194,"NOV 15, 2023",PHI vs. BOS,L,39,6,15,0.4,3,7,0.429,5,5,1.0,0,3,3,4,0,0,2,3,20,9,1,Tyrese Maxey,PHI,PHI,BOS,32.5,Pts+Asts,27,23,24,7
22023,1630178,22300194,"NOV 15, 2023",PHI vs. BOS,L,39,6,15,0.4,3,7,0.429,5,5,1.0,0,3,3,4,0,0,2,3,20,9,1,Tyrese Maxey,PHI,PHI,BOS,9.5,Rebs+Asts,27,23,24,7
22023,1630178,22300194,"NOV 15, 2023",PHI vs. BOS,L,39,6,15,0.4,3,7,0.429,5,5,1.0,0,3,3,4,0,0,2,3,20,9,1,Tyrese Maxey,PHI,PHI,BOS,1.5,Blks+Stls,27,23,24,7
22023,1630178,22300019,"NOV 14, 2023",PHI vs. IND,L,38,9,23,0.391,2,5,0.4,7,7,1.0,0,4,4,5,0,1,4,2,27,-6,1,Tyrese Maxey,PHI,PHI,IND,25.5,Points,36,31,32,9
22023,1630178,22300019,"NOV 14, 2023",PHI vs. IND,L,38,9,23,0.391,2,5,0.4,7,7,1.0,0,4,4,5,0,1,4,2,27,-6,1,Tyrese Maxey,PHI,PHI,IND,35.5,Pts+Rebs+Asts,36,31,32,9
22023,1630178,22300019,"NOV 14, 2023",PHI vs. IND,L,38,9,23,0.391,2,5,0.4,7,7,1.0,0,4,4,5,0,1,4,2,27,-6,1,Tyrese Maxey,PHI,PHI,IND,6.5,Assists,36,31,32,9
22023,1630178,22300019,"NOV 14, 2023",PHI vs. IND,L,38,9,23,0.391,2,5,0.4,7,7,1.0,0,4,4,5,0,1,4,2,27,-6,1,Tyrese Maxey,PHI,PHI,IND,42.0,Fantasy Score,36,31,32,9
22023,1630178,22300019,"NOV 14, 2023",PHI vs. IND,L,38,9,23,0.391,2,5,0.4,7,7,1.0,0,4,4,5,0,1,4,2,27,-6,1,Tyrese Maxey,PHI,PHI,IND,7.5,3-PT Attempted,36,31,32,9
22023,1630178,22300019,"NOV 14, 2023",PHI vs. IND,L,38,9,23,0.391,2,5,0.4,7,7,1.0,0,4,4,5,0,1,4,2,27,-6,1,Tyrese Maxey,PHI,PHI,IND,4.5,Free Throws Made,36,31,32,9
22023,1630178,22300019,"NOV 14, 2023",PHI vs. IND,L,38,9,23,0.391,2,5,0.4,7,7,1.0,0,4,4,5,0,1,4,2,27,-6,1,Tyrese Maxey,PHI,PHI,IND,18.5,FG Attempted,36,31,32,9
22023,1630178,22300019,"NOV 14, 2023",PHI vs. IND,L,38,9,23,0.391,2,5,0.4,7,7,1.0,0,4,4,5,0,1,4,2,27,-6,1,Tyrese Maxey,PHI,PHI,IND,28.5,Pts+Rebs,36,31,32,9
22023,1630178,22300019,"NOV 14, 2023",PHI vs. IND,L,38,9,23,0.391,2,5,0.4,7,7,1.0,0,4,4,5,0,1,4,2,27,-6,1,Tyrese Maxey,PHI,PHI,IND,32.5,Pts+Asts,36,31,32,9
22023,1630178,22300019,"NOV 14, 2023",PHI vs. IND,L,38,9,23,0.391,2,5,0.4,7,7,1.0,0,4,4,5,0,1,4,2,27,-6,1,Tyrese Maxey,PHI,PHI,IND,9.5,Rebs+Asts,36,31,32,9
22023,1630178,22300019,"NOV 14, 2023",PHI vs. IND,L,38,9,23,0.391,2,5,0.4,7,7,1.0,0,4,4,5,0,1,4,2,27,-6,1,Tyrese Maxey,PHI,PHI,IND,1.5,Blks+Stls,36,31,32,9
22023,1630178,22300180,"NOV 12, 2023",PHI vs. IND,W,39,20,32,0.625,7,11,0.636,3,3,1.0,3,4,7,5,0,3,2,2,50,17,1,Tyrese Maxey,PHI,PHI,IND,25.5,Points,62,57,55,12
22023,1630178,22300180,"NOV 12, 2023",PHI vs. IND,W,39,20,32,0.625,7,11,0.636,3,3,1.0,3,4,7,5,0,3,2,2,50,17,1,Tyrese Maxey,PHI,PHI,IND,35.5,Pts+Rebs+Asts,62,57,55,12
22023,1630178,22300180,"NOV 12, 2023",PHI vs. IND,W,39,20,32,0.625,7,11,0.636,3,3,1.0,3,4,7,5,0,3,2,2,50,17,1,Tyrese Maxey,PHI,PHI,IND,6.5,Assists,62,57,55,12
22023,1630178,22300180,"NOV 12, 2023",PHI vs. IND,W,39,20,32,0.625,7,11,0.636,3,3,1.0,3,4,7,5,0,3,2,2,50,17,1,Tyrese Maxey,PHI,PHI,IND,42.0,Fantasy Score,62,57,55,12
22023,1630178,22300180,"NOV 12, 2023",PHI vs. IND,W,39,20,32,0.625,7,11,0.636,3,3,1.0,3,4,7,5,0,3,2,2,50,17,1,Tyrese Maxey,PHI,PHI,IND,7.5,3-PT Attempted,62,57,55,12
22023,1630178,22300180,"NOV 12, 2023",PHI vs. IND,W,39,20,32,0.625,7,11,0.636,3,3,1.0,3,4,7,5,0,3,2,2,50,17,1,Tyrese Maxey,PHI,PHI,IND,4.5,Free Throws Made,62,57,55,12
22023,1630178,22300180,"NOV 12, 2023",PHI vs. IND,W,39,20,32,0.625,7,11,0.636,3,3,1.0,3,4,7,5,0,3,2,2,50,17,1,Tyrese Maxey,PHI,PHI,IND,18.5,FG Attempted,62,57,55,12
22023,1630178,22300180,"NOV 12, 2023",PHI vs. IND,W,39,20,32,0.625,7,11,0.636,3,3,1.0,3,4,7,5,0,3,2,2,50,17,1,Tyrese Maxey,PHI,PHI,IND,28.5,Pts+Rebs,62,57,55,12
22023,1630178,22300180,"NOV 12, 2023",PHI vs. IND,W,39,20,32,0.625,7,11,0.636,3,3,1.0,3,4,7,5,0,3,2,2,50,17,1,Tyrese Maxey,PHI,PHI,IND,32.5,Pts+Asts,62,57,55,12
22023,1630178,22300180,"NOV 12, 2023",PHI vs. IND,W,39,20,32,0.625,7,11,0.636,3,3,1.0,3,4,7,5,0,3,2,2,50,17,1,Tyrese Maxey,PHI,PHI,IND,9.5,Rebs+Asts,62,57,55,12
22023,1630178,22300180,"NOV 12, 2023",PHI vs. IND,W,39,20,32,0.625,7,11,0.636,3,3,1.0,3,4,7,5,0,3,2,2,50,17,1,Tyrese Maxey,PHI,PHI,IND,1.5,Blks+Stls,62,57,55,12
22023,1630178,22300008,"NOV 10, 2023",PHI @ DET,W,39,9,19,0.474,2,7,0.286,9,9,1.0,0,6,6,11,3,1,0,3,29,17,1,Tyrese Maxey,PHI,DET,PHI,25.5,Points,46,35,40,17
22023,1630178,22300008,"NOV 10, 2023",PHI @ DET,W,39,9,19,0.474,2,7,0.286,9,9,1.0,0,6,6,11,3,1,0,3,29,17,1,Tyrese Maxey,PHI,DET,PHI,35.5,Pts+Rebs+Asts,46,35,40,17
22023,1630178,22300008,"NOV 10, 2023",PHI @ DET,W,39,9,19,0.474,2,7,0.286,9,9,1.0,0,6,6,11,3,1,0,3,29,17,1,Tyrese Maxey,PHI,DET,PHI,6.5,Assists,46,35,40,17
22023,1630178,22300008,"NOV 10, 2023",PHI @ DET,W,39,9,19,0.474,2,7,0.286,9,9,1.0,0,6,6,11,3,1,0,3,29,17,1,Tyrese Maxey,PHI,DET,PHI,42.0,Fantasy Score,46,35,40,17
22023,1630178,22300008,"NOV 10, 2023",PHI @ DET,W,39,9,19,0.474,2,7,0.286,9,9,1.0,0,6,6,11,3,1,0,3,29,17,1,Tyrese Maxey,PHI,DET,PHI,7.5,3-PT Attempted,46,35,40,17
22023,1630178,22300008,"NOV 10, 2023",PHI @ DET,W,39,9,19,0.474,2,7,0.286,9,9,1.0,0,6,6,11,3,1,0,3,29,17,1,Tyrese Maxey,PHI,DET,PHI,4.5,Free Throws Made,46,35,40,17
22023,1630178,22300008,"NOV 10, 2023",PHI @ DET,W,39,9,19,0.474,2,7,0.286,9,9,1.0,0,6,6,11,3,1,0,3,29,17,1,Tyrese Maxey,PHI,DET,PHI,18.5,FG Attempted,46,35,40,17
22023,1630178,22300008,"NOV 10, 2023",PHI @ DET,W,39,9,19,0.474,2,7,0.286,9,9,1.0,0,6,6,11,3,1,0,3,29,17,1,Tyrese Maxey,PHI,DET,PHI,28.5,Pts+Rebs,46,35,40,17
22023,1630178,22300008,"NOV 10, 2023",PHI @ DET,W,39,9,19,0.474,2,7,0.286,9,9,1.0,0,6,6,11,3,1,0,3,29,17,1,Tyrese Maxey,PHI,DET,PHI,32.5,Pts+Asts,46,35,40,17
22023,1630178,22300008,"NOV 10, 2023",PHI @ DET,W,39,9,19,0.474,2,7,0.286,9,9,1.0,0,6,6,11,3,1,0,3,29,17,1,Tyrese Maxey,PHI,DET,PHI,9.5,Rebs+Asts,46,35,40,17
22023,1630178,22300008,"NOV 10, 2023",PHI @ DET,W,39,9,19,0.474,2,7,0.286,9,9,1.0,0,6,6,11,3,1,0,3,29,17,1,Tyrese Maxey,PHI,DET,PHI,1.5,Blks+Stls,46,35,40,17
22023,1630178,22300159,"NOV 08, 2023",PHI vs. BOS,W,39,11,27,0.407,3,11,0.273,0,1,0.0,1,8,9,5,1,2,1,4,25,-3,1,Tyrese Maxey,PHI,PHI,BOS,25.5,Points,39,34,30,14
22023,1630178,22300159,"NOV 08, 2023",PHI vs. BOS,W,39,11,27,0.407,3,11,0.273,0,1,0.0,1,8,9,5,1,2,1,4,25,-3,1,Tyrese Maxey,PHI,PHI,BOS,35.5,Pts+Rebs+Asts,39,34,30,14
22023,1630178,22300159,"NOV 08, 2023",PHI vs. BOS,W,39,11,27,0.407,3,11,0.273,0,1,0.0,1,8,9,5,1,2,1,4,25,-3,1,Tyrese Maxey,PHI,PHI,BOS,6.5,Assists,39,34,30,14
22023,1630178,22300159,"NOV 08, 2023",PHI vs. BOS,W,39,11,27,0.407,3,11,0.273,0,1,0.0,1,8,9,5,1,2,1,4,25,-3,1,Tyrese Maxey,PHI,PHI,BOS,42.0,Fantasy Score,39,34,30,14
22023,1630178,22300159,"NOV 08, 2023",PHI vs. BOS,W,39,11,27,0.407,3,11,0.273,0,1,0.0,1,8,9,5,1,2,1,4,25,-3,1,Tyrese Maxey,PHI,PHI,BOS,7.5,3-PT Attempted,39,34,30,14
22023,1630178,22300159,"NOV 08, 2023",PHI vs. BOS,W,39,11,27,0.407,3,11,0.273,0,1,0.0,1,8,9,5,1,2,1,4,25,-3,1,Tyrese Maxey,PHI,PHI,BOS,4.5,Free Throws Made,39,34,30,14
22023,1630178,22300159,"NOV 08, 2023",PHI vs. BOS,W,39,11,27,0.407,3,11,0.273,0,1,0.0,1,8,9,5,1,2,1,4,25,-3,1,Tyrese Maxey,PHI,PHI,BOS,18.5,FG Attempted,39,34,30,14
22023,1630178,22300159,"NOV 08, 2023",PHI vs. BOS,W,39,11,27,0.407,3,11,0.273,0,1,0.0,1,8,9,5,1,2,1,4,25,-3,1,Tyrese Maxey,PHI,PHI,BOS,28.5,Pts+Rebs,39,34,30,14
22023,1630178,22300159,"NOV 08, 2023",PHI vs. BOS,W,39,11,27,0.407,3,11,0.273,0,1,0.0,1,8,9,5,1,2,1,4,25,-3,1,Tyrese Maxey,PHI,PHI,BOS,32.5,Pts+Asts,39,34,30,14
22023,1630178,22300159,"NOV 08, 2023",PHI vs. BOS,W,39,11,27,0.407,3,11,0.273,0,1,0.0,1,8,9,5,1,2,1,4,25,-3,1,Tyrese Maxey,PHI,PHI,BOS,9.5,Rebs+Asts,39,34,30,14
22023,1630178,22300159,"NOV 08, 2023",PHI vs. BOS,W,39,11,27,0.407,3,11,0.273,0,1,0.0,1,8,9,5,1,2,1,4,25,-3,1,Tyrese Maxey,PHI,PHI,BOS,1.5,Blks+Stls,39,34,30,14
22023,1630178,22300148,"NOV 06, 2023",PHI vs. WAS,W,32,9,16,0.563,3,9,0.333,1,1,1.0,0,1,1,11,1,1,0,2,22,9,1,Tyrese Maxey,PHI,PHI,WAS,25.5,Points,34,23,33,12
22023,1630178,22300148,"NOV 06, 2023",PHI vs. WAS,W,32,9,16,0.563,3,9,0.333,1,1,1.0,0,1,1,11,1,1,0,2,22,9,1,Tyrese Maxey,PHI,PHI,WAS,35.5,Pts+Rebs+Asts,34,23,33,12
22023,1630178,22300148,"NOV 06, 2023",PHI vs. WAS,W,32,9,16,0.563,3,9,0.333,1,1,1.0,0,1,1,11,1,1,0,2,22,9,1,Tyrese Maxey,PHI,PHI,WAS,6.5,Assists,34,23,33,12
22023,1630178,22300148,"NOV 06, 2023",PHI vs. WAS,W,32,9,16,0.563,3,9,0.333,1,1,1.0,0,1,1,11,1,1,0,2,22,9,1,Tyrese Maxey,PHI,PHI,WAS,42.0,Fantasy Score,34,23,33,12
22023,1630178,22300148,"NOV 06, 2023",PHI vs. WAS,W,32,9,16,0.563,3,9,0.333,1,1,1.0,0,1,1,11,1,1,0,2,22,9,1,Tyrese Maxey,PHI,PHI,WAS,7.5,3-PT Attempted,34,23,33,12
22023,1630178,22300148,"NOV 06, 2023",PHI vs. WAS,W,32,9,16,0.563,3,9,0.333,1,1,1.0,0,1,1,11,1,1,0,2,22,9,1,Tyrese Maxey,PHI,PHI,WAS,4.5,Free Throws Made,34,23,33,12
22023,1630178,22300148,"NOV 06, 2023",PHI vs. WAS,W,32,9,16,0.563,3,9,0.333,1,1,1.0,0,1,1,11,1,1,0,2,22,9,1,Tyrese Maxey,PHI,PHI,WAS,18.5,FG Attempted,34,23,33,12
22023,1630178,22300148,"NOV 06, 2023",PHI vs. WAS,W,32,9,16,0.563,3,9,0.333,1,1,1.0,0,1,1,11,1,1,0,2,22,9,1,Tyrese Maxey,PHI,PHI,WAS,28.5,Pts+Rebs,34,23,33,12
22023,1630178,22300148,"NOV 06, 2023",PHI vs. WAS,W,32,9,16,0.563,3,9,0.333,1,1,1.0,0,1,1,11,1,1,0,2,22,9,1,Tyrese Maxey,PHI,PHI,WAS,32.5,Pts+Asts,34,23,33,12
22023,1630178,22300148,"NOV 06, 2023",PHI vs. WAS,W,32,9,16,0.563,3,9,0.333,1,1,1.0,0,1,1,11,1,1,0,2,22,9,1,Tyrese Maxey,PHI,PHI,WAS,9.5,Rebs+Asts,34,23,33,12
22023,1630178,22300148,"NOV 06, 2023",PHI vs. WAS,W,32,9,16,0.563,3,9,0.333,1,1,1.0,0,1,1,11,1,1,0,2,22,9,1,Tyrese Maxey,PHI,PHI,WAS,1.5,Blks+Stls,34,23,33,12
22023,1630178,22300132,"NOV 04, 2023",PHI vs. PHX,W,36,9,18,0.5,2,6,0.333,2,2,1.0,2,3,5,10,0,1,3,0,22,25,1,Tyrese Maxey,PHI,PHI,PHX,25.5,Points,37,27,32,15
22023,1630178,22300132,"NOV 04, 2023",PHI vs. PHX,W,36,9,18,0.5,2,6,0.333,2,2,1.0,2,3,5,10,0,1,3,0,22,25,1,Tyrese Maxey,PHI,PHI,PHX,35.5,Pts+Rebs+Asts,37,27,32,15
22023,1630178,22300132,"NOV 04, 2023",PHI vs. PHX,W,36,9,18,0.5,2,6,0.333,2,2,1.0,2,3,5,10,0,1,3,0,22,25,1,Tyrese Maxey,PHI,PHI,PHX,6.5,Assists,37,27,32,15
22023,1630178,22300132,"NOV 04, 2023",PHI vs. PHX,W,36,9,18,0.5,2,6,0.333,2,2,1.0,2,3,5,10,0,1,3,0,22,25,1,Tyrese Maxey,PHI,PHI,PHX,42.0,Fantasy Score,37,27,32,15
22023,1630178,22300132,"NOV 04, 2023",PHI vs. PHX,W,36,9,18,0.5,2,6,0.333,2,2,1.0,2,3,5,10,0,1,3,0,22,25,1,Tyrese Maxey,PHI,PHI,PHX,7.5,3-PT Attempted,37,27,32,15
22023,1630178,22300132,"NOV 04, 2023",PHI vs. PHX,W,36,9,18,0.5,2,6,0.333,2,2,1.0,2,3,5,10,0,1,3,0,22,25,1,Tyrese Maxey,PHI,PHI,PHX,4.5,Free Throws Made,37,27,32,15
22023,1630178,22300132,"NOV 04, 2023",PHI vs. PHX,W,36,9,18,0.5,2,6,0.333,2,2,1.0,2,3,5,10,0,1,3,0,22,25,1,Tyrese Maxey,PHI,PHI,PHX,18.5,FG Attempted,37,27,32,15
22023,1630178,22300132,"NOV 04, 2023",PHI vs. PHX,W,36,9,18,0.5,2,6,0.333,2,2,1.0,2,3,5,10,0,1,3,0,22,25,1,Tyrese Maxey,PHI,PHI,PHX,28.5,Pts+Rebs,37,27,32,15
22023,1630178,22300132,"NOV 04, 2023",PHI vs. PHX,W,36,9,18,0.5,2,6,0.333,2,2,1.0,2,3,5,10,0,1,3,0,22,25,1,Tyrese Maxey,PHI,PHI,PHX,32.5,Pts+Asts,37,27,32,15
22023,1630178,22300132,"NOV 04, 2023",PHI vs. PHX,W,36,9,18,0.5,2,6,0.333,2,2,1.0,2,3,5,10,0,1,3,0,22,25,1,Tyrese Maxey,PHI,PHI,PHX,9.5,Rebs+Asts,37,27,32,15
22023,1630178,22300132,"NOV 04, 2023",PHI vs. PHX,W,36,9,18,0.5,2,6,0.333,2,2,1.0,2,3,5,10,0,1,3,0,22,25,1,Tyrese Maxey,PHI,PHI,PHX,1.5,Blks+Stls,37,27,32,15
22023,1630178,22300128,"NOV 02, 2023",PHI vs. TOR,W,40,7,16,0.438,0,3,0.0,4,4,1.0,0,1,1,4,2,0,1,1,18,6,1,Tyrese Maxey,PHI,PHI,TOR,25.5,Points,23,19,22,5
22023,1630178,22300128,"NOV 02, 2023",PHI vs. TOR,W,40,7,16,0.438,0,3,0.0,4,4,1.0,0,1,1,4,2,0,1,1,18,6,1,Tyrese Maxey,PHI,PHI,TOR,35.5,Pts+Rebs+Asts,23,19,22,5
22023,1630178,22300128,"NOV 02, 2023",PHI vs. TOR,W,40,7,16,0.438,0,3,0.0,4,4,1.0,0,1,1,4,2,0,1,1,18,6,1,Tyrese Maxey,PHI,PHI,TOR,6.5,Assists,23,19,22,5
22023,1630178,22300128,"NOV 02, 2023",PHI vs. TOR,W,40,7,16,0.438,0,3,0.0,4,4,1.0,0,1,1,4,2,0,1,1,18,6,1,Tyrese Maxey,PHI,PHI,TOR,42.0,Fantasy Score,23,19,22,5
22023,1630178,22300128,"NOV 02, 2023",PHI vs. TOR,W,40,7,16,0.438,0,3,0.0,4,4,1.0,0,1,1,4,2,0,1,1,18,6,1,Tyrese Maxey,PHI,PHI,TOR,7.5,3-PT Attempted,23,19,22,5
22023,1630178,22300128,"NOV 02, 2023",PHI vs. TOR,W,40,7,16,0.438,0,3,0.0,4,4,1.0,0,1,1,4,2,0,1,1,18,6,1,Tyrese Maxey,PHI,PHI,TOR,4.5,Free Throws Made,23,19,22,5
22023,1630178,22300128,"NOV 02, 2023",PHI vs. TOR,W,40,7,16,0.438,0,3,0.0,4,4,1.0,0,1,1,4,2,0,1,1,18,6,1,Tyrese Maxey,PHI,PHI,TOR,18.5,FG Attempted,23,19,22,5
22023,1630178,22300128,"NOV 02, 2023",PHI vs. TOR,W,40,7,16,0.438,0,3,0.0,4,4,1.0,0,1,1,4,2,0,1,1,18,6,1,Tyrese Maxey,PHI,PHI,TOR,28.5,Pts+Rebs,23,19,22,5
22023,1630178,22300128,"NOV 02, 2023",PHI vs. TOR,W,40,7,16,0.438,0,3,0.0,4,4,1.0,0,1,1,4,2,0,1,1,18,6,1,Tyrese Maxey,PHI,PHI,TOR,32.5,Pts+Asts,23,19,22,5
22023,1630178,22300128,"NOV 02, 2023",PHI vs. TOR,W,40,7,16,0.438,0,3,0.0,4,4,1.0,0,1,1,4,2,0,1,1,18,6,1,Tyrese Maxey,PHI,PHI,TOR,9.5,Rebs+Asts,23,19,22,5
22023,1630178,22300128,"NOV 02, 2023",PHI vs. TOR,W,40,7,16,0.438,0,3,0.0,4,4,1.0,0,1,1,4,2,0,1,1,18,6,1,Tyrese Maxey,PHI,PHI,TOR,1.5,Blks+Stls,23,19,22,5
22023,1630178,22300098,"OCT 29, 2023",PHI vs. POR,W,35,6,14,0.429,4,8,0.5,10,10,1.0,1,9,10,4,0,0,2,1,26,19,1,Tyrese Maxey,PHI,PHI,POR,25.5,Points,40,36,30,14
22023,1630178,22300098,"OCT 29, 2023",PHI vs. POR,W,35,6,14,0.429,4,8,0.5,10,10,1.0,1,9,10,4,0,0,2,1,26,19,1,Tyrese Maxey,PHI,PHI,POR,35.5,Pts+Rebs+Asts,40,36,30,14
22023,1630178,22300098,"OCT 29, 2023",PHI vs. POR,W,35,6,14,0.429,4,8,0.5,10,10,1.0,1,9,10,4,0,0,2,1,26,19,1,Tyrese Maxey,PHI,PHI,POR,6.5,Assists,40,36,30,14
22023,1630178,22300098,"OCT 29, 2023",PHI vs. POR,W,35,6,14,0.429,4,8,0.5,10,10,1.0,1,9,10,4,0,0,2,1,26,19,1,Tyrese Maxey,PHI,PHI,POR,42.0,Fantasy Score,40,36,30,14
22023,1630178,22300098,"OCT 29, 2023",PHI vs. POR,W,35,6,14,0.429,4,8,0.5,10,10,1.0,1,9,10,4,0,0,2,1,26,19,1,Tyrese Maxey,PHI,PHI,POR,7.5,3-PT Attempted,40,36,30,14
22023,1630178,22300098,"OCT 29, 2023",PHI vs. POR,W,35,6,14,0.429,4,8,0.5,10,10,1.0,1,9,10,4,0,0,2,1,26,19,1,Tyrese Maxey,PHI,PHI,POR,4.5,Free Throws Made,40,36,30,14
22023,1630178,22300098,"OCT 29, 2023",PHI vs. POR,W,35,6,14,0.429,4,8,0.5,10,10,1.0,1,9,10,4,0,0,2,1,26,19,1,Tyrese Maxey,PHI,PHI,POR,18.5,FG Attempted,40,36,30,14
22023,1630178,22300098,"OCT 29, 2023",PHI vs. POR,W,35,6,14,0.429,4,8,0.5,10,10,1.0,1,9,10,4,0,0,2,1,26,19,1,Tyrese Maxey,PHI,PHI,POR,28.5,Pts+Rebs,40,36,30,14
22023,1630178,22300098,"OCT 29, 2023",PHI vs. POR,W,35,6,14,0.429,4,8,0.5,10,10,1.0,1,9,10,4,0,0,2,1,26,19,1,Tyrese Maxey,PHI,PHI,POR,32.5,Pts+Asts,40,36,30,14
22023,1630178,22300098,"OCT 29, 2023",PHI vs. POR,W,35,6,14,0.429,4,8,0.5,10,10,1.0,1,9,10,4,0,0,2,1,26,19,1,Tyrese Maxey,PHI,PHI,POR,9.5,Rebs+Asts,40,36,30,14
22023,1630178,22300098,"OCT 29, 2023",PHI vs. POR,W,35,6,14,0.429,4,8,0.5,10,10,1.0,1,9,10,4,0,0,2,1,26,19,1,Tyrese Maxey,PHI,PHI,POR,1.5,Blks+Stls,40,36,30,14
22023,1630178,22300092,"OCT 28, 2023",PHI @ TOR,W,41,12,20,0.6,7,9,0.778,3,3,1.0,1,5,6,7,0,1,1,1,34,10,1,Tyrese Maxey,PHI,TOR,PHI,25.5,Points,47,40,41,13
22023,1630178,22300092,"OCT 28, 2023",PHI @ TOR,W,41,12,20,0.6,7,9,0.778,3,3,1.0,1,5,6,7,0,1,1,1,34,10,1,Tyrese Maxey,PHI,TOR,PHI,35.5,Pts+Rebs+Asts,47,40,41,13
22023,1630178,22300092,"OCT 28, 2023",PHI @ TOR,W,41,12,20,0.6,7,9,0.778,3,3,1.0,1,5,6,7,0,1,1,1,34,10,1,Tyrese Maxey,PHI,TOR,PHI,6.5,Assists,47,40,41,13
22023,1630178,22300092,"OCT 28, 2023",PHI @ TOR,W,41,12,20,0.6,7,9,0.778,3,3,1.0,1,5,6,7,0,1,1,1,34,10,1,Tyrese Maxey,PHI,TOR,PHI,42.0,Fantasy Score,47,40,41,13
22023,1630178,22300092,"OCT 28, 2023",PHI @ TOR,W,41,12,20,0.6,7,9,0.778,3,3,1.0,1,5,6,7,0,1,1,1,34,10,1,Tyrese Maxey,PHI,TOR,PHI,7.5,3-PT Attempted,47,40,41,13
22023,1630178,22300092,"OCT 28, 2023",PHI @ TOR,W,41,12,20,0.6,7,9,0.778,3,3,1.0,1,5,6,7,0,1,1,1,34,10,1,Tyrese Maxey,PHI,TOR,PHI,4.5,Free Throws Made,47,40,41,13
22023,1630178,22300092,"OCT 28, 2023",PHI @ TOR,W,41,12,20,0.6,7,9,0.778,3,3,1.0,1,5,6,7,0,1,1,1,34,10,1,Tyrese Maxey,PHI,TOR,PHI,18.5,FG Attempted,47,40,41,13
22023,1630178,22300092,"OCT 28, 2023",PHI @ TOR,W,41,12,20,0.6,7,9,0.778,3,3,1.0,1,5,6,7,0,1,1,1,34,10,1,Tyrese Maxey,PHI,TOR,PHI,28.5,Pts+Rebs,47,40,41,13
22023,1630178,22300092,"OCT 28, 2023",PHI @ TOR,W,41,12,20,0.6,7,9,0.778,3,3,1.0,1,5,6,7,0,1,1,1,34,10,1,Tyrese Maxey,PHI,TOR,PHI,32.5,Pts+Asts,47,40,41,13
22023,1630178,22300092,"OCT 28, 2023",PHI @ TOR,W,41,12,20,0.6,7,9,0.778,3,3,1.0,1,5,6,7,0,1,1,1,34,10,1,Tyrese Maxey,PHI,TOR,PHI,9.5,Rebs+Asts,47,40,41,13
22023,1630178,22300092,"OCT 28, 2023",PHI @ TOR,W,41,12,20,0.6,7,9,0.778,3,3,1.0,1,5,6,7,0,1,1,1,34,10,1,Tyrese Maxey,PHI,TOR,PHI,1.5,Blks+Stls,47,40,41,13
22023,1630178,22300075,"OCT 26, 2023",PHI @ MIL,L,40,10,22,0.455,3,8,0.375,8,10,0.8,0,4,4,8,2,0,0,3,31,0,1,Tyrese Maxey,PHI,MIL,PHI,25.5,Points,43,35,39,12
22023,1630178,22300075,"OCT 26, 2023",PHI @ MIL,L,40,10,22,0.455,3,8,0.375,8,10,0.8,0,4,4,8,2,0,0,3,31,0,1,Tyrese Maxey,PHI,MIL,PHI,35.5,Pts+Rebs+Asts,43,35,39,12
22023,1630178,22300075,"OCT 26, 2023",PHI @ MIL,L,40,10,22,0.455,3,8,0.375,8,10,0.8,0,4,4,8,2,0,0,3,31,0,1,Tyrese Maxey,PHI,MIL,PHI,6.5,Assists,43,35,39,12
22023,1630178,22300075,"OCT 26, 2023",PHI @ MIL,L,40,10,22,0.455,3,8,0.375,8,10,0.8,0,4,4,8,2,0,0,3,31,0,1,Tyrese Maxey,PHI,MIL,PHI,42.0,Fantasy Score,43,35,39,12
22023,1630178,22300075,"OCT 26, 2023",PHI @ MIL,L,40,10,22,0.455,3,8,0.375,8,10,0.8,0,4,4,8,2,0,0,3,31,0,1,Tyrese Maxey,PHI,MIL,PHI,7.5,3-PT Attempted,43,35,39,12
22023,1630178,22300075,"OCT 26, 2023",PHI @ MIL,L,40,10,22,0.455,3,8,0.375,8,10,0.8,0,4,4,8,2,0,0,3,31,0,1,Tyrese Maxey,PHI,MIL,PHI,4.5,Free Throws Made,43,35,39,12
22023,1630178,22300075,"OCT 26, 2023",PHI @ MIL,L,40,10,22,0.455,3,8,0.375,8,10,0.8,0,4,4,8,2,0,0,3,31,0,1,Tyrese Maxey,PHI,MIL,PHI,18.5,FG Attempted,43,35,39,12
22023,1630178,22300075,"OCT 26, 2023",PHI @ MIL,L,40,10,22,0.455,3,8,0.375,8,10,0.8,0,4,4,8,2,0,0,3,31,0,1,Tyrese Maxey,PHI,MIL,PHI,28.5,Pts+Rebs,43,35,39,12
22023,1630178,22300075,"OCT 26, 2023",PHI @ MIL,L,40,10,22,0.455,3,8,0.375,8,10,0.8,0,4,4,8,2,0,0,3,31,0,1,Tyrese Maxey,PHI,MIL,PHI,32.5,Pts+Asts,43,35,39,12
22023,1630178,22300075,"OCT 26, 2023",PHI @ MIL,L,40,10,22,0.455,3,8,0.375,8,10,0.8,0,4,4,8,2,0,0,3,31,0,1,Tyrese Maxey,PHI,MIL,PHI,9.5,Rebs+Asts,43,35,39,12
22023,1630178,22300075,"OCT 26, 2023",PHI @ MIL,L,40,10,22,0.455,3,8,0.375,8,10,0.8,0,4,4,8,2,0,0,3,31,0,1,Tyrese Maxey,PHI,MIL,PHI,1.5,Blks+Stls,43,35,39,12
22023,1630219,22300549,"JAN 13, 2024",LAL @ UTA,L,10,0,2,0.0,0,0,0.0,0,0,0.0,0,1,1,2,1,0,0,2,0,-5,1,Skylar Mays,LAL,UTA,LAL,,,3,1,2,3
22023,1630219,22300531,"JAN 11, 2024",LAL vs. PHX,L,12,5,6,0.833,2,2,1.0,0,0,0.0,1,0,1,1,1,0,0,0,12,9,1,Skylar Mays,LAL,LAL,PHX,,,14,13,13,2
22023,1630219,22300472,"JAN 03, 2024",POR @ DAL,L,8,2,4,0.5,0,0,0.0,1,2,0.5,1,4,5,1,0,0,1,0,5,3,1,Skylar Mays,POR,DAL,POR,,,11,10,6,6
22023,1630219,22300456,"JAN 01, 2024",POR @ PHX,L,17,3,8,0.375,1,3,0.333,0,0,0.0,1,1,2,3,0,1,1,1,7,-10,1,Skylar Mays,POR,PHX,POR,,,12,9,10,5
22023,1630219,22300437,"DEC 29, 2023",POR vs. SAS,W,20,5,10,0.5,1,1,1.0,0,0,0.0,1,1,2,2,1,0,0,0,11,-9,1,Skylar Mays,POR,POR,SAS,,,15,13,13,4
22023,1630219,22300427,"DEC 28, 2023",POR vs. SAS,L,14,0,8,0.0,0,4,0.0,0,0,0.0,1,2,3,0,1,0,0,0,0,-9,1,Skylar Mays,POR,POR,SAS,,,3,3,0,3
22023,1630219,22300413,"DEC 26, 2023",POR vs. SAC,W,2,0,0,0.0,0,0,0.0,0,0,0.0,0,0,0,0,0,0,0,0,0,-2,1,Skylar Mays,POR,POR,SAC,,,0,0,0,0
22023,1630219,22300399,"DEC 23, 2023",POR @ GSW,L,5,0,2,0.0,0,0,0.0,1,2,0.5,0,0,0,1,0,0,1,0,1,-1,1,Skylar Mays,POR,GSW,POR,,,2,1,2,1
22023,1630219,22300323,"DEC 14, 2023",POR vs. UTA,L,17,0,0,0.0,0,0,0.0,0,0,0.0,1,0,1,5,1,0,0,0,0,24,1,Skylar Mays,POR,POR,UTA,,,6,1,5,6
22023,1630219,22300237,"NOV 22, 2023",POR vs. UTA,W,6,0,1,0.0,0,0,0.0,0,0,0.0,0,0,0,0,0,0,0,0,0,-14,1,Skylar Mays,POR,POR,UTA,,,0,0,0,0
22023,1630219,22300041,"NOV 21, 2023",POR @ PHX,L,21,2,5,0.4,2,3,0.667,0,0,0.0,0,2,2,3,0,0,1,2,6,-13,1,Skylar Mays,POR,PHX,POR,,,11,8,9,5
22023,1630219,22300215,"NOV 19, 2023",POR vs. OKC,L,26,4,9,0.444,2,6,0.333,1,2,0.5,0,2,2,7,2,0,3,0,11,-37,1,Skylar Mays,POR,POR,OKC,,,20,13,18,9
22023,1630219,22300036,"NOV 17, 2023",POR vs. LAL,L,26,6,14,0.429,3,7,0.429,0,0,0.0,3,2,5,8,2,0,0,3,15,-11,1,Skylar Mays,POR,POR,LAL,,,28,20,23,13
22023,1630219,22300199,"NOV 15, 2023",POR vs. CLE,L,31,4,13,0.308,2,4,0.5,3,3,1.0,0,1,1,4,1,0,2,4,13,-13,1,Skylar Mays,POR,POR,CLE,,,18,14,17,5
22023,1630219,22300023,"NOV 14, 2023",POR @ UTA,L,31,3,8,0.375,0,1,0.0,0,0,0.0,0,5,5,10,0,2,2,1,6,1,1,Skylar Mays,POR,UTA,POR,,,21,11,16,15
22023,1630219,22300187,"NOV 12, 2023",POR @ LAL,L,33,7,13,0.538,0,4,0.0,1,2,0.5,0,4,4,12,0,0,1,2,15,-1,1,Skylar Mays,POR,LAL,POR,,,31,19,27,16
22023,1630219,22300170,"NOV 08, 2023",POR @ SAC,L,37,8,15,0.533,0,2,0.0,2,2,1.0,0,2,2,11,2,0,3,4,18,-8,1,Skylar Mays,POR,SAC,POR,,,31,20,29,13
22023,1630219,22300144,"NOV 05, 2023",POR vs. MEM,L,16,2,9,0.222,1,5,0.2,2,2,1.0,0,1,1,2,2,0,0,3,7,9,1,Skylar Mays,POR,POR,MEM,,,10,8,9,3
22023,1630219,22300007,"NOV 03, 2023",POR vs. MEM,W,15,3,8,0.375,1,5,0.2,2,2,1.0,0,1,1,1,1,0,1,0,9,-9,1,Skylar Mays,POR,POR,MEM,,,11,10,10,2
22023,1630219,22300115,"NOV 01, 2023",POR @ DET,W,8,1,3,0.333,0,0,0.0,0,0,0.0,1,0,1,2,0,0,1,0,2,9,1,Skylar Mays,POR,DET,POR,,,5,3,4,3
22023,1630219,22300105,"OCT 30, 2023",POR @ TOR,W,11,2,4,0.5,1,3,0.333,0,0,0.0,0,0,0,1,1,0,0,0,5,3,1,Skylar Mays,POR,TOR,POR,,,6,5,6,1
22023,1630219,22300098,"OCT 29, 2023",POR @ PHI,L,5,0,2,0.0,0,1,0.0,0,0,0.0,0,0,0,1,0,0,1,0,0,-7,1,Skylar Mays,POR,PHI,POR,,,1,0,1,1
22023,1630219,22300086,"OCT 27, 2023",POR vs. ORL,L,8,1,2,0.5,0,0,0.0,0,0,0.0,0,0,0,1,0,0,0,0,2,0,1,Skylar Mays,POR,POR,ORL,,,3,2,3,1
22023,1630540,22300557,"JAN 15, 2024",NYK vs. ORL,L,36,8,17,0.471,4,10,0.4,0,0,0.0,0,2,2,1,2,1,1,4,20,3,1,Miles McBride,NYK,NYK,ORL,,,23,22,21,3
22023,1630540,22300544,"JAN 13, 2024",NYK @ MEM,W,38,7,10,0.7,4,7,0.571,1,2,0.5,0,6,6,5,1,1,3,3,19,13,1,Miles McBride,NYK,MEM,NYK,,,30,25,24,11
22023,1630540,22300530,"JAN 11, 2024",NYK @ DAL,L,9,2,5,0.4,1,4,0.25,0,0,0.0,1,1,2,1,0,0,0,2,5,-12,1,Miles McBride,NYK,DAL,NYK,,,8,7,6,3
22023,1630540,22300514,"JAN 09, 2024",NYK vs. POR,W,22,6,13,0.462,4,7,0.571,0,0,0.0,1,1,2,0,1,0,2,1,16,-1,1,Miles McBride,NYK,NYK,POR,,,18,18,16,2
22023,1630540,22300494,"JAN 06, 2024",NYK @ WAS,W,13,2,6,0.333,1,2,0.5,0,0,0.0,1,0,1,5,1,0,0,2,5,-4,1,Miles McBride,NYK,WAS,NYK,,,11,6,10,6
22023,1630540,22300483,"JAN 05, 2024",NYK @ PHI,W,15,4,8,0.5,4,6,0.667,3,3,1.0,0,1,1,4,0,0,0,1,15,20,1,Miles McBride,NYK,PHI,NYK,,,20,16,19,5
22023,1630540,22300468,"JAN 03, 2024",NYK vs. CHI,W,10,1,3,0.333,1,2,0.5,0,0,0.0,0,0,0,0,0,0,0,1,3,-15,1,Miles McBride,NYK,NYK,CHI,,,3,3,3,0
22023,1630540,22300451,"JAN 01, 2024",NYK vs. MIN,W,7,0,3,0.0,0,1,0.0,0,0,0.0,0,0,0,0,0,0,1,0,0,-10,1,Miles McBride,NYK,NYK,MIN,,,0,0,0,0
22023,1630540,22300441,"DEC 30, 2023",NYK @ IND,L,18,2,3,0.667,1,2,0.5,0,0,0.0,0,0,0,1,0,0,0,3,5,7,1,Miles McBride,NYK,IND,NYK,,,6,5,6,1
22023,1630540,22300388,"DEC 23, 2023",NYK vs. MIL,L,1,0,0,0.0,0,0,0.0,0,0,0.0,0,1,1,0,0,0,0,0,0,-3,1,Miles McBride,NYK,NYK,MIL,,,1,1,0,1
22023,1630540,22300368,"DEC 20, 2023",NYK @ BKN,W,2,0,1,0.0,0,1,0.0,0,0,0.0,0,0,0,0,0,0,0,0,0,-4,1,Miles McBride,NYK,BKN,NYK,,,0,0,0,0
22023,1630540,22300343,"DEC 16, 2023",NYK @ LAC,L,11,2,4,0.5,0,0,0.0,0,0,0.0,0,1,1,2,2,0,0,2,4,-4,1,Miles McBride,NYK,LAC,NYK,,,7,5,6,3
22023,1630540,22300333,"DEC 15, 2023",NYK @ PHX,W,1,1,1,1.0,1,1,1.0,0,0,0.0,0,0,0,0,0,0,0,0,3,-1,1,Miles McBride,NYK,PHX,NYK,,,3,3,3,0
22023,1630540,22300297,"DEC 11, 2023",NYK vs. TOR,W,10,1,2,0.5,1,1,1.0,0,0,0.0,0,0,0,3,0,0,0,1,3,5,1,Miles McBride,NYK,NYK,TOR,,,6,3,6,3
22023,1630540,22301201,"DEC 05, 2023",NYK @ MIL,L,2,1,1,1.0,1,1,1.0,0,0,0.0,0,0,0,0,0,0,0,0,3,-4,1,Miles McBride,NYK,MIL,NYK,,,3,3,3,0
22023,1630540,22300057,"NOV 28, 2023",NYK vs. CHA,W,1,0,0,0.0,0,0,0.0,0,0,0.0,0,0,0,1,0,0,0,0,0,-1,1,Miles McBride,NYK,NYK,CHA,,,1,0,1,1
22023,1630540,22300221,"NOV 20, 2023",NYK @ MIN,L,3,0,0,0.0,0,0,0.0,0,0,0.0,0,0,0,0,0,0,0,0,0,0,1,Miles McBride,NYK,MIN,NYK,,,0,0,0,0
22023,1630540,22300202,"NOV 18, 2023",NYK @ CHA,W,9,2,3,0.667,1,2,0.5,0,0,0.0,0,0,0,0,0,0,0,2,5,-1,1,Miles McBride,NYK,CHA,NYK,,,5,5,5,0
22023,1630540,22300028,"NOV 17, 2023",NYK @ WAS,W,14,2,3,0.667,1,2,0.5,0,0,0.0,1,0,1,0,1,0,0,2,5,3,1,Miles McBride,NYK,WAS,NYK,,,6,6,5,1
22023,1630540,22300193,"NOV 15, 2023",NYK @ ATL,W,1,0,0,0.0,0,0,0.0,0,0,0.0,0,0,0,0,0,0,0,1,0,-2,1,Miles McBride,NYK,ATL,NYK,,,0,0,0,0
22023,1630540,22300188,"NOV 13, 2023",NYK @ BOS,L,1,0,1,0.0,0,1,0.0,0,0,0.0,0,0,0,0,0,0,0,0,0,1,1,Miles McBride,NYK,BOS,NYK,,,0,0,0,0
22023,1630540,22300177,"NOV 12, 2023",NYK vs. CHA,W,3,1,2,0.5,1,2,0.5,0,0,0.0,0,1,1,1,0,0,0,0,3,-7,1,Miles McBride,NYK,NYK,CHA,,,5,4,4,2
22023,1630540,22300161,"NOV 08, 2023",NYK vs. SAS,W,2,0,0,0.0,0,0,0.0,0,0,0.0,0,0,0,0,0,0,0,0,0,-2,1,Miles McBride,NYK,NYK,SAS,,,0,0,0,0
22023,1630540,22300002,"NOV 03, 2023",NYK @ MIL,L,2,0,1,0.0,0,1,0.0,0,0,0.0,0,0,0,0,0,0,0,0,0,-10,1,Miles McBride,NYK,MIL,NYK,,,0,0,0,0
22023,1630540,22300120,"NOV 01, 2023",NYK vs. CLE,L,9,1,2,0.5,0,1,0.0,1,2,0.5,0,0,0,0,2,0,0,1,3,0,1,Miles McBride,NYK,NYK,CLE,,,3,3,3,0
22023,1630540,22300112,"OCT 31, 2023",NYK @ CLE,W,4,1,2,0.5,1,2,0.5,0,0,0.0,0,0,0,0,0,0,0,1,3,-5,1,Miles McBride,NYK,CLE,NYK,,,3,3,3,0
22023,1630540,22300090,"OCT 28, 2023",NYK @ NOP,L,5,1,3,0.333,0,2,0.0,0,0,0.0,0,1,1,1,1,0,0,0,2,10,1,Miles McBride,NYK,NOP,NYK,,,4,3,3,2
22023,203468,22300556,"JAN 15, 2024",NOP @ DAL,L,29,9,17,0.529,3,7,0.429,2,2,1.0,0,6,6,4,1,0,0,5,23,15,1,CJ McCollum,NOP,DAL,NOP,,,33,29,27,10
22023,203468,22300539,"JAN 12, 2024",NOP @ DEN,L,30,4,10,0.4,3,8,0.375,1,2,0.5,0,5,5,7,1,0,2,2,12,-13,1,CJ McCollum,NOP,DEN,NOP,,,24,17,19,12
22023,203468,22300525,"JAN 10, 2024",NOP @ GSW,W,26,5,13,0.385,2,7,0.286,2,2,1.0,0,3,3,8,2,1,0,0,14,22,1,CJ McCollum,NOP,GSW,NOP,,,25,17,22,11
22023,203468,22300500,"JAN 07, 2024",NOP @ SAC,W,27,11,16,0.688,7,10,0.7,1,2,0.5,1,6,7,4,0,2,3,0,30,31,1,CJ McCollum,NOP,SAC,NOP,,,41,37,34,11
22023,203468,22300486,"JAN 05, 2024",NOP vs. LAC,L,31,4,13,0.308,4,9,0.444,0,0,0.0,1,5,6,3,1,0,1,3,12,-10,1,CJ McCollum,NOP,NOP,LAC,,,21,18,15,9
22023,203468,22300471,"JAN 03, 2024",NOP @ MIN,W,30,8,16,0.5,4,6,0.667,4,4,1.0,0,3,3,5,0,1,2,2,24,12,1,CJ McCollum,NOP,MIN,NOP,,,32,27,29,8
22023,203468,22300461,"JAN 02, 2024",NOP vs. BKN,W,25,6,11,0.545,4,8,0.5,0,0,0.0,2,4,6,5,0,0,2,0,16,12,1,CJ McCollum,NOP,NOP,BKN,,,27,22,21,11
22023,203468,22300446,"DEC 31, 2023",NOP vs. LAL,W,36,8,19,0.421,6,11,0.545,0,0,0.0,0,5,5,9,1,1,1,2,22,15,1,CJ McCollum,NOP,NOP,LAL,,,36,27,31,14
22023,203468,22300424,"DEC 28, 2023",NOP vs. UTA,W,32,8,16,0.5,4,10,0.4,2,3,0.667,1,2,3,6,2,0,2,2,22,8,1,CJ McCollum,NOP,NOP,UTA,,,31,25,28,9
22023,203468,22300410,"DEC 26, 2023",NOP vs. MEM,L,39,6,14,0.429,3,8,0.375,1,4,0.25,0,2,2,2,1,1,1,4,16,-9,1,CJ McCollum,NOP,NOP,MEM,,,20,18,18,4
22023,203468,22300392,"DEC 23, 2023",NOP vs. HOU,L,34,4,10,0.4,2,7,0.286,3,4,0.75,1,4,5,2,1,1,4,4,13,-2,1,CJ McCollum,NOP,NOP,HOU,,,20,18,15,7
22023,203468,22300375,"DEC 21, 2023",NOP @ CLE,W,34,7,15,0.467,2,8,0.25,2,2,1.0,0,6,6,4,4,1,2,2,18,13,1,CJ McCollum,NOP,CLE,NOP,,,28,24,22,10
22023,203468,22300360,"DEC 19, 2023",NOP vs. MEM,L,41,6,11,0.545,6,9,0.667,0,0,0.0,0,3,3,6,1,1,1,2,18,9,1,CJ McCollum,NOP,NOP,MEM,,,27,21,24,9
22023,203468,22300345,"DEC 17, 2023",NOP @ SAS,W,26,10,15,0.667,6,7,0.857,3,3,1.0,0,2,2,2,1,0,3,2,29,21,1,CJ McCollum,NOP,SAS,NOP,,,33,31,31,4
22023,203468,22300326,"DEC 15, 2023",NOP @ CHA,W,35,7,18,0.389,3,9,0.333,2,2,1.0,2,3,5,4,1,1,2,0,19,4,1,CJ McCollum,NOP,CHA,NOP,,,28,24,23,9
22023,203468,22300311,"DEC 13, 2023",NOP @ WAS,W,32,8,14,0.571,4,6,0.667,2,2,1.0,0,3,3,6,0,0,0,3,22,13,1,CJ McCollum,NOP,WAS,NOP,,,31,25,28,9
22023,203468,22300301,"DEC 11, 2023",NOP vs. MIN,W,29,8,15,0.533,4,7,0.571,3,3,1.0,0,4,4,4,1,1,1,2,23,21,1,CJ McCollum,NOP,NOP,MIN,,,31,27,27,8
22023,203468,22301230,"DEC 07, 2023",NOP @ LAL,L,25,4,14,0.286,1,4,0.25,0,0,0.0,1,3,4,2,2,0,1,2,9,-38,1,CJ McCollum,NOP,LAL,NOP,,,15,13,11,6
22023,203468,22301204,"DEC 04, 2023",NOP @ SAC,W,36,7,14,0.5,3,5,0.6,0,0,0.0,0,2,2,7,2,2,2,2,17,-4,1,CJ McCollum,NOP,SAC,NOP,,,26,19,24,9
22023,203468,22300278,"DEC 01, 2023",NOP vs. SAS,W,38,8,18,0.444,1,8,0.125,2,2,1.0,1,2,3,8,2,1,1,1,19,16,1,CJ McCollum,NOP,NOP,SAS,,,30,22,27,11
22023,203468,22300262,"NOV 29, 2023",NOP vs. PHI,W,28,7,16,0.438,3,8,0.375,3,3,1.0,1,3,4,5,2,1,2,3,20,19,1,CJ McCollum,NOP,NOP,PHI,,,29,24,25,9
22023,203468,22300135,"NOV 04, 2023",NOP vs. ATL,L,33,5,12,0.417,1,6,0.167,2,3,0.667,0,1,1,6,2,3,0,3,13,-19,1,CJ McCollum,NOP,NOP,ATL,,,20,14,19,7
22023,203468,22300129,"NOV 02, 2023",NOP vs. DET,W,35,10,23,0.435,3,10,0.3,10,11,0.909,1,3,4,5,0,0,4,3,33,-17,1,CJ McCollum,NOP,NOP,DET,,,42,37,38,9
22023,203468,22300121,"NOV 01, 2023",NOP @ OKC,W,37,10,17,0.588,5,8,0.625,4,7,0.571,1,10,11,5,0,1,1,2,29,16,1,CJ McCollum,NOP,OKC,NOP,,,45,40,34,16
22023,203468,22300108,"OCT 30, 2023",NOP vs. GSW,L,33,7,21,0.333,2,8,0.25,3,4,0.75,2,4,6,5,1,0,0,1,19,-19,1,CJ McCollum,NOP,NOP,GSW,,,30,25,24,11
22023,203468,22300090,"OCT 28, 2023",NOP vs. NYK,W,30,4,11,0.364,2,7,0.286,2,4,0.5,0,3,3,7,4,0,1,2,12,18,1,CJ McCollum,NOP,NOP,NYK,,,22,15,19,10
22023,203468,22300071,"OCT 25, 2023",NOP @ MEM,W,37,8,16,0.5,6,11,0.545,2,2,1.0,1,3,4,6,2,1,2,3,24,-1,1,CJ McCollum,NOP,MEM,NOP,,,34,28,30,10
22023,204456,22300564,"JAN 15, 2024",IND @ UTA,L,19,3,6,0.5,0,0,0.0,2,2,1.0,1,4,5,5,1,0,3,1,8,3,1,T.J. McConnell,IND,UTA,IND,,,18,13,13,10
22023,204456,22300550,"JAN 14, 2024",IND @ DEN,L,19,2,9,0.222,0,2,0.0,1,2,0.5,1,1,2,5,0,0,1,0,5,8,1,T.J. McConnell,IND,DEN,IND,,,12,7,10,7
22023,204456,22300533,"JAN 12, 2024",IND @ ATL,W,25,3,5,0.6,0,0,0.0,0,0,0.0,0,4,4,14,3,1,5,0,6,14,1,T.J. McConnell,IND,ATL,IND,,,24,10,20,18
22023,204456,22300520,"JAN 10, 2024",IND vs. WAS,W,22,7,10,0.7,0,0,0.0,0,0,0.0,0,2,2,8,2,0,0,2,14,7,1,T.J. McConnell,IND,IND,WAS,,,24,16,22,10
22023,204456,22300507,"JAN 08, 2024",IND vs. BOS,W,25,6,12,0.5,0,2,0.0,0,0,0.0,1,3,4,7,2,0,2,1,12,10,1,T.J. McConnell,IND,IND,BOS,,,23,16,19,11
22023,204456,22300493,"JAN 06, 2024",IND vs. BOS,L,12,3,3,1.0,0,0,0.0,0,0,0.0,0,1,1,5,2,0,3,0,6,-3,1,T.J. McConnell,IND,IND,BOS,,,12,7,11,6
22023,204456,22300480,"JAN 05, 2024",IND vs. ATL,W,23,5,6,0.833,0,0,0.0,0,0,0.0,2,1,3,10,3,0,1,2,10,10,1,T.J. McConnell,IND,IND,ATL,,,23,13,20,13
22023,204456,22300466,"JAN 03, 2024",IND vs. MIL,W,19,2,6,0.333,0,1,0.0,2,2,1.0,0,6,6,3,0,0,1,1,6,3,1,T.J. McConnell,IND,IND,MIL,,,15,12,9,9
22023,204456,22300454,"JAN 01, 2024",IND @ MIL,W,22,5,9,0.556,0,1,0.0,6,8,0.75,1,3,4,9,1,0,0,0,16,31,1,T.J. McConnell,IND,MIL,IND,,,29,20,25,13
22023,204456,22300441,"DEC 30, 2023",IND vs. NYK,W,12,2,3,0.667,0,0,0.0,1,1,1.0,0,0,0,3,0,0,2,0,5,-5,1,T.J. McConnell,IND,IND,NYK,,,8,5,8,3
22023,204456,22300391,"DEC 23, 2023",IND vs. ORL,L,7,0,1,0.0,0,0,0.0,1,2,0.5,0,0,0,2,0,0,1,0,1,-17,1,T.J. McConnell,IND,IND,ORL,,,3,1,3,2
22023,204456,22300377,"DEC 21, 2023",IND @ MEM,L,4,1,1,1.0,0,0,0.0,0,0,0.0,0,1,1,1,0,0,1,0,2,-5,1,T.J. McConnell,IND,MEM,IND,,,4,3,3,2
22023,204456,22300365,"DEC 20, 2023",IND vs. CHA,W,20,3,3,1.0,0,0,0.0,3,4,0.75,1,4,5,9,1,0,1,1,9,-1,1,T.J. McConnell,IND,IND,CHA,,,23,14,18,14
22023,204456,22300350,"DEC 18, 2023",IND vs. LAC,L,20,5,10,0.5,0,0,0.0,0,0,0.0,1,4,5,8,1,0,0,2,10,16,1,T.J. McConnell,IND,IND,LAC,,,23,15,18,13
22023,204456,22300338,"DEC 16, 2023",IND @ MIN,L,26,5,12,0.417,0,1,0.0,0,0,0.0,1,3,4,6,2,1,1,1,10,-17,1,T.J. McConnell,IND,MIN,IND,,,20,14,16,10
22023,204456,22300328,"DEC 15, 2023",IND @ WAS,L,20,4,10,0.4,0,0,0.0,1,1,1.0,0,3,3,9,1,0,2,0,9,-1,1,T.J. McConnell,IND,WAS,IND,,,21,12,18,12
22023,204456,22300315,"DEC 13, 2023",IND @ MIL,L,16,4,9,0.444,0,2,0.0,1,1,1.0,1,4,5,5,2,0,3,1,9,-12,1,T.J. McConnell,IND,MIL,IND,,,19,14,14,10
22023,204456,22300293,"DEC 11, 2023",IND @ DET,W,15,4,10,0.4,0,1,0.0,0,0,0.0,0,2,2,5,1,0,2,2,8,0,1,T.J. McConnell,IND,DET,IND,,,15,10,13,7
22023,204456,22301229,"DEC 07, 2023",IND @ MIL,W,11,4,7,0.571,0,0,0.0,1,2,0.5,1,0,1,4,3,0,3,0,9,9,1,T.J. McConnell,IND,MIL,IND,,,14,10,13,5
22023,204456,22301202,"DEC 04, 2023",IND vs. BOS,W,9,1,5,0.2,0,0,0.0,0,0,0.0,0,2,2,3,1,0,0,0,2,-5,1,T.J. McConnell,IND,IND,BOS,,,7,4,5,5
22023,204456,22300284,"DEC 02, 2023",IND @ MIA,W,25,10,11,0.909,0,0,0.0,0,0,0.0,0,2,2,11,0,0,1,0,20,5,1,T.J. McConnell,IND,MIA,IND,,,33,22,31,13
22023,204456,22300254,"NOV 27, 2023",IND vs. POR,L,10,0,2,0.0,0,1,0.0,0,2,0.0,2,2,4,4,1,1,3,0,0,4,1,T.J. McConnell,IND,IND,POR,,,8,4,4,8
22023,204456,22300230,"NOV 22, 2023",IND vs. TOR,L,14,3,6,0.5,1,1,1.0,0,0,0.0,0,2,2,5,1,0,0,5,7,-4,1,T.J. McConnell,IND,IND,TOR,,,14,9,12,7
22023,204456,22300039,"NOV 21, 2023",IND @ ATL,W,14,1,5,0.2,0,0,0.0,0,0,0.0,0,0,0,4,0,0,0,1,2,-4,1,T.J. McConnell,IND,ATL,IND,,,6,2,6,4
22023,204456,22300209,"NOV 19, 2023",IND vs. ORL,L,21,5,9,0.556,0,1,0.0,1,3,0.333,1,3,4,5,0,0,2,1,11,2,1,T.J. McConnell,IND,IND,ORL,,,20,15,16,9
22023,204456,22300019,"NOV 14, 2023",IND @ PHI,W,13,5,8,0.625,0,2,0.0,1,1,1.0,1,2,3,3,0,0,1,3,11,-7,1,T.J. McConnell,IND,PHI,IND,,,17,14,14,6
22023,204456,22300180,"NOV 12, 2023",IND @ PHI,L,17,3,5,0.6,0,0,0.0,2,2,1.0,0,2,2,1,3,1,1,1,8,10,1,T.J. McConnell,IND,PHI,IND,,,11,10,9,3
22023,204456,22300146,"NOV 06, 2023",IND vs. SAS,W,9,1,2,0.5,0,0,0.0,2,2,1.0,0,3,3,4,0,0,1,1,4,6,1,T.J. McConnell,IND,IND,SAS,,,11,7,8,7
22023,204456,22300133,"NOV 04, 2023",IND vs. CHA,L,5,0,2,0.0,0,0,0.0,0,0,0.0,0,0,0,0,0,0,1,1,0,-9,1,T.J. McConnell,IND,IND,CHA,,,0,0,0,0
22023,204456,22300118,"NOV 01, 2023",IND @ BOS,L,28,8,13,0.615,0,1,0.0,2,2,1.0,2,5,7,5,1,0,1,2,18,-29,1,T.J. McConnell,IND,BOS,IND,,,30,25,23,12
22023,204456,22300091,"OCT 28, 2023",IND @ CLE,W,19,3,5,0.6,0,0,0.0,2,2,1.0,1,1,2,8,0,0,0,1,8,21,1,T.J. McConnell,IND,CLE,IND,,,18,10,16,10
22023,204456,22300064,"OCT 25, 2023",IND vs. WAS,W,6,2,2,1.0,0,0,0.0,0,0,0.0,0,1,1,2,2,0,0,0,4,1,1,T.J. McConnell,IND,IND,WAS,,,7,5,6,3
22023,1630183,22300553,"JAN 14, 2024",MIN vs. LAC,W,35,6,10,0.6,2,3,0.667,0,0,0.0,1,3,4,4,2,0,4,2,14,4,1,Jaden McDaniels,MIN,MIN,LAC,,,22,18,18,8
22023,1630183,22300538,"JAN 12, 2024",MIN vs. POR,W,24,4,8,0.5,1,3,0.333,0,0,0.0,0,2,2,3,2,0,4,1,9,36,1,Jaden McDaniels,MIN,MIN,POR,,,14,11,12,5
22023,1630183,22300517,"JAN 10, 2024",MIN @ BOS,L,24,2,8,0.25,1,4,0.25,0,0,0.0,0,1,1,1,0,0,1,6,5,-12,1,Jaden McDaniels,MIN,BOS,MIN,,,7,6,6,2
22023,1630183,22300513,"JAN 09, 2024",MIN @ ORL,W,35,6,10,0.6,2,5,0.4,1,1,1.0,0,9,9,1,1,0,2,1,15,35,1,Jaden McDaniels,MIN,ORL,MIN,,,25,24,16,10
22023,1630183,22300501,"JAN 07, 2024",MIN @ DAL,L,37,1,10,0.1,0,5,0.0,0,0,0.0,1,2,3,4,0,0,0,4,2,-7,1,Jaden McDaniels,MIN,DAL,MIN,,,9,5,6,7
22023,1630183,22300485,"JAN 05, 2024",MIN @ HOU,W,30,7,10,0.7,2,3,0.667,0,0,0.0,0,3,3,0,1,0,0,1,16,14,1,Jaden McDaniels,MIN,HOU,MIN,,,19,19,16,3
22023,1630183,22300471,"JAN 03, 2024",MIN vs. NOP,L,33,5,10,0.5,1,3,0.333,0,0,0.0,0,0,0,2,2,1,1,3,11,-19,1,Jaden McDaniels,MIN,MIN,NOP,,,13,11,13,2
22023,1630183,22300451,"JAN 01, 2024",MIN @ NYK,L,33,2,8,0.25,1,5,0.2,3,4,0.75,1,0,1,0,1,1,1,4,8,-9,1,Jaden McDaniels,MIN,NYK,MIN,,,9,9,8,1
22023,1630183,22300443,"DEC 30, 2023",MIN vs. LAL,W,26,2,6,0.333,0,1,0.0,2,2,1.0,0,3,3,2,1,1,1,6,6,-3,1,Jaden McDaniels,MIN,MIN,LAL,,,11,9,8,5
22023,1630183,22300423,"DEC 28, 2023",MIN vs. DAL,W,34,5,8,0.625,2,3,0.667,0,1,0.0,0,0,0,0,1,4,2,3,12,4,1,Jaden McDaniels,MIN,MIN,DAL,,,12,12,12,0
22023,1630183,22300411,"DEC 26, 2023",MIN @ OKC,L,27,3,10,0.3,0,3,0.0,2,2,1.0,1,0,1,1,1,1,2,5,8,-16,1,Jaden McDaniels,MIN,OKC,MIN,,,10,9,9,2
22023,1630183,22300400,"DEC 23, 2023",MIN @ SAC,W,41,8,16,0.5,3,9,0.333,1,2,0.5,0,5,5,1,4,1,0,4,20,12,1,Jaden McDaniels,MIN,SAC,MIN,,,26,25,21,6
22023,1630183,22300380,"DEC 21, 2023",MIN vs. LAL,W,36,5,8,0.625,2,4,0.5,2,2,1.0,0,1,1,3,1,0,1,2,14,-3,1,Jaden McDaniels,MIN,MIN,LAL,,,18,15,17,4
22023,1630183,22300367,"DEC 20, 2023",MIN @ PHI,L,38,8,12,0.667,2,3,0.667,3,5,0.6,1,2,3,0,1,0,0,3,21,-3,1,Jaden McDaniels,MIN,PHI,MIN,,,24,24,21,3
22023,1630183,22300353,"DEC 18, 2023",MIN @ MIA,W,30,5,10,0.5,0,0,0.0,0,0,0.0,3,2,5,2,0,3,3,6,10,1,1,Jaden McDaniels,MIN,MIA,MIN,,,17,15,12,7
22023,1630183,22300338,"DEC 16, 2023",MIN vs. IND,W,18,2,4,0.5,1,1,1.0,0,0,0.0,0,1,1,0,1,0,1,2,5,8,1,Jaden McDaniels,MIN,MIN,IND,,,6,6,5,1
22023,1630183,22300321,"DEC 14, 2023",MIN @ DAL,W,24,5,9,0.556,0,2,0.0,1,1,1.0,1,1,2,1,0,1,0,3,11,7,1,Jaden McDaniels,MIN,DAL,MIN,,,14,13,12,3
22023,1630183,22300301,"DEC 11, 2023",MIN @ NOP,L,27,5,12,0.417,2,6,0.333,0,1,0.0,0,3,3,0,0,0,1,4,12,-3,1,Jaden McDaniels,MIN,NOP,MIN,,,15,15,12,3
22023,1630183,22300221,"NOV 20, 2023",MIN vs. NYK,W,5,2,2,1.0,0,0,0.0,0,0,0.0,0,1,1,0,0,0,1,0,4,1,1,Jaden McDaniels,MIN,MIN,NYK,,,5,5,4,1
22023,1630183,22300203,"NOV 18, 2023",MIN @ NOP,W,34,5,7,0.714,1,2,0.5,1,1,1.0,0,2,2,1,0,0,2,3,12,8,1,Jaden McDaniels,MIN,NOP,MIN,,,15,14,13,3
22023,1630183,22300197,"NOV 15, 2023",MIN @ PHX,L,23,6,10,0.6,0,3,0.0,1,1,1.0,1,1,2,3,2,0,1,4,13,-5,1,Jaden McDaniels,MIN,PHX,MIN,,,18,15,16,5
22023,1630183,22300025,"NOV 14, 2023",MIN @ GSW,W,2,0,1,0.0,0,1,0.0,0,0,0.0,0,0,0,0,0,0,0,0,0,2,1,Jaden McDaniels,MIN,GSW,MIN,,,0,0,0,0
22023,1630183,22300186,"NOV 12, 2023",MIN @ GSW,W,35,6,8,0.75,1,2,0.5,0,0,0.0,0,0,0,1,0,0,0,5,13,8,1,Jaden McDaniels,MIN,GSW,MIN,,,14,13,14,1
22023,1630183,22300013,"NOV 10, 2023",MIN @ SAS,W,26,5,11,0.455,0,2,0.0,0,0,0.0,2,3,5,0,2,0,0,6,10,-1,1,Jaden McDaniels,MIN,SAS,MIN,,,15,15,10,5
22023,1630183,22300166,"NOV 08, 2023",MIN vs. NOP,W,26,4,7,0.571,2,5,0.4,0,0,0.0,0,0,0,3,0,0,0,2,10,18,1,Jaden McDaniels,MIN,MIN,NOP,,,13,10,13,3
22023,1630183,22300154,"NOV 06, 2023",MIN vs. BOS,W,45,8,18,0.444,4,9,0.444,0,0,0.0,1,1,2,1,1,0,3,3,20,-6,1,Jaden McDaniels,MIN,MIN,BOS,,,23,22,21,3
22023,1630183,22300138,"NOV 04, 2023",MIN vs. UTA,W,20,2,4,0.5,1,2,0.5,0,0,0.0,0,0,0,1,1,1,0,6,5,10,1,Jaden McDaniels,MIN,MIN,UTA,,,6,5,6,1
22023,1630183,22300123,"NOV 01, 2023",MIN vs. DEN,W,21,3,5,0.6,0,1,0.0,0,0,0.0,3,6,9,2,0,2,4,5,6,19,1,Jaden McDaniels,MIN,MIN,DEN,,,17,15,8,11
22023,1630183,22300104,"OCT 30, 2023",MIN @ ATL,L,24,5,6,0.833,2,2,1.0,0,0,0.0,0,3,3,2,0,1,0,2,12,-8,1,Jaden McDaniels,MIN,ATL,MIN,,,17,15,14,5
22023,1629667,22300563,"JAN 15, 2024",TOR vs. BOS,L,12,2,5,0.4,1,3,0.333,0,2,0.0,1,1,2,0,0,0,0,0,5,-12,1,Jalen McDaniels,TOR,TOR,BOS,,,7,7,5,2
22023,1629667,22300540,"JAN 12, 2024",TOR @ UTA,L,8,4,5,0.8,0,0,0.0,7,10,0.7,2,1,3,0,1,0,1,0,15,-8,1,Jalen McDaniels,TOR,UTA,TOR,,,18,18,15,3
22023,1629667,22300526,"JAN 10, 2024",TOR @ LAC,L,13,1,2,0.5,0,0,0.0,0,0,0.0,0,3,3,1,1,0,0,2,2,0,1,Jalen McDaniels,TOR,LAC,TOR,,,6,5,3,4
22023,1629667,22300504,"JAN 07, 2024",TOR @ GSW,W,4,0,0,0.0,0,0,0.0,0,0,0.0,0,0,0,1,0,0,0,0,0,-5,1,Jalen McDaniels,TOR,GSW,TOR,,,1,0,1,1
22023,1629667,22300492,"JAN 05, 2024",TOR @ SAC,L,7,1,2,0.5,0,1,0.0,0,0,0.0,0,0,0,0,0,0,0,1,2,-5,1,Jalen McDaniels,TOR,SAC,TOR,,,2,2,2,0
22023,1629667,22300440,"DEC 30, 2023",TOR @ DET,L,17,0,3,0.0,0,1,0.0,2,2,1.0,0,1,1,0,0,0,1,3,2,-7,1,Jalen McDaniels,TOR,DET,TOR,,,3,3,2,1
22023,1629667,22300432,"DEC 29, 2023",TOR @ BOS,L,15,5,10,0.5,2,7,0.286,1,2,0.5,0,0,0,2,1,0,0,4,13,8,1,Jalen McDaniels,TOR,BOS,TOR,,,15,13,15,2
22023,1629667,22300416,"DEC 27, 2023",TOR @ WAS,W,19,2,7,0.286,0,4,0.0,2,2,1.0,0,4,4,1,1,0,0,2,6,11,1,Jalen McDaniels,TOR,WAS,TOR,,,11,10,7,5
22023,1629667,22300382,"DEC 22, 2023",TOR @ PHI,L,2,1,1,1.0,1,1,1.0,0,0,0.0,0,2,2,0,0,0,0,0,3,3,1,Jalen McDaniels,TOR,PHI,TOR,,,5,5,3,2
22023,1629667,22300330,"DEC 15, 2023",TOR vs. ATL,L,3,0,3,0.0,0,2,0.0,0,0,0.0,0,0,0,0,0,0,0,0,0,1,1,Jalen McDaniels,TOR,TOR,ATL,,,0,0,0,0
22023,1629667,22300276,"DEC 01, 2023",TOR vs. NYK,L,7,1,4,0.25,0,2,0.0,0,0,0.0,1,1,2,1,0,0,0,1,2,8,1,Jalen McDaniels,TOR,TOR,NYK,,,5,4,3,3
22023,1629667,22300260,"NOV 29, 2023",TOR vs. PHX,W,9,0,1,0.0,0,1,0.0,0,0,0.0,0,0,0,0,0,0,2,2,0,-3,1,Jalen McDaniels,TOR,TOR,PHX,,,0,0,0,0
22023,1629667,22300054,"NOV 28, 2023",TOR @ BKN,L,13,2,4,0.5,1,1,1.0,0,0,0.0,1,1,2,1,2,1,0,2,5,2,1,Jalen McDaniels,TOR,BKN,TOR,,,8,7,6,3
22023,1629667,22300038,"NOV 21, 2023",TOR @ ORL,L,7,1,1,1.0,1,1,1.0,2,2,1.0,1,0,1,1,0,0,1,1,5,5,1,Jalen McDaniels,TOR,ORL,TOR,,,7,6,6,2
22023,1629667,22300211,"NOV 19, 2023",TOR vs. DET,W,8,2,4,0.5,0,1,0.0,0,0,0.0,0,1,1,1,0,0,1,1,4,-5,1,Jalen McDaniels,TOR,TOR,DET,,,6,5,5,2
22023,1629667,22300031,"NOV 17, 2023",TOR vs. BOS,L,7,2,5,0.4,0,1,0.0,0,0,0.0,0,0,0,0,0,0,0,0,4,-8,1,Jalen McDaniels,TOR,TOR,BOS,,,4,4,4,0
22023,1629667,22300195,"NOV 15, 2023",TOR vs. MIL,L,18,3,10,0.3,1,4,0.25,0,0,0.0,0,4,4,1,1,1,1,0,7,21,1,Jalen McDaniels,TOR,TOR,MIL,,,12,11,8,5
22023,1629667,22300189,"NOV 13, 2023",TOR vs. WAS,W,5,0,1,0.0,0,0,0.0,0,0,0.0,0,0,0,0,0,0,0,0,0,-6,1,Jalen McDaniels,TOR,TOR,WAS,,,0,0,0,0
22023,1629667,22300174,"NOV 11, 2023",TOR @ BOS,L,9,0,2,0.0,0,0,0.0,0,0,0.0,0,1,1,0,0,0,0,2,0,2,1,Jalen McDaniels,TOR,BOS,TOR,,,1,1,0,1
22023,1629667,22300141,"NOV 05, 2023",TOR @ SAS,W,5,0,3,0.0,0,1,0.0,0,0,0.0,0,1,1,0,0,0,1,0,0,-4,1,Jalen McDaniels,TOR,SAS,TOR,,,1,1,0,1
22023,1629667,22300128,"NOV 02, 2023",TOR @ PHI,L,9,2,3,0.667,1,2,0.5,0,0,0.0,0,1,1,0,0,0,0,0,5,4,1,Jalen McDaniels,TOR,PHI,TOR,,,6,6,5,1
22023,1629667,22300105,"OCT 30, 2023",TOR vs. POR,L,5,0,1,0.0,0,1,0.0,0,0,0.0,0,0,0,1,0,0,0,1,0,-4,1,Jalen McDaniels,TOR,TOR,POR,,,1,0,1,1
22023,1629667,22300092,"OCT 28, 2023",TOR vs. PHI,L,3,0,0,0.0,0,0,0.0,0,0,0.0,0,0,0,0,0,0,0,0,0,-5,1,Jalen McDaniels,TOR,TOR,PHI,,,0,0,0,0
22023,1629667,22300082,"OCT 27, 2023",TOR @ CHI,L,18,0,4,0.0,0,4,0.0,0,0,0.0,1,2,3,1,1,0,0,1,0,-25,1,Jalen McDaniels,TOR,CHI,TOR,,,4,3,1,4
22023,1629667,22300069,"OCT 25, 2023",TOR vs. MIN,W,16,0,3,0.0,0,3,0.0,0,0,0.0,0,2,2,2,1,1,0,2,0,-3,1,Jalen McDaniels,TOR,TOR,MIN,,,4,2,2,4
22023,203926,22300559,"JAN 15, 2024",SAS @ ATL,L,15,2,5,0.4,2,5,0.4,0,0,0.0,0,1,1,0,0,0,0,1,6,2,1,Doug McDermott,SAS,ATL,SAS,,,7,7,6,1
22023,203926,22300541,"JAN 12, 2024",SAS vs. CHA,W,12,4,6,0.667,4,6,0.667,2,3,0.667,0,2,2,0,0,0,0,0,14,13,1,Doug McDermott,SAS,SAS,CHA,,,16,16,14,2
22023,203926,22300519,"JAN 10, 2024",SAS @ DET,W,15,5,6,0.833,4,5,0.8,0,0,0.0,0,2,2,0,0,0,0,0,14,-3,1,Doug McDermott,SAS,DET,SAS,,,16,16,14,2
22023,203926,22300460,"JAN 02, 2024",SAS @ MEM,L,16,1,4,0.25,1,4,0.25,0,0,0.0,0,0,0,0,0,0,0,0,3,-9,1,Doug McDermott,SAS,MEM,SAS,,,3,3,3,0
22023,203926,22300448,"DEC 31, 2023",SAS vs. BOS,L,16,0,3,0.0,0,3,0.0,0,0,0.0,0,0,0,1,0,0,1,1,0,-10,1,Doug McDermott,SAS,SAS,BOS,,,1,0,1,1
22023,203926,22300437,"DEC 29, 2023",SAS @ POR,L,23,6,9,0.667,6,8,0.75,0,0,0.0,0,1,1,1,0,0,2,1,18,12,1,Doug McDermott,SAS,POR,SAS,,,20,19,19,2
22023,203926,22300427,"DEC 28, 2023",SAS @ POR,W,16,3,4,0.75,2,3,0.667,0,0,0.0,0,1,1,1,0,0,0,0,8,-3,1,Doug McDermott,SAS,POR,SAS,,,10,9,9,2
22023,203926,22300412,"DEC 26, 2023",SAS vs. UTA,L,11,0,2,0.0,0,2,0.0,0,0,0.0,0,0,0,0,0,0,0,0,0,-10,1,Doug McDermott,SAS,SAS,UTA,,,0,0,0,0
22023,203926,22300398,"DEC 23, 2023",SAS @ DAL,L,6,0,0,0.0,0,0,0.0,0,2,0.0,0,0,0,0,0,0,0,0,0,4,1,Doug McDermott,SAS,DAL,SAS,,,0,0,0,0
22023,203926,22300376,"DEC 21, 2023",SAS @ CHI,L,12,1,4,0.25,1,4,0.25,0,0,0.0,0,0,0,1,1,0,0,3,3,-11,1,Doug McDermott,SAS,CHI,SAS,,,4,3,4,1
22023,203926,22300361,"DEC 19, 2023",SAS @ MIL,L,13,0,2,0.0,0,1,0.0,0,0,0.0,0,2,2,2,0,0,0,3,0,0,1,Doug McDermott,SAS,MIL,SAS,,,4,2,2,4
22023,203926,22300345,"DEC 17, 2023",SAS vs. NOP,L,15,2,7,0.286,1,5,0.2,2,2,1.0,1,1,2,1,0,0,0,1,7,-26,1,Doug McDermott,SAS,SAS,NOP,,,10,9,8,3
22023,203926,22300331,"DEC 15, 2023",SAS vs. LAL,W,17,2,4,0.5,2,4,0.5,0,0,0.0,0,1,1,0,0,0,1,1,6,-2,1,Doug McDermott,SAS,SAS,LAL,,,7,7,6,1
22023,203926,22300316,"DEC 13, 2023",SAS vs. LAL,L,15,1,5,0.2,1,3,0.333,0,0,0.0,0,1,1,1,1,0,0,0,3,-9,1,Doug McDermott,SAS,SAS,LAL,,,5,4,4,2
22023,203926,22300298,"DEC 11, 2023",SAS @ HOU,L,15,2,5,0.4,2,5,0.4,0,0,0.0,0,0,0,1,1,0,0,0,6,-2,1,Doug McDermott,SAS,HOU,SAS,,,7,6,7,1
22023,203926,22301223,"DEC 08, 2023",SAS vs. CHI,L,15,3,6,0.5,3,4,0.75,0,0,0.0,0,1,1,1,0,0,1,2,9,10,1,Doug McDermott,SAS,SAS,CHI,,,11,10,10,2
22023,203926,22301210,"DEC 06, 2023",SAS @ MIN,L,22,3,8,0.375,3,8,0.375,2,2,1.0,0,3,3,2,0,0,0,1,11,2,1,Doug McDermott,SAS,MIN,SAS,,,16,14,13,5
22023,203926,22300252,"NOV 26, 2023",SAS @ DEN,L,12,0,2,0.0,0,2,0.0,0,0,0.0,0,0,0,1,0,0,0,0,0,-12,1,Doug McDermott,SAS,DEN,SAS,,,1,0,1,1
22023,203926,22300051,"NOV 24, 2023",SAS @ GSW,L,19,3,6,0.5,1,3,0.333,0,0,0.0,1,0,1,4,3,0,0,0,7,-1,1,Doug McDermott,SAS,GSW,SAS,,,12,8,11,5
22023,203926,22300235,"NOV 22, 2023",SAS vs. LAC,L,14,1,2,0.5,1,2,0.5,0,0,0.0,0,2,2,1,0,1,3,2,3,4,1,Doug McDermott,SAS,SAS,LAC,,,6,5,4,3
22023,203926,22300223,"NOV 20, 2023",SAS vs. LAC,L,14,1,3,0.333,1,3,0.333,0,0,0.0,0,2,2,2,0,0,0,1,3,-8,1,Doug McDermott,SAS,SAS,LAC,,,7,5,5,4
22023,203926,22300206,"NOV 18, 2023",SAS vs. MEM,L,16,2,5,0.4,1,3,0.333,0,0,0.0,0,0,0,2,1,0,0,3,5,-8,1,Doug McDermott,SAS,SAS,MEM,,,7,5,7,2
22023,203926,22300032,"NOV 17, 2023",SAS vs. SAC,L,16,2,4,0.5,1,2,0.5,1,2,0.5,0,0,0,3,0,0,0,1,6,16,1,Doug McDermott,SAS,SAS,SAC,,,9,6,9,3
22023,203926,22300021,"NOV 14, 2023",SAS @ OKC,L,18,2,4,0.5,1,2,0.5,0,0,0.0,0,1,1,1,0,0,4,0,5,-18,1,Doug McDermott,SAS,OKC,SAS,,,7,6,6,2
22023,203926,22300184,"NOV 12, 2023",SAS vs. MIA,L,21,3,4,0.75,2,3,0.667,0,0,0.0,1,2,3,5,0,0,0,2,8,-3,1,Doug McDermott,SAS,SAS,MIA,,,16,11,13,8
22023,203926,22300013,"NOV 10, 2023",SAS vs. MIN,L,14,1,4,0.25,1,3,0.333,0,0,0.0,0,0,0,1,0,0,0,2,3,3,1,Doug McDermott,SAS,SAS,MIN,,,4,3,4,1
22023,203926,22300161,"NOV 08, 2023",SAS @ NYK,L,22,4,9,0.444,3,8,0.375,0,0,0.0,1,2,3,1,0,0,3,3,11,-5,1,Doug McDermott,SAS,NYK,SAS,,,15,14,12,4
22023,203926,22300146,"NOV 06, 2023",SAS @ IND,L,20,5,9,0.556,4,6,0.667,3,4,0.75,0,1,1,4,0,0,0,1,17,-18,1,Doug McDermott,SAS,IND,SAS,,,22,18,21,5
22023,203926,22300141,"NOV 05, 2023",SAS vs. TOR,L,24,4,8,0.5,4,8,0.5,0,0,0.0,0,1,1,2,0,0,2,2,12,0,1,Doug McDermott,SAS,SAS,TOR,,,15,13,14,3
22023,203926,22300131,"NOV 02, 2023",SAS @ PHX,W,16,2,4,0.5,2,3,0.667,0,0,0.0,0,0,0,0,1,0,0,0,6,-17,1,Doug McDermott,SAS,PHX,SAS,,,6,6,6,0
22023,203926,22300113,"OCT 31, 2023",SAS @ PHX,W,15,2,3,0.667,2,2,1.0,0,0,0.0,0,1,1,1,1,0,0,1,6,0,1,Doug McDermott,SAS,PHX,SAS,,,8,7,7,2
22023,203926,22300099,"OCT 29, 2023",SAS @ LAC,L,15,3,6,0.5,2,4,0.5,0,0,0.0,0,3,3,2,0,0,0,3,8,-8,1,Doug McDermott,SAS,LAC,SAS,,,13,11,10,5
22023,203926,22300083,"OCT 27, 2023",SAS vs. HOU,W,16,3,5,0.6,2,4,0.5,0,0,0.0,0,0,0,0,0,0,0,0,8,-4,1,Doug McDermott,SAS,SAS,HOU,,,8,8,8,0
22023,203926,22300073,"OCT 25, 2023",SAS vs. DAL,L,11,0,1,0.0,0,1,0.0,0,0,0.0,0,1,1,1,0,1,0,1,0,-7,1,Doug McDermott,SAS,SAS,DAL,,,2,1,1,2
22023,201580,22300532,"JAN 12, 2024",SAC @ PHI,L,5,0,3,0.0,0,1,0.0,2,2,1.0,1,4,5,0,0,1,0,0,2,1,1,JaVale McGee,SAC,PHI,SAC,,,7,7,2,5
22023,201580,22300518,"JAN 10, 2024",SAC @ CHA,W,5,2,5,0.4,0,0,0.0,4,4,1.0,4,3,7,0,0,0,2,0,8,1,1,JaVale McGee,SAC,CHA,SAC,,,15,15,8,7
22023,201580,22300500,"JAN 07, 2024",SAC vs. NOP,L,6,0,1,0.0,0,0,0.0,0,0,0.0,0,1,1,1,0,0,1,0,0,-17,1,JaVale McGee,SAC,SAC,NOP,,,2,1,1,2
22023,201580,22300492,"JAN 05, 2024",SAC vs. TOR,W,7,2,3,0.667,0,0,0.0,2,2,1.0,0,2,2,1,0,0,0,0,6,-7,1,JaVale McGee,SAC,SAC,TOR,,,9,8,7,3
22023,201580,22300476,"JAN 03, 2024",SAC vs. ORL,W,8,2,2,1.0,0,0,0.0,1,3,0.333,0,2,2,0,1,0,0,2,5,-3,1,JaVale McGee,SAC,SAC,ORL,,,7,7,5,2
22023,201580,22300449,"DEC 31, 2023",SAC @ MEM,W,4,0,0,0.0,0,0,0.0,0,0,0.0,0,2,2,0,0,1,2,1,0,4,1,JaVale McGee,SAC,MEM,SAC,,,2,2,0,2
22023,201580,22300413,"DEC 26, 2023",SAC @ POR,L,5,2,2,1.0,0,0,0.0,0,0,0.0,1,0,1,1,0,0,1,1,4,-6,1,JaVale McGee,SAC,POR,SAC,,,6,5,5,2
22023,201580,22300400,"DEC 23, 2023",SAC vs. MIN,L,9,3,6,0.5,0,0,0.0,1,1,1.0,0,2,2,1,1,1,1,2,7,5,1,JaVale McGee,SAC,SAC,MIN,,,10,9,8,3
22023,201580,22300387,"DEC 22, 2023",SAC vs. PHX,W,10,1,2,0.5,0,0,0.0,3,4,0.75,0,1,1,0,0,0,1,3,5,-7,1,JaVale McGee,SAC,SAC,PHX,,,6,6,5,1
22023,201580,22300373,"DEC 20, 2023",SAC vs. BOS,L,12,2,3,0.667,0,0,0.0,0,2,0.0,0,3,3,1,0,4,1,0,4,3,1,JaVale McGee,SAC,SAC,BOS,,,8,7,5,4
22023,201580,22300342,"DEC 16, 2023",SAC vs. UTA,W,4,2,3,0.667,0,0,0.0,0,0,0.0,0,0,0,0,0,0,1,1,4,-4,1,JaVale McGee,SAC,SAC,UTA,,,4,4,4,0
22023,201580,22300324,"DEC 14, 2023",SAC vs. OKC,W,4,1,1,1.0,0,0,0.0,0,0,0.0,0,2,2,0,0,0,2,1,2,2,1,JaVale McGee,SAC,SAC,OKC,,,4,4,2,2
22023,201580,22300309,"DEC 12, 2023",SAC @ LAC,L,6,3,3,1.0,0,0,0.0,0,1,0.0,1,0,1,0,0,0,1,1,6,-8,1,JaVale McGee,SAC,LAC,SAC,,,7,7,6,1
22023,201580,22300303,"DEC 11, 2023",SAC vs. BKN,W,8,0,2,0.0,0,0,0.0,0,0,0.0,2,1,3,2,0,0,1,3,0,7,1,JaVale McGee,SAC,SAC,BKN,,,5,3,2,5
22023,201580,22301228,"DEC 08, 2023",SAC @ PHX,W,7,0,0,0.0,0,0,0.0,0,0,0.0,0,1,1,0,0,0,0,1,0,10,1,JaVale McGee,SAC,PHX,SAC,,,1,1,0,1
22023,201580,22301204,"DEC 04, 2023",SAC vs. NOP,L,4,0,1,0.0,0,0,0.0,0,0,0.0,0,1,1,0,1,0,0,0,0,-6,1,JaVale McGee,SAC,SAC,NOP,,,1,1,0,1
22023,201580,22300290,"DEC 02, 2023",SAC vs. DEN,W,12,4,4,1.0,0,0,0.0,0,0,0.0,1,3,4,0,0,3,0,3,8,14,1,JaVale McGee,SAC,SAC,DEN,,,12,12,8,4
22023,201580,22300264,"NOV 29, 2023",SAC vs. LAC,L,5,1,1,1.0,0,0,0.0,0,0,0.0,3,2,5,0,0,0,1,1,2,-1,1,JaVale McGee,SAC,SAC,LAC,,,7,7,2,5
22023,201580,22300060,"NOV 28, 2023",SAC vs. GSW,W,5,0,1,0.0,0,0,0.0,1,2,0.5,1,0,1,0,0,2,1,1,1,0,1,JaVale McGee,SAC,SAC,GSW,,,2,2,1,1
22023,201580,22300050,"NOV 24, 2023",SAC @ MIN,W,8,2,2,1.0,0,0,0.0,0,0,0.0,2,4,6,1,0,0,0,1,4,16,1,JaVale McGee,SAC,MIN,SAC,,,11,10,5,7
22023,201580,22300233,"NOV 22, 2023",SAC @ NOP,L,5,0,0,0.0,0,0,0.0,0,2,0.0,0,1,1,0,0,0,2,0,0,-16,1,JaVale McGee,SAC,NOP,SAC,,,1,1,0,1
22023,201580,22300222,"NOV 20, 2023",SAC @ NOP,L,13,4,6,0.667,0,0,0.0,2,4,0.5,2,5,7,1,0,2,3,3,10,-6,1,JaVale McGee,SAC,NOP,SAC,,,18,17,11,8
22023,201580,22300212,"NOV 19, 2023",SAC @ DAL,W,9,2,4,0.5,0,0,0.0,2,2,1.0,2,5,7,1,1,1,1,1,6,3,1,JaVale McGee,SAC,DAL,SAC,,,14,13,7,8
22023,201580,22300032,"NOV 17, 2023",SAC @ SAS,W,8,2,2,1.0,0,0,0.0,0,0,0.0,0,0,0,1,0,0,1,1,4,-1,1,JaVale McGee,SAC,SAS,SAC,,,5,4,5,1
22023,201580,22300198,"NOV 15, 2023",SAC @ LAL,W,9,3,3,1.0,0,0,0.0,1,2,0.5,2,4,6,1,2,0,2,3,7,-7,1,JaVale McGee,SAC,LAL,SAC,,,14,13,8,7
22023,201580,22300191,"NOV 13, 2023",SAC vs. CLE,W,7,1,2,0.5,0,0,0.0,0,0,0.0,1,3,4,1,0,0,0,1,2,2,1,JaVale McGee,SAC,SAC,CLE,,,7,6,3,5
22023,201580,22300153,"NOV 06, 2023",SAC @ HOU,L,10,4,5,0.8,0,0,0.0,2,2,1.0,3,0,3,0,0,0,2,4,10,-11,1,JaVale McGee,SAC,HOU,SAC,,,13,13,10,3
22023,201580,22300137,"NOV 04, 2023",SAC @ HOU,L,15,5,9,0.556,0,1,0.0,2,2,1.0,2,4,6,0,0,0,0,0,12,7,1,JaVale McGee,SAC,HOU,SAC,,,18,18,12,6
22023,201580,22300126,"NOV 01, 2023",SAC @ GSW,L,10,3,7,0.429,0,0,0.0,0,0,0.0,2,4,6,0,0,1,1,0,6,3,1,JaVale McGee,SAC,GSW,SAC,,,12,12,6,6
22023,201580,22300100,"OCT 29, 2023",SAC vs. LAL,W,15,2,2,1.0,0,0,0.0,0,0,0.0,0,0,0,0,1,1,1,1,4,4,1,JaVale McGee,SAC,SAC,LAL,,,4,4,4,0
22023,201580,22300087,"OCT 27, 2023",SAC vs. GSW,L,12,3,6,0.5,0,0,0.0,1,3,0.333,2,2,4,0,0,0,2,0,7,1,1,JaVale McGee,SAC,SAC,GSW,,,11,11,7,4
22023,201580,22300072,"OCT 25, 2023",SAC @ UTA,W,13,4,4,1.0,0,0,0.0,0,0,0.0,0,1,1,1,0,1,0,0,8,13,1,JaVale McGee,SAC,UTA,SAC,,,10,9,9,2
22023,1631121,22300551,"JAN 14, 2024",CHA @ MIA,L,5,1,2,0.5,0,1,0.0,0,0,0.0,1,1,2,0,0,0,0,0,2,1,1,Bryce McGowens,CHA,MIA,CHA,,,4,4,2,2
22023,1631121,22300541,"JAN 12, 2024",CHA @ SAS,L,24,5,7,0.714,1,2,0.5,1,1,1.0,0,0,0,0,1,0,4,1,12,-18,1,Bryce McGowens,CHA,SAS,CHA,,,12,12,12,0
22023,1631121,22300518,"JAN 10, 2024",CHA vs. SAC,L,10,1,2,0.5,1,2,0.5,1,2,0.5,0,2,2,1,0,0,1,0,4,-2,1,Bryce McGowens,CHA,CHA,SAC,,,7,6,5,3
22023,1631121,22300506,"JAN 08, 2024",CHA vs. CHI,L,24,1,7,0.143,1,5,0.2,0,0,0.0,0,1,1,2,0,0,0,1,3,-6,1,Bryce McGowens,CHA,CHA,CHI,,,6,4,5,3
22023,1631121,22300484,"JAN 05, 2024",CHA @ CHI,L,5,0,4,0.0,0,1,0.0,0,0,0.0,2,0,2,0,0,0,1,0,0,-2,1,Bryce McGowens,CHA,CHI,CHA,,,2,2,0,2
22023,1631121,22300464,"JAN 02, 2024",CHA @ SAC,W,21,1,3,0.333,0,2,0.0,2,3,0.667,1,1,2,2,0,0,0,1,4,1,1,Bryce McGowens,CHA,SAC,CHA,,,8,6,6,4
22023,1631121,22300455,"JAN 01, 2024",CHA @ DEN,L,23,4,8,0.5,2,3,0.667,0,0,0.0,0,2,2,3,0,0,0,4,10,-16,1,Bryce McGowens,CHA,DEN,CHA,,,15,12,13,5
22023,1631121,22300436,"DEC 29, 2023",CHA @ PHX,L,21,2,4,0.5,0,1,0.0,0,0,0.0,0,1,1,3,0,0,0,1,4,-2,1,Bryce McGowens,CHA,PHX,CHA,,,8,5,7,4
22023,1631121,22300428,"DEC 28, 2023",CHA @ LAL,L,22,3,6,0.5,3,4,0.75,1,2,0.5,0,2,2,1,0,0,1,3,10,1,1,Bryce McGowens,CHA,LAL,CHA,,,13,12,11,3
22023,1631121,22300414,"DEC 26, 2023",CHA @ LAC,L,22,4,6,0.667,0,1,0.0,2,3,0.667,0,3,3,2,0,0,0,3,10,-10,1,Bryce McGowens,CHA,LAC,CHA,,,15,13,12,5
22023,1631121,22300390,"DEC 23, 2023",CHA vs. DEN,L,18,0,4,0.0,0,0,0.0,0,0,0.0,2,1,3,0,0,0,0,1,0,-4,1,Bryce McGowens,CHA,CHA,DEN,,,3,3,0,3
22023,1631121,22300365,"DEC 20, 2023",CHA @ IND,L,21,1,2,0.5,0,1,0.0,0,0,0.0,0,0,0,1,0,0,2,5,2,1,1,Bryce McGowens,CHA,IND,CHA,,,3,2,3,1
22023,1631121,22300354,"DEC 18, 2023",CHA @ TOR,L,32,4,9,0.444,2,5,0.4,4,4,1.0,0,5,5,1,1,1,2,1,14,-3,1,Bryce McGowens,CHA,TOR,CHA,,,20,19,15,6
22023,1631121,22300335,"DEC 16, 2023",CHA vs. PHI,L,24,5,10,0.5,0,2,0.0,2,3,0.667,0,2,2,0,0,0,0,1,12,-17,1,Bryce McGowens,CHA,CHA,PHI,,,14,14,12,2
22023,1631121,22300326,"DEC 15, 2023",CHA vs. NOP,L,21,2,5,0.4,0,2,0.0,3,5,0.6,1,1,2,0,1,0,0,2,7,-14,1,Bryce McGowens,CHA,CHA,NOP,,,9,9,7,2
22023,1631121,22300312,"DEC 13, 2023",CHA @ MIA,L,18,2,4,0.5,1,2,0.5,2,2,1.0,1,2,3,1,0,0,0,2,7,-9,1,Bryce McGowens,CHA,MIA,CHA,,,11,10,8,4
22023,1631121,22300292,"DEC 11, 2023",CHA vs. MIA,L,23,1,4,0.25,0,2,0.0,1,2,0.5,0,1,1,1,0,0,1,2,3,9,1,Bryce McGowens,CHA,CHA,MIA,,,5,4,4,2
22023,1631121,22301216,"DEC 08, 2023",CHA vs. TOR,W,7,0,0,0.0,0,0,0.0,0,0,0.0,0,0,0,0,0,0,0,0,0,-2,1,Bryce McGowens,CHA,CHA,TOR,,,0,0,0,0
22023,1631121,22301211,"DEC 06, 2023",CHA @ CHI,L,16,2,2,1.0,1,1,1.0,0,0,0.0,0,1,1,1,0,0,1,3,5,-10,1,Bryce McGowens,CHA,CHI,CHA,,,7,6,6,2
22023,1631121,22300281,"DEC 02, 2023",CHA vs. MIN,L,16,1,3,0.333,0,0,0.0,0,0,0.0,0,1,1,1,0,0,0,1,2,5,1,Bryce McGowens,CHA,CHA,MIN,,,4,3,3,2
22023,1631121,22300266,"NOV 30, 2023",CHA @ BKN,W,22,5,7,0.714,4,5,0.8,0,0,0.0,0,2,2,3,0,1,0,1,14,-6,1,Bryce McGowens,CHA,BKN,CHA,,,19,16,17,5
22023,1631121,22300057,"NOV 28, 2023",CHA @ NYK,L,13,2,5,0.4,1,2,0.5,0,0,0.0,1,1,2,0,1,0,0,1,5,-12,1,Bryce McGowens,CHA,NYK,CHA,,,7,7,5,2
22023,1631121,22300248,"NOV 26, 2023",CHA @ ORL,L,6,0,0,0.0,0,0,0.0,0,0,0.0,1,1,2,1,1,0,1,2,0,1,1,Bryce McGowens,CHA,ORL,CHA,,,3,2,1,3
22023,1631121,22300225,"NOV 22, 2023",CHA vs. WAS,W,23,4,5,0.8,3,4,0.75,2,2,1.0,1,2,3,0,1,1,1,1,13,11,1,Bryce McGowens,CHA,CHA,WAS,,,16,16,13,3
22023,1631121,22300217,"NOV 20, 2023",CHA vs. BOS,W,14,1,6,0.167,1,6,0.167,0,0,0.0,0,2,2,2,0,0,1,1,3,-17,1,Bryce McGowens,CHA,CHA,BOS,,,7,5,5,4
22023,1631121,22300202,"NOV 18, 2023",CHA vs. NYK,L,16,0,2,0.0,0,1,0.0,0,0,0.0,1,1,2,1,0,0,0,2,0,4,1,Bryce McGowens,CHA,CHA,NYK,,,3,2,1,3
22023,1631121,22300027,"NOV 17, 2023",CHA vs. MIL,L,10,1,3,0.333,1,2,0.5,2,2,1.0,0,0,0,1,0,0,0,0,5,-8,1,Bryce McGowens,CHA,CHA,MIL,,,6,5,6,1
22023,1631121,22300017,"NOV 14, 2023",CHA vs. MIA,L,29,4,7,0.571,3,5,0.6,1,2,0.5,0,4,4,1,1,0,1,4,12,-3,1,Bryce McGowens,CHA,CHA,MIA,,,17,16,13,5
22023,1631121,22300177,"NOV 12, 2023",CHA @ NYK,L,19,1,4,0.25,0,2,0.0,0,0,0.0,0,0,0,0,0,0,0,0,2,-6,1,Bryce McGowens,CHA,NYK,CHA,,,2,2,2,0
22023,1631121,22300009,"NOV 10, 2023",CHA @ WAS,W,13,1,2,0.5,0,1,0.0,0,0,0.0,0,2,2,1,0,0,1,3,2,-8,1,Bryce McGowens,CHA,WAS,CHA,,,5,4,3,3
22023,1631121,22300157,"NOV 08, 2023",CHA vs. WAS,L,15,0,0,0.0,0,0,0.0,2,2,1.0,0,3,3,1,0,0,2,2,2,-1,1,Bryce McGowens,CHA,CHA,WAS,,,6,5,3,4
22023,1631121,22300143,"NOV 05, 2023",CHA @ DAL,L,10,0,1,0.0,0,1,0.0,1,2,0.5,0,2,2,0,2,0,0,0,1,1,1,Bryce McGowens,CHA,DAL,CHA,,,3,3,1,2
22023,1629162,22300538,"JAN 12, 2024",MIN vs. POR,W,13,1,3,0.333,0,2,0.0,0,0,0.0,0,0,0,5,1,0,2,2,2,-9,1,Jordan McLaughlin,MIN,MIN,POR,,,7,2,7,5
22023,1629162,22300517,"JAN 10, 2024",MIN @ BOS,L,17,2,5,0.4,2,3,0.667,0,0,0.0,0,2,2,0,0,0,0,1,6,-5,1,Jordan McLaughlin,MIN,BOS,MIN,,,8,8,6,2
22023,1629162,22300513,"JAN 09, 2024",MIN @ ORL,W,15,2,3,0.667,0,1,0.0,0,0,0.0,0,0,0,5,1,0,1,1,4,-8,1,Jordan McLaughlin,MIN,ORL,MIN,,,9,4,9,5
22023,1629162,22300501,"JAN 07, 2024",MIN @ DAL,L,13,2,7,0.286,2,7,0.286,0,0,0.0,0,1,1,1,2,1,0,0,6,-4,1,Jordan McLaughlin,MIN,DAL,MIN,,,8,7,7,2
22023,1629162,22300485,"JAN 05, 2024",MIN @ HOU,W,13,1,1,1.0,1,1,1.0,0,0,0.0,0,3,3,3,2,0,0,0,3,19,1,Jordan McLaughlin,MIN,HOU,MIN,,,9,6,6,6
22023,1629162,22300471,"JAN 03, 2024",MIN vs. NOP,L,17,1,6,0.167,0,4,0.0,1,2,0.5,2,1,3,4,1,0,0,0,3,5,1,Jordan McLaughlin,MIN,MIN,NOP,,,10,6,7,7
22023,1629162,22300451,"JAN 01, 2024",MIN @ NYK,L,12,4,5,0.8,1,2,0.5,0,0,0.0,0,1,1,3,2,0,0,1,9,13,1,Jordan McLaughlin,MIN,NYK,MIN,,,13,10,12,4
22023,1629162,22300411,"DEC 26, 2023",MIN @ OKC,L,14,1,5,0.2,0,1,0.0,0,0,0.0,2,2,4,2,3,0,1,0,2,-8,1,Jordan McLaughlin,MIN,OKC,MIN,,,8,6,4,6
22023,1629162,22300400,"DEC 23, 2023",MIN @ SAC,W,2,0,0,0.0,0,0,0.0,0,0,0.0,0,0,0,2,0,0,0,0,0,-1,1,Jordan McLaughlin,MIN,SAC,MIN,,,2,0,2,2
22023,1629162,22300367,"DEC 20, 2023",MIN @ PHI,L,2,0,0,0.0,0,0,0.0,0,0,0.0,0,0,0,1,0,0,0,0,0,0,1,Jordan McLaughlin,MIN,PHI,MIN,,,1,0,1,1
22023,1629162,22300338,"DEC 16, 2023",MIN vs. IND,W,3,0,0,0.0,0,0,0.0,0,0,0.0,0,0,0,0,0,1,0,0,0,-5,1,Jordan McLaughlin,MIN,MIN,IND,,,0,0,0,0
22023,1629162,22300321,"DEC 14, 2023",MIN @ DAL,W,2,0,0,0.0,0,0,0.0,0,0,0.0,0,0,0,1,0,0,0,0,0,-1,1,Jordan McLaughlin,MIN,DAL,MIN,,,1,0,1,1
22023,1629162,22300301,"DEC 11, 2023",MIN @ NOP,L,8,1,1,1.0,1,1,1.0,0,0,0.0,0,0,0,1,1,0,0,0,3,1,1,Jordan McLaughlin,MIN,NOP,MIN,,,4,3,4,1
22023,1629162,22300154,"NOV 06, 2023",MIN vs. BOS,W,4,0,0,0.0,0,0,0.0,2,2,1.0,0,0,0,0,0,1,0,0,2,3,1,Jordan McLaughlin,MIN,MIN,BOS,,,2,2,2,0
22023,1629162,22300138,"NOV 04, 2023",MIN vs. UTA,W,4,0,0,0.0,0,0,0.0,0,0,0.0,0,0,0,1,0,0,0,1,0,5,1,Jordan McLaughlin,MIN,MIN,UTA,,,1,0,1,1
22023,1629162,22300123,"NOV 01, 2023",MIN vs. DEN,W,4,0,1,0.0,0,1,0.0,0,0,0.0,0,0,0,0,0,0,0,0,0,2,1,Jordan McLaughlin,MIN,MIN,DEN,,,0,0,0,0
22023,1629162,22300104,"OCT 30, 2023",MIN @ ATL,L,1,0,0,0.0,0,0,0.0,0,0,0.0,0,0,0,0,0,1,0,0,0,4,1,Jordan McLaughlin,MIN,ATL,MIN,,,0,0,0,0
22023,1629162,22300093,"OCT 28, 2023",MIN vs. MIA,W,6,1,3,0.333,1,1,1.0,0,0,0.0,0,0,0,4,0,0,0,1,3,-4,1,Jordan McLaughlin,MIN,MIN,MIA,,,7,3,7,4
22023,1629001,22300532,"JAN 12, 2024",PHI vs. SAC,W,25,2,9,0.222,2,8,0.25,0,0,0.0,1,3,4,3,1,0,1,3,6,9,1,De'Anthony Melton,PHI,PHI,SAC,,,13,10,9,7
22023,1629001,22300521,"JAN 10, 2024",PHI @ ATL,L,21,3,7,0.429,2,4,0.5,2,2,1.0,1,2,3,2,0,0,1,0,10,1,1,De'Anthony Melton,PHI,ATL,PHI,,,15,13,12,5
22023,1629001,22300442,"DEC 30, 2023",PHI @ CHI,L,26,3,9,0.333,3,9,0.333,0,0,0.0,0,3,3,0,4,0,0,4,9,-17,1,De'Anthony Melton,PHI,CHI,PHI,,,12,12,9,3
22023,1629001,22300434,"DEC 29, 2023",PHI @ HOU,W,36,5,12,0.417,2,7,0.286,3,4,0.75,0,3,3,2,1,0,2,1,15,3,1,De'Anthony Melton,PHI,HOU,PHI,,,20,18,17,5
22023,1629001,22300415,"DEC 27, 2023",PHI @ ORL,W,37,8,13,0.615,4,7,0.571,2,2,1.0,1,4,5,1,2,0,1,3,22,24,1,De'Anthony Melton,PHI,ORL,PHI,,,28,27,23,6
22023,1629001,22300404,"DEC 25, 2023",PHI @ MIA,L,37,5,17,0.294,2,9,0.222,3,3,1.0,2,5,7,5,4,1,0,2,15,12,1,De'Anthony Melton,PHI,MIA,PHI,,,27,22,20,12
22023,1629001,22300367,"DEC 20, 2023",PHI vs. MIN,W,16,1,2,0.5,0,1,0.0,2,2,1.0,0,3,3,2,0,0,1,1,4,7,1,De'Anthony Melton,PHI,PHI,MIN,,,9,7,6,5
22023,1629001,22300351,"DEC 18, 2023",PHI vs. CHI,L,29,3,5,0.6,0,1,0.0,0,0,0.0,2,2,4,2,3,1,0,0,6,8,1,De'Anthony Melton,PHI,PHI,CHI,,,12,10,8,6
22023,1629001,22300335,"DEC 16, 2023",PHI @ CHA,W,25,2,6,0.333,2,6,0.333,0,0,0.0,0,2,2,2,4,0,1,2,6,20,1,De'Anthony Melton,PHI,CHA,PHI,,,10,8,8,4
22023,1629001,22300327,"DEC 15, 2023",PHI vs. DET,W,23,1,6,0.167,0,3,0.0,2,2,1.0,2,1,3,1,1,1,0,4,4,24,1,De'Anthony Melton,PHI,PHI,DET,,,8,7,5,4
22023,1629001,22300310,"DEC 13, 2023",PHI @ DET,W,21,4,9,0.444,2,4,0.5,0,0,0.0,1,5,6,1,1,2,0,4,10,18,1,De'Anthony Melton,PHI,DET,PHI,,,17,16,11,7
22023,1629001,22300295,"DEC 11, 2023",PHI vs. WAS,W,27,2,11,0.182,1,7,0.143,0,0,0.0,1,1,2,5,5,0,2,3,5,17,1,De'Anthony Melton,PHI,PHI,WAS,,,12,7,10,7
22023,1629001,22301218,"DEC 08, 2023",PHI vs. ATL,W,34,6,13,0.462,2,7,0.286,1,2,0.5,0,6,6,5,1,1,1,0,15,25,1,De'Anthony Melton,PHI,PHI,ATL,,,26,21,20,11
22023,1629001,22301208,"DEC 06, 2023",PHI @ WAS,W,27,5,10,0.5,2,5,0.4,7,7,1.0,0,5,5,4,2,1,1,1,19,12,1,De'Anthony Melton,PHI,WAS,PHI,,,28,24,23,9
22023,1629001,22300275,"DEC 01, 2023",PHI @ BOS,L,37,7,19,0.368,4,12,0.333,3,4,0.75,1,3,4,2,1,1,4,6,21,-3,1,De'Anthony Melton,PHI,BOS,PHI,,,27,25,23,6
22023,1629001,22300262,"NOV 29, 2023",PHI @ NOP,L,30,5,14,0.357,4,10,0.4,3,4,0.75,0,3,3,6,3,1,4,2,17,-17,1,De'Anthony Melton,PHI,NOP,PHI,,,26,20,23,9
22023,1629001,22300255,"NOV 27, 2023",PHI vs. LAL,W,25,3,6,0.5,3,6,0.5,0,0,0.0,0,0,0,2,1,0,0,2,9,11,1,De'Anthony Melton,PHI,PHI,LAL,,,11,9,11,2
22023,1629001,22300239,"NOV 25, 2023",PHI @ OKC,W,30,5,12,0.417,3,8,0.375,1,2,0.5,3,4,7,5,0,1,0,3,14,4,1,De'Anthony Melton,PHI,OKC,PHI,,,26,21,19,12
22023,1629001,22300232,"NOV 22, 2023",PHI @ MIN,L,30,3,11,0.273,1,5,0.2,9,9,1.0,1,5,6,3,0,1,1,2,16,-6,1,De'Anthony Melton,PHI,MIN,PHI,,,25,22,19,9
22023,1629001,22300040,"NOV 21, 2023",PHI vs. CLE,L,41,5,14,0.357,1,6,0.167,2,3,0.667,4,2,6,3,2,0,1,3,13,1,1,De'Anthony Melton,PHI,PHI,CLE,,,22,19,16,9
22023,1629001,22300208,"NOV 19, 2023",PHI @ BKN,W,27,8,10,0.8,4,6,0.667,1,1,1.0,0,5,5,1,3,0,1,3,21,23,1,De'Anthony Melton,PHI,BKN,PHI,,,27,26,22,6
22023,1629001,22300029,"NOV 17, 2023",PHI @ ATL,W,36,5,13,0.385,3,7,0.429,1,2,0.5,1,3,4,5,2,1,3,2,14,12,1,De'Anthony Melton,PHI,ATL,PHI,,,23,18,19,9
22023,1629001,22300194,"NOV 15, 2023",PHI vs. BOS,L,34,5,10,0.5,5,6,0.833,1,2,0.5,1,6,7,1,0,0,0,3,16,-9,1,De'Anthony Melton,PHI,PHI,BOS,,,24,23,17,8
22023,1629001,22300019,"NOV 14, 2023",PHI vs. IND,L,35,8,13,0.615,4,6,0.667,10,10,1.0,1,3,4,3,1,0,2,5,30,-9,1,De'Anthony Melton,PHI,PHI,IND,,,37,34,33,7
22023,1629001,22300180,"NOV 12, 2023",PHI vs. IND,W,30,4,7,0.571,1,3,0.333,1,1,1.0,1,3,4,6,0,0,2,1,10,-1,1,De'Anthony Melton,PHI,PHI,IND,,,20,14,16,10
22023,1629001,22300008,"NOV 10, 2023",PHI @ DET,W,30,3,9,0.333,2,6,0.333,2,4,0.5,0,3,3,2,3,1,0,3,10,15,1,De'Anthony Melton,PHI,DET,PHI,,,15,13,12,5
22023,1629001,22300159,"NOV 08, 2023",PHI vs. BOS,W,29,1,9,0.111,1,7,0.143,0,0,0.0,0,4,4,2,1,0,1,2,3,-3,1,De'Anthony Melton,PHI,PHI,BOS,,,9,7,5,6
22023,1629001,22300148,"NOV 06, 2023",PHI vs. WAS,W,26,5,10,0.5,4,5,0.8,0,0,0.0,0,3,3,4,1,0,1,1,14,1,1,De'Anthony Melton,PHI,PHI,WAS,,,21,17,18,7
22023,1629001,22300132,"NOV 04, 2023",PHI vs. PHX,W,25,3,10,0.3,2,7,0.286,0,2,0.0,2,0,2,4,1,1,2,3,8,0,1,De'Anthony Melton,PHI,PHI,PHX,,,14,10,12,6
22023,1629001,22300128,"NOV 02, 2023",PHI vs. TOR,W,21,1,6,0.167,1,3,0.333,1,2,0.5,0,5,5,5,1,0,1,4,4,10,1,De'Anthony Melton,PHI,PHI,TOR,,,14,9,9,10
22023,1629001,22300098,"OCT 29, 2023",PHI vs. POR,W,31,4,9,0.444,1,2,0.5,3,3,1.0,0,2,2,8,2,0,1,2,12,27,1,De'Anthony Melton,PHI,PHI,POR,,,22,14,20,10
22023,1629001,22300092,"OCT 28, 2023",PHI @ TOR,W,32,1,7,0.143,0,4,0.0,0,0,0.0,0,5,5,4,1,1,2,2,2,0,1,De'Anthony Melton,PHI,TOR,PHI,,,11,7,6,9
22023,1629001,22300075,"OCT 26, 2023",PHI @ MIL,L,25,3,10,0.3,2,6,0.333,2,2,1.0,1,1,2,4,2,0,1,2,10,-4,1,De'Anthony Melton,PHI,MIL,PHI,,,16,12,14,6
22023,1630241,22300561,"JAN 15, 2024",CLE vs. CHI,W,20,5,7,0.714,4,6,0.667,1,1,1.0,1,2,3,2,2,0,0,4,15,0,1,Sam Merrill,CLE,CLE,CHI,,,20,18,17,5
22023,1630241,22300527,"JAN 11, 2024",CLE vs. BKN,W,32,2,12,0.167,2,11,0.182,0,0,0.0,2,7,9,1,1,0,0,1,6,2,1,Sam Merrill,CLE,CLE,BKN,,,16,15,7,10
22023,1630241,22300497,"JAN 07, 2024",CLE vs. SAS,W,23,5,11,0.455,5,9,0.556,3,3,1.0,0,3,3,3,0,0,0,0,18,23,1,Sam Merrill,CLE,CLE,SAS,,,24,21,21,6
22023,1630241,22300482,"JAN 05, 2024",CLE vs. WAS,W,26,4,12,0.333,3,9,0.333,0,0,0.0,0,2,2,2,1,0,0,2,11,8,1,Sam Merrill,CLE,CLE,WAS,,,15,13,13,4
22023,1630241,22300465,"JAN 03, 2024",CLE vs. WAS,W,29,4,11,0.364,3,9,0.333,0,0,0.0,1,4,5,6,0,0,0,2,11,27,1,Sam Merrill,CLE,CLE,WAS,,,22,16,17,11
22023,1630241,22300452,"JAN 01, 2024",CLE @ TOR,L,17,6,11,0.545,4,8,0.5,0,0,0.0,0,3,3,1,0,0,1,2,16,-2,1,Sam Merrill,CLE,TOR,CLE,,,20,19,17,4
22023,1630241,22300433,"DEC 29, 2023",CLE vs. MIL,L,15,1,4,0.25,1,4,0.25,0,0,0.0,0,0,0,1,0,0,0,1,3,-1,1,Sam Merrill,CLE,CLE,MIL,,,4,3,4,1
22023,1630241,22300375,"DEC 21, 2023",CLE vs. NOP,L,12,0,4,0.0,0,3,0.0,0,0,0.0,0,0,0,1,0,0,1,0,0,1,1,Sam Merrill,CLE,CLE,NOP,,,1,0,1,1
22023,1630241,22300364,"DEC 20, 2023",CLE vs. UTA,W,30,9,16,0.563,8,14,0.571,1,2,0.5,0,3,3,2,1,0,2,4,27,17,1,Sam Merrill,CLE,CLE,UTA,,,32,30,29,5
22023,1630241,22300349,"DEC 18, 2023",CLE vs. HOU,W,24,6,11,0.545,5,10,0.5,2,2,1.0,1,3,4,3,1,1,0,1,19,13,1,Sam Merrill,CLE,CLE,HOU,,,26,23,22,7
22023,1630241,22300336,"DEC 16, 2023",CLE vs. ATL,W,8,3,6,0.5,3,6,0.5,0,0,0.0,0,1,1,1,0,0,0,1,9,4,1,Sam Merrill,CLE,CLE,ATL,,,11,10,10,2
22023,1630241,22300294,"DEC 11, 2023",CLE @ ORL,L,17,2,6,0.333,2,4,0.5,0,0,0.0,1,2,3,1,0,0,1,2,6,-4,1,Sam Merrill,CLE,ORL,CLE,,,10,9,7,4
22023,1630241,22301220,"DEC 08, 2023",CLE @ MIA,W,10,3,5,0.6,3,5,0.6,0,0,0.0,1,2,3,1,0,0,0,2,9,-8,1,Sam Merrill,CLE,MIA,CLE,,,13,12,10,4
22023,1630241,22300283,"DEC 02, 2023",CLE @ DET,W,3,0,1,0.0,0,1,0.0,0,0,0.0,0,0,0,1,0,0,0,1,0,0,1,Sam Merrill,CLE,DET,CLE,,,1,0,1,1
22023,1630241,22300229,"NOV 22, 2023",CLE vs. MIA,L,17,3,6,0.5,3,5,0.6,0,0,0.0,0,1,1,1,0,0,1,3,9,-10,1,Sam Merrill,CLE,CLE,MIA,,,11,10,10,2
22023,1630241,22300040,"NOV 21, 2023",CLE @ PHI,W,6,0,1,0.0,0,1,0.0,0,0,0.0,0,0,0,0,0,0,0,0,0,0,1,Sam Merrill,CLE,PHI,CLE,,,0,0,0,0
22023,1630241,22300210,"NOV 19, 2023",CLE vs. DEN,W,24,3,10,0.3,3,9,0.333,0,0,0.0,1,1,2,1,0,0,0,2,9,-15,1,Sam Merrill,CLE,CLE,DEN,,,12,11,10,3
22023,1630241,22300030,"NOV 17, 2023",CLE vs. DET,W,1,0,0,0.0,0,0,0.0,0,0,0.0,0,0,0,0,0,0,0,0,0,-2,1,Sam Merrill,CLE,CLE,DET,,,0,0,0,0
22023,1630241,22300199,"NOV 15, 2023",CLE @ POR,W,2,0,0,0.0,0,0,0.0,0,0,0.0,0,0,0,0,0,0,0,0,0,0,1,Sam Merrill,CLE,POR,CLE,,,0,0,0,0
22023,1630241,22300191,"NOV 13, 2023",CLE @ SAC,L,3,0,1,0.0,0,1,0.0,0,0,0.0,0,0,0,0,0,0,0,0,0,1,1,Sam Merrill,CLE,SAC,CLE,,,0,0,0,0
22023,1630241,22300142,"NOV 05, 2023",CLE vs. GSW,W,1,0,0,0.0,0,0,0.0,0,0,0.0,0,0,0,0,0,0,0,0,0,-2,1,Sam Merrill,CLE,CLE,GSW,,,0,0,0,0
22023,1630241,22300112,"OCT 31, 2023",CLE vs. NYK,L,14,2,4,0.5,2,4,0.5,0,0,0.0,0,1,1,2,1,0,1,0,6,-2,1,Sam Merrill,CLE,CLE,NYK,,,9,7,8,3
22023,1630241,22300091,"OCT 28, 2023",CLE vs. IND,L,6,0,2,0.0,0,1,0.0,0,0,0.0,1,1,2,1,1,0,0,0,0,2,1,Sam Merrill,CLE,CLE,IND,,,3,2,1,3
22023,1629002,22300554,"JAN 14, 2024",PHX @ POR,W,17,3,3,1.0,1,1,1.0,1,2,0.5,0,3,3,0,1,2,0,3,8,1,1,Chimezie Metu,PHX,POR,PHX,,,11,11,8,3
22023,1629002,22300531,"JAN 11, 2024",PHX @ LAL,W,9,0,0,0.0,0,0,0.0,4,4,1.0,1,1,2,1,0,0,0,0,4,-6,1,Chimezie Metu,PHX,LAL,PHX,,,7,6,5,3
22023,1629002,22300511,"JAN 08, 2024",PHX @ LAC,L,8,1,1,1.0,0,0,0.0,2,2,1.0,0,2,2,0,0,1,0,1,4,-7,1,Chimezie Metu,PHX,LAC,PHX,,,6,6,4,2
22023,1629002,22300503,"JAN 07, 2024",PHX vs. MEM,L,12,2,7,0.286,0,5,0.0,0,0,0.0,0,1,1,0,1,0,1,3,4,-8,1,Chimezie Metu,PHX,PHX,MEM,,,5,5,4,1
22023,1629002,22300489,"JAN 05, 2024",PHX vs. MIA,W,17,3,3,1.0,0,0,0.0,1,1,1.0,0,2,2,0,2,0,2,0,7,18,1,Chimezie Metu,PHX,PHX,MIA,,,9,9,7,2
22023,1629002,22300473,"JAN 03, 2024",PHX vs. LAC,L,15,3,6,0.5,1,4,0.25,0,0,0.0,1,2,3,2,2,0,1,0,7,-10,1,Chimezie Metu,PHX,PHX,LAC,,,12,10,9,5
22023,1629002,22300456,"JAN 01, 2024",PHX vs. POR,W,26,4,8,0.5,2,4,0.5,4,4,1.0,2,3,5,1,1,0,2,3,14,6,1,Chimezie Metu,PHX,PHX,POR,,,20,19,15,6
22023,1629002,22300450,"DEC 31, 2023",PHX vs. ORL,W,17,3,7,0.429,0,2,0.0,0,0,0.0,2,4,6,0,0,0,1,2,6,-4,1,Chimezie Metu,PHX,PHX,ORL,,,12,12,6,6
22023,1629002,22300436,"DEC 29, 2023",PHX vs. CHA,W,19,2,3,0.667,1,1,1.0,4,4,1.0,1,6,7,1,1,0,0,0,9,5,1,Chimezie Metu,PHX,PHX,CHA,,,17,16,10,8
22023,1629002,22300418,"DEC 27, 2023",PHX @ HOU,W,16,1,1,1.0,0,0,0.0,2,2,1.0,1,1,2,0,0,0,3,0,4,1,1,Chimezie Metu,PHX,HOU,PHX,,,6,6,4,2
22023,1629002,22300405,"DEC 25, 2023",PHX vs. DAL,L,34,9,18,0.5,2,6,0.333,3,4,0.75,6,13,19,2,1,0,3,1,23,-3,1,Chimezie Metu,PHX,PHX,DAL,,,44,42,25,21
22023,1629002,22300387,"DEC 22, 2023",PHX @ SAC,L,13,3,6,0.5,0,2,0.0,4,4,1.0,1,3,4,0,0,0,1,1,10,5,1,Chimezie Metu,PHX,SAC,PHX,,,14,14,10,4
22023,1629002,22300363,"DEC 19, 2023",PHX @ POR,L,15,1,2,0.5,0,1,0.0,0,0,0.0,0,1,1,1,1,0,1,0,2,-6,1,Chimezie Metu,PHX,POR,PHX,,,4,3,3,2
22023,1629002,22300347,"DEC 17, 2023",PHX vs. WAS,W,9,1,1,1.0,0,0,0.0,2,2,1.0,0,2,2,0,1,0,1,0,4,0,1,Chimezie Metu,PHX,PHX,WAS,,,6,6,4,2
22023,1629002,22300333,"DEC 15, 2023",PHX vs. NYK,L,10,1,3,0.333,0,2,0.0,1,2,0.5,0,1,1,1,0,0,1,0,3,-12,1,Chimezie Metu,PHX,PHX,NYK,,,5,4,4,2
22023,1629002,22300317,"DEC 13, 2023",PHX vs. BKN,L,20,3,8,0.375,2,3,0.667,0,0,0.0,3,1,4,0,2,0,1,2,8,-4,1,Chimezie Metu,PHX,PHX,BKN,,,12,12,8,4
22023,1629002,22300308,"DEC 12, 2023",PHX vs. GSW,W,25,5,7,0.714,3,5,0.6,1,2,0.5,1,4,5,0,1,0,1,2,14,28,1,Chimezie Metu,PHX,PHX,GSW,,,19,19,14,5
22023,1629002,22301228,"DEC 08, 2023",PHX vs. SAC,L,23,4,9,0.444,0,4,0.0,2,2,1.0,0,4,4,1,2,2,0,1,10,-1,1,Chimezie Metu,PHX,PHX,SAC,,,15,14,11,5
22023,1629002,22300279,"DEC 01, 2023",PHX vs. DEN,L,4,0,2,0.0,0,1,0.0,0,0,0.0,0,1,1,1,0,0,0,0,0,-1,1,Chimezie Metu,PHX,PHX,DEN,,,2,1,1,2
22023,1629002,22300260,"NOV 29, 2023",PHX @ TOR,L,15,2,3,0.667,1,1,1.0,0,0,0.0,0,2,2,0,0,0,1,3,5,-4,1,Chimezie Metu,PHX,TOR,PHX,,,7,7,5,2
22023,1629002,22300247,"NOV 26, 2023",PHX @ NYK,W,13,3,3,1.0,2,2,1.0,0,0,0.0,2,2,4,0,0,0,0,3,8,3,1,Chimezie Metu,PHX,NYK,PHX,,,12,12,8,4
22023,1629002,22300044,"NOV 24, 2023",PHX @ MEM,W,15,1,3,0.333,0,1,0.0,1,2,0.5,0,2,2,1,0,0,0,2,3,7,1,Chimezie Metu,PHX,MEM,PHX,,,6,5,4,3
22023,1629002,22300236,"NOV 22, 2023",PHX vs. GSW,W,12,2,3,0.667,0,1,0.0,0,0,0.0,0,2,2,0,0,2,0,2,4,-10,1,Chimezie Metu,PHX,PHX,GSW,,,6,6,4,2
22023,1629002,22300041,"NOV 21, 2023",PHX vs. POR,W,6,0,0,0.0,0,0,0.0,0,0,0.0,0,0,0,1,1,0,0,1,0,-1,1,Chimezie Metu,PHX,PHX,POR,,,1,0,1,1
22023,1629002,22300197,"NOV 15, 2023",PHX vs. MIN,W,4,2,4,0.5,0,1,0.0,0,0,0.0,0,2,2,0,0,0,1,2,4,-3,1,Chimezie Metu,PHX,PHX,MIN,,,6,6,4,2
22023,1629002,22300185,"NOV 12, 2023",PHX vs. OKC,L,1,0,1,0.0,0,1,0.0,0,0,0.0,0,0,0,0,0,0,0,0,0,0,1,Chimezie Metu,PHX,PHX,OKC,,,0,0,0,0
22023,1629002,22300140,"NOV 05, 2023",PHX @ DET,W,2,0,0,0.0,0,0,0.0,0,0,0.0,0,0,0,0,0,0,0,0,0,-5,1,Chimezie Metu,PHX,DET,PHX,,,0,0,0,0
22023,1629002,22300132,"NOV 04, 2023",PHX @ PHI,L,5,0,1,0.0,0,1,0.0,2,2,1.0,0,1,1,0,0,1,1,0,2,4,1,Chimezie Metu,PHX,PHI,PHX,,,3,3,2,1
22023,1629002,22300094,"OCT 28, 2023",PHX vs. UTA,W,3,1,2,0.5,0,0,0.0,0,0,0.0,0,1,1,1,0,0,0,0,2,-4,1,Chimezie Metu,PHX,PHX,UTA,,,4,3,3,2
22023,203995,22300565,"JAN 15, 2024",OKC @ LAL,L,15,2,4,0.5,2,2,1.0,0,0,0.0,0,1,1,1,0,0,0,2,6,4,1,Vasilije Micic,OKC,LAL,OKC,,,8,7,7,2
22023,203995,22300546,"JAN 13, 2024",OKC vs. ORL,W,11,3,5,0.6,1,2,0.5,0,0,0.0,0,2,2,1,1,0,1,1,7,0,1,Vasilije Micic,OKC,OKC,ORL,,,10,9,8,3
22023,203995,22300529,"JAN 11, 2024",OKC vs. POR,W,9,0,0,0.0,0,0,0.0,2,2,1.0,0,1,1,2,0,0,0,0,2,8,1,Vasilije Micic,OKC,OKC,POR,,,5,3,4,3
22023,203995,22300522,"JAN 10, 2024",OKC @ MIA,W,15,2,2,1.0,0,0,0.0,0,0,0.0,0,1,1,5,1,0,0,1,4,16,1,Vasilije Micic,OKC,MIA,OKC,,,10,5,9,6
22023,203995,22300481,"JAN 05, 2024",OKC @ BKN,L,12,3,4,0.75,0,1,0.0,0,0,0.0,0,0,0,3,1,1,0,0,6,1,1,Vasilije Micic,OKC,BKN,OKC,,,9,6,9,3
22023,203995,22300462,"JAN 02, 2024",OKC vs. BOS,W,11,1,5,0.2,1,4,0.25,0,0,0.0,0,1,1,5,0,0,0,2,3,4,1,Vasilije Micic,OKC,OKC,BOS,,,9,4,8,6
22023,203995,22300447,"DEC 31, 2023",OKC vs. BKN,W,12,1,1,1.0,0,0,0.0,0,0,0.0,1,2,3,4,1,0,0,4,2,6,1,Vasilije Micic,OKC,OKC,BKN,,,9,5,6,7
22023,203995,22300435,"DEC 29, 2023",OKC @ DEN,W,14,1,4,0.25,0,3,0.0,0,0,0.0,0,1,1,2,0,1,0,2,2,4,1,Vasilije Micic,OKC,DEN,OKC,,,5,3,4,3
22023,203995,22300411,"DEC 26, 2023",OKC vs. MIN,W,16,1,7,0.143,0,4,0.0,0,0,0.0,0,0,0,4,2,0,1,3,2,7,1,Vasilije Micic,OKC,OKC,MIN,,,6,2,6,4
22023,203995,22300355,"DEC 18, 2023",OKC vs. MEM,W,7,0,1,0.0,0,1,0.0,0,0,0.0,0,0,0,0,0,1,1,0,0,-10,1,Vasilije Micic,OKC,OKC,MEM,,,0,0,0,0
22023,203995,22300302,"DEC 11, 2023",OKC vs. UTA,W,16,1,5,0.2,0,3,0.0,0,0,0.0,0,1,1,5,1,0,0,0,2,8,1,Vasilije Micic,OKC,OKC,UTA,,,8,3,7,6
22023,203995,22300234,"NOV 22, 2023",OKC vs. CHI,W,11,1,4,0.25,0,3,0.0,0,0,0.0,0,0,0,2,0,0,2,0,2,-2,1,Vasilije Micic,OKC,OKC,CHI,,,4,2,4,2
22023,203995,22300215,"NOV 19, 2023",OKC @ POR,W,6,0,1,0.0,0,0,0.0,0,0,0.0,0,0,0,1,0,0,2,0,0,3,1,Vasilije Micic,OKC,POR,OKC,,,1,0,1,1
22023,203995,22300207,"NOV 18, 2023",OKC @ GSW,W,8,1,1,1.0,0,0,0.0,0,0,0.0,0,0,0,1,0,0,0,0,2,-1,1,Vasilije Micic,OKC,GSW,OKC,,,3,2,3,1
22023,203995,22300201,"NOV 16, 2023",OKC @ GSW,W,21,1,5,0.2,1,3,0.333,2,2,1.0,0,2,2,7,0,0,0,3,5,18,1,Vasilije Micic,OKC,GSW,OKC,,,14,7,12,9
22023,203995,22300021,"NOV 14, 2023",OKC vs. SAS,W,19,2,4,0.5,2,3,0.667,2,4,0.5,0,1,1,4,1,0,2,1,8,16,1,Vasilije Micic,OKC,OKC,SAS,,,13,9,12,5
22023,203995,22300005,"NOV 03, 2023",OKC vs. GSW,L,12,2,5,0.4,1,2,0.5,0,0,0.0,0,1,1,3,0,0,0,1,5,-2,1,Vasilije Micic,OKC,OKC,GSW,,,9,6,8,4
22023,203995,22300095,"OCT 29, 2023",OKC vs. DEN,L,14,1,3,0.333,0,2,0.0,0,0,0.0,0,0,0,3,0,0,2,1,2,-9,1,Vasilije Micic,OKC,OKC,DEN,,,5,2,5,3
22023,203995,22300081,"OCT 27, 2023",OKC @ CLE,W,6,1,1,1.0,1,1,1.0,0,0,0.0,0,0,0,1,0,0,2,0,3,2,1,Vasilije Micic,OKC,CLE,OKC,,,4,3,4,1
22023,203114,22300545,"JAN 13, 2024",MIL vs. GSW,W,33,10,13,0.769,3,5,0.6,1,2,0.5,1,2,3,10,1,1,3,2,24,-2,1,Khris Middleton,MIL,MIL,GSW,,,37,27,34,13
22023,203114,22300528,"JAN 11, 2024",MIL vs. BOS,W,20,2,9,0.222,1,5,0.2,0,0,0.0,0,2,2,7,1,0,0,2,5,25,1,Khris Middleton,MIL,MIL,BOS,,,14,7,12,9
22023,203114,22300510,"JAN 08, 2024",MIL vs. UTA,L,34,7,16,0.438,3,6,0.5,6,6,1.0,0,3,3,8,2,1,3,1,23,-8,1,Khris Middleton,MIL,MIL,UTA,,,34,26,31,11
22023,203114,22300496,"JAN 06, 2024",MIL @ HOU,L,33,3,9,0.333,0,5,0.0,4,6,0.667,0,3,3,5,1,0,3,5,10,7,1,Khris Middleton,MIL,HOU,MIL,,,18,13,15,8
22023,203114,22300477,"JAN 04, 2024",MIL @ SAS,W,15,5,8,0.625,2,3,0.667,0,0,0.0,0,3,3,5,1,0,1,0,12,7,1,Khris Middleton,MIL,SAS,MIL,,,20,15,17,8
22023,203114,22300466,"JAN 03, 2024",MIL @ IND,L,32,7,13,0.538,4,7,0.571,1,1,1.0,1,5,6,7,0,2,4,2,19,-15,1,Khris Middleton,MIL,IND,MIL,,,32,25,26,13
22023,203114,22300454,"JAN 01, 2024",MIL vs. IND,L,32,9,13,0.692,2,5,0.4,1,2,0.5,1,2,3,6,1,0,4,5,21,5,1,Khris Middleton,MIL,MIL,IND,,,30,24,27,9
22023,203114,22300433,"DEC 29, 2023",MIL @ CLE,W,33,4,10,0.4,1,3,0.333,4,4,1.0,0,3,3,11,3,0,4,1,13,7,1,Khris Middleton,MIL,CLE,MIL,,,27,16,24,14
22023,203114,22300417,"DEC 27, 2023",MIL @ BKN,W,32,11,18,0.611,3,7,0.429,2,2,1.0,1,2,3,10,0,2,3,2,27,5,1,Khris Middleton,MIL,BKN,MIL,,,40,30,37,13
22023,203114,22300401,"DEC 25, 2023",MIL @ NYK,L,33,10,20,0.5,4,9,0.444,0,0,0.0,0,2,2,6,1,0,2,4,24,9,1,Khris Middleton,MIL,NYK,MIL,,,32,26,30,8
22023,203114,22300388,"DEC 23, 2023",MIL @ NYK,W,33,9,16,0.563,2,4,0.5,0,0,0.0,1,4,5,5,0,0,3,4,20,17,1,Khris Middleton,MIL,NYK,MIL,,,30,25,25,10
22023,203114,22300378,"DEC 21, 2023",MIL vs. ORL,W,29,5,11,0.455,2,7,0.286,2,2,1.0,0,4,4,3,0,1,1,2,14,11,1,Khris Middleton,MIL,MIL,ORL,,,21,18,17,7
22023,203114,22300361,"DEC 19, 2023",MIL vs. SAS,W,28,7,15,0.467,3,6,0.5,0,0,0.0,0,3,3,4,1,0,1,2,17,12,1,Khris Middleton,MIL,MIL,SAS,,,24,20,21,7
22023,203114,22300346,"DEC 17, 2023",MIL vs. HOU,W,29,7,15,0.467,1,5,0.2,5,5,1.0,0,3,3,2,0,0,4,3,20,7,1,Khris Middleton,MIL,MIL,HOU,,,25,23,22,5
22023,203114,22300315,"DEC 13, 2023",MIL vs. IND,W,29,6,11,0.545,1,3,0.333,1,1,1.0,1,8,9,7,1,0,1,3,14,14,1,Khris Middleton,MIL,MIL,IND,,,30,23,21,16
22023,203114,22300300,"DEC 11, 2023",MIL vs. CHI,W,33,5,11,0.455,0,3,0.0,3,4,0.75,1,12,13,6,1,0,4,4,13,0,1,Khris Middleton,MIL,MIL,CHI,,,32,26,19,19
22023,203114,22301229,"DEC 07, 2023",MIL vs. IND,L,30,7,13,0.538,4,5,0.8,2,2,1.0,1,6,7,4,2,0,4,2,20,-3,1,Khris Middleton,MIL,MIL,IND,,,31,27,24,11
22023,203114,22301201,"DEC 05, 2023",MIL vs. NYK,W,26,6,12,0.5,2,3,0.667,0,0,0.0,2,2,4,7,1,0,2,1,14,11,1,Khris Middleton,MIL,MIL,NYK,,,25,18,21,11
22023,203114,22300286,"DEC 02, 2023",MIL vs. ATL,W,25,5,9,0.556,2,4,0.5,0,0,0.0,0,5,5,3,1,0,1,0,12,-8,1,Khris Middleton,MIL,MIL,ATL,,,20,17,15,8
22023,203114,22300269,"NOV 30, 2023",MIL @ CHI,L,27,3,10,0.3,1,4,0.25,2,5,0.4,0,3,3,3,2,0,3,3,9,-8,1,Khris Middleton,MIL,CHI,MIL,,,15,12,12,6
22023,203114,22300056,"NOV 28, 2023",MIL @ MIA,W,23,7,13,0.538,1,3,0.333,2,2,1.0,1,7,8,2,0,0,0,3,17,20,1,Khris Middleton,MIL,MIA,MIL,,,27,25,19,10
22023,203114,22300049,"NOV 24, 2023",MIL vs. WAS,W,13,3,8,0.375,1,3,0.333,0,0,0.0,0,1,1,5,0,0,1,1,7,5,1,Khris Middleton,MIL,MIL,WAS,,,13,8,12,6
22023,203114,22300228,"NOV 22, 2023",MIL @ BOS,L,29,4,14,0.286,2,5,0.4,2,2,1.0,2,3,5,7,1,0,0,4,12,-6,1,Khris Middleton,MIL,BOS,MIL,,,24,17,19,12
22023,203114,22300219,"NOV 20, 2023",MIL @ WAS,W,23,6,12,0.5,0,2,0.0,6,7,0.857,1,5,6,7,0,0,4,3,18,23,1,Khris Middleton,MIL,WAS,MIL,,,31,24,25,13
22023,203114,22300027,"NOV 17, 2023",MIL @ CHA,W,22,4,11,0.364,2,7,0.286,2,2,1.0,1,5,6,1,1,0,1,3,12,16,1,Khris Middleton,MIL,CHA,MIL,,,19,18,13,7
22023,203114,22300195,"NOV 15, 2023",MIL @ TOR,W,20,5,9,0.556,1,2,0.5,0,0,0.0,1,4,5,4,2,0,4,3,11,12,1,Khris Middleton,MIL,TOR,MIL,,,20,16,15,9
22023,203114,22300190,"NOV 13, 2023",MIL vs. CHI,W,19,6,10,0.6,1,5,0.2,0,0,0.0,1,5,6,2,1,0,2,2,13,0,1,Khris Middleton,MIL,MIL,CHI,,,21,19,15,8
22023,203114,22300173,"NOV 11, 2023",MIL @ ORL,L,20,4,8,0.5,2,4,0.5,0,0,0.0,0,0,0,7,0,1,1,1,10,-3,1,Khris Middleton,MIL,ORL,MIL,,,17,10,17,7
22023,203114,22300171,"NOV 09, 2023",MIL @ IND,L,20,7,13,0.538,2,6,0.333,3,4,0.75,1,1,2,4,0,0,2,1,19,-5,1,Khris Middleton,MIL,IND,MIL,,,25,21,23,6
22023,203114,22300149,"NOV 06, 2023",MIL @ BKN,W,21,6,10,0.6,1,4,0.25,2,2,1.0,0,3,3,4,0,0,0,1,15,9,1,Khris Middleton,MIL,BKN,MIL,,,22,18,19,7
22023,203114,22300002,"NOV 03, 2023",MIL vs. NYK,W,21,5,10,0.5,2,3,0.667,0,0,0.0,3,6,9,4,0,0,0,1,12,-2,1,Khris Middleton,MIL,MIL,NYK,,,25,21,16,13
22023,203114,22300116,"NOV 01, 2023",MIL @ TOR,L,17,4,10,0.4,1,4,0.25,2,2,1.0,0,3,3,0,1,0,4,2,11,-13,1,Khris Middleton,MIL,TOR,MIL,,,14,14,11,3
22023,203114,22300107,"OCT 30, 2023",MIL vs. MIA,W,17,1,4,0.25,0,2,0.0,3,4,0.75,0,2,2,5,1,0,1,2,5,14,1,Khris Middleton,MIL,MIL,MIA,,,12,7,10,7
22023,203114,22300075,"OCT 26, 2023",MIL vs. PHI,W,16,2,5,0.4,1,3,0.333,1,2,0.5,0,3,3,4,2,0,2,0,6,14,1,Khris Middleton,MIL,MIL,PHI,,,13,9,10,7
22023,1641706,22300541,"JAN 12, 2024",CHA @ SAS,L,9,0,5,0.0,0,1,0.0,1,2,0.5,2,0,2,1,1,0,1,1,1,-5,1,Brandon Miller,CHA,SAS,CHA,,,4,3,2,3
22023,1641706,22300518,"JAN 10, 2024",CHA vs. SAC,L,28,5,10,0.5,4,6,0.667,1,2,0.5,0,1,1,2,0,0,0,1,15,4,1,Brandon Miller,CHA,CHA,SAC,,,18,16,17,3
22023,1641706,22300506,"JAN 08, 2024",CHA vs. CHI,L,31,2,11,0.182,0,7,0.0,0,0,0.0,0,6,6,4,1,0,3,4,4,-6,1,Brandon Miller,CHA,CHA,CHI,,,14,10,8,10
22023,1641706,22300484,"JAN 05, 2024",CHA @ CHI,L,23,3,13,0.231,1,7,0.143,2,2,1.0,0,3,3,1,1,0,0,3,9,3,1,Brandon Miller,CHA,CHI,CHA,,,13,12,10,4
22023,1641706,22300455,"JAN 01, 2024",CHA @ DEN,L,32,5,17,0.294,3,9,0.333,2,2,1.0,0,5,5,1,0,0,2,1,15,-31,1,Brandon Miller,CHA,DEN,CHA,,,21,20,16,6
22023,1641706,22300436,"DEC 29, 2023",CHA @ PHX,L,31,7,16,0.438,6,10,0.6,0,0,0.0,1,0,1,3,1,1,0,4,20,-15,1,Brandon Miller,CHA,PHX,CHA,,,24,21,23,4
22023,1641706,22300428,"DEC 28, 2023",CHA @ LAL,L,29,5,9,0.556,3,5,0.6,4,4,1.0,1,0,1,2,1,1,3,0,17,-4,1,Brandon Miller,CHA,LAL,CHA,,,20,18,19,3
22023,1641706,22300390,"DEC 23, 2023",CHA vs. DEN,L,11,2,5,0.4,0,2,0.0,0,0,0.0,0,1,1,2,0,0,3,1,4,-4,1,Brandon Miller,CHA,CHA,DEN,,,7,5,6,3
22023,1641706,22300365,"DEC 20, 2023",CHA @ IND,L,33,9,17,0.529,2,4,0.5,1,2,0.5,2,4,6,3,1,0,1,4,21,-30,1,Brandon Miller,CHA,IND,CHA,,,30,27,24,9
22023,1641706,22300354,"DEC 18, 2023",CHA @ TOR,L,37,6,16,0.375,0,5,0.0,2,2,1.0,0,3,3,0,0,1,3,3,14,-6,1,Brandon Miller,CHA,TOR,CHA,,,17,17,14,3
22023,1641706,22300335,"DEC 16, 2023",CHA vs. PHI,L,29,4,16,0.25,2,7,0.286,4,4,1.0,0,4,4,4,0,1,3,0,14,-28,1,Brandon Miller,CHA,CHA,PHI,,,22,18,18,8
22023,1641706,22300326,"DEC 15, 2023",CHA vs. NOP,L,35,7,16,0.438,2,5,0.4,0,2,0.0,0,4,4,3,1,0,0,3,16,-1,1,Brandon Miller,CHA,CHA,NOP,,,23,20,19,7
22023,1641706,22300312,"DEC 13, 2023",CHA @ MIA,L,39,7,16,0.438,4,10,0.4,0,0,0.0,0,2,2,3,3,0,5,3,18,-4,1,Brandon Miller,CHA,MIA,CHA,,,23,20,21,5
22023,1641706,22300292,"DEC 11, 2023",CHA vs. MIA,L,30,6,14,0.429,3,8,0.375,1,1,1.0,0,4,4,2,0,0,2,5,16,3,1,Brandon Miller,CHA,CHA,MIA,,,22,20,18,6
22023,1641706,22301216,"DEC 08, 2023",CHA vs. TOR,W,35,7,15,0.467,4,7,0.571,2,2,1.0,0,5,5,3,0,2,4,1,20,2,1,Brandon Miller,CHA,CHA,TOR,,,28,25,23,8
22023,1641706,22301211,"DEC 06, 2023",CHA @ CHI,L,39,4,14,0.286,3,6,0.5,1,1,1.0,0,6,6,4,1,1,2,3,12,-8,1,Brandon Miller,CHA,CHI,CHA,,,22,18,16,10
22023,1641706,22300281,"DEC 02, 2023",CHA vs. MIN,L,36,5,13,0.385,2,4,0.5,2,2,1.0,1,4,5,3,0,2,2,3,14,-8,1,Brandon Miller,CHA,CHA,MIN,,,22,19,17,8
22023,1641706,22300057,"NOV 28, 2023",CHA @ NYK,L,36,7,18,0.389,4,8,0.5,0,0,0.0,0,3,3,2,1,0,3,2,18,-24,1,Brandon Miller,CHA,NYK,CHA,,,23,21,20,5
22023,1641706,22300248,"NOV 26, 2023",CHA @ ORL,L,33,7,11,0.636,2,3,0.667,4,5,0.8,0,5,5,1,1,0,2,5,20,-1,1,Brandon Miller,CHA,ORL,CHA,,,26,25,21,6
22023,1641706,22300225,"NOV 22, 2023",CHA vs. WAS,W,31,6,12,0.5,3,6,0.5,0,0,0.0,0,0,0,3,1,0,0,2,15,-2,1,Brandon Miller,CHA,CHA,WAS,,,18,15,18,3
22023,1641706,22300217,"NOV 20, 2023",CHA vs. BOS,W,40,4,12,0.333,1,4,0.25,0,0,0.0,4,3,7,4,2,1,2,2,9,22,1,Brandon Miller,CHA,CHA,BOS,,,20,16,13,11
22023,1641706,22300202,"NOV 18, 2023",CHA vs. NYK,L,34,10,15,0.667,5,7,0.714,4,4,1.0,0,3,3,2,0,0,2,3,29,-7,1,Brandon Miller,CHA,CHA,NYK,,,34,32,31,5
22023,1641706,22300027,"NOV 17, 2023",CHA vs. MIL,L,27,5,12,0.417,0,3,0.0,0,1,0.0,2,2,4,3,1,0,1,2,10,-24,1,Brandon Miller,CHA,CHA,MIL,,,17,14,13,7
22023,1641706,22300177,"NOV 12, 2023",CHA @ NYK,L,10,5,6,0.833,1,2,0.5,0,1,0.0,1,2,3,0,0,0,0,0,11,4,1,Brandon Miller,CHA,NYK,CHA,,,14,14,11,3
22023,1641706,22300009,"NOV 10, 2023",CHA @ WAS,W,32,5,16,0.313,0,6,0.0,2,2,1.0,2,1,3,2,1,2,1,5,12,3,1,Brandon Miller,CHA,WAS,CHA,,,17,15,14,5
22023,1641706,22300157,"NOV 08, 2023",CHA vs. WAS,L,30,5,11,0.455,1,2,0.5,2,3,0.667,2,3,5,2,1,0,2,2,13,-11,1,Brandon Miller,CHA,CHA,WAS,,,20,18,15,7
22023,1641706,22300143,"NOV 05, 2023",CHA @ DAL,L,36,3,12,0.25,0,5,0.0,1,2,0.5,0,1,1,1,1,0,0,3,7,-9,1,Brandon Miller,CHA,DAL,CHA,,,9,8,8,2
22023,1641706,22300133,"NOV 04, 2023",CHA @ IND,W,34,4,7,0.571,0,2,0.0,2,2,1.0,1,2,3,1,0,1,0,4,10,17,1,Brandon Miller,CHA,IND,CHA,,,14,13,11,4
22023,1641706,22300122,"NOV 01, 2023",CHA @ HOU,L,24,4,9,0.444,1,3,0.333,1,2,0.5,1,4,5,2,0,0,1,5,10,-6,1,Brandon Miller,CHA,HOU,CHA,,,17,15,12,7
22023,1641706,22300101,"OCT 30, 2023",CHA vs. BKN,L,36,7,16,0.438,2,5,0.4,6,6,1.0,4,5,9,2,0,1,0,3,22,-4,1,Brandon Miller,CHA,CHA,BKN,,,33,31,24,11
22023,1641706,22300077,"OCT 27, 2023",CHA vs. DET,L,33,6,13,0.462,2,4,0.5,3,4,0.75,2,4,6,2,1,1,3,4,17,-2,1,Brandon Miller,CHA,CHA,DET,,,25,23,19,8
22023,1641706,22300063,"OCT 25, 2023",CHA vs. ATL,W,25,5,9,0.556,3,7,0.429,0,0,0.0,0,3,3,2,0,0,1,3,13,-13,1,Brandon Miller,CHA,CHA,ATL,,,18,16,15,5
22023,1641757,22300537,"JAN 12, 2024",LAC @ MEM,W,4,1,2,0.5,0,0,0.0,0,0,0.0,2,0,2,0,0,0,0,0,2,-11,1,Jordan Miller,LAC,MEM,LAC,,,4,4,2,2
22023,1641757,22300343,"DEC 16, 2023",LAC vs. NYK,W,5,0,0,0.0,0,0,0.0,0,0,0.0,0,1,1,0,0,0,1,0,0,-2,1,Jordan Miller,LAC,LAC,NYK,,,1,1,0,1
22023,1641757,22300114,"OCT 31, 2023",LAC vs. ORL,W,3,1,1,1.0,1,1,1.0,0,0,0.0,0,0,0,0,0,0,0,1,3,2,1,Jordan Miller,LAC,LAC,ORL,,,3,3,3,0
22023,1641757,22300074,"OCT 25, 2023",LAC vs. POR,W,4,1,2,0.5,0,0,0.0,0,0,0.0,0,0,0,0,0,0,0,1,2,-7,1,Jordan Miller,LAC,LAC,POR,,,2,2,2,0
22023,1631159,22300538,"JAN 12, 2024",MIN vs. POR,W,8,2,4,0.5,0,2,0.0,0,0,0.0,0,2,2,0,1,1,1,2,4,-9,1,Leonard Miller,MIN,MIN,POR,,,6,6,4,2
22023,1631159,22300411,"DEC 26, 2023",MIN @ OKC,L,5,3,3,1.0,1,1,1.0,0,0,0.0,0,1,1,0,0,0,0,0,7,-1,1,Leonard Miller,MIN,OKC,MIN,,,8,8,7,1
22023,1631159,22300249,"NOV 26, 2023",MIN @ MEM,W,2,1,1,1.0,0,0,0.0,0,0,0.0,0,2,2,1,0,0,0,0,2,3,1,Leonard Miller,MIN,MEM,MIN,,,5,4,3,3
22023,1631159,22300232,"NOV 22, 2023",MIN vs. PHI,W,2,0,0,0.0,0,0,0.0,0,0,0.0,0,3,3,0,0,0,0,1,0,-1,1,Leonard Miller,MIN,MIN,PHI,,,3,3,0,3
22023,1631159,22300093,"OCT 28, 2023",MIN vs. MIA,W,2,0,1,0.0,0,0,0.0,0,0,0.0,0,1,1,0,0,0,0,0,0,-7,1,Leonard Miller,MIN,MIN,MIA,,,1,1,0,1
22023,201988,22300533,"JAN 12, 2024",ATL vs. IND,L,15,1,3,0.333,0,1,0.0,0,0,0.0,1,0,1,0,1,0,0,1,2,-11,1,Patty Mills,ATL,ATL,IND,,,3,3,2,1
22023,201988,22300521,"JAN 10, 2024",ATL vs. PHI,W,6,0,0,0.0,0,0,0.0,0,0,0.0,0,0,0,0,0,0,0,2,0,0,1,Patty Mills,ATL,ATL,PHI,,,0,0,0,0
22023,201988,22300445,"DEC 31, 2023",ATL @ WAS,W,8,0,1,0.0,0,1,0.0,0,0,0.0,0,2,2,0,0,0,0,0,0,17,1,Patty Mills,ATL,WAS,ATL,,,2,2,0,2
22023,201988,22300431,"DEC 29, 2023",ATL vs. SAC,L,11,1,1,1.0,1,1,1.0,0,0,0.0,0,0,0,0,0,0,0,0,3,-11,1,Patty Mills,ATL,ATL,SAC,,,3,3,3,0
22023,201988,22300384,"DEC 22, 2023",ATL @ MIA,L,12,1,2,0.5,1,1,1.0,0,0,0.0,1,0,1,1,0,0,1,4,3,-2,1,Patty Mills,ATL,MIA,ATL,,,5,4,4,2
22023,201988,22300336,"DEC 16, 2023",ATL @ CLE,L,13,1,4,0.25,1,3,0.333,0,0,0.0,0,2,2,2,0,0,1,2,3,-1,1,Patty Mills,ATL,CLE,ATL,,,7,5,5,4
22023,201988,22300330,"DEC 15, 2023",ATL @ TOR,W,1,0,0,0.0,0,0,0.0,0,0,0.0,0,0,0,0,0,0,0,0,0,-3,1,Patty Mills,ATL,TOR,ATL,,,0,0,0,0
22023,201988,22301218,"DEC 08, 2023",ATL @ PHI,L,17,1,4,0.25,1,3,0.333,0,0,0.0,0,1,1,2,1,1,1,2,3,1,1,Patty Mills,ATL,PHI,ATL,,,6,4,5,3
22023,201988,22300241,"NOV 25, 2023",ATL @ WAS,W,5,1,2,0.5,1,1,1.0,0,0,0.0,0,1,1,0,0,0,0,0,3,-2,1,Patty Mills,ATL,WAS,ATL,,,4,4,3,1
22023,1629003,22300538,"JAN 12, 2024",MIN vs. POR,W,10,3,5,0.6,0,0,0.0,0,0,0.0,0,0,0,2,0,0,0,1,6,-11,1,Shake Milton,MIN,MIN,POR,,,8,6,8,2
22023,1629003,22300517,"JAN 10, 2024",MIN @ BOS,L,9,1,2,0.5,0,0,0.0,0,1,0.0,0,2,2,0,0,1,0,0,2,8,1,Shake Milton,MIN,BOS,MIN,,,4,4,2,2
22023,1629003,22300513,"JAN 09, 2024",MIN @ ORL,W,2,2,2,1.0,0,0,0.0,0,0,0.0,0,0,0,0,0,0,0,0,4,-2,1,Shake Milton,MIN,ORL,MIN,,,4,4,4,0
22023,1629003,22300485,"JAN 05, 2024",MIN @ HOU,W,3,0,1,0.0,0,1,0.0,0,0,0.0,0,0,0,0,0,0,1,1,0,0,1,Shake Milton,MIN,HOU,MIN,,,0,0,0,0
22023,1629003,22300471,"JAN 03, 2024",MIN vs. NOP,L,3,2,2,1.0,1,1,1.0,0,0,0.0,0,0,0,0,0,0,0,0,5,8,1,Shake Milton,MIN,MIN,NOP,,,5,5,5,0
22023,1629003,22300411,"DEC 26, 2023",MIN @ OKC,L,5,0,0,0.0,0,0,0.0,0,0,0.0,0,0,0,1,0,0,0,0,0,-1,1,Shake Milton,MIN,OKC,MIN,,,1,0,1,1
22023,1629003,22300400,"DEC 23, 2023",MIN @ SAC,W,14,2,4,0.5,1,2,0.5,0,0,0.0,0,1,1,1,0,0,1,0,5,-6,1,Shake Milton,MIN,SAC,MIN,,,7,6,6,2
22023,1629003,22300367,"DEC 20, 2023",MIN @ PHI,L,13,0,2,0.0,0,0,0.0,2,2,1.0,0,0,0,3,0,0,1,2,2,-1,1,Shake Milton,MIN,PHI,MIN,,,5,2,5,3
22023,1629003,22300338,"DEC 16, 2023",MIN vs. IND,W,5,0,2,0.0,0,1,0.0,0,0,0.0,0,0,0,0,0,0,0,1,0,-5,1,Shake Milton,MIN,MIN,IND,,,0,0,0,0
22023,1629003,22300321,"DEC 14, 2023",MIN @ DAL,W,2,1,1,1.0,0,0,0.0,0,0,0.0,0,0,0,0,0,0,0,0,2,-1,1,Shake Milton,MIN,DAL,MIN,,,2,2,2,0
22023,1629003,22300301,"DEC 11, 2023",MIN @ NOP,L,20,4,10,0.4,0,1,0.0,4,4,1.0,1,0,1,5,0,0,1,4,12,1,1,Shake Milton,MIN,NOP,MIN,,,18,13,17,6
22023,1629003,22301221,"DEC 08, 2023",MIN @ MEM,W,22,6,9,0.667,3,5,0.6,2,2,1.0,0,2,2,1,0,0,2,1,17,9,1,Shake Milton,MIN,MEM,MIN,,,20,19,18,3
22023,1629003,22301210,"DEC 06, 2023",MIN vs. SAS,W,12,0,2,0.0,0,1,0.0,0,0,0.0,0,1,1,0,0,0,0,0,0,-12,1,Shake Milton,MIN,MIN,SAS,,,1,1,0,1
22023,1629003,22300281,"DEC 02, 2023",MIN @ CHA,W,23,2,8,0.25,0,2,0.0,2,2,1.0,0,1,1,2,1,0,0,2,6,-5,1,Shake Milton,MIN,CHA,MIN,,,9,7,8,3
22023,1629003,22300270,"NOV 30, 2023",MIN vs. UTA,W,20,2,7,0.286,0,2,0.0,1,2,0.5,0,2,2,3,2,0,0,0,5,-6,1,Shake Milton,MIN,MIN,UTA,,,10,7,8,5
22023,1629003,22300058,"NOV 28, 2023",MIN vs. OKC,W,12,1,2,0.5,0,1,0.0,2,2,1.0,0,1,1,1,1,1,2,1,4,-4,1,Shake Milton,MIN,MIN,OKC,,,6,5,5,2
22023,1629003,22300249,"NOV 26, 2023",MIN @ MEM,W,19,2,6,0.333,1,3,0.333,1,2,0.5,0,2,2,3,1,0,1,2,6,8,1,Shake Milton,MIN,MEM,MIN,,,11,8,9,5
22023,1629003,22300050,"NOV 24, 2023",MIN vs. SAC,L,13,1,6,0.167,0,1,0.0,0,0,0.0,1,1,2,1,1,1,3,1,2,-10,1,Shake Milton,MIN,MIN,SAC,,,5,4,3,3
22023,1629003,22300232,"NOV 22, 2023",MIN vs. PHI,W,21,3,7,0.429,1,3,0.333,5,6,0.833,0,0,0,1,0,0,0,2,12,2,1,Shake Milton,MIN,MIN,PHI,,,13,12,13,1
22023,1629003,22300221,"NOV 20, 2023",MIN vs. NYK,W,14,2,5,0.4,0,2,0.0,2,2,1.0,0,5,5,4,0,0,1,1,6,0,1,Shake Milton,MIN,MIN,NYK,,,15,11,10,9
22023,1629003,22300203,"NOV 18, 2023",MIN @ NOP,W,16,2,6,0.333,0,2,0.0,4,4,1.0,0,1,1,1,1,0,1,2,8,-16,1,Shake Milton,MIN,NOP,MIN,,,10,9,9,2
22023,1629003,22300197,"NOV 15, 2023",MIN @ PHX,L,23,4,8,0.5,0,2,0.0,0,0,0.0,1,3,4,0,0,0,0,3,8,6,1,Shake Milton,MIN,PHX,MIN,,,12,12,8,4
22023,1629003,22300025,"NOV 14, 2023",MIN @ GSW,W,15,2,4,0.5,0,1,0.0,2,2,1.0,0,4,4,3,0,0,1,3,6,8,1,Shake Milton,MIN,GSW,MIN,,,13,10,9,7
22023,1629003,22300186,"NOV 12, 2023",MIN @ GSW,W,10,0,1,0.0,0,0,0.0,1,2,0.5,0,0,0,0,0,0,1,1,1,-2,1,Shake Milton,MIN,GSW,MIN,,,1,1,1,0
22023,1629003,22300013,"NOV 10, 2023",MIN @ SAS,W,14,2,4,0.5,2,3,0.667,0,1,0.0,1,2,3,1,0,0,2,3,6,0,1,Shake Milton,MIN,SAS,MIN,,,10,9,7,4
22023,1629003,22300166,"NOV 08, 2023",MIN vs. NOP,W,19,4,9,0.444,1,5,0.2,1,1,1.0,0,4,4,1,2,0,2,1,10,4,1,Shake Milton,MIN,MIN,NOP,,,15,14,11,5
22023,1629003,22300154,"NOV 06, 2023",MIN vs. BOS,W,3,0,0,0.0,0,0,0.0,0,0,0.0,0,0,0,0,0,0,0,0,0,-8,1,Shake Milton,MIN,MIN,BOS,,,0,0,0,0
22023,1629003,22300138,"NOV 04, 2023",MIN vs. UTA,W,15,2,4,0.5,0,2,0.0,4,4,1.0,1,1,2,0,1,1,0,2,8,4,1,Shake Milton,MIN,MIN,UTA,,,10,10,8,2
22023,1629003,22300123,"NOV 01, 2023",MIN vs. DEN,W,18,0,3,0.0,0,0,0.0,2,2,1.0,0,1,1,1,2,0,1,1,2,10,1,Shake Milton,MIN,MIN,DEN,,,4,3,3,2
22023,1629003,22300104,"OCT 30, 2023",MIN @ ATL,L,17,4,8,0.5,2,2,1.0,0,0,0.0,0,1,1,1,0,0,1,1,10,2,1,Shake Milton,MIN,ATL,MIN,,,12,11,11,2
22023,1629003,22300093,"OCT 28, 2023",MIN vs. MIA,W,17,1,4,0.25,0,2,0.0,0,1,0.0,0,1,1,2,0,0,2,0,2,-4,1,Shake Milton,MIN,MIN,MIA,,,5,3,4,3
22023,1629003,22300069,"OCT 25, 2023",MIN @ TOR,L,21,1,5,0.2,1,4,0.25,1,2,0.5,0,3,3,4,2,0,2,4,4,3,1,Shake Milton,MIN,TOR,MIN,,,11,7,8,7
22023,1631303,22300554,"JAN 14, 2024",POR vs. PHX,L,17,0,1,0.0,0,1,0.0,1,2,0.5,0,2,2,0,0,0,0,5,1,-4,1,Justin Minaya,POR,POR,PHX,,,3,3,1,2
22023,1631303,22300538,"JAN 12, 2024",POR @ MIN,L,9,1,1,1.0,1,1,1.0,0,0,0.0,0,0,0,2,1,1,0,0,3,13,1,Justin Minaya,POR,MIN,POR,,,5,3,5,2
22023,1631303,22300529,"JAN 11, 2024",POR @ OKC,L,14,2,5,0.4,0,2,0.0,0,0,0.0,0,2,2,1,2,1,0,0,4,-5,1,Justin Minaya,POR,OKC,POR,,,7,6,5,3
22023,1631303,22300514,"JAN 09, 2024",POR @ NYK,L,12,1,4,0.25,0,2,0.0,1,2,0.5,1,0,1,1,0,1,1,1,3,8,1,Justin Minaya,POR,NYK,POR,,,5,4,4,2
22023,1631303,22301226,"DEC 08, 2023",POR vs. DAL,L,8,0,0,0.0,0,0,0.0,0,0,0.0,0,0,0,0,0,0,0,1,0,3,1,Justin Minaya,POR,POR,DAL,,,0,0,0,0
22023,1631303,22300215,"NOV 19, 2023",POR vs. OKC,L,13,2,6,0.333,2,4,0.5,1,2,0.5,2,0,2,0,0,1,0,0,7,-7,1,Justin Minaya,POR,POR,OKC,,,9,9,7,2
22023,1631303,22300036,"NOV 17, 2023",POR vs. LAL,L,5,0,0,0.0,0,0,0.0,0,0,0.0,0,0,0,0,0,0,0,0,0,-2,1,Justin Minaya,POR,POR,LAL,,,0,0,0,0
22023,1631303,22300199,"NOV 15, 2023",POR vs. CLE,L,3,0,0,0.0,0,0,0.0,0,0,0.0,0,0,0,0,0,0,0,0,0,0,1,Justin Minaya,POR,POR,CLE,,,0,0,0,0
22023,1631303,22300023,"NOV 14, 2023",POR @ UTA,L,3,0,0,0.0,0,0,0.0,0,0,0.0,1,0,1,0,0,0,0,0,0,-1,1,Justin Minaya,POR,UTA,POR,,,1,1,0,1
22023,1631303,22300170,"NOV 08, 2023",POR @ SAC,L,8,0,0,0.0,0,0,0.0,0,0,0.0,1,1,2,0,0,0,1,1,0,-4,1,Justin Minaya,POR,SAC,POR,,,2,2,0,2
22023,1631169,22300538,"JAN 12, 2024",MIN vs. POR,W,9,0,3,0.0,0,0,0.0,2,2,1.0,0,0,0,0,1,1,0,2,2,-10,1,Josh Minott,MIN,MIN,POR,,,2,2,2,0
22023,1631169,22300485,"JAN 05, 2024",MIN @ HOU,W,3,0,0,0.0,0,0,0.0,2,2,1.0,0,0,0,0,0,0,0,0,2,-6,1,Josh Minott,MIN,HOU,MIN,,,2,2,2,0
22023,1631169,22300471,"JAN 03, 2024",MIN vs. NOP,L,3,0,0,0.0,0,0,0.0,2,2,1.0,0,0,0,0,0,1,0,0,2,8,1,Josh Minott,MIN,MIN,NOP,,,2,2,2,0
22023,1631169,22300411,"DEC 26, 2023",MIN @ OKC,L,5,0,1,0.0,0,0,0.0,0,0,0.0,0,0,0,2,0,0,1,0,0,-1,1,Josh Minott,MIN,OKC,MIN,,,2,0,2,2
22023,1631169,22300321,"DEC 14, 2023",MIN @ DAL,W,2,1,1,1.0,0,0,0.0,1,1,1.0,0,0,0,0,0,0,0,0,3,-1,1,Josh Minott,MIN,DAL,MIN,,,3,3,3,0
22023,1631169,22300301,"DEC 11, 2023",MIN @ NOP,L,2,1,1,1.0,0,0,0.0,1,1,1.0,0,0,0,0,0,0,0,0,3,1,1,Josh Minott,MIN,NOP,MIN,,,3,3,3,0
22023,1631169,22300249,"NOV 26, 2023",MIN @ MEM,W,2,1,2,0.5,0,1,0.0,0,0,0.0,0,0,0,0,0,0,0,0,2,3,1,Josh Minott,MIN,MEM,MIN,,,2,2,2,0
22023,1631169,22300232,"NOV 22, 2023",MIN vs. PHI,W,2,0,0,0.0,0,0,0.0,0,0,0.0,0,0,0,0,0,0,0,1,0,-1,1,Josh Minott,MIN,MIN,PHI,,,0,0,0,0
22023,1631169,22300221,"NOV 20, 2023",MIN vs. NYK,W,1,1,1,1.0,0,0,0.0,0,0,0.0,0,2,2,0,0,0,0,1,2,2,1,Josh Minott,MIN,MIN,NYK,,,4,4,2,2
22023,1631169,22300197,"NOV 15, 2023",MIN @ PHX,L,5,1,3,0.333,0,2,0.0,0,1,0.0,1,0,1,0,0,0,0,0,2,5,1,Josh Minott,MIN,PHX,MIN,,,3,3,2,1
22023,1631169,22300166,"NOV 08, 2023",MIN vs. NOP,W,3,0,1,0.0,0,1,0.0,0,0,0.0,0,0,0,0,0,0,0,2,0,-6,1,Josh Minott,MIN,MIN,NOP,,,0,0,0,0
22023,1631169,22300138,"NOV 04, 2023",MIN vs. UTA,W,4,1,1,1.0,0,0,0.0,2,3,0.667,0,0,0,1,0,0,0,0,4,5,1,Josh Minott,MIN,MIN,UTA,,,5,4,5,1
22023,1631169,22300123,"NOV 01, 2023",MIN vs. DEN,W,4,1,1,1.0,0,0,0.0,0,0,0.0,0,0,0,0,0,0,0,0,2,2,1,Josh Minott,MIN,MIN,DEN,,,2,2,2,0
22023,1631169,22300104,"OCT 30, 2023",MIN @ ATL,L,1,1,1,1.0,0,0,0.0,0,0,0.0,0,0,0,0,0,0,0,0,2,4,1,Josh Minott,MIN,ATL,MIN,,,2,2,2,0
22023,1631169,22300093,"OCT 28, 2023",MIN vs. MIA,W,2,0,2,0.0,0,1,0.0,0,0,0.0,0,0,0,0,0,1,0,0,0,-7,1,Josh Minott,MIN,MIN,MIA,,,0,0,0,0
22023,1630558,22300532,"JAN 12, 2024",SAC @ PHI,L,6,2,3,0.667,0,0,0.0,0,0,0.0,0,0,0,0,0,0,0,0,4,3,1,Davion Mitchell,SAC,PHI,SAC,,,4,4,4,0
22023,1630558,22300518,"JAN 10, 2024",SAC @ CHA,W,5,0,1,0.0,0,0,0.0,0,0,0.0,0,1,1,0,0,0,0,1,0,1,1,Davion Mitchell,SAC,CHA,SAC,,,1,1,0,1
22023,1630558,22300512,"JAN 09, 2024",SAC @ DET,W,1,0,0,0.0,0,0,0.0,0,0,0.0,1,0,1,0,0,0,0,0,0,2,1,Davion Mitchell,SAC,DET,SAC,,,1,1,0,1
22023,1630558,22300500,"JAN 07, 2024",SAC vs. NOP,L,10,0,2,0.0,0,2,0.0,0,0,0.0,0,0,0,0,1,0,0,1,0,-12,1,Davion Mitchell,SAC,SAC,NOP,,,0,0,0,0
22023,1630558,22300492,"JAN 05, 2024",SAC vs. TOR,W,11,3,8,0.375,1,4,0.25,0,0,0.0,0,1,1,2,0,0,0,0,7,6,1,Davion Mitchell,SAC,SAC,TOR,,,10,8,9,3
22023,1630558,22300476,"JAN 03, 2024",SAC vs. ORL,W,14,1,3,0.333,0,2,0.0,0,0,0.0,0,1,1,3,0,0,2,0,2,6,1,Davion Mitchell,SAC,SAC,ORL,,,6,3,5,4
22023,1630558,22300464,"JAN 02, 2024",SAC vs. CHA,L,14,1,3,0.333,1,1,1.0,1,2,0.5,0,1,1,0,0,0,1,1,4,-4,1,Davion Mitchell,SAC,SAC,CHA,,,5,5,4,1
22023,1630558,22300449,"DEC 31, 2023",SAC @ MEM,W,14,4,4,1.0,0,0,0.0,0,0,0.0,0,2,2,4,0,0,0,2,8,11,1,Davion Mitchell,SAC,MEM,SAC,,,14,10,12,6
22023,1630558,22300431,"DEC 29, 2023",SAC @ ATL,W,13,1,3,0.333,0,1,0.0,0,0,0.0,1,0,1,2,0,0,0,2,2,-1,1,Davion Mitchell,SAC,ATL,SAC,,,5,3,4,3
22023,1630558,22300413,"DEC 26, 2023",SAC @ POR,L,2,1,3,0.333,0,2,0.0,0,0,0.0,0,1,1,0,0,0,0,0,2,2,1,Davion Mitchell,SAC,POR,SAC,,,3,3,2,1
22023,1630558,22300387,"DEC 22, 2023",SAC vs. PHX,W,2,0,1,0.0,0,1,0.0,0,0,0.0,0,0,0,0,0,0,0,0,0,-6,1,Davion Mitchell,SAC,SAC,PHX,,,0,0,0,0
22023,1630558,22300373,"DEC 20, 2023",SAC vs. BOS,L,5,0,1,0.0,0,0,0.0,0,2,0.0,0,0,0,1,0,0,0,0,0,-4,1,Davion Mitchell,SAC,SAC,BOS,,,1,0,1,1
22023,1630558,22300358,"DEC 18, 2023",SAC vs. WAS,W,4,1,2,0.5,0,0,0.0,0,0,0.0,0,1,1,1,0,0,0,0,2,-6,1,Davion Mitchell,SAC,SAC,WAS,,,4,3,3,2
22023,1630558,22300342,"DEC 16, 2023",SAC vs. UTA,W,18,2,5,0.4,0,1,0.0,0,0,0.0,0,0,0,1,0,0,0,3,4,-8,1,Davion Mitchell,SAC,SAC,UTA,,,5,4,5,1
22023,1630558,22300309,"DEC 12, 2023",SAC @ LAC,L,15,0,3,0.0,0,1,0.0,1,2,0.5,0,0,0,2,0,0,0,1,1,-14,1,Davion Mitchell,SAC,LAC,SAC,,,3,1,3,2
22023,1630558,22300303,"DEC 11, 2023",SAC vs. BKN,W,3,0,1,0.0,0,1,0.0,0,0,0.0,1,0,1,1,0,0,0,0,0,-7,1,Davion Mitchell,SAC,SAC,BKN,,,2,1,1,2
22023,1630558,22301228,"DEC 08, 2023",SAC @ PHX,W,1,0,0,0.0,0,0,0.0,0,0,0.0,0,0,0,0,0,0,0,0,0,-4,1,Davion Mitchell,SAC,PHX,SAC,,,0,0,0,0
22023,1630558,22300264,"NOV 29, 2023",SAC vs. LAC,L,13,3,7,0.429,1,5,0.2,2,2,1.0,0,3,3,3,0,0,1,0,9,-5,1,Davion Mitchell,SAC,SAC,LAC,,,15,12,12,6
22023,1630558,22300060,"NOV 28, 2023",SAC vs. GSW,W,9,1,4,0.25,0,2,0.0,2,2,1.0,0,0,0,0,1,0,0,2,4,-14,1,Davion Mitchell,SAC,SAC,GSW,,,4,4,4,0
22023,1630558,22300050,"NOV 24, 2023",SAC @ MIN,W,9,2,2,1.0,1,1,1.0,0,0,0.0,0,0,0,1,0,0,1,1,5,-6,1,Davion Mitchell,SAC,MIN,SAC,,,6,5,6,1
22023,1630558,22300233,"NOV 22, 2023",SAC @ NOP,L,10,0,0,0.0,0,0,0.0,2,2,1.0,0,1,1,2,0,0,0,0,2,9,1,Davion Mitchell,SAC,NOP,SAC,,,5,3,4,3
22023,1630558,22300222,"NOV 20, 2023",SAC @ NOP,L,19,0,2,0.0,0,2,0.0,2,2,1.0,0,0,0,8,0,0,1,1,2,-4,1,Davion Mitchell,SAC,NOP,SAC,,,10,2,10,8
22023,1630558,22300212,"NOV 19, 2023",SAC @ DAL,W,9,0,3,0.0,0,1,0.0,0,0,0.0,0,0,0,1,0,0,2,0,0,1,1,Davion Mitchell,SAC,DAL,SAC,,,1,0,1,1
22023,1630558,22300016,"NOV 10, 2023",SAC vs. OKC,W,17,1,6,0.167,1,6,0.167,0,0,0.0,0,1,1,1,0,0,0,1,3,1,1,Davion Mitchell,SAC,SAC,OKC,,,5,4,4,2
22023,1630558,22300170,"NOV 08, 2023",SAC vs. POR,W,28,6,9,0.667,3,4,0.75,1,1,1.0,0,0,0,4,0,0,2,4,16,3,1,Davion Mitchell,SAC,SAC,POR,,,20,16,20,4
22023,1630558,22300153,"NOV 06, 2023",SAC @ HOU,L,27,2,11,0.182,1,5,0.2,0,0,0.0,1,0,1,2,0,1,0,2,5,-30,1,Davion Mitchell,SAC,HOU,SAC,,,8,6,7,3
22023,1630558,22300137,"NOV 04, 2023",SAC @ HOU,L,26,3,7,0.429,1,4,0.25,0,0,0.0,0,3,3,5,0,1,1,3,7,-13,1,Davion Mitchell,SAC,HOU,SAC,,,15,10,12,8
22023,1630558,22300126,"NOV 01, 2023",SAC @ GSW,L,30,5,9,0.556,3,6,0.5,0,0,0.0,0,3,3,4,3,0,2,1,13,-3,1,Davion Mitchell,SAC,GSW,SAC,,,20,16,17,7
22023,1630558,22300100,"OCT 29, 2023",SAC vs. LAL,W,15,2,4,0.5,1,2,0.5,0,0,0.0,0,2,2,2,0,0,0,4,5,-17,1,Davion Mitchell,SAC,SAC,LAL,,,9,7,7,4
22023,1630558,22300087,"OCT 27, 2023",SAC vs. GSW,L,11,0,2,0.0,0,1,0.0,0,0,0.0,0,0,0,0,1,0,2,1,0,-8,1,Davion Mitchell,SAC,SAC,GSW,,,0,0,0,0
22023,1630558,22300072,"OCT 25, 2023",SAC @ UTA,W,14,0,3,0.0,0,2,0.0,0,0,0.0,0,3,3,4,0,0,1,3,0,4,1,Davion Mitchell,SAC,UTA,SAC,,,7,3,4,7
22023,1628378,22300561,"JAN 15, 2024",CLE vs. CHI,W,37,11,21,0.524,4,10,0.4,8,8,1.0,2,1,3,7,2,0,2,0,34,19,1,Donovan Mitchell,CLE,CLE,CHI,,,44,37,41,10
22023,1628378,22300527,"JAN 11, 2024",CLE vs. BKN,W,41,15,30,0.5,4,12,0.333,11,13,0.846,2,10,12,6,4,0,7,1,45,11,1,Donovan Mitchell,CLE,CLE,BKN,,,63,57,51,18
22023,1628378,22300497,"JAN 07, 2024",CLE vs. SAS,W,37,7,18,0.389,1,10,0.1,2,4,0.5,0,2,2,9,1,0,4,1,17,-6,1,Donovan Mitchell,CLE,CLE,SAS,,,28,19,26,11
22023,1628378,22300482,"JAN 05, 2024",CLE vs. WAS,W,26,8,15,0.533,5,8,0.625,5,8,0.625,1,1,2,4,1,0,3,2,26,22,1,Donovan Mitchell,CLE,CLE,WAS,,,32,28,30,6
22023,1628378,22300465,"JAN 03, 2024",CLE vs. WAS,W,24,6,16,0.375,4,9,0.444,6,6,1.0,1,2,3,4,2,2,2,0,22,18,1,Donovan Mitchell,CLE,CLE,WAS,,,29,25,26,7
22023,1628378,22300452,"JAN 01, 2024",CLE @ TOR,L,38,8,21,0.381,4,9,0.444,6,6,1.0,1,6,7,7,4,0,3,4,26,7,1,Donovan Mitchell,CLE,TOR,CLE,,,40,33,33,14
22023,1628378,22300433,"DEC 29, 2023",CLE vs. MIL,L,36,14,23,0.609,2,10,0.2,4,4,1.0,1,5,6,9,2,1,2,3,34,3,1,Donovan Mitchell,CLE,CLE,MIL,,,49,40,43,15
22023,1628378,22300349,"DEC 18, 2023",CLE vs. HOU,W,45,14,27,0.519,4,11,0.364,5,5,1.0,0,1,1,6,0,2,2,5,37,4,1,Donovan Mitchell,CLE,CLE,HOU,,,44,38,43,7
22023,1628378,22300336,"DEC 16, 2023",CLE vs. ATL,W,41,7,21,0.333,4,9,0.444,4,4,1.0,3,2,5,13,2,0,1,4,22,7,1,Donovan Mitchell,CLE,CLE,ATL,,,40,27,35,18
22023,1628378,22300319,"DEC 14, 2023",CLE @ BOS,L,40,12,24,0.5,2,8,0.25,5,5,1.0,1,7,8,6,1,0,3,2,31,-11,1,Donovan Mitchell,CLE,BOS,CLE,,,45,39,37,14
22023,1628378,22300305,"DEC 12, 2023",CLE @ BOS,L,35,11,22,0.5,5,13,0.385,2,2,1.0,0,6,6,3,1,0,3,3,29,6,1,Donovan Mitchell,CLE,BOS,CLE,,,38,35,32,9
22023,1628378,22300294,"DEC 11, 2023",CLE @ ORL,L,37,6,18,0.333,2,10,0.2,8,9,0.889,1,2,3,3,3,1,2,3,22,-11,1,Donovan Mitchell,CLE,ORL,CLE,,,28,25,25,6
22023,1628378,22301220,"DEC 08, 2023",CLE @ MIA,W,36,9,17,0.529,3,8,0.375,6,8,0.75,1,12,13,6,1,0,5,1,27,15,1,Donovan Mitchell,CLE,MIA,CLE,,,46,40,33,19
22023,1628378,22301205,"DEC 06, 2023",CLE vs. ORL,W,37,12,24,0.5,5,10,0.5,6,9,0.667,2,5,7,6,1,0,4,3,35,0,1,Donovan Mitchell,CLE,CLE,ORL,,,48,42,41,13
22023,1628378,22300283,"DEC 02, 2023",CLE @ DET,W,33,7,19,0.368,2,5,0.4,4,5,0.8,1,2,3,4,2,0,4,2,20,-13,1,Donovan Mitchell,CLE,DET,CLE,,,27,23,24,7
22023,1628378,22300265,"NOV 30, 2023",CLE vs. POR,L,34,7,20,0.35,1,9,0.111,8,8,1.0,3,4,7,6,4,0,1,1,23,1,1,Donovan Mitchell,CLE,CLE,POR,,,36,30,29,13
22023,1628378,22300055,"NOV 28, 2023",CLE vs. ATL,W,35,14,25,0.56,3,11,0.273,9,9,1.0,2,9,11,5,3,1,6,3,40,29,1,Donovan Mitchell,CLE,CLE,ATL,,,56,51,45,16
22023,1628378,22300251,"NOV 26, 2023",CLE vs. TOR,W,34,4,17,0.235,0,5,0.0,2,3,0.667,1,4,5,4,1,0,0,0,10,1,1,Donovan Mitchell,CLE,CLE,TOR,,,19,15,14,9
22023,1628378,22300242,"NOV 25, 2023",CLE vs. LAL,L,35,4,18,0.222,2,6,0.333,12,13,0.923,0,5,5,6,1,0,1,0,22,-2,1,Donovan Mitchell,CLE,CLE,LAL,,,33,27,28,11
22023,1628378,22300199,"NOV 15, 2023",CLE @ POR,W,36,13,20,0.65,5,8,0.625,3,4,0.75,0,6,6,4,1,0,3,4,34,22,1,Donovan Mitchell,CLE,POR,CLE,,,44,40,38,10
22023,1628378,22300191,"NOV 13, 2023",CLE @ SAC,L,38,7,21,0.333,4,9,0.444,4,4,1.0,0,2,2,5,1,1,2,0,22,-1,1,Donovan Mitchell,CLE,SAC,CLE,,,29,24,27,7
22023,1628378,22300176,"NOV 11, 2023",CLE @ GSW,W,36,7,22,0.318,2,6,0.333,5,6,0.833,1,6,7,5,2,1,2,4,21,15,1,Donovan Mitchell,CLE,GSW,CLE,,,33,28,26,12
22023,1628378,22300167,"NOV 08, 2023",CLE @ OKC,L,37,8,23,0.348,1,9,0.111,3,3,1.0,0,5,5,5,2,0,0,2,20,2,1,Donovan Mitchell,CLE,OKC,CLE,,,30,25,25,10
22023,1628378,22300142,"NOV 05, 2023",CLE vs. GSW,W,34,11,19,0.579,5,11,0.455,4,4,1.0,1,1,2,7,2,0,4,3,31,6,1,Donovan Mitchell,CLE,CLE,GSW,,,40,33,38,9
22023,1628378,22300001,"NOV 03, 2023",CLE @ IND,L,37,13,21,0.619,4,7,0.571,8,10,0.8,1,4,5,9,1,0,3,1,38,0,1,Donovan Mitchell,CLE,IND,CLE,,,52,43,47,14
22023,1628378,22300120,"NOV 01, 2023",CLE @ NYK,W,37,9,22,0.409,6,15,0.4,6,6,1.0,1,5,6,4,1,1,5,5,30,3,1,Donovan Mitchell,CLE,NYK,CLE,,,40,36,34,10
22023,1628378,22300112,"OCT 31, 2023",CLE vs. NYK,L,29,11,20,0.55,0,3,0.0,4,4,1.0,2,1,3,3,3,0,2,2,26,-11,1,Donovan Mitchell,CLE,CLE,NYK,,,32,29,29,6
22023,1628378,22300081,"OCT 27, 2023",CLE vs. OKC,L,42,15,27,0.556,4,11,0.364,9,11,0.818,1,7,8,5,3,2,5,1,43,7,1,Donovan Mitchell,CLE,CLE,OKC,,,56,51,48,13
22023,1628378,22300067,"OCT 25, 2023",CLE @ BKN,W,36,11,21,0.524,4,10,0.4,1,1,1.0,2,3,5,6,4,1,0,1,27,7,1,Donovan Mitchell,CLE,BKN,CLE,,,38,32,33,11
22023,1630596,22301205,"DEC 06, 2023",CLE vs. ORL,W,37,8,12,0.667,0,0,0.0,0,0,0.0,1,4,5,2,1,1,4,5,16,13,1,Evan Mobley,CLE,CLE,ORL,,,23,21,18,7
22023,1630596,22300283,"DEC 02, 2023",CLE @ DET,W,36,2,5,0.4,0,0,0.0,2,3,0.667,1,10,11,1,0,0,2,3,6,1,1,Evan Mobley,CLE,DET,CLE,,,18,17,7,12
22023,1630596,22300265,"NOV 30, 2023",CLE vs. POR,L,34,9,14,0.643,0,1,0.0,2,2,1.0,2,6,8,3,2,0,3,1,20,3,1,Evan Mobley,CLE,CLE,POR,,,31,28,23,11
22023,1630596,22300055,"NOV 28, 2023",CLE vs. ATL,W,34,8,11,0.727,1,1,1.0,0,0,0.0,5,14,19,1,0,7,1,4,17,25,1,Evan Mobley,CLE,CLE,ATL,,,37,36,18,20
22023,1630596,22300251,"NOV 26, 2023",CLE vs. TOR,W,38,5,14,0.357,0,1,0.0,2,2,1.0,3,11,14,1,0,2,3,3,12,-4,1,Evan Mobley,CLE,CLE,TOR,,,27,26,13,15
22023,1630596,22300242,"NOV 25, 2023",CLE vs. LAL,L,36,8,12,0.667,0,0,0.0,2,3,0.667,1,5,6,6,4,1,2,3,18,-5,1,Evan Mobley,CLE,CLE,LAL,,,30,24,24,12
22023,1630596,22300229,"NOV 22, 2023",CLE vs. MIA,L,25,5,7,0.714,0,0,0.0,3,3,1.0,2,8,10,2,0,0,2,0,13,-12,1,Evan Mobley,CLE,CLE,MIA,,,25,23,15,12
22023,1630596,22300040,"NOV 21, 2023",CLE @ PHI,W,38,6,10,0.6,0,0,0.0,6,6,1.0,0,12,12,3,0,1,4,4,18,-4,1,Evan Mobley,CLE,PHI,CLE,,,33,30,21,15
22023,1630596,22300210,"NOV 19, 2023",CLE vs. DEN,W,32,8,11,0.727,0,0,0.0,0,0,0.0,3,7,10,5,0,2,2,3,16,12,1,Evan Mobley,CLE,CLE,DEN,,,31,26,21,15
22023,1630596,22300030,"NOV 17, 2023",CLE vs. DET,W,35,8,12,0.667,0,0,0.0,2,4,0.5,4,6,10,5,1,0,3,4,18,-6,1,Evan Mobley,CLE,CLE,DET,,,33,28,23,15
22023,1630596,22300199,"NOV 15, 2023",CLE @ POR,W,35,8,11,0.727,0,1,0.0,5,8,0.625,3,9,12,3,1,3,1,1,21,26,1,Evan Mobley,CLE,POR,CLE,,,36,33,24,15
22023,1630596,22300191,"NOV 13, 2023",CLE @ SAC,L,30,8,14,0.571,0,0,0.0,0,0,0.0,7,5,12,2,1,0,3,4,16,-3,1,Evan Mobley,CLE,SAC,CLE,,,30,28,18,14
22023,1630596,22300176,"NOV 11, 2023",CLE @ GSW,W,31,6,10,0.6,0,1,0.0,7,7,1.0,1,4,5,2,1,1,2,4,19,-4,1,Evan Mobley,CLE,GSW,CLE,,,26,24,21,7
22023,1630596,22300167,"NOV 08, 2023",CLE @ OKC,L,33,9,16,0.563,0,1,0.0,4,4,1.0,2,3,5,1,1,1,1,2,22,3,1,Evan Mobley,CLE,OKC,CLE,,,28,27,23,6
22023,1630596,22300142,"NOV 05, 2023",CLE vs. GSW,W,29,6,10,0.6,0,1,0.0,1,4,0.25,5,11,16,2,0,1,5,4,13,8,1,Evan Mobley,CLE,CLE,GSW,,,31,29,15,18
22023,1630596,22300001,"NOV 03, 2023",CLE @ IND,L,36,7,13,0.538,0,2,0.0,0,0,0.0,2,8,10,5,3,4,2,2,14,11,1,Evan Mobley,CLE,IND,CLE,,,29,24,19,15
22023,1630596,22300120,"NOV 01, 2023",CLE @ NYK,W,35,6,12,0.5,0,0,0.0,2,3,0.667,2,6,8,5,2,2,2,2,14,8,1,Evan Mobley,CLE,NYK,CLE,,,27,22,19,13
22023,1630596,22300112,"OCT 31, 2023",CLE vs. NYK,L,29,3,9,0.333,0,0,0.0,0,0,0.0,4,8,12,5,0,2,2,0,6,-19,1,Evan Mobley,CLE,CLE,NYK,,,23,18,11,17
22023,1630596,22300091,"OCT 28, 2023",CLE vs. IND,L,33,12,22,0.545,1,1,1.0,8,10,0.8,5,9,14,3,0,3,2,4,33,-15,1,Evan Mobley,CLE,CLE,IND,,,50,47,36,17
22023,1630596,22300081,"OCT 27, 2023",CLE vs. OKC,L,34,5,12,0.417,0,0,0.0,4,6,0.667,2,13,15,3,0,2,2,4,14,-9,1,Evan Mobley,CLE,CLE,OKC,,,32,29,17,18
22023,1630596,22300067,"OCT 25, 2023",CLE @ BKN,W,34,5,11,0.455,0,0,0.0,0,0,0.0,1,5,6,1,0,2,0,3,10,3,1,Evan Mobley,CLE,BKN,CLE,,,17,16,11,7
22023,1630600,22300375,"DEC 21, 2023",CLE vs. NOP,L,4,1,1,1.0,1,1,1.0,0,0,0.0,0,0,0,1,0,0,0,0,3,2,1,Isaiah Mobley,CLE,CLE,NOP,,,4,3,4,1
22023,1630600,22300229,"NOV 22, 2023",CLE vs. MIA,L,9,1,3,0.333,0,1,0.0,0,0,0.0,0,1,1,3,1,0,1,1,2,-5,1,Isaiah Mobley,CLE,CLE,MIA,,,6,3,5,4
22023,1630600,22300112,"OCT 31, 2023",CLE vs. NYK,L,1,0,0,0.0,0,0,0.0,0,0,0.0,0,1,1,0,0,0,0,1,0,-3,1,Isaiah Mobley,CLE,CLE,NYK,,,1,1,0,1
22023,1628370,22300552,"JAN 14, 2024",SAC @ MIL,L,36,9,21,0.429,4,9,0.444,6,10,0.6,1,6,7,7,0,0,1,1,28,-11,1,Malik Monk,SAC,MIL,SAC,,,42,35,35,14
22023,1628370,22300532,"JAN 12, 2024",SAC @ PHI,L,27,5,17,0.294,0,7,0.0,5,6,0.833,0,1,1,4,2,1,2,1,15,-9,1,Malik Monk,SAC,PHI,SAC,,,20,16,19,5
22023,1628370,22300518,"JAN 10, 2024",SAC @ CHA,W,30,6,13,0.462,1,5,0.2,7,7,1.0,0,4,4,4,0,2,1,0,20,17,1,Malik Monk,SAC,CHA,SAC,,,28,24,24,8
22023,1628370,22300512,"JAN 09, 2024",SAC @ DET,W,28,9,15,0.6,2,6,0.333,0,0,0.0,0,2,2,9,1,2,3,5,20,18,1,Malik Monk,SAC,DET,SAC,,,31,22,29,11
22023,1628370,22300500,"JAN 07, 2024",SAC vs. NOP,L,21,2,9,0.222,2,6,0.333,0,0,0.0,0,1,1,5,1,1,1,1,6,-26,1,Malik Monk,SAC,SAC,NOP,,,12,7,11,6
22023,1628370,22300492,"JAN 05, 2024",SAC vs. TOR,W,32,6,16,0.375,3,9,0.333,0,1,0.0,0,1,1,9,1,0,1,4,15,10,1,Malik Monk,SAC,SAC,TOR,,,25,16,24,10
22023,1628370,22300476,"JAN 03, 2024",SAC vs. ORL,W,46,12,20,0.6,7,13,0.538,6,8,0.75,0,3,3,9,2,1,3,5,37,14,1,Malik Monk,SAC,SAC,ORL,,,49,40,46,12
22023,1628370,22300464,"JAN 02, 2024",SAC vs. CHA,L,20,2,7,0.286,2,5,0.4,0,0,0.0,1,2,3,2,0,1,1,2,6,-21,1,Malik Monk,SAC,SAC,CHA,,,11,9,8,5
22023,1628370,22300449,"DEC 31, 2023",SAC @ MEM,W,21,10,13,0.769,4,5,0.8,3,3,1.0,0,4,4,5,0,0,0,1,27,16,1,Malik Monk,SAC,MEM,SAC,,,36,31,32,9
22023,1628370,22300431,"DEC 29, 2023",SAC @ ATL,W,31,6,10,0.6,2,5,0.4,1,1,1.0,0,4,4,8,1,1,5,3,15,18,1,Malik Monk,SAC,ATL,SAC,,,27,19,23,12
22023,1628370,22300413,"DEC 26, 2023",SAC @ POR,L,19,3,11,0.273,1,7,0.143,0,0,0.0,0,1,1,4,0,1,0,2,7,-21,1,Malik Monk,SAC,POR,SAC,,,12,8,11,5
22023,1628370,22300387,"DEC 22, 2023",SAC vs. PHX,W,20,3,8,0.375,0,3,0.0,1,2,0.5,0,2,2,5,0,3,2,4,7,-3,1,Malik Monk,SAC,SAC,PHX,,,14,9,12,7
22023,1628370,22300373,"DEC 20, 2023",SAC vs. BOS,L,25,3,10,0.3,0,4,0.0,4,4,1.0,0,2,2,5,0,0,1,1,10,-7,1,Malik Monk,SAC,SAC,BOS,,,17,12,15,7
22023,1628370,22300358,"DEC 18, 2023",SAC vs. WAS,W,22,3,7,0.429,3,6,0.5,1,2,0.5,0,1,1,6,0,1,1,3,10,3,1,Malik Monk,SAC,SAC,WAS,,,17,11,16,7
22023,1628370,22300342,"DEC 16, 2023",SAC vs. UTA,W,26,6,16,0.375,4,12,0.333,2,2,1.0,0,4,4,8,0,1,1,0,18,-3,1,Malik Monk,SAC,SAC,UTA,,,30,22,26,12
22023,1628370,22300324,"DEC 14, 2023",SAC vs. OKC,W,33,7,15,0.467,4,8,0.5,0,0,0.0,0,1,1,9,0,1,4,2,18,12,1,Malik Monk,SAC,SAC,OKC,,,28,19,27,10
22023,1628370,22300309,"DEC 12, 2023",SAC @ LAC,L,22,3,8,0.375,2,5,0.4,0,0,0.0,0,0,0,5,0,0,4,4,8,-20,1,Malik Monk,SAC,LAC,SAC,,,13,8,13,5
22023,1628370,22300303,"DEC 11, 2023",SAC vs. BKN,W,28,8,13,0.615,4,7,0.571,1,1,1.0,1,1,2,9,1,0,2,0,21,12,1,Malik Monk,SAC,SAC,BKN,,,32,23,30,11
22023,1628370,22301228,"DEC 08, 2023",SAC @ PHX,W,28,5,10,0.5,3,7,0.429,0,0,0.0,0,2,2,6,0,0,2,2,13,18,1,Malik Monk,SAC,PHX,SAC,,,21,15,19,8
22023,1628370,22301204,"DEC 04, 2023",SAC vs. NOP,L,32,7,14,0.5,5,9,0.556,2,2,1.0,1,2,3,5,2,0,3,0,21,-17,1,Malik Monk,SAC,SAC,NOP,,,29,24,26,8
22023,1628370,22300290,"DEC 02, 2023",SAC vs. DEN,W,28,9,14,0.643,4,7,0.571,4,4,1.0,0,3,3,4,2,0,3,1,26,12,1,Malik Monk,SAC,SAC,DEN,,,33,29,30,7
22023,1628370,22300264,"NOV 29, 2023",SAC vs. LAC,L,28,3,8,0.375,2,5,0.4,7,7,1.0,0,4,4,2,0,0,2,1,15,-8,1,Malik Monk,SAC,SAC,LAC,,,21,19,17,6
22023,1628370,22300060,"NOV 28, 2023",SAC vs. GSW,W,26,8,15,0.533,3,7,0.429,2,2,1.0,1,2,3,1,1,1,3,2,21,12,1,Malik Monk,SAC,SAC,GSW,,,25,24,22,4
22023,1628370,22300050,"NOV 24, 2023",SAC @ MIN,W,30,6,14,0.429,3,6,0.5,2,2,1.0,0,2,2,0,1,0,3,2,17,11,1,Malik Monk,SAC,MIN,SAC,,,19,19,17,2
22023,1628370,22300233,"NOV 22, 2023",SAC @ NOP,L,26,2,8,0.25,1,6,0.167,5,5,1.0,0,4,4,5,2,0,2,2,10,-2,1,Malik Monk,SAC,NOP,SAC,,,19,14,15,9
22023,1628370,22300222,"NOV 20, 2023",SAC @ NOP,L,24,3,11,0.273,2,6,0.333,0,0,0.0,0,0,0,5,0,0,1,2,8,-16,1,Malik Monk,SAC,NOP,SAC,,,13,8,13,5
22023,1628370,22300212,"NOV 19, 2023",SAC @ DAL,W,18,4,9,0.444,4,6,0.667,0,0,0.0,0,2,2,3,1,1,2,2,12,8,1,Malik Monk,SAC,DAL,SAC,,,17,14,15,5
22023,1628370,22300032,"NOV 17, 2023",SAC @ SAS,W,26,7,11,0.636,6,9,0.667,0,0,0.0,1,3,4,8,1,0,1,3,20,13,1,Malik Monk,SAC,SAS,SAC,,,32,24,28,12
22023,1628370,22300198,"NOV 15, 2023",SAC @ LAL,W,21,1,8,0.125,1,5,0.2,0,0,0.0,0,5,5,5,1,0,3,1,3,-6,1,Malik Monk,SAC,LAL,SAC,,,13,8,8,10
22023,1628370,22300191,"NOV 13, 2023",SAC vs. CLE,W,26,4,8,0.5,3,5,0.6,2,2,1.0,1,4,5,4,1,1,2,2,13,10,1,Malik Monk,SAC,SAC,CLE,,,22,18,17,9
22023,1628370,22300016,"NOV 10, 2023",SAC vs. OKC,W,29,5,12,0.417,2,5,0.4,0,0,0.0,0,2,2,8,1,0,2,3,12,7,1,Malik Monk,SAC,SAC,OKC,,,22,14,20,10
22023,1628370,22300170,"NOV 08, 2023",SAC vs. POR,W,30,4,16,0.25,0,7,0.0,15,19,0.789,2,4,6,10,1,0,5,0,23,8,1,Malik Monk,SAC,SAC,POR,,,39,29,33,16
22023,1628370,22300153,"NOV 06, 2023",SAC @ HOU,L,15,2,6,0.333,1,3,0.333,0,0,0.0,0,1,1,2,1,0,1,3,5,-16,1,Malik Monk,SAC,HOU,SAC,,,8,6,7,3
22023,1628370,22300137,"NOV 04, 2023",SAC @ HOU,L,26,6,13,0.462,3,7,0.429,3,4,0.75,0,3,3,7,0,1,1,1,18,-9,1,Malik Monk,SAC,HOU,SAC,,,28,21,25,10
22023,1628370,22300126,"NOV 01, 2023",SAC @ GSW,L,25,5,9,0.556,3,5,0.6,3,3,1.0,3,0,3,2,0,2,3,1,16,1,1,Malik Monk,SAC,GSW,SAC,,,21,19,18,5
22023,1628370,22300100,"OCT 29, 2023",SAC vs. LAL,W,25,7,17,0.412,4,9,0.444,4,5,0.8,1,2,3,3,0,0,2,1,22,0,1,Malik Monk,SAC,SAC,LAL,,,28,25,25,6
22023,1628370,22300087,"OCT 27, 2023",SAC vs. GSW,L,18,2,4,0.5,1,2,0.5,4,4,1.0,0,0,0,6,0,1,2,2,9,-6,1,Malik Monk,SAC,SAC,GSW,,,15,9,15,6
22023,1628370,22300072,"OCT 25, 2023",SAC @ UTA,W,23,4,12,0.333,2,9,0.222,0,0,0.0,1,1,2,7,0,2,2,2,10,12,1,Malik Monk,SAC,UTA,SAC,,,19,12,17,9
22023,1630541,22300525,"JAN 10, 2024",GSW vs. NOP,L,25,8,18,0.444,4,8,0.5,1,1,1.0,1,1,2,0,1,0,0,3,21,-7,1,Moses Moody,GSW,GSW,NOP,,,23,23,21,2
22023,1630541,22300504,"JAN 07, 2024",GSW vs. TOR,L,22,7,9,0.778,4,6,0.667,3,3,1.0,0,3,3,1,1,0,1,1,21,-2,1,Moses Moody,GSW,GSW,TOR,,,25,24,22,4
22023,1630541,22300490,"JAN 05, 2024",GSW vs. DET,W,6,0,2,0.0,0,1,0.0,0,0,0.0,0,1,1,0,0,0,0,1,0,-4,1,Moses Moody,GSW,GSW,DET,,,1,1,0,1
22023,1630541,22300426,"DEC 28, 2023",GSW vs. MIA,L,13,4,8,0.5,0,2,0.0,3,3,1.0,1,2,3,0,0,2,0,1,11,10,1,Moses Moody,GSW,GSW,MIA,,,14,14,11,3
22023,1630541,22300402,"DEC 25, 2023",GSW @ DEN,L,3,0,0,0.0,0,0,0.0,0,0,0.0,0,0,0,0,0,0,0,0,0,-8,1,Moses Moody,GSW,DEN,GSW,,,0,0,0,0
22023,1630541,22300399,"DEC 23, 2023",GSW vs. POR,W,17,4,6,0.667,1,2,0.5,2,2,1.0,0,1,1,1,1,1,2,3,11,6,1,Moses Moody,GSW,GSW,POR,,,13,12,12,2
22023,1630541,22300386,"DEC 22, 2023",GSW vs. WAS,W,19,1,4,0.25,0,3,0.0,3,4,0.75,1,2,3,0,1,0,2,1,5,8,1,Moses Moody,GSW,GSW,WAS,,,8,8,5,3
22023,1630541,22300362,"DEC 19, 2023",GSW vs. BOS,W,17,3,9,0.333,2,6,0.333,2,2,1.0,0,0,0,0,0,0,0,0,10,3,1,Moses Moody,GSW,GSW,BOS,,,10,10,10,0
22023,1630541,22300348,"DEC 17, 2023",GSW @ POR,W,19,3,7,0.429,0,2,0.0,0,0,0.0,2,2,4,1,1,0,1,0,6,9,1,Moses Moody,GSW,POR,GSW,,,11,10,7,5
22023,1630541,22300339,"DEC 16, 2023",GSW vs. BKN,W,14,1,3,0.333,0,0,0.0,0,0,0.0,2,1,3,1,0,0,0,0,2,-2,1,Moses Moody,GSW,GSW,BKN,,,6,5,3,4
22023,1630541,22300325,"DEC 14, 2023",GSW @ LAC,L,16,4,6,0.667,0,1,0.0,3,4,0.75,2,3,5,1,1,0,2,1,11,4,1,Moses Moody,GSW,LAC,GSW,,,17,16,12,6
22023,1630541,22300308,"DEC 12, 2023",GSW @ PHX,L,24,3,6,0.5,2,3,0.667,4,6,0.667,1,3,4,0,0,0,2,3,12,-15,1,Moses Moody,GSW,PHX,GSW,,,16,16,12,4
22023,1630541,22301222,"DEC 08, 2023",GSW @ OKC,L,16,1,6,0.167,0,4,0.0,0,0,0.0,2,2,4,0,0,0,2,4,2,-7,1,Moses Moody,GSW,OKC,GSW,,,6,6,2,4
22023,1630541,22301214,"DEC 06, 2023",GSW vs. POR,W,26,5,10,0.5,1,4,0.25,1,1,1.0,2,2,4,0,1,1,1,2,12,3,1,Moses Moody,GSW,GSW,POR,,,16,16,12,4
22023,1630541,22300280,"DEC 02, 2023",GSW @ LAC,L,32,5,13,0.385,2,5,0.4,9,10,0.9,3,2,5,2,2,0,0,3,21,-1,1,Moses Moody,GSW,LAC,GSW,,,28,26,23,7
22023,1630541,22300273,"NOV 30, 2023",GSW vs. LAC,W,28,6,10,0.6,1,4,0.25,0,0,0.0,2,1,3,1,0,1,0,2,13,-9,1,Moses Moody,GSW,GSW,LAC,,,17,16,14,4
22023,1630541,22300060,"NOV 28, 2023",GSW @ SAC,L,13,4,4,1.0,3,3,1.0,0,0,0.0,1,0,1,2,0,0,0,1,11,-2,1,Moses Moody,GSW,SAC,GSW,,,14,12,13,3
22023,1630541,22300051,"NOV 24, 2023",GSW vs. SAS,W,17,4,4,1.0,1,1,1.0,0,2,0.0,2,2,4,1,0,0,2,0,9,-6,1,Moses Moody,GSW,GSW,SAS,,,14,13,10,5
22023,1630541,22300236,"NOV 22, 2023",GSW @ PHX,L,23,4,8,0.5,0,1,0.0,0,1,0.0,1,8,9,1,0,1,1,5,8,-3,1,Moses Moody,GSW,PHX,GSW,,,18,17,9,10
22023,1630541,22300224,"NOV 20, 2023",GSW vs. HOU,W,22,3,7,0.429,1,3,0.333,0,0,0.0,2,2,4,0,0,0,0,2,7,3,1,Moses Moody,GSW,GSW,HOU,,,11,11,7,4
22023,1630541,22300207,"NOV 18, 2023",GSW vs. OKC,L,18,1,4,0.25,0,3,0.0,4,4,1.0,2,2,4,1,1,0,2,2,6,-8,1,Moses Moody,GSW,GSW,OKC,,,11,10,7,5
22023,1630541,22300201,"NOV 16, 2023",GSW vs. OKC,L,23,5,11,0.455,2,4,0.5,0,1,0.0,2,2,4,1,0,1,1,1,12,-4,1,Moses Moody,GSW,GSW,OKC,,,17,16,13,5
22023,1630541,22300025,"NOV 14, 2023",GSW vs. MIN,L,14,4,6,0.667,1,2,0.5,2,2,1.0,1,1,2,2,1,0,0,0,11,-12,1,Moses Moody,GSW,GSW,MIN,,,15,13,13,4
22023,1630541,22300186,"NOV 12, 2023",GSW vs. MIN,L,13,1,6,0.167,0,4,0.0,0,0,0.0,1,2,3,0,0,0,1,1,2,-10,1,Moses Moody,GSW,GSW,MIN,,,5,5,2,3
22023,1630541,22300176,"NOV 11, 2023",GSW vs. CLE,L,18,2,4,0.5,2,3,0.667,2,2,1.0,1,4,5,1,0,0,1,3,8,2,1,Moses Moody,GSW,GSW,CLE,,,14,13,9,6
22023,1630541,22300169,"NOV 08, 2023",GSW @ DEN,L,14,4,7,0.571,2,3,0.667,0,0,0.0,0,3,3,1,1,0,0,0,10,6,1,Moses Moody,GSW,DEN,GSW,,,14,13,11,4
22023,1630541,22300145,"NOV 06, 2023",GSW @ DET,W,19,2,6,0.333,0,2,0.0,0,0,0.0,1,1,2,2,3,0,0,0,4,8,1,Moses Moody,GSW,DET,GSW,,,8,6,6,4
22023,1630541,22300142,"NOV 05, 2023",GSW @ CLE,L,14,1,3,0.333,0,2,0.0,1,2,0.5,1,2,3,0,1,0,0,1,3,-1,1,Moses Moody,GSW,CLE,GSW,,,6,6,3,3
22023,1630541,22300005,"NOV 03, 2023",GSW @ OKC,W,18,3,7,0.429,2,5,0.4,0,0,0.0,1,0,1,2,1,0,1,3,8,4,1,Moses Moody,GSW,OKC,GSW,,,11,9,10,3
22023,1630541,22300126,"NOV 01, 2023",GSW vs. SAC,W,15,0,3,0.0,0,2,0.0,1,2,0.5,0,3,3,0,0,1,0,1,1,-5,1,Moses Moody,GSW,GSW,SAC,,,4,4,1,3
22023,1630541,22300108,"OCT 30, 2023",GSW @ NOP,W,21,5,8,0.625,2,5,0.4,1,1,1.0,2,1,3,4,0,0,0,0,13,18,1,Moses Moody,GSW,NOP,GSW,,,20,16,17,7
22023,1630541,22300096,"OCT 29, 2023",GSW @ HOU,W,17,1,6,0.167,1,5,0.2,2,2,1.0,0,3,3,1,0,1,0,1,5,11,1,Moses Moody,GSW,HOU,GSW,,,9,8,6,4
22023,1630541,22300087,"OCT 27, 2023",GSW @ SAC,W,21,4,5,0.8,2,3,0.667,0,0,0.0,0,3,3,1,3,0,1,0,10,11,1,Moses Moody,GSW,SAC,GSW,,,14,13,11,4
22023,1630541,22300062,"OCT 24, 2023",GSW vs. PHX,L,18,4,6,0.667,2,4,0.5,1,2,0.5,1,2,3,0,3,1,1,1,11,-6,1,Moses Moody,GSW,GSW,PHX,,,14,14,11,3
22023,1631111,22300538,"JAN 12, 2024",MIN vs. POR,W,8,2,2,1.0,0,0,0.0,0,0,0.0,0,0,0,0,2,0,0,2,4,-11,1,Wendell Moore Jr.,MIN,MIN,POR,,,4,4,4,0
22023,1631111,22300485,"JAN 05, 2024",MIN @ HOU,W,3,0,0,0.0,0,0,0.0,0,0,0.0,0,2,2,0,0,1,0,0,0,-6,1,Wendell Moore Jr.,MIN,HOU,MIN,,,2,2,0,2
22023,1631111,22300411,"DEC 26, 2023",MIN @ OKC,L,5,0,0,0.0,0,0,0.0,0,0,0.0,0,0,0,0,0,0,1,0,0,-1,1,Wendell Moore Jr.,MIN,OKC,MIN,,,0,0,0,0
22023,1631111,22300367,"DEC 20, 2023",MIN @ PHI,L,2,1,1,1.0,0,0,0.0,0,0,0.0,0,0,0,0,1,0,1,0,2,0,1,Wendell Moore Jr.,MIN,PHI,MIN,,,2,2,2,0
22023,1631111,22300338,"DEC 16, 2023",MIN vs. IND,W,3,0,0,0.0,0,0,0.0,0,0,0.0,0,0,0,0,0,0,0,0,0,-5,1,Wendell Moore Jr.,MIN,MIN,IND,,,0,0,0,0
22023,1631111,22300321,"DEC 14, 2023",MIN @ DAL,W,2,0,0,0.0,0,0,0.0,0,0,0.0,0,0,0,0,0,0,0,1,0,-1,1,Wendell Moore Jr.,MIN,DAL,MIN,,,0,0,0,0
22023,1631111,22300301,"DEC 11, 2023",MIN @ NOP,L,2,0,0,0.0,0,0,0.0,0,0,0.0,0,1,1,0,0,0,0,0,0,1,1,Wendell Moore Jr.,MIN,NOP,MIN,,,1,1,0,1
22023,1631111,22301221,"DEC 08, 2023",MIN @ MEM,W,3,0,1,0.0,0,1,0.0,0,0,0.0,0,0,0,1,0,0,0,0,0,1,1,Wendell Moore Jr.,MIN,MEM,MIN,,,1,0,1,1
22023,1631111,22300232,"NOV 22, 2023",MIN vs. PHI,W,2,0,1,0.0,0,1,0.0,0,0,0.0,0,0,0,0,0,0,0,0,0,-1,1,Wendell Moore Jr.,MIN,MIN,PHI,,,0,0,0,0
22023,1629630,22300491,"JAN 05, 2024",MEM @ LAL,W,35,7,17,0.412,3,7,0.429,4,5,0.8,2,5,7,7,1,1,2,3,21,15,1,Ja Morant,MEM,LAL,MEM,,,35,28,28,14
22023,1629630,22300470,"JAN 03, 2024",MEM vs. TOR,L,35,10,18,0.556,3,6,0.5,5,6,0.833,1,7,8,9,1,0,2,1,28,-7,1,Ja Morant,MEM,MEM,TOR,,,45,36,37,17
22023,1629630,22300460,"JAN 02, 2024",MEM vs. SAS,W,35,7,15,0.467,3,9,0.333,9,12,0.75,0,5,5,10,1,0,4,3,26,-1,1,Ja Morant,MEM,MEM,SAS,,,41,31,36,15
22023,1629630,22300449,"DEC 31, 2023",MEM vs. SAC,L,31,4,12,0.333,2,4,0.5,7,8,0.875,0,3,3,3,0,0,0,3,17,-9,1,Ja Morant,MEM,MEM,SAC,,,23,20,20,6
22023,1629630,22300438,"DEC 29, 2023",MEM @ LAC,L,37,7,19,0.368,0,7,0.0,5,6,0.833,0,6,6,10,0,0,3,4,19,-19,1,Ja Morant,MEM,LAC,MEM,,,35,25,29,16
22023,1629630,22300410,"DEC 26, 2023",MEM @ NOP,W,40,12,24,0.5,1,7,0.143,6,8,0.75,0,4,4,7,1,2,6,2,31,3,1,Ja Morant,MEM,NOP,MEM,,,42,35,38,11
22023,1629630,22300393,"DEC 23, 2023",MEM @ ATL,W,36,14,25,0.56,1,3,0.333,1,1,1.0,0,6,6,11,1,1,3,1,30,2,1,Ja Morant,MEM,ATL,MEM,,,47,36,41,17
22023,1629630,22300377,"DEC 21, 2023",MEM vs. IND,W,34,7,16,0.438,1,3,0.333,5,6,0.833,0,5,5,8,0,0,2,0,20,15,1,Ja Morant,MEM,MEM,IND,,,33,25,28,13
22023,1629630,22300360,"DEC 19, 2023",MEM @ NOP,W,35,12,24,0.5,0,5,0.0,10,12,0.833,3,3,6,8,2,1,5,2,34,12,1,Ja Morant,MEM,NOP,MEM,,,48,40,42,14
22023,202693,22300530,"JAN 11, 2024",DAL vs. NYK,W,4,0,1,0.0,0,0,0.0,2,2,1.0,0,0,0,0,0,0,0,0,2,6,1,Markieff Morris,DAL,DAL,NYK,,,2,2,2,0
22023,202693,22300515,"JAN 09, 2024",DAL vs. MEM,L,6,0,0,0.0,0,0,0.0,0,0,0.0,0,1,1,0,0,0,0,0,0,-2,1,Markieff Morris,DAL,DAL,MEM,,,1,1,0,1
22023,202693,22300472,"JAN 03, 2024",DAL vs. POR,W,12,1,3,0.333,1,1,1.0,0,0,0.0,0,3,3,1,1,0,1,2,3,1,1,Markieff Morris,DAL,DAL,POR,,,7,6,4,4
22023,202693,22300423,"DEC 28, 2023",DAL @ MIN,L,3,0,1,0.0,0,0,0.0,0,0,0.0,0,0,0,0,0,0,1,0,0,-7,1,Markieff Morris,DAL,MIN,DAL,,,0,0,0,0
22023,202693,22300385,"DEC 22, 2023",DAL @ HOU,L,12,1,4,0.25,1,4,0.25,1,2,0.5,0,2,2,0,0,0,0,0,4,-13,1,Markieff Morris,DAL,HOU,DAL,,,6,6,4,2
22023,202693,22300372,"DEC 20, 2023",DAL vs. LAC,L,5,0,1,0.0,0,0,0.0,0,0,0.0,1,1,2,0,0,0,0,1,0,-5,1,Markieff Morris,DAL,DAL,LAC,,,2,2,0,2
22023,202693,22300356,"DEC 18, 2023",DAL @ DEN,L,13,1,3,0.333,0,2,0.0,0,0,0.0,0,3,3,0,0,0,0,1,2,-11,1,Markieff Morris,DAL,DEN,DAL,,,5,5,2,3
22023,202693,22300341,"DEC 16, 2023",DAL @ POR,W,20,4,9,0.444,2,5,0.4,0,0,0.0,0,5,5,4,1,0,2,0,10,8,1,Markieff Morris,DAL,POR,DAL,,,19,15,14,9
22023,202693,22300321,"DEC 14, 2023",DAL vs. MIN,L,13,1,1,1.0,0,0,0.0,0,0,0.0,0,1,1,1,0,0,0,3,2,-6,1,Markieff Morris,DAL,DAL,MIN,,,4,3,3,2
22023,202693,22300306,"DEC 12, 2023",DAL vs. LAL,W,6,0,2,0.0,0,2,0.0,0,0,0.0,0,2,2,1,1,0,0,0,0,-10,1,Markieff Morris,DAL,DAL,LAL,,,3,2,1,3
22023,202693,22300299,"DEC 11, 2023",DAL @ MEM,W,21,2,5,0.4,2,4,0.5,0,0,0.0,1,2,3,2,2,1,2,1,6,5,1,Markieff Morris,DAL,MEM,DAL,,,11,9,8,5
22023,202693,22301226,"DEC 08, 2023",DAL @ POR,W,7,1,1,1.0,0,0,0.0,0,0,0.0,0,1,1,0,0,0,3,1,2,1,1,Markieff Morris,DAL,POR,DAL,,,3,3,2,1
22023,202693,22301213,"DEC 06, 2023",DAL vs. UTA,W,6,1,3,0.333,1,2,0.5,0,0,0.0,0,1,1,0,0,0,0,0,3,4,1,Markieff Morris,DAL,DAL,UTA,,,4,4,3,1
22023,202693,22300277,"DEC 01, 2023",DAL vs. MEM,L,14,2,7,0.286,2,4,0.5,0,0,0.0,2,1,3,1,0,0,0,2,6,-11,1,Markieff Morris,DAL,DAL,MEM,,,10,9,7,4
22023,202693,22300212,"NOV 19, 2023",DAL vs. SAC,L,5,1,4,0.25,0,2,0.0,0,0,0.0,0,0,0,1,0,0,0,0,2,5,1,Markieff Morris,DAL,DAL,SAC,,,3,2,3,1
22023,202693,22300183,"NOV 12, 2023",DAL @ NOP,W,4,0,2,0.0,0,2,0.0,0,0,0.0,0,1,1,0,0,0,0,0,0,-8,1,Markieff Morris,DAL,NOP,DAL,,,1,1,0,1
22023,202694,22300555,"JAN 15, 2024",PHI vs. HOU,W,14,3,3,1.0,2,2,1.0,0,0,0.0,0,5,5,1,0,0,0,1,8,26,1,Marcus Morris Sr.,PHI,PHI,HOU,,,14,13,9,6
22023,202694,22300532,"JAN 12, 2024",PHI vs. SAC,W,17,0,5,0.0,0,0,0.0,0,0,0.0,0,4,4,0,0,0,1,0,0,2,1,Marcus Morris Sr.,PHI,PHI,SAC,,,4,4,0,4
22023,202694,22300521,"JAN 10, 2024",PHI @ ATL,L,26,4,9,0.444,3,8,0.375,6,6,1.0,1,3,4,1,0,0,1,3,17,-10,1,Marcus Morris Sr.,PHI,ATL,PHI,,,22,21,18,5
22023,202694,22300495,"JAN 06, 2024",PHI vs. UTA,L,28,5,12,0.417,3,7,0.429,2,2,1.0,2,4,6,1,2,2,0,2,15,-2,1,Marcus Morris Sr.,PHI,PHI,UTA,,,22,21,16,7
22023,202694,22300483,"JAN 05, 2024",PHI vs. NYK,L,16,0,1,0.0,0,1,0.0,0,0,0.0,0,0,0,1,0,0,0,0,0,-24,1,Marcus Morris Sr.,PHI,PHI,NYK,,,1,0,1,1
22023,202694,22300459,"JAN 02, 2024",PHI vs. CHI,W,11,0,3,0.0,0,0,0.0,2,4,0.5,1,1,2,0,1,0,1,0,2,-7,1,Marcus Morris Sr.,PHI,PHI,CHI,,,4,4,2,2
22023,202694,22300442,"DEC 30, 2023",PHI @ CHI,L,17,2,5,0.4,0,2,0.0,0,0,0.0,0,2,2,1,0,0,1,3,4,-9,1,Marcus Morris Sr.,PHI,CHI,PHI,,,7,6,5,3
22023,202694,22300434,"DEC 29, 2023",PHI @ HOU,W,27,4,8,0.5,2,5,0.4,4,5,0.8,1,4,5,1,1,1,1,5,14,10,1,Marcus Morris Sr.,PHI,HOU,PHI,,,20,19,15,6
22023,202694,22300415,"DEC 27, 2023",PHI @ ORL,W,22,6,14,0.429,0,3,0.0,2,3,0.667,0,3,3,0,0,0,0,3,14,4,1,Marcus Morris Sr.,PHI,ORL,PHI,,,17,17,14,3
22023,202694,22300404,"DEC 25, 2023",PHI @ MIA,L,11,0,4,0.0,0,3,0.0,0,0,0.0,0,1,1,0,0,0,0,1,0,-17,1,Marcus Morris Sr.,PHI,MIA,PHI,,,1,1,0,1
22023,202694,22300382,"DEC 22, 2023",PHI vs. TOR,W,31,2,3,0.667,1,2,0.5,2,2,1.0,1,3,4,5,0,0,0,3,7,4,1,Marcus Morris Sr.,PHI,PHI,TOR,,,16,11,12,9
22023,202694,22300367,"DEC 20, 2023",PHI vs. MIN,W,25,2,4,0.5,1,2,0.5,0,0,0.0,0,1,1,0,1,0,0,2,5,23,1,Marcus Morris Sr.,PHI,PHI,MIN,,,6,6,5,1
22023,202694,22300335,"DEC 16, 2023",PHI @ CHA,W,16,3,7,0.429,0,2,0.0,0,0,0.0,0,4,4,1,0,0,0,1,6,11,1,Marcus Morris Sr.,PHI,CHA,PHI,,,11,10,7,5
22023,202694,22300327,"DEC 15, 2023",PHI vs. DET,W,15,5,8,0.625,5,5,1.0,0,0,0.0,0,2,2,1,1,0,1,1,15,12,1,Marcus Morris Sr.,PHI,PHI,DET,,,18,17,16,3
22023,202694,22300310,"DEC 13, 2023",PHI @ DET,W,16,2,2,1.0,0,0,0.0,0,0,0.0,1,7,8,2,0,1,0,2,4,6,1,Marcus Morris Sr.,PHI,DET,PHI,,,14,12,6,10
22023,202694,22300295,"DEC 11, 2023",PHI vs. WAS,W,12,5,6,0.833,2,3,0.667,0,0,0.0,0,2,2,1,1,0,0,3,12,24,1,Marcus Morris Sr.,PHI,PHI,WAS,,,15,14,13,3
22023,202694,22301218,"DEC 08, 2023",PHI vs. ATL,W,16,1,1,1.0,1,1,1.0,0,0,0.0,0,3,3,1,0,1,0,3,3,3,1,Marcus Morris Sr.,PHI,PHI,ATL,,,7,6,4,4
22023,202694,22301208,"DEC 06, 2023",PHI @ WAS,W,15,1,4,0.25,0,1,0.0,2,2,1.0,1,2,3,0,0,0,0,0,4,-8,1,Marcus Morris Sr.,PHI,WAS,PHI,,,7,7,4,3
22023,202694,22300275,"DEC 01, 2023",PHI @ BOS,L,28,5,12,0.417,2,3,0.667,1,1,1.0,1,6,7,1,1,1,0,1,13,-2,1,Marcus Morris Sr.,PHI,BOS,PHI,,,21,20,14,8
22023,202694,22300262,"NOV 29, 2023",PHI @ NOP,L,17,3,7,0.429,1,3,0.333,0,0,0.0,1,2,3,2,1,1,1,4,7,-17,1,Marcus Morris Sr.,PHI,NOP,PHI,,,12,10,9,5
22023,202694,22300255,"NOV 27, 2023",PHI vs. LAL,W,20,6,8,0.75,4,5,0.8,0,0,0.0,0,1,1,0,1,0,0,2,16,24,1,Marcus Morris Sr.,PHI,PHI,LAL,,,17,17,16,1
22023,202694,22300239,"NOV 25, 2023",PHI @ OKC,W,15,0,2,0.0,0,2,0.0,0,0,0.0,1,2,3,0,0,0,1,3,0,-10,1,Marcus Morris Sr.,PHI,OKC,PHI,,,3,3,0,3
22023,202694,22300232,"NOV 22, 2023",PHI @ MIN,L,16,6,12,0.5,3,5,0.6,1,1,1.0,2,2,4,2,1,2,2,5,16,-7,1,Marcus Morris Sr.,PHI,MIN,PHI,,,22,20,18,6
22023,202694,22300040,"NOV 21, 2023",PHI vs. CLE,L,3,0,0,0.0,0,0,0.0,0,0,0.0,0,0,0,0,0,0,0,0,0,-1,1,Marcus Morris Sr.,PHI,PHI,CLE,,,0,0,0,0
22023,202694,22300208,"NOV 19, 2023",PHI @ BKN,W,6,1,1,1.0,1,1,1.0,0,0,0.0,0,1,1,0,0,0,0,0,3,2,1,Marcus Morris Sr.,PHI,BKN,PHI,,,4,4,3,1
22023,202694,22300029,"NOV 17, 2023",PHI @ ATL,W,2,0,0,0.0,0,0,0.0,0,0,0.0,0,1,1,0,0,0,0,1,0,2,1,Marcus Morris Sr.,PHI,ATL,PHI,,,1,1,0,1
22023,202694,22300194,"NOV 15, 2023",PHI vs. BOS,L,8,0,3,0.0,0,2,0.0,0,0,0.0,0,0,0,0,0,0,1,0,0,-16,1,Marcus Morris Sr.,PHI,PHI,BOS,,,0,0,0,0
22023,202694,22300019,"NOV 14, 2023",PHI vs. IND,L,18,1,4,0.25,0,2,0.0,0,0,0.0,0,3,3,1,0,0,0,1,2,-5,1,Marcus Morris Sr.,PHI,PHI,IND,,,6,5,3,4
22023,202694,22300008,"NOV 10, 2023",PHI @ DET,W,6,0,0,0.0,0,0,0.0,0,0,0.0,0,1,1,0,0,0,0,2,0,-10,1,Marcus Morris Sr.,PHI,DET,PHI,,,1,1,0,1
22023,202694,22300148,"NOV 06, 2023",PHI vs. WAS,W,6,1,2,0.5,0,0,0.0,1,1,1.0,0,1,1,0,0,1,0,0,3,7,1,Marcus Morris Sr.,PHI,PHI,WAS,,,4,4,3,1
22023,1630530,22300556,"JAN 15, 2024",NOP @ DAL,L,22,2,5,0.4,1,4,0.25,9,12,0.75,0,3,3,0,1,0,0,0,14,-10,1,Trey Murphy III,NOP,DAL,NOP,,,17,17,14,3
22023,1630530,22300539,"JAN 12, 2024",NOP @ DEN,L,28,2,9,0.222,2,8,0.25,0,0,0.0,0,3,3,4,2,0,0,0,6,-18,1,Trey Murphy III,NOP,DEN,NOP,,,13,9,10,7
22023,1630530,22300525,"JAN 10, 2024",NOP @ GSW,W,24,6,13,0.462,4,11,0.364,0,0,0.0,3,1,4,6,0,1,0,2,16,38,1,Trey Murphy III,NOP,GSW,NOP,,,26,20,22,10
22023,1630530,22300500,"JAN 07, 2024",NOP @ SAC,W,24,4,7,0.571,3,6,0.5,0,0,0.0,0,2,2,5,1,0,1,1,11,19,1,Trey Murphy III,NOP,SAC,NOP,,,18,13,16,7
22023,1630530,22300486,"JAN 05, 2024",NOP vs. LAC,L,17,1,9,0.111,1,6,0.167,0,0,0.0,0,2,2,1,0,1,0,0,3,-15,1,Trey Murphy III,NOP,NOP,LAC,,,6,5,4,3
22023,1630530,22300424,"DEC 28, 2023",NOP vs. UTA,W,23,2,8,0.25,2,7,0.286,0,0,0.0,0,1,1,2,0,0,1,2,6,-1,1,Trey Murphy III,NOP,NOP,UTA,,,9,7,8,3
22023,1630530,22300410,"DEC 26, 2023",NOP vs. MEM,L,36,3,8,0.375,3,6,0.5,1,2,0.5,2,5,7,1,2,0,2,2,10,10,1,Trey Murphy III,NOP,NOP,MEM,,,18,17,11,8
22023,1630530,22300392,"DEC 23, 2023",NOP vs. HOU,L,34,4,11,0.364,3,7,0.429,3,3,1.0,1,5,6,0,2,0,1,2,14,4,1,Trey Murphy III,NOP,NOP,HOU,,,20,20,14,6
22023,1630530,22300375,"DEC 21, 2023",NOP @ CLE,W,28,10,16,0.625,6,10,0.6,2,2,1.0,0,4,4,3,1,1,1,1,28,20,1,Trey Murphy III,NOP,CLE,NOP,,,35,32,31,7
22023,1630530,22300360,"DEC 19, 2023",NOP vs. MEM,L,21,2,6,0.333,0,1,0.0,3,3,1.0,0,3,3,0,0,0,1,2,7,-6,1,Trey Murphy III,NOP,NOP,MEM,,,10,10,7,3
22023,1630530,22300345,"DEC 17, 2023",NOP @ SAS,W,25,5,10,0.5,2,5,0.4,2,3,0.667,0,4,4,4,1,0,0,1,14,27,1,Trey Murphy III,NOP,SAS,NOP,,,22,18,18,8
22023,1630530,22300326,"DEC 15, 2023",NOP @ CHA,W,25,3,7,0.429,1,5,0.2,6,6,1.0,0,6,6,2,0,0,0,2,13,8,1,Trey Murphy III,NOP,CHA,NOP,,,21,19,15,8
22023,1630530,22300311,"DEC 13, 2023",NOP @ WAS,W,33,7,10,0.7,6,7,0.857,7,8,0.875,0,6,6,4,2,1,0,0,27,43,1,Trey Murphy III,NOP,WAS,NOP,,,37,33,31,10
22023,1630530,22300301,"DEC 11, 2023",NOP vs. MIN,W,24,4,8,0.5,1,5,0.2,1,2,0.5,0,3,3,1,0,0,2,0,10,-4,1,Trey Murphy III,NOP,NOP,MIN,,,14,13,11,4
22023,1630530,22301230,"DEC 07, 2023",NOP @ LAL,L,22,5,13,0.385,2,7,0.286,2,2,1.0,0,3,3,1,0,0,0,1,14,-25,1,Trey Murphy III,NOP,LAL,NOP,,,18,17,15,4
22023,1630530,22301204,"DEC 04, 2023",NOP @ SAC,W,30,6,13,0.462,3,8,0.375,1,2,0.5,0,2,2,1,0,1,0,1,16,24,1,Trey Murphy III,NOP,SAC,NOP,,,19,18,17,3
22023,1630530,22300278,"DEC 01, 2023",NOP vs. SAS,W,22,7,13,0.538,4,10,0.4,0,0,0.0,1,2,3,1,1,1,0,0,18,9,1,Trey Murphy III,NOP,NOP,SAS,,,22,21,19,4
22023,1627749,22300559,"JAN 15, 2024",ATL vs. SAS,W,33,6,15,0.4,1,6,0.167,0,0,0.0,0,13,13,0,0,1,2,3,13,0,1,Dejounte Murray,ATL,ATL,SAS,,,26,26,13,13
22023,1627749,22300543,"JAN 13, 2024",ATL vs. WAS,L,31,4,15,0.267,1,6,0.167,4,4,1.0,0,5,5,3,0,0,2,1,13,-22,1,Dejounte Murray,ATL,ATL,WAS,,,21,18,16,8
22023,1627749,22300533,"JAN 12, 2024",ATL vs. IND,L,32,13,18,0.722,3,6,0.5,0,0,0.0,0,4,4,4,3,0,3,2,29,-1,1,Dejounte Murray,ATL,ATL,IND,,,37,33,33,8
22023,1627749,22300521,"JAN 10, 2024",ATL vs. PHI,W,38,8,18,0.444,5,7,0.714,4,4,1.0,0,5,5,5,1,0,1,2,25,1,1,Dejounte Murray,ATL,ATL,PHI,,,35,30,30,10
22023,1627749,22300499,"JAN 07, 2024",ATL @ ORL,L,40,9,20,0.45,0,2,0.0,6,10,0.6,0,6,6,2,0,0,3,2,24,-14,1,Dejounte Murray,ATL,ORL,ATL,,,32,30,26,8
22023,1627749,22300480,"JAN 05, 2024",ATL @ IND,L,34,13,19,0.684,2,3,0.667,2,2,1.0,0,1,1,2,0,0,1,0,30,-20,1,Dejounte Murray,ATL,IND,ATL,,,33,31,32,3
22023,1627749,22300467,"JAN 03, 2024",ATL vs. OKC,W,35,8,18,0.444,2,5,0.4,4,4,1.0,2,4,6,6,0,0,3,2,22,4,1,Dejounte Murray,ATL,ATL,OKC,,,34,28,28,12
22023,1627749,22300445,"DEC 31, 2023",ATL @ WAS,W,34,13,21,0.619,3,6,0.5,3,5,0.6,1,5,6,3,0,0,1,1,32,0,1,Dejounte Murray,ATL,WAS,ATL,,,41,38,35,9
22023,1627749,22300431,"DEC 29, 2023",ATL vs. SAC,L,37,7,20,0.35,4,8,0.5,0,0,0.0,1,5,6,3,1,0,3,3,18,5,1,Dejounte Murray,ATL,ATL,SAC,,,27,24,21,9
22023,1627749,22300408,"DEC 26, 2023",ATL @ CHI,L,34,6,15,0.4,2,9,0.222,3,4,0.75,0,6,6,4,2,1,3,4,17,0,1,Dejounte Murray,ATL,CHI,ATL,,,27,23,21,10
22023,1627749,22300393,"DEC 23, 2023",ATL vs. MEM,L,35,10,15,0.667,4,6,0.667,2,2,1.0,1,3,4,4,2,0,3,4,26,-4,1,Dejounte Murray,ATL,ATL,MEM,,,34,30,30,8
22023,1627749,22300384,"DEC 22, 2023",ATL @ MIA,L,34,10,20,0.5,3,9,0.333,1,3,0.333,1,7,8,6,3,0,2,0,24,-3,1,Dejounte Murray,ATL,MIA,ATL,,,38,32,30,14
22023,1627749,22300371,"DEC 20, 2023",ATL @ HOU,W,35,7,15,0.467,3,8,0.375,4,5,0.8,2,1,3,5,0,1,3,2,21,-8,1,Dejounte Murray,ATL,HOU,ATL,,,29,24,26,8
22023,1627749,22300352,"DEC 18, 2023",ATL vs. DET,W,33,8,13,0.615,3,5,0.6,1,2,0.5,0,3,3,3,1,1,1,2,20,2,1,Dejounte Murray,ATL,ATL,DET,,,26,23,23,6
22023,1627749,22300336,"DEC 16, 2023",ATL @ CLE,L,37,8,19,0.421,0,5,0.0,5,6,0.833,0,3,3,6,1,1,0,2,21,-3,1,Dejounte Murray,ATL,CLE,ATL,,,30,24,27,9
22023,1627749,22300330,"DEC 15, 2023",ATL @ TOR,W,33,8,18,0.444,1,6,0.167,0,0,0.0,1,6,7,9,1,0,1,3,17,18,1,Dejounte Murray,ATL,TOR,ATL,,,33,24,26,16
22023,1627749,22300313,"DEC 13, 2023",ATL @ TOR,L,34,8,17,0.471,4,9,0.444,0,1,0.0,0,3,3,5,0,2,0,2,20,-17,1,Dejounte Murray,ATL,TOR,ATL,,,28,23,25,8
22023,1627749,22300296,"DEC 11, 2023",ATL vs. DEN,L,38,8,22,0.364,3,8,0.375,2,2,1.0,4,2,6,3,1,0,2,2,21,-6,1,Dejounte Murray,ATL,ATL,DEN,,,30,27,24,9
22023,1627749,22301218,"DEC 08, 2023",ATL @ PHI,L,36,7,17,0.412,2,5,0.4,4,4,1.0,1,3,4,9,1,0,4,1,20,-7,1,Dejounte Murray,ATL,PHI,ATL,,,33,24,29,13
22023,1627749,22301209,"DEC 06, 2023",ATL vs. BKN,L,32,6,16,0.375,1,5,0.2,0,0,0.0,0,10,10,9,1,0,0,3,13,2,1,Dejounte Murray,ATL,ATL,BKN,,,32,23,22,19
22023,1627749,22300286,"DEC 02, 2023",ATL @ MIL,L,34,12,19,0.632,4,6,0.667,2,2,1.0,0,2,2,3,2,0,2,0,30,-7,1,Dejounte Murray,ATL,MIL,ATL,,,35,32,33,5
22023,1627749,22300272,"NOV 30, 2023",ATL @ SAS,W,35,10,21,0.476,2,4,0.5,2,2,1.0,0,3,3,2,5,0,0,1,24,-1,1,Dejounte Murray,ATL,SAS,ATL,,,29,27,26,5
22023,1627749,22300055,"NOV 28, 2023",ATL @ CLE,L,31,5,14,0.357,3,7,0.429,0,0,0.0,1,2,3,1,2,1,3,0,13,-21,1,Dejounte Murray,ATL,CLE,ATL,,,17,16,14,4
22023,1627749,22300246,"NOV 26, 2023",ATL @ BOS,L,34,2,13,0.154,0,6,0.0,2,2,1.0,2,2,4,3,0,0,3,1,6,-7,1,Dejounte Murray,ATL,BOS,ATL,,,13,10,9,7
22023,1627749,22300241,"NOV 25, 2023",ATL @ WAS,W,27,4,14,0.286,1,6,0.167,2,2,1.0,0,5,5,10,4,0,0,0,11,19,1,Dejounte Murray,ATL,WAS,ATL,,,26,16,21,15
22023,1627749,22300227,"NOV 22, 2023",ATL vs. BKN,W,39,6,21,0.286,3,8,0.375,5,5,1.0,3,3,6,8,2,0,1,4,20,0,1,Dejounte Murray,ATL,ATL,BKN,,,34,26,28,14
22023,1627749,22300039,"NOV 21, 2023",ATL vs. IND,L,34,11,19,0.579,4,6,0.667,2,2,1.0,1,2,3,5,2,0,5,3,28,-7,1,Dejounte Murray,ATL,ATL,IND,,,36,31,33,8
22023,1627749,22300029,"NOV 17, 2023",ATL vs. PHI,L,35,5,16,0.313,3,7,0.429,0,0,0.0,0,1,1,3,1,0,3,2,13,-18,1,Dejounte Murray,ATL,ATL,PHI,,,17,14,16,4
22023,1627749,22300193,"NOV 15, 2023",ATL vs. NYK,L,32,6,12,0.5,0,3,0.0,1,3,0.333,0,5,5,2,1,0,1,1,13,-16,1,Dejounte Murray,ATL,ATL,NYK,,,20,18,15,7
22023,1627749,22300018,"NOV 14, 2023",ATL @ DET,W,37,11,21,0.524,1,4,0.25,9,9,1.0,0,5,5,10,3,0,2,2,32,9,1,Dejounte Murray,ATL,DET,ATL,,,47,37,42,15
22023,1627749,22300175,"NOV 11, 2023",ATL vs. MIA,L,36,9,16,0.563,5,9,0.556,0,1,0.0,0,5,5,5,3,1,3,1,23,-9,1,Dejounte Murray,ATL,ATL,MIA,,,33,28,28,10
22023,1627749,22300172,"NOV 09, 2023",ATL @ ORL,W,33,6,15,0.4,3,7,0.429,1,2,0.5,0,3,3,2,2,0,4,2,16,5,1,Dejounte Murray,ATL,ORL,ATL,,,21,19,18,5
22023,1627749,22300155,"NOV 06, 2023",ATL @ OKC,L,33,7,16,0.438,6,9,0.667,9,10,0.9,2,2,4,6,1,0,3,4,29,-3,1,Dejounte Murray,ATL,OKC,ATL,,,39,33,35,10
22023,1627749,22300135,"NOV 04, 2023",ATL @ NOP,W,37,8,20,0.4,2,9,0.222,2,2,1.0,2,6,8,7,0,0,3,1,20,13,1,Dejounte Murray,ATL,NOP,ATL,,,35,28,27,15
22023,1627749,22300117,"NOV 01, 2023",ATL vs. WAS,W,34,10,15,0.667,3,5,0.6,1,2,0.5,0,4,4,8,1,1,4,2,24,15,1,Dejounte Murray,ATL,ATL,WAS,,,36,28,32,12
22023,1627749,22300104,"OCT 30, 2023",ATL vs. MIN,W,39,17,24,0.708,3,5,0.6,4,4,1.0,0,7,7,5,2,0,3,1,41,25,1,Dejounte Murray,ATL,ATL,MIN,,,53,48,46,12
22023,1627749,22300097,"OCT 29, 2023",ATL @ MIL,W,30,6,12,0.5,1,5,0.2,2,2,1.0,0,1,1,5,2,1,3,0,15,26,1,Dejounte Murray,ATL,MIL,ATL,,,21,16,20,6
22023,1627749,22300079,"OCT 27, 2023",ATL vs. NYK,L,35,8,17,0.471,0,3,0.0,2,3,0.667,2,5,7,6,1,1,1,1,18,-6,1,Dejounte Murray,ATL,ATL,NYK,,,31,25,24,13
22023,1627749,22300063,"OCT 25, 2023",ATL @ CHA,L,33,3,14,0.214,0,3,0.0,5,6,0.833,0,2,2,6,0,0,1,0,11,-15,1,Dejounte Murray,ATL,CHA,ATL,,,19,13,17,8
22023,1627750,22300550,"JAN 14, 2024",DEN vs. IND,W,36,11,18,0.611,1,4,0.25,2,4,0.5,0,1,1,8,1,0,5,3,25,-5,1,Jamal Murray,DEN,DEN,IND,23.5,Points,34,26,33,9
22023,1627750,22300550,"JAN 14, 2024",DEN vs. IND,W,36,11,18,0.611,1,4,0.25,2,4,0.5,0,1,1,8,1,0,5,3,25,-5,1,Jamal Murray,DEN,DEN,IND,3.5,Rebounds,34,26,33,9
22023,1627750,22300550,"JAN 14, 2024",DEN vs. IND,W,36,11,18,0.611,1,4,0.25,2,4,0.5,0,1,1,8,1,0,5,3,25,-5,1,Jamal Murray,DEN,DEN,IND,34.5,Pts+Rebs+Asts,34,26,33,9
22023,1627750,22300550,"JAN 14, 2024",DEN vs. IND,W,36,11,18,0.611,1,4,0.25,2,4,0.5,0,1,1,8,1,0,5,3,25,-5,1,Jamal Murray,DEN,DEN,IND,6.5,Assists,34,26,33,9
22023,1627750,22300550,"JAN 14, 2024",DEN vs. IND,W,36,11,18,0.611,1,4,0.25,2,4,0.5,0,1,1,8,1,0,5,3,25,-5,1,Jamal Murray,DEN,DEN,IND,27.5,Pts+Rebs,34,26,33,9
22023,1627750,22300550,"JAN 14, 2024",DEN vs. IND,W,36,11,18,0.611,1,4,0.25,2,4,0.5,0,1,1,8,1,0,5,3,25,-5,1,Jamal Murray,DEN,DEN,IND,30.5,Pts+Asts,34,26,33,9
22023,1627750,22300550,"JAN 14, 2024",DEN vs. IND,W,36,11,18,0.611,1,4,0.25,2,4,0.5,0,1,1,8,1,0,5,3,25,-5,1,Jamal Murray,DEN,DEN,IND,10.5,Rebs+Asts,34,26,33,9
22023,1627750,22300550,"JAN 14, 2024",DEN vs. IND,W,36,11,18,0.611,1,4,0.25,2,4,0.5,0,1,1,8,1,0,5,3,25,-5,1,Jamal Murray,DEN,DEN,IND,1.5,Blks+Stls,34,26,33,9
22023,1627750,22300550,"JAN 14, 2024",DEN vs. IND,W,36,11,18,0.611,1,4,0.25,2,4,0.5,0,1,1,8,1,0,5,3,25,-5,1,Jamal Murray,DEN,DEN,IND,2.5,Turnovers,34,26,33,9
22023,1627750,22300539,"JAN 12, 2024",DEN vs. NOP,W,34,8,15,0.533,3,5,0.6,1,1,1.0,0,2,2,9,0,0,2,3,20,18,1,Jamal Murray,DEN,DEN,NOP,23.5,Points,31,22,29,11
22023,1627750,22300539,"JAN 12, 2024",DEN vs. NOP,W,34,8,15,0.533,3,5,0.6,1,1,1.0,0,2,2,9,0,0,2,3,20,18,1,Jamal Murray,DEN,DEN,NOP,3.5,Rebounds,31,22,29,11
22023,1627750,22300539,"JAN 12, 2024",DEN vs. NOP,W,34,8,15,0.533,3,5,0.6,1,1,1.0,0,2,2,9,0,0,2,3,20,18,1,Jamal Murray,DEN,DEN,NOP,34.5,Pts+Rebs+Asts,31,22,29,11
22023,1627750,22300539,"JAN 12, 2024",DEN vs. NOP,W,34,8,15,0.533,3,5,0.6,1,1,1.0,0,2,2,9,0,0,2,3,20,18,1,Jamal Murray,DEN,DEN,NOP,6.5,Assists,31,22,29,11
22023,1627750,22300539,"JAN 12, 2024",DEN vs. NOP,W,34,8,15,0.533,3,5,0.6,1,1,1.0,0,2,2,9,0,0,2,3,20,18,1,Jamal Murray,DEN,DEN,NOP,27.5,Pts+Rebs,31,22,29,11
22023,1627750,22300539,"JAN 12, 2024",DEN vs. NOP,W,34,8,15,0.533,3,5,0.6,1,1,1.0,0,2,2,9,0,0,2,3,20,18,1,Jamal Murray,DEN,DEN,NOP,30.5,Pts+Asts,31,22,29,11
22023,1627750,22300539,"JAN 12, 2024",DEN vs. NOP,W,34,8,15,0.533,3,5,0.6,1,1,1.0,0,2,2,9,0,0,2,3,20,18,1,Jamal Murray,DEN,DEN,NOP,10.5,Rebs+Asts,31,22,29,11
22023,1627750,22300539,"JAN 12, 2024",DEN vs. NOP,W,34,8,15,0.533,3,5,0.6,1,1,1.0,0,2,2,9,0,0,2,3,20,18,1,Jamal Murray,DEN,DEN,NOP,1.5,Blks+Stls,31,22,29,11
22023,1627750,22300539,"JAN 12, 2024",DEN vs. NOP,W,34,8,15,0.533,3,5,0.6,1,1,1.0,0,2,2,9,0,0,2,3,20,18,1,Jamal Murray,DEN,DEN,NOP,2.5,Turnovers,31,22,29,11
22023,1627750,22300524,"JAN 10, 2024",DEN @ UTA,L,31,6,15,0.4,1,5,0.2,4,4,1.0,0,1,1,6,1,2,4,3,17,-27,1,Jamal Murray,DEN,UTA,DEN,23.5,Points,24,18,23,7
22023,1627750,22300524,"JAN 10, 2024",DEN @ UTA,L,31,6,15,0.4,1,5,0.2,4,4,1.0,0,1,1,6,1,2,4,3,17,-27,1,Jamal Murray,DEN,UTA,DEN,3.5,Rebounds,24,18,23,7
22023,1627750,22300524,"JAN 10, 2024",DEN @ UTA,L,31,6,15,0.4,1,5,0.2,4,4,1.0,0,1,1,6,1,2,4,3,17,-27,1,Jamal Murray,DEN,UTA,DEN,34.5,Pts+Rebs+Asts,24,18,23,7
22023,1627750,22300524,"JAN 10, 2024",DEN @ UTA,L,31,6,15,0.4,1,5,0.2,4,4,1.0,0,1,1,6,1,2,4,3,17,-27,1,Jamal Murray,DEN,UTA,DEN,6.5,Assists,24,18,23,7
22023,1627750,22300524,"JAN 10, 2024",DEN @ UTA,L,31,6,15,0.4,1,5,0.2,4,4,1.0,0,1,1,6,1,2,4,3,17,-27,1,Jamal Murray,DEN,UTA,DEN,27.5,Pts+Rebs,24,18,23,7
22023,1627750,22300524,"JAN 10, 2024",DEN @ UTA,L,31,6,15,0.4,1,5,0.2,4,4,1.0,0,1,1,6,1,2,4,3,17,-27,1,Jamal Murray,DEN,UTA,DEN,30.5,Pts+Asts,24,18,23,7
22023,1627750,22300524,"JAN 10, 2024",DEN @ UTA,L,31,6,15,0.4,1,5,0.2,4,4,1.0,0,1,1,6,1,2,4,3,17,-27,1,Jamal Murray,DEN,UTA,DEN,10.5,Rebs+Asts,24,18,23,7
22023,1627750,22300524,"JAN 10, 2024",DEN @ UTA,L,31,6,15,0.4,1,5,0.2,4,4,1.0,0,1,1,6,1,2,4,3,17,-27,1,Jamal Murray,DEN,UTA,DEN,1.5,Blks+Stls,24,18,23,7
22023,1627750,22300524,"JAN 10, 2024",DEN @ UTA,L,31,6,15,0.4,1,5,0.2,4,4,1.0,0,1,1,6,1,2,4,3,17,-27,1,Jamal Murray,DEN,UTA,DEN,2.5,Turnovers,24,18,23,7
22023,1627750,22300502,"JAN 07, 2024",DEN vs. DET,W,30,14,24,0.583,3,8,0.375,6,7,0.857,2,3,5,4,1,1,1,4,37,11,1,Jamal Murray,DEN,DEN,DET,23.5,Points,46,42,41,9
22023,1627750,22300502,"JAN 07, 2024",DEN vs. DET,W,30,14,24,0.583,3,8,0.375,6,7,0.857,2,3,5,4,1,1,1,4,37,11,1,Jamal Murray,DEN,DEN,DET,3.5,Rebounds,46,42,41,9
22023,1627750,22300502,"JAN 07, 2024",DEN vs. DET,W,30,14,24,0.583,3,8,0.375,6,7,0.857,2,3,5,4,1,1,1,4,37,11,1,Jamal Murray,DEN,DEN,DET,34.5,Pts+Rebs+Asts,46,42,41,9
22023,1627750,22300502,"JAN 07, 2024",DEN vs. DET,W,30,14,24,0.583,3,8,0.375,6,7,0.857,2,3,5,4,1,1,1,4,37,11,1,Jamal Murray,DEN,DEN,DET,6.5,Assists,46,42,41,9
22023,1627750,22300502,"JAN 07, 2024",DEN vs. DET,W,30,14,24,0.583,3,8,0.375,6,7,0.857,2,3,5,4,1,1,1,4,37,11,1,Jamal Murray,DEN,DEN,DET,27.5,Pts+Rebs,46,42,41,9
22023,1627750,22300502,"JAN 07, 2024",DEN vs. DET,W,30,14,24,0.583,3,8,0.375,6,7,0.857,2,3,5,4,1,1,1,4,37,11,1,Jamal Murray,DEN,DEN,DET,30.5,Pts+Asts,46,42,41,9
22023,1627750,22300502,"JAN 07, 2024",DEN vs. DET,W,30,14,24,0.583,3,8,0.375,6,7,0.857,2,3,5,4,1,1,1,4,37,11,1,Jamal Murray,DEN,DEN,DET,10.5,Rebs+Asts,46,42,41,9
22023,1627750,22300502,"JAN 07, 2024",DEN vs. DET,W,30,14,24,0.583,3,8,0.375,6,7,0.857,2,3,5,4,1,1,1,4,37,11,1,Jamal Murray,DEN,DEN,DET,1.5,Blks+Stls,46,42,41,9
22023,1627750,22300502,"JAN 07, 2024",DEN vs. DET,W,30,14,24,0.583,3,8,0.375,6,7,0.857,2,3,5,4,1,1,1,4,37,11,1,Jamal Murray,DEN,DEN,DET,2.5,Turnovers,46,42,41,9
22023,1627750,22300488,"JAN 05, 2024",DEN vs. ORL,L,33,9,23,0.391,0,6,0.0,2,2,1.0,1,6,7,9,1,0,3,3,20,-5,1,Jamal Murray,DEN,DEN,ORL,23.5,Points,36,27,29,16
22023,1627750,22300488,"JAN 05, 2024",DEN vs. ORL,L,33,9,23,0.391,0,6,0.0,2,2,1.0,1,6,7,9,1,0,3,3,20,-5,1,Jamal Murray,DEN,DEN,ORL,3.5,Rebounds,36,27,29,16
22023,1627750,22300488,"JAN 05, 2024",DEN vs. ORL,L,33,9,23,0.391,0,6,0.0,2,2,1.0,1,6,7,9,1,0,3,3,20,-5,1,Jamal Murray,DEN,DEN,ORL,34.5,Pts+Rebs+Asts,36,27,29,16
22023,1627750,22300488,"JAN 05, 2024",DEN vs. ORL,L,33,9,23,0.391,0,6,0.0,2,2,1.0,1,6,7,9,1,0,3,3,20,-5,1,Jamal Murray,DEN,DEN,ORL,6.5,Assists,36,27,29,16
22023,1627750,22300488,"JAN 05, 2024",DEN vs. ORL,L,33,9,23,0.391,0,6,0.0,2,2,1.0,1,6,7,9,1,0,3,3,20,-5,1,Jamal Murray,DEN,DEN,ORL,27.5,Pts+Rebs,36,27,29,16
22023,1627750,22300488,"JAN 05, 2024",DEN vs. ORL,L,33,9,23,0.391,0,6,0.0,2,2,1.0,1,6,7,9,1,0,3,3,20,-5,1,Jamal Murray,DEN,DEN,ORL,30.5,Pts+Asts,36,27,29,16
22023,1627750,22300488,"JAN 05, 2024",DEN vs. ORL,L,33,9,23,0.391,0,6,0.0,2,2,1.0,1,6,7,9,1,0,3,3,20,-5,1,Jamal Murray,DEN,DEN,ORL,10.5,Rebs+Asts,36,27,29,16
22023,1627750,22300488,"JAN 05, 2024",DEN vs. ORL,L,33,9,23,0.391,0,6,0.0,2,2,1.0,1,6,7,9,1,0,3,3,20,-5,1,Jamal Murray,DEN,DEN,ORL,1.5,Blks+Stls,36,27,29,16
22023,1627750,22300488,"JAN 05, 2024",DEN vs. ORL,L,33,9,23,0.391,0,6,0.0,2,2,1.0,1,6,7,9,1,0,3,3,20,-5,1,Jamal Murray,DEN,DEN,ORL,2.5,Turnovers,36,27,29,16
22023,1627750,22300478,"JAN 04, 2024",DEN @ GSW,W,32,8,16,0.5,1,6,0.167,8,9,0.889,0,2,2,6,2,0,0,4,25,9,1,Jamal Murray,DEN,GSW,DEN,23.5,Points,33,27,31,8
22023,1627750,22300478,"JAN 04, 2024",DEN @ GSW,W,32,8,16,0.5,1,6,0.167,8,9,0.889,0,2,2,6,2,0,0,4,25,9,1,Jamal Murray,DEN,GSW,DEN,3.5,Rebounds,33,27,31,8
22023,1627750,22300478,"JAN 04, 2024",DEN @ GSW,W,32,8,16,0.5,1,6,0.167,8,9,0.889,0,2,2,6,2,0,0,4,25,9,1,Jamal Murray,DEN,GSW,DEN,34.5,Pts+Rebs+Asts,33,27,31,8
22023,1627750,22300478,"JAN 04, 2024",DEN @ GSW,W,32,8,16,0.5,1,6,0.167,8,9,0.889,0,2,2,6,2,0,0,4,25,9,1,Jamal Murray,DEN,GSW,DEN,6.5,Assists,33,27,31,8
22023,1627750,22300478,"JAN 04, 2024",DEN @ GSW,W,32,8,16,0.5,1,6,0.167,8,9,0.889,0,2,2,6,2,0,0,4,25,9,1,Jamal Murray,DEN,GSW,DEN,27.5,Pts+Rebs,33,27,31,8
22023,1627750,22300478,"JAN 04, 2024",DEN @ GSW,W,32,8,16,0.5,1,6,0.167,8,9,0.889,0,2,2,6,2,0,0,4,25,9,1,Jamal Murray,DEN,GSW,DEN,30.5,Pts+Asts,33,27,31,8
22023,1627750,22300478,"JAN 04, 2024",DEN @ GSW,W,32,8,16,0.5,1,6,0.167,8,9,0.889,0,2,2,6,2,0,0,4,25,9,1,Jamal Murray,DEN,GSW,DEN,10.5,Rebs+Asts,33,27,31,8
22023,1627750,22300478,"JAN 04, 2024",DEN @ GSW,W,32,8,16,0.5,1,6,0.167,8,9,0.889,0,2,2,6,2,0,0,4,25,9,1,Jamal Murray,DEN,GSW,DEN,1.5,Blks+Stls,33,27,31,8
22023,1627750,22300478,"JAN 04, 2024",DEN @ GSW,W,32,8,16,0.5,1,6,0.167,8,9,0.889,0,2,2,6,2,0,0,4,25,9,1,Jamal Murray,DEN,GSW,DEN,2.5,Turnovers,33,27,31,8
22023,1627750,22300455,"JAN 01, 2024",DEN vs. CHA,W,27,7,16,0.438,5,9,0.556,6,7,0.857,0,3,3,7,2,1,2,1,25,26,1,Jamal Murray,DEN,DEN,CHA,23.5,Points,35,28,32,10
22023,1627750,22300455,"JAN 01, 2024",DEN vs. CHA,W,27,7,16,0.438,5,9,0.556,6,7,0.857,0,3,3,7,2,1,2,1,25,26,1,Jamal Murray,DEN,DEN,CHA,3.5,Rebounds,35,28,32,10
22023,1627750,22300455,"JAN 01, 2024",DEN vs. CHA,W,27,7,16,0.438,5,9,0.556,6,7,0.857,0,3,3,7,2,1,2,1,25,26,1,Jamal Murray,DEN,DEN,CHA,34.5,Pts+Rebs+Asts,35,28,32,10
22023,1627750,22300455,"JAN 01, 2024",DEN vs. CHA,W,27,7,16,0.438,5,9,0.556,6,7,0.857,0,3,3,7,2,1,2,1,25,26,1,Jamal Murray,DEN,DEN,CHA,6.5,Assists,35,28,32,10
22023,1627750,22300455,"JAN 01, 2024",DEN vs. CHA,W,27,7,16,0.438,5,9,0.556,6,7,0.857,0,3,3,7,2,1,2,1,25,26,1,Jamal Murray,DEN,DEN,CHA,27.5,Pts+Rebs,35,28,32,10
22023,1627750,22300455,"JAN 01, 2024",DEN vs. CHA,W,27,7,16,0.438,5,9,0.556,6,7,0.857,0,3,3,7,2,1,2,1,25,26,1,Jamal Murray,DEN,DEN,CHA,30.5,Pts+Asts,35,28,32,10
22023,1627750,22300455,"JAN 01, 2024",DEN vs. CHA,W,27,7,16,0.438,5,9,0.556,6,7,0.857,0,3,3,7,2,1,2,1,25,26,1,Jamal Murray,DEN,DEN,CHA,10.5,Rebs+Asts,35,28,32,10
22023,1627750,22300455,"JAN 01, 2024",DEN vs. CHA,W,27,7,16,0.438,5,9,0.556,6,7,0.857,0,3,3,7,2,1,2,1,25,26,1,Jamal Murray,DEN,DEN,CHA,1.5,Blks+Stls,35,28,32,10
22023,1627750,22300455,"JAN 01, 2024",DEN vs. CHA,W,27,7,16,0.438,5,9,0.556,6,7,0.857,0,3,3,7,2,1,2,1,25,26,1,Jamal Murray,DEN,DEN,CHA,2.5,Turnovers,35,28,32,10
22023,1627750,22300435,"DEC 29, 2023",DEN vs. OKC,L,36,4,15,0.267,1,6,0.167,0,1,0.0,0,3,3,11,1,1,2,1,9,-20,1,Jamal Murray,DEN,DEN,OKC,23.5,Points,23,12,20,14
22023,1627750,22300435,"DEC 29, 2023",DEN vs. OKC,L,36,4,15,0.267,1,6,0.167,0,1,0.0,0,3,3,11,1,1,2,1,9,-20,1,Jamal Murray,DEN,DEN,OKC,3.5,Rebounds,23,12,20,14
22023,1627750,22300435,"DEC 29, 2023",DEN vs. OKC,L,36,4,15,0.267,1,6,0.167,0,1,0.0,0,3,3,11,1,1,2,1,9,-20,1,Jamal Murray,DEN,DEN,OKC,34.5,Pts+Rebs+Asts,23,12,20,14
22023,1627750,22300435,"DEC 29, 2023",DEN vs. OKC,L,36,4,15,0.267,1,6,0.167,0,1,0.0,0,3,3,11,1,1,2,1,9,-20,1,Jamal Murray,DEN,DEN,OKC,6.5,Assists,23,12,20,14
22023,1627750,22300435,"DEC 29, 2023",DEN vs. OKC,L,36,4,15,0.267,1,6,0.167,0,1,0.0,0,3,3,11,1,1,2,1,9,-20,1,Jamal Murray,DEN,DEN,OKC,27.5,Pts+Rebs,23,12,20,14
22023,1627750,22300435,"DEC 29, 2023",DEN vs. OKC,L,36,4,15,0.267,1,6,0.167,0,1,0.0,0,3,3,11,1,1,2,1,9,-20,1,Jamal Murray,DEN,DEN,OKC,30.5,Pts+Asts,23,12,20,14
22023,1627750,22300435,"DEC 29, 2023",DEN vs. OKC,L,36,4,15,0.267,1,6,0.167,0,1,0.0,0,3,3,11,1,1,2,1,9,-20,1,Jamal Murray,DEN,DEN,OKC,10.5,Rebs+Asts,23,12,20,14
22023,1627750,22300435,"DEC 29, 2023",DEN vs. OKC,L,36,4,15,0.267,1,6,0.167,0,1,0.0,0,3,3,11,1,1,2,1,9,-20,1,Jamal Murray,DEN,DEN,OKC,1.5,Blks+Stls,23,12,20,14
22023,1627750,22300435,"DEC 29, 2023",DEN vs. OKC,L,36,4,15,0.267,1,6,0.167,0,1,0.0,0,3,3,11,1,1,2,1,9,-20,1,Jamal Murray,DEN,DEN,OKC,2.5,Turnovers,23,12,20,14
22023,1627750,22300425,"DEC 28, 2023",DEN vs. MEM,W,26,9,12,0.75,4,6,0.667,1,1,1.0,2,1,3,9,2,0,1,0,23,19,1,Jamal Murray,DEN,DEN,MEM,23.5,Points,35,26,32,12
22023,1627750,22300425,"DEC 28, 2023",DEN vs. MEM,W,26,9,12,0.75,4,6,0.667,1,1,1.0,2,1,3,9,2,0,1,0,23,19,1,Jamal Murray,DEN,DEN,MEM,3.5,Rebounds,35,26,32,12
22023,1627750,22300425,"DEC 28, 2023",DEN vs. MEM,W,26,9,12,0.75,4,6,0.667,1,1,1.0,2,1,3,9,2,0,1,0,23,19,1,Jamal Murray,DEN,DEN,MEM,34.5,Pts+Rebs+Asts,35,26,32,12
22023,1627750,22300425,"DEC 28, 2023",DEN vs. MEM,W,26,9,12,0.75,4,6,0.667,1,1,1.0,2,1,3,9,2,0,1,0,23,19,1,Jamal Murray,DEN,DEN,MEM,6.5,Assists,35,26,32,12
22023,1627750,22300425,"DEC 28, 2023",DEN vs. MEM,W,26,9,12,0.75,4,6,0.667,1,1,1.0,2,1,3,9,2,0,1,0,23,19,1,Jamal Murray,DEN,DEN,MEM,27.5,Pts+Rebs,35,26,32,12
22023,1627750,22300425,"DEC 28, 2023",DEN vs. MEM,W,26,9,12,0.75,4,6,0.667,1,1,1.0,2,1,3,9,2,0,1,0,23,19,1,Jamal Murray,DEN,DEN,MEM,30.5,Pts+Asts,35,26,32,12
22023,1627750,22300425,"DEC 28, 2023",DEN vs. MEM,W,26,9,12,0.75,4,6,0.667,1,1,1.0,2,1,3,9,2,0,1,0,23,19,1,Jamal Murray,DEN,DEN,MEM,10.5,Rebs+Asts,35,26,32,12
22023,1627750,22300425,"DEC 28, 2023",DEN vs. MEM,W,26,9,12,0.75,4,6,0.667,1,1,1.0,2,1,3,9,2,0,1,0,23,19,1,Jamal Murray,DEN,DEN,MEM,1.5,Blks+Stls,35,26,32,12
22023,1627750,22300425,"DEC 28, 2023",DEN vs. MEM,W,26,9,12,0.75,4,6,0.667,1,1,1.0,2,1,3,9,2,0,1,0,23,19,1,Jamal Murray,DEN,DEN,MEM,2.5,Turnovers,35,26,32,12
22023,1627750,22300402,"DEC 25, 2023",DEN vs. GSW,W,33,10,18,0.556,3,5,0.6,5,5,1.0,1,4,5,3,2,0,2,4,28,20,1,Jamal Murray,DEN,DEN,GSW,23.5,Points,36,33,31,8
22023,1627750,22300402,"DEC 25, 2023",DEN vs. GSW,W,33,10,18,0.556,3,5,0.6,5,5,1.0,1,4,5,3,2,0,2,4,28,20,1,Jamal Murray,DEN,DEN,GSW,3.5,Rebounds,36,33,31,8
22023,1627750,22300402,"DEC 25, 2023",DEN vs. GSW,W,33,10,18,0.556,3,5,0.6,5,5,1.0,1,4,5,3,2,0,2,4,28,20,1,Jamal Murray,DEN,DEN,GSW,34.5,Pts+Rebs+Asts,36,33,31,8
22023,1627750,22300402,"DEC 25, 2023",DEN vs. GSW,W,33,10,18,0.556,3,5,0.6,5,5,1.0,1,4,5,3,2,0,2,4,28,20,1,Jamal Murray,DEN,DEN,GSW,6.5,Assists,36,33,31,8
22023,1627750,22300402,"DEC 25, 2023",DEN vs. GSW,W,33,10,18,0.556,3,5,0.6,5,5,1.0,1,4,5,3,2,0,2,4,28,20,1,Jamal Murray,DEN,DEN,GSW,27.5,Pts+Rebs,36,33,31,8
22023,1627750,22300402,"DEC 25, 2023",DEN vs. GSW,W,33,10,18,0.556,3,5,0.6,5,5,1.0,1,4,5,3,2,0,2,4,28,20,1,Jamal Murray,DEN,DEN,GSW,30.5,Pts+Asts,36,33,31,8
22023,1627750,22300402,"DEC 25, 2023",DEN vs. GSW,W,33,10,18,0.556,3,5,0.6,5,5,1.0,1,4,5,3,2,0,2,4,28,20,1,Jamal Murray,DEN,DEN,GSW,10.5,Rebs+Asts,36,33,31,8
22023,1627750,22300402,"DEC 25, 2023",DEN vs. GSW,W,33,10,18,0.556,3,5,0.6,5,5,1.0,1,4,5,3,2,0,2,4,28,20,1,Jamal Murray,DEN,DEN,GSW,1.5,Blks+Stls,36,33,31,8
22023,1627750,22300402,"DEC 25, 2023",DEN vs. GSW,W,33,10,18,0.556,3,5,0.6,5,5,1.0,1,4,5,3,2,0,2,4,28,20,1,Jamal Murray,DEN,DEN,GSW,2.5,Turnovers,36,33,31,8
22023,1627750,22300390,"DEC 23, 2023",DEN @ CHA,W,33,8,19,0.421,2,6,0.333,2,2,1.0,2,10,12,5,3,0,1,1,20,7,1,Jamal Murray,DEN,CHA,DEN,23.5,Points,37,32,25,17
22023,1627750,22300390,"DEC 23, 2023",DEN @ CHA,W,33,8,19,0.421,2,6,0.333,2,2,1.0,2,10,12,5,3,0,1,1,20,7,1,Jamal Murray,DEN,CHA,DEN,3.5,Rebounds,37,32,25,17
22023,1627750,22300390,"DEC 23, 2023",DEN @ CHA,W,33,8,19,0.421,2,6,0.333,2,2,1.0,2,10,12,5,3,0,1,1,20,7,1,Jamal Murray,DEN,CHA,DEN,34.5,Pts+Rebs+Asts,37,32,25,17
22023,1627750,22300390,"DEC 23, 2023",DEN @ CHA,W,33,8,19,0.421,2,6,0.333,2,2,1.0,2,10,12,5,3,0,1,1,20,7,1,Jamal Murray,DEN,CHA,DEN,6.5,Assists,37,32,25,17
22023,1627750,22300390,"DEC 23, 2023",DEN @ CHA,W,33,8,19,0.421,2,6,0.333,2,2,1.0,2,10,12,5,3,0,1,1,20,7,1,Jamal Murray,DEN,CHA,DEN,27.5,Pts+Rebs,37,32,25,17
22023,1627750,22300390,"DEC 23, 2023",DEN @ CHA,W,33,8,19,0.421,2,6,0.333,2,2,1.0,2,10,12,5,3,0,1,1,20,7,1,Jamal Murray,DEN,CHA,DEN,30.5,Pts+Asts,37,32,25,17
22023,1627750,22300390,"DEC 23, 2023",DEN @ CHA,W,33,8,19,0.421,2,6,0.333,2,2,1.0,2,10,12,5,3,0,1,1,20,7,1,Jamal Murray,DEN,CHA,DEN,10.5,Rebs+Asts,37,32,25,17
22023,1627750,22300390,"DEC 23, 2023",DEN @ CHA,W,33,8,19,0.421,2,6,0.333,2,2,1.0,2,10,12,5,3,0,1,1,20,7,1,Jamal Murray,DEN,CHA,DEN,1.5,Blks+Stls,37,32,25,17
22023,1627750,22300390,"DEC 23, 2023",DEN @ CHA,W,33,8,19,0.421,2,6,0.333,2,2,1.0,2,10,12,5,3,0,1,1,20,7,1,Jamal Murray,DEN,CHA,DEN,2.5,Turnovers,37,32,25,17
22023,1627750,22300383,"DEC 22, 2023",DEN @ BKN,W,34,11,19,0.579,4,6,0.667,6,8,0.75,1,4,5,9,0,2,1,0,32,18,1,Jamal Murray,DEN,BKN,DEN,23.5,Points,46,37,41,14
22023,1627750,22300383,"DEC 22, 2023",DEN @ BKN,W,34,11,19,0.579,4,6,0.667,6,8,0.75,1,4,5,9,0,2,1,0,32,18,1,Jamal Murray,DEN,BKN,DEN,3.5,Rebounds,46,37,41,14
22023,1627750,22300383,"DEC 22, 2023",DEN @ BKN,W,34,11,19,0.579,4,6,0.667,6,8,0.75,1,4,5,9,0,2,1,0,32,18,1,Jamal Murray,DEN,BKN,DEN,34.5,Pts+Rebs+Asts,46,37,41,14
22023,1627750,22300383,"DEC 22, 2023",DEN @ BKN,W,34,11,19,0.579,4,6,0.667,6,8,0.75,1,4,5,9,0,2,1,0,32,18,1,Jamal Murray,DEN,BKN,DEN,6.5,Assists,46,37,41,14
22023,1627750,22300383,"DEC 22, 2023",DEN @ BKN,W,34,11,19,0.579,4,6,0.667,6,8,0.75,1,4,5,9,0,2,1,0,32,18,1,Jamal Murray,DEN,BKN,DEN,27.5,Pts+Rebs,46,37,41,14
22023,1627750,22300383,"DEC 22, 2023",DEN @ BKN,W,34,11,19,0.579,4,6,0.667,6,8,0.75,1,4,5,9,0,2,1,0,32,18,1,Jamal Murray,DEN,BKN,DEN,30.5,Pts+Asts,46,37,41,14
22023,1627750,22300383,"DEC 22, 2023",DEN @ BKN,W,34,11,19,0.579,4,6,0.667,6,8,0.75,1,4,5,9,0,2,1,0,32,18,1,Jamal Murray,DEN,BKN,DEN,10.5,Rebs+Asts,46,37,41,14
22023,1627750,22300383,"DEC 22, 2023",DEN @ BKN,W,34,11,19,0.579,4,6,0.667,6,8,0.75,1,4,5,9,0,2,1,0,32,18,1,Jamal Murray,DEN,BKN,DEN,1.5,Blks+Stls,46,37,41,14
22023,1627750,22300383,"DEC 22, 2023",DEN @ BKN,W,34,11,19,0.579,4,6,0.667,6,8,0.75,1,4,5,9,0,2,1,0,32,18,1,Jamal Murray,DEN,BKN,DEN,2.5,Turnovers,46,37,41,14
22023,1627750,22300369,"DEC 20, 2023",DEN @ TOR,W,32,9,22,0.409,2,7,0.286,0,0,0.0,1,4,5,6,1,2,2,2,20,12,1,Jamal Murray,DEN,TOR,DEN,23.5,Points,31,25,26,11
22023,1627750,22300369,"DEC 20, 2023",DEN @ TOR,W,32,9,22,0.409,2,7,0.286,0,0,0.0,1,4,5,6,1,2,2,2,20,12,1,Jamal Murray,DEN,TOR,DEN,3.5,Rebounds,31,25,26,11
22023,1627750,22300369,"DEC 20, 2023",DEN @ TOR,W,32,9,22,0.409,2,7,0.286,0,0,0.0,1,4,5,6,1,2,2,2,20,12,1,Jamal Murray,DEN,TOR,DEN,34.5,Pts+Rebs+Asts,31,25,26,11
22023,1627750,22300369,"DEC 20, 2023",DEN @ TOR,W,32,9,22,0.409,2,7,0.286,0,0,0.0,1,4,5,6,1,2,2,2,20,12,1,Jamal Murray,DEN,TOR,DEN,6.5,Assists,31,25,26,11
22023,1627750,22300369,"DEC 20, 2023",DEN @ TOR,W,32,9,22,0.409,2,7,0.286,0,0,0.0,1,4,5,6,1,2,2,2,20,12,1,Jamal Murray,DEN,TOR,DEN,27.5,Pts+Rebs,31,25,26,11
22023,1627750,22300369,"DEC 20, 2023",DEN @ TOR,W,32,9,22,0.409,2,7,0.286,0,0,0.0,1,4,5,6,1,2,2,2,20,12,1,Jamal Murray,DEN,TOR,DEN,30.5,Pts+Asts,31,25,26,11
22023,1627750,22300369,"DEC 20, 2023",DEN @ TOR,W,32,9,22,0.409,2,7,0.286,0,0,0.0,1,4,5,6,1,2,2,2,20,12,1,Jamal Murray,DEN,TOR,DEN,10.5,Rebs+Asts,31,25,26,11
22023,1627750,22300369,"DEC 20, 2023",DEN @ TOR,W,32,9,22,0.409,2,7,0.286,0,0,0.0,1,4,5,6,1,2,2,2,20,12,1,Jamal Murray,DEN,TOR,DEN,1.5,Blks+Stls,31,25,26,11
22023,1627750,22300369,"DEC 20, 2023",DEN @ TOR,W,32,9,22,0.409,2,7,0.286,0,0,0.0,1,4,5,6,1,2,2,2,20,12,1,Jamal Murray,DEN,TOR,DEN,2.5,Turnovers,31,25,26,11
22023,1627750,22300356,"DEC 18, 2023",DEN vs. DAL,W,25,8,14,0.571,4,4,1.0,2,2,1.0,0,4,4,2,1,1,2,1,22,18,1,Jamal Murray,DEN,DEN,DAL,23.5,Points,28,26,24,6
22023,1627750,22300356,"DEC 18, 2023",DEN vs. DAL,W,25,8,14,0.571,4,4,1.0,2,2,1.0,0,4,4,2,1,1,2,1,22,18,1,Jamal Murray,DEN,DEN,DAL,3.5,Rebounds,28,26,24,6
22023,1627750,22300356,"DEC 18, 2023",DEN vs. DAL,W,25,8,14,0.571,4,4,1.0,2,2,1.0,0,4,4,2,1,1,2,1,22,18,1,Jamal Murray,DEN,DEN,DAL,34.5,Pts+Rebs+Asts,28,26,24,6
22023,1627750,22300356,"DEC 18, 2023",DEN vs. DAL,W,25,8,14,0.571,4,4,1.0,2,2,1.0,0,4,4,2,1,1,2,1,22,18,1,Jamal Murray,DEN,DEN,DAL,6.5,Assists,28,26,24,6
22023,1627750,22300356,"DEC 18, 2023",DEN vs. DAL,W,25,8,14,0.571,4,4,1.0,2,2,1.0,0,4,4,2,1,1,2,1,22,18,1,Jamal Murray,DEN,DEN,DAL,27.5,Pts+Rebs,28,26,24,6
22023,1627750,22300356,"DEC 18, 2023",DEN vs. DAL,W,25,8,14,0.571,4,4,1.0,2,2,1.0,0,4,4,2,1,1,2,1,22,18,1,Jamal Murray,DEN,DEN,DAL,30.5,Pts+Asts,28,26,24,6
22023,1627750,22300356,"DEC 18, 2023",DEN vs. DAL,W,25,8,14,0.571,4,4,1.0,2,2,1.0,0,4,4,2,1,1,2,1,22,18,1,Jamal Murray,DEN,DEN,DAL,10.5,Rebs+Asts,28,26,24,6
22023,1627750,22300356,"DEC 18, 2023",DEN vs. DAL,W,25,8,14,0.571,4,4,1.0,2,2,1.0,0,4,4,2,1,1,2,1,22,18,1,Jamal Murray,DEN,DEN,DAL,1.5,Blks+Stls,28,26,24,6
22023,1627750,22300356,"DEC 18, 2023",DEN vs. DAL,W,25,8,14,0.571,4,4,1.0,2,2,1.0,0,4,4,2,1,1,2,1,22,18,1,Jamal Murray,DEN,DEN,DAL,2.5,Turnovers,28,26,24,6
22023,1627750,22300340,"DEC 16, 2023",DEN vs. OKC,L,28,5,13,0.385,0,6,0.0,5,5,1.0,1,1,2,5,0,0,1,4,15,-3,1,Jamal Murray,DEN,DEN,OKC,23.5,Points,22,17,20,7
22023,1627750,22300340,"DEC 16, 2023",DEN vs. OKC,L,28,5,13,0.385,0,6,0.0,5,5,1.0,1,1,2,5,0,0,1,4,15,-3,1,Jamal Murray,DEN,DEN,OKC,3.5,Rebounds,22,17,20,7
22023,1627750,22300340,"DEC 16, 2023",DEN vs. OKC,L,28,5,13,0.385,0,6,0.0,5,5,1.0,1,1,2,5,0,0,1,4,15,-3,1,Jamal Murray,DEN,DEN,OKC,34.5,Pts+Rebs+Asts,22,17,20,7
22023,1627750,22300340,"DEC 16, 2023",DEN vs. OKC,L,28,5,13,0.385,0,6,0.0,5,5,1.0,1,1,2,5,0,0,1,4,15,-3,1,Jamal Murray,DEN,DEN,OKC,6.5,Assists,22,17,20,7
22023,1627750,22300340,"DEC 16, 2023",DEN vs. OKC,L,28,5,13,0.385,0,6,0.0,5,5,1.0,1,1,2,5,0,0,1,4,15,-3,1,Jamal Murray,DEN,DEN,OKC,27.5,Pts+Rebs,22,17,20,7
22023,1627750,22300340,"DEC 16, 2023",DEN vs. OKC,L,28,5,13,0.385,0,6,0.0,5,5,1.0,1,1,2,5,0,0,1,4,15,-3,1,Jamal Murray,DEN,DEN,OKC,30.5,Pts+Asts,22,17,20,7
22023,1627750,22300340,"DEC 16, 2023",DEN vs. OKC,L,28,5,13,0.385,0,6,0.0,5,5,1.0,1,1,2,5,0,0,1,4,15,-3,1,Jamal Murray,DEN,DEN,OKC,10.5,Rebs+Asts,22,17,20,7
22023,1627750,22300340,"DEC 16, 2023",DEN vs. OKC,L,28,5,13,0.385,0,6,0.0,5,5,1.0,1,1,2,5,0,0,1,4,15,-3,1,Jamal Murray,DEN,DEN,OKC,1.5,Blks+Stls,22,17,20,7
22023,1627750,22300340,"DEC 16, 2023",DEN vs. OKC,L,28,5,13,0.385,0,6,0.0,5,5,1.0,1,1,2,5,0,0,1,4,15,-3,1,Jamal Murray,DEN,DEN,OKC,2.5,Turnovers,22,17,20,7
22023,1627750,22300322,"DEC 14, 2023",DEN vs. BKN,W,22,7,15,0.467,2,4,0.5,0,0,0.0,0,1,1,2,3,1,0,2,16,9,1,Jamal Murray,DEN,DEN,BKN,23.5,Points,19,17,18,3
22023,1627750,22300322,"DEC 14, 2023",DEN vs. BKN,W,22,7,15,0.467,2,4,0.5,0,0,0.0,0,1,1,2,3,1,0,2,16,9,1,Jamal Murray,DEN,DEN,BKN,3.5,Rebounds,19,17,18,3
22023,1627750,22300322,"DEC 14, 2023",DEN vs. BKN,W,22,7,15,0.467,2,4,0.5,0,0,0.0,0,1,1,2,3,1,0,2,16,9,1,Jamal Murray,DEN,DEN,BKN,34.5,Pts+Rebs+Asts,19,17,18,3
22023,1627750,22300322,"DEC 14, 2023",DEN vs. BKN,W,22,7,15,0.467,2,4,0.5,0,0,0.0,0,1,1,2,3,1,0,2,16,9,1,Jamal Murray,DEN,DEN,BKN,6.5,Assists,19,17,18,3
22023,1627750,22300322,"DEC 14, 2023",DEN vs. BKN,W,22,7,15,0.467,2,4,0.5,0,0,0.0,0,1,1,2,3,1,0,2,16,9,1,Jamal Murray,DEN,DEN,BKN,27.5,Pts+Rebs,19,17,18,3
22023,1627750,22300322,"DEC 14, 2023",DEN vs. BKN,W,22,7,15,0.467,2,4,0.5,0,0,0.0,0,1,1,2,3,1,0,2,16,9,1,Jamal Murray,DEN,DEN,BKN,30.5,Pts+Asts,19,17,18,3
22023,1627750,22300322,"DEC 14, 2023",DEN vs. BKN,W,22,7,15,0.467,2,4,0.5,0,0,0.0,0,1,1,2,3,1,0,2,16,9,1,Jamal Murray,DEN,DEN,BKN,10.5,Rebs+Asts,19,17,18,3
22023,1627750,22300322,"DEC 14, 2023",DEN vs. BKN,W,22,7,15,0.467,2,4,0.5,0,0,0.0,0,1,1,2,3,1,0,2,16,9,1,Jamal Murray,DEN,DEN,BKN,1.5,Blks+Stls,19,17,18,3
22023,1627750,22300322,"DEC 14, 2023",DEN vs. BKN,W,22,7,15,0.467,2,4,0.5,0,0,0.0,0,1,1,2,3,1,0,2,16,9,1,Jamal Murray,DEN,DEN,BKN,2.5,Turnovers,19,17,18,3
22023,1627750,22300296,"DEC 11, 2023",DEN @ ATL,W,29,12,15,0.8,4,5,0.8,1,1,1.0,1,8,9,4,1,2,6,1,29,14,1,Jamal Murray,DEN,ATL,DEN,23.5,Points,42,38,33,13
22023,1627750,22300296,"DEC 11, 2023",DEN @ ATL,W,29,12,15,0.8,4,5,0.8,1,1,1.0,1,8,9,4,1,2,6,1,29,14,1,Jamal Murray,DEN,ATL,DEN,3.5,Rebounds,42,38,33,13
22023,1627750,22300296,"DEC 11, 2023",DEN @ ATL,W,29,12,15,0.8,4,5,0.8,1,1,1.0,1,8,9,4,1,2,6,1,29,14,1,Jamal Murray,DEN,ATL,DEN,34.5,Pts+Rebs+Asts,42,38,33,13
22023,1627750,22300296,"DEC 11, 2023",DEN @ ATL,W,29,12,15,0.8,4,5,0.8,1,1,1.0,1,8,9,4,1,2,6,1,29,14,1,Jamal Murray,DEN,ATL,DEN,6.5,Assists,42,38,33,13
22023,1627750,22300296,"DEC 11, 2023",DEN @ ATL,W,29,12,15,0.8,4,5,0.8,1,1,1.0,1,8,9,4,1,2,6,1,29,14,1,Jamal Murray,DEN,ATL,DEN,27.5,Pts+Rebs,42,38,33,13
22023,1627750,22300296,"DEC 11, 2023",DEN @ ATL,W,29,12,15,0.8,4,5,0.8,1,1,1.0,1,8,9,4,1,2,6,1,29,14,1,Jamal Murray,DEN,ATL,DEN,30.5,Pts+Asts,42,38,33,13
22023,1627750,22300296,"DEC 11, 2023",DEN @ ATL,W,29,12,15,0.8,4,5,0.8,1,1,1.0,1,8,9,4,1,2,6,1,29,14,1,Jamal Murray,DEN,ATL,DEN,10.5,Rebs+Asts,42,38,33,13
22023,1627750,22300296,"DEC 11, 2023",DEN @ ATL,W,29,12,15,0.8,4,5,0.8,1,1,1.0,1,8,9,4,1,2,6,1,29,14,1,Jamal Murray,DEN,ATL,DEN,1.5,Blks+Stls,42,38,33,13
22023,1627750,22300296,"DEC 11, 2023",DEN @ ATL,W,29,12,15,0.8,4,5,0.8,1,1,1.0,1,8,9,4,1,2,6,1,29,14,1,Jamal Murray,DEN,ATL,DEN,2.5,Turnovers,42,38,33,13
22023,1627750,22301224,"DEC 08, 2023",DEN vs. HOU,L,32,6,17,0.353,4,8,0.5,5,5,1.0,0,5,5,3,0,0,1,2,21,4,1,Jamal Murray,DEN,DEN,HOU,23.5,Points,29,26,24,8
22023,1627750,22301224,"DEC 08, 2023",DEN vs. HOU,L,32,6,17,0.353,4,8,0.5,5,5,1.0,0,5,5,3,0,0,1,2,21,4,1,Jamal Murray,DEN,DEN,HOU,3.5,Rebounds,29,26,24,8
22023,1627750,22301224,"DEC 08, 2023",DEN vs. HOU,L,32,6,17,0.353,4,8,0.5,5,5,1.0,0,5,5,3,0,0,1,2,21,4,1,Jamal Murray,DEN,DEN,HOU,34.5,Pts+Rebs+Asts,29,26,24,8
22023,1627750,22301224,"DEC 08, 2023",DEN vs. HOU,L,32,6,17,0.353,4,8,0.5,5,5,1.0,0,5,5,3,0,0,1,2,21,4,1,Jamal Murray,DEN,DEN,HOU,6.5,Assists,29,26,24,8
22023,1627750,22301224,"DEC 08, 2023",DEN vs. HOU,L,32,6,17,0.353,4,8,0.5,5,5,1.0,0,5,5,3,0,0,1,2,21,4,1,Jamal Murray,DEN,DEN,HOU,27.5,Pts+Rebs,29,26,24,8
22023,1627750,22301224,"DEC 08, 2023",DEN vs. HOU,L,32,6,17,0.353,4,8,0.5,5,5,1.0,0,5,5,3,0,0,1,2,21,4,1,Jamal Murray,DEN,DEN,HOU,30.5,Pts+Asts,29,26,24,8
22023,1627750,22301224,"DEC 08, 2023",DEN vs. HOU,L,32,6,17,0.353,4,8,0.5,5,5,1.0,0,5,5,3,0,0,1,2,21,4,1,Jamal Murray,DEN,DEN,HOU,10.5,Rebs+Asts,29,26,24,8
22023,1627750,22301224,"DEC 08, 2023",DEN vs. HOU,L,32,6,17,0.353,4,8,0.5,5,5,1.0,0,5,5,3,0,0,1,2,21,4,1,Jamal Murray,DEN,DEN,HOU,1.5,Blks+Stls,29,26,24,8
22023,1627750,22301224,"DEC 08, 2023",DEN vs. HOU,L,32,6,17,0.353,4,8,0.5,5,5,1.0,0,5,5,3,0,0,1,2,21,4,1,Jamal Murray,DEN,DEN,HOU,2.5,Turnovers,29,26,24,8
22023,1627750,22301215,"DEC 06, 2023",DEN @ LAC,L,29,10,18,0.556,2,7,0.286,1,1,1.0,0,0,0,6,1,1,1,4,23,2,1,Jamal Murray,DEN,LAC,DEN,23.5,Points,29,23,29,6
22023,1627750,22301215,"DEC 06, 2023",DEN @ LAC,L,29,10,18,0.556,2,7,0.286,1,1,1.0,0,0,0,6,1,1,1,4,23,2,1,Jamal Murray,DEN,LAC,DEN,3.5,Rebounds,29,23,29,6
22023,1627750,22301215,"DEC 06, 2023",DEN @ LAC,L,29,10,18,0.556,2,7,0.286,1,1,1.0,0,0,0,6,1,1,1,4,23,2,1,Jamal Murray,DEN,LAC,DEN,34.5,Pts+Rebs+Asts,29,23,29,6
22023,1627750,22301215,"DEC 06, 2023",DEN @ LAC,L,29,10,18,0.556,2,7,0.286,1,1,1.0,0,0,0,6,1,1,1,4,23,2,1,Jamal Murray,DEN,LAC,DEN,6.5,Assists,29,23,29,6
22023,1627750,22301215,"DEC 06, 2023",DEN @ LAC,L,29,10,18,0.556,2,7,0.286,1,1,1.0,0,0,0,6,1,1,1,4,23,2,1,Jamal Murray,DEN,LAC,DEN,27.5,Pts+Rebs,29,23,29,6
22023,1627750,22301215,"DEC 06, 2023",DEN @ LAC,L,29,10,18,0.556,2,7,0.286,1,1,1.0,0,0,0,6,1,1,1,4,23,2,1,Jamal Murray,DEN,LAC,DEN,30.5,Pts+Asts,29,23,29,6
22023,1627750,22301215,"DEC 06, 2023",DEN @ LAC,L,29,10,18,0.556,2,7,0.286,1,1,1.0,0,0,0,6,1,1,1,4,23,2,1,Jamal Murray,DEN,LAC,DEN,10.5,Rebs+Asts,29,23,29,6
22023,1627750,22301215,"DEC 06, 2023",DEN @ LAC,L,29,10,18,0.556,2,7,0.286,1,1,1.0,0,0,0,6,1,1,1,4,23,2,1,Jamal Murray,DEN,LAC,DEN,1.5,Blks+Stls,29,23,29,6
22023,1627750,22301215,"DEC 06, 2023",DEN @ LAC,L,29,10,18,0.556,2,7,0.286,1,1,1.0,0,0,0,6,1,1,1,4,23,2,1,Jamal Murray,DEN,LAC,DEN,2.5,Turnovers,29,23,29,6
22023,1627750,22300263,"NOV 29, 2023",DEN vs. HOU,W,22,4,14,0.286,3,8,0.375,5,5,1.0,0,6,6,6,0,0,0,2,16,14,1,Jamal Murray,DEN,DEN,HOU,23.5,Points,28,22,22,12
22023,1627750,22300263,"NOV 29, 2023",DEN vs. HOU,W,22,4,14,0.286,3,8,0.375,5,5,1.0,0,6,6,6,0,0,0,2,16,14,1,Jamal Murray,DEN,DEN,HOU,3.5,Rebounds,28,22,22,12
22023,1627750,22300263,"NOV 29, 2023",DEN vs. HOU,W,22,4,14,0.286,3,8,0.375,5,5,1.0,0,6,6,6,0,0,0,2,16,14,1,Jamal Murray,DEN,DEN,HOU,34.5,Pts+Rebs+Asts,28,22,22,12
22023,1627750,22300263,"NOV 29, 2023",DEN vs. HOU,W,22,4,14,0.286,3,8,0.375,5,5,1.0,0,6,6,6,0,0,0,2,16,14,1,Jamal Murray,DEN,DEN,HOU,6.5,Assists,28,22,22,12
22023,1627750,22300263,"NOV 29, 2023",DEN vs. HOU,W,22,4,14,0.286,3,8,0.375,5,5,1.0,0,6,6,6,0,0,0,2,16,14,1,Jamal Murray,DEN,DEN,HOU,27.5,Pts+Rebs,28,22,22,12
22023,1627750,22300263,"NOV 29, 2023",DEN vs. HOU,W,22,4,14,0.286,3,8,0.375,5,5,1.0,0,6,6,6,0,0,0,2,16,14,1,Jamal Murray,DEN,DEN,HOU,30.5,Pts+Asts,28,22,22,12
22023,1627750,22300263,"NOV 29, 2023",DEN vs. HOU,W,22,4,14,0.286,3,8,0.375,5,5,1.0,0,6,6,6,0,0,0,2,16,14,1,Jamal Murray,DEN,DEN,HOU,10.5,Rebs+Asts,28,22,22,12
22023,1627750,22300263,"NOV 29, 2023",DEN vs. HOU,W,22,4,14,0.286,3,8,0.375,5,5,1.0,0,6,6,6,0,0,0,2,16,14,1,Jamal Murray,DEN,DEN,HOU,1.5,Blks+Stls,28,22,22,12
22023,1627750,22300263,"NOV 29, 2023",DEN vs. HOU,W,22,4,14,0.286,3,8,0.375,5,5,1.0,0,6,6,6,0,0,0,2,16,14,1,Jamal Murray,DEN,DEN,HOU,2.5,Turnovers,28,22,22,12
22023,1627750,22300139,"NOV 04, 2023",DEN vs. CHI,W,10,1,3,0.333,0,0,0.0,0,0,0.0,0,2,2,0,0,0,0,0,2,-2,1,Jamal Murray,DEN,DEN,CHI,23.5,Points,4,4,2,2
22023,1627750,22300139,"NOV 04, 2023",DEN vs. CHI,W,10,1,3,0.333,0,0,0.0,0,0,0.0,0,2,2,0,0,0,0,0,2,-2,1,Jamal Murray,DEN,DEN,CHI,3.5,Rebounds,4,4,2,2
22023,1627750,22300139,"NOV 04, 2023",DEN vs. CHI,W,10,1,3,0.333,0,0,0.0,0,0,0.0,0,2,2,0,0,0,0,0,2,-2,1,Jamal Murray,DEN,DEN,CHI,34.5,Pts+Rebs+Asts,4,4,2,2
22023,1627750,22300139,"NOV 04, 2023",DEN vs. CHI,W,10,1,3,0.333,0,0,0.0,0,0,0.0,0,2,2,0,0,0,0,0,2,-2,1,Jamal Murray,DEN,DEN,CHI,6.5,Assists,4,4,2,2
22023,1627750,22300139,"NOV 04, 2023",DEN vs. CHI,W,10,1,3,0.333,0,0,0.0,0,0,0.0,0,2,2,0,0,0,0,0,2,-2,1,Jamal Murray,DEN,DEN,CHI,27.5,Pts+Rebs,4,4,2,2
22023,1627750,22300139,"NOV 04, 2023",DEN vs. CHI,W,10,1,3,0.333,0,0,0.0,0,0,0.0,0,2,2,0,0,0,0,0,2,-2,1,Jamal Murray,DEN,DEN,CHI,30.5,Pts+Asts,4,4,2,2
22023,1627750,22300139,"NOV 04, 2023",DEN vs. CHI,W,10,1,3,0.333,0,0,0.0,0,0,0.0,0,2,2,0,0,0,0,0,2,-2,1,Jamal Murray,DEN,DEN,CHI,10.5,Rebs+Asts,4,4,2,2
22023,1627750,22300139,"NOV 04, 2023",DEN vs. CHI,W,10,1,3,0.333,0,0,0.0,0,0,0.0,0,2,2,0,0,0,0,0,2,-2,1,Jamal Murray,DEN,DEN,CHI,1.5,Blks+Stls,4,4,2,2
22023,1627750,22300139,"NOV 04, 2023",DEN vs. CHI,W,10,1,3,0.333,0,0,0.0,0,0,0.0,0,2,2,0,0,0,0,0,2,-2,1,Jamal Murray,DEN,DEN,CHI,2.5,Turnovers,4,4,2,2
22023,1627750,22300006,"NOV 03, 2023",DEN vs. DAL,W,39,5,15,0.333,2,6,0.333,6,6,1.0,0,2,2,13,1,0,2,4,18,2,1,Jamal Murray,DEN,DEN,DAL,23.5,Points,33,20,31,15
22023,1627750,22300006,"NOV 03, 2023",DEN vs. DAL,W,39,5,15,0.333,2,6,0.333,6,6,1.0,0,2,2,13,1,0,2,4,18,2,1,Jamal Murray,DEN,DEN,DAL,3.5,Rebounds,33,20,31,15
22023,1627750,22300006,"NOV 03, 2023",DEN vs. DAL,W,39,5,15,0.333,2,6,0.333,6,6,1.0,0,2,2,13,1,0,2,4,18,2,1,Jamal Murray,DEN,DEN,DAL,34.5,Pts+Rebs+Asts,33,20,31,15
22023,1627750,22300006,"NOV 03, 2023",DEN vs. DAL,W,39,5,15,0.333,2,6,0.333,6,6,1.0,0,2,2,13,1,0,2,4,18,2,1,Jamal Murray,DEN,DEN,DAL,6.5,Assists,33,20,31,15
22023,1627750,22300006,"NOV 03, 2023",DEN vs. DAL,W,39,5,15,0.333,2,6,0.333,6,6,1.0,0,2,2,13,1,0,2,4,18,2,1,Jamal Murray,DEN,DEN,DAL,27.5,Pts+Rebs,33,20,31,15
22023,1627750,22300006,"NOV 03, 2023",DEN vs. DAL,W,39,5,15,0.333,2,6,0.333,6,6,1.0,0,2,2,13,1,0,2,4,18,2,1,Jamal Murray,DEN,DEN,DAL,30.5,Pts+Asts,33,20,31,15
22023,1627750,22300006,"NOV 03, 2023",DEN vs. DAL,W,39,5,15,0.333,2,6,0.333,6,6,1.0,0,2,2,13,1,0,2,4,18,2,1,Jamal Murray,DEN,DEN,DAL,10.5,Rebs+Asts,33,20,31,15
22023,1627750,22300006,"NOV 03, 2023",DEN vs. DAL,W,39,5,15,0.333,2,6,0.333,6,6,1.0,0,2,2,13,1,0,2,4,18,2,1,Jamal Murray,DEN,DEN,DAL,1.5,Blks+Stls,33,20,31,15
22023,1627750,22300006,"NOV 03, 2023",DEN vs. DAL,W,39,5,15,0.333,2,6,0.333,6,6,1.0,0,2,2,13,1,0,2,4,18,2,1,Jamal Murray,DEN,DEN,DAL,2.5,Turnovers,33,20,31,15
22023,1627750,22300123,"NOV 01, 2023",DEN @ MIN,L,32,5,16,0.313,1,4,0.25,3,5,0.6,2,4,6,6,1,1,3,3,14,-17,1,Jamal Murray,DEN,MIN,DEN,23.5,Points,26,20,20,12
22023,1627750,22300123,"NOV 01, 2023",DEN @ MIN,L,32,5,16,0.313,1,4,0.25,3,5,0.6,2,4,6,6,1,1,3,3,14,-17,1,Jamal Murray,DEN,MIN,DEN,3.5,Rebounds,26,20,20,12
22023,1627750,22300123,"NOV 01, 2023",DEN @ MIN,L,32,5,16,0.313,1,4,0.25,3,5,0.6,2,4,6,6,1,1,3,3,14,-17,1,Jamal Murray,DEN,MIN,DEN,34.5,Pts+Rebs+Asts,26,20,20,12
22023,1627750,22300123,"NOV 01, 2023",DEN @ MIN,L,32,5,16,0.313,1,4,0.25,3,5,0.6,2,4,6,6,1,1,3,3,14,-17,1,Jamal Murray,DEN,MIN,DEN,6.5,Assists,26,20,20,12
22023,1627750,22300123,"NOV 01, 2023",DEN @ MIN,L,32,5,16,0.313,1,4,0.25,3,5,0.6,2,4,6,6,1,1,3,3,14,-17,1,Jamal Murray,DEN,MIN,DEN,27.5,Pts+Rebs,26,20,20,12
22023,1627750,22300123,"NOV 01, 2023",DEN @ MIN,L,32,5,16,0.313,1,4,0.25,3,5,0.6,2,4,6,6,1,1,3,3,14,-17,1,Jamal Murray,DEN,MIN,DEN,30.5,Pts+Asts,26,20,20,12
22023,1627750,22300123,"NOV 01, 2023",DEN @ MIN,L,32,5,16,0.313,1,4,0.25,3,5,0.6,2,4,6,6,1,1,3,3,14,-17,1,Jamal Murray,DEN,MIN,DEN,10.5,Rebs+Asts,26,20,20,12
22023,1627750,22300123,"NOV 01, 2023",DEN @ MIN,L,32,5,16,0.313,1,4,0.25,3,5,0.6,2,4,6,6,1,1,3,3,14,-17,1,Jamal Murray,DEN,MIN,DEN,1.5,Blks+Stls,26,20,20,12
22023,1627750,22300123,"NOV 01, 2023",DEN @ MIN,L,32,5,16,0.313,1,4,0.25,3,5,0.6,2,4,6,6,1,1,3,3,14,-17,1,Jamal Murray,DEN,MIN,DEN,2.5,Turnovers,26,20,20,12
22023,1627750,22300110,"OCT 30, 2023",DEN vs. UTA,W,37,7,19,0.368,3,7,0.429,1,2,0.5,0,3,3,14,0,2,3,0,18,-5,1,Jamal Murray,DEN,DEN,UTA,23.5,Points,35,21,32,17
22023,1627750,22300110,"OCT 30, 2023",DEN vs. UTA,W,37,7,19,0.368,3,7,0.429,1,2,0.5,0,3,3,14,0,2,3,0,18,-5,1,Jamal Murray,DEN,DEN,UTA,3.5,Rebounds,35,21,32,17
22023,1627750,22300110,"OCT 30, 2023",DEN vs. UTA,W,37,7,19,0.368,3,7,0.429,1,2,0.5,0,3,3,14,0,2,3,0,18,-5,1,Jamal Murray,DEN,DEN,UTA,34.5,Pts+Rebs+Asts,35,21,32,17
22023,1627750,22300110,"OCT 30, 2023",DEN vs. UTA,W,37,7,19,0.368,3,7,0.429,1,2,0.5,0,3,3,14,0,2,3,0,18,-5,1,Jamal Murray,DEN,DEN,UTA,6.5,Assists,35,21,32,17
22023,1627750,22300110,"OCT 30, 2023",DEN vs. UTA,W,37,7,19,0.368,3,7,0.429,1,2,0.5,0,3,3,14,0,2,3,0,18,-5,1,Jamal Murray,DEN,DEN,UTA,27.5,Pts+Rebs,35,21,32,17
22023,1627750,22300110,"OCT 30, 2023",DEN vs. UTA,W,37,7,19,0.368,3,7,0.429,1,2,0.5,0,3,3,14,0,2,3,0,18,-5,1,Jamal Murray,DEN,DEN,UTA,30.5,Pts+Asts,35,21,32,17
22023,1627750,22300110,"OCT 30, 2023",DEN vs. UTA,W,37,7,19,0.368,3,7,0.429,1,2,0.5,0,3,3,14,0,2,3,0,18,-5,1,Jamal Murray,DEN,DEN,UTA,10.5,Rebs+Asts,35,21,32,17
22023,1627750,22300110,"OCT 30, 2023",DEN vs. UTA,W,37,7,19,0.368,3,7,0.429,1,2,0.5,0,3,3,14,0,2,3,0,18,-5,1,Jamal Murray,DEN,DEN,UTA,1.5,Blks+Stls,35,21,32,17
22023,1627750,22300110,"OCT 30, 2023",DEN vs. UTA,W,37,7,19,0.368,3,7,0.429,1,2,0.5,0,3,3,14,0,2,3,0,18,-5,1,Jamal Murray,DEN,DEN,UTA,2.5,Turnovers,35,21,32,17
22023,1627750,22300095,"OCT 29, 2023",DEN @ OKC,W,30,9,14,0.643,1,1,1.0,0,0,0.0,1,1,2,8,0,0,4,1,19,22,1,Jamal Murray,DEN,OKC,DEN,23.5,Points,29,21,27,10
22023,1627750,22300095,"OCT 29, 2023",DEN @ OKC,W,30,9,14,0.643,1,1,1.0,0,0,0.0,1,1,2,8,0,0,4,1,19,22,1,Jamal Murray,DEN,OKC,DEN,3.5,Rebounds,29,21,27,10
22023,1627750,22300095,"OCT 29, 2023",DEN @ OKC,W,30,9,14,0.643,1,1,1.0,0,0,0.0,1,1,2,8,0,0,4,1,19,22,1,Jamal Murray,DEN,OKC,DEN,34.5,Pts+Rebs+Asts,29,21,27,10
22023,1627750,22300095,"OCT 29, 2023",DEN @ OKC,W,30,9,14,0.643,1,1,1.0,0,0,0.0,1,1,2,8,0,0,4,1,19,22,1,Jamal Murray,DEN,OKC,DEN,6.5,Assists,29,21,27,10
22023,1627750,22300095,"OCT 29, 2023",DEN @ OKC,W,30,9,14,0.643,1,1,1.0,0,0,0.0,1,1,2,8,0,0,4,1,19,22,1,Jamal Murray,DEN,OKC,DEN,27.5,Pts+Rebs,29,21,27,10
22023,1627750,22300095,"OCT 29, 2023",DEN @ OKC,W,30,9,14,0.643,1,1,1.0,0,0,0.0,1,1,2,8,0,0,4,1,19,22,1,Jamal Murray,DEN,OKC,DEN,30.5,Pts+Asts,29,21,27,10
22023,1627750,22300095,"OCT 29, 2023",DEN @ OKC,W,30,9,14,0.643,1,1,1.0,0,0,0.0,1,1,2,8,0,0,4,1,19,22,1,Jamal Murray,DEN,OKC,DEN,10.5,Rebs+Asts,29,21,27,10
22023,1627750,22300095,"OCT 29, 2023",DEN @ OKC,W,30,9,14,0.643,1,1,1.0,0,0,0.0,1,1,2,8,0,0,4,1,19,22,1,Jamal Murray,DEN,OKC,DEN,1.5,Blks+Stls,29,21,27,10
22023,1627750,22300095,"OCT 29, 2023",DEN @ OKC,W,30,9,14,0.643,1,1,1.0,0,0,0.0,1,1,2,8,0,0,4,1,19,22,1,Jamal Murray,DEN,OKC,DEN,2.5,Turnovers,29,21,27,10
22023,1627750,22300078,"OCT 27, 2023",DEN @ MEM,W,34,7,17,0.412,4,9,0.444,4,4,1.0,0,1,1,5,0,1,3,2,22,8,1,Jamal Murray,DEN,MEM,DEN,23.5,Points,28,23,27,6
22023,1627750,22300078,"OCT 27, 2023",DEN @ MEM,W,34,7,17,0.412,4,9,0.444,4,4,1.0,0,1,1,5,0,1,3,2,22,8,1,Jamal Murray,DEN,MEM,DEN,3.5,Rebounds,28,23,27,6
22023,1627750,22300078,"OCT 27, 2023",DEN @ MEM,W,34,7,17,0.412,4,9,0.444,4,4,1.0,0,1,1,5,0,1,3,2,22,8,1,Jamal Murray,DEN,MEM,DEN,34.5,Pts+Rebs+Asts,28,23,27,6
22023,1627750,22300078,"OCT 27, 2023",DEN @ MEM,W,34,7,17,0.412,4,9,0.444,4,4,1.0,0,1,1,5,0,1,3,2,22,8,1,Jamal Murray,DEN,MEM,DEN,6.5,Assists,28,23,27,6
22023,1627750,22300078,"OCT 27, 2023",DEN @ MEM,W,34,7,17,0.412,4,9,0.444,4,4,1.0,0,1,1,5,0,1,3,2,22,8,1,Jamal Murray,DEN,MEM,DEN,27.5,Pts+Rebs,28,23,27,6
22023,1627750,22300078,"OCT 27, 2023",DEN @ MEM,W,34,7,17,0.412,4,9,0.444,4,4,1.0,0,1,1,5,0,1,3,2,22,8,1,Jamal Murray,DEN,MEM,DEN,30.5,Pts+Asts,28,23,27,6
22023,1627750,22300078,"OCT 27, 2023",DEN @ MEM,W,34,7,17,0.412,4,9,0.444,4,4,1.0,0,1,1,5,0,1,3,2,22,8,1,Jamal Murray,DEN,MEM,DEN,10.5,Rebs+Asts,28,23,27,6
22023,1627750,22300078,"OCT 27, 2023",DEN @ MEM,W,34,7,17,0.412,4,9,0.444,4,4,1.0,0,1,1,5,0,1,3,2,22,8,1,Jamal Murray,DEN,MEM,DEN,1.5,Blks+Stls,28,23,27,6
22023,1627750,22300078,"OCT 27, 2023",DEN @ MEM,W,34,7,17,0.412,4,9,0.444,4,4,1.0,0,1,1,5,0,1,3,2,22,8,1,Jamal Murray,DEN,MEM,DEN,2.5,Turnovers,28,23,27,6
22023,1627750,22300061,"OCT 24, 2023",DEN vs. LAL,W,34,8,13,0.615,3,5,0.6,2,2,1.0,0,2,2,6,0,1,1,3,21,3,1,Jamal Murray,DEN,DEN,LAL,23.5,Points,29,23,27,8
22023,1627750,22300061,"OCT 24, 2023",DEN vs. LAL,W,34,8,13,0.615,3,5,0.6,2,2,1.0,0,2,2,6,0,1,1,3,21,3,1,Jamal Murray,DEN,DEN,LAL,3.5,Rebounds,29,23,27,8
22023,1627750,22300061,"OCT 24, 2023",DEN vs. LAL,W,34,8,13,0.615,3,5,0.6,2,2,1.0,0,2,2,6,0,1,1,3,21,3,1,Jamal Murray,DEN,DEN,LAL,34.5,Pts+Rebs+Asts,29,23,27,8
22023,1627750,22300061,"OCT 24, 2023",DEN vs. LAL,W,34,8,13,0.615,3,5,0.6,2,2,1.0,0,2,2,6,0,1,1,3,21,3,1,Jamal Murray,DEN,DEN,LAL,6.5,Assists,29,23,27,8
22023,1627750,22300061,"OCT 24, 2023",DEN vs. LAL,W,34,8,13,0.615,3,5,0.6,2,2,1.0,0,2,2,6,0,1,1,3,21,3,1,Jamal Murray,DEN,DEN,LAL,27.5,Pts+Rebs,29,23,27,8
22023,1627750,22300061,"OCT 24, 2023",DEN vs. LAL,W,34,8,13,0.615,3,5,0.6,2,2,1.0,0,2,2,6,0,1,1,3,21,3,1,Jamal Murray,DEN,DEN,LAL,30.5,Pts+Asts,29,23,27,8
22023,1627750,22300061,"OCT 24, 2023",DEN vs. LAL,W,34,8,13,0.615,3,5,0.6,2,2,1.0,0,2,2,6,0,1,1,3,21,3,1,Jamal Murray,DEN,DEN,LAL,10.5,Rebs+Asts,29,23,27,8
22023,1627750,22300061,"OCT 24, 2023",DEN vs. LAL,W,34,8,13,0.615,3,5,0.6,2,2,1.0,0,2,2,6,0,1,1,3,21,3,1,Jamal Murray,DEN,DEN,LAL,1.5,Blks+Stls,29,23,27,8
22023,1627750,22300061,"OCT 24, 2023",DEN vs. LAL,W,34,8,13,0.615,3,5,0.6,2,2,1.0,0,2,2,6,0,1,1,3,21,3,1,Jamal Murray,DEN,DEN,LAL,2.5,Turnovers,29,23,27,8
22023,1631099,22300552,"JAN 14, 2024",SAC @ MIL,L,19,2,9,0.222,0,2,0.0,0,0,0.0,0,1,1,0,0,1,0,1,4,1,1,Keegan Murray,SAC,MIL,SAC,15.0,Points,5,5,4,1
22023,1631099,22300552,"JAN 14, 2024",SAC @ MIL,L,19,2,9,0.222,0,2,0.0,0,0,0.0,0,1,1,0,0,1,0,1,4,1,1,Keegan Murray,SAC,MIL,SAC,5.0,Rebounds,5,5,4,1
22023,1631099,22300552,"JAN 14, 2024",SAC @ MIL,L,19,2,9,0.222,0,2,0.0,0,0,0.0,0,1,1,0,0,1,0,1,4,1,1,Keegan Murray,SAC,MIL,SAC,21.5,Pts+Rebs+Asts,5,5,4,1
22023,1631099,22300552,"JAN 14, 2024",SAC @ MIL,L,19,2,9,0.222,0,2,0.0,0,0,0.0,0,1,1,0,0,1,0,1,4,1,1,Keegan Murray,SAC,MIL,SAC,25.5,Fantasy Score,5,5,4,1
22023,1631099,22300552,"JAN 14, 2024",SAC @ MIL,L,19,2,9,0.222,0,2,0.0,0,0,0.0,0,1,1,0,0,1,0,1,4,1,1,Keegan Murray,SAC,MIL,SAC,6.5,3-PT Attempted,5,5,4,1
22023,1631099,22300552,"JAN 14, 2024",SAC @ MIL,L,19,2,9,0.222,0,2,0.0,0,0,0.0,0,1,1,0,0,1,0,1,4,1,1,Keegan Murray,SAC,MIL,SAC,20.5,Pts+Rebs,5,5,4,1
22023,1631099,22300552,"JAN 14, 2024",SAC @ MIL,L,19,2,9,0.222,0,2,0.0,0,0,0.0,0,1,1,0,0,1,0,1,4,1,1,Keegan Murray,SAC,MIL,SAC,0.5,Dunks,5,5,4,1
22023,1631099,22300552,"JAN 14, 2024",SAC @ MIL,L,19,2,9,0.222,0,2,0.0,0,0,0.0,0,1,1,0,0,1,0,1,4,1,1,Keegan Murray,SAC,MIL,SAC,16.5,Pts+Asts,5,5,4,1
22023,1631099,22300552,"JAN 14, 2024",SAC @ MIL,L,19,2,9,0.222,0,2,0.0,0,0,0.0,0,1,1,0,0,1,0,1,4,1,1,Keegan Murray,SAC,MIL,SAC,0.5,Blocked Shots,5,5,4,1
22023,1631099,22300552,"JAN 14, 2024",SAC @ MIL,L,19,2,9,0.222,0,2,0.0,0,0,0.0,0,1,1,0,0,1,0,1,4,1,1,Keegan Murray,SAC,MIL,SAC,1.5,Blks+Stls,5,5,4,1
22023,1631099,22300532,"JAN 12, 2024",SAC @ PHI,L,35,6,14,0.429,3,7,0.429,0,1,0.0,2,6,8,3,1,2,2,2,15,-6,1,Keegan Murray,SAC,PHI,SAC,15.0,Points,26,23,18,11
22023,1631099,22300532,"JAN 12, 2024",SAC @ PHI,L,35,6,14,0.429,3,7,0.429,0,1,0.0,2,6,8,3,1,2,2,2,15,-6,1,Keegan Murray,SAC,PHI,SAC,5.0,Rebounds,26,23,18,11
22023,1631099,22300532,"JAN 12, 2024",SAC @ PHI,L,35,6,14,0.429,3,7,0.429,0,1,0.0,2,6,8,3,1,2,2,2,15,-6,1,Keegan Murray,SAC,PHI,SAC,21.5,Pts+Rebs+Asts,26,23,18,11
22023,1631099,22300532,"JAN 12, 2024",SAC @ PHI,L,35,6,14,0.429,3,7,0.429,0,1,0.0,2,6,8,3,1,2,2,2,15,-6,1,Keegan Murray,SAC,PHI,SAC,25.5,Fantasy Score,26,23,18,11
22023,1631099,22300532,"JAN 12, 2024",SAC @ PHI,L,35,6,14,0.429,3,7,0.429,0,1,0.0,2,6,8,3,1,2,2,2,15,-6,1,Keegan Murray,SAC,PHI,SAC,6.5,3-PT Attempted,26,23,18,11
22023,1631099,22300532,"JAN 12, 2024",SAC @ PHI,L,35,6,14,0.429,3,7,0.429,0,1,0.0,2,6,8,3,1,2,2,2,15,-6,1,Keegan Murray,SAC,PHI,SAC,20.5,Pts+Rebs,26,23,18,11
22023,1631099,22300532,"JAN 12, 2024",SAC @ PHI,L,35,6,14,0.429,3,7,0.429,0,1,0.0,2,6,8,3,1,2,2,2,15,-6,1,Keegan Murray,SAC,PHI,SAC,0.5,Dunks,26,23,18,11
22023,1631099,22300532,"JAN 12, 2024",SAC @ PHI,L,35,6,14,0.429,3,7,0.429,0,1,0.0,2,6,8,3,1,2,2,2,15,-6,1,Keegan Murray,SAC,PHI,SAC,16.5,Pts+Asts,26,23,18,11
22023,1631099,22300532,"JAN 12, 2024",SAC @ PHI,L,35,6,14,0.429,3,7,0.429,0,1,0.0,2,6,8,3,1,2,2,2,15,-6,1,Keegan Murray,SAC,PHI,SAC,0.5,Blocked Shots,26,23,18,11
22023,1631099,22300532,"JAN 12, 2024",SAC @ PHI,L,35,6,14,0.429,3,7,0.429,0,1,0.0,2,6,8,3,1,2,2,2,15,-6,1,Keegan Murray,SAC,PHI,SAC,1.5,Blks+Stls,26,23,18,11
22023,1631099,22300518,"JAN 10, 2024",SAC @ CHA,W,32,11,18,0.611,3,7,0.429,0,0,0.0,0,6,6,3,0,1,0,2,25,5,1,Keegan Murray,SAC,CHA,SAC,15.0,Points,34,31,28,9
22023,1631099,22300518,"JAN 10, 2024",SAC @ CHA,W,32,11,18,0.611,3,7,0.429,0,0,0.0,0,6,6,3,0,1,0,2,25,5,1,Keegan Murray,SAC,CHA,SAC,5.0,Rebounds,34,31,28,9
22023,1631099,22300518,"JAN 10, 2024",SAC @ CHA,W,32,11,18,0.611,3,7,0.429,0,0,0.0,0,6,6,3,0,1,0,2,25,5,1,Keegan Murray,SAC,CHA,SAC,21.5,Pts+Rebs+Asts,34,31,28,9
22023,1631099,22300518,"JAN 10, 2024",SAC @ CHA,W,32,11,18,0.611,3,7,0.429,0,0,0.0,0,6,6,3,0,1,0,2,25,5,1,Keegan Murray,SAC,CHA,SAC,25.5,Fantasy Score,34,31,28,9
22023,1631099,22300518,"JAN 10, 2024",SAC @ CHA,W,32,11,18,0.611,3,7,0.429,0,0,0.0,0,6,6,3,0,1,0,2,25,5,1,Keegan Murray,SAC,CHA,SAC,6.5,3-PT Attempted,34,31,28,9
22023,1631099,22300518,"JAN 10, 2024",SAC @ CHA,W,32,11,18,0.611,3,7,0.429,0,0,0.0,0,6,6,3,0,1,0,2,25,5,1,Keegan Murray,SAC,CHA,SAC,20.5,Pts+Rebs,34,31,28,9
22023,1631099,22300518,"JAN 10, 2024",SAC @ CHA,W,32,11,18,0.611,3,7,0.429,0,0,0.0,0,6,6,3,0,1,0,2,25,5,1,Keegan Murray,SAC,CHA,SAC,0.5,Dunks,34,31,28,9
22023,1631099,22300518,"JAN 10, 2024",SAC @ CHA,W,32,11,18,0.611,3,7,0.429,0,0,0.0,0,6,6,3,0,1,0,2,25,5,1,Keegan Murray,SAC,CHA,SAC,16.5,Pts+Asts,34,31,28,9
22023,1631099,22300518,"JAN 10, 2024",SAC @ CHA,W,32,11,18,0.611,3,7,0.429,0,0,0.0,0,6,6,3,0,1,0,2,25,5,1,Keegan Murray,SAC,CHA,SAC,0.5,Blocked Shots,34,31,28,9
22023,1631099,22300518,"JAN 10, 2024",SAC @ CHA,W,32,11,18,0.611,3,7,0.429,0,0,0.0,0,6,6,3,0,1,0,2,25,5,1,Keegan Murray,SAC,CHA,SAC,1.5,Blks+Stls,34,31,28,9
22023,1631099,22300512,"JAN 09, 2024",SAC @ DET,W,35,13,17,0.765,5,9,0.556,1,1,1.0,0,5,5,2,1,2,1,2,32,32,1,Keegan Murray,SAC,DET,SAC,15.0,Points,39,37,34,7
22023,1631099,22300512,"JAN 09, 2024",SAC @ DET,W,35,13,17,0.765,5,9,0.556,1,1,1.0,0,5,5,2,1,2,1,2,32,32,1,Keegan Murray,SAC,DET,SAC,5.0,Rebounds,39,37,34,7
22023,1631099,22300512,"JAN 09, 2024",SAC @ DET,W,35,13,17,0.765,5,9,0.556,1,1,1.0,0,5,5,2,1,2,1,2,32,32,1,Keegan Murray,SAC,DET,SAC,21.5,Pts+Rebs+Asts,39,37,34,7
22023,1631099,22300512,"JAN 09, 2024",SAC @ DET,W,35,13,17,0.765,5,9,0.556,1,1,1.0,0,5,5,2,1,2,1,2,32,32,1,Keegan Murray,SAC,DET,SAC,25.5,Fantasy Score,39,37,34,7
22023,1631099,22300512,"JAN 09, 2024",SAC @ DET,W,35,13,17,0.765,5,9,0.556,1,1,1.0,0,5,5,2,1,2,1,2,32,32,1,Keegan Murray,SAC,DET,SAC,6.5,3-PT Attempted,39,37,34,7
22023,1631099,22300512,"JAN 09, 2024",SAC @ DET,W,35,13,17,0.765,5,9,0.556,1,1,1.0,0,5,5,2,1,2,1,2,32,32,1,Keegan Murray,SAC,DET,SAC,20.5,Pts+Rebs,39,37,34,7
22023,1631099,22300512,"JAN 09, 2024",SAC @ DET,W,35,13,17,0.765,5,9,0.556,1,1,1.0,0,5,5,2,1,2,1,2,32,32,1,Keegan Murray,SAC,DET,SAC,0.5,Dunks,39,37,34,7
22023,1631099,22300512,"JAN 09, 2024",SAC @ DET,W,35,13,17,0.765,5,9,0.556,1,1,1.0,0,5,5,2,1,2,1,2,32,32,1,Keegan Murray,SAC,DET,SAC,16.5,Pts+Asts,39,37,34,7
22023,1631099,22300512,"JAN 09, 2024",SAC @ DET,W,35,13,17,0.765,5,9,0.556,1,1,1.0,0,5,5,2,1,2,1,2,32,32,1,Keegan Murray,SAC,DET,SAC,0.5,Blocked Shots,39,37,34,7
22023,1631099,22300512,"JAN 09, 2024",SAC @ DET,W,35,13,17,0.765,5,9,0.556,1,1,1.0,0,5,5,2,1,2,1,2,32,32,1,Keegan Murray,SAC,DET,SAC,1.5,Blks+Stls,39,37,34,7
22023,1631099,22300500,"JAN 07, 2024",SAC vs. NOP,L,26,2,9,0.222,1,6,0.167,3,3,1.0,1,0,1,0,1,0,0,1,8,-31,1,Keegan Murray,SAC,SAC,NOP,15.0,Points,9,9,8,1
22023,1631099,22300500,"JAN 07, 2024",SAC vs. NOP,L,26,2,9,0.222,1,6,0.167,3,3,1.0,1,0,1,0,1,0,0,1,8,-31,1,Keegan Murray,SAC,SAC,NOP,5.0,Rebounds,9,9,8,1
22023,1631099,22300500,"JAN 07, 2024",SAC vs. NOP,L,26,2,9,0.222,1,6,0.167,3,3,1.0,1,0,1,0,1,0,0,1,8,-31,1,Keegan Murray,SAC,SAC,NOP,21.5,Pts+Rebs+Asts,9,9,8,1
22023,1631099,22300500,"JAN 07, 2024",SAC vs. NOP,L,26,2,9,0.222,1,6,0.167,3,3,1.0,1,0,1,0,1,0,0,1,8,-31,1,Keegan Murray,SAC,SAC,NOP,25.5,Fantasy Score,9,9,8,1
22023,1631099,22300500,"JAN 07, 2024",SAC vs. NOP,L,26,2,9,0.222,1,6,0.167,3,3,1.0,1,0,1,0,1,0,0,1,8,-31,1,Keegan Murray,SAC,SAC,NOP,6.5,3-PT Attempted,9,9,8,1
22023,1631099,22300500,"JAN 07, 2024",SAC vs. NOP,L,26,2,9,0.222,1,6,0.167,3,3,1.0,1,0,1,0,1,0,0,1,8,-31,1,Keegan Murray,SAC,SAC,NOP,20.5,Pts+Rebs,9,9,8,1
22023,1631099,22300500,"JAN 07, 2024",SAC vs. NOP,L,26,2,9,0.222,1,6,0.167,3,3,1.0,1,0,1,0,1,0,0,1,8,-31,1,Keegan Murray,SAC,SAC,NOP,0.5,Dunks,9,9,8,1
22023,1631099,22300500,"JAN 07, 2024",SAC vs. NOP,L,26,2,9,0.222,1,6,0.167,3,3,1.0,1,0,1,0,1,0,0,1,8,-31,1,Keegan Murray,SAC,SAC,NOP,16.5,Pts+Asts,9,9,8,1
22023,1631099,22300500,"JAN 07, 2024",SAC vs. NOP,L,26,2,9,0.222,1,6,0.167,3,3,1.0,1,0,1,0,1,0,0,1,8,-31,1,Keegan Murray,SAC,SAC,NOP,0.5,Blocked Shots,9,9,8,1
22023,1631099,22300500,"JAN 07, 2024",SAC vs. NOP,L,26,2,9,0.222,1,6,0.167,3,3,1.0,1,0,1,0,1,0,0,1,8,-31,1,Keegan Murray,SAC,SAC,NOP,1.5,Blks+Stls,9,9,8,1
22023,1631099,22300492,"JAN 05, 2024",SAC vs. TOR,W,35,6,11,0.545,4,4,1.0,2,4,0.5,3,9,12,1,1,0,3,1,18,-3,1,Keegan Murray,SAC,SAC,TOR,15.0,Points,31,30,19,13
22023,1631099,22300492,"JAN 05, 2024",SAC vs. TOR,W,35,6,11,0.545,4,4,1.0,2,4,0.5,3,9,12,1,1,0,3,1,18,-3,1,Keegan Murray,SAC,SAC,TOR,5.0,Rebounds,31,30,19,13
22023,1631099,22300492,"JAN 05, 2024",SAC vs. TOR,W,35,6,11,0.545,4,4,1.0,2,4,0.5,3,9,12,1,1,0,3,1,18,-3,1,Keegan Murray,SAC,SAC,TOR,21.5,Pts+Rebs+Asts,31,30,19,13
22023,1631099,22300492,"JAN 05, 2024",SAC vs. TOR,W,35,6,11,0.545,4,4,1.0,2,4,0.5,3,9,12,1,1,0,3,1,18,-3,1,Keegan Murray,SAC,SAC,TOR,25.5,Fantasy Score,31,30,19,13
22023,1631099,22300492,"JAN 05, 2024",SAC vs. TOR,W,35,6,11,0.545,4,4,1.0,2,4,0.5,3,9,12,1,1,0,3,1,18,-3,1,Keegan Murray,SAC,SAC,TOR,6.5,3-PT Attempted,31,30,19,13
22023,1631099,22300492,"JAN 05, 2024",SAC vs. TOR,W,35,6,11,0.545,4,4,1.0,2,4,0.5,3,9,12,1,1,0,3,1,18,-3,1,Keegan Murray,SAC,SAC,TOR,20.5,Pts+Rebs,31,30,19,13
22023,1631099,22300492,"JAN 05, 2024",SAC vs. TOR,W,35,6,11,0.545,4,4,1.0,2,4,0.5,3,9,12,1,1,0,3,1,18,-3,1,Keegan Murray,SAC,SAC,TOR,0.5,Dunks,31,30,19,13
22023,1631099,22300492,"JAN 05, 2024",SAC vs. TOR,W,35,6,11,0.545,4,4,1.0,2,4,0.5,3,9,12,1,1,0,3,1,18,-3,1,Keegan Murray,SAC,SAC,TOR,16.5,Pts+Asts,31,30,19,13
22023,1631099,22300492,"JAN 05, 2024",SAC vs. TOR,W,35,6,11,0.545,4,4,1.0,2,4,0.5,3,9,12,1,1,0,3,1,18,-3,1,Keegan Murray,SAC,SAC,TOR,0.5,Blocked Shots,31,30,19,13
22023,1631099,22300492,"JAN 05, 2024",SAC vs. TOR,W,35,6,11,0.545,4,4,1.0,2,4,0.5,3,9,12,1,1,0,3,1,18,-3,1,Keegan Murray,SAC,SAC,TOR,1.5,Blks+Stls,31,30,19,13
22023,1631099,22300476,"JAN 03, 2024",SAC vs. ORL,W,46,13,21,0.619,2,6,0.333,0,0,0.0,4,8,12,1,1,0,0,0,28,-7,1,Keegan Murray,SAC,SAC,ORL,15.0,Points,41,40,29,13
22023,1631099,22300476,"JAN 03, 2024",SAC vs. ORL,W,46,13,21,0.619,2,6,0.333,0,0,0.0,4,8,12,1,1,0,0,0,28,-7,1,Keegan Murray,SAC,SAC,ORL,5.0,Rebounds,41,40,29,13
22023,1631099,22300476,"JAN 03, 2024",SAC vs. ORL,W,46,13,21,0.619,2,6,0.333,0,0,0.0,4,8,12,1,1,0,0,0,28,-7,1,Keegan Murray,SAC,SAC,ORL,21.5,Pts+Rebs+Asts,41,40,29,13
22023,1631099,22300476,"JAN 03, 2024",SAC vs. ORL,W,46,13,21,0.619,2,6,0.333,0,0,0.0,4,8,12,1,1,0,0,0,28,-7,1,Keegan Murray,SAC,SAC,ORL,25.5,Fantasy Score,41,40,29,13
22023,1631099,22300476,"JAN 03, 2024",SAC vs. ORL,W,46,13,21,0.619,2,6,0.333,0,0,0.0,4,8,12,1,1,0,0,0,28,-7,1,Keegan Murray,SAC,SAC,ORL,6.5,3-PT Attempted,41,40,29,13
22023,1631099,22300476,"JAN 03, 2024",SAC vs. ORL,W,46,13,21,0.619,2,6,0.333,0,0,0.0,4,8,12,1,1,0,0,0,28,-7,1,Keegan Murray,SAC,SAC,ORL,20.5,Pts+Rebs,41,40,29,13
22023,1631099,22300476,"JAN 03, 2024",SAC vs. ORL,W,46,13,21,0.619,2,6,0.333,0,0,0.0,4,8,12,1,1,0,0,0,28,-7,1,Keegan Murray,SAC,SAC,ORL,0.5,Dunks,41,40,29,13
22023,1631099,22300476,"JAN 03, 2024",SAC vs. ORL,W,46,13,21,0.619,2,6,0.333,0,0,0.0,4,8,12,1,1,0,0,0,28,-7,1,Keegan Murray,SAC,SAC,ORL,16.5,Pts+Asts,41,40,29,13
22023,1631099,22300476,"JAN 03, 2024",SAC vs. ORL,W,46,13,21,0.619,2,6,0.333,0,0,0.0,4,8,12,1,1,0,0,0,28,-7,1,Keegan Murray,SAC,SAC,ORL,0.5,Blocked Shots,41,40,29,13
22023,1631099,22300476,"JAN 03, 2024",SAC vs. ORL,W,46,13,21,0.619,2,6,0.333,0,0,0.0,4,8,12,1,1,0,0,0,28,-7,1,Keegan Murray,SAC,SAC,ORL,1.5,Blks+Stls,41,40,29,13
22023,1631099,22300464,"JAN 02, 2024",SAC vs. CHA,L,37,4,12,0.333,1,6,0.167,1,2,0.5,1,2,3,2,3,0,1,5,10,-8,1,Keegan Murray,SAC,SAC,CHA,15.0,Points,15,13,12,5
22023,1631099,22300464,"JAN 02, 2024",SAC vs. CHA,L,37,4,12,0.333,1,6,0.167,1,2,0.5,1,2,3,2,3,0,1,5,10,-8,1,Keegan Murray,SAC,SAC,CHA,5.0,Rebounds,15,13,12,5
22023,1631099,22300464,"JAN 02, 2024",SAC vs. CHA,L,37,4,12,0.333,1,6,0.167,1,2,0.5,1,2,3,2,3,0,1,5,10,-8,1,Keegan Murray,SAC,SAC,CHA,21.5,Pts+Rebs+Asts,15,13,12,5
22023,1631099,22300464,"JAN 02, 2024",SAC vs. CHA,L,37,4,12,0.333,1,6,0.167,1,2,0.5,1,2,3,2,3,0,1,5,10,-8,1,Keegan Murray,SAC,SAC,CHA,25.5,Fantasy Score,15,13,12,5
22023,1631099,22300464,"JAN 02, 2024",SAC vs. CHA,L,37,4,12,0.333,1,6,0.167,1,2,0.5,1,2,3,2,3,0,1,5,10,-8,1,Keegan Murray,SAC,SAC,CHA,6.5,3-PT Attempted,15,13,12,5
22023,1631099,22300464,"JAN 02, 2024",SAC vs. CHA,L,37,4,12,0.333,1,6,0.167,1,2,0.5,1,2,3,2,3,0,1,5,10,-8,1,Keegan Murray,SAC,SAC,CHA,20.5,Pts+Rebs,15,13,12,5
22023,1631099,22300464,"JAN 02, 2024",SAC vs. CHA,L,37,4,12,0.333,1,6,0.167,1,2,0.5,1,2,3,2,3,0,1,5,10,-8,1,Keegan Murray,SAC,SAC,CHA,0.5,Dunks,15,13,12,5
22023,1631099,22300464,"JAN 02, 2024",SAC vs. CHA,L,37,4,12,0.333,1,6,0.167,1,2,0.5,1,2,3,2,3,0,1,5,10,-8,1,Keegan Murray,SAC,SAC,CHA,16.5,Pts+Asts,15,13,12,5
22023,1631099,22300464,"JAN 02, 2024",SAC vs. CHA,L,37,4,12,0.333,1,6,0.167,1,2,0.5,1,2,3,2,3,0,1,5,10,-8,1,Keegan Murray,SAC,SAC,CHA,0.5,Blocked Shots,15,13,12,5
22023,1631099,22300464,"JAN 02, 2024",SAC vs. CHA,L,37,4,12,0.333,1,6,0.167,1,2,0.5,1,2,3,2,3,0,1,5,10,-8,1,Keegan Murray,SAC,SAC,CHA,1.5,Blks+Stls,15,13,12,5
22023,1631099,22300449,"DEC 31, 2023",SAC @ MEM,W,26,4,9,0.444,2,4,0.5,0,0,0.0,1,2,3,1,0,0,1,1,10,13,1,Keegan Murray,SAC,MEM,SAC,15.0,Points,14,13,11,4
22023,1631099,22300449,"DEC 31, 2023",SAC @ MEM,W,26,4,9,0.444,2,4,0.5,0,0,0.0,1,2,3,1,0,0,1,1,10,13,1,Keegan Murray,SAC,MEM,SAC,5.0,Rebounds,14,13,11,4
22023,1631099,22300449,"DEC 31, 2023",SAC @ MEM,W,26,4,9,0.444,2,4,0.5,0,0,0.0,1,2,3,1,0,0,1,1,10,13,1,Keegan Murray,SAC,MEM,SAC,21.5,Pts+Rebs+Asts,14,13,11,4
22023,1631099,22300449,"DEC 31, 2023",SAC @ MEM,W,26,4,9,0.444,2,4,0.5,0,0,0.0,1,2,3,1,0,0,1,1,10,13,1,Keegan Murray,SAC,MEM,SAC,25.5,Fantasy Score,14,13,11,4
22023,1631099,22300449,"DEC 31, 2023",SAC @ MEM,W,26,4,9,0.444,2,4,0.5,0,0,0.0,1,2,3,1,0,0,1,1,10,13,1,Keegan Murray,SAC,MEM,SAC,6.5,3-PT Attempted,14,13,11,4
22023,1631099,22300449,"DEC 31, 2023",SAC @ MEM,W,26,4,9,0.444,2,4,0.5,0,0,0.0,1,2,3,1,0,0,1,1,10,13,1,Keegan Murray,SAC,MEM,SAC,20.5,Pts+Rebs,14,13,11,4
22023,1631099,22300449,"DEC 31, 2023",SAC @ MEM,W,26,4,9,0.444,2,4,0.5,0,0,0.0,1,2,3,1,0,0,1,1,10,13,1,Keegan Murray,SAC,MEM,SAC,0.5,Dunks,14,13,11,4
22023,1631099,22300449,"DEC 31, 2023",SAC @ MEM,W,26,4,9,0.444,2,4,0.5,0,0,0.0,1,2,3,1,0,0,1,1,10,13,1,Keegan Murray,SAC,MEM,SAC,16.5,Pts+Asts,14,13,11,4
22023,1631099,22300449,"DEC 31, 2023",SAC @ MEM,W,26,4,9,0.444,2,4,0.5,0,0,0.0,1,2,3,1,0,0,1,1,10,13,1,Keegan Murray,SAC,MEM,SAC,0.5,Blocked Shots,14,13,11,4
22023,1631099,22300449,"DEC 31, 2023",SAC @ MEM,W,26,4,9,0.444,2,4,0.5,0,0,0.0,1,2,3,1,0,0,1,1,10,13,1,Keegan Murray,SAC,MEM,SAC,1.5,Blks+Stls,14,13,11,4
22023,1631099,22300431,"DEC 29, 2023",SAC @ ATL,W,36,4,12,0.333,1,6,0.167,0,0,0.0,0,5,5,0,2,2,0,5,9,-3,1,Keegan Murray,SAC,ATL,SAC,15.0,Points,14,14,9,5
22023,1631099,22300431,"DEC 29, 2023",SAC @ ATL,W,36,4,12,0.333,1,6,0.167,0,0,0.0,0,5,5,0,2,2,0,5,9,-3,1,Keegan Murray,SAC,ATL,SAC,5.0,Rebounds,14,14,9,5
22023,1631099,22300431,"DEC 29, 2023",SAC @ ATL,W,36,4,12,0.333,1,6,0.167,0,0,0.0,0,5,5,0,2,2,0,5,9,-3,1,Keegan Murray,SAC,ATL,SAC,21.5,Pts+Rebs+Asts,14,14,9,5
22023,1631099,22300431,"DEC 29, 2023",SAC @ ATL,W,36,4,12,0.333,1,6,0.167,0,0,0.0,0,5,5,0,2,2,0,5,9,-3,1,Keegan Murray,SAC,ATL,SAC,25.5,Fantasy Score,14,14,9,5
22023,1631099,22300431,"DEC 29, 2023",SAC @ ATL,W,36,4,12,0.333,1,6,0.167,0,0,0.0,0,5,5,0,2,2,0,5,9,-3,1,Keegan Murray,SAC,ATL,SAC,6.5,3-PT Attempted,14,14,9,5
22023,1631099,22300431,"DEC 29, 2023",SAC @ ATL,W,36,4,12,0.333,1,6,0.167,0,0,0.0,0,5,5,0,2,2,0,5,9,-3,1,Keegan Murray,SAC,ATL,SAC,20.5,Pts+Rebs,14,14,9,5
22023,1631099,22300431,"DEC 29, 2023",SAC @ ATL,W,36,4,12,0.333,1,6,0.167,0,0,0.0,0,5,5,0,2,2,0,5,9,-3,1,Keegan Murray,SAC,ATL,SAC,0.5,Dunks,14,14,9,5
22023,1631099,22300431,"DEC 29, 2023",SAC @ ATL,W,36,4,12,0.333,1,6,0.167,0,0,0.0,0,5,5,0,2,2,0,5,9,-3,1,Keegan Murray,SAC,ATL,SAC,16.5,Pts+Asts,14,14,9,5
22023,1631099,22300431,"DEC 29, 2023",SAC @ ATL,W,36,4,12,0.333,1,6,0.167,0,0,0.0,0,5,5,0,2,2,0,5,9,-3,1,Keegan Murray,SAC,ATL,SAC,0.5,Blocked Shots,14,14,9,5
22023,1631099,22300431,"DEC 29, 2023",SAC @ ATL,W,36,4,12,0.333,1,6,0.167,0,0,0.0,0,5,5,0,2,2,0,5,9,-3,1,Keegan Murray,SAC,ATL,SAC,1.5,Blks+Stls,14,14,9,5
22023,1631099,22300413,"DEC 26, 2023",SAC @ POR,L,36,2,11,0.182,1,7,0.143,0,0,0.0,1,3,4,2,1,1,0,1,5,-10,1,Keegan Murray,SAC,POR,SAC,15.0,Points,11,9,7,6
22023,1631099,22300413,"DEC 26, 2023",SAC @ POR,L,36,2,11,0.182,1,7,0.143,0,0,0.0,1,3,4,2,1,1,0,1,5,-10,1,Keegan Murray,SAC,POR,SAC,5.0,Rebounds,11,9,7,6
22023,1631099,22300413,"DEC 26, 2023",SAC @ POR,L,36,2,11,0.182,1,7,0.143,0,0,0.0,1,3,4,2,1,1,0,1,5,-10,1,Keegan Murray,SAC,POR,SAC,21.5,Pts+Rebs+Asts,11,9,7,6
22023,1631099,22300413,"DEC 26, 2023",SAC @ POR,L,36,2,11,0.182,1,7,0.143,0,0,0.0,1,3,4,2,1,1,0,1,5,-10,1,Keegan Murray,SAC,POR,SAC,25.5,Fantasy Score,11,9,7,6
22023,1631099,22300413,"DEC 26, 2023",SAC @ POR,L,36,2,11,0.182,1,7,0.143,0,0,0.0,1,3,4,2,1,1,0,1,5,-10,1,Keegan Murray,SAC,POR,SAC,6.5,3-PT Attempted,11,9,7,6
22023,1631099,22300413,"DEC 26, 2023",SAC @ POR,L,36,2,11,0.182,1,7,0.143,0,0,0.0,1,3,4,2,1,1,0,1,5,-10,1,Keegan Murray,SAC,POR,SAC,20.5,Pts+Rebs,11,9,7,6
22023,1631099,22300413,"DEC 26, 2023",SAC @ POR,L,36,2,11,0.182,1,7,0.143,0,0,0.0,1,3,4,2,1,1,0,1,5,-10,1,Keegan Murray,SAC,POR,SAC,0.5,Dunks,11,9,7,6
22023,1631099,22300413,"DEC 26, 2023",SAC @ POR,L,36,2,11,0.182,1,7,0.143,0,0,0.0,1,3,4,2,1,1,0,1,5,-10,1,Keegan Murray,SAC,POR,SAC,16.5,Pts+Asts,11,9,7,6
22023,1631099,22300413,"DEC 26, 2023",SAC @ POR,L,36,2,11,0.182,1,7,0.143,0,0,0.0,1,3,4,2,1,1,0,1,5,-10,1,Keegan Murray,SAC,POR,SAC,0.5,Blocked Shots,11,9,7,6
22023,1631099,22300413,"DEC 26, 2023",SAC @ POR,L,36,2,11,0.182,1,7,0.143,0,0,0.0,1,3,4,2,1,1,0,1,5,-10,1,Keegan Murray,SAC,POR,SAC,1.5,Blks+Stls,11,9,7,6
22023,1631099,22300400,"DEC 23, 2023",SAC vs. MIN,L,40,8,16,0.5,3,7,0.429,1,2,0.5,1,6,7,0,3,1,1,4,20,-8,1,Keegan Murray,SAC,SAC,MIN,15.0,Points,27,27,20,7
22023,1631099,22300400,"DEC 23, 2023",SAC vs. MIN,L,40,8,16,0.5,3,7,0.429,1,2,0.5,1,6,7,0,3,1,1,4,20,-8,1,Keegan Murray,SAC,SAC,MIN,5.0,Rebounds,27,27,20,7
22023,1631099,22300400,"DEC 23, 2023",SAC vs. MIN,L,40,8,16,0.5,3,7,0.429,1,2,0.5,1,6,7,0,3,1,1,4,20,-8,1,Keegan Murray,SAC,SAC,MIN,21.5,Pts+Rebs+Asts,27,27,20,7
22023,1631099,22300400,"DEC 23, 2023",SAC vs. MIN,L,40,8,16,0.5,3,7,0.429,1,2,0.5,1,6,7,0,3,1,1,4,20,-8,1,Keegan Murray,SAC,SAC,MIN,25.5,Fantasy Score,27,27,20,7
22023,1631099,22300400,"DEC 23, 2023",SAC vs. MIN,L,40,8,16,0.5,3,7,0.429,1,2,0.5,1,6,7,0,3,1,1,4,20,-8,1,Keegan Murray,SAC,SAC,MIN,6.5,3-PT Attempted,27,27,20,7
22023,1631099,22300400,"DEC 23, 2023",SAC vs. MIN,L,40,8,16,0.5,3,7,0.429,1,2,0.5,1,6,7,0,3,1,1,4,20,-8,1,Keegan Murray,SAC,SAC,MIN,20.5,Pts+Rebs,27,27,20,7
22023,1631099,22300400,"DEC 23, 2023",SAC vs. MIN,L,40,8,16,0.5,3,7,0.429,1,2,0.5,1,6,7,0,3,1,1,4,20,-8,1,Keegan Murray,SAC,SAC,MIN,0.5,Dunks,27,27,20,7
22023,1631099,22300400,"DEC 23, 2023",SAC vs. MIN,L,40,8,16,0.5,3,7,0.429,1,2,0.5,1,6,7,0,3,1,1,4,20,-8,1,Keegan Murray,SAC,SAC,MIN,16.5,Pts+Asts,27,27,20,7
22023,1631099,22300400,"DEC 23, 2023",SAC vs. MIN,L,40,8,16,0.5,3,7,0.429,1,2,0.5,1,6,7,0,3,1,1,4,20,-8,1,Keegan Murray,SAC,SAC,MIN,0.5,Blocked Shots,27,27,20,7
22023,1631099,22300400,"DEC 23, 2023",SAC vs. MIN,L,40,8,16,0.5,3,7,0.429,1,2,0.5,1,6,7,0,3,1,1,4,20,-8,1,Keegan Murray,SAC,SAC,MIN,1.5,Blks+Stls,27,27,20,7
22023,1631099,22300387,"DEC 22, 2023",SAC vs. PHX,W,33,8,13,0.615,3,7,0.429,2,2,1.0,1,4,5,2,0,0,1,3,21,25,1,Keegan Murray,SAC,SAC,PHX,15.0,Points,28,26,23,7
22023,1631099,22300387,"DEC 22, 2023",SAC vs. PHX,W,33,8,13,0.615,3,7,0.429,2,2,1.0,1,4,5,2,0,0,1,3,21,25,1,Keegan Murray,SAC,SAC,PHX,5.0,Rebounds,28,26,23,7
22023,1631099,22300387,"DEC 22, 2023",SAC vs. PHX,W,33,8,13,0.615,3,7,0.429,2,2,1.0,1,4,5,2,0,0,1,3,21,25,1,Keegan Murray,SAC,SAC,PHX,21.5,Pts+Rebs+Asts,28,26,23,7
22023,1631099,22300387,"DEC 22, 2023",SAC vs. PHX,W,33,8,13,0.615,3,7,0.429,2,2,1.0,1,4,5,2,0,0,1,3,21,25,1,Keegan Murray,SAC,SAC,PHX,25.5,Fantasy Score,28,26,23,7
22023,1631099,22300387,"DEC 22, 2023",SAC vs. PHX,W,33,8,13,0.615,3,7,0.429,2,2,1.0,1,4,5,2,0,0,1,3,21,25,1,Keegan Murray,SAC,SAC,PHX,6.5,3-PT Attempted,28,26,23,7
22023,1631099,22300387,"DEC 22, 2023",SAC vs. PHX,W,33,8,13,0.615,3,7,0.429,2,2,1.0,1,4,5,2,0,0,1,3,21,25,1,Keegan Murray,SAC,SAC,PHX,20.5,Pts+Rebs,28,26,23,7
22023,1631099,22300387,"DEC 22, 2023",SAC vs. PHX,W,33,8,13,0.615,3,7,0.429,2,2,1.0,1,4,5,2,0,0,1,3,21,25,1,Keegan Murray,SAC,SAC,PHX,0.5,Dunks,28,26,23,7
22023,1631099,22300387,"DEC 22, 2023",SAC vs. PHX,W,33,8,13,0.615,3,7,0.429,2,2,1.0,1,4,5,2,0,0,1,3,21,25,1,Keegan Murray,SAC,SAC,PHX,16.5,Pts+Asts,28,26,23,7
22023,1631099,22300387,"DEC 22, 2023",SAC vs. PHX,W,33,8,13,0.615,3,7,0.429,2,2,1.0,1,4,5,2,0,0,1,3,21,25,1,Keegan Murray,SAC,SAC,PHX,0.5,Blocked Shots,28,26,23,7
22023,1631099,22300387,"DEC 22, 2023",SAC vs. PHX,W,33,8,13,0.615,3,7,0.429,2,2,1.0,1,4,5,2,0,0,1,3,21,25,1,Keegan Murray,SAC,SAC,PHX,1.5,Blks+Stls,28,26,23,7
22023,1631099,22300373,"DEC 20, 2023",SAC vs. BOS,L,26,5,11,0.455,3,7,0.429,0,0,0.0,1,0,1,0,0,0,1,4,13,-23,1,Keegan Murray,SAC,SAC,BOS,15.0,Points,14,14,13,1
22023,1631099,22300373,"DEC 20, 2023",SAC vs. BOS,L,26,5,11,0.455,3,7,0.429,0,0,0.0,1,0,1,0,0,0,1,4,13,-23,1,Keegan Murray,SAC,SAC,BOS,5.0,Rebounds,14,14,13,1
22023,1631099,22300373,"DEC 20, 2023",SAC vs. BOS,L,26,5,11,0.455,3,7,0.429,0,0,0.0,1,0,1,0,0,0,1,4,13,-23,1,Keegan Murray,SAC,SAC,BOS,21.5,Pts+Rebs+Asts,14,14,13,1
22023,1631099,22300373,"DEC 20, 2023",SAC vs. BOS,L,26,5,11,0.455,3,7,0.429,0,0,0.0,1,0,1,0,0,0,1,4,13,-23,1,Keegan Murray,SAC,SAC,BOS,25.5,Fantasy Score,14,14,13,1
22023,1631099,22300373,"DEC 20, 2023",SAC vs. BOS,L,26,5,11,0.455,3,7,0.429,0,0,0.0,1,0,1,0,0,0,1,4,13,-23,1,Keegan Murray,SAC,SAC,BOS,6.5,3-PT Attempted,14,14,13,1
22023,1631099,22300373,"DEC 20, 2023",SAC vs. BOS,L,26,5,11,0.455,3,7,0.429,0,0,0.0,1,0,1,0,0,0,1,4,13,-23,1,Keegan Murray,SAC,SAC,BOS,20.5,Pts+Rebs,14,14,13,1
22023,1631099,22300373,"DEC 20, 2023",SAC vs. BOS,L,26,5,11,0.455,3,7,0.429,0,0,0.0,1,0,1,0,0,0,1,4,13,-23,1,Keegan Murray,SAC,SAC,BOS,0.5,Dunks,14,14,13,1
22023,1631099,22300373,"DEC 20, 2023",SAC vs. BOS,L,26,5,11,0.455,3,7,0.429,0,0,0.0,1,0,1,0,0,0,1,4,13,-23,1,Keegan Murray,SAC,SAC,BOS,16.5,Pts+Asts,14,14,13,1
22023,1631099,22300373,"DEC 20, 2023",SAC vs. BOS,L,26,5,11,0.455,3,7,0.429,0,0,0.0,1,0,1,0,0,0,1,4,13,-23,1,Keegan Murray,SAC,SAC,BOS,0.5,Blocked Shots,14,14,13,1
22023,1631099,22300373,"DEC 20, 2023",SAC vs. BOS,L,26,5,11,0.455,3,7,0.429,0,0,0.0,1,0,1,0,0,0,1,4,13,-23,1,Keegan Murray,SAC,SAC,BOS,1.5,Blks+Stls,14,14,13,1
22023,1631099,22300358,"DEC 18, 2023",SAC vs. WAS,W,32,9,17,0.529,4,7,0.571,3,3,1.0,1,4,5,4,1,0,0,4,25,20,1,Keegan Murray,SAC,SAC,WAS,15.0,Points,34,30,29,9
22023,1631099,22300358,"DEC 18, 2023",SAC vs. WAS,W,32,9,17,0.529,4,7,0.571,3,3,1.0,1,4,5,4,1,0,0,4,25,20,1,Keegan Murray,SAC,SAC,WAS,5.0,Rebounds,34,30,29,9
22023,1631099,22300358,"DEC 18, 2023",SAC vs. WAS,W,32,9,17,0.529,4,7,0.571,3,3,1.0,1,4,5,4,1,0,0,4,25,20,1,Keegan Murray,SAC,SAC,WAS,21.5,Pts+Rebs+Asts,34,30,29,9
22023,1631099,22300358,"DEC 18, 2023",SAC vs. WAS,W,32,9,17,0.529,4,7,0.571,3,3,1.0,1,4,5,4,1,0,0,4,25,20,1,Keegan Murray,SAC,SAC,WAS,25.5,Fantasy Score,34,30,29,9
22023,1631099,22300358,"DEC 18, 2023",SAC vs. WAS,W,32,9,17,0.529,4,7,0.571,3,3,1.0,1,4,5,4,1,0,0,4,25,20,1,Keegan Murray,SAC,SAC,WAS,6.5,3-PT Attempted,34,30,29,9
22023,1631099,22300358,"DEC 18, 2023",SAC vs. WAS,W,32,9,17,0.529,4,7,0.571,3,3,1.0,1,4,5,4,1,0,0,4,25,20,1,Keegan Murray,SAC,SAC,WAS,20.5,Pts+Rebs,34,30,29,9
22023,1631099,22300358,"DEC 18, 2023",SAC vs. WAS,W,32,9,17,0.529,4,7,0.571,3,3,1.0,1,4,5,4,1,0,0,4,25,20,1,Keegan Murray,SAC,SAC,WAS,0.5,Dunks,34,30,29,9
22023,1631099,22300358,"DEC 18, 2023",SAC vs. WAS,W,32,9,17,0.529,4,7,0.571,3,3,1.0,1,4,5,4,1,0,0,4,25,20,1,Keegan Murray,SAC,SAC,WAS,16.5,Pts+Asts,34,30,29,9
22023,1631099,22300358,"DEC 18, 2023",SAC vs. WAS,W,32,9,17,0.529,4,7,0.571,3,3,1.0,1,4,5,4,1,0,0,4,25,20,1,Keegan Murray,SAC,SAC,WAS,0.5,Blocked Shots,34,30,29,9
22023,1631099,22300358,"DEC 18, 2023",SAC vs. WAS,W,32,9,17,0.529,4,7,0.571,3,3,1.0,1,4,5,4,1,0,0,4,25,20,1,Keegan Murray,SAC,SAC,WAS,1.5,Blks+Stls,34,30,29,9
22023,1631099,22300342,"DEC 16, 2023",SAC vs. UTA,W,36,16,23,0.696,12,15,0.8,3,4,0.75,1,7,8,2,2,0,0,1,47,33,1,Keegan Murray,SAC,SAC,UTA,15.0,Points,57,55,49,10
22023,1631099,22300342,"DEC 16, 2023",SAC vs. UTA,W,36,16,23,0.696,12,15,0.8,3,4,0.75,1,7,8,2,2,0,0,1,47,33,1,Keegan Murray,SAC,SAC,UTA,5.0,Rebounds,57,55,49,10
22023,1631099,22300342,"DEC 16, 2023",SAC vs. UTA,W,36,16,23,0.696,12,15,0.8,3,4,0.75,1,7,8,2,2,0,0,1,47,33,1,Keegan Murray,SAC,SAC,UTA,21.5,Pts+Rebs+Asts,57,55,49,10
22023,1631099,22300342,"DEC 16, 2023",SAC vs. UTA,W,36,16,23,0.696,12,15,0.8,3,4,0.75,1,7,8,2,2,0,0,1,47,33,1,Keegan Murray,SAC,SAC,UTA,25.5,Fantasy Score,57,55,49,10
22023,1631099,22300342,"DEC 16, 2023",SAC vs. UTA,W,36,16,23,0.696,12,15,0.8,3,4,0.75,1,7,8,2,2,0,0,1,47,33,1,Keegan Murray,SAC,SAC,UTA,6.5,3-PT Attempted,57,55,49,10
22023,1631099,22300342,"DEC 16, 2023",SAC vs. UTA,W,36,16,23,0.696,12,15,0.8,3,4,0.75,1,7,8,2,2,0,0,1,47,33,1,Keegan Murray,SAC,SAC,UTA,20.5,Pts+Rebs,57,55,49,10
22023,1631099,22300342,"DEC 16, 2023",SAC vs. UTA,W,36,16,23,0.696,12,15,0.8,3,4,0.75,1,7,8,2,2,0,0,1,47,33,1,Keegan Murray,SAC,SAC,UTA,0.5,Dunks,57,55,49,10
22023,1631099,22300342,"DEC 16, 2023",SAC vs. UTA,W,36,16,23,0.696,12,15,0.8,3,4,0.75,1,7,8,2,2,0,0,1,47,33,1,Keegan Murray,SAC,SAC,UTA,16.5,Pts+Asts,57,55,49,10
22023,1631099,22300342,"DEC 16, 2023",SAC vs. UTA,W,36,16,23,0.696,12,15,0.8,3,4,0.75,1,7,8,2,2,0,0,1,47,33,1,Keegan Murray,SAC,SAC,UTA,0.5,Blocked Shots,57,55,49,10
22023,1631099,22300342,"DEC 16, 2023",SAC vs. UTA,W,36,16,23,0.696,12,15,0.8,3,4,0.75,1,7,8,2,2,0,0,1,47,33,1,Keegan Murray,SAC,SAC,UTA,1.5,Blks+Stls,57,55,49,10
22023,1631099,22300324,"DEC 14, 2023",SAC vs. OKC,W,31,4,8,0.5,0,2,0.0,7,8,0.875,2,1,3,1,1,0,1,4,15,-12,1,Keegan Murray,SAC,SAC,OKC,15.0,Points,19,18,16,4
22023,1631099,22300324,"DEC 14, 2023",SAC vs. OKC,W,31,4,8,0.5,0,2,0.0,7,8,0.875,2,1,3,1,1,0,1,4,15,-12,1,Keegan Murray,SAC,SAC,OKC,5.0,Rebounds,19,18,16,4
22023,1631099,22300324,"DEC 14, 2023",SAC vs. OKC,W,31,4,8,0.5,0,2,0.0,7,8,0.875,2,1,3,1,1,0,1,4,15,-12,1,Keegan Murray,SAC,SAC,OKC,21.5,Pts+Rebs+Asts,19,18,16,4
22023,1631099,22300324,"DEC 14, 2023",SAC vs. OKC,W,31,4,8,0.5,0,2,0.0,7,8,0.875,2,1,3,1,1,0,1,4,15,-12,1,Keegan Murray,SAC,SAC,OKC,25.5,Fantasy Score,19,18,16,4
22023,1631099,22300324,"DEC 14, 2023",SAC vs. OKC,W,31,4,8,0.5,0,2,0.0,7,8,0.875,2,1,3,1,1,0,1,4,15,-12,1,Keegan Murray,SAC,SAC,OKC,6.5,3-PT Attempted,19,18,16,4
22023,1631099,22300324,"DEC 14, 2023",SAC vs. OKC,W,31,4,8,0.5,0,2,0.0,7,8,0.875,2,1,3,1,1,0,1,4,15,-12,1,Keegan Murray,SAC,SAC,OKC,20.5,Pts+Rebs,19,18,16,4
22023,1631099,22300324,"DEC 14, 2023",SAC vs. OKC,W,31,4,8,0.5,0,2,0.0,7,8,0.875,2,1,3,1,1,0,1,4,15,-12,1,Keegan Murray,SAC,SAC,OKC,0.5,Dunks,19,18,16,4
22023,1631099,22300324,"DEC 14, 2023",SAC vs. OKC,W,31,4,8,0.5,0,2,0.0,7,8,0.875,2,1,3,1,1,0,1,4,15,-12,1,Keegan Murray,SAC,SAC,OKC,16.5,Pts+Asts,19,18,16,4
22023,1631099,22300324,"DEC 14, 2023",SAC vs. OKC,W,31,4,8,0.5,0,2,0.0,7,8,0.875,2,1,3,1,1,0,1,4,15,-12,1,Keegan Murray,SAC,SAC,OKC,0.5,Blocked Shots,19,18,16,4
22023,1631099,22300324,"DEC 14, 2023",SAC vs. OKC,W,31,4,8,0.5,0,2,0.0,7,8,0.875,2,1,3,1,1,0,1,4,15,-12,1,Keegan Murray,SAC,SAC,OKC,1.5,Blks+Stls,19,18,16,4
22023,1631099,22300309,"DEC 12, 2023",SAC @ LAC,L,31,6,14,0.429,0,5,0.0,5,6,0.833,0,7,7,1,3,0,0,2,17,-21,1,Keegan Murray,SAC,LAC,SAC,15.0,Points,25,24,18,8
22023,1631099,22300309,"DEC 12, 2023",SAC @ LAC,L,31,6,14,0.429,0,5,0.0,5,6,0.833,0,7,7,1,3,0,0,2,17,-21,1,Keegan Murray,SAC,LAC,SAC,5.0,Rebounds,25,24,18,8
22023,1631099,22300309,"DEC 12, 2023",SAC @ LAC,L,31,6,14,0.429,0,5,0.0,5,6,0.833,0,7,7,1,3,0,0,2,17,-21,1,Keegan Murray,SAC,LAC,SAC,21.5,Pts+Rebs+Asts,25,24,18,8
22023,1631099,22300309,"DEC 12, 2023",SAC @ LAC,L,31,6,14,0.429,0,5,0.0,5,6,0.833,0,7,7,1,3,0,0,2,17,-21,1,Keegan Murray,SAC,LAC,SAC,25.5,Fantasy Score,25,24,18,8
22023,1631099,22300309,"DEC 12, 2023",SAC @ LAC,L,31,6,14,0.429,0,5,0.0,5,6,0.833,0,7,7,1,3,0,0,2,17,-21,1,Keegan Murray,SAC,LAC,SAC,6.5,3-PT Attempted,25,24,18,8
22023,1631099,22300309,"DEC 12, 2023",SAC @ LAC,L,31,6,14,0.429,0,5,0.0,5,6,0.833,0,7,7,1,3,0,0,2,17,-21,1,Keegan Murray,SAC,LAC,SAC,20.5,Pts+Rebs,25,24,18,8
22023,1631099,22300309,"DEC 12, 2023",SAC @ LAC,L,31,6,14,0.429,0,5,0.0,5,6,0.833,0,7,7,1,3,0,0,2,17,-21,1,Keegan Murray,SAC,LAC,SAC,0.5,Dunks,25,24,18,8
22023,1631099,22300309,"DEC 12, 2023",SAC @ LAC,L,31,6,14,0.429,0,5,0.0,5,6,0.833,0,7,7,1,3,0,0,2,17,-21,1,Keegan Murray,SAC,LAC,SAC,16.5,Pts+Asts,25,24,18,8
22023,1631099,22300309,"DEC 12, 2023",SAC @ LAC,L,31,6,14,0.429,0,5,0.0,5,6,0.833,0,7,7,1,3,0,0,2,17,-21,1,Keegan Murray,SAC,LAC,SAC,0.5,Blocked Shots,25,24,18,8
22023,1631099,22300309,"DEC 12, 2023",SAC @ LAC,L,31,6,14,0.429,0,5,0.0,5,6,0.833,0,7,7,1,3,0,0,2,17,-21,1,Keegan Murray,SAC,LAC,SAC,1.5,Blks+Stls,25,24,18,8
22023,1631099,22300303,"DEC 11, 2023",SAC vs. BKN,W,34,9,13,0.692,4,4,1.0,2,2,1.0,1,2,3,3,0,0,0,4,24,17,1,Keegan Murray,SAC,SAC,BKN,15.0,Points,30,27,27,6
22023,1631099,22300303,"DEC 11, 2023",SAC vs. BKN,W,34,9,13,0.692,4,4,1.0,2,2,1.0,1,2,3,3,0,0,0,4,24,17,1,Keegan Murray,SAC,SAC,BKN,5.0,Rebounds,30,27,27,6
22023,1631099,22300303,"DEC 11, 2023",SAC vs. BKN,W,34,9,13,0.692,4,4,1.0,2,2,1.0,1,2,3,3,0,0,0,4,24,17,1,Keegan Murray,SAC,SAC,BKN,21.5,Pts+Rebs+Asts,30,27,27,6
22023,1631099,22300303,"DEC 11, 2023",SAC vs. BKN,W,34,9,13,0.692,4,4,1.0,2,2,1.0,1,2,3,3,0,0,0,4,24,17,1,Keegan Murray,SAC,SAC,BKN,25.5,Fantasy Score,30,27,27,6
22023,1631099,22300303,"DEC 11, 2023",SAC vs. BKN,W,34,9,13,0.692,4,4,1.0,2,2,1.0,1,2,3,3,0,0,0,4,24,17,1,Keegan Murray,SAC,SAC,BKN,6.5,3-PT Attempted,30,27,27,6
22023,1631099,22300303,"DEC 11, 2023",SAC vs. BKN,W,34,9,13,0.692,4,4,1.0,2,2,1.0,1,2,3,3,0,0,0,4,24,17,1,Keegan Murray,SAC,SAC,BKN,20.5,Pts+Rebs,30,27,27,6
22023,1631099,22300303,"DEC 11, 2023",SAC vs. BKN,W,34,9,13,0.692,4,4,1.0,2,2,1.0,1,2,3,3,0,0,0,4,24,17,1,Keegan Murray,SAC,SAC,BKN,0.5,Dunks,30,27,27,6
22023,1631099,22300303,"DEC 11, 2023",SAC vs. BKN,W,34,9,13,0.692,4,4,1.0,2,2,1.0,1,2,3,3,0,0,0,4,24,17,1,Keegan Murray,SAC,SAC,BKN,16.5,Pts+Asts,30,27,27,6
22023,1631099,22300303,"DEC 11, 2023",SAC vs. BKN,W,34,9,13,0.692,4,4,1.0,2,2,1.0,1,2,3,3,0,0,0,4,24,17,1,Keegan Murray,SAC,SAC,BKN,0.5,Blocked Shots,30,27,27,6
22023,1631099,22300303,"DEC 11, 2023",SAC vs. BKN,W,34,9,13,0.692,4,4,1.0,2,2,1.0,1,2,3,3,0,0,0,4,24,17,1,Keegan Murray,SAC,SAC,BKN,1.5,Blks+Stls,30,27,27,6
22023,1631099,22301228,"DEC 08, 2023",SAC @ PHX,W,30,6,13,0.462,1,7,0.143,0,0,0.0,2,2,4,0,1,0,1,6,13,-1,1,Keegan Murray,SAC,PHX,SAC,15.0,Points,17,17,13,4
22023,1631099,22301228,"DEC 08, 2023",SAC @ PHX,W,30,6,13,0.462,1,7,0.143,0,0,0.0,2,2,4,0,1,0,1,6,13,-1,1,Keegan Murray,SAC,PHX,SAC,5.0,Rebounds,17,17,13,4
22023,1631099,22301228,"DEC 08, 2023",SAC @ PHX,W,30,6,13,0.462,1,7,0.143,0,0,0.0,2,2,4,0,1,0,1,6,13,-1,1,Keegan Murray,SAC,PHX,SAC,21.5,Pts+Rebs+Asts,17,17,13,4
22023,1631099,22301228,"DEC 08, 2023",SAC @ PHX,W,30,6,13,0.462,1,7,0.143,0,0,0.0,2,2,4,0,1,0,1,6,13,-1,1,Keegan Murray,SAC,PHX,SAC,25.5,Fantasy Score,17,17,13,4
22023,1631099,22301228,"DEC 08, 2023",SAC @ PHX,W,30,6,13,0.462,1,7,0.143,0,0,0.0,2,2,4,0,1,0,1,6,13,-1,1,Keegan Murray,SAC,PHX,SAC,6.5,3-PT Attempted,17,17,13,4
22023,1631099,22301228,"DEC 08, 2023",SAC @ PHX,W,30,6,13,0.462,1,7,0.143,0,0,0.0,2,2,4,0,1,0,1,6,13,-1,1,Keegan Murray,SAC,PHX,SAC,20.5,Pts+Rebs,17,17,13,4
22023,1631099,22301228,"DEC 08, 2023",SAC @ PHX,W,30,6,13,0.462,1,7,0.143,0,0,0.0,2,2,4,0,1,0,1,6,13,-1,1,Keegan Murray,SAC,PHX,SAC,0.5,Dunks,17,17,13,4
22023,1631099,22301228,"DEC 08, 2023",SAC @ PHX,W,30,6,13,0.462,1,7,0.143,0,0,0.0,2,2,4,0,1,0,1,6,13,-1,1,Keegan Murray,SAC,PHX,SAC,16.5,Pts+Asts,17,17,13,4
22023,1631099,22301228,"DEC 08, 2023",SAC @ PHX,W,30,6,13,0.462,1,7,0.143,0,0,0.0,2,2,4,0,1,0,1,6,13,-1,1,Keegan Murray,SAC,PHX,SAC,0.5,Blocked Shots,17,17,13,4
22023,1631099,22301228,"DEC 08, 2023",SAC @ PHX,W,30,6,13,0.462,1,7,0.143,0,0,0.0,2,2,4,0,1,0,1,6,13,-1,1,Keegan Murray,SAC,PHX,SAC,1.5,Blks+Stls,17,17,13,4
22023,1631099,22301204,"DEC 04, 2023",SAC vs. NOP,L,31,5,11,0.455,4,8,0.5,0,0,0.0,0,4,4,1,0,0,1,5,14,-8,1,Keegan Murray,SAC,SAC,NOP,15.0,Points,19,18,15,5
22023,1631099,22301204,"DEC 04, 2023",SAC vs. NOP,L,31,5,11,0.455,4,8,0.5,0,0,0.0,0,4,4,1,0,0,1,5,14,-8,1,Keegan Murray,SAC,SAC,NOP,5.0,Rebounds,19,18,15,5
22023,1631099,22301204,"DEC 04, 2023",SAC vs. NOP,L,31,5,11,0.455,4,8,0.5,0,0,0.0,0,4,4,1,0,0,1,5,14,-8,1,Keegan Murray,SAC,SAC,NOP,21.5,Pts+Rebs+Asts,19,18,15,5
22023,1631099,22301204,"DEC 04, 2023",SAC vs. NOP,L,31,5,11,0.455,4,8,0.5,0,0,0.0,0,4,4,1,0,0,1,5,14,-8,1,Keegan Murray,SAC,SAC,NOP,25.5,Fantasy Score,19,18,15,5
22023,1631099,22301204,"DEC 04, 2023",SAC vs. NOP,L,31,5,11,0.455,4,8,0.5,0,0,0.0,0,4,4,1,0,0,1,5,14,-8,1,Keegan Murray,SAC,SAC,NOP,6.5,3-PT Attempted,19,18,15,5
22023,1631099,22301204,"DEC 04, 2023",SAC vs. NOP,L,31,5,11,0.455,4,8,0.5,0,0,0.0,0,4,4,1,0,0,1,5,14,-8,1,Keegan Murray,SAC,SAC,NOP,20.5,Pts+Rebs,19,18,15,5
22023,1631099,22301204,"DEC 04, 2023",SAC vs. NOP,L,31,5,11,0.455,4,8,0.5,0,0,0.0,0,4,4,1,0,0,1,5,14,-8,1,Keegan Murray,SAC,SAC,NOP,0.5,Dunks,19,18,15,5
22023,1631099,22301204,"DEC 04, 2023",SAC vs. NOP,L,31,5,11,0.455,4,8,0.5,0,0,0.0,0,4,4,1,0,0,1,5,14,-8,1,Keegan Murray,SAC,SAC,NOP,16.5,Pts+Asts,19,18,15,5
22023,1631099,22301204,"DEC 04, 2023",SAC vs. NOP,L,31,5,11,0.455,4,8,0.5,0,0,0.0,0,4,4,1,0,0,1,5,14,-8,1,Keegan Murray,SAC,SAC,NOP,0.5,Blocked Shots,19,18,15,5
22023,1631099,22301204,"DEC 04, 2023",SAC vs. NOP,L,31,5,11,0.455,4,8,0.5,0,0,0.0,0,4,4,1,0,0,1,5,14,-8,1,Keegan Murray,SAC,SAC,NOP,1.5,Blks+Stls,19,18,15,5
22023,1631099,22300290,"DEC 02, 2023",SAC vs. DEN,W,23,3,10,0.3,2,5,0.4,0,0,0.0,0,5,5,1,0,0,2,0,8,-16,1,Keegan Murray,SAC,SAC,DEN,15.0,Points,14,13,9,6
22023,1631099,22300290,"DEC 02, 2023",SAC vs. DEN,W,23,3,10,0.3,2,5,0.4,0,0,0.0,0,5,5,1,0,0,2,0,8,-16,1,Keegan Murray,SAC,SAC,DEN,5.0,Rebounds,14,13,9,6
22023,1631099,22300290,"DEC 02, 2023",SAC vs. DEN,W,23,3,10,0.3,2,5,0.4,0,0,0.0,0,5,5,1,0,0,2,0,8,-16,1,Keegan Murray,SAC,SAC,DEN,21.5,Pts+Rebs+Asts,14,13,9,6
22023,1631099,22300290,"DEC 02, 2023",SAC vs. DEN,W,23,3,10,0.3,2,5,0.4,0,0,0.0,0,5,5,1,0,0,2,0,8,-16,1,Keegan Murray,SAC,SAC,DEN,25.5,Fantasy Score,14,13,9,6
22023,1631099,22300290,"DEC 02, 2023",SAC vs. DEN,W,23,3,10,0.3,2,5,0.4,0,0,0.0,0,5,5,1,0,0,2,0,8,-16,1,Keegan Murray,SAC,SAC,DEN,6.5,3-PT Attempted,14,13,9,6
22023,1631099,22300290,"DEC 02, 2023",SAC vs. DEN,W,23,3,10,0.3,2,5,0.4,0,0,0.0,0,5,5,1,0,0,2,0,8,-16,1,Keegan Murray,SAC,SAC,DEN,20.5,Pts+Rebs,14,13,9,6
22023,1631099,22300290,"DEC 02, 2023",SAC vs. DEN,W,23,3,10,0.3,2,5,0.4,0,0,0.0,0,5,5,1,0,0,2,0,8,-16,1,Keegan Murray,SAC,SAC,DEN,0.5,Dunks,14,13,9,6
22023,1631099,22300290,"DEC 02, 2023",SAC vs. DEN,W,23,3,10,0.3,2,5,0.4,0,0,0.0,0,5,5,1,0,0,2,0,8,-16,1,Keegan Murray,SAC,SAC,DEN,16.5,Pts+Asts,14,13,9,6
22023,1631099,22300290,"DEC 02, 2023",SAC vs. DEN,W,23,3,10,0.3,2,5,0.4,0,0,0.0,0,5,5,1,0,0,2,0,8,-16,1,Keegan Murray,SAC,SAC,DEN,0.5,Blocked Shots,14,13,9,6
22023,1631099,22300290,"DEC 02, 2023",SAC vs. DEN,W,23,3,10,0.3,2,5,0.4,0,0,0.0,0,5,5,1,0,0,2,0,8,-16,1,Keegan Murray,SAC,SAC,DEN,1.5,Blks+Stls,14,13,9,6
22023,1631099,22300222,"NOV 20, 2023",SAC @ NOP,L,16,1,4,0.25,1,2,0.5,2,2,1.0,2,1,3,0,1,1,0,2,5,-20,1,Keegan Murray,SAC,NOP,SAC,15.0,Points,8,8,5,3
22023,1631099,22300222,"NOV 20, 2023",SAC @ NOP,L,16,1,4,0.25,1,2,0.5,2,2,1.0,2,1,3,0,1,1,0,2,5,-20,1,Keegan Murray,SAC,NOP,SAC,5.0,Rebounds,8,8,5,3
22023,1631099,22300222,"NOV 20, 2023",SAC @ NOP,L,16,1,4,0.25,1,2,0.5,2,2,1.0,2,1,3,0,1,1,0,2,5,-20,1,Keegan Murray,SAC,NOP,SAC,21.5,Pts+Rebs+Asts,8,8,5,3
22023,1631099,22300222,"NOV 20, 2023",SAC @ NOP,L,16,1,4,0.25,1,2,0.5,2,2,1.0,2,1,3,0,1,1,0,2,5,-20,1,Keegan Murray,SAC,NOP,SAC,25.5,Fantasy Score,8,8,5,3
22023,1631099,22300222,"NOV 20, 2023",SAC @ NOP,L,16,1,4,0.25,1,2,0.5,2,2,1.0,2,1,3,0,1,1,0,2,5,-20,1,Keegan Murray,SAC,NOP,SAC,6.5,3-PT Attempted,8,8,5,3
22023,1631099,22300222,"NOV 20, 2023",SAC @ NOP,L,16,1,4,0.25,1,2,0.5,2,2,1.0,2,1,3,0,1,1,0,2,5,-20,1,Keegan Murray,SAC,NOP,SAC,20.5,Pts+Rebs,8,8,5,3
22023,1631099,22300222,"NOV 20, 2023",SAC @ NOP,L,16,1,4,0.25,1,2,0.5,2,2,1.0,2,1,3,0,1,1,0,2,5,-20,1,Keegan Murray,SAC,NOP,SAC,0.5,Dunks,8,8,5,3
22023,1631099,22300222,"NOV 20, 2023",SAC @ NOP,L,16,1,4,0.25,1,2,0.5,2,2,1.0,2,1,3,0,1,1,0,2,5,-20,1,Keegan Murray,SAC,NOP,SAC,16.5,Pts+Asts,8,8,5,3
22023,1631099,22300222,"NOV 20, 2023",SAC @ NOP,L,16,1,4,0.25,1,2,0.5,2,2,1.0,2,1,3,0,1,1,0,2,5,-20,1,Keegan Murray,SAC,NOP,SAC,0.5,Blocked Shots,8,8,5,3
22023,1631099,22300222,"NOV 20, 2023",SAC @ NOP,L,16,1,4,0.25,1,2,0.5,2,2,1.0,2,1,3,0,1,1,0,2,5,-20,1,Keegan Murray,SAC,NOP,SAC,1.5,Blks+Stls,8,8,5,3
22023,1631099,22300212,"NOV 19, 2023",SAC @ DAL,W,33,7,13,0.538,2,7,0.286,1,1,1.0,3,0,3,4,1,0,1,5,17,21,1,Keegan Murray,SAC,DAL,SAC,15.0,Points,24,20,21,7
22023,1631099,22300212,"NOV 19, 2023",SAC @ DAL,W,33,7,13,0.538,2,7,0.286,1,1,1.0,3,0,3,4,1,0,1,5,17,21,1,Keegan Murray,SAC,DAL,SAC,5.0,Rebounds,24,20,21,7
22023,1631099,22300212,"NOV 19, 2023",SAC @ DAL,W,33,7,13,0.538,2,7,0.286,1,1,1.0,3,0,3,4,1,0,1,5,17,21,1,Keegan Murray,SAC,DAL,SAC,21.5,Pts+Rebs+Asts,24,20,21,7
22023,1631099,22300212,"NOV 19, 2023",SAC @ DAL,W,33,7,13,0.538,2,7,0.286,1,1,1.0,3,0,3,4,1,0,1,5,17,21,1,Keegan Murray,SAC,DAL,SAC,25.5,Fantasy Score,24,20,21,7
22023,1631099,22300212,"NOV 19, 2023",SAC @ DAL,W,33,7,13,0.538,2,7,0.286,1,1,1.0,3,0,3,4,1,0,1,5,17,21,1,Keegan Murray,SAC,DAL,SAC,6.5,3-PT Attempted,24,20,21,7
22023,1631099,22300212,"NOV 19, 2023",SAC @ DAL,W,33,7,13,0.538,2,7,0.286,1,1,1.0,3,0,3,4,1,0,1,5,17,21,1,Keegan Murray,SAC,DAL,SAC,20.5,Pts+Rebs,24,20,21,7
22023,1631099,22300212,"NOV 19, 2023",SAC @ DAL,W,33,7,13,0.538,2,7,0.286,1,1,1.0,3,0,3,4,1,0,1,5,17,21,1,Keegan Murray,SAC,DAL,SAC,0.5,Dunks,24,20,21,7
22023,1631099,22300212,"NOV 19, 2023",SAC @ DAL,W,33,7,13,0.538,2,7,0.286,1,1,1.0,3,0,3,4,1,0,1,5,17,21,1,Keegan Murray,SAC,DAL,SAC,16.5,Pts+Asts,24,20,21,7
22023,1631099,22300212,"NOV 19, 2023",SAC @ DAL,W,33,7,13,0.538,2,7,0.286,1,1,1.0,3,0,3,4,1,0,1,5,17,21,1,Keegan Murray,SAC,DAL,SAC,0.5,Blocked Shots,24,20,21,7
22023,1631099,22300212,"NOV 19, 2023",SAC @ DAL,W,33,7,13,0.538,2,7,0.286,1,1,1.0,3,0,3,4,1,0,1,5,17,21,1,Keegan Murray,SAC,DAL,SAC,1.5,Blks+Stls,24,20,21,7
22023,1631099,22300032,"NOV 17, 2023",SAC @ SAS,W,38,3,10,0.3,0,4,0.0,0,0,0.0,1,5,6,3,1,0,2,2,6,19,1,Keegan Murray,SAC,SAS,SAC,15.0,Points,15,12,9,9
22023,1631099,22300032,"NOV 17, 2023",SAC @ SAS,W,38,3,10,0.3,0,4,0.0,0,0,0.0,1,5,6,3,1,0,2,2,6,19,1,Keegan Murray,SAC,SAS,SAC,5.0,Rebounds,15,12,9,9
22023,1631099,22300032,"NOV 17, 2023",SAC @ SAS,W,38,3,10,0.3,0,4,0.0,0,0,0.0,1,5,6,3,1,0,2,2,6,19,1,Keegan Murray,SAC,SAS,SAC,21.5,Pts+Rebs+Asts,15,12,9,9
22023,1631099,22300032,"NOV 17, 2023",SAC @ SAS,W,38,3,10,0.3,0,4,0.0,0,0,0.0,1,5,6,3,1,0,2,2,6,19,1,Keegan Murray,SAC,SAS,SAC,25.5,Fantasy Score,15,12,9,9
22023,1631099,22300032,"NOV 17, 2023",SAC @ SAS,W,38,3,10,0.3,0,4,0.0,0,0,0.0,1,5,6,3,1,0,2,2,6,19,1,Keegan Murray,SAC,SAS,SAC,6.5,3-PT Attempted,15,12,9,9
22023,1631099,22300032,"NOV 17, 2023",SAC @ SAS,W,38,3,10,0.3,0,4,0.0,0,0,0.0,1,5,6,3,1,0,2,2,6,19,1,Keegan Murray,SAC,SAS,SAC,20.5,Pts+Rebs,15,12,9,9
22023,1631099,22300032,"NOV 17, 2023",SAC @ SAS,W,38,3,10,0.3,0,4,0.0,0,0,0.0,1,5,6,3,1,0,2,2,6,19,1,Keegan Murray,SAC,SAS,SAC,0.5,Dunks,15,12,9,9
22023,1631099,22300032,"NOV 17, 2023",SAC @ SAS,W,38,3,10,0.3,0,4,0.0,0,0,0.0,1,5,6,3,1,0,2,2,6,19,1,Keegan Murray,SAC,SAS,SAC,16.5,Pts+Asts,15,12,9,9
22023,1631099,22300032,"NOV 17, 2023",SAC @ SAS,W,38,3,10,0.3,0,4,0.0,0,0,0.0,1,5,6,3,1,0,2,2,6,19,1,Keegan Murray,SAC,SAS,SAC,0.5,Blocked Shots,15,12,9,9
22023,1631099,22300032,"NOV 17, 2023",SAC @ SAS,W,38,3,10,0.3,0,4,0.0,0,0,0.0,1,5,6,3,1,0,2,2,6,19,1,Keegan Murray,SAC,SAS,SAC,1.5,Blks+Stls,15,12,9,9
22023,1631099,22300198,"NOV 15, 2023",SAC @ LAL,W,31,3,9,0.333,2,7,0.286,1,2,0.5,0,6,6,2,2,0,1,2,9,13,1,Keegan Murray,SAC,LAL,SAC,15.0,Points,17,15,11,8
22023,1631099,22300198,"NOV 15, 2023",SAC @ LAL,W,31,3,9,0.333,2,7,0.286,1,2,0.5,0,6,6,2,2,0,1,2,9,13,1,Keegan Murray,SAC,LAL,SAC,5.0,Rebounds,17,15,11,8
22023,1631099,22300198,"NOV 15, 2023",SAC @ LAL,W,31,3,9,0.333,2,7,0.286,1,2,0.5,0,6,6,2,2,0,1,2,9,13,1,Keegan Murray,SAC,LAL,SAC,21.5,Pts+Rebs+Asts,17,15,11,8
22023,1631099,22300198,"NOV 15, 2023",SAC @ LAL,W,31,3,9,0.333,2,7,0.286,1,2,0.5,0,6,6,2,2,0,1,2,9,13,1,Keegan Murray,SAC,LAL,SAC,25.5,Fantasy Score,17,15,11,8
22023,1631099,22300198,"NOV 15, 2023",SAC @ LAL,W,31,3,9,0.333,2,7,0.286,1,2,0.5,0,6,6,2,2,0,1,2,9,13,1,Keegan Murray,SAC,LAL,SAC,6.5,3-PT Attempted,17,15,11,8
22023,1631099,22300198,"NOV 15, 2023",SAC @ LAL,W,31,3,9,0.333,2,7,0.286,1,2,0.5,0,6,6,2,2,0,1,2,9,13,1,Keegan Murray,SAC,LAL,SAC,20.5,Pts+Rebs,17,15,11,8
22023,1631099,22300198,"NOV 15, 2023",SAC @ LAL,W,31,3,9,0.333,2,7,0.286,1,2,0.5,0,6,6,2,2,0,1,2,9,13,1,Keegan Murray,SAC,LAL,SAC,0.5,Dunks,17,15,11,8
22023,1631099,22300198,"NOV 15, 2023",SAC @ LAL,W,31,3,9,0.333,2,7,0.286,1,2,0.5,0,6,6,2,2,0,1,2,9,13,1,Keegan Murray,SAC,LAL,SAC,16.5,Pts+Asts,17,15,11,8
22023,1631099,22300198,"NOV 15, 2023",SAC @ LAL,W,31,3,9,0.333,2,7,0.286,1,2,0.5,0,6,6,2,2,0,1,2,9,13,1,Keegan Murray,SAC,LAL,SAC,0.5,Blocked Shots,17,15,11,8
22023,1631099,22300198,"NOV 15, 2023",SAC @ LAL,W,31,3,9,0.333,2,7,0.286,1,2,0.5,0,6,6,2,2,0,1,2,9,13,1,Keegan Murray,SAC,LAL,SAC,1.5,Blks+Stls,17,15,11,8
22023,1631099,22300191,"NOV 13, 2023",SAC vs. CLE,W,38,9,13,0.692,5,8,0.625,2,2,1.0,2,6,8,1,1,0,0,0,25,21,1,Keegan Murray,SAC,SAC,CLE,15.0,Points,34,33,26,9
22023,1631099,22300191,"NOV 13, 2023",SAC vs. CLE,W,38,9,13,0.692,5,8,0.625,2,2,1.0,2,6,8,1,1,0,0,0,25,21,1,Keegan Murray,SAC,SAC,CLE,5.0,Rebounds,34,33,26,9
22023,1631099,22300191,"NOV 13, 2023",SAC vs. CLE,W,38,9,13,0.692,5,8,0.625,2,2,1.0,2,6,8,1,1,0,0,0,25,21,1,Keegan Murray,SAC,SAC,CLE,21.5,Pts+Rebs+Asts,34,33,26,9
22023,1631099,22300191,"NOV 13, 2023",SAC vs. CLE,W,38,9,13,0.692,5,8,0.625,2,2,1.0,2,6,8,1,1,0,0,0,25,21,1,Keegan Murray,SAC,SAC,CLE,25.5,Fantasy Score,34,33,26,9
22023,1631099,22300191,"NOV 13, 2023",SAC vs. CLE,W,38,9,13,0.692,5,8,0.625,2,2,1.0,2,6,8,1,1,0,0,0,25,21,1,Keegan Murray,SAC,SAC,CLE,6.5,3-PT Attempted,34,33,26,9
22023,1631099,22300191,"NOV 13, 2023",SAC vs. CLE,W,38,9,13,0.692,5,8,0.625,2,2,1.0,2,6,8,1,1,0,0,0,25,21,1,Keegan Murray,SAC,SAC,CLE,20.5,Pts+Rebs,34,33,26,9
22023,1631099,22300191,"NOV 13, 2023",SAC vs. CLE,W,38,9,13,0.692,5,8,0.625,2,2,1.0,2,6,8,1,1,0,0,0,25,21,1,Keegan Murray,SAC,SAC,CLE,0.5,Dunks,34,33,26,9
22023,1631099,22300191,"NOV 13, 2023",SAC vs. CLE,W,38,9,13,0.692,5,8,0.625,2,2,1.0,2,6,8,1,1,0,0,0,25,21,1,Keegan Murray,SAC,SAC,CLE,16.5,Pts+Asts,34,33,26,9
22023,1631099,22300191,"NOV 13, 2023",SAC vs. CLE,W,38,9,13,0.692,5,8,0.625,2,2,1.0,2,6,8,1,1,0,0,0,25,21,1,Keegan Murray,SAC,SAC,CLE,0.5,Blocked Shots,34,33,26,9
22023,1631099,22300191,"NOV 13, 2023",SAC vs. CLE,W,38,9,13,0.692,5,8,0.625,2,2,1.0,2,6,8,1,1,0,0,0,25,21,1,Keegan Murray,SAC,SAC,CLE,1.5,Blks+Stls,34,33,26,9
22023,1631099,22300016,"NOV 10, 2023",SAC vs. OKC,W,40,8,17,0.471,3,10,0.3,5,5,1.0,4,7,11,1,3,1,3,1,24,-3,1,Keegan Murray,SAC,SAC,OKC,15.0,Points,36,35,25,12
22023,1631099,22300016,"NOV 10, 2023",SAC vs. OKC,W,40,8,17,0.471,3,10,0.3,5,5,1.0,4,7,11,1,3,1,3,1,24,-3,1,Keegan Murray,SAC,SAC,OKC,5.0,Rebounds,36,35,25,12
22023,1631099,22300016,"NOV 10, 2023",SAC vs. OKC,W,40,8,17,0.471,3,10,0.3,5,5,1.0,4,7,11,1,3,1,3,1,24,-3,1,Keegan Murray,SAC,SAC,OKC,21.5,Pts+Rebs+Asts,36,35,25,12
22023,1631099,22300016,"NOV 10, 2023",SAC vs. OKC,W,40,8,17,0.471,3,10,0.3,5,5,1.0,4,7,11,1,3,1,3,1,24,-3,1,Keegan Murray,SAC,SAC,OKC,25.5,Fantasy Score,36,35,25,12
22023,1631099,22300016,"NOV 10, 2023",SAC vs. OKC,W,40,8,17,0.471,3,10,0.3,5,5,1.0,4,7,11,1,3,1,3,1,24,-3,1,Keegan Murray,SAC,SAC,OKC,6.5,3-PT Attempted,36,35,25,12
22023,1631099,22300016,"NOV 10, 2023",SAC vs. OKC,W,40,8,17,0.471,3,10,0.3,5,5,1.0,4,7,11,1,3,1,3,1,24,-3,1,Keegan Murray,SAC,SAC,OKC,20.5,Pts+Rebs,36,35,25,12
22023,1631099,22300016,"NOV 10, 2023",SAC vs. OKC,W,40,8,17,0.471,3,10,0.3,5,5,1.0,4,7,11,1,3,1,3,1,24,-3,1,Keegan Murray,SAC,SAC,OKC,0.5,Dunks,36,35,25,12
22023,1631099,22300016,"NOV 10, 2023",SAC vs. OKC,W,40,8,17,0.471,3,10,0.3,5,5,1.0,4,7,11,1,3,1,3,1,24,-3,1,Keegan Murray,SAC,SAC,OKC,16.5,Pts+Asts,36,35,25,12
22023,1631099,22300016,"NOV 10, 2023",SAC vs. OKC,W,40,8,17,0.471,3,10,0.3,5,5,1.0,4,7,11,1,3,1,3,1,24,-3,1,Keegan Murray,SAC,SAC,OKC,0.5,Blocked Shots,36,35,25,12
22023,1631099,22300016,"NOV 10, 2023",SAC vs. OKC,W,40,8,17,0.471,3,10,0.3,5,5,1.0,4,7,11,1,3,1,3,1,24,-3,1,Keegan Murray,SAC,SAC,OKC,1.5,Blks+Stls,36,35,25,12
22023,1631099,22300170,"NOV 08, 2023",SAC vs. POR,W,31,4,17,0.235,1,6,0.167,0,0,0.0,2,5,7,3,1,2,1,3,9,8,1,Keegan Murray,SAC,SAC,POR,15.0,Points,19,16,12,10
22023,1631099,22300170,"NOV 08, 2023",SAC vs. POR,W,31,4,17,0.235,1,6,0.167,0,0,0.0,2,5,7,3,1,2,1,3,9,8,1,Keegan Murray,SAC,SAC,POR,5.0,Rebounds,19,16,12,10
22023,1631099,22300170,"NOV 08, 2023",SAC vs. POR,W,31,4,17,0.235,1,6,0.167,0,0,0.0,2,5,7,3,1,2,1,3,9,8,1,Keegan Murray,SAC,SAC,POR,21.5,Pts+Rebs+Asts,19,16,12,10
22023,1631099,22300170,"NOV 08, 2023",SAC vs. POR,W,31,4,17,0.235,1,6,0.167,0,0,0.0,2,5,7,3,1,2,1,3,9,8,1,Keegan Murray,SAC,SAC,POR,25.5,Fantasy Score,19,16,12,10
22023,1631099,22300170,"NOV 08, 2023",SAC vs. POR,W,31,4,17,0.235,1,6,0.167,0,0,0.0,2,5,7,3,1,2,1,3,9,8,1,Keegan Murray,SAC,SAC,POR,6.5,3-PT Attempted,19,16,12,10
22023,1631099,22300170,"NOV 08, 2023",SAC vs. POR,W,31,4,17,0.235,1,6,0.167,0,0,0.0,2,5,7,3,1,2,1,3,9,8,1,Keegan Murray,SAC,SAC,POR,20.5,Pts+Rebs,19,16,12,10
22023,1631099,22300170,"NOV 08, 2023",SAC vs. POR,W,31,4,17,0.235,1,6,0.167,0,0,0.0,2,5,7,3,1,2,1,3,9,8,1,Keegan Murray,SAC,SAC,POR,0.5,Dunks,19,16,12,10
22023,1631099,22300170,"NOV 08, 2023",SAC vs. POR,W,31,4,17,0.235,1,6,0.167,0,0,0.0,2,5,7,3,1,2,1,3,9,8,1,Keegan Murray,SAC,SAC,POR,16.5,Pts+Asts,19,16,12,10
22023,1631099,22300170,"NOV 08, 2023",SAC vs. POR,W,31,4,17,0.235,1,6,0.167,0,0,0.0,2,5,7,3,1,2,1,3,9,8,1,Keegan Murray,SAC,SAC,POR,0.5,Blocked Shots,19,16,12,10
22023,1631099,22300170,"NOV 08, 2023",SAC vs. POR,W,31,4,17,0.235,1,6,0.167,0,0,0.0,2,5,7,3,1,2,1,3,9,8,1,Keegan Murray,SAC,SAC,POR,1.5,Blks+Stls,19,16,12,10
22023,1631099,22300153,"NOV 06, 2023",SAC @ HOU,L,28,5,11,0.455,2,6,0.333,0,0,0.0,0,5,5,1,1,0,2,3,12,-18,1,Keegan Murray,SAC,HOU,SAC,15.0,Points,18,17,13,6
22023,1631099,22300153,"NOV 06, 2023",SAC @ HOU,L,28,5,11,0.455,2,6,0.333,0,0,0.0,0,5,5,1,1,0,2,3,12,-18,1,Keegan Murray,SAC,HOU,SAC,5.0,Rebounds,18,17,13,6
22023,1631099,22300153,"NOV 06, 2023",SAC @ HOU,L,28,5,11,0.455,2,6,0.333,0,0,0.0,0,5,5,1,1,0,2,3,12,-18,1,Keegan Murray,SAC,HOU,SAC,21.5,Pts+Rebs+Asts,18,17,13,6
22023,1631099,22300153,"NOV 06, 2023",SAC @ HOU,L,28,5,11,0.455,2,6,0.333,0,0,0.0,0,5,5,1,1,0,2,3,12,-18,1,Keegan Murray,SAC,HOU,SAC,25.5,Fantasy Score,18,17,13,6
22023,1631099,22300153,"NOV 06, 2023",SAC @ HOU,L,28,5,11,0.455,2,6,0.333,0,0,0.0,0,5,5,1,1,0,2,3,12,-18,1,Keegan Murray,SAC,HOU,SAC,6.5,3-PT Attempted,18,17,13,6
22023,1631099,22300153,"NOV 06, 2023",SAC @ HOU,L,28,5,11,0.455,2,6,0.333,0,0,0.0,0,5,5,1,1,0,2,3,12,-18,1,Keegan Murray,SAC,HOU,SAC,20.5,Pts+Rebs,18,17,13,6
22023,1631099,22300153,"NOV 06, 2023",SAC @ HOU,L,28,5,11,0.455,2,6,0.333,0,0,0.0,0,5,5,1,1,0,2,3,12,-18,1,Keegan Murray,SAC,HOU,SAC,0.5,Dunks,18,17,13,6
22023,1631099,22300153,"NOV 06, 2023",SAC @ HOU,L,28,5,11,0.455,2,6,0.333,0,0,0.0,0,5,5,1,1,0,2,3,12,-18,1,Keegan Murray,SAC,HOU,SAC,16.5,Pts+Asts,18,17,13,6
22023,1631099,22300153,"NOV 06, 2023",SAC @ HOU,L,28,5,11,0.455,2,6,0.333,0,0,0.0,0,5,5,1,1,0,2,3,12,-18,1,Keegan Murray,SAC,HOU,SAC,0.5,Blocked Shots,18,17,13,6
22023,1631099,22300153,"NOV 06, 2023",SAC @ HOU,L,28,5,11,0.455,2,6,0.333,0,0,0.0,0,5,5,1,1,0,2,3,12,-18,1,Keegan Murray,SAC,HOU,SAC,1.5,Blks+Stls,18,17,13,6
22023,1631099,22300137,"NOV 04, 2023",SAC @ HOU,L,33,3,12,0.25,1,8,0.125,0,0,0.0,0,2,2,1,0,0,0,1,7,-17,1,Keegan Murray,SAC,HOU,SAC,15.0,Points,10,9,8,3
22023,1631099,22300137,"NOV 04, 2023",SAC @ HOU,L,33,3,12,0.25,1,8,0.125,0,0,0.0,0,2,2,1,0,0,0,1,7,-17,1,Keegan Murray,SAC,HOU,SAC,5.0,Rebounds,10,9,8,3
22023,1631099,22300137,"NOV 04, 2023",SAC @ HOU,L,33,3,12,0.25,1,8,0.125,0,0,0.0,0,2,2,1,0,0,0,1,7,-17,1,Keegan Murray,SAC,HOU,SAC,21.5,Pts+Rebs+Asts,10,9,8,3
22023,1631099,22300137,"NOV 04, 2023",SAC @ HOU,L,33,3,12,0.25,1,8,0.125,0,0,0.0,0,2,2,1,0,0,0,1,7,-17,1,Keegan Murray,SAC,HOU,SAC,25.5,Fantasy Score,10,9,8,3
22023,1631099,22300137,"NOV 04, 2023",SAC @ HOU,L,33,3,12,0.25,1,8,0.125,0,0,0.0,0,2,2,1,0,0,0,1,7,-17,1,Keegan Murray,SAC,HOU,SAC,6.5,3-PT Attempted,10,9,8,3
22023,1631099,22300137,"NOV 04, 2023",SAC @ HOU,L,33,3,12,0.25,1,8,0.125,0,0,0.0,0,2,2,1,0,0,0,1,7,-17,1,Keegan Murray,SAC,HOU,SAC,20.5,Pts+Rebs,10,9,8,3
22023,1631099,22300137,"NOV 04, 2023",SAC @ HOU,L,33,3,12,0.25,1,8,0.125,0,0,0.0,0,2,2,1,0,0,0,1,7,-17,1,Keegan Murray,SAC,HOU,SAC,0.5,Dunks,10,9,8,3
22023,1631099,22300137,"NOV 04, 2023",SAC @ HOU,L,33,3,12,0.25,1,8,0.125,0,0,0.0,0,2,2,1,0,0,0,1,7,-17,1,Keegan Murray,SAC,HOU,SAC,16.5,Pts+Asts,10,9,8,3
22023,1631099,22300137,"NOV 04, 2023",SAC @ HOU,L,33,3,12,0.25,1,8,0.125,0,0,0.0,0,2,2,1,0,0,0,1,7,-17,1,Keegan Murray,SAC,HOU,SAC,0.5,Blocked Shots,10,9,8,3
22023,1631099,22300137,"NOV 04, 2023",SAC @ HOU,L,33,3,12,0.25,1,8,0.125,0,0,0.0,0,2,2,1,0,0,0,1,7,-17,1,Keegan Murray,SAC,HOU,SAC,1.5,Blks+Stls,10,9,8,3
22023,1631099,22300126,"NOV 01, 2023",SAC @ GSW,L,39,4,15,0.267,0,7,0.0,2,2,1.0,2,4,6,3,2,0,0,2,10,3,1,Keegan Murray,SAC,GSW,SAC,15.0,Points,19,16,13,9
22023,1631099,22300126,"NOV 01, 2023",SAC @ GSW,L,39,4,15,0.267,0,7,0.0,2,2,1.0,2,4,6,3,2,0,0,2,10,3,1,Keegan Murray,SAC,GSW,SAC,5.0,Rebounds,19,16,13,9
22023,1631099,22300126,"NOV 01, 2023",SAC @ GSW,L,39,4,15,0.267,0,7,0.0,2,2,1.0,2,4,6,3,2,0,0,2,10,3,1,Keegan Murray,SAC,GSW,SAC,21.5,Pts+Rebs+Asts,19,16,13,9
22023,1631099,22300126,"NOV 01, 2023",SAC @ GSW,L,39,4,15,0.267,0,7,0.0,2,2,1.0,2,4,6,3,2,0,0,2,10,3,1,Keegan Murray,SAC,GSW,SAC,25.5,Fantasy Score,19,16,13,9
22023,1631099,22300126,"NOV 01, 2023",SAC @ GSW,L,39,4,15,0.267,0,7,0.0,2,2,1.0,2,4,6,3,2,0,0,2,10,3,1,Keegan Murray,SAC,GSW,SAC,6.5,3-PT Attempted,19,16,13,9
22023,1631099,22300126,"NOV 01, 2023",SAC @ GSW,L,39,4,15,0.267,0,7,0.0,2,2,1.0,2,4,6,3,2,0,0,2,10,3,1,Keegan Murray,SAC,GSW,SAC,20.5,Pts+Rebs,19,16,13,9
22023,1631099,22300126,"NOV 01, 2023",SAC @ GSW,L,39,4,15,0.267,0,7,0.0,2,2,1.0,2,4,6,3,2,0,0,2,10,3,1,Keegan Murray,SAC,GSW,SAC,0.5,Dunks,19,16,13,9
22023,1631099,22300126,"NOV 01, 2023",SAC @ GSW,L,39,4,15,0.267,0,7,0.0,2,2,1.0,2,4,6,3,2,0,0,2,10,3,1,Keegan Murray,SAC,GSW,SAC,16.5,Pts+Asts,19,16,13,9
22023,1631099,22300126,"NOV 01, 2023",SAC @ GSW,L,39,4,15,0.267,0,7,0.0,2,2,1.0,2,4,6,3,2,0,0,2,10,3,1,Keegan Murray,SAC,GSW,SAC,0.5,Blocked Shots,19,16,13,9
22023,1631099,22300126,"NOV 01, 2023",SAC @ GSW,L,39,4,15,0.267,0,7,0.0,2,2,1.0,2,4,6,3,2,0,0,2,10,3,1,Keegan Murray,SAC,GSW,SAC,1.5,Blks+Stls,19,16,13,9
22023,1631099,22300100,"OCT 29, 2023",SAC vs. LAL,W,33,6,14,0.429,3,9,0.333,2,3,0.667,3,5,8,5,2,1,1,4,17,13,1,Keegan Murray,SAC,SAC,LAL,15.0,Points,30,25,22,13
22023,1631099,22300100,"OCT 29, 2023",SAC vs. LAL,W,33,6,14,0.429,3,9,0.333,2,3,0.667,3,5,8,5,2,1,1,4,17,13,1,Keegan Murray,SAC,SAC,LAL,5.0,Rebounds,30,25,22,13
22023,1631099,22300100,"OCT 29, 2023",SAC vs. LAL,W,33,6,14,0.429,3,9,0.333,2,3,0.667,3,5,8,5,2,1,1,4,17,13,1,Keegan Murray,SAC,SAC,LAL,21.5,Pts+Rebs+Asts,30,25,22,13
22023,1631099,22300100,"OCT 29, 2023",SAC vs. LAL,W,33,6,14,0.429,3,9,0.333,2,3,0.667,3,5,8,5,2,1,1,4,17,13,1,Keegan Murray,SAC,SAC,LAL,25.5,Fantasy Score,30,25,22,13
22023,1631099,22300100,"OCT 29, 2023",SAC vs. LAL,W,33,6,14,0.429,3,9,0.333,2,3,0.667,3,5,8,5,2,1,1,4,17,13,1,Keegan Murray,SAC,SAC,LAL,6.5,3-PT Attempted,30,25,22,13
22023,1631099,22300100,"OCT 29, 2023",SAC vs. LAL,W,33,6,14,0.429,3,9,0.333,2,3,0.667,3,5,8,5,2,1,1,4,17,13,1,Keegan Murray,SAC,SAC,LAL,20.5,Pts+Rebs,30,25,22,13
22023,1631099,22300100,"OCT 29, 2023",SAC vs. LAL,W,33,6,14,0.429,3,9,0.333,2,3,0.667,3,5,8,5,2,1,1,4,17,13,1,Keegan Murray,SAC,SAC,LAL,0.5,Dunks,30,25,22,13
22023,1631099,22300100,"OCT 29, 2023",SAC vs. LAL,W,33,6,14,0.429,3,9,0.333,2,3,0.667,3,5,8,5,2,1,1,4,17,13,1,Keegan Murray,SAC,SAC,LAL,16.5,Pts+Asts,30,25,22,13
22023,1631099,22300100,"OCT 29, 2023",SAC vs. LAL,W,33,6,14,0.429,3,9,0.333,2,3,0.667,3,5,8,5,2,1,1,4,17,13,1,Keegan Murray,SAC,SAC,LAL,0.5,Blocked Shots,30,25,22,13
22023,1631099,22300100,"OCT 29, 2023",SAC vs. LAL,W,33,6,14,0.429,3,9,0.333,2,3,0.667,3,5,8,5,2,1,1,4,17,13,1,Keegan Murray,SAC,SAC,LAL,1.5,Blks+Stls,30,25,22,13
22023,1631099,22300087,"OCT 27, 2023",SAC vs. GSW,L,40,6,16,0.375,3,11,0.273,1,2,0.5,3,4,7,1,2,1,4,2,16,-11,1,Keegan Murray,SAC,SAC,GSW,15.0,Points,24,23,17,8
22023,1631099,22300087,"OCT 27, 2023",SAC vs. GSW,L,40,6,16,0.375,3,11,0.273,1,2,0.5,3,4,7,1,2,1,4,2,16,-11,1,Keegan Murray,SAC,SAC,GSW,5.0,Rebounds,24,23,17,8
22023,1631099,22300087,"OCT 27, 2023",SAC vs. GSW,L,40,6,16,0.375,3,11,0.273,1,2,0.5,3,4,7,1,2,1,4,2,16,-11,1,Keegan Murray,SAC,SAC,GSW,21.5,Pts+Rebs+Asts,24,23,17,8
22023,1631099,22300087,"OCT 27, 2023",SAC vs. GSW,L,40,6,16,0.375,3,11,0.273,1,2,0.5,3,4,7,1,2,1,4,2,16,-11,1,Keegan Murray,SAC,SAC,GSW,25.5,Fantasy Score,24,23,17,8
22023,1631099,22300087,"OCT 27, 2023",SAC vs. GSW,L,40,6,16,0.375,3,11,0.273,1,2,0.5,3,4,7,1,2,1,4,2,16,-11,1,Keegan Murray,SAC,SAC,GSW,6.5,3-PT Attempted,24,23,17,8
22023,1631099,22300087,"OCT 27, 2023",SAC vs. GSW,L,40,6,16,0.375,3,11,0.273,1,2,0.5,3,4,7,1,2,1,4,2,16,-11,1,Keegan Murray,SAC,SAC,GSW,20.5,Pts+Rebs,24,23,17,8
22023,1631099,22300087,"OCT 27, 2023",SAC vs. GSW,L,40,6,16,0.375,3,11,0.273,1,2,0.5,3,4,7,1,2,1,4,2,16,-11,1,Keegan Murray,SAC,SAC,GSW,0.5,Dunks,24,23,17,8
22023,1631099,22300087,"OCT 27, 2023",SAC vs. GSW,L,40,6,16,0.375,3,11,0.273,1,2,0.5,3,4,7,1,2,1,4,2,16,-11,1,Keegan Murray,SAC,SAC,GSW,16.5,Pts+Asts,24,23,17,8
22023,1631099,22300087,"OCT 27, 2023",SAC vs. GSW,L,40,6,16,0.375,3,11,0.273,1,2,0.5,3,4,7,1,2,1,4,2,16,-11,1,Keegan Murray,SAC,SAC,GSW,0.5,Blocked Shots,24,23,17,8
22023,1631099,22300087,"OCT 27, 2023",SAC vs. GSW,L,40,6,16,0.375,3,11,0.273,1,2,0.5,3,4,7,1,2,1,4,2,16,-11,1,Keegan Murray,SAC,SAC,GSW,1.5,Blks+Stls,24,23,17,8
22023,1631099,22300072,"OCT 25, 2023",SAC @ UTA,W,30,5,13,0.385,4,9,0.444,1,1,1.0,2,6,8,1,1,2,0,4,15,12,1,Keegan Murray,SAC,UTA,SAC,15.0,Points,24,23,16,9
22023,1631099,22300072,"OCT 25, 2023",SAC @ UTA,W,30,5,13,0.385,4,9,0.444,1,1,1.0,2,6,8,1,1,2,0,4,15,12,1,Keegan Murray,SAC,UTA,SAC,5.0,Rebounds,24,23,16,9
22023,1631099,22300072,"OCT 25, 2023",SAC @ UTA,W,30,5,13,0.385,4,9,0.444,1,1,1.0,2,6,8,1,1,2,0,4,15,12,1,Keegan Murray,SAC,UTA,SAC,21.5,Pts+Rebs+Asts,24,23,16,9
22023,1631099,22300072,"OCT 25, 2023",SAC @ UTA,W,30,5,13,0.385,4,9,0.444,1,1,1.0,2,6,8,1,1,2,0,4,15,12,1,Keegan Murray,SAC,UTA,SAC,25.5,Fantasy Score,24,23,16,9
22023,1631099,22300072,"OCT 25, 2023",SAC @ UTA,W,30,5,13,0.385,4,9,0.444,1,1,1.0,2,6,8,1,1,2,0,4,15,12,1,Keegan Murray,SAC,UTA,SAC,6.5,3-PT Attempted,24,23,16,9
22023,1631099,22300072,"OCT 25, 2023",SAC @ UTA,W,30,5,13,0.385,4,9,0.444,1,1,1.0,2,6,8,1,1,2,0,4,15,12,1,Keegan Murray,SAC,UTA,SAC,20.5,Pts+Rebs,24,23,16,9
22023,1631099,22300072,"OCT 25, 2023",SAC @ UTA,W,30,5,13,0.385,4,9,0.444,1,1,1.0,2,6,8,1,1,2,0,4,15,12,1,Keegan Murray,SAC,UTA,SAC,0.5,Dunks,24,23,16,9
22023,1631099,22300072,"OCT 25, 2023",SAC @ UTA,W,30,5,13,0.385,4,9,0.444,1,1,1.0,2,6,8,1,1,2,0,4,15,12,1,Keegan Murray,SAC,UTA,SAC,16.5,Pts+Asts,24,23,16,9
22023,1631099,22300072,"OCT 25, 2023",SAC @ UTA,W,30,5,13,0.385,4,9,0.444,1,1,1.0,2,6,8,1,1,2,0,4,15,12,1,Keegan Murray,SAC,UTA,SAC,0.5,Blocked Shots,24,23,16,9
22023,1631099,22300072,"OCT 25, 2023",SAC @ UTA,W,30,5,13,0.385,4,9,0.444,1,1,1.0,2,6,8,1,1,2,0,4,15,12,1,Keegan Murray,SAC,UTA,SAC,1.5,Blks+Stls,24,23,16,9
22023,1631200,22300554,"JAN 14, 2024",POR vs. PHX,L,37,5,9,0.556,3,6,0.5,0,1,0.0,0,1,1,3,3,0,3,2,13,-9,1,Kris Murray,POR,POR,PHX,,,17,14,16,4
22023,1631200,22300538,"JAN 12, 2024",POR @ MIN,L,9,0,1,0.0,0,0,0.0,2,2,1.0,0,0,0,1,1,0,0,0,2,13,1,Kris Murray,POR,MIN,POR,,,3,2,3,1
22023,1631200,22300529,"JAN 11, 2024",POR @ OKC,L,23,4,10,0.4,1,5,0.2,0,0,0.0,3,2,5,0,1,0,0,0,9,-22,1,Kris Murray,POR,OKC,POR,,,14,14,9,5
22023,1631200,22300514,"JAN 09, 2024",POR @ NYK,L,16,3,10,0.3,0,3,0.0,3,3,1.0,2,1,3,1,1,0,1,0,9,6,1,Kris Murray,POR,NYK,POR,,,13,12,10,4
22023,1631200,22300498,"JAN 07, 2024",POR @ BKN,W,7,0,2,0.0,0,0,0.0,0,0,0.0,1,2,3,0,0,0,2,1,0,2,1,Kris Murray,POR,BKN,POR,,,3,3,0,3
22023,1631200,22300487,"JAN 05, 2024",POR @ DAL,L,20,4,8,0.5,2,3,0.667,0,0,0.0,2,2,4,1,2,0,1,0,10,-17,1,Kris Murray,POR,DAL,POR,,,15,14,11,5
22023,1631200,22300472,"JAN 03, 2024",POR @ DAL,L,15,1,3,0.333,0,1,0.0,0,0,0.0,0,1,1,2,0,0,1,0,2,0,1,Kris Murray,POR,DAL,POR,,,5,3,4,3
22023,1631200,22300456,"JAN 01, 2024",POR @ PHX,L,19,3,5,0.6,0,2,0.0,0,0,0.0,1,1,2,1,1,1,0,2,6,-11,1,Kris Murray,POR,PHX,POR,,,9,8,7,3
22023,1631200,22300413,"DEC 26, 2023",POR vs. SAC,W,2,0,0,0.0,0,0,0.0,0,0,0.0,0,0,0,0,0,0,0,0,0,-2,1,Kris Murray,POR,POR,SAC,,,0,0,0,0
22023,1631200,22300399,"DEC 23, 2023",POR @ GSW,L,5,1,1,1.0,0,0,0.0,0,0,0.0,1,1,2,0,1,0,0,2,2,-1,1,Kris Murray,POR,GSW,POR,,,4,4,2,2
22023,1631200,22300323,"DEC 14, 2023",POR vs. UTA,L,17,2,7,0.286,2,5,0.4,0,0,0.0,3,2,5,3,2,1,0,0,6,24,1,Kris Murray,POR,POR,UTA,,,14,11,9,8
22023,1631200,22301226,"DEC 08, 2023",POR vs. DAL,L,18,2,6,0.333,1,3,0.333,0,0,0.0,1,4,5,0,1,0,0,0,5,7,1,Kris Murray,POR,POR,DAL,,,10,10,5,5
22023,1631200,22301214,"DEC 06, 2023",POR @ GSW,L,21,2,4,0.5,2,4,0.5,0,0,0.0,0,5,5,1,2,0,0,2,6,-1,1,Kris Murray,POR,GSW,POR,,,12,11,7,6
22023,1631200,22300237,"NOV 22, 2023",POR vs. UTA,W,17,1,5,0.2,0,3,0.0,0,1,0.0,2,0,2,0,1,0,0,0,2,-9,1,Kris Murray,POR,POR,UTA,,,4,4,2,2
22023,1631200,22300041,"NOV 21, 2023",POR @ PHX,L,2,1,2,0.5,1,1,1.0,0,0,0.0,0,0,0,0,0,0,0,0,3,3,1,Kris Murray,POR,PHX,POR,,,3,3,3,0
22023,1631200,22300215,"NOV 19, 2023",POR vs. OKC,L,21,2,4,0.5,1,2,0.5,3,4,0.75,1,1,2,0,1,0,1,3,8,-10,1,Kris Murray,POR,POR,OKC,,,10,10,8,2
22023,1631200,22300036,"NOV 17, 2023",POR vs. LAL,L,5,0,2,0.0,0,2,0.0,0,0,0.0,1,0,1,0,1,0,0,1,0,-5,1,Kris Murray,POR,POR,LAL,,,1,1,0,1
22023,1631200,22300199,"NOV 15, 2023",POR vs. CLE,L,17,2,5,0.4,1,3,0.333,0,0,0.0,0,2,2,3,1,0,0,1,5,7,1,Kris Murray,POR,POR,CLE,,,10,7,8,5
22023,1631200,22300023,"NOV 14, 2023",POR @ UTA,L,3,0,0,0.0,0,0,0.0,0,0,0.0,0,0,0,0,0,0,0,0,0,-1,1,Kris Murray,POR,UTA,POR,,,0,0,0,0
22023,1631200,22300187,"NOV 12, 2023",POR @ LAL,L,3,0,0,0.0,0,0,0.0,0,0,0.0,0,0,0,0,0,0,0,1,0,4,1,Kris Murray,POR,LAL,POR,,,0,0,0,0
22023,1631200,22300170,"NOV 08, 2023",POR @ SAC,L,9,0,1,0.0,0,0,0.0,0,0,0.0,0,0,0,0,0,1,0,1,0,-5,1,Kris Murray,POR,SAC,POR,,,0,0,0,0
22023,1631200,22300098,"OCT 29, 2023",POR @ PHI,L,6,0,1,0.0,0,1,0.0,0,0,0.0,0,0,0,0,1,0,0,1,0,-8,1,Kris Murray,POR,PHI,POR,,,0,0,0,0
22023,1631200,22300074,"OCT 25, 2023",POR @ LAC,L,5,0,0,0.0,0,0,0.0,0,0,0.0,0,1,1,0,0,0,0,0,0,12,1,Kris Murray,POR,LAC,POR,,,1,1,0,1
22023,203488,22300520,"JAN 10, 2024",WAS @ IND,L,11,2,4,0.5,0,2,0.0,0,0,0.0,3,1,4,0,0,0,1,4,4,-5,1,Mike Muscala,WAS,IND,WAS,,,8,8,4,4
22023,203488,22300508,"JAN 08, 2024",WAS vs. OKC,L,8,0,1,0.0,0,0,0.0,0,0,0.0,1,0,1,0,1,0,1,1,0,-5,1,Mike Muscala,WAS,WAS,OKC,,,1,1,0,1
22023,203488,22300494,"JAN 06, 2024",WAS vs. NYK,L,14,0,4,0.0,0,3,0.0,1,2,0.5,3,3,6,0,0,0,1,0,1,-13,1,Mike Muscala,WAS,WAS,NYK,,,7,7,1,6
22023,203488,22300482,"JAN 05, 2024",WAS @ CLE,L,18,0,3,0.0,0,2,0.0,0,0,0.0,1,5,6,0,0,0,1,2,0,-5,1,Mike Muscala,WAS,CLE,WAS,,,6,6,0,6
22023,203488,22300465,"JAN 03, 2024",WAS @ CLE,L,21,5,9,0.556,2,5,0.4,0,0,0.0,2,2,4,2,0,0,0,0,12,-22,1,Mike Muscala,WAS,CLE,WAS,,,18,16,14,6
22023,203488,22300445,"DEC 31, 2023",WAS vs. ATL,L,20,4,8,0.5,2,5,0.4,0,0,0.0,0,4,4,3,0,0,0,1,10,-16,1,Mike Muscala,WAS,WAS,ATL,,,17,14,13,7
22023,203488,22300430,"DEC 29, 2023",WAS vs. BKN,W,31,4,9,0.444,3,7,0.429,0,0,0.0,0,3,3,3,0,2,0,3,11,21,1,Mike Muscala,WAS,WAS,BKN,,,17,14,14,6
22023,203488,22300416,"DEC 27, 2023",WAS vs. TOR,L,7,0,3,0.0,0,0,0.0,0,0,0.0,2,4,6,0,0,0,1,0,0,-2,1,Mike Muscala,WAS,WAS,TOR,,,6,6,0,6
22023,203488,22300386,"DEC 22, 2023",WAS @ GSW,L,14,1,5,0.2,0,1,0.0,0,0,0.0,2,4,6,0,0,0,1,2,2,-18,1,Mike Muscala,WAS,GSW,WAS,,,8,8,2,6
22023,203488,22300381,"DEC 21, 2023",WAS @ POR,W,14,2,5,0.4,1,3,0.333,0,2,0.0,0,1,1,1,1,0,0,2,5,-7,1,Mike Muscala,WAS,POR,WAS,,,7,6,6,2
22023,203488,22300358,"DEC 18, 2023",WAS @ SAC,L,23,2,3,0.667,1,1,1.0,6,6,1.0,1,5,6,2,1,1,2,3,11,15,1,Mike Muscala,WAS,SAC,WAS,,,19,17,13,8
22023,203488,22300347,"DEC 17, 2023",WAS @ PHX,L,10,1,4,0.25,0,2,0.0,2,2,1.0,2,2,4,0,0,0,0,1,4,-4,1,Mike Muscala,WAS,PHX,WAS,,,8,8,4,4
22023,203488,22300328,"DEC 15, 2023",WAS vs. IND,W,19,0,1,0.0,0,1,0.0,0,0,0.0,0,0,0,2,0,1,0,1,0,-3,1,Mike Muscala,WAS,WAS,IND,,,2,0,2,2
22023,203488,22300311,"DEC 13, 2023",WAS vs. NOP,L,4,0,2,0.0,0,2,0.0,0,0,0.0,0,1,1,0,0,0,0,0,0,8,1,Mike Muscala,WAS,WAS,NOP,,,1,1,0,1
22023,203488,22300295,"DEC 11, 2023",WAS @ PHI,L,20,0,4,0.0,0,3,0.0,0,2,0.0,3,1,4,1,0,0,0,3,0,-25,1,Mike Muscala,WAS,PHI,WAS,,,5,4,1,5
22023,203488,22301219,"DEC 08, 2023",WAS @ BKN,L,15,2,3,0.667,2,3,0.667,2,2,1.0,0,0,0,0,1,0,1,1,8,-4,1,Mike Muscala,WAS,BKN,WAS,,,8,8,8,0
22023,203488,22301208,"DEC 06, 2023",WAS vs. PHI,L,6,2,3,0.667,0,1,0.0,0,0,0.0,0,0,0,0,0,0,0,0,4,6,1,Mike Muscala,WAS,WAS,PHI,,,4,4,4,0
22023,203488,22300241,"NOV 25, 2023",WAS vs. ATL,L,18,2,3,0.667,1,2,0.5,0,0,0.0,0,6,6,4,0,2,1,0,5,-8,1,Mike Muscala,WAS,WAS,ATL,,,15,11,9,10
22023,203488,22300189,"NOV 13, 2023",WAS @ TOR,L,7,1,2,0.5,0,0,0.0,2,2,1.0,1,1,2,0,0,0,3,0,4,-1,1,Mike Muscala,WAS,TOR,WAS,,,6,6,4,2
22023,203488,22300148,"NOV 06, 2023",WAS @ PHI,L,3,0,1,0.0,0,0,0.0,0,0,0.0,0,0,0,0,0,0,0,1,0,-3,1,Mike Muscala,WAS,PHI,WAS,,,0,0,0,0
22023,203488,22300003,"NOV 03, 2023",WAS @ MIA,L,12,2,5,0.4,1,4,0.25,0,0,0.0,0,1,1,1,0,0,1,1,5,-11,1,Mike Muscala,WAS,MIA,WAS,,,7,6,6,2
22023,203488,22300117,"NOV 01, 2023",WAS @ ATL,L,22,2,7,0.286,1,4,0.25,2,2,1.0,1,3,4,1,1,1,2,3,7,-22,1,Mike Muscala,WAS,ATL,WAS,,,12,11,8,5
22023,203488,22300089,"OCT 28, 2023",WAS vs. MEM,W,11,1,1,1.0,0,0,0.0,0,0,0.0,0,3,3,2,0,0,0,2,2,-2,1,Mike Muscala,WAS,WAS,MEM,,,7,5,4,5
22023,203488,22300064,"OCT 25, 2023",WAS @ IND,L,8,0,0,0.0,0,0,0.0,0,0,0.0,0,3,3,0,0,0,0,0,0,-8,1,Mike Muscala,WAS,IND,WAS,,,3,3,0,3
22023,1629004,22300542,"JAN 13, 2024",BOS vs. HOU,W,9,2,5,0.4,2,3,0.667,0,0,0.0,1,0,1,0,0,0,0,1,6,-1,1,Svi Mykhailiuk,BOS,BOS,HOU,,,7,7,6,1
22023,1629004,22300528,"JAN 11, 2024",BOS @ MIL,L,17,3,5,0.6,2,3,0.667,1,2,0.5,0,1,1,1,1,0,0,0,9,-5,1,Svi Mykhailiuk,BOS,MIL,BOS,,,11,10,10,2
22023,1629004,22300507,"JAN 08, 2024",BOS @ IND,L,5,0,0,0.0,0,0,0.0,2,4,0.5,1,0,1,0,0,0,1,0,2,-1,1,Svi Mykhailiuk,BOS,IND,BOS,,,3,3,2,1
22023,1629004,22300493,"JAN 06, 2024",BOS @ IND,W,1,0,0,0.0,0,0,0.0,0,0,0.0,0,0,0,0,0,0,0,0,0,0,1,Svi Mykhailiuk,BOS,IND,BOS,,,0,0,0,0
22023,1629004,22300479,"JAN 05, 2024",BOS vs. UTA,W,15,1,7,0.143,1,6,0.167,0,0,0.0,0,3,3,0,0,0,0,2,3,-6,1,Svi Mykhailiuk,BOS,BOS,UTA,,,6,6,3,3
22023,1629004,22300448,"DEC 31, 2023",BOS @ SAS,W,8,0,4,0.0,0,4,0.0,0,0,0.0,0,1,1,0,1,0,1,1,0,-4,1,Svi Mykhailiuk,BOS,SAS,BOS,,,1,1,0,1
22023,1629004,22300432,"DEC 29, 2023",BOS vs. TOR,W,7,2,3,0.667,1,2,0.5,0,0,0.0,0,1,1,1,0,0,0,2,5,-6,1,Svi Mykhailiuk,BOS,BOS,TOR,,,7,6,6,2
22023,1629004,22300373,"DEC 20, 2023",BOS @ SAC,W,16,1,6,0.167,0,4,0.0,0,0,0.0,2,2,4,3,1,0,0,1,2,7,1,Svi Mykhailiuk,BOS,SAC,BOS,,,9,6,5,7
22023,1629004,22300362,"DEC 19, 2023",BOS @ GSW,L,2,0,1,0.0,0,1,0.0,0,0,0.0,0,0,0,0,0,0,0,0,0,3,1,Svi Mykhailiuk,BOS,GSW,BOS,,,0,0,0,0
22023,1629004,22300329,"DEC 15, 2023",BOS vs. ORL,W,5,0,1,0.0,0,1,0.0,0,0,0.0,0,0,0,0,0,0,0,0,0,-4,1,Svi Mykhailiuk,BOS,BOS,ORL,,,0,0,0,0
22023,1629004,22300053,"NOV 28, 2023",BOS vs. CHI,W,2,0,0,0.0,0,0,0.0,0,0,0.0,0,0,0,0,0,0,0,0,0,0,1,Svi Mykhailiuk,BOS,BOS,CHI,,,0,0,0,0
22023,1629004,22300217,"NOV 20, 2023",BOS @ CHA,L,9,1,2,0.5,1,2,0.5,0,0,0.0,0,0,0,0,1,0,0,0,3,7,1,Svi Mykhailiuk,BOS,CHA,BOS,,,3,3,3,0
22023,1629004,22300194,"NOV 15, 2023",BOS @ PHI,W,15,2,4,0.5,1,3,0.333,0,0,0.0,1,0,1,0,1,0,1,3,5,0,1,Svi Mykhailiuk,BOS,PHI,BOS,,,6,6,5,1
22023,1629004,22300174,"NOV 11, 2023",BOS vs. TOR,W,5,0,2,0.0,0,2,0.0,0,0,0.0,0,0,0,0,0,0,1,0,0,-7,1,Svi Mykhailiuk,BOS,BOS,TOR,,,0,0,0,0
22023,1629004,22300010,"NOV 10, 2023",BOS vs. BKN,W,9,0,1,0.0,0,1,0.0,0,0,0.0,0,1,1,0,0,0,2,1,0,-5,1,Svi Mykhailiuk,BOS,BOS,BKN,,,1,1,0,1
22023,1629004,22300154,"NOV 06, 2023",BOS @ MIN,L,4,0,0,0.0,0,0,0.0,0,0,0.0,0,0,0,0,0,0,0,0,0,-2,1,Svi Mykhailiuk,BOS,MIN,BOS,,,0,0,0,0
22023,1629004,22300118,"NOV 01, 2023",BOS vs. IND,W,11,2,6,0.333,1,4,0.25,0,0,0.0,0,3,3,0,0,0,0,0,5,17,1,Svi Mykhailiuk,BOS,BOS,IND,,,8,8,5,3
22023,1629004,22300103,"OCT 30, 2023",BOS @ WAS,W,5,1,2,0.5,1,2,0.5,0,0,0.0,0,0,0,1,1,0,0,0,3,1,1,Svi Mykhailiuk,BOS,WAS,BOS,,,4,3,4,1
22023,1626204,22300556,"JAN 15, 2024",NOP @ DAL,L,26,5,11,0.455,1,4,0.25,3,3,1.0,1,7,8,2,3,0,1,1,14,16,1,Larry Nance Jr.,NOP,DAL,NOP,,,24,22,16,10
22023,1626204,22300547,"JAN 13, 2024",NOP @ DAL,W,20,4,4,1.0,0,0,0.0,6,6,1.0,1,1,2,3,2,0,0,0,14,14,1,Larry Nance Jr.,NOP,DAL,NOP,,,19,16,17,5
22023,1626204,22300539,"JAN 12, 2024",NOP @ DEN,L,20,5,6,0.833,3,4,0.75,0,0,0.0,0,2,2,1,2,1,1,1,13,-9,1,Larry Nance Jr.,NOP,DEN,NOP,,,16,15,14,3
22023,1626204,22300525,"JAN 10, 2024",NOP @ GSW,W,19,1,1,1.0,1,1,1.0,3,4,0.75,1,4,5,1,2,1,1,0,6,17,1,Larry Nance Jr.,NOP,GSW,NOP,,,12,11,7,6
22023,1626204,22300500,"JAN 07, 2024",NOP @ SAC,W,14,1,4,0.25,0,0,0.0,0,0,0.0,2,5,7,4,0,1,2,1,2,23,1,Larry Nance Jr.,NOP,SAC,NOP,,,13,9,6,11
22023,1626204,22300486,"JAN 05, 2024",NOP vs. LAC,L,19,3,6,0.5,1,2,0.5,0,0,0.0,3,3,6,2,1,0,0,0,7,-21,1,Larry Nance Jr.,NOP,NOP,LAC,,,15,13,9,8
22023,1626204,22300471,"JAN 03, 2024",NOP @ MIN,W,22,4,6,0.667,0,0,0.0,0,0,0.0,3,6,9,2,1,1,0,1,8,-2,1,Larry Nance Jr.,NOP,MIN,NOP,,,19,17,10,11
22023,1626204,22300461,"JAN 02, 2024",NOP vs. BKN,W,20,2,4,0.5,1,2,0.5,1,2,0.5,2,6,8,0,2,0,1,2,6,10,1,Larry Nance Jr.,NOP,NOP,BKN,,,14,14,6,8
22023,1626204,22300446,"DEC 31, 2023",NOP vs. LAL,W,23,3,4,0.75,1,1,1.0,4,4,1.0,2,8,10,3,0,0,1,3,11,17,1,Larry Nance Jr.,NOP,NOP,LAL,,,24,21,14,13
22023,1626204,22300424,"DEC 28, 2023",NOP vs. UTA,W,25,4,6,0.667,1,2,0.5,0,0,0.0,1,6,7,0,5,1,2,0,9,16,1,Larry Nance Jr.,NOP,NOP,UTA,,,16,16,9,7
22023,1626204,22300256,"NOV 27, 2023",NOP @ UTA,L,9,1,1,1.0,0,0,0.0,1,2,0.5,2,2,4,2,0,0,1,1,3,-5,1,Larry Nance Jr.,NOP,UTA,NOP,,,9,7,5,6
22023,1626204,22300243,"NOV 25, 2023",NOP @ UTA,L,12,0,0,0.0,0,0,0.0,0,0,0.0,1,2,3,0,3,0,1,1,0,-2,1,Larry Nance Jr.,NOP,UTA,NOP,,,3,3,0,3
22023,1626204,22300052,"NOV 24, 2023",NOP @ LAC,W,20,2,4,0.5,0,1,0.0,0,0,0.0,1,2,3,0,0,3,1,1,4,-5,1,Larry Nance Jr.,NOP,LAC,NOP,,,7,7,4,3
22023,1626204,22300233,"NOV 22, 2023",NOP vs. SAC,W,12,2,4,0.5,0,1,0.0,0,0,0.0,1,3,4,0,1,0,1,2,4,-4,1,Larry Nance Jr.,NOP,NOP,SAC,,,8,8,4,4
22023,1626204,22300183,"NOV 12, 2023",NOP vs. DAL,L,7,0,2,0.0,0,1,0.0,0,0,0.0,1,2,3,0,0,0,1,1,0,-9,1,Larry Nance Jr.,NOP,NOP,DAL,,,3,3,0,3
22023,1626204,22300011,"NOV 10, 2023",NOP @ HOU,L,15,0,0,0.0,0,0,0.0,1,2,0.5,1,4,5,1,0,0,1,1,1,-8,1,Larry Nance Jr.,NOP,HOU,NOP,,,7,6,2,6
22023,1626204,22300166,"NOV 08, 2023",NOP @ MIN,L,18,3,7,0.429,0,1,0.0,0,0,0.0,2,1,3,0,2,0,1,1,6,-11,1,Larry Nance Jr.,NOP,MIN,NOP,,,9,9,6,3
22023,1626204,22300156,"NOV 06, 2023",NOP @ DEN,L,15,2,3,0.667,1,1,1.0,0,0,0.0,1,2,3,1,0,0,1,1,5,2,1,Larry Nance Jr.,NOP,DEN,NOP,,,9,8,6,4
22023,1626204,22300135,"NOV 04, 2023",NOP vs. ATL,L,15,2,5,0.4,0,2,0.0,2,2,1.0,1,2,3,1,0,0,0,1,6,6,1,Larry Nance Jr.,NOP,NOP,ATL,,,10,9,7,4
22023,1626204,22300129,"NOV 02, 2023",NOP vs. DET,W,15,2,6,0.333,0,2,0.0,0,0,0.0,1,0,1,1,0,0,0,2,4,-11,1,Larry Nance Jr.,NOP,NOP,DET,,,6,5,5,2
22023,1626204,22300121,"NOV 01, 2023",NOP @ OKC,W,23,4,5,0.8,1,1,1.0,0,2,0.0,2,5,7,2,2,0,0,2,9,-1,1,Larry Nance Jr.,NOP,OKC,NOP,,,18,16,11,9
22023,1626204,22300108,"OCT 30, 2023",NOP vs. GSW,L,17,2,2,1.0,1,1,1.0,0,0,0.0,2,3,5,2,0,0,3,2,5,-6,1,Larry Nance Jr.,NOP,NOP,GSW,,,12,10,7,7
22023,1626204,22300090,"OCT 28, 2023",NOP vs. NYK,W,16,0,1,0.0,0,0,0.0,0,0,0.0,1,5,6,0,0,1,0,2,0,7,1,Larry Nance Jr.,NOP,NOP,NYK,,,6,6,0,6
22023,1626204,22300071,"OCT 25, 2023",NOP @ MEM,W,15,1,2,0.5,0,0,0.0,0,0,0.0,1,7,8,0,1,0,2,1,2,-4,1,Larry Nance Jr.,NOP,MEM,NOP,,,10,10,2,8
22023,1629614,22300564,"JAN 15, 2024",IND @ UTA,L,23,5,10,0.5,1,3,0.333,3,3,1.0,0,0,0,4,1,0,2,2,14,-20,1,Andrew Nembhard,IND,UTA,IND,,,18,14,18,4
22023,1629614,22300550,"JAN 14, 2024",IND @ DEN,L,29,4,8,0.5,0,1,0.0,4,6,0.667,1,1,2,7,0,0,2,0,12,-16,1,Andrew Nembhard,IND,DEN,IND,,,21,14,19,9
22023,1629614,22300533,"JAN 12, 2024",IND @ ATL,W,23,4,6,0.667,2,2,1.0,0,0,0.0,0,4,4,6,2,0,4,2,10,4,1,Andrew Nembhard,IND,ATL,IND,,,20,14,16,10
22023,1629614,22300520,"JAN 10, 2024",IND vs. WAS,W,26,1,8,0.125,0,1,0.0,0,0,0.0,2,0,2,5,2,0,5,3,2,1,1,Andrew Nembhard,IND,IND,WAS,,,9,4,7,7
22023,1629614,22300507,"JAN 08, 2024",IND vs. BOS,W,12,4,6,0.667,1,2,0.5,0,0,0.0,0,0,0,3,0,0,2,5,9,-8,1,Andrew Nembhard,IND,IND,BOS,,,12,9,12,3
22023,1629614,22300454,"JAN 01, 2024",IND @ MIL,W,8,1,2,0.5,0,0,0.0,0,0,0.0,0,0,0,0,0,0,2,0,2,-21,1,Andrew Nembhard,IND,MIL,IND,,,2,2,2,0
22023,1629614,22300441,"DEC 30, 2023",IND vs. NYK,W,33,5,10,0.5,2,4,0.5,2,2,1.0,3,2,5,5,2,0,4,4,14,20,1,Andrew Nembhard,IND,IND,NYK,,,24,19,19,10
22023,1629614,22300422,"DEC 28, 2023",IND @ CHI,W,24,4,13,0.308,0,3,0.0,0,0,0.0,1,2,3,4,1,0,1,3,8,-19,1,Andrew Nembhard,IND,CHI,IND,,,15,11,12,7
22023,1629614,22300409,"DEC 26, 2023",IND @ HOU,W,34,5,6,0.833,1,1,1.0,0,0,0.0,0,2,2,6,0,0,6,1,11,10,1,Andrew Nembhard,IND,HOU,IND,,,19,13,17,8
22023,1629614,22300391,"DEC 23, 2023",IND vs. ORL,L,36,8,10,0.8,1,1,1.0,0,0,0.0,1,0,1,5,0,0,1,2,17,14,1,Andrew Nembhard,IND,IND,ORL,,,23,18,22,6
22023,1629614,22300377,"DEC 21, 2023",IND @ MEM,L,16,2,4,0.5,2,3,0.667,0,0,0.0,0,1,1,1,2,0,1,2,6,-10,1,Andrew Nembhard,IND,MEM,IND,,,8,7,7,2
22023,1629614,22301229,"DEC 07, 2023",IND @ MIL,W,14,4,5,0.8,0,0,0.0,0,0,0.0,0,0,0,2,1,1,0,0,8,6,1,Andrew Nembhard,IND,MIL,IND,,,10,8,10,2
22023,1629614,22301202,"DEC 04, 2023",IND vs. BOS,W,5,0,2,0.0,0,0,0.0,1,2,0.5,0,1,1,1,0,0,0,1,1,-7,1,Andrew Nembhard,IND,IND,BOS,,,3,2,2,2
22023,1629614,22300284,"DEC 02, 2023",IND @ MIA,W,23,1,9,0.111,0,4,0.0,2,2,1.0,0,1,1,11,1,0,0,1,4,10,1,Andrew Nembhard,IND,MIA,IND,,,16,5,15,12
22023,1629614,22300267,"NOV 30, 2023",IND @ MIA,L,22,1,4,0.25,0,1,0.0,0,0,0.0,0,1,1,5,2,0,2,6,2,0,1,Andrew Nembhard,IND,MIA,IND,,,8,3,7,6
22023,1629614,22300254,"NOV 27, 2023",IND vs. POR,L,21,4,6,0.667,0,1,0.0,0,0,0.0,2,1,3,3,1,0,2,3,8,-4,1,Andrew Nembhard,IND,IND,POR,,,14,11,11,6
22023,1629614,22300047,"NOV 24, 2023",IND vs. DET,W,20,6,13,0.462,1,3,0.333,0,1,0.0,3,0,3,4,1,0,2,1,13,25,1,Andrew Nembhard,IND,IND,DET,,,20,16,17,7
22023,1629614,22300019,"NOV 14, 2023",IND @ PHI,W,10,1,3,0.333,0,1,0.0,0,0,0.0,1,1,2,4,1,0,0,1,2,-8,1,Andrew Nembhard,IND,PHI,IND,,,8,4,6,6
22023,1629614,22300180,"NOV 12, 2023",IND @ PHI,L,14,2,4,0.5,0,2,0.0,0,0,0.0,0,0,0,1,0,0,3,0,4,-15,1,Andrew Nembhard,IND,PHI,IND,,,5,4,5,1
22023,1629614,22300171,"NOV 09, 2023",IND vs. MIL,W,20,4,5,0.8,2,2,1.0,0,0,0.0,0,2,2,2,1,0,1,3,10,2,1,Andrew Nembhard,IND,IND,MIL,,,14,12,12,4
22023,1629614,22300158,"NOV 08, 2023",IND vs. UTA,W,19,4,4,1.0,1,1,1.0,0,0,0.0,1,3,4,7,1,0,0,2,9,16,1,Andrew Nembhard,IND,IND,UTA,,,20,13,16,11
22023,1629614,22300146,"NOV 06, 2023",IND vs. SAS,W,16,3,7,0.429,3,5,0.6,0,0,0.0,0,2,2,8,0,0,2,3,9,11,1,Andrew Nembhard,IND,IND,SAS,,,19,11,17,10
22023,1629614,22300133,"NOV 04, 2023",IND vs. CHA,L,18,3,9,0.333,1,3,0.333,0,0,0.0,1,0,1,2,2,0,0,0,7,-7,1,Andrew Nembhard,IND,IND,CHA,,,10,8,9,3
22023,1629614,22300001,"NOV 03, 2023",IND vs. CLE,W,18,2,5,0.4,0,0,0.0,2,2,1.0,0,0,0,3,0,0,2,0,6,-7,1,Andrew Nembhard,IND,IND,CLE,,,9,6,9,3
22023,1629614,22300118,"NOV 01, 2023",IND @ BOS,L,20,6,17,0.353,1,7,0.143,1,2,0.5,0,2,2,1,0,0,1,0,14,-22,1,Andrew Nembhard,IND,BOS,IND,,,17,16,15,3
22023,1629614,22300102,"OCT 30, 2023",IND vs. CHI,L,21,3,7,0.429,0,4,0.0,0,0,0.0,0,1,1,2,2,0,4,4,6,-2,1,Andrew Nembhard,IND,IND,CHI,,,9,7,8,3
22023,1629614,22300091,"OCT 28, 2023",IND @ CLE,W,25,2,5,0.4,0,2,0.0,0,0,0.0,0,2,2,4,2,0,1,4,4,21,1,Andrew Nembhard,IND,CLE,IND,,,10,6,8,6
22023,1629614,22300064,"OCT 25, 2023",IND vs. WAS,W,22,6,9,0.667,0,1,0.0,0,0,0.0,1,3,4,10,0,0,2,4,12,12,1,Andrew Nembhard,IND,IND,WAS,,,26,16,22,14
22023,1630174,22300533,"JAN 12, 2024",IND @ ATL,W,21,5,6,0.833,3,3,1.0,0,0,0.0,1,3,4,0,1,0,1,3,13,1,1,Aaron Nesmith,IND,ATL,IND,,,17,17,13,4
22023,1630174,22300520,"JAN 10, 2024",IND vs. WAS,W,24,3,9,0.333,2,5,0.4,2,2,1.0,0,3,3,1,0,0,0,1,10,1,1,Aaron Nesmith,IND,IND,WAS,,,14,13,11,4
22023,1630174,22300507,"JAN 08, 2024",IND vs. BOS,W,26,6,10,0.6,3,5,0.6,2,3,0.667,2,2,4,2,0,1,0,2,17,1,1,Aaron Nesmith,IND,IND,BOS,,,23,21,19,6
22023,1630174,22300493,"JAN 06, 2024",IND vs. BOS,L,32,3,13,0.231,0,7,0.0,2,2,1.0,1,3,4,0,3,1,0,2,8,-5,1,Aaron Nesmith,IND,IND,BOS,,,12,12,8,4
22023,1630174,22300480,"JAN 05, 2024",IND vs. ATL,W,22,7,11,0.636,1,2,0.5,0,0,0.0,0,2,2,3,1,1,2,3,15,25,1,Aaron Nesmith,IND,IND,ATL,,,20,17,18,5
22023,1630174,22300466,"JAN 03, 2024",IND vs. MIL,W,22,4,4,1.0,1,1,1.0,0,0,0.0,0,4,4,2,3,0,0,2,9,18,1,Aaron Nesmith,IND,IND,MIL,,,15,13,11,6
22023,1630174,22300454,"JAN 01, 2024",IND @ MIL,W,27,1,10,0.1,1,7,0.143,1,2,0.5,1,4,5,0,3,2,0,4,4,-11,1,Aaron Nesmith,IND,MIL,IND,,,9,9,4,5
22023,1630174,22300441,"DEC 30, 2023",IND vs. NYK,W,31,8,13,0.615,7,11,0.636,2,2,1.0,0,1,1,2,1,0,2,2,25,10,1,Aaron Nesmith,IND,IND,NYK,,,28,26,27,3
22023,1630174,22300422,"DEC 28, 2023",IND @ CHI,W,34,4,9,0.444,4,6,0.667,0,0,0.0,0,5,5,1,1,2,1,4,12,25,1,Aaron Nesmith,IND,CHI,IND,,,18,17,13,6
22023,1630174,22300409,"DEC 26, 2023",IND @ HOU,W,30,3,6,0.5,2,4,0.5,2,2,1.0,1,4,5,2,0,0,3,5,10,17,1,Aaron Nesmith,IND,HOU,IND,,,17,15,12,7
22023,1630174,22300391,"DEC 23, 2023",IND vs. ORL,L,28,1,5,0.2,1,4,0.25,0,0,0.0,1,2,3,2,2,0,4,6,3,-20,1,Aaron Nesmith,IND,IND,ORL,,,8,6,5,5
22023,1630174,22300377,"DEC 21, 2023",IND @ MEM,L,28,5,12,0.417,4,8,0.5,0,0,0.0,1,4,5,0,4,3,2,1,14,-23,1,Aaron Nesmith,IND,MEM,IND,,,19,19,14,5
22023,1630174,22300365,"DEC 20, 2023",IND vs. CHA,W,23,6,6,1.0,4,4,1.0,3,3,1.0,0,2,2,1,1,0,1,1,19,8,1,Aaron Nesmith,IND,IND,CHA,,,22,21,20,3
22023,1630174,22300350,"DEC 18, 2023",IND vs. LAC,L,26,4,7,0.571,2,3,0.667,2,2,1.0,1,5,6,2,2,3,1,3,12,0,1,Aaron Nesmith,IND,IND,LAC,,,20,18,14,8
22023,1630174,22300338,"DEC 16, 2023",IND @ MIN,L,26,7,14,0.5,2,4,0.5,1,1,1.0,3,2,5,0,0,1,0,1,17,-15,1,Aaron Nesmith,IND,MIN,IND,,,22,22,17,5
22023,1630174,22300328,"DEC 15, 2023",IND @ WAS,L,24,4,10,0.4,3,8,0.375,1,3,0.333,2,1,3,1,2,1,0,5,12,-6,1,Aaron Nesmith,IND,WAS,IND,,,16,15,13,4
22023,1630174,22300315,"DEC 13, 2023",IND @ MIL,L,25,5,11,0.455,2,7,0.286,0,0,0.0,1,0,1,1,0,0,2,5,12,-20,1,Aaron Nesmith,IND,MIL,IND,,,14,13,13,2
22023,1630174,22300293,"DEC 11, 2023",IND @ DET,W,27,5,7,0.714,3,4,0.75,0,0,0.0,0,1,1,1,0,0,2,3,13,6,1,Aaron Nesmith,IND,DET,IND,,,15,14,14,2
22023,1630174,22301229,"DEC 07, 2023",IND @ MIL,W,27,2,6,0.333,1,4,0.25,1,1,1.0,0,1,1,1,0,1,0,5,6,16,1,Aaron Nesmith,IND,MIL,IND,,,8,7,7,2
22023,1630174,22301202,"DEC 04, 2023",IND vs. BOS,W,31,6,10,0.6,1,3,0.333,1,2,0.5,0,1,1,1,0,1,1,3,14,2,1,Aaron Nesmith,IND,IND,BOS,,,16,15,15,2
22023,1630174,22300284,"DEC 02, 2023",IND @ MIA,W,29,7,9,0.778,4,6,0.667,4,6,0.667,0,4,4,1,0,1,0,4,22,9,1,Aaron Nesmith,IND,MIA,IND,,,27,26,23,5
22023,1630174,22300267,"NOV 30, 2023",IND @ MIA,L,23,4,5,0.8,0,1,0.0,1,1,1.0,3,2,5,1,4,0,1,6,9,-2,1,Aaron Nesmith,IND,MIA,IND,,,15,14,10,6
22023,1630174,22300254,"NOV 27, 2023",IND vs. POR,L,25,3,6,0.5,1,3,0.333,0,1,0.0,1,2,3,0,3,0,2,4,7,-6,1,Aaron Nesmith,IND,IND,POR,,,10,10,7,3
22023,1630174,22300039,"NOV 21, 2023",IND @ ATL,W,25,6,9,0.667,1,3,0.333,4,5,0.8,1,0,1,1,1,1,0,4,17,4,1,Aaron Nesmith,IND,ATL,IND,,,19,18,18,2
22023,1630174,22300209,"NOV 19, 2023",IND vs. ORL,L,15,0,2,0.0,0,0,0.0,0,0,0.0,0,1,1,0,0,0,0,2,0,-22,1,Aaron Nesmith,IND,IND,ORL,,,1,1,0,1
22023,1630174,22300019,"NOV 14, 2023",IND @ PHI,W,22,2,8,0.25,1,5,0.2,1,2,0.5,0,4,4,2,1,1,1,4,6,-10,1,Aaron Nesmith,IND,PHI,IND,,,12,10,8,6
22023,1630174,22300180,"NOV 12, 2023",IND @ PHI,L,26,3,6,0.5,2,5,0.4,0,0,0.0,1,3,4,3,1,0,0,3,8,2,1,Aaron Nesmith,IND,PHI,IND,,,15,12,11,7
22023,1630174,22300171,"NOV 09, 2023",IND vs. MIL,W,16,2,4,0.5,2,3,0.667,0,0,0.0,0,1,1,0,0,0,1,5,6,-22,1,Aaron Nesmith,IND,IND,MIL,,,7,7,6,1
22023,1630174,22300158,"NOV 08, 2023",IND vs. UTA,W,30,9,13,0.692,4,6,0.667,2,2,1.0,1,1,2,0,2,0,1,4,24,14,1,Aaron Nesmith,IND,IND,UTA,,,26,26,24,2
22023,1630174,22300146,"NOV 06, 2023",IND vs. SAS,W,16,5,8,0.625,3,4,0.75,2,2,1.0,1,1,2,2,2,0,0,0,15,17,1,Aaron Nesmith,IND,IND,SAS,,,19,17,17,4
22023,1630174,22300133,"NOV 04, 2023",IND vs. CHA,L,25,1,5,0.2,1,1,1.0,1,2,0.5,0,2,2,1,1,2,0,0,4,-9,1,Aaron Nesmith,IND,IND,CHA,,,7,6,5,3
22023,1630174,22300001,"NOV 03, 2023",IND vs. CLE,W,27,5,8,0.625,2,4,0.5,1,4,0.25,1,4,5,0,2,1,2,3,13,1,1,Aaron Nesmith,IND,IND,CLE,,,18,18,13,5
22023,1630174,22300118,"NOV 01, 2023",IND @ BOS,L,19,4,9,0.444,1,6,0.167,0,1,0.0,1,0,1,1,0,0,0,4,9,-10,1,Aaron Nesmith,IND,BOS,IND,,,11,10,10,2
22023,1630174,22300102,"OCT 30, 2023",IND vs. CHI,L,27,1,4,0.25,1,4,0.25,2,2,1.0,0,4,4,3,0,2,0,6,5,-15,1,Aaron Nesmith,IND,IND,CHI,,,12,9,8,7
22023,1630174,22300091,"OCT 28, 2023",IND @ CLE,W,30,10,16,0.625,5,9,0.556,1,2,0.5,4,5,9,0,0,0,0,1,26,18,1,Aaron Nesmith,IND,CLE,IND,,,35,35,26,9
22023,1630174,22300064,"OCT 25, 2023",IND vs. WAS,W,23,2,5,0.4,1,3,0.333,2,2,1.0,1,4,5,1,0,1,1,3,7,13,1,Aaron Nesmith,IND,IND,WAS,,,13,12,8,6
22023,1627777,22300561,"JAN 15, 2024",CLE vs. CHI,W,19,3,11,0.273,3,9,0.333,0,0,0.0,0,2,2,0,0,1,1,2,9,-7,1,Georges Niang,CLE,CLE,CHI,,,11,11,9,2
22023,1627777,22300527,"JAN 11, 2024",CLE vs. BKN,W,16,3,6,0.5,2,4,0.5,2,2,1.0,1,3,4,2,0,0,0,3,10,1,1,Georges Niang,CLE,CLE,BKN,,,16,14,12,6
22023,1627777,22300497,"JAN 07, 2024",CLE vs. SAS,W,27,4,7,0.571,3,6,0.5,0,0,0.0,0,4,4,1,0,1,1,2,11,27,1,Georges Niang,CLE,CLE,SAS,,,16,15,12,5
22023,1627777,22300482,"JAN 05, 2024",CLE vs. WAS,W,25,5,9,0.556,4,8,0.5,0,0,0.0,0,9,9,1,0,0,1,2,14,3,1,Georges Niang,CLE,CLE,WAS,,,24,23,15,10
22023,1627777,22300465,"JAN 03, 2024",CLE vs. WAS,W,28,5,11,0.455,3,7,0.429,2,2,1.0,1,7,8,1,0,0,0,2,15,24,1,Georges Niang,CLE,CLE,WAS,,,24,23,16,9
22023,1627777,22300452,"JAN 01, 2024",CLE @ TOR,L,16,4,5,0.8,0,1,0.0,0,0,0.0,0,4,4,2,0,0,1,5,8,-3,1,Georges Niang,CLE,TOR,CLE,,,14,12,10,6
22023,1627777,22300433,"DEC 29, 2023",CLE vs. MIL,L,14,1,7,0.143,0,6,0.0,0,0,0.0,0,0,0,0,1,1,0,2,2,-8,1,Georges Niang,CLE,CLE,MIL,,,2,2,2,0
22023,1627777,22300420,"DEC 27, 2023",CLE @ DAL,W,24,6,11,0.545,4,8,0.5,0,2,0.0,0,2,2,3,1,1,2,0,16,-15,1,Georges Niang,CLE,DAL,CLE,,,21,18,19,5
22023,1627777,22300396,"DEC 23, 2023",CLE @ CHI,W,21,3,12,0.25,1,5,0.2,0,0,0.0,1,4,5,0,0,0,2,4,7,-4,1,Georges Niang,CLE,CHI,CLE,,,12,12,7,5
22023,1627777,22300375,"DEC 21, 2023",CLE vs. NOP,L,19,4,8,0.5,3,7,0.429,0,0,0.0,0,2,2,1,0,1,3,1,11,-13,1,Georges Niang,CLE,CLE,NOP,,,14,13,12,3
22023,1627777,22300364,"DEC 20, 2023",CLE vs. UTA,W,23,6,13,0.462,3,10,0.3,0,0,0.0,0,1,1,1,0,0,1,4,15,11,1,Georges Niang,CLE,CLE,UTA,,,17,16,16,2
22023,1627777,22300349,"DEC 18, 2023",CLE vs. HOU,W,25,4,10,0.4,2,6,0.333,0,0,0.0,1,1,2,0,2,0,3,5,10,10,1,Georges Niang,CLE,CLE,HOU,,,12,12,10,2
22023,1627777,22300336,"DEC 16, 2023",CLE vs. ATL,W,15,0,4,0.0,0,3,0.0,0,0,0.0,1,2,3,2,0,0,0,2,0,-1,1,Georges Niang,CLE,CLE,ATL,,,5,3,2,5
22023,1627777,22300319,"DEC 14, 2023",CLE @ BOS,L,22,1,4,0.25,0,2,0.0,2,2,1.0,0,2,2,0,0,0,1,2,4,-7,1,Georges Niang,CLE,BOS,CLE,,,6,6,4,2
22023,1627777,22300305,"DEC 12, 2023",CLE @ BOS,L,23,1,1,1.0,1,1,1.0,0,0,0.0,0,2,2,1,0,0,1,1,3,-14,1,Georges Niang,CLE,BOS,CLE,,,6,5,4,3
22023,1627777,22300294,"DEC 11, 2023",CLE @ ORL,L,22,0,10,0.0,0,5,0.0,0,0,0.0,1,3,4,0,0,0,0,3,0,1,1,Georges Niang,CLE,ORL,CLE,,,4,4,0,4
22023,1627777,22301220,"DEC 08, 2023",CLE @ MIA,W,20,5,9,0.556,3,4,0.75,0,0,0.0,1,2,3,2,0,0,2,1,13,-10,1,Georges Niang,CLE,MIA,CLE,,,18,16,15,5
22023,1627777,22301205,"DEC 06, 2023",CLE vs. ORL,W,28,4,7,0.571,2,5,0.4,0,0,0.0,1,4,5,3,0,0,2,4,10,14,1,Georges Niang,CLE,CLE,ORL,,,18,15,13,8
22023,1627777,22300283,"DEC 02, 2023",CLE @ DET,W,22,5,8,0.625,1,4,0.25,1,2,0.5,0,3,3,2,0,0,0,1,12,15,1,Georges Niang,CLE,DET,CLE,,,17,15,14,5
22023,1627777,22300265,"NOV 30, 2023",CLE vs. POR,L,19,3,6,0.5,1,3,0.333,1,1,1.0,1,0,1,2,2,0,0,0,8,-4,1,Georges Niang,CLE,CLE,POR,,,11,9,10,3
22023,1627777,22300055,"NOV 28, 2023",CLE vs. ATL,W,19,4,9,0.444,2,6,0.333,2,2,1.0,0,7,7,1,0,0,1,3,12,-10,1,Georges Niang,CLE,CLE,ATL,,,20,19,13,8
22023,1627777,22300251,"NOV 26, 2023",CLE vs. TOR,W,23,3,9,0.333,2,5,0.4,0,0,0.0,0,6,6,3,1,0,0,4,8,13,1,Georges Niang,CLE,CLE,TOR,,,17,14,11,9
22023,1627777,22300242,"NOV 25, 2023",CLE vs. LAL,L,23,5,13,0.385,3,9,0.333,0,0,0.0,0,2,2,1,2,0,1,2,13,7,1,Georges Niang,CLE,CLE,LAL,,,16,15,14,3
22023,1627777,22300229,"NOV 22, 2023",CLE vs. MIA,L,20,4,9,0.444,3,5,0.6,0,0,0.0,1,2,3,1,0,0,0,5,11,-17,1,Georges Niang,CLE,CLE,MIA,,,15,14,12,4
22023,1627777,22300040,"NOV 21, 2023",CLE @ PHI,W,26,5,9,0.556,2,4,0.5,0,0,0.0,0,7,7,0,0,0,1,2,12,12,1,Georges Niang,CLE,PHI,CLE,,,19,19,12,7
22023,1627777,22300210,"NOV 19, 2023",CLE vs. DEN,W,23,4,9,0.444,2,3,0.667,2,2,1.0,0,3,3,2,0,0,1,1,12,11,1,Georges Niang,CLE,CLE,DEN,,,17,15,14,5
22023,1627777,22300030,"NOV 17, 2023",CLE vs. DET,W,27,3,4,0.75,1,1,1.0,2,2,1.0,0,7,7,2,1,0,0,1,9,21,1,Georges Niang,CLE,CLE,DET,,,18,16,11,9
22023,1627777,22300199,"NOV 15, 2023",CLE @ POR,W,22,3,6,0.5,2,4,0.5,0,0,0.0,0,2,2,0,0,1,2,1,8,-8,1,Georges Niang,CLE,POR,CLE,,,10,10,8,2
22023,1627777,22300191,"NOV 13, 2023",CLE @ SAC,L,22,5,7,0.714,2,4,0.5,0,0,0.0,0,1,1,1,0,0,0,1,12,-12,1,Georges Niang,CLE,SAC,CLE,,,14,13,13,2
22023,1627777,22300176,"NOV 11, 2023",CLE @ GSW,W,19,0,4,0.0,0,4,0.0,0,0,0.0,1,1,2,1,0,0,1,1,0,-10,1,Georges Niang,CLE,GSW,CLE,,,3,2,1,3
22023,1627777,22300167,"NOV 08, 2023",CLE @ OKC,L,18,3,5,0.6,1,3,0.333,0,0,0.0,0,2,2,0,0,0,1,3,7,-11,1,Georges Niang,CLE,OKC,CLE,,,9,9,7,2
22023,1627777,22300142,"NOV 05, 2023",CLE vs. GSW,W,25,2,6,0.333,2,4,0.5,0,0,0.0,0,6,6,1,0,0,0,4,6,1,1,Georges Niang,CLE,CLE,GSW,,,13,12,7,7
22023,1627777,22300001,"NOV 03, 2023",CLE @ IND,L,27,4,9,0.444,2,6,0.333,2,2,1.0,0,5,5,1,0,0,0,2,12,9,1,Georges Niang,CLE,IND,CLE,,,18,17,13,6
22023,1627777,22300120,"NOV 01, 2023",CLE @ NYK,W,28,1,6,0.167,1,3,0.333,2,2,1.0,0,10,10,2,1,0,0,4,5,7,1,Georges Niang,CLE,NYK,CLE,,,17,15,7,12
22023,1627777,22300112,"OCT 31, 2023",CLE vs. NYK,L,24,4,12,0.333,3,9,0.333,0,0,0.0,0,3,3,1,0,0,2,3,11,-12,1,Georges Niang,CLE,CLE,NYK,,,15,14,12,4
22023,1627777,22300091,"OCT 28, 2023",CLE vs. IND,L,19,3,10,0.3,1,4,0.25,0,0,0.0,1,2,3,2,0,1,1,3,7,-16,1,Georges Niang,CLE,CLE,IND,,,12,10,9,5
22023,1627777,22300081,"OCT 27, 2023",CLE vs. OKC,L,21,1,6,0.167,0,5,0.0,0,0,0.0,0,2,2,1,0,0,0,2,2,0,1,Georges Niang,CLE,CLE,OKC,,,5,4,3,3
22023,1627777,22300067,"OCT 25, 2023",CLE @ BKN,W,20,0,3,0.0,0,3,0.0,0,0,0.0,2,2,4,0,0,0,0,3,0,-9,1,Georges Niang,CLE,BKN,CLE,,,4,4,0,4
22023,1630227,22300301,"DEC 11, 2023",MIN @ NOP,L,2,0,0,0.0,0,0,0.0,0,2,0.0,0,0,0,0,0,0,0,0,0,1,1,Daishen Nix,MIN,NOP,MIN,,,0,0,0,0
22023,1630227,22300270,"NOV 30, 2023",MIN vs. UTA,W,10,1,5,0.2,1,4,0.25,0,0,0.0,0,1,1,0,0,0,0,0,3,6,1,Daishen Nix,MIN,MIN,UTA,,,4,4,3,1
22023,1630227,22300249,"NOV 26, 2023",MIN @ MEM,W,2,1,2,0.5,1,1,1.0,0,0,0.0,0,0,0,0,0,0,0,0,3,3,1,Daishen Nix,MIN,MEM,MIN,,,3,3,3,0
22023,1630227,22300166,"NOV 08, 2023",MIN vs. NOP,W,3,0,0,0.0,0,0,0.0,0,0,0.0,0,0,0,0,0,0,0,0,0,-6,1,Daishen Nix,MIN,MIN,NOP,,,0,0,0,0
22023,1630227,22300138,"NOV 04, 2023",MIN vs. UTA,W,3,1,1,1.0,0,0,0.0,0,0,0.0,0,0,0,0,1,0,0,0,2,6,1,Daishen Nix,MIN,MIN,UTA,,,2,2,2,0
22023,1630227,22300104,"OCT 30, 2023",MIN @ ATL,L,1,0,0,0.0,0,0,0.0,0,0,0.0,0,0,0,0,0,0,0,0,0,4,1,Daishen Nix,MIN,ATL,MIN,,,0,0,0,0
22023,1630192,22300539,"JAN 12, 2024",DEN vs. NOP,W,2,0,1,0.0,0,0,0.0,0,0,0.0,0,0,0,0,0,0,0,0,0,-6,1,Zeke Nnaji,DEN,DEN,NOP,,,0,0,0,0
22023,1630192,22300524,"JAN 10, 2024",DEN @ UTA,L,6,1,2,0.5,1,1,1.0,2,2,1.0,0,0,0,1,1,0,0,2,5,12,1,Zeke Nnaji,DEN,UTA,DEN,,,6,5,6,1
22023,1630192,22300502,"JAN 07, 2024",DEN vs. DET,W,2,0,1,0.0,0,1,0.0,0,0,0.0,0,0,0,0,0,0,0,0,0,-6,1,Zeke Nnaji,DEN,DEN,DET,,,0,0,0,0
22023,1630192,22300488,"JAN 05, 2024",DEN vs. ORL,L,11,1,1,1.0,0,0,0.0,1,2,0.5,1,1,2,0,1,0,2,4,3,2,1,Zeke Nnaji,DEN,DEN,ORL,,,5,5,3,2
22023,1630192,22300478,"JAN 04, 2024",DEN @ GSW,W,6,1,1,1.0,0,0,0.0,0,0,0.0,1,2,3,1,0,0,0,0,2,-3,1,Zeke Nnaji,DEN,GSW,DEN,,,6,5,3,4
22023,1630192,22300455,"JAN 01, 2024",DEN vs. CHA,W,21,1,5,0.2,0,2,0.0,0,0,0.0,1,2,3,1,0,3,2,2,2,-9,1,Zeke Nnaji,DEN,DEN,CHA,,,6,5,3,4
22023,1630192,22300435,"DEC 29, 2023",DEN vs. OKC,L,3,0,1,0.0,0,0,0.0,0,0,0.0,0,0,0,0,0,0,0,0,0,-6,1,Zeke Nnaji,DEN,DEN,OKC,,,0,0,0,0
22023,1630192,22300425,"DEC 28, 2023",DEN vs. MEM,W,6,2,3,0.667,0,0,0.0,0,0,0.0,1,2,3,0,0,0,1,2,4,3,1,Zeke Nnaji,DEN,DEN,MEM,,,7,7,4,3
22023,1630192,22300402,"DEC 25, 2023",DEN vs. GSW,W,5,0,0,0.0,0,0,0.0,0,0,0.0,0,0,0,0,1,0,0,1,0,-11,1,Zeke Nnaji,DEN,DEN,GSW,,,0,0,0,0
22023,1630192,22300390,"DEC 23, 2023",DEN @ CHA,W,12,0,1,0.0,0,0,0.0,0,0,0.0,2,0,2,1,0,2,2,4,0,-7,1,Zeke Nnaji,DEN,CHA,DEN,,,3,2,1,3
22023,1630192,22300383,"DEC 22, 2023",DEN @ BKN,W,7,1,2,0.5,0,0,0.0,0,0,0.0,1,2,3,0,0,0,0,2,2,-9,1,Zeke Nnaji,DEN,BKN,DEN,,,5,5,2,3
22023,1630192,22300369,"DEC 20, 2023",DEN @ TOR,W,10,0,3,0.0,0,0,0.0,0,2,0.0,2,1,3,1,1,2,2,1,0,-6,1,Zeke Nnaji,DEN,TOR,DEN,,,4,3,1,4
22023,1630192,22300356,"DEC 18, 2023",DEN vs. DAL,W,20,5,8,0.625,0,2,0.0,4,4,1.0,2,2,4,2,1,1,1,4,14,10,1,Zeke Nnaji,DEN,DEN,DAL,,,20,18,16,6
22023,1630192,22300322,"DEC 14, 2023",DEN vs. BKN,W,6,2,2,1.0,1,1,1.0,0,0,0.0,3,0,3,1,0,0,0,1,5,4,1,Zeke Nnaji,DEN,DEN,BKN,,,9,8,6,4
22023,1630192,22300296,"DEC 11, 2023",DEN @ ATL,W,12,1,2,0.5,0,1,0.0,1,1,1.0,1,3,4,1,0,2,1,3,3,-1,1,Zeke Nnaji,DEN,ATL,DEN,,,8,7,4,5
22023,1630192,22300263,"NOV 29, 2023",DEN vs. HOU,W,18,2,4,0.5,0,0,0.0,3,4,0.75,2,1,3,0,0,1,0,2,7,-17,1,Zeke Nnaji,DEN,DEN,HOU,,,10,10,7,3
22023,1630192,22300257,"NOV 27, 2023",DEN @ LAC,W,12,3,8,0.375,0,0,0.0,2,5,0.4,7,0,7,0,0,3,1,2,8,-13,1,Zeke Nnaji,DEN,LAC,DEN,,,15,15,8,7
22023,1630192,22300252,"NOV 26, 2023",DEN vs. SAS,W,1,0,0,0.0,0,0,0.0,0,0,0.0,0,0,0,0,0,0,0,2,0,-2,1,Zeke Nnaji,DEN,DEN,SAS,,,0,0,0,0
22023,1630192,22300048,"NOV 24, 2023",DEN @ HOU,L,4,0,1,0.0,0,0,0.0,0,0,0.0,0,0,0,0,0,0,1,0,0,0,1,Zeke Nnaji,DEN,HOU,DEN,,,0,0,0,0
22023,1630192,22300226,"NOV 22, 2023",DEN @ ORL,L,12,1,2,0.5,0,0,0.0,1,2,0.5,1,0,1,2,0,0,0,1,3,-9,1,Zeke Nnaji,DEN,ORL,DEN,,,6,4,5,3
22023,1630192,22300218,"NOV 20, 2023",DEN @ DET,W,14,2,3,0.667,1,1,1.0,2,3,0.667,1,0,1,0,1,1,1,3,7,2,1,Zeke Nnaji,DEN,DET,DEN,,,8,8,7,1
22023,1630192,22300210,"NOV 19, 2023",DEN @ CLE,L,14,3,4,0.75,1,1,1.0,2,2,1.0,3,1,4,1,0,0,1,2,9,7,1,Zeke Nnaji,DEN,CLE,DEN,,,14,13,10,5
22023,1630192,22300034,"NOV 17, 2023",DEN @ NOP,L,4,0,1,0.0,0,0,0.0,0,0,0.0,0,0,0,0,0,0,2,2,0,-10,1,Zeke Nnaji,DEN,NOP,DEN,,,0,0,0,0
22023,1630192,22300024,"NOV 14, 2023",DEN vs. LAC,W,12,1,2,0.5,0,0,0.0,1,2,0.5,1,2,3,0,0,0,0,1,3,0,1,Zeke Nnaji,DEN,DEN,LAC,,,6,6,3,3
22023,1630192,22300182,"NOV 12, 2023",DEN @ HOU,L,11,1,4,0.25,0,1,0.0,0,0,0.0,2,2,4,0,0,0,0,0,2,-18,1,Zeke Nnaji,DEN,HOU,DEN,,,6,6,2,4
22023,1630192,22300169,"NOV 08, 2023",DEN vs. GSW,W,6,0,1,0.0,0,0,0.0,0,0,0.0,0,2,2,2,0,0,0,0,0,-3,1,Zeke Nnaji,DEN,DEN,GSW,,,4,2,2,4
22023,1630192,22300156,"NOV 06, 2023",DEN vs. NOP,W,6,0,0,0.0,0,0,0.0,0,0,0.0,1,1,2,1,0,1,1,2,0,-6,1,Zeke Nnaji,DEN,DEN,NOP,,,3,2,1,3
22023,1630192,22300139,"NOV 04, 2023",DEN vs. CHI,W,2,0,0,0.0,0,0,0.0,1,2,0.5,0,1,1,0,0,0,0,1,1,-1,1,Zeke Nnaji,DEN,DEN,CHI,,,2,2,1,1
22023,1630192,22300006,"NOV 03, 2023",DEN vs. DAL,W,12,2,2,1.0,0,0,0.0,0,1,0.0,1,3,4,0,0,0,1,0,4,-4,1,Zeke Nnaji,DEN,DEN,DAL,,,8,8,4,4
22023,1630192,22300123,"NOV 01, 2023",DEN @ MIN,L,18,4,9,0.444,1,3,0.333,0,0,0.0,2,3,5,0,0,2,0,3,9,-6,1,Zeke Nnaji,DEN,MIN,DEN,,,14,14,9,5
22023,1630192,22300110,"OCT 30, 2023",DEN vs. UTA,W,13,2,2,1.0,0,0,0.0,2,3,0.667,1,2,3,0,2,0,0,0,6,-5,1,Zeke Nnaji,DEN,DEN,UTA,,,9,9,6,3
22023,1630192,22300095,"OCT 29, 2023",DEN @ OKC,W,15,0,1,0.0,0,0,0.0,0,0,0.0,1,2,3,1,0,0,0,2,0,12,1,Zeke Nnaji,DEN,OKC,DEN,,,4,3,1,4
22023,1630192,22300078,"OCT 27, 2023",DEN @ MEM,W,13,3,4,0.75,0,0,0.0,1,2,0.5,0,1,1,0,0,2,1,1,7,-2,1,Zeke Nnaji,DEN,MEM,DEN,,,8,8,7,1
22023,1630192,22300061,"OCT 24, 2023",DEN vs. LAL,W,12,1,3,0.333,0,1,0.0,2,2,1.0,0,0,0,1,0,0,1,2,4,-3,1,Zeke Nnaji,DEN,DEN,LAL,,,5,4,5,1
22023,1641806,22300195,"NOV 15, 2023",TOR vs. MIL,L,4,0,1,0.0,0,0,0.0,2,2,1.0,2,0,2,2,1,0,0,0,2,4,1,Markquis Nowell,TOR,TOR,MIL,,,6,4,4,4
22023,203994,22300554,"JAN 14, 2024",PHX @ POR,W,27,5,8,0.625,0,0,0.0,4,6,0.667,4,9,13,1,3,1,1,3,14,18,1,Jusuf Nurkic,PHX,POR,PHX,12.5,Points,28,27,15,14
22023,203994,22300554,"JAN 14, 2024",PHX @ POR,W,27,5,8,0.625,0,0,0.0,4,6,0.667,4,9,13,1,3,1,1,3,14,18,1,Jusuf Nurkic,PHX,POR,PHX,11.0,Rebounds,28,27,15,14
22023,203994,22300554,"JAN 14, 2024",PHX @ POR,W,27,5,8,0.625,0,0,0.0,4,6,0.667,4,9,13,1,3,1,1,3,14,18,1,Jusuf Nurkic,PHX,POR,PHX,26.5,Pts+Rebs+Asts,28,27,15,14
22023,203994,22300554,"JAN 14, 2024",PHX @ POR,W,27,5,8,0.625,0,0,0.0,4,6,0.667,4,9,13,1,3,1,1,3,14,18,1,Jusuf Nurkic,PHX,POR,PHX,32.5,Fantasy Score,28,27,15,14
22023,203994,22300554,"JAN 14, 2024",PHX @ POR,W,27,5,8,0.625,0,0,0.0,4,6,0.667,4,9,13,1,3,1,1,3,14,18,1,Jusuf Nurkic,PHX,POR,PHX,8.0,Defensive Rebounds,28,27,15,14
22023,203994,22300554,"JAN 14, 2024",PHX @ POR,W,27,5,8,0.625,0,0,0.0,4,6,0.667,4,9,13,1,3,1,1,3,14,18,1,Jusuf Nurkic,PHX,POR,PHX,23.5,Pts+Rebs,28,27,15,14
22023,203994,22300554,"JAN 14, 2024",PHX @ POR,W,27,5,8,0.625,0,0,0.0,4,6,0.667,4,9,13,1,3,1,1,3,14,18,1,Jusuf Nurkic,PHX,POR,PHX,0.5,Dunks,28,27,15,14
22023,203994,22300554,"JAN 14, 2024",PHX @ POR,W,27,5,8,0.625,0,0,0.0,4,6,0.667,4,9,13,1,3,1,1,3,14,18,1,Jusuf Nurkic,PHX,POR,PHX,15.5,Pts+Asts,28,27,15,14
22023,203994,22300554,"JAN 14, 2024",PHX @ POR,W,27,5,8,0.625,0,0,0.0,4,6,0.667,4,9,13,1,3,1,1,3,14,18,1,Jusuf Nurkic,PHX,POR,PHX,13.5,Rebs+Asts,28,27,15,14
22023,203994,22300531,"JAN 11, 2024",PHX @ LAL,W,28,3,6,0.5,0,0,0.0,3,4,0.75,4,8,12,2,1,0,2,2,9,29,1,Jusuf Nurkic,PHX,LAL,PHX,12.5,Points,23,21,11,14
22023,203994,22300531,"JAN 11, 2024",PHX @ LAL,W,28,3,6,0.5,0,0,0.0,3,4,0.75,4,8,12,2,1,0,2,2,9,29,1,Jusuf Nurkic,PHX,LAL,PHX,11.0,Rebounds,23,21,11,14
22023,203994,22300531,"JAN 11, 2024",PHX @ LAL,W,28,3,6,0.5,0,0,0.0,3,4,0.75,4,8,12,2,1,0,2,2,9,29,1,Jusuf Nurkic,PHX,LAL,PHX,26.5,Pts+Rebs+Asts,23,21,11,14
22023,203994,22300531,"JAN 11, 2024",PHX @ LAL,W,28,3,6,0.5,0,0,0.0,3,4,0.75,4,8,12,2,1,0,2,2,9,29,1,Jusuf Nurkic,PHX,LAL,PHX,32.5,Fantasy Score,23,21,11,14
22023,203994,22300531,"JAN 11, 2024",PHX @ LAL,W,28,3,6,0.5,0,0,0.0,3,4,0.75,4,8,12,2,1,0,2,2,9,29,1,Jusuf Nurkic,PHX,LAL,PHX,8.0,Defensive Rebounds,23,21,11,14
22023,203994,22300531,"JAN 11, 2024",PHX @ LAL,W,28,3,6,0.5,0,0,0.0,3,4,0.75,4,8,12,2,1,0,2,2,9,29,1,Jusuf Nurkic,PHX,LAL,PHX,23.5,Pts+Rebs,23,21,11,14
22023,203994,22300531,"JAN 11, 2024",PHX @ LAL,W,28,3,6,0.5,0,0,0.0,3,4,0.75,4,8,12,2,1,0,2,2,9,29,1,Jusuf Nurkic,PHX,LAL,PHX,0.5,Dunks,23,21,11,14
22023,203994,22300531,"JAN 11, 2024",PHX @ LAL,W,28,3,6,0.5,0,0,0.0,3,4,0.75,4,8,12,2,1,0,2,2,9,29,1,Jusuf Nurkic,PHX,LAL,PHX,15.5,Pts+Asts,23,21,11,14
22023,203994,22300531,"JAN 11, 2024",PHX @ LAL,W,28,3,6,0.5,0,0,0.0,3,4,0.75,4,8,12,2,1,0,2,2,9,29,1,Jusuf Nurkic,PHX,LAL,PHX,13.5,Rebs+Asts,23,21,11,14
22023,203994,22300511,"JAN 08, 2024",PHX @ LAC,L,21,3,8,0.375,1,2,0.5,1,2,0.5,1,2,3,2,1,0,0,1,8,-14,1,Jusuf Nurkic,PHX,LAC,PHX,12.5,Points,13,11,10,5
22023,203994,22300511,"JAN 08, 2024",PHX @ LAC,L,21,3,8,0.375,1,2,0.5,1,2,0.5,1,2,3,2,1,0,0,1,8,-14,1,Jusuf Nurkic,PHX,LAC,PHX,11.0,Rebounds,13,11,10,5
22023,203994,22300511,"JAN 08, 2024",PHX @ LAC,L,21,3,8,0.375,1,2,0.5,1,2,0.5,1,2,3,2,1,0,0,1,8,-14,1,Jusuf Nurkic,PHX,LAC,PHX,26.5,Pts+Rebs+Asts,13,11,10,5
22023,203994,22300511,"JAN 08, 2024",PHX @ LAC,L,21,3,8,0.375,1,2,0.5,1,2,0.5,1,2,3,2,1,0,0,1,8,-14,1,Jusuf Nurkic,PHX,LAC,PHX,32.5,Fantasy Score,13,11,10,5
22023,203994,22300511,"JAN 08, 2024",PHX @ LAC,L,21,3,8,0.375,1,2,0.5,1,2,0.5,1,2,3,2,1,0,0,1,8,-14,1,Jusuf Nurkic,PHX,LAC,PHX,8.0,Defensive Rebounds,13,11,10,5
22023,203994,22300511,"JAN 08, 2024",PHX @ LAC,L,21,3,8,0.375,1,2,0.5,1,2,0.5,1,2,3,2,1,0,0,1,8,-14,1,Jusuf Nurkic,PHX,LAC,PHX,23.5,Pts+Rebs,13,11,10,5
22023,203994,22300511,"JAN 08, 2024",PHX @ LAC,L,21,3,8,0.375,1,2,0.5,1,2,0.5,1,2,3,2,1,0,0,1,8,-14,1,Jusuf Nurkic,PHX,LAC,PHX,0.5,Dunks,13,11,10,5
22023,203994,22300511,"JAN 08, 2024",PHX @ LAC,L,21,3,8,0.375,1,2,0.5,1,2,0.5,1,2,3,2,1,0,0,1,8,-14,1,Jusuf Nurkic,PHX,LAC,PHX,15.5,Pts+Asts,13,11,10,5
22023,203994,22300511,"JAN 08, 2024",PHX @ LAC,L,21,3,8,0.375,1,2,0.5,1,2,0.5,1,2,3,2,1,0,0,1,8,-14,1,Jusuf Nurkic,PHX,LAC,PHX,13.5,Rebs+Asts,13,11,10,5
22023,203994,22300503,"JAN 07, 2024",PHX vs. MEM,L,32,8,17,0.471,1,2,0.5,1,3,0.333,6,13,19,5,0,1,2,4,18,2,1,Jusuf Nurkic,PHX,PHX,MEM,12.5,Points,42,37,23,24
22023,203994,22300503,"JAN 07, 2024",PHX vs. MEM,L,32,8,17,0.471,1,2,0.5,1,3,0.333,6,13,19,5,0,1,2,4,18,2,1,Jusuf Nurkic,PHX,PHX,MEM,11.0,Rebounds,42,37,23,24
22023,203994,22300503,"JAN 07, 2024",PHX vs. MEM,L,32,8,17,0.471,1,2,0.5,1,3,0.333,6,13,19,5,0,1,2,4,18,2,1,Jusuf Nurkic,PHX,PHX,MEM,26.5,Pts+Rebs+Asts,42,37,23,24
22023,203994,22300503,"JAN 07, 2024",PHX vs. MEM,L,32,8,17,0.471,1,2,0.5,1,3,0.333,6,13,19,5,0,1,2,4,18,2,1,Jusuf Nurkic,PHX,PHX,MEM,32.5,Fantasy Score,42,37,23,24
22023,203994,22300503,"JAN 07, 2024",PHX vs. MEM,L,32,8,17,0.471,1,2,0.5,1,3,0.333,6,13,19,5,0,1,2,4,18,2,1,Jusuf Nurkic,PHX,PHX,MEM,8.0,Defensive Rebounds,42,37,23,24
22023,203994,22300503,"JAN 07, 2024",PHX vs. MEM,L,32,8,17,0.471,1,2,0.5,1,3,0.333,6,13,19,5,0,1,2,4,18,2,1,Jusuf Nurkic,PHX,PHX,MEM,23.5,Pts+Rebs,42,37,23,24
22023,203994,22300503,"JAN 07, 2024",PHX vs. MEM,L,32,8,17,0.471,1,2,0.5,1,3,0.333,6,13,19,5,0,1,2,4,18,2,1,Jusuf Nurkic,PHX,PHX,MEM,0.5,Dunks,42,37,23,24
22023,203994,22300503,"JAN 07, 2024",PHX vs. MEM,L,32,8,17,0.471,1,2,0.5,1,3,0.333,6,13,19,5,0,1,2,4,18,2,1,Jusuf Nurkic,PHX,PHX,MEM,15.5,Pts+Asts,42,37,23,24
22023,203994,22300503,"JAN 07, 2024",PHX vs. MEM,L,32,8,17,0.471,1,2,0.5,1,3,0.333,6,13,19,5,0,1,2,4,18,2,1,Jusuf Nurkic,PHX,PHX,MEM,13.5,Rebs+Asts,42,37,23,24
22023,203994,22300489,"JAN 05, 2024",PHX vs. MIA,W,26,3,6,0.5,0,1,0.0,0,0,0.0,1,8,9,2,1,0,0,2,6,21,1,Jusuf Nurkic,PHX,PHX,MIA,12.5,Points,17,15,8,11
22023,203994,22300489,"JAN 05, 2024",PHX vs. MIA,W,26,3,6,0.5,0,1,0.0,0,0,0.0,1,8,9,2,1,0,0,2,6,21,1,Jusuf Nurkic,PHX,PHX,MIA,11.0,Rebounds,17,15,8,11
22023,203994,22300489,"JAN 05, 2024",PHX vs. MIA,W,26,3,6,0.5,0,1,0.0,0,0,0.0,1,8,9,2,1,0,0,2,6,21,1,Jusuf Nurkic,PHX,PHX,MIA,26.5,Pts+Rebs+Asts,17,15,8,11
22023,203994,22300489,"JAN 05, 2024",PHX vs. MIA,W,26,3,6,0.5,0,1,0.0,0,0,0.0,1,8,9,2,1,0,0,2,6,21,1,Jusuf Nurkic,PHX,PHX,MIA,32.5,Fantasy Score,17,15,8,11
22023,203994,22300489,"JAN 05, 2024",PHX vs. MIA,W,26,3,6,0.5,0,1,0.0,0,0,0.0,1,8,9,2,1,0,0,2,6,21,1,Jusuf Nurkic,PHX,PHX,MIA,8.0,Defensive Rebounds,17,15,8,11
22023,203994,22300489,"JAN 05, 2024",PHX vs. MIA,W,26,3,6,0.5,0,1,0.0,0,0,0.0,1,8,9,2,1,0,0,2,6,21,1,Jusuf Nurkic,PHX,PHX,MIA,23.5,Pts+Rebs,17,15,8,11
22023,203994,22300489,"JAN 05, 2024",PHX vs. MIA,W,26,3,6,0.5,0,1,0.0,0,0,0.0,1,8,9,2,1,0,0,2,6,21,1,Jusuf Nurkic,PHX,PHX,MIA,0.5,Dunks,17,15,8,11
22023,203994,22300489,"JAN 05, 2024",PHX vs. MIA,W,26,3,6,0.5,0,1,0.0,0,0,0.0,1,8,9,2,1,0,0,2,6,21,1,Jusuf Nurkic,PHX,PHX,MIA,15.5,Pts+Asts,17,15,8,11
22023,203994,22300489,"JAN 05, 2024",PHX vs. MIA,W,26,3,6,0.5,0,1,0.0,0,0,0.0,1,8,9,2,1,0,0,2,6,21,1,Jusuf Nurkic,PHX,PHX,MIA,13.5,Rebs+Asts,17,15,8,11
22023,203994,22300473,"JAN 03, 2024",PHX vs. LAC,L,25,3,5,0.6,0,1,0.0,3,3,1.0,1,5,6,1,1,0,1,3,9,-15,1,Jusuf Nurkic,PHX,PHX,LAC,12.5,Points,16,15,10,7
22023,203994,22300473,"JAN 03, 2024",PHX vs. LAC,L,25,3,5,0.6,0,1,0.0,3,3,1.0,1,5,6,1,1,0,1,3,9,-15,1,Jusuf Nurkic,PHX,PHX,LAC,11.0,Rebounds,16,15,10,7
22023,203994,22300473,"JAN 03, 2024",PHX vs. LAC,L,25,3,5,0.6,0,1,0.0,3,3,1.0,1,5,6,1,1,0,1,3,9,-15,1,Jusuf Nurkic,PHX,PHX,LAC,26.5,Pts+Rebs+Asts,16,15,10,7
22023,203994,22300473,"JAN 03, 2024",PHX vs. LAC,L,25,3,5,0.6,0,1,0.0,3,3,1.0,1,5,6,1,1,0,1,3,9,-15,1,Jusuf Nurkic,PHX,PHX,LAC,32.5,Fantasy Score,16,15,10,7
22023,203994,22300473,"JAN 03, 2024",PHX vs. LAC,L,25,3,5,0.6,0,1,0.0,3,3,1.0,1,5,6,1,1,0,1,3,9,-15,1,Jusuf Nurkic,PHX,PHX,LAC,8.0,Defensive Rebounds,16,15,10,7
22023,203994,22300473,"JAN 03, 2024",PHX vs. LAC,L,25,3,5,0.6,0,1,0.0,3,3,1.0,1,5,6,1,1,0,1,3,9,-15,1,Jusuf Nurkic,PHX,PHX,LAC,23.5,Pts+Rebs,16,15,10,7
22023,203994,22300473,"JAN 03, 2024",PHX vs. LAC,L,25,3,5,0.6,0,1,0.0,3,3,1.0,1,5,6,1,1,0,1,3,9,-15,1,Jusuf Nurkic,PHX,PHX,LAC,0.5,Dunks,16,15,10,7
22023,203994,22300473,"JAN 03, 2024",PHX vs. LAC,L,25,3,5,0.6,0,1,0.0,3,3,1.0,1,5,6,1,1,0,1,3,9,-15,1,Jusuf Nurkic,PHX,PHX,LAC,15.5,Pts+Asts,16,15,10,7
22023,203994,22300473,"JAN 03, 2024",PHX vs. LAC,L,25,3,5,0.6,0,1,0.0,3,3,1.0,1,5,6,1,1,0,1,3,9,-15,1,Jusuf Nurkic,PHX,PHX,LAC,13.5,Rebs+Asts,16,15,10,7
22023,203994,22300456,"JAN 01, 2024",PHX vs. POR,W,25,6,8,0.75,1,2,0.5,5,6,0.833,1,6,7,5,1,2,2,3,18,17,1,Jusuf Nurkic,PHX,PHX,POR,12.5,Points,30,25,23,12
22023,203994,22300456,"JAN 01, 2024",PHX vs. POR,W,25,6,8,0.75,1,2,0.5,5,6,0.833,1,6,7,5,1,2,2,3,18,17,1,Jusuf Nurkic,PHX,PHX,POR,11.0,Rebounds,30,25,23,12
22023,203994,22300456,"JAN 01, 2024",PHX vs. POR,W,25,6,8,0.75,1,2,0.5,5,6,0.833,1,6,7,5,1,2,2,3,18,17,1,Jusuf Nurkic,PHX,PHX,POR,26.5,Pts+Rebs+Asts,30,25,23,12
22023,203994,22300456,"JAN 01, 2024",PHX vs. POR,W,25,6,8,0.75,1,2,0.5,5,6,0.833,1,6,7,5,1,2,2,3,18,17,1,Jusuf Nurkic,PHX,PHX,POR,32.5,Fantasy Score,30,25,23,12
22023,203994,22300456,"JAN 01, 2024",PHX vs. POR,W,25,6,8,0.75,1,2,0.5,5,6,0.833,1,6,7,5,1,2,2,3,18,17,1,Jusuf Nurkic,PHX,PHX,POR,8.0,Defensive Rebounds,30,25,23,12
22023,203994,22300456,"JAN 01, 2024",PHX vs. POR,W,25,6,8,0.75,1,2,0.5,5,6,0.833,1,6,7,5,1,2,2,3,18,17,1,Jusuf Nurkic,PHX,PHX,POR,23.5,Pts+Rebs,30,25,23,12
22023,203994,22300456,"JAN 01, 2024",PHX vs. POR,W,25,6,8,0.75,1,2,0.5,5,6,0.833,1,6,7,5,1,2,2,3,18,17,1,Jusuf Nurkic,PHX,PHX,POR,0.5,Dunks,30,25,23,12
22023,203994,22300456,"JAN 01, 2024",PHX vs. POR,W,25,6,8,0.75,1,2,0.5,5,6,0.833,1,6,7,5,1,2,2,3,18,17,1,Jusuf Nurkic,PHX,PHX,POR,15.5,Pts+Asts,30,25,23,12
22023,203994,22300456,"JAN 01, 2024",PHX vs. POR,W,25,6,8,0.75,1,2,0.5,5,6,0.833,1,6,7,5,1,2,2,3,18,17,1,Jusuf Nurkic,PHX,PHX,POR,13.5,Rebs+Asts,30,25,23,12
22023,203994,22300450,"DEC 31, 2023",PHX vs. ORL,W,33,8,17,0.471,0,3,0.0,3,5,0.6,3,10,13,3,0,0,1,3,19,18,1,Jusuf Nurkic,PHX,PHX,ORL,12.5,Points,35,32,22,16
22023,203994,22300450,"DEC 31, 2023",PHX vs. ORL,W,33,8,17,0.471,0,3,0.0,3,5,0.6,3,10,13,3,0,0,1,3,19,18,1,Jusuf Nurkic,PHX,PHX,ORL,11.0,Rebounds,35,32,22,16
22023,203994,22300450,"DEC 31, 2023",PHX vs. ORL,W,33,8,17,0.471,0,3,0.0,3,5,0.6,3,10,13,3,0,0,1,3,19,18,1,Jusuf Nurkic,PHX,PHX,ORL,26.5,Pts+Rebs+Asts,35,32,22,16
22023,203994,22300450,"DEC 31, 2023",PHX vs. ORL,W,33,8,17,0.471,0,3,0.0,3,5,0.6,3,10,13,3,0,0,1,3,19,18,1,Jusuf Nurkic,PHX,PHX,ORL,32.5,Fantasy Score,35,32,22,16
22023,203994,22300450,"DEC 31, 2023",PHX vs. ORL,W,33,8,17,0.471,0,3,0.0,3,5,0.6,3,10,13,3,0,0,1,3,19,18,1,Jusuf Nurkic,PHX,PHX,ORL,8.0,Defensive Rebounds,35,32,22,16
22023,203994,22300450,"DEC 31, 2023",PHX vs. ORL,W,33,8,17,0.471,0,3,0.0,3,5,0.6,3,10,13,3,0,0,1,3,19,18,1,Jusuf Nurkic,PHX,PHX,ORL,23.5,Pts+Rebs,35,32,22,16
22023,203994,22300450,"DEC 31, 2023",PHX vs. ORL,W,33,8,17,0.471,0,3,0.0,3,5,0.6,3,10,13,3,0,0,1,3,19,18,1,Jusuf Nurkic,PHX,PHX,ORL,0.5,Dunks,35,32,22,16
22023,203994,22300450,"DEC 31, 2023",PHX vs. ORL,W,33,8,17,0.471,0,3,0.0,3,5,0.6,3,10,13,3,0,0,1,3,19,18,1,Jusuf Nurkic,PHX,PHX,ORL,15.5,Pts+Asts,35,32,22,16
22023,203994,22300450,"DEC 31, 2023",PHX vs. ORL,W,33,8,17,0.471,0,3,0.0,3,5,0.6,3,10,13,3,0,0,1,3,19,18,1,Jusuf Nurkic,PHX,PHX,ORL,13.5,Rebs+Asts,35,32,22,16
22023,203994,22300436,"DEC 29, 2023",PHX vs. CHA,W,28,10,13,0.769,0,1,0.0,4,4,1.0,3,12,15,1,0,2,3,1,24,9,1,Jusuf Nurkic,PHX,PHX,CHA,12.5,Points,40,39,25,16
22023,203994,22300436,"DEC 29, 2023",PHX vs. CHA,W,28,10,13,0.769,0,1,0.0,4,4,1.0,3,12,15,1,0,2,3,1,24,9,1,Jusuf Nurkic,PHX,PHX,CHA,11.0,Rebounds,40,39,25,16
22023,203994,22300436,"DEC 29, 2023",PHX vs. CHA,W,28,10,13,0.769,0,1,0.0,4,4,1.0,3,12,15,1,0,2,3,1,24,9,1,Jusuf Nurkic,PHX,PHX,CHA,26.5,Pts+Rebs+Asts,40,39,25,16
22023,203994,22300436,"DEC 29, 2023",PHX vs. CHA,W,28,10,13,0.769,0,1,0.0,4,4,1.0,3,12,15,1,0,2,3,1,24,9,1,Jusuf Nurkic,PHX,PHX,CHA,32.5,Fantasy Score,40,39,25,16
22023,203994,22300436,"DEC 29, 2023",PHX vs. CHA,W,28,10,13,0.769,0,1,0.0,4,4,1.0,3,12,15,1,0,2,3,1,24,9,1,Jusuf Nurkic,PHX,PHX,CHA,8.0,Defensive Rebounds,40,39,25,16
22023,203994,22300436,"DEC 29, 2023",PHX vs. CHA,W,28,10,13,0.769,0,1,0.0,4,4,1.0,3,12,15,1,0,2,3,1,24,9,1,Jusuf Nurkic,PHX,PHX,CHA,23.5,Pts+Rebs,40,39,25,16
22023,203994,22300436,"DEC 29, 2023",PHX vs. CHA,W,28,10,13,0.769,0,1,0.0,4,4,1.0,3,12,15,1,0,2,3,1,24,9,1,Jusuf Nurkic,PHX,PHX,CHA,0.5,Dunks,40,39,25,16
22023,203994,22300436,"DEC 29, 2023",PHX vs. CHA,W,28,10,13,0.769,0,1,0.0,4,4,1.0,3,12,15,1,0,2,3,1,24,9,1,Jusuf Nurkic,PHX,PHX,CHA,15.5,Pts+Asts,40,39,25,16
22023,203994,22300436,"DEC 29, 2023",PHX vs. CHA,W,28,10,13,0.769,0,1,0.0,4,4,1.0,3,12,15,1,0,2,3,1,24,9,1,Jusuf Nurkic,PHX,PHX,CHA,13.5,Rebs+Asts,40,39,25,16
22023,203994,22300418,"DEC 27, 2023",PHX @ HOU,W,14,3,6,0.5,1,1,1.0,1,2,0.5,1,9,10,0,0,2,3,4,8,2,1,Jusuf Nurkic,PHX,HOU,PHX,12.5,Points,18,18,8,10
22023,203994,22300418,"DEC 27, 2023",PHX @ HOU,W,14,3,6,0.5,1,1,1.0,1,2,0.5,1,9,10,0,0,2,3,4,8,2,1,Jusuf Nurkic,PHX,HOU,PHX,11.0,Rebounds,18,18,8,10
22023,203994,22300418,"DEC 27, 2023",PHX @ HOU,W,14,3,6,0.5,1,1,1.0,1,2,0.5,1,9,10,0,0,2,3,4,8,2,1,Jusuf Nurkic,PHX,HOU,PHX,26.5,Pts+Rebs+Asts,18,18,8,10
22023,203994,22300418,"DEC 27, 2023",PHX @ HOU,W,14,3,6,0.5,1,1,1.0,1,2,0.5,1,9,10,0,0,2,3,4,8,2,1,Jusuf Nurkic,PHX,HOU,PHX,32.5,Fantasy Score,18,18,8,10
22023,203994,22300418,"DEC 27, 2023",PHX @ HOU,W,14,3,6,0.5,1,1,1.0,1,2,0.5,1,9,10,0,0,2,3,4,8,2,1,Jusuf Nurkic,PHX,HOU,PHX,8.0,Defensive Rebounds,18,18,8,10
22023,203994,22300418,"DEC 27, 2023",PHX @ HOU,W,14,3,6,0.5,1,1,1.0,1,2,0.5,1,9,10,0,0,2,3,4,8,2,1,Jusuf Nurkic,PHX,HOU,PHX,23.5,Pts+Rebs,18,18,8,10
22023,203994,22300418,"DEC 27, 2023",PHX @ HOU,W,14,3,6,0.5,1,1,1.0,1,2,0.5,1,9,10,0,0,2,3,4,8,2,1,Jusuf Nurkic,PHX,HOU,PHX,0.5,Dunks,18,18,8,10
22023,203994,22300418,"DEC 27, 2023",PHX @ HOU,W,14,3,6,0.5,1,1,1.0,1,2,0.5,1,9,10,0,0,2,3,4,8,2,1,Jusuf Nurkic,PHX,HOU,PHX,15.5,Pts+Asts,18,18,8,10
22023,203994,22300418,"DEC 27, 2023",PHX @ HOU,W,14,3,6,0.5,1,1,1.0,1,2,0.5,1,9,10,0,0,2,3,4,8,2,1,Jusuf Nurkic,PHX,HOU,PHX,13.5,Rebs+Asts,18,18,8,10
22023,203994,22300363,"DEC 19, 2023",PHX @ POR,L,31,4,11,0.364,0,2,0.0,1,2,0.5,5,8,13,3,2,2,4,3,9,-5,1,Jusuf Nurkic,PHX,POR,PHX,12.5,Points,25,22,12,16
22023,203994,22300363,"DEC 19, 2023",PHX @ POR,L,31,4,11,0.364,0,2,0.0,1,2,0.5,5,8,13,3,2,2,4,3,9,-5,1,Jusuf Nurkic,PHX,POR,PHX,11.0,Rebounds,25,22,12,16
22023,203994,22300363,"DEC 19, 2023",PHX @ POR,L,31,4,11,0.364,0,2,0.0,1,2,0.5,5,8,13,3,2,2,4,3,9,-5,1,Jusuf Nurkic,PHX,POR,PHX,26.5,Pts+Rebs+Asts,25,22,12,16
22023,203994,22300363,"DEC 19, 2023",PHX @ POR,L,31,4,11,0.364,0,2,0.0,1,2,0.5,5,8,13,3,2,2,4,3,9,-5,1,Jusuf Nurkic,PHX,POR,PHX,32.5,Fantasy Score,25,22,12,16
22023,203994,22300363,"DEC 19, 2023",PHX @ POR,L,31,4,11,0.364,0,2,0.0,1,2,0.5,5,8,13,3,2,2,4,3,9,-5,1,Jusuf Nurkic,PHX,POR,PHX,8.0,Defensive Rebounds,25,22,12,16
22023,203994,22300363,"DEC 19, 2023",PHX @ POR,L,31,4,11,0.364,0,2,0.0,1,2,0.5,5,8,13,3,2,2,4,3,9,-5,1,Jusuf Nurkic,PHX,POR,PHX,23.5,Pts+Rebs,25,22,12,16
22023,203994,22300363,"DEC 19, 2023",PHX @ POR,L,31,4,11,0.364,0,2,0.0,1,2,0.5,5,8,13,3,2,2,4,3,9,-5,1,Jusuf Nurkic,PHX,POR,PHX,0.5,Dunks,25,22,12,16
22023,203994,22300363,"DEC 19, 2023",PHX @ POR,L,31,4,11,0.364,0,2,0.0,1,2,0.5,5,8,13,3,2,2,4,3,9,-5,1,Jusuf Nurkic,PHX,POR,PHX,15.5,Pts+Asts,25,22,12,16
22023,203994,22300363,"DEC 19, 2023",PHX @ POR,L,31,4,11,0.364,0,2,0.0,1,2,0.5,5,8,13,3,2,2,4,3,9,-5,1,Jusuf Nurkic,PHX,POR,PHX,13.5,Rebs+Asts,25,22,12,16
22023,203994,22300347,"DEC 17, 2023",PHX vs. WAS,W,30,2,7,0.286,0,1,0.0,2,4,0.5,3,14,17,5,1,1,2,5,6,-6,1,Jusuf Nurkic,PHX,PHX,WAS,12.5,Points,28,23,11,22
22023,203994,22300347,"DEC 17, 2023",PHX vs. WAS,W,30,2,7,0.286,0,1,0.0,2,4,0.5,3,14,17,5,1,1,2,5,6,-6,1,Jusuf Nurkic,PHX,PHX,WAS,11.0,Rebounds,28,23,11,22
22023,203994,22300347,"DEC 17, 2023",PHX vs. WAS,W,30,2,7,0.286,0,1,0.0,2,4,0.5,3,14,17,5,1,1,2,5,6,-6,1,Jusuf Nurkic,PHX,PHX,WAS,26.5,Pts+Rebs+Asts,28,23,11,22
22023,203994,22300347,"DEC 17, 2023",PHX vs. WAS,W,30,2,7,0.286,0,1,0.0,2,4,0.5,3,14,17,5,1,1,2,5,6,-6,1,Jusuf Nurkic,PHX,PHX,WAS,32.5,Fantasy Score,28,23,11,22
22023,203994,22300347,"DEC 17, 2023",PHX vs. WAS,W,30,2,7,0.286,0,1,0.0,2,4,0.5,3,14,17,5,1,1,2,5,6,-6,1,Jusuf Nurkic,PHX,PHX,WAS,8.0,Defensive Rebounds,28,23,11,22
22023,203994,22300347,"DEC 17, 2023",PHX vs. WAS,W,30,2,7,0.286,0,1,0.0,2,4,0.5,3,14,17,5,1,1,2,5,6,-6,1,Jusuf Nurkic,PHX,PHX,WAS,23.5,Pts+Rebs,28,23,11,22
22023,203994,22300347,"DEC 17, 2023",PHX vs. WAS,W,30,2,7,0.286,0,1,0.0,2,4,0.5,3,14,17,5,1,1,2,5,6,-6,1,Jusuf Nurkic,PHX,PHX,WAS,0.5,Dunks,28,23,11,22
22023,203994,22300347,"DEC 17, 2023",PHX vs. WAS,W,30,2,7,0.286,0,1,0.0,2,4,0.5,3,14,17,5,1,1,2,5,6,-6,1,Jusuf Nurkic,PHX,PHX,WAS,15.5,Pts+Asts,28,23,11,22
22023,203994,22300347,"DEC 17, 2023",PHX vs. WAS,W,30,2,7,0.286,0,1,0.0,2,4,0.5,3,14,17,5,1,1,2,5,6,-6,1,Jusuf Nurkic,PHX,PHX,WAS,13.5,Rebs+Asts,28,23,11,22
22023,203994,22300333,"DEC 15, 2023",PHX vs. NYK,L,30,9,13,0.692,1,2,0.5,2,2,1.0,4,8,12,2,1,0,3,2,21,5,1,Jusuf Nurkic,PHX,PHX,NYK,12.5,Points,35,33,23,14
22023,203994,22300333,"DEC 15, 2023",PHX vs. NYK,L,30,9,13,0.692,1,2,0.5,2,2,1.0,4,8,12,2,1,0,3,2,21,5,1,Jusuf Nurkic,PHX,PHX,NYK,11.0,Rebounds,35,33,23,14
22023,203994,22300333,"DEC 15, 2023",PHX vs. NYK,L,30,9,13,0.692,1,2,0.5,2,2,1.0,4,8,12,2,1,0,3,2,21,5,1,Jusuf Nurkic,PHX,PHX,NYK,26.5,Pts+Rebs+Asts,35,33,23,14
22023,203994,22300333,"DEC 15, 2023",PHX vs. NYK,L,30,9,13,0.692,1,2,0.5,2,2,1.0,4,8,12,2,1,0,3,2,21,5,1,Jusuf Nurkic,PHX,PHX,NYK,32.5,Fantasy Score,35,33,23,14
22023,203994,22300333,"DEC 15, 2023",PHX vs. NYK,L,30,9,13,0.692,1,2,0.5,2,2,1.0,4,8,12,2,1,0,3,2,21,5,1,Jusuf Nurkic,PHX,PHX,NYK,8.0,Defensive Rebounds,35,33,23,14
22023,203994,22300333,"DEC 15, 2023",PHX vs. NYK,L,30,9,13,0.692,1,2,0.5,2,2,1.0,4,8,12,2,1,0,3,2,21,5,1,Jusuf Nurkic,PHX,PHX,NYK,23.5,Pts+Rebs,35,33,23,14
22023,203994,22300333,"DEC 15, 2023",PHX vs. NYK,L,30,9,13,0.692,1,2,0.5,2,2,1.0,4,8,12,2,1,0,3,2,21,5,1,Jusuf Nurkic,PHX,PHX,NYK,0.5,Dunks,35,33,23,14
22023,203994,22300333,"DEC 15, 2023",PHX vs. NYK,L,30,9,13,0.692,1,2,0.5,2,2,1.0,4,8,12,2,1,0,3,2,21,5,1,Jusuf Nurkic,PHX,PHX,NYK,15.5,Pts+Asts,35,33,23,14
22023,203994,22300333,"DEC 15, 2023",PHX vs. NYK,L,30,9,13,0.692,1,2,0.5,2,2,1.0,4,8,12,2,1,0,3,2,21,5,1,Jusuf Nurkic,PHX,PHX,NYK,13.5,Rebs+Asts,35,33,23,14
22023,203994,22300317,"DEC 13, 2023",PHX vs. BKN,L,31,7,15,0.467,0,2,0.0,1,2,0.5,6,16,22,3,0,2,0,3,15,15,1,Jusuf Nurkic,PHX,PHX,BKN,12.5,Points,40,37,18,25
22023,203994,22300317,"DEC 13, 2023",PHX vs. BKN,L,31,7,15,0.467,0,2,0.0,1,2,0.5,6,16,22,3,0,2,0,3,15,15,1,Jusuf Nurkic,PHX,PHX,BKN,11.0,Rebounds,40,37,18,25
22023,203994,22300317,"DEC 13, 2023",PHX vs. BKN,L,31,7,15,0.467,0,2,0.0,1,2,0.5,6,16,22,3,0,2,0,3,15,15,1,Jusuf Nurkic,PHX,PHX,BKN,26.5,Pts+Rebs+Asts,40,37,18,25
22023,203994,22300317,"DEC 13, 2023",PHX vs. BKN,L,31,7,15,0.467,0,2,0.0,1,2,0.5,6,16,22,3,0,2,0,3,15,15,1,Jusuf Nurkic,PHX,PHX,BKN,32.5,Fantasy Score,40,37,18,25
22023,203994,22300317,"DEC 13, 2023",PHX vs. BKN,L,31,7,15,0.467,0,2,0.0,1,2,0.5,6,16,22,3,0,2,0,3,15,15,1,Jusuf Nurkic,PHX,PHX,BKN,8.0,Defensive Rebounds,40,37,18,25
22023,203994,22300317,"DEC 13, 2023",PHX vs. BKN,L,31,7,15,0.467,0,2,0.0,1,2,0.5,6,16,22,3,0,2,0,3,15,15,1,Jusuf Nurkic,PHX,PHX,BKN,23.5,Pts+Rebs,40,37,18,25
22023,203994,22300317,"DEC 13, 2023",PHX vs. BKN,L,31,7,15,0.467,0,2,0.0,1,2,0.5,6,16,22,3,0,2,0,3,15,15,1,Jusuf Nurkic,PHX,PHX,BKN,0.5,Dunks,40,37,18,25
22023,203994,22300317,"DEC 13, 2023",PHX vs. BKN,L,31,7,15,0.467,0,2,0.0,1,2,0.5,6,16,22,3,0,2,0,3,15,15,1,Jusuf Nurkic,PHX,PHX,BKN,15.5,Pts+Asts,40,37,18,25
22023,203994,22300317,"DEC 13, 2023",PHX vs. BKN,L,31,7,15,0.467,0,2,0.0,1,2,0.5,6,16,22,3,0,2,0,3,15,15,1,Jusuf Nurkic,PHX,PHX,BKN,13.5,Rebs+Asts,40,37,18,25
22023,203994,22300308,"DEC 12, 2023",PHX vs. GSW,W,31,3,9,0.333,1,3,0.333,10,11,0.909,3,10,13,7,1,0,1,3,17,10,1,Jusuf Nurkic,PHX,PHX,GSW,12.5,Points,37,30,24,20
22023,203994,22300308,"DEC 12, 2023",PHX vs. GSW,W,31,3,9,0.333,1,3,0.333,10,11,0.909,3,10,13,7,1,0,1,3,17,10,1,Jusuf Nurkic,PHX,PHX,GSW,11.0,Rebounds,37,30,24,20
22023,203994,22300308,"DEC 12, 2023",PHX vs. GSW,W,31,3,9,0.333,1,3,0.333,10,11,0.909,3,10,13,7,1,0,1,3,17,10,1,Jusuf Nurkic,PHX,PHX,GSW,26.5,Pts+Rebs+Asts,37,30,24,20
22023,203994,22300308,"DEC 12, 2023",PHX vs. GSW,W,31,3,9,0.333,1,3,0.333,10,11,0.909,3,10,13,7,1,0,1,3,17,10,1,Jusuf Nurkic,PHX,PHX,GSW,32.5,Fantasy Score,37,30,24,20
22023,203994,22300308,"DEC 12, 2023",PHX vs. GSW,W,31,3,9,0.333,1,3,0.333,10,11,0.909,3,10,13,7,1,0,1,3,17,10,1,Jusuf Nurkic,PHX,PHX,GSW,8.0,Defensive Rebounds,37,30,24,20
22023,203994,22300308,"DEC 12, 2023",PHX vs. GSW,W,31,3,9,0.333,1,3,0.333,10,11,0.909,3,10,13,7,1,0,1,3,17,10,1,Jusuf Nurkic,PHX,PHX,GSW,23.5,Pts+Rebs,37,30,24,20
22023,203994,22300308,"DEC 12, 2023",PHX vs. GSW,W,31,3,9,0.333,1,3,0.333,10,11,0.909,3,10,13,7,1,0,1,3,17,10,1,Jusuf Nurkic,PHX,PHX,GSW,0.5,Dunks,37,30,24,20
22023,203994,22300308,"DEC 12, 2023",PHX vs. GSW,W,31,3,9,0.333,1,3,0.333,10,11,0.909,3,10,13,7,1,0,1,3,17,10,1,Jusuf Nurkic,PHX,PHX,GSW,15.5,Pts+Asts,37,30,24,20
22023,203994,22300308,"DEC 12, 2023",PHX vs. GSW,W,31,3,9,0.333,1,3,0.333,10,11,0.909,3,10,13,7,1,0,1,3,17,10,1,Jusuf Nurkic,PHX,PHX,GSW,13.5,Rebs+Asts,37,30,24,20
22023,203994,22301228,"DEC 08, 2023",PHX vs. SAC,L,30,6,13,0.462,2,4,0.5,1,4,0.25,1,8,9,3,1,0,0,3,15,2,1,Jusuf Nurkic,PHX,PHX,SAC,12.5,Points,27,24,18,12
22023,203994,22301228,"DEC 08, 2023",PHX vs. SAC,L,30,6,13,0.462,2,4,0.5,1,4,0.25,1,8,9,3,1,0,0,3,15,2,1,Jusuf Nurkic,PHX,PHX,SAC,11.0,Rebounds,27,24,18,12
22023,203994,22301228,"DEC 08, 2023",PHX vs. SAC,L,30,6,13,0.462,2,4,0.5,1,4,0.25,1,8,9,3,1,0,0,3,15,2,1,Jusuf Nurkic,PHX,PHX,SAC,26.5,Pts+Rebs+Asts,27,24,18,12
22023,203994,22301228,"DEC 08, 2023",PHX vs. SAC,L,30,6,13,0.462,2,4,0.5,1,4,0.25,1,8,9,3,1,0,0,3,15,2,1,Jusuf Nurkic,PHX,PHX,SAC,32.5,Fantasy Score,27,24,18,12
22023,203994,22301228,"DEC 08, 2023",PHX vs. SAC,L,30,6,13,0.462,2,4,0.5,1,4,0.25,1,8,9,3,1,0,0,3,15,2,1,Jusuf Nurkic,PHX,PHX,SAC,8.0,Defensive Rebounds,27,24,18,12
22023,203994,22301228,"DEC 08, 2023",PHX vs. SAC,L,30,6,13,0.462,2,4,0.5,1,4,0.25,1,8,9,3,1,0,0,3,15,2,1,Jusuf Nurkic,PHX,PHX,SAC,23.5,Pts+Rebs,27,24,18,12
22023,203994,22301228,"DEC 08, 2023",PHX vs. SAC,L,30,6,13,0.462,2,4,0.5,1,4,0.25,1,8,9,3,1,0,0,3,15,2,1,Jusuf Nurkic,PHX,PHX,SAC,0.5,Dunks,27,24,18,12
22023,203994,22301228,"DEC 08, 2023",PHX vs. SAC,L,30,6,13,0.462,2,4,0.5,1,4,0.25,1,8,9,3,1,0,0,3,15,2,1,Jusuf Nurkic,PHX,PHX,SAC,15.5,Pts+Asts,27,24,18,12
22023,203994,22301228,"DEC 08, 2023",PHX vs. SAC,L,30,6,13,0.462,2,4,0.5,1,4,0.25,1,8,9,3,1,0,0,3,15,2,1,Jusuf Nurkic,PHX,PHX,SAC,13.5,Rebs+Asts,27,24,18,12
22023,203994,22301203,"DEC 05, 2023",PHX @ LAL,L,29,1,3,0.333,0,0,0.0,1,4,0.25,0,8,8,4,1,0,2,4,3,12,1,Jusuf Nurkic,PHX,LAL,PHX,12.5,Points,15,11,7,12
22023,203994,22301203,"DEC 05, 2023",PHX @ LAL,L,29,1,3,0.333,0,0,0.0,1,4,0.25,0,8,8,4,1,0,2,4,3,12,1,Jusuf Nurkic,PHX,LAL,PHX,11.0,Rebounds,15,11,7,12
22023,203994,22301203,"DEC 05, 2023",PHX @ LAL,L,29,1,3,0.333,0,0,0.0,1,4,0.25,0,8,8,4,1,0,2,4,3,12,1,Jusuf Nurkic,PHX,LAL,PHX,26.5,Pts+Rebs+Asts,15,11,7,12
22023,203994,22301203,"DEC 05, 2023",PHX @ LAL,L,29,1,3,0.333,0,0,0.0,1,4,0.25,0,8,8,4,1,0,2,4,3,12,1,Jusuf Nurkic,PHX,LAL,PHX,32.5,Fantasy Score,15,11,7,12
22023,203994,22301203,"DEC 05, 2023",PHX @ LAL,L,29,1,3,0.333,0,0,0.0,1,4,0.25,0,8,8,4,1,0,2,4,3,12,1,Jusuf Nurkic,PHX,LAL,PHX,8.0,Defensive Rebounds,15,11,7,12
22023,203994,22301203,"DEC 05, 2023",PHX @ LAL,L,29,1,3,0.333,0,0,0.0,1,4,0.25,0,8,8,4,1,0,2,4,3,12,1,Jusuf Nurkic,PHX,LAL,PHX,23.5,Pts+Rebs,15,11,7,12
22023,203994,22301203,"DEC 05, 2023",PHX @ LAL,L,29,1,3,0.333,0,0,0.0,1,4,0.25,0,8,8,4,1,0,2,4,3,12,1,Jusuf Nurkic,PHX,LAL,PHX,0.5,Dunks,15,11,7,12
22023,203994,22301203,"DEC 05, 2023",PHX @ LAL,L,29,1,3,0.333,0,0,0.0,1,4,0.25,0,8,8,4,1,0,2,4,3,12,1,Jusuf Nurkic,PHX,LAL,PHX,15.5,Pts+Asts,15,11,7,12
22023,203994,22301203,"DEC 05, 2023",PHX @ LAL,L,29,1,3,0.333,0,0,0.0,1,4,0.25,0,8,8,4,1,0,2,4,3,12,1,Jusuf Nurkic,PHX,LAL,PHX,13.5,Rebs+Asts,15,11,7,12
22023,203994,22300288,"DEC 02, 2023",PHX vs. MEM,W,26,6,18,0.333,0,3,0.0,2,2,1.0,3,6,9,3,2,1,3,6,14,10,1,Jusuf Nurkic,PHX,PHX,MEM,12.5,Points,26,23,17,12
22023,203994,22300288,"DEC 02, 2023",PHX vs. MEM,W,26,6,18,0.333,0,3,0.0,2,2,1.0,3,6,9,3,2,1,3,6,14,10,1,Jusuf Nurkic,PHX,PHX,MEM,11.0,Rebounds,26,23,17,12
22023,203994,22300288,"DEC 02, 2023",PHX vs. MEM,W,26,6,18,0.333,0,3,0.0,2,2,1.0,3,6,9,3,2,1,3,6,14,10,1,Jusuf Nurkic,PHX,PHX,MEM,26.5,Pts+Rebs+Asts,26,23,17,12
22023,203994,22300288,"DEC 02, 2023",PHX vs. MEM,W,26,6,18,0.333,0,3,0.0,2,2,1.0,3,6,9,3,2,1,3,6,14,10,1,Jusuf Nurkic,PHX,PHX,MEM,32.5,Fantasy Score,26,23,17,12
22023,203994,22300288,"DEC 02, 2023",PHX vs. MEM,W,26,6,18,0.333,0,3,0.0,2,2,1.0,3,6,9,3,2,1,3,6,14,10,1,Jusuf Nurkic,PHX,PHX,MEM,8.0,Defensive Rebounds,26,23,17,12
22023,203994,22300288,"DEC 02, 2023",PHX vs. MEM,W,26,6,18,0.333,0,3,0.0,2,2,1.0,3,6,9,3,2,1,3,6,14,10,1,Jusuf Nurkic,PHX,PHX,MEM,23.5,Pts+Rebs,26,23,17,12
22023,203994,22300288,"DEC 02, 2023",PHX vs. MEM,W,26,6,18,0.333,0,3,0.0,2,2,1.0,3,6,9,3,2,1,3,6,14,10,1,Jusuf Nurkic,PHX,PHX,MEM,0.5,Dunks,26,23,17,12
22023,203994,22300288,"DEC 02, 2023",PHX vs. MEM,W,26,6,18,0.333,0,3,0.0,2,2,1.0,3,6,9,3,2,1,3,6,14,10,1,Jusuf Nurkic,PHX,PHX,MEM,15.5,Pts+Asts,26,23,17,12
22023,203994,22300288,"DEC 02, 2023",PHX vs. MEM,W,26,6,18,0.333,0,3,0.0,2,2,1.0,3,6,9,3,2,1,3,6,14,10,1,Jusuf Nurkic,PHX,PHX,MEM,13.5,Rebs+Asts,26,23,17,12
22023,203994,22300279,"DEC 01, 2023",PHX vs. DEN,L,33,13,22,0.591,2,6,0.333,3,5,0.6,3,3,6,2,0,2,6,6,31,3,1,Jusuf Nurkic,PHX,PHX,DEN,12.5,Points,39,37,33,8
22023,203994,22300279,"DEC 01, 2023",PHX vs. DEN,L,33,13,22,0.591,2,6,0.333,3,5,0.6,3,3,6,2,0,2,6,6,31,3,1,Jusuf Nurkic,PHX,PHX,DEN,11.0,Rebounds,39,37,33,8
22023,203994,22300279,"DEC 01, 2023",PHX vs. DEN,L,33,13,22,0.591,2,6,0.333,3,5,0.6,3,3,6,2,0,2,6,6,31,3,1,Jusuf Nurkic,PHX,PHX,DEN,26.5,Pts+Rebs+Asts,39,37,33,8
22023,203994,22300279,"DEC 01, 2023",PHX vs. DEN,L,33,13,22,0.591,2,6,0.333,3,5,0.6,3,3,6,2,0,2,6,6,31,3,1,Jusuf Nurkic,PHX,PHX,DEN,32.5,Fantasy Score,39,37,33,8
22023,203994,22300279,"DEC 01, 2023",PHX vs. DEN,L,33,13,22,0.591,2,6,0.333,3,5,0.6,3,3,6,2,0,2,6,6,31,3,1,Jusuf Nurkic,PHX,PHX,DEN,8.0,Defensive Rebounds,39,37,33,8
22023,203994,22300279,"DEC 01, 2023",PHX vs. DEN,L,33,13,22,0.591,2,6,0.333,3,5,0.6,3,3,6,2,0,2,6,6,31,3,1,Jusuf Nurkic,PHX,PHX,DEN,23.5,Pts+Rebs,39,37,33,8
22023,203994,22300279,"DEC 01, 2023",PHX vs. DEN,L,33,13,22,0.591,2,6,0.333,3,5,0.6,3,3,6,2,0,2,6,6,31,3,1,Jusuf Nurkic,PHX,PHX,DEN,0.5,Dunks,39,37,33,8
22023,203994,22300279,"DEC 01, 2023",PHX vs. DEN,L,33,13,22,0.591,2,6,0.333,3,5,0.6,3,3,6,2,0,2,6,6,31,3,1,Jusuf Nurkic,PHX,PHX,DEN,15.5,Pts+Asts,39,37,33,8
22023,203994,22300279,"DEC 01, 2023",PHX vs. DEN,L,33,13,22,0.591,2,6,0.333,3,5,0.6,3,3,6,2,0,2,6,6,31,3,1,Jusuf Nurkic,PHX,PHX,DEN,13.5,Rebs+Asts,39,37,33,8
22023,203994,22300260,"NOV 29, 2023",PHX @ TOR,L,30,8,12,0.667,1,1,1.0,2,2,1.0,1,13,14,6,0,2,2,3,19,2,1,Jusuf Nurkic,PHX,TOR,PHX,12.5,Points,39,33,25,20
22023,203994,22300260,"NOV 29, 2023",PHX @ TOR,L,30,8,12,0.667,1,1,1.0,2,2,1.0,1,13,14,6,0,2,2,3,19,2,1,Jusuf Nurkic,PHX,TOR,PHX,11.0,Rebounds,39,33,25,20
22023,203994,22300260,"NOV 29, 2023",PHX @ TOR,L,30,8,12,0.667,1,1,1.0,2,2,1.0,1,13,14,6,0,2,2,3,19,2,1,Jusuf Nurkic,PHX,TOR,PHX,26.5,Pts+Rebs+Asts,39,33,25,20
22023,203994,22300260,"NOV 29, 2023",PHX @ TOR,L,30,8,12,0.667,1,1,1.0,2,2,1.0,1,13,14,6,0,2,2,3,19,2,1,Jusuf Nurkic,PHX,TOR,PHX,32.5,Fantasy Score,39,33,25,20
22023,203994,22300260,"NOV 29, 2023",PHX @ TOR,L,30,8,12,0.667,1,1,1.0,2,2,1.0,1,13,14,6,0,2,2,3,19,2,1,Jusuf Nurkic,PHX,TOR,PHX,8.0,Defensive Rebounds,39,33,25,20
22023,203994,22300260,"NOV 29, 2023",PHX @ TOR,L,30,8,12,0.667,1,1,1.0,2,2,1.0,1,13,14,6,0,2,2,3,19,2,1,Jusuf Nurkic,PHX,TOR,PHX,23.5,Pts+Rebs,39,33,25,20
22023,203994,22300260,"NOV 29, 2023",PHX @ TOR,L,30,8,12,0.667,1,1,1.0,2,2,1.0,1,13,14,6,0,2,2,3,19,2,1,Jusuf Nurkic,PHX,TOR,PHX,0.5,Dunks,39,33,25,20
22023,203994,22300260,"NOV 29, 2023",PHX @ TOR,L,30,8,12,0.667,1,1,1.0,2,2,1.0,1,13,14,6,0,2,2,3,19,2,1,Jusuf Nurkic,PHX,TOR,PHX,15.5,Pts+Asts,39,33,25,20
22023,203994,22300260,"NOV 29, 2023",PHX @ TOR,L,30,8,12,0.667,1,1,1.0,2,2,1.0,1,13,14,6,0,2,2,3,19,2,1,Jusuf Nurkic,PHX,TOR,PHX,13.5,Rebs+Asts,39,33,25,20
22023,203994,22300247,"NOV 26, 2023",PHX @ NYK,W,33,4,9,0.444,0,2,0.0,0,0,0.0,4,6,10,4,0,4,1,2,8,1,1,Jusuf Nurkic,PHX,NYK,PHX,12.5,Points,22,18,12,14
22023,203994,22300247,"NOV 26, 2023",PHX @ NYK,W,33,4,9,0.444,0,2,0.0,0,0,0.0,4,6,10,4,0,4,1,2,8,1,1,Jusuf Nurkic,PHX,NYK,PHX,11.0,Rebounds,22,18,12,14
22023,203994,22300247,"NOV 26, 2023",PHX @ NYK,W,33,4,9,0.444,0,2,0.0,0,0,0.0,4,6,10,4,0,4,1,2,8,1,1,Jusuf Nurkic,PHX,NYK,PHX,26.5,Pts+Rebs+Asts,22,18,12,14
22023,203994,22300247,"NOV 26, 2023",PHX @ NYK,W,33,4,9,0.444,0,2,0.0,0,0,0.0,4,6,10,4,0,4,1,2,8,1,1,Jusuf Nurkic,PHX,NYK,PHX,32.5,Fantasy Score,22,18,12,14
22023,203994,22300247,"NOV 26, 2023",PHX @ NYK,W,33,4,9,0.444,0,2,0.0,0,0,0.0,4,6,10,4,0,4,1,2,8,1,1,Jusuf Nurkic,PHX,NYK,PHX,8.0,Defensive Rebounds,22,18,12,14
22023,203994,22300247,"NOV 26, 2023",PHX @ NYK,W,33,4,9,0.444,0,2,0.0,0,0,0.0,4,6,10,4,0,4,1,2,8,1,1,Jusuf Nurkic,PHX,NYK,PHX,23.5,Pts+Rebs,22,18,12,14
22023,203994,22300247,"NOV 26, 2023",PHX @ NYK,W,33,4,9,0.444,0,2,0.0,0,0,0.0,4,6,10,4,0,4,1,2,8,1,1,Jusuf Nurkic,PHX,NYK,PHX,0.5,Dunks,22,18,12,14
22023,203994,22300247,"NOV 26, 2023",PHX @ NYK,W,33,4,9,0.444,0,2,0.0,0,0,0.0,4,6,10,4,0,4,1,2,8,1,1,Jusuf Nurkic,PHX,NYK,PHX,15.5,Pts+Asts,22,18,12,14
22023,203994,22300247,"NOV 26, 2023",PHX @ NYK,W,33,4,9,0.444,0,2,0.0,0,0,0.0,4,6,10,4,0,4,1,2,8,1,1,Jusuf Nurkic,PHX,NYK,PHX,13.5,Rebs+Asts,22,18,12,14
22023,203994,22300044,"NOV 24, 2023",PHX @ MEM,W,33,2,5,0.4,0,2,0.0,2,4,0.5,2,9,11,6,2,2,2,2,6,14,1,Jusuf Nurkic,PHX,MEM,PHX,12.5,Points,23,17,12,17
22023,203994,22300044,"NOV 24, 2023",PHX @ MEM,W,33,2,5,0.4,0,2,0.0,2,4,0.5,2,9,11,6,2,2,2,2,6,14,1,Jusuf Nurkic,PHX,MEM,PHX,11.0,Rebounds,23,17,12,17
22023,203994,22300044,"NOV 24, 2023",PHX @ MEM,W,33,2,5,0.4,0,2,0.0,2,4,0.5,2,9,11,6,2,2,2,2,6,14,1,Jusuf Nurkic,PHX,MEM,PHX,26.5,Pts+Rebs+Asts,23,17,12,17
22023,203994,22300044,"NOV 24, 2023",PHX @ MEM,W,33,2,5,0.4,0,2,0.0,2,4,0.5,2,9,11,6,2,2,2,2,6,14,1,Jusuf Nurkic,PHX,MEM,PHX,32.5,Fantasy Score,23,17,12,17
22023,203994,22300044,"NOV 24, 2023",PHX @ MEM,W,33,2,5,0.4,0,2,0.0,2,4,0.5,2,9,11,6,2,2,2,2,6,14,1,Jusuf Nurkic,PHX,MEM,PHX,8.0,Defensive Rebounds,23,17,12,17
22023,203994,22300044,"NOV 24, 2023",PHX @ MEM,W,33,2,5,0.4,0,2,0.0,2,4,0.5,2,9,11,6,2,2,2,2,6,14,1,Jusuf Nurkic,PHX,MEM,PHX,23.5,Pts+Rebs,23,17,12,17
22023,203994,22300044,"NOV 24, 2023",PHX @ MEM,W,33,2,5,0.4,0,2,0.0,2,4,0.5,2,9,11,6,2,2,2,2,6,14,1,Jusuf Nurkic,PHX,MEM,PHX,0.5,Dunks,23,17,12,17
22023,203994,22300044,"NOV 24, 2023",PHX @ MEM,W,33,2,5,0.4,0,2,0.0,2,4,0.5,2,9,11,6,2,2,2,2,6,14,1,Jusuf Nurkic,PHX,MEM,PHX,15.5,Pts+Asts,23,17,12,17
22023,203994,22300044,"NOV 24, 2023",PHX @ MEM,W,33,2,5,0.4,0,2,0.0,2,4,0.5,2,9,11,6,2,2,2,2,6,14,1,Jusuf Nurkic,PHX,MEM,PHX,13.5,Rebs+Asts,23,17,12,17
22023,203994,22300236,"NOV 22, 2023",PHX vs. GSW,W,17,4,8,0.5,0,1,0.0,1,2,0.5,3,2,5,0,0,0,0,4,9,11,1,Jusuf Nurkic,PHX,PHX,GSW,12.5,Points,14,14,9,5
22023,203994,22300236,"NOV 22, 2023",PHX vs. GSW,W,17,4,8,0.5,0,1,0.0,1,2,0.5,3,2,5,0,0,0,0,4,9,11,1,Jusuf Nurkic,PHX,PHX,GSW,11.0,Rebounds,14,14,9,5
22023,203994,22300236,"NOV 22, 2023",PHX vs. GSW,W,17,4,8,0.5,0,1,0.0,1,2,0.5,3,2,5,0,0,0,0,4,9,11,1,Jusuf Nurkic,PHX,PHX,GSW,26.5,Pts+Rebs+Asts,14,14,9,5
22023,203994,22300236,"NOV 22, 2023",PHX vs. GSW,W,17,4,8,0.5,0,1,0.0,1,2,0.5,3,2,5,0,0,0,0,4,9,11,1,Jusuf Nurkic,PHX,PHX,GSW,32.5,Fantasy Score,14,14,9,5
22023,203994,22300236,"NOV 22, 2023",PHX vs. GSW,W,17,4,8,0.5,0,1,0.0,1,2,0.5,3,2,5,0,0,0,0,4,9,11,1,Jusuf Nurkic,PHX,PHX,GSW,8.0,Defensive Rebounds,14,14,9,5
22023,203994,22300236,"NOV 22, 2023",PHX vs. GSW,W,17,4,8,0.5,0,1,0.0,1,2,0.5,3,2,5,0,0,0,0,4,9,11,1,Jusuf Nurkic,PHX,PHX,GSW,23.5,Pts+Rebs,14,14,9,5
22023,203994,22300236,"NOV 22, 2023",PHX vs. GSW,W,17,4,8,0.5,0,1,0.0,1,2,0.5,3,2,5,0,0,0,0,4,9,11,1,Jusuf Nurkic,PHX,PHX,GSW,0.5,Dunks,14,14,9,5
22023,203994,22300236,"NOV 22, 2023",PHX vs. GSW,W,17,4,8,0.5,0,1,0.0,1,2,0.5,3,2,5,0,0,0,0,4,9,11,1,Jusuf Nurkic,PHX,PHX,GSW,15.5,Pts+Asts,14,14,9,5
22023,203994,22300236,"NOV 22, 2023",PHX vs. GSW,W,17,4,8,0.5,0,1,0.0,1,2,0.5,3,2,5,0,0,0,0,4,9,11,1,Jusuf Nurkic,PHX,PHX,GSW,13.5,Rebs+Asts,14,14,9,5
22023,203994,22300041,"NOV 21, 2023",PHX vs. POR,W,29,7,11,0.636,2,4,0.5,2,2,1.0,6,6,12,0,1,4,3,4,18,17,1,Jusuf Nurkic,PHX,PHX,POR,12.5,Points,30,30,18,12
22023,203994,22300041,"NOV 21, 2023",PHX vs. POR,W,29,7,11,0.636,2,4,0.5,2,2,1.0,6,6,12,0,1,4,3,4,18,17,1,Jusuf Nurkic,PHX,PHX,POR,11.0,Rebounds,30,30,18,12
22023,203994,22300041,"NOV 21, 2023",PHX vs. POR,W,29,7,11,0.636,2,4,0.5,2,2,1.0,6,6,12,0,1,4,3,4,18,17,1,Jusuf Nurkic,PHX,PHX,POR,26.5,Pts+Rebs+Asts,30,30,18,12
22023,203994,22300041,"NOV 21, 2023",PHX vs. POR,W,29,7,11,0.636,2,4,0.5,2,2,1.0,6,6,12,0,1,4,3,4,18,17,1,Jusuf Nurkic,PHX,PHX,POR,32.5,Fantasy Score,30,30,18,12
22023,203994,22300041,"NOV 21, 2023",PHX vs. POR,W,29,7,11,0.636,2,4,0.5,2,2,1.0,6,6,12,0,1,4,3,4,18,17,1,Jusuf Nurkic,PHX,PHX,POR,8.0,Defensive Rebounds,30,30,18,12
22023,203994,22300041,"NOV 21, 2023",PHX vs. POR,W,29,7,11,0.636,2,4,0.5,2,2,1.0,6,6,12,0,1,4,3,4,18,17,1,Jusuf Nurkic,PHX,PHX,POR,23.5,Pts+Rebs,30,30,18,12
22023,203994,22300041,"NOV 21, 2023",PHX vs. POR,W,29,7,11,0.636,2,4,0.5,2,2,1.0,6,6,12,0,1,4,3,4,18,17,1,Jusuf Nurkic,PHX,PHX,POR,0.5,Dunks,30,30,18,12
22023,203994,22300041,"NOV 21, 2023",PHX vs. POR,W,29,7,11,0.636,2,4,0.5,2,2,1.0,6,6,12,0,1,4,3,4,18,17,1,Jusuf Nurkic,PHX,PHX,POR,15.5,Pts+Asts,30,30,18,12
22023,203994,22300041,"NOV 21, 2023",PHX vs. POR,W,29,7,11,0.636,2,4,0.5,2,2,1.0,6,6,12,0,1,4,3,4,18,17,1,Jusuf Nurkic,PHX,PHX,POR,13.5,Rebs+Asts,30,30,18,12
22023,203994,22300214,"NOV 19, 2023",PHX @ UTA,W,35,7,11,0.636,0,0,0.0,4,4,1.0,4,8,12,2,1,2,2,5,18,9,1,Jusuf Nurkic,PHX,UTA,PHX,12.5,Points,32,30,20,14
22023,203994,22300214,"NOV 19, 2023",PHX @ UTA,W,35,7,11,0.636,0,0,0.0,4,4,1.0,4,8,12,2,1,2,2,5,18,9,1,Jusuf Nurkic,PHX,UTA,PHX,11.0,Rebounds,32,30,20,14
22023,203994,22300214,"NOV 19, 2023",PHX @ UTA,W,35,7,11,0.636,0,0,0.0,4,4,1.0,4,8,12,2,1,2,2,5,18,9,1,Jusuf Nurkic,PHX,UTA,PHX,26.5,Pts+Rebs+Asts,32,30,20,14
22023,203994,22300214,"NOV 19, 2023",PHX @ UTA,W,35,7,11,0.636,0,0,0.0,4,4,1.0,4,8,12,2,1,2,2,5,18,9,1,Jusuf Nurkic,PHX,UTA,PHX,32.5,Fantasy Score,32,30,20,14
22023,203994,22300214,"NOV 19, 2023",PHX @ UTA,W,35,7,11,0.636,0,0,0.0,4,4,1.0,4,8,12,2,1,2,2,5,18,9,1,Jusuf Nurkic,PHX,UTA,PHX,8.0,Defensive Rebounds,32,30,20,14
22023,203994,22300214,"NOV 19, 2023",PHX @ UTA,W,35,7,11,0.636,0,0,0.0,4,4,1.0,4,8,12,2,1,2,2,5,18,9,1,Jusuf Nurkic,PHX,UTA,PHX,23.5,Pts+Rebs,32,30,20,14
22023,203994,22300214,"NOV 19, 2023",PHX @ UTA,W,35,7,11,0.636,0,0,0.0,4,4,1.0,4,8,12,2,1,2,2,5,18,9,1,Jusuf Nurkic,PHX,UTA,PHX,0.5,Dunks,32,30,20,14
22023,203994,22300214,"NOV 19, 2023",PHX @ UTA,W,35,7,11,0.636,0,0,0.0,4,4,1.0,4,8,12,2,1,2,2,5,18,9,1,Jusuf Nurkic,PHX,UTA,PHX,15.5,Pts+Asts,32,30,20,14
22023,203994,22300214,"NOV 19, 2023",PHX @ UTA,W,35,7,11,0.636,0,0,0.0,4,4,1.0,4,8,12,2,1,2,2,5,18,9,1,Jusuf Nurkic,PHX,UTA,PHX,13.5,Rebs+Asts,32,30,20,14
22023,203994,22300035,"NOV 17, 2023",PHX @ UTA,W,23,4,7,0.571,0,1,0.0,7,7,1.0,2,5,7,4,1,0,4,4,15,-2,1,Jusuf Nurkic,PHX,UTA,PHX,12.5,Points,26,22,19,11
22023,203994,22300035,"NOV 17, 2023",PHX @ UTA,W,23,4,7,0.571,0,1,0.0,7,7,1.0,2,5,7,4,1,0,4,4,15,-2,1,Jusuf Nurkic,PHX,UTA,PHX,11.0,Rebounds,26,22,19,11
22023,203994,22300035,"NOV 17, 2023",PHX @ UTA,W,23,4,7,0.571,0,1,0.0,7,7,1.0,2,5,7,4,1,0,4,4,15,-2,1,Jusuf Nurkic,PHX,UTA,PHX,26.5,Pts+Rebs+Asts,26,22,19,11
22023,203994,22300035,"NOV 17, 2023",PHX @ UTA,W,23,4,7,0.571,0,1,0.0,7,7,1.0,2,5,7,4,1,0,4,4,15,-2,1,Jusuf Nurkic,PHX,UTA,PHX,32.5,Fantasy Score,26,22,19,11
22023,203994,22300035,"NOV 17, 2023",PHX @ UTA,W,23,4,7,0.571,0,1,0.0,7,7,1.0,2,5,7,4,1,0,4,4,15,-2,1,Jusuf Nurkic,PHX,UTA,PHX,8.0,Defensive Rebounds,26,22,19,11
22023,203994,22300035,"NOV 17, 2023",PHX @ UTA,W,23,4,7,0.571,0,1,0.0,7,7,1.0,2,5,7,4,1,0,4,4,15,-2,1,Jusuf Nurkic,PHX,UTA,PHX,23.5,Pts+Rebs,26,22,19,11
22023,203994,22300035,"NOV 17, 2023",PHX @ UTA,W,23,4,7,0.571,0,1,0.0,7,7,1.0,2,5,7,4,1,0,4,4,15,-2,1,Jusuf Nurkic,PHX,UTA,PHX,0.5,Dunks,26,22,19,11
22023,203994,22300035,"NOV 17, 2023",PHX @ UTA,W,23,4,7,0.571,0,1,0.0,7,7,1.0,2,5,7,4,1,0,4,4,15,-2,1,Jusuf Nurkic,PHX,UTA,PHX,15.5,Pts+Asts,26,22,19,11
22023,203994,22300035,"NOV 17, 2023",PHX @ UTA,W,23,4,7,0.571,0,1,0.0,7,7,1.0,2,5,7,4,1,0,4,4,15,-2,1,Jusuf Nurkic,PHX,UTA,PHX,13.5,Rebs+Asts,26,22,19,11
22023,203994,22300197,"NOV 15, 2023",PHX vs. MIN,W,24,1,3,0.333,1,1,1.0,0,0,0.0,1,4,5,4,0,0,0,3,3,10,1,Jusuf Nurkic,PHX,PHX,MIN,12.5,Points,12,8,7,9
22023,203994,22300197,"NOV 15, 2023",PHX vs. MIN,W,24,1,3,0.333,1,1,1.0,0,0,0.0,1,4,5,4,0,0,0,3,3,10,1,Jusuf Nurkic,PHX,PHX,MIN,11.0,Rebounds,12,8,7,9
22023,203994,22300197,"NOV 15, 2023",PHX vs. MIN,W,24,1,3,0.333,1,1,1.0,0,0,0.0,1,4,5,4,0,0,0,3,3,10,1,Jusuf Nurkic,PHX,PHX,MIN,26.5,Pts+Rebs+Asts,12,8,7,9
22023,203994,22300197,"NOV 15, 2023",PHX vs. MIN,W,24,1,3,0.333,1,1,1.0,0,0,0.0,1,4,5,4,0,0,0,3,3,10,1,Jusuf Nurkic,PHX,PHX,MIN,32.5,Fantasy Score,12,8,7,9
22023,203994,22300197,"NOV 15, 2023",PHX vs. MIN,W,24,1,3,0.333,1,1,1.0,0,0,0.0,1,4,5,4,0,0,0,3,3,10,1,Jusuf Nurkic,PHX,PHX,MIN,8.0,Defensive Rebounds,12,8,7,9
22023,203994,22300197,"NOV 15, 2023",PHX vs. MIN,W,24,1,3,0.333,1,1,1.0,0,0,0.0,1,4,5,4,0,0,0,3,3,10,1,Jusuf Nurkic,PHX,PHX,MIN,23.5,Pts+Rebs,12,8,7,9
22023,203994,22300197,"NOV 15, 2023",PHX vs. MIN,W,24,1,3,0.333,1,1,1.0,0,0,0.0,1,4,5,4,0,0,0,3,3,10,1,Jusuf Nurkic,PHX,PHX,MIN,0.5,Dunks,12,8,7,9
22023,203994,22300197,"NOV 15, 2023",PHX vs. MIN,W,24,1,3,0.333,1,1,1.0,0,0,0.0,1,4,5,4,0,0,0,3,3,10,1,Jusuf Nurkic,PHX,PHX,MIN,15.5,Pts+Asts,12,8,7,9
22023,203994,22300197,"NOV 15, 2023",PHX vs. MIN,W,24,1,3,0.333,1,1,1.0,0,0,0.0,1,4,5,4,0,0,0,3,3,10,1,Jusuf Nurkic,PHX,PHX,MIN,13.5,Rebs+Asts,12,8,7,9
22023,203994,22300185,"NOV 12, 2023",PHX vs. OKC,L,26,1,6,0.167,0,3,0.0,1,2,0.5,3,5,8,1,1,2,2,3,3,-15,1,Jusuf Nurkic,PHX,PHX,OKC,12.5,Points,12,11,4,9
22023,203994,22300185,"NOV 12, 2023",PHX vs. OKC,L,26,1,6,0.167,0,3,0.0,1,2,0.5,3,5,8,1,1,2,2,3,3,-15,1,Jusuf Nurkic,PHX,PHX,OKC,11.0,Rebounds,12,11,4,9
22023,203994,22300185,"NOV 12, 2023",PHX vs. OKC,L,26,1,6,0.167,0,3,0.0,1,2,0.5,3,5,8,1,1,2,2,3,3,-15,1,Jusuf Nurkic,PHX,PHX,OKC,26.5,Pts+Rebs+Asts,12,11,4,9
22023,203994,22300185,"NOV 12, 2023",PHX vs. OKC,L,26,1,6,0.167,0,3,0.0,1,2,0.5,3,5,8,1,1,2,2,3,3,-15,1,Jusuf Nurkic,PHX,PHX,OKC,32.5,Fantasy Score,12,11,4,9
22023,203994,22300185,"NOV 12, 2023",PHX vs. OKC,L,26,1,6,0.167,0,3,0.0,1,2,0.5,3,5,8,1,1,2,2,3,3,-15,1,Jusuf Nurkic,PHX,PHX,OKC,8.0,Defensive Rebounds,12,11,4,9
22023,203994,22300185,"NOV 12, 2023",PHX vs. OKC,L,26,1,6,0.167,0,3,0.0,1,2,0.5,3,5,8,1,1,2,2,3,3,-15,1,Jusuf Nurkic,PHX,PHX,OKC,23.5,Pts+Rebs,12,11,4,9
22023,203994,22300185,"NOV 12, 2023",PHX vs. OKC,L,26,1,6,0.167,0,3,0.0,1,2,0.5,3,5,8,1,1,2,2,3,3,-15,1,Jusuf Nurkic,PHX,PHX,OKC,0.5,Dunks,12,11,4,9
22023,203994,22300185,"NOV 12, 2023",PHX vs. OKC,L,26,1,6,0.167,0,3,0.0,1,2,0.5,3,5,8,1,1,2,2,3,3,-15,1,Jusuf Nurkic,PHX,PHX,OKC,15.5,Pts+Asts,12,11,4,9
22023,203994,22300185,"NOV 12, 2023",PHX vs. OKC,L,26,1,6,0.167,0,3,0.0,1,2,0.5,3,5,8,1,1,2,2,3,3,-15,1,Jusuf Nurkic,PHX,PHX,OKC,13.5,Rebs+Asts,12,11,4,9
22023,203994,22300015,"NOV 10, 2023",PHX vs. LAL,L,33,4,8,0.5,2,3,0.667,4,7,0.571,3,6,9,7,1,0,2,3,14,5,1,Jusuf Nurkic,PHX,PHX,LAL,12.5,Points,30,23,21,16
22023,203994,22300015,"NOV 10, 2023",PHX vs. LAL,L,33,4,8,0.5,2,3,0.667,4,7,0.571,3,6,9,7,1,0,2,3,14,5,1,Jusuf Nurkic,PHX,PHX,LAL,11.0,Rebounds,30,23,21,16
22023,203994,22300015,"NOV 10, 2023",PHX vs. LAL,L,33,4,8,0.5,2,3,0.667,4,7,0.571,3,6,9,7,1,0,2,3,14,5,1,Jusuf Nurkic,PHX,PHX,LAL,26.5,Pts+Rebs+Asts,30,23,21,16
22023,203994,22300015,"NOV 10, 2023",PHX vs. LAL,L,33,4,8,0.5,2,3,0.667,4,7,0.571,3,6,9,7,1,0,2,3,14,5,1,Jusuf Nurkic,PHX,PHX,LAL,32.5,Fantasy Score,30,23,21,16
22023,203994,22300015,"NOV 10, 2023",PHX vs. LAL,L,33,4,8,0.5,2,3,0.667,4,7,0.571,3,6,9,7,1,0,2,3,14,5,1,Jusuf Nurkic,PHX,PHX,LAL,8.0,Defensive Rebounds,30,23,21,16
22023,203994,22300015,"NOV 10, 2023",PHX vs. LAL,L,33,4,8,0.5,2,3,0.667,4,7,0.571,3,6,9,7,1,0,2,3,14,5,1,Jusuf Nurkic,PHX,PHX,LAL,23.5,Pts+Rebs,30,23,21,16
22023,203994,22300015,"NOV 10, 2023",PHX vs. LAL,L,33,4,8,0.5,2,3,0.667,4,7,0.571,3,6,9,7,1,0,2,3,14,5,1,Jusuf Nurkic,PHX,PHX,LAL,0.5,Dunks,30,23,21,16
22023,203994,22300015,"NOV 10, 2023",PHX vs. LAL,L,33,4,8,0.5,2,3,0.667,4,7,0.571,3,6,9,7,1,0,2,3,14,5,1,Jusuf Nurkic,PHX,PHX,LAL,15.5,Pts+Asts,30,23,21,16
22023,203994,22300015,"NOV 10, 2023",PHX vs. LAL,L,33,4,8,0.5,2,3,0.667,4,7,0.571,3,6,9,7,1,0,2,3,14,5,1,Jusuf Nurkic,PHX,PHX,LAL,13.5,Rebs+Asts,30,23,21,16
22023,203994,22300162,"NOV 08, 2023",PHX @ CHI,W,38,8,16,0.5,0,2,0.0,4,6,0.667,8,9,17,8,2,0,6,4,20,12,1,Jusuf Nurkic,PHX,CHI,PHX,12.5,Points,45,37,28,25
22023,203994,22300162,"NOV 08, 2023",PHX @ CHI,W,38,8,16,0.5,0,2,0.0,4,6,0.667,8,9,17,8,2,0,6,4,20,12,1,Jusuf Nurkic,PHX,CHI,PHX,11.0,Rebounds,45,37,28,25
22023,203994,22300162,"NOV 08, 2023",PHX @ CHI,W,38,8,16,0.5,0,2,0.0,4,6,0.667,8,9,17,8,2,0,6,4,20,12,1,Jusuf Nurkic,PHX,CHI,PHX,26.5,Pts+Rebs+Asts,45,37,28,25
22023,203994,22300162,"NOV 08, 2023",PHX @ CHI,W,38,8,16,0.5,0,2,0.0,4,6,0.667,8,9,17,8,2,0,6,4,20,12,1,Jusuf Nurkic,PHX,CHI,PHX,32.5,Fantasy Score,45,37,28,25
22023,203994,22300162,"NOV 08, 2023",PHX @ CHI,W,38,8,16,0.5,0,2,0.0,4,6,0.667,8,9,17,8,2,0,6,4,20,12,1,Jusuf Nurkic,PHX,CHI,PHX,8.0,Defensive Rebounds,45,37,28,25
22023,203994,22300162,"NOV 08, 2023",PHX @ CHI,W,38,8,16,0.5,0,2,0.0,4,6,0.667,8,9,17,8,2,0,6,4,20,12,1,Jusuf Nurkic,PHX,CHI,PHX,23.5,Pts+Rebs,45,37,28,25
22023,203994,22300162,"NOV 08, 2023",PHX @ CHI,W,38,8,16,0.5,0,2,0.0,4,6,0.667,8,9,17,8,2,0,6,4,20,12,1,Jusuf Nurkic,PHX,CHI,PHX,0.5,Dunks,45,37,28,25
22023,203994,22300162,"NOV 08, 2023",PHX @ CHI,W,38,8,16,0.5,0,2,0.0,4,6,0.667,8,9,17,8,2,0,6,4,20,12,1,Jusuf Nurkic,PHX,CHI,PHX,15.5,Pts+Asts,45,37,28,25
22023,203994,22300162,"NOV 08, 2023",PHX @ CHI,W,38,8,16,0.5,0,2,0.0,4,6,0.667,8,9,17,8,2,0,6,4,20,12,1,Jusuf Nurkic,PHX,CHI,PHX,13.5,Rebs+Asts,45,37,28,25
22023,203994,22300140,"NOV 05, 2023",PHX @ DET,W,28,1,4,0.25,0,1,0.0,4,6,0.667,3,1,4,7,2,3,2,2,6,13,1,Jusuf Nurkic,PHX,DET,PHX,12.5,Points,17,10,13,11
22023,203994,22300140,"NOV 05, 2023",PHX @ DET,W,28,1,4,0.25,0,1,0.0,4,6,0.667,3,1,4,7,2,3,2,2,6,13,1,Jusuf Nurkic,PHX,DET,PHX,11.0,Rebounds,17,10,13,11
22023,203994,22300140,"NOV 05, 2023",PHX @ DET,W,28,1,4,0.25,0,1,0.0,4,6,0.667,3,1,4,7,2,3,2,2,6,13,1,Jusuf Nurkic,PHX,DET,PHX,26.5,Pts+Rebs+Asts,17,10,13,11
22023,203994,22300140,"NOV 05, 2023",PHX @ DET,W,28,1,4,0.25,0,1,0.0,4,6,0.667,3,1,4,7,2,3,2,2,6,13,1,Jusuf Nurkic,PHX,DET,PHX,32.5,Fantasy Score,17,10,13,11
22023,203994,22300140,"NOV 05, 2023",PHX @ DET,W,28,1,4,0.25,0,1,0.0,4,6,0.667,3,1,4,7,2,3,2,2,6,13,1,Jusuf Nurkic,PHX,DET,PHX,8.0,Defensive Rebounds,17,10,13,11
22023,203994,22300140,"NOV 05, 2023",PHX @ DET,W,28,1,4,0.25,0,1,0.0,4,6,0.667,3,1,4,7,2,3,2,2,6,13,1,Jusuf Nurkic,PHX,DET,PHX,23.5,Pts+Rebs,17,10,13,11
22023,203994,22300140,"NOV 05, 2023",PHX @ DET,W,28,1,4,0.25,0,1,0.0,4,6,0.667,3,1,4,7,2,3,2,2,6,13,1,Jusuf Nurkic,PHX,DET,PHX,0.5,Dunks,17,10,13,11
22023,203994,22300140,"NOV 05, 2023",PHX @ DET,W,28,1,4,0.25,0,1,0.0,4,6,0.667,3,1,4,7,2,3,2,2,6,13,1,Jusuf Nurkic,PHX,DET,PHX,15.5,Pts+Asts,17,10,13,11
22023,203994,22300140,"NOV 05, 2023",PHX @ DET,W,28,1,4,0.25,0,1,0.0,4,6,0.667,3,1,4,7,2,3,2,2,6,13,1,Jusuf Nurkic,PHX,DET,PHX,13.5,Rebs+Asts,17,10,13,11
22023,203994,22300132,"NOV 04, 2023",PHX @ PHI,L,23,4,14,0.286,1,6,0.167,2,4,0.5,3,6,9,5,1,1,0,2,11,-3,1,Jusuf Nurkic,PHX,PHI,PHX,12.5,Points,25,20,16,14
22023,203994,22300132,"NOV 04, 2023",PHX @ PHI,L,23,4,14,0.286,1,6,0.167,2,4,0.5,3,6,9,5,1,1,0,2,11,-3,1,Jusuf Nurkic,PHX,PHI,PHX,11.0,Rebounds,25,20,16,14
22023,203994,22300132,"NOV 04, 2023",PHX @ PHI,L,23,4,14,0.286,1,6,0.167,2,4,0.5,3,6,9,5,1,1,0,2,11,-3,1,Jusuf Nurkic,PHX,PHI,PHX,26.5,Pts+Rebs+Asts,25,20,16,14
22023,203994,22300132,"NOV 04, 2023",PHX @ PHI,L,23,4,14,0.286,1,6,0.167,2,4,0.5,3,6,9,5,1,1,0,2,11,-3,1,Jusuf Nurkic,PHX,PHI,PHX,32.5,Fantasy Score,25,20,16,14
22023,203994,22300132,"NOV 04, 2023",PHX @ PHI,L,23,4,14,0.286,1,6,0.167,2,4,0.5,3,6,9,5,1,1,0,2,11,-3,1,Jusuf Nurkic,PHX,PHI,PHX,8.0,Defensive Rebounds,25,20,16,14
22023,203994,22300132,"NOV 04, 2023",PHX @ PHI,L,23,4,14,0.286,1,6,0.167,2,4,0.5,3,6,9,5,1,1,0,2,11,-3,1,Jusuf Nurkic,PHX,PHI,PHX,23.5,Pts+Rebs,25,20,16,14
22023,203994,22300132,"NOV 04, 2023",PHX @ PHI,L,23,4,14,0.286,1,6,0.167,2,4,0.5,3,6,9,5,1,1,0,2,11,-3,1,Jusuf Nurkic,PHX,PHI,PHX,0.5,Dunks,25,20,16,14
22023,203994,22300132,"NOV 04, 2023",PHX @ PHI,L,23,4,14,0.286,1,6,0.167,2,4,0.5,3,6,9,5,1,1,0,2,11,-3,1,Jusuf Nurkic,PHX,PHI,PHX,15.5,Pts+Asts,25,20,16,14
22023,203994,22300132,"NOV 04, 2023",PHX @ PHI,L,23,4,14,0.286,1,6,0.167,2,4,0.5,3,6,9,5,1,1,0,2,11,-3,1,Jusuf Nurkic,PHX,PHI,PHX,13.5,Rebs+Asts,25,20,16,14
22023,203994,22300131,"NOV 02, 2023",PHX vs. SAS,L,19,2,5,0.4,1,3,0.333,2,2,1.0,1,2,3,2,1,0,2,3,7,-5,1,Jusuf Nurkic,PHX,PHX,SAS,12.5,Points,12,10,9,5
22023,203994,22300131,"NOV 02, 2023",PHX vs. SAS,L,19,2,5,0.4,1,3,0.333,2,2,1.0,1,2,3,2,1,0,2,3,7,-5,1,Jusuf Nurkic,PHX,PHX,SAS,11.0,Rebounds,12,10,9,5
22023,203994,22300131,"NOV 02, 2023",PHX vs. SAS,L,19,2,5,0.4,1,3,0.333,2,2,1.0,1,2,3,2,1,0,2,3,7,-5,1,Jusuf Nurkic,PHX,PHX,SAS,26.5,Pts+Rebs+Asts,12,10,9,5
22023,203994,22300131,"NOV 02, 2023",PHX vs. SAS,L,19,2,5,0.4,1,3,0.333,2,2,1.0,1,2,3,2,1,0,2,3,7,-5,1,Jusuf Nurkic,PHX,PHX,SAS,32.5,Fantasy Score,12,10,9,5
22023,203994,22300131,"NOV 02, 2023",PHX vs. SAS,L,19,2,5,0.4,1,3,0.333,2,2,1.0,1,2,3,2,1,0,2,3,7,-5,1,Jusuf Nurkic,PHX,PHX,SAS,8.0,Defensive Rebounds,12,10,9,5
22023,203994,22300131,"NOV 02, 2023",PHX vs. SAS,L,19,2,5,0.4,1,3,0.333,2,2,1.0,1,2,3,2,1,0,2,3,7,-5,1,Jusuf Nurkic,PHX,PHX,SAS,23.5,Pts+Rebs,12,10,9,5
22023,203994,22300131,"NOV 02, 2023",PHX vs. SAS,L,19,2,5,0.4,1,3,0.333,2,2,1.0,1,2,3,2,1,0,2,3,7,-5,1,Jusuf Nurkic,PHX,PHX,SAS,0.5,Dunks,12,10,9,5
22023,203994,22300131,"NOV 02, 2023",PHX vs. SAS,L,19,2,5,0.4,1,3,0.333,2,2,1.0,1,2,3,2,1,0,2,3,7,-5,1,Jusuf Nurkic,PHX,PHX,SAS,15.5,Pts+Asts,12,10,9,5
22023,203994,22300131,"NOV 02, 2023",PHX vs. SAS,L,19,2,5,0.4,1,3,0.333,2,2,1.0,1,2,3,2,1,0,2,3,7,-5,1,Jusuf Nurkic,PHX,PHX,SAS,13.5,Rebs+Asts,12,10,9,5
22023,203994,22300113,"OCT 31, 2023",PHX vs. SAS,L,30,4,10,0.4,2,5,0.4,2,2,1.0,0,12,12,4,1,2,0,4,12,-8,1,Jusuf Nurkic,PHX,PHX,SAS,12.5,Points,28,24,16,16
22023,203994,22300113,"OCT 31, 2023",PHX vs. SAS,L,30,4,10,0.4,2,5,0.4,2,2,1.0,0,12,12,4,1,2,0,4,12,-8,1,Jusuf Nurkic,PHX,PHX,SAS,11.0,Rebounds,28,24,16,16
22023,203994,22300113,"OCT 31, 2023",PHX vs. SAS,L,30,4,10,0.4,2,5,0.4,2,2,1.0,0,12,12,4,1,2,0,4,12,-8,1,Jusuf Nurkic,PHX,PHX,SAS,26.5,Pts+Rebs+Asts,28,24,16,16
22023,203994,22300113,"OCT 31, 2023",PHX vs. SAS,L,30,4,10,0.4,2,5,0.4,2,2,1.0,0,12,12,4,1,2,0,4,12,-8,1,Jusuf Nurkic,PHX,PHX,SAS,32.5,Fantasy Score,28,24,16,16
22023,203994,22300113,"OCT 31, 2023",PHX vs. SAS,L,30,4,10,0.4,2,5,0.4,2,2,1.0,0,12,12,4,1,2,0,4,12,-8,1,Jusuf Nurkic,PHX,PHX,SAS,8.0,Defensive Rebounds,28,24,16,16
22023,203994,22300113,"OCT 31, 2023",PHX vs. SAS,L,30,4,10,0.4,2,5,0.4,2,2,1.0,0,12,12,4,1,2,0,4,12,-8,1,Jusuf Nurkic,PHX,PHX,SAS,23.5,Pts+Rebs,28,24,16,16
22023,203994,22300113,"OCT 31, 2023",PHX vs. SAS,L,30,4,10,0.4,2,5,0.4,2,2,1.0,0,12,12,4,1,2,0,4,12,-8,1,Jusuf Nurkic,PHX,PHX,SAS,0.5,Dunks,28,24,16,16
22023,203994,22300113,"OCT 31, 2023",PHX vs. SAS,L,30,4,10,0.4,2,5,0.4,2,2,1.0,0,12,12,4,1,2,0,4,12,-8,1,Jusuf Nurkic,PHX,PHX,SAS,15.5,Pts+Asts,28,24,16,16
22023,203994,22300113,"OCT 31, 2023",PHX vs. SAS,L,30,4,10,0.4,2,5,0.4,2,2,1.0,0,12,12,4,1,2,0,4,12,-8,1,Jusuf Nurkic,PHX,PHX,SAS,13.5,Rebs+Asts,28,24,16,16
22023,203994,22300094,"OCT 28, 2023",PHX vs. UTA,W,23,3,8,0.375,0,2,0.0,4,6,0.667,2,5,7,6,2,1,2,3,10,15,1,Jusuf Nurkic,PHX,PHX,UTA,12.5,Points,23,17,16,13
22023,203994,22300094,"OCT 28, 2023",PHX vs. UTA,W,23,3,8,0.375,0,2,0.0,4,6,0.667,2,5,7,6,2,1,2,3,10,15,1,Jusuf Nurkic,PHX,PHX,UTA,11.0,Rebounds,23,17,16,13
22023,203994,22300094,"OCT 28, 2023",PHX vs. UTA,W,23,3,8,0.375,0,2,0.0,4,6,0.667,2,5,7,6,2,1,2,3,10,15,1,Jusuf Nurkic,PHX,PHX,UTA,26.5,Pts+Rebs+Asts,23,17,16,13
22023,203994,22300094,"OCT 28, 2023",PHX vs. UTA,W,23,3,8,0.375,0,2,0.0,4,6,0.667,2,5,7,6,2,1,2,3,10,15,1,Jusuf Nurkic,PHX,PHX,UTA,32.5,Fantasy Score,23,17,16,13
22023,203994,22300094,"OCT 28, 2023",PHX vs. UTA,W,23,3,8,0.375,0,2,0.0,4,6,0.667,2,5,7,6,2,1,2,3,10,15,1,Jusuf Nurkic,PHX,PHX,UTA,8.0,Defensive Rebounds,23,17,16,13
22023,203994,22300094,"OCT 28, 2023",PHX vs. UTA,W,23,3,8,0.375,0,2,0.0,4,6,0.667,2,5,7,6,2,1,2,3,10,15,1,Jusuf Nurkic,PHX,PHX,UTA,23.5,Pts+Rebs,23,17,16,13
22023,203994,22300094,"OCT 28, 2023",PHX vs. UTA,W,23,3,8,0.375,0,2,0.0,4,6,0.667,2,5,7,6,2,1,2,3,10,15,1,Jusuf Nurkic,PHX,PHX,UTA,0.5,Dunks,23,17,16,13
22023,203994,22300094,"OCT 28, 2023",PHX vs. UTA,W,23,3,8,0.375,0,2,0.0,4,6,0.667,2,5,7,6,2,1,2,3,10,15,1,Jusuf Nurkic,PHX,PHX,UTA,15.5,Pts+Asts,23,17,16,13
22023,203994,22300094,"OCT 28, 2023",PHX vs. UTA,W,23,3,8,0.375,0,2,0.0,4,6,0.667,2,5,7,6,2,1,2,3,10,15,1,Jusuf Nurkic,PHX,PHX,UTA,13.5,Rebs+Asts,23,17,16,13
22023,203994,22300076,"OCT 26, 2023",PHX @ LAL,L,28,1,5,0.2,0,2,0.0,2,2,1.0,3,6,9,3,3,0,4,5,4,-3,1,Jusuf Nurkic,PHX,LAL,PHX,12.5,Points,16,13,7,12
22023,203994,22300076,"OCT 26, 2023",PHX @ LAL,L,28,1,5,0.2,0,2,0.0,2,2,1.0,3,6,9,3,3,0,4,5,4,-3,1,Jusuf Nurkic,PHX,LAL,PHX,11.0,Rebounds,16,13,7,12
22023,203994,22300076,"OCT 26, 2023",PHX @ LAL,L,28,1,5,0.2,0,2,0.0,2,2,1.0,3,6,9,3,3,0,4,5,4,-3,1,Jusuf Nurkic,PHX,LAL,PHX,26.5,Pts+Rebs+Asts,16,13,7,12
22023,203994,22300076,"OCT 26, 2023",PHX @ LAL,L,28,1,5,0.2,0,2,0.0,2,2,1.0,3,6,9,3,3,0,4,5,4,-3,1,Jusuf Nurkic,PHX,LAL,PHX,32.5,Fantasy Score,16,13,7,12
22023,203994,22300076,"OCT 26, 2023",PHX @ LAL,L,28,1,5,0.2,0,2,0.0,2,2,1.0,3,6,9,3,3,0,4,5,4,-3,1,Jusuf Nurkic,PHX,LAL,PHX,8.0,Defensive Rebounds,16,13,7,12
22023,203994,22300076,"OCT 26, 2023",PHX @ LAL,L,28,1,5,0.2,0,2,0.0,2,2,1.0,3,6,9,3,3,0,4,5,4,-3,1,Jusuf Nurkic,PHX,LAL,PHX,23.5,Pts+Rebs,16,13,7,12
22023,203994,22300076,"OCT 26, 2023",PHX @ LAL,L,28,1,5,0.2,0,2,0.0,2,2,1.0,3,6,9,3,3,0,4,5,4,-3,1,Jusuf Nurkic,PHX,LAL,PHX,0.5,Dunks,16,13,7,12
22023,203994,22300076,"OCT 26, 2023",PHX @ LAL,L,28,1,5,0.2,0,2,0.0,2,2,1.0,3,6,9,3,3,0,4,5,4,-3,1,Jusuf Nurkic,PHX,LAL,PHX,15.5,Pts+Asts,16,13,7,12
22023,203994,22300076,"OCT 26, 2023",PHX @ LAL,L,28,1,5,0.2,0,2,0.0,2,2,1.0,3,6,9,3,3,0,4,5,4,-3,1,Jusuf Nurkic,PHX,LAL,PHX,13.5,Rebs+Asts,16,13,7,12
22023,203994,22300062,"OCT 24, 2023",PHX @ GSW,W,28,5,8,0.625,1,2,0.5,3,3,1.0,3,11,14,3,0,1,1,5,14,2,1,Jusuf Nurkic,PHX,GSW,PHX,12.5,Points,31,28,17,17
22023,203994,22300062,"OCT 24, 2023",PHX @ GSW,W,28,5,8,0.625,1,2,0.5,3,3,1.0,3,11,14,3,0,1,1,5,14,2,1,Jusuf Nurkic,PHX,GSW,PHX,11.0,Rebounds,31,28,17,17
22023,203994,22300062,"OCT 24, 2023",PHX @ GSW,W,28,5,8,0.625,1,2,0.5,3,3,1.0,3,11,14,3,0,1,1,5,14,2,1,Jusuf Nurkic,PHX,GSW,PHX,26.5,Pts+Rebs+Asts,31,28,17,17
22023,203994,22300062,"OCT 24, 2023",PHX @ GSW,W,28,5,8,0.625,1,2,0.5,3,3,1.0,3,11,14,3,0,1,1,5,14,2,1,Jusuf Nurkic,PHX,GSW,PHX,32.5,Fantasy Score,31,28,17,17
22023,203994,22300062,"OCT 24, 2023",PHX @ GSW,W,28,5,8,0.625,1,2,0.5,3,3,1.0,3,11,14,3,0,1,1,5,14,2,1,Jusuf Nurkic,PHX,GSW,PHX,8.0,Defensive Rebounds,31,28,17,17
22023,203994,22300062,"OCT 24, 2023",PHX @ GSW,W,28,5,8,0.625,1,2,0.5,3,3,1.0,3,11,14,3,0,1,1,5,14,2,1,Jusuf Nurkic,PHX,GSW,PHX,23.5,Pts+Rebs,31,28,17,17
22023,203994,22300062,"OCT 24, 2023",PHX @ GSW,W,28,5,8,0.625,1,2,0.5,3,3,1.0,3,11,14,3,0,1,1,5,14,2,1,Jusuf Nurkic,PHX,GSW,PHX,0.5,Dunks,31,28,17,17
22023,203994,22300062,"OCT 24, 2023",PHX @ GSW,W,28,5,8,0.625,1,2,0.5,3,3,1.0,3,11,14,3,0,1,1,5,14,2,1,Jusuf Nurkic,PHX,GSW,PHX,15.5,Pts+Asts,31,28,17,17
22023,203994,22300062,"OCT 24, 2023",PHX @ GSW,W,28,5,8,0.625,1,2,0.5,3,3,1.0,3,11,14,3,0,1,1,5,14,2,1,Jusuf Nurkic,PHX,GSW,PHX,13.5,Rebs+Asts,31,28,17,17
22023,1629670,22300564,"JAN 15, 2024",IND @ UTA,L,17,3,10,0.3,0,4,0.0,1,2,0.5,1,2,3,2,0,0,1,2,7,-19,1,Jordan Nwora,IND,UTA,IND,,,12,10,9,5
22023,1629670,22300550,"JAN 14, 2024",IND @ DEN,L,13,1,5,0.2,1,4,0.25,0,0,0.0,0,1,1,1,1,0,0,1,3,3,1,Jordan Nwora,IND,DEN,IND,,,5,4,4,2
22023,1629670,22300533,"JAN 12, 2024",IND @ ATL,W,4,0,1,0.0,0,0,0.0,0,0,0.0,0,1,1,2,0,0,0,0,0,-2,1,Jordan Nwora,IND,ATL,IND,,,3,1,2,3
22023,1629670,22300520,"JAN 10, 2024",IND vs. WAS,W,17,4,7,0.571,1,2,0.5,0,0,0.0,0,5,5,0,0,0,0,3,9,5,1,Jordan Nwora,IND,IND,WAS,,,14,14,9,5
22023,1629670,22300493,"JAN 06, 2024",IND vs. BOS,L,1,0,0,0.0,0,0,0.0,0,0,0.0,0,0,0,0,0,0,0,0,0,0,1,Jordan Nwora,IND,IND,BOS,,,0,0,0,0
22023,1629670,22300480,"JAN 05, 2024",IND vs. ATL,W,10,2,3,0.667,1,2,0.5,2,2,1.0,0,1,1,2,0,0,1,1,7,4,1,Jordan Nwora,IND,IND,ATL,,,10,8,9,3
22023,1629670,22300466,"JAN 03, 2024",IND vs. MIL,W,1,0,0,0.0,0,0,0.0,0,0,0.0,0,0,0,0,0,0,0,0,0,-3,1,Jordan Nwora,IND,IND,MIL,,,0,0,0,0
22023,1629670,22300441,"DEC 30, 2023",IND vs. NYK,W,1,0,0,0.0,0,0,0.0,0,0,0.0,0,0,0,0,0,0,0,0,0,-3,1,Jordan Nwora,IND,IND,NYK,,,0,0,0,0
22023,1629670,22300365,"DEC 20, 2023",IND vs. CHA,W,9,2,5,0.4,0,1,0.0,2,2,1.0,0,0,0,1,0,0,0,3,6,1,1,Jordan Nwora,IND,IND,CHA,,,7,6,7,1
22023,1629670,22300350,"DEC 18, 2023",IND vs. LAC,L,16,4,8,0.5,1,4,0.25,0,0,0.0,0,3,3,0,0,0,0,1,9,-5,1,Jordan Nwora,IND,IND,LAC,,,12,12,9,3
22023,1629670,22300338,"DEC 16, 2023",IND @ MIN,L,10,3,4,0.75,0,1,0.0,1,1,1.0,0,1,1,3,0,0,1,0,7,7,1,Jordan Nwora,IND,MIN,IND,,,11,8,10,4
22023,1629670,22300328,"DEC 15, 2023",IND @ WAS,L,4,2,3,0.667,2,2,1.0,0,0,0.0,0,1,1,0,0,0,1,0,6,3,1,Jordan Nwora,IND,WAS,IND,,,7,7,6,1
22023,1629670,22300315,"DEC 13, 2023",IND @ MIL,L,6,2,2,1.0,1,1,1.0,0,0,0.0,1,1,2,1,1,0,1,0,5,4,1,Jordan Nwora,IND,MIL,IND,,,8,7,6,3
22023,1629670,22300230,"NOV 22, 2023",IND vs. TOR,L,14,0,5,0.0,0,2,0.0,0,0,0.0,3,1,4,1,1,0,1,3,0,-16,1,Jordan Nwora,IND,IND,TOR,,,5,4,1,5
22023,1629670,22300209,"NOV 19, 2023",IND vs. ORL,L,23,8,11,0.727,2,5,0.4,1,1,1.0,2,3,5,1,3,0,1,3,19,18,1,Jordan Nwora,IND,IND,ORL,,,25,24,20,6
22023,1629670,22300146,"NOV 06, 2023",IND vs. SAS,W,9,2,3,0.667,1,2,0.5,1,2,0.5,0,4,4,0,0,0,2,0,6,6,1,Jordan Nwora,IND,IND,SAS,,,10,10,6,4
22023,1629670,22300118,"NOV 01, 2023",IND @ BOS,L,21,2,8,0.25,0,4,0.0,1,1,1.0,0,1,1,3,0,0,3,2,5,-22,1,Jordan Nwora,IND,BOS,IND,,,9,6,8,4
22023,1629670,22300064,"OCT 25, 2023",IND vs. WAS,W,6,2,7,0.286,1,2,0.5,0,0,0.0,1,0,1,1,0,1,0,0,5,3,1,Jordan Nwora,IND,IND,WAS,,,7,6,6,2
22023,1626220,22300562,"JAN 15, 2024",BKN vs. MIA,L,30,5,10,0.5,5,10,0.5,0,0,0.0,1,8,9,5,0,1,0,4,15,9,1,Royce O'Neale,BKN,BKN,MIA,,,29,24,20,14
22023,1626220,22300527,"JAN 11, 2024",BKN @ CLE,L,17,0,2,0.0,0,2,0.0,0,0,0.0,0,2,2,1,0,0,1,2,0,-8,1,Royce O'Neale,BKN,CLE,BKN,,,3,2,1,3
22023,1626220,22300498,"JAN 07, 2024",BKN vs. POR,L,18,3,5,0.6,2,4,0.5,0,0,0.0,0,3,3,1,1,0,2,3,8,-8,1,Royce O'Neale,BKN,BKN,POR,,,12,11,9,4
22023,1626220,22300481,"JAN 05, 2024",BKN vs. OKC,W,16,2,4,0.5,1,2,0.5,0,0,0.0,2,2,4,2,1,0,5,3,5,16,1,Royce O'Neale,BKN,BKN,OKC,,,11,9,7,6
22023,1626220,22300469,"JAN 03, 2024",BKN @ HOU,L,30,5,13,0.385,2,8,0.25,1,2,0.5,1,3,4,3,2,0,1,3,13,-7,1,Royce O'Neale,BKN,HOU,BKN,,,20,17,16,7
22023,1626220,22300461,"JAN 02, 2024",BKN @ NOP,L,28,0,6,0.0,0,5,0.0,0,0,0.0,4,4,8,5,1,0,3,3,0,-10,1,Royce O'Neale,BKN,NOP,BKN,,,13,8,5,13
22023,1626220,22300447,"DEC 31, 2023",BKN @ OKC,L,21,2,9,0.222,1,7,0.143,0,0,0.0,1,2,3,2,1,0,0,2,5,-11,1,Royce O'Neale,BKN,OKC,BKN,,,10,8,7,5
22023,1626220,22300430,"DEC 29, 2023",BKN @ WAS,L,18,3,4,0.75,1,2,0.5,0,0,0.0,1,2,3,2,0,0,2,0,7,-10,1,Royce O'Neale,BKN,WAS,BKN,,,12,10,9,5
22023,1626220,22300417,"DEC 27, 2023",BKN vs. MIL,L,10,1,4,0.25,1,3,0.333,0,0,0.0,0,1,1,2,0,0,0,1,3,1,1,Royce O'Neale,BKN,BKN,MIL,,,6,4,5,3
22023,1626220,22300406,"DEC 26, 2023",BKN @ DET,W,15,3,6,0.5,2,3,0.667,0,0,0.0,0,2,2,2,0,0,0,2,8,14,1,Royce O'Neale,BKN,DET,BKN,,,12,10,10,4
22023,1626220,22300394,"DEC 23, 2023",BKN vs. DET,W,19,2,3,0.667,1,1,1.0,0,0,0.0,0,6,6,5,1,0,1,1,5,13,1,Royce O'Neale,BKN,BKN,DET,,,16,11,10,11
22023,1626220,22300383,"DEC 22, 2023",BKN vs. DEN,L,22,4,7,0.571,2,5,0.4,3,4,0.75,2,4,6,3,0,2,1,1,13,5,1,Royce O'Neale,BKN,BKN,DEN,,,22,19,16,9
22023,1626220,22300368,"DEC 20, 2023",BKN vs. NYK,L,28,2,11,0.182,2,10,0.2,0,0,0.0,1,5,6,6,1,3,2,2,6,-10,1,Royce O'Neale,BKN,BKN,NYK,,,18,12,12,12
22023,1626220,22300357,"DEC 18, 2023",BKN @ UTA,L,23,2,6,0.333,2,6,0.333,0,0,0.0,0,1,1,1,1,0,1,2,6,-11,1,Royce O'Neale,BKN,UTA,BKN,,,8,7,7,2
22023,1626220,22300339,"DEC 16, 2023",BKN @ GSW,L,34,4,10,0.4,3,9,0.333,0,0,0.0,3,2,5,3,1,1,3,4,11,3,1,Royce O'Neale,BKN,GSW,BKN,,,19,16,14,8
22023,1626220,22300322,"DEC 14, 2023",BKN @ DEN,L,14,1,1,1.0,0,0,0.0,0,0,0.0,0,1,1,1,1,0,1,1,2,-19,1,Royce O'Neale,BKN,DEN,BKN,,,4,3,3,2
22023,1626220,22300317,"DEC 13, 2023",BKN @ PHX,W,19,3,5,0.6,2,4,0.5,0,0,0.0,0,1,1,4,0,0,0,1,8,19,1,Royce O'Neale,BKN,PHX,BKN,,,13,9,12,5
22023,1626220,22300303,"DEC 11, 2023",BKN @ SAC,L,19,1,3,0.333,1,1,1.0,2,2,1.0,1,3,4,1,0,0,0,0,5,-2,1,Royce O'Neale,BKN,SAC,BKN,,,10,9,6,5
22023,1626220,22301219,"DEC 08, 2023",BKN vs. WAS,W,26,4,10,0.4,3,9,0.333,2,2,1.0,2,6,8,5,1,1,0,1,13,11,1,Royce O'Neale,BKN,BKN,WAS,,,26,21,18,13
22023,1626220,22301209,"DEC 06, 2023",BKN @ ATL,W,21,2,6,0.333,1,4,0.25,1,2,0.5,0,3,3,2,1,0,0,2,6,10,1,Royce O'Neale,BKN,ATL,BKN,,,11,9,8,5
22023,1626220,22300282,"DEC 02, 2023",BKN vs. ORL,W,26,1,3,0.333,1,3,0.333,0,0,0.0,1,5,6,7,1,1,0,3,3,24,1,Royce O'Neale,BKN,BKN,ORL,,,16,9,10,13
22023,1626220,22300054,"NOV 28, 2023",BKN vs. TOR,W,31,6,12,0.5,6,12,0.5,0,0,0.0,2,5,7,4,2,2,1,5,18,15,1,Royce O'Neale,BKN,BKN,TOR,,,29,25,22,11
22023,1626220,22300250,"NOV 26, 2023",BKN vs. CHI,W,36,7,11,0.636,6,10,0.6,0,0,0.0,0,9,9,4,1,0,1,2,20,11,1,Royce O'Neale,BKN,BKN,CHI,,,33,29,24,13
22023,1626220,22300240,"NOV 25, 2023",BKN vs. MIA,W,29,2,6,0.333,2,5,0.4,0,0,0.0,1,1,2,4,2,1,1,4,6,9,1,Royce O'Neale,BKN,BKN,MIA,,,12,8,10,6
22023,1626220,22300227,"NOV 22, 2023",BKN @ ATL,L,21,0,3,0.0,0,2,0.0,0,2,0.0,0,3,3,1,1,1,1,3,0,-5,1,Royce O'Neale,BKN,ATL,BKN,,,4,3,1,4
22023,1626220,22300208,"NOV 19, 2023",BKN vs. PHI,L,25,0,2,0.0,0,0,0.0,0,0,0.0,1,3,4,3,1,2,1,1,0,-1,1,Royce O'Neale,BKN,BKN,PHI,,,7,4,3,7
22023,1626220,22300200,"NOV 16, 2023",BKN @ MIA,L,20,2,5,0.4,1,4,0.25,0,0,0.0,0,0,0,4,1,0,1,2,5,-22,1,Royce O'Neale,BKN,MIA,BKN,,,9,5,9,4
22023,1626220,22300020,"NOV 14, 2023",BKN vs. ORL,W,34,4,6,0.667,4,6,0.667,1,2,0.5,0,4,4,1,0,0,1,4,13,15,1,Royce O'Neale,BKN,BKN,ORL,,,18,17,14,5
22023,1626220,22300178,"NOV 12, 2023",BKN vs. WAS,W,31,3,8,0.375,3,7,0.429,1,2,0.5,1,5,6,4,2,0,2,4,10,-2,1,Royce O'Neale,BKN,BKN,WAS,,,20,16,14,10
22023,1626220,22300010,"NOV 10, 2023",BKN @ BOS,L,27,1,3,0.333,1,3,0.333,0,0,0.0,0,3,3,4,0,0,1,3,3,-13,1,Royce O'Neale,BKN,BOS,BKN,,,10,6,7,7
22023,1626220,22300160,"NOV 08, 2023",BKN vs. LAC,W,34,4,10,0.4,4,8,0.5,0,0,0.0,3,7,10,2,0,3,0,1,12,3,1,Royce O'Neale,BKN,BKN,LAC,,,24,22,14,12
22023,1626220,22300149,"NOV 06, 2023",BKN vs. MIL,L,25,4,8,0.5,4,7,0.571,0,0,0.0,1,8,9,3,0,1,1,4,12,-12,1,Royce O'Neale,BKN,BKN,MIL,,,24,21,15,12
22023,1626220,22300136,"NOV 04, 2023",BKN vs. BOS,L,37,2,15,0.133,2,13,0.154,0,0,0.0,1,3,4,3,1,1,0,4,6,-18,1,Royce O'Neale,BKN,BKN,BOS,,,13,10,9,7
22023,1626220,22300004,"NOV 03, 2023",BKN @ CHI,W,32,3,10,0.3,3,9,0.333,0,0,0.0,0,5,5,8,0,1,0,4,9,-3,1,Royce O'Neale,BKN,CHI,BKN,,,22,14,17,13
22023,1626220,22300119,"NOV 01, 2023",BKN @ MIA,W,39,2,6,0.333,2,5,0.4,0,0,0.0,0,7,7,5,2,1,3,5,6,-3,1,Royce O'Neale,BKN,MIA,BKN,,,18,13,11,12
22023,1626220,22300101,"OCT 30, 2023",BKN @ CHA,W,32,3,8,0.375,2,6,0.333,0,0,0.0,0,2,2,0,0,2,0,1,8,0,1,Royce O'Neale,BKN,CHA,BKN,,,10,10,8,2
22023,1626220,22300084,"OCT 27, 2023",BKN @ DAL,L,34,4,9,0.444,3,7,0.429,0,0,0.0,2,8,10,3,1,0,3,4,11,-11,1,Royce O'Neale,BKN,DAL,BKN,,,24,21,14,13
22023,1626220,22300067,"OCT 25, 2023",BKN vs. CLE,L,23,2,6,0.333,1,4,0.25,0,0,0.0,0,7,7,2,0,0,1,2,5,8,1,Royce O'Neale,BKN,BKN,CLE,,,14,12,7,9
22023,1629643,22300557,"JAN 15, 2024",ORL @ NYK,W,26,5,7,0.714,4,5,0.8,1,1,1.0,2,1,3,0,0,1,0,1,15,-5,1,Chuma Okeke,ORL,NYK,ORL,,,18,18,15,3
22023,1629643,22300546,"JAN 13, 2024",ORL @ OKC,L,19,2,6,0.333,1,5,0.2,0,0,0.0,1,3,4,2,0,0,0,1,5,-3,1,Chuma Okeke,ORL,OKC,ORL,,,11,9,7,6
22023,1629643,22300535,"JAN 12, 2024",ORL @ MIA,L,29,6,10,0.6,4,8,0.5,0,0,0.0,2,2,4,2,0,1,1,0,16,-17,1,Chuma Okeke,ORL,MIA,ORL,,,22,20,18,6
22023,1629643,22300513,"JAN 09, 2024",ORL vs. MIN,L,27,1,10,0.1,1,8,0.125,0,0,0.0,2,8,10,1,0,1,0,2,3,-9,1,Chuma Okeke,ORL,ORL,MIN,,,14,13,4,11
22023,1629643,22300499,"JAN 07, 2024",ORL vs. ATL,W,38,1,5,0.2,1,5,0.2,0,0,0.0,0,7,7,2,0,0,1,0,3,17,1,Chuma Okeke,ORL,ORL,ATL,,,12,10,5,9
22023,1629643,22300488,"JAN 05, 2024",ORL @ DEN,W,29,1,3,0.333,1,3,0.333,0,2,0.0,3,4,7,1,1,1,4,1,3,-2,1,Chuma Okeke,ORL,DEN,ORL,,,11,10,4,8
22023,1629643,22300476,"JAN 03, 2024",ORL @ SAC,L,27,4,5,0.8,3,4,0.75,0,0,0.0,1,6,7,3,0,1,0,2,11,4,1,Chuma Okeke,ORL,SAC,ORL,,,21,18,14,10
22023,1629643,22300450,"DEC 31, 2023",ORL @ PHX,L,0,0,0,0.0,0,0,0.0,0,0,0.0,0,0,0,0,0,0,0,0,0,-2,1,Chuma Okeke,ORL,PHX,ORL,,,0,0,0,0
22023,1629643,22300429,"DEC 29, 2023",ORL vs. NYK,W,12,1,5,0.2,0,4,0.0,0,0,0.0,0,0,0,1,0,0,0,1,2,5,1,Chuma Okeke,ORL,ORL,NYK,,,3,2,3,1
22023,1629643,22300415,"DEC 27, 2023",ORL vs. PHI,L,15,1,3,0.333,1,2,0.5,0,0,0.0,1,3,4,0,0,1,0,2,3,-2,1,Chuma Okeke,ORL,ORL,PHI,,,7,7,3,4
22023,1629643,22300366,"DEC 20, 2023",ORL vs. MIA,L,5,2,3,0.667,1,2,0.5,0,0,0.0,0,2,2,1,1,0,0,1,5,14,1,Chuma Okeke,ORL,ORL,MIA,,,8,7,6,3
22023,1629643,22300344,"DEC 17, 2023",ORL @ BOS,L,2,0,0,0.0,0,0,0.0,0,0,0.0,0,1,1,0,0,0,0,0,0,4,1,Chuma Okeke,ORL,BOS,ORL,,,1,1,0,1
22023,1629643,22300329,"DEC 15, 2023",ORL @ BOS,L,3,0,1,0.0,0,0,0.0,0,0,0.0,0,0,0,0,0,0,0,0,0,3,1,Chuma Okeke,ORL,BOS,ORL,,,0,0,0,0
22023,1629643,22301217,"DEC 08, 2023",ORL vs. DET,W,13,1,1,1.0,0,0,0.0,0,0,0.0,0,4,4,0,1,0,1,0,2,4,1,Chuma Okeke,ORL,ORL,DET,,,6,6,2,4
22023,1629643,22300282,"DEC 02, 2023",ORL @ BKN,L,4,0,2,0.0,0,2,0.0,0,0,0.0,0,0,0,0,0,0,1,0,0,-5,1,Chuma Okeke,ORL,BKN,ORL,,,0,0,0,0
22023,1629643,22300259,"NOV 29, 2023",ORL vs. WAS,W,5,0,2,0.0,0,1,0.0,0,0,0.0,0,0,0,2,0,0,0,0,0,-1,1,Chuma Okeke,ORL,ORL,WAS,,,2,0,2,2
22023,1629643,22300038,"NOV 21, 2023",ORL vs. TOR,W,4,2,3,0.667,2,3,0.667,0,0,0.0,0,0,0,0,0,0,0,0,6,-4,1,Chuma Okeke,ORL,ORL,TOR,,,6,6,6,0
22023,1629643,22300209,"NOV 19, 2023",ORL @ IND,W,8,1,2,0.5,1,1,1.0,0,0,0.0,0,1,1,0,0,0,0,0,3,-15,1,Chuma Okeke,ORL,IND,ORL,,,4,4,3,1
22023,1629643,22300020,"NOV 14, 2023",ORL @ BKN,L,2,0,0,0.0,0,0,0.0,0,0,0.0,0,0,0,0,0,0,0,0,0,-5,1,Chuma Okeke,ORL,BKN,ORL,,,0,0,0,0
22023,1629643,22300172,"NOV 09, 2023",ORL vs. ATL,L,2,0,1,0.0,0,1,0.0,0,0,0.0,1,0,1,0,0,0,0,0,0,-1,1,Chuma Okeke,ORL,ORL,ATL,,,1,1,0,1
22023,1629643,22300134,"NOV 04, 2023",ORL vs. LAL,W,3,0,1,0.0,0,1,0.0,0,0,0.0,1,0,1,1,0,0,0,0,0,3,1,Chuma Okeke,ORL,ORL,LAL,,,2,1,1,2
22023,1629643,22300114,"OCT 31, 2023",ORL @ LAC,L,4,1,1,1.0,0,0,0.0,0,0,0.0,1,0,1,0,0,0,1,0,2,-1,1,Chuma Okeke,ORL,LAC,ORL,,,3,3,2,1
22023,1629643,22300066,"OCT 25, 2023",ORL vs. HOU,W,5,0,1,0.0,0,1,0.0,0,0,0.0,0,3,3,0,0,0,0,0,0,9,1,Chuma Okeke,ORL,ORL,HOU,,,3,3,0,3
22023,1629006,22300554,"JAN 14, 2024",PHX @ POR,W,7,0,0,0.0,0,0,0.0,0,0,0.0,0,1,1,0,0,0,0,1,0,-6,1,Josh Okogie,PHX,POR,PHX,,,1,1,0,1
22023,1629006,22300531,"JAN 11, 2024",PHX @ LAL,W,12,2,4,0.5,0,2,0.0,1,2,0.5,0,0,0,0,1,0,0,1,5,-3,1,Josh Okogie,PHX,LAL,PHX,,,5,5,5,0
22023,1629006,22300511,"JAN 08, 2024",PHX @ LAC,L,18,2,3,0.667,0,1,0.0,0,0,0.0,1,0,1,2,3,0,0,2,4,-12,1,Josh Okogie,PHX,LAC,PHX,,,7,5,6,3
22023,1629006,22300503,"JAN 07, 2024",PHX vs. MEM,L,14,2,5,0.4,0,2,0.0,2,2,1.0,0,1,1,2,2,0,0,5,6,12,1,Josh Okogie,PHX,PHX,MEM,,,9,7,8,3
22023,1629006,22300489,"JAN 05, 2024",PHX vs. MIA,W,24,0,2,0.0,0,1,0.0,7,8,0.875,1,1,2,4,3,2,0,5,7,4,1,Josh Okogie,PHX,PHX,MIA,,,13,9,11,6
22023,1629006,22300473,"JAN 03, 2024",PHX vs. LAC,L,16,2,3,0.667,1,2,0.5,0,0,0.0,1,1,2,1,0,1,1,2,5,9,1,Josh Okogie,PHX,PHX,LAC,,,8,7,6,3
22023,1629006,22300456,"JAN 01, 2024",PHX vs. POR,W,18,1,2,0.5,0,0,0.0,1,2,0.5,0,2,2,3,0,1,1,1,3,8,1,Josh Okogie,PHX,PHX,POR,,,8,5,6,5
22023,1629006,22300450,"DEC 31, 2023",PHX vs. ORL,W,7,0,2,0.0,0,1,0.0,0,0,0.0,1,1,2,2,0,0,0,3,0,-8,1,Josh Okogie,PHX,PHX,ORL,,,4,2,2,4
22023,1629006,22300418,"DEC 27, 2023",PHX @ HOU,W,10,0,2,0.0,0,1,0.0,0,0,0.0,1,0,1,0,0,0,0,1,0,5,1,Josh Okogie,PHX,HOU,PHX,,,1,1,0,1
22023,1629006,22300405,"DEC 25, 2023",PHX vs. DAL,L,12,0,5,0.0,0,3,0.0,1,2,0.5,1,1,2,2,1,0,0,2,1,-7,1,Josh Okogie,PHX,PHX,DAL,,,5,3,3,4
22023,1629006,22300308,"DEC 12, 2023",PHX vs. GSW,W,11,3,4,0.75,3,4,0.75,1,2,0.5,1,1,2,2,0,1,0,1,10,6,1,Josh Okogie,PHX,PHX,GSW,,,14,12,12,4
22023,1629006,22301228,"DEC 08, 2023",PHX vs. SAC,L,29,0,5,0.0,0,3,0.0,0,0,0.0,2,0,2,3,2,2,1,3,0,3,1,Josh Okogie,PHX,PHX,SAC,,,5,2,3,5
22023,1629006,22301203,"DEC 05, 2023",PHX @ LAL,L,9,0,1,0.0,0,1,0.0,0,0,0.0,0,1,1,0,1,0,0,0,0,-11,1,Josh Okogie,PHX,LAL,PHX,,,1,1,0,1
22023,1629006,22300288,"DEC 02, 2023",PHX vs. MEM,W,26,1,2,0.5,0,1,0.0,1,6,0.167,3,4,7,1,3,1,1,2,3,12,1,Josh Okogie,PHX,PHX,MEM,,,11,10,4,8
22023,1629006,22300279,"DEC 01, 2023",PHX vs. DEN,L,26,5,9,0.556,1,5,0.2,2,2,1.0,2,2,4,0,1,2,2,3,13,4,1,Josh Okogie,PHX,PHX,DEN,,,17,17,13,4
22023,1629006,22300260,"NOV 29, 2023",PHX @ TOR,L,24,2,4,0.5,0,0,0.0,6,6,1.0,4,3,7,2,0,0,0,1,10,1,1,Josh Okogie,PHX,TOR,PHX,,,19,17,12,9
22023,1629006,22300247,"NOV 26, 2023",PHX @ NYK,W,17,0,5,0.0,0,3,0.0,3,4,0.75,1,3,4,2,1,0,2,3,3,-3,1,Josh Okogie,PHX,NYK,PHX,,,9,7,5,6
22023,1629006,22300044,"NOV 24, 2023",PHX @ MEM,W,28,2,9,0.222,1,4,0.25,0,1,0.0,1,6,7,3,1,0,0,1,5,22,1,Josh Okogie,PHX,MEM,PHX,,,15,12,8,10
22023,1629006,22300236,"NOV 22, 2023",PHX vs. GSW,W,27,4,5,0.8,1,2,0.5,3,4,0.75,1,1,2,0,1,1,1,1,12,-1,1,Josh Okogie,PHX,PHX,GSW,,,14,14,12,2
22023,1629006,22300041,"NOV 21, 2023",PHX vs. POR,W,13,0,0,0.0,0,0,0.0,2,2,1.0,1,2,3,1,1,0,1,0,2,9,1,Josh Okogie,PHX,PHX,POR,,,6,5,3,4
22023,1629006,22300214,"NOV 19, 2023",PHX @ UTA,W,14,1,2,0.5,1,2,0.5,0,0,0.0,2,1,3,0,3,0,1,1,3,-10,1,Josh Okogie,PHX,UTA,PHX,,,6,6,3,3
22023,1629006,22300035,"NOV 17, 2023",PHX @ UTA,W,13,0,1,0.0,0,0,0.0,1,2,0.5,1,0,1,0,0,0,1,2,1,-14,1,Josh Okogie,PHX,UTA,PHX,,,2,2,1,1
22023,1629006,22300197,"NOV 15, 2023",PHX vs. MIN,W,19,4,5,0.8,3,3,1.0,1,2,0.5,0,0,0,1,0,0,0,1,12,11,1,Josh Okogie,PHX,PHX,MIN,,,13,12,13,1
22023,1629006,22300185,"NOV 12, 2023",PHX vs. OKC,L,21,0,3,0.0,0,2,0.0,8,8,1.0,1,1,2,1,0,1,1,1,8,-8,1,Josh Okogie,PHX,PHX,OKC,,,11,10,9,3
22023,1629006,22300015,"NOV 10, 2023",PHX vs. LAL,L,13,0,4,0.0,0,4,0.0,2,2,1.0,2,4,6,1,0,0,0,0,2,7,1,Josh Okogie,PHX,PHX,LAL,,,9,8,3,7
22023,1629006,22300162,"NOV 08, 2023",PHX @ CHI,W,18,3,6,0.5,0,2,0.0,1,2,0.5,2,0,2,0,1,0,0,2,7,-18,1,Josh Okogie,PHX,CHI,PHX,,,9,9,7,2
22023,1629006,22300140,"NOV 05, 2023",PHX @ DET,W,29,3,6,0.5,0,1,0.0,4,5,0.8,4,3,7,2,2,0,2,1,10,9,1,Josh Okogie,PHX,DET,PHX,,,19,17,12,9
22023,1629006,22300132,"NOV 04, 2023",PHX @ PHI,L,26,2,7,0.286,0,2,0.0,0,0,0.0,1,0,1,2,2,1,1,0,4,-12,1,Josh Okogie,PHX,PHI,PHX,,,7,5,6,3
22023,1629006,22300131,"NOV 02, 2023",PHX vs. SAS,L,12,0,2,0.0,0,1,0.0,0,0,0.0,0,1,1,0,2,0,0,0,0,-4,1,Josh Okogie,PHX,PHX,SAS,,,1,1,0,1
22023,1629006,22300113,"OCT 31, 2023",PHX vs. SAS,L,30,3,10,0.3,1,4,0.25,4,5,0.8,1,1,2,2,0,2,2,1,11,-3,1,Josh Okogie,PHX,PHX,SAS,,,15,13,13,4
22023,1629006,22300094,"OCT 28, 2023",PHX vs. UTA,W,23,2,4,0.5,0,2,0.0,3,3,1.0,0,1,1,0,0,0,0,3,7,25,1,Josh Okogie,PHX,PHX,UTA,,,8,8,7,1
22023,1629006,22300076,"OCT 26, 2023",PHX @ LAL,L,33,3,5,0.6,2,4,0.5,2,2,1.0,4,4,8,3,0,1,1,2,10,5,1,Josh Okogie,PHX,LAL,PHX,,,21,18,13,11
22023,1629006,22300062,"OCT 24, 2023",PHX @ GSW,W,32,7,9,0.778,1,1,1.0,2,2,1.0,4,1,5,1,1,0,2,2,17,2,1,Josh Okogie,PHX,GSW,PHX,,,23,22,18,6
22023,1630168,22300559,"JAN 15, 2024",ATL vs. SAS,W,23,3,8,0.375,0,1,0.0,1,1,1.0,2,4,6,1,0,0,2,4,7,2,1,Onyeka Okongwu,ATL,ATL,SAS,,,14,13,8,7
22023,1630168,22300543,"JAN 13, 2024",ATL vs. WAS,L,19,3,5,0.6,0,0,0.0,3,5,0.6,6,4,10,1,0,3,2,4,9,-19,1,Onyeka Okongwu,ATL,ATL,WAS,,,20,19,10,11
22023,1630168,22300533,"JAN 12, 2024",ATL vs. IND,L,23,3,4,0.75,0,0,0.0,0,0,0.0,1,0,1,1,0,0,0,2,6,-19,1,Onyeka Okongwu,ATL,ATL,IND,,,8,7,7,2
22023,1630168,22300521,"JAN 10, 2024",ATL vs. PHI,W,36,7,10,0.7,0,0,0.0,5,5,1.0,6,5,11,1,0,2,2,5,19,-1,1,Onyeka Okongwu,ATL,ATL,PHI,,,31,30,20,12
22023,1630168,22300499,"JAN 07, 2024",ATL @ ORL,L,32,2,3,0.667,1,2,0.5,0,2,0.0,1,5,6,3,0,5,0,3,5,19,1,Onyeka Okongwu,ATL,ORL,ATL,,,14,11,8,9
22023,1630168,22300480,"JAN 05, 2024",ATL @ IND,L,21,1,1,1.0,0,0,0.0,1,2,0.5,4,2,6,1,0,1,0,1,3,-8,1,Onyeka Okongwu,ATL,IND,ATL,,,10,9,4,7
22023,1630168,22300467,"JAN 03, 2024",ATL vs. OKC,W,22,3,4,0.75,0,0,0.0,5,5,1.0,3,4,7,0,1,0,0,2,11,14,1,Onyeka Okongwu,ATL,ATL,OKC,,,18,18,11,7
22023,1630168,22300431,"DEC 29, 2023",ATL vs. SAC,L,23,3,6,0.5,0,0,0.0,1,2,0.5,1,2,3,1,1,1,0,2,7,-11,1,Onyeka Okongwu,ATL,ATL,SAC,,,11,10,8,4
22023,1630168,22300408,"DEC 26, 2023",ATL @ CHI,L,21,4,6,0.667,1,2,0.5,2,2,1.0,1,5,6,0,1,0,1,3,11,2,1,Onyeka Okongwu,ATL,CHI,ATL,,,17,17,11,6
22023,1630168,22300393,"DEC 23, 2023",ATL vs. MEM,L,28,5,10,0.5,0,2,0.0,0,0,0.0,4,3,7,4,2,2,3,4,10,-7,1,Onyeka Okongwu,ATL,ATL,MEM,,,21,17,14,11
22023,1630168,22300384,"DEC 22, 2023",ATL @ MIA,L,26,4,7,0.571,0,1,0.0,1,2,0.5,4,3,7,1,1,2,0,3,9,-10,1,Onyeka Okongwu,ATL,MIA,ATL,,,17,16,10,8
22023,1630168,22300371,"DEC 20, 2023",ATL @ HOU,W,33,8,11,0.727,0,1,0.0,3,4,0.75,1,10,11,2,0,0,0,1,19,12,1,Onyeka Okongwu,ATL,HOU,ATL,,,32,30,21,13
22023,1630168,22300352,"DEC 18, 2023",ATL vs. DET,W,23,5,6,0.833,0,0,0.0,4,4,1.0,0,2,2,1,0,1,2,2,14,0,1,Onyeka Okongwu,ATL,ATL,DET,,,17,16,15,3
22023,1630168,22300336,"DEC 16, 2023",ATL @ CLE,L,32,7,12,0.583,2,4,0.5,0,0,0.0,2,2,4,1,0,1,1,4,16,-15,1,Onyeka Okongwu,ATL,CLE,ATL,,,21,20,17,5
22023,1630168,22300330,"DEC 15, 2023",ATL @ TOR,W,33,6,7,0.857,1,2,0.5,1,1,1.0,4,7,11,0,0,1,1,3,14,14,1,Onyeka Okongwu,ATL,TOR,ATL,,,25,25,14,11
22023,1630168,22300313,"DEC 13, 2023",ATL @ TOR,L,30,5,9,0.556,3,5,0.6,0,0,0.0,2,6,8,1,0,2,0,0,13,5,1,Onyeka Okongwu,ATL,TOR,ATL,,,22,21,14,9
22023,1630168,22300296,"DEC 11, 2023",ATL vs. DEN,L,28,3,5,0.6,0,0,0.0,1,1,1.0,2,4,6,3,0,1,0,3,7,4,1,Onyeka Okongwu,ATL,ATL,DEN,,,16,13,10,9
22023,1630168,22301218,"DEC 08, 2023",ATL @ PHI,L,18,3,7,0.429,0,2,0.0,1,2,0.5,4,4,8,2,0,2,0,5,7,-1,1,Onyeka Okongwu,ATL,PHI,ATL,,,17,15,9,10
22023,1630168,22301209,"DEC 06, 2023",ATL vs. BKN,L,24,1,5,0.2,0,2,0.0,0,0,0.0,2,7,9,2,1,0,1,4,2,-8,1,Onyeka Okongwu,ATL,ATL,BKN,,,13,11,4,11
22023,1630168,22300286,"DEC 02, 2023",ATL @ MIL,L,27,2,4,0.5,0,2,0.0,1,3,0.333,1,3,4,3,0,0,0,3,5,-19,1,Onyeka Okongwu,ATL,MIL,ATL,,,12,9,8,7
22023,1630168,22300272,"NOV 30, 2023",ATL @ SAS,W,28,3,6,0.5,1,3,0.333,4,5,0.8,2,6,8,0,0,0,1,4,11,-4,1,Onyeka Okongwu,ATL,SAS,ATL,,,19,19,11,8
22023,1630168,22300055,"NOV 28, 2023",ATL @ CLE,L,22,4,8,0.5,1,1,1.0,4,5,0.8,2,7,9,2,0,0,0,0,13,1,1,Onyeka Okongwu,ATL,CLE,ATL,,,24,22,15,11
22023,1630168,22300246,"NOV 26, 2023",ATL @ BOS,L,27,2,2,1.0,0,0,0.0,0,0,0.0,0,3,3,0,2,1,0,2,4,-2,1,Onyeka Okongwu,ATL,BOS,ATL,,,7,7,4,3
22023,1630168,22300241,"NOV 25, 2023",ATL @ WAS,W,25,3,6,0.5,0,1,0.0,3,4,0.75,3,3,6,1,1,1,0,2,9,9,1,Onyeka Okongwu,ATL,WAS,ATL,,,16,15,10,7
22023,1630168,22300227,"NOV 22, 2023",ATL vs. BKN,W,25,6,10,0.6,0,2,0.0,0,0,0.0,4,6,10,0,0,1,0,1,12,16,1,Onyeka Okongwu,ATL,ATL,BKN,,,22,22,12,10
22023,1630168,22300039,"NOV 21, 2023",ATL vs. IND,L,22,3,7,0.429,0,2,0.0,1,1,1.0,4,2,6,4,0,1,1,2,7,6,1,Onyeka Okongwu,ATL,ATL,IND,,,17,13,11,10
22023,1630168,22300029,"NOV 17, 2023",ATL vs. PHI,L,19,2,6,0.333,1,2,0.5,0,0,0.0,2,3,5,0,0,0,1,3,5,-6,1,Onyeka Okongwu,ATL,ATL,PHI,,,10,10,5,5
22023,1630168,22300193,"NOV 15, 2023",ATL vs. NYK,L,22,2,4,0.5,0,0,0.0,4,4,1.0,2,4,6,1,1,1,4,4,8,18,1,Onyeka Okongwu,ATL,ATL,NYK,,,15,14,9,7
22023,1630168,22300018,"NOV 14, 2023",ATL @ DET,W,21,4,4,1.0,0,0,0.0,0,0,0.0,3,6,9,2,0,1,2,5,8,-2,1,Onyeka Okongwu,ATL,DET,ATL,,,19,17,10,11
22023,1630168,22300175,"NOV 11, 2023",ATL vs. MIA,L,24,0,3,0.0,0,0,0.0,2,2,1.0,4,3,7,2,0,2,0,2,2,-15,1,Onyeka Okongwu,ATL,ATL,MIA,,,11,9,4,9
22023,1630168,22300172,"NOV 09, 2023",ATL @ ORL,W,21,3,4,0.75,0,1,0.0,1,2,0.5,1,1,2,2,3,4,1,4,7,-18,1,Onyeka Okongwu,ATL,ORL,ATL,,,11,9,9,4
22023,1630168,22300155,"NOV 06, 2023",ATL @ OKC,L,25,3,8,0.375,0,1,0.0,1,1,1.0,6,8,14,0,0,0,2,3,7,1,1,Onyeka Okongwu,ATL,OKC,ATL,,,21,21,7,14
22023,1630168,22300135,"NOV 04, 2023",ATL @ NOP,W,20,4,6,0.667,2,3,0.667,7,8,0.875,2,4,6,0,1,1,0,0,17,-1,1,Onyeka Okongwu,ATL,NOP,ATL,,,23,23,17,6
22023,1630168,22300117,"NOV 01, 2023",ATL vs. WAS,W,27,6,8,0.75,0,1,0.0,4,4,1.0,5,6,11,2,0,1,1,3,16,-8,1,Onyeka Okongwu,ATL,ATL,WAS,,,29,27,18,13
22023,1630168,22300104,"OCT 30, 2023",ATL vs. MIN,W,24,3,3,1.0,0,0,0.0,4,4,1.0,2,5,7,3,0,0,0,1,10,22,1,Onyeka Okongwu,ATL,ATL,MIN,,,20,17,13,10
22023,1630168,22300097,"OCT 29, 2023",ATL @ MIL,W,23,7,11,0.636,0,2,0.0,0,0,0.0,4,3,7,2,1,0,1,4,14,5,1,Onyeka Okongwu,ATL,MIL,ATL,,,23,21,16,9
22023,1630168,22300079,"OCT 27, 2023",ATL vs. NYK,L,20,1,2,0.5,0,0,0.0,4,4,1.0,0,2,2,1,1,1,0,4,6,2,1,Onyeka Okongwu,ATL,ATL,NYK,,,9,8,7,3
22023,1630168,22300063,"OCT 25, 2023",ATL @ CHA,L,19,3,5,0.6,0,0,0.0,1,1,1.0,1,3,4,2,0,0,1,5,7,14,1,Onyeka Okongwu,ATL,CHA,ATL,,,13,11,9,6
22023,1630171,22300561,"JAN 15, 2024",CLE vs. CHI,W,25,3,12,0.25,1,6,0.167,0,0,0.0,1,4,5,1,0,0,1,1,7,18,1,Isaac Okoro,CLE,CLE,CHI,,,13,12,8,6
22023,1630171,22300527,"JAN 11, 2024",CLE vs. BKN,W,35,4,12,0.333,2,5,0.4,2,2,1.0,3,1,4,0,0,0,1,4,12,6,1,Isaac Okoro,CLE,CLE,BKN,,,16,16,12,4
22023,1630171,22300497,"JAN 07, 2024",CLE vs. SAS,W,27,1,2,0.5,1,2,0.5,0,0,0.0,4,1,5,1,0,0,2,0,3,-17,1,Isaac Okoro,CLE,CLE,SAS,,,9,8,4,6
22023,1630171,22300482,"JAN 05, 2024",CLE vs. WAS,W,22,2,5,0.4,0,0,0.0,4,6,0.667,2,2,4,0,1,0,3,2,8,16,1,Isaac Okoro,CLE,CLE,WAS,,,12,12,8,4
22023,1630171,22300465,"JAN 03, 2024",CLE vs. WAS,W,20,4,4,1.0,1,1,1.0,0,0,0.0,0,2,2,3,1,0,0,2,9,12,1,Isaac Okoro,CLE,CLE,WAS,,,14,11,12,5
22023,1630171,22300452,"JAN 01, 2024",CLE @ TOR,L,27,5,10,0.5,0,4,0.0,6,7,0.857,0,1,1,3,2,1,1,4,16,-17,1,Isaac Okoro,CLE,TOR,CLE,,,20,17,19,4
22023,1630171,22300433,"DEC 29, 2023",CLE vs. MIL,L,30,3,5,0.6,0,1,0.0,2,2,1.0,0,2,2,3,1,1,1,3,8,-10,1,Isaac Okoro,CLE,CLE,MIL,,,13,10,11,5
22023,1630171,22300420,"DEC 27, 2023",CLE @ DAL,W,39,7,13,0.538,4,7,0.571,4,5,0.8,2,1,3,1,0,1,2,2,22,4,1,Isaac Okoro,CLE,DAL,CLE,,,26,25,23,4
22023,1630171,22300396,"DEC 23, 2023",CLE @ CHI,W,35,3,9,0.333,0,5,0.0,6,7,0.857,0,3,3,3,0,0,1,2,12,6,1,Isaac Okoro,CLE,CHI,CLE,,,18,15,15,6
22023,1630171,22300375,"DEC 21, 2023",CLE vs. NOP,L,32,7,10,0.7,2,5,0.4,0,1,0.0,1,2,3,4,1,0,0,2,16,-19,1,Isaac Okoro,CLE,CLE,NOP,,,23,19,20,7
22023,1630171,22300364,"DEC 20, 2023",CLE vs. UTA,W,25,2,7,0.286,1,3,0.333,0,2,0.0,3,3,6,5,0,0,1,2,5,3,1,Isaac Okoro,CLE,CLE,UTA,,,16,11,10,11
22023,1630171,22300349,"DEC 18, 2023",CLE vs. HOU,W,32,4,7,0.571,1,2,0.5,2,3,0.667,4,3,7,6,0,1,0,1,11,-2,1,Isaac Okoro,CLE,CLE,HOU,,,24,18,17,13
22023,1630171,22300336,"DEC 16, 2023",CLE vs. ATL,W,32,6,9,0.667,3,4,0.75,3,4,0.75,3,0,3,3,1,0,0,2,18,-1,1,Isaac Okoro,CLE,CLE,ATL,,,24,21,21,6
22023,1630171,22300319,"DEC 14, 2023",CLE @ BOS,L,18,2,2,1.0,1,1,1.0,2,2,1.0,1,3,4,2,1,0,1,3,7,4,1,Isaac Okoro,CLE,BOS,CLE,,,13,11,9,6
22023,1630171,22300305,"DEC 12, 2023",CLE @ BOS,L,16,1,4,0.25,1,2,0.5,0,0,0.0,0,2,2,1,1,0,1,1,3,-15,1,Isaac Okoro,CLE,BOS,CLE,,,6,5,4,3
22023,1630171,22300294,"DEC 11, 2023",CLE @ ORL,L,26,0,4,0.0,0,4,0.0,1,4,0.25,3,1,4,0,0,0,1,2,1,-21,1,Isaac Okoro,CLE,ORL,CLE,,,5,5,1,4
22023,1630171,22301220,"DEC 08, 2023",CLE @ MIA,W,22,3,4,0.75,1,2,0.5,2,2,1.0,0,1,1,0,1,1,1,2,9,-12,1,Isaac Okoro,CLE,MIA,CLE,,,10,10,9,1
22023,1630171,22301205,"DEC 06, 2023",CLE vs. ORL,W,29,0,4,0.0,0,2,0.0,0,0,0.0,0,1,1,1,1,0,0,1,0,16,1,Isaac Okoro,CLE,CLE,ORL,,,2,1,1,2
22023,1630171,22300283,"DEC 02, 2023",CLE @ DET,W,33,4,7,0.571,1,3,0.333,0,0,0.0,0,6,6,4,4,0,0,3,9,15,1,Isaac Okoro,CLE,DET,CLE,,,19,15,13,10
22023,1630171,22300265,"NOV 30, 2023",CLE vs. POR,L,17,1,2,0.5,1,1,1.0,0,0,0.0,0,0,0,0,1,0,0,1,3,-12,1,Isaac Okoro,CLE,CLE,POR,,,3,3,3,0
22023,1630171,22300055,"NOV 28, 2023",CLE vs. ATL,W,16,3,6,0.5,0,1,0.0,0,1,0.0,1,1,2,2,0,2,0,0,6,-3,1,Isaac Okoro,CLE,CLE,ATL,,,10,8,8,4
22023,1630171,22300251,"NOV 26, 2023",CLE vs. TOR,W,10,1,3,0.333,0,1,0.0,0,0,0.0,0,0,0,0,0,0,1,0,2,-3,1,Isaac Okoro,CLE,CLE,TOR,,,2,2,2,0
22023,1630171,22300242,"NOV 25, 2023",CLE vs. LAL,L,19,2,3,0.667,0,0,0.0,1,1,1.0,1,2,3,0,0,1,2,1,5,7,1,Isaac Okoro,CLE,CLE,LAL,,,8,8,5,3
22023,1630171,22300001,"NOV 03, 2023",CLE @ IND,L,23,2,3,0.667,1,1,1.0,0,0,0.0,0,1,1,2,2,0,1,4,5,-19,1,Isaac Okoro,CLE,IND,CLE,,,8,6,7,3
22023,1630171,22300120,"NOV 01, 2023",CLE @ NYK,W,31,1,3,0.333,0,2,0.0,0,0,0.0,0,3,3,2,1,0,1,6,2,-1,1,Isaac Okoro,CLE,NYK,CLE,,,7,5,4,5
22023,1630171,22300112,"OCT 31, 2023",CLE vs. NYK,L,25,4,11,0.364,2,5,0.4,1,2,0.5,3,4,7,0,0,0,1,2,11,-9,1,Isaac Okoro,CLE,CLE,NYK,,,18,18,11,7
22023,1630171,22300091,"OCT 28, 2023",CLE vs. IND,L,35,5,8,0.625,0,0,0.0,1,2,0.5,2,3,5,3,0,1,0,3,11,-2,1,Isaac Okoro,CLE,CLE,IND,,,19,16,14,8
22023,1630171,22300081,"OCT 27, 2023",CLE vs. OKC,L,28,3,8,0.375,1,3,0.333,3,4,0.75,4,3,7,2,2,1,1,3,10,-7,1,Isaac Okoro,CLE,CLE,OKC,,,19,17,12,9
22023,1630171,22300067,"OCT 25, 2023",CLE @ BKN,W,32,6,10,0.6,2,4,0.5,4,5,0.8,3,3,6,4,2,1,2,5,18,5,1,Isaac Okoro,CLE,BKN,CLE,,,28,24,22,10
22023,203482,22300564,"JAN 15, 2024",UTA vs. IND,W,17,1,3,0.333,0,0,0.0,2,2,1.0,1,5,6,4,0,1,3,4,4,-5,1,Kelly Olynyk,UTA,UTA,IND,,,14,10,8,10
22023,203482,22300549,"JAN 13, 2024",UTA vs. LAL,W,15,2,8,0.25,0,1,0.0,0,0,0.0,1,4,5,2,0,0,2,1,4,-10,1,Kelly Olynyk,UTA,UTA,LAL,,,11,9,6,7
22023,203482,22300540,"JAN 12, 2024",UTA vs. TOR,W,21,4,7,0.571,1,2,0.5,2,4,0.5,2,8,10,5,1,0,1,3,11,14,1,Kelly Olynyk,UTA,UTA,TOR,,,26,21,16,15
22023,203482,22300524,"JAN 10, 2024",UTA vs. DEN,W,19,4,5,0.8,1,1,1.0,0,0,0.0,0,3,3,5,2,1,1,2,9,0,1,Kelly Olynyk,UTA,UTA,DEN,,,17,12,14,8
22023,203482,22300510,"JAN 08, 2024",UTA @ MIL,W,17,4,6,0.667,2,2,1.0,3,4,0.75,2,4,6,3,0,0,2,4,13,9,1,Kelly Olynyk,UTA,MIL,UTA,,,22,19,16,9
22023,203482,22300495,"JAN 06, 2024",UTA @ PHI,W,15,2,3,0.667,1,1,1.0,0,0,0.0,0,1,1,4,0,0,3,3,5,5,1,Kelly Olynyk,UTA,PHI,UTA,,,10,6,9,5
22023,203482,22300479,"JAN 05, 2024",UTA @ BOS,L,14,0,2,0.0,0,1,0.0,6,8,0.75,0,1,1,1,1,0,0,3,6,-22,1,Kelly Olynyk,UTA,BOS,UTA,,,8,7,7,2
22023,203482,22300474,"JAN 03, 2024",UTA vs. DET,W,20,3,5,0.6,0,1,0.0,3,3,1.0,2,3,5,4,1,0,2,3,9,0,1,Kelly Olynyk,UTA,UTA,DET,,,18,14,13,9
22023,203482,22300457,"JAN 01, 2024",UTA vs. DAL,W,19,3,3,1.0,1,1,1.0,0,0,0.0,0,5,5,6,3,0,1,3,7,28,1,Kelly Olynyk,UTA,UTA,DAL,,,18,12,13,11
22023,203482,22300439,"DEC 30, 2023",UTA vs. MIA,W,28,8,12,0.667,0,1,0.0,3,3,1.0,3,3,6,10,1,1,3,5,19,11,1,Kelly Olynyk,UTA,UTA,MIA,,,35,25,29,16
22023,203482,22300424,"DEC 28, 2023",UTA @ NOP,L,19,3,5,0.6,0,1,0.0,0,0,0.0,2,1,3,3,1,0,2,0,6,-10,1,Kelly Olynyk,UTA,NOP,UTA,,,12,9,9,6
22023,203482,22300412,"DEC 26, 2023",UTA @ SAS,W,23,2,6,0.333,1,3,0.333,2,2,1.0,2,3,5,6,0,1,0,1,7,-4,1,Kelly Olynyk,UTA,SAS,UTA,,,18,12,13,11
22023,203482,22300395,"DEC 23, 2023",UTA @ TOR,W,17,3,5,0.6,1,3,0.333,0,0,0.0,0,4,4,7,0,1,0,4,7,-9,1,Kelly Olynyk,UTA,TOR,UTA,,,18,11,14,11
22023,203482,22300374,"DEC 21, 2023",UTA @ DET,W,35,10,16,0.625,3,6,0.5,4,4,1.0,0,3,3,6,4,0,4,2,27,-4,1,Kelly Olynyk,UTA,DET,UTA,,,36,30,33,9
22023,203482,22300364,"DEC 20, 2023",UTA @ CLE,L,20,2,3,0.667,0,1,0.0,1,2,0.5,1,1,2,6,1,2,3,0,5,-14,1,Kelly Olynyk,UTA,CLE,UTA,,,13,7,11,8
22023,203482,22300357,"DEC 18, 2023",UTA vs. BKN,W,20,1,2,0.5,0,1,0.0,0,0,0.0,1,4,5,3,1,0,0,4,2,2,1,Kelly Olynyk,UTA,UTA,BKN,,,10,7,5,8
22023,203482,22300342,"DEC 16, 2023",UTA @ SAC,L,29,4,7,0.571,1,2,0.5,0,0,0.0,0,5,5,13,1,1,1,3,9,-18,1,Kelly Olynyk,UTA,SAC,UTA,,,27,14,22,18
22023,203482,22300323,"DEC 14, 2023",UTA @ POR,W,24,1,6,0.167,0,3,0.0,0,0,0.0,1,9,10,7,0,0,0,1,2,27,1,Kelly Olynyk,UTA,POR,UTA,,,19,12,9,17
22023,203482,22300318,"DEC 13, 2023",UTA vs. NYK,W,30,3,9,0.333,1,2,0.5,2,2,1.0,1,9,10,8,0,0,3,3,9,-1,1,Kelly Olynyk,UTA,UTA,NYK,,,27,19,17,18
22023,203482,22300302,"DEC 11, 2023",UTA @ OKC,L,21,1,5,0.2,0,2,0.0,0,0,0.0,0,6,6,3,0,0,2,2,2,-19,1,Kelly Olynyk,UTA,OKC,UTA,,,11,8,5,9
22023,203482,22301225,"DEC 08, 2023",UTA vs. LAC,L,18,4,5,0.8,1,1,1.0,4,4,1.0,0,4,4,2,1,0,0,3,13,6,1,Kelly Olynyk,UTA,UTA,LAC,,,19,17,15,6
22023,203482,22300270,"NOV 30, 2023",UTA @ MIN,L,14,3,5,0.6,2,2,1.0,0,0,0.0,1,3,4,3,0,0,2,3,8,2,1,Kelly Olynyk,UTA,MIN,UTA,,,15,12,11,7
22023,203482,22300261,"NOV 29, 2023",UTA @ MEM,L,18,2,2,1.0,1,1,1.0,0,0,0.0,0,2,2,2,2,0,1,3,5,-13,1,Kelly Olynyk,UTA,MEM,UTA,,,9,7,7,4
22023,203482,22300256,"NOV 27, 2023",UTA vs. NOP,W,19,0,1,0.0,0,0,0.0,4,4,1.0,0,4,4,4,0,0,0,5,4,4,1,Kelly Olynyk,UTA,UTA,NOP,,,12,8,8,8
22023,203482,22300243,"NOV 25, 2023",UTA vs. NOP,W,24,4,6,0.667,3,3,1.0,2,2,1.0,1,5,6,3,1,1,3,0,13,11,1,Kelly Olynyk,UTA,UTA,NOP,,,22,19,16,9
22023,203482,22300237,"NOV 22, 2023",UTA @ POR,L,32,5,5,1.0,0,0,0.0,3,3,1.0,3,6,9,5,1,1,3,1,13,-8,1,Kelly Olynyk,UTA,POR,UTA,,,27,22,18,14
22023,203482,22300042,"NOV 21, 2023",UTA @ LAL,L,24,1,6,0.167,0,4,0.0,2,4,0.5,2,3,5,5,0,0,2,3,4,-17,1,Kelly Olynyk,UTA,LAL,UTA,,,14,9,9,10
22023,203482,22300214,"NOV 19, 2023",UTA vs. PHX,L,20,1,4,0.25,0,2,0.0,4,4,1.0,3,2,5,5,0,0,4,6,6,2,1,Kelly Olynyk,UTA,UTA,PHX,,,16,11,11,10
22023,203482,22300035,"NOV 17, 2023",UTA vs. PHX,L,20,3,4,0.75,1,2,0.5,0,0,0.0,1,3,4,7,0,0,1,2,7,-2,1,Kelly Olynyk,UTA,UTA,PHX,,,18,11,14,11
22023,203482,22300023,"NOV 14, 2023",UTA vs. POR,W,24,4,8,0.5,2,3,0.667,2,2,1.0,6,6,12,3,1,0,3,1,12,11,1,Kelly Olynyk,UTA,UTA,POR,,,27,24,15,15
22023,203482,22300012,"NOV 10, 2023",UTA @ MEM,W,21,2,3,0.667,0,0,0.0,2,2,1.0,2,6,8,2,1,1,2,3,6,5,1,Kelly Olynyk,UTA,MEM,UTA,,,16,14,8,10
22023,203482,22300158,"NOV 08, 2023",UTA @ IND,L,21,2,4,0.5,0,2,0.0,0,0,0.0,1,4,5,0,1,0,2,5,4,-19,1,Kelly Olynyk,UTA,IND,UTA,,,9,9,4,5
22023,203482,22300152,"NOV 06, 2023",UTA @ CHI,L,23,5,7,0.714,2,3,0.667,1,1,1.0,0,7,7,8,0,0,1,1,13,-8,1,Kelly Olynyk,UTA,CHI,UTA,,,28,20,21,15
22023,203482,22300138,"NOV 04, 2023",UTA @ MIN,L,18,0,4,0.0,0,2,0.0,0,0,0.0,2,2,4,1,0,0,2,4,0,-11,1,Kelly Olynyk,UTA,MIN,UTA,,,5,4,1,5
22023,203482,22300130,"NOV 02, 2023",UTA vs. ORL,L,19,2,4,0.5,0,1,0.0,0,0,0.0,1,1,2,3,3,0,2,5,4,-3,1,Kelly Olynyk,UTA,UTA,ORL,,,9,6,7,5
22023,203482,22300125,"NOV 01, 2023",UTA vs. MEM,W,26,5,7,0.714,3,4,0.75,1,2,0.5,3,5,8,5,1,0,3,1,14,38,1,Kelly Olynyk,UTA,UTA,MEM,,,27,22,19,13
22023,203482,22300110,"OCT 30, 2023",UTA @ DEN,L,18,0,2,0.0,0,2,0.0,3,4,0.75,2,2,4,5,3,0,1,4,3,-8,1,Kelly Olynyk,UTA,DEN,UTA,,,12,7,8,9
22023,203482,22300094,"OCT 28, 2023",UTA @ PHX,L,16,4,5,0.8,0,1,0.0,1,1,1.0,2,4,6,3,0,0,1,2,9,-5,1,Kelly Olynyk,UTA,PHX,UTA,,,18,15,12,9
22023,203482,22300085,"OCT 27, 2023",UTA vs. LAC,W,27,5,6,0.833,2,2,1.0,3,3,1.0,3,1,4,3,1,1,3,3,15,-4,1,Kelly Olynyk,UTA,UTA,LAC,,,22,19,18,7
22023,203482,22300072,"OCT 25, 2023",UTA vs. SAC,L,17,2,3,0.667,0,0,0.0,1,1,1.0,3,3,6,4,1,0,1,3,5,-5,1,Kelly Olynyk,UTA,UTA,SAC,,,15,11,9,10
22023,1630647,22300494,"JAN 06, 2024",WAS vs. NYK,L,3,0,1,0.0,0,1,0.0,0,0,0.0,0,1,1,1,0,0,0,1,0,5,1,Eugene Omoruyi,WAS,WAS,NYK,,,2,1,1,2
22023,1630647,22300482,"JAN 05, 2024",WAS @ CLE,L,7,3,5,0.6,0,1,0.0,2,2,1.0,1,0,1,0,1,0,0,2,8,1,1,Eugene Omoruyi,WAS,CLE,WAS,,,9,9,8,1
22023,1630647,22300465,"JAN 03, 2024",WAS @ CLE,L,7,1,3,0.333,0,1,0.0,0,0,0.0,1,0,1,0,0,0,0,2,2,-4,1,Eugene Omoruyi,WAS,CLE,WAS,,,3,3,2,1
22023,1630647,22300416,"DEC 27, 2023",WAS vs. TOR,L,6,3,4,0.75,0,1,0.0,1,2,0.5,0,1,1,2,2,0,1,2,7,-4,1,Eugene Omoruyi,WAS,WAS,TOR,,,10,8,9,3
22023,1630647,22300358,"DEC 18, 2023",WAS @ SAC,L,5,1,3,0.333,0,1,0.0,0,0,0.0,0,2,2,0,0,0,0,1,2,6,1,Eugene Omoruyi,WAS,SAC,WAS,,,4,4,2,2
22023,1630647,22300347,"DEC 17, 2023",WAS @ PHX,L,0,0,0,0.0,0,0,0.0,0,0,0.0,0,0,0,0,0,0,0,0,0,0,1,Eugene Omoruyi,WAS,PHX,WAS,,,0,0,0,0
22023,1630647,22300295,"DEC 11, 2023",WAS @ PHI,L,2,0,1,0.0,0,0,0.0,0,0,0.0,0,0,0,0,0,0,0,1,0,-4,1,Eugene Omoruyi,WAS,PHI,WAS,,,0,0,0,0
22023,1630647,22301219,"DEC 08, 2023",WAS @ BKN,L,4,1,2,0.5,0,1,0.0,1,1,1.0,0,1,1,0,1,0,2,1,3,-2,1,Eugene Omoruyi,WAS,BKN,WAS,,,4,4,3,1
22023,1630647,22300259,"NOV 29, 2023",WAS @ ORL,L,10,3,5,0.6,1,2,0.5,3,4,0.75,1,0,1,1,1,0,0,3,10,-2,1,Eugene Omoruyi,WAS,ORL,WAS,,,12,11,11,2
22023,1630647,22300253,"NOV 27, 2023",WAS @ DET,W,2,1,3,0.333,1,1,1.0,0,0,0.0,2,0,2,0,0,0,0,0,3,0,1,Eugene Omoruyi,WAS,DET,WAS,,,5,5,3,2
22023,1630647,22300241,"NOV 25, 2023",WAS vs. ATL,L,12,4,6,0.667,0,1,0.0,2,2,1.0,2,1,3,1,1,0,0,1,10,1,1,Eugene Omoruyi,WAS,WAS,ATL,,,14,13,11,4
22023,1630647,22300219,"NOV 20, 2023",WAS vs. MIL,L,1,0,1,0.0,0,1,0.0,2,2,1.0,0,0,0,0,0,0,0,0,2,2,1,Eugene Omoruyi,WAS,WAS,MIL,,,2,2,2,0
22023,1630647,22300028,"NOV 17, 2023",WAS vs. NYK,L,2,2,2,1.0,1,1,1.0,0,0,0.0,0,0,0,0,0,0,0,0,5,-1,1,Eugene Omoruyi,WAS,WAS,NYK,,,5,5,5,0
22023,1630647,22300157,"NOV 08, 2023",WAS @ CHA,W,3,0,1,0.0,0,1,0.0,0,0,0.0,0,1,1,0,1,0,0,0,0,-2,1,Eugene Omoruyi,WAS,CHA,WAS,,,1,1,0,1
22023,1630647,22300148,"NOV 06, 2023",WAS @ PHI,L,11,1,2,0.5,1,2,0.5,1,2,0.5,0,4,4,2,0,0,3,4,4,-3,1,Eugene Omoruyi,WAS,PHI,WAS,,,10,8,6,6
22023,1630647,22300003,"NOV 03, 2023",WAS @ MIA,L,7,2,2,1.0,0,0,0.0,0,0,0.0,0,0,0,2,1,0,1,1,4,18,1,Eugene Omoruyi,WAS,MIA,WAS,,,6,4,6,2
22023,1630647,22300117,"NOV 01, 2023",WAS @ ATL,L,8,3,6,0.5,0,1,0.0,1,2,0.5,0,2,2,0,0,0,1,1,7,-3,1,Eugene Omoruyi,WAS,ATL,WAS,,,9,9,7,2
22023,1630647,22300103,"OCT 30, 2023",WAS vs. BOS,L,12,5,5,1.0,1,1,1.0,3,4,0.75,3,3,6,1,1,1,0,0,14,14,1,Eugene Omoruyi,WAS,WAS,BOS,,,21,20,15,7
22023,1630647,22300064,"OCT 25, 2023",WAS @ IND,L,8,2,3,0.667,0,0,0.0,0,0,0.0,1,1,2,1,0,0,1,0,4,-2,1,Eugene Omoruyi,WAS,IND,WAS,,,7,6,5,3
22023,1626224,22300559,"JAN 15, 2024",SAS @ ATL,L,12,1,5,0.2,1,5,0.2,0,0,0.0,0,1,1,0,0,0,1,3,3,-11,1,Cedi Osman,SAS,ATL,SAS,,,4,4,3,1
22023,1626224,22300548,"JAN 13, 2024",SAS vs. CHI,L,23,3,5,0.6,3,5,0.6,0,0,0.0,0,2,2,1,1,0,0,3,9,5,1,Cedi Osman,SAS,SAS,CHI,,,12,11,10,3
22023,1626224,22300541,"JAN 12, 2024",SAS vs. CHA,W,14,4,4,1.0,2,2,1.0,1,2,0.5,1,3,4,1,1,0,3,2,11,3,1,Cedi Osman,SAS,SAS,CHA,,,16,15,12,5
22023,1626224,22300519,"JAN 10, 2024",SAS @ DET,W,21,4,6,0.667,1,3,0.333,2,3,0.667,1,5,6,3,2,0,0,0,11,14,1,Cedi Osman,SAS,DET,SAS,,,20,17,14,9
22023,1626224,22300497,"JAN 07, 2024",SAS @ CLE,L,21,4,7,0.571,1,4,0.25,0,0,0.0,2,4,6,1,1,0,0,1,9,-19,1,Cedi Osman,SAS,CLE,SAS,,,16,15,10,7
22023,1626224,22300477,"JAN 04, 2024",SAS vs. MIL,L,28,4,7,0.571,3,6,0.5,2,3,0.667,0,2,2,5,3,0,1,3,13,10,1,Cedi Osman,SAS,SAS,MIL,,,20,15,18,7
22023,1626224,22300460,"JAN 02, 2024",SAS @ MEM,L,12,0,3,0.0,0,2,0.0,0,0,0.0,0,6,6,2,0,0,2,2,0,-9,1,Cedi Osman,SAS,MEM,SAS,,,8,6,2,8
22023,1626224,22300448,"DEC 31, 2023",SAS vs. BOS,L,16,2,4,0.5,1,2,0.5,0,0,0.0,0,0,0,2,1,0,0,2,5,-14,1,Cedi Osman,SAS,SAS,BOS,,,7,5,7,2
22023,1626224,22300437,"DEC 29, 2023",SAS @ POR,L,18,2,4,0.5,0,1,0.0,0,0,0.0,0,4,4,2,0,0,0,1,4,5,1,Cedi Osman,SAS,POR,SAS,,,10,8,6,6
22023,1626224,22300427,"DEC 28, 2023",SAS @ POR,W,16,2,3,0.667,0,0,0.0,0,0,0.0,0,2,2,2,0,0,0,0,4,-2,1,Cedi Osman,SAS,POR,SAS,,,8,6,6,4
22023,1626224,22300412,"DEC 26, 2023",SAS vs. UTA,L,13,0,2,0.0,0,1,0.0,1,4,0.25,0,2,2,3,0,0,0,0,1,-10,1,Cedi Osman,SAS,SAS,UTA,,,6,3,4,5
22023,1626224,22300398,"DEC 23, 2023",SAS @ DAL,L,10,1,3,0.333,1,2,0.5,0,0,0.0,0,0,0,2,1,0,0,1,3,-14,1,Cedi Osman,SAS,DAL,SAS,,,5,3,5,2
22023,1626224,22300376,"DEC 21, 2023",SAS @ CHI,L,11,0,4,0.0,0,3,0.0,2,2,1.0,0,1,1,3,0,0,2,1,2,-12,1,Cedi Osman,SAS,CHI,SAS,,,6,3,5,4
22023,1626224,22300361,"DEC 19, 2023",SAS @ MIL,L,19,3,6,0.5,0,2,0.0,4,4,1.0,0,2,2,1,0,0,0,1,10,-9,1,Cedi Osman,SAS,MIL,SAS,,,13,12,11,3
22023,1626224,22300345,"DEC 17, 2023",SAS vs. NOP,L,17,5,7,0.714,1,2,0.5,3,4,0.75,0,3,3,0,0,0,1,2,14,-11,1,Cedi Osman,SAS,SAS,NOP,,,17,17,14,3
22023,1626224,22300331,"DEC 15, 2023",SAS vs. LAL,W,25,6,11,0.545,3,6,0.5,0,0,0.0,0,2,2,6,0,0,0,2,15,13,1,Cedi Osman,SAS,SAS,LAL,,,23,17,21,8
22023,1626224,22300316,"DEC 13, 2023",SAS vs. LAL,L,17,2,4,0.5,1,2,0.5,0,0,0.0,0,7,7,2,0,0,0,0,5,9,1,Cedi Osman,SAS,SAS,LAL,,,14,12,7,9
22023,1626224,22300298,"DEC 11, 2023",SAS @ HOU,L,13,4,7,0.571,0,2,0.0,2,4,0.5,0,2,2,1,0,0,2,1,10,-3,1,Cedi Osman,SAS,HOU,SAS,,,13,12,11,3
22023,1626224,22301223,"DEC 08, 2023",SAS vs. CHI,L,10,3,7,0.429,1,4,0.25,0,0,0.0,0,1,1,1,0,1,0,1,7,1,1,Cedi Osman,SAS,SAS,CHI,,,9,8,8,2
22023,1626224,22301210,"DEC 06, 2023",SAS @ MIN,L,32,3,8,0.375,0,3,0.0,0,2,0.0,2,6,8,6,2,0,1,2,6,-10,1,Cedi Osman,SAS,MIN,SAS,,,20,14,12,14
22023,1626224,22300278,"DEC 01, 2023",SAS @ NOP,L,27,4,9,0.444,2,5,0.4,1,2,0.5,0,2,2,5,0,1,0,3,11,-17,1,Cedi Osman,SAS,NOP,SAS,,,18,13,16,7
22023,1626224,22300272,"NOV 30, 2023",SAS vs. ATL,L,15,1,7,0.143,1,5,0.2,0,0,0.0,0,1,1,2,0,0,1,3,3,-3,1,Cedi Osman,SAS,SAS,ATL,,,6,4,5,3
22023,1626224,22300252,"NOV 26, 2023",SAS @ DEN,L,16,1,5,0.2,1,3,0.333,4,4,1.0,1,2,3,3,0,0,3,2,7,-9,1,Cedi Osman,SAS,DEN,SAS,,,13,10,10,6
22023,1626224,22300051,"NOV 24, 2023",SAS @ GSW,L,18,5,11,0.455,1,6,0.167,0,0,0.0,1,0,1,0,0,0,1,3,11,-3,1,Cedi Osman,SAS,GSW,SAS,,,12,12,11,1
22023,1626224,22300235,"NOV 22, 2023",SAS vs. LAC,L,19,2,6,0.333,1,3,0.333,0,0,0.0,0,1,1,0,2,0,0,3,5,-18,1,Cedi Osman,SAS,SAS,LAC,,,6,6,5,1
22023,1626224,22300223,"NOV 20, 2023",SAS vs. LAC,L,23,7,10,0.7,2,4,0.5,1,1,1.0,2,3,5,1,0,0,0,4,17,-11,1,Cedi Osman,SAS,SAS,LAC,,,23,22,18,6
22023,1626224,22300206,"NOV 18, 2023",SAS vs. MEM,L,24,4,10,0.4,3,7,0.429,2,2,1.0,2,3,5,1,1,0,1,1,13,-21,1,Cedi Osman,SAS,SAS,MEM,,,19,18,14,6
22023,1626224,22300032,"NOV 17, 2023",SAS vs. SAC,L,15,1,3,0.333,1,2,0.5,0,0,0.0,0,2,2,1,0,0,0,1,3,-7,1,Cedi Osman,SAS,SAS,SAC,,,6,5,4,3
22023,1626224,22300021,"NOV 14, 2023",SAS @ OKC,L,15,2,5,0.4,2,5,0.4,0,0,0.0,0,0,0,0,0,0,0,0,6,-7,1,Cedi Osman,SAS,OKC,SAS,,,6,6,6,0
22023,1626224,22300184,"NOV 12, 2023",SAS vs. MIA,L,20,1,3,0.333,1,1,1.0,0,0,0.0,1,0,1,0,0,1,0,2,3,-15,1,Cedi Osman,SAS,SAS,MIA,,,4,4,3,1
22023,1626224,22300013,"NOV 10, 2023",SAS vs. MIN,L,16,1,2,0.5,0,1,0.0,0,0,0.0,0,0,0,2,1,0,0,1,2,-14,1,Cedi Osman,SAS,SAS,MIN,,,4,2,4,2
22023,1626224,22300161,"NOV 08, 2023",SAS @ NYK,L,13,1,4,0.25,0,3,0.0,0,0,0.0,1,2,3,2,0,0,0,0,2,-5,1,Cedi Osman,SAS,NYK,SAS,,,7,5,4,5
22023,1626224,22300146,"NOV 06, 2023",SAS @ IND,L,19,2,6,0.333,1,2,0.5,1,2,0.5,1,2,3,2,1,0,1,1,6,-22,1,Cedi Osman,SAS,IND,SAS,,,11,9,8,5
22023,1626224,22300141,"NOV 05, 2023",SAS vs. TOR,L,26,3,6,0.5,1,2,0.5,0,0,0.0,0,4,4,3,0,0,2,4,7,9,1,Cedi Osman,SAS,SAS,TOR,,,14,11,10,7
22023,1626224,22300131,"NOV 02, 2023",SAS @ PHX,W,22,5,8,0.625,3,6,0.5,0,0,0.0,0,2,2,1,1,0,0,1,13,-16,1,Cedi Osman,SAS,PHX,SAS,,,16,15,14,3
22023,1626224,22300113,"OCT 31, 2023",SAS @ PHX,W,19,4,7,0.571,1,2,0.5,0,1,0.0,0,2,2,1,1,0,0,0,9,6,1,Cedi Osman,SAS,PHX,SAS,,,12,11,10,3
22023,1626224,22300099,"OCT 29, 2023",SAS @ LAC,L,17,4,7,0.571,2,4,0.5,2,2,1.0,0,1,1,1,1,1,0,1,12,-5,1,Cedi Osman,SAS,LAC,SAS,,,14,13,13,2
22023,1626224,22300083,"OCT 27, 2023",SAS vs. HOU,W,23,5,7,0.714,4,6,0.667,0,0,0.0,0,2,2,1,0,0,3,1,14,9,1,Cedi Osman,SAS,SAS,HOU,,,17,16,15,3
22023,1626224,22300073,"OCT 25, 2023",SAS vs. DAL,L,22,5,10,0.5,2,6,0.333,0,0,0.0,0,0,0,2,0,1,0,2,12,-11,1,Cedi Osman,SAS,SAS,DAL,,,14,12,14,2
22023,1626162,22300555,"JAN 15, 2024",PHI vs. HOU,W,26,3,8,0.375,1,3,0.333,0,0,0.0,0,2,2,0,4,0,1,3,7,-12,1,Kelly Oubre Jr.,PHI,PHI,HOU,12.5,Points,9,9,7,2
22023,1626162,22300555,"JAN 15, 2024",PHI vs. HOU,W,26,3,8,0.375,1,3,0.333,0,0,0.0,0,2,2,0,4,0,1,3,7,-12,1,Kelly Oubre Jr.,PHI,PHI,HOU,4.0,Rebounds,9,9,7,2
22023,1626162,22300555,"JAN 15, 2024",PHI vs. HOU,W,26,3,8,0.375,1,3,0.333,0,0,0.0,0,2,2,0,4,0,1,3,7,-12,1,Kelly Oubre Jr.,PHI,PHI,HOU,18.5,Pts+Rebs+Asts,9,9,7,2
22023,1626162,22300555,"JAN 15, 2024",PHI vs. HOU,W,26,3,8,0.375,1,3,0.333,0,0,0.0,0,2,2,0,4,0,1,3,7,-12,1,Kelly Oubre Jr.,PHI,PHI,HOU,16.5,Pts+Rebs,9,9,7,2
22023,1626162,22300555,"JAN 15, 2024",PHI vs. HOU,W,26,3,8,0.375,1,3,0.333,0,0,0.0,0,2,2,0,4,0,1,3,7,-12,1,Kelly Oubre Jr.,PHI,PHI,HOU,13.5,Pts+Asts,9,9,7,2
22023,1626162,22300555,"JAN 15, 2024",PHI vs. HOU,W,26,3,8,0.375,1,3,0.333,0,0,0.0,0,2,2,0,4,0,1,3,7,-12,1,Kelly Oubre Jr.,PHI,PHI,HOU,1.5,3-PT Made,9,9,7,2
22023,1626162,22300521,"JAN 10, 2024",PHI @ ATL,L,32,3,11,0.273,0,3,0.0,1,2,0.5,0,3,3,2,1,0,1,3,7,-8,1,Kelly Oubre Jr.,PHI,ATL,PHI,12.5,Points,12,10,9,5
22023,1626162,22300521,"JAN 10, 2024",PHI @ ATL,L,32,3,11,0.273,0,3,0.0,1,2,0.5,0,3,3,2,1,0,1,3,7,-8,1,Kelly Oubre Jr.,PHI,ATL,PHI,4.0,Rebounds,12,10,9,5
22023,1626162,22300521,"JAN 10, 2024",PHI @ ATL,L,32,3,11,0.273,0,3,0.0,1,2,0.5,0,3,3,2,1,0,1,3,7,-8,1,Kelly Oubre Jr.,PHI,ATL,PHI,18.5,Pts+Rebs+Asts,12,10,9,5
22023,1626162,22300521,"JAN 10, 2024",PHI @ ATL,L,32,3,11,0.273,0,3,0.0,1,2,0.5,0,3,3,2,1,0,1,3,7,-8,1,Kelly Oubre Jr.,PHI,ATL,PHI,16.5,Pts+Rebs,12,10,9,5
22023,1626162,22300521,"JAN 10, 2024",PHI @ ATL,L,32,3,11,0.273,0,3,0.0,1,2,0.5,0,3,3,2,1,0,1,3,7,-8,1,Kelly Oubre Jr.,PHI,ATL,PHI,13.5,Pts+Asts,12,10,9,5
22023,1626162,22300521,"JAN 10, 2024",PHI @ ATL,L,32,3,11,0.273,0,3,0.0,1,2,0.5,0,3,3,2,1,0,1,3,7,-8,1,Kelly Oubre Jr.,PHI,ATL,PHI,1.5,3-PT Made,12,10,9,5
22023,1626162,22300495,"JAN 06, 2024",PHI vs. UTA,L,37,8,18,0.444,1,6,0.167,7,8,0.875,1,3,4,4,1,0,0,5,24,1,1,Kelly Oubre Jr.,PHI,PHI,UTA,12.5,Points,32,28,28,8
22023,1626162,22300495,"JAN 06, 2024",PHI vs. UTA,L,37,8,18,0.444,1,6,0.167,7,8,0.875,1,3,4,4,1,0,0,5,24,1,1,Kelly Oubre Jr.,PHI,PHI,UTA,4.0,Rebounds,32,28,28,8
22023,1626162,22300495,"JAN 06, 2024",PHI vs. UTA,L,37,8,18,0.444,1,6,0.167,7,8,0.875,1,3,4,4,1,0,0,5,24,1,1,Kelly Oubre Jr.,PHI,PHI,UTA,18.5,Pts+Rebs+Asts,32,28,28,8
22023,1626162,22300495,"JAN 06, 2024",PHI vs. UTA,L,37,8,18,0.444,1,6,0.167,7,8,0.875,1,3,4,4,1,0,0,5,24,1,1,Kelly Oubre Jr.,PHI,PHI,UTA,16.5,Pts+Rebs,32,28,28,8
22023,1626162,22300495,"JAN 06, 2024",PHI vs. UTA,L,37,8,18,0.444,1,6,0.167,7,8,0.875,1,3,4,4,1,0,0,5,24,1,1,Kelly Oubre Jr.,PHI,PHI,UTA,13.5,Pts+Asts,32,28,28,8
22023,1626162,22300495,"JAN 06, 2024",PHI vs. UTA,L,37,8,18,0.444,1,6,0.167,7,8,0.875,1,3,4,4,1,0,0,5,24,1,1,Kelly Oubre Jr.,PHI,PHI,UTA,1.5,3-PT Made,32,28,28,8
22023,1626162,22300483,"JAN 05, 2024",PHI vs. NYK,L,31,6,12,0.5,3,6,0.5,0,0,0.0,2,5,7,1,0,3,3,2,15,-20,1,Kelly Oubre Jr.,PHI,PHI,NYK,12.5,Points,23,22,16,8
22023,1626162,22300483,"JAN 05, 2024",PHI vs. NYK,L,31,6,12,0.5,3,6,0.5,0,0,0.0,2,5,7,1,0,3,3,2,15,-20,1,Kelly Oubre Jr.,PHI,PHI,NYK,4.0,Rebounds,23,22,16,8
22023,1626162,22300483,"JAN 05, 2024",PHI vs. NYK,L,31,6,12,0.5,3,6,0.5,0,0,0.0,2,5,7,1,0,3,3,2,15,-20,1,Kelly Oubre Jr.,PHI,PHI,NYK,18.5,Pts+Rebs+Asts,23,22,16,8
22023,1626162,22300483,"JAN 05, 2024",PHI vs. NYK,L,31,6,12,0.5,3,6,0.5,0,0,0.0,2,5,7,1,0,3,3,2,15,-20,1,Kelly Oubre Jr.,PHI,PHI,NYK,16.5,Pts+Rebs,23,22,16,8
22023,1626162,22300483,"JAN 05, 2024",PHI vs. NYK,L,31,6,12,0.5,3,6,0.5,0,0,0.0,2,5,7,1,0,3,3,2,15,-20,1,Kelly Oubre Jr.,PHI,PHI,NYK,13.5,Pts+Asts,23,22,16,8
22023,1626162,22300483,"JAN 05, 2024",PHI vs. NYK,L,31,6,12,0.5,3,6,0.5,0,0,0.0,2,5,7,1,0,3,3,2,15,-20,1,Kelly Oubre Jr.,PHI,PHI,NYK,1.5,3-PT Made,23,22,16,8
22023,1626162,22300459,"JAN 02, 2024",PHI vs. CHI,W,27,5,8,0.625,3,5,0.6,3,3,1.0,0,3,3,3,3,0,1,3,16,28,1,Kelly Oubre Jr.,PHI,PHI,CHI,12.5,Points,22,19,19,6
22023,1626162,22300459,"JAN 02, 2024",PHI vs. CHI,W,27,5,8,0.625,3,5,0.6,3,3,1.0,0,3,3,3,3,0,1,3,16,28,1,Kelly Oubre Jr.,PHI,PHI,CHI,4.0,Rebounds,22,19,19,6
22023,1626162,22300459,"JAN 02, 2024",PHI vs. CHI,W,27,5,8,0.625,3,5,0.6,3,3,1.0,0,3,3,3,3,0,1,3,16,28,1,Kelly Oubre Jr.,PHI,PHI,CHI,18.5,Pts+Rebs+Asts,22,19,19,6
22023,1626162,22300459,"JAN 02, 2024",PHI vs. CHI,W,27,5,8,0.625,3,5,0.6,3,3,1.0,0,3,3,3,3,0,1,3,16,28,1,Kelly Oubre Jr.,PHI,PHI,CHI,16.5,Pts+Rebs,22,19,19,6
22023,1626162,22300459,"JAN 02, 2024",PHI vs. CHI,W,27,5,8,0.625,3,5,0.6,3,3,1.0,0,3,3,3,3,0,1,3,16,28,1,Kelly Oubre Jr.,PHI,PHI,CHI,13.5,Pts+Asts,22,19,19,6
22023,1626162,22300459,"JAN 02, 2024",PHI vs. CHI,W,27,5,8,0.625,3,5,0.6,3,3,1.0,0,3,3,3,3,0,1,3,16,28,1,Kelly Oubre Jr.,PHI,PHI,CHI,1.5,3-PT Made,22,19,19,6
22023,1626162,22300442,"DEC 30, 2023",PHI @ CHI,L,28,5,13,0.385,0,5,0.0,1,1,1.0,3,2,5,2,2,1,0,2,11,-11,1,Kelly Oubre Jr.,PHI,CHI,PHI,12.5,Points,18,16,13,7
22023,1626162,22300442,"DEC 30, 2023",PHI @ CHI,L,28,5,13,0.385,0,5,0.0,1,1,1.0,3,2,5,2,2,1,0,2,11,-11,1,Kelly Oubre Jr.,PHI,CHI,PHI,4.0,Rebounds,18,16,13,7
22023,1626162,22300442,"DEC 30, 2023",PHI @ CHI,L,28,5,13,0.385,0,5,0.0,1,1,1.0,3,2,5,2,2,1,0,2,11,-11,1,Kelly Oubre Jr.,PHI,CHI,PHI,18.5,Pts+Rebs+Asts,18,16,13,7
22023,1626162,22300442,"DEC 30, 2023",PHI @ CHI,L,28,5,13,0.385,0,5,0.0,1,1,1.0,3,2,5,2,2,1,0,2,11,-11,1,Kelly Oubre Jr.,PHI,CHI,PHI,16.5,Pts+Rebs,18,16,13,7
22023,1626162,22300442,"DEC 30, 2023",PHI @ CHI,L,28,5,13,0.385,0,5,0.0,1,1,1.0,3,2,5,2,2,1,0,2,11,-11,1,Kelly Oubre Jr.,PHI,CHI,PHI,13.5,Pts+Asts,18,16,13,7
22023,1626162,22300442,"DEC 30, 2023",PHI @ CHI,L,28,5,13,0.385,0,5,0.0,1,1,1.0,3,2,5,2,2,1,0,2,11,-11,1,Kelly Oubre Jr.,PHI,CHI,PHI,1.5,3-PT Made,18,16,13,7
22023,1626162,22300434,"DEC 29, 2023",PHI @ HOU,W,24,4,7,0.571,3,4,0.75,2,2,1.0,0,1,1,1,0,0,3,1,13,-4,1,Kelly Oubre Jr.,PHI,HOU,PHI,12.5,Points,15,14,14,2
22023,1626162,22300434,"DEC 29, 2023",PHI @ HOU,W,24,4,7,0.571,3,4,0.75,2,2,1.0,0,1,1,1,0,0,3,1,13,-4,1,Kelly Oubre Jr.,PHI,HOU,PHI,4.0,Rebounds,15,14,14,2
22023,1626162,22300434,"DEC 29, 2023",PHI @ HOU,W,24,4,7,0.571,3,4,0.75,2,2,1.0,0,1,1,1,0,0,3,1,13,-4,1,Kelly Oubre Jr.,PHI,HOU,PHI,18.5,Pts+Rebs+Asts,15,14,14,2
22023,1626162,22300434,"DEC 29, 2023",PHI @ HOU,W,24,4,7,0.571,3,4,0.75,2,2,1.0,0,1,1,1,0,0,3,1,13,-4,1,Kelly Oubre Jr.,PHI,HOU,PHI,16.5,Pts+Rebs,15,14,14,2
22023,1626162,22300434,"DEC 29, 2023",PHI @ HOU,W,24,4,7,0.571,3,4,0.75,2,2,1.0,0,1,1,1,0,0,3,1,13,-4,1,Kelly Oubre Jr.,PHI,HOU,PHI,13.5,Pts+Asts,15,14,14,2
22023,1626162,22300434,"DEC 29, 2023",PHI @ HOU,W,24,4,7,0.571,3,4,0.75,2,2,1.0,0,1,1,1,0,0,3,1,13,-4,1,Kelly Oubre Jr.,PHI,HOU,PHI,1.5,3-PT Made,15,14,14,2
22023,1626162,22300415,"DEC 27, 2023",PHI @ ORL,W,29,1,7,0.143,1,4,0.25,1,2,0.5,1,3,4,1,2,2,1,1,4,16,1,Kelly Oubre Jr.,PHI,ORL,PHI,12.5,Points,9,8,5,5
22023,1626162,22300415,"DEC 27, 2023",PHI @ ORL,W,29,1,7,0.143,1,4,0.25,1,2,0.5,1,3,4,1,2,2,1,1,4,16,1,Kelly Oubre Jr.,PHI,ORL,PHI,4.0,Rebounds,9,8,5,5
22023,1626162,22300415,"DEC 27, 2023",PHI @ ORL,W,29,1,7,0.143,1,4,0.25,1,2,0.5,1,3,4,1,2,2,1,1,4,16,1,Kelly Oubre Jr.,PHI,ORL,PHI,18.5,Pts+Rebs+Asts,9,8,5,5
22023,1626162,22300415,"DEC 27, 2023",PHI @ ORL,W,29,1,7,0.143,1,4,0.25,1,2,0.5,1,3,4,1,2,2,1,1,4,16,1,Kelly Oubre Jr.,PHI,ORL,PHI,16.5,Pts+Rebs,9,8,5,5
22023,1626162,22300415,"DEC 27, 2023",PHI @ ORL,W,29,1,7,0.143,1,4,0.25,1,2,0.5,1,3,4,1,2,2,1,1,4,16,1,Kelly Oubre Jr.,PHI,ORL,PHI,13.5,Pts+Asts,9,8,5,5
22023,1626162,22300415,"DEC 27, 2023",PHI @ ORL,W,29,1,7,0.143,1,4,0.25,1,2,0.5,1,3,4,1,2,2,1,1,4,16,1,Kelly Oubre Jr.,PHI,ORL,PHI,1.5,3-PT Made,9,8,5,5
22023,1626162,22300404,"DEC 25, 2023",PHI @ MIA,L,40,9,16,0.563,6,9,0.667,1,3,0.333,1,6,7,3,1,1,1,3,25,10,1,Kelly Oubre Jr.,PHI,MIA,PHI,12.5,Points,35,32,28,10
22023,1626162,22300404,"DEC 25, 2023",PHI @ MIA,L,40,9,16,0.563,6,9,0.667,1,3,0.333,1,6,7,3,1,1,1,3,25,10,1,Kelly Oubre Jr.,PHI,MIA,PHI,4.0,Rebounds,35,32,28,10
22023,1626162,22300404,"DEC 25, 2023",PHI @ MIA,L,40,9,16,0.563,6,9,0.667,1,3,0.333,1,6,7,3,1,1,1,3,25,10,1,Kelly Oubre Jr.,PHI,MIA,PHI,18.5,Pts+Rebs+Asts,35,32,28,10
22023,1626162,22300404,"DEC 25, 2023",PHI @ MIA,L,40,9,16,0.563,6,9,0.667,1,3,0.333,1,6,7,3,1,1,1,3,25,10,1,Kelly Oubre Jr.,PHI,MIA,PHI,16.5,Pts+Rebs,35,32,28,10
22023,1626162,22300404,"DEC 25, 2023",PHI @ MIA,L,40,9,16,0.563,6,9,0.667,1,3,0.333,1,6,7,3,1,1,1,3,25,10,1,Kelly Oubre Jr.,PHI,MIA,PHI,13.5,Pts+Asts,35,32,28,10
22023,1626162,22300404,"DEC 25, 2023",PHI @ MIA,L,40,9,16,0.563,6,9,0.667,1,3,0.333,1,6,7,3,1,1,1,3,25,10,1,Kelly Oubre Jr.,PHI,MIA,PHI,1.5,3-PT Made,35,32,28,10
22023,1626162,22300382,"DEC 22, 2023",PHI vs. TOR,W,26,3,9,0.333,2,6,0.333,0,0,0.0,0,3,3,0,1,0,0,4,8,-5,1,Kelly Oubre Jr.,PHI,PHI,TOR,12.5,Points,11,11,8,3
22023,1626162,22300382,"DEC 22, 2023",PHI vs. TOR,W,26,3,9,0.333,2,6,0.333,0,0,0.0,0,3,3,0,1,0,0,4,8,-5,1,Kelly Oubre Jr.,PHI,PHI,TOR,4.0,Rebounds,11,11,8,3
22023,1626162,22300382,"DEC 22, 2023",PHI vs. TOR,W,26,3,9,0.333,2,6,0.333,0,0,0.0,0,3,3,0,1,0,0,4,8,-5,1,Kelly Oubre Jr.,PHI,PHI,TOR,18.5,Pts+Rebs+Asts,11,11,8,3
22023,1626162,22300382,"DEC 22, 2023",PHI vs. TOR,W,26,3,9,0.333,2,6,0.333,0,0,0.0,0,3,3,0,1,0,0,4,8,-5,1,Kelly Oubre Jr.,PHI,PHI,TOR,16.5,Pts+Rebs,11,11,8,3
22023,1626162,22300382,"DEC 22, 2023",PHI vs. TOR,W,26,3,9,0.333,2,6,0.333,0,0,0.0,0,3,3,0,1,0,0,4,8,-5,1,Kelly Oubre Jr.,PHI,PHI,TOR,13.5,Pts+Asts,11,11,8,3
22023,1626162,22300382,"DEC 22, 2023",PHI vs. TOR,W,26,3,9,0.333,2,6,0.333,0,0,0.0,0,3,3,0,1,0,0,4,8,-5,1,Kelly Oubre Jr.,PHI,PHI,TOR,1.5,3-PT Made,11,11,8,3
22023,1626162,22300367,"DEC 20, 2023",PHI vs. MIN,W,29,3,6,0.5,1,3,0.333,0,1,0.0,0,2,2,0,2,0,1,3,7,-7,1,Kelly Oubre Jr.,PHI,PHI,MIN,12.5,Points,9,9,7,2
22023,1626162,22300367,"DEC 20, 2023",PHI vs. MIN,W,29,3,6,0.5,1,3,0.333,0,1,0.0,0,2,2,0,2,0,1,3,7,-7,1,Kelly Oubre Jr.,PHI,PHI,MIN,4.0,Rebounds,9,9,7,2
22023,1626162,22300367,"DEC 20, 2023",PHI vs. MIN,W,29,3,6,0.5,1,3,0.333,0,1,0.0,0,2,2,0,2,0,1,3,7,-7,1,Kelly Oubre Jr.,PHI,PHI,MIN,18.5,Pts+Rebs+Asts,9,9,7,2
22023,1626162,22300367,"DEC 20, 2023",PHI vs. MIN,W,29,3,6,0.5,1,3,0.333,0,1,0.0,0,2,2,0,2,0,1,3,7,-7,1,Kelly Oubre Jr.,PHI,PHI,MIN,16.5,Pts+Rebs,9,9,7,2
22023,1626162,22300367,"DEC 20, 2023",PHI vs. MIN,W,29,3,6,0.5,1,3,0.333,0,1,0.0,0,2,2,0,2,0,1,3,7,-7,1,Kelly Oubre Jr.,PHI,PHI,MIN,13.5,Pts+Asts,9,9,7,2
22023,1626162,22300367,"DEC 20, 2023",PHI vs. MIN,W,29,3,6,0.5,1,3,0.333,0,1,0.0,0,2,2,0,2,0,1,3,7,-7,1,Kelly Oubre Jr.,PHI,PHI,MIN,1.5,3-PT Made,9,9,7,2
22023,1626162,22300351,"DEC 18, 2023",PHI vs. CHI,L,24,2,10,0.2,1,5,0.2,1,2,0.5,0,3,3,0,1,0,0,3,6,-10,1,Kelly Oubre Jr.,PHI,PHI,CHI,12.5,Points,9,9,6,3
22023,1626162,22300351,"DEC 18, 2023",PHI vs. CHI,L,24,2,10,0.2,1,5,0.2,1,2,0.5,0,3,3,0,1,0,0,3,6,-10,1,Kelly Oubre Jr.,PHI,PHI,CHI,4.0,Rebounds,9,9,6,3
22023,1626162,22300351,"DEC 18, 2023",PHI vs. CHI,L,24,2,10,0.2,1,5,0.2,1,2,0.5,0,3,3,0,1,0,0,3,6,-10,1,Kelly Oubre Jr.,PHI,PHI,CHI,18.5,Pts+Rebs+Asts,9,9,6,3
22023,1626162,22300351,"DEC 18, 2023",PHI vs. CHI,L,24,2,10,0.2,1,5,0.2,1,2,0.5,0,3,3,0,1,0,0,3,6,-10,1,Kelly Oubre Jr.,PHI,PHI,CHI,16.5,Pts+Rebs,9,9,6,3
22023,1626162,22300351,"DEC 18, 2023",PHI vs. CHI,L,24,2,10,0.2,1,5,0.2,1,2,0.5,0,3,3,0,1,0,0,3,6,-10,1,Kelly Oubre Jr.,PHI,PHI,CHI,13.5,Pts+Asts,9,9,6,3
22023,1626162,22300351,"DEC 18, 2023",PHI vs. CHI,L,24,2,10,0.2,1,5,0.2,1,2,0.5,0,3,3,0,1,0,0,3,6,-10,1,Kelly Oubre Jr.,PHI,PHI,CHI,1.5,3-PT Made,9,9,6,3
22023,1626162,22300335,"DEC 16, 2023",PHI @ CHA,W,21,5,10,0.5,2,5,0.4,0,0,0.0,2,2,4,0,0,0,1,2,12,27,1,Kelly Oubre Jr.,PHI,CHA,PHI,12.5,Points,16,16,12,4
22023,1626162,22300335,"DEC 16, 2023",PHI @ CHA,W,21,5,10,0.5,2,5,0.4,0,0,0.0,2,2,4,0,0,0,1,2,12,27,1,Kelly Oubre Jr.,PHI,CHA,PHI,4.0,Rebounds,16,16,12,4
22023,1626162,22300335,"DEC 16, 2023",PHI @ CHA,W,21,5,10,0.5,2,5,0.4,0,0,0.0,2,2,4,0,0,0,1,2,12,27,1,Kelly Oubre Jr.,PHI,CHA,PHI,18.5,Pts+Rebs+Asts,16,16,12,4
22023,1626162,22300335,"DEC 16, 2023",PHI @ CHA,W,21,5,10,0.5,2,5,0.4,0,0,0.0,2,2,4,0,0,0,1,2,12,27,1,Kelly Oubre Jr.,PHI,CHA,PHI,16.5,Pts+Rebs,16,16,12,4
22023,1626162,22300335,"DEC 16, 2023",PHI @ CHA,W,21,5,10,0.5,2,5,0.4,0,0,0.0,2,2,4,0,0,0,1,2,12,27,1,Kelly Oubre Jr.,PHI,CHA,PHI,13.5,Pts+Asts,16,16,12,4
22023,1626162,22300335,"DEC 16, 2023",PHI @ CHA,W,21,5,10,0.5,2,5,0.4,0,0,0.0,2,2,4,0,0,0,1,2,12,27,1,Kelly Oubre Jr.,PHI,CHA,PHI,1.5,3-PT Made,16,16,12,4
22023,1626162,22300327,"DEC 15, 2023",PHI vs. DET,W,17,4,11,0.364,1,5,0.2,2,2,1.0,1,2,3,1,0,0,0,3,11,6,1,Kelly Oubre Jr.,PHI,PHI,DET,12.5,Points,15,14,12,4
22023,1626162,22300327,"DEC 15, 2023",PHI vs. DET,W,17,4,11,0.364,1,5,0.2,2,2,1.0,1,2,3,1,0,0,0,3,11,6,1,Kelly Oubre Jr.,PHI,PHI,DET,4.0,Rebounds,15,14,12,4
22023,1626162,22300327,"DEC 15, 2023",PHI vs. DET,W,17,4,11,0.364,1,5,0.2,2,2,1.0,1,2,3,1,0,0,0,3,11,6,1,Kelly Oubre Jr.,PHI,PHI,DET,18.5,Pts+Rebs+Asts,15,14,12,4
22023,1626162,22300327,"DEC 15, 2023",PHI vs. DET,W,17,4,11,0.364,1,5,0.2,2,2,1.0,1,2,3,1,0,0,0,3,11,6,1,Kelly Oubre Jr.,PHI,PHI,DET,16.5,Pts+Rebs,15,14,12,4
22023,1626162,22300327,"DEC 15, 2023",PHI vs. DET,W,17,4,11,0.364,1,5,0.2,2,2,1.0,1,2,3,1,0,0,0,3,11,6,1,Kelly Oubre Jr.,PHI,PHI,DET,13.5,Pts+Asts,15,14,12,4
22023,1626162,22300327,"DEC 15, 2023",PHI vs. DET,W,17,4,11,0.364,1,5,0.2,2,2,1.0,1,2,3,1,0,0,0,3,11,6,1,Kelly Oubre Jr.,PHI,PHI,DET,1.5,3-PT Made,15,14,12,4
22023,1626162,22300310,"DEC 13, 2023",PHI @ DET,W,23,7,9,0.778,2,4,0.5,1,2,0.5,0,3,3,1,2,0,2,2,17,18,1,Kelly Oubre Jr.,PHI,DET,PHI,12.5,Points,21,20,18,4
22023,1626162,22300310,"DEC 13, 2023",PHI @ DET,W,23,7,9,0.778,2,4,0.5,1,2,0.5,0,3,3,1,2,0,2,2,17,18,1,Kelly Oubre Jr.,PHI,DET,PHI,4.0,Rebounds,21,20,18,4
22023,1626162,22300310,"DEC 13, 2023",PHI @ DET,W,23,7,9,0.778,2,4,0.5,1,2,0.5,0,3,3,1,2,0,2,2,17,18,1,Kelly Oubre Jr.,PHI,DET,PHI,18.5,Pts+Rebs+Asts,21,20,18,4
22023,1626162,22300310,"DEC 13, 2023",PHI @ DET,W,23,7,9,0.778,2,4,0.5,1,2,0.5,0,3,3,1,2,0,2,2,17,18,1,Kelly Oubre Jr.,PHI,DET,PHI,16.5,Pts+Rebs,21,20,18,4
22023,1626162,22300310,"DEC 13, 2023",PHI @ DET,W,23,7,9,0.778,2,4,0.5,1,2,0.5,0,3,3,1,2,0,2,2,17,18,1,Kelly Oubre Jr.,PHI,DET,PHI,13.5,Pts+Asts,21,20,18,4
22023,1626162,22300310,"DEC 13, 2023",PHI @ DET,W,23,7,9,0.778,2,4,0.5,1,2,0.5,0,3,3,1,2,0,2,2,17,18,1,Kelly Oubre Jr.,PHI,DET,PHI,1.5,3-PT Made,21,20,18,4
22023,1626162,22300295,"DEC 11, 2023",PHI vs. WAS,W,18,3,8,0.375,1,4,0.25,0,0,0.0,1,4,5,1,1,0,0,3,7,23,1,Kelly Oubre Jr.,PHI,PHI,WAS,12.5,Points,13,12,8,6
22023,1626162,22300295,"DEC 11, 2023",PHI vs. WAS,W,18,3,8,0.375,1,4,0.25,0,0,0.0,1,4,5,1,1,0,0,3,7,23,1,Kelly Oubre Jr.,PHI,PHI,WAS,4.0,Rebounds,13,12,8,6
22023,1626162,22300295,"DEC 11, 2023",PHI vs. WAS,W,18,3,8,0.375,1,4,0.25,0,0,0.0,1,4,5,1,1,0,0,3,7,23,1,Kelly Oubre Jr.,PHI,PHI,WAS,18.5,Pts+Rebs+Asts,13,12,8,6
22023,1626162,22300295,"DEC 11, 2023",PHI vs. WAS,W,18,3,8,0.375,1,4,0.25,0,0,0.0,1,4,5,1,1,0,0,3,7,23,1,Kelly Oubre Jr.,PHI,PHI,WAS,16.5,Pts+Rebs,13,12,8,6
22023,1626162,22300295,"DEC 11, 2023",PHI vs. WAS,W,18,3,8,0.375,1,4,0.25,0,0,0.0,1,4,5,1,1,0,0,3,7,23,1,Kelly Oubre Jr.,PHI,PHI,WAS,13.5,Pts+Asts,13,12,8,6
22023,1626162,22300295,"DEC 11, 2023",PHI vs. WAS,W,18,3,8,0.375,1,4,0.25,0,0,0.0,1,4,5,1,1,0,0,3,7,23,1,Kelly Oubre Jr.,PHI,PHI,WAS,1.5,3-PT Made,13,12,8,6
22023,1626162,22301218,"DEC 08, 2023",PHI vs. ATL,W,24,4,9,0.444,1,4,0.25,2,4,0.5,2,1,3,1,2,1,0,1,11,1,1,Kelly Oubre Jr.,PHI,PHI,ATL,12.5,Points,15,14,12,4
22023,1626162,22301218,"DEC 08, 2023",PHI vs. ATL,W,24,4,9,0.444,1,4,0.25,2,4,0.5,2,1,3,1,2,1,0,1,11,1,1,Kelly Oubre Jr.,PHI,PHI,ATL,4.0,Rebounds,15,14,12,4
22023,1626162,22301218,"DEC 08, 2023",PHI vs. ATL,W,24,4,9,0.444,1,4,0.25,2,4,0.5,2,1,3,1,2,1,0,1,11,1,1,Kelly Oubre Jr.,PHI,PHI,ATL,18.5,Pts+Rebs+Asts,15,14,12,4
22023,1626162,22301218,"DEC 08, 2023",PHI vs. ATL,W,24,4,9,0.444,1,4,0.25,2,4,0.5,2,1,3,1,2,1,0,1,11,1,1,Kelly Oubre Jr.,PHI,PHI,ATL,16.5,Pts+Rebs,15,14,12,4
22023,1626162,22301218,"DEC 08, 2023",PHI vs. ATL,W,24,4,9,0.444,1,4,0.25,2,4,0.5,2,1,3,1,2,1,0,1,11,1,1,Kelly Oubre Jr.,PHI,PHI,ATL,13.5,Pts+Asts,15,14,12,4
22023,1626162,22301218,"DEC 08, 2023",PHI vs. ATL,W,24,4,9,0.444,1,4,0.25,2,4,0.5,2,1,3,1,2,1,0,1,11,1,1,Kelly Oubre Jr.,PHI,PHI,ATL,1.5,3-PT Made,15,14,12,4
22023,1626162,22301208,"DEC 06, 2023",PHI @ WAS,W,19,5,8,0.625,1,3,0.333,1,1,1.0,1,2,3,1,0,0,1,1,12,-3,1,Kelly Oubre Jr.,PHI,WAS,PHI,12.5,Points,16,15,13,4
22023,1626162,22301208,"DEC 06, 2023",PHI @ WAS,W,19,5,8,0.625,1,3,0.333,1,1,1.0,1,2,3,1,0,0,1,1,12,-3,1,Kelly Oubre Jr.,PHI,WAS,PHI,4.0,Rebounds,16,15,13,4
22023,1626162,22301208,"DEC 06, 2023",PHI @ WAS,W,19,5,8,0.625,1,3,0.333,1,1,1.0,1,2,3,1,0,0,1,1,12,-3,1,Kelly Oubre Jr.,PHI,WAS,PHI,18.5,Pts+Rebs+Asts,16,15,13,4
22023,1626162,22301208,"DEC 06, 2023",PHI @ WAS,W,19,5,8,0.625,1,3,0.333,1,1,1.0,1,2,3,1,0,0,1,1,12,-3,1,Kelly Oubre Jr.,PHI,WAS,PHI,16.5,Pts+Rebs,16,15,13,4
22023,1626162,22301208,"DEC 06, 2023",PHI @ WAS,W,19,5,8,0.625,1,3,0.333,1,1,1.0,1,2,3,1,0,0,1,1,12,-3,1,Kelly Oubre Jr.,PHI,WAS,PHI,13.5,Pts+Asts,16,15,13,4
22023,1626162,22301208,"DEC 06, 2023",PHI @ WAS,W,19,5,8,0.625,1,3,0.333,1,1,1.0,1,2,3,1,0,0,1,1,12,-3,1,Kelly Oubre Jr.,PHI,WAS,PHI,1.5,3-PT Made,16,15,13,4
22023,1626162,22300008,"NOV 10, 2023",PHI @ DET,W,26,3,9,0.333,0,3,0.0,2,3,0.667,2,6,8,1,2,0,0,3,8,7,1,Kelly Oubre Jr.,PHI,DET,PHI,12.5,Points,17,16,9,9
22023,1626162,22300008,"NOV 10, 2023",PHI @ DET,W,26,3,9,0.333,0,3,0.0,2,3,0.667,2,6,8,1,2,0,0,3,8,7,1,Kelly Oubre Jr.,PHI,DET,PHI,4.0,Rebounds,17,16,9,9
22023,1626162,22300008,"NOV 10, 2023",PHI @ DET,W,26,3,9,0.333,0,3,0.0,2,3,0.667,2,6,8,1,2,0,0,3,8,7,1,Kelly Oubre Jr.,PHI,DET,PHI,18.5,Pts+Rebs+Asts,17,16,9,9
22023,1626162,22300008,"NOV 10, 2023",PHI @ DET,W,26,3,9,0.333,0,3,0.0,2,3,0.667,2,6,8,1,2,0,0,3,8,7,1,Kelly Oubre Jr.,PHI,DET,PHI,16.5,Pts+Rebs,17,16,9,9
22023,1626162,22300008,"NOV 10, 2023",PHI @ DET,W,26,3,9,0.333,0,3,0.0,2,3,0.667,2,6,8,1,2,0,0,3,8,7,1,Kelly Oubre Jr.,PHI,DET,PHI,13.5,Pts+Asts,17,16,9,9
22023,1626162,22300008,"NOV 10, 2023",PHI @ DET,W,26,3,9,0.333,0,3,0.0,2,3,0.667,2,6,8,1,2,0,0,3,8,7,1,Kelly Oubre Jr.,PHI,DET,PHI,1.5,3-PT Made,17,16,9,9
22023,1626162,22300159,"NOV 08, 2023",PHI vs. BOS,W,27,6,11,0.545,1,3,0.333,1,2,0.5,1,7,8,1,1,0,0,0,14,2,1,Kelly Oubre Jr.,PHI,PHI,BOS,12.5,Points,23,22,15,9
22023,1626162,22300159,"NOV 08, 2023",PHI vs. BOS,W,27,6,11,0.545,1,3,0.333,1,2,0.5,1,7,8,1,1,0,0,0,14,2,1,Kelly Oubre Jr.,PHI,PHI,BOS,4.0,Rebounds,23,22,15,9
22023,1626162,22300159,"NOV 08, 2023",PHI vs. BOS,W,27,6,11,0.545,1,3,0.333,1,2,0.5,1,7,8,1,1,0,0,0,14,2,1,Kelly Oubre Jr.,PHI,PHI,BOS,18.5,Pts+Rebs+Asts,23,22,15,9
22023,1626162,22300159,"NOV 08, 2023",PHI vs. BOS,W,27,6,11,0.545,1,3,0.333,1,2,0.5,1,7,8,1,1,0,0,0,14,2,1,Kelly Oubre Jr.,PHI,PHI,BOS,16.5,Pts+Rebs,23,22,15,9
22023,1626162,22300159,"NOV 08, 2023",PHI vs. BOS,W,27,6,11,0.545,1,3,0.333,1,2,0.5,1,7,8,1,1,0,0,0,14,2,1,Kelly Oubre Jr.,PHI,PHI,BOS,13.5,Pts+Asts,23,22,15,9
22023,1626162,22300159,"NOV 08, 2023",PHI vs. BOS,W,27,6,11,0.545,1,3,0.333,1,2,0.5,1,7,8,1,1,0,0,0,14,2,1,Kelly Oubre Jr.,PHI,PHI,BOS,1.5,3-PT Made,23,22,15,9
22023,1626162,22300148,"NOV 06, 2023",PHI vs. WAS,W,27,1,5,0.2,0,2,0.0,1,2,0.5,1,4,5,1,1,1,3,2,3,-4,1,Kelly Oubre Jr.,PHI,PHI,WAS,12.5,Points,9,8,4,6
22023,1626162,22300148,"NOV 06, 2023",PHI vs. WAS,W,27,1,5,0.2,0,2,0.0,1,2,0.5,1,4,5,1,1,1,3,2,3,-4,1,Kelly Oubre Jr.,PHI,PHI,WAS,4.0,Rebounds,9,8,4,6
22023,1626162,22300148,"NOV 06, 2023",PHI vs. WAS,W,27,1,5,0.2,0,2,0.0,1,2,0.5,1,4,5,1,1,1,3,2,3,-4,1,Kelly Oubre Jr.,PHI,PHI,WAS,18.5,Pts+Rebs+Asts,9,8,4,6
22023,1626162,22300148,"NOV 06, 2023",PHI vs. WAS,W,27,1,5,0.2,0,2,0.0,1,2,0.5,1,4,5,1,1,1,3,2,3,-4,1,Kelly Oubre Jr.,PHI,PHI,WAS,16.5,Pts+Rebs,9,8,4,6
22023,1626162,22300148,"NOV 06, 2023",PHI vs. WAS,W,27,1,5,0.2,0,2,0.0,1,2,0.5,1,4,5,1,1,1,3,2,3,-4,1,Kelly Oubre Jr.,PHI,PHI,WAS,13.5,Pts+Asts,9,8,4,6
22023,1626162,22300148,"NOV 06, 2023",PHI vs. WAS,W,27,1,5,0.2,0,2,0.0,1,2,0.5,1,4,5,1,1,1,3,2,3,-4,1,Kelly Oubre Jr.,PHI,PHI,WAS,1.5,3-PT Made,9,8,4,6
22023,1626162,22300132,"NOV 04, 2023",PHI vs. PHX,W,35,10,18,0.556,3,7,0.429,2,3,0.667,0,3,3,0,0,1,0,3,25,11,1,Kelly Oubre Jr.,PHI,PHI,PHX,12.5,Points,28,28,25,3
22023,1626162,22300132,"NOV 04, 2023",PHI vs. PHX,W,35,10,18,0.556,3,7,0.429,2,3,0.667,0,3,3,0,0,1,0,3,25,11,1,Kelly Oubre Jr.,PHI,PHI,PHX,4.0,Rebounds,28,28,25,3
22023,1626162,22300132,"NOV 04, 2023",PHI vs. PHX,W,35,10,18,0.556,3,7,0.429,2,3,0.667,0,3,3,0,0,1,0,3,25,11,1,Kelly Oubre Jr.,PHI,PHI,PHX,18.5,Pts+Rebs+Asts,28,28,25,3
22023,1626162,22300132,"NOV 04, 2023",PHI vs. PHX,W,35,10,18,0.556,3,7,0.429,2,3,0.667,0,3,3,0,0,1,0,3,25,11,1,Kelly Oubre Jr.,PHI,PHI,PHX,16.5,Pts+Rebs,28,28,25,3
22023,1626162,22300132,"NOV 04, 2023",PHI vs. PHX,W,35,10,18,0.556,3,7,0.429,2,3,0.667,0,3,3,0,0,1,0,3,25,11,1,Kelly Oubre Jr.,PHI,PHI,PHX,13.5,Pts+Asts,28,28,25,3
22023,1626162,22300132,"NOV 04, 2023",PHI vs. PHX,W,35,10,18,0.556,3,7,0.429,2,3,0.667,0,3,3,0,0,1,0,3,25,11,1,Kelly Oubre Jr.,PHI,PHI,PHX,1.5,3-PT Made,28,28,25,3
22023,1626162,22300128,"NOV 02, 2023",PHI vs. TOR,W,30,8,13,0.615,5,6,0.833,2,3,0.667,3,2,5,0,1,0,0,3,23,8,1,Kelly Oubre Jr.,PHI,PHI,TOR,12.5,Points,28,28,23,5
22023,1626162,22300128,"NOV 02, 2023",PHI vs. TOR,W,30,8,13,0.615,5,6,0.833,2,3,0.667,3,2,5,0,1,0,0,3,23,8,1,Kelly Oubre Jr.,PHI,PHI,TOR,4.0,Rebounds,28,28,23,5
22023,1626162,22300128,"NOV 02, 2023",PHI vs. TOR,W,30,8,13,0.615,5,6,0.833,2,3,0.667,3,2,5,0,1,0,0,3,23,8,1,Kelly Oubre Jr.,PHI,PHI,TOR,18.5,Pts+Rebs+Asts,28,28,23,5
22023,1626162,22300128,"NOV 02, 2023",PHI vs. TOR,W,30,8,13,0.615,5,6,0.833,2,3,0.667,3,2,5,0,1,0,0,3,23,8,1,Kelly Oubre Jr.,PHI,PHI,TOR,16.5,Pts+Rebs,28,28,23,5
22023,1626162,22300128,"NOV 02, 2023",PHI vs. TOR,W,30,8,13,0.615,5,6,0.833,2,3,0.667,3,2,5,0,1,0,0,3,23,8,1,Kelly Oubre Jr.,PHI,PHI,TOR,13.5,Pts+Asts,28,28,23,5
22023,1626162,22300128,"NOV 02, 2023",PHI vs. TOR,W,30,8,13,0.615,5,6,0.833,2,3,0.667,3,2,5,0,1,0,0,3,23,8,1,Kelly Oubre Jr.,PHI,PHI,TOR,1.5,3-PT Made,28,28,23,5
22023,1626162,22300098,"OCT 29, 2023",PHI vs. POR,W,26,3,10,0.3,0,4,0.0,6,6,1.0,1,2,3,0,2,1,1,1,12,-1,1,Kelly Oubre Jr.,PHI,PHI,POR,12.5,Points,15,15,12,3
22023,1626162,22300098,"OCT 29, 2023",PHI vs. POR,W,26,3,10,0.3,0,4,0.0,6,6,1.0,1,2,3,0,2,1,1,1,12,-1,1,Kelly Oubre Jr.,PHI,PHI,POR,4.0,Rebounds,15,15,12,3
22023,1626162,22300098,"OCT 29, 2023",PHI vs. POR,W,26,3,10,0.3,0,4,0.0,6,6,1.0,1,2,3,0,2,1,1,1,12,-1,1,Kelly Oubre Jr.,PHI,PHI,POR,18.5,Pts+Rebs+Asts,15,15,12,3
22023,1626162,22300098,"OCT 29, 2023",PHI vs. POR,W,26,3,10,0.3,0,4,0.0,6,6,1.0,1,2,3,0,2,1,1,1,12,-1,1,Kelly Oubre Jr.,PHI,PHI,POR,16.5,Pts+Rebs,15,15,12,3
22023,1626162,22300098,"OCT 29, 2023",PHI vs. POR,W,26,3,10,0.3,0,4,0.0,6,6,1.0,1,2,3,0,2,1,1,1,12,-1,1,Kelly Oubre Jr.,PHI,PHI,POR,13.5,Pts+Asts,15,15,12,3
22023,1626162,22300098,"OCT 29, 2023",PHI vs. POR,W,26,3,10,0.3,0,4,0.0,6,6,1.0,1,2,3,0,2,1,1,1,12,-1,1,Kelly Oubre Jr.,PHI,PHI,POR,1.5,3-PT Made,15,15,12,3
22023,1626162,22300092,"OCT 28, 2023",PHI @ TOR,W,29,7,17,0.412,0,6,0.0,4,5,0.8,2,3,5,2,3,0,0,3,18,3,1,Kelly Oubre Jr.,PHI,TOR,PHI,12.5,Points,25,23,20,7
22023,1626162,22300092,"OCT 28, 2023",PHI @ TOR,W,29,7,17,0.412,0,6,0.0,4,5,0.8,2,3,5,2,3,0,0,3,18,3,1,Kelly Oubre Jr.,PHI,TOR,PHI,4.0,Rebounds,25,23,20,7
22023,1626162,22300092,"OCT 28, 2023",PHI @ TOR,W,29,7,17,0.412,0,6,0.0,4,5,0.8,2,3,5,2,3,0,0,3,18,3,1,Kelly Oubre Jr.,PHI,TOR,PHI,18.5,Pts+Rebs+Asts,25,23,20,7
22023,1626162,22300092,"OCT 28, 2023",PHI @ TOR,W,29,7,17,0.412,0,6,0.0,4,5,0.8,2,3,5,2,3,0,0,3,18,3,1,Kelly Oubre Jr.,PHI,TOR,PHI,16.5,Pts+Rebs,25,23,20,7
22023,1626162,22300092,"OCT 28, 2023",PHI @ TOR,W,29,7,17,0.412,0,6,0.0,4,5,0.8,2,3,5,2,3,0,0,3,18,3,1,Kelly Oubre Jr.,PHI,TOR,PHI,13.5,Pts+Asts,25,23,20,7
22023,1626162,22300092,"OCT 28, 2023",PHI @ TOR,W,29,7,17,0.412,0,6,0.0,4,5,0.8,2,3,5,2,3,0,0,3,18,3,1,Kelly Oubre Jr.,PHI,TOR,PHI,1.5,3-PT Made,25,23,20,7
22023,1626162,22300075,"OCT 26, 2023",PHI @ MIL,L,32,9,11,0.818,5,6,0.833,4,4,1.0,1,3,4,0,1,0,3,4,27,14,1,Kelly Oubre Jr.,PHI,MIL,PHI,12.5,Points,31,31,27,4
22023,1626162,22300075,"OCT 26, 2023",PHI @ MIL,L,32,9,11,0.818,5,6,0.833,4,4,1.0,1,3,4,0,1,0,3,4,27,14,1,Kelly Oubre Jr.,PHI,MIL,PHI,4.0,Rebounds,31,31,27,4
22023,1626162,22300075,"OCT 26, 2023",PHI @ MIL,L,32,9,11,0.818,5,6,0.833,4,4,1.0,1,3,4,0,1,0,3,4,27,14,1,Kelly Oubre Jr.,PHI,MIL,PHI,18.5,Pts+Rebs+Asts,31,31,27,4
22023,1626162,22300075,"OCT 26, 2023",PHI @ MIL,L,32,9,11,0.818,5,6,0.833,4,4,1.0,1,3,4,0,1,0,3,4,27,14,1,Kelly Oubre Jr.,PHI,MIL,PHI,16.5,Pts+Rebs,31,31,27,4
22023,1626162,22300075,"OCT 26, 2023",PHI @ MIL,L,32,9,11,0.818,5,6,0.833,4,4,1.0,1,3,4,0,1,0,3,4,27,14,1,Kelly Oubre Jr.,PHI,MIL,PHI,13.5,Pts+Asts,31,31,27,4
22023,1626162,22300075,"OCT 26, 2023",PHI @ MIL,L,32,9,11,0.818,5,6,0.833,4,4,1.0,1,3,4,0,1,0,3,4,27,14,1,Kelly Oubre Jr.,PHI,MIL,PHI,1.5,3-PT Made,31,31,27,4
22023,101108,22300490,"JAN 05, 2024",GSW vs. DET,W,24,3,5,0.6,2,4,0.5,0,1,0.0,0,6,6,4,0,1,1,2,8,2,1,Chris Paul,GSW,GSW,DET,,,18,14,12,10
22023,101108,22300478,"JAN 04, 2024",GSW vs. DEN,L,30,4,7,0.571,1,3,0.333,0,1,0.0,1,3,4,6,0,0,0,2,9,4,1,Chris Paul,GSW,GSW,DEN,,,19,13,15,10
22023,101108,22300463,"JAN 02, 2024",GSW vs. ORL,W,30,3,5,0.6,3,3,1.0,3,4,0.75,0,2,2,4,0,0,1,1,12,-8,1,Chris Paul,GSW,GSW,ORL,,,18,14,16,6
22023,101108,22300444,"DEC 30, 2023",GSW vs. DAL,L,33,9,14,0.643,6,9,0.667,0,0,0.0,0,2,2,6,2,1,0,2,24,-10,1,Chris Paul,GSW,GSW,DAL,,,32,26,30,8
22023,101108,22300426,"DEC 28, 2023",GSW vs. MIA,L,27,3,6,0.5,1,4,0.25,2,2,1.0,0,4,4,4,0,0,3,4,9,-8,1,Chris Paul,GSW,GSW,MIA,,,17,13,13,8
22023,101108,22300402,"DEC 25, 2023",GSW @ DEN,L,28,5,10,0.5,3,5,0.6,0,0,0.0,1,2,3,3,0,0,1,1,13,13,1,Chris Paul,GSW,DEN,GSW,,,19,16,16,6
22023,101108,22300399,"DEC 23, 2023",GSW vs. POR,W,27,1,4,0.25,0,2,0.0,0,0,0.0,0,3,3,11,3,0,1,1,2,9,1,Chris Paul,GSW,GSW,POR,,,16,5,13,14
22023,101108,22300386,"DEC 22, 2023",GSW vs. WAS,W,25,2,7,0.286,0,3,0.0,0,1,0.0,0,7,7,10,1,0,1,2,4,27,1,Chris Paul,GSW,GSW,WAS,,,21,11,14,17
22023,101108,22300362,"DEC 19, 2023",GSW vs. BOS,W,35,4,12,0.333,1,5,0.2,0,0,0.0,1,6,7,12,0,0,0,2,9,9,1,Chris Paul,GSW,GSW,BOS,,,28,16,21,19
22023,101108,22300348,"DEC 17, 2023",GSW @ POR,W,32,2,7,0.286,0,4,0.0,0,0,0.0,1,3,4,8,1,0,2,1,4,-4,1,Chris Paul,GSW,POR,GSW,,,16,8,12,12
22023,101108,22300339,"DEC 16, 2023",GSW vs. BKN,W,30,1,4,0.25,0,2,0.0,0,0,0.0,0,4,4,11,0,0,3,2,2,3,1,Chris Paul,GSW,GSW,BKN,,,17,6,13,15
22023,101108,22300325,"DEC 14, 2023",GSW @ LAC,L,29,4,9,0.444,2,5,0.4,2,2,1.0,0,2,2,3,0,0,2,4,12,-11,1,Chris Paul,GSW,LAC,GSW,,,17,14,15,5
22023,101108,22300308,"DEC 12, 2023",GSW @ PHX,L,30,5,8,0.625,3,4,0.75,2,3,0.667,0,5,5,11,2,0,1,4,15,12,1,Chris Paul,GSW,PHX,GSW,,,31,20,26,16
22023,101108,22301214,"DEC 06, 2023",GSW vs. POR,W,20,1,4,0.25,0,2,0.0,0,0,0.0,1,2,3,6,0,0,2,2,2,-4,1,Chris Paul,GSW,GSW,POR,,,11,5,8,9
22023,101108,22300060,"NOV 28, 2023",GSW @ SAC,L,5,1,2,0.5,1,2,0.5,0,0,0.0,0,0,0,0,2,0,0,1,3,0,1,Chris Paul,GSW,SAC,GSW,,,3,3,3,0
22023,101108,22300051,"NOV 24, 2023",GSW vs. SAS,W,29,2,6,0.333,1,3,0.333,0,0,0.0,0,5,5,10,0,0,1,2,5,16,1,Chris Paul,GSW,GSW,SAS,,,20,10,15,15
22023,101108,22300236,"NOV 22, 2023",GSW @ PHX,L,17,1,2,0.5,0,1,0.0,4,4,1.0,0,2,2,6,0,0,1,1,6,-18,1,Chris Paul,GSW,PHX,GSW,,,14,8,12,8
22023,101108,22300224,"NOV 20, 2023",GSW vs. HOU,W,34,4,7,0.571,3,5,0.6,4,4,1.0,1,5,6,12,2,0,1,4,15,12,1,Chris Paul,GSW,GSW,HOU,,,33,21,27,18
22023,101108,22300207,"NOV 18, 2023",GSW vs. OKC,L,38,4,9,0.444,4,7,0.571,0,0,0.0,1,3,4,11,3,0,0,3,12,3,1,Chris Paul,GSW,GSW,OKC,,,27,16,23,15
22023,101108,22300201,"NOV 16, 2023",GSW vs. OKC,L,28,4,8,0.5,4,6,0.667,3,3,1.0,0,3,3,8,1,0,1,1,15,-3,1,Chris Paul,GSW,GSW,OKC,,,26,18,23,11
22023,101108,22300025,"NOV 14, 2023",GSW vs. MIN,L,36,6,14,0.429,2,3,0.667,1,1,1.0,0,5,5,4,3,1,4,0,15,-9,1,Chris Paul,GSW,GSW,MIN,,,24,20,19,9
22023,101108,22300186,"NOV 12, 2023",GSW vs. MIN,L,22,0,3,0.0,0,2,0.0,2,2,1.0,0,1,1,5,0,0,2,4,2,-1,1,Chris Paul,GSW,GSW,MIN,,,8,3,7,6
22023,101108,22300176,"NOV 11, 2023",GSW vs. CLE,L,26,4,7,0.571,1,2,0.5,0,0,0.0,0,3,3,9,3,0,3,2,9,-12,1,Chris Paul,GSW,GSW,CLE,,,21,12,18,12
22023,101108,22300169,"NOV 08, 2023",GSW @ DEN,L,27,4,10,0.4,1,4,0.25,0,0,0.0,1,4,5,4,1,0,1,2,9,5,1,Chris Paul,GSW,DEN,GSW,,,18,14,13,9
22023,101108,22300145,"NOV 06, 2023",GSW @ DET,W,21,6,9,0.667,2,3,0.667,3,3,1.0,0,5,5,6,0,0,0,0,17,13,1,Chris Paul,GSW,DET,GSW,,,28,22,23,11
22023,101108,22300142,"NOV 05, 2023",GSW @ CLE,L,25,2,10,0.2,1,5,0.2,0,0,0.0,0,1,1,2,2,0,0,3,5,-12,1,Chris Paul,GSW,CLE,GSW,,,8,6,7,3
22023,101108,22300005,"NOV 03, 2023",GSW @ OKC,W,28,0,6,0.0,0,2,0.0,1,2,0.5,0,2,2,13,2,0,0,1,1,6,1,Chris Paul,GSW,OKC,GSW,,,16,3,14,15
22023,101108,22300126,"NOV 01, 2023",GSW vs. SAC,W,28,1,5,0.2,0,3,0.0,0,0,0.0,1,3,4,8,0,0,0,2,2,5,1,Chris Paul,GSW,GSW,SAC,,,14,6,10,12
22023,101108,22300108,"OCT 30, 2023",GSW @ NOP,W,25,6,10,0.6,1,5,0.2,0,0,0.0,0,6,6,5,2,0,1,0,13,17,1,Chris Paul,GSW,NOP,GSW,,,24,19,18,11
22023,101108,22300096,"OCT 29, 2023",GSW @ HOU,W,27,3,8,0.375,0,3,0.0,2,2,1.0,0,5,5,7,1,0,1,1,8,22,1,Chris Paul,GSW,HOU,GSW,,,20,13,15,12
22023,101108,22300087,"OCT 27, 2023",GSW @ SAC,W,33,5,12,0.417,0,2,0.0,0,0,0.0,0,2,2,12,3,0,3,2,10,2,1,Chris Paul,GSW,SAC,GSW,,,24,12,22,14
22023,101108,22300062,"OCT 24, 2023",GSW vs. PHX,L,34,4,15,0.267,0,6,0.0,6,7,0.857,1,5,6,9,2,0,1,0,14,5,1,Chris Paul,GSW,GSW,PHX,,,29,20,23,15
22023,1626166,22300552,"JAN 14, 2024",MIL vs. SAC,W,12,5,7,0.714,3,4,0.75,2,2,1.0,0,0,0,1,1,0,0,0,15,7,1,Cameron Payne,MIL,MIL,SAC,,,16,15,16,1
22023,1626166,22300528,"JAN 11, 2024",MIL vs. BOS,W,15,3,4,0.75,1,2,0.5,0,0,0.0,0,4,4,3,0,0,0,0,7,-4,1,Cameron Payne,MIL,MIL,BOS,,,14,11,10,7
22023,1626166,22300496,"JAN 06, 2024",MIL @ HOU,L,8,0,1,0.0,0,1,0.0,1,2,0.5,0,0,0,1,0,0,0,0,1,-1,1,Cameron Payne,MIL,HOU,MIL,,,2,1,2,1
22023,1626166,22300477,"JAN 04, 2024",MIL @ SAS,W,15,0,3,0.0,0,3,0.0,5,5,1.0,0,1,1,4,0,0,0,1,5,-4,1,Cameron Payne,MIL,SAS,MIL,,,10,6,9,5
22023,1626166,22300466,"JAN 03, 2024",MIL @ IND,L,10,2,3,0.667,1,2,0.5,2,3,0.667,0,1,1,2,0,0,0,3,7,5,1,Cameron Payne,MIL,IND,MIL,,,10,8,9,3
22023,1626166,22300454,"JAN 01, 2024",MIL vs. IND,L,12,1,4,0.25,0,2,0.0,3,3,1.0,1,0,1,2,1,0,2,1,5,-13,1,Cameron Payne,MIL,MIL,IND,,,8,6,7,3
22023,1626166,22300433,"DEC 29, 2023",MIL @ CLE,W,6,0,1,0.0,0,1,0.0,0,0,0.0,0,0,0,0,0,0,3,0,0,-9,1,Cameron Payne,MIL,CLE,MIL,,,0,0,0,0
22023,1626166,22300417,"DEC 27, 2023",MIL @ BKN,W,23,6,9,0.667,5,8,0.625,1,1,1.0,1,3,4,6,2,0,0,4,18,24,1,Cameron Payne,MIL,BKN,MIL,,,28,22,24,10
22023,1626166,22300401,"DEC 25, 2023",MIL @ NYK,L,10,1,2,0.5,1,2,0.5,0,0,0.0,0,0,0,1,0,0,0,0,3,-1,1,Cameron Payne,MIL,NYK,MIL,,,4,3,4,1
22023,1626166,22300388,"DEC 23, 2023",MIL @ NYK,W,14,2,2,1.0,1,1,1.0,3,4,0.75,0,1,1,1,0,0,0,0,8,16,1,Cameron Payne,MIL,NYK,MIL,,,10,9,9,2
22023,1626166,22300378,"DEC 21, 2023",MIL vs. ORL,W,13,1,4,0.25,0,3,0.0,0,0,0.0,0,1,1,4,0,0,0,2,2,-5,1,Cameron Payne,MIL,MIL,ORL,,,7,3,6,5
22023,1626166,22300361,"DEC 19, 2023",MIL vs. SAS,W,13,2,6,0.333,0,2,0.0,3,3,1.0,0,0,0,0,0,0,0,1,7,-9,1,Cameron Payne,MIL,MIL,SAS,,,7,7,7,0
22023,1626166,22300346,"DEC 17, 2023",MIL vs. HOU,W,11,0,4,0.0,0,4,0.0,0,0,0.0,0,0,0,1,0,0,0,2,0,2,1,Cameron Payne,MIL,MIL,HOU,,,1,0,1,1
22023,1626166,22300334,"DEC 16, 2023",MIL vs. DET,W,15,3,5,0.6,1,3,0.333,4,4,1.0,0,1,1,5,1,0,2,2,11,5,1,Cameron Payne,MIL,MIL,DET,,,17,12,16,6
22023,1626166,22300315,"DEC 13, 2023",MIL vs. IND,W,14,0,4,0.0,0,2,0.0,1,2,0.5,0,0,0,4,0,0,1,1,1,4,1,Cameron Payne,MIL,MIL,IND,,,5,1,5,4
22023,1626166,22300300,"DEC 11, 2023",MIL vs. CHI,W,18,2,4,0.5,1,2,0.5,0,0,0.0,0,0,0,5,0,0,1,2,5,0,1,Cameron Payne,MIL,MIL,CHI,,,10,5,10,5
22023,1626166,22301229,"DEC 07, 2023",MIL vs. IND,L,16,2,9,0.222,0,3,0.0,0,0,0.0,0,1,1,2,0,0,2,0,4,-18,1,Cameron Payne,MIL,MIL,IND,,,7,5,6,3
22023,1626166,22301201,"DEC 05, 2023",MIL vs. NYK,W,14,5,6,0.833,2,3,0.667,0,0,0.0,0,2,2,2,1,0,1,2,12,7,1,Cameron Payne,MIL,MIL,NYK,,,16,14,14,4
22023,1626166,22300286,"DEC 02, 2023",MIL vs. ATL,W,20,7,11,0.636,2,6,0.333,2,2,1.0,0,3,3,2,0,0,1,5,18,5,1,Cameron Payne,MIL,MIL,ATL,,,23,21,20,5
22023,1626166,22300269,"NOV 30, 2023",MIL @ CHI,L,12,2,6,0.333,2,5,0.4,0,0,0.0,0,1,1,1,0,0,0,0,6,-20,1,Cameron Payne,MIL,CHI,MIL,,,8,7,7,2
22023,1626166,22300056,"NOV 28, 2023",MIL @ MIA,W,18,1,2,0.5,0,1,0.0,0,0,0.0,0,1,1,3,0,0,1,2,2,-15,1,Cameron Payne,MIL,MIA,MIL,,,6,3,5,4
22023,1626166,22300245,"NOV 26, 2023",MIL vs. POR,W,17,1,4,0.25,1,3,0.333,0,0,0.0,0,2,2,3,1,0,3,2,3,3,1,Cameron Payne,MIL,MIL,POR,,,8,5,6,5
22023,1626166,22300049,"NOV 24, 2023",MIL vs. WAS,W,17,2,4,0.5,0,2,0.0,0,0,0.0,0,3,3,3,0,0,0,3,4,-4,1,Cameron Payne,MIL,MIL,WAS,,,10,7,7,6
22023,1626166,22300228,"NOV 22, 2023",MIL @ BOS,L,10,1,5,0.2,1,3,0.333,0,0,0.0,0,0,0,2,0,0,0,0,3,-12,1,Cameron Payne,MIL,BOS,MIL,,,5,3,5,2
22023,1626166,22300219,"NOV 20, 2023",MIL @ WAS,W,16,2,5,0.4,2,4,0.5,0,0,0.0,0,2,2,2,1,0,1,1,6,8,1,Cameron Payne,MIL,WAS,MIL,,,10,8,8,4
22023,1626166,22300205,"NOV 18, 2023",MIL vs. DAL,W,17,4,5,0.8,3,4,0.75,0,0,0.0,0,2,2,2,1,0,0,4,11,10,1,Cameron Payne,MIL,MIL,DAL,,,15,13,13,4
22023,1626166,22300027,"NOV 17, 2023",MIL @ CHA,W,21,1,3,0.333,0,2,0.0,0,0,0.0,0,3,3,6,0,1,0,1,2,21,1,Cameron Payne,MIL,CHA,MIL,,,11,5,8,9
22023,1626166,22300195,"NOV 15, 2023",MIL @ TOR,W,16,4,8,0.5,3,4,0.75,2,2,1.0,0,1,1,2,0,0,0,2,13,1,1,Cameron Payne,MIL,TOR,MIL,,,16,14,15,3
22023,1626166,22300190,"NOV 13, 2023",MIL vs. CHI,W,17,0,2,0.0,0,2,0.0,0,0,0.0,0,0,0,5,0,0,2,2,0,15,1,Cameron Payne,MIL,MIL,CHI,,,5,0,5,5
22023,1626166,22300173,"NOV 11, 2023",MIL @ ORL,L,26,6,8,0.75,2,3,0.667,0,0,0.0,0,0,0,2,2,0,2,3,14,-8,1,Cameron Payne,MIL,ORL,MIL,,,16,14,16,2
22023,1626166,22300171,"NOV 09, 2023",MIL @ IND,L,30,3,9,0.333,1,2,0.5,0,0,0.0,0,4,4,5,0,1,1,4,7,-17,1,Cameron Payne,MIL,IND,MIL,,,16,11,12,9
22023,1626166,22300165,"NOV 08, 2023",MIL vs. DET,W,24,1,4,0.25,1,3,0.333,4,4,1.0,0,1,1,3,2,0,1,2,7,7,1,Cameron Payne,MIL,MIL,DET,,,11,8,10,4
22023,1626166,22300149,"NOV 06, 2023",MIL @ BKN,W,16,4,6,0.667,3,4,0.75,0,0,0.0,0,1,1,3,0,0,0,1,11,9,1,Cameron Payne,MIL,BKN,MIL,,,15,12,14,4
22023,1626166,22300002,"NOV 03, 2023",MIL vs. NYK,W,12,0,1,0.0,0,0,0.0,0,0,0.0,0,0,0,1,0,0,1,2,0,3,1,Cameron Payne,MIL,MIL,NYK,,,1,0,1,1
22023,1626166,22300116,"NOV 01, 2023",MIL @ TOR,L,19,2,5,0.4,0,2,0.0,0,0,0.0,0,2,2,1,0,0,1,2,4,-4,1,Cameron Payne,MIL,TOR,MIL,,,7,6,5,3
22023,1626166,22300107,"OCT 30, 2023",MIL vs. MIA,W,13,4,5,0.8,3,4,0.75,0,0,0.0,1,0,1,0,0,0,1,0,11,6,1,Cameron Payne,MIL,MIL,MIA,,,12,12,11,1
22023,1626166,22300097,"OCT 29, 2023",MIL vs. ATL,L,14,2,3,0.667,2,3,0.667,0,0,0.0,0,1,1,1,0,0,1,4,6,3,1,Cameron Payne,MIL,MIL,ATL,,,8,7,7,2
22023,1626166,22300075,"OCT 26, 2023",MIL vs. PHI,W,9,1,3,0.333,0,1,0.0,0,0,0.0,0,0,0,0,1,0,0,3,2,-7,1,Cameron Payne,MIL,MIL,PHI,,,2,2,2,0
22023,1627780,22300463,"JAN 02, 2024",GSW vs. ORL,W,11,1,5,0.2,0,3,0.0,0,0,0.0,1,3,4,0,0,0,1,0,2,10,1,Gary Payton II,GSW,GSW,ORL,,,6,6,2,4
22023,1627780,22300444,"DEC 30, 2023",GSW vs. DAL,L,9,1,3,0.333,0,1,0.0,0,0,0.0,0,0,0,0,0,1,0,3,2,-1,1,Gary Payton II,GSW,GSW,DAL,,,2,2,2,0
22023,1627780,22300060,"NOV 28, 2023",GSW @ SAC,L,17,3,4,0.75,0,1,0.0,1,1,1.0,1,4,5,1,2,1,1,3,7,-9,1,Gary Payton II,GSW,SAC,GSW,,,13,12,8,6
22023,1627780,22300051,"NOV 24, 2023",GSW vs. SAS,W,19,2,3,0.667,0,1,0.0,0,0,0.0,0,3,3,0,1,1,2,4,4,0,1,Gary Payton II,GSW,GSW,SAS,,,7,7,4,3
22023,1627780,22300201,"NOV 16, 2023",GSW vs. OKC,L,8,0,4,0.0,0,1,0.0,1,2,0.5,1,0,1,0,1,0,0,1,1,-12,1,Gary Payton II,GSW,GSW,OKC,,,2,2,1,1
22023,1627780,22300025,"NOV 14, 2023",GSW vs. MIN,L,16,3,5,0.6,1,3,0.333,0,0,0.0,1,2,3,2,0,0,0,1,7,-3,1,Gary Payton II,GSW,GSW,MIN,,,12,10,9,5
22023,1627780,22300186,"NOV 12, 2023",GSW vs. MIN,L,14,2,2,1.0,0,0,0.0,0,0,0.0,2,2,4,2,0,0,1,2,4,-2,1,Gary Payton II,GSW,GSW,MIN,,,10,8,6,6
22023,1627780,22300176,"NOV 11, 2023",GSW vs. CLE,L,11,1,4,0.25,0,1,0.0,1,2,0.5,2,3,5,0,0,0,1,0,3,-12,1,Gary Payton II,GSW,GSW,CLE,,,8,8,3,5
22023,1627780,22300145,"NOV 06, 2023",GSW @ DET,W,24,3,5,0.6,0,0,0.0,0,0,0.0,4,2,6,0,2,0,0,2,6,11,1,Gary Payton II,GSW,DET,GSW,,,12,12,6,6
22023,1627780,22300142,"NOV 05, 2023",GSW @ CLE,L,12,2,7,0.286,1,3,0.333,0,0,0.0,2,0,2,1,0,0,0,2,5,-10,1,Gary Payton II,GSW,CLE,GSW,,,8,7,6,3
22023,1627780,22300005,"NOV 03, 2023",GSW @ OKC,W,22,4,6,0.667,1,3,0.333,0,0,0.0,0,3,3,1,2,0,1,2,9,9,1,Gary Payton II,GSW,OKC,GSW,,,13,12,10,4
22023,1627780,22300126,"NOV 01, 2023",GSW vs. SAC,W,22,2,4,0.5,0,0,0.0,0,0,0.0,0,2,2,1,1,0,1,0,4,5,1,Gary Payton II,GSW,GSW,SAC,,,7,6,5,3
22023,1627780,22300108,"OCT 30, 2023",GSW @ NOP,W,20,4,10,0.4,2,6,0.333,0,0,0.0,2,2,4,1,1,1,0,4,10,17,1,Gary Payton II,GSW,NOP,GSW,,,15,14,11,5
22023,1627780,22300096,"OCT 29, 2023",GSW @ HOU,W,19,6,8,0.75,3,4,0.75,0,0,0.0,0,4,4,1,3,1,0,1,15,13,1,Gary Payton II,GSW,HOU,GSW,,,20,19,16,5
22023,1627780,22300087,"OCT 27, 2023",GSW @ SAC,W,18,2,4,0.5,1,3,0.333,2,2,1.0,0,0,0,1,1,0,2,3,7,-3,1,Gary Payton II,GSW,SAC,GSW,,,8,7,8,1
22023,1627780,22300062,"OCT 24, 2023",GSW vs. PHX,L,22,0,5,0.0,0,2,0.0,1,2,0.5,0,2,2,2,3,0,0,1,1,15,1,Gary Payton II,GSW,GSW,PHX,,,5,3,3,4
22023,1630196,22300222,"NOV 20, 2023",SAC @ NOP,L,6,1,2,0.5,0,0,0.0,1,2,0.5,0,0,0,0,0,0,0,1,3,3,1,Filip Petrusev,SAC,NOP,SAC,,,3,3,3,0
22023,1630196,22300198,"NOV 15, 2023",SAC @ LAL,W,0,0,0,0.0,0,0,0.0,0,0,0.0,0,0,0,0,0,0,0,0,0,0,1,Filip Petrusev,SAC,LAL,SAC,,,0,0,0,0
22023,1630196,22300098,"OCT 29, 2023",PHI vs. POR,W,3,0,0,0.0,0,0,0.0,0,0,0.0,0,1,1,0,0,0,0,0,0,3,1,Filip Petrusev,PHI,PHI,POR,,,1,1,0,1
22023,1641763,22300468,"JAN 03, 2024",CHI @ NYK,L,2,0,1,0.0,0,0,0.0,0,0,0.0,1,0,1,0,0,0,0,0,0,0,1,Julian Phillips,CHI,NYK,CHI,,,1,1,0,1
22023,1641763,22300459,"JAN 02, 2024",CHI @ PHI,L,17,3,5,0.6,1,3,0.333,0,0,0.0,0,0,0,0,0,3,0,2,7,10,1,Julian Phillips,CHI,PHI,CHI,,,7,7,7,0
22023,1641763,22300442,"DEC 30, 2023",CHI vs. PHI,W,1,0,0,0.0,0,0,0.0,0,0,0.0,0,0,0,0,0,0,0,0,0,-4,1,Julian Phillips,CHI,CHI,PHI,,,0,0,0,0
22023,1641763,22300422,"DEC 28, 2023",CHI vs. IND,L,1,0,0,0.0,0,0,0.0,0,0,0.0,0,0,0,0,0,0,0,0,0,-1,1,Julian Phillips,CHI,CHI,IND,,,0,0,0,0
22023,1641763,22300376,"DEC 21, 2023",CHI vs. SAS,W,4,0,1,0.0,0,1,0.0,0,0,0.0,0,0,0,0,0,0,0,1,0,-5,1,Julian Phillips,CHI,CHI,SAS,,,0,0,0,0
22023,1641763,22300370,"DEC 20, 2023",CHI vs. LAL,W,1,0,0,0.0,0,0,0.0,0,0,0.0,0,0,0,0,0,0,0,0,0,-2,1,Julian Phillips,CHI,CHI,LAL,,,0,0,0,0
22023,1641763,22300337,"DEC 16, 2023",CHI @ MIA,L,0,0,0,0.0,0,0,0.0,0,0,0.0,0,0,0,0,0,0,0,0,0,0,1,Julian Phillips,CHI,MIA,CHI,,,0,0,0,0
22023,1641763,22300307,"DEC 12, 2023",CHI vs. DEN,L,7,0,1,0.0,0,1,0.0,0,0,0.0,0,1,1,1,0,0,1,1,0,3,1,Julian Phillips,CHI,CHI,DEN,,,2,1,1,2
22023,1641763,22300300,"DEC 11, 2023",CHI @ MIL,L,4,0,0,0.0,0,0,0.0,0,0,0.0,0,0,0,0,0,0,0,0,0,-4,1,Julian Phillips,CHI,MIL,CHI,,,0,0,0,0
22023,1641763,22301223,"DEC 08, 2023",CHI @ SAS,W,4,1,1,1.0,0,0,0.0,0,0,0.0,1,1,2,0,0,0,0,2,2,-4,1,Julian Phillips,CHI,SAS,CHI,,,4,4,2,2
22023,1641763,22301211,"DEC 06, 2023",CHI vs. CHA,W,6,1,2,0.5,0,1,0.0,0,0,0.0,0,0,0,1,0,0,0,0,2,-2,1,Julian Phillips,CHI,CHI,CHA,,,3,2,3,1
22023,1641763,22300285,"DEC 02, 2023",CHI vs. NOP,W,4,1,1,1.0,0,0,0.0,0,0,0.0,0,0,0,0,1,0,0,0,2,5,1,Julian Phillips,CHI,CHI,NOP,,,2,2,2,0
22023,1641763,22300269,"NOV 30, 2023",CHI vs. MIL,W,14,0,3,0.0,0,2,0.0,0,0,0.0,1,2,3,3,0,0,0,3,0,14,1,Julian Phillips,CHI,CHI,MIL,,,6,3,3,6
22023,1641763,22300053,"NOV 28, 2023",CHI @ BOS,L,10,0,2,0.0,0,1,0.0,1,2,0.5,0,2,2,1,0,0,1,0,1,-2,1,Julian Phillips,CHI,BOS,CHI,,,4,3,2,3
22023,1641763,22300046,"NOV 24, 2023",CHI @ TOR,L,4,1,2,0.5,0,1,0.0,0,2,0.0,0,0,0,0,0,0,0,1,2,0,1,Julian Phillips,CHI,TOR,CHI,,,2,2,2,0
22023,1641763,22300220,"NOV 20, 2023",CHI vs. MIA,L,2,1,2,0.5,0,0,0.0,0,0,0.0,0,1,1,0,0,0,0,1,2,6,1,Julian Phillips,CHI,CHI,MIA,,,3,3,2,1
22023,1641763,22300196,"NOV 15, 2023",CHI vs. ORL,L,4,0,2,0.0,0,1,0.0,0,0,0.0,0,0,0,0,0,0,0,1,0,-4,1,Julian Phillips,CHI,CHI,ORL,,,0,0,0,0
22023,1641763,22300152,"NOV 06, 2023",CHI vs. UTA,W,2,0,1,0.0,0,1,0.0,0,0,0.0,0,1,1,0,0,0,0,0,0,-5,1,Julian Phillips,CHI,CHI,UTA,,,1,1,0,1
22023,1641763,22300139,"NOV 04, 2023",CHI @ DEN,L,3,0,0,0.0,0,0,0.0,0,0,0.0,0,0,0,0,0,0,0,0,0,-2,1,Julian Phillips,CHI,DEN,CHI,,,0,0,0,0
22023,1641763,22300088,"OCT 28, 2023",CHI @ DET,L,1,0,0,0.0,0,0,0.0,0,0,0.0,0,0,0,0,0,0,0,0,0,0,1,Julian Phillips,CHI,DET,CHI,,,0,0,0,0
22023,1641763,22300070,"OCT 25, 2023",CHI vs. OKC,L,4,0,0,0.0,0,0,0.0,0,0,0.0,0,0,0,0,0,0,0,0,0,1,1,Julian Phillips,CHI,CHI,OKC,,,0,0,0,0
22023,1629618,22300455,"JAN 01, 2024",DEN vs. CHA,W,4,0,1,0.0,0,1,0.0,0,0,0.0,0,0,0,0,0,0,0,0,0,-6,1,Jalen Pickett,DEN,DEN,CHA,,,0,0,0,0
22023,1629618,22300435,"DEC 29, 2023",DEN vs. OKC,L,3,0,1,0.0,0,0,0.0,0,0,0.0,0,0,0,0,0,0,0,1,0,-6,1,Jalen Pickett,DEN,DEN,OKC,,,0,0,0,0
22023,1629618,22300425,"DEC 28, 2023",DEN vs. MEM,W,6,1,2,0.5,1,2,0.5,0,0,0.0,0,1,1,2,0,0,0,0,3,3,1,Jalen Pickett,DEN,DEN,MEM,,,6,4,5,3
22023,1629618,22300322,"DEC 14, 2023",DEN vs. BKN,W,2,1,1,1.0,1,1,1.0,0,0,0.0,0,0,0,1,0,0,0,0,3,6,1,Jalen Pickett,DEN,DEN,BKN,,,4,3,4,1
22023,1629618,22300263,"NOV 29, 2023",DEN vs. HOU,W,3,0,1,0.0,0,1,0.0,0,0,0.0,0,0,0,0,0,0,0,0,0,-9,1,Jalen Pickett,DEN,DEN,HOU,,,0,0,0,0
22023,1629618,22300252,"NOV 26, 2023",DEN vs. SAS,W,2,0,0,0.0,0,0,0.0,0,0,0.0,0,0,0,0,0,0,1,1,0,-4,1,Jalen Pickett,DEN,DEN,SAS,,,0,0,0,0
22023,1629618,22300226,"NOV 22, 2023",DEN @ ORL,L,8,0,4,0.0,0,3,0.0,0,0,0.0,0,1,1,0,0,0,1,0,0,1,1,Jalen Pickett,DEN,ORL,DEN,,,1,1,0,1
22023,1629618,22300218,"NOV 20, 2023",DEN @ DET,W,7,1,1,1.0,0,0,0.0,0,0,0.0,1,1,2,1,1,0,0,1,2,1,1,Jalen Pickett,DEN,DET,DEN,,,5,4,3,3
22023,1629618,22300210,"NOV 19, 2023",DEN @ CLE,L,19,2,4,0.5,2,3,0.667,2,2,1.0,0,2,2,3,1,0,1,0,8,7,1,Jalen Pickett,DEN,CLE,DEN,,,13,10,11,5
22023,1629618,22300034,"NOV 17, 2023",DEN @ NOP,L,10,0,2,0.0,0,2,0.0,0,0,0.0,0,1,1,1,0,0,1,2,0,9,1,Jalen Pickett,DEN,NOP,DEN,,,2,1,1,2
22023,1629618,22300024,"NOV 14, 2023",DEN vs. LAC,W,17,2,3,0.667,1,2,0.5,0,0,0.0,0,2,2,2,1,0,2,2,5,-4,1,Jalen Pickett,DEN,DEN,LAC,,,9,7,7,4
22023,1629618,22300156,"NOV 06, 2023",DEN vs. NOP,W,1,1,1,1.0,1,1,1.0,0,0,0.0,0,0,0,0,0,0,0,0,3,3,1,Jalen Pickett,DEN,DEN,NOP,,,3,3,3,0
22023,1629618,22300139,"NOV 04, 2023",DEN vs. CHI,W,2,1,1,1.0,1,1,1.0,0,0,0.0,0,0,0,0,0,0,0,0,3,-1,1,Jalen Pickett,DEN,DEN,CHI,,,3,3,3,0
22023,1629618,22300123,"NOV 01, 2023",DEN @ MIN,L,5,1,2,0.5,0,1,0.0,0,0,0.0,0,2,2,0,0,0,0,1,2,0,1,Jalen Pickett,DEN,MIN,DEN,,,4,4,2,2
22023,1629618,22300061,"OCT 24, 2023",DEN vs. LAL,W,1,1,1,1.0,0,0,0.0,0,0,0.0,0,0,0,0,0,0,0,0,2,0,1,Jalen Pickett,DEN,DEN,LAL,,,2,2,2,0
22023,203486,22300553,"JAN 14, 2024",LAC @ MIN,L,16,4,5,0.8,0,0,0.0,0,0,0.0,0,3,3,0,1,0,0,4,8,3,1,Mason Plumlee,LAC,MIN,LAC,,,11,11,8,3
22023,203486,22300511,"JAN 08, 2024",LAC vs. PHX,W,5,0,0,0.0,0,0,0.0,1,2,0.5,0,2,2,3,0,0,0,0,1,2,1,Mason Plumlee,LAC,LAC,PHX,,,6,3,4,5
22023,203486,22300486,"JAN 05, 2024",LAC @ NOP,W,7,2,2,1.0,0,0,0.0,4,5,0.8,1,1,2,0,0,0,0,1,8,-15,1,Mason Plumlee,LAC,NOP,LAC,,,10,10,8,2
22023,203486,22300151,"NOV 06, 2023",LAC @ NYK,L,11,1,1,1.0,0,0,0.0,0,0,0.0,0,2,2,1,1,0,1,0,2,10,1,Mason Plumlee,LAC,NYK,LAC,,,5,4,3,3
22023,203486,22300127,"NOV 01, 2023",LAC @ LAL,L,19,1,3,0.333,0,0,0.0,3,6,0.5,0,6,6,0,3,0,1,0,5,-9,1,Mason Plumlee,LAC,LAL,LAC,,,11,11,5,6
22023,203486,22300114,"OCT 31, 2023",LAC vs. ORL,W,22,5,7,0.714,0,0,0.0,0,2,0.0,2,5,7,2,0,1,2,4,10,-5,1,Mason Plumlee,LAC,LAC,ORL,,,19,17,12,9
22023,203486,22300099,"OCT 29, 2023",LAC vs. SAS,W,21,2,3,0.667,0,0,0.0,0,0,0.0,2,4,6,1,0,0,0,0,4,7,1,Mason Plumlee,LAC,LAC,SAS,,,11,10,5,7
22023,203486,22300085,"OCT 27, 2023",LAC @ UTA,L,12,1,1,1.0,0,0,0.0,1,2,0.5,1,3,4,0,0,0,1,2,3,-11,1,Mason Plumlee,LAC,UTA,LAC,,,7,7,3,4
22023,203486,22300074,"OCT 25, 2023",LAC vs. POR,W,18,2,4,0.5,0,0,0.0,2,4,0.5,3,5,8,2,0,0,0,0,6,-6,1,Mason Plumlee,LAC,LAC,POR,,,16,14,8,10
22023,1641764,22300560,"JAN 15, 2024",GSW @ MEM,L,27,4,12,0.333,0,3,0.0,0,0,0.0,2,2,4,4,0,0,2,4,8,-3,1,Brandin Podziemski,GSW,MEM,GSW,,,16,12,12,8
22023,1641764,22300545,"JAN 13, 2024",GSW @ MIL,L,36,10,14,0.714,3,5,0.6,0,1,0.0,1,9,10,3,2,0,0,3,23,-1,1,Brandin Podziemski,GSW,MIL,GSW,,,36,33,26,13
22023,1641764,22300536,"JAN 12, 2024",GSW @ CHI,W,27,2,8,0.25,0,4,0.0,1,1,1.0,1,2,3,4,0,0,0,3,5,12,1,Brandin Podziemski,GSW,CHI,GSW,,,12,8,9,7
22023,1641764,22300525,"JAN 10, 2024",GSW vs. NOP,L,25,1,6,0.167,0,2,0.0,0,0,0.0,3,6,9,2,0,0,2,1,2,-31,1,Brandin Podziemski,GSW,GSW,NOP,,,13,11,4,11
22023,1641764,22300504,"JAN 07, 2024",GSW vs. TOR,L,29,2,11,0.182,1,8,0.125,0,0,0.0,2,6,8,4,0,0,0,1,5,-9,1,Brandin Podziemski,GSW,GSW,TOR,,,17,13,9,12
22023,1641764,22300490,"JAN 05, 2024",GSW vs. DET,W,25,4,7,0.571,2,2,1.0,1,3,0.333,2,3,5,5,1,0,1,2,11,-3,1,Brandin Podziemski,GSW,GSW,DET,,,21,16,16,10
22023,1641764,22300478,"JAN 04, 2024",GSW vs. DEN,L,28,5,10,0.5,3,4,0.75,0,0,0.0,0,2,2,5,1,0,0,2,13,-2,1,Brandin Podziemski,GSW,GSW,DEN,,,20,15,18,7
22023,1641764,22300463,"JAN 02, 2024",GSW vs. ORL,W,28,4,7,0.571,1,3,0.333,1,4,0.25,1,3,4,2,2,0,0,2,10,4,1,Brandin Podziemski,GSW,GSW,ORL,,,16,14,12,6
22023,1641764,22300444,"DEC 30, 2023",GSW vs. DAL,L,29,5,8,0.625,3,5,0.6,0,0,0.0,1,8,9,4,1,0,2,1,13,-4,1,Brandin Podziemski,GSW,GSW,DAL,,,26,22,17,13
22023,1641764,22300426,"DEC 28, 2023",GSW vs. MIA,L,28,4,9,0.444,2,5,0.4,0,0,0.0,1,2,3,6,0,0,1,2,10,1,1,Brandin Podziemski,GSW,GSW,MIA,,,19,13,16,9
22023,1641764,22300402,"DEC 25, 2023",GSW @ DEN,L,34,4,7,0.571,3,4,0.75,2,2,1.0,4,5,9,6,5,0,2,1,13,1,1,Brandin Podziemski,GSW,DEN,GSW,,,28,22,19,15
22023,1641764,22300399,"DEC 23, 2023",GSW vs. POR,W,32,7,12,0.583,1,5,0.2,0,0,0.0,1,9,10,7,1,1,2,1,15,25,1,Brandin Podziemski,GSW,GSW,POR,,,32,25,22,17
22023,1641764,22300386,"DEC 22, 2023",GSW vs. WAS,W,29,3,9,0.333,2,5,0.4,2,2,1.0,3,4,7,5,1,0,1,2,10,16,1,Brandin Podziemski,GSW,GSW,WAS,,,22,17,15,12
22023,1641764,22300362,"DEC 19, 2023",GSW vs. BOS,W,16,2,4,0.5,1,3,0.333,0,0,0.0,1,4,5,1,1,0,1,2,5,2,1,Brandin Podziemski,GSW,GSW,BOS,,,11,10,6,6
22023,1641764,22300348,"DEC 17, 2023",GSW @ POR,W,33,4,8,0.5,0,2,0.0,2,2,1.0,0,5,5,5,1,0,1,3,10,1,1,Brandin Podziemski,GSW,POR,GSW,,,20,15,15,10
22023,1641764,22300339,"DEC 16, 2023",GSW vs. BKN,W,32,7,15,0.467,4,9,0.444,1,2,0.5,1,4,5,5,3,1,5,4,19,0,1,Brandin Podziemski,GSW,GSW,BKN,,,29,24,24,10
22023,1641764,22300325,"DEC 14, 2023",GSW @ LAC,L,35,2,11,0.182,0,3,0.0,0,0,0.0,4,3,7,2,3,1,3,2,4,-8,1,Brandin Podziemski,GSW,LAC,GSW,,,13,11,6,9
22023,1641764,22300308,"DEC 12, 2023",GSW @ PHX,L,29,9,14,0.643,2,4,0.5,0,1,0.0,5,6,11,5,1,0,3,2,20,18,1,Brandin Podziemski,GSW,PHX,GSW,,,36,31,25,16
22023,1641764,22301222,"DEC 08, 2023",GSW @ OKC,L,23,5,11,0.455,1,4,0.25,1,1,1.0,5,1,6,4,1,0,1,2,12,-1,1,Brandin Podziemski,GSW,OKC,GSW,,,22,18,16,10
22023,1641764,22301214,"DEC 06, 2023",GSW vs. POR,W,21,1,3,0.333,1,1,1.0,0,2,0.0,1,4,5,1,0,0,1,2,3,5,1,Brandin Podziemski,GSW,GSW,POR,,,9,8,4,6
22023,1641764,22300280,"DEC 02, 2023",GSW @ LAC,L,37,5,9,0.556,2,3,0.667,0,0,0.0,0,6,6,3,1,2,1,2,12,1,1,Brandin Podziemski,GSW,LAC,GSW,,,21,18,15,9
22023,1641764,22300273,"NOV 30, 2023",GSW vs. LAC,W,31,5,10,0.5,2,4,0.5,1,2,0.5,2,6,8,2,0,0,0,2,13,12,1,Brandin Podziemski,GSW,GSW,LAC,,,23,21,15,10
22023,1641764,22300051,"NOV 24, 2023",GSW vs. SAS,W,12,0,5,0.0,0,2,0.0,0,0,0.0,1,2,3,2,0,0,1,0,0,0,1,Brandin Podziemski,GSW,GSW,SAS,,,5,3,2,5
22023,1641764,22300236,"NOV 22, 2023",GSW @ PHX,L,23,4,9,0.444,1,3,0.333,1,2,0.5,2,2,4,2,3,0,0,1,10,20,1,Brandin Podziemski,GSW,PHX,GSW,,,16,14,12,6
22023,1641764,22300224,"NOV 20, 2023",GSW vs. HOU,W,18,1,2,0.5,1,2,0.5,0,0,0.0,0,5,5,3,0,0,0,2,3,3,1,Brandin Podziemski,GSW,GSW,HOU,,,11,8,6,8
22023,1641764,22300207,"NOV 18, 2023",GSW vs. OKC,L,25,2,6,0.333,1,4,0.25,3,4,0.75,0,3,3,3,0,0,3,0,8,-15,1,Brandin Podziemski,GSW,GSW,OKC,,,14,11,11,6
22023,1641764,22300201,"NOV 16, 2023",GSW vs. OKC,L,25,4,7,0.571,3,4,0.75,2,2,1.0,2,6,8,3,0,0,1,5,13,-26,1,Brandin Podziemski,GSW,GSW,OKC,,,24,21,16,11
22023,1641764,22300025,"NOV 14, 2023",GSW vs. MIN,L,39,9,18,0.5,3,8,0.375,2,2,1.0,1,6,7,5,1,0,3,4,23,11,1,Brandin Podziemski,GSW,GSW,MIN,,,35,30,28,12
22023,1641764,22300186,"NOV 12, 2023",GSW vs. MIN,L,1,3,5,0.6,2,2,1.0,0,0,0.0,1,0,1,0,1,0,0,0,8,6,1,Brandin Podziemski,GSW,GSW,MIN,,,9,9,8,1
22023,1641764,22300176,"NOV 11, 2023",GSW vs. CLE,L,8,1,2,0.5,0,0,0.0,0,0,0.0,1,1,2,2,1,0,1,1,2,5,1,Brandin Podziemski,GSW,GSW,CLE,,,6,4,4,4
22023,1641764,22300169,"NOV 08, 2023",GSW @ DEN,L,11,2,3,0.667,0,0,0.0,1,1,1.0,1,2,3,2,0,0,0,2,5,8,1,Brandin Podziemski,GSW,DEN,GSW,,,10,8,7,5
22023,1641764,22300145,"NOV 06, 2023",GSW @ DET,W,0,0,0,0.0,0,0,0.0,0,0,0.0,0,0,0,0,0,0,0,0,0,1,1,Brandin Podziemski,GSW,DET,GSW,,,0,0,0,0
22023,1641764,22300142,"NOV 05, 2023",GSW @ CLE,L,8,0,2,0.0,0,1,0.0,0,0,0.0,1,1,2,2,0,0,2,0,0,5,1,Brandin Podziemski,GSW,CLE,GSW,,,4,2,2,4
22023,1641764,22300108,"OCT 30, 2023",GSW @ NOP,W,23,2,5,0.4,0,1,0.0,1,2,0.5,1,7,8,2,0,0,2,4,5,15,1,Brandin Podziemski,GSW,NOP,GSW,,,15,13,7,10
22023,1627751,22300504,"JAN 07, 2024",TOR @ GSW,W,31,6,8,0.75,0,0,0.0,2,5,0.4,3,8,11,5,0,0,2,3,14,21,1,Jakob Poeltl,TOR,GSW,TOR,,,30,25,19,16
22023,1627751,22300492,"JAN 05, 2024",TOR @ SAC,L,23,7,10,0.7,0,0,0.0,0,0,0.0,1,5,6,2,0,3,3,6,14,12,1,Jakob Poeltl,TOR,SAC,TOR,,,22,20,16,8
22023,1627751,22300470,"JAN 03, 2024",TOR @ MEM,W,33,2,7,0.286,0,0,0.0,3,4,0.75,3,5,8,2,1,5,1,3,7,-9,1,Jakob Poeltl,TOR,MEM,TOR,,,17,15,9,10
22023,1627751,22300452,"JAN 01, 2024",TOR vs. CLE,W,37,5,8,0.625,0,0,0.0,4,7,0.571,4,7,11,4,0,3,4,4,14,3,1,Jakob Poeltl,TOR,TOR,CLE,,,29,25,18,15
22023,1627751,22300440,"DEC 30, 2023",TOR @ DET,L,35,2,4,0.5,0,0,0.0,0,0,0.0,2,12,14,5,1,3,0,4,4,8,1,Jakob Poeltl,TOR,DET,TOR,,,23,18,9,19
22023,1627751,22300432,"DEC 29, 2023",TOR @ BOS,L,22,5,8,0.625,0,0,0.0,2,2,1.0,4,6,10,3,0,2,0,3,12,-9,1,Jakob Poeltl,TOR,BOS,TOR,,,25,22,15,13
22023,1627751,22300416,"DEC 27, 2023",TOR @ WAS,W,21,4,6,0.667,0,0,0.0,2,4,0.5,3,5,8,2,2,1,2,4,10,16,1,Jakob Poeltl,TOR,WAS,TOR,,,20,18,12,10
22023,1627751,22300395,"DEC 23, 2023",TOR vs. UTA,L,21,1,4,0.25,0,0,0.0,0,0,0.0,2,2,4,3,0,2,0,2,2,3,1,Jakob Poeltl,TOR,TOR,UTA,,,9,6,5,7
22023,1627751,22300382,"DEC 22, 2023",TOR @ PHI,L,29,9,15,0.6,0,0,0.0,1,2,0.5,2,6,8,2,1,0,1,3,19,-14,1,Jakob Poeltl,TOR,PHI,TOR,,,29,27,21,10
22023,1627751,22300369,"DEC 20, 2023",TOR vs. DEN,L,19,2,5,0.4,0,0,0.0,0,0,0.0,2,3,5,3,0,2,1,2,4,-12,1,Jakob Poeltl,TOR,TOR,DEN,,,12,9,7,8
22023,1627751,22300354,"DEC 18, 2023",TOR vs. CHA,W,15,2,2,1.0,0,0,0.0,0,0,0.0,0,1,1,2,0,0,4,3,4,-12,1,Jakob Poeltl,TOR,TOR,CHA,,,7,5,6,3
22023,1627751,22300330,"DEC 15, 2023",TOR vs. ATL,L,25,7,7,1.0,0,0,0.0,1,2,0.5,2,6,8,0,2,1,3,4,15,-12,1,Jakob Poeltl,TOR,TOR,ATL,,,23,23,15,8
22023,1627751,22300313,"DEC 13, 2023",TOR vs. ATL,W,32,5,8,0.625,0,0,0.0,5,8,0.625,4,9,13,6,0,3,1,4,15,12,1,Jakob Poeltl,TOR,TOR,ATL,,,34,28,21,19
22023,1627751,22300297,"DEC 11, 2023",TOR @ NYK,L,24,3,6,0.5,0,0,0.0,5,8,0.625,6,2,8,2,0,0,1,2,11,-6,1,Jakob Poeltl,TOR,NYK,TOR,,,21,19,13,10
22023,1627751,22301216,"DEC 08, 2023",TOR @ CHA,L,26,4,4,1.0,0,0,0.0,0,0,0.0,4,4,8,1,0,0,0,2,8,-8,1,Jakob Poeltl,TOR,CHA,TOR,,,17,16,9,9
22023,1627751,22301207,"DEC 06, 2023",TOR vs. MIA,L,28,1,2,0.5,0,0,0.0,0,2,0.0,1,5,6,1,0,4,0,2,2,-12,1,Jakob Poeltl,TOR,TOR,MIA,,,9,8,3,7
22023,1627751,22300276,"DEC 01, 2023",TOR vs. NYK,L,28,6,9,0.667,0,0,0.0,0,0,0.0,4,8,12,1,0,2,1,4,12,0,1,Jakob Poeltl,TOR,TOR,NYK,,,25,24,13,13
22023,1627751,22300260,"NOV 29, 2023",TOR vs. PHX,W,30,8,9,0.889,0,0,0.0,1,2,0.5,2,2,4,1,0,1,2,4,17,1,1,Jakob Poeltl,TOR,TOR,PHX,,,22,21,18,5
22023,1627751,22300054,"NOV 28, 2023",TOR @ BKN,L,25,3,5,0.6,0,0,0.0,0,0,0.0,3,6,9,4,1,2,1,2,6,0,1,Jakob Poeltl,TOR,BKN,TOR,,,19,15,10,13
22023,1627751,22300251,"NOV 26, 2023",TOR @ CLE,L,35,8,9,0.889,0,0,0.0,2,2,1.0,4,9,13,2,2,0,1,3,18,9,1,Jakob Poeltl,TOR,CLE,TOR,,,33,31,20,15
22023,1627751,22300046,"NOV 24, 2023",TOR vs. CHI,W,31,7,8,0.875,0,0,0.0,1,5,0.2,4,6,10,3,2,1,1,1,15,15,1,Jakob Poeltl,TOR,TOR,CHI,,,28,25,18,13
22023,1627751,22300230,"NOV 22, 2023",TOR @ IND,W,29,3,4,0.75,0,0,0.0,0,0,0.0,1,3,4,6,0,1,3,0,6,-2,1,Jakob Poeltl,TOR,IND,TOR,,,16,10,12,10
22023,1627751,22300038,"NOV 21, 2023",TOR @ ORL,L,23,5,7,0.714,0,0,0.0,0,0,0.0,1,9,10,1,0,1,4,6,10,-13,1,Jakob Poeltl,TOR,ORL,TOR,,,21,20,11,11
22023,1627751,22300211,"NOV 19, 2023",TOR vs. DET,W,25,6,6,1.0,0,0,0.0,4,5,0.8,2,8,10,4,1,3,1,3,16,21,1,Jakob Poeltl,TOR,TOR,DET,,,30,26,20,14
22023,1627751,22300031,"NOV 17, 2023",TOR vs. BOS,L,34,5,5,1.0,0,0,0.0,1,2,0.5,2,6,8,4,1,0,3,0,11,1,1,Jakob Poeltl,TOR,TOR,BOS,,,23,19,15,12
22023,1627751,22300195,"NOV 15, 2023",TOR vs. MIL,L,27,6,10,0.6,0,0,0.0,1,2,0.5,7,4,11,1,4,2,0,4,13,-17,1,Jakob Poeltl,TOR,TOR,MIL,,,25,24,14,12
22023,1627751,22300189,"NOV 13, 2023",TOR vs. WAS,W,24,6,8,0.75,0,0,0.0,1,3,0.333,3,3,6,5,0,0,1,1,13,-14,1,Jakob Poeltl,TOR,TOR,WAS,,,24,19,18,11
22023,1627751,22300174,"NOV 11, 2023",TOR @ BOS,L,21,6,10,0.6,0,0,0.0,0,0,0.0,2,1,3,2,0,0,1,3,12,-9,1,Jakob Poeltl,TOR,BOS,TOR,,,17,15,14,5
22023,1627751,22300168,"NOV 08, 2023",TOR @ DAL,W,21,2,5,0.4,0,0,0.0,0,1,0.0,3,3,6,3,2,0,1,4,4,0,1,Jakob Poeltl,TOR,DAL,TOR,,,13,10,7,9
22023,1627751,22300141,"NOV 05, 2023",TOR @ SAS,W,28,8,10,0.8,0,0,0.0,0,2,0.0,3,7,10,0,3,1,1,2,16,-5,1,Jakob Poeltl,TOR,SAS,TOR,,,26,26,16,10
22023,1627751,22300128,"NOV 02, 2023",TOR @ PHI,L,28,4,8,0.5,0,0,0.0,1,1,1.0,2,7,9,2,0,1,4,2,9,-9,1,Jakob Poeltl,TOR,PHI,TOR,,,20,18,11,11
22023,1627751,22300116,"NOV 01, 2023",TOR vs. MIL,W,29,7,10,0.7,0,0,0.0,0,0,0.0,4,7,11,2,0,3,2,4,14,22,1,Jakob Poeltl,TOR,TOR,MIL,,,27,25,16,13
22023,1627751,22300105,"OCT 30, 2023",TOR vs. POR,L,28,6,8,0.75,0,0,0.0,2,3,0.667,5,5,10,1,0,1,2,3,14,-5,1,Jakob Poeltl,TOR,TOR,POR,,,25,24,15,11
22023,1627751,22300092,"OCT 28, 2023",TOR vs. PHI,L,25,2,5,0.4,0,0,0.0,2,3,0.667,1,6,7,3,0,1,2,2,6,-19,1,Jakob Poeltl,TOR,TOR,PHI,,,16,13,9,10
22023,1627751,22300082,"OCT 27, 2023",TOR @ CHI,L,19,4,5,0.8,0,0,0.0,0,0,0.0,0,6,6,0,0,0,3,6,8,20,1,Jakob Poeltl,TOR,CHI,TOR,,,14,14,8,6
22023,1627751,22300069,"OCT 25, 2023",TOR vs. MIN,W,24,3,3,1.0,0,0,0.0,1,4,0.25,3,8,11,1,1,1,0,1,7,8,1,Jakob Poeltl,TOR,TOR,MIN,,,19,18,8,12
22023,1630197,22300302,"DEC 11, 2023",OKC vs. UTA,W,9,0,2,0.0,0,2,0.0,0,0,0.0,0,1,1,0,0,0,0,0,0,-17,1,Aleksej Pokusevski,OKC,OKC,UTA,,,1,1,0,1
22023,1630197,22300271,"NOV 30, 2023",OKC vs. LAL,W,3,0,1,0.0,0,0,0.0,0,0,0.0,0,0,0,0,0,0,0,1,0,3,1,Aleksej Pokusevski,OKC,OKC,LAL,,,0,0,0,0
22023,1630197,22300215,"NOV 19, 2023",OKC @ POR,W,9,2,3,0.667,1,1,1.0,0,0,0.0,2,1,3,4,0,0,0,1,5,9,1,Aleksej Pokusevski,OKC,POR,OKC,,,12,8,9,7
22023,1630197,22300021,"NOV 14, 2023",OKC vs. SAS,W,5,0,1,0.0,0,1,0.0,0,0,0.0,0,1,1,1,0,0,0,0,0,2,1,Aleksej Pokusevski,OKC,OKC,SAS,,,2,1,1,2
22023,1630197,22300109,"OCT 30, 2023",OKC vs. DET,W,2,0,2,0.0,0,2,0.0,0,0,0.0,0,0,0,0,0,0,1,2,0,-8,1,Aleksej Pokusevski,OKC,OKC,DET,,,0,0,0,0
22023,1630197,22300095,"OCT 29, 2023",OKC vs. DEN,L,14,0,1,0.0,0,1,0.0,1,2,0.5,0,1,1,0,0,1,2,1,1,-11,1,Aleksej Pokusevski,OKC,OKC,DEN,,,2,2,1,1
22023,1630197,22300070,"OCT 25, 2023",OKC @ CHI,W,2,0,1,0.0,0,1,0.0,0,0,0.0,0,2,2,0,0,0,0,0,0,0,1,Aleksej Pokusevski,OKC,CHI,OKC,,,2,2,0,2
22023,1629673,22300558,"JAN 15, 2024",WAS vs. DET,L,32,6,14,0.429,2,7,0.286,2,2,1.0,0,0,0,2,0,0,1,3,16,-9,1,Jordan Poole,WAS,WAS,DET,,,18,16,18,2
22023,1629673,22300543,"JAN 13, 2024",WAS @ ATL,W,26,8,16,0.5,2,6,0.333,2,2,1.0,0,2,2,2,1,1,1,1,20,19,1,Jordan Poole,WAS,ATL,WAS,,,24,22,22,4
22023,1629673,22300520,"JAN 10, 2024",WAS @ IND,L,34,11,21,0.524,2,7,0.286,4,6,0.667,1,3,4,7,3,0,1,3,28,0,1,Jordan Poole,WAS,IND,WAS,,,39,32,35,11
22023,1629673,22300508,"JAN 08, 2024",WAS vs. OKC,L,29,8,17,0.471,4,8,0.5,4,5,0.8,0,0,0,5,0,0,1,5,24,3,1,Jordan Poole,WAS,WAS,OKC,,,29,24,29,5
22023,1629673,22300494,"JAN 06, 2024",WAS vs. NYK,L,30,4,10,0.4,1,5,0.2,1,2,0.5,0,3,3,4,2,0,2,3,10,-1,1,Jordan Poole,WAS,WAS,NYK,,,17,13,14,7
22023,1629673,22300482,"JAN 05, 2024",WAS @ CLE,L,23,0,4,0.0,0,2,0.0,2,2,1.0,0,0,0,1,0,1,0,4,2,-14,1,Jordan Poole,WAS,CLE,WAS,,,3,2,3,1
22023,1629673,22300465,"JAN 03, 2024",WAS @ CLE,L,23,3,11,0.273,2,4,0.5,0,0,0.0,3,0,3,2,0,0,1,3,8,-22,1,Jordan Poole,WAS,CLE,WAS,,,13,11,10,5
22023,1629673,22300445,"DEC 31, 2023",WAS vs. ATL,L,29,6,14,0.429,1,7,0.143,0,0,0.0,0,3,3,6,0,1,0,3,13,6,1,Jordan Poole,WAS,WAS,ATL,,,22,16,19,9
22023,1629673,22300430,"DEC 29, 2023",WAS vs. BKN,W,25,2,6,0.333,1,4,0.25,0,0,0.0,0,0,0,5,0,0,1,4,5,-16,1,Jordan Poole,WAS,WAS,BKN,,,10,5,10,5
22023,1629673,22300416,"DEC 27, 2023",WAS vs. TOR,L,28,5,12,0.417,1,7,0.143,3,4,0.75,2,2,4,4,0,1,2,1,14,-17,1,Jordan Poole,WAS,WAS,TOR,,,22,18,18,8
22023,1629673,22300407,"DEC 26, 2023",WAS vs. ORL,L,33,11,20,0.55,6,11,0.545,2,2,1.0,0,2,2,3,3,0,3,3,30,-18,1,Jordan Poole,WAS,WAS,ORL,,,35,32,33,5
22023,1629673,22300386,"DEC 22, 2023",WAS @ GSW,L,27,7,21,0.333,3,12,0.25,8,9,0.889,1,2,3,3,2,0,1,3,25,-9,1,Jordan Poole,WAS,GSW,WAS,,,31,28,28,6
22023,1629673,22300381,"DEC 21, 2023",WAS @ POR,W,34,4,13,0.308,0,4,0.0,5,5,1.0,0,2,2,6,1,0,3,2,13,5,1,Jordan Poole,WAS,POR,WAS,,,21,15,19,8
22023,1629673,22300358,"DEC 18, 2023",WAS @ SAC,L,29,10,18,0.556,8,13,0.615,0,0,0.0,0,0,0,2,0,0,1,4,28,-8,1,Jordan Poole,WAS,SAC,WAS,,,30,28,30,2
22023,1629673,22300347,"DEC 17, 2023",WAS @ PHX,L,32,5,17,0.294,2,9,0.222,2,2,1.0,0,4,4,4,1,0,4,4,14,4,1,Jordan Poole,WAS,PHX,WAS,,,22,18,18,8
22023,1629673,22300328,"DEC 15, 2023",WAS vs. IND,W,32,12,18,0.667,3,4,0.75,3,4,0.75,0,4,4,8,1,0,2,4,30,15,1,Jordan Poole,WAS,WAS,IND,,,42,34,38,12
22023,1629673,22300311,"DEC 13, 2023",WAS vs. NOP,L,31,5,12,0.417,1,5,0.2,0,0,0.0,0,1,1,4,2,1,4,2,11,-10,1,Jordan Poole,WAS,WAS,NOP,,,16,12,15,5
22023,1629673,22300295,"DEC 11, 2023",WAS @ PHI,L,26,3,11,0.273,1,3,0.333,4,4,1.0,0,0,0,3,0,0,3,1,11,-30,1,Jordan Poole,WAS,PHI,WAS,,,14,11,14,3
22023,1629673,22301219,"DEC 08, 2023",WAS @ BKN,L,24,3,7,0.429,0,2,0.0,2,2,1.0,0,2,2,2,0,0,3,3,8,-16,1,Jordan Poole,WAS,BKN,WAS,,,12,10,10,4
22023,1629673,22301208,"DEC 06, 2023",WAS vs. PHI,L,32,10,16,0.625,3,5,0.6,0,0,0.0,0,1,1,2,1,0,3,3,23,-10,1,Jordan Poole,WAS,WAS,PHI,,,26,24,25,3
22023,1629673,22300274,"DEC 01, 2023",WAS @ ORL,L,30,3,12,0.25,0,5,0.0,8,9,0.889,0,4,4,4,1,0,2,5,14,-4,1,Jordan Poole,WAS,ORL,WAS,,,22,18,18,8
22023,1629673,22300259,"NOV 29, 2023",WAS @ ORL,L,26,5,12,0.417,4,7,0.571,5,6,0.833,0,5,5,2,2,1,2,3,19,-6,1,Jordan Poole,WAS,ORL,WAS,,,26,24,21,7
22023,1629673,22300253,"NOV 27, 2023",WAS @ DET,W,25,3,9,0.333,0,2,0.0,4,4,1.0,0,0,0,3,1,0,4,3,10,10,1,Jordan Poole,WAS,DET,WAS,,,13,10,13,3
22023,1629673,22300049,"NOV 24, 2023",WAS @ MIL,L,34,9,20,0.45,1,6,0.167,7,9,0.778,1,4,5,7,0,0,2,5,26,-3,1,Jordan Poole,WAS,MIL,WAS,,,38,31,33,12
22023,1629673,22300225,"NOV 22, 2023",WAS @ CHA,L,33,8,21,0.381,4,11,0.364,4,4,1.0,2,3,5,2,3,0,3,1,24,-14,1,Jordan Poole,WAS,CHA,WAS,,,31,29,26,7
22023,1629673,22300219,"NOV 20, 2023",WAS vs. MIL,L,33,11,26,0.423,3,9,0.333,5,5,1.0,0,1,1,1,0,0,0,4,30,-26,1,Jordan Poole,WAS,WAS,MIL,,,32,31,31,2
22023,1629673,22300028,"NOV 17, 2023",WAS vs. NYK,L,29,2,11,0.182,0,6,0.0,4,4,1.0,0,1,1,4,0,0,5,2,8,-18,1,Jordan Poole,WAS,WAS,NYK,,,13,9,12,5
22023,1629673,22300192,"NOV 15, 2023",WAS vs. DAL,L,32,6,17,0.353,2,7,0.286,2,2,1.0,1,4,5,3,1,0,5,4,16,-10,1,Jordan Poole,WAS,WAS,DAL,,,24,21,19,8
22023,1629673,22300189,"NOV 13, 2023",WAS @ TOR,L,35,6,16,0.375,2,6,0.333,0,0,0.0,2,2,4,6,3,1,4,5,14,-12,1,Jordan Poole,WAS,TOR,WAS,,,24,18,20,10
22023,1629673,22300178,"NOV 12, 2023",WAS @ BKN,L,32,5,12,0.417,2,8,0.25,0,1,0.0,0,5,5,2,0,1,3,6,12,-22,1,Jordan Poole,WAS,BKN,WAS,,,19,17,14,7
22023,1629673,22300009,"NOV 10, 2023",WAS vs. CHA,L,31,6,14,0.429,1,5,0.2,1,1,1.0,0,2,2,6,0,0,3,4,14,-17,1,Jordan Poole,WAS,WAS,CHA,,,22,16,20,8
22023,1629673,22300157,"NOV 08, 2023",WAS @ CHA,W,20,3,12,0.25,1,5,0.2,4,5,0.8,1,1,2,1,0,0,1,2,11,-5,1,Jordan Poole,WAS,CHA,WAS,,,14,13,12,3
22023,1629673,22300148,"NOV 06, 2023",WAS @ PHI,L,31,8,15,0.533,4,9,0.444,3,3,1.0,0,1,1,6,0,1,2,4,23,-3,1,Jordan Poole,WAS,PHI,WAS,,,30,24,29,7
22023,1629673,22300003,"NOV 03, 2023",WAS @ MIA,L,28,8,14,0.571,3,4,0.75,0,1,0.0,0,1,1,6,4,0,2,3,19,-21,1,Jordan Poole,WAS,MIA,WAS,,,26,20,25,7
22023,1629673,22300117,"NOV 01, 2023",WAS @ ATL,L,20,5,13,0.385,2,6,0.333,1,1,1.0,0,0,0,1,1,0,1,1,13,-22,1,Jordan Poole,WAS,ATL,WAS,,,14,13,14,1
22023,1629673,22300103,"OCT 30, 2023",WAS vs. BOS,L,25,5,11,0.455,1,5,0.2,0,0,0.0,2,1,3,2,3,1,3,3,11,-29,1,Jordan Poole,WAS,WAS,BOS,,,16,14,13,5
22023,1629673,22300089,"OCT 28, 2023",WAS vs. MEM,W,36,8,23,0.348,4,12,0.333,7,9,0.778,0,4,4,2,1,1,5,2,27,13,1,Jordan Poole,WAS,WAS,MEM,,,33,31,29,6
22023,1629673,22300064,"OCT 25, 2023",WAS @ IND,L,26,7,18,0.389,0,6,0.0,4,5,0.8,0,2,2,5,1,1,4,1,18,-12,1,Jordan Poole,WAS,IND,WAS,,,25,20,23,7
22023,1641854,22300497,"JAN 07, 2024",CLE vs. SAS,W,4,0,0,0.0,0,0,0.0,0,0,0.0,0,1,1,1,0,1,0,0,0,8,1,Craig Porter,CLE,CLE,SAS,,,2,1,1,2
22023,1641854,22300482,"JAN 05, 2024",CLE vs. WAS,W,12,3,6,0.5,0,0,0.0,1,1,1.0,1,3,4,4,1,0,5,2,7,4,1,Craig Porter,CLE,CLE,WAS,,,15,11,11,8
22023,1641854,22300465,"JAN 03, 2024",CLE vs. WAS,W,15,4,5,0.8,0,0,0.0,0,1,0.0,1,2,3,3,0,0,1,0,8,7,1,Craig Porter,CLE,CLE,WAS,,,14,11,11,6
22023,1641854,22300452,"JAN 01, 2024",CLE @ TOR,L,6,0,2,0.0,0,1,0.0,0,0,0.0,0,1,1,0,0,0,0,1,0,-11,1,Craig Porter,CLE,TOR,CLE,,,1,1,0,1
22023,1641854,22300433,"DEC 29, 2023",CLE vs. MIL,L,15,6,10,0.6,1,3,0.333,1,1,1.0,0,1,1,1,1,0,0,1,14,0,1,Craig Porter,CLE,CLE,MIL,,,16,15,15,2
22023,1641854,22300420,"DEC 27, 2023",CLE @ DAL,W,30,4,11,0.364,0,1,0.0,1,2,0.5,4,8,12,7,3,1,2,4,9,9,1,Craig Porter,CLE,DAL,CLE,,,28,21,16,19
22023,1641854,22300396,"DEC 23, 2023",CLE @ CHI,W,39,8,14,0.571,1,3,0.333,2,5,0.4,1,6,7,8,1,1,3,1,19,14,1,Craig Porter,CLE,CHI,CLE,,,34,26,27,15
22023,1641854,22300375,"DEC 21, 2023",CLE vs. NOP,L,29,3,9,0.333,1,1,1.0,0,0,0.0,0,3,3,11,1,0,2,1,7,3,1,Craig Porter,CLE,CLE,NOP,,,21,10,18,14
22023,1641854,22300364,"DEC 20, 2023",CLE vs. UTA,W,25,2,7,0.286,0,2,0.0,2,2,1.0,3,4,7,6,0,3,0,0,6,-2,1,Craig Porter,CLE,CLE,UTA,,,19,13,12,13
22023,1641854,22300349,"DEC 18, 2023",CLE vs. HOU,W,9,1,2,0.5,1,1,1.0,0,0,0.0,0,0,0,3,1,0,0,0,3,4,1,Craig Porter,CLE,CLE,HOU,,,6,3,6,3
22023,1641854,22300336,"DEC 16, 2023",CLE vs. ATL,W,15,3,8,0.375,0,1,0.0,0,0,0.0,1,1,2,3,0,0,1,1,6,6,1,Craig Porter,CLE,CLE,ATL,,,11,8,9,5
22023,1641854,22301220,"DEC 08, 2023",CLE @ MIA,W,23,3,7,0.429,0,0,0.0,2,4,0.5,0,3,3,4,2,1,0,0,8,7,1,Craig Porter,CLE,MIA,CLE,,,15,11,12,7
22023,1641854,22300283,"DEC 02, 2023",CLE @ DET,W,4,0,0,0.0,0,0,0.0,0,0,0.0,0,0,0,0,0,0,0,1,0,0,1,Craig Porter,CLE,DET,CLE,,,0,0,0,0
22023,1641854,22300055,"NOV 28, 2023",CLE vs. ATL,W,3,1,2,0.5,0,0,0.0,0,0,0.0,0,0,0,0,0,0,2,0,2,-8,1,Craig Porter,CLE,CLE,ATL,,,2,2,2,0
22023,1641854,22300242,"NOV 25, 2023",CLE vs. LAL,L,17,5,7,0.714,1,1,1.0,0,0,0.0,0,1,1,1,0,0,1,2,11,-10,1,Craig Porter,CLE,CLE,LAL,,,13,12,12,2
22023,1641854,22300229,"NOV 22, 2023",CLE vs. MIA,L,35,6,12,0.5,2,5,0.4,2,3,0.667,0,2,2,5,1,2,4,1,16,-24,1,Craig Porter,CLE,CLE,MIA,,,23,18,21,7
22023,1641854,22300040,"NOV 21, 2023",CLE @ PHI,W,27,5,9,0.556,0,0,0.0,2,2,1.0,0,3,3,9,0,1,1,0,12,21,1,Craig Porter,CLE,PHI,CLE,,,24,15,21,12
22023,1641854,22300210,"NOV 19, 2023",CLE vs. DEN,W,25,7,10,0.7,0,0,0.0,7,7,1.0,2,2,4,4,2,1,1,3,21,-2,1,Craig Porter,CLE,CLE,DEN,,,29,25,25,8
22023,1641854,22300030,"NOV 17, 2023",CLE vs. DET,W,16,5,9,0.556,0,0,0.0,2,2,1.0,0,3,3,5,1,0,0,0,12,14,1,Craig Porter,CLE,CLE,DET,,,20,15,17,8
22023,1641854,22300199,"NOV 15, 2023",CLE @ POR,W,9,2,3,0.667,0,0,0.0,0,0,0.0,0,2,2,0,0,0,2,1,4,-8,1,Craig Porter,CLE,POR,CLE,,,6,6,4,2
22023,1641854,22300191,"NOV 13, 2023",CLE @ SAC,L,3,0,1,0.0,0,0,0.0,0,0,0.0,0,3,3,3,0,0,0,1,0,1,1,Craig Porter,CLE,SAC,CLE,,,6,3,3,6
22023,1641854,22300176,"NOV 11, 2023",CLE @ GSW,W,2,0,0,0.0,0,0,0.0,1,6,0.167,0,0,0,0,0,0,0,0,1,-8,1,Craig Porter,CLE,GSW,CLE,,,1,1,1,0
22023,1641854,22300120,"NOV 01, 2023",CLE @ NYK,W,11,1,1,1.0,0,0,0.0,2,2,1.0,0,1,1,0,1,0,0,3,4,3,1,Craig Porter,CLE,NYK,CLE,,,5,5,4,1
22023,1641854,22300112,"OCT 31, 2023",CLE vs. NYK,L,22,5,12,0.417,0,1,0.0,0,0,0.0,1,3,4,2,2,1,3,3,10,-9,1,Craig Porter,CLE,CLE,NYK,,,16,14,12,6
22023,1641854,22300091,"OCT 28, 2023",CLE vs. IND,L,4,0,0,0.0,0,0,0.0,0,0,0.0,0,0,0,1,0,0,0,0,0,-10,1,Craig Porter,CLE,CLE,IND,,,1,0,1,1
22023,1629008,22300550,"JAN 14, 2024",DEN vs. IND,W,37,9,15,0.6,7,11,0.636,0,0,0.0,0,8,8,5,1,2,1,1,25,13,1,Michael Porter Jr.,DEN,DEN,IND,15.5,Points,38,33,30,13
22023,1629008,22300550,"JAN 14, 2024",DEN vs. IND,W,37,9,15,0.6,7,11,0.636,0,0,0.0,0,8,8,5,1,2,1,1,25,13,1,Michael Porter Jr.,DEN,DEN,IND,6.0,Rebounds,38,33,30,13
22023,1629008,22300550,"JAN 14, 2024",DEN vs. IND,W,37,9,15,0.6,7,11,0.636,0,0,0.0,0,8,8,5,1,2,1,1,25,13,1,Michael Porter Jr.,DEN,DEN,IND,23.5,Pts+Rebs+Asts,38,33,30,13
22023,1629008,22300550,"JAN 14, 2024",DEN vs. IND,W,37,9,15,0.6,7,11,0.636,0,0,0.0,0,8,8,5,1,2,1,1,25,13,1,Michael Porter Jr.,DEN,DEN,IND,21.5,Pts+Rebs,38,33,30,13
22023,1629008,22300550,"JAN 14, 2024",DEN vs. IND,W,37,9,15,0.6,7,11,0.636,0,0,0.0,0,8,8,5,1,2,1,1,25,13,1,Michael Porter Jr.,DEN,DEN,IND,16.5,Pts+Asts,38,33,30,13
22023,1629008,22300550,"JAN 14, 2024",DEN vs. IND,W,37,9,15,0.6,7,11,0.636,0,0,0.0,0,8,8,5,1,2,1,1,25,13,1,Michael Porter Jr.,DEN,DEN,IND,2.5,3-PT Made,38,33,30,13
22023,1629008,22300550,"JAN 14, 2024",DEN vs. IND,W,37,9,15,0.6,7,11,0.636,0,0,0.0,0,8,8,5,1,2,1,1,25,13,1,Michael Porter Jr.,DEN,DEN,IND,0.5,Blocked Shots,38,33,30,13
22023,1629008,22300550,"JAN 14, 2024",DEN vs. IND,W,37,9,15,0.6,7,11,0.636,0,0,0.0,0,8,8,5,1,2,1,1,25,13,1,Michael Porter Jr.,DEN,DEN,IND,7.5,Rebs+Asts,38,33,30,13
22023,1629008,22300539,"JAN 12, 2024",DEN vs. NOP,W,33,8,12,0.667,2,5,0.4,2,3,0.667,1,9,10,1,1,1,1,2,20,14,1,Michael Porter Jr.,DEN,DEN,NOP,15.5,Points,31,30,21,11
22023,1629008,22300539,"JAN 12, 2024",DEN vs. NOP,W,33,8,12,0.667,2,5,0.4,2,3,0.667,1,9,10,1,1,1,1,2,20,14,1,Michael Porter Jr.,DEN,DEN,NOP,6.0,Rebounds,31,30,21,11
22023,1629008,22300539,"JAN 12, 2024",DEN vs. NOP,W,33,8,12,0.667,2,5,0.4,2,3,0.667,1,9,10,1,1,1,1,2,20,14,1,Michael Porter Jr.,DEN,DEN,NOP,23.5,Pts+Rebs+Asts,31,30,21,11
22023,1629008,22300539,"JAN 12, 2024",DEN vs. NOP,W,33,8,12,0.667,2,5,0.4,2,3,0.667,1,9,10,1,1,1,1,2,20,14,1,Michael Porter Jr.,DEN,DEN,NOP,21.5,Pts+Rebs,31,30,21,11
22023,1629008,22300539,"JAN 12, 2024",DEN vs. NOP,W,33,8,12,0.667,2,5,0.4,2,3,0.667,1,9,10,1,1,1,1,2,20,14,1,Michael Porter Jr.,DEN,DEN,NOP,16.5,Pts+Asts,31,30,21,11
22023,1629008,22300539,"JAN 12, 2024",DEN vs. NOP,W,33,8,12,0.667,2,5,0.4,2,3,0.667,1,9,10,1,1,1,1,2,20,14,1,Michael Porter Jr.,DEN,DEN,NOP,2.5,3-PT Made,31,30,21,11
22023,1629008,22300539,"JAN 12, 2024",DEN vs. NOP,W,33,8,12,0.667,2,5,0.4,2,3,0.667,1,9,10,1,1,1,1,2,20,14,1,Michael Porter Jr.,DEN,DEN,NOP,0.5,Blocked Shots,31,30,21,11
22023,1629008,22300539,"JAN 12, 2024",DEN vs. NOP,W,33,8,12,0.667,2,5,0.4,2,3,0.667,1,9,10,1,1,1,1,2,20,14,1,Michael Porter Jr.,DEN,DEN,NOP,7.5,Rebs+Asts,31,30,21,11
22023,1629008,22300524,"JAN 10, 2024",DEN @ UTA,L,24,2,9,0.222,1,3,0.333,0,0,0.0,1,3,4,1,0,0,1,2,5,-18,1,Michael Porter Jr.,DEN,UTA,DEN,15.5,Points,10,9,6,5
22023,1629008,22300524,"JAN 10, 2024",DEN @ UTA,L,24,2,9,0.222,1,3,0.333,0,0,0.0,1,3,4,1,0,0,1,2,5,-18,1,Michael Porter Jr.,DEN,UTA,DEN,6.0,Rebounds,10,9,6,5
22023,1629008,22300524,"JAN 10, 2024",DEN @ UTA,L,24,2,9,0.222,1,3,0.333,0,0,0.0,1,3,4,1,0,0,1,2,5,-18,1,Michael Porter Jr.,DEN,UTA,DEN,23.5,Pts+Rebs+Asts,10,9,6,5
22023,1629008,22300524,"JAN 10, 2024",DEN @ UTA,L,24,2,9,0.222,1,3,0.333,0,0,0.0,1,3,4,1,0,0,1,2,5,-18,1,Michael Porter Jr.,DEN,UTA,DEN,21.5,Pts+Rebs,10,9,6,5
22023,1629008,22300524,"JAN 10, 2024",DEN @ UTA,L,24,2,9,0.222,1,3,0.333,0,0,0.0,1,3,4,1,0,0,1,2,5,-18,1,Michael Porter Jr.,DEN,UTA,DEN,16.5,Pts+Asts,10,9,6,5
22023,1629008,22300524,"JAN 10, 2024",DEN @ UTA,L,24,2,9,0.222,1,3,0.333,0,0,0.0,1,3,4,1,0,0,1,2,5,-18,1,Michael Porter Jr.,DEN,UTA,DEN,2.5,3-PT Made,10,9,6,5
22023,1629008,22300524,"JAN 10, 2024",DEN @ UTA,L,24,2,9,0.222,1,3,0.333,0,0,0.0,1,3,4,1,0,0,1,2,5,-18,1,Michael Porter Jr.,DEN,UTA,DEN,0.5,Blocked Shots,10,9,6,5
22023,1629008,22300524,"JAN 10, 2024",DEN @ UTA,L,24,2,9,0.222,1,3,0.333,0,0,0.0,1,3,4,1,0,0,1,2,5,-18,1,Michael Porter Jr.,DEN,UTA,DEN,7.5,Rebs+Asts,10,9,6,5
22023,1629008,22300502,"JAN 07, 2024",DEN vs. DET,W,28,7,12,0.583,1,5,0.2,3,3,1.0,0,1,1,2,0,0,1,1,18,29,1,Michael Porter Jr.,DEN,DEN,DET,15.5,Points,21,19,20,3
22023,1629008,22300502,"JAN 07, 2024",DEN vs. DET,W,28,7,12,0.583,1,5,0.2,3,3,1.0,0,1,1,2,0,0,1,1,18,29,1,Michael Porter Jr.,DEN,DEN,DET,6.0,Rebounds,21,19,20,3
22023,1629008,22300502,"JAN 07, 2024",DEN vs. DET,W,28,7,12,0.583,1,5,0.2,3,3,1.0,0,1,1,2,0,0,1,1,18,29,1,Michael Porter Jr.,DEN,DEN,DET,23.5,Pts+Rebs+Asts,21,19,20,3
22023,1629008,22300502,"JAN 07, 2024",DEN vs. DET,W,28,7,12,0.583,1,5,0.2,3,3,1.0,0,1,1,2,0,0,1,1,18,29,1,Michael Porter Jr.,DEN,DEN,DET,21.5,Pts+Rebs,21,19,20,3
22023,1629008,22300502,"JAN 07, 2024",DEN vs. DET,W,28,7,12,0.583,1,5,0.2,3,3,1.0,0,1,1,2,0,0,1,1,18,29,1,Michael Porter Jr.,DEN,DEN,DET,16.5,Pts+Asts,21,19,20,3
22023,1629008,22300502,"JAN 07, 2024",DEN vs. DET,W,28,7,12,0.583,1,5,0.2,3,3,1.0,0,1,1,2,0,0,1,1,18,29,1,Michael Porter Jr.,DEN,DEN,DET,2.5,3-PT Made,21,19,20,3
22023,1629008,22300502,"JAN 07, 2024",DEN vs. DET,W,28,7,12,0.583,1,5,0.2,3,3,1.0,0,1,1,2,0,0,1,1,18,29,1,Michael Porter Jr.,DEN,DEN,DET,0.5,Blocked Shots,21,19,20,3
22023,1629008,22300502,"JAN 07, 2024",DEN vs. DET,W,28,7,12,0.583,1,5,0.2,3,3,1.0,0,1,1,2,0,0,1,1,18,29,1,Michael Porter Jr.,DEN,DEN,DET,7.5,Rebs+Asts,21,19,20,3
22023,1629008,22300488,"JAN 05, 2024",DEN vs. ORL,L,31,9,14,0.643,4,6,0.667,0,0,0.0,0,3,3,1,2,0,0,2,22,6,1,Michael Porter Jr.,DEN,DEN,ORL,15.5,Points,26,25,23,4
22023,1629008,22300488,"JAN 05, 2024",DEN vs. ORL,L,31,9,14,0.643,4,6,0.667,0,0,0.0,0,3,3,1,2,0,0,2,22,6,1,Michael Porter Jr.,DEN,DEN,ORL,6.0,Rebounds,26,25,23,4
22023,1629008,22300488,"JAN 05, 2024",DEN vs. ORL,L,31,9,14,0.643,4,6,0.667,0,0,0.0,0,3,3,1,2,0,0,2,22,6,1,Michael Porter Jr.,DEN,DEN,ORL,23.5,Pts+Rebs+Asts,26,25,23,4
22023,1629008,22300488,"JAN 05, 2024",DEN vs. ORL,L,31,9,14,0.643,4,6,0.667,0,0,0.0,0,3,3,1,2,0,0,2,22,6,1,Michael Porter Jr.,DEN,DEN,ORL,21.5,Pts+Rebs,26,25,23,4
22023,1629008,22300488,"JAN 05, 2024",DEN vs. ORL,L,31,9,14,0.643,4,6,0.667,0,0,0.0,0,3,3,1,2,0,0,2,22,6,1,Michael Porter Jr.,DEN,DEN,ORL,16.5,Pts+Asts,26,25,23,4
22023,1629008,22300488,"JAN 05, 2024",DEN vs. ORL,L,31,9,14,0.643,4,6,0.667,0,0,0.0,0,3,3,1,2,0,0,2,22,6,1,Michael Porter Jr.,DEN,DEN,ORL,2.5,3-PT Made,26,25,23,4
22023,1629008,22300488,"JAN 05, 2024",DEN vs. ORL,L,31,9,14,0.643,4,6,0.667,0,0,0.0,0,3,3,1,2,0,0,2,22,6,1,Michael Porter Jr.,DEN,DEN,ORL,0.5,Blocked Shots,26,25,23,4
22023,1629008,22300488,"JAN 05, 2024",DEN vs. ORL,L,31,9,14,0.643,4,6,0.667,0,0,0.0,0,3,3,1,2,0,0,2,22,6,1,Michael Porter Jr.,DEN,DEN,ORL,7.5,Rebs+Asts,26,25,23,4
22023,1629008,22300478,"JAN 04, 2024",DEN @ GSW,W,30,3,6,0.5,2,5,0.4,0,0,0.0,0,4,4,0,0,0,0,3,8,5,1,Michael Porter Jr.,DEN,GSW,DEN,15.5,Points,12,12,8,4
22023,1629008,22300478,"JAN 04, 2024",DEN @ GSW,W,30,3,6,0.5,2,5,0.4,0,0,0.0,0,4,4,0,0,0,0,3,8,5,1,Michael Porter Jr.,DEN,GSW,DEN,6.0,Rebounds,12,12,8,4
22023,1629008,22300478,"JAN 04, 2024",DEN @ GSW,W,30,3,6,0.5,2,5,0.4,0,0,0.0,0,4,4,0,0,0,0,3,8,5,1,Michael Porter Jr.,DEN,GSW,DEN,23.5,Pts+Rebs+Asts,12,12,8,4
22023,1629008,22300478,"JAN 04, 2024",DEN @ GSW,W,30,3,6,0.5,2,5,0.4,0,0,0.0,0,4,4,0,0,0,0,3,8,5,1,Michael Porter Jr.,DEN,GSW,DEN,21.5,Pts+Rebs,12,12,8,4
22023,1629008,22300478,"JAN 04, 2024",DEN @ GSW,W,30,3,6,0.5,2,5,0.4,0,0,0.0,0,4,4,0,0,0,0,3,8,5,1,Michael Porter Jr.,DEN,GSW,DEN,16.5,Pts+Asts,12,12,8,4
22023,1629008,22300478,"JAN 04, 2024",DEN @ GSW,W,30,3,6,0.5,2,5,0.4,0,0,0.0,0,4,4,0,0,0,0,3,8,5,1,Michael Porter Jr.,DEN,GSW,DEN,2.5,3-PT Made,12,12,8,4
22023,1629008,22300478,"JAN 04, 2024",DEN @ GSW,W,30,3,6,0.5,2,5,0.4,0,0,0.0,0,4,4,0,0,0,0,3,8,5,1,Michael Porter Jr.,DEN,GSW,DEN,0.5,Blocked Shots,12,12,8,4
22023,1629008,22300478,"JAN 04, 2024",DEN @ GSW,W,30,3,6,0.5,2,5,0.4,0,0,0.0,0,4,4,0,0,0,0,3,8,5,1,Michael Porter Jr.,DEN,GSW,DEN,7.5,Rebs+Asts,12,12,8,4
22023,1629008,22300455,"JAN 01, 2024",DEN vs. CHA,W,31,8,17,0.471,4,11,0.364,2,2,1.0,1,7,8,1,0,0,1,1,22,33,1,Michael Porter Jr.,DEN,DEN,CHA,15.5,Points,31,30,23,9
22023,1629008,22300455,"JAN 01, 2024",DEN vs. CHA,W,31,8,17,0.471,4,11,0.364,2,2,1.0,1,7,8,1,0,0,1,1,22,33,1,Michael Porter Jr.,DEN,DEN,CHA,6.0,Rebounds,31,30,23,9
22023,1629008,22300455,"JAN 01, 2024",DEN vs. CHA,W,31,8,17,0.471,4,11,0.364,2,2,1.0,1,7,8,1,0,0,1,1,22,33,1,Michael Porter Jr.,DEN,DEN,CHA,23.5,Pts+Rebs+Asts,31,30,23,9
22023,1629008,22300455,"JAN 01, 2024",DEN vs. CHA,W,31,8,17,0.471,4,11,0.364,2,2,1.0,1,7,8,1,0,0,1,1,22,33,1,Michael Porter Jr.,DEN,DEN,CHA,21.5,Pts+Rebs,31,30,23,9
22023,1629008,22300455,"JAN 01, 2024",DEN vs. CHA,W,31,8,17,0.471,4,11,0.364,2,2,1.0,1,7,8,1,0,0,1,1,22,33,1,Michael Porter Jr.,DEN,DEN,CHA,16.5,Pts+Asts,31,30,23,9
22023,1629008,22300455,"JAN 01, 2024",DEN vs. CHA,W,31,8,17,0.471,4,11,0.364,2,2,1.0,1,7,8,1,0,0,1,1,22,33,1,Michael Porter Jr.,DEN,DEN,CHA,2.5,3-PT Made,31,30,23,9
22023,1629008,22300455,"JAN 01, 2024",DEN vs. CHA,W,31,8,17,0.471,4,11,0.364,2,2,1.0,1,7,8,1,0,0,1,1,22,33,1,Michael Porter Jr.,DEN,DEN,CHA,0.5,Blocked Shots,31,30,23,9
22023,1629008,22300455,"JAN 01, 2024",DEN vs. CHA,W,31,8,17,0.471,4,11,0.364,2,2,1.0,1,7,8,1,0,0,1,1,22,33,1,Michael Porter Jr.,DEN,DEN,CHA,7.5,Rebs+Asts,31,30,23,9
22023,1629008,22300435,"DEC 29, 2023",DEN vs. OKC,L,31,4,12,0.333,2,8,0.25,2,2,1.0,0,6,6,1,0,1,0,1,12,-10,1,Michael Porter Jr.,DEN,DEN,OKC,15.5,Points,19,18,13,7
22023,1629008,22300435,"DEC 29, 2023",DEN vs. OKC,L,31,4,12,0.333,2,8,0.25,2,2,1.0,0,6,6,1,0,1,0,1,12,-10,1,Michael Porter Jr.,DEN,DEN,OKC,6.0,Rebounds,19,18,13,7
22023,1629008,22300435,"DEC 29, 2023",DEN vs. OKC,L,31,4,12,0.333,2,8,0.25,2,2,1.0,0,6,6,1,0,1,0,1,12,-10,1,Michael Porter Jr.,DEN,DEN,OKC,23.5,Pts+Rebs+Asts,19,18,13,7
22023,1629008,22300435,"DEC 29, 2023",DEN vs. OKC,L,31,4,12,0.333,2,8,0.25,2,2,1.0,0,6,6,1,0,1,0,1,12,-10,1,Michael Porter Jr.,DEN,DEN,OKC,21.5,Pts+Rebs,19,18,13,7
22023,1629008,22300435,"DEC 29, 2023",DEN vs. OKC,L,31,4,12,0.333,2,8,0.25,2,2,1.0,0,6,6,1,0,1,0,1,12,-10,1,Michael Porter Jr.,DEN,DEN,OKC,16.5,Pts+Asts,19,18,13,7
22023,1629008,22300435,"DEC 29, 2023",DEN vs. OKC,L,31,4,12,0.333,2,8,0.25,2,2,1.0,0,6,6,1,0,1,0,1,12,-10,1,Michael Porter Jr.,DEN,DEN,OKC,2.5,3-PT Made,19,18,13,7
22023,1629008,22300435,"DEC 29, 2023",DEN vs. OKC,L,31,4,12,0.333,2,8,0.25,2,2,1.0,0,6,6,1,0,1,0,1,12,-10,1,Michael Porter Jr.,DEN,DEN,OKC,0.5,Blocked Shots,19,18,13,7
22023,1629008,22300435,"DEC 29, 2023",DEN vs. OKC,L,31,4,12,0.333,2,8,0.25,2,2,1.0,0,6,6,1,0,1,0,1,12,-10,1,Michael Porter Jr.,DEN,DEN,OKC,7.5,Rebs+Asts,19,18,13,7
22023,1629008,22300425,"DEC 28, 2023",DEN vs. MEM,W,23,3,6,0.5,2,3,0.667,0,0,0.0,0,4,4,0,0,1,2,3,8,28,1,Michael Porter Jr.,DEN,DEN,MEM,15.5,Points,12,12,8,4
22023,1629008,22300425,"DEC 28, 2023",DEN vs. MEM,W,23,3,6,0.5,2,3,0.667,0,0,0.0,0,4,4,0,0,1,2,3,8,28,1,Michael Porter Jr.,DEN,DEN,MEM,6.0,Rebounds,12,12,8,4
22023,1629008,22300425,"DEC 28, 2023",DEN vs. MEM,W,23,3,6,0.5,2,3,0.667,0,0,0.0,0,4,4,0,0,1,2,3,8,28,1,Michael Porter Jr.,DEN,DEN,MEM,23.5,Pts+Rebs+Asts,12,12,8,4
22023,1629008,22300425,"DEC 28, 2023",DEN vs. MEM,W,23,3,6,0.5,2,3,0.667,0,0,0.0,0,4,4,0,0,1,2,3,8,28,1,Michael Porter Jr.,DEN,DEN,MEM,21.5,Pts+Rebs,12,12,8,4
22023,1629008,22300425,"DEC 28, 2023",DEN vs. MEM,W,23,3,6,0.5,2,3,0.667,0,0,0.0,0,4,4,0,0,1,2,3,8,28,1,Michael Porter Jr.,DEN,DEN,MEM,16.5,Pts+Asts,12,12,8,4
22023,1629008,22300425,"DEC 28, 2023",DEN vs. MEM,W,23,3,6,0.5,2,3,0.667,0,0,0.0,0,4,4,0,0,1,2,3,8,28,1,Michael Porter Jr.,DEN,DEN,MEM,2.5,3-PT Made,12,12,8,4
22023,1629008,22300425,"DEC 28, 2023",DEN vs. MEM,W,23,3,6,0.5,2,3,0.667,0,0,0.0,0,4,4,0,0,1,2,3,8,28,1,Michael Porter Jr.,DEN,DEN,MEM,0.5,Blocked Shots,12,12,8,4
22023,1629008,22300425,"DEC 28, 2023",DEN vs. MEM,W,23,3,6,0.5,2,3,0.667,0,0,0.0,0,4,4,0,0,1,2,3,8,28,1,Michael Porter Jr.,DEN,DEN,MEM,7.5,Rebs+Asts,12,12,8,4
22023,1629008,22300402,"DEC 25, 2023",DEN vs. GSW,W,40,8,17,0.471,3,10,0.3,0,0,0.0,0,10,10,1,0,4,0,1,19,23,1,Michael Porter Jr.,DEN,DEN,GSW,15.5,Points,30,29,20,11
22023,1629008,22300402,"DEC 25, 2023",DEN vs. GSW,W,40,8,17,0.471,3,10,0.3,0,0,0.0,0,10,10,1,0,4,0,1,19,23,1,Michael Porter Jr.,DEN,DEN,GSW,6.0,Rebounds,30,29,20,11
22023,1629008,22300402,"DEC 25, 2023",DEN vs. GSW,W,40,8,17,0.471,3,10,0.3,0,0,0.0,0,10,10,1,0,4,0,1,19,23,1,Michael Porter Jr.,DEN,DEN,GSW,23.5,Pts+Rebs+Asts,30,29,20,11
22023,1629008,22300402,"DEC 25, 2023",DEN vs. GSW,W,40,8,17,0.471,3,10,0.3,0,0,0.0,0,10,10,1,0,4,0,1,19,23,1,Michael Porter Jr.,DEN,DEN,GSW,21.5,Pts+Rebs,30,29,20,11
22023,1629008,22300402,"DEC 25, 2023",DEN vs. GSW,W,40,8,17,0.471,3,10,0.3,0,0,0.0,0,10,10,1,0,4,0,1,19,23,1,Michael Porter Jr.,DEN,DEN,GSW,16.5,Pts+Asts,30,29,20,11
22023,1629008,22300402,"DEC 25, 2023",DEN vs. GSW,W,40,8,17,0.471,3,10,0.3,0,0,0.0,0,10,10,1,0,4,0,1,19,23,1,Michael Porter Jr.,DEN,DEN,GSW,2.5,3-PT Made,30,29,20,11
22023,1629008,22300402,"DEC 25, 2023",DEN vs. GSW,W,40,8,17,0.471,3,10,0.3,0,0,0.0,0,10,10,1,0,4,0,1,19,23,1,Michael Porter Jr.,DEN,DEN,GSW,0.5,Blocked Shots,30,29,20,11
22023,1629008,22300402,"DEC 25, 2023",DEN vs. GSW,W,40,8,17,0.471,3,10,0.3,0,0,0.0,0,10,10,1,0,4,0,1,19,23,1,Michael Porter Jr.,DEN,DEN,GSW,7.5,Rebs+Asts,30,29,20,11
22023,1629008,22300390,"DEC 23, 2023",DEN @ CHA,W,31,8,14,0.571,5,8,0.625,1,2,0.5,1,4,5,1,1,2,1,2,22,15,1,Michael Porter Jr.,DEN,CHA,DEN,15.5,Points,28,27,23,6
22023,1629008,22300390,"DEC 23, 2023",DEN @ CHA,W,31,8,14,0.571,5,8,0.625,1,2,0.5,1,4,5,1,1,2,1,2,22,15,1,Michael Porter Jr.,DEN,CHA,DEN,6.0,Rebounds,28,27,23,6
22023,1629008,22300390,"DEC 23, 2023",DEN @ CHA,W,31,8,14,0.571,5,8,0.625,1,2,0.5,1,4,5,1,1,2,1,2,22,15,1,Michael Porter Jr.,DEN,CHA,DEN,23.5,Pts+Rebs+Asts,28,27,23,6
22023,1629008,22300390,"DEC 23, 2023",DEN @ CHA,W,31,8,14,0.571,5,8,0.625,1,2,0.5,1,4,5,1,1,2,1,2,22,15,1,Michael Porter Jr.,DEN,CHA,DEN,21.5,Pts+Rebs,28,27,23,6
22023,1629008,22300390,"DEC 23, 2023",DEN @ CHA,W,31,8,14,0.571,5,8,0.625,1,2,0.5,1,4,5,1,1,2,1,2,22,15,1,Michael Porter Jr.,DEN,CHA,DEN,16.5,Pts+Asts,28,27,23,6
22023,1629008,22300390,"DEC 23, 2023",DEN @ CHA,W,31,8,14,0.571,5,8,0.625,1,2,0.5,1,4,5,1,1,2,1,2,22,15,1,Michael Porter Jr.,DEN,CHA,DEN,2.5,3-PT Made,28,27,23,6
22023,1629008,22300390,"DEC 23, 2023",DEN @ CHA,W,31,8,14,0.571,5,8,0.625,1,2,0.5,1,4,5,1,1,2,1,2,22,15,1,Michael Porter Jr.,DEN,CHA,DEN,0.5,Blocked Shots,28,27,23,6
22023,1629008,22300390,"DEC 23, 2023",DEN @ CHA,W,31,8,14,0.571,5,8,0.625,1,2,0.5,1,4,5,1,1,2,1,2,22,15,1,Michael Porter Jr.,DEN,CHA,DEN,7.5,Rebs+Asts,28,27,23,6
22023,1629008,22300383,"DEC 22, 2023",DEN @ BKN,W,34,6,10,0.6,3,5,0.6,0,0,0.0,0,4,4,3,0,1,1,1,15,13,1,Michael Porter Jr.,DEN,BKN,DEN,15.5,Points,22,19,18,7
22023,1629008,22300383,"DEC 22, 2023",DEN @ BKN,W,34,6,10,0.6,3,5,0.6,0,0,0.0,0,4,4,3,0,1,1,1,15,13,1,Michael Porter Jr.,DEN,BKN,DEN,6.0,Rebounds,22,19,18,7
22023,1629008,22300383,"DEC 22, 2023",DEN @ BKN,W,34,6,10,0.6,3,5,0.6,0,0,0.0,0,4,4,3,0,1,1,1,15,13,1,Michael Porter Jr.,DEN,BKN,DEN,23.5,Pts+Rebs+Asts,22,19,18,7
22023,1629008,22300383,"DEC 22, 2023",DEN @ BKN,W,34,6,10,0.6,3,5,0.6,0,0,0.0,0,4,4,3,0,1,1,1,15,13,1,Michael Porter Jr.,DEN,BKN,DEN,21.5,Pts+Rebs,22,19,18,7
22023,1629008,22300383,"DEC 22, 2023",DEN @ BKN,W,34,6,10,0.6,3,5,0.6,0,0,0.0,0,4,4,3,0,1,1,1,15,13,1,Michael Porter Jr.,DEN,BKN,DEN,16.5,Pts+Asts,22,19,18,7
22023,1629008,22300383,"DEC 22, 2023",DEN @ BKN,W,34,6,10,0.6,3,5,0.6,0,0,0.0,0,4,4,3,0,1,1,1,15,13,1,Michael Porter Jr.,DEN,BKN,DEN,2.5,3-PT Made,22,19,18,7
22023,1629008,22300383,"DEC 22, 2023",DEN @ BKN,W,34,6,10,0.6,3,5,0.6,0,0,0.0,0,4,4,3,0,1,1,1,15,13,1,Michael Porter Jr.,DEN,BKN,DEN,0.5,Blocked Shots,22,19,18,7
22023,1629008,22300383,"DEC 22, 2023",DEN @ BKN,W,34,6,10,0.6,3,5,0.6,0,0,0.0,0,4,4,3,0,1,1,1,15,13,1,Michael Porter Jr.,DEN,BKN,DEN,7.5,Rebs+Asts,22,19,18,7
22023,1629008,22300369,"DEC 20, 2023",DEN @ TOR,W,33,5,13,0.385,2,7,0.286,0,0,0.0,1,5,6,2,1,0,0,1,12,10,1,Michael Porter Jr.,DEN,TOR,DEN,15.5,Points,20,18,14,8
22023,1629008,22300369,"DEC 20, 2023",DEN @ TOR,W,33,5,13,0.385,2,7,0.286,0,0,0.0,1,5,6,2,1,0,0,1,12,10,1,Michael Porter Jr.,DEN,TOR,DEN,6.0,Rebounds,20,18,14,8
22023,1629008,22300369,"DEC 20, 2023",DEN @ TOR,W,33,5,13,0.385,2,7,0.286,0,0,0.0,1,5,6,2,1,0,0,1,12,10,1,Michael Porter Jr.,DEN,TOR,DEN,23.5,Pts+Rebs+Asts,20,18,14,8
22023,1629008,22300369,"DEC 20, 2023",DEN @ TOR,W,33,5,13,0.385,2,7,0.286,0,0,0.0,1,5,6,2,1,0,0,1,12,10,1,Michael Porter Jr.,DEN,TOR,DEN,21.5,Pts+Rebs,20,18,14,8
22023,1629008,22300369,"DEC 20, 2023",DEN @ TOR,W,33,5,13,0.385,2,7,0.286,0,0,0.0,1,5,6,2,1,0,0,1,12,10,1,Michael Porter Jr.,DEN,TOR,DEN,16.5,Pts+Asts,20,18,14,8
22023,1629008,22300369,"DEC 20, 2023",DEN @ TOR,W,33,5,13,0.385,2,7,0.286,0,0,0.0,1,5,6,2,1,0,0,1,12,10,1,Michael Porter Jr.,DEN,TOR,DEN,2.5,3-PT Made,20,18,14,8
22023,1629008,22300369,"DEC 20, 2023",DEN @ TOR,W,33,5,13,0.385,2,7,0.286,0,0,0.0,1,5,6,2,1,0,0,1,12,10,1,Michael Porter Jr.,DEN,TOR,DEN,0.5,Blocked Shots,20,18,14,8
22023,1629008,22300369,"DEC 20, 2023",DEN @ TOR,W,33,5,13,0.385,2,7,0.286,0,0,0.0,1,5,6,2,1,0,0,1,12,10,1,Michael Porter Jr.,DEN,TOR,DEN,7.5,Rebs+Asts,20,18,14,8
22023,1629008,22300356,"DEC 18, 2023",DEN vs. DAL,W,23,3,8,0.375,2,3,0.667,0,0,0.0,2,2,4,1,0,0,2,1,8,13,1,Michael Porter Jr.,DEN,DEN,DAL,15.5,Points,13,12,9,5
22023,1629008,22300356,"DEC 18, 2023",DEN vs. DAL,W,23,3,8,0.375,2,3,0.667,0,0,0.0,2,2,4,1,0,0,2,1,8,13,1,Michael Porter Jr.,DEN,DEN,DAL,6.0,Rebounds,13,12,9,5
22023,1629008,22300356,"DEC 18, 2023",DEN vs. DAL,W,23,3,8,0.375,2,3,0.667,0,0,0.0,2,2,4,1,0,0,2,1,8,13,1,Michael Porter Jr.,DEN,DEN,DAL,23.5,Pts+Rebs+Asts,13,12,9,5
22023,1629008,22300356,"DEC 18, 2023",DEN vs. DAL,W,23,3,8,0.375,2,3,0.667,0,0,0.0,2,2,4,1,0,0,2,1,8,13,1,Michael Porter Jr.,DEN,DEN,DAL,21.5,Pts+Rebs,13,12,9,5
22023,1629008,22300356,"DEC 18, 2023",DEN vs. DAL,W,23,3,8,0.375,2,3,0.667,0,0,0.0,2,2,4,1,0,0,2,1,8,13,1,Michael Porter Jr.,DEN,DEN,DAL,16.5,Pts+Asts,13,12,9,5
22023,1629008,22300356,"DEC 18, 2023",DEN vs. DAL,W,23,3,8,0.375,2,3,0.667,0,0,0.0,2,2,4,1,0,0,2,1,8,13,1,Michael Porter Jr.,DEN,DEN,DAL,2.5,3-PT Made,13,12,9,5
22023,1629008,22300356,"DEC 18, 2023",DEN vs. DAL,W,23,3,8,0.375,2,3,0.667,0,0,0.0,2,2,4,1,0,0,2,1,8,13,1,Michael Porter Jr.,DEN,DEN,DAL,0.5,Blocked Shots,13,12,9,5
22023,1629008,22300356,"DEC 18, 2023",DEN vs. DAL,W,23,3,8,0.375,2,3,0.667,0,0,0.0,2,2,4,1,0,0,2,1,8,13,1,Michael Porter Jr.,DEN,DEN,DAL,7.5,Rebs+Asts,13,12,9,5
22023,1629008,22300340,"DEC 16, 2023",DEN vs. OKC,L,32,8,18,0.444,4,8,0.5,0,0,0.0,0,11,11,0,0,0,1,0,20,1,1,Michael Porter Jr.,DEN,DEN,OKC,15.5,Points,31,31,20,11
22023,1629008,22300340,"DEC 16, 2023",DEN vs. OKC,L,32,8,18,0.444,4,8,0.5,0,0,0.0,0,11,11,0,0,0,1,0,20,1,1,Michael Porter Jr.,DEN,DEN,OKC,6.0,Rebounds,31,31,20,11
22023,1629008,22300340,"DEC 16, 2023",DEN vs. OKC,L,32,8,18,0.444,4,8,0.5,0,0,0.0,0,11,11,0,0,0,1,0,20,1,1,Michael Porter Jr.,DEN,DEN,OKC,23.5,Pts+Rebs+Asts,31,31,20,11
22023,1629008,22300340,"DEC 16, 2023",DEN vs. OKC,L,32,8,18,0.444,4,8,0.5,0,0,0.0,0,11,11,0,0,0,1,0,20,1,1,Michael Porter Jr.,DEN,DEN,OKC,21.5,Pts+Rebs,31,31,20,11
22023,1629008,22300340,"DEC 16, 2023",DEN vs. OKC,L,32,8,18,0.444,4,8,0.5,0,0,0.0,0,11,11,0,0,0,1,0,20,1,1,Michael Porter Jr.,DEN,DEN,OKC,16.5,Pts+Asts,31,31,20,11
22023,1629008,22300340,"DEC 16, 2023",DEN vs. OKC,L,32,8,18,0.444,4,8,0.5,0,0,0.0,0,11,11,0,0,0,1,0,20,1,1,Michael Porter Jr.,DEN,DEN,OKC,2.5,3-PT Made,31,31,20,11
22023,1629008,22300340,"DEC 16, 2023",DEN vs. OKC,L,32,8,18,0.444,4,8,0.5,0,0,0.0,0,11,11,0,0,0,1,0,20,1,1,Michael Porter Jr.,DEN,DEN,OKC,0.5,Blocked Shots,31,31,20,11
22023,1629008,22300340,"DEC 16, 2023",DEN vs. OKC,L,32,8,18,0.444,4,8,0.5,0,0,0.0,0,11,11,0,0,0,1,0,20,1,1,Michael Porter Jr.,DEN,DEN,OKC,7.5,Rebs+Asts,31,31,20,11
22023,1629008,22300322,"DEC 14, 2023",DEN vs. BKN,W,23,3,8,0.375,1,4,0.25,2,2,1.0,2,4,6,1,1,0,0,0,9,11,1,Michael Porter Jr.,DEN,DEN,BKN,15.5,Points,16,15,10,7
22023,1629008,22300322,"DEC 14, 2023",DEN vs. BKN,W,23,3,8,0.375,1,4,0.25,2,2,1.0,2,4,6,1,1,0,0,0,9,11,1,Michael Porter Jr.,DEN,DEN,BKN,6.0,Rebounds,16,15,10,7
22023,1629008,22300322,"DEC 14, 2023",DEN vs. BKN,W,23,3,8,0.375,1,4,0.25,2,2,1.0,2,4,6,1,1,0,0,0,9,11,1,Michael Porter Jr.,DEN,DEN,BKN,23.5,Pts+Rebs+Asts,16,15,10,7
22023,1629008,22300322,"DEC 14, 2023",DEN vs. BKN,W,23,3,8,0.375,1,4,0.25,2,2,1.0,2,4,6,1,1,0,0,0,9,11,1,Michael Porter Jr.,DEN,DEN,BKN,21.5,Pts+Rebs,16,15,10,7
22023,1629008,22300322,"DEC 14, 2023",DEN vs. BKN,W,23,3,8,0.375,1,4,0.25,2,2,1.0,2,4,6,1,1,0,0,0,9,11,1,Michael Porter Jr.,DEN,DEN,BKN,16.5,Pts+Asts,16,15,10,7
22023,1629008,22300322,"DEC 14, 2023",DEN vs. BKN,W,23,3,8,0.375,1,4,0.25,2,2,1.0,2,4,6,1,1,0,0,0,9,11,1,Michael Porter Jr.,DEN,DEN,BKN,2.5,3-PT Made,16,15,10,7
22023,1629008,22300322,"DEC 14, 2023",DEN vs. BKN,W,23,3,8,0.375,1,4,0.25,2,2,1.0,2,4,6,1,1,0,0,0,9,11,1,Michael Porter Jr.,DEN,DEN,BKN,0.5,Blocked Shots,16,15,10,7
22023,1629008,22300322,"DEC 14, 2023",DEN vs. BKN,W,23,3,8,0.375,1,4,0.25,2,2,1.0,2,4,6,1,1,0,0,0,9,11,1,Michael Porter Jr.,DEN,DEN,BKN,7.5,Rebs+Asts,16,15,10,7
22023,1629008,22300307,"DEC 12, 2023",DEN @ CHI,W,32,6,16,0.375,2,8,0.25,3,4,0.75,0,7,7,0,1,0,0,1,17,3,1,Michael Porter Jr.,DEN,CHI,DEN,15.5,Points,24,24,17,7
22023,1629008,22300307,"DEC 12, 2023",DEN @ CHI,W,32,6,16,0.375,2,8,0.25,3,4,0.75,0,7,7,0,1,0,0,1,17,3,1,Michael Porter Jr.,DEN,CHI,DEN,6.0,Rebounds,24,24,17,7
22023,1629008,22300307,"DEC 12, 2023",DEN @ CHI,W,32,6,16,0.375,2,8,0.25,3,4,0.75,0,7,7,0,1,0,0,1,17,3,1,Michael Porter Jr.,DEN,CHI,DEN,23.5,Pts+Rebs+Asts,24,24,17,7
22023,1629008,22300307,"DEC 12, 2023",DEN @ CHI,W,32,6,16,0.375,2,8,0.25,3,4,0.75,0,7,7,0,1,0,0,1,17,3,1,Michael Porter Jr.,DEN,CHI,DEN,21.5,Pts+Rebs,24,24,17,7
22023,1629008,22300307,"DEC 12, 2023",DEN @ CHI,W,32,6,16,0.375,2,8,0.25,3,4,0.75,0,7,7,0,1,0,0,1,17,3,1,Michael Porter Jr.,DEN,CHI,DEN,16.5,Pts+Asts,24,24,17,7
22023,1629008,22300307,"DEC 12, 2023",DEN @ CHI,W,32,6,16,0.375,2,8,0.25,3,4,0.75,0,7,7,0,1,0,0,1,17,3,1,Michael Porter Jr.,DEN,CHI,DEN,2.5,3-PT Made,24,24,17,7
22023,1629008,22300307,"DEC 12, 2023",DEN @ CHI,W,32,6,16,0.375,2,8,0.25,3,4,0.75,0,7,7,0,1,0,0,1,17,3,1,Michael Porter Jr.,DEN,CHI,DEN,0.5,Blocked Shots,24,24,17,7
22023,1629008,22300307,"DEC 12, 2023",DEN @ CHI,W,32,6,16,0.375,2,8,0.25,3,4,0.75,0,7,7,0,1,0,0,1,17,3,1,Michael Porter Jr.,DEN,CHI,DEN,7.5,Rebs+Asts,24,24,17,7
22023,1629008,22300296,"DEC 11, 2023",DEN @ ATL,W,26,1,11,0.091,0,4,0.0,1,2,0.5,2,5,7,3,0,0,1,3,3,12,1,Michael Porter Jr.,DEN,ATL,DEN,15.5,Points,13,10,6,10
22023,1629008,22300296,"DEC 11, 2023",DEN @ ATL,W,26,1,11,0.091,0,4,0.0,1,2,0.5,2,5,7,3,0,0,1,3,3,12,1,Michael Porter Jr.,DEN,ATL,DEN,6.0,Rebounds,13,10,6,10
22023,1629008,22300296,"DEC 11, 2023",DEN @ ATL,W,26,1,11,0.091,0,4,0.0,1,2,0.5,2,5,7,3,0,0,1,3,3,12,1,Michael Porter Jr.,DEN,ATL,DEN,23.5,Pts+Rebs+Asts,13,10,6,10
22023,1629008,22300296,"DEC 11, 2023",DEN @ ATL,W,26,1,11,0.091,0,4,0.0,1,2,0.5,2,5,7,3,0,0,1,3,3,12,1,Michael Porter Jr.,DEN,ATL,DEN,21.5,Pts+Rebs,13,10,6,10
22023,1629008,22300296,"DEC 11, 2023",DEN @ ATL,W,26,1,11,0.091,0,4,0.0,1,2,0.5,2,5,7,3,0,0,1,3,3,12,1,Michael Porter Jr.,DEN,ATL,DEN,16.5,Pts+Asts,13,10,6,10
22023,1629008,22300296,"DEC 11, 2023",DEN @ ATL,W,26,1,11,0.091,0,4,0.0,1,2,0.5,2,5,7,3,0,0,1,3,3,12,1,Michael Porter Jr.,DEN,ATL,DEN,2.5,3-PT Made,13,10,6,10
22023,1629008,22300296,"DEC 11, 2023",DEN @ ATL,W,26,1,11,0.091,0,4,0.0,1,2,0.5,2,5,7,3,0,0,1,3,3,12,1,Michael Porter Jr.,DEN,ATL,DEN,0.5,Blocked Shots,13,10,6,10
22023,1629008,22300296,"DEC 11, 2023",DEN @ ATL,W,26,1,11,0.091,0,4,0.0,1,2,0.5,2,5,7,3,0,0,1,3,3,12,1,Michael Porter Jr.,DEN,ATL,DEN,7.5,Rebs+Asts,13,10,6,10
22023,1629008,22301224,"DEC 08, 2023",DEN vs. HOU,L,40,8,12,0.667,3,6,0.5,1,1,1.0,1,7,8,0,0,2,2,3,20,11,1,Michael Porter Jr.,DEN,DEN,HOU,15.5,Points,28,28,20,8
22023,1629008,22301224,"DEC 08, 2023",DEN vs. HOU,L,40,8,12,0.667,3,6,0.5,1,1,1.0,1,7,8,0,0,2,2,3,20,11,1,Michael Porter Jr.,DEN,DEN,HOU,6.0,Rebounds,28,28,20,8
22023,1629008,22301224,"DEC 08, 2023",DEN vs. HOU,L,40,8,12,0.667,3,6,0.5,1,1,1.0,1,7,8,0,0,2,2,3,20,11,1,Michael Porter Jr.,DEN,DEN,HOU,23.5,Pts+Rebs+Asts,28,28,20,8
22023,1629008,22301224,"DEC 08, 2023",DEN vs. HOU,L,40,8,12,0.667,3,6,0.5,1,1,1.0,1,7,8,0,0,2,2,3,20,11,1,Michael Porter Jr.,DEN,DEN,HOU,21.5,Pts+Rebs,28,28,20,8
22023,1629008,22301224,"DEC 08, 2023",DEN vs. HOU,L,40,8,12,0.667,3,6,0.5,1,1,1.0,1,7,8,0,0,2,2,3,20,11,1,Michael Porter Jr.,DEN,DEN,HOU,16.5,Pts+Asts,28,28,20,8
22023,1629008,22301224,"DEC 08, 2023",DEN vs. HOU,L,40,8,12,0.667,3,6,0.5,1,1,1.0,1,7,8,0,0,2,2,3,20,11,1,Michael Porter Jr.,DEN,DEN,HOU,2.5,3-PT Made,28,28,20,8
22023,1629008,22301224,"DEC 08, 2023",DEN vs. HOU,L,40,8,12,0.667,3,6,0.5,1,1,1.0,1,7,8,0,0,2,2,3,20,11,1,Michael Porter Jr.,DEN,DEN,HOU,0.5,Blocked Shots,28,28,20,8
22023,1629008,22301224,"DEC 08, 2023",DEN vs. HOU,L,40,8,12,0.667,3,6,0.5,1,1,1.0,1,7,8,0,0,2,2,3,20,11,1,Michael Porter Jr.,DEN,DEN,HOU,7.5,Rebs+Asts,28,28,20,8
22023,1629008,22301215,"DEC 06, 2023",DEN @ LAC,L,34,7,8,0.875,4,5,0.8,0,0,0.0,3,6,9,0,0,1,2,2,18,4,1,Michael Porter Jr.,DEN,LAC,DEN,15.5,Points,27,27,18,9
22023,1629008,22301215,"DEC 06, 2023",DEN @ LAC,L,34,7,8,0.875,4,5,0.8,0,0,0.0,3,6,9,0,0,1,2,2,18,4,1,Michael Porter Jr.,DEN,LAC,DEN,6.0,Rebounds,27,27,18,9
22023,1629008,22301215,"DEC 06, 2023",DEN @ LAC,L,34,7,8,0.875,4,5,0.8,0,0,0.0,3,6,9,0,0,1,2,2,18,4,1,Michael Porter Jr.,DEN,LAC,DEN,23.5,Pts+Rebs+Asts,27,27,18,9
22023,1629008,22301215,"DEC 06, 2023",DEN @ LAC,L,34,7,8,0.875,4,5,0.8,0,0,0.0,3,6,9,0,0,1,2,2,18,4,1,Michael Porter Jr.,DEN,LAC,DEN,21.5,Pts+Rebs,27,27,18,9
22023,1629008,22301215,"DEC 06, 2023",DEN @ LAC,L,34,7,8,0.875,4,5,0.8,0,0,0.0,3,6,9,0,0,1,2,2,18,4,1,Michael Porter Jr.,DEN,LAC,DEN,16.5,Pts+Asts,27,27,18,9
22023,1629008,22301215,"DEC 06, 2023",DEN @ LAC,L,34,7,8,0.875,4,5,0.8,0,0,0.0,3,6,9,0,0,1,2,2,18,4,1,Michael Porter Jr.,DEN,LAC,DEN,2.5,3-PT Made,27,27,18,9
22023,1629008,22301215,"DEC 06, 2023",DEN @ LAC,L,34,7,8,0.875,4,5,0.8,0,0,0.0,3,6,9,0,0,1,2,2,18,4,1,Michael Porter Jr.,DEN,LAC,DEN,0.5,Blocked Shots,27,27,18,9
22023,1629008,22301215,"DEC 06, 2023",DEN @ LAC,L,34,7,8,0.875,4,5,0.8,0,0,0.0,3,6,9,0,0,1,2,2,18,4,1,Michael Porter Jr.,DEN,LAC,DEN,7.5,Rebs+Asts,27,27,18,9
22023,1629008,22300290,"DEC 02, 2023",DEN @ SAC,L,33,6,12,0.5,1,5,0.2,0,0,0.0,0,8,8,2,0,2,1,1,13,-6,1,Michael Porter Jr.,DEN,SAC,DEN,15.5,Points,23,21,15,10
22023,1629008,22300290,"DEC 02, 2023",DEN @ SAC,L,33,6,12,0.5,1,5,0.2,0,0,0.0,0,8,8,2,0,2,1,1,13,-6,1,Michael Porter Jr.,DEN,SAC,DEN,6.0,Rebounds,23,21,15,10
22023,1629008,22300290,"DEC 02, 2023",DEN @ SAC,L,33,6,12,0.5,1,5,0.2,0,0,0.0,0,8,8,2,0,2,1,1,13,-6,1,Michael Porter Jr.,DEN,SAC,DEN,23.5,Pts+Rebs+Asts,23,21,15,10
22023,1629008,22300290,"DEC 02, 2023",DEN @ SAC,L,33,6,12,0.5,1,5,0.2,0,0,0.0,0,8,8,2,0,2,1,1,13,-6,1,Michael Porter Jr.,DEN,SAC,DEN,21.5,Pts+Rebs,23,21,15,10
22023,1629008,22300290,"DEC 02, 2023",DEN @ SAC,L,33,6,12,0.5,1,5,0.2,0,0,0.0,0,8,8,2,0,2,1,1,13,-6,1,Michael Porter Jr.,DEN,SAC,DEN,16.5,Pts+Asts,23,21,15,10
22023,1629008,22300290,"DEC 02, 2023",DEN @ SAC,L,33,6,12,0.5,1,5,0.2,0,0,0.0,0,8,8,2,0,2,1,1,13,-6,1,Michael Porter Jr.,DEN,SAC,DEN,2.5,3-PT Made,23,21,15,10
22023,1629008,22300290,"DEC 02, 2023",DEN @ SAC,L,33,6,12,0.5,1,5,0.2,0,0,0.0,0,8,8,2,0,2,1,1,13,-6,1,Michael Porter Jr.,DEN,SAC,DEN,0.5,Blocked Shots,23,21,15,10
22023,1629008,22300290,"DEC 02, 2023",DEN @ SAC,L,33,6,12,0.5,1,5,0.2,0,0,0.0,0,8,8,2,0,2,1,1,13,-6,1,Michael Porter Jr.,DEN,SAC,DEN,7.5,Rebs+Asts,23,21,15,10
22023,1629008,22300279,"DEC 01, 2023",DEN @ PHX,W,37,8,16,0.5,0,4,0.0,3,3,1.0,1,9,10,4,2,1,2,1,19,8,1,Michael Porter Jr.,DEN,PHX,DEN,15.5,Points,33,29,23,14
22023,1629008,22300279,"DEC 01, 2023",DEN @ PHX,W,37,8,16,0.5,0,4,0.0,3,3,1.0,1,9,10,4,2,1,2,1,19,8,1,Michael Porter Jr.,DEN,PHX,DEN,6.0,Rebounds,33,29,23,14
22023,1629008,22300279,"DEC 01, 2023",DEN @ PHX,W,37,8,16,0.5,0,4,0.0,3,3,1.0,1,9,10,4,2,1,2,1,19,8,1,Michael Porter Jr.,DEN,PHX,DEN,23.5,Pts+Rebs+Asts,33,29,23,14
22023,1629008,22300279,"DEC 01, 2023",DEN @ PHX,W,37,8,16,0.5,0,4,0.0,3,3,1.0,1,9,10,4,2,1,2,1,19,8,1,Michael Porter Jr.,DEN,PHX,DEN,21.5,Pts+Rebs,33,29,23,14
22023,1629008,22300279,"DEC 01, 2023",DEN @ PHX,W,37,8,16,0.5,0,4,0.0,3,3,1.0,1,9,10,4,2,1,2,1,19,8,1,Michael Porter Jr.,DEN,PHX,DEN,16.5,Pts+Asts,33,29,23,14
22023,1629008,22300279,"DEC 01, 2023",DEN @ PHX,W,37,8,16,0.5,0,4,0.0,3,3,1.0,1,9,10,4,2,1,2,1,19,8,1,Michael Porter Jr.,DEN,PHX,DEN,2.5,3-PT Made,33,29,23,14
22023,1629008,22300279,"DEC 01, 2023",DEN @ PHX,W,37,8,16,0.5,0,4,0.0,3,3,1.0,1,9,10,4,2,1,2,1,19,8,1,Michael Porter Jr.,DEN,PHX,DEN,0.5,Blocked Shots,33,29,23,14
22023,1629008,22300279,"DEC 01, 2023",DEN @ PHX,W,37,8,16,0.5,0,4,0.0,3,3,1.0,1,9,10,4,2,1,2,1,19,8,1,Michael Porter Jr.,DEN,PHX,DEN,7.5,Rebs+Asts,33,29,23,14
22023,1629008,22300263,"NOV 29, 2023",DEN vs. HOU,W,34,11,17,0.647,7,12,0.583,1,3,0.333,2,8,10,5,1,0,0,2,30,26,1,Michael Porter Jr.,DEN,DEN,HOU,15.5,Points,45,40,35,15
22023,1629008,22300263,"NOV 29, 2023",DEN vs. HOU,W,34,11,17,0.647,7,12,0.583,1,3,0.333,2,8,10,5,1,0,0,2,30,26,1,Michael Porter Jr.,DEN,DEN,HOU,6.0,Rebounds,45,40,35,15
22023,1629008,22300263,"NOV 29, 2023",DEN vs. HOU,W,34,11,17,0.647,7,12,0.583,1,3,0.333,2,8,10,5,1,0,0,2,30,26,1,Michael Porter Jr.,DEN,DEN,HOU,23.5,Pts+Rebs+Asts,45,40,35,15
22023,1629008,22300263,"NOV 29, 2023",DEN vs. HOU,W,34,11,17,0.647,7,12,0.583,1,3,0.333,2,8,10,5,1,0,0,2,30,26,1,Michael Porter Jr.,DEN,DEN,HOU,21.5,Pts+Rebs,45,40,35,15
22023,1629008,22300263,"NOV 29, 2023",DEN vs. HOU,W,34,11,17,0.647,7,12,0.583,1,3,0.333,2,8,10,5,1,0,0,2,30,26,1,Michael Porter Jr.,DEN,DEN,HOU,16.5,Pts+Asts,45,40,35,15
22023,1629008,22300263,"NOV 29, 2023",DEN vs. HOU,W,34,11,17,0.647,7,12,0.583,1,3,0.333,2,8,10,5,1,0,0,2,30,26,1,Michael Porter Jr.,DEN,DEN,HOU,2.5,3-PT Made,45,40,35,15
22023,1629008,22300263,"NOV 29, 2023",DEN vs. HOU,W,34,11,17,0.647,7,12,0.583,1,3,0.333,2,8,10,5,1,0,0,2,30,26,1,Michael Porter Jr.,DEN,DEN,HOU,0.5,Blocked Shots,45,40,35,15
22023,1629008,22300263,"NOV 29, 2023",DEN vs. HOU,W,34,11,17,0.647,7,12,0.583,1,3,0.333,2,8,10,5,1,0,0,2,30,26,1,Michael Porter Jr.,DEN,DEN,HOU,7.5,Rebs+Asts,45,40,35,15
22023,1629008,22300257,"NOV 27, 2023",DEN @ LAC,W,29,3,13,0.231,2,7,0.286,0,0,0.0,3,7,10,3,0,0,1,5,8,4,1,Michael Porter Jr.,DEN,LAC,DEN,15.5,Points,21,18,11,13
22023,1629008,22300257,"NOV 27, 2023",DEN @ LAC,W,29,3,13,0.231,2,7,0.286,0,0,0.0,3,7,10,3,0,0,1,5,8,4,1,Michael Porter Jr.,DEN,LAC,DEN,6.0,Rebounds,21,18,11,13
22023,1629008,22300257,"NOV 27, 2023",DEN @ LAC,W,29,3,13,0.231,2,7,0.286,0,0,0.0,3,7,10,3,0,0,1,5,8,4,1,Michael Porter Jr.,DEN,LAC,DEN,23.5,Pts+Rebs+Asts,21,18,11,13
22023,1629008,22300257,"NOV 27, 2023",DEN @ LAC,W,29,3,13,0.231,2,7,0.286,0,0,0.0,3,7,10,3,0,0,1,5,8,4,1,Michael Porter Jr.,DEN,LAC,DEN,21.5,Pts+Rebs,21,18,11,13
22023,1629008,22300257,"NOV 27, 2023",DEN @ LAC,W,29,3,13,0.231,2,7,0.286,0,0,0.0,3,7,10,3,0,0,1,5,8,4,1,Michael Porter Jr.,DEN,LAC,DEN,16.5,Pts+Asts,21,18,11,13
22023,1629008,22300257,"NOV 27, 2023",DEN @ LAC,W,29,3,13,0.231,2,7,0.286,0,0,0.0,3,7,10,3,0,0,1,5,8,4,1,Michael Porter Jr.,DEN,LAC,DEN,2.5,3-PT Made,21,18,11,13
22023,1629008,22300257,"NOV 27, 2023",DEN @ LAC,W,29,3,13,0.231,2,7,0.286,0,0,0.0,3,7,10,3,0,0,1,5,8,4,1,Michael Porter Jr.,DEN,LAC,DEN,0.5,Blocked Shots,21,18,11,13
22023,1629008,22300257,"NOV 27, 2023",DEN @ LAC,W,29,3,13,0.231,2,7,0.286,0,0,0.0,3,7,10,3,0,0,1,5,8,4,1,Michael Porter Jr.,DEN,LAC,DEN,7.5,Rebs+Asts,21,18,11,13
22023,1629008,22300252,"NOV 26, 2023",DEN vs. SAS,W,33,8,14,0.571,4,9,0.444,5,6,0.833,1,6,7,2,0,1,3,0,25,15,1,Michael Porter Jr.,DEN,DEN,SAS,15.5,Points,34,32,27,9
22023,1629008,22300252,"NOV 26, 2023",DEN vs. SAS,W,33,8,14,0.571,4,9,0.444,5,6,0.833,1,6,7,2,0,1,3,0,25,15,1,Michael Porter Jr.,DEN,DEN,SAS,6.0,Rebounds,34,32,27,9
22023,1629008,22300252,"NOV 26, 2023",DEN vs. SAS,W,33,8,14,0.571,4,9,0.444,5,6,0.833,1,6,7,2,0,1,3,0,25,15,1,Michael Porter Jr.,DEN,DEN,SAS,23.5,Pts+Rebs+Asts,34,32,27,9
22023,1629008,22300252,"NOV 26, 2023",DEN vs. SAS,W,33,8,14,0.571,4,9,0.444,5,6,0.833,1,6,7,2,0,1,3,0,25,15,1,Michael Porter Jr.,DEN,DEN,SAS,21.5,Pts+Rebs,34,32,27,9
22023,1629008,22300252,"NOV 26, 2023",DEN vs. SAS,W,33,8,14,0.571,4,9,0.444,5,6,0.833,1,6,7,2,0,1,3,0,25,15,1,Michael Porter Jr.,DEN,DEN,SAS,16.5,Pts+Asts,34,32,27,9
22023,1629008,22300252,"NOV 26, 2023",DEN vs. SAS,W,33,8,14,0.571,4,9,0.444,5,6,0.833,1,6,7,2,0,1,3,0,25,15,1,Michael Porter Jr.,DEN,DEN,SAS,2.5,3-PT Made,34,32,27,9
22023,1629008,22300252,"NOV 26, 2023",DEN vs. SAS,W,33,8,14,0.571,4,9,0.444,5,6,0.833,1,6,7,2,0,1,3,0,25,15,1,Michael Porter Jr.,DEN,DEN,SAS,0.5,Blocked Shots,34,32,27,9
22023,1629008,22300252,"NOV 26, 2023",DEN vs. SAS,W,33,8,14,0.571,4,9,0.444,5,6,0.833,1,6,7,2,0,1,3,0,25,15,1,Michael Porter Jr.,DEN,DEN,SAS,7.5,Rebs+Asts,34,32,27,9
22023,1629008,22300048,"NOV 24, 2023",DEN @ HOU,L,37,6,14,0.429,2,8,0.25,0,0,0.0,1,6,7,1,1,2,1,1,14,-8,1,Michael Porter Jr.,DEN,HOU,DEN,15.5,Points,22,21,15,8
22023,1629008,22300048,"NOV 24, 2023",DEN @ HOU,L,37,6,14,0.429,2,8,0.25,0,0,0.0,1,6,7,1,1,2,1,1,14,-8,1,Michael Porter Jr.,DEN,HOU,DEN,6.0,Rebounds,22,21,15,8
22023,1629008,22300048,"NOV 24, 2023",DEN @ HOU,L,37,6,14,0.429,2,8,0.25,0,0,0.0,1,6,7,1,1,2,1,1,14,-8,1,Michael Porter Jr.,DEN,HOU,DEN,23.5,Pts+Rebs+Asts,22,21,15,8
22023,1629008,22300048,"NOV 24, 2023",DEN @ HOU,L,37,6,14,0.429,2,8,0.25,0,0,0.0,1,6,7,1,1,2,1,1,14,-8,1,Michael Porter Jr.,DEN,HOU,DEN,21.5,Pts+Rebs,22,21,15,8
22023,1629008,22300048,"NOV 24, 2023",DEN @ HOU,L,37,6,14,0.429,2,8,0.25,0,0,0.0,1,6,7,1,1,2,1,1,14,-8,1,Michael Porter Jr.,DEN,HOU,DEN,16.5,Pts+Asts,22,21,15,8
22023,1629008,22300048,"NOV 24, 2023",DEN @ HOU,L,37,6,14,0.429,2,8,0.25,0,0,0.0,1,6,7,1,1,2,1,1,14,-8,1,Michael Porter Jr.,DEN,HOU,DEN,2.5,3-PT Made,22,21,15,8
22023,1629008,22300048,"NOV 24, 2023",DEN @ HOU,L,37,6,14,0.429,2,8,0.25,0,0,0.0,1,6,7,1,1,2,1,1,14,-8,1,Michael Porter Jr.,DEN,HOU,DEN,0.5,Blocked Shots,22,21,15,8
22023,1629008,22300048,"NOV 24, 2023",DEN @ HOU,L,37,6,14,0.429,2,8,0.25,0,0,0.0,1,6,7,1,1,2,1,1,14,-8,1,Michael Porter Jr.,DEN,HOU,DEN,7.5,Rebs+Asts,22,21,15,8
22023,1629008,22300226,"NOV 22, 2023",DEN @ ORL,L,31,9,16,0.563,5,9,0.556,2,2,1.0,0,2,2,0,1,0,0,4,25,5,1,Michael Porter Jr.,DEN,ORL,DEN,15.5,Points,27,27,25,2
22023,1629008,22300226,"NOV 22, 2023",DEN @ ORL,L,31,9,16,0.563,5,9,0.556,2,2,1.0,0,2,2,0,1,0,0,4,25,5,1,Michael Porter Jr.,DEN,ORL,DEN,6.0,Rebounds,27,27,25,2
22023,1629008,22300226,"NOV 22, 2023",DEN @ ORL,L,31,9,16,0.563,5,9,0.556,2,2,1.0,0,2,2,0,1,0,0,4,25,5,1,Michael Porter Jr.,DEN,ORL,DEN,23.5,Pts+Rebs+Asts,27,27,25,2
22023,1629008,22300226,"NOV 22, 2023",DEN @ ORL,L,31,9,16,0.563,5,9,0.556,2,2,1.0,0,2,2,0,1,0,0,4,25,5,1,Michael Porter Jr.,DEN,ORL,DEN,21.5,Pts+Rebs,27,27,25,2
22023,1629008,22300226,"NOV 22, 2023",DEN @ ORL,L,31,9,16,0.563,5,9,0.556,2,2,1.0,0,2,2,0,1,0,0,4,25,5,1,Michael Porter Jr.,DEN,ORL,DEN,16.5,Pts+Asts,27,27,25,2
22023,1629008,22300226,"NOV 22, 2023",DEN @ ORL,L,31,9,16,0.563,5,9,0.556,2,2,1.0,0,2,2,0,1,0,0,4,25,5,1,Michael Porter Jr.,DEN,ORL,DEN,2.5,3-PT Made,27,27,25,2
22023,1629008,22300226,"NOV 22, 2023",DEN @ ORL,L,31,9,16,0.563,5,9,0.556,2,2,1.0,0,2,2,0,1,0,0,4,25,5,1,Michael Porter Jr.,DEN,ORL,DEN,0.5,Blocked Shots,27,27,25,2
22023,1629008,22300226,"NOV 22, 2023",DEN @ ORL,L,31,9,16,0.563,5,9,0.556,2,2,1.0,0,2,2,0,1,0,0,4,25,5,1,Michael Porter Jr.,DEN,ORL,DEN,7.5,Rebs+Asts,27,27,25,2
22023,1629008,22300218,"NOV 20, 2023",DEN @ DET,W,38,5,15,0.333,4,9,0.444,0,1,0.0,2,9,11,2,0,1,4,3,14,-1,1,Michael Porter Jr.,DEN,DET,DEN,15.5,Points,27,25,16,13
22023,1629008,22300218,"NOV 20, 2023",DEN @ DET,W,38,5,15,0.333,4,9,0.444,0,1,0.0,2,9,11,2,0,1,4,3,14,-1,1,Michael Porter Jr.,DEN,DET,DEN,6.0,Rebounds,27,25,16,13
22023,1629008,22300218,"NOV 20, 2023",DEN @ DET,W,38,5,15,0.333,4,9,0.444,0,1,0.0,2,9,11,2,0,1,4,3,14,-1,1,Michael Porter Jr.,DEN,DET,DEN,23.5,Pts+Rebs+Asts,27,25,16,13
22023,1629008,22300218,"NOV 20, 2023",DEN @ DET,W,38,5,15,0.333,4,9,0.444,0,1,0.0,2,9,11,2,0,1,4,3,14,-1,1,Michael Porter Jr.,DEN,DET,DEN,21.5,Pts+Rebs,27,25,16,13
22023,1629008,22300218,"NOV 20, 2023",DEN @ DET,W,38,5,15,0.333,4,9,0.444,0,1,0.0,2,9,11,2,0,1,4,3,14,-1,1,Michael Porter Jr.,DEN,DET,DEN,16.5,Pts+Asts,27,25,16,13
22023,1629008,22300218,"NOV 20, 2023",DEN @ DET,W,38,5,15,0.333,4,9,0.444,0,1,0.0,2,9,11,2,0,1,4,3,14,-1,1,Michael Porter Jr.,DEN,DET,DEN,2.5,3-PT Made,27,25,16,13
22023,1629008,22300218,"NOV 20, 2023",DEN @ DET,W,38,5,15,0.333,4,9,0.444,0,1,0.0,2,9,11,2,0,1,4,3,14,-1,1,Michael Porter Jr.,DEN,DET,DEN,0.5,Blocked Shots,27,25,16,13
22023,1629008,22300218,"NOV 20, 2023",DEN @ DET,W,38,5,15,0.333,4,9,0.444,0,1,0.0,2,9,11,2,0,1,4,3,14,-1,1,Michael Porter Jr.,DEN,DET,DEN,7.5,Rebs+Asts,27,25,16,13
22023,1629008,22300210,"NOV 19, 2023",DEN @ CLE,L,27,7,15,0.467,5,9,0.556,2,2,1.0,1,5,6,0,1,0,2,2,21,-31,1,Michael Porter Jr.,DEN,CLE,DEN,15.5,Points,27,27,21,6
22023,1629008,22300210,"NOV 19, 2023",DEN @ CLE,L,27,7,15,0.467,5,9,0.556,2,2,1.0,1,5,6,0,1,0,2,2,21,-31,1,Michael Porter Jr.,DEN,CLE,DEN,6.0,Rebounds,27,27,21,6
22023,1629008,22300210,"NOV 19, 2023",DEN @ CLE,L,27,7,15,0.467,5,9,0.556,2,2,1.0,1,5,6,0,1,0,2,2,21,-31,1,Michael Porter Jr.,DEN,CLE,DEN,23.5,Pts+Rebs+Asts,27,27,21,6
22023,1629008,22300210,"NOV 19, 2023",DEN @ CLE,L,27,7,15,0.467,5,9,0.556,2,2,1.0,1,5,6,0,1,0,2,2,21,-31,1,Michael Porter Jr.,DEN,CLE,DEN,21.5,Pts+Rebs,27,27,21,6
22023,1629008,22300210,"NOV 19, 2023",DEN @ CLE,L,27,7,15,0.467,5,9,0.556,2,2,1.0,1,5,6,0,1,0,2,2,21,-31,1,Michael Porter Jr.,DEN,CLE,DEN,16.5,Pts+Asts,27,27,21,6
22023,1629008,22300210,"NOV 19, 2023",DEN @ CLE,L,27,7,15,0.467,5,9,0.556,2,2,1.0,1,5,6,0,1,0,2,2,21,-31,1,Michael Porter Jr.,DEN,CLE,DEN,2.5,3-PT Made,27,27,21,6
22023,1629008,22300210,"NOV 19, 2023",DEN @ CLE,L,27,7,15,0.467,5,9,0.556,2,2,1.0,1,5,6,0,1,0,2,2,21,-31,1,Michael Porter Jr.,DEN,CLE,DEN,0.5,Blocked Shots,27,27,21,6
22023,1629008,22300210,"NOV 19, 2023",DEN @ CLE,L,27,7,15,0.467,5,9,0.556,2,2,1.0,1,5,6,0,1,0,2,2,21,-31,1,Michael Porter Jr.,DEN,CLE,DEN,7.5,Rebs+Asts,27,27,21,6
22023,1629008,22300034,"NOV 17, 2023",DEN @ NOP,L,33,8,14,0.571,2,6,0.333,0,1,0.0,3,8,11,0,0,0,0,3,18,-15,1,Michael Porter Jr.,DEN,NOP,DEN,15.5,Points,29,29,18,11
22023,1629008,22300034,"NOV 17, 2023",DEN @ NOP,L,33,8,14,0.571,2,6,0.333,0,1,0.0,3,8,11,0,0,0,0,3,18,-15,1,Michael Porter Jr.,DEN,NOP,DEN,6.0,Rebounds,29,29,18,11
22023,1629008,22300034,"NOV 17, 2023",DEN @ NOP,L,33,8,14,0.571,2,6,0.333,0,1,0.0,3,8,11,0,0,0,0,3,18,-15,1,Michael Porter Jr.,DEN,NOP,DEN,23.5,Pts+Rebs+Asts,29,29,18,11
22023,1629008,22300034,"NOV 17, 2023",DEN @ NOP,L,33,8,14,0.571,2,6,0.333,0,1,0.0,3,8,11,0,0,0,0,3,18,-15,1,Michael Porter Jr.,DEN,NOP,DEN,21.5,Pts+Rebs,29,29,18,11
22023,1629008,22300034,"NOV 17, 2023",DEN @ NOP,L,33,8,14,0.571,2,6,0.333,0,1,0.0,3,8,11,0,0,0,0,3,18,-15,1,Michael Porter Jr.,DEN,NOP,DEN,16.5,Pts+Asts,29,29,18,11
22023,1629008,22300034,"NOV 17, 2023",DEN @ NOP,L,33,8,14,0.571,2,6,0.333,0,1,0.0,3,8,11,0,0,0,0,3,18,-15,1,Michael Porter Jr.,DEN,NOP,DEN,2.5,3-PT Made,29,29,18,11
22023,1629008,22300034,"NOV 17, 2023",DEN @ NOP,L,33,8,14,0.571,2,6,0.333,0,1,0.0,3,8,11,0,0,0,0,3,18,-15,1,Michael Porter Jr.,DEN,NOP,DEN,0.5,Blocked Shots,29,29,18,11
22023,1629008,22300034,"NOV 17, 2023",DEN @ NOP,L,33,8,14,0.571,2,6,0.333,0,1,0.0,3,8,11,0,0,0,0,3,18,-15,1,Michael Porter Jr.,DEN,NOP,DEN,7.5,Rebs+Asts,29,29,18,11
22023,1629008,22300024,"NOV 14, 2023",DEN vs. LAC,W,34,4,11,0.364,2,8,0.25,0,2,0.0,1,4,5,0,1,1,2,3,10,4,1,Michael Porter Jr.,DEN,DEN,LAC,15.5,Points,15,15,10,5
22023,1629008,22300024,"NOV 14, 2023",DEN vs. LAC,W,34,4,11,0.364,2,8,0.25,0,2,0.0,1,4,5,0,1,1,2,3,10,4,1,Michael Porter Jr.,DEN,DEN,LAC,6.0,Rebounds,15,15,10,5
22023,1629008,22300024,"NOV 14, 2023",DEN vs. LAC,W,34,4,11,0.364,2,8,0.25,0,2,0.0,1,4,5,0,1,1,2,3,10,4,1,Michael Porter Jr.,DEN,DEN,LAC,23.5,Pts+Rebs+Asts,15,15,10,5
22023,1629008,22300024,"NOV 14, 2023",DEN vs. LAC,W,34,4,11,0.364,2,8,0.25,0,2,0.0,1,4,5,0,1,1,2,3,10,4,1,Michael Porter Jr.,DEN,DEN,LAC,21.5,Pts+Rebs,15,15,10,5
22023,1629008,22300024,"NOV 14, 2023",DEN vs. LAC,W,34,4,11,0.364,2,8,0.25,0,2,0.0,1,4,5,0,1,1,2,3,10,4,1,Michael Porter Jr.,DEN,DEN,LAC,16.5,Pts+Asts,15,15,10,5
22023,1629008,22300024,"NOV 14, 2023",DEN vs. LAC,W,34,4,11,0.364,2,8,0.25,0,2,0.0,1,4,5,0,1,1,2,3,10,4,1,Michael Porter Jr.,DEN,DEN,LAC,2.5,3-PT Made,15,15,10,5
22023,1629008,22300024,"NOV 14, 2023",DEN vs. LAC,W,34,4,11,0.364,2,8,0.25,0,2,0.0,1,4,5,0,1,1,2,3,10,4,1,Michael Porter Jr.,DEN,DEN,LAC,0.5,Blocked Shots,15,15,10,5
22023,1629008,22300024,"NOV 14, 2023",DEN vs. LAC,W,34,4,11,0.364,2,8,0.25,0,2,0.0,1,4,5,0,1,1,2,3,10,4,1,Michael Porter Jr.,DEN,DEN,LAC,7.5,Rebs+Asts,15,15,10,5
22023,1629008,22300182,"NOV 12, 2023",DEN @ HOU,L,38,11,19,0.579,3,10,0.3,0,0,0.0,2,8,10,0,0,1,2,3,25,2,1,Michael Porter Jr.,DEN,HOU,DEN,15.5,Points,35,35,25,10
22023,1629008,22300182,"NOV 12, 2023",DEN @ HOU,L,38,11,19,0.579,3,10,0.3,0,0,0.0,2,8,10,0,0,1,2,3,25,2,1,Michael Porter Jr.,DEN,HOU,DEN,6.0,Rebounds,35,35,25,10
22023,1629008,22300182,"NOV 12, 2023",DEN @ HOU,L,38,11,19,0.579,3,10,0.3,0,0,0.0,2,8,10,0,0,1,2,3,25,2,1,Michael Porter Jr.,DEN,HOU,DEN,23.5,Pts+Rebs+Asts,35,35,25,10
22023,1629008,22300182,"NOV 12, 2023",DEN @ HOU,L,38,11,19,0.579,3,10,0.3,0,0,0.0,2,8,10,0,0,1,2,3,25,2,1,Michael Porter Jr.,DEN,HOU,DEN,21.5,Pts+Rebs,35,35,25,10
22023,1629008,22300182,"NOV 12, 2023",DEN @ HOU,L,38,11,19,0.579,3,10,0.3,0,0,0.0,2,8,10,0,0,1,2,3,25,2,1,Michael Porter Jr.,DEN,HOU,DEN,16.5,Pts+Asts,35,35,25,10
22023,1629008,22300182,"NOV 12, 2023",DEN @ HOU,L,38,11,19,0.579,3,10,0.3,0,0,0.0,2,8,10,0,0,1,2,3,25,2,1,Michael Porter Jr.,DEN,HOU,DEN,2.5,3-PT Made,35,35,25,10
22023,1629008,22300182,"NOV 12, 2023",DEN @ HOU,L,38,11,19,0.579,3,10,0.3,0,0,0.0,2,8,10,0,0,1,2,3,25,2,1,Michael Porter Jr.,DEN,HOU,DEN,0.5,Blocked Shots,35,35,25,10
22023,1629008,22300182,"NOV 12, 2023",DEN @ HOU,L,38,11,19,0.579,3,10,0.3,0,0,0.0,2,8,10,0,0,1,2,3,25,2,1,Michael Porter Jr.,DEN,HOU,DEN,7.5,Rebs+Asts,35,35,25,10
22023,1629008,22300169,"NOV 08, 2023",DEN vs. GSW,W,37,7,17,0.412,3,8,0.375,0,0,0.0,2,6,8,2,0,2,0,1,17,13,1,Michael Porter Jr.,DEN,DEN,GSW,15.5,Points,27,25,19,10
22023,1629008,22300169,"NOV 08, 2023",DEN vs. GSW,W,37,7,17,0.412,3,8,0.375,0,0,0.0,2,6,8,2,0,2,0,1,17,13,1,Michael Porter Jr.,DEN,DEN,GSW,6.0,Rebounds,27,25,19,10
22023,1629008,22300169,"NOV 08, 2023",DEN vs. GSW,W,37,7,17,0.412,3,8,0.375,0,0,0.0,2,6,8,2,0,2,0,1,17,13,1,Michael Porter Jr.,DEN,DEN,GSW,23.5,Pts+Rebs+Asts,27,25,19,10
22023,1629008,22300169,"NOV 08, 2023",DEN vs. GSW,W,37,7,17,0.412,3,8,0.375,0,0,0.0,2,6,8,2,0,2,0,1,17,13,1,Michael Porter Jr.,DEN,DEN,GSW,21.5,Pts+Rebs,27,25,19,10
22023,1629008,22300169,"NOV 08, 2023",DEN vs. GSW,W,37,7,17,0.412,3,8,0.375,0,0,0.0,2,6,8,2,0,2,0,1,17,13,1,Michael Porter Jr.,DEN,DEN,GSW,16.5,Pts+Asts,27,25,19,10
22023,1629008,22300169,"NOV 08, 2023",DEN vs. GSW,W,37,7,17,0.412,3,8,0.375,0,0,0.0,2,6,8,2,0,2,0,1,17,13,1,Michael Porter Jr.,DEN,DEN,GSW,2.5,3-PT Made,27,25,19,10
22023,1629008,22300169,"NOV 08, 2023",DEN vs. GSW,W,37,7,17,0.412,3,8,0.375,0,0,0.0,2,6,8,2,0,2,0,1,17,13,1,Michael Porter Jr.,DEN,DEN,GSW,0.5,Blocked Shots,27,25,19,10
22023,1629008,22300169,"NOV 08, 2023",DEN vs. GSW,W,37,7,17,0.412,3,8,0.375,0,0,0.0,2,6,8,2,0,2,0,1,17,13,1,Michael Porter Jr.,DEN,DEN,GSW,7.5,Rebs+Asts,27,25,19,10
22023,1629008,22300156,"NOV 06, 2023",DEN vs. NOP,W,29,8,16,0.5,2,6,0.333,4,4,1.0,2,7,9,3,0,0,1,2,22,13,1,Michael Porter Jr.,DEN,DEN,NOP,15.5,Points,34,31,25,12
22023,1629008,22300156,"NOV 06, 2023",DEN vs. NOP,W,29,8,16,0.5,2,6,0.333,4,4,1.0,2,7,9,3,0,0,1,2,22,13,1,Michael Porter Jr.,DEN,DEN,NOP,6.0,Rebounds,34,31,25,12
22023,1629008,22300156,"NOV 06, 2023",DEN vs. NOP,W,29,8,16,0.5,2,6,0.333,4,4,1.0,2,7,9,3,0,0,1,2,22,13,1,Michael Porter Jr.,DEN,DEN,NOP,23.5,Pts+Rebs+Asts,34,31,25,12
22023,1629008,22300156,"NOV 06, 2023",DEN vs. NOP,W,29,8,16,0.5,2,6,0.333,4,4,1.0,2,7,9,3,0,0,1,2,22,13,1,Michael Porter Jr.,DEN,DEN,NOP,21.5,Pts+Rebs,34,31,25,12
22023,1629008,22300156,"NOV 06, 2023",DEN vs. NOP,W,29,8,16,0.5,2,6,0.333,4,4,1.0,2,7,9,3,0,0,1,2,22,13,1,Michael Porter Jr.,DEN,DEN,NOP,16.5,Pts+Asts,34,31,25,12
22023,1629008,22300156,"NOV 06, 2023",DEN vs. NOP,W,29,8,16,0.5,2,6,0.333,4,4,1.0,2,7,9,3,0,0,1,2,22,13,1,Michael Porter Jr.,DEN,DEN,NOP,2.5,3-PT Made,34,31,25,12
22023,1629008,22300156,"NOV 06, 2023",DEN vs. NOP,W,29,8,16,0.5,2,6,0.333,4,4,1.0,2,7,9,3,0,0,1,2,22,13,1,Michael Porter Jr.,DEN,DEN,NOP,0.5,Blocked Shots,34,31,25,12
22023,1629008,22300156,"NOV 06, 2023",DEN vs. NOP,W,29,8,16,0.5,2,6,0.333,4,4,1.0,2,7,9,3,0,0,1,2,22,13,1,Michael Porter Jr.,DEN,DEN,NOP,7.5,Rebs+Asts,34,31,25,12
22023,1629008,22300139,"NOV 04, 2023",DEN vs. CHI,W,31,9,16,0.563,5,10,0.5,4,5,0.8,1,5,6,2,1,2,2,4,27,30,1,Michael Porter Jr.,DEN,DEN,CHI,15.5,Points,35,33,29,8
22023,1629008,22300139,"NOV 04, 2023",DEN vs. CHI,W,31,9,16,0.563,5,10,0.5,4,5,0.8,1,5,6,2,1,2,2,4,27,30,1,Michael Porter Jr.,DEN,DEN,CHI,6.0,Rebounds,35,33,29,8
22023,1629008,22300139,"NOV 04, 2023",DEN vs. CHI,W,31,9,16,0.563,5,10,0.5,4,5,0.8,1,5,6,2,1,2,2,4,27,30,1,Michael Porter Jr.,DEN,DEN,CHI,23.5,Pts+Rebs+Asts,35,33,29,8
22023,1629008,22300139,"NOV 04, 2023",DEN vs. CHI,W,31,9,16,0.563,5,10,0.5,4,5,0.8,1,5,6,2,1,2,2,4,27,30,1,Michael Porter Jr.,DEN,DEN,CHI,21.5,Pts+Rebs,35,33,29,8
22023,1629008,22300139,"NOV 04, 2023",DEN vs. CHI,W,31,9,16,0.563,5,10,0.5,4,5,0.8,1,5,6,2,1,2,2,4,27,30,1,Michael Porter Jr.,DEN,DEN,CHI,16.5,Pts+Asts,35,33,29,8
22023,1629008,22300139,"NOV 04, 2023",DEN vs. CHI,W,31,9,16,0.563,5,10,0.5,4,5,0.8,1,5,6,2,1,2,2,4,27,30,1,Michael Porter Jr.,DEN,DEN,CHI,2.5,3-PT Made,35,33,29,8
22023,1629008,22300139,"NOV 04, 2023",DEN vs. CHI,W,31,9,16,0.563,5,10,0.5,4,5,0.8,1,5,6,2,1,2,2,4,27,30,1,Michael Porter Jr.,DEN,DEN,CHI,0.5,Blocked Shots,35,33,29,8
22023,1629008,22300139,"NOV 04, 2023",DEN vs. CHI,W,31,9,16,0.563,5,10,0.5,4,5,0.8,1,5,6,2,1,2,2,4,27,30,1,Michael Porter Jr.,DEN,DEN,CHI,7.5,Rebs+Asts,35,33,29,8
22023,1629008,22300006,"NOV 03, 2023",DEN vs. DAL,W,34,10,18,0.556,4,8,0.5,0,0,0.0,5,4,9,1,0,2,1,2,24,17,1,Michael Porter Jr.,DEN,DEN,DAL,15.5,Points,34,33,25,10
22023,1629008,22300006,"NOV 03, 2023",DEN vs. DAL,W,34,10,18,0.556,4,8,0.5,0,0,0.0,5,4,9,1,0,2,1,2,24,17,1,Michael Porter Jr.,DEN,DEN,DAL,6.0,Rebounds,34,33,25,10
22023,1629008,22300006,"NOV 03, 2023",DEN vs. DAL,W,34,10,18,0.556,4,8,0.5,0,0,0.0,5,4,9,1,0,2,1,2,24,17,1,Michael Porter Jr.,DEN,DEN,DAL,23.5,Pts+Rebs+Asts,34,33,25,10
22023,1629008,22300006,"NOV 03, 2023",DEN vs. DAL,W,34,10,18,0.556,4,8,0.5,0,0,0.0,5,4,9,1,0,2,1,2,24,17,1,Michael Porter Jr.,DEN,DEN,DAL,21.5,Pts+Rebs,34,33,25,10
22023,1629008,22300006,"NOV 03, 2023",DEN vs. DAL,W,34,10,18,0.556,4,8,0.5,0,0,0.0,5,4,9,1,0,2,1,2,24,17,1,Michael Porter Jr.,DEN,DEN,DAL,16.5,Pts+Asts,34,33,25,10
22023,1629008,22300006,"NOV 03, 2023",DEN vs. DAL,W,34,10,18,0.556,4,8,0.5,0,0,0.0,5,4,9,1,0,2,1,2,24,17,1,Michael Porter Jr.,DEN,DEN,DAL,2.5,3-PT Made,34,33,25,10
22023,1629008,22300006,"NOV 03, 2023",DEN vs. DAL,W,34,10,18,0.556,4,8,0.5,0,0,0.0,5,4,9,1,0,2,1,2,24,17,1,Michael Porter Jr.,DEN,DEN,DAL,0.5,Blocked Shots,34,33,25,10
22023,1629008,22300006,"NOV 03, 2023",DEN vs. DAL,W,34,10,18,0.556,4,8,0.5,0,0,0.0,5,4,9,1,0,2,1,2,24,17,1,Michael Porter Jr.,DEN,DEN,DAL,7.5,Rebs+Asts,34,33,25,10
22023,1629008,22300123,"NOV 01, 2023",DEN @ MIN,L,25,2,11,0.182,0,5,0.0,1,1,1.0,2,3,5,1,1,1,0,0,5,-19,1,Michael Porter Jr.,DEN,MIN,DEN,15.5,Points,11,10,6,6
22023,1629008,22300123,"NOV 01, 2023",DEN @ MIN,L,25,2,11,0.182,0,5,0.0,1,1,1.0,2,3,5,1,1,1,0,0,5,-19,1,Michael Porter Jr.,DEN,MIN,DEN,6.0,Rebounds,11,10,6,6
22023,1629008,22300123,"NOV 01, 2023",DEN @ MIN,L,25,2,11,0.182,0,5,0.0,1,1,1.0,2,3,5,1,1,1,0,0,5,-19,1,Michael Porter Jr.,DEN,MIN,DEN,23.5,Pts+Rebs+Asts,11,10,6,6
22023,1629008,22300123,"NOV 01, 2023",DEN @ MIN,L,25,2,11,0.182,0,5,0.0,1,1,1.0,2,3,5,1,1,1,0,0,5,-19,1,Michael Porter Jr.,DEN,MIN,DEN,21.5,Pts+Rebs,11,10,6,6
22023,1629008,22300123,"NOV 01, 2023",DEN @ MIN,L,25,2,11,0.182,0,5,0.0,1,1,1.0,2,3,5,1,1,1,0,0,5,-19,1,Michael Porter Jr.,DEN,MIN,DEN,16.5,Pts+Asts,11,10,6,6
22023,1629008,22300123,"NOV 01, 2023",DEN @ MIN,L,25,2,11,0.182,0,5,0.0,1,1,1.0,2,3,5,1,1,1,0,0,5,-19,1,Michael Porter Jr.,DEN,MIN,DEN,2.5,3-PT Made,11,10,6,6
22023,1629008,22300123,"NOV 01, 2023",DEN @ MIN,L,25,2,11,0.182,0,5,0.0,1,1,1.0,2,3,5,1,1,1,0,0,5,-19,1,Michael Porter Jr.,DEN,MIN,DEN,0.5,Blocked Shots,11,10,6,6
22023,1629008,22300123,"NOV 01, 2023",DEN @ MIN,L,25,2,11,0.182,0,5,0.0,1,1,1.0,2,3,5,1,1,1,0,0,5,-19,1,Michael Porter Jr.,DEN,MIN,DEN,7.5,Rebs+Asts,11,10,6,6
22023,1629008,22300110,"OCT 30, 2023",DEN vs. UTA,W,19,3,8,0.375,2,6,0.333,0,0,0.0,0,1,1,2,0,1,1,3,8,2,1,Michael Porter Jr.,DEN,DEN,UTA,15.5,Points,11,9,10,3
22023,1629008,22300110,"OCT 30, 2023",DEN vs. UTA,W,19,3,8,0.375,2,6,0.333,0,0,0.0,0,1,1,2,0,1,1,3,8,2,1,Michael Porter Jr.,DEN,DEN,UTA,6.0,Rebounds,11,9,10,3
22023,1629008,22300110,"OCT 30, 2023",DEN vs. UTA,W,19,3,8,0.375,2,6,0.333,0,0,0.0,0,1,1,2,0,1,1,3,8,2,1,Michael Porter Jr.,DEN,DEN,UTA,23.5,Pts+Rebs+Asts,11,9,10,3
22023,1629008,22300110,"OCT 30, 2023",DEN vs. UTA,W,19,3,8,0.375,2,6,0.333,0,0,0.0,0,1,1,2,0,1,1,3,8,2,1,Michael Porter Jr.,DEN,DEN,UTA,21.5,Pts+Rebs,11,9,10,3
22023,1629008,22300110,"OCT 30, 2023",DEN vs. UTA,W,19,3,8,0.375,2,6,0.333,0,0,0.0,0,1,1,2,0,1,1,3,8,2,1,Michael Porter Jr.,DEN,DEN,UTA,16.5,Pts+Asts,11,9,10,3
22023,1629008,22300110,"OCT 30, 2023",DEN vs. UTA,W,19,3,8,0.375,2,6,0.333,0,0,0.0,0,1,1,2,0,1,1,3,8,2,1,Michael Porter Jr.,DEN,DEN,UTA,2.5,3-PT Made,11,9,10,3
22023,1629008,22300110,"OCT 30, 2023",DEN vs. UTA,W,19,3,8,0.375,2,6,0.333,0,0,0.0,0,1,1,2,0,1,1,3,8,2,1,Michael Porter Jr.,DEN,DEN,UTA,0.5,Blocked Shots,11,9,10,3
22023,1629008,22300110,"OCT 30, 2023",DEN vs. UTA,W,19,3,8,0.375,2,6,0.333,0,0,0.0,0,1,1,2,0,1,1,3,8,2,1,Michael Porter Jr.,DEN,DEN,UTA,7.5,Rebs+Asts,11,9,10,3
22023,1629008,22300095,"OCT 29, 2023",DEN @ OKC,W,25,8,14,0.571,4,7,0.571,0,0,0.0,3,6,9,2,0,0,1,3,20,12,1,Michael Porter Jr.,DEN,OKC,DEN,15.5,Points,31,29,22,11
22023,1629008,22300095,"OCT 29, 2023",DEN @ OKC,W,25,8,14,0.571,4,7,0.571,0,0,0.0,3,6,9,2,0,0,1,3,20,12,1,Michael Porter Jr.,DEN,OKC,DEN,6.0,Rebounds,31,29,22,11
22023,1629008,22300095,"OCT 29, 2023",DEN @ OKC,W,25,8,14,0.571,4,7,0.571,0,0,0.0,3,6,9,2,0,0,1,3,20,12,1,Michael Porter Jr.,DEN,OKC,DEN,23.5,Pts+Rebs+Asts,31,29,22,11
22023,1629008,22300095,"OCT 29, 2023",DEN @ OKC,W,25,8,14,0.571,4,7,0.571,0,0,0.0,3,6,9,2,0,0,1,3,20,12,1,Michael Porter Jr.,DEN,OKC,DEN,21.5,Pts+Rebs,31,29,22,11
22023,1629008,22300095,"OCT 29, 2023",DEN @ OKC,W,25,8,14,0.571,4,7,0.571,0,0,0.0,3,6,9,2,0,0,1,3,20,12,1,Michael Porter Jr.,DEN,OKC,DEN,16.5,Pts+Asts,31,29,22,11
22023,1629008,22300095,"OCT 29, 2023",DEN @ OKC,W,25,8,14,0.571,4,7,0.571,0,0,0.0,3,6,9,2,0,0,1,3,20,12,1,Michael Porter Jr.,DEN,OKC,DEN,2.5,3-PT Made,31,29,22,11
22023,1629008,22300095,"OCT 29, 2023",DEN @ OKC,W,25,8,14,0.571,4,7,0.571,0,0,0.0,3,6,9,2,0,0,1,3,20,12,1,Michael Porter Jr.,DEN,OKC,DEN,0.5,Blocked Shots,31,29,22,11
22023,1629008,22300095,"OCT 29, 2023",DEN @ OKC,W,25,8,14,0.571,4,7,0.571,0,0,0.0,3,6,9,2,0,0,1,3,20,12,1,Michael Porter Jr.,DEN,OKC,DEN,7.5,Rebs+Asts,31,29,22,11
22023,1629008,22300078,"OCT 27, 2023",DEN @ MEM,W,29,3,7,0.429,2,5,0.4,1,1,1.0,1,12,13,3,0,0,1,4,9,4,1,Michael Porter Jr.,DEN,MEM,DEN,15.5,Points,25,22,12,16
22023,1629008,22300078,"OCT 27, 2023",DEN @ MEM,W,29,3,7,0.429,2,5,0.4,1,1,1.0,1,12,13,3,0,0,1,4,9,4,1,Michael Porter Jr.,DEN,MEM,DEN,6.0,Rebounds,25,22,12,16
22023,1629008,22300078,"OCT 27, 2023",DEN @ MEM,W,29,3,7,0.429,2,5,0.4,1,1,1.0,1,12,13,3,0,0,1,4,9,4,1,Michael Porter Jr.,DEN,MEM,DEN,23.5,Pts+Rebs+Asts,25,22,12,16
22023,1629008,22300078,"OCT 27, 2023",DEN @ MEM,W,29,3,7,0.429,2,5,0.4,1,1,1.0,1,12,13,3,0,0,1,4,9,4,1,Michael Porter Jr.,DEN,MEM,DEN,21.5,Pts+Rebs,25,22,12,16
22023,1629008,22300078,"OCT 27, 2023",DEN @ MEM,W,29,3,7,0.429,2,5,0.4,1,1,1.0,1,12,13,3,0,0,1,4,9,4,1,Michael Porter Jr.,DEN,MEM,DEN,16.5,Pts+Asts,25,22,12,16
22023,1629008,22300078,"OCT 27, 2023",DEN @ MEM,W,29,3,7,0.429,2,5,0.4,1,1,1.0,1,12,13,3,0,0,1,4,9,4,1,Michael Porter Jr.,DEN,MEM,DEN,2.5,3-PT Made,25,22,12,16
22023,1629008,22300078,"OCT 27, 2023",DEN @ MEM,W,29,3,7,0.429,2,5,0.4,1,1,1.0,1,12,13,3,0,0,1,4,9,4,1,Michael Porter Jr.,DEN,MEM,DEN,0.5,Blocked Shots,25,22,12,16
22023,1629008,22300078,"OCT 27, 2023",DEN @ MEM,W,29,3,7,0.429,2,5,0.4,1,1,1.0,1,12,13,3,0,0,1,4,9,4,1,Michael Porter Jr.,DEN,MEM,DEN,7.5,Rebs+Asts,25,22,12,16
22023,1629008,22300061,"OCT 24, 2023",DEN vs. LAL,W,30,5,13,0.385,2,9,0.222,0,0,0.0,2,10,12,2,2,0,0,1,12,12,1,Michael Porter Jr.,DEN,DEN,LAL,15.5,Points,26,24,14,14
22023,1629008,22300061,"OCT 24, 2023",DEN vs. LAL,W,30,5,13,0.385,2,9,0.222,0,0,0.0,2,10,12,2,2,0,0,1,12,12,1,Michael Porter Jr.,DEN,DEN,LAL,6.0,Rebounds,26,24,14,14
22023,1629008,22300061,"OCT 24, 2023",DEN vs. LAL,W,30,5,13,0.385,2,9,0.222,0,0,0.0,2,10,12,2,2,0,0,1,12,12,1,Michael Porter Jr.,DEN,DEN,LAL,23.5,Pts+Rebs+Asts,26,24,14,14
22023,1629008,22300061,"OCT 24, 2023",DEN vs. LAL,W,30,5,13,0.385,2,9,0.222,0,0,0.0,2,10,12,2,2,0,0,1,12,12,1,Michael Porter Jr.,DEN,DEN,LAL,21.5,Pts+Rebs,26,24,14,14
22023,1629008,22300061,"OCT 24, 2023",DEN vs. LAL,W,30,5,13,0.385,2,9,0.222,0,0,0.0,2,10,12,2,2,0,0,1,12,12,1,Michael Porter Jr.,DEN,DEN,LAL,16.5,Pts+Asts,26,24,14,14
22023,1629008,22300061,"OCT 24, 2023",DEN vs. LAL,W,30,5,13,0.385,2,9,0.222,0,0,0.0,2,10,12,2,2,0,0,1,12,12,1,Michael Porter Jr.,DEN,DEN,LAL,2.5,3-PT Made,26,24,14,14
22023,1629008,22300061,"OCT 24, 2023",DEN vs. LAL,W,30,5,13,0.385,2,9,0.222,0,0,0.0,2,10,12,2,2,0,0,1,12,12,1,Michael Porter Jr.,DEN,DEN,LAL,0.5,Blocked Shots,26,24,14,14
22023,1629008,22300061,"OCT 24, 2023",DEN vs. LAL,W,30,5,13,0.385,2,9,0.222,0,0,0.0,2,10,12,2,2,0,0,1,12,12,1,Michael Porter Jr.,DEN,DEN,LAL,7.5,Rebs+Asts,26,24,14,14
22023,203490,22300440,"DEC 30, 2023",TOR @ DET,L,7,0,0,0.0,0,0,0.0,0,0,0.0,0,0,0,1,0,0,0,2,0,-3,1,Otto Porter Jr.,TOR,DET,TOR,,,1,0,1,1
22023,203490,22300432,"DEC 29, 2023",TOR @ BOS,L,8,0,1,0.0,0,1,0.0,0,0,0.0,0,0,0,2,0,0,0,0,0,-5,1,Otto Porter Jr.,TOR,BOS,TOR,,,2,0,2,2
22023,203490,22300416,"DEC 27, 2023",TOR @ WAS,W,13,3,3,1.0,0,0,0.0,0,0,0.0,0,2,2,2,1,1,0,2,6,12,1,Otto Porter Jr.,TOR,WAS,TOR,,,10,8,8,4
22023,203490,22300382,"DEC 22, 2023",TOR @ PHI,L,15,1,3,0.333,1,3,0.333,2,2,1.0,0,3,3,0,0,0,0,3,5,-10,1,Otto Porter Jr.,TOR,PHI,TOR,,,8,8,5,3
22023,203490,22301216,"DEC 08, 2023",TOR @ CHA,L,6,0,1,0.0,0,1,0.0,0,0,0.0,0,0,0,1,0,0,0,0,0,-7,1,Otto Porter Jr.,TOR,CHA,TOR,,,1,0,1,1
22023,203490,22301207,"DEC 06, 2023",TOR vs. MIA,L,14,0,2,0.0,0,2,0.0,0,0,0.0,0,2,2,1,1,1,1,2,0,14,1,Otto Porter Jr.,TOR,TOR,MIA,,,3,2,1,3
22023,203490,22300251,"NOV 26, 2023",TOR @ CLE,L,5,0,1,0.0,0,1,0.0,0,0,0.0,1,0,1,0,0,0,0,0,0,-4,1,Otto Porter Jr.,TOR,CLE,TOR,,,1,1,0,1
22023,203490,22300230,"NOV 22, 2023",TOR @ IND,W,11,1,1,1.0,1,1,1.0,0,0,0.0,1,3,4,0,0,0,0,2,3,14,1,Otto Porter Jr.,TOR,IND,TOR,,,7,7,3,4
22023,203490,22300038,"NOV 21, 2023",TOR @ ORL,L,5,2,2,1.0,1,1,1.0,0,0,0.0,1,1,2,0,0,0,1,1,5,4,1,Otto Porter Jr.,TOR,ORL,TOR,,,7,7,5,2
22023,203490,22300195,"NOV 15, 2023",TOR vs. MIL,L,11,0,0,0.0,0,0,0.0,0,0,0.0,0,1,1,0,0,0,0,0,0,0,1,Otto Porter Jr.,TOR,TOR,MIL,,,1,1,0,1
22023,203490,22300189,"NOV 13, 2023",TOR vs. WAS,W,14,2,6,0.333,0,1,0.0,1,1,1.0,1,0,1,0,1,1,0,0,5,-13,1,Otto Porter Jr.,TOR,TOR,WAS,,,6,6,5,1
22023,203490,22300174,"NOV 11, 2023",TOR @ BOS,L,14,1,2,0.5,1,2,0.5,0,0,0.0,0,3,3,0,1,0,0,1,3,-9,1,Otto Porter Jr.,TOR,BOS,TOR,,,6,6,3,3
22023,203490,22300168,"NOV 08, 2023",TOR @ DAL,W,15,0,3,0.0,0,2,0.0,0,0,0.0,0,3,3,0,1,0,0,1,0,9,1,Otto Porter Jr.,TOR,DAL,TOR,,,3,3,0,3
22023,203490,22300141,"NOV 05, 2023",TOR @ SAS,W,19,2,4,0.5,2,4,0.5,0,0,0.0,0,4,4,0,0,1,0,2,6,9,1,Otto Porter Jr.,TOR,SAS,TOR,,,10,10,6,4
22023,203490,22300116,"NOV 01, 2023",TOR vs. MIL,W,16,2,4,0.5,2,4,0.5,0,0,0.0,2,1,3,1,0,1,0,3,6,11,1,Otto Porter Jr.,TOR,TOR,MIL,,,10,9,7,4
22023,1626171,22300552,"JAN 14, 2024",MIL vs. SAC,W,26,9,11,0.818,2,2,1.0,2,2,1.0,2,8,10,1,0,0,2,1,22,10,1,Bobby Portis,MIL,MIL,SAC,,,33,32,23,11
22023,1626171,22300545,"JAN 13, 2024",MIL vs. GSW,W,21,4,11,0.364,2,4,0.5,0,0,0.0,0,8,8,0,0,0,1,5,10,7,1,Bobby Portis,MIL,MIL,GSW,,,18,18,10,8
22023,1626171,22300528,"JAN 11, 2024",MIL vs. BOS,W,22,11,18,0.611,5,6,0.833,1,2,0.5,1,11,12,0,1,0,0,1,28,15,1,Bobby Portis,MIL,MIL,BOS,,,40,40,28,12
22023,1626171,22300510,"JAN 08, 2024",MIL vs. UTA,L,16,4,11,0.364,0,2,0.0,0,0,0.0,1,2,3,0,0,0,0,4,8,-8,1,Bobby Portis,MIL,MIL,UTA,,,11,11,8,3
22023,1626171,22300496,"JAN 06, 2024",MIL @ HOU,L,17,2,5,0.4,1,2,0.5,1,2,0.5,0,6,6,0,1,1,2,5,6,-13,1,Bobby Portis,MIL,HOU,MIL,,,12,12,6,6
22023,1626171,22300477,"JAN 04, 2024",MIL @ SAS,W,21,2,6,0.333,0,2,0.0,1,2,0.5,1,3,4,0,0,1,2,3,5,-8,1,Bobby Portis,MIL,SAS,MIL,,,9,9,5,4
22023,1626171,22300466,"JAN 03, 2024",MIL @ IND,L,20,4,10,0.4,0,2,0.0,1,2,0.5,3,3,6,1,0,1,0,1,9,-1,1,Bobby Portis,MIL,IND,MIL,,,16,15,10,7
22023,1626171,22300454,"JAN 01, 2024",MIL vs. IND,L,18,4,12,0.333,0,4,0.0,0,0,0.0,1,4,5,0,0,1,0,4,8,-21,1,Bobby Portis,MIL,MIL,IND,,,13,13,8,5
22023,1626171,22300433,"DEC 29, 2023",MIL @ CLE,W,23,2,6,0.333,1,2,0.5,4,6,0.667,1,4,5,1,1,0,0,3,9,-5,1,Bobby Portis,MIL,CLE,MIL,,,15,14,10,6
22023,1626171,22300417,"DEC 27, 2023",MIL @ BKN,W,31,6,9,0.667,2,3,0.667,0,0,0.0,0,6,6,4,2,1,1,1,14,20,1,Bobby Portis,MIL,BKN,MIL,,,24,20,18,10
22023,1626171,22300401,"DEC 25, 2023",MIL @ NYK,L,31,5,11,0.455,0,4,0.0,2,2,1.0,5,4,9,0,0,0,3,4,12,-3,1,Bobby Portis,MIL,NYK,MIL,,,21,21,12,9
22023,1626171,22300388,"DEC 23, 2023",MIL @ NYK,W,27,9,14,0.643,3,4,0.75,2,2,1.0,2,9,11,1,2,0,2,4,23,17,1,Bobby Portis,MIL,NYK,MIL,,,35,34,24,12
22023,1626171,22300378,"DEC 21, 2023",MIL vs. ORL,W,21,3,8,0.375,0,2,0.0,0,0,0.0,5,3,8,1,1,1,0,1,6,-18,1,Bobby Portis,MIL,MIL,ORL,,,15,14,7,9
22023,1626171,22300361,"DEC 19, 2023",MIL vs. SAS,W,26,10,16,0.625,3,6,0.5,0,0,0.0,1,9,10,2,2,0,0,3,23,4,1,Bobby Portis,MIL,MIL,SAS,,,35,33,25,12
22023,1626171,22300346,"DEC 17, 2023",MIL vs. HOU,W,25,5,7,0.714,1,2,0.5,0,0,0.0,4,2,6,0,0,0,0,3,11,7,1,Bobby Portis,MIL,MIL,HOU,,,17,17,11,6
22023,1626171,22300334,"DEC 16, 2023",MIL vs. DET,W,27,11,18,0.611,4,7,0.571,5,5,1.0,3,9,12,1,1,0,4,3,31,24,1,Bobby Portis,MIL,MIL,DET,,,44,43,32,13
22023,1626171,22300315,"DEC 13, 2023",MIL vs. IND,W,23,8,13,0.615,3,4,0.75,0,0,0.0,1,1,2,2,0,0,0,2,19,16,1,Bobby Portis,MIL,MIL,IND,,,23,21,21,4
22023,1626171,22300300,"DEC 11, 2023",MIL vs. CHI,W,25,7,11,0.636,1,3,0.333,2,2,1.0,2,5,7,0,0,0,1,3,17,-4,1,Bobby Portis,MIL,MIL,CHI,,,24,24,17,7
22023,1626171,22301229,"DEC 07, 2023",MIL vs. IND,L,18,2,5,0.4,0,1,0.0,0,0,0.0,4,2,6,1,0,1,1,2,4,-6,1,Bobby Portis,MIL,MIL,IND,,,11,10,5,7
22023,1626171,22301201,"DEC 05, 2023",MIL vs. NYK,W,24,5,9,0.556,1,3,0.333,2,2,1.0,2,2,4,1,0,2,1,4,13,-7,1,Bobby Portis,MIL,MIL,NYK,,,18,17,14,5
22023,1626171,22300286,"DEC 02, 2023",MIL vs. ATL,W,23,7,13,0.538,1,4,0.25,0,0,0.0,2,9,11,0,0,0,0,3,15,9,1,Bobby Portis,MIL,MIL,ATL,,,26,26,15,11
22023,1626171,22300269,"NOV 30, 2023",MIL @ CHI,L,31,2,8,0.25,0,2,0.0,0,0,0.0,1,8,9,2,2,0,0,3,4,-14,1,Bobby Portis,MIL,CHI,MIL,,,15,13,6,11
22023,1626171,22300056,"NOV 28, 2023",MIL @ MIA,W,23,3,8,0.375,0,2,0.0,0,0,0.0,0,2,2,0,0,0,0,2,6,-12,1,Bobby Portis,MIL,MIA,MIL,,,8,8,6,2
22023,1626171,22300245,"NOV 26, 2023",MIL vs. POR,W,31,5,12,0.417,2,5,0.4,0,0,0.0,6,2,8,1,2,3,2,3,12,3,1,Bobby Portis,MIL,MIL,POR,,,21,20,13,9
22023,1626171,22300049,"NOV 24, 2023",MIL vs. WAS,W,25,1,5,0.2,0,1,0.0,0,0,0.0,2,4,6,1,0,1,0,3,2,3,1,Bobby Portis,MIL,MIL,WAS,,,9,8,3,7
22023,1626171,22300228,"NOV 22, 2023",MIL @ BOS,L,21,2,6,0.333,0,0,0.0,0,0,0.0,1,6,7,0,0,0,0,2,4,-4,1,Bobby Portis,MIL,BOS,MIL,,,11,11,4,7
22023,1626171,22300219,"NOV 20, 2023",MIL @ WAS,W,23,8,13,0.615,1,3,0.333,0,0,0.0,1,7,8,1,1,0,1,2,17,13,1,Bobby Portis,MIL,WAS,MIL,,,26,25,18,9
22023,1626171,22300205,"NOV 18, 2023",MIL vs. DAL,W,22,5,10,0.5,1,2,0.5,0,0,0.0,1,6,7,2,0,0,0,0,11,7,1,Bobby Portis,MIL,MIL,DAL,,,20,18,13,9
22023,1626171,22300027,"NOV 17, 2023",MIL @ CHA,W,30,6,12,0.5,1,3,0.333,0,0,0.0,0,7,7,1,1,0,3,1,13,4,1,Bobby Portis,MIL,CHA,MIL,,,21,20,14,8
22023,1626171,22300195,"NOV 15, 2023",MIL @ TOR,W,31,7,11,0.636,2,3,0.667,2,2,1.0,1,6,7,0,0,2,0,5,18,15,1,Bobby Portis,MIL,TOR,MIL,,,25,25,18,7
22023,1626171,22300190,"NOV 13, 2023",MIL vs. CHI,W,25,7,10,0.7,3,6,0.5,2,2,1.0,2,8,10,2,0,1,0,3,19,24,1,Bobby Portis,MIL,MIL,CHI,,,31,29,21,12
22023,1626171,22300173,"NOV 11, 2023",MIL @ ORL,L,28,4,11,0.364,2,5,0.4,3,4,0.75,1,6,7,1,2,0,2,4,13,-6,1,Bobby Portis,MIL,ORL,MIL,,,21,20,14,8
22023,1626171,22300171,"NOV 09, 2023",MIL @ IND,L,24,5,11,0.455,0,2,0.0,1,1,1.0,0,8,8,2,1,1,3,2,11,6,1,Bobby Portis,MIL,IND,MIL,,,21,19,13,10
22023,1626171,22300165,"NOV 08, 2023",MIL vs. DET,W,23,7,14,0.5,1,4,0.25,3,3,1.0,2,3,5,2,0,0,2,1,18,-4,1,Bobby Portis,MIL,MIL,DET,,,25,23,20,7
22023,1626171,22300149,"NOV 06, 2023",MIL @ BKN,W,26,3,8,0.375,1,2,0.5,4,4,1.0,0,6,6,2,2,0,1,2,11,14,1,Bobby Portis,MIL,BKN,MIL,,,19,17,13,8
22023,1626171,22300002,"NOV 03, 2023",MIL vs. NYK,W,17,2,10,0.2,0,2,0.0,0,0,0.0,0,2,2,0,2,0,0,1,4,-2,1,Bobby Portis,MIL,MIL,NYK,,,6,6,4,2
22023,1626171,22300116,"NOV 01, 2023",MIL @ TOR,L,19,2,6,0.333,0,1,0.0,6,9,0.667,1,5,6,1,2,0,1,1,10,-7,1,Bobby Portis,MIL,TOR,MIL,,,17,16,11,7
22023,1626171,22300107,"OCT 30, 2023",MIL vs. MIA,W,19,7,10,0.7,0,2,0.0,2,2,1.0,2,6,8,2,2,1,0,3,16,18,1,Bobby Portis,MIL,MIL,MIA,,,26,24,18,10
22023,1626171,22300097,"OCT 29, 2023",MIL vs. ATL,L,21,5,10,0.5,0,2,0.0,2,2,1.0,1,3,4,2,0,0,3,2,12,-5,1,Bobby Portis,MIL,MIL,ATL,,,18,16,14,6
22023,1626171,22300075,"OCT 26, 2023",MIL vs. PHI,W,19,5,8,0.625,0,0,0.0,0,4,0.0,2,4,6,2,0,1,0,3,10,-10,1,Bobby Portis,MIL,MIL,PHI,,,18,16,12,8
22023,204001,22300563,"JAN 15, 2024",BOS @ TOR,W,32,2,6,0.333,1,4,0.25,10,12,0.833,0,6,6,2,0,2,6,4,15,2,1,Kristaps Porzingis,BOS,TOR,BOS,,,23,21,17,8
22023,204001,22300542,"JAN 13, 2024",BOS vs. HOU,W,28,6,11,0.545,3,5,0.6,2,2,1.0,1,6,7,5,1,3,2,3,17,24,1,Kristaps Porzingis,BOS,BOS,HOU,,,29,24,22,12
22023,204001,22300528,"JAN 11, 2024",BOS @ MIL,L,21,3,9,0.333,0,3,0.0,0,0,0.0,1,1,2,4,1,1,1,2,6,-27,1,Kristaps Porzingis,BOS,MIL,BOS,,,12,8,10,6
22023,204001,22300507,"JAN 08, 2024",BOS @ IND,L,38,6,13,0.462,1,4,0.25,6,7,0.857,2,3,5,7,0,3,1,2,19,1,1,Kristaps Porzingis,BOS,IND,BOS,,,31,24,26,12
22023,204001,22300493,"JAN 06, 2024",BOS @ IND,W,6,1,2,0.5,0,1,0.0,0,0,0.0,1,2,3,0,1,1,0,0,2,4,1,Kristaps Porzingis,BOS,IND,BOS,,,5,5,2,3
22023,204001,22300479,"JAN 05, 2024",BOS vs. UTA,W,27,4,7,0.571,1,3,0.333,10,12,0.833,0,5,5,2,0,1,1,3,19,18,1,Kristaps Porzingis,BOS,BOS,UTA,,,26,24,21,7
22023,204001,22300462,"JAN 02, 2024",BOS @ OKC,L,35,12,18,0.667,2,3,0.667,8,9,0.889,6,4,10,2,0,3,1,1,34,3,1,Kristaps Porzingis,BOS,OKC,BOS,,,46,44,36,12
22023,204001,22300448,"DEC 31, 2023",BOS @ SAS,W,30,4,14,0.286,0,7,0.0,6,6,1.0,1,8,9,2,1,2,1,2,14,33,1,Kristaps Porzingis,BOS,SAS,BOS,,,25,23,16,11
22023,204001,22300421,"DEC 28, 2023",BOS vs. DET,W,36,13,21,0.619,3,9,0.333,6,7,0.857,0,8,8,1,1,0,1,4,35,12,1,Kristaps Porzingis,BOS,BOS,DET,,,44,43,36,9
22023,204001,22300403,"DEC 25, 2023",BOS @ LAL,W,35,11,19,0.579,2,8,0.25,4,7,0.571,3,8,11,2,1,2,1,3,28,16,1,Kristaps Porzingis,BOS,LAL,BOS,,,41,39,30,13
22023,204001,22300373,"DEC 20, 2023",BOS @ SAC,W,29,7,11,0.636,3,4,0.75,7,8,0.875,2,7,9,2,0,6,3,3,24,22,1,Kristaps Porzingis,BOS,SAC,BOS,,,35,33,26,11
22023,204001,22300344,"DEC 17, 2023",BOS vs. ORL,W,29,6,12,0.5,2,4,0.5,1,1,1.0,1,9,10,0,1,1,4,2,15,4,1,Kristaps Porzingis,BOS,BOS,ORL,,,25,25,15,10
22023,204001,22300319,"DEC 14, 2023",BOS vs. CLE,W,31,5,11,0.455,1,6,0.167,7,8,0.875,1,5,6,0,1,2,3,2,18,-1,1,Kristaps Porzingis,BOS,BOS,CLE,,,24,24,18,6
22023,204001,22300305,"DEC 12, 2023",BOS vs. CLE,W,32,5,16,0.313,2,6,0.333,9,9,1.0,3,7,10,3,1,2,3,1,21,-3,1,Kristaps Porzingis,BOS,BOS,CLE,,,34,31,24,13
22023,204001,22301227,"DEC 08, 2023",BOS vs. NYK,W,29,7,13,0.538,3,6,0.5,4,4,1.0,1,2,3,1,2,0,2,2,21,13,1,Kristaps Porzingis,BOS,BOS,NYK,,,25,24,22,4
22023,204001,22300043,"NOV 24, 2023",BOS @ ORL,L,22,4,9,0.444,1,4,0.25,0,1,0.0,1,3,4,2,2,0,2,3,9,6,1,Kristaps Porzingis,BOS,ORL,BOS,,,15,13,11,6
22023,204001,22300228,"NOV 22, 2023",BOS vs. MIL,W,27,9,15,0.6,2,7,0.286,1,2,0.5,1,5,6,1,0,0,1,5,21,3,1,Kristaps Porzingis,BOS,BOS,MIL,,,28,27,22,7
22023,204001,22300217,"NOV 20, 2023",BOS @ CHA,L,34,5,14,0.357,1,8,0.125,6,10,0.6,3,5,8,0,2,3,0,2,17,-26,1,Kristaps Porzingis,BOS,CHA,BOS,,,25,25,17,8
22023,204001,22300213,"NOV 19, 2023",BOS @ MEM,W,34,9,13,0.692,0,3,0.0,8,9,0.889,2,6,8,1,1,6,2,4,26,4,1,Kristaps Porzingis,BOS,MEM,BOS,,,35,34,27,9
22023,204001,22300031,"NOV 17, 2023",BOS @ TOR,W,35,6,13,0.462,0,3,0.0,2,2,1.0,2,10,12,5,1,3,2,3,14,2,1,Kristaps Porzingis,BOS,TOR,BOS,,,31,26,19,17
22023,204001,22300188,"NOV 13, 2023",BOS vs. NYK,W,33,7,11,0.636,3,6,0.5,4,4,1.0,1,5,6,3,0,1,1,5,21,19,1,Kristaps Porzingis,BOS,BOS,NYK,,,30,27,24,9
22023,204001,22300174,"NOV 11, 2023",BOS vs. TOR,W,28,9,14,0.643,3,7,0.429,0,1,0.0,0,7,7,3,0,0,3,1,21,12,1,Kristaps Porzingis,BOS,BOS,TOR,,,31,28,24,10
22023,204001,22300010,"NOV 10, 2023",BOS vs. BKN,W,25,2,4,0.5,0,2,0.0,5,5,1.0,0,2,2,2,0,1,0,2,9,20,1,Kristaps Porzingis,BOS,BOS,BKN,,,13,11,11,4
22023,204001,22300159,"NOV 08, 2023",BOS @ PHI,L,31,10,19,0.526,2,6,0.333,7,8,0.875,4,2,6,3,0,1,0,4,29,8,1,Kristaps Porzingis,BOS,PHI,BOS,,,38,35,32,9
22023,204001,22300154,"NOV 06, 2023",BOS @ MIN,L,36,5,14,0.357,2,6,0.333,8,10,0.8,1,4,5,1,1,1,1,5,20,-7,1,Kristaps Porzingis,BOS,MIN,BOS,,,26,25,21,6
22023,204001,22300136,"NOV 04, 2023",BOS @ BKN,W,30,8,10,0.8,1,2,0.5,5,8,0.625,2,5,7,1,0,3,1,2,22,4,1,Kristaps Porzingis,BOS,BKN,BOS,,,30,29,23,8
22023,204001,22300118,"NOV 01, 2023",BOS vs. IND,W,27,3,7,0.429,1,3,0.333,6,6,1.0,1,5,6,2,0,0,2,3,13,27,1,Kristaps Porzingis,BOS,BOS,IND,,,21,19,15,8
22023,204001,22300103,"OCT 30, 2023",BOS @ WAS,W,24,7,9,0.778,1,2,0.5,0,0,0.0,0,6,6,3,0,1,2,2,15,30,1,Kristaps Porzingis,BOS,WAS,BOS,,,24,21,18,9
22023,204001,22300080,"OCT 27, 2023",BOS vs. MIA,W,30,6,12,0.5,2,6,0.333,3,4,0.75,3,6,9,1,3,1,1,6,17,-12,1,Kristaps Porzingis,BOS,BOS,MIA,,,27,26,18,10
22023,204001,22300065,"OCT 25, 2023",BOS @ NYK,W,38,8,15,0.533,5,9,0.556,9,10,0.9,1,7,8,0,0,4,1,4,30,13,1,Kristaps Porzingis,BOS,NYK,BOS,,,38,38,30,8
22023,1630695,22300342,"DEC 16, 2023",UTA @ SAC,L,4,0,1,0.0,0,1,0.0,0,0,0.0,0,4,4,0,0,0,0,0,0,-1,1,Micah Potter,UTA,SAC,UTA,,,4,4,0,4
22023,1630695,22300323,"DEC 14, 2023",UTA @ POR,W,3,0,0,0.0,0,0,0.0,0,0,0.0,0,0,0,0,0,0,0,0,0,-12,1,Micah Potter,UTA,POR,UTA,,,0,0,0,0
22023,203939,22300556,"JAN 15, 2024",DAL vs. NOP,W,16,2,2,1.0,0,0,0.0,0,0,0.0,3,1,4,2,0,2,0,5,4,6,1,Dwight Powell,DAL,DAL,NOP,,,10,8,6,6
22023,203939,22300547,"JAN 13, 2024",DAL vs. NOP,L,34,0,1,0.0,0,0,0.0,2,2,1.0,5,4,9,8,3,0,1,5,2,6,1,Dwight Powell,DAL,DAL,NOP,,,19,11,10,17
22023,203939,22300530,"JAN 11, 2024",DAL vs. NYK,W,28,2,3,0.667,0,0,0.0,0,0,0.0,5,4,9,2,1,0,0,5,4,2,1,Dwight Powell,DAL,DAL,NYK,,,15,13,6,11
22023,203939,22300515,"JAN 09, 2024",DAL vs. MEM,L,22,2,3,0.667,0,0,0.0,0,0,0.0,1,3,4,3,2,1,2,3,4,9,1,Dwight Powell,DAL,DAL,MEM,,,11,8,7,7
22023,203939,22300501,"JAN 07, 2024",DAL vs. MIN,W,28,3,5,0.6,0,0,0.0,3,5,0.6,5,1,6,4,1,0,0,4,9,14,1,Dwight Powell,DAL,DAL,MIN,,,19,15,13,10
22023,203939,22300487,"JAN 05, 2024",DAL vs. POR,W,26,2,4,0.5,0,0,0.0,2,4,0.5,2,7,9,3,1,1,2,0,6,32,1,Dwight Powell,DAL,DAL,POR,,,18,15,9,12
22023,203939,22300472,"JAN 03, 2024",DAL vs. POR,W,13,1,1,1.0,0,0,0.0,3,6,0.5,1,2,3,2,0,0,1,2,5,6,1,Dwight Powell,DAL,DAL,POR,,,10,8,7,5
22023,203939,22300457,"JAN 01, 2024",DAL @ UTA,L,10,2,3,0.667,0,0,0.0,0,0,0.0,2,2,4,1,2,0,0,1,4,-13,1,Dwight Powell,DAL,UTA,DAL,,,9,8,5,5
22023,203939,22300444,"DEC 30, 2023",DAL @ GSW,W,13,1,2,0.5,0,0,0.0,0,0,0.0,2,0,2,1,0,0,0,2,2,-2,1,Dwight Powell,DAL,GSW,DAL,,,5,4,3,3
22023,203939,22300423,"DEC 28, 2023",DAL @ MIN,L,30,6,8,0.75,0,0,0.0,0,0,0.0,7,7,14,6,2,1,1,3,12,15,1,Dwight Powell,DAL,MIN,DAL,,,32,26,18,20
22023,203939,22300420,"DEC 27, 2023",DAL vs. CLE,L,5,1,1,1.0,0,0,0.0,1,1,1.0,0,0,0,0,0,0,1,1,3,5,1,Dwight Powell,DAL,DAL,CLE,,,3,3,3,0
22023,203939,22300405,"DEC 25, 2023",DAL @ PHX,W,7,2,2,1.0,0,0,0.0,0,0,0.0,0,1,1,2,0,0,0,1,4,-6,1,Dwight Powell,DAL,PHX,DAL,,,7,5,6,3
22023,203939,22300398,"DEC 23, 2023",DAL vs. SAS,W,22,5,5,1.0,0,0,0.0,4,4,1.0,2,2,4,1,1,1,0,4,14,30,1,Dwight Powell,DAL,DAL,SAS,,,19,18,15,5
22023,203939,22300385,"DEC 22, 2023",DAL @ HOU,L,8,0,1,0.0,0,1,0.0,0,0,0.0,0,4,4,0,0,0,0,1,0,-1,1,Dwight Powell,DAL,HOU,DAL,,,4,4,0,4
22023,203939,22300372,"DEC 20, 2023",DAL vs. LAC,L,18,1,1,1.0,0,0,0.0,1,2,0.5,1,0,1,1,0,0,0,2,3,-17,1,Dwight Powell,DAL,DAL,LAC,,,5,4,4,2
22023,203939,22300356,"DEC 18, 2023",DAL @ DEN,L,23,4,6,0.667,0,0,0.0,0,0,0.0,6,2,8,0,0,0,1,4,8,-17,1,Dwight Powell,DAL,DEN,DAL,,,16,16,8,8
22023,203939,22300341,"DEC 16, 2023",DAL @ POR,W,22,2,3,0.667,0,0,0.0,2,3,0.667,4,1,5,0,0,1,0,2,6,7,1,Dwight Powell,DAL,POR,DAL,,,11,11,6,5
22023,203939,22300321,"DEC 14, 2023",DAL vs. MIN,L,7,0,0,0.0,0,0,0.0,4,4,1.0,0,4,4,0,0,0,0,1,4,4,1,Dwight Powell,DAL,DAL,MIN,,,8,8,4,4
22023,203939,22300299,"DEC 11, 2023",DAL @ MEM,W,12,1,2,0.5,0,0,0.0,0,0,0.0,1,1,2,2,0,0,1,3,2,4,1,Dwight Powell,DAL,MEM,DAL,,,6,4,4,4
22023,203939,22301226,"DEC 08, 2023",DAL @ POR,W,12,1,2,0.5,0,0,0.0,2,2,1.0,1,1,2,3,3,0,1,5,4,6,1,Dwight Powell,DAL,POR,DAL,,,9,6,7,5
22023,203939,22301213,"DEC 06, 2023",DAL vs. UTA,W,18,2,2,1.0,0,0,0.0,0,0,0.0,1,3,4,3,1,0,0,1,4,20,1,Dwight Powell,DAL,DAL,UTA,,,11,8,7,7
22023,203939,22300287,"DEC 02, 2023",DAL vs. OKC,L,4,0,0,0.0,0,0,0.0,2,2,1.0,0,0,0,0,0,0,1,1,2,-9,1,Dwight Powell,DAL,DAL,OKC,,,2,2,2,0
22023,203939,22300059,"NOV 28, 2023",DAL vs. HOU,W,3,0,0,0.0,0,0,0.0,0,0,0.0,0,0,0,0,0,0,0,0,0,-1,1,Dwight Powell,DAL,DAL,HOU,,,0,0,0,0
22023,203939,22300244,"NOV 25, 2023",DAL @ LAC,L,15,0,0,0.0,0,0,0.0,2,2,1.0,0,2,2,3,0,0,0,2,2,-17,1,Dwight Powell,DAL,LAC,DAL,,,7,4,5,5
22023,203939,22300238,"NOV 22, 2023",DAL @ LAL,W,5,0,0,0.0,0,0,0.0,0,0,0.0,0,0,0,1,0,0,1,2,0,-3,1,Dwight Powell,DAL,LAL,DAL,,,1,0,1,1
22023,203939,22300212,"NOV 19, 2023",DAL vs. SAC,L,13,0,0,0.0,0,0,0.0,0,0,0.0,0,1,1,1,1,0,2,1,0,-5,1,Dwight Powell,DAL,DAL,SAC,,,2,1,1,2
22023,203939,22300205,"NOV 18, 2023",DAL @ MIL,L,24,1,2,0.5,0,0,0.0,1,1,1.0,0,3,3,1,0,0,0,3,3,-6,1,Dwight Powell,DAL,MIL,DAL,,,7,6,4,4
22023,203939,22300192,"NOV 15, 2023",DAL @ WAS,W,7,1,1,1.0,0,0,0.0,0,0,0.0,0,1,1,2,0,0,0,1,2,2,1,Dwight Powell,DAL,WAS,DAL,,,5,3,4,3
22023,203939,22300022,"NOV 14, 2023",DAL @ NOP,L,11,2,4,0.5,0,0,0.0,0,0,0.0,3,4,7,1,0,1,1,1,4,-16,1,Dwight Powell,DAL,NOP,DAL,,,12,11,5,8
22023,203939,22300183,"NOV 12, 2023",DAL @ NOP,W,18,3,4,0.75,0,0,0.0,1,2,0.5,3,7,10,2,1,0,0,4,7,7,1,Dwight Powell,DAL,NOP,DAL,,,19,17,9,12
22023,203939,22300014,"NOV 10, 2023",DAL vs. LAC,W,22,2,3,0.667,0,0,0.0,5,5,1.0,4,1,5,4,1,0,1,3,9,3,1,Dwight Powell,DAL,DAL,LAC,,,18,14,13,9
22023,203939,22300168,"NOV 08, 2023",DAL vs. TOR,L,24,1,1,1.0,0,0,0.0,3,5,0.6,0,6,6,0,0,1,0,2,5,-10,1,Dwight Powell,DAL,DAL,TOR,,,11,11,5,6
22023,203939,22300147,"NOV 06, 2023",DAL @ ORL,W,28,2,2,1.0,0,0,0.0,3,5,0.6,0,2,2,2,1,2,0,3,7,14,1,Dwight Powell,DAL,ORL,DAL,,,11,9,9,4
22023,203939,22300143,"NOV 05, 2023",DAL vs. CHA,W,15,3,3,1.0,0,0,0.0,4,6,0.667,5,0,5,3,0,0,0,2,10,2,1,Dwight Powell,DAL,DAL,CHA,,,18,15,13,8
22023,203939,22300006,"NOV 03, 2023",DAL @ DEN,L,17,2,5,0.4,0,0,0.0,2,2,1.0,1,0,1,1,0,0,0,2,6,-2,1,Dwight Powell,DAL,DEN,DAL,,,8,7,7,2
22023,203939,22300124,"NOV 01, 2023",DAL vs. CHI,W,10,0,0,0.0,0,0,0.0,5,6,0.833,1,0,1,1,0,0,0,1,5,-5,1,Dwight Powell,DAL,DAL,CHI,,,7,6,6,2
22023,203939,22300106,"OCT 30, 2023",DAL @ MEM,W,12,0,0,0.0,0,0,0.0,0,0,0.0,2,3,5,0,0,4,1,1,0,10,1,Dwight Powell,DAL,MEM,DAL,,,5,5,0,5
22023,203939,22300084,"OCT 27, 2023",DAL vs. BKN,W,13,4,4,1.0,1,1,1.0,2,2,1.0,2,0,2,0,1,0,0,0,11,-6,1,Dwight Powell,DAL,DAL,BKN,,,13,13,11,2
22023,1626181,22300553,"JAN 14, 2024",LAC @ MIN,L,30,9,12,0.75,6,9,0.667,0,0,0.0,0,1,1,0,0,2,1,1,24,11,1,Norman Powell,LAC,MIN,LAC,14.0,Points,25,25,24,1
22023,1626181,22300553,"JAN 14, 2024",LAC @ MIN,L,30,9,12,0.75,6,9,0.667,0,0,0.0,0,1,1,0,0,2,1,1,24,11,1,Norman Powell,LAC,MIN,LAC,18.5,Pts+Rebs+Asts,25,25,24,1
22023,1626181,22300553,"JAN 14, 2024",LAC @ MIN,L,30,9,12,0.75,6,9,0.667,0,0,0.0,0,1,1,0,0,2,1,1,24,11,1,Norman Powell,LAC,MIN,LAC,17.0,Pts+Rebs,25,25,24,1
22023,1626181,22300553,"JAN 14, 2024",LAC @ MIN,L,30,9,12,0.75,6,9,0.667,0,0,0.0,0,1,1,0,0,2,1,1,24,11,1,Norman Powell,LAC,MIN,LAC,15.0,Pts+Asts,25,25,24,1
22023,1626181,22300537,"JAN 12, 2024",LAC @ MEM,W,24,5,8,0.625,0,2,0.0,1,1,1.0,0,5,5,0,0,0,1,2,11,11,1,Norman Powell,LAC,MEM,LAC,14.0,Points,16,16,11,5
22023,1626181,22300537,"JAN 12, 2024",LAC @ MEM,W,24,5,8,0.625,0,2,0.0,1,1,1.0,0,5,5,0,0,0,1,2,11,11,1,Norman Powell,LAC,MEM,LAC,18.5,Pts+Rebs+Asts,16,16,11,5
22023,1626181,22300537,"JAN 12, 2024",LAC @ MEM,W,24,5,8,0.625,0,2,0.0,1,1,1.0,0,5,5,0,0,0,1,2,11,11,1,Norman Powell,LAC,MEM,LAC,17.0,Pts+Rebs,16,16,11,5
22023,1626181,22300537,"JAN 12, 2024",LAC @ MEM,W,24,5,8,0.625,0,2,0.0,1,1,1.0,0,5,5,0,0,0,1,2,11,11,1,Norman Powell,LAC,MEM,LAC,15.0,Pts+Asts,16,16,11,5
22023,1626181,22300526,"JAN 10, 2024",LAC vs. TOR,W,27,4,11,0.364,3,8,0.375,2,2,1.0,0,3,3,1,0,0,0,1,13,2,1,Norman Powell,LAC,LAC,TOR,14.0,Points,17,16,14,4
22023,1626181,22300526,"JAN 10, 2024",LAC vs. TOR,W,27,4,11,0.364,3,8,0.375,2,2,1.0,0,3,3,1,0,0,0,1,13,2,1,Norman Powell,LAC,LAC,TOR,18.5,Pts+Rebs+Asts,17,16,14,4
22023,1626181,22300526,"JAN 10, 2024",LAC vs. TOR,W,27,4,11,0.364,3,8,0.375,2,2,1.0,0,3,3,1,0,0,0,1,13,2,1,Norman Powell,LAC,LAC,TOR,17.0,Pts+Rebs,17,16,14,4
22023,1626181,22300526,"JAN 10, 2024",LAC vs. TOR,W,27,4,11,0.364,3,8,0.375,2,2,1.0,0,3,3,1,0,0,0,1,13,2,1,Norman Powell,LAC,LAC,TOR,15.0,Pts+Asts,17,16,14,4
22023,1626181,22300511,"JAN 08, 2024",LAC vs. PHX,W,25,4,6,0.667,2,3,0.667,4,4,1.0,1,4,5,1,0,0,1,1,14,20,1,Norman Powell,LAC,LAC,PHX,14.0,Points,20,19,15,6
22023,1626181,22300511,"JAN 08, 2024",LAC vs. PHX,W,25,4,6,0.667,2,3,0.667,4,4,1.0,1,4,5,1,0,0,1,1,14,20,1,Norman Powell,LAC,LAC,PHX,18.5,Pts+Rebs+Asts,20,19,15,6
22023,1626181,22300511,"JAN 08, 2024",LAC vs. PHX,W,25,4,6,0.667,2,3,0.667,4,4,1.0,1,4,5,1,0,0,1,1,14,20,1,Norman Powell,LAC,LAC,PHX,17.0,Pts+Rebs,20,19,15,6
22023,1626181,22300511,"JAN 08, 2024",LAC vs. PHX,W,25,4,6,0.667,2,3,0.667,4,4,1.0,1,4,5,1,0,0,1,1,14,20,1,Norman Powell,LAC,LAC,PHX,15.0,Pts+Asts,20,19,15,6
22023,1626181,22300505,"JAN 07, 2024",LAC @ LAL,L,25,3,12,0.25,2,5,0.4,6,6,1.0,0,0,0,0,2,0,0,1,14,-1,1,Norman Powell,LAC,LAL,LAC,14.0,Points,14,14,14,0
22023,1626181,22300505,"JAN 07, 2024",LAC @ LAL,L,25,3,12,0.25,2,5,0.4,6,6,1.0,0,0,0,0,2,0,0,1,14,-1,1,Norman Powell,LAC,LAL,LAC,18.5,Pts+Rebs+Asts,14,14,14,0
22023,1626181,22300505,"JAN 07, 2024",LAC @ LAL,L,25,3,12,0.25,2,5,0.4,6,6,1.0,0,0,0,0,2,0,0,1,14,-1,1,Norman Powell,LAC,LAL,LAC,17.0,Pts+Rebs,14,14,14,0
22023,1626181,22300505,"JAN 07, 2024",LAC @ LAL,L,25,3,12,0.25,2,5,0.4,6,6,1.0,0,0,0,0,2,0,0,1,14,-1,1,Norman Powell,LAC,LAL,LAC,15.0,Pts+Asts,14,14,14,0
22023,1626181,22300486,"JAN 05, 2024",LAC @ NOP,W,25,5,13,0.385,3,6,0.5,0,0,0.0,0,3,3,2,1,0,0,1,13,36,1,Norman Powell,LAC,NOP,LAC,14.0,Points,18,16,15,5
22023,1626181,22300486,"JAN 05, 2024",LAC @ NOP,W,25,5,13,0.385,3,6,0.5,0,0,0.0,0,3,3,2,1,0,0,1,13,36,1,Norman Powell,LAC,NOP,LAC,18.5,Pts+Rebs+Asts,18,16,15,5
22023,1626181,22300486,"JAN 05, 2024",LAC @ NOP,W,25,5,13,0.385,3,6,0.5,0,0,0.0,0,3,3,2,1,0,0,1,13,36,1,Norman Powell,LAC,NOP,LAC,17.0,Pts+Rebs,18,16,15,5
22023,1626181,22300486,"JAN 05, 2024",LAC @ NOP,W,25,5,13,0.385,3,6,0.5,0,0,0.0,0,3,3,2,1,0,0,1,13,36,1,Norman Powell,LAC,NOP,LAC,15.0,Pts+Asts,18,16,15,5
22023,1626181,22300473,"JAN 03, 2024",LAC @ PHX,W,26,5,8,0.625,3,5,0.6,0,0,0.0,0,2,2,1,0,0,3,1,13,-7,1,Norman Powell,LAC,PHX,LAC,14.0,Points,16,15,14,3
22023,1626181,22300473,"JAN 03, 2024",LAC @ PHX,W,26,5,8,0.625,3,5,0.6,0,0,0.0,0,2,2,1,0,0,3,1,13,-7,1,Norman Powell,LAC,PHX,LAC,18.5,Pts+Rebs+Asts,16,15,14,3
22023,1626181,22300473,"JAN 03, 2024",LAC @ PHX,W,26,5,8,0.625,3,5,0.6,0,0,0.0,0,2,2,1,0,0,3,1,13,-7,1,Norman Powell,LAC,PHX,LAC,17.0,Pts+Rebs,16,15,14,3
22023,1626181,22300473,"JAN 03, 2024",LAC @ PHX,W,26,5,8,0.625,3,5,0.6,0,0,0.0,0,2,2,1,0,0,3,1,13,-7,1,Norman Powell,LAC,PHX,LAC,15.0,Pts+Asts,16,15,14,3
22023,1626181,22300458,"JAN 01, 2024",LAC vs. MIA,W,33,9,11,0.818,4,5,0.8,0,0,0.0,0,2,2,2,2,0,1,4,22,13,1,Norman Powell,LAC,LAC,MIA,14.0,Points,26,24,24,4
22023,1626181,22300458,"JAN 01, 2024",LAC vs. MIA,W,33,9,11,0.818,4,5,0.8,0,0,0.0,0,2,2,2,2,0,1,4,22,13,1,Norman Powell,LAC,LAC,MIA,18.5,Pts+Rebs+Asts,26,24,24,4
22023,1626181,22300458,"JAN 01, 2024",LAC vs. MIA,W,33,9,11,0.818,4,5,0.8,0,0,0.0,0,2,2,2,2,0,1,4,22,13,1,Norman Powell,LAC,LAC,MIA,17.0,Pts+Rebs,26,24,24,4
22023,1626181,22300458,"JAN 01, 2024",LAC vs. MIA,W,33,9,11,0.818,4,5,0.8,0,0,0.0,0,2,2,2,2,0,1,4,22,13,1,Norman Powell,LAC,LAC,MIA,15.0,Pts+Asts,26,24,24,4
22023,1626181,22300438,"DEC 29, 2023",LAC vs. MEM,W,25,5,12,0.417,1,4,0.25,2,2,1.0,0,6,6,1,0,0,1,2,13,-7,1,Norman Powell,LAC,LAC,MEM,14.0,Points,20,19,14,7
22023,1626181,22300438,"DEC 29, 2023",LAC vs. MEM,W,25,5,12,0.417,1,4,0.25,2,2,1.0,0,6,6,1,0,0,1,2,13,-7,1,Norman Powell,LAC,LAC,MEM,18.5,Pts+Rebs+Asts,20,19,14,7
22023,1626181,22300438,"DEC 29, 2023",LAC vs. MEM,W,25,5,12,0.417,1,4,0.25,2,2,1.0,0,6,6,1,0,0,1,2,13,-7,1,Norman Powell,LAC,LAC,MEM,17.0,Pts+Rebs,20,19,14,7
22023,1626181,22300438,"DEC 29, 2023",LAC vs. MEM,W,25,5,12,0.417,1,4,0.25,2,2,1.0,0,6,6,1,0,0,1,2,13,-7,1,Norman Powell,LAC,LAC,MEM,15.0,Pts+Asts,20,19,14,7
22023,1626181,22300414,"DEC 26, 2023",LAC vs. CHA,W,28,2,7,0.286,1,5,0.2,2,2,1.0,0,3,3,0,0,0,0,1,7,5,1,Norman Powell,LAC,LAC,CHA,14.0,Points,10,10,7,3
22023,1626181,22300414,"DEC 26, 2023",LAC vs. CHA,W,28,2,7,0.286,1,5,0.2,2,2,1.0,0,3,3,0,0,0,0,1,7,5,1,Norman Powell,LAC,LAC,CHA,18.5,Pts+Rebs+Asts,10,10,7,3
22023,1626181,22300414,"DEC 26, 2023",LAC vs. CHA,W,28,2,7,0.286,1,5,0.2,2,2,1.0,0,3,3,0,0,0,0,1,7,5,1,Norman Powell,LAC,LAC,CHA,17.0,Pts+Rebs,10,10,7,3
22023,1626181,22300414,"DEC 26, 2023",LAC vs. CHA,W,28,2,7,0.286,1,5,0.2,2,2,1.0,0,3,3,0,0,0,0,1,7,5,1,Norman Powell,LAC,LAC,CHA,15.0,Pts+Asts,10,10,7,3
22023,1626181,22300389,"DEC 23, 2023",LAC vs. BOS,L,25,3,9,0.333,1,3,0.333,0,0,0.0,0,0,0,0,0,0,1,5,7,-10,1,Norman Powell,LAC,LAC,BOS,14.0,Points,7,7,7,0
22023,1626181,22300389,"DEC 23, 2023",LAC vs. BOS,L,25,3,9,0.333,1,3,0.333,0,0,0.0,0,0,0,0,0,0,1,5,7,-10,1,Norman Powell,LAC,LAC,BOS,18.5,Pts+Rebs+Asts,7,7,7,0
22023,1626181,22300389,"DEC 23, 2023",LAC vs. BOS,L,25,3,9,0.333,1,3,0.333,0,0,0.0,0,0,0,0,0,0,1,5,7,-10,1,Norman Powell,LAC,LAC,BOS,17.0,Pts+Rebs,7,7,7,0
22023,1626181,22300389,"DEC 23, 2023",LAC vs. BOS,L,25,3,9,0.333,1,3,0.333,0,0,0.0,0,0,0,0,0,0,1,5,7,-10,1,Norman Powell,LAC,LAC,BOS,15.0,Pts+Asts,7,7,7,0
22023,1626181,22300379,"DEC 21, 2023",LAC @ OKC,L,23,6,11,0.545,4,8,0.5,0,0,0.0,1,3,4,1,0,1,1,0,16,-2,1,Norman Powell,LAC,OKC,LAC,14.0,Points,21,20,17,5
22023,1626181,22300379,"DEC 21, 2023",LAC @ OKC,L,23,6,11,0.545,4,8,0.5,0,0,0.0,1,3,4,1,0,1,1,0,16,-2,1,Norman Powell,LAC,OKC,LAC,18.5,Pts+Rebs+Asts,21,20,17,5
22023,1626181,22300379,"DEC 21, 2023",LAC @ OKC,L,23,6,11,0.545,4,8,0.5,0,0,0.0,1,3,4,1,0,1,1,0,16,-2,1,Norman Powell,LAC,OKC,LAC,17.0,Pts+Rebs,21,20,17,5
22023,1626181,22300379,"DEC 21, 2023",LAC @ OKC,L,23,6,11,0.545,4,8,0.5,0,0,0.0,1,3,4,1,0,1,1,0,16,-2,1,Norman Powell,LAC,OKC,LAC,15.0,Pts+Asts,21,20,17,5
22023,1626181,22300372,"DEC 20, 2023",LAC @ DAL,W,31,7,10,0.7,3,6,0.5,4,4,1.0,0,3,3,2,1,0,1,2,21,16,1,Norman Powell,LAC,DAL,LAC,14.0,Points,26,24,23,5
22023,1626181,22300372,"DEC 20, 2023",LAC @ DAL,W,31,7,10,0.7,3,6,0.5,4,4,1.0,0,3,3,2,1,0,1,2,21,16,1,Norman Powell,LAC,DAL,LAC,18.5,Pts+Rebs+Asts,26,24,23,5
22023,1626181,22300372,"DEC 20, 2023",LAC @ DAL,W,31,7,10,0.7,3,6,0.5,4,4,1.0,0,3,3,2,1,0,1,2,21,16,1,Norman Powell,LAC,DAL,LAC,17.0,Pts+Rebs,26,24,23,5
22023,1626181,22300372,"DEC 20, 2023",LAC @ DAL,W,31,7,10,0.7,3,6,0.5,4,4,1.0,0,3,3,2,1,0,1,2,21,16,1,Norman Powell,LAC,DAL,LAC,15.0,Pts+Asts,26,24,23,5
22023,1626181,22300350,"DEC 18, 2023",LAC @ IND,W,30,6,11,0.545,4,6,0.667,3,3,1.0,0,3,3,0,0,0,0,1,19,23,1,Norman Powell,LAC,IND,LAC,14.0,Points,22,22,19,3
22023,1626181,22300350,"DEC 18, 2023",LAC @ IND,W,30,6,11,0.545,4,6,0.667,3,3,1.0,0,3,3,0,0,0,0,1,19,23,1,Norman Powell,LAC,IND,LAC,18.5,Pts+Rebs+Asts,22,22,19,3
22023,1626181,22300350,"DEC 18, 2023",LAC @ IND,W,30,6,11,0.545,4,6,0.667,3,3,1.0,0,3,3,0,0,0,0,1,19,23,1,Norman Powell,LAC,IND,LAC,17.0,Pts+Rebs,22,22,19,3
22023,1626181,22300350,"DEC 18, 2023",LAC @ IND,W,30,6,11,0.545,4,6,0.667,3,3,1.0,0,3,3,0,0,0,0,1,19,23,1,Norman Powell,LAC,IND,LAC,15.0,Pts+Asts,22,22,19,3
22023,1626181,22300343,"DEC 16, 2023",LAC vs. NYK,W,24,6,10,0.6,1,2,0.5,3,3,1.0,0,2,2,0,0,1,1,1,16,9,1,Norman Powell,LAC,LAC,NYK,14.0,Points,18,18,16,2
22023,1626181,22300343,"DEC 16, 2023",LAC vs. NYK,W,24,6,10,0.6,1,2,0.5,3,3,1.0,0,2,2,0,0,1,1,1,16,9,1,Norman Powell,LAC,LAC,NYK,18.5,Pts+Rebs+Asts,18,18,16,2
22023,1626181,22300343,"DEC 16, 2023",LAC vs. NYK,W,24,6,10,0.6,1,2,0.5,3,3,1.0,0,2,2,0,0,1,1,1,16,9,1,Norman Powell,LAC,LAC,NYK,17.0,Pts+Rebs,18,18,16,2
22023,1626181,22300343,"DEC 16, 2023",LAC vs. NYK,W,24,6,10,0.6,1,2,0.5,3,3,1.0,0,2,2,0,0,1,1,1,16,9,1,Norman Powell,LAC,LAC,NYK,15.0,Pts+Asts,18,18,16,2
22023,1626181,22300325,"DEC 14, 2023",LAC vs. GSW,W,36,9,13,0.692,1,4,0.25,2,2,1.0,0,5,5,2,1,0,1,3,21,20,1,Norman Powell,LAC,LAC,GSW,14.0,Points,28,26,23,7
22023,1626181,22300325,"DEC 14, 2023",LAC vs. GSW,W,36,9,13,0.692,1,4,0.25,2,2,1.0,0,5,5,2,1,0,1,3,21,20,1,Norman Powell,LAC,LAC,GSW,18.5,Pts+Rebs+Asts,28,26,23,7
22023,1626181,22300325,"DEC 14, 2023",LAC vs. GSW,W,36,9,13,0.692,1,4,0.25,2,2,1.0,0,5,5,2,1,0,1,3,21,20,1,Norman Powell,LAC,LAC,GSW,17.0,Pts+Rebs,28,26,23,7
22023,1626181,22300325,"DEC 14, 2023",LAC vs. GSW,W,36,9,13,0.692,1,4,0.25,2,2,1.0,0,5,5,2,1,0,1,3,21,20,1,Norman Powell,LAC,LAC,GSW,15.0,Pts+Asts,28,26,23,7
22023,1626181,22300309,"DEC 12, 2023",LAC vs. SAC,W,27,5,11,0.455,2,4,0.5,3,3,1.0,0,1,1,2,0,0,1,1,15,26,1,Norman Powell,LAC,LAC,SAC,14.0,Points,18,16,17,3
22023,1626181,22300309,"DEC 12, 2023",LAC vs. SAC,W,27,5,11,0.455,2,4,0.5,3,3,1.0,0,1,1,2,0,0,1,1,15,26,1,Norman Powell,LAC,LAC,SAC,18.5,Pts+Rebs+Asts,18,16,17,3
22023,1626181,22300309,"DEC 12, 2023",LAC vs. SAC,W,27,5,11,0.455,2,4,0.5,3,3,1.0,0,1,1,2,0,0,1,1,15,26,1,Norman Powell,LAC,LAC,SAC,17.0,Pts+Rebs,18,16,17,3
22023,1626181,22300309,"DEC 12, 2023",LAC vs. SAC,W,27,5,11,0.455,2,4,0.5,3,3,1.0,0,1,1,2,0,0,1,1,15,26,1,Norman Powell,LAC,LAC,SAC,15.0,Pts+Asts,18,16,17,3
22023,1626181,22300304,"DEC 11, 2023",LAC vs. POR,W,25,6,9,0.667,2,4,0.5,2,2,1.0,0,3,3,1,1,2,0,4,16,3,1,Norman Powell,LAC,LAC,POR,14.0,Points,20,19,17,4
22023,1626181,22300304,"DEC 11, 2023",LAC vs. POR,W,25,6,9,0.667,2,4,0.5,2,2,1.0,0,3,3,1,1,2,0,4,16,3,1,Norman Powell,LAC,LAC,POR,18.5,Pts+Rebs+Asts,20,19,17,4
22023,1626181,22300304,"DEC 11, 2023",LAC vs. POR,W,25,6,9,0.667,2,4,0.5,2,2,1.0,0,3,3,1,1,2,0,4,16,3,1,Norman Powell,LAC,LAC,POR,17.0,Pts+Rebs,20,19,17,4
22023,1626181,22300304,"DEC 11, 2023",LAC vs. POR,W,25,6,9,0.667,2,4,0.5,2,2,1.0,0,3,3,1,1,2,0,4,16,3,1,Norman Powell,LAC,LAC,POR,15.0,Pts+Asts,20,19,17,4
22023,1626181,22301225,"DEC 08, 2023",LAC @ UTA,W,28,4,11,0.364,2,8,0.25,0,0,0.0,0,1,1,1,0,0,1,0,10,2,1,Norman Powell,LAC,UTA,LAC,14.0,Points,12,11,11,2
22023,1626181,22301225,"DEC 08, 2023",LAC @ UTA,W,28,4,11,0.364,2,8,0.25,0,0,0.0,0,1,1,1,0,0,1,0,10,2,1,Norman Powell,LAC,UTA,LAC,18.5,Pts+Rebs+Asts,12,11,11,2
22023,1626181,22301225,"DEC 08, 2023",LAC @ UTA,W,28,4,11,0.364,2,8,0.25,0,0,0.0,0,1,1,1,0,0,1,0,10,2,1,Norman Powell,LAC,UTA,LAC,17.0,Pts+Rebs,12,11,11,2
22023,1626181,22301225,"DEC 08, 2023",LAC @ UTA,W,28,4,11,0.364,2,8,0.25,0,0,0.0,0,1,1,1,0,0,1,0,10,2,1,Norman Powell,LAC,UTA,LAC,15.0,Pts+Asts,12,11,11,2
22023,1626181,22301215,"DEC 06, 2023",LAC vs. DEN,W,32,5,12,0.417,1,3,0.333,6,6,1.0,0,5,5,2,1,0,1,0,17,24,1,Norman Powell,LAC,LAC,DEN,14.0,Points,24,22,19,7
22023,1626181,22301215,"DEC 06, 2023",LAC vs. DEN,W,32,5,12,0.417,1,3,0.333,6,6,1.0,0,5,5,2,1,0,1,0,17,24,1,Norman Powell,LAC,LAC,DEN,18.5,Pts+Rebs+Asts,24,22,19,7
22023,1626181,22301215,"DEC 06, 2023",LAC vs. DEN,W,32,5,12,0.417,1,3,0.333,6,6,1.0,0,5,5,2,1,0,1,0,17,24,1,Norman Powell,LAC,LAC,DEN,17.0,Pts+Rebs,24,22,19,7
22023,1626181,22301215,"DEC 06, 2023",LAC vs. DEN,W,32,5,12,0.417,1,3,0.333,6,6,1.0,0,5,5,2,1,0,1,0,17,24,1,Norman Powell,LAC,LAC,DEN,15.0,Pts+Asts,24,22,19,7
22023,1626181,22300280,"DEC 02, 2023",LAC vs. GSW,W,30,5,12,0.417,2,5,0.4,0,0,0.0,1,0,1,0,0,0,2,1,12,14,1,Norman Powell,LAC,LAC,GSW,14.0,Points,13,13,12,1
22023,1626181,22300280,"DEC 02, 2023",LAC vs. GSW,W,30,5,12,0.417,2,5,0.4,0,0,0.0,1,0,1,0,0,0,2,1,12,14,1,Norman Powell,LAC,LAC,GSW,18.5,Pts+Rebs+Asts,13,13,12,1
22023,1626181,22300280,"DEC 02, 2023",LAC vs. GSW,W,30,5,12,0.417,2,5,0.4,0,0,0.0,1,0,1,0,0,0,2,1,12,14,1,Norman Powell,LAC,LAC,GSW,17.0,Pts+Rebs,13,13,12,1
22023,1626181,22300280,"DEC 02, 2023",LAC vs. GSW,W,30,5,12,0.417,2,5,0.4,0,0,0.0,1,0,1,0,0,0,2,1,12,14,1,Norman Powell,LAC,LAC,GSW,15.0,Pts+Asts,13,13,12,1
22023,1626181,22300273,"NOV 30, 2023",LAC @ GSW,L,18,1,2,0.5,0,0,0.0,3,3,1.0,0,0,0,0,1,0,2,1,5,-13,1,Norman Powell,LAC,GSW,LAC,14.0,Points,5,5,5,0
22023,1626181,22300273,"NOV 30, 2023",LAC @ GSW,L,18,1,2,0.5,0,0,0.0,3,3,1.0,0,0,0,0,1,0,2,1,5,-13,1,Norman Powell,LAC,GSW,LAC,18.5,Pts+Rebs+Asts,5,5,5,0
22023,1626181,22300273,"NOV 30, 2023",LAC @ GSW,L,18,1,2,0.5,0,0,0.0,3,3,1.0,0,0,0,0,1,0,2,1,5,-13,1,Norman Powell,LAC,GSW,LAC,17.0,Pts+Rebs,5,5,5,0
22023,1626181,22300273,"NOV 30, 2023",LAC @ GSW,L,18,1,2,0.5,0,0,0.0,3,3,1.0,0,0,0,0,1,0,2,1,5,-13,1,Norman Powell,LAC,GSW,LAC,15.0,Pts+Asts,5,5,5,0
22023,1626181,22300264,"NOV 29, 2023",LAC @ SAC,W,13,1,6,0.167,1,2,0.5,0,0,0.0,0,1,1,0,0,0,0,1,3,0,1,Norman Powell,LAC,SAC,LAC,14.0,Points,4,4,3,1
22023,1626181,22300264,"NOV 29, 2023",LAC @ SAC,W,13,1,6,0.167,1,2,0.5,0,0,0.0,0,1,1,0,0,0,0,1,3,0,1,Norman Powell,LAC,SAC,LAC,18.5,Pts+Rebs+Asts,4,4,3,1
22023,1626181,22300264,"NOV 29, 2023",LAC @ SAC,W,13,1,6,0.167,1,2,0.5,0,0,0.0,0,1,1,0,0,0,0,1,3,0,1,Norman Powell,LAC,SAC,LAC,17.0,Pts+Rebs,4,4,3,1
22023,1626181,22300264,"NOV 29, 2023",LAC @ SAC,W,13,1,6,0.167,1,2,0.5,0,0,0.0,0,1,1,0,0,0,0,1,3,0,1,Norman Powell,LAC,SAC,LAC,15.0,Pts+Asts,4,4,3,1
22023,1626181,22300257,"NOV 27, 2023",LAC vs. DEN,L,21,2,8,0.25,1,5,0.2,5,5,1.0,1,1,2,1,1,1,0,3,10,-10,1,Norman Powell,LAC,LAC,DEN,14.0,Points,13,12,11,3
22023,1626181,22300257,"NOV 27, 2023",LAC vs. DEN,L,21,2,8,0.25,1,5,0.2,5,5,1.0,1,1,2,1,1,1,0,3,10,-10,1,Norman Powell,LAC,LAC,DEN,18.5,Pts+Rebs+Asts,13,12,11,3
22023,1626181,22300257,"NOV 27, 2023",LAC vs. DEN,L,21,2,8,0.25,1,5,0.2,5,5,1.0,1,1,2,1,1,1,0,3,10,-10,1,Norman Powell,LAC,LAC,DEN,17.0,Pts+Rebs,13,12,11,3
22023,1626181,22300257,"NOV 27, 2023",LAC vs. DEN,L,21,2,8,0.25,1,5,0.2,5,5,1.0,1,1,2,1,1,1,0,3,10,-10,1,Norman Powell,LAC,LAC,DEN,15.0,Pts+Asts,13,12,11,3
22023,1626181,22300244,"NOV 25, 2023",LAC vs. DAL,W,25,4,4,1.0,3,3,1.0,4,4,1.0,0,3,3,1,0,0,1,2,15,2,1,Norman Powell,LAC,LAC,DAL,14.0,Points,19,18,16,4
22023,1626181,22300244,"NOV 25, 2023",LAC vs. DAL,W,25,4,4,1.0,3,3,1.0,4,4,1.0,0,3,3,1,0,0,1,2,15,2,1,Norman Powell,LAC,LAC,DAL,18.5,Pts+Rebs+Asts,19,18,16,4
22023,1626181,22300244,"NOV 25, 2023",LAC vs. DAL,W,25,4,4,1.0,3,3,1.0,4,4,1.0,0,3,3,1,0,0,1,2,15,2,1,Norman Powell,LAC,LAC,DAL,17.0,Pts+Rebs,19,18,16,4
22023,1626181,22300244,"NOV 25, 2023",LAC vs. DAL,W,25,4,4,1.0,3,3,1.0,4,4,1.0,0,3,3,1,0,0,1,2,15,2,1,Norman Powell,LAC,LAC,DAL,15.0,Pts+Asts,19,18,16,4
22023,1626181,22300052,"NOV 24, 2023",LAC vs. NOP,L,28,8,14,0.571,3,5,0.6,1,1,1.0,0,1,1,0,3,0,0,1,20,-2,1,Norman Powell,LAC,LAC,NOP,14.0,Points,21,21,20,1
22023,1626181,22300052,"NOV 24, 2023",LAC vs. NOP,L,28,8,14,0.571,3,5,0.6,1,1,1.0,0,1,1,0,3,0,0,1,20,-2,1,Norman Powell,LAC,LAC,NOP,18.5,Pts+Rebs+Asts,21,21,20,1
22023,1626181,22300052,"NOV 24, 2023",LAC vs. NOP,L,28,8,14,0.571,3,5,0.6,1,1,1.0,0,1,1,0,3,0,0,1,20,-2,1,Norman Powell,LAC,LAC,NOP,17.0,Pts+Rebs,21,21,20,1
22023,1626181,22300052,"NOV 24, 2023",LAC vs. NOP,L,28,8,14,0.571,3,5,0.6,1,1,1.0,0,1,1,0,3,0,0,1,20,-2,1,Norman Powell,LAC,LAC,NOP,15.0,Pts+Asts,21,21,20,1
22023,1626181,22300235,"NOV 22, 2023",LAC @ SAS,W,14,2,4,0.5,1,1,1.0,0,1,0.0,0,1,1,0,0,1,2,1,5,1,1,Norman Powell,LAC,SAS,LAC,14.0,Points,6,6,5,1
22023,1626181,22300235,"NOV 22, 2023",LAC @ SAS,W,14,2,4,0.5,1,1,1.0,0,1,0.0,0,1,1,0,0,1,2,1,5,1,1,Norman Powell,LAC,SAS,LAC,18.5,Pts+Rebs+Asts,6,6,5,1
22023,1626181,22300235,"NOV 22, 2023",LAC @ SAS,W,14,2,4,0.5,1,1,1.0,0,1,0.0,0,1,1,0,0,1,2,1,5,1,1,Norman Powell,LAC,SAS,LAC,17.0,Pts+Rebs,6,6,5,1
22023,1626181,22300235,"NOV 22, 2023",LAC @ SAS,W,14,2,4,0.5,1,1,1.0,0,1,0.0,0,1,1,0,0,1,2,1,5,1,1,Norman Powell,LAC,SAS,LAC,15.0,Pts+Asts,6,6,5,1
22023,1626181,22300223,"NOV 20, 2023",LAC @ SAS,W,30,5,12,0.417,2,6,0.333,7,7,1.0,0,5,5,0,2,1,1,0,19,18,1,Norman Powell,LAC,SAS,LAC,14.0,Points,24,24,19,5
22023,1626181,22300223,"NOV 20, 2023",LAC @ SAS,W,30,5,12,0.417,2,6,0.333,7,7,1.0,0,5,5,0,2,1,1,0,19,18,1,Norman Powell,LAC,SAS,LAC,18.5,Pts+Rebs+Asts,24,24,19,5
22023,1626181,22300223,"NOV 20, 2023",LAC @ SAS,W,30,5,12,0.417,2,6,0.333,7,7,1.0,0,5,5,0,2,1,1,0,19,18,1,Norman Powell,LAC,SAS,LAC,17.0,Pts+Rebs,24,24,19,5
22023,1626181,22300223,"NOV 20, 2023",LAC @ SAS,W,30,5,12,0.417,2,6,0.333,7,7,1.0,0,5,5,0,2,1,1,0,19,18,1,Norman Powell,LAC,SAS,LAC,15.0,Pts+Asts,24,24,19,5
22023,1626181,22300037,"NOV 17, 2023",LAC vs. HOU,W,30,3,11,0.273,2,5,0.4,2,2,1.0,1,2,3,3,1,1,0,2,10,-6,1,Norman Powell,LAC,LAC,HOU,14.0,Points,16,13,13,6
22023,1626181,22300037,"NOV 17, 2023",LAC vs. HOU,W,30,3,11,0.273,2,5,0.4,2,2,1.0,1,2,3,3,1,1,0,2,10,-6,1,Norman Powell,LAC,LAC,HOU,18.5,Pts+Rebs+Asts,16,13,13,6
22023,1626181,22300037,"NOV 17, 2023",LAC vs. HOU,W,30,3,11,0.273,2,5,0.4,2,2,1.0,1,2,3,3,1,1,0,2,10,-6,1,Norman Powell,LAC,LAC,HOU,17.0,Pts+Rebs,16,13,13,6
22023,1626181,22300037,"NOV 17, 2023",LAC vs. HOU,W,30,3,11,0.273,2,5,0.4,2,2,1.0,1,2,3,3,1,1,0,2,10,-6,1,Norman Powell,LAC,LAC,HOU,15.0,Pts+Asts,16,13,13,6
22023,1626181,22300024,"NOV 14, 2023",LAC @ DEN,L,26,4,7,0.571,2,3,0.667,4,5,0.8,0,1,1,1,0,0,0,5,14,5,1,Norman Powell,LAC,DEN,LAC,14.0,Points,16,15,15,2
22023,1626181,22300024,"NOV 14, 2023",LAC @ DEN,L,26,4,7,0.571,2,3,0.667,4,5,0.8,0,1,1,1,0,0,0,5,14,5,1,Norman Powell,LAC,DEN,LAC,18.5,Pts+Rebs+Asts,16,15,15,2
22023,1626181,22300024,"NOV 14, 2023",LAC @ DEN,L,26,4,7,0.571,2,3,0.667,4,5,0.8,0,1,1,1,0,0,0,5,14,5,1,Norman Powell,LAC,DEN,LAC,17.0,Pts+Rebs,16,15,15,2
22023,1626181,22300024,"NOV 14, 2023",LAC @ DEN,L,26,4,7,0.571,2,3,0.667,4,5,0.8,0,1,1,1,0,0,0,5,14,5,1,Norman Powell,LAC,DEN,LAC,15.0,Pts+Asts,16,15,15,2
22023,1626181,22300179,"NOV 12, 2023",LAC vs. MEM,L,31,7,13,0.538,4,7,0.571,2,6,0.333,0,2,2,3,0,0,0,5,20,8,1,Norman Powell,LAC,LAC,MEM,14.0,Points,25,22,23,5
22023,1626181,22300179,"NOV 12, 2023",LAC vs. MEM,L,31,7,13,0.538,4,7,0.571,2,6,0.333,0,2,2,3,0,0,0,5,20,8,1,Norman Powell,LAC,LAC,MEM,18.5,Pts+Rebs+Asts,25,22,23,5
22023,1626181,22300179,"NOV 12, 2023",LAC vs. MEM,L,31,7,13,0.538,4,7,0.571,2,6,0.333,0,2,2,3,0,0,0,5,20,8,1,Norman Powell,LAC,LAC,MEM,17.0,Pts+Rebs,25,22,23,5
22023,1626181,22300179,"NOV 12, 2023",LAC vs. MEM,L,31,7,13,0.538,4,7,0.571,2,6,0.333,0,2,2,3,0,0,0,5,20,8,1,Norman Powell,LAC,LAC,MEM,15.0,Pts+Asts,25,22,23,5
22023,1626181,22300014,"NOV 10, 2023",LAC @ DAL,L,11,0,1,0.0,0,0,0.0,0,0,0.0,0,0,0,0,0,0,2,1,0,-35,1,Norman Powell,LAC,DAL,LAC,14.0,Points,0,0,0,0
22023,1626181,22300014,"NOV 10, 2023",LAC @ DAL,L,11,0,1,0.0,0,0,0.0,0,0,0.0,0,0,0,0,0,0,2,1,0,-35,1,Norman Powell,LAC,DAL,LAC,18.5,Pts+Rebs+Asts,0,0,0,0
22023,1626181,22300014,"NOV 10, 2023",LAC @ DAL,L,11,0,1,0.0,0,0,0.0,0,0,0.0,0,0,0,0,0,0,2,1,0,-35,1,Norman Powell,LAC,DAL,LAC,17.0,Pts+Rebs,0,0,0,0
22023,1626181,22300014,"NOV 10, 2023",LAC @ DAL,L,11,0,1,0.0,0,0,0.0,0,0,0.0,0,0,0,0,0,0,2,1,0,-35,1,Norman Powell,LAC,DAL,LAC,15.0,Pts+Asts,0,0,0,0
22023,1626181,22300160,"NOV 08, 2023",LAC @ BKN,L,22,4,8,0.5,2,5,0.4,0,0,0.0,0,1,1,1,2,2,1,2,10,-6,1,Norman Powell,LAC,BKN,LAC,14.0,Points,12,11,11,2
22023,1626181,22300160,"NOV 08, 2023",LAC @ BKN,L,22,4,8,0.5,2,5,0.4,0,0,0.0,0,1,1,1,2,2,1,2,10,-6,1,Norman Powell,LAC,BKN,LAC,18.5,Pts+Rebs+Asts,12,11,11,2
22023,1626181,22300160,"NOV 08, 2023",LAC @ BKN,L,22,4,8,0.5,2,5,0.4,0,0,0.0,0,1,1,1,2,2,1,2,10,-6,1,Norman Powell,LAC,BKN,LAC,17.0,Pts+Rebs,12,11,11,2
22023,1626181,22300160,"NOV 08, 2023",LAC @ BKN,L,22,4,8,0.5,2,5,0.4,0,0,0.0,0,1,1,1,2,2,1,2,10,-6,1,Norman Powell,LAC,BKN,LAC,15.0,Pts+Asts,12,11,11,2
22023,1626181,22300151,"NOV 06, 2023",LAC @ NYK,L,22,5,7,0.714,4,6,0.667,0,0,0.0,0,1,1,0,0,1,3,1,14,-6,1,Norman Powell,LAC,NYK,LAC,14.0,Points,15,15,14,1
22023,1626181,22300151,"NOV 06, 2023",LAC @ NYK,L,22,5,7,0.714,4,6,0.667,0,0,0.0,0,1,1,0,0,1,3,1,14,-6,1,Norman Powell,LAC,NYK,LAC,18.5,Pts+Rebs+Asts,15,15,14,1
22023,1626181,22300151,"NOV 06, 2023",LAC @ NYK,L,22,5,7,0.714,4,6,0.667,0,0,0.0,0,1,1,0,0,1,3,1,14,-6,1,Norman Powell,LAC,NYK,LAC,17.0,Pts+Rebs,15,15,14,1
22023,1626181,22300151,"NOV 06, 2023",LAC @ NYK,L,22,5,7,0.714,4,6,0.667,0,0,0.0,0,1,1,0,0,1,3,1,14,-6,1,Norman Powell,LAC,NYK,LAC,15.0,Pts+Asts,15,15,14,1
22023,1626181,22300127,"NOV 01, 2023",LAC @ LAL,L,35,6,14,0.429,0,4,0.0,0,0,0.0,0,2,2,3,0,1,0,6,12,-14,1,Norman Powell,LAC,LAL,LAC,14.0,Points,17,14,15,5
22023,1626181,22300127,"NOV 01, 2023",LAC @ LAL,L,35,6,14,0.429,0,4,0.0,0,0,0.0,0,2,2,3,0,1,0,6,12,-14,1,Norman Powell,LAC,LAL,LAC,18.5,Pts+Rebs+Asts,17,14,15,5
22023,1626181,22300127,"NOV 01, 2023",LAC @ LAL,L,35,6,14,0.429,0,4,0.0,0,0,0.0,0,2,2,3,0,1,0,6,12,-14,1,Norman Powell,LAC,LAL,LAC,17.0,Pts+Rebs,17,14,15,5
22023,1626181,22300127,"NOV 01, 2023",LAC @ LAL,L,35,6,14,0.429,0,4,0.0,0,0,0.0,0,2,2,3,0,1,0,6,12,-14,1,Norman Powell,LAC,LAL,LAC,15.0,Pts+Asts,17,14,15,5
22023,1626181,22300114,"OCT 31, 2023",LAC vs. ORL,W,29,5,8,0.625,2,5,0.4,5,7,0.714,0,3,3,3,0,0,3,4,17,-2,1,Norman Powell,LAC,LAC,ORL,14.0,Points,23,20,20,6
22023,1626181,22300114,"OCT 31, 2023",LAC vs. ORL,W,29,5,8,0.625,2,5,0.4,5,7,0.714,0,3,3,3,0,0,3,4,17,-2,1,Norman Powell,LAC,LAC,ORL,18.5,Pts+Rebs+Asts,23,20,20,6
22023,1626181,22300114,"OCT 31, 2023",LAC vs. ORL,W,29,5,8,0.625,2,5,0.4,5,7,0.714,0,3,3,3,0,0,3,4,17,-2,1,Norman Powell,LAC,LAC,ORL,17.0,Pts+Rebs,23,20,20,6
22023,1626181,22300114,"OCT 31, 2023",LAC vs. ORL,W,29,5,8,0.625,2,5,0.4,5,7,0.714,0,3,3,3,0,0,3,4,17,-2,1,Norman Powell,LAC,LAC,ORL,15.0,Pts+Asts,23,20,20,6
22023,1626181,22300099,"OCT 29, 2023",LAC vs. SAS,W,19,5,11,0.455,2,5,0.4,1,2,0.5,1,2,3,1,2,1,0,1,13,8,1,Norman Powell,LAC,LAC,SAS,14.0,Points,17,16,14,4
22023,1626181,22300099,"OCT 29, 2023",LAC vs. SAS,W,19,5,11,0.455,2,5,0.4,1,2,0.5,1,2,3,1,2,1,0,1,13,8,1,Norman Powell,LAC,LAC,SAS,18.5,Pts+Rebs+Asts,17,16,14,4
22023,1626181,22300099,"OCT 29, 2023",LAC vs. SAS,W,19,5,11,0.455,2,5,0.4,1,2,0.5,1,2,3,1,2,1,0,1,13,8,1,Norman Powell,LAC,LAC,SAS,17.0,Pts+Rebs,17,16,14,4
22023,1626181,22300099,"OCT 29, 2023",LAC vs. SAS,W,19,5,11,0.455,2,5,0.4,1,2,0.5,1,2,3,1,2,1,0,1,13,8,1,Norman Powell,LAC,LAC,SAS,15.0,Pts+Asts,17,16,14,4
22023,1626181,22300085,"OCT 27, 2023",LAC @ UTA,L,25,7,10,0.7,2,4,0.5,4,4,1.0,0,3,3,1,1,0,1,2,20,3,1,Norman Powell,LAC,UTA,LAC,14.0,Points,24,23,21,4
22023,1626181,22300085,"OCT 27, 2023",LAC @ UTA,L,25,7,10,0.7,2,4,0.5,4,4,1.0,0,3,3,1,1,0,1,2,20,3,1,Norman Powell,LAC,UTA,LAC,18.5,Pts+Rebs+Asts,24,23,21,4
22023,1626181,22300085,"OCT 27, 2023",LAC @ UTA,L,25,7,10,0.7,2,4,0.5,4,4,1.0,0,3,3,1,1,0,1,2,20,3,1,Norman Powell,LAC,UTA,LAC,17.0,Pts+Rebs,24,23,21,4
22023,1626181,22300085,"OCT 27, 2023",LAC @ UTA,L,25,7,10,0.7,2,4,0.5,4,4,1.0,0,3,3,1,1,0,1,2,20,3,1,Norman Powell,LAC,UTA,LAC,15.0,Pts+Asts,24,23,21,4
22023,1626181,22300074,"OCT 25, 2023",LAC vs. POR,W,23,2,6,0.333,2,5,0.4,2,2,1.0,0,3,3,1,0,0,2,0,8,-4,1,Norman Powell,LAC,LAC,POR,14.0,Points,12,11,9,4
22023,1626181,22300074,"OCT 25, 2023",LAC vs. POR,W,23,2,6,0.333,2,5,0.4,2,2,1.0,0,3,3,1,0,0,2,0,8,-4,1,Norman Powell,LAC,LAC,POR,18.5,Pts+Rebs+Asts,12,11,9,4
22023,1626181,22300074,"OCT 25, 2023",LAC vs. POR,W,23,2,6,0.333,2,5,0.4,2,2,1.0,0,3,3,1,0,0,2,0,8,-4,1,Norman Powell,LAC,LAC,POR,17.0,Pts+Rebs,12,11,9,4
22023,1626181,22300074,"OCT 25, 2023",LAC vs. POR,W,23,2,6,0.333,2,5,0.4,2,2,1.0,0,3,3,1,0,0,2,0,8,-4,1,Norman Powell,LAC,LAC,POR,15.0,Pts+Asts,12,11,9,4
22023,1630563,22300343,"DEC 16, 2023",LAC vs. NYK,W,5,1,2,0.5,0,1,0.0,0,0,0.0,0,0,0,0,0,1,3,0,2,-2,1,Joshua Primo,LAC,LAC,NYK,,,2,2,2,0
22023,1627752,22300565,"JAN 15, 2024",LAL vs. OKC,W,31,1,6,0.167,1,5,0.2,0,0,0.0,0,2,2,3,0,1,0,2,3,-1,1,Taurean Prince,LAL,LAL,OKC,,,8,5,6,5
22023,1627752,22300549,"JAN 13, 2024",LAL @ UTA,L,30,5,8,0.625,2,4,0.5,0,0,0.0,0,1,1,1,0,1,0,3,12,-19,1,Taurean Prince,LAL,UTA,LAL,,,14,13,13,2
22023,1627752,22300531,"JAN 11, 2024",LAL vs. PHX,L,28,4,10,0.4,3,8,0.375,0,0,0.0,1,5,6,2,0,0,0,0,11,-30,1,Taurean Prince,LAL,LAL,PHX,,,19,17,13,8
22023,1627752,22300516,"JAN 09, 2024",LAL vs. TOR,W,34,4,8,0.5,2,6,0.333,1,2,0.5,0,4,4,0,2,0,0,2,11,-7,1,Taurean Prince,LAL,LAL,TOR,,,15,15,11,4
22023,1627752,22300505,"JAN 07, 2024",LAL vs. LAC,W,30,4,8,0.5,3,6,0.5,2,2,1.0,0,1,1,2,1,0,0,3,13,-2,1,Taurean Prince,LAL,LAL,LAC,,,16,14,15,3
22023,1627752,22300491,"JAN 05, 2024",LAL vs. MEM,L,35,3,9,0.333,3,7,0.429,1,2,0.5,1,1,2,2,2,1,1,3,10,-19,1,Taurean Prince,LAL,LAL,MEM,,,14,12,12,4
22023,1627752,22300475,"JAN 03, 2024",LAL vs. MIA,L,29,0,6,0.0,0,5,0.0,0,0,0.0,0,5,5,2,0,0,1,2,0,-14,1,Taurean Prince,LAL,LAL,MIA,,,7,5,2,7
22023,1627752,22300446,"DEC 31, 2023",LAL @ NOP,L,34,5,9,0.556,4,7,0.571,1,1,1.0,0,1,1,4,2,2,2,2,15,-12,1,Taurean Prince,LAL,NOP,LAL,,,20,16,19,5
22023,1627752,22300443,"DEC 30, 2023",LAL @ MIN,L,33,3,9,0.333,3,6,0.5,0,0,0.0,0,2,2,1,3,0,3,1,9,15,1,Taurean Prince,LAL,MIN,LAL,,,12,11,10,3
22023,1627752,22300428,"DEC 28, 2023",LAL vs. CHA,W,23,1,7,0.143,1,4,0.25,0,0,0.0,0,3,3,3,3,0,1,2,3,2,1,Taurean Prince,LAL,LAL,CHA,,,9,6,6,6
22023,1627752,22300403,"DEC 25, 2023",LAL vs. BOS,L,39,6,13,0.462,5,12,0.417,0,0,0.0,0,4,4,3,1,0,0,4,17,-12,1,Taurean Prince,LAL,LAL,BOS,,,24,21,20,7
22023,1627752,22300397,"DEC 23, 2023",LAL @ OKC,W,28,3,7,0.429,2,5,0.4,2,2,1.0,1,5,6,1,1,2,0,5,10,9,1,Taurean Prince,LAL,OKC,LAL,,,17,16,11,7
22023,1627752,22300380,"DEC 21, 2023",LAL @ MIN,L,37,5,6,0.833,4,5,0.8,0,0,0.0,0,5,5,1,0,0,3,4,14,6,1,Taurean Prince,LAL,MIN,LAL,,,20,19,15,6
22023,1627752,22300370,"DEC 20, 2023",LAL @ CHI,L,34,5,10,0.5,4,8,0.5,2,2,1.0,0,4,4,4,1,1,1,3,16,-7,1,Taurean Prince,LAL,CHI,LAL,,,24,20,20,8
22023,1627752,22300359,"DEC 18, 2023",LAL vs. NYK,L,39,3,13,0.231,3,13,0.231,0,0,0.0,1,1,2,3,0,1,1,1,9,-1,1,Taurean Prince,LAL,LAL,NYK,,,14,11,12,5
22023,1627752,22300331,"DEC 15, 2023",LAL @ SAS,L,36,5,10,0.5,2,6,0.333,0,0,0.0,0,3,3,1,1,1,1,2,12,-19,1,Taurean Prince,LAL,SAS,LAL,,,16,15,13,4
22023,1627752,22300316,"DEC 13, 2023",LAL @ SAS,W,32,6,12,0.5,4,10,0.4,1,2,0.5,1,4,5,5,2,1,3,1,17,3,1,Taurean Prince,LAL,SAS,LAL,,,27,22,22,10
22023,1627752,22300306,"DEC 12, 2023",LAL @ DAL,L,37,5,6,0.833,5,6,0.833,0,0,0.0,0,4,4,4,0,0,1,0,15,5,1,Taurean Prince,LAL,DAL,LAL,,,23,19,19,8
22023,1627752,22301230,"DEC 07, 2023",LAL vs. NOP,W,23,5,9,0.556,5,8,0.625,0,0,0.0,0,3,3,1,1,0,0,3,15,23,1,Taurean Prince,LAL,LAL,NOP,,,19,18,16,4
22023,1627752,22301203,"DEC 05, 2023",LAL vs. PHX,W,27,2,6,0.333,0,2,0.0,1,2,0.5,0,3,3,0,3,0,3,1,5,-12,1,Taurean Prince,LAL,LAL,PHX,,,8,8,5,3
22023,1627752,22300291,"DEC 02, 2023",LAL vs. HOU,W,29,4,7,0.571,3,5,0.6,0,0,0.0,0,6,6,1,2,0,1,0,11,6,1,Taurean Prince,LAL,LAL,HOU,,,18,17,12,7
22023,1627752,22300271,"NOV 30, 2023",LAL @ OKC,L,32,2,7,0.286,2,5,0.4,0,0,0.0,0,1,1,2,0,0,1,5,6,-10,1,Taurean Prince,LAL,OKC,LAL,,,9,7,8,3
22023,1627752,22300258,"NOV 29, 2023",LAL @ DET,W,23,3,4,0.75,3,4,0.75,0,0,0.0,0,1,1,1,1,0,1,0,9,26,1,Taurean Prince,LAL,DET,LAL,,,11,10,10,2
22023,1627752,22300255,"NOV 27, 2023",LAL @ PHI,L,29,4,8,0.5,3,6,0.5,0,0,0.0,0,4,4,1,0,0,1,3,11,-26,1,Taurean Prince,LAL,PHI,LAL,,,16,15,12,5
22023,1627752,22300242,"NOV 25, 2023",LAL @ CLE,W,32,3,8,0.375,1,3,0.333,0,0,0.0,0,4,4,6,1,2,0,0,7,12,1,Taurean Prince,LAL,CLE,LAL,,,17,11,13,10
22023,1627752,22300238,"NOV 22, 2023",LAL vs. DAL,L,37,6,10,0.6,2,5,0.4,0,0,0.0,1,5,6,2,0,0,1,3,14,15,1,Taurean Prince,LAL,LAL,DAL,,,22,20,16,8
22023,1627752,22300042,"NOV 21, 2023",LAL vs. UTA,W,31,1,8,0.125,0,4,0.0,2,3,0.667,0,0,0,1,0,1,2,0,4,26,1,Taurean Prince,LAL,LAL,UTA,,,5,4,5,1
22023,1627752,22300216,"NOV 19, 2023",LAL vs. HOU,W,24,1,11,0.091,0,4,0.0,0,1,0.0,3,1,4,2,0,0,2,0,2,-6,1,Taurean Prince,LAL,LAL,HOU,,,8,6,4,6
22023,1627752,22300036,"NOV 17, 2023",LAL @ POR,W,35,3,7,0.429,1,5,0.2,3,3,1.0,1,0,1,3,2,0,0,5,10,11,1,Taurean Prince,LAL,POR,LAL,,,14,11,13,4
22023,1627752,22300198,"NOV 15, 2023",LAL vs. SAC,L,25,3,7,0.429,1,4,0.25,0,0,0.0,0,2,2,0,1,0,0,2,7,-24,1,Taurean Prince,LAL,LAL,SAC,,,9,9,7,2
22023,1627752,22300026,"NOV 14, 2023",LAL vs. MEM,W,29,3,6,0.5,2,5,0.4,0,0,0.0,0,3,3,1,1,0,0,3,8,9,1,Taurean Prince,LAL,LAL,MEM,,,12,11,9,4
22023,1627752,22300187,"NOV 12, 2023",LAL vs. POR,W,33,5,9,0.556,0,3,0.0,1,1,1.0,0,3,3,1,1,0,1,2,11,1,1,Taurean Prince,LAL,LAL,POR,,,15,14,12,4
22023,1627752,22300015,"NOV 10, 2023",LAL @ PHX,W,33,3,8,0.375,0,4,0.0,1,2,0.5,0,1,1,0,0,2,0,4,7,3,1,Taurean Prince,LAL,PHX,LAL,,,8,8,7,1
22023,1627752,22300163,"NOV 08, 2023",LAL @ HOU,L,27,3,6,0.5,1,2,0.5,0,0,0.0,0,1,1,1,0,0,1,3,7,-16,1,Taurean Prince,LAL,HOU,LAL,,,9,8,8,2
22023,1627752,22300150,"NOV 06, 2023",LAL @ MIA,L,34,4,9,0.444,1,4,0.25,0,0,0.0,0,3,3,2,2,0,0,4,9,13,1,Taurean Prince,LAL,MIA,LAL,,,14,12,11,5
22023,1627752,22300111,"OCT 30, 2023",LAL vs. ORL,W,26,1,4,0.25,0,2,0.0,2,2,1.0,0,0,0,1,0,1,0,3,4,-5,1,Taurean Prince,LAL,LAL,ORL,,,5,4,5,1
22023,1627752,22300100,"OCT 29, 2023",LAL @ SAC,L,41,7,17,0.412,5,13,0.385,1,2,0.5,0,3,3,2,0,1,1,3,20,-10,1,Taurean Prince,LAL,SAC,LAL,,,25,23,22,5
22023,1627752,22300076,"OCT 26, 2023",LAL vs. PHX,W,18,0,5,0.0,0,1,0.0,0,0,0.0,0,0,0,0,1,0,0,3,0,-15,1,Taurean Prince,LAL,LAL,PHX,,,0,0,0,0
22023,1627752,22300061,"OCT 24, 2023",LAL @ DEN,L,30,6,8,0.75,4,6,0.667,2,2,1.0,1,2,3,1,0,1,1,0,18,-14,1,Taurean Prince,LAL,DEN,LAL,,,22,21,19,4
22023,1630202,22300563,"JAN 15, 2024",BOS @ TOR,W,24,1,7,0.143,1,6,0.167,0,0,0.0,0,3,3,2,0,0,0,2,3,16,1,Payton Pritchard,BOS,TOR,BOS,,,8,6,5,5
22023,1630202,22300542,"JAN 13, 2024",BOS vs. HOU,W,23,7,10,0.7,3,6,0.5,2,2,1.0,2,2,4,3,0,0,2,1,19,12,1,Payton Pritchard,BOS,BOS,HOU,,,26,23,22,7
22023,1630202,22300528,"JAN 11, 2024",BOS @ MIL,L,31,6,13,0.462,2,9,0.222,7,7,1.0,0,4,4,4,0,1,1,1,21,-13,1,Payton Pritchard,BOS,MIL,BOS,,,29,25,25,8
22023,1630202,22300517,"JAN 10, 2024",BOS vs. MIN,W,16,1,4,0.25,1,3,0.333,0,0,0.0,0,1,1,1,0,0,0,0,3,3,1,Payton Pritchard,BOS,BOS,MIN,,,5,4,4,2
22023,1630202,22300507,"JAN 08, 2024",BOS @ IND,L,23,5,6,0.833,4,5,0.8,0,0,0.0,4,3,7,3,0,0,1,2,14,-2,1,Payton Pritchard,BOS,IND,BOS,,,24,21,17,10
22023,1630202,22300493,"JAN 06, 2024",BOS @ IND,W,15,2,5,0.4,1,3,0.333,0,0,0.0,0,2,2,0,1,0,0,0,5,10,1,Payton Pritchard,BOS,IND,BOS,,,7,7,5,2
22023,1630202,22300479,"JAN 05, 2024",BOS vs. UTA,W,23,3,10,0.3,1,7,0.143,0,0,0.0,1,1,2,4,1,0,3,3,7,14,1,Payton Pritchard,BOS,BOS,UTA,,,13,9,11,6
22023,1630202,22300462,"JAN 02, 2024",BOS @ OKC,L,25,2,5,0.4,1,4,0.25,0,0,0.0,1,2,3,4,2,0,0,1,5,9,1,Payton Pritchard,BOS,OKC,BOS,,,12,8,9,7
22023,1630202,22300448,"DEC 31, 2023",BOS @ SAS,W,19,4,8,0.5,1,5,0.2,0,2,0.0,1,2,3,7,0,0,0,0,9,10,1,Payton Pritchard,BOS,SAS,BOS,,,19,12,16,10
22023,1630202,22300432,"DEC 29, 2023",BOS vs. TOR,W,25,3,10,0.3,3,8,0.375,0,0,0.0,3,2,5,6,0,0,2,3,9,-3,1,Payton Pritchard,BOS,BOS,TOR,,,20,14,15,11
22023,1630202,22300421,"DEC 28, 2023",BOS vs. DET,W,24,4,11,0.364,1,6,0.167,0,0,0.0,2,2,4,2,1,0,1,0,9,-9,1,Payton Pritchard,BOS,BOS,DET,,,15,13,11,6
22023,1630202,22300403,"DEC 25, 2023",BOS @ LAL,W,13,4,8,0.5,2,6,0.333,0,0,0.0,2,0,2,0,0,0,0,1,10,-5,1,Payton Pritchard,BOS,LAL,BOS,,,12,12,10,2
22023,1630202,22300389,"DEC 23, 2023",BOS @ LAC,W,23,3,8,0.375,3,5,0.6,0,0,0.0,1,3,4,3,0,0,0,3,9,13,1,Payton Pritchard,BOS,LAC,BOS,,,16,13,12,7
22023,1630202,22300373,"DEC 20, 2023",BOS @ SAC,W,29,6,12,0.5,6,11,0.545,2,3,0.667,0,4,4,4,1,0,1,1,20,10,1,Payton Pritchard,BOS,SAC,BOS,,,28,24,24,8
22023,1630202,22300362,"DEC 19, 2023",BOS @ GSW,L,19,4,6,0.667,3,5,0.6,0,0,0.0,0,0,0,2,0,0,1,1,11,-10,1,Payton Pritchard,BOS,GSW,BOS,,,13,11,13,2
22023,1630202,22300344,"DEC 17, 2023",BOS vs. ORL,W,21,2,5,0.4,1,1,1.0,0,0,0.0,2,4,6,3,0,1,1,3,5,10,1,Payton Pritchard,BOS,BOS,ORL,,,14,11,8,9
22023,1630202,22300329,"DEC 15, 2023",BOS vs. ORL,W,28,7,10,0.7,6,7,0.857,1,2,0.5,1,2,3,5,1,0,0,4,21,8,1,Payton Pritchard,BOS,BOS,ORL,,,29,24,26,8
22023,1630202,22300319,"DEC 14, 2023",BOS vs. CLE,W,14,0,1,0.0,0,1,0.0,0,0,0.0,0,3,3,2,0,1,0,1,0,1,1,Payton Pritchard,BOS,BOS,CLE,,,5,3,2,5
22023,1630202,22300305,"DEC 12, 2023",BOS vs. CLE,W,12,2,5,0.4,2,5,0.4,0,0,0.0,0,3,3,3,2,1,1,1,6,10,1,Payton Pritchard,BOS,BOS,CLE,,,12,9,9,6
22023,1630202,22301227,"DEC 08, 2023",BOS vs. NYK,W,19,2,4,0.5,1,3,0.333,0,0,0.0,1,1,2,2,0,0,0,2,5,-12,1,Payton Pritchard,BOS,BOS,NYK,,,9,7,7,4
22023,1630202,22301202,"DEC 04, 2023",BOS @ IND,L,15,0,5,0.0,0,4,0.0,0,0,0.0,0,4,4,2,0,0,0,0,0,-4,1,Payton Pritchard,BOS,IND,BOS,,,6,4,2,6
22023,1630202,22300275,"DEC 01, 2023",BOS vs. PHI,W,23,3,7,0.429,2,6,0.333,2,2,1.0,0,2,2,5,1,0,0,1,10,-2,1,Payton Pritchard,BOS,BOS,PHI,,,17,12,15,7
22023,1630202,22300053,"NOV 28, 2023",BOS vs. CHI,W,23,4,10,0.4,3,7,0.429,0,0,0.0,1,4,5,2,1,0,0,0,11,11,1,Payton Pritchard,BOS,BOS,CHI,,,18,16,13,7
22023,1630202,22300246,"NOV 26, 2023",BOS vs. ATL,W,20,2,6,0.333,2,6,0.333,0,0,0.0,0,2,2,0,0,0,0,0,6,-10,1,Payton Pritchard,BOS,BOS,ATL,,,8,8,6,2
22023,1630202,22300043,"NOV 24, 2023",BOS @ ORL,L,13,1,2,0.5,0,0,0.0,0,0,0.0,0,1,1,2,0,0,1,0,2,-6,1,Payton Pritchard,BOS,ORL,BOS,,,5,3,4,3
22023,1630202,22300228,"NOV 22, 2023",BOS vs. MIL,W,21,4,7,0.571,2,4,0.5,0,0,0.0,0,2,2,1,0,0,2,0,10,6,1,Payton Pritchard,BOS,BOS,MIL,,,13,12,11,3
22023,1630202,22300217,"NOV 20, 2023",BOS @ CHA,L,33,8,14,0.571,5,8,0.625,0,0,0.0,2,4,6,3,2,0,0,1,21,16,1,Payton Pritchard,BOS,CHA,BOS,,,30,27,24,9
22023,1630202,22300213,"NOV 19, 2023",BOS @ MEM,W,15,2,5,0.4,1,2,0.5,2,4,0.5,0,3,3,1,0,0,1,0,7,0,1,Payton Pritchard,BOS,MEM,BOS,,,11,10,8,4
22023,1630202,22300031,"NOV 17, 2023",BOS @ TOR,W,17,2,7,0.286,1,5,0.2,0,0,0.0,1,2,3,3,1,0,0,1,5,11,1,Payton Pritchard,BOS,TOR,BOS,,,11,8,8,6
22023,1630202,22300194,"NOV 15, 2023",BOS @ PHI,W,23,2,5,0.4,1,3,0.333,0,0,0.0,1,1,2,3,0,0,0,0,5,7,1,Payton Pritchard,BOS,PHI,BOS,,,10,7,8,5
22023,1630202,22300188,"NOV 13, 2023",BOS vs. NYK,W,19,2,3,0.667,1,1,1.0,0,0,0.0,0,3,3,3,0,0,0,3,5,5,1,Payton Pritchard,BOS,BOS,NYK,,,11,8,8,6
22023,1630202,22300174,"NOV 11, 2023",BOS vs. TOR,W,25,2,5,0.4,1,3,0.333,2,2,1.0,3,3,6,4,0,0,1,1,7,14,1,Payton Pritchard,BOS,BOS,TOR,,,17,13,11,10
22023,1630202,22300010,"NOV 10, 2023",BOS vs. BKN,W,30,5,10,0.5,2,7,0.286,1,2,0.5,4,1,5,3,1,0,0,1,13,9,1,Payton Pritchard,BOS,BOS,BKN,,,21,18,16,8
22023,1630202,22300159,"NOV 08, 2023",BOS @ PHI,L,16,0,4,0.0,0,2,0.0,0,0,0.0,2,0,2,4,0,0,1,0,0,-2,1,Payton Pritchard,BOS,PHI,BOS,,,6,2,4,6
22023,1630202,22300154,"NOV 06, 2023",BOS @ MIN,L,20,0,3,0.0,0,1,0.0,0,0,0.0,3,3,6,3,0,0,0,2,0,13,1,Payton Pritchard,BOS,MIN,BOS,,,9,6,3,9
22023,1630202,22300136,"NOV 04, 2023",BOS @ BKN,W,19,0,4,0.0,0,4,0.0,0,0,0.0,0,0,0,2,0,0,1,2,0,-10,1,Payton Pritchard,BOS,BKN,BOS,,,2,0,2,2
22023,1630202,22300118,"NOV 01, 2023",BOS vs. IND,W,26,6,10,0.6,2,3,0.667,1,1,1.0,1,3,4,9,0,0,0,2,15,32,1,Payton Pritchard,BOS,BOS,IND,,,28,19,24,13
22023,1630202,22300103,"OCT 30, 2023",BOS @ WAS,W,25,0,8,0.0,0,6,0.0,0,0,0.0,1,6,7,6,1,0,4,3,0,-2,1,Payton Pritchard,BOS,WAS,BOS,,,13,7,6,13
22023,1630202,22300080,"OCT 27, 2023",BOS vs. MIA,W,13,1,1,1.0,1,1,1.0,0,0,0.0,0,0,0,1,0,0,0,2,3,8,1,Payton Pritchard,BOS,BOS,MIA,,,4,3,4,1
22023,1630202,22300065,"OCT 25, 2023",BOS @ NYK,W,11,1,4,0.25,0,3,0.0,2,2,1.0,0,1,1,1,0,0,0,1,4,-8,1,Payton Pritchard,BOS,NYK,BOS,,,6,5,5,2
22023,1641765,22300487,"JAN 05, 2024",DAL vs. POR,W,14,3,7,0.429,2,3,0.667,0,0,0.0,1,5,6,3,0,0,0,3,8,2,1,Olivier-Maxence Prosper,DAL,DAL,POR,,,17,14,11,9
22023,1641765,22300472,"JAN 03, 2024",DAL vs. POR,W,8,1,3,0.333,0,0,0.0,3,4,0.75,2,3,5,1,0,1,0,1,5,-3,1,Olivier-Maxence Prosper,DAL,DAL,POR,,,11,10,6,6
22023,1641765,22300457,"JAN 01, 2024",DAL @ UTA,L,7,0,2,0.0,0,1,0.0,0,0,0.0,0,3,3,0,0,0,0,0,0,-13,1,Olivier-Maxence Prosper,DAL,UTA,DAL,,,3,3,0,3
22023,1641765,22300405,"DEC 25, 2023",DAL @ PHX,W,0,0,0,0.0,0,0,0.0,0,0,0.0,0,0,0,0,0,0,0,0,0,0,1,Olivier-Maxence Prosper,DAL,PHX,DAL,,,0,0,0,0
22023,1641765,22300398,"DEC 23, 2023",DAL vs. SAS,W,12,0,3,0.0,0,1,0.0,0,0,0.0,0,2,2,0,0,0,0,1,0,-6,1,Olivier-Maxence Prosper,DAL,DAL,SAS,,,2,2,0,2
22023,1641765,22300385,"DEC 22, 2023",DAL @ HOU,L,30,6,13,0.462,1,4,0.25,7,9,0.778,5,1,6,2,1,0,3,2,20,-5,1,Olivier-Maxence Prosper,DAL,HOU,DAL,,,28,26,22,8
22023,1641765,22300372,"DEC 20, 2023",DAL vs. LAC,L,3,0,0,0.0,0,0,0.0,0,0,0.0,0,1,1,1,0,0,0,0,0,3,1,Olivier-Maxence Prosper,DAL,DAL,LAC,,,2,1,1,2
22023,1641765,22300356,"DEC 18, 2023",DAL @ DEN,L,20,1,5,0.2,0,2,0.0,0,0,0.0,1,3,4,3,0,0,0,1,2,-6,1,Olivier-Maxence Prosper,DAL,DEN,DAL,,,9,6,5,7
22023,1641765,22300341,"DEC 16, 2023",DAL @ POR,W,6,0,1,0.0,0,1,0.0,0,0,0.0,2,3,5,1,0,0,0,0,0,3,1,Olivier-Maxence Prosper,DAL,POR,DAL,,,6,5,1,6
22023,1641765,22300321,"DEC 14, 2023",DAL vs. MIN,L,3,1,1,1.0,0,0,0.0,0,0,0.0,0,0,0,0,0,0,0,0,2,1,1,Olivier-Maxence Prosper,DAL,DAL,MIN,,,2,2,2,0
22023,1641765,22300306,"DEC 12, 2023",DAL vs. LAL,W,1,0,0,0.0,0,0,0.0,0,0,0.0,0,0,0,0,0,0,0,0,0,-3,1,Olivier-Maxence Prosper,DAL,DAL,LAL,,,0,0,0,0
22023,1641765,22300299,"DEC 11, 2023",DAL @ MEM,W,18,4,7,0.571,3,6,0.5,0,0,0.0,0,4,4,2,0,1,1,2,11,-5,1,Olivier-Maxence Prosper,DAL,MEM,DAL,,,17,15,13,6
22023,1641765,22301226,"DEC 08, 2023",DAL @ POR,W,5,0,1,0.0,0,1,0.0,0,0,0.0,0,1,1,0,0,0,0,0,0,1,1,Olivier-Maxence Prosper,DAL,POR,DAL,,,1,1,0,1
22023,1641765,22301213,"DEC 06, 2023",DAL vs. UTA,W,21,2,4,0.5,1,2,0.5,1,2,0.5,1,4,5,2,0,0,0,1,6,17,1,Olivier-Maxence Prosper,DAL,DAL,UTA,,,13,11,8,7
22023,1641765,22300287,"DEC 02, 2023",DAL vs. OKC,L,14,0,2,0.0,0,1,0.0,2,2,1.0,1,0,1,1,0,0,0,2,2,-4,1,Olivier-Maxence Prosper,DAL,DAL,OKC,,,4,3,3,2
22023,1641765,22300277,"DEC 01, 2023",DAL vs. MEM,L,11,0,1,0.0,0,1,0.0,2,2,1.0,0,0,0,2,0,0,0,0,2,4,1,Olivier-Maxence Prosper,DAL,DAL,MEM,,,4,2,4,2
22023,1641765,22300244,"NOV 25, 2023",DAL @ LAC,L,6,0,2,0.0,0,2,0.0,0,0,0.0,0,0,0,0,1,0,0,0,0,-1,1,Olivier-Maxence Prosper,DAL,LAC,DAL,,,0,0,0,0
22023,1641765,22300212,"NOV 19, 2023",DAL vs. SAC,L,5,0,1,0.0,0,1,0.0,0,0,0.0,0,3,3,0,0,0,0,0,0,5,1,Olivier-Maxence Prosper,DAL,DAL,SAC,,,3,3,0,3
22023,1641765,22300192,"NOV 15, 2023",DAL @ WAS,W,7,1,2,0.5,0,1,0.0,0,2,0.0,0,2,2,1,0,0,0,0,2,-2,1,Olivier-Maxence Prosper,DAL,WAS,DAL,,,5,4,3,3
22023,1641765,22300022,"NOV 14, 2023",DAL @ NOP,L,9,2,3,0.667,1,2,0.5,1,2,0.5,1,2,3,0,0,0,0,0,6,7,1,Olivier-Maxence Prosper,DAL,NOP,DAL,,,9,9,6,3
22023,1641765,22300183,"NOV 12, 2023",DAL @ NOP,W,6,1,3,0.333,0,2,0.0,2,2,1.0,0,0,0,0,0,0,0,2,4,-11,1,Olivier-Maxence Prosper,DAL,NOP,DAL,,,4,4,4,0
22023,1641765,22300014,"NOV 10, 2023",DAL vs. LAC,W,5,0,1,0.0,0,0,0.0,1,2,0.5,1,0,1,0,0,0,0,1,1,-13,1,Olivier-Maxence Prosper,DAL,DAL,LAC,,,2,2,1,1
22023,1641765,22300006,"NOV 03, 2023",DAL @ DEN,L,1,0,1,0.0,0,0,0.0,0,0,0.0,0,0,0,0,0,0,0,0,0,2,1,Olivier-Maxence Prosper,DAL,DEN,DAL,,,0,0,0,0
22023,1630243,22300546,"JAN 13, 2024",ORL @ OKC,L,17,3,6,0.5,0,3,0.0,1,1,1.0,0,4,4,1,0,3,2,2,7,4,1,Trevelin Queen,ORL,OKC,ORL,,,12,11,8,5
22023,1630243,22300535,"JAN 12, 2024",ORL @ MIA,L,7,0,1,0.0,0,1,0.0,0,0,0.0,0,1,1,0,0,0,1,0,0,4,1,Trevelin Queen,ORL,MIA,ORL,,,1,1,0,1
22023,1630243,22300513,"JAN 09, 2024",ORL vs. MIN,L,28,3,9,0.333,3,4,0.75,2,2,1.0,1,2,3,3,1,0,2,1,11,-10,1,Trevelin Queen,ORL,ORL,MIN,,,17,14,14,6
22023,1630243,22300499,"JAN 07, 2024",ORL vs. ATL,W,6,1,1,1.0,0,0,0.0,0,0,0.0,1,0,1,0,0,0,1,2,2,-3,1,Trevelin Queen,ORL,ORL,ATL,,,3,3,2,1
22023,1630243,22300488,"JAN 05, 2024",ORL @ DEN,W,31,2,4,0.5,0,1,0.0,1,1,1.0,1,4,5,2,2,1,0,4,5,10,1,Trevelin Queen,ORL,DEN,ORL,,,12,10,7,7
22023,1630243,22300476,"JAN 03, 2024",ORL @ SAC,L,38,2,7,0.286,0,3,0.0,1,2,0.5,0,2,2,6,2,1,0,5,5,1,1,Trevelin Queen,ORL,SAC,ORL,,,13,7,11,8
22023,1630243,22300415,"DEC 27, 2023",ORL vs. PHI,L,1,0,1,0.0,0,1,0.0,0,0,0.0,0,0,0,0,1,0,0,0,0,3,1,Trevelin Queen,ORL,ORL,PHI,,,0,0,0,0
22023,1629674,22300528,"JAN 11, 2024",BOS @ MIL,L,13,2,4,0.5,0,0,0.0,0,0,0.0,1,2,3,0,0,1,1,1,4,-4,1,Neemias Queta,BOS,MIL,BOS,,,7,7,4,3
22023,1629674,22300479,"JAN 05, 2024",BOS vs. UTA,W,4,0,1,0.0,0,0,0.0,0,0,0.0,0,0,0,0,0,0,0,2,0,-5,1,Neemias Queta,BOS,BOS,UTA,,,0,0,0,0
22023,1629674,22300448,"DEC 31, 2023",BOS @ SAS,W,5,2,2,1.0,0,0,0.0,1,1,1.0,0,2,2,0,0,1,0,0,5,1,1,Neemias Queta,BOS,SAS,BOS,,,7,7,5,2
22023,1629674,22300432,"DEC 29, 2023",BOS vs. TOR,W,14,3,3,1.0,0,0,0.0,0,0,0.0,1,4,5,1,0,0,0,0,6,3,1,Neemias Queta,BOS,BOS,TOR,,,12,11,7,6
22023,1629674,22300421,"DEC 28, 2023",BOS vs. DET,W,20,2,2,1.0,0,0,0.0,1,2,0.5,0,2,2,0,1,0,0,4,5,-3,1,Neemias Queta,BOS,BOS,DET,,,7,7,5,2
22023,1629674,22300403,"DEC 25, 2023",BOS @ LAL,W,7,0,0,0.0,0,0,0.0,0,0,0.0,0,1,1,1,1,0,0,3,0,-10,1,Neemias Queta,BOS,LAL,BOS,,,2,1,1,2
22023,1629674,22300389,"DEC 23, 2023",BOS @ LAC,W,23,4,7,0.571,0,0,0.0,6,8,0.75,6,6,12,3,0,0,1,5,14,14,1,Neemias Queta,BOS,LAC,BOS,,,29,26,17,15
22023,1629674,22300373,"DEC 20, 2023",BOS @ SAC,W,19,3,8,0.375,0,0,0.0,0,0,0.0,4,4,8,0,1,0,1,5,6,3,1,Neemias Queta,BOS,SAC,BOS,,,14,14,6,8
22023,1629674,22300362,"DEC 19, 2023",BOS @ GSW,L,21,5,8,0.625,0,0,0.0,0,0,0.0,6,4,10,1,1,0,0,0,10,10,1,Neemias Queta,BOS,GSW,BOS,,,21,20,11,11
22023,1629674,22300344,"DEC 17, 2023",BOS vs. ORL,W,16,1,2,0.5,0,0,0.0,0,0,0.0,0,3,3,0,0,0,0,1,2,8,1,Neemias Queta,BOS,BOS,ORL,,,5,5,2,3
22023,1629674,22300329,"DEC 15, 2023",BOS vs. ORL,W,18,2,3,0.667,0,0,0.0,0,0,0.0,2,1,3,1,1,3,1,6,4,13,1,Neemias Queta,BOS,BOS,ORL,,,8,7,5,4
22023,1629674,22300275,"DEC 01, 2023",BOS vs. PHI,W,10,1,1,1.0,0,0,0.0,3,4,0.75,2,3,5,0,0,0,2,1,5,3,1,Neemias Queta,BOS,BOS,PHI,,,10,10,5,5
22023,1629674,22300246,"NOV 26, 2023",BOS vs. ATL,W,15,3,8,0.375,0,0,0.0,1,1,1.0,6,4,10,0,1,0,0,0,7,5,1,Neemias Queta,BOS,BOS,ATL,,,17,17,7,10
22023,1629674,22300213,"NOV 19, 2023",BOS @ MEM,W,5,0,1,0.0,0,0,0.0,0,0,0.0,0,2,2,0,0,0,0,1,0,-3,1,Neemias Queta,BOS,MEM,BOS,,,2,2,0,2
22023,1630193,22300563,"JAN 15, 2024",TOR vs. BOS,L,37,8,20,0.4,2,7,0.286,3,4,0.75,0,6,6,3,1,1,0,3,21,2,1,Immanuel Quickley,TOR,TOR,BOS,,,30,27,24,9
22023,1630193,22300540,"JAN 12, 2024",TOR @ UTA,L,25,4,8,0.5,3,3,1.0,4,4,1.0,1,2,3,0,0,0,1,1,15,-28,1,Immanuel Quickley,TOR,UTA,TOR,,,18,18,15,3
22023,1630193,22300526,"JAN 10, 2024",TOR @ LAC,L,36,7,16,0.438,2,4,0.5,9,9,1.0,0,4,4,6,1,0,1,1,25,-5,1,Immanuel Quickley,TOR,LAC,TOR,,,35,29,31,10
22023,1630193,22300516,"JAN 09, 2024",TOR @ LAL,L,26,8,14,0.571,4,6,0.667,1,3,0.333,1,4,5,5,0,0,1,6,21,2,1,Immanuel Quickley,TOR,LAL,TOR,,,31,26,26,10
22023,1630193,22300504,"JAN 07, 2024",TOR @ GSW,W,26,4,10,0.4,1,4,0.25,0,0,0.0,1,4,5,10,1,0,0,0,9,4,1,Immanuel Quickley,TOR,GSW,TOR,,,24,14,19,15
22023,1630193,22300492,"JAN 05, 2024",TOR @ SAC,L,38,6,17,0.353,4,12,0.333,4,4,1.0,0,5,5,8,0,0,3,1,20,-3,1,Immanuel Quickley,TOR,SAC,TOR,,,33,25,28,13
22023,1630193,22300470,"JAN 03, 2024",TOR @ MEM,W,33,8,18,0.444,5,8,0.625,5,6,0.833,0,3,3,5,0,1,1,3,26,9,1,Immanuel Quickley,TOR,MEM,TOR,,,34,29,31,8
22023,1630193,22300452,"JAN 01, 2024",TOR vs. CLE,W,28,5,13,0.385,2,5,0.4,2,3,0.667,0,6,6,3,2,0,0,4,14,7,1,Immanuel Quickley,TOR,TOR,CLE,,,23,20,17,9
22023,1630193,22300429,"DEC 29, 2023",NYK @ ORL,L,28,4,10,0.4,3,7,0.429,1,1,1.0,0,1,1,1,0,0,1,4,12,3,1,Immanuel Quickley,NYK,ORL,NYK,,,14,13,13,2
22023,1630193,22300419,"DEC 27, 2023",NYK @ OKC,L,25,7,10,0.7,4,5,0.8,4,4,1.0,0,0,0,2,0,0,1,0,22,2,1,Immanuel Quickley,NYK,OKC,NYK,,,24,22,24,2
22023,1630193,22300401,"DEC 25, 2023",NYK vs. MIL,W,22,7,10,0.7,2,4,0.5,4,4,1.0,0,0,0,1,1,0,1,1,20,14,1,Immanuel Quickley,NYK,NYK,MIL,,,21,20,21,1
22023,1630193,22300388,"DEC 23, 2023",NYK vs. MIL,L,22,2,8,0.25,1,5,0.2,2,2,1.0,0,2,2,1,0,0,1,1,7,-11,1,Immanuel Quickley,NYK,NYK,MIL,,,10,9,8,3
22023,1630193,22300368,"DEC 20, 2023",NYK @ BKN,W,24,7,12,0.583,4,6,0.667,1,4,0.25,0,0,0,2,1,1,1,0,19,6,1,Immanuel Quickley,NYK,BKN,NYK,,,21,19,21,2
22023,1630193,22300359,"DEC 18, 2023",NYK @ LAL,W,29,8,15,0.533,3,7,0.429,1,1,1.0,0,3,3,2,1,0,1,2,20,7,1,Immanuel Quickley,NYK,LAL,NYK,,,25,23,22,5
22023,1630193,22300343,"DEC 16, 2023",NYK @ LAC,L,19,3,8,0.375,0,3,0.0,3,4,0.75,0,4,4,3,0,0,0,0,9,3,1,Immanuel Quickley,NYK,LAC,NYK,,,16,13,12,7
22023,1630193,22300333,"DEC 15, 2023",NYK @ PHX,W,24,3,8,0.375,1,3,0.333,3,4,0.75,0,5,5,3,2,0,1,2,10,28,1,Immanuel Quickley,NYK,PHX,NYK,,,18,15,13,8
22023,1630193,22300318,"DEC 13, 2023",NYK @ UTA,L,18,6,8,0.75,3,4,0.75,0,0,0.0,1,1,2,1,2,0,1,1,15,-13,1,Immanuel Quickley,NYK,UTA,NYK,,,18,17,16,3
22023,1630193,22301227,"DEC 08, 2023",NYK @ BOS,L,25,4,10,0.4,3,8,0.375,6,6,1.0,0,0,0,1,0,0,0,2,17,15,1,Immanuel Quickley,NYK,BOS,NYK,,,18,17,18,1
22023,1630193,22301201,"DEC 05, 2023",NYK @ MIL,L,19,1,7,0.143,1,4,0.25,4,4,1.0,0,1,1,3,0,0,1,0,7,-10,1,Immanuel Quickley,NYK,MIL,NYK,,,11,8,10,4
22023,1630193,22300276,"DEC 01, 2023",NYK @ TOR,W,19,3,6,0.5,1,3,0.333,3,4,0.75,0,1,1,1,1,0,1,0,10,16,1,Immanuel Quickley,NYK,TOR,NYK,,,12,11,11,2
22023,1630193,22300268,"NOV 30, 2023",NYK vs. DET,W,19,2,10,0.2,1,5,0.2,0,0,0.0,0,1,1,2,0,0,1,0,5,3,1,Immanuel Quickley,NYK,NYK,DET,,,8,6,7,3
22023,1630193,22300057,"NOV 28, 2023",NYK vs. CHA,W,26,9,20,0.45,4,10,0.4,1,1,1.0,0,3,3,1,0,0,1,1,23,21,1,Immanuel Quickley,NYK,NYK,CHA,,,27,26,24,4
22023,1630193,22300247,"NOV 26, 2023",NYK vs. PHX,L,29,4,10,0.4,3,5,0.6,7,8,0.875,0,2,2,1,1,1,0,1,18,5,1,Immanuel Quickley,NYK,NYK,PHX,,,21,20,19,3
22023,1630193,22300045,"NOV 24, 2023",NYK vs. MIA,W,26,8,17,0.471,4,8,0.5,0,0,0.0,0,4,4,2,0,1,2,1,20,22,1,Immanuel Quickley,NYK,NYK,MIA,,,26,24,22,6
22023,1630193,22300221,"NOV 20, 2023",NYK @ MIN,L,17,4,14,0.286,1,7,0.143,6,6,1.0,0,1,1,0,0,0,0,3,15,-6,1,Immanuel Quickley,NYK,MIN,NYK,,,16,16,15,1
22023,1630193,22300202,"NOV 18, 2023",NYK @ CHA,W,23,4,11,0.364,0,5,0.0,1,1,1.0,0,4,4,1,0,0,1,3,9,-1,1,Immanuel Quickley,NYK,CHA,NYK,,,14,13,10,5
22023,1630193,22300028,"NOV 17, 2023",NYK @ WAS,W,33,10,18,0.556,3,7,0.429,4,5,0.8,0,6,6,4,1,0,1,5,27,11,1,Immanuel Quickley,NYK,WAS,NYK,,,37,33,31,10
22023,1630193,22300193,"NOV 15, 2023",NYK @ ATL,W,28,6,11,0.545,3,5,0.6,5,6,0.833,0,0,0,4,1,0,2,3,20,-12,1,Immanuel Quickley,NYK,ATL,NYK,,,24,20,24,4
22023,1630193,22300188,"NOV 13, 2023",NYK @ BOS,L,26,1,10,0.1,1,2,0.5,4,4,1.0,0,6,6,1,1,0,0,3,7,-12,1,Immanuel Quickley,NYK,BOS,NYK,,,14,13,8,7
22023,1630193,22300177,"NOV 12, 2023",NYK vs. CHA,W,26,5,9,0.556,4,6,0.667,3,3,1.0,0,5,5,9,0,0,1,1,17,22,1,Immanuel Quickley,NYK,NYK,CHA,,,31,22,26,14
22023,1630193,22300161,"NOV 08, 2023",NYK vs. SAS,W,28,8,17,0.471,3,9,0.333,0,0,0.0,0,0,0,5,1,0,0,1,19,-3,1,Immanuel Quickley,NYK,NYK,SAS,,,24,19,24,5
22023,1630193,22300151,"NOV 06, 2023",NYK vs. LAC,W,20,3,5,0.6,1,3,0.333,0,0,0.0,0,1,1,5,0,0,0,0,7,22,1,Immanuel Quickley,NYK,NYK,LAC,,,13,8,12,6
22023,1630193,22300002,"NOV 03, 2023",NYK @ MIL,L,22,5,10,0.5,1,3,0.333,3,3,1.0,0,3,3,1,0,0,1,1,14,-1,1,Immanuel Quickley,NYK,MIL,NYK,,,18,17,15,4
22023,1630193,22300120,"NOV 01, 2023",NYK vs. CLE,L,28,7,16,0.438,0,3,0.0,4,6,0.667,2,4,6,4,1,0,0,0,18,-1,1,Immanuel Quickley,NYK,NYK,CLE,,,28,24,22,10
22023,1630193,22300112,"OCT 31, 2023",NYK @ CLE,W,24,6,11,0.545,3,6,0.5,3,3,1.0,0,3,3,2,0,0,3,0,18,9,1,Immanuel Quickley,NYK,CLE,NYK,,,23,21,20,5
22023,1630193,22300090,"OCT 28, 2023",NYK @ NOP,L,19,4,9,0.444,0,3,0.0,2,2,1.0,0,1,1,1,0,0,2,3,10,-11,1,Immanuel Quickley,NYK,NOP,NYK,,,12,11,11,2
22023,1630193,22300079,"OCT 27, 2023",NYK @ ATL,W,24,4,14,0.286,1,9,0.111,2,2,1.0,0,6,6,6,1,0,4,2,11,-3,1,Immanuel Quickley,NYK,ATL,NYK,,,23,17,17,12
22023,1630193,22300065,"OCT 25, 2023",NYK vs. BOS,L,28,7,11,0.636,5,7,0.714,5,6,0.833,2,4,6,4,1,0,2,3,24,-3,1,Immanuel Quickley,NYK,NYK,BOS,,,34,30,28,10
22023,1631311,22300560,"JAN 15, 2024",GSW @ MEM,L,5,0,0,0.0,0,0,0.0,0,0,0.0,0,0,0,1,0,1,0,0,0,1,1,Lester Quinones,GSW,MEM,GSW,,,1,0,1,1
22023,1631311,22300545,"JAN 13, 2024",GSW @ MIL,L,18,2,5,0.4,1,1,1.0,1,2,0.5,2,2,4,2,0,0,1,2,6,9,1,Lester Quinones,GSW,MIL,GSW,,,12,10,8,6
22023,1631311,22300525,"JAN 10, 2024",GSW vs. NOP,L,8,1,4,0.25,1,3,0.333,0,0,0.0,1,0,1,1,0,0,0,0,3,-1,1,Lester Quinones,GSW,GSW,NOP,,,5,4,4,2
22023,1631311,22300504,"JAN 07, 2024",GSW vs. TOR,L,7,2,3,0.667,1,2,0.5,0,0,0.0,0,1,1,0,1,0,1,1,5,10,1,Lester Quinones,GSW,GSW,TOR,,,6,6,5,1
22023,1631311,22300426,"DEC 28, 2023",GSW vs. MIA,L,2,0,0,0.0,0,0,0.0,0,0,0.0,0,0,0,0,0,0,0,1,0,3,1,Lester Quinones,GSW,GSW,MIA,,,0,0,0,0
22023,1631311,22300386,"DEC 22, 2023",GSW vs. WAS,W,6,1,3,0.333,1,2,0.5,0,0,0.0,0,3,3,1,0,0,1,1,3,-12,1,Lester Quinones,GSW,GSW,WAS,,,7,6,4,4
22023,1631311,22300201,"NOV 16, 2023",GSW vs. OKC,L,4,0,3,0.0,0,2,0.0,0,0,0.0,0,0,0,0,0,0,0,1,0,1,1,Lester Quinones,GSW,GSW,OKC,,,0,0,0,0
22023,1631311,22300108,"OCT 30, 2023",GSW @ NOP,W,5,2,3,0.667,1,2,0.5,0,0,0.0,0,0,0,0,0,0,1,0,5,0,1,Lester Quinones,GSW,NOP,GSW,,,5,5,5,0
22023,203944,22300557,"JAN 15, 2024",NYK vs. ORL,L,38,5,18,0.278,2,9,0.222,3,5,0.6,1,5,6,5,0,0,0,3,15,2,1,Julius Randle,NYK,NYK,ORL,,,26,21,20,11
22023,203944,22300544,"JAN 13, 2024",NYK @ MEM,W,36,9,21,0.429,1,6,0.167,5,6,0.833,5,6,11,5,0,1,6,2,24,10,1,Julius Randle,NYK,MEM,NYK,,,40,35,29,16
22023,203944,22300530,"JAN 11, 2024",NYK @ DAL,L,37,12,23,0.522,2,7,0.286,6,7,0.857,1,5,6,5,2,0,4,3,32,-1,1,Julius Randle,NYK,DAL,NYK,,,43,38,37,11
22023,203944,22300514,"JAN 09, 2024",NYK vs. POR,W,32,7,17,0.412,2,4,0.5,4,4,1.0,0,7,7,8,0,1,2,1,20,31,1,Julius Randle,NYK,NYK,POR,,,35,27,28,15
22023,203944,22300494,"JAN 06, 2024",NYK @ WAS,W,38,13,23,0.565,3,8,0.375,10,13,0.769,3,4,7,5,1,0,2,2,39,24,1,Julius Randle,NYK,WAS,NYK,,,51,46,44,12
22023,203944,22300483,"JAN 05, 2024",NYK @ PHI,W,30,1,11,0.091,0,3,0.0,6,6,1.0,0,7,7,5,1,1,4,3,8,13,1,Julius Randle,NYK,PHI,NYK,,,20,15,13,12
22023,203944,22300468,"JAN 03, 2024",NYK vs. CHI,W,39,13,23,0.565,3,7,0.429,6,7,0.857,0,6,6,4,2,1,3,3,35,13,1,Julius Randle,NYK,NYK,CHI,,,45,41,39,10
22023,203944,22300451,"JAN 01, 2024",NYK vs. MIN,W,36,14,24,0.583,2,6,0.333,9,13,0.692,3,6,9,0,0,0,6,5,39,2,1,Julius Randle,NYK,NYK,MIN,,,48,48,39,9
22023,203944,22300441,"DEC 30, 2023",NYK @ IND,L,39,9,22,0.409,1,5,0.2,9,13,0.692,6,6,12,4,0,0,5,1,28,-6,1,Julius Randle,NYK,IND,NYK,,,44,40,32,16
22023,203944,22300429,"DEC 29, 2023",NYK @ ORL,L,36,16,25,0.64,0,4,0.0,6,8,0.75,3,9,12,6,0,1,5,5,38,0,1,Julius Randle,NYK,ORL,NYK,,,56,50,44,18
22023,203944,22300419,"DEC 27, 2023",NYK @ OKC,L,36,7,15,0.467,1,4,0.25,10,13,0.769,1,8,9,2,0,0,3,3,25,-12,1,Julius Randle,NYK,OKC,NYK,,,36,34,27,11
22023,203944,22300401,"DEC 25, 2023",NYK vs. MIL,W,41,8,17,0.471,2,5,0.4,6,6,1.0,1,8,9,2,1,0,4,3,24,6,1,Julius Randle,NYK,NYK,MIL,,,35,33,26,11
22023,203944,22300388,"DEC 23, 2023",NYK vs. MIL,L,34,8,17,0.471,0,2,0.0,10,10,1.0,1,7,8,1,1,0,3,3,26,-3,1,Julius Randle,NYK,NYK,MIL,,,35,34,27,9
22023,203944,22300368,"DEC 20, 2023",NYK @ BKN,W,34,9,20,0.45,0,4,0.0,8,9,0.889,2,5,7,4,0,0,1,3,26,27,1,Julius Randle,NYK,BKN,NYK,,,37,33,30,11
22023,203944,22300359,"DEC 18, 2023",NYK @ LAL,W,43,12,22,0.545,1,4,0.25,2,2,1.0,1,13,14,3,0,0,2,3,27,17,1,Julius Randle,NYK,LAL,NYK,,,44,41,30,17
22023,203944,22300343,"DEC 16, 2023",NYK @ LAC,L,31,8,17,0.471,0,3,0.0,6,6,1.0,2,2,4,3,0,0,3,3,22,-20,1,Julius Randle,NYK,LAC,NYK,,,29,26,25,7
22023,203944,22300333,"DEC 15, 2023",NYK @ PHX,W,35,10,16,0.625,1,3,0.333,2,2,1.0,1,7,8,6,0,1,5,4,23,4,1,Julius Randle,NYK,PHX,NYK,,,37,31,29,14
22023,203944,22300318,"DEC 13, 2023",NYK @ UTA,L,39,14,23,0.609,2,6,0.333,2,2,1.0,3,9,12,6,1,1,2,4,32,13,1,Julius Randle,NYK,UTA,NYK,,,50,44,38,18
22023,203944,22300297,"DEC 11, 2023",NYK vs. TOR,W,35,14,21,0.667,1,3,0.333,5,7,0.714,3,5,8,5,0,0,3,1,34,-1,1,Julius Randle,NYK,NYK,TOR,,,47,42,39,13
22023,203944,22301227,"DEC 08, 2023",NYK @ BOS,L,34,7,15,0.467,3,4,0.75,3,4,0.75,1,4,5,3,1,1,6,2,20,-18,1,Julius Randle,NYK,BOS,NYK,,,28,25,23,8
22023,203944,22301201,"DEC 05, 2023",NYK @ MIL,L,37,14,19,0.737,2,2,1.0,11,12,0.917,3,3,6,5,0,0,4,3,41,-21,1,Julius Randle,NYK,MIL,NYK,,,52,47,46,11
22023,203944,22300276,"DEC 01, 2023",NYK @ TOR,W,35,8,15,0.533,1,4,0.25,3,3,1.0,2,8,10,9,0,0,2,3,20,15,1,Julius Randle,NYK,TOR,NYK,,,39,30,29,19
22023,203944,22300268,"NOV 30, 2023",NYK vs. DET,W,38,12,21,0.571,2,5,0.4,3,6,0.5,2,8,10,8,0,1,3,3,29,11,1,Julius Randle,NYK,NYK,DET,,,47,39,37,18
22023,203944,22300057,"NOV 28, 2023",NYK vs. CHA,W,34,8,15,0.533,2,7,0.286,7,8,0.875,4,16,20,5,2,0,4,2,25,27,1,Julius Randle,NYK,NYK,CHA,,,50,45,30,25
22023,203944,22300247,"NOV 26, 2023",NYK vs. PHX,L,36,10,21,0.476,1,4,0.25,7,8,0.875,3,2,5,2,0,0,2,2,28,-9,1,Julius Randle,NYK,NYK,PHX,,,35,33,30,7
22023,203944,22300045,"NOV 24, 2023",NYK vs. MIA,W,35,5,12,0.417,1,4,0.25,2,2,1.0,0,8,8,7,0,0,6,0,13,-8,1,Julius Randle,NYK,NYK,MIA,,,28,21,20,15
22023,203944,22300221,"NOV 20, 2023",NYK @ MIN,L,34,6,16,0.375,1,6,0.167,8,12,0.667,3,11,14,1,0,0,2,2,21,-12,1,Julius Randle,NYK,MIN,NYK,,,36,35,22,15
22023,203944,22300202,"NOV 18, 2023",NYK @ CHA,W,38,8,17,0.471,2,5,0.4,3,7,0.429,0,6,6,8,0,0,4,4,21,9,1,Julius Randle,NYK,CHA,NYK,,,35,27,29,14
22023,203944,22300028,"NOV 17, 2023",NYK @ WAS,W,35,9,18,0.5,1,5,0.2,3,6,0.5,1,6,7,8,1,2,6,3,22,15,1,Julius Randle,NYK,WAS,NYK,,,37,29,30,15
22023,203944,22300193,"NOV 15, 2023",NYK @ ATL,W,39,12,24,0.5,3,5,0.6,2,2,1.0,2,8,10,8,1,0,1,4,29,12,1,Julius Randle,NYK,ATL,NYK,,,47,39,37,18
22023,203944,22300188,"NOV 13, 2023",NYK @ BOS,L,38,7,19,0.368,2,8,0.25,9,11,0.818,3,6,9,5,0,0,3,4,25,-10,1,Julius Randle,NYK,BOS,NYK,,,39,34,30,14
22023,203944,22300177,"NOV 12, 2023",NYK vs. CHA,W,27,8,16,0.5,1,4,0.25,6,8,0.75,1,4,5,5,3,0,3,1,23,8,1,Julius Randle,NYK,NYK,CHA,,,33,28,28,10
22023,203944,22300161,"NOV 08, 2023",NYK vs. SAS,W,31,8,19,0.421,2,6,0.333,5,8,0.625,4,12,16,5,1,0,2,1,23,31,1,Julius Randle,NYK,NYK,SAS,,,44,39,28,21
22023,203944,22300151,"NOV 06, 2023",NYK vs. LAC,W,37,9,21,0.429,3,8,0.375,6,6,1.0,2,8,10,3,0,0,6,3,27,2,1,Julius Randle,NYK,NYK,LAC,,,40,37,30,13
22023,203944,22300002,"NOV 03, 2023",NYK @ MIL,L,39,5,20,0.25,1,9,0.111,5,9,0.556,4,8,12,5,2,0,1,4,16,-5,1,Julius Randle,NYK,MIL,NYK,,,33,28,21,17
22023,203944,22300120,"NOV 01, 2023",NYK vs. CLE,L,35,3,15,0.2,0,6,0.0,0,0,0.0,0,6,6,4,1,0,3,2,6,-4,1,Julius Randle,NYK,NYK,CLE,,,16,12,10,10
22023,203944,22300112,"OCT 31, 2023",NYK @ CLE,W,31,5,14,0.357,2,5,0.4,7,10,0.7,3,7,10,2,1,0,1,1,19,18,1,Julius Randle,NYK,CLE,NYK,,,31,29,21,12
22023,203944,22300090,"OCT 28, 2023",NYK @ NOP,L,34,4,15,0.267,0,5,0.0,2,2,1.0,0,12,12,4,0,0,8,4,10,-11,1,Julius Randle,NYK,NOP,NYK,,,26,22,14,16
22023,203944,22300079,"OCT 27, 2023",NYK @ ATL,W,34,4,10,0.4,3,7,0.429,6,8,0.75,2,10,12,9,0,0,3,3,17,7,1,Julius Randle,NYK,ATL,NYK,,,38,29,26,21
22023,203944,22300065,"OCT 25, 2023",NYK vs. BOS,L,34,5,22,0.227,3,8,0.375,1,5,0.2,4,7,11,7,2,0,0,3,14,-13,1,Julius Randle,NYK,NYK,BOS,,,32,25,21,18
22023,1641871,22300554,"JAN 14, 2024",POR vs. PHX,L,39,7,15,0.467,2,6,0.333,1,1,1.0,2,4,6,1,2,1,2,4,17,-2,1,Duop Reath,POR,POR,PHX,,,24,23,18,7
22023,1641871,22300538,"JAN 12, 2024",POR @ MIN,L,24,6,14,0.429,2,6,0.333,0,3,0.0,3,3,6,0,1,1,1,4,14,-20,1,Duop Reath,POR,MIN,POR,,,20,20,14,6
22023,1641871,22300529,"JAN 11, 2024",POR @ OKC,L,24,3,9,0.333,1,4,0.25,1,2,0.5,2,5,7,2,0,1,0,2,8,-49,1,Duop Reath,POR,OKC,POR,,,17,15,10,9
22023,1641871,22300514,"JAN 09, 2024",POR @ NYK,L,21,3,6,0.5,1,3,0.333,0,0,0.0,1,5,6,0,0,0,0,2,7,-20,1,Duop Reath,POR,NYK,POR,,,13,13,7,6
22023,1641871,22300498,"JAN 07, 2024",POR @ BKN,W,41,5,10,0.5,3,4,0.75,2,3,0.667,3,10,13,1,1,3,1,4,15,4,1,Duop Reath,POR,BKN,POR,,,29,28,16,14
22023,1641871,22300487,"JAN 05, 2024",POR @ DAL,L,27,7,12,0.583,1,3,0.333,1,2,0.5,4,3,7,2,0,0,3,3,16,-16,1,Duop Reath,POR,DAL,POR,,,25,23,18,9
22023,1641871,22300472,"JAN 03, 2024",POR @ DAL,L,6,1,2,0.5,0,1,0.0,0,0,0.0,0,2,2,1,0,0,2,4,2,0,1,Duop Reath,POR,DAL,POR,,,5,4,3,3
22023,1641871,22300413,"DEC 26, 2023",POR vs. SAC,W,32,9,15,0.6,3,6,0.5,4,4,1.0,5,4,9,0,1,1,1,3,25,24,1,Duop Reath,POR,POR,SAC,,,34,34,25,9
22023,1641871,22300399,"DEC 23, 2023",POR @ GSW,L,9,0,2,0.0,0,2,0.0,0,0,0.0,0,1,1,0,0,0,0,3,0,-13,1,Duop Reath,POR,GSW,POR,,,1,1,0,1
22023,1641871,22300381,"DEC 21, 2023",POR vs. WAS,L,10,4,7,0.571,1,1,1.0,1,1,1.0,1,4,5,0,0,1,1,4,10,8,1,Duop Reath,POR,POR,WAS,,,15,15,10,5
22023,1641871,22300363,"DEC 19, 2023",POR vs. PHX,W,4,1,1,1.0,1,1,1.0,0,0,0.0,1,1,2,0,1,0,1,0,3,-3,1,Duop Reath,POR,POR,PHX,,,5,5,3,2
22023,1641871,22300341,"DEC 16, 2023",POR vs. DAL,L,15,3,9,0.333,0,3,0.0,5,5,1.0,3,2,5,1,0,0,0,0,11,-8,1,Duop Reath,POR,POR,DAL,,,17,16,12,6
22023,1641871,22300323,"DEC 14, 2023",POR vs. UTA,L,13,6,11,0.545,3,6,0.5,0,0,0.0,2,3,5,0,1,1,0,1,15,21,1,Duop Reath,POR,POR,UTA,,,20,20,15,5
22023,1641871,22300304,"DEC 11, 2023",POR @ LAC,L,26,4,11,0.364,2,6,0.333,0,0,0.0,2,1,3,4,1,0,1,3,10,0,1,Duop Reath,POR,LAC,POR,,,17,13,14,7
22023,1641871,22301226,"DEC 08, 2023",POR vs. DAL,L,21,4,9,0.444,2,6,0.333,0,0,0.0,2,4,6,1,2,0,1,4,10,2,1,Duop Reath,POR,POR,DAL,,,17,16,11,7
22023,1641871,22301214,"DEC 06, 2023",POR @ GSW,L,22,2,6,0.333,1,5,0.2,5,6,0.833,1,5,6,2,1,1,0,5,10,6,1,Duop Reath,POR,GSW,POR,,,18,16,12,8
22023,1641871,22300289,"DEC 02, 2023",POR @ UTA,L,14,3,8,0.375,1,4,0.25,2,2,1.0,1,0,1,1,0,0,0,0,9,8,1,Duop Reath,POR,UTA,POR,,,11,10,10,2
22023,1641871,22300265,"NOV 30, 2023",POR @ CLE,W,18,4,5,0.8,3,4,0.75,2,2,1.0,1,1,2,2,1,1,1,2,13,14,1,Duop Reath,POR,CLE,POR,,,17,15,15,4
22023,1641871,22300254,"NOV 27, 2023",POR @ IND,W,10,1,1,1.0,1,1,1.0,1,2,0.5,0,2,2,1,0,0,1,1,4,1,1,Duop Reath,POR,IND,POR,,,7,6,5,3
22023,1641871,22300245,"NOV 26, 2023",POR @ MIL,L,12,1,5,0.2,1,4,0.25,0,0,0.0,0,0,0,0,2,0,1,2,3,7,1,Duop Reath,POR,MIL,POR,,,3,3,3,0
22023,1641871,22300237,"NOV 22, 2023",POR vs. UTA,W,20,3,5,0.6,2,4,0.5,0,0,0.0,0,4,4,1,0,1,1,2,8,5,1,Duop Reath,POR,POR,UTA,,,13,12,9,5
22023,1641871,22300041,"NOV 21, 2023",POR @ PHX,L,13,4,6,0.667,2,3,0.667,0,0,0.0,1,0,1,1,2,0,0,1,10,15,1,Duop Reath,POR,PHX,POR,,,12,11,11,2
22023,1641871,22300215,"NOV 19, 2023",POR vs. OKC,L,12,1,6,0.167,0,2,0.0,2,2,1.0,0,2,2,0,0,0,1,2,4,-9,1,Duop Reath,POR,POR,OKC,,,6,6,4,2
22023,1641871,22300036,"NOV 17, 2023",POR vs. LAL,L,10,0,5,0.0,0,4,0.0,0,0,0.0,1,1,2,0,0,0,0,1,0,-6,1,Duop Reath,POR,POR,LAL,,,2,2,0,2
22023,1641871,22300199,"NOV 15, 2023",POR vs. CLE,L,20,6,10,0.6,2,5,0.4,2,2,1.0,2,0,2,3,0,0,1,2,16,0,1,Duop Reath,POR,POR,CLE,,,21,18,19,5
22023,1641871,22300023,"NOV 14, 2023",POR @ UTA,L,10,0,4,0.0,0,3,0.0,0,0,0.0,1,0,1,0,0,0,2,1,0,-5,1,Duop Reath,POR,UTA,POR,,,1,1,0,1
22023,1641871,22300187,"NOV 12, 2023",POR @ LAL,L,14,4,10,0.4,3,8,0.375,0,0,0.0,0,3,3,3,0,1,0,3,11,11,1,Duop Reath,POR,LAL,POR,,,17,14,14,6
22023,1630559,22300565,"JAN 15, 2024",LAL vs. OKC,W,33,6,10,0.6,1,3,0.333,2,2,1.0,0,3,3,7,0,1,2,0,15,9,1,Austin Reaves,LAL,LAL,OKC,,,25,18,22,10
22023,1630559,22300549,"JAN 13, 2024",LAL @ UTA,L,31,7,8,0.875,1,2,0.5,4,6,0.667,1,3,4,2,0,0,1,6,19,-21,1,Austin Reaves,LAL,UTA,LAL,,,25,23,21,6
22023,1630559,22300531,"JAN 11, 2024",LAL vs. PHX,L,30,4,7,0.571,2,3,0.667,3,3,1.0,1,0,1,6,1,0,3,2,13,-23,1,Austin Reaves,LAL,LAL,PHX,,,20,14,19,7
22023,1630559,22300516,"JAN 09, 2024",LAL vs. TOR,W,32,3,10,0.3,1,6,0.167,4,4,1.0,0,3,3,7,1,0,0,2,11,-2,1,Austin Reaves,LAL,LAL,TOR,,,21,14,18,10
22023,1630559,22300505,"JAN 07, 2024",LAL vs. LAC,W,32,2,5,0.4,0,3,0.0,4,5,0.8,0,0,0,2,0,0,2,0,8,-4,1,Austin Reaves,LAL,LAL,LAC,,,10,8,10,2
22023,1630559,22300491,"JAN 05, 2024",LAL vs. MEM,L,40,8,14,0.571,0,3,0.0,3,4,0.75,0,7,7,12,2,0,1,4,19,-23,1,Austin Reaves,LAL,LAL,MEM,,,38,26,31,19
22023,1630559,22300475,"JAN 03, 2024",LAL vs. MIA,L,37,7,12,0.583,2,6,0.333,8,9,0.889,0,5,5,8,0,0,3,2,24,-2,1,Austin Reaves,LAL,LAL,MIA,,,37,29,32,13
22023,1630559,22300446,"DEC 31, 2023",LAL @ NOP,L,36,7,12,0.583,1,5,0.2,5,6,0.833,1,1,2,9,1,1,0,3,20,-19,1,Austin Reaves,LAL,NOP,LAL,,,31,22,29,11
22023,1630559,22300443,"DEC 30, 2023",LAL @ MIN,L,29,2,11,0.182,0,5,0.0,5,6,0.833,1,1,2,0,0,0,1,2,9,2,1,Austin Reaves,LAL,MIN,LAL,,,11,11,9,2
22023,1630559,22300428,"DEC 28, 2023",LAL vs. CHA,W,24,6,8,0.75,2,3,0.667,2,2,1.0,0,2,2,4,1,0,0,4,16,9,1,Austin Reaves,LAL,LAL,CHA,,,22,18,20,6
22023,1630559,22300403,"DEC 25, 2023",LAL vs. BOS,L,28,4,9,0.444,2,3,0.667,1,1,1.0,4,2,6,3,1,0,2,3,11,-1,1,Austin Reaves,LAL,LAL,BOS,,,20,17,14,9
22023,1630559,22300397,"DEC 23, 2023",LAL @ OKC,W,28,4,8,0.5,2,5,0.4,1,1,1.0,0,3,3,9,0,0,1,3,11,-2,1,Austin Reaves,LAL,OKC,LAL,,,23,14,20,12
22023,1630559,22300380,"DEC 21, 2023",LAL @ MIN,L,27,7,14,0.5,1,4,0.25,5,5,1.0,2,6,8,5,2,0,4,2,20,-9,1,Austin Reaves,LAL,MIN,LAL,,,33,28,25,13
22023,1630559,22300370,"DEC 20, 2023",LAL @ CHI,L,28,9,14,0.643,2,5,0.4,1,1,1.0,0,0,0,3,1,1,3,1,21,-22,1,Austin Reaves,LAL,CHI,LAL,,,24,21,24,3
22023,1630559,22300359,"DEC 18, 2023",LAL vs. NYK,L,33,6,15,0.4,3,7,0.429,5,5,1.0,0,3,3,7,1,0,4,2,20,7,1,Austin Reaves,LAL,LAL,NYK,,,30,23,27,10
22023,1630559,22300331,"DEC 15, 2023",LAL @ SAS,L,34,8,18,0.444,4,10,0.4,2,2,1.0,2,5,7,4,0,0,2,0,22,-8,1,Austin Reaves,LAL,SAS,LAL,,,33,29,26,11
22023,1630559,22300316,"DEC 13, 2023",LAL @ SAS,W,29,6,10,0.6,3,6,0.5,0,0,0.0,2,2,4,8,1,0,1,2,15,-9,1,Austin Reaves,LAL,SAS,LAL,,,27,19,23,12
22023,1630559,22300306,"DEC 12, 2023",LAL @ DAL,L,32,7,14,0.5,4,7,0.571,4,5,0.8,0,5,5,8,0,0,3,2,22,4,1,Austin Reaves,LAL,DAL,LAL,,,35,27,30,13
22023,1630559,22301230,"DEC 07, 2023",LAL vs. NOP,W,23,5,9,0.556,3,6,0.5,4,4,1.0,0,5,5,7,1,0,2,0,17,21,1,Austin Reaves,LAL,LAL,NOP,,,29,22,24,12
22023,1630559,22301203,"DEC 05, 2023",LAL vs. PHX,W,27,7,16,0.438,3,8,0.375,3,3,1.0,2,4,6,2,0,0,3,1,20,17,1,Austin Reaves,LAL,LAL,PHX,,,28,26,22,8
22023,1630559,22300291,"DEC 02, 2023",LAL vs. HOU,W,22,6,11,0.545,1,4,0.25,5,6,0.833,1,3,4,1,3,0,1,2,18,15,1,Austin Reaves,LAL,LAL,HOU,,,23,22,19,5
22023,1630559,22300271,"NOV 30, 2023",LAL @ OKC,L,29,5,9,0.556,1,4,0.25,3,3,1.0,0,2,2,3,0,0,2,2,14,-23,1,Austin Reaves,LAL,OKC,LAL,,,19,16,17,5
22023,1630559,22300258,"NOV 29, 2023",LAL @ DET,W,24,3,8,0.375,0,4,0.0,0,0,0.0,1,2,3,4,0,1,2,2,6,13,1,Austin Reaves,LAL,DET,LAL,,,13,9,10,7
22023,1630559,22300255,"NOV 27, 2023",LAL @ PHI,L,29,4,10,0.4,1,4,0.25,3,3,1.0,0,2,2,2,0,0,3,2,12,-19,1,Austin Reaves,LAL,PHI,LAL,,,16,14,14,4
22023,1630559,22300242,"NOV 25, 2023",LAL @ CLE,W,32,4,8,0.5,1,2,0.5,6,6,1.0,1,4,5,10,2,0,2,1,15,-2,1,Austin Reaves,LAL,CLE,LAL,,,30,20,25,15
22023,1630559,22300238,"NOV 22, 2023",LAL vs. DAL,L,31,7,14,0.5,1,5,0.2,2,3,0.667,1,5,6,6,0,0,2,5,17,-3,1,Austin Reaves,LAL,LAL,DAL,,,29,23,23,12
22023,1630559,22300042,"NOV 21, 2023",LAL vs. UTA,W,26,7,13,0.538,1,4,0.25,4,4,1.0,0,5,5,5,3,0,2,0,19,10,1,Austin Reaves,LAL,LAL,UTA,,,29,24,24,10
22023,1630559,22300216,"NOV 19, 2023",LAL vs. HOU,W,25,5,7,0.714,2,3,0.667,5,6,0.833,0,6,6,6,0,0,2,0,17,9,1,Austin Reaves,LAL,LAL,HOU,,,29,23,23,12
22023,1630559,22300036,"NOV 17, 2023",LAL @ POR,W,18,1,4,0.25,0,0,0.0,5,6,0.833,1,1,2,4,0,0,3,0,7,11,1,Austin Reaves,LAL,POR,LAL,,,13,9,11,6
22023,1630559,22300198,"NOV 15, 2023",LAL vs. SAC,L,34,4,10,0.4,0,5,0.0,1,2,0.5,2,9,11,8,1,0,4,1,9,0,1,Austin Reaves,LAL,LAL,SAC,,,28,20,17,19
22023,1630559,22300026,"NOV 14, 2023",LAL vs. MEM,W,29,5,9,0.556,4,4,1.0,2,3,0.667,2,10,12,7,0,0,3,0,16,13,1,Austin Reaves,LAL,LAL,MEM,,,35,28,23,19
22023,1630559,22300187,"NOV 12, 2023",LAL vs. POR,W,28,6,12,0.5,2,4,0.5,4,4,1.0,0,4,4,4,0,0,1,0,18,3,1,Austin Reaves,LAL,LAL,POR,,,26,22,22,8
22023,1630559,22300015,"NOV 10, 2023",LAL @ PHX,W,35,6,11,0.545,2,4,0.5,1,1,1.0,0,1,1,7,1,0,2,1,15,-2,1,Austin Reaves,LAL,PHX,LAL,,,23,16,22,8
22023,1630559,22300163,"NOV 08, 2023",LAL @ HOU,L,26,2,9,0.222,0,4,0.0,3,3,1.0,0,1,1,4,2,0,2,1,7,-28,1,Austin Reaves,LAL,HOU,LAL,,,12,8,11,5
22023,1630559,22300150,"NOV 06, 2023",LAL @ MIA,L,40,9,14,0.643,3,8,0.375,2,3,0.667,3,7,10,9,1,0,4,1,23,2,1,Austin Reaves,LAL,MIA,LAL,,,42,33,32,19
22023,1630559,22300134,"NOV 04, 2023",LAL @ ORL,L,34,7,11,0.636,3,5,0.6,3,4,0.75,0,2,2,2,2,0,1,0,20,6,1,Austin Reaves,LAL,ORL,LAL,,,24,22,22,4
22023,1630559,22300127,"NOV 01, 2023",LAL vs. LAC,W,38,5,13,0.385,0,3,0.0,5,5,1.0,2,5,7,7,3,0,5,4,15,-5,1,Austin Reaves,LAL,LAL,LAC,,,29,22,22,14
22023,1630559,22300111,"OCT 30, 2023",LAL vs. ORL,W,31,5,12,0.417,1,4,0.25,0,0,0.0,0,3,3,3,0,1,3,0,11,-14,1,Austin Reaves,LAL,LAL,ORL,,,17,14,14,6
22023,1630559,22300100,"OCT 29, 2023",LAL @ SAC,L,28,1,12,0.083,1,8,0.125,2,2,1.0,0,2,2,2,1,0,3,2,5,-12,1,Austin Reaves,LAL,SAC,LAL,,,9,7,7,4
22023,1630559,22300076,"OCT 26, 2023",LAL vs. PHX,W,28,4,7,0.571,1,2,0.5,1,2,0.5,1,1,2,1,1,0,1,5,10,-11,1,Austin Reaves,LAL,LAL,PHX,,,13,12,11,3
22023,1630559,22300061,"OCT 24, 2023",LAL @ DEN,L,31,4,11,0.364,1,2,0.5,5,7,0.714,4,4,8,4,2,0,2,2,14,-14,1,Austin Reaves,LAL,DEN,LAL,,,26,22,18,12
22023,1629629,22300549,"JAN 13, 2024",LAL @ UTA,L,11,0,1,0.0,0,1,0.0,0,0,0.0,0,1,1,0,0,0,0,0,0,3,1,Cam Reddish,LAL,UTA,LAL,,,1,1,0,1
22023,1629629,22300531,"JAN 11, 2024",LAL vs. PHX,L,8,0,1,0.0,0,1,0.0,0,0,0.0,0,0,0,0,0,0,0,1,0,-5,1,Cam Reddish,LAL,LAL,PHX,,,0,0,0,0
22023,1629629,22300516,"JAN 09, 2024",LAL vs. TOR,W,23,4,7,0.571,4,6,0.667,1,2,0.5,0,1,1,0,1,1,2,1,13,-7,1,Cam Reddish,LAL,LAL,TOR,,,14,14,13,1
22023,1629629,22300505,"JAN 07, 2024",LAL vs. LAC,W,20,2,6,0.333,2,3,0.667,1,2,0.5,1,3,4,1,2,0,5,1,7,-8,1,Cam Reddish,LAL,LAL,LAC,,,12,11,8,5
22023,1629629,22300491,"JAN 05, 2024",LAL vs. MEM,L,32,3,8,0.375,2,3,0.667,0,0,0.0,1,1,2,0,1,0,0,0,8,-20,1,Cam Reddish,LAL,LAL,MEM,,,10,10,8,2
22023,1629629,22300475,"JAN 03, 2024",LAL vs. MIA,L,19,0,1,0.0,0,1,0.0,0,0,0.0,0,0,0,1,0,0,4,2,0,-7,1,Cam Reddish,LAL,LAL,MIA,,,1,0,1,1
22023,1629629,22300443,"DEC 30, 2023",LAL @ MIN,L,22,2,7,0.286,0,1,0.0,0,0,0.0,1,2,3,4,0,0,0,0,4,1,1,Cam Reddish,LAL,MIN,LAL,,,11,7,8,7
22023,1629629,22300403,"DEC 25, 2023",LAL vs. BOS,L,18,1,2,0.5,1,1,1.0,2,2,1.0,0,0,0,0,0,0,2,2,5,-12,1,Cam Reddish,LAL,LAL,BOS,,,5,5,5,0
22023,1629629,22300397,"DEC 23, 2023",LAL @ OKC,W,28,2,7,0.286,0,4,0.0,0,0,0.0,1,3,4,7,1,0,0,2,4,13,1,Cam Reddish,LAL,OKC,LAL,,,15,8,11,11
22023,1629629,22300380,"DEC 21, 2023",LAL @ MIN,L,37,3,8,0.375,0,2,0.0,2,2,1.0,1,0,1,2,1,0,1,1,8,-6,1,Cam Reddish,LAL,MIN,LAL,,,11,9,10,3
22023,1629629,22300370,"DEC 20, 2023",LAL @ CHI,L,28,5,14,0.357,3,8,0.375,0,0,0.0,1,3,4,2,2,0,1,1,13,-1,1,Cam Reddish,LAL,CHI,LAL,,,19,17,15,6
22023,1629629,22300359,"DEC 18, 2023",LAL vs. NYK,L,27,2,9,0.222,0,4,0.0,0,0,0.0,1,1,2,1,3,0,0,5,4,-6,1,Cam Reddish,LAL,LAL,NYK,,,7,6,5,3
22023,1629629,22300316,"DEC 13, 2023",LAL @ SAS,W,24,4,7,0.571,2,3,0.667,0,0,0.0,0,2,2,3,3,1,1,0,10,12,1,Cam Reddish,LAL,SAS,LAL,,,15,12,13,5
22023,1629629,22300306,"DEC 12, 2023",LAL @ DAL,L,22,2,4,0.5,0,0,0.0,0,0,0.0,1,2,3,2,0,1,2,3,4,-10,1,Cam Reddish,LAL,DAL,LAL,,,9,7,6,5
22023,1629629,22301230,"DEC 07, 2023",LAL vs. NOP,W,23,3,6,0.5,1,2,0.5,2,2,1.0,2,3,5,2,0,0,1,1,9,31,1,Cam Reddish,LAL,LAL,NOP,,,16,14,11,7
22023,1629629,22301203,"DEC 05, 2023",LAL vs. PHX,W,30,0,4,0.0,0,2,0.0,4,4,1.0,1,1,2,1,1,0,0,4,4,-7,1,Cam Reddish,LAL,LAL,PHX,,,7,6,5,3
22023,1629629,22300291,"DEC 02, 2023",LAL vs. HOU,W,24,4,7,0.571,0,1,0.0,3,3,1.0,1,4,5,1,0,1,0,3,11,-1,1,Cam Reddish,LAL,LAL,HOU,,,17,16,12,6
22023,1629629,22300258,"NOV 29, 2023",LAL @ DET,W,20,0,3,0.0,0,2,0.0,0,0,0.0,0,3,3,2,0,0,1,2,0,13,1,Cam Reddish,LAL,DET,LAL,,,5,3,2,5
22023,1629629,22300042,"NOV 21, 2023",LAL vs. UTA,W,5,0,0,0.0,0,0,0.0,0,0,0.0,0,0,0,0,0,0,0,1,0,4,1,Cam Reddish,LAL,LAL,UTA,,,0,0,0,0
22023,1629629,22300216,"NOV 19, 2023",LAL vs. HOU,W,39,3,9,0.333,1,5,0.2,0,0,0.0,0,3,3,3,3,0,1,2,7,13,1,Cam Reddish,LAL,LAL,HOU,,,13,10,10,6
22023,1629629,22300036,"NOV 17, 2023",LAL @ POR,W,31,2,4,0.5,1,2,0.5,3,4,0.75,1,1,2,1,3,1,1,0,8,1,1,Cam Reddish,LAL,POR,LAL,,,11,10,9,3
22023,1629629,22300198,"NOV 15, 2023",LAL vs. SAC,L,32,7,14,0.5,2,5,0.4,0,0,0.0,0,2,2,0,5,0,1,1,16,0,1,Cam Reddish,LAL,LAL,SAC,,,18,18,16,2
22023,1629629,22300026,"NOV 14, 2023",LAL vs. MEM,W,25,3,7,0.429,3,5,0.6,1,2,0.5,0,1,1,2,0,0,0,2,10,16,1,Cam Reddish,LAL,LAL,MEM,,,13,11,12,3
22023,1629629,22300187,"NOV 12, 2023",LAL vs. POR,W,38,7,10,0.7,1,3,0.333,3,3,1.0,1,6,7,2,3,1,1,1,18,10,1,Cam Reddish,LAL,LAL,POR,,,27,25,20,9
22023,1629629,22300015,"NOV 10, 2023",LAL @ PHX,W,28,5,10,0.5,5,8,0.625,2,2,1.0,1,2,3,0,3,0,0,3,17,7,1,Cam Reddish,LAL,PHX,LAL,,,20,20,17,3
22023,1629629,22300163,"NOV 08, 2023",LAL @ HOU,L,25,2,7,0.286,0,3,0.0,3,4,0.75,0,1,1,0,3,0,0,0,7,-20,1,Cam Reddish,LAL,HOU,LAL,,,8,8,7,1
22023,1629629,22300150,"NOV 06, 2023",LAL @ MIA,L,29,2,5,0.4,0,0,0.0,3,4,0.75,2,2,4,2,1,0,2,0,7,-4,1,Cam Reddish,LAL,MIA,LAL,,,13,11,9,6
22023,1629629,22300134,"NOV 04, 2023",LAL @ ORL,L,24,1,5,0.2,0,1,0.0,0,0,0.0,0,3,3,0,0,0,1,4,2,-15,1,Cam Reddish,LAL,ORL,LAL,,,5,5,2,3
22023,1629629,22300127,"NOV 01, 2023",LAL vs. LAC,W,37,2,7,0.286,1,5,0.2,3,4,0.75,0,4,4,4,3,1,0,5,8,-4,1,Cam Reddish,LAL,LAL,LAC,,,16,12,12,8
22023,1629629,22300111,"OCT 30, 2023",LAL vs. ORL,W,14,0,1,0.0,0,1,0.0,0,0,0.0,0,2,2,2,1,0,1,0,0,-3,1,Cam Reddish,LAL,LAL,ORL,,,4,2,2,4
22023,1629629,22300100,"OCT 29, 2023",LAL @ SAC,L,5,0,2,0.0,0,1,0.0,0,0,0.0,0,1,1,0,0,0,0,0,0,-7,1,Cam Reddish,LAL,SAC,LAL,,,1,1,0,1
22023,1629629,22300076,"OCT 26, 2023",LAL vs. PHX,W,12,2,5,0.4,0,3,0.0,0,0,0.0,0,1,1,0,0,0,1,2,4,-12,1,Cam Reddish,LAL,LAL,PHX,,,5,5,4,1
22023,1629629,22300061,"OCT 24, 2023",LAL @ DEN,L,18,2,4,0.5,1,2,0.5,2,2,1.0,2,2,4,0,0,1,0,2,7,7,1,Cam Reddish,LAL,DEN,LAL,,,11,11,7,4
22023,1630194,22300555,"JAN 15, 2024",PHI vs. HOU,W,17,3,4,0.75,0,0,0.0,1,2,0.5,2,2,4,2,0,1,1,0,7,2,1,Paul Reed,PHI,PHI,HOU,,,13,11,9,6
22023,1630194,22300532,"JAN 12, 2024",PHI vs. SAC,W,24,3,9,0.333,0,1,0.0,2,2,1.0,5,3,8,2,2,3,0,4,8,9,1,Paul Reed,PHI,PHI,SAC,,,18,16,10,10
22023,1630194,22300521,"JAN 10, 2024",PHI @ ATL,L,19,4,8,0.5,0,1,0.0,1,1,1.0,1,8,9,2,1,2,0,2,9,-2,1,Paul Reed,PHI,ATL,PHI,,,20,18,11,11
22023,1630194,22300495,"JAN 06, 2024",PHI vs. UTA,L,25,7,12,0.583,0,0,0.0,2,4,0.5,3,3,6,1,0,0,1,1,16,-7,1,Paul Reed,PHI,PHI,UTA,,,23,22,17,7
22023,1630194,22300483,"JAN 05, 2024",PHI vs. NYK,L,12,3,5,0.6,0,0,0.0,0,0,0.0,0,1,1,0,0,0,0,2,6,-7,1,Paul Reed,PHI,PHI,NYK,,,7,7,6,1
22023,1630194,22300459,"JAN 02, 2024",PHI vs. CHI,W,13,1,3,0.333,0,0,0.0,0,0,0.0,0,4,4,0,2,0,0,2,2,-9,1,Paul Reed,PHI,PHI,CHI,,,6,6,2,4
22023,1630194,22300442,"DEC 30, 2023",PHI @ CHI,L,28,4,10,0.4,1,2,0.5,2,2,1.0,4,3,7,3,4,1,1,3,11,-7,1,Paul Reed,PHI,CHI,PHI,,,21,18,14,10
22023,1630194,22300434,"DEC 29, 2023",PHI @ HOU,W,24,3,5,0.6,0,0,0.0,1,2,0.5,2,0,2,4,1,0,0,3,7,-6,1,Paul Reed,PHI,HOU,PHI,,,13,9,11,6
22023,1630194,22300415,"DEC 27, 2023",PHI @ ORL,W,32,6,11,0.545,1,1,1.0,2,3,0.667,5,5,10,3,1,3,2,4,15,8,1,Paul Reed,PHI,ORL,PHI,,,28,25,18,13
22023,1630194,22300404,"DEC 25, 2023",PHI @ MIA,L,17,2,3,0.667,0,1,0.0,0,2,0.0,0,2,2,1,0,1,0,5,4,12,1,Paul Reed,PHI,MIA,PHI,,,7,6,5,3
22023,1630194,22300382,"DEC 22, 2023",PHI vs. TOR,W,13,1,2,0.5,0,1,0.0,2,2,1.0,1,3,4,0,1,1,0,2,4,8,1,Paul Reed,PHI,PHI,TOR,,,8,8,4,4
22023,1630194,22300367,"DEC 20, 2023",PHI vs. MIN,W,12,3,5,0.6,0,0,0.0,2,2,1.0,4,4,8,3,3,1,2,3,8,11,1,Paul Reed,PHI,PHI,MIN,,,19,16,11,11
22023,1630194,22300351,"DEC 18, 2023",PHI vs. CHI,L,12,3,5,0.6,0,1,0.0,2,2,1.0,2,2,4,1,1,1,0,2,8,-4,1,Paul Reed,PHI,PHI,CHI,,,13,12,9,5
22023,1630194,22300335,"DEC 16, 2023",PHI @ CHA,W,14,2,4,0.5,0,0,0.0,0,0,0.0,1,2,3,1,0,1,0,1,4,11,1,Paul Reed,PHI,CHA,PHI,,,8,7,5,4
22023,1630194,22300327,"DEC 15, 2023",PHI vs. DET,W,12,0,1,0.0,0,0,0.0,0,0,0.0,2,3,5,2,0,0,2,1,0,11,1,Paul Reed,PHI,PHI,DET,,,7,5,2,7
22023,1630194,22300310,"DEC 13, 2023",PHI @ DET,W,13,1,3,0.333,0,0,0.0,3,3,1.0,1,3,4,0,0,0,3,2,5,-4,1,Paul Reed,PHI,DET,PHI,,,9,9,5,4
22023,1630194,22300295,"DEC 11, 2023",PHI vs. WAS,W,13,2,2,1.0,0,0,0.0,0,1,0.0,2,4,6,3,0,1,0,3,4,12,1,Paul Reed,PHI,PHI,WAS,,,13,10,7,9
22023,1630194,22301218,"DEC 08, 2023",PHI vs. ATL,W,6,1,2,0.5,0,0,0.0,0,0,0.0,2,2,4,0,0,0,3,1,2,-3,1,Paul Reed,PHI,PHI,ATL,,,6,6,2,4
22023,1630194,22301208,"DEC 06, 2023",PHI @ WAS,W,10,0,1,0.0,0,1,0.0,0,0,0.0,0,1,1,0,0,0,0,3,0,-3,1,Paul Reed,PHI,WAS,PHI,,,1,1,0,1
22023,1630194,22300275,"DEC 01, 2023",PHI @ BOS,L,22,6,7,0.857,1,1,1.0,1,1,1.0,0,4,4,1,0,1,1,3,14,-6,1,Paul Reed,PHI,BOS,PHI,,,19,18,15,5
22023,1630194,22300262,"NOV 29, 2023",PHI @ NOP,L,27,3,4,0.75,0,1,0.0,3,3,1.0,2,2,4,5,1,0,3,4,9,1,1,Paul Reed,PHI,NOP,PHI,,,18,13,14,9
22023,1630194,22300255,"NOV 27, 2023",PHI vs. LAL,W,17,4,5,0.8,1,1,1.0,0,0,0.0,1,2,3,0,2,0,0,1,9,33,1,Paul Reed,PHI,PHI,LAL,,,12,12,9,3
22023,1630194,22300239,"NOV 25, 2023",PHI @ OKC,W,11,2,4,0.5,1,1,1.0,0,0,0.0,2,1,3,0,0,0,2,1,5,-3,1,Paul Reed,PHI,OKC,PHI,,,8,8,5,3
22023,1630194,22300232,"NOV 22, 2023",PHI @ MIN,L,26,5,9,0.556,0,0,0.0,0,0,0.0,6,3,9,1,2,4,1,4,10,-10,1,Paul Reed,PHI,MIN,PHI,,,20,19,11,10
22023,1630194,22300040,"NOV 21, 2023",PHI vs. CLE,L,9,2,4,0.5,0,0,0.0,0,0,0.0,2,1,3,0,1,0,0,1,4,-5,1,Paul Reed,PHI,PHI,CLE,,,7,7,4,3
22023,1630194,22300208,"NOV 19, 2023",PHI @ BKN,W,14,0,4,0.0,0,1,0.0,0,0,0.0,1,3,4,1,0,2,0,2,0,-6,1,Paul Reed,PHI,BKN,PHI,,,5,4,1,5
22023,1630194,22300029,"NOV 17, 2023",PHI @ ATL,W,11,1,3,0.333,0,0,0.0,0,0,0.0,1,1,2,0,0,0,0,1,2,-6,1,Paul Reed,PHI,ATL,PHI,,,4,4,2,2
22023,1630194,22300194,"NOV 15, 2023",PHI vs. BOS,L,14,4,5,0.8,1,1,1.0,1,2,0.5,3,3,6,2,0,1,1,1,10,15,1,Paul Reed,PHI,PHI,BOS,,,18,16,12,8
22023,1630194,22300019,"NOV 14, 2023",PHI vs. IND,L,10,1,1,1.0,0,0,0.0,0,0,0.0,1,0,1,1,0,1,1,1,2,3,1,Paul Reed,PHI,PHI,IND,,,4,3,3,2
22023,1630194,22300180,"NOV 12, 2023",PHI vs. IND,W,15,2,4,0.5,0,0,0.0,0,0,0.0,2,4,6,3,1,0,0,2,4,12,1,Paul Reed,PHI,PHI,IND,,,13,10,7,9
22023,1630194,22300008,"NOV 10, 2023",PHI @ DET,W,12,1,2,0.5,0,0,0.0,0,0,0.0,0,4,4,0,0,0,0,3,2,7,1,Paul Reed,PHI,DET,PHI,,,6,6,2,4
22023,1630194,22300159,"NOV 08, 2023",PHI vs. BOS,W,11,4,5,0.8,0,0,0.0,0,0,0.0,3,1,4,0,1,0,1,0,8,-1,1,Paul Reed,PHI,PHI,BOS,,,12,12,8,4
22023,1630194,22300148,"NOV 06, 2023",PHI vs. WAS,W,14,3,3,1.0,0,0,0.0,0,0,0.0,2,4,6,2,1,0,1,1,6,9,1,Paul Reed,PHI,PHI,WAS,,,14,12,8,8
22023,1630194,22300132,"NOV 04, 2023",PHI vs. PHX,W,15,2,4,0.5,0,0,0.0,0,0,0.0,1,4,5,1,0,0,0,3,4,13,1,Paul Reed,PHI,PHI,PHX,,,10,9,5,6
22023,1630194,22300128,"NOV 02, 2023",PHI vs. TOR,W,12,3,4,0.75,0,0,0.0,0,0,0.0,3,2,5,0,0,1,1,2,6,-5,1,Paul Reed,PHI,PHI,TOR,,,11,11,6,5
22023,1630194,22300098,"OCT 29, 2023",PHI vs. POR,W,17,1,5,0.2,0,2,0.0,0,0,0.0,1,4,5,1,0,1,1,2,2,0,1,Paul Reed,PHI,PHI,POR,,,8,7,3,6
22023,1630194,22300092,"OCT 28, 2023",PHI @ TOR,W,13,2,4,0.5,0,0,0.0,0,0,0.0,2,3,5,0,1,0,1,4,4,9,1,Paul Reed,PHI,TOR,PHI,,,9,9,4,5
22023,1630194,22300075,"OCT 26, 2023",PHI @ MIL,L,12,1,2,0.5,0,1,0.0,1,2,0.5,1,3,4,2,0,1,2,4,3,0,1,Paul Reed,PHI,MIL,PHI,,,9,7,5,6
22023,1629675,22300553,"JAN 14, 2024",MIN vs. LAC,W,14,3,5,0.6,2,3,0.667,0,0,0.0,0,1,1,1,2,0,1,2,8,6,1,Naz Reid,MIN,MIN,LAC,,,10,9,9,2
22023,1629675,22300538,"JAN 12, 2024",MIN vs. POR,W,21,5,10,0.5,2,6,0.333,2,5,0.4,1,2,3,1,2,0,0,2,14,-4,1,Naz Reid,MIN,MIN,POR,,,18,17,15,4
22023,1629675,22300517,"JAN 10, 2024",MIN @ BOS,L,37,7,15,0.467,3,7,0.429,2,2,1.0,3,7,10,3,0,3,1,4,19,2,1,Naz Reid,MIN,BOS,MIN,,,32,29,22,13
22023,1629675,22300513,"JAN 09, 2024",MIN @ ORL,W,21,5,8,0.625,2,4,0.5,1,2,0.5,2,8,10,2,0,0,3,3,13,1,1,Naz Reid,MIN,ORL,MIN,,,25,23,15,12
22023,1629675,22300501,"JAN 07, 2024",MIN @ DAL,L,27,7,12,0.583,1,4,0.25,0,2,0.0,4,5,9,0,0,0,0,2,15,-1,1,Naz Reid,MIN,DAL,MIN,,,24,24,15,9
22023,1629675,22300485,"JAN 05, 2024",MIN @ HOU,W,25,6,11,0.545,3,6,0.5,1,2,0.5,1,6,7,2,0,1,0,1,16,21,1,Naz Reid,MIN,HOU,MIN,,,25,23,18,9
22023,1629675,22300471,"JAN 03, 2024",MIN vs. NOP,L,25,3,8,0.375,2,5,0.4,0,0,0.0,0,6,6,2,0,2,1,2,8,3,1,Naz Reid,MIN,MIN,NOP,,,16,14,10,8
22023,1629675,22300451,"JAN 01, 2024",MIN @ NYK,L,19,2,6,0.333,1,4,0.25,0,0,0.0,0,2,2,0,0,0,0,5,5,-5,1,Naz Reid,MIN,NYK,MIN,,,7,7,5,2
22023,1629675,22300443,"DEC 30, 2023",MIN vs. LAL,W,27,8,11,0.727,2,5,0.4,3,4,0.75,0,5,5,1,2,2,2,3,21,13,1,Naz Reid,MIN,MIN,LAL,,,27,26,22,6
22023,1629675,22300423,"DEC 28, 2023",MIN vs. DAL,W,18,3,5,0.6,3,5,0.6,0,0,0.0,0,4,4,2,0,0,3,4,9,12,1,Naz Reid,MIN,MIN,DAL,,,15,13,11,6
22023,1629675,22300411,"DEC 26, 2023",MIN @ OKC,L,19,2,4,0.5,2,3,0.667,0,0,0.0,1,6,7,0,0,0,4,1,6,-9,1,Naz Reid,MIN,OKC,MIN,,,13,13,6,7
22023,1629675,22300400,"DEC 23, 2023",MIN @ SAC,W,19,2,4,0.5,0,1,0.0,2,2,1.0,0,2,2,2,2,0,1,0,6,-13,1,Naz Reid,MIN,SAC,MIN,,,10,8,8,4
22023,1629675,22300380,"DEC 21, 2023",MIN vs. LAL,W,21,3,9,0.333,3,6,0.5,0,0,0.0,2,3,5,2,1,1,3,6,9,5,1,Naz Reid,MIN,MIN,LAL,,,16,14,11,7
22023,1629675,22300367,"DEC 20, 2023",MIN @ PHI,L,20,4,9,0.444,2,6,0.333,0,0,0.0,1,1,2,1,0,1,4,3,10,-27,1,Naz Reid,MIN,PHI,MIN,,,13,12,11,3
22023,1629675,22300353,"DEC 18, 2023",MIN @ MIA,W,21,5,13,0.385,1,6,0.167,2,2,1.0,1,3,4,1,1,1,1,2,13,2,1,Naz Reid,MIN,MIA,MIN,,,18,17,14,5
22023,1629675,22300338,"DEC 16, 2023",MIN vs. IND,W,27,6,8,0.75,3,5,0.6,2,2,1.0,0,5,5,0,0,0,1,2,17,25,1,Naz Reid,MIN,MIN,IND,,,22,22,17,5
22023,1629675,22300321,"DEC 14, 2023",MIN @ DAL,W,31,8,14,0.571,7,11,0.636,4,4,1.0,2,4,6,3,1,0,2,2,27,16,1,Naz Reid,MIN,DAL,MIN,,,36,33,30,9
22023,1629675,22300301,"DEC 11, 2023",MIN @ NOP,L,24,7,15,0.467,3,7,0.429,0,0,0.0,3,3,6,2,1,0,0,3,17,0,1,Naz Reid,MIN,NOP,MIN,,,25,23,19,8
22023,1629675,22301221,"DEC 08, 2023",MIN @ MEM,W,24,5,12,0.417,0,5,0.0,0,0,0.0,0,9,9,2,1,1,1,2,10,7,1,Naz Reid,MIN,MEM,MIN,,,21,19,12,11
22023,1629675,22301210,"DEC 06, 2023",MIN vs. SAS,W,29,7,18,0.389,1,7,0.143,0,0,0.0,4,5,9,2,0,1,1,2,15,10,1,Naz Reid,MIN,MIN,SAS,,,26,24,17,11
22023,1629675,22300281,"DEC 02, 2023",MIN @ CHA,W,25,9,14,0.643,3,6,0.5,2,2,1.0,2,3,5,2,1,0,2,0,23,-7,1,Naz Reid,MIN,CHA,MIN,,,30,28,25,7
22023,1629675,22300270,"NOV 30, 2023",MIN vs. UTA,W,22,3,9,0.333,0,4,0.0,0,0,0.0,1,2,3,0,1,1,0,2,6,-2,1,Naz Reid,MIN,MIN,UTA,,,9,9,6,3
22023,1629675,22300058,"NOV 28, 2023",MIN vs. OKC,W,25,6,9,0.667,3,4,0.75,0,0,0.0,1,6,7,2,0,2,1,2,15,1,1,Naz Reid,MIN,MIN,OKC,,,24,22,17,9
22023,1629675,22300249,"NOV 26, 2023",MIN @ MEM,W,22,4,9,0.444,1,2,0.5,3,4,0.75,2,4,6,0,1,0,1,4,12,4,1,Naz Reid,MIN,MEM,MIN,,,18,18,12,6
22023,1629675,22300050,"NOV 24, 2023",MIN vs. SAC,L,18,4,7,0.571,1,3,0.333,0,0,0.0,0,1,1,0,0,2,3,0,9,-19,1,Naz Reid,MIN,MIN,SAC,,,10,10,9,1
22023,1629675,22300232,"NOV 22, 2023",MIN vs. PHI,W,22,6,13,0.462,1,4,0.25,0,1,0.0,1,3,4,0,3,1,0,1,13,4,1,Naz Reid,MIN,MIN,PHI,,,17,17,13,4
22023,1629675,22300221,"NOV 20, 2023",MIN vs. NYK,W,18,3,8,0.375,1,6,0.167,3,3,1.0,0,3,3,1,1,0,3,6,10,3,1,Naz Reid,MIN,MIN,NYK,,,14,13,11,4
22023,1629675,22300203,"NOV 18, 2023",MIN @ NOP,W,18,2,8,0.25,2,6,0.333,2,2,1.0,0,1,1,0,0,1,1,0,8,-8,1,Naz Reid,MIN,NOP,MIN,,,9,9,8,1
22023,1629675,22300197,"NOV 15, 2023",MIN @ PHX,L,19,4,7,0.571,1,2,0.5,4,4,1.0,2,2,4,0,1,0,0,0,13,-5,1,Naz Reid,MIN,PHX,MIN,,,17,17,13,4
22023,1629675,22300025,"NOV 14, 2023",MIN @ GSW,W,16,4,5,0.8,2,3,0.667,0,0,0.0,0,2,2,0,0,0,1,4,10,-8,1,Naz Reid,MIN,GSW,MIN,,,12,12,10,2
22023,1629675,22300186,"NOV 12, 2023",MIN @ GSW,W,19,3,8,0.375,2,5,0.4,2,2,1.0,1,5,6,2,0,0,2,2,10,10,1,Naz Reid,MIN,GSW,MIN,,,18,16,12,8
22023,1629675,22300013,"NOV 10, 2023",MIN @ SAS,W,18,3,7,0.429,1,3,0.333,0,0,0.0,1,2,3,0,0,2,0,1,7,7,1,Naz Reid,MIN,SAS,MIN,,,10,10,7,3
22023,1629675,22300166,"NOV 08, 2023",MIN vs. NOP,W,22,4,8,0.5,1,4,0.25,0,0,0.0,1,3,4,0,1,0,0,2,9,17,1,Naz Reid,MIN,MIN,NOP,,,13,13,9,4
22023,1629675,22300154,"NOV 06, 2023",MIN vs. BOS,W,25,5,9,0.556,2,4,0.5,2,2,1.0,1,3,4,2,2,2,3,0,14,-2,1,Naz Reid,MIN,MIN,BOS,,,20,18,16,6
22023,1629675,22300138,"NOV 04, 2023",MIN vs. UTA,W,22,5,9,0.556,3,5,0.6,3,4,0.75,2,3,5,1,0,0,1,0,16,9,1,Naz Reid,MIN,MIN,UTA,,,22,21,17,6
22023,1629675,22300123,"NOV 01, 2023",MIN vs. DEN,W,19,6,9,0.667,1,3,0.333,3,3,1.0,1,4,5,1,1,0,1,0,16,4,1,Naz Reid,MIN,MIN,DEN,,,22,21,17,6
22023,1629675,22300104,"OCT 30, 2023",MIN @ ATL,L,24,5,12,0.417,3,7,0.429,0,0,0.0,0,1,1,0,0,0,1,1,13,-21,1,Naz Reid,MIN,ATL,MIN,,,14,14,13,1
22023,1629675,22300093,"OCT 28, 2023",MIN vs. MIA,W,28,10,14,0.714,4,7,0.571,1,1,1.0,1,7,8,1,2,0,0,3,25,30,1,Naz Reid,MIN,MIN,MIA,,,34,33,26,9
22023,1629675,22300069,"OCT 25, 2023",MIN @ TOR,L,24,3,8,0.375,0,2,0.0,4,4,1.0,1,3,4,1,0,0,1,0,10,1,1,Naz Reid,MIN,TOR,MIN,,,15,14,11,5
22023,1631197,22300008,"NOV 10, 2023",DET vs. PHI,L,7,2,3,0.667,1,2,0.5,0,0,0.0,0,0,0,0,0,0,1,1,5,2,1,Jared Rhoden,DET,DET,PHI,,,5,5,5,0
22023,1631197,22300165,"NOV 08, 2023",DET @ MIL,L,13,3,4,0.75,0,1,0.0,0,0,0.0,0,1,1,3,0,0,0,2,6,9,1,Jared Rhoden,DET,MIL,DET,,,10,7,9,4
22023,1631197,22300145,"NOV 06, 2023",DET vs. GSW,L,5,0,2,0.0,0,1,0.0,2,2,1.0,1,1,2,0,0,0,1,1,2,-9,1,Jared Rhoden,DET,DET,GSW,,,4,4,2,2
22023,1631197,22300140,"NOV 05, 2023",DET vs. PHX,L,3,0,0,0.0,0,0,0.0,0,0,0.0,0,0,0,0,0,0,0,0,0,5,1,Jared Rhoden,DET,DET,PHX,,,0,0,0,0
22023,1631197,22300109,"OCT 30, 2023",DET @ OKC,L,2,0,0,0.0,0,0,0.0,0,0,0.0,0,1,1,0,0,0,0,0,0,8,1,Jared Rhoden,DET,OKC,DET,,,1,1,0,1
22023,1630208,22300551,"JAN 14, 2024",CHA @ MIA,L,27,1,5,0.2,0,0,0.0,0,0,0.0,0,8,8,0,0,0,1,4,2,-15,1,Nick Richards,CHA,MIA,CHA,,,10,10,2,8
22023,1630208,22300541,"JAN 12, 2024",CHA @ SAS,L,22,5,8,0.625,0,0,0.0,2,2,1.0,5,3,8,1,0,1,0,3,12,-19,1,Nick Richards,CHA,SAS,CHA,,,21,20,13,9
22023,1630208,22300518,"JAN 10, 2024",CHA vs. SAC,L,26,3,5,0.6,0,0,0.0,2,2,1.0,4,5,9,3,0,1,1,3,8,1,1,Nick Richards,CHA,CHA,SAC,,,20,17,11,12
22023,1630208,22300506,"JAN 08, 2024",CHA vs. CHI,L,39,5,6,0.833,0,0,0.0,0,0,0.0,1,7,8,1,0,3,0,4,10,-8,1,Nick Richards,CHA,CHA,CHI,,,19,18,11,9
22023,1630208,22300484,"JAN 05, 2024",CHA @ CHI,L,27,2,6,0.333,0,0,0.0,0,2,0.0,5,7,12,1,0,0,2,4,4,-4,1,Nick Richards,CHA,CHI,CHA,,,17,16,5,13
22023,1630208,22300464,"JAN 02, 2024",CHA @ SAC,W,26,3,4,0.75,0,0,0.0,1,2,0.5,1,9,10,1,1,2,2,2,7,2,1,Nick Richards,CHA,SAC,CHA,,,18,17,8,11
22023,1630208,22300455,"JAN 01, 2024",CHA @ DEN,L,30,7,12,0.583,0,0,0.0,1,2,0.5,2,6,8,1,1,1,0,2,15,-29,1,Nick Richards,CHA,DEN,CHA,,,24,23,16,9
22023,1630208,22300436,"DEC 29, 2023",CHA @ PHX,L,31,3,4,0.75,0,0,0.0,0,0,0.0,1,1,2,0,0,0,0,4,6,-21,1,Nick Richards,CHA,PHX,CHA,,,8,8,6,2
22023,1630208,22300428,"DEC 28, 2023",CHA @ LAL,L,26,5,5,1.0,0,0,0.0,1,3,0.333,3,7,10,1,2,2,0,3,11,-6,1,Nick Richards,CHA,LAL,CHA,,,22,21,12,11
22023,1630208,22300414,"DEC 26, 2023",CHA @ LAC,L,33,5,6,0.833,0,0,0.0,3,4,0.75,2,8,10,2,0,1,1,2,13,-21,1,Nick Richards,CHA,LAC,CHA,,,25,23,15,12
22023,1630208,22300390,"DEC 23, 2023",CHA vs. DEN,L,38,4,8,0.5,0,0,0.0,4,6,0.667,6,9,15,3,1,3,3,1,12,-4,1,Nick Richards,CHA,CHA,DEN,,,30,27,15,18
22023,1630208,22300365,"DEC 20, 2023",CHA @ IND,L,19,2,4,0.5,0,0,0.0,0,0,0.0,6,2,8,0,0,0,0,3,4,-12,1,Nick Richards,CHA,IND,CHA,,,12,12,4,8
22023,1630208,22300354,"DEC 18, 2023",CHA @ TOR,L,32,4,5,0.8,0,0,0.0,2,2,1.0,4,6,10,3,0,0,0,2,10,-3,1,Nick Richards,CHA,TOR,CHA,,,23,20,13,13
22023,1630208,22300335,"DEC 16, 2023",CHA vs. PHI,L,19,4,6,0.667,0,0,0.0,0,0,0.0,2,2,4,1,1,2,1,3,8,-8,1,Nick Richards,CHA,CHA,PHI,,,13,12,9,5
22023,1630208,22300326,"DEC 15, 2023",CHA vs. NOP,L,30,7,7,1.0,0,0,0.0,2,2,1.0,1,5,6,1,0,1,0,5,16,6,1,Nick Richards,CHA,CHA,NOP,,,23,22,17,7
22023,1630208,22300312,"DEC 13, 2023",CHA @ MIA,L,40,3,5,0.6,0,0,0.0,0,1,0.0,1,9,10,0,0,4,2,1,6,-8,1,Nick Richards,CHA,MIA,CHA,,,16,16,6,10
22023,1630208,22300292,"DEC 11, 2023",CHA vs. MIA,L,26,2,6,0.333,0,0,0.0,2,2,1.0,3,3,6,1,0,0,0,1,6,-14,1,Nick Richards,CHA,CHA,MIA,,,13,12,7,7
22023,1630208,22301216,"DEC 08, 2023",CHA vs. TOR,W,26,5,7,0.714,0,0,0.0,5,6,0.833,2,6,8,0,1,0,1,2,15,7,1,Nick Richards,CHA,CHA,TOR,,,23,23,15,8
22023,1630208,22301211,"DEC 06, 2023",CHA @ CHI,L,28,2,4,0.5,0,0,0.0,2,2,1.0,6,5,11,0,0,3,2,3,6,-11,1,Nick Richards,CHA,CHI,CHA,,,17,17,6,11
22023,1630208,22300281,"DEC 02, 2023",CHA vs. MIN,L,9,1,3,0.333,0,0,0.0,2,2,1.0,1,2,3,1,1,1,0,1,4,-3,1,Nick Richards,CHA,CHA,MIN,,,8,7,5,4
22023,1630208,22300027,"NOV 17, 2023",CHA vs. MIL,L,7,1,2,0.5,0,0,0.0,0,0,0.0,0,1,1,0,0,0,0,0,2,-5,1,Nick Richards,CHA,CHA,MIL,,,3,3,2,1
22023,1630208,22300017,"NOV 14, 2023",CHA vs. MIA,L,25,2,2,1.0,0,0,0.0,6,6,1.0,1,11,12,1,1,0,3,5,10,5,1,Nick Richards,CHA,CHA,MIA,,,23,22,11,13
22023,1630208,22300177,"NOV 12, 2023",CHA @ NYK,L,22,7,9,0.778,0,0,0.0,2,2,1.0,1,3,4,0,0,0,2,4,16,-6,1,Nick Richards,CHA,NYK,CHA,,,20,20,16,4
22023,1630208,22300009,"NOV 10, 2023",CHA @ WAS,W,18,5,5,1.0,0,0,0.0,5,8,0.625,3,4,7,0,1,1,1,4,15,-12,1,Nick Richards,CHA,WAS,CHA,,,22,22,15,7
22023,1630208,22300157,"NOV 08, 2023",CHA vs. WAS,L,16,2,3,0.667,0,0,0.0,3,4,0.75,0,6,6,0,0,0,0,2,7,-9,1,Nick Richards,CHA,CHA,WAS,,,13,13,7,6
22023,1630208,22300143,"NOV 05, 2023",CHA @ DAL,L,21,6,7,0.857,0,0,0.0,0,0,0.0,3,6,9,1,0,1,0,4,12,-5,1,Nick Richards,CHA,DAL,CHA,,,22,21,13,10
22023,1630208,22300133,"NOV 04, 2023",CHA @ IND,W,18,4,4,1.0,0,0,0.0,2,2,1.0,3,7,10,0,0,2,1,1,10,4,1,Nick Richards,CHA,IND,CHA,,,20,20,10,10
22023,1630208,22300122,"NOV 01, 2023",CHA @ HOU,L,19,3,6,0.5,0,0,0.0,4,4,1.0,4,4,8,0,0,4,1,3,10,-9,1,Nick Richards,CHA,HOU,CHA,,,18,18,10,8
22023,1630208,22300101,"OCT 30, 2023",CHA vs. BKN,L,13,1,1,1.0,0,0,0.0,2,2,1.0,0,2,2,1,1,2,1,2,4,-7,1,Nick Richards,CHA,CHA,BKN,,,7,6,5,3
22023,1630208,22300077,"OCT 27, 2023",CHA vs. DET,L,16,0,1,0.0,0,0,0.0,0,2,0.0,1,1,2,0,1,2,2,4,0,1,1,Nick Richards,CHA,CHA,DET,,,2,2,0,2
22023,1630208,22300063,"OCT 25, 2023",CHA vs. ATL,W,18,2,2,1.0,0,0,0.0,3,4,0.75,1,3,4,1,0,1,2,3,7,-14,1,Nick Richards,CHA,CHA,ATL,,,12,11,8,5
22023,1626196,22300562,"JAN 15, 2024",MIA @ BKN,W,28,3,13,0.231,2,6,0.333,1,1,1.0,1,4,5,1,0,1,1,2,9,-11,1,Josh Richardson,MIA,BKN,MIA,,,15,14,10,6
22023,1626196,22300551,"JAN 14, 2024",MIA vs. CHA,W,20,4,8,0.5,2,3,0.667,1,1,1.0,1,1,2,0,0,0,1,1,11,5,1,Josh Richardson,MIA,MIA,CHA,,,13,13,11,2
22023,1626196,22300535,"JAN 12, 2024",MIA vs. ORL,W,25,4,6,0.667,0,1,0.0,1,1,1.0,0,1,1,2,1,0,2,2,9,-5,1,Josh Richardson,MIA,MIA,ORL,,,12,10,11,3
22023,1626196,22300522,"JAN 10, 2024",MIA vs. OKC,L,21,3,7,0.429,2,5,0.4,0,0,0.0,0,1,1,2,1,0,2,2,8,-19,1,Josh Richardson,MIA,MIA,OKC,,,11,9,10,3
22023,1626196,22300509,"JAN 08, 2024",MIA vs. HOU,W,29,4,6,0.667,2,3,0.667,2,2,1.0,0,2,2,2,0,1,0,2,12,1,1,Josh Richardson,MIA,MIA,HOU,,,16,14,14,4
22023,1626196,22300489,"JAN 05, 2024",MIA @ PHX,L,29,2,9,0.222,1,6,0.167,5,5,1.0,1,7,8,7,2,0,0,3,10,-4,1,Josh Richardson,MIA,PHX,MIA,,,25,18,17,15
22023,1626196,22300475,"JAN 03, 2024",MIA @ LAL,W,21,4,7,0.571,2,3,0.667,0,0,0.0,0,1,1,1,0,1,0,3,10,9,1,Josh Richardson,MIA,LAL,MIA,,,12,11,11,2
22023,1626196,22300384,"DEC 22, 2023",MIA vs. ATL,W,29,1,5,0.2,0,4,0.0,1,1,1.0,0,3,3,1,1,0,1,0,3,0,1,Josh Richardson,MIA,MIA,ATL,,,7,6,4,4
22023,1626196,22300366,"DEC 20, 2023",MIA @ ORL,W,34,4,12,0.333,4,8,0.5,0,0,0.0,0,2,2,4,1,1,0,1,12,7,1,Josh Richardson,MIA,ORL,MIA,,,18,14,16,6
22023,1626196,22300353,"DEC 18, 2023",MIA vs. MIN,L,26,4,6,0.667,2,4,0.5,3,3,1.0,0,4,4,3,0,0,1,2,13,-7,1,Josh Richardson,MIA,MIA,MIN,,,20,17,16,7
22023,1626196,22300337,"DEC 16, 2023",MIA vs. CHI,W,20,3,7,0.429,2,5,0.4,0,0,0.0,1,1,2,2,0,0,1,1,8,-12,1,Josh Richardson,MIA,MIA,CHI,,,12,10,10,4
22023,1626196,22300292,"DEC 11, 2023",MIA @ CHA,W,25,0,7,0.0,0,4,0.0,2,2,1.0,0,4,4,4,1,0,0,0,2,-11,1,Josh Richardson,MIA,CHA,MIA,,,10,6,6,8
22023,1626196,22301220,"DEC 08, 2023",MIA vs. CLE,L,31,6,11,0.545,5,7,0.714,0,0,0.0,0,1,1,2,1,0,1,3,17,7,1,Josh Richardson,MIA,MIA,CLE,,,20,18,19,3
22023,1626196,22301207,"DEC 06, 2023",MIA @ TOR,W,30,2,6,0.333,1,4,0.25,2,2,1.0,1,3,4,2,0,0,1,3,7,-7,1,Josh Richardson,MIA,TOR,MIA,,,13,11,9,6
22023,1626196,22300284,"DEC 02, 2023",MIA vs. IND,L,24,6,9,0.667,2,4,0.5,2,2,1.0,0,2,2,3,0,1,2,1,16,-11,1,Josh Richardson,MIA,MIA,IND,,,21,18,19,5
22023,1626196,22300267,"NOV 30, 2023",MIA vs. IND,W,32,8,11,0.727,0,2,0.0,3,4,0.75,1,3,4,3,0,0,2,3,19,22,1,Josh Richardson,MIA,MIA,IND,,,26,23,22,7
22023,1626196,22300056,"NOV 28, 2023",MIA vs. MIL,L,37,7,13,0.538,3,7,0.429,3,4,0.75,1,2,3,7,0,0,0,2,20,-10,1,Josh Richardson,MIA,MIA,MIL,,,30,23,27,10
22023,1626196,22300240,"NOV 25, 2023",MIA @ BKN,L,37,4,11,0.364,0,5,0.0,3,3,1.0,2,3,5,5,0,1,2,1,11,-16,1,Josh Richardson,MIA,BKN,MIA,,,21,16,16,10
22023,1626196,22300045,"NOV 24, 2023",MIA @ NYK,L,34,5,10,0.5,2,4,0.5,3,3,1.0,1,1,2,2,2,0,2,3,15,-7,1,Josh Richardson,MIA,NYK,MIA,,,19,17,17,4
22023,1626196,22300229,"NOV 22, 2023",MIA @ CLE,W,27,5,9,0.556,2,4,0.5,2,2,1.0,1,0,1,5,2,0,0,0,14,13,1,Josh Richardson,MIA,CLE,MIA,,,20,15,19,6
22023,1626196,22300220,"NOV 20, 2023",MIA @ CHI,W,30,4,12,0.333,2,6,0.333,0,0,0.0,2,2,4,1,0,1,3,2,10,11,1,Josh Richardson,MIA,CHI,MIA,,,15,14,11,5
22023,1626196,22300204,"NOV 18, 2023",MIA @ CHI,L,26,3,6,0.5,1,4,0.25,0,0,0.0,0,1,1,2,1,0,0,0,7,-25,1,Josh Richardson,MIA,CHI,MIA,,,10,8,9,3
22023,1626196,22300200,"NOV 16, 2023",MIA vs. BKN,W,26,3,7,0.429,1,5,0.2,1,1,1.0,0,2,2,3,2,0,0,2,8,5,1,Josh Richardson,MIA,MIA,BKN,,,13,10,11,5
22023,1626196,22300017,"NOV 14, 2023",MIA @ CHA,W,33,2,10,0.2,0,6,0.0,2,2,1.0,1,4,5,6,1,1,1,2,6,11,1,Josh Richardson,MIA,CHA,MIA,,,17,11,12,11
22023,1626196,22300184,"NOV 12, 2023",MIA @ SAS,W,26,4,7,0.571,2,4,0.5,2,2,1.0,0,3,3,4,1,0,0,2,12,1,1,Josh Richardson,MIA,SAS,MIA,,,19,15,16,7
22023,1626196,22300175,"NOV 11, 2023",MIA @ ATL,W,23,6,7,0.857,3,4,0.75,1,1,1.0,0,2,2,0,0,0,1,0,16,15,1,Josh Richardson,MIA,ATL,MIA,,,18,18,16,2
22023,1626196,22300164,"NOV 08, 2023",MIA @ MEM,W,17,1,9,0.111,0,5,0.0,0,0,0.0,0,0,0,2,0,1,4,1,2,-19,1,Josh Richardson,MIA,MEM,MIA,,,4,2,4,2
22023,1626196,22300150,"NOV 06, 2023",MIA vs. LAL,W,21,1,2,0.5,1,2,0.5,0,0,0.0,0,2,2,0,0,0,1,4,3,-6,1,Josh Richardson,MIA,MIA,LAL,,,5,5,3,2
22023,1626196,22300003,"NOV 03, 2023",MIA vs. WAS,W,26,4,6,0.667,1,2,0.5,1,1,1.0,0,3,3,5,0,0,2,2,10,-2,1,Josh Richardson,MIA,MIA,WAS,,,18,13,15,8
22023,1626196,22300119,"NOV 01, 2023",MIA vs. BKN,L,30,1,9,0.111,1,5,0.2,1,2,0.5,0,3,3,3,1,0,0,2,4,-13,1,Josh Richardson,MIA,MIA,BKN,,,10,7,7,6
22023,1626196,22300107,"OCT 30, 2023",MIA @ MIL,L,23,3,7,0.429,0,2,0.0,0,0,0.0,0,3,3,2,0,0,0,3,6,4,1,Josh Richardson,MIA,MIL,MIA,,,11,9,8,5
22023,1629130,22300562,"JAN 15, 2024",MIA @ BKN,W,22,0,4,0.0,0,3,0.0,0,0,0.0,0,2,2,2,1,1,2,1,0,-11,1,Duncan Robinson,MIA,BKN,MIA,,,4,2,2,4
22023,1629130,22300551,"JAN 14, 2024",MIA vs. CHA,W,30,7,11,0.636,3,6,0.5,2,2,1.0,0,4,4,5,1,1,2,2,19,12,1,Duncan Robinson,MIA,MIA,CHA,,,28,23,24,9
22023,1629130,22300535,"JAN 12, 2024",MIA vs. ORL,W,41,9,19,0.474,4,10,0.4,1,1,1.0,1,3,4,3,1,0,3,1,23,13,1,Duncan Robinson,MIA,MIA,ORL,,,30,27,26,7
22023,1629130,22300522,"JAN 10, 2024",MIA vs. OKC,L,25,1,8,0.125,1,7,0.143,0,0,0.0,0,1,1,1,2,0,1,0,3,-18,1,Duncan Robinson,MIA,MIA,OKC,,,5,4,4,2
22023,1629130,22300509,"JAN 08, 2024",MIA vs. HOU,W,29,4,12,0.333,3,10,0.3,3,3,1.0,0,3,3,7,1,0,1,6,14,2,1,Duncan Robinson,MIA,MIA,HOU,,,24,17,21,10
22023,1629130,22300489,"JAN 05, 2024",MIA @ PHX,L,27,1,7,0.143,1,6,0.167,1,2,0.5,0,1,1,3,1,1,3,3,4,-3,1,Duncan Robinson,MIA,PHX,MIA,,,8,5,7,4
22023,1629130,22300475,"JAN 03, 2024",MIA @ LAL,W,30,5,14,0.357,3,12,0.25,0,0,0.0,0,0,0,2,1,0,1,3,13,0,1,Duncan Robinson,MIA,LAL,MIA,,,15,13,15,2
22023,1629130,22300458,"JAN 01, 2024",MIA @ LAC,L,26,3,8,0.375,3,7,0.429,6,6,1.0,0,1,1,2,0,0,1,1,15,-3,1,Duncan Robinson,MIA,LAC,MIA,,,18,16,17,3
22023,1629130,22300439,"DEC 30, 2023",MIA @ UTA,L,32,4,8,0.5,3,5,0.6,0,0,0.0,0,4,4,4,2,2,1,4,11,-10,1,Duncan Robinson,MIA,UTA,MIA,,,19,15,15,8
22023,1629130,22300426,"DEC 28, 2023",MIA @ GSW,W,30,2,11,0.182,1,6,0.167,0,0,0.0,1,1,2,4,0,0,0,3,5,5,1,Duncan Robinson,MIA,GSW,MIA,,,11,7,9,6
22023,1629130,22300404,"DEC 25, 2023",MIA vs. PHI,W,34,5,13,0.385,5,10,0.5,1,1,1.0,0,4,4,2,1,0,0,3,16,26,1,Duncan Robinson,MIA,MIA,PHI,,,22,20,18,6
22023,1629130,22300384,"DEC 22, 2023",MIA vs. ATL,W,25,8,11,0.727,4,7,0.571,7,7,1.0,1,2,3,3,1,0,2,0,27,14,1,Duncan Robinson,MIA,MIA,ATL,,,33,30,30,6
22023,1629130,22300366,"DEC 20, 2023",MIA @ ORL,W,23,4,5,0.8,1,1,1.0,3,3,1.0,0,3,3,6,0,0,1,3,12,16,1,Duncan Robinson,MIA,ORL,MIA,,,21,15,18,9
22023,1629130,22300353,"DEC 18, 2023",MIA vs. MIN,L,22,5,9,0.556,4,8,0.5,0,0,0.0,0,5,5,3,1,0,2,2,14,-7,1,Duncan Robinson,MIA,MIA,MIN,,,22,19,17,8
22023,1629130,22300337,"DEC 16, 2023",MIA vs. CHI,W,24,3,9,0.333,3,9,0.333,0,0,0.0,0,1,1,6,0,0,2,0,9,-15,1,Duncan Robinson,MIA,MIA,CHI,,,16,10,15,7
22023,1629130,22300320,"DEC 14, 2023",MIA vs. CHI,L,27,4,9,0.444,3,6,0.5,0,2,0.0,0,2,2,3,0,0,1,2,11,-13,1,Duncan Robinson,MIA,MIA,CHI,,,16,13,14,5
22023,1629130,22300312,"DEC 13, 2023",MIA vs. CHA,W,40,7,11,0.636,6,9,0.667,3,3,1.0,0,2,2,3,2,0,4,2,23,15,1,Duncan Robinson,MIA,MIA,CHA,,,28,25,26,5
22023,1629130,22300292,"DEC 11, 2023",MIA @ CHA,W,33,8,14,0.571,5,9,0.556,3,3,1.0,1,6,7,4,2,0,0,0,24,1,1,Duncan Robinson,MIA,CHA,MIA,,,35,31,28,11
22023,1629130,22301220,"DEC 08, 2023",MIA vs. CLE,L,23,0,7,0.0,0,6,0.0,1,2,0.5,0,0,0,1,0,0,6,4,1,-25,1,Duncan Robinson,MIA,MIA,CLE,,,2,1,2,1
22023,1629130,22301207,"DEC 06, 2023",MIA @ TOR,W,32,9,19,0.474,3,10,0.3,0,0,0.0,1,5,6,7,1,0,0,1,21,33,1,Duncan Robinson,MIA,TOR,MIA,,,34,27,28,13
22023,1629130,22300284,"DEC 02, 2023",MIA vs. IND,L,30,7,11,0.636,2,3,0.667,1,1,1.0,1,1,2,3,0,0,2,6,17,-9,1,Duncan Robinson,MIA,MIA,IND,,,22,19,20,5
22023,1629130,22300267,"NOV 30, 2023",MIA vs. IND,W,29,5,9,0.556,4,6,0.667,2,2,1.0,0,1,1,2,1,0,1,3,16,9,1,Duncan Robinson,MIA,MIA,IND,,,19,17,18,3
22023,1629130,22300056,"NOV 28, 2023",MIA vs. MIL,L,31,5,11,0.455,3,7,0.429,0,2,0.0,0,3,3,3,0,1,2,3,13,-14,1,Duncan Robinson,MIA,MIA,MIL,,,19,16,16,6
22023,1629130,22300229,"NOV 22, 2023",MIA @ CLE,W,24,3,7,0.429,1,3,0.333,0,0,0.0,0,2,2,3,0,0,0,3,7,32,1,Duncan Robinson,MIA,CLE,MIA,,,12,9,10,5
22023,1629130,22300220,"NOV 20, 2023",MIA @ CHI,W,30,7,11,0.636,6,9,0.667,2,2,1.0,0,2,2,2,0,0,0,3,22,7,1,Duncan Robinson,MIA,CHI,MIA,,,26,24,24,4
22023,1629130,22300204,"NOV 18, 2023",MIA @ CHI,L,35,5,9,0.556,4,5,0.8,3,4,0.75,0,3,3,7,0,0,1,2,17,3,1,Duncan Robinson,MIA,CHI,MIA,,,27,20,24,10
22023,1629130,22300200,"NOV 16, 2023",MIA vs. BKN,W,38,8,14,0.571,6,10,0.6,4,4,1.0,0,0,0,2,0,0,0,3,26,2,1,Duncan Robinson,MIA,MIA,BKN,,,28,26,28,2
22023,1629130,22300017,"NOV 14, 2023",MIA @ CHA,W,36,6,13,0.462,4,10,0.4,2,2,1.0,0,8,8,5,1,1,1,2,18,1,1,Duncan Robinson,MIA,CHA,MIA,,,31,26,23,13
22023,1629130,22300184,"NOV 12, 2023",MIA @ SAS,W,39,8,16,0.5,4,7,0.571,6,6,1.0,1,4,5,4,0,1,0,1,26,22,1,Duncan Robinson,MIA,SAS,MIA,,,35,31,30,9
22023,1629130,22300175,"NOV 11, 2023",MIA @ ATL,W,30,5,15,0.333,1,10,0.1,0,0,0.0,0,3,3,2,1,0,1,3,11,-1,1,Duncan Robinson,MIA,ATL,MIA,,,16,14,13,5
22023,1629130,22300164,"NOV 08, 2023",MIA @ MEM,W,35,3,7,0.429,2,5,0.4,1,2,0.5,0,3,3,2,0,0,5,3,9,2,1,Duncan Robinson,MIA,MEM,MIA,,,14,12,11,5
22023,1629130,22300150,"NOV 06, 2023",MIA vs. LAL,W,26,5,11,0.455,2,6,0.333,0,0,0.0,0,3,3,3,1,0,1,1,12,8,1,Duncan Robinson,MIA,MIA,LAL,,,18,15,15,6
22023,1629130,22300003,"NOV 03, 2023",MIA vs. WAS,W,30,7,11,0.636,4,8,0.5,0,0,0.0,0,1,1,6,1,0,2,0,18,2,1,Duncan Robinson,MIA,MIA,WAS,,,25,19,24,7
22023,1629130,22300119,"NOV 01, 2023",MIA vs. BKN,L,21,2,8,0.25,1,6,0.167,0,0,0.0,0,3,3,2,0,0,1,4,5,-4,1,Duncan Robinson,MIA,MIA,BKN,,,10,8,7,5
22023,1629130,22300107,"OCT 30, 2023",MIA @ MIL,L,22,6,10,0.6,3,7,0.429,0,0,0.0,1,0,1,1,0,0,0,5,15,-1,1,Duncan Robinson,MIA,MIL,MIA,,,17,16,16,2
22023,1629130,22300093,"OCT 28, 2023",MIA @ MIN,L,29,3,12,0.25,2,10,0.2,0,0,0.0,1,2,3,1,1,0,1,1,8,-18,1,Duncan Robinson,MIA,MIN,MIA,,,12,11,9,4
22023,1629130,22300080,"OCT 27, 2023",MIA @ BOS,L,24,3,7,0.429,3,6,0.5,0,0,0.0,0,1,1,0,0,0,0,2,9,-12,1,Duncan Robinson,MIA,BOS,MIA,,,10,10,9,1
22023,1629130,22300068,"OCT 25, 2023",MIA vs. DET,W,22,6,10,0.6,3,5,0.6,0,0,0.0,1,1,2,1,0,0,0,1,15,-3,1,Duncan Robinson,MIA,MIA,DET,,,18,17,16,3
22023,1629010,22300536,"JAN 12, 2024",GSW @ CHI,W,4,0,0,0.0,0,0,0.0,1,2,0.5,0,0,0,0,0,0,0,0,1,-8,1,Jerome Robinson,GSW,CHI,GSW,,,1,1,1,0
22023,1629010,22300504,"JAN 07, 2024",GSW vs. TOR,L,7,0,2,0.0,0,1,0.0,0,0,0.0,0,1,1,1,0,0,0,1,0,10,1,Jerome Robinson,GSW,GSW,TOR,,,2,1,1,2
22023,1629010,22300426,"DEC 28, 2023",GSW vs. MIA,L,2,0,1,0.0,0,1,0.0,0,0,0.0,0,0,0,0,0,1,0,0,0,3,1,Jerome Robinson,GSW,GSW,MIA,,,0,0,0,0
22023,1629010,22300399,"DEC 23, 2023",GSW vs. POR,W,4,0,2,0.0,0,2,0.0,3,4,0.75,0,0,0,0,0,0,0,0,3,1,1,Jerome Robinson,GSW,GSW,POR,,,3,3,3,0
22023,1629010,22300386,"DEC 22, 2023",GSW vs. WAS,W,2,0,0,0.0,0,0,0.0,0,0,0.0,0,0,0,0,0,0,0,0,0,-4,1,Jerome Robinson,GSW,GSW,WAS,,,0,0,0,0
22023,1629010,22300108,"OCT 30, 2023",GSW @ NOP,W,5,0,2,0.0,0,0,0.0,0,0,0.0,1,1,2,0,0,0,0,0,0,0,1,Jerome Robinson,GSW,NOP,GSW,,,2,2,0,2
22023,1629011,22301227,"DEC 08, 2023",NYK @ BOS,L,19,5,6,0.833,0,0,0.0,0,2,0.0,5,3,8,2,1,0,1,2,10,-19,1,Mitchell Robinson,NYK,BOS,NYK,,,20,18,12,10
22023,1629011,22301201,"DEC 05, 2023",NYK @ MIL,L,27,1,2,0.5,0,0,0.0,0,0,0.0,1,3,4,3,2,1,2,2,2,-10,1,Mitchell Robinson,NYK,MIL,NYK,,,9,6,5,7
22023,1629011,22300276,"DEC 01, 2023",NYK @ TOR,W,32,3,3,1.0,0,0,0.0,0,0,0.0,2,3,5,1,4,1,2,3,6,6,1,Mitchell Robinson,NYK,TOR,NYK,,,12,11,7,6
22023,1629011,22300268,"NOV 30, 2023",NYK vs. DET,W,31,2,4,0.5,0,0,0.0,2,2,1.0,6,3,9,1,1,1,1,2,6,8,1,Mitchell Robinson,NYK,NYK,DET,,,16,15,7,10
22023,1629011,22300057,"NOV 28, 2023",NYK vs. CHA,W,33,3,6,0.5,0,0,0.0,0,0,0.0,5,5,10,0,2,6,4,1,6,18,1,Mitchell Robinson,NYK,NYK,CHA,,,16,16,6,10
22023,1629011,22300247,"NOV 26, 2023",NYK vs. PHX,L,34,1,2,0.5,0,0,0.0,1,4,0.25,5,6,11,1,1,1,1,2,3,-1,1,Mitchell Robinson,NYK,NYK,PHX,,,15,14,4,12
22023,1629011,22300045,"NOV 24, 2023",NYK vs. MIA,W,20,2,4,0.5,0,0,0.0,1,4,0.25,3,4,7,0,2,0,0,2,5,-17,1,Mitchell Robinson,NYK,NYK,MIA,,,12,12,5,7
22023,1629011,22300221,"NOV 20, 2023",NYK @ MIN,L,30,5,7,0.714,0,0,0.0,0,0,0.0,7,4,11,0,2,2,2,3,10,-11,1,Mitchell Robinson,NYK,MIN,NYK,,,21,21,10,11
22023,1629011,22300202,"NOV 18, 2023",NYK @ CHA,W,33,2,5,0.4,0,0,0.0,0,0,0.0,11,3,14,1,0,3,3,0,4,9,1,Mitchell Robinson,NYK,CHA,NYK,,,19,18,5,15
22023,1629011,22300028,"NOV 17, 2023",NYK @ WAS,W,27,3,4,0.75,0,0,0.0,0,1,0.0,3,5,8,1,0,1,0,1,6,16,1,Mitchell Robinson,NYK,WAS,NYK,,,15,14,7,9
22023,1629011,22300193,"NOV 15, 2023",NYK @ ATL,W,31,3,3,1.0,0,0,0.0,0,0,0.0,6,9,15,0,3,1,1,0,6,8,1,Mitchell Robinson,NYK,ATL,NYK,,,21,21,6,15
22023,1629011,22300188,"NOV 13, 2023",NYK @ BOS,L,33,2,2,1.0,0,0,0.0,0,2,0.0,3,3,6,1,1,2,1,2,4,-14,1,Mitchell Robinson,NYK,BOS,NYK,,,11,10,5,7
22023,1629011,22300177,"NOV 12, 2023",NYK vs. CHA,W,24,5,7,0.714,0,0,0.0,0,2,0.0,5,4,9,0,1,0,0,2,10,4,1,Mitchell Robinson,NYK,NYK,CHA,,,19,19,10,9
22023,1629011,22300161,"NOV 08, 2023",NYK vs. SAS,W,31,3,4,0.75,0,0,0.0,2,6,0.333,5,7,12,1,0,0,0,3,8,30,1,Mitchell Robinson,NYK,NYK,SAS,,,21,20,9,13
22023,1629011,22300151,"NOV 06, 2023",NYK vs. LAC,W,35,6,10,0.6,0,0,0.0,1,1,1.0,9,6,15,0,4,0,0,2,13,4,1,Mitchell Robinson,NYK,NYK,LAC,,,28,28,13,15
22023,1629011,22300002,"NOV 03, 2023",NYK @ MIL,L,29,0,4,0.0,0,0,0.0,0,0,0.0,6,9,15,1,0,0,0,4,0,-4,1,Mitchell Robinson,NYK,MIL,NYK,,,16,15,1,16
22023,1629011,22300120,"NOV 01, 2023",NYK vs. CLE,L,32,1,3,0.333,0,0,0.0,4,8,0.5,8,8,16,0,0,2,1,3,6,-1,1,Mitchell Robinson,NYK,NYK,CLE,,,22,22,6,16
22023,1629011,22300112,"OCT 31, 2023",NYK @ CLE,W,22,4,4,1.0,0,0,0.0,0,0,0.0,3,4,7,0,1,0,1,0,8,6,1,Mitchell Robinson,NYK,CLE,NYK,,,15,15,8,7
22023,1629011,22300090,"OCT 28, 2023",NYK @ NOP,L,29,4,8,0.5,0,0,0.0,0,0,0.0,10,5,15,0,1,2,0,1,8,-11,1,Mitchell Robinson,NYK,NOP,NYK,,,23,23,8,15
22023,1629011,22300079,"OCT 27, 2023",NYK @ ATL,W,38,2,6,0.333,0,0,0.0,3,4,0.75,6,7,13,1,4,4,0,1,7,11,1,Mitchell Robinson,NYK,ATL,NYK,,,21,20,8,14
22023,1629011,22300065,"OCT 25, 2023",NYK vs. BOS,L,22,1,4,0.25,0,0,0.0,0,2,0.0,3,3,6,1,2,0,1,4,2,1,1,Mitchell Robinson,NYK,NYK,BOS,,,9,8,3,7
22023,1631115,22300551,"JAN 14, 2024",MIA vs. CHA,W,2,0,0,0.0,0,0,0.0,0,0,0.0,0,0,0,0,0,0,0,1,0,-1,1,Orlando Robinson,MIA,MIA,CHA,,,0,0,0,0
22023,1631115,22300475,"JAN 03, 2024",MIA @ LAL,W,1,0,0,0.0,0,0,0.0,0,0,0.0,0,0,0,0,0,0,0,0,0,0,1,Orlando Robinson,MIA,LAL,MIA,,,0,0,0,0
22023,1631115,22300458,"JAN 01, 2024",MIA @ LAC,L,3,0,0,0.0,0,0,0.0,1,2,0.5,0,1,1,1,0,0,0,0,1,3,1,Orlando Robinson,MIA,LAC,MIA,,,3,2,2,2
22023,1631115,22300366,"DEC 20, 2023",MIA @ ORL,W,1,0,0,0.0,0,0,0.0,0,0,0.0,0,0,0,0,0,0,0,0,0,-5,1,Orlando Robinson,MIA,ORL,MIA,,,0,0,0,0
22023,1631115,22300337,"DEC 16, 2023",MIA vs. CHI,W,11,1,4,0.25,0,2,0.0,0,0,0.0,1,1,2,1,0,0,0,2,2,-1,1,Orlando Robinson,MIA,MIA,CHI,,,5,4,3,3
22023,1631115,22300320,"DEC 14, 2023",MIA vs. CHI,L,14,0,2,0.0,0,1,0.0,1,2,0.5,2,0,2,0,0,0,1,2,1,-13,1,Orlando Robinson,MIA,MIA,CHI,,,3,3,1,2
22023,1631115,22300312,"DEC 13, 2023",MIA vs. CHA,W,12,3,5,0.6,0,0,0.0,0,0,0.0,2,2,4,1,0,0,3,2,6,3,1,Orlando Robinson,MIA,MIA,CHA,,,11,10,7,5
22023,1631115,22300292,"DEC 11, 2023",MIA @ CHA,W,22,2,5,0.4,1,2,0.5,2,4,0.5,1,5,6,2,0,2,1,5,7,-7,1,Orlando Robinson,MIA,CHA,MIA,,,15,13,9,8
22023,1631115,22301220,"DEC 08, 2023",MIA vs. CLE,L,20,2,3,0.667,0,0,0.0,1,1,1.0,2,6,8,3,0,1,1,3,5,-18,1,Orlando Robinson,MIA,MIA,CLE,,,16,13,8,11
22023,1631115,22301207,"DEC 06, 2023",MIA @ TOR,W,33,5,9,0.556,2,3,0.667,3,3,1.0,3,9,12,4,3,1,1,3,15,27,1,Orlando Robinson,MIA,TOR,MIA,,,31,27,19,16
22023,1631115,22300284,"DEC 02, 2023",MIA vs. IND,L,29,7,11,0.636,2,2,1.0,0,0,0.0,1,4,5,3,0,0,1,1,16,-6,1,Orlando Robinson,MIA,MIA,IND,,,24,21,19,8
22023,1631115,22300267,"NOV 30, 2023",MIA vs. IND,W,7,1,2,0.5,0,0,0.0,0,0,0.0,0,2,2,0,0,0,0,1,2,5,1,Orlando Robinson,MIA,MIA,IND,,,4,4,2,2
22023,1631115,22300229,"NOV 22, 2023",MIA @ CLE,W,28,6,9,0.667,1,1,1.0,1,2,0.5,4,5,9,2,1,2,2,4,14,22,1,Orlando Robinson,MIA,CLE,MIA,,,25,23,16,11
22023,1631115,22300220,"NOV 20, 2023",MIA @ CHI,W,2,0,0,0.0,0,0,0.0,0,0,0.0,0,0,0,0,0,0,0,1,0,-6,1,Orlando Robinson,MIA,CHI,MIA,,,0,0,0,0
22023,1631115,22300107,"OCT 30, 2023",MIA @ MIL,L,26,4,7,0.571,1,1,1.0,2,2,1.0,2,5,7,7,1,0,3,4,11,4,1,Orlando Robinson,MIA,MIL,MIA,,,25,18,18,14
22023,1631115,22300093,"OCT 28, 2023",MIA @ MIN,L,4,0,2,0.0,0,0,0.0,0,0,0.0,0,1,1,0,0,1,0,0,0,2,1,Orlando Robinson,MIA,MIN,MIA,,,1,1,0,1
22023,1630526,22300547,"JAN 13, 2024",NOP @ DAL,W,22,1,4,0.25,0,1,0.0,0,0,0.0,0,4,4,0,2,0,1,1,2,10,1,Jeremiah Robinson-Earl,NOP,DAL,NOP,,,6,6,2,4
22023,1630526,22300525,"JAN 10, 2024",NOP @ GSW,W,6,0,0,0.0,0,0,0.0,0,0,0.0,0,1,1,0,0,1,0,0,0,-5,1,Jeremiah Robinson-Earl,NOP,GSW,NOP,,,1,1,0,1
22023,1630526,22300500,"JAN 07, 2024",NOP @ SAC,W,10,3,4,0.75,1,2,0.5,0,0,0.0,0,0,0,0,0,1,1,1,7,-14,1,Jeremiah Robinson-Earl,NOP,SAC,NOP,,,7,7,7,0
22023,1630526,22300461,"JAN 02, 2024",NOP vs. BKN,W,4,0,1,0.0,0,0,0.0,0,0,0.0,1,4,5,0,0,0,1,0,0,1,1,Jeremiah Robinson-Earl,NOP,NOP,BKN,,,5,5,0,5
22023,1630526,22300392,"DEC 23, 2023",NOP vs. HOU,L,22,2,5,0.4,0,3,0.0,0,0,0.0,0,3,3,2,2,1,0,2,4,-8,1,Jeremiah Robinson-Earl,NOP,NOP,HOU,,,9,7,6,5
22023,1630526,22300375,"DEC 21, 2023",NOP @ CLE,W,20,5,6,0.833,1,2,0.5,0,0,0.0,0,5,5,1,0,0,0,1,11,22,1,Jeremiah Robinson-Earl,NOP,CLE,NOP,,,17,16,12,6
22023,1630526,22300345,"DEC 17, 2023",NOP @ SAS,W,4,2,2,1.0,0,0,0.0,0,0,0.0,0,1,1,0,0,0,0,0,4,-1,1,Jeremiah Robinson-Earl,NOP,SAS,NOP,,,5,5,4,1
22023,1630526,22300311,"DEC 13, 2023",NOP @ WAS,W,2,1,2,0.5,0,0,0.0,0,0,0.0,2,0,2,0,0,0,0,0,2,-2,1,Jeremiah Robinson-Earl,NOP,WAS,NOP,,,4,4,2,2
22023,1630526,22301230,"DEC 07, 2023",NOP @ LAL,L,6,0,2,0.0,0,0,0.0,0,0,0.0,0,2,2,1,0,0,0,0,0,-3,1,Jeremiah Robinson-Earl,NOP,LAL,NOP,,,3,2,1,3
22023,1630526,22300285,"DEC 02, 2023",NOP @ CHI,L,0,0,0,0.0,0,0,0.0,0,0,0.0,0,0,0,0,0,0,0,0,0,0,1,Jeremiah Robinson-Earl,NOP,CHI,NOP,,,0,0,0,0
22023,1630526,22300222,"NOV 20, 2023",NOP vs. SAC,W,12,1,4,0.25,0,1,0.0,2,2,1.0,3,2,5,1,0,0,0,1,4,-12,1,Jeremiah Robinson-Earl,NOP,NOP,SAC,,,10,9,5,6
22023,1630526,22300203,"NOV 18, 2023",NOP vs. MIN,L,10,2,3,0.667,0,1,0.0,0,0,0.0,0,0,0,0,0,0,0,1,4,-5,1,Jeremiah Robinson-Earl,NOP,NOP,MIN,,,4,4,4,0
22023,1630526,22300034,"NOV 17, 2023",NOP vs. DEN,W,0,0,0,0.0,0,0,0.0,0,0,0.0,0,0,0,0,0,0,0,0,0,0,1,Jeremiah Robinson-Earl,NOP,NOP,DEN,,,0,0,0,0
22023,1630526,22300022,"NOV 14, 2023",NOP vs. DAL,W,13,1,1,1.0,1,1,1.0,0,0,0.0,1,1,2,2,1,0,3,2,3,2,1,Jeremiah Robinson-Earl,NOP,NOP,DAL,,,7,5,5,4
22023,1630526,22300183,"NOV 12, 2023",NOP vs. DAL,L,26,4,8,0.5,3,5,0.6,0,0,0.0,1,5,6,1,1,0,1,2,11,5,1,Jeremiah Robinson-Earl,NOP,NOP,DAL,,,18,17,12,7
22023,1630526,22300011,"NOV 10, 2023",NOP @ HOU,L,9,2,2,1.0,1,1,1.0,0,0,0.0,0,0,0,0,0,0,0,1,5,-7,1,Jeremiah Robinson-Earl,NOP,HOU,NOP,,,5,5,5,0
22023,1630526,22300166,"NOV 08, 2023",NOP @ MIN,L,28,3,7,0.429,1,2,0.5,4,4,1.0,3,6,9,1,0,0,2,2,11,-18,1,Jeremiah Robinson-Earl,NOP,MIN,NOP,,,21,20,12,10
22023,1631223,22300560,"JAN 15, 2024",MEM vs. GSW,W,21,5,12,0.417,2,4,0.5,0,0,0.0,3,4,7,2,0,0,2,1,12,9,1,David Roddy,MEM,MEM,GSW,,,21,19,14,9
22023,1631223,22300544,"JAN 13, 2024",MEM vs. NYK,L,35,6,12,0.5,2,4,0.5,0,0,0.0,1,3,4,1,2,0,2,4,14,-19,1,David Roddy,MEM,MEM,NYK,,,19,18,15,5
22023,1631223,22300537,"JAN 12, 2024",MEM vs. LAC,L,27,7,11,0.636,3,5,0.6,0,0,0.0,1,5,6,4,1,0,2,3,17,-5,1,David Roddy,MEM,MEM,LAC,,,27,23,21,10
22023,1631223,22300515,"JAN 09, 2024",MEM @ DAL,W,25,3,7,0.429,1,2,0.5,4,4,1.0,2,3,5,3,0,0,2,2,11,11,1,David Roddy,MEM,DAL,MEM,,,19,16,14,8
22023,1631223,22300491,"JAN 05, 2024",MEM @ LAL,W,7,0,2,0.0,0,1,0.0,0,0,0.0,0,2,2,0,0,0,0,1,0,0,1,David Roddy,MEM,LAL,MEM,,,2,2,0,2
22023,1631223,22300470,"JAN 03, 2024",MEM vs. TOR,L,8,0,2,0.0,0,2,0.0,0,0,0.0,0,0,0,0,0,0,0,0,0,-10,1,David Roddy,MEM,MEM,TOR,,,0,0,0,0
22023,1631223,22300460,"JAN 02, 2024",MEM vs. SAS,W,0,0,0,0.0,0,0,0.0,0,0,0.0,0,0,0,0,0,0,0,0,0,-4,1,David Roddy,MEM,MEM,SAS,,,0,0,0,0
22023,1631223,22300449,"DEC 31, 2023",MEM vs. SAC,L,11,0,3,0.0,0,2,0.0,2,2,1.0,0,0,0,1,0,0,1,0,2,-13,1,David Roddy,MEM,MEM,SAC,,,3,2,3,1
22023,1631223,22300438,"DEC 29, 2023",MEM @ LAC,L,22,1,3,0.333,0,1,0.0,2,3,0.667,0,2,2,1,0,0,1,1,4,7,1,David Roddy,MEM,LAC,MEM,,,7,6,5,3
22023,1631223,22300425,"DEC 28, 2023",MEM @ DEN,L,29,5,9,0.556,1,2,0.5,4,8,0.5,0,0,0,2,0,0,0,0,15,-11,1,David Roddy,MEM,DEN,MEM,,,17,15,17,2
22023,1631223,22300410,"DEC 26, 2023",MEM @ NOP,W,16,3,7,0.429,2,5,0.4,0,0,0.0,1,3,4,1,0,0,0,0,8,1,1,David Roddy,MEM,NOP,MEM,,,13,12,9,5
22023,1631223,22300360,"DEC 19, 2023",MEM @ NOP,W,9,0,2,0.0,0,1,0.0,0,0,0.0,1,0,1,3,0,0,1,0,0,7,1,David Roddy,MEM,NOP,MEM,,,4,1,3,4
22023,1631223,22300355,"DEC 18, 2023",MEM @ OKC,L,22,2,5,0.4,1,3,0.333,3,3,1.0,0,4,4,1,1,0,3,1,8,-1,1,David Roddy,MEM,OKC,MEM,,,13,12,9,5
22023,1631223,22300332,"DEC 15, 2023",MEM vs. HOU,L,28,3,10,0.3,1,6,0.167,2,2,1.0,1,4,5,2,0,1,0,2,9,-3,1,David Roddy,MEM,MEM,HOU,,,16,14,11,7
22023,1631223,22300314,"DEC 13, 2023",MEM @ HOU,L,32,3,14,0.214,2,7,0.286,1,2,0.5,1,5,6,4,1,0,1,1,9,1,1,David Roddy,MEM,HOU,MEM,,,19,15,13,10
22023,1631223,22300299,"DEC 11, 2023",MEM vs. DAL,L,29,3,9,0.333,1,5,0.2,1,2,0.5,2,4,6,2,1,0,1,1,8,1,1,David Roddy,MEM,MEM,DAL,,,16,14,10,8
22023,1631223,22301221,"DEC 08, 2023",MEM vs. MIN,L,25,6,11,0.545,1,4,0.25,0,0,0.0,0,3,3,0,0,0,0,0,13,-11,1,David Roddy,MEM,MEM,MIN,,,16,16,13,3
22023,1631223,22301206,"DEC 06, 2023",MEM @ DET,W,22,1,3,0.333,1,2,0.5,1,2,0.5,1,5,6,1,2,0,3,1,4,-5,1,David Roddy,MEM,DET,MEM,,,11,10,5,7
22023,1631223,22300288,"DEC 02, 2023",MEM @ PHX,L,30,3,7,0.429,2,3,0.667,0,0,0.0,2,4,6,1,1,0,1,2,8,-10,1,David Roddy,MEM,PHX,MEM,,,15,14,9,7
22023,1631223,22300277,"DEC 01, 2023",MEM @ DAL,W,24,2,9,0.222,0,3,0.0,2,2,1.0,1,5,6,3,1,1,1,2,6,12,1,David Roddy,MEM,DAL,MEM,,,15,12,9,9
22023,1631223,22300261,"NOV 29, 2023",MEM vs. UTA,W,25,7,11,0.636,5,9,0.556,0,0,0.0,1,5,6,1,0,0,0,2,19,0,1,David Roddy,MEM,MEM,UTA,,,26,25,20,7
22023,1631223,22300249,"NOV 26, 2023",MEM vs. MIN,L,28,4,9,0.444,2,5,0.4,1,1,1.0,2,2,4,2,0,0,1,2,11,-5,1,David Roddy,MEM,MEM,MIN,,,17,15,13,6
22023,1631223,22300044,"NOV 24, 2023",MEM vs. PHX,L,27,5,9,0.556,2,4,0.5,2,3,0.667,0,4,4,0,2,1,2,0,14,-15,1,David Roddy,MEM,MEM,PHX,,,18,18,14,4
22023,1631223,22300231,"NOV 22, 2023",MEM @ HOU,L,22,2,7,0.286,0,1,0.0,0,0,0.0,0,6,6,1,0,0,2,0,4,-5,1,David Roddy,MEM,HOU,MEM,,,11,10,5,7
22023,1631223,22300213,"NOV 19, 2023",MEM vs. BOS,L,20,0,2,0.0,0,2,0.0,0,0,0.0,0,2,2,0,0,0,0,0,0,-3,1,David Roddy,MEM,MEM,BOS,,,2,2,0,2
22023,1631223,22300206,"NOV 18, 2023",MEM @ SAS,W,26,0,5,0.0,0,3,0.0,0,2,0.0,2,2,4,1,2,0,1,1,0,16,1,David Roddy,MEM,SAS,MEM,,,5,4,1,5
22023,1631223,22300026,"NOV 14, 2023",MEM @ LAL,L,31,6,17,0.353,2,8,0.25,3,4,0.75,1,2,3,3,2,2,0,2,17,-7,1,David Roddy,MEM,LAL,MEM,,,23,20,20,6
22023,1631223,22300179,"NOV 12, 2023",MEM @ LAC,W,21,4,7,0.571,0,1,0.0,0,0,0.0,4,2,6,0,1,1,0,1,8,-5,1,David Roddy,MEM,LAC,MEM,,,14,14,8,6
22023,1631223,22300012,"NOV 10, 2023",MEM vs. UTA,L,19,3,9,0.333,1,5,0.2,0,0,0.0,1,2,3,0,0,0,2,1,7,-6,1,David Roddy,MEM,MEM,UTA,,,10,10,7,3
22023,1631223,22300164,"NOV 08, 2023",MEM vs. MIA,L,13,1,2,0.5,0,0,0.0,2,2,1.0,2,1,3,0,1,0,2,2,4,10,1,David Roddy,MEM,MEM,MIA,,,7,7,4,3
22023,1631223,22300144,"NOV 05, 2023",MEM @ POR,W,13,2,5,0.4,0,1,0.0,0,0,0.0,0,2,2,0,1,0,0,1,4,5,1,David Roddy,MEM,POR,MEM,,,6,6,4,2
22023,1631223,22300007,"NOV 03, 2023",MEM @ POR,L,32,8,14,0.571,0,4,0.0,0,0,0.0,1,2,3,0,0,0,0,4,16,-13,1,David Roddy,MEM,POR,MEM,,,19,19,16,3
22023,1631223,22300125,"NOV 01, 2023",MEM @ UTA,L,24,4,8,0.5,1,3,0.333,0,0,0.0,1,2,3,1,0,1,1,1,9,-17,1,David Roddy,MEM,UTA,MEM,,,13,12,10,4
22023,1631223,22300106,"OCT 30, 2023",MEM vs. DAL,L,29,4,8,0.5,0,1,0.0,1,2,0.5,1,4,5,2,0,1,0,2,9,-2,1,David Roddy,MEM,MEM,DAL,,,16,14,11,7
22023,1631223,22300089,"OCT 28, 2023",MEM @ WAS,L,24,5,8,0.625,3,4,0.75,1,1,1.0,0,6,6,2,0,1,1,3,14,0,1,David Roddy,MEM,WAS,MEM,,,22,20,16,8
22023,1631223,22300078,"OCT 27, 2023",MEM vs. DEN,L,15,0,4,0.0,0,2,0.0,0,0,0.0,0,2,2,2,1,0,2,3,0,-8,1,David Roddy,MEM,MEM,DEN,,,4,2,2,4
22023,1631223,22300071,"OCT 25, 2023",MEM vs. NOP,L,28,4,7,0.571,1,3,0.333,0,0,0.0,1,4,5,2,0,0,1,2,9,-3,1,David Roddy,MEM,MEM,NOP,,,16,14,11,7
22023,1631157,22300416,"DEC 27, 2023",WAS vs. TOR,L,6,1,3,0.333,0,0,0.0,0,0,0.0,0,0,0,0,0,0,0,0,2,-4,1,Ryan Rollins,WAS,WAS,TOR,,,2,2,2,0
22023,1631157,22300386,"DEC 22, 2023",WAS @ GSW,L,11,3,4,0.75,1,1,1.0,0,1,0.0,0,1,1,1,0,1,0,1,7,10,1,Ryan Rollins,WAS,GSW,WAS,,,9,8,8,2
22023,1631157,22300219,"NOV 20, 2023",WAS vs. MIL,L,1,0,0,0.0,0,0,0.0,0,0,0.0,0,0,0,0,0,0,0,0,0,2,1,Ryan Rollins,WAS,WAS,MIL,,,0,0,0,0
22023,1631157,22300192,"NOV 15, 2023",WAS vs. DAL,L,2,1,1,1.0,0,0,0.0,0,0,0.0,0,0,0,0,0,0,0,0,2,5,1,Ryan Rollins,WAS,WAS,DAL,,,2,2,2,0
22023,1631157,22300157,"NOV 08, 2023",WAS @ CHA,W,3,1,1,1.0,0,0,0.0,1,1,1.0,0,0,0,0,2,0,0,0,3,-2,1,Ryan Rollins,WAS,CHA,WAS,,,3,3,3,0
22023,1631157,22300148,"NOV 06, 2023",WAS @ PHI,L,10,3,5,0.6,0,1,0.0,0,0,0.0,1,4,5,3,2,0,5,2,6,1,1,Ryan Rollins,WAS,PHI,WAS,,,14,11,9,8
22023,1631157,22300003,"NOV 03, 2023",WAS @ MIA,L,7,2,4,0.5,1,1,1.0,2,3,0.667,0,1,1,2,0,1,0,1,7,15,1,Ryan Rollins,WAS,MIA,WAS,,,10,8,9,3
22023,1631157,22300117,"NOV 01, 2023",WAS @ ATL,L,7,2,2,1.0,0,0,0.0,2,2,1.0,0,0,0,1,0,1,0,2,6,17,1,Ryan Rollins,WAS,ATL,WAS,,,7,6,7,1
22023,1631157,22300103,"OCT 30, 2023",WAS vs. BOS,L,12,0,2,0.0,0,0,0.0,7,8,0.875,1,0,1,3,4,0,1,1,7,14,1,Ryan Rollins,WAS,WAS,BOS,,,11,8,10,4
22023,1631157,22300064,"OCT 25, 2023",WAS @ IND,L,6,0,3,0.0,0,0,0.0,1,2,0.5,0,3,3,1,0,0,1,0,1,-1,1,Ryan Rollins,WAS,IND,WAS,,,5,4,2,4
22023,201565,22300460,"JAN 02, 2024",MEM vs. SAS,W,9,2,4,0.5,0,1,0.0,0,0,0.0,0,0,0,2,0,0,0,0,4,1,1,Derrick Rose,MEM,MEM,SAS,,,6,4,6,2
22023,201565,22300449,"DEC 31, 2023",MEM vs. SAC,L,12,1,3,0.333,0,0,0.0,0,0,0.0,0,0,0,3,0,0,1,0,2,-16,1,Derrick Rose,MEM,MEM,SAC,,,5,2,5,3
22023,201565,22300332,"DEC 15, 2023",MEM vs. HOU,L,9,1,3,0.333,1,2,0.5,0,0,0.0,0,1,1,2,0,0,0,0,3,11,1,Derrick Rose,MEM,MEM,HOU,,,6,4,5,3
22023,201565,22300314,"DEC 13, 2023",MEM @ HOU,L,31,7,14,0.5,1,4,0.25,4,4,1.0,1,3,4,6,0,1,1,4,19,-14,1,Derrick Rose,MEM,HOU,MEM,,,29,23,25,10
22023,201565,22300299,"DEC 11, 2023",MEM vs. DAL,L,17,2,7,0.286,1,3,0.333,2,2,1.0,0,3,3,4,0,0,2,1,7,-10,1,Derrick Rose,MEM,MEM,DAL,,,14,10,11,7
22023,201565,22301221,"DEC 08, 2023",MEM vs. MIN,L,22,2,7,0.286,0,1,0.0,2,2,1.0,0,1,1,7,0,0,1,1,6,-8,1,Derrick Rose,MEM,MEM,MIN,,,14,7,13,8
22023,201565,22301206,"DEC 06, 2023",MEM @ DET,W,15,2,7,0.286,0,1,0.0,0,0,0.0,0,1,1,2,2,0,5,1,4,2,1,Derrick Rose,MEM,DET,MEM,,,7,5,6,3
22023,201565,22300277,"DEC 01, 2023",MEM @ DAL,W,20,3,7,0.429,0,2,0.0,0,0,0.0,0,2,2,3,1,0,1,3,6,21,1,Derrick Rose,MEM,DAL,MEM,,,11,8,9,5
22023,201565,22300261,"NOV 29, 2023",MEM vs. UTA,W,27,7,11,0.636,0,3,0.0,0,0,0.0,0,4,4,9,0,0,1,2,14,20,1,Derrick Rose,MEM,MEM,UTA,,,27,18,23,13
22023,201565,22300249,"NOV 26, 2023",MEM vs. MIN,L,20,5,12,0.417,0,2,0.0,2,2,1.0,2,0,2,4,1,0,1,2,12,-3,1,Derrick Rose,MEM,MEM,MIN,,,18,14,16,6
22023,201565,22300044,"NOV 24, 2023",MEM vs. PHX,L,22,8,9,0.889,1,1,1.0,0,0,0.0,0,2,2,1,1,0,1,0,17,-10,1,Derrick Rose,MEM,MEM,PHX,,,20,19,18,3
22023,201565,22300231,"NOV 22, 2023",MEM @ HOU,L,16,1,3,0.333,1,2,0.5,4,4,1.0,0,1,1,2,0,0,2,0,7,-3,1,Derrick Rose,MEM,HOU,MEM,,,10,8,9,3
22023,201565,22300206,"NOV 18, 2023",MEM @ SAS,W,14,3,4,0.75,1,1,1.0,2,3,0.667,0,1,1,1,0,0,0,1,9,5,1,Derrick Rose,MEM,SAS,MEM,,,11,10,10,2
22023,201565,22300106,"OCT 30, 2023",MEM vs. DAL,L,14,0,4,0.0,0,1,0.0,1,2,0.5,0,1,1,0,0,0,0,1,1,-18,1,Derrick Rose,MEM,MEM,DAL,,,2,2,1,1
22023,201565,22300089,"OCT 28, 2023",MEM @ WAS,L,18,3,8,0.375,1,2,0.5,0,0,0.0,1,0,1,5,1,1,3,0,7,9,1,Derrick Rose,MEM,WAS,MEM,,,13,8,12,6
22023,201565,22300078,"OCT 27, 2023",MEM vs. DEN,L,22,6,14,0.429,2,3,0.667,2,2,1.0,2,2,4,3,1,0,3,2,16,-1,1,Derrick Rose,MEM,MEM,DEN,,,23,20,19,7
22023,201565,22300071,"OCT 25, 2023",MEM vs. NOP,L,16,3,11,0.273,2,4,0.5,0,0,0.0,1,1,2,3,0,0,0,0,8,-10,1,Derrick Rose,MEM,MEM,NOP,,,13,10,11,5
22023,1626179,22300551,"JAN 14, 2024",CHA @ MIA,L,35,8,23,0.348,4,11,0.364,6,6,1.0,2,3,5,7,0,0,1,2,26,-18,1,Terry Rozier,CHA,MIA,CHA,,,38,31,33,12
22023,1626179,22300541,"JAN 12, 2024",CHA @ SAS,L,28,6,14,0.429,3,9,0.333,1,2,0.5,0,2,2,2,2,1,1,2,16,-32,1,Terry Rozier,CHA,SAS,CHA,,,20,18,18,4
22023,1626179,22300518,"JAN 10, 2024",CHA vs. SAC,L,32,6,14,0.429,3,6,0.5,7,8,0.875,0,4,4,2,1,1,0,1,22,-31,1,Terry Rozier,CHA,CHA,SAC,,,28,26,24,6
22023,1626179,22300506,"JAN 08, 2024",CHA vs. CHI,L,44,10,18,0.556,7,13,0.538,12,12,1.0,0,3,3,8,0,0,0,2,39,-9,1,Terry Rozier,CHA,CHA,CHI,,,50,42,47,11
22023,1626179,22300484,"JAN 05, 2024",CHA @ CHI,L,36,5,17,0.294,1,7,0.143,4,4,1.0,1,3,4,7,1,0,3,2,15,-10,1,Terry Rozier,CHA,CHI,CHA,,,26,19,22,11
22023,1626179,22300464,"JAN 02, 2024",CHA @ SAC,W,36,13,24,0.542,3,11,0.273,5,6,0.833,0,3,3,6,1,2,2,3,34,-1,1,Terry Rozier,CHA,SAC,CHA,,,43,37,40,9
22023,1626179,22300436,"DEC 29, 2023",CHA @ PHX,L,39,14,22,0.636,8,12,0.667,6,6,1.0,1,3,4,8,1,0,0,0,42,-1,1,Terry Rozier,CHA,PHX,CHA,,,54,46,50,12
22023,1626179,22300428,"DEC 28, 2023",CHA @ LAL,L,32,5,14,0.357,1,3,0.333,7,9,0.778,0,6,6,8,1,0,4,0,18,-32,1,Terry Rozier,CHA,LAL,CHA,,,32,24,26,14
22023,1626179,22300414,"DEC 26, 2023",CHA @ LAC,L,39,8,23,0.348,1,8,0.125,1,3,0.333,0,4,4,7,1,0,4,2,18,0,1,Terry Rozier,CHA,LAC,CHA,,,29,22,25,11
22023,1626179,22300365,"DEC 20, 2023",CHA @ IND,L,35,10,26,0.385,2,10,0.2,3,3,1.0,2,7,9,7,1,0,1,0,25,-21,1,Terry Rozier,CHA,IND,CHA,,,41,34,32,16
22023,1626179,22300354,"DEC 18, 2023",CHA @ TOR,L,32,9,20,0.45,2,8,0.25,2,2,1.0,1,2,3,7,3,1,3,4,22,-3,1,Terry Rozier,CHA,TOR,CHA,,,32,25,29,10
22023,1626179,22300335,"DEC 16, 2023",CHA vs. PHI,L,20,3,10,0.3,0,5,0.0,0,0,0.0,1,1,2,2,0,0,2,2,6,-38,1,Terry Rozier,CHA,CHA,PHI,,,10,8,8,4
22023,1626179,22300326,"DEC 15, 2023",CHA vs. NOP,L,39,11,25,0.44,4,11,0.364,4,4,1.0,0,4,4,6,3,0,2,0,30,-10,1,Terry Rozier,CHA,CHA,NOP,,,40,34,36,10
22023,1626179,22300312,"DEC 13, 2023",CHA @ MIA,L,37,10,14,0.714,5,6,0.833,3,3,1.0,0,3,3,7,4,1,1,2,28,-15,1,Terry Rozier,CHA,MIA,CHA,,,38,31,35,10
22023,1626179,22300292,"DEC 11, 2023",CHA vs. MIA,L,39,10,17,0.588,8,13,0.615,6,7,0.857,1,1,2,13,0,0,3,4,34,4,1,Terry Rozier,CHA,CHA,MIA,,,49,36,47,15
22023,1626179,22301216,"DEC 08, 2023",CHA vs. TOR,W,40,7,15,0.467,2,5,0.4,5,5,1.0,0,2,2,13,0,0,2,5,21,5,1,Terry Rozier,CHA,CHA,TOR,,,36,23,34,15
22023,1626179,22301211,"DEC 06, 2023",CHA @ CHI,L,40,10,24,0.417,1,11,0.091,4,4,1.0,1,4,5,7,1,2,2,4,25,-11,1,Terry Rozier,CHA,CHI,CHA,,,37,30,32,12
22023,1626179,22300281,"DEC 02, 2023",CHA vs. MIN,L,35,8,20,0.4,3,7,0.429,4,5,0.8,1,5,6,7,2,0,1,4,23,-6,1,Terry Rozier,CHA,CHA,MIN,,,36,29,30,13
22023,1626179,22300266,"NOV 30, 2023",CHA @ BKN,W,40,13,25,0.52,7,9,0.778,4,4,1.0,0,4,4,13,2,0,3,1,37,2,1,Terry Rozier,CHA,BKN,CHA,,,54,41,50,17
22023,1626179,22300057,"NOV 28, 2023",CHA @ NYK,L,33,5,16,0.313,0,3,0.0,1,1,1.0,0,2,2,5,1,0,3,0,11,-10,1,Terry Rozier,CHA,NYK,CHA,,,18,13,16,7
22023,1626179,22300248,"NOV 26, 2023",CHA @ ORL,L,37,9,15,0.6,2,4,0.5,2,4,0.5,0,1,1,9,1,1,5,4,22,-10,1,Terry Rozier,CHA,ORL,CHA,,,32,23,31,10
22023,1626179,22300133,"NOV 04, 2023",CHA @ IND,W,31,7,14,0.5,3,5,0.6,5,5,1.0,0,6,6,3,0,1,0,0,22,0,1,Terry Rozier,CHA,IND,CHA,,,31,28,25,9
22023,1626179,22300122,"NOV 01, 2023",CHA @ HOU,L,38,10,21,0.476,1,6,0.167,0,0,0.0,2,1,3,6,1,0,4,0,21,-1,1,Terry Rozier,CHA,HOU,CHA,,,30,24,27,9
22023,1626179,22300101,"OCT 30, 2023",CHA vs. BKN,L,41,10,19,0.526,2,6,0.333,1,1,1.0,0,3,3,9,1,1,2,2,23,-13,1,Terry Rozier,CHA,CHA,BKN,,,35,26,32,12
22023,1626179,22300077,"OCT 27, 2023",CHA vs. DET,L,35,8,20,0.4,0,7,0.0,4,4,1.0,1,2,3,1,1,0,2,0,20,-11,1,Terry Rozier,CHA,CHA,DET,,,24,23,21,4
22023,1626179,22300063,"OCT 25, 2023",CHA vs. ATL,W,34,7,16,0.438,2,7,0.286,8,12,0.667,1,4,5,6,0,0,3,2,24,14,1,Terry Rozier,CHA,CHA,ATL,,,35,29,30,11
22023,1641712,22300554,"JAN 14, 2024",POR vs. PHX,L,14,4,5,0.8,3,3,1.0,0,0,0.0,2,3,5,2,0,0,1,2,11,4,1,Rayan Rupert,POR,POR,PHX,,,18,16,13,7
22023,1641712,22300538,"JAN 12, 2024",POR @ MIN,L,7,1,2,0.5,0,0,0.0,1,2,0.5,0,1,1,1,0,0,0,0,3,11,1,Rayan Rupert,POR,MIN,POR,,,5,4,4,2
22023,1641712,22300529,"JAN 11, 2024",POR @ OKC,L,12,1,5,0.2,1,2,0.5,0,0,0.0,0,3,3,2,0,0,0,0,3,0,1,Rayan Rupert,POR,OKC,POR,,,8,6,5,5
22023,1641712,22300514,"JAN 09, 2024",POR @ NYK,L,12,2,5,0.4,0,1,0.0,0,0,0.0,1,4,5,1,0,0,1,0,4,8,1,Rayan Rupert,POR,NYK,POR,,,10,9,5,6
22023,1641712,22300487,"JAN 05, 2024",POR @ DAL,L,19,3,5,0.6,1,2,0.5,0,0,0.0,1,2,3,0,0,0,2,3,7,-12,1,Rayan Rupert,POR,DAL,POR,,,10,10,7,3
22023,1641712,22300399,"DEC 23, 2023",POR @ GSW,L,5,0,1,0.0,0,0,0.0,0,0,0.0,0,0,0,2,0,0,0,0,0,-1,1,Rayan Rupert,POR,GSW,POR,,,2,0,2,2
22023,1641712,22300237,"NOV 22, 2023",POR vs. UTA,W,6,0,2,0.0,0,1,0.0,0,0,0.0,0,0,0,0,0,0,0,0,0,-14,1,Rayan Rupert,POR,POR,UTA,,,0,0,0,0
22023,1641712,22300041,"NOV 21, 2023",POR @ PHX,L,2,0,1,0.0,0,0,0.0,0,0,0.0,0,0,0,1,1,0,0,0,0,3,1,Rayan Rupert,POR,PHX,POR,,,1,0,1,1
22023,1641712,22300215,"NOV 19, 2023",POR vs. OKC,L,12,1,5,0.2,1,3,0.333,1,2,0.5,1,0,1,1,1,0,1,0,4,-8,1,Rayan Rupert,POR,POR,OKC,,,6,5,5,2
22023,1641712,22300199,"NOV 15, 2023",POR vs. CLE,L,3,0,1,0.0,0,1,0.0,0,0,0.0,0,0,0,0,0,0,1,1,0,0,1,Rayan Rupert,POR,POR,CLE,,,0,0,0,0
22023,1641712,22300023,"NOV 14, 2023",POR @ UTA,L,3,0,2,0.0,0,0,0.0,1,2,0.5,0,0,0,0,0,0,0,0,1,-1,1,Rayan Rupert,POR,UTA,POR,,,1,1,1,0
22023,1641712,22300098,"OCT 29, 2023",POR @ PHI,L,5,0,1,0.0,0,1,0.0,0,0,0.0,0,0,0,0,0,0,0,0,0,-7,1,Rayan Rupert,POR,PHI,POR,,,0,0,0,0
22023,1641712,22300074,"OCT 25, 2023",POR @ LAC,L,2,0,0,0.0,0,0,0.0,0,0,0.0,0,0,0,0,0,0,0,0,0,3,1,Rayan Rupert,POR,LAC,POR,,,0,0,0,0
22023,1626156,22300565,"JAN 15, 2024",LAL vs. OKC,W,36,5,12,0.417,2,7,0.286,2,2,1.0,1,1,2,6,2,1,5,2,14,3,1,D'Angelo Russell,LAL,LAL,OKC,,,22,16,20,8
22023,1626156,22300549,"JAN 13, 2024",LAL @ UTA,L,41,15,26,0.577,6,11,0.545,3,3,1.0,0,3,3,8,1,2,3,3,39,-2,1,D'Angelo Russell,LAL,UTA,LAL,,,50,42,47,11
22023,1626156,22300531,"JAN 11, 2024",LAL vs. PHX,L,27,7,14,0.5,3,7,0.429,2,4,0.5,0,1,1,6,2,0,3,2,19,2,1,D'Angelo Russell,LAL,LAL,PHX,,,26,20,25,7
22023,1626156,22300516,"JAN 09, 2024",LAL vs. TOR,W,17,4,8,0.5,2,6,0.333,1,2,0.5,1,0,1,5,0,0,2,1,11,7,1,D'Angelo Russell,LAL,LAL,TOR,,,17,12,16,6
22023,1626156,22300505,"JAN 07, 2024",LAL vs. LAC,W,31,5,14,0.357,3,9,0.333,0,0,0.0,0,0,0,6,1,1,3,2,13,5,1,D'Angelo Russell,LAL,LAL,LAC,,,19,13,19,6
22023,1626156,22300443,"DEC 30, 2023",LAL @ MIN,L,20,1,4,0.25,0,1,0.0,3,4,0.75,0,1,1,3,0,0,1,1,5,-19,1,D'Angelo Russell,LAL,MIN,LAL,,,9,6,8,4
22023,1626156,22300428,"DEC 28, 2023",LAL vs. CHA,W,29,5,10,0.5,4,7,0.571,2,2,1.0,0,3,3,9,0,0,1,3,16,18,1,D'Angelo Russell,LAL,LAL,CHA,,,28,19,25,12
22023,1626156,22300403,"DEC 25, 2023",LAL vs. BOS,L,18,4,6,0.667,0,1,0.0,0,0,0.0,0,1,1,6,1,0,2,1,8,-3,1,D'Angelo Russell,LAL,LAL,BOS,,,15,9,14,7
22023,1626156,22300397,"DEC 23, 2023",LAL @ OKC,W,17,5,9,0.556,3,6,0.5,2,3,0.667,0,1,1,3,0,0,1,1,15,0,1,D'Angelo Russell,LAL,OKC,LAL,,,19,16,18,4
22023,1626156,22300380,"DEC 21, 2023",LAL @ MIN,L,38,7,19,0.368,2,6,0.333,1,1,1.0,0,4,4,8,2,3,4,1,17,-4,1,D'Angelo Russell,LAL,MIN,LAL,,,29,21,25,12
22023,1626156,22300370,"DEC 20, 2023",LAL @ CHI,L,28,1,6,0.167,0,4,0.0,0,0,0.0,0,1,1,2,0,0,1,2,2,3,1,D'Angelo Russell,LAL,CHI,LAL,,,5,3,4,3
22023,1626156,22300359,"DEC 18, 2023",LAL vs. NYK,L,28,3,10,0.3,3,6,0.5,0,0,0.0,0,3,3,4,1,0,0,1,9,-4,1,D'Angelo Russell,LAL,LAL,NYK,,,16,12,13,7
22023,1626156,22300316,"DEC 13, 2023",LAL @ SAS,W,33,6,13,0.462,0,4,0.0,0,1,0.0,0,3,3,10,3,0,3,4,12,-6,1,D'Angelo Russell,LAL,SAS,LAL,,,25,15,22,13
22023,1626156,22300306,"DEC 12, 2023",LAL @ DAL,L,25,3,9,0.333,1,4,0.25,0,0,0.0,0,2,2,7,0,0,2,4,7,-6,1,D'Angelo Russell,LAL,DAL,LAL,,,16,9,14,9
22023,1626156,22301230,"DEC 07, 2023",LAL vs. NOP,W,22,6,10,0.6,2,5,0.4,0,0,0.0,0,3,3,1,1,0,4,1,14,23,1,D'Angelo Russell,LAL,LAL,NOP,,,18,17,15,4
22023,1626156,22301203,"DEC 05, 2023",LAL vs. PHX,W,24,3,11,0.273,2,6,0.333,0,0,0.0,1,0,1,5,0,0,0,2,8,-7,1,D'Angelo Russell,LAL,LAL,PHX,,,14,9,13,6
22023,1626156,22300291,"DEC 02, 2023",LAL vs. HOU,W,26,4,10,0.4,1,5,0.2,0,0,0.0,0,2,2,7,5,0,0,2,9,8,1,D'Angelo Russell,LAL,LAL,HOU,,,18,11,16,9
22023,1626156,22300271,"NOV 30, 2023",LAL @ OKC,L,32,6,13,0.462,2,5,0.4,2,2,1.0,1,2,3,10,1,0,2,3,16,-4,1,D'Angelo Russell,LAL,OKC,LAL,,,29,19,26,13
22023,1626156,22300258,"NOV 29, 2023",LAL @ DET,W,34,13,17,0.765,5,7,0.714,4,5,0.8,0,4,4,9,1,2,3,0,35,31,1,D'Angelo Russell,LAL,DET,LAL,,,48,39,44,13
22023,1626156,22300255,"NOV 27, 2023",LAL @ PHI,L,24,5,10,0.5,1,2,0.5,1,2,0.5,0,2,2,7,0,0,0,0,12,-8,1,D'Angelo Russell,LAL,PHI,LAL,,,21,14,19,9
22023,1626156,22300242,"NOV 25, 2023",LAL @ CLE,W,32,4,12,0.333,2,6,0.333,0,0,0.0,0,5,5,5,2,0,4,3,10,3,1,D'Angelo Russell,LAL,CLE,LAL,,,20,15,15,10
22023,1626156,22300238,"NOV 22, 2023",LAL vs. DAL,L,24,5,11,0.455,2,4,0.5,3,3,1.0,0,3,3,5,0,1,1,1,15,1,1,D'Angelo Russell,LAL,LAL,DAL,,,23,18,20,8
22023,1626156,22300042,"NOV 21, 2023",LAL vs. UTA,W,26,7,9,0.778,3,4,0.75,3,5,0.6,0,3,3,8,0,1,0,2,20,30,1,D'Angelo Russell,LAL,LAL,UTA,,,31,23,28,11
22023,1626156,22300216,"NOV 19, 2023",LAL vs. HOU,W,24,1,8,0.125,1,5,0.2,1,2,0.5,0,5,5,2,3,0,3,1,4,-7,1,D'Angelo Russell,LAL,LAL,HOU,,,11,9,6,7
22023,1626156,22300036,"NOV 17, 2023",LAL @ POR,W,29,5,10,0.5,4,7,0.571,0,1,0.0,1,2,3,6,0,0,4,1,14,2,1,D'Angelo Russell,LAL,POR,LAL,,,23,17,20,9
22023,1626156,22300198,"NOV 15, 2023",LAL vs. SAC,L,35,12,20,0.6,4,6,0.667,0,0,0.0,3,2,5,5,0,1,2,3,28,-13,1,D'Angelo Russell,LAL,LAL,SAC,,,38,33,33,10
22023,1626156,22300026,"NOV 14, 2023",LAL vs. MEM,W,27,8,12,0.667,6,8,0.75,2,3,0.667,0,3,3,5,0,0,0,0,24,25,1,D'Angelo Russell,LAL,LAL,MEM,,,32,27,29,8
22023,1626156,22300187,"NOV 12, 2023",LAL vs. POR,W,32,5,14,0.357,0,3,0.0,1,2,0.5,1,4,5,11,1,0,1,2,11,4,1,D'Angelo Russell,LAL,LAL,POR,,,27,16,22,16
22023,1626156,22300015,"NOV 10, 2023",LAL @ PHX,W,29,6,12,0.5,0,3,0.0,7,9,0.778,0,3,3,9,0,1,1,4,19,1,1,D'Angelo Russell,LAL,PHX,LAL,,,31,22,28,12
22023,1626156,22300163,"NOV 08, 2023",LAL @ HOU,L,28,9,18,0.5,4,7,0.571,0,0,0.0,0,2,2,4,0,3,1,1,22,-18,1,D'Angelo Russell,LAL,HOU,LAL,,,28,24,26,6
22023,1626156,22300150,"NOV 06, 2023",LAL @ MIA,L,29,6,10,0.6,1,3,0.333,0,0,0.0,0,4,4,6,0,1,3,2,13,-4,1,D'Angelo Russell,LAL,MIA,LAL,,,23,17,19,10
22023,1626156,22300134,"NOV 04, 2023",LAL @ ORL,L,35,4,17,0.235,1,10,0.1,2,2,1.0,2,2,4,4,0,0,1,2,11,-17,1,D'Angelo Russell,LAL,ORL,LAL,,,19,15,15,8
22023,1626156,22300127,"NOV 01, 2023",LAL vs. LAC,W,36,10,19,0.526,3,7,0.429,4,4,1.0,0,2,2,6,0,0,3,2,27,3,1,D'Angelo Russell,LAL,LAL,LAC,,,35,29,33,8
22023,1626156,22300111,"OCT 30, 2023",LAL vs. ORL,W,36,10,14,0.714,3,6,0.5,5,5,1.0,0,2,2,8,1,1,3,4,28,7,1,D'Angelo Russell,LAL,LAL,ORL,,,38,30,36,10
22023,1626156,22300100,"OCT 29, 2023",LAL @ SAC,L,41,5,13,0.385,1,5,0.2,6,7,0.857,0,3,3,9,0,0,0,4,17,-7,1,D'Angelo Russell,LAL,SAC,LAL,,,29,20,26,12
22023,1626156,22300076,"OCT 26, 2023",LAL vs. PHX,W,33,6,16,0.375,1,7,0.143,1,1,1.0,0,4,4,5,2,1,3,2,14,8,1,D'Angelo Russell,LAL,LAL,PHX,,,23,18,19,9
22023,1626156,22300061,"OCT 24, 2023",LAL @ DEN,L,36,4,12,0.333,2,5,0.4,1,2,0.5,0,4,4,7,1,0,3,3,11,1,1,D'Angelo Russell,LAL,DEN,LAL,,,22,15,18,11
22023,1630346,22300203,"NOV 18, 2023",NOP vs. MIN,L,27,3,5,0.6,3,4,0.75,1,1,1.0,0,3,3,1,1,0,3,1,10,1,1,Matt Ryan,NOP,NOP,MIN,,,14,13,11,4
22023,1630346,22300034,"NOV 17, 2023",NOP vs. DEN,W,19,3,7,0.429,3,5,0.6,0,1,0.0,0,0,0,0,0,0,0,0,9,8,1,Matt Ryan,NOP,NOP,DEN,,,9,9,9,0
22023,1630346,22300022,"NOV 14, 2023",NOP vs. DAL,W,20,2,7,0.286,2,5,0.4,0,0,0.0,0,2,2,0,1,0,0,0,6,17,1,Matt Ryan,NOP,NOP,DAL,,,8,8,6,2
22023,1630346,22300183,"NOV 12, 2023",NOP vs. DAL,L,27,5,7,0.714,4,6,0.667,0,0,0.0,3,3,6,2,0,0,0,3,14,0,1,Matt Ryan,NOP,NOP,DAL,,,22,20,16,8
22023,1630346,22300011,"NOV 10, 2023",NOP @ HOU,L,16,0,1,0.0,0,1,0.0,0,0,0.0,0,2,2,0,1,0,1,2,0,-9,1,Matt Ryan,NOP,HOU,NOP,,,2,2,0,2
22023,1630346,22300166,"NOV 08, 2023",NOP @ MIN,L,26,2,5,0.4,2,4,0.5,6,6,1.0,0,4,4,1,0,0,5,4,12,-4,1,Matt Ryan,NOP,MIN,NOP,,,17,16,13,5
22023,1630346,22300156,"NOV 06, 2023",NOP @ DEN,L,25,5,8,0.625,4,6,0.667,3,3,1.0,0,0,0,1,0,0,0,3,17,-4,1,Matt Ryan,NOP,DEN,NOP,,,18,17,18,1
22023,1630346,22300135,"NOV 04, 2023",NOP vs. ATL,L,17,1,4,0.25,0,3,0.0,2,2,1.0,1,1,2,1,0,0,1,2,4,-5,1,Matt Ryan,NOP,NOP,ATL,,,7,6,5,3
22023,1630346,22300129,"NOV 02, 2023",NOP vs. DET,W,35,7,10,0.7,6,8,0.75,0,0,0.0,0,2,2,2,0,0,3,0,20,16,1,Matt Ryan,NOP,NOP,DET,,,24,22,22,4
22023,1630346,22300121,"NOV 01, 2023",NOP @ OKC,W,20,2,6,0.333,1,5,0.2,0,0,0.0,0,3,3,0,0,0,1,2,5,-3,1,Matt Ryan,NOP,OKC,NOP,,,8,8,5,3
22023,1630346,22300108,"OCT 30, 2023",NOP vs. GSW,L,27,4,9,0.444,3,7,0.429,1,1,1.0,1,1,2,2,1,0,2,2,12,-17,1,Matt Ryan,NOP,NOP,GSW,,,16,14,14,4
22023,1630346,22300090,"OCT 28, 2023",NOP vs. NYK,W,26,1,8,0.125,1,8,0.125,0,0,0.0,0,3,3,3,1,1,0,3,3,8,1,Matt Ryan,NOP,NOP,NYK,,,9,6,6,6
22023,1630346,22300071,"OCT 25, 2023",NOP @ MEM,W,14,3,6,0.5,3,6,0.5,0,0,0.0,0,1,1,1,0,0,0,2,9,20,1,Matt Ryan,NOP,MEM,NOP,,,11,10,10,2
22023,1627734,22300552,"JAN 14, 2024",SAC @ MIL,L,45,9,10,0.9,1,1,1.0,2,2,1.0,3,10,13,15,1,1,3,3,21,7,1,Domantas Sabonis,SAC,MIL,SAC,21.0,Points,49,34,36,28
22023,1627734,22300552,"JAN 14, 2024",SAC @ MIL,L,45,9,10,0.9,1,1,1.0,2,2,1.0,3,10,13,15,1,1,3,3,21,7,1,Domantas Sabonis,SAC,MIL,SAC,12.5,Rebounds,49,34,36,28
22023,1627734,22300552,"JAN 14, 2024",SAC @ MIL,L,45,9,10,0.9,1,1,1.0,2,2,1.0,3,10,13,15,1,1,3,3,21,7,1,Domantas Sabonis,SAC,MIL,SAC,42.5,Pts+Rebs+Asts,49,34,36,28
22023,1627734,22300552,"JAN 14, 2024",SAC @ MIL,L,45,9,10,0.9,1,1,1.0,2,2,1.0,3,10,13,15,1,1,3,3,21,7,1,Domantas Sabonis,SAC,MIL,SAC,8.0,Assists,49,34,36,28
22023,1627734,22300552,"JAN 14, 2024",SAC @ MIL,L,45,9,10,0.9,1,1,1.0,2,2,1.0,3,10,13,15,1,1,3,3,21,7,1,Domantas Sabonis,SAC,MIL,SAC,47.0,Fantasy Score,49,34,36,28
22023,1627734,22300552,"JAN 14, 2024",SAC @ MIL,L,45,9,10,0.9,1,1,1.0,2,2,1.0,3,10,13,15,1,1,3,3,21,7,1,Domantas Sabonis,SAC,MIL,SAC,9.0,Defensive Rebounds,49,34,36,28
22023,1627734,22300552,"JAN 14, 2024",SAC @ MIL,L,45,9,10,0.9,1,1,1.0,2,2,1.0,3,10,13,15,1,1,3,3,21,7,1,Domantas Sabonis,SAC,MIL,SAC,3.5,Free Throws Made,49,34,36,28
22023,1627734,22300552,"JAN 14, 2024",SAC @ MIL,L,45,9,10,0.9,1,1,1.0,2,2,1.0,3,10,13,15,1,1,3,3,21,7,1,Domantas Sabonis,SAC,MIL,SAC,14.0,FG Attempted,49,34,36,28
22023,1627734,22300552,"JAN 14, 2024",SAC @ MIL,L,45,9,10,0.9,1,1,1.0,2,2,1.0,3,10,13,15,1,1,3,3,21,7,1,Domantas Sabonis,SAC,MIL,SAC,34.0,Pts+Rebs,49,34,36,28
22023,1627734,22300552,"JAN 14, 2024",SAC @ MIL,L,45,9,10,0.9,1,1,1.0,2,2,1.0,3,10,13,15,1,1,3,3,21,7,1,Domantas Sabonis,SAC,MIL,SAC,29.5,Pts+Asts,49,34,36,28
22023,1627734,22300552,"JAN 14, 2024",SAC @ MIL,L,45,9,10,0.9,1,1,1.0,2,2,1.0,3,10,13,15,1,1,3,3,21,7,1,Domantas Sabonis,SAC,MIL,SAC,20.5,Rebs+Asts,49,34,36,28
22023,1627734,22300532,"JAN 12, 2024",SAC @ PHI,L,33,6,10,0.6,0,0,0.0,2,2,1.0,5,7,12,5,0,0,4,3,14,-20,1,Domantas Sabonis,SAC,PHI,SAC,21.0,Points,31,26,19,17
22023,1627734,22300532,"JAN 12, 2024",SAC @ PHI,L,33,6,10,0.6,0,0,0.0,2,2,1.0,5,7,12,5,0,0,4,3,14,-20,1,Domantas Sabonis,SAC,PHI,SAC,12.5,Rebounds,31,26,19,17
22023,1627734,22300532,"JAN 12, 2024",SAC @ PHI,L,33,6,10,0.6,0,0,0.0,2,2,1.0,5,7,12,5,0,0,4,3,14,-20,1,Domantas Sabonis,SAC,PHI,SAC,42.5,Pts+Rebs+Asts,31,26,19,17
22023,1627734,22300532,"JAN 12, 2024",SAC @ PHI,L,33,6,10,0.6,0,0,0.0,2,2,1.0,5,7,12,5,0,0,4,3,14,-20,1,Domantas Sabonis,SAC,PHI,SAC,8.0,Assists,31,26,19,17
22023,1627734,22300532,"JAN 12, 2024",SAC @ PHI,L,33,6,10,0.6,0,0,0.0,2,2,1.0,5,7,12,5,0,0,4,3,14,-20,1,Domantas Sabonis,SAC,PHI,SAC,47.0,Fantasy Score,31,26,19,17
22023,1627734,22300532,"JAN 12, 2024",SAC @ PHI,L,33,6,10,0.6,0,0,0.0,2,2,1.0,5,7,12,5,0,0,4,3,14,-20,1,Domantas Sabonis,SAC,PHI,SAC,9.0,Defensive Rebounds,31,26,19,17
22023,1627734,22300532,"JAN 12, 2024",SAC @ PHI,L,33,6,10,0.6,0,0,0.0,2,2,1.0,5,7,12,5,0,0,4,3,14,-20,1,Domantas Sabonis,SAC,PHI,SAC,3.5,Free Throws Made,31,26,19,17
22023,1627734,22300532,"JAN 12, 2024",SAC @ PHI,L,33,6,10,0.6,0,0,0.0,2,2,1.0,5,7,12,5,0,0,4,3,14,-20,1,Domantas Sabonis,SAC,PHI,SAC,14.0,FG Attempted,31,26,19,17
22023,1627734,22300532,"JAN 12, 2024",SAC @ PHI,L,33,6,10,0.6,0,0,0.0,2,2,1.0,5,7,12,5,0,0,4,3,14,-20,1,Domantas Sabonis,SAC,PHI,SAC,34.0,Pts+Rebs,31,26,19,17
22023,1627734,22300532,"JAN 12, 2024",SAC @ PHI,L,33,6,10,0.6,0,0,0.0,2,2,1.0,5,7,12,5,0,0,4,3,14,-20,1,Domantas Sabonis,SAC,PHI,SAC,29.5,Pts+Asts,31,26,19,17
22023,1627734,22300532,"JAN 12, 2024",SAC @ PHI,L,33,6,10,0.6,0,0,0.0,2,2,1.0,5,7,12,5,0,0,4,3,14,-20,1,Domantas Sabonis,SAC,PHI,SAC,20.5,Rebs+Asts,31,26,19,17
22023,1627734,22300518,"JAN 10, 2024",SAC @ CHA,W,28,9,13,0.692,1,2,0.5,5,6,0.833,1,9,10,7,0,1,2,2,24,-4,1,Domantas Sabonis,SAC,CHA,SAC,21.0,Points,41,34,31,17
22023,1627734,22300518,"JAN 10, 2024",SAC @ CHA,W,28,9,13,0.692,1,2,0.5,5,6,0.833,1,9,10,7,0,1,2,2,24,-4,1,Domantas Sabonis,SAC,CHA,SAC,12.5,Rebounds,41,34,31,17
22023,1627734,22300518,"JAN 10, 2024",SAC @ CHA,W,28,9,13,0.692,1,2,0.5,5,6,0.833,1,9,10,7,0,1,2,2,24,-4,1,Domantas Sabonis,SAC,CHA,SAC,42.5,Pts+Rebs+Asts,41,34,31,17
22023,1627734,22300518,"JAN 10, 2024",SAC @ CHA,W,28,9,13,0.692,1,2,0.5,5,6,0.833,1,9,10,7,0,1,2,2,24,-4,1,Domantas Sabonis,SAC,CHA,SAC,8.0,Assists,41,34,31,17
22023,1627734,22300518,"JAN 10, 2024",SAC @ CHA,W,28,9,13,0.692,1,2,0.5,5,6,0.833,1,9,10,7,0,1,2,2,24,-4,1,Domantas Sabonis,SAC,CHA,SAC,47.0,Fantasy Score,41,34,31,17
22023,1627734,22300518,"JAN 10, 2024",SAC @ CHA,W,28,9,13,0.692,1,2,0.5,5,6,0.833,1,9,10,7,0,1,2,2,24,-4,1,Domantas Sabonis,SAC,CHA,SAC,9.0,Defensive Rebounds,41,34,31,17
22023,1627734,22300518,"JAN 10, 2024",SAC @ CHA,W,28,9,13,0.692,1,2,0.5,5,6,0.833,1,9,10,7,0,1,2,2,24,-4,1,Domantas Sabonis,SAC,CHA,SAC,3.5,Free Throws Made,41,34,31,17
22023,1627734,22300518,"JAN 10, 2024",SAC @ CHA,W,28,9,13,0.692,1,2,0.5,5,6,0.833,1,9,10,7,0,1,2,2,24,-4,1,Domantas Sabonis,SAC,CHA,SAC,14.0,FG Attempted,41,34,31,17
22023,1627734,22300518,"JAN 10, 2024",SAC @ CHA,W,28,9,13,0.692,1,2,0.5,5,6,0.833,1,9,10,7,0,1,2,2,24,-4,1,Domantas Sabonis,SAC,CHA,SAC,34.0,Pts+Rebs,41,34,31,17
22023,1627734,22300518,"JAN 10, 2024",SAC @ CHA,W,28,9,13,0.692,1,2,0.5,5,6,0.833,1,9,10,7,0,1,2,2,24,-4,1,Domantas Sabonis,SAC,CHA,SAC,29.5,Pts+Asts,41,34,31,17
22023,1627734,22300518,"JAN 10, 2024",SAC @ CHA,W,28,9,13,0.692,1,2,0.5,5,6,0.833,1,9,10,7,0,1,2,2,24,-4,1,Domantas Sabonis,SAC,CHA,SAC,20.5,Rebs+Asts,41,34,31,17
22023,1627734,22300512,"JAN 09, 2024",SAC @ DET,W,38,16,21,0.762,1,1,1.0,4,4,1.0,5,5,10,13,3,0,5,3,37,28,1,Domantas Sabonis,SAC,DET,SAC,21.0,Points,60,47,50,23
22023,1627734,22300512,"JAN 09, 2024",SAC @ DET,W,38,16,21,0.762,1,1,1.0,4,4,1.0,5,5,10,13,3,0,5,3,37,28,1,Domantas Sabonis,SAC,DET,SAC,12.5,Rebounds,60,47,50,23
22023,1627734,22300512,"JAN 09, 2024",SAC @ DET,W,38,16,21,0.762,1,1,1.0,4,4,1.0,5,5,10,13,3,0,5,3,37,28,1,Domantas Sabonis,SAC,DET,SAC,42.5,Pts+Rebs+Asts,60,47,50,23
22023,1627734,22300512,"JAN 09, 2024",SAC @ DET,W,38,16,21,0.762,1,1,1.0,4,4,1.0,5,5,10,13,3,0,5,3,37,28,1,Domantas Sabonis,SAC,DET,SAC,8.0,Assists,60,47,50,23
22023,1627734,22300512,"JAN 09, 2024",SAC @ DET,W,38,16,21,0.762,1,1,1.0,4,4,1.0,5,5,10,13,3,0,5,3,37,28,1,Domantas Sabonis,SAC,DET,SAC,47.0,Fantasy Score,60,47,50,23
22023,1627734,22300512,"JAN 09, 2024",SAC @ DET,W,38,16,21,0.762,1,1,1.0,4,4,1.0,5,5,10,13,3,0,5,3,37,28,1,Domantas Sabonis,SAC,DET,SAC,9.0,Defensive Rebounds,60,47,50,23
22023,1627734,22300512,"JAN 09, 2024",SAC @ DET,W,38,16,21,0.762,1,1,1.0,4,4,1.0,5,5,10,13,3,0,5,3,37,28,1,Domantas Sabonis,SAC,DET,SAC,3.5,Free Throws Made,60,47,50,23
22023,1627734,22300512,"JAN 09, 2024",SAC @ DET,W,38,16,21,0.762,1,1,1.0,4,4,1.0,5,5,10,13,3,0,5,3,37,28,1,Domantas Sabonis,SAC,DET,SAC,14.0,FG Attempted,60,47,50,23
22023,1627734,22300512,"JAN 09, 2024",SAC @ DET,W,38,16,21,0.762,1,1,1.0,4,4,1.0,5,5,10,13,3,0,5,3,37,28,1,Domantas Sabonis,SAC,DET,SAC,34.0,Pts+Rebs,60,47,50,23
22023,1627734,22300512,"JAN 09, 2024",SAC @ DET,W,38,16,21,0.762,1,1,1.0,4,4,1.0,5,5,10,13,3,0,5,3,37,28,1,Domantas Sabonis,SAC,DET,SAC,29.5,Pts+Asts,60,47,50,23
22023,1627734,22300512,"JAN 09, 2024",SAC @ DET,W,38,16,21,0.762,1,1,1.0,4,4,1.0,5,5,10,13,3,0,5,3,37,28,1,Domantas Sabonis,SAC,DET,SAC,20.5,Rebs+Asts,60,47,50,23
22023,1627734,22300500,"JAN 07, 2024",SAC vs. NOP,L,29,8,12,0.667,1,2,0.5,0,1,0.0,0,10,10,6,1,0,3,2,17,-32,1,Domantas Sabonis,SAC,SAC,NOP,21.0,Points,33,27,23,16
22023,1627734,22300500,"JAN 07, 2024",SAC vs. NOP,L,29,8,12,0.667,1,2,0.5,0,1,0.0,0,10,10,6,1,0,3,2,17,-32,1,Domantas Sabonis,SAC,SAC,NOP,12.5,Rebounds,33,27,23,16
22023,1627734,22300500,"JAN 07, 2024",SAC vs. NOP,L,29,8,12,0.667,1,2,0.5,0,1,0.0,0,10,10,6,1,0,3,2,17,-32,1,Domantas Sabonis,SAC,SAC,NOP,42.5,Pts+Rebs+Asts,33,27,23,16
22023,1627734,22300500,"JAN 07, 2024",SAC vs. NOP,L,29,8,12,0.667,1,2,0.5,0,1,0.0,0,10,10,6,1,0,3,2,17,-32,1,Domantas Sabonis,SAC,SAC,NOP,8.0,Assists,33,27,23,16
22023,1627734,22300500,"JAN 07, 2024",SAC vs. NOP,L,29,8,12,0.667,1,2,0.5,0,1,0.0,0,10,10,6,1,0,3,2,17,-32,1,Domantas Sabonis,SAC,SAC,NOP,47.0,Fantasy Score,33,27,23,16
22023,1627734,22300500,"JAN 07, 2024",SAC vs. NOP,L,29,8,12,0.667,1,2,0.5,0,1,0.0,0,10,10,6,1,0,3,2,17,-32,1,Domantas Sabonis,SAC,SAC,NOP,9.0,Defensive Rebounds,33,27,23,16
22023,1627734,22300500,"JAN 07, 2024",SAC vs. NOP,L,29,8,12,0.667,1,2,0.5,0,1,0.0,0,10,10,6,1,0,3,2,17,-32,1,Domantas Sabonis,SAC,SAC,NOP,3.5,Free Throws Made,33,27,23,16
22023,1627734,22300500,"JAN 07, 2024",SAC vs. NOP,L,29,8,12,0.667,1,2,0.5,0,1,0.0,0,10,10,6,1,0,3,2,17,-32,1,Domantas Sabonis,SAC,SAC,NOP,14.0,FG Attempted,33,27,23,16
22023,1627734,22300500,"JAN 07, 2024",SAC vs. NOP,L,29,8,12,0.667,1,2,0.5,0,1,0.0,0,10,10,6,1,0,3,2,17,-32,1,Domantas Sabonis,SAC,SAC,NOP,34.0,Pts+Rebs,33,27,23,16
22023,1627734,22300500,"JAN 07, 2024",SAC vs. NOP,L,29,8,12,0.667,1,2,0.5,0,1,0.0,0,10,10,6,1,0,3,2,17,-32,1,Domantas Sabonis,SAC,SAC,NOP,29.5,Pts+Asts,33,27,23,16
22023,1627734,22300500,"JAN 07, 2024",SAC vs. NOP,L,29,8,12,0.667,1,2,0.5,0,1,0.0,0,10,10,6,1,0,3,2,17,-32,1,Domantas Sabonis,SAC,SAC,NOP,20.5,Rebs+Asts,33,27,23,16
22023,1627734,22300492,"JAN 05, 2024",SAC vs. TOR,W,39,11,16,0.688,0,0,0.0,2,3,0.667,4,11,15,11,0,0,6,6,24,12,1,Domantas Sabonis,SAC,SAC,TOR,21.0,Points,50,39,35,26
22023,1627734,22300492,"JAN 05, 2024",SAC vs. TOR,W,39,11,16,0.688,0,0,0.0,2,3,0.667,4,11,15,11,0,0,6,6,24,12,1,Domantas Sabonis,SAC,SAC,TOR,12.5,Rebounds,50,39,35,26
22023,1627734,22300492,"JAN 05, 2024",SAC vs. TOR,W,39,11,16,0.688,0,0,0.0,2,3,0.667,4,11,15,11,0,0,6,6,24,12,1,Domantas Sabonis,SAC,SAC,TOR,42.5,Pts+Rebs+Asts,50,39,35,26
22023,1627734,22300492,"JAN 05, 2024",SAC vs. TOR,W,39,11,16,0.688,0,0,0.0,2,3,0.667,4,11,15,11,0,0,6,6,24,12,1,Domantas Sabonis,SAC,SAC,TOR,8.0,Assists,50,39,35,26
22023,1627734,22300492,"JAN 05, 2024",SAC vs. TOR,W,39,11,16,0.688,0,0,0.0,2,3,0.667,4,11,15,11,0,0,6,6,24,12,1,Domantas Sabonis,SAC,SAC,TOR,47.0,Fantasy Score,50,39,35,26
22023,1627734,22300492,"JAN 05, 2024",SAC vs. TOR,W,39,11,16,0.688,0,0,0.0,2,3,0.667,4,11,15,11,0,0,6,6,24,12,1,Domantas Sabonis,SAC,SAC,TOR,9.0,Defensive Rebounds,50,39,35,26
22023,1627734,22300492,"JAN 05, 2024",SAC vs. TOR,W,39,11,16,0.688,0,0,0.0,2,3,0.667,4,11,15,11,0,0,6,6,24,12,1,Domantas Sabonis,SAC,SAC,TOR,3.5,Free Throws Made,50,39,35,26
22023,1627734,22300492,"JAN 05, 2024",SAC vs. TOR,W,39,11,16,0.688,0,0,0.0,2,3,0.667,4,11,15,11,0,0,6,6,24,12,1,Domantas Sabonis,SAC,SAC,TOR,14.0,FG Attempted,50,39,35,26
22023,1627734,22300492,"JAN 05, 2024",SAC vs. TOR,W,39,11,16,0.688,0,0,0.0,2,3,0.667,4,11,15,11,0,0,6,6,24,12,1,Domantas Sabonis,SAC,SAC,TOR,34.0,Pts+Rebs,50,39,35,26
22023,1627734,22300492,"JAN 05, 2024",SAC vs. TOR,W,39,11,16,0.688,0,0,0.0,2,3,0.667,4,11,15,11,0,0,6,6,24,12,1,Domantas Sabonis,SAC,SAC,TOR,29.5,Pts+Asts,50,39,35,26
22023,1627734,22300492,"JAN 05, 2024",SAC vs. TOR,W,39,11,16,0.688,0,0,0.0,2,3,0.667,4,11,15,11,0,0,6,6,24,12,1,Domantas Sabonis,SAC,SAC,TOR,20.5,Rebs+Asts,50,39,35,26
22023,1627734,22300476,"JAN 03, 2024",SAC vs. ORL,W,45,8,14,0.571,0,0,0.0,6,9,0.667,6,17,23,12,2,1,6,2,22,10,1,Domantas Sabonis,SAC,SAC,ORL,21.0,Points,57,45,34,35
22023,1627734,22300476,"JAN 03, 2024",SAC vs. ORL,W,45,8,14,0.571,0,0,0.0,6,9,0.667,6,17,23,12,2,1,6,2,22,10,1,Domantas Sabonis,SAC,SAC,ORL,12.5,Rebounds,57,45,34,35
22023,1627734,22300476,"JAN 03, 2024",SAC vs. ORL,W,45,8,14,0.571,0,0,0.0,6,9,0.667,6,17,23,12,2,1,6,2,22,10,1,Domantas Sabonis,SAC,SAC,ORL,42.5,Pts+Rebs+Asts,57,45,34,35
22023,1627734,22300476,"JAN 03, 2024",SAC vs. ORL,W,45,8,14,0.571,0,0,0.0,6,9,0.667,6,17,23,12,2,1,6,2,22,10,1,Domantas Sabonis,SAC,SAC,ORL,8.0,Assists,57,45,34,35
22023,1627734,22300476,"JAN 03, 2024",SAC vs. ORL,W,45,8,14,0.571,0,0,0.0,6,9,0.667,6,17,23,12,2,1,6,2,22,10,1,Domantas Sabonis,SAC,SAC,ORL,47.0,Fantasy Score,57,45,34,35
22023,1627734,22300476,"JAN 03, 2024",SAC vs. ORL,W,45,8,14,0.571,0,0,0.0,6,9,0.667,6,17,23,12,2,1,6,2,22,10,1,Domantas Sabonis,SAC,SAC,ORL,9.0,Defensive Rebounds,57,45,34,35
22023,1627734,22300476,"JAN 03, 2024",SAC vs. ORL,W,45,8,14,0.571,0,0,0.0,6,9,0.667,6,17,23,12,2,1,6,2,22,10,1,Domantas Sabonis,SAC,SAC,ORL,3.5,Free Throws Made,57,45,34,35
22023,1627734,22300476,"JAN 03, 2024",SAC vs. ORL,W,45,8,14,0.571,0,0,0.0,6,9,0.667,6,17,23,12,2,1,6,2,22,10,1,Domantas Sabonis,SAC,SAC,ORL,14.0,FG Attempted,57,45,34,35
22023,1627734,22300476,"JAN 03, 2024",SAC vs. ORL,W,45,8,14,0.571,0,0,0.0,6,9,0.667,6,17,23,12,2,1,6,2,22,10,1,Domantas Sabonis,SAC,SAC,ORL,34.0,Pts+Rebs,57,45,34,35
22023,1627734,22300476,"JAN 03, 2024",SAC vs. ORL,W,45,8,14,0.571,0,0,0.0,6,9,0.667,6,17,23,12,2,1,6,2,22,10,1,Domantas Sabonis,SAC,SAC,ORL,29.5,Pts+Asts,57,45,34,35
22023,1627734,22300476,"JAN 03, 2024",SAC vs. ORL,W,45,8,14,0.571,0,0,0.0,6,9,0.667,6,17,23,12,2,1,6,2,22,10,1,Domantas Sabonis,SAC,SAC,ORL,20.5,Rebs+Asts,57,45,34,35
22023,1627734,22300464,"JAN 02, 2024",SAC vs. CHA,L,35,11,21,0.524,1,1,1.0,0,1,0.0,9,10,19,4,1,0,11,5,23,-3,1,Domantas Sabonis,SAC,SAC,CHA,21.0,Points,46,42,27,23
22023,1627734,22300464,"JAN 02, 2024",SAC vs. CHA,L,35,11,21,0.524,1,1,1.0,0,1,0.0,9,10,19,4,1,0,11,5,23,-3,1,Domantas Sabonis,SAC,SAC,CHA,12.5,Rebounds,46,42,27,23
22023,1627734,22300464,"JAN 02, 2024",SAC vs. CHA,L,35,11,21,0.524,1,1,1.0,0,1,0.0,9,10,19,4,1,0,11,5,23,-3,1,Domantas Sabonis,SAC,SAC,CHA,42.5,Pts+Rebs+Asts,46,42,27,23
22023,1627734,22300464,"JAN 02, 2024",SAC vs. CHA,L,35,11,21,0.524,1,1,1.0,0,1,0.0,9,10,19,4,1,0,11,5,23,-3,1,Domantas Sabonis,SAC,SAC,CHA,8.0,Assists,46,42,27,23
22023,1627734,22300464,"JAN 02, 2024",SAC vs. CHA,L,35,11,21,0.524,1,1,1.0,0,1,0.0,9,10,19,4,1,0,11,5,23,-3,1,Domantas Sabonis,SAC,SAC,CHA,47.0,Fantasy Score,46,42,27,23
22023,1627734,22300464,"JAN 02, 2024",SAC vs. CHA,L,35,11,21,0.524,1,1,1.0,0,1,0.0,9,10,19,4,1,0,11,5,23,-3,1,Domantas Sabonis,SAC,SAC,CHA,9.0,Defensive Rebounds,46,42,27,23
22023,1627734,22300464,"JAN 02, 2024",SAC vs. CHA,L,35,11,21,0.524,1,1,1.0,0,1,0.0,9,10,19,4,1,0,11,5,23,-3,1,Domantas Sabonis,SAC,SAC,CHA,3.5,Free Throws Made,46,42,27,23
22023,1627734,22300464,"JAN 02, 2024",SAC vs. CHA,L,35,11,21,0.524,1,1,1.0,0,1,0.0,9,10,19,4,1,0,11,5,23,-3,1,Domantas Sabonis,SAC,SAC,CHA,14.0,FG Attempted,46,42,27,23
22023,1627734,22300464,"JAN 02, 2024",SAC vs. CHA,L,35,11,21,0.524,1,1,1.0,0,1,0.0,9,10,19,4,1,0,11,5,23,-3,1,Domantas Sabonis,SAC,SAC,CHA,34.0,Pts+Rebs,46,42,27,23
22023,1627734,22300464,"JAN 02, 2024",SAC vs. CHA,L,35,11,21,0.524,1,1,1.0,0,1,0.0,9,10,19,4,1,0,11,5,23,-3,1,Domantas Sabonis,SAC,SAC,CHA,29.5,Pts+Asts,46,42,27,23
22023,1627734,22300464,"JAN 02, 2024",SAC vs. CHA,L,35,11,21,0.524,1,1,1.0,0,1,0.0,9,10,19,4,1,0,11,5,23,-3,1,Domantas Sabonis,SAC,SAC,CHA,20.5,Rebs+Asts,46,42,27,23
22023,1627734,22300449,"DEC 31, 2023",SAC @ MEM,W,32,5,11,0.455,0,1,0.0,3,5,0.6,2,19,21,12,1,0,3,4,13,17,1,Domantas Sabonis,SAC,MEM,SAC,21.0,Points,46,34,25,33
22023,1627734,22300449,"DEC 31, 2023",SAC @ MEM,W,32,5,11,0.455,0,1,0.0,3,5,0.6,2,19,21,12,1,0,3,4,13,17,1,Domantas Sabonis,SAC,MEM,SAC,12.5,Rebounds,46,34,25,33
22023,1627734,22300449,"DEC 31, 2023",SAC @ MEM,W,32,5,11,0.455,0,1,0.0,3,5,0.6,2,19,21,12,1,0,3,4,13,17,1,Domantas Sabonis,SAC,MEM,SAC,42.5,Pts+Rebs+Asts,46,34,25,33
22023,1627734,22300449,"DEC 31, 2023",SAC @ MEM,W,32,5,11,0.455,0,1,0.0,3,5,0.6,2,19,21,12,1,0,3,4,13,17,1,Domantas Sabonis,SAC,MEM,SAC,8.0,Assists,46,34,25,33
22023,1627734,22300449,"DEC 31, 2023",SAC @ MEM,W,32,5,11,0.455,0,1,0.0,3,5,0.6,2,19,21,12,1,0,3,4,13,17,1,Domantas Sabonis,SAC,MEM,SAC,47.0,Fantasy Score,46,34,25,33
22023,1627734,22300449,"DEC 31, 2023",SAC @ MEM,W,32,5,11,0.455,0,1,0.0,3,5,0.6,2,19,21,12,1,0,3,4,13,17,1,Domantas Sabonis,SAC,MEM,SAC,9.0,Defensive Rebounds,46,34,25,33
22023,1627734,22300449,"DEC 31, 2023",SAC @ MEM,W,32,5,11,0.455,0,1,0.0,3,5,0.6,2,19,21,12,1,0,3,4,13,17,1,Domantas Sabonis,SAC,MEM,SAC,3.5,Free Throws Made,46,34,25,33
22023,1627734,22300449,"DEC 31, 2023",SAC @ MEM,W,32,5,11,0.455,0,1,0.0,3,5,0.6,2,19,21,12,1,0,3,4,13,17,1,Domantas Sabonis,SAC,MEM,SAC,14.0,FG Attempted,46,34,25,33
22023,1627734,22300449,"DEC 31, 2023",SAC @ MEM,W,32,5,11,0.455,0,1,0.0,3,5,0.6,2,19,21,12,1,0,3,4,13,17,1,Domantas Sabonis,SAC,MEM,SAC,34.0,Pts+Rebs,46,34,25,33
22023,1627734,22300449,"DEC 31, 2023",SAC @ MEM,W,32,5,11,0.455,0,1,0.0,3,5,0.6,2,19,21,12,1,0,3,4,13,17,1,Domantas Sabonis,SAC,MEM,SAC,29.5,Pts+Asts,46,34,25,33
22023,1627734,22300449,"DEC 31, 2023",SAC @ MEM,W,32,5,11,0.455,0,1,0.0,3,5,0.6,2,19,21,12,1,0,3,4,13,17,1,Domantas Sabonis,SAC,MEM,SAC,20.5,Rebs+Asts,46,34,25,33
22023,1627734,22300431,"DEC 29, 2023",SAC @ ATL,W,35,12,17,0.706,0,0,0.0,1,4,0.25,2,8,10,7,0,0,1,2,25,-4,1,Domantas Sabonis,SAC,ATL,SAC,21.0,Points,42,35,32,17
22023,1627734,22300431,"DEC 29, 2023",SAC @ ATL,W,35,12,17,0.706,0,0,0.0,1,4,0.25,2,8,10,7,0,0,1,2,25,-4,1,Domantas Sabonis,SAC,ATL,SAC,12.5,Rebounds,42,35,32,17
22023,1627734,22300431,"DEC 29, 2023",SAC @ ATL,W,35,12,17,0.706,0,0,0.0,1,4,0.25,2,8,10,7,0,0,1,2,25,-4,1,Domantas Sabonis,SAC,ATL,SAC,42.5,Pts+Rebs+Asts,42,35,32,17
22023,1627734,22300431,"DEC 29, 2023",SAC @ ATL,W,35,12,17,0.706,0,0,0.0,1,4,0.25,2,8,10,7,0,0,1,2,25,-4,1,Domantas Sabonis,SAC,ATL,SAC,8.0,Assists,42,35,32,17
22023,1627734,22300431,"DEC 29, 2023",SAC @ ATL,W,35,12,17,0.706,0,0,0.0,1,4,0.25,2,8,10,7,0,0,1,2,25,-4,1,Domantas Sabonis,SAC,ATL,SAC,47.0,Fantasy Score,42,35,32,17
22023,1627734,22300431,"DEC 29, 2023",SAC @ ATL,W,35,12,17,0.706,0,0,0.0,1,4,0.25,2,8,10,7,0,0,1,2,25,-4,1,Domantas Sabonis,SAC,ATL,SAC,9.0,Defensive Rebounds,42,35,32,17
22023,1627734,22300431,"DEC 29, 2023",SAC @ ATL,W,35,12,17,0.706,0,0,0.0,1,4,0.25,2,8,10,7,0,0,1,2,25,-4,1,Domantas Sabonis,SAC,ATL,SAC,3.5,Free Throws Made,42,35,32,17
22023,1627734,22300431,"DEC 29, 2023",SAC @ ATL,W,35,12,17,0.706,0,0,0.0,1,4,0.25,2,8,10,7,0,0,1,2,25,-4,1,Domantas Sabonis,SAC,ATL,SAC,14.0,FG Attempted,42,35,32,17
22023,1627734,22300431,"DEC 29, 2023",SAC @ ATL,W,35,12,17,0.706,0,0,0.0,1,4,0.25,2,8,10,7,0,0,1,2,25,-4,1,Domantas Sabonis,SAC,ATL,SAC,34.0,Pts+Rebs,42,35,32,17
22023,1627734,22300431,"DEC 29, 2023",SAC @ ATL,W,35,12,17,0.706,0,0,0.0,1,4,0.25,2,8,10,7,0,0,1,2,25,-4,1,Domantas Sabonis,SAC,ATL,SAC,29.5,Pts+Asts,42,35,32,17
22023,1627734,22300431,"DEC 29, 2023",SAC @ ATL,W,35,12,17,0.706,0,0,0.0,1,4,0.25,2,8,10,7,0,0,1,2,25,-4,1,Domantas Sabonis,SAC,ATL,SAC,20.5,Rebs+Asts,42,35,32,17
22023,1627734,22300413,"DEC 26, 2023",SAC @ POR,L,36,14,19,0.737,0,0,0.0,6,7,0.857,3,9,12,5,0,0,2,4,34,-9,1,Domantas Sabonis,SAC,POR,SAC,21.0,Points,51,46,39,17
22023,1627734,22300413,"DEC 26, 2023",SAC @ POR,L,36,14,19,0.737,0,0,0.0,6,7,0.857,3,9,12,5,0,0,2,4,34,-9,1,Domantas Sabonis,SAC,POR,SAC,12.5,Rebounds,51,46,39,17
22023,1627734,22300413,"DEC 26, 2023",SAC @ POR,L,36,14,19,0.737,0,0,0.0,6,7,0.857,3,9,12,5,0,0,2,4,34,-9,1,Domantas Sabonis,SAC,POR,SAC,42.5,Pts+Rebs+Asts,51,46,39,17
22023,1627734,22300413,"DEC 26, 2023",SAC @ POR,L,36,14,19,0.737,0,0,0.0,6,7,0.857,3,9,12,5,0,0,2,4,34,-9,1,Domantas Sabonis,SAC,POR,SAC,8.0,Assists,51,46,39,17
22023,1627734,22300413,"DEC 26, 2023",SAC @ POR,L,36,14,19,0.737,0,0,0.0,6,7,0.857,3,9,12,5,0,0,2,4,34,-9,1,Domantas Sabonis,SAC,POR,SAC,47.0,Fantasy Score,51,46,39,17
22023,1627734,22300413,"DEC 26, 2023",SAC @ POR,L,36,14,19,0.737,0,0,0.0,6,7,0.857,3,9,12,5,0,0,2,4,34,-9,1,Domantas Sabonis,SAC,POR,SAC,9.0,Defensive Rebounds,51,46,39,17
22023,1627734,22300413,"DEC 26, 2023",SAC @ POR,L,36,14,19,0.737,0,0,0.0,6,7,0.857,3,9,12,5,0,0,2,4,34,-9,1,Domantas Sabonis,SAC,POR,SAC,3.5,Free Throws Made,51,46,39,17
22023,1627734,22300413,"DEC 26, 2023",SAC @ POR,L,36,14,19,0.737,0,0,0.0,6,7,0.857,3,9,12,5,0,0,2,4,34,-9,1,Domantas Sabonis,SAC,POR,SAC,14.0,FG Attempted,51,46,39,17
22023,1627734,22300413,"DEC 26, 2023",SAC @ POR,L,36,14,19,0.737,0,0,0.0,6,7,0.857,3,9,12,5,0,0,2,4,34,-9,1,Domantas Sabonis,SAC,POR,SAC,34.0,Pts+Rebs,51,46,39,17
22023,1627734,22300413,"DEC 26, 2023",SAC @ POR,L,36,14,19,0.737,0,0,0.0,6,7,0.857,3,9,12,5,0,0,2,4,34,-9,1,Domantas Sabonis,SAC,POR,SAC,29.5,Pts+Asts,51,46,39,17
22023,1627734,22300413,"DEC 26, 2023",SAC @ POR,L,36,14,19,0.737,0,0,0.0,6,7,0.857,3,9,12,5,0,0,2,4,34,-9,1,Domantas Sabonis,SAC,POR,SAC,20.5,Rebs+Asts,51,46,39,17
22023,1627734,22300400,"DEC 23, 2023",SAC vs. MIN,L,39,7,12,0.583,0,1,0.0,3,5,0.6,1,9,10,10,1,0,3,3,17,-17,1,Domantas Sabonis,SAC,SAC,MIN,21.0,Points,37,27,27,20
22023,1627734,22300400,"DEC 23, 2023",SAC vs. MIN,L,39,7,12,0.583,0,1,0.0,3,5,0.6,1,9,10,10,1,0,3,3,17,-17,1,Domantas Sabonis,SAC,SAC,MIN,12.5,Rebounds,37,27,27,20
22023,1627734,22300400,"DEC 23, 2023",SAC vs. MIN,L,39,7,12,0.583,0,1,0.0,3,5,0.6,1,9,10,10,1,0,3,3,17,-17,1,Domantas Sabonis,SAC,SAC,MIN,42.5,Pts+Rebs+Asts,37,27,27,20
22023,1627734,22300400,"DEC 23, 2023",SAC vs. MIN,L,39,7,12,0.583,0,1,0.0,3,5,0.6,1,9,10,10,1,0,3,3,17,-17,1,Domantas Sabonis,SAC,SAC,MIN,8.0,Assists,37,27,27,20
22023,1627734,22300400,"DEC 23, 2023",SAC vs. MIN,L,39,7,12,0.583,0,1,0.0,3,5,0.6,1,9,10,10,1,0,3,3,17,-17,1,Domantas Sabonis,SAC,SAC,MIN,47.0,Fantasy Score,37,27,27,20
22023,1627734,22300400,"DEC 23, 2023",SAC vs. MIN,L,39,7,12,0.583,0,1,0.0,3,5,0.6,1,9,10,10,1,0,3,3,17,-17,1,Domantas Sabonis,SAC,SAC,MIN,9.0,Defensive Rebounds,37,27,27,20
22023,1627734,22300400,"DEC 23, 2023",SAC vs. MIN,L,39,7,12,0.583,0,1,0.0,3,5,0.6,1,9,10,10,1,0,3,3,17,-17,1,Domantas Sabonis,SAC,SAC,MIN,3.5,Free Throws Made,37,27,27,20
22023,1627734,22300400,"DEC 23, 2023",SAC vs. MIN,L,39,7,12,0.583,0,1,0.0,3,5,0.6,1,9,10,10,1,0,3,3,17,-17,1,Domantas Sabonis,SAC,SAC,MIN,14.0,FG Attempted,37,27,27,20
22023,1627734,22300400,"DEC 23, 2023",SAC vs. MIN,L,39,7,12,0.583,0,1,0.0,3,5,0.6,1,9,10,10,1,0,3,3,17,-17,1,Domantas Sabonis,SAC,SAC,MIN,34.0,Pts+Rebs,37,27,27,20
22023,1627734,22300400,"DEC 23, 2023",SAC vs. MIN,L,39,7,12,0.583,0,1,0.0,3,5,0.6,1,9,10,10,1,0,3,3,17,-17,1,Domantas Sabonis,SAC,SAC,MIN,29.5,Pts+Asts,37,27,27,20
22023,1627734,22300400,"DEC 23, 2023",SAC vs. MIN,L,39,7,12,0.583,0,1,0.0,3,5,0.6,1,9,10,10,1,0,3,3,17,-17,1,Domantas Sabonis,SAC,SAC,MIN,20.5,Rebs+Asts,37,27,27,20
22023,1627734,22300387,"DEC 22, 2023",SAC vs. PHX,W,35,12,15,0.8,0,2,0.0,4,5,0.8,1,10,11,12,0,0,3,3,28,27,1,Domantas Sabonis,SAC,SAC,PHX,21.0,Points,51,39,40,23
22023,1627734,22300387,"DEC 22, 2023",SAC vs. PHX,W,35,12,15,0.8,0,2,0.0,4,5,0.8,1,10,11,12,0,0,3,3,28,27,1,Domantas Sabonis,SAC,SAC,PHX,12.5,Rebounds,51,39,40,23
22023,1627734,22300387,"DEC 22, 2023",SAC vs. PHX,W,35,12,15,0.8,0,2,0.0,4,5,0.8,1,10,11,12,0,0,3,3,28,27,1,Domantas Sabonis,SAC,SAC,PHX,42.5,Pts+Rebs+Asts,51,39,40,23
22023,1627734,22300387,"DEC 22, 2023",SAC vs. PHX,W,35,12,15,0.8,0,2,0.0,4,5,0.8,1,10,11,12,0,0,3,3,28,27,1,Domantas Sabonis,SAC,SAC,PHX,8.0,Assists,51,39,40,23
22023,1627734,22300387,"DEC 22, 2023",SAC vs. PHX,W,35,12,15,0.8,0,2,0.0,4,5,0.8,1,10,11,12,0,0,3,3,28,27,1,Domantas Sabonis,SAC,SAC,PHX,47.0,Fantasy Score,51,39,40,23
22023,1627734,22300387,"DEC 22, 2023",SAC vs. PHX,W,35,12,15,0.8,0,2,0.0,4,5,0.8,1,10,11,12,0,0,3,3,28,27,1,Domantas Sabonis,SAC,SAC,PHX,9.0,Defensive Rebounds,51,39,40,23
22023,1627734,22300387,"DEC 22, 2023",SAC vs. PHX,W,35,12,15,0.8,0,2,0.0,4,5,0.8,1,10,11,12,0,0,3,3,28,27,1,Domantas Sabonis,SAC,SAC,PHX,3.5,Free Throws Made,51,39,40,23
22023,1627734,22300387,"DEC 22, 2023",SAC vs. PHX,W,35,12,15,0.8,0,2,0.0,4,5,0.8,1,10,11,12,0,0,3,3,28,27,1,Domantas Sabonis,SAC,SAC,PHX,14.0,FG Attempted,51,39,40,23
22023,1627734,22300387,"DEC 22, 2023",SAC vs. PHX,W,35,12,15,0.8,0,2,0.0,4,5,0.8,1,10,11,12,0,0,3,3,28,27,1,Domantas Sabonis,SAC,SAC,PHX,34.0,Pts+Rebs,51,39,40,23
22023,1627734,22300387,"DEC 22, 2023",SAC vs. PHX,W,35,12,15,0.8,0,2,0.0,4,5,0.8,1,10,11,12,0,0,3,3,28,27,1,Domantas Sabonis,SAC,SAC,PHX,29.5,Pts+Asts,51,39,40,23
22023,1627734,22300387,"DEC 22, 2023",SAC vs. PHX,W,35,12,15,0.8,0,2,0.0,4,5,0.8,1,10,11,12,0,0,3,3,28,27,1,Domantas Sabonis,SAC,SAC,PHX,20.5,Rebs+Asts,51,39,40,23
22023,1627734,22300373,"DEC 20, 2023",SAC vs. BOS,L,26,6,14,0.429,0,1,0.0,1,4,0.25,5,5,10,8,0,1,1,2,13,-25,1,Domantas Sabonis,SAC,SAC,BOS,21.0,Points,31,23,21,18
22023,1627734,22300373,"DEC 20, 2023",SAC vs. BOS,L,26,6,14,0.429,0,1,0.0,1,4,0.25,5,5,10,8,0,1,1,2,13,-25,1,Domantas Sabonis,SAC,SAC,BOS,12.5,Rebounds,31,23,21,18
22023,1627734,22300373,"DEC 20, 2023",SAC vs. BOS,L,26,6,14,0.429,0,1,0.0,1,4,0.25,5,5,10,8,0,1,1,2,13,-25,1,Domantas Sabonis,SAC,SAC,BOS,42.5,Pts+Rebs+Asts,31,23,21,18
22023,1627734,22300373,"DEC 20, 2023",SAC vs. BOS,L,26,6,14,0.429,0,1,0.0,1,4,0.25,5,5,10,8,0,1,1,2,13,-25,1,Domantas Sabonis,SAC,SAC,BOS,8.0,Assists,31,23,21,18
22023,1627734,22300373,"DEC 20, 2023",SAC vs. BOS,L,26,6,14,0.429,0,1,0.0,1,4,0.25,5,5,10,8,0,1,1,2,13,-25,1,Domantas Sabonis,SAC,SAC,BOS,47.0,Fantasy Score,31,23,21,18
22023,1627734,22300373,"DEC 20, 2023",SAC vs. BOS,L,26,6,14,0.429,0,1,0.0,1,4,0.25,5,5,10,8,0,1,1,2,13,-25,1,Domantas Sabonis,SAC,SAC,BOS,9.0,Defensive Rebounds,31,23,21,18
22023,1627734,22300373,"DEC 20, 2023",SAC vs. BOS,L,26,6,14,0.429,0,1,0.0,1,4,0.25,5,5,10,8,0,1,1,2,13,-25,1,Domantas Sabonis,SAC,SAC,BOS,3.5,Free Throws Made,31,23,21,18
22023,1627734,22300373,"DEC 20, 2023",SAC vs. BOS,L,26,6,14,0.429,0,1,0.0,1,4,0.25,5,5,10,8,0,1,1,2,13,-25,1,Domantas Sabonis,SAC,SAC,BOS,14.0,FG Attempted,31,23,21,18
22023,1627734,22300373,"DEC 20, 2023",SAC vs. BOS,L,26,6,14,0.429,0,1,0.0,1,4,0.25,5,5,10,8,0,1,1,2,13,-25,1,Domantas Sabonis,SAC,SAC,BOS,34.0,Pts+Rebs,31,23,21,18
22023,1627734,22300373,"DEC 20, 2023",SAC vs. BOS,L,26,6,14,0.429,0,1,0.0,1,4,0.25,5,5,10,8,0,1,1,2,13,-25,1,Domantas Sabonis,SAC,SAC,BOS,29.5,Pts+Asts,31,23,21,18
22023,1627734,22300373,"DEC 20, 2023",SAC vs. BOS,L,26,6,14,0.429,0,1,0.0,1,4,0.25,5,5,10,8,0,1,1,2,13,-25,1,Domantas Sabonis,SAC,SAC,BOS,20.5,Rebs+Asts,31,23,21,18
22023,1627734,22300358,"DEC 18, 2023",SAC vs. WAS,W,32,11,16,0.688,1,1,1.0,5,6,0.833,3,10,13,12,0,1,2,1,28,25,1,Domantas Sabonis,SAC,SAC,WAS,21.0,Points,53,41,40,25
22023,1627734,22300358,"DEC 18, 2023",SAC vs. WAS,W,32,11,16,0.688,1,1,1.0,5,6,0.833,3,10,13,12,0,1,2,1,28,25,1,Domantas Sabonis,SAC,SAC,WAS,12.5,Rebounds,53,41,40,25
22023,1627734,22300358,"DEC 18, 2023",SAC vs. WAS,W,32,11,16,0.688,1,1,1.0,5,6,0.833,3,10,13,12,0,1,2,1,28,25,1,Domantas Sabonis,SAC,SAC,WAS,42.5,Pts+Rebs+Asts,53,41,40,25
22023,1627734,22300358,"DEC 18, 2023",SAC vs. WAS,W,32,11,16,0.688,1,1,1.0,5,6,0.833,3,10,13,12,0,1,2,1,28,25,1,Domantas Sabonis,SAC,SAC,WAS,8.0,Assists,53,41,40,25
22023,1627734,22300358,"DEC 18, 2023",SAC vs. WAS,W,32,11,16,0.688,1,1,1.0,5,6,0.833,3,10,13,12,0,1,2,1,28,25,1,Domantas Sabonis,SAC,SAC,WAS,47.0,Fantasy Score,53,41,40,25
22023,1627734,22300358,"DEC 18, 2023",SAC vs. WAS,W,32,11,16,0.688,1,1,1.0,5,6,0.833,3,10,13,12,0,1,2,1,28,25,1,Domantas Sabonis,SAC,SAC,WAS,9.0,Defensive Rebounds,53,41,40,25
22023,1627734,22300358,"DEC 18, 2023",SAC vs. WAS,W,32,11,16,0.688,1,1,1.0,5,6,0.833,3,10,13,12,0,1,2,1,28,25,1,Domantas Sabonis,SAC,SAC,WAS,3.5,Free Throws Made,53,41,40,25
22023,1627734,22300358,"DEC 18, 2023",SAC vs. WAS,W,32,11,16,0.688,1,1,1.0,5,6,0.833,3,10,13,12,0,1,2,1,28,25,1,Domantas Sabonis,SAC,SAC,WAS,14.0,FG Attempted,53,41,40,25
22023,1627734,22300358,"DEC 18, 2023",SAC vs. WAS,W,32,11,16,0.688,1,1,1.0,5,6,0.833,3,10,13,12,0,1,2,1,28,25,1,Domantas Sabonis,SAC,SAC,WAS,34.0,Pts+Rebs,53,41,40,25
22023,1627734,22300358,"DEC 18, 2023",SAC vs. WAS,W,32,11,16,0.688,1,1,1.0,5,6,0.833,3,10,13,12,0,1,2,1,28,25,1,Domantas Sabonis,SAC,SAC,WAS,29.5,Pts+Asts,53,41,40,25
22023,1627734,22300358,"DEC 18, 2023",SAC vs. WAS,W,32,11,16,0.688,1,1,1.0,5,6,0.833,3,10,13,12,0,1,2,1,28,25,1,Domantas Sabonis,SAC,SAC,WAS,20.5,Rebs+Asts,53,41,40,25
22023,1627734,22300342,"DEC 16, 2023",SAC vs. UTA,W,35,9,10,0.9,0,1,0.0,2,4,0.5,2,8,10,8,2,0,6,1,20,34,1,Domantas Sabonis,SAC,SAC,UTA,21.0,Points,38,30,28,18
22023,1627734,22300342,"DEC 16, 2023",SAC vs. UTA,W,35,9,10,0.9,0,1,0.0,2,4,0.5,2,8,10,8,2,0,6,1,20,34,1,Domantas Sabonis,SAC,SAC,UTA,12.5,Rebounds,38,30,28,18
22023,1627734,22300342,"DEC 16, 2023",SAC vs. UTA,W,35,9,10,0.9,0,1,0.0,2,4,0.5,2,8,10,8,2,0,6,1,20,34,1,Domantas Sabonis,SAC,SAC,UTA,42.5,Pts+Rebs+Asts,38,30,28,18
22023,1627734,22300342,"DEC 16, 2023",SAC vs. UTA,W,35,9,10,0.9,0,1,0.0,2,4,0.5,2,8,10,8,2,0,6,1,20,34,1,Domantas Sabonis,SAC,SAC,UTA,8.0,Assists,38,30,28,18
22023,1627734,22300342,"DEC 16, 2023",SAC vs. UTA,W,35,9,10,0.9,0,1,0.0,2,4,0.5,2,8,10,8,2,0,6,1,20,34,1,Domantas Sabonis,SAC,SAC,UTA,47.0,Fantasy Score,38,30,28,18
22023,1627734,22300342,"DEC 16, 2023",SAC vs. UTA,W,35,9,10,0.9,0,1,0.0,2,4,0.5,2,8,10,8,2,0,6,1,20,34,1,Domantas Sabonis,SAC,SAC,UTA,9.0,Defensive Rebounds,38,30,28,18
22023,1627734,22300342,"DEC 16, 2023",SAC vs. UTA,W,35,9,10,0.9,0,1,0.0,2,4,0.5,2,8,10,8,2,0,6,1,20,34,1,Domantas Sabonis,SAC,SAC,UTA,3.5,Free Throws Made,38,30,28,18
22023,1627734,22300342,"DEC 16, 2023",SAC vs. UTA,W,35,9,10,0.9,0,1,0.0,2,4,0.5,2,8,10,8,2,0,6,1,20,34,1,Domantas Sabonis,SAC,SAC,UTA,14.0,FG Attempted,38,30,28,18
22023,1627734,22300342,"DEC 16, 2023",SAC vs. UTA,W,35,9,10,0.9,0,1,0.0,2,4,0.5,2,8,10,8,2,0,6,1,20,34,1,Domantas Sabonis,SAC,SAC,UTA,34.0,Pts+Rebs,38,30,28,18
22023,1627734,22300342,"DEC 16, 2023",SAC vs. UTA,W,35,9,10,0.9,0,1,0.0,2,4,0.5,2,8,10,8,2,0,6,1,20,34,1,Domantas Sabonis,SAC,SAC,UTA,29.5,Pts+Asts,38,30,28,18
22023,1627734,22300342,"DEC 16, 2023",SAC vs. UTA,W,35,9,10,0.9,0,1,0.0,2,4,0.5,2,8,10,8,2,0,6,1,20,34,1,Domantas Sabonis,SAC,SAC,UTA,20.5,Rebs+Asts,38,30,28,18
22023,1627734,22300324,"DEC 14, 2023",SAC vs. OKC,W,40,8,14,0.571,1,2,0.5,1,2,0.5,2,14,16,7,0,0,2,2,18,-1,1,Domantas Sabonis,SAC,SAC,OKC,21.0,Points,41,34,25,23
22023,1627734,22300324,"DEC 14, 2023",SAC vs. OKC,W,40,8,14,0.571,1,2,0.5,1,2,0.5,2,14,16,7,0,0,2,2,18,-1,1,Domantas Sabonis,SAC,SAC,OKC,12.5,Rebounds,41,34,25,23
22023,1627734,22300324,"DEC 14, 2023",SAC vs. OKC,W,40,8,14,0.571,1,2,0.5,1,2,0.5,2,14,16,7,0,0,2,2,18,-1,1,Domantas Sabonis,SAC,SAC,OKC,42.5,Pts+Rebs+Asts,41,34,25,23
22023,1627734,22300324,"DEC 14, 2023",SAC vs. OKC,W,40,8,14,0.571,1,2,0.5,1,2,0.5,2,14,16,7,0,0,2,2,18,-1,1,Domantas Sabonis,SAC,SAC,OKC,8.0,Assists,41,34,25,23
22023,1627734,22300324,"DEC 14, 2023",SAC vs. OKC,W,40,8,14,0.571,1,2,0.5,1,2,0.5,2,14,16,7,0,0,2,2,18,-1,1,Domantas Sabonis,SAC,SAC,OKC,47.0,Fantasy Score,41,34,25,23
22023,1627734,22300324,"DEC 14, 2023",SAC vs. OKC,W,40,8,14,0.571,1,2,0.5,1,2,0.5,2,14,16,7,0,0,2,2,18,-1,1,Domantas Sabonis,SAC,SAC,OKC,9.0,Defensive Rebounds,41,34,25,23
22023,1627734,22300324,"DEC 14, 2023",SAC vs. OKC,W,40,8,14,0.571,1,2,0.5,1,2,0.5,2,14,16,7,0,0,2,2,18,-1,1,Domantas Sabonis,SAC,SAC,OKC,3.5,Free Throws Made,41,34,25,23
22023,1627734,22300324,"DEC 14, 2023",SAC vs. OKC,W,40,8,14,0.571,1,2,0.5,1,2,0.5,2,14,16,7,0,0,2,2,18,-1,1,Domantas Sabonis,SAC,SAC,OKC,14.0,FG Attempted,41,34,25,23
22023,1627734,22300324,"DEC 14, 2023",SAC vs. OKC,W,40,8,14,0.571,1,2,0.5,1,2,0.5,2,14,16,7,0,0,2,2,18,-1,1,Domantas Sabonis,SAC,SAC,OKC,34.0,Pts+Rebs,41,34,25,23
22023,1627734,22300324,"DEC 14, 2023",SAC vs. OKC,W,40,8,14,0.571,1,2,0.5,1,2,0.5,2,14,16,7,0,0,2,2,18,-1,1,Domantas Sabonis,SAC,SAC,OKC,29.5,Pts+Asts,41,34,25,23
22023,1627734,22300324,"DEC 14, 2023",SAC vs. OKC,W,40,8,14,0.571,1,2,0.5,1,2,0.5,2,14,16,7,0,0,2,2,18,-1,1,Domantas Sabonis,SAC,SAC,OKC,20.5,Rebs+Asts,41,34,25,23
22023,1627734,22300309,"DEC 12, 2023",SAC @ LAC,L,26,5,11,0.455,0,2,0.0,5,8,0.625,5,5,10,3,2,0,2,3,15,-23,1,Domantas Sabonis,SAC,LAC,SAC,21.0,Points,28,25,18,13
22023,1627734,22300309,"DEC 12, 2023",SAC @ LAC,L,26,5,11,0.455,0,2,0.0,5,8,0.625,5,5,10,3,2,0,2,3,15,-23,1,Domantas Sabonis,SAC,LAC,SAC,12.5,Rebounds,28,25,18,13
22023,1627734,22300309,"DEC 12, 2023",SAC @ LAC,L,26,5,11,0.455,0,2,0.0,5,8,0.625,5,5,10,3,2,0,2,3,15,-23,1,Domantas Sabonis,SAC,LAC,SAC,42.5,Pts+Rebs+Asts,28,25,18,13
22023,1627734,22300309,"DEC 12, 2023",SAC @ LAC,L,26,5,11,0.455,0,2,0.0,5,8,0.625,5,5,10,3,2,0,2,3,15,-23,1,Domantas Sabonis,SAC,LAC,SAC,8.0,Assists,28,25,18,13
22023,1627734,22300309,"DEC 12, 2023",SAC @ LAC,L,26,5,11,0.455,0,2,0.0,5,8,0.625,5,5,10,3,2,0,2,3,15,-23,1,Domantas Sabonis,SAC,LAC,SAC,47.0,Fantasy Score,28,25,18,13
22023,1627734,22300309,"DEC 12, 2023",SAC @ LAC,L,26,5,11,0.455,0,2,0.0,5,8,0.625,5,5,10,3,2,0,2,3,15,-23,1,Domantas Sabonis,SAC,LAC,SAC,9.0,Defensive Rebounds,28,25,18,13
22023,1627734,22300309,"DEC 12, 2023",SAC @ LAC,L,26,5,11,0.455,0,2,0.0,5,8,0.625,5,5,10,3,2,0,2,3,15,-23,1,Domantas Sabonis,SAC,LAC,SAC,3.5,Free Throws Made,28,25,18,13
22023,1627734,22300309,"DEC 12, 2023",SAC @ LAC,L,26,5,11,0.455,0,2,0.0,5,8,0.625,5,5,10,3,2,0,2,3,15,-23,1,Domantas Sabonis,SAC,LAC,SAC,14.0,FG Attempted,28,25,18,13
22023,1627734,22300309,"DEC 12, 2023",SAC @ LAC,L,26,5,11,0.455,0,2,0.0,5,8,0.625,5,5,10,3,2,0,2,3,15,-23,1,Domantas Sabonis,SAC,LAC,SAC,34.0,Pts+Rebs,28,25,18,13
22023,1627734,22300309,"DEC 12, 2023",SAC @ LAC,L,26,5,11,0.455,0,2,0.0,5,8,0.625,5,5,10,3,2,0,2,3,15,-23,1,Domantas Sabonis,SAC,LAC,SAC,29.5,Pts+Asts,28,25,18,13
22023,1627734,22300309,"DEC 12, 2023",SAC @ LAC,L,26,5,11,0.455,0,2,0.0,5,8,0.625,5,5,10,3,2,0,2,3,15,-23,1,Domantas Sabonis,SAC,LAC,SAC,20.5,Rebs+Asts,28,25,18,13
22023,1627734,22300303,"DEC 11, 2023",SAC vs. BKN,W,34,6,14,0.429,1,1,1.0,2,4,0.5,4,12,16,9,2,0,4,2,15,11,1,Domantas Sabonis,SAC,SAC,BKN,21.0,Points,40,31,24,25
22023,1627734,22300303,"DEC 11, 2023",SAC vs. BKN,W,34,6,14,0.429,1,1,1.0,2,4,0.5,4,12,16,9,2,0,4,2,15,11,1,Domantas Sabonis,SAC,SAC,BKN,12.5,Rebounds,40,31,24,25
22023,1627734,22300303,"DEC 11, 2023",SAC vs. BKN,W,34,6,14,0.429,1,1,1.0,2,4,0.5,4,12,16,9,2,0,4,2,15,11,1,Domantas Sabonis,SAC,SAC,BKN,42.5,Pts+Rebs+Asts,40,31,24,25
22023,1627734,22300303,"DEC 11, 2023",SAC vs. BKN,W,34,6,14,0.429,1,1,1.0,2,4,0.5,4,12,16,9,2,0,4,2,15,11,1,Domantas Sabonis,SAC,SAC,BKN,8.0,Assists,40,31,24,25
22023,1627734,22300303,"DEC 11, 2023",SAC vs. BKN,W,34,6,14,0.429,1,1,1.0,2,4,0.5,4,12,16,9,2,0,4,2,15,11,1,Domantas Sabonis,SAC,SAC,BKN,47.0,Fantasy Score,40,31,24,25
22023,1627734,22300303,"DEC 11, 2023",SAC vs. BKN,W,34,6,14,0.429,1,1,1.0,2,4,0.5,4,12,16,9,2,0,4,2,15,11,1,Domantas Sabonis,SAC,SAC,BKN,9.0,Defensive Rebounds,40,31,24,25
22023,1627734,22300303,"DEC 11, 2023",SAC vs. BKN,W,34,6,14,0.429,1,1,1.0,2,4,0.5,4,12,16,9,2,0,4,2,15,11,1,Domantas Sabonis,SAC,SAC,BKN,3.5,Free Throws Made,40,31,24,25
22023,1627734,22300303,"DEC 11, 2023",SAC vs. BKN,W,34,6,14,0.429,1,1,1.0,2,4,0.5,4,12,16,9,2,0,4,2,15,11,1,Domantas Sabonis,SAC,SAC,BKN,14.0,FG Attempted,40,31,24,25
22023,1627734,22300303,"DEC 11, 2023",SAC vs. BKN,W,34,6,14,0.429,1,1,1.0,2,4,0.5,4,12,16,9,2,0,4,2,15,11,1,Domantas Sabonis,SAC,SAC,BKN,34.0,Pts+Rebs,40,31,24,25
22023,1627734,22300303,"DEC 11, 2023",SAC vs. BKN,W,34,6,14,0.429,1,1,1.0,2,4,0.5,4,12,16,9,2,0,4,2,15,11,1,Domantas Sabonis,SAC,SAC,BKN,29.5,Pts+Asts,40,31,24,25
22023,1627734,22300303,"DEC 11, 2023",SAC vs. BKN,W,34,6,14,0.429,1,1,1.0,2,4,0.5,4,12,16,9,2,0,4,2,15,11,1,Domantas Sabonis,SAC,SAC,BKN,20.5,Rebs+Asts,40,31,24,25
22023,1627734,22301228,"DEC 08, 2023",SAC @ PHX,W,38,6,11,0.545,0,0,0.0,3,4,0.75,4,13,17,5,0,0,4,4,15,3,1,Domantas Sabonis,SAC,PHX,SAC,21.0,Points,37,32,20,22
22023,1627734,22301228,"DEC 08, 2023",SAC @ PHX,W,38,6,11,0.545,0,0,0.0,3,4,0.75,4,13,17,5,0,0,4,4,15,3,1,Domantas Sabonis,SAC,PHX,SAC,12.5,Rebounds,37,32,20,22
22023,1627734,22301228,"DEC 08, 2023",SAC @ PHX,W,38,6,11,0.545,0,0,0.0,3,4,0.75,4,13,17,5,0,0,4,4,15,3,1,Domantas Sabonis,SAC,PHX,SAC,42.5,Pts+Rebs+Asts,37,32,20,22
22023,1627734,22301228,"DEC 08, 2023",SAC @ PHX,W,38,6,11,0.545,0,0,0.0,3,4,0.75,4,13,17,5,0,0,4,4,15,3,1,Domantas Sabonis,SAC,PHX,SAC,8.0,Assists,37,32,20,22
22023,1627734,22301228,"DEC 08, 2023",SAC @ PHX,W,38,6,11,0.545,0,0,0.0,3,4,0.75,4,13,17,5,0,0,4,4,15,3,1,Domantas Sabonis,SAC,PHX,SAC,47.0,Fantasy Score,37,32,20,22
22023,1627734,22301228,"DEC 08, 2023",SAC @ PHX,W,38,6,11,0.545,0,0,0.0,3,4,0.75,4,13,17,5,0,0,4,4,15,3,1,Domantas Sabonis,SAC,PHX,SAC,9.0,Defensive Rebounds,37,32,20,22
22023,1627734,22301228,"DEC 08, 2023",SAC @ PHX,W,38,6,11,0.545,0,0,0.0,3,4,0.75,4,13,17,5,0,0,4,4,15,3,1,Domantas Sabonis,SAC,PHX,SAC,3.5,Free Throws Made,37,32,20,22
22023,1627734,22301228,"DEC 08, 2023",SAC @ PHX,W,38,6,11,0.545,0,0,0.0,3,4,0.75,4,13,17,5,0,0,4,4,15,3,1,Domantas Sabonis,SAC,PHX,SAC,14.0,FG Attempted,37,32,20,22
22023,1627734,22301228,"DEC 08, 2023",SAC @ PHX,W,38,6,11,0.545,0,0,0.0,3,4,0.75,4,13,17,5,0,0,4,4,15,3,1,Domantas Sabonis,SAC,PHX,SAC,34.0,Pts+Rebs,37,32,20,22
22023,1627734,22301228,"DEC 08, 2023",SAC @ PHX,W,38,6,11,0.545,0,0,0.0,3,4,0.75,4,13,17,5,0,0,4,4,15,3,1,Domantas Sabonis,SAC,PHX,SAC,29.5,Pts+Asts,37,32,20,22
22023,1627734,22301228,"DEC 08, 2023",SAC @ PHX,W,38,6,11,0.545,0,0,0.0,3,4,0.75,4,13,17,5,0,0,4,4,15,3,1,Domantas Sabonis,SAC,PHX,SAC,20.5,Rebs+Asts,37,32,20,22
22023,1627734,22301204,"DEC 04, 2023",SAC vs. NOP,L,36,8,12,0.667,0,1,0.0,10,10,1.0,5,8,13,10,2,1,1,2,26,5,1,Domantas Sabonis,SAC,SAC,NOP,21.0,Points,49,39,36,23
22023,1627734,22301204,"DEC 04, 2023",SAC vs. NOP,L,36,8,12,0.667,0,1,0.0,10,10,1.0,5,8,13,10,2,1,1,2,26,5,1,Domantas Sabonis,SAC,SAC,NOP,12.5,Rebounds,49,39,36,23
22023,1627734,22301204,"DEC 04, 2023",SAC vs. NOP,L,36,8,12,0.667,0,1,0.0,10,10,1.0,5,8,13,10,2,1,1,2,26,5,1,Domantas Sabonis,SAC,SAC,NOP,42.5,Pts+Rebs+Asts,49,39,36,23
22023,1627734,22301204,"DEC 04, 2023",SAC vs. NOP,L,36,8,12,0.667,0,1,0.0,10,10,1.0,5,8,13,10,2,1,1,2,26,5,1,Domantas Sabonis,SAC,SAC,NOP,8.0,Assists,49,39,36,23
22023,1627734,22301204,"DEC 04, 2023",SAC vs. NOP,L,36,8,12,0.667,0,1,0.0,10,10,1.0,5,8,13,10,2,1,1,2,26,5,1,Domantas Sabonis,SAC,SAC,NOP,47.0,Fantasy Score,49,39,36,23
22023,1627734,22301204,"DEC 04, 2023",SAC vs. NOP,L,36,8,12,0.667,0,1,0.0,10,10,1.0,5,8,13,10,2,1,1,2,26,5,1,Domantas Sabonis,SAC,SAC,NOP,9.0,Defensive Rebounds,49,39,36,23
22023,1627734,22301204,"DEC 04, 2023",SAC vs. NOP,L,36,8,12,0.667,0,1,0.0,10,10,1.0,5,8,13,10,2,1,1,2,26,5,1,Domantas Sabonis,SAC,SAC,NOP,3.5,Free Throws Made,49,39,36,23
22023,1627734,22301204,"DEC 04, 2023",SAC vs. NOP,L,36,8,12,0.667,0,1,0.0,10,10,1.0,5,8,13,10,2,1,1,2,26,5,1,Domantas Sabonis,SAC,SAC,NOP,14.0,FG Attempted,49,39,36,23
22023,1627734,22301204,"DEC 04, 2023",SAC vs. NOP,L,36,8,12,0.667,0,1,0.0,10,10,1.0,5,8,13,10,2,1,1,2,26,5,1,Domantas Sabonis,SAC,SAC,NOP,34.0,Pts+Rebs,49,39,36,23
22023,1627734,22301204,"DEC 04, 2023",SAC vs. NOP,L,36,8,12,0.667,0,1,0.0,10,10,1.0,5,8,13,10,2,1,1,2,26,5,1,Domantas Sabonis,SAC,SAC,NOP,29.5,Pts+Asts,49,39,36,23
22023,1627734,22301204,"DEC 04, 2023",SAC vs. NOP,L,36,8,12,0.667,0,1,0.0,10,10,1.0,5,8,13,10,2,1,1,2,26,5,1,Domantas Sabonis,SAC,SAC,NOP,20.5,Rebs+Asts,49,39,36,23
22023,1627734,22300290,"DEC 02, 2023",SAC vs. DEN,W,36,7,18,0.389,1,3,0.333,2,3,0.667,2,13,15,7,1,0,2,5,17,-8,1,Domantas Sabonis,SAC,SAC,DEN,21.0,Points,39,32,24,22
22023,1627734,22300290,"DEC 02, 2023",SAC vs. DEN,W,36,7,18,0.389,1,3,0.333,2,3,0.667,2,13,15,7,1,0,2,5,17,-8,1,Domantas Sabonis,SAC,SAC,DEN,12.5,Rebounds,39,32,24,22
22023,1627734,22300290,"DEC 02, 2023",SAC vs. DEN,W,36,7,18,0.389,1,3,0.333,2,3,0.667,2,13,15,7,1,0,2,5,17,-8,1,Domantas Sabonis,SAC,SAC,DEN,42.5,Pts+Rebs+Asts,39,32,24,22
22023,1627734,22300290,"DEC 02, 2023",SAC vs. DEN,W,36,7,18,0.389,1,3,0.333,2,3,0.667,2,13,15,7,1,0,2,5,17,-8,1,Domantas Sabonis,SAC,SAC,DEN,8.0,Assists,39,32,24,22
22023,1627734,22300290,"DEC 02, 2023",SAC vs. DEN,W,36,7,18,0.389,1,3,0.333,2,3,0.667,2,13,15,7,1,0,2,5,17,-8,1,Domantas Sabonis,SAC,SAC,DEN,47.0,Fantasy Score,39,32,24,22
22023,1627734,22300290,"DEC 02, 2023",SAC vs. DEN,W,36,7,18,0.389,1,3,0.333,2,3,0.667,2,13,15,7,1,0,2,5,17,-8,1,Domantas Sabonis,SAC,SAC,DEN,9.0,Defensive Rebounds,39,32,24,22
22023,1627734,22300290,"DEC 02, 2023",SAC vs. DEN,W,36,7,18,0.389,1,3,0.333,2,3,0.667,2,13,15,7,1,0,2,5,17,-8,1,Domantas Sabonis,SAC,SAC,DEN,3.5,Free Throws Made,39,32,24,22
22023,1627734,22300290,"DEC 02, 2023",SAC vs. DEN,W,36,7,18,0.389,1,3,0.333,2,3,0.667,2,13,15,7,1,0,2,5,17,-8,1,Domantas Sabonis,SAC,SAC,DEN,14.0,FG Attempted,39,32,24,22
22023,1627734,22300290,"DEC 02, 2023",SAC vs. DEN,W,36,7,18,0.389,1,3,0.333,2,3,0.667,2,13,15,7,1,0,2,5,17,-8,1,Domantas Sabonis,SAC,SAC,DEN,34.0,Pts+Rebs,39,32,24,22
22023,1627734,22300290,"DEC 02, 2023",SAC vs. DEN,W,36,7,18,0.389,1,3,0.333,2,3,0.667,2,13,15,7,1,0,2,5,17,-8,1,Domantas Sabonis,SAC,SAC,DEN,29.5,Pts+Asts,39,32,24,22
22023,1627734,22300290,"DEC 02, 2023",SAC vs. DEN,W,36,7,18,0.389,1,3,0.333,2,3,0.667,2,13,15,7,1,0,2,5,17,-8,1,Domantas Sabonis,SAC,SAC,DEN,20.5,Rebs+Asts,39,32,24,22
22023,1627734,22300264,"NOV 29, 2023",SAC vs. LAC,L,31,3,12,0.25,2,3,0.667,3,4,0.75,1,4,5,3,0,0,1,3,11,-19,1,Domantas Sabonis,SAC,SAC,LAC,21.0,Points,19,16,14,8
22023,1627734,22300264,"NOV 29, 2023",SAC vs. LAC,L,31,3,12,0.25,2,3,0.667,3,4,0.75,1,4,5,3,0,0,1,3,11,-19,1,Domantas Sabonis,SAC,SAC,LAC,12.5,Rebounds,19,16,14,8
22023,1627734,22300264,"NOV 29, 2023",SAC vs. LAC,L,31,3,12,0.25,2,3,0.667,3,4,0.75,1,4,5,3,0,0,1,3,11,-19,1,Domantas Sabonis,SAC,SAC,LAC,42.5,Pts+Rebs+Asts,19,16,14,8
22023,1627734,22300264,"NOV 29, 2023",SAC vs. LAC,L,31,3,12,0.25,2,3,0.667,3,4,0.75,1,4,5,3,0,0,1,3,11,-19,1,Domantas Sabonis,SAC,SAC,LAC,8.0,Assists,19,16,14,8
22023,1627734,22300264,"NOV 29, 2023",SAC vs. LAC,L,31,3,12,0.25,2,3,0.667,3,4,0.75,1,4,5,3,0,0,1,3,11,-19,1,Domantas Sabonis,SAC,SAC,LAC,47.0,Fantasy Score,19,16,14,8
22023,1627734,22300264,"NOV 29, 2023",SAC vs. LAC,L,31,3,12,0.25,2,3,0.667,3,4,0.75,1,4,5,3,0,0,1,3,11,-19,1,Domantas Sabonis,SAC,SAC,LAC,9.0,Defensive Rebounds,19,16,14,8
22023,1627734,22300264,"NOV 29, 2023",SAC vs. LAC,L,31,3,12,0.25,2,3,0.667,3,4,0.75,1,4,5,3,0,0,1,3,11,-19,1,Domantas Sabonis,SAC,SAC,LAC,3.5,Free Throws Made,19,16,14,8
22023,1627734,22300264,"NOV 29, 2023",SAC vs. LAC,L,31,3,12,0.25,2,3,0.667,3,4,0.75,1,4,5,3,0,0,1,3,11,-19,1,Domantas Sabonis,SAC,SAC,LAC,14.0,FG Attempted,19,16,14,8
22023,1627734,22300264,"NOV 29, 2023",SAC vs. LAC,L,31,3,12,0.25,2,3,0.667,3,4,0.75,1,4,5,3,0,0,1,3,11,-19,1,Domantas Sabonis,SAC,SAC,LAC,34.0,Pts+Rebs,19,16,14,8
22023,1627734,22300264,"NOV 29, 2023",SAC vs. LAC,L,31,3,12,0.25,2,3,0.667,3,4,0.75,1,4,5,3,0,0,1,3,11,-19,1,Domantas Sabonis,SAC,SAC,LAC,29.5,Pts+Asts,19,16,14,8
22023,1627734,22300264,"NOV 29, 2023",SAC vs. LAC,L,31,3,12,0.25,2,3,0.667,3,4,0.75,1,4,5,3,0,0,1,3,11,-19,1,Domantas Sabonis,SAC,SAC,LAC,20.5,Rebs+Asts,19,16,14,8
22023,1627734,22300060,"NOV 28, 2023",SAC vs. GSW,W,37,2,7,0.286,0,1,0.0,5,6,0.833,2,6,8,10,1,0,1,3,9,-3,1,Domantas Sabonis,SAC,SAC,GSW,21.0,Points,27,17,19,18
22023,1627734,22300060,"NOV 28, 2023",SAC vs. GSW,W,37,2,7,0.286,0,1,0.0,5,6,0.833,2,6,8,10,1,0,1,3,9,-3,1,Domantas Sabonis,SAC,SAC,GSW,12.5,Rebounds,27,17,19,18
22023,1627734,22300060,"NOV 28, 2023",SAC vs. GSW,W,37,2,7,0.286,0,1,0.0,5,6,0.833,2,6,8,10,1,0,1,3,9,-3,1,Domantas Sabonis,SAC,SAC,GSW,42.5,Pts+Rebs+Asts,27,17,19,18
22023,1627734,22300060,"NOV 28, 2023",SAC vs. GSW,W,37,2,7,0.286,0,1,0.0,5,6,0.833,2,6,8,10,1,0,1,3,9,-3,1,Domantas Sabonis,SAC,SAC,GSW,8.0,Assists,27,17,19,18
22023,1627734,22300060,"NOV 28, 2023",SAC vs. GSW,W,37,2,7,0.286,0,1,0.0,5,6,0.833,2,6,8,10,1,0,1,3,9,-3,1,Domantas Sabonis,SAC,SAC,GSW,47.0,Fantasy Score,27,17,19,18
22023,1627734,22300060,"NOV 28, 2023",SAC vs. GSW,W,37,2,7,0.286,0,1,0.0,5,6,0.833,2,6,8,10,1,0,1,3,9,-3,1,Domantas Sabonis,SAC,SAC,GSW,9.0,Defensive Rebounds,27,17,19,18
22023,1627734,22300060,"NOV 28, 2023",SAC vs. GSW,W,37,2,7,0.286,0,1,0.0,5,6,0.833,2,6,8,10,1,0,1,3,9,-3,1,Domantas Sabonis,SAC,SAC,GSW,3.5,Free Throws Made,27,17,19,18
22023,1627734,22300060,"NOV 28, 2023",SAC vs. GSW,W,37,2,7,0.286,0,1,0.0,5,6,0.833,2,6,8,10,1,0,1,3,9,-3,1,Domantas Sabonis,SAC,SAC,GSW,14.0,FG Attempted,27,17,19,18
22023,1627734,22300060,"NOV 28, 2023",SAC vs. GSW,W,37,2,7,0.286,0,1,0.0,5,6,0.833,2,6,8,10,1,0,1,3,9,-3,1,Domantas Sabonis,SAC,SAC,GSW,34.0,Pts+Rebs,27,17,19,18
22023,1627734,22300060,"NOV 28, 2023",SAC vs. GSW,W,37,2,7,0.286,0,1,0.0,5,6,0.833,2,6,8,10,1,0,1,3,9,-3,1,Domantas Sabonis,SAC,SAC,GSW,29.5,Pts+Asts,27,17,19,18
22023,1627734,22300060,"NOV 28, 2023",SAC vs. GSW,W,37,2,7,0.286,0,1,0.0,5,6,0.833,2,6,8,10,1,0,1,3,9,-3,1,Domantas Sabonis,SAC,SAC,GSW,20.5,Rebs+Asts,27,17,19,18
22023,1627734,22300050,"NOV 24, 2023",SAC @ MIN,W,39,7,15,0.467,1,1,1.0,0,1,0.0,5,6,11,5,2,3,2,6,15,-7,1,Domantas Sabonis,SAC,MIN,SAC,21.0,Points,31,26,20,16
22023,1627734,22300050,"NOV 24, 2023",SAC @ MIN,W,39,7,15,0.467,1,1,1.0,0,1,0.0,5,6,11,5,2,3,2,6,15,-7,1,Domantas Sabonis,SAC,MIN,SAC,12.5,Rebounds,31,26,20,16
22023,1627734,22300050,"NOV 24, 2023",SAC @ MIN,W,39,7,15,0.467,1,1,1.0,0,1,0.0,5,6,11,5,2,3,2,6,15,-7,1,Domantas Sabonis,SAC,MIN,SAC,42.5,Pts+Rebs+Asts,31,26,20,16
22023,1627734,22300050,"NOV 24, 2023",SAC @ MIN,W,39,7,15,0.467,1,1,1.0,0,1,0.0,5,6,11,5,2,3,2,6,15,-7,1,Domantas Sabonis,SAC,MIN,SAC,8.0,Assists,31,26,20,16
22023,1627734,22300050,"NOV 24, 2023",SAC @ MIN,W,39,7,15,0.467,1,1,1.0,0,1,0.0,5,6,11,5,2,3,2,6,15,-7,1,Domantas Sabonis,SAC,MIN,SAC,47.0,Fantasy Score,31,26,20,16
22023,1627734,22300050,"NOV 24, 2023",SAC @ MIN,W,39,7,15,0.467,1,1,1.0,0,1,0.0,5,6,11,5,2,3,2,6,15,-7,1,Domantas Sabonis,SAC,MIN,SAC,9.0,Defensive Rebounds,31,26,20,16
22023,1627734,22300050,"NOV 24, 2023",SAC @ MIN,W,39,7,15,0.467,1,1,1.0,0,1,0.0,5,6,11,5,2,3,2,6,15,-7,1,Domantas Sabonis,SAC,MIN,SAC,3.5,Free Throws Made,31,26,20,16
22023,1627734,22300050,"NOV 24, 2023",SAC @ MIN,W,39,7,15,0.467,1,1,1.0,0,1,0.0,5,6,11,5,2,3,2,6,15,-7,1,Domantas Sabonis,SAC,MIN,SAC,14.0,FG Attempted,31,26,20,16
22023,1627734,22300050,"NOV 24, 2023",SAC @ MIN,W,39,7,15,0.467,1,1,1.0,0,1,0.0,5,6,11,5,2,3,2,6,15,-7,1,Domantas Sabonis,SAC,MIN,SAC,34.0,Pts+Rebs,31,26,20,16
22023,1627734,22300050,"NOV 24, 2023",SAC @ MIN,W,39,7,15,0.467,1,1,1.0,0,1,0.0,5,6,11,5,2,3,2,6,15,-7,1,Domantas Sabonis,SAC,MIN,SAC,29.5,Pts+Asts,31,26,20,16
22023,1627734,22300050,"NOV 24, 2023",SAC @ MIN,W,39,7,15,0.467,1,1,1.0,0,1,0.0,5,6,11,5,2,3,2,6,15,-7,1,Domantas Sabonis,SAC,MIN,SAC,20.5,Rebs+Asts,31,26,20,16
22023,1627734,22300233,"NOV 22, 2023",SAC @ NOP,L,36,8,11,0.727,0,0,0.0,7,10,0.7,2,7,9,6,0,1,3,3,23,12,1,Domantas Sabonis,SAC,NOP,SAC,21.0,Points,38,32,29,15
22023,1627734,22300233,"NOV 22, 2023",SAC @ NOP,L,36,8,11,0.727,0,0,0.0,7,10,0.7,2,7,9,6,0,1,3,3,23,12,1,Domantas Sabonis,SAC,NOP,SAC,12.5,Rebounds,38,32,29,15
22023,1627734,22300233,"NOV 22, 2023",SAC @ NOP,L,36,8,11,0.727,0,0,0.0,7,10,0.7,2,7,9,6,0,1,3,3,23,12,1,Domantas Sabonis,SAC,NOP,SAC,42.5,Pts+Rebs+Asts,38,32,29,15
22023,1627734,22300233,"NOV 22, 2023",SAC @ NOP,L,36,8,11,0.727,0,0,0.0,7,10,0.7,2,7,9,6,0,1,3,3,23,12,1,Domantas Sabonis,SAC,NOP,SAC,8.0,Assists,38,32,29,15
22023,1627734,22300233,"NOV 22, 2023",SAC @ NOP,L,36,8,11,0.727,0,0,0.0,7,10,0.7,2,7,9,6,0,1,3,3,23,12,1,Domantas Sabonis,SAC,NOP,SAC,47.0,Fantasy Score,38,32,29,15
22023,1627734,22300233,"NOV 22, 2023",SAC @ NOP,L,36,8,11,0.727,0,0,0.0,7,10,0.7,2,7,9,6,0,1,3,3,23,12,1,Domantas Sabonis,SAC,NOP,SAC,9.0,Defensive Rebounds,38,32,29,15
22023,1627734,22300233,"NOV 22, 2023",SAC @ NOP,L,36,8,11,0.727,0,0,0.0,7,10,0.7,2,7,9,6,0,1,3,3,23,12,1,Domantas Sabonis,SAC,NOP,SAC,3.5,Free Throws Made,38,32,29,15
22023,1627734,22300233,"NOV 22, 2023",SAC @ NOP,L,36,8,11,0.727,0,0,0.0,7,10,0.7,2,7,9,6,0,1,3,3,23,12,1,Domantas Sabonis,SAC,NOP,SAC,14.0,FG Attempted,38,32,29,15
22023,1627734,22300233,"NOV 22, 2023",SAC @ NOP,L,36,8,11,0.727,0,0,0.0,7,10,0.7,2,7,9,6,0,1,3,3,23,12,1,Domantas Sabonis,SAC,NOP,SAC,34.0,Pts+Rebs,38,32,29,15
22023,1627734,22300233,"NOV 22, 2023",SAC @ NOP,L,36,8,11,0.727,0,0,0.0,7,10,0.7,2,7,9,6,0,1,3,3,23,12,1,Domantas Sabonis,SAC,NOP,SAC,29.5,Pts+Asts,38,32,29,15
22023,1627734,22300233,"NOV 22, 2023",SAC @ NOP,L,36,8,11,0.727,0,0,0.0,7,10,0.7,2,7,9,6,0,1,3,3,23,12,1,Domantas Sabonis,SAC,NOP,SAC,20.5,Rebs+Asts,38,32,29,15
22023,1627734,22300222,"NOV 20, 2023",SAC @ NOP,L,31,4,8,0.5,0,0,0.0,2,3,0.667,5,5,10,8,0,0,5,4,10,-36,1,Domantas Sabonis,SAC,NOP,SAC,21.0,Points,28,20,18,18
22023,1627734,22300222,"NOV 20, 2023",SAC @ NOP,L,31,4,8,0.5,0,0,0.0,2,3,0.667,5,5,10,8,0,0,5,4,10,-36,1,Domantas Sabonis,SAC,NOP,SAC,12.5,Rebounds,28,20,18,18
22023,1627734,22300222,"NOV 20, 2023",SAC @ NOP,L,31,4,8,0.5,0,0,0.0,2,3,0.667,5,5,10,8,0,0,5,4,10,-36,1,Domantas Sabonis,SAC,NOP,SAC,42.5,Pts+Rebs+Asts,28,20,18,18
22023,1627734,22300222,"NOV 20, 2023",SAC @ NOP,L,31,4,8,0.5,0,0,0.0,2,3,0.667,5,5,10,8,0,0,5,4,10,-36,1,Domantas Sabonis,SAC,NOP,SAC,8.0,Assists,28,20,18,18
22023,1627734,22300222,"NOV 20, 2023",SAC @ NOP,L,31,4,8,0.5,0,0,0.0,2,3,0.667,5,5,10,8,0,0,5,4,10,-36,1,Domantas Sabonis,SAC,NOP,SAC,47.0,Fantasy Score,28,20,18,18
22023,1627734,22300222,"NOV 20, 2023",SAC @ NOP,L,31,4,8,0.5,0,0,0.0,2,3,0.667,5,5,10,8,0,0,5,4,10,-36,1,Domantas Sabonis,SAC,NOP,SAC,9.0,Defensive Rebounds,28,20,18,18
22023,1627734,22300222,"NOV 20, 2023",SAC @ NOP,L,31,4,8,0.5,0,0,0.0,2,3,0.667,5,5,10,8,0,0,5,4,10,-36,1,Domantas Sabonis,SAC,NOP,SAC,3.5,Free Throws Made,28,20,18,18
22023,1627734,22300222,"NOV 20, 2023",SAC @ NOP,L,31,4,8,0.5,0,0,0.0,2,3,0.667,5,5,10,8,0,0,5,4,10,-36,1,Domantas Sabonis,SAC,NOP,SAC,14.0,FG Attempted,28,20,18,18
22023,1627734,22300222,"NOV 20, 2023",SAC @ NOP,L,31,4,8,0.5,0,0,0.0,2,3,0.667,5,5,10,8,0,0,5,4,10,-36,1,Domantas Sabonis,SAC,NOP,SAC,34.0,Pts+Rebs,28,20,18,18
22023,1627734,22300222,"NOV 20, 2023",SAC @ NOP,L,31,4,8,0.5,0,0,0.0,2,3,0.667,5,5,10,8,0,0,5,4,10,-36,1,Domantas Sabonis,SAC,NOP,SAC,29.5,Pts+Asts,28,20,18,18
22023,1627734,22300222,"NOV 20, 2023",SAC @ NOP,L,31,4,8,0.5,0,0,0.0,2,3,0.667,5,5,10,8,0,0,5,4,10,-36,1,Domantas Sabonis,SAC,NOP,SAC,20.5,Rebs+Asts,28,20,18,18
22023,1627734,22300212,"NOV 19, 2023",SAC @ DAL,W,35,13,15,0.867,0,2,0.0,6,10,0.6,3,10,13,6,0,0,1,2,32,16,1,Domantas Sabonis,SAC,DAL,SAC,21.0,Points,51,45,38,19
22023,1627734,22300212,"NOV 19, 2023",SAC @ DAL,W,35,13,15,0.867,0,2,0.0,6,10,0.6,3,10,13,6,0,0,1,2,32,16,1,Domantas Sabonis,SAC,DAL,SAC,12.5,Rebounds,51,45,38,19
22023,1627734,22300212,"NOV 19, 2023",SAC @ DAL,W,35,13,15,0.867,0,2,0.0,6,10,0.6,3,10,13,6,0,0,1,2,32,16,1,Domantas Sabonis,SAC,DAL,SAC,42.5,Pts+Rebs+Asts,51,45,38,19
22023,1627734,22300212,"NOV 19, 2023",SAC @ DAL,W,35,13,15,0.867,0,2,0.0,6,10,0.6,3,10,13,6,0,0,1,2,32,16,1,Domantas Sabonis,SAC,DAL,SAC,8.0,Assists,51,45,38,19
22023,1627734,22300212,"NOV 19, 2023",SAC @ DAL,W,35,13,15,0.867,0,2,0.0,6,10,0.6,3,10,13,6,0,0,1,2,32,16,1,Domantas Sabonis,SAC,DAL,SAC,47.0,Fantasy Score,51,45,38,19
22023,1627734,22300212,"NOV 19, 2023",SAC @ DAL,W,35,13,15,0.867,0,2,0.0,6,10,0.6,3,10,13,6,0,0,1,2,32,16,1,Domantas Sabonis,SAC,DAL,SAC,9.0,Defensive Rebounds,51,45,38,19
22023,1627734,22300212,"NOV 19, 2023",SAC @ DAL,W,35,13,15,0.867,0,2,0.0,6,10,0.6,3,10,13,6,0,0,1,2,32,16,1,Domantas Sabonis,SAC,DAL,SAC,3.5,Free Throws Made,51,45,38,19
22023,1627734,22300212,"NOV 19, 2023",SAC @ DAL,W,35,13,15,0.867,0,2,0.0,6,10,0.6,3,10,13,6,0,0,1,2,32,16,1,Domantas Sabonis,SAC,DAL,SAC,14.0,FG Attempted,51,45,38,19
22023,1627734,22300212,"NOV 19, 2023",SAC @ DAL,W,35,13,15,0.867,0,2,0.0,6,10,0.6,3,10,13,6,0,0,1,2,32,16,1,Domantas Sabonis,SAC,DAL,SAC,34.0,Pts+Rebs,51,45,38,19
22023,1627734,22300212,"NOV 19, 2023",SAC @ DAL,W,35,13,15,0.867,0,2,0.0,6,10,0.6,3,10,13,6,0,0,1,2,32,16,1,Domantas Sabonis,SAC,DAL,SAC,29.5,Pts+Asts,51,45,38,19
22023,1627734,22300212,"NOV 19, 2023",SAC @ DAL,W,35,13,15,0.867,0,2,0.0,6,10,0.6,3,10,13,6,0,0,1,2,32,16,1,Domantas Sabonis,SAC,DAL,SAC,20.5,Rebs+Asts,51,45,38,19
22023,1627734,22300032,"NOV 17, 2023",SAC @ SAS,W,35,9,13,0.692,2,3,0.667,7,8,0.875,2,12,14,7,0,1,4,5,27,6,1,Domantas Sabonis,SAC,SAS,SAC,21.0,Points,48,41,34,21
22023,1627734,22300032,"NOV 17, 2023",SAC @ SAS,W,35,9,13,0.692,2,3,0.667,7,8,0.875,2,12,14,7,0,1,4,5,27,6,1,Domantas Sabonis,SAC,SAS,SAC,12.5,Rebounds,48,41,34,21
22023,1627734,22300032,"NOV 17, 2023",SAC @ SAS,W,35,9,13,0.692,2,3,0.667,7,8,0.875,2,12,14,7,0,1,4,5,27,6,1,Domantas Sabonis,SAC,SAS,SAC,42.5,Pts+Rebs+Asts,48,41,34,21
22023,1627734,22300032,"NOV 17, 2023",SAC @ SAS,W,35,9,13,0.692,2,3,0.667,7,8,0.875,2,12,14,7,0,1,4,5,27,6,1,Domantas Sabonis,SAC,SAS,SAC,8.0,Assists,48,41,34,21
22023,1627734,22300032,"NOV 17, 2023",SAC @ SAS,W,35,9,13,0.692,2,3,0.667,7,8,0.875,2,12,14,7,0,1,4,5,27,6,1,Domantas Sabonis,SAC,SAS,SAC,47.0,Fantasy Score,48,41,34,21
22023,1627734,22300032,"NOV 17, 2023",SAC @ SAS,W,35,9,13,0.692,2,3,0.667,7,8,0.875,2,12,14,7,0,1,4,5,27,6,1,Domantas Sabonis,SAC,SAS,SAC,9.0,Defensive Rebounds,48,41,34,21
22023,1627734,22300032,"NOV 17, 2023",SAC @ SAS,W,35,9,13,0.692,2,3,0.667,7,8,0.875,2,12,14,7,0,1,4,5,27,6,1,Domantas Sabonis,SAC,SAS,SAC,3.5,Free Throws Made,48,41,34,21
22023,1627734,22300032,"NOV 17, 2023",SAC @ SAS,W,35,9,13,0.692,2,3,0.667,7,8,0.875,2,12,14,7,0,1,4,5,27,6,1,Domantas Sabonis,SAC,SAS,SAC,14.0,FG Attempted,48,41,34,21
22023,1627734,22300032,"NOV 17, 2023",SAC @ SAS,W,35,9,13,0.692,2,3,0.667,7,8,0.875,2,12,14,7,0,1,4,5,27,6,1,Domantas Sabonis,SAC,SAS,SAC,34.0,Pts+Rebs,48,41,34,21
22023,1627734,22300032,"NOV 17, 2023",SAC @ SAS,W,35,9,13,0.692,2,3,0.667,7,8,0.875,2,12,14,7,0,1,4,5,27,6,1,Domantas Sabonis,SAC,SAS,SAC,29.5,Pts+Asts,48,41,34,21
22023,1627734,22300032,"NOV 17, 2023",SAC @ SAS,W,35,9,13,0.692,2,3,0.667,7,8,0.875,2,12,14,7,0,1,4,5,27,6,1,Domantas Sabonis,SAC,SAS,SAC,20.5,Rebs+Asts,48,41,34,21
22023,1627734,22300198,"NOV 15, 2023",SAC @ LAL,W,39,13,19,0.684,1,1,1.0,2,2,1.0,5,11,16,7,3,1,4,3,29,20,1,Domantas Sabonis,SAC,LAL,SAC,21.0,Points,52,45,36,23
22023,1627734,22300198,"NOV 15, 2023",SAC @ LAL,W,39,13,19,0.684,1,1,1.0,2,2,1.0,5,11,16,7,3,1,4,3,29,20,1,Domantas Sabonis,SAC,LAL,SAC,12.5,Rebounds,52,45,36,23
22023,1627734,22300198,"NOV 15, 2023",SAC @ LAL,W,39,13,19,0.684,1,1,1.0,2,2,1.0,5,11,16,7,3,1,4,3,29,20,1,Domantas Sabonis,SAC,LAL,SAC,42.5,Pts+Rebs+Asts,52,45,36,23
22023,1627734,22300198,"NOV 15, 2023",SAC @ LAL,W,39,13,19,0.684,1,1,1.0,2,2,1.0,5,11,16,7,3,1,4,3,29,20,1,Domantas Sabonis,SAC,LAL,SAC,8.0,Assists,52,45,36,23
22023,1627734,22300198,"NOV 15, 2023",SAC @ LAL,W,39,13,19,0.684,1,1,1.0,2,2,1.0,5,11,16,7,3,1,4,3,29,20,1,Domantas Sabonis,SAC,LAL,SAC,47.0,Fantasy Score,52,45,36,23
22023,1627734,22300198,"NOV 15, 2023",SAC @ LAL,W,39,13,19,0.684,1,1,1.0,2,2,1.0,5,11,16,7,3,1,4,3,29,20,1,Domantas Sabonis,SAC,LAL,SAC,9.0,Defensive Rebounds,52,45,36,23
22023,1627734,22300198,"NOV 15, 2023",SAC @ LAL,W,39,13,19,0.684,1,1,1.0,2,2,1.0,5,11,16,7,3,1,4,3,29,20,1,Domantas Sabonis,SAC,LAL,SAC,3.5,Free Throws Made,52,45,36,23
22023,1627734,22300198,"NOV 15, 2023",SAC @ LAL,W,39,13,19,0.684,1,1,1.0,2,2,1.0,5,11,16,7,3,1,4,3,29,20,1,Domantas Sabonis,SAC,LAL,SAC,14.0,FG Attempted,52,45,36,23
22023,1627734,22300198,"NOV 15, 2023",SAC @ LAL,W,39,13,19,0.684,1,1,1.0,2,2,1.0,5,11,16,7,3,1,4,3,29,20,1,Domantas Sabonis,SAC,LAL,SAC,34.0,Pts+Rebs,52,45,36,23
22023,1627734,22300198,"NOV 15, 2023",SAC @ LAL,W,39,13,19,0.684,1,1,1.0,2,2,1.0,5,11,16,7,3,1,4,3,29,20,1,Domantas Sabonis,SAC,LAL,SAC,29.5,Pts+Asts,52,45,36,23
22023,1627734,22300198,"NOV 15, 2023",SAC @ LAL,W,39,13,19,0.684,1,1,1.0,2,2,1.0,5,11,16,7,3,1,4,3,29,20,1,Domantas Sabonis,SAC,LAL,SAC,20.5,Rebs+Asts,52,45,36,23
22023,1627734,22300191,"NOV 13, 2023",SAC vs. CLE,W,35,8,10,0.8,1,2,0.5,6,11,0.545,0,9,9,10,0,2,3,4,23,6,1,Domantas Sabonis,SAC,SAC,CLE,21.0,Points,42,32,33,19
22023,1627734,22300191,"NOV 13, 2023",SAC vs. CLE,W,35,8,10,0.8,1,2,0.5,6,11,0.545,0,9,9,10,0,2,3,4,23,6,1,Domantas Sabonis,SAC,SAC,CLE,12.5,Rebounds,42,32,33,19
22023,1627734,22300191,"NOV 13, 2023",SAC vs. CLE,W,35,8,10,0.8,1,2,0.5,6,11,0.545,0,9,9,10,0,2,3,4,23,6,1,Domantas Sabonis,SAC,SAC,CLE,42.5,Pts+Rebs+Asts,42,32,33,19
22023,1627734,22300191,"NOV 13, 2023",SAC vs. CLE,W,35,8,10,0.8,1,2,0.5,6,11,0.545,0,9,9,10,0,2,3,4,23,6,1,Domantas Sabonis,SAC,SAC,CLE,8.0,Assists,42,32,33,19
22023,1627734,22300191,"NOV 13, 2023",SAC vs. CLE,W,35,8,10,0.8,1,2,0.5,6,11,0.545,0,9,9,10,0,2,3,4,23,6,1,Domantas Sabonis,SAC,SAC,CLE,47.0,Fantasy Score,42,32,33,19
22023,1627734,22300191,"NOV 13, 2023",SAC vs. CLE,W,35,8,10,0.8,1,2,0.5,6,11,0.545,0,9,9,10,0,2,3,4,23,6,1,Domantas Sabonis,SAC,SAC,CLE,9.0,Defensive Rebounds,42,32,33,19
22023,1627734,22300191,"NOV 13, 2023",SAC vs. CLE,W,35,8,10,0.8,1,2,0.5,6,11,0.545,0,9,9,10,0,2,3,4,23,6,1,Domantas Sabonis,SAC,SAC,CLE,3.5,Free Throws Made,42,32,33,19
22023,1627734,22300191,"NOV 13, 2023",SAC vs. CLE,W,35,8,10,0.8,1,2,0.5,6,11,0.545,0,9,9,10,0,2,3,4,23,6,1,Domantas Sabonis,SAC,SAC,CLE,14.0,FG Attempted,42,32,33,19
22023,1627734,22300191,"NOV 13, 2023",SAC vs. CLE,W,35,8,10,0.8,1,2,0.5,6,11,0.545,0,9,9,10,0,2,3,4,23,6,1,Domantas Sabonis,SAC,SAC,CLE,34.0,Pts+Rebs,42,32,33,19
22023,1627734,22300191,"NOV 13, 2023",SAC vs. CLE,W,35,8,10,0.8,1,2,0.5,6,11,0.545,0,9,9,10,0,2,3,4,23,6,1,Domantas Sabonis,SAC,SAC,CLE,29.5,Pts+Asts,42,32,33,19
22023,1627734,22300191,"NOV 13, 2023",SAC vs. CLE,W,35,8,10,0.8,1,2,0.5,6,11,0.545,0,9,9,10,0,2,3,4,23,6,1,Domantas Sabonis,SAC,SAC,CLE,20.5,Rebs+Asts,42,32,33,19
22023,1627734,22300016,"NOV 10, 2023",SAC vs. OKC,W,38,7,15,0.467,0,0,0.0,3,6,0.5,6,7,13,13,1,2,5,5,17,11,1,Domantas Sabonis,SAC,SAC,OKC,21.0,Points,43,30,30,26
22023,1627734,22300016,"NOV 10, 2023",SAC vs. OKC,W,38,7,15,0.467,0,0,0.0,3,6,0.5,6,7,13,13,1,2,5,5,17,11,1,Domantas Sabonis,SAC,SAC,OKC,12.5,Rebounds,43,30,30,26
22023,1627734,22300016,"NOV 10, 2023",SAC vs. OKC,W,38,7,15,0.467,0,0,0.0,3,6,0.5,6,7,13,13,1,2,5,5,17,11,1,Domantas Sabonis,SAC,SAC,OKC,42.5,Pts+Rebs+Asts,43,30,30,26
22023,1627734,22300016,"NOV 10, 2023",SAC vs. OKC,W,38,7,15,0.467,0,0,0.0,3,6,0.5,6,7,13,13,1,2,5,5,17,11,1,Domantas Sabonis,SAC,SAC,OKC,8.0,Assists,43,30,30,26
22023,1627734,22300016,"NOV 10, 2023",SAC vs. OKC,W,38,7,15,0.467,0,0,0.0,3,6,0.5,6,7,13,13,1,2,5,5,17,11,1,Domantas Sabonis,SAC,SAC,OKC,47.0,Fantasy Score,43,30,30,26
22023,1627734,22300016,"NOV 10, 2023",SAC vs. OKC,W,38,7,15,0.467,0,0,0.0,3,6,0.5,6,7,13,13,1,2,5,5,17,11,1,Domantas Sabonis,SAC,SAC,OKC,9.0,Defensive Rebounds,43,30,30,26
22023,1627734,22300016,"NOV 10, 2023",SAC vs. OKC,W,38,7,15,0.467,0,0,0.0,3,6,0.5,6,7,13,13,1,2,5,5,17,11,1,Domantas Sabonis,SAC,SAC,OKC,3.5,Free Throws Made,43,30,30,26
22023,1627734,22300016,"NOV 10, 2023",SAC vs. OKC,W,38,7,15,0.467,0,0,0.0,3,6,0.5,6,7,13,13,1,2,5,5,17,11,1,Domantas Sabonis,SAC,SAC,OKC,14.0,FG Attempted,43,30,30,26
22023,1627734,22300016,"NOV 10, 2023",SAC vs. OKC,W,38,7,15,0.467,0,0,0.0,3,6,0.5,6,7,13,13,1,2,5,5,17,11,1,Domantas Sabonis,SAC,SAC,OKC,34.0,Pts+Rebs,43,30,30,26
22023,1627734,22300016,"NOV 10, 2023",SAC vs. OKC,W,38,7,15,0.467,0,0,0.0,3,6,0.5,6,7,13,13,1,2,5,5,17,11,1,Domantas Sabonis,SAC,SAC,OKC,29.5,Pts+Asts,43,30,30,26
22023,1627734,22300016,"NOV 10, 2023",SAC vs. OKC,W,38,7,15,0.467,0,0,0.0,3,6,0.5,6,7,13,13,1,2,5,5,17,11,1,Domantas Sabonis,SAC,SAC,OKC,20.5,Rebs+Asts,43,30,30,26
22023,1627734,22300170,"NOV 08, 2023",SAC vs. POR,W,40,11,14,0.786,0,0,0.0,5,7,0.714,7,4,11,9,1,1,6,4,27,-5,1,Domantas Sabonis,SAC,SAC,POR,21.0,Points,47,38,36,20
22023,1627734,22300170,"NOV 08, 2023",SAC vs. POR,W,40,11,14,0.786,0,0,0.0,5,7,0.714,7,4,11,9,1,1,6,4,27,-5,1,Domantas Sabonis,SAC,SAC,POR,12.5,Rebounds,47,38,36,20
22023,1627734,22300170,"NOV 08, 2023",SAC vs. POR,W,40,11,14,0.786,0,0,0.0,5,7,0.714,7,4,11,9,1,1,6,4,27,-5,1,Domantas Sabonis,SAC,SAC,POR,42.5,Pts+Rebs+Asts,47,38,36,20
22023,1627734,22300170,"NOV 08, 2023",SAC vs. POR,W,40,11,14,0.786,0,0,0.0,5,7,0.714,7,4,11,9,1,1,6,4,27,-5,1,Domantas Sabonis,SAC,SAC,POR,8.0,Assists,47,38,36,20
22023,1627734,22300170,"NOV 08, 2023",SAC vs. POR,W,40,11,14,0.786,0,0,0.0,5,7,0.714,7,4,11,9,1,1,6,4,27,-5,1,Domantas Sabonis,SAC,SAC,POR,47.0,Fantasy Score,47,38,36,20
22023,1627734,22300170,"NOV 08, 2023",SAC vs. POR,W,40,11,14,0.786,0,0,0.0,5,7,0.714,7,4,11,9,1,1,6,4,27,-5,1,Domantas Sabonis,SAC,SAC,POR,9.0,Defensive Rebounds,47,38,36,20
22023,1627734,22300170,"NOV 08, 2023",SAC vs. POR,W,40,11,14,0.786,0,0,0.0,5,7,0.714,7,4,11,9,1,1,6,4,27,-5,1,Domantas Sabonis,SAC,SAC,POR,3.5,Free Throws Made,47,38,36,20
22023,1627734,22300170,"NOV 08, 2023",SAC vs. POR,W,40,11,14,0.786,0,0,0.0,5,7,0.714,7,4,11,9,1,1,6,4,27,-5,1,Domantas Sabonis,SAC,SAC,POR,14.0,FG Attempted,47,38,36,20
22023,1627734,22300170,"NOV 08, 2023",SAC vs. POR,W,40,11,14,0.786,0,0,0.0,5,7,0.714,7,4,11,9,1,1,6,4,27,-5,1,Domantas Sabonis,SAC,SAC,POR,34.0,Pts+Rebs,47,38,36,20
22023,1627734,22300170,"NOV 08, 2023",SAC vs. POR,W,40,11,14,0.786,0,0,0.0,5,7,0.714,7,4,11,9,1,1,6,4,27,-5,1,Domantas Sabonis,SAC,SAC,POR,29.5,Pts+Asts,47,38,36,20
22023,1627734,22300170,"NOV 08, 2023",SAC vs. POR,W,40,11,14,0.786,0,0,0.0,5,7,0.714,7,4,11,9,1,1,6,4,27,-5,1,Domantas Sabonis,SAC,SAC,POR,20.5,Rebs+Asts,47,38,36,20
22023,1627734,22300153,"NOV 06, 2023",SAC @ HOU,L,30,3,4,0.75,0,0,0.0,2,3,0.667,3,5,8,5,0,0,4,4,8,-24,1,Domantas Sabonis,SAC,HOU,SAC,21.0,Points,21,16,13,13
22023,1627734,22300153,"NOV 06, 2023",SAC @ HOU,L,30,3,4,0.75,0,0,0.0,2,3,0.667,3,5,8,5,0,0,4,4,8,-24,1,Domantas Sabonis,SAC,HOU,SAC,12.5,Rebounds,21,16,13,13
22023,1627734,22300153,"NOV 06, 2023",SAC @ HOU,L,30,3,4,0.75,0,0,0.0,2,3,0.667,3,5,8,5,0,0,4,4,8,-24,1,Domantas Sabonis,SAC,HOU,SAC,42.5,Pts+Rebs+Asts,21,16,13,13
22023,1627734,22300153,"NOV 06, 2023",SAC @ HOU,L,30,3,4,0.75,0,0,0.0,2,3,0.667,3,5,8,5,0,0,4,4,8,-24,1,Domantas Sabonis,SAC,HOU,SAC,8.0,Assists,21,16,13,13
22023,1627734,22300153,"NOV 06, 2023",SAC @ HOU,L,30,3,4,0.75,0,0,0.0,2,3,0.667,3,5,8,5,0,0,4,4,8,-24,1,Domantas Sabonis,SAC,HOU,SAC,47.0,Fantasy Score,21,16,13,13
22023,1627734,22300153,"NOV 06, 2023",SAC @ HOU,L,30,3,4,0.75,0,0,0.0,2,3,0.667,3,5,8,5,0,0,4,4,8,-24,1,Domantas Sabonis,SAC,HOU,SAC,9.0,Defensive Rebounds,21,16,13,13
22023,1627734,22300153,"NOV 06, 2023",SAC @ HOU,L,30,3,4,0.75,0,0,0.0,2,3,0.667,3,5,8,5,0,0,4,4,8,-24,1,Domantas Sabonis,SAC,HOU,SAC,3.5,Free Throws Made,21,16,13,13
22023,1627734,22300153,"NOV 06, 2023",SAC @ HOU,L,30,3,4,0.75,0,0,0.0,2,3,0.667,3,5,8,5,0,0,4,4,8,-24,1,Domantas Sabonis,SAC,HOU,SAC,14.0,FG Attempted,21,16,13,13
22023,1627734,22300153,"NOV 06, 2023",SAC @ HOU,L,30,3,4,0.75,0,0,0.0,2,3,0.667,3,5,8,5,0,0,4,4,8,-24,1,Domantas Sabonis,SAC,HOU,SAC,34.0,Pts+Rebs,21,16,13,13
22023,1627734,22300153,"NOV 06, 2023",SAC @ HOU,L,30,3,4,0.75,0,0,0.0,2,3,0.667,3,5,8,5,0,0,4,4,8,-24,1,Domantas Sabonis,SAC,HOU,SAC,29.5,Pts+Asts,21,16,13,13
22023,1627734,22300153,"NOV 06, 2023",SAC @ HOU,L,30,3,4,0.75,0,0,0.0,2,3,0.667,3,5,8,5,0,0,4,4,8,-24,1,Domantas Sabonis,SAC,HOU,SAC,20.5,Rebs+Asts,21,16,13,13
22023,1627734,22300137,"NOV 04, 2023",SAC @ HOU,L,31,5,10,0.5,0,2,0.0,1,4,0.25,3,12,15,4,1,2,5,2,11,-26,1,Domantas Sabonis,SAC,HOU,SAC,21.0,Points,30,26,15,19
22023,1627734,22300137,"NOV 04, 2023",SAC @ HOU,L,31,5,10,0.5,0,2,0.0,1,4,0.25,3,12,15,4,1,2,5,2,11,-26,1,Domantas Sabonis,SAC,HOU,SAC,12.5,Rebounds,30,26,15,19
22023,1627734,22300137,"NOV 04, 2023",SAC @ HOU,L,31,5,10,0.5,0,2,0.0,1,4,0.25,3,12,15,4,1,2,5,2,11,-26,1,Domantas Sabonis,SAC,HOU,SAC,42.5,Pts+Rebs+Asts,30,26,15,19
22023,1627734,22300137,"NOV 04, 2023",SAC @ HOU,L,31,5,10,0.5,0,2,0.0,1,4,0.25,3,12,15,4,1,2,5,2,11,-26,1,Domantas Sabonis,SAC,HOU,SAC,8.0,Assists,30,26,15,19
22023,1627734,22300137,"NOV 04, 2023",SAC @ HOU,L,31,5,10,0.5,0,2,0.0,1,4,0.25,3,12,15,4,1,2,5,2,11,-26,1,Domantas Sabonis,SAC,HOU,SAC,47.0,Fantasy Score,30,26,15,19
22023,1627734,22300137,"NOV 04, 2023",SAC @ HOU,L,31,5,10,0.5,0,2,0.0,1,4,0.25,3,12,15,4,1,2,5,2,11,-26,1,Domantas Sabonis,SAC,HOU,SAC,9.0,Defensive Rebounds,30,26,15,19
22023,1627734,22300137,"NOV 04, 2023",SAC @ HOU,L,31,5,10,0.5,0,2,0.0,1,4,0.25,3,12,15,4,1,2,5,2,11,-26,1,Domantas Sabonis,SAC,HOU,SAC,3.5,Free Throws Made,30,26,15,19
22023,1627734,22300137,"NOV 04, 2023",SAC @ HOU,L,31,5,10,0.5,0,2,0.0,1,4,0.25,3,12,15,4,1,2,5,2,11,-26,1,Domantas Sabonis,SAC,HOU,SAC,14.0,FG Attempted,30,26,15,19
22023,1627734,22300137,"NOV 04, 2023",SAC @ HOU,L,31,5,10,0.5,0,2,0.0,1,4,0.25,3,12,15,4,1,2,5,2,11,-26,1,Domantas Sabonis,SAC,HOU,SAC,34.0,Pts+Rebs,30,26,15,19
22023,1627734,22300137,"NOV 04, 2023",SAC @ HOU,L,31,5,10,0.5,0,2,0.0,1,4,0.25,3,12,15,4,1,2,5,2,11,-26,1,Domantas Sabonis,SAC,HOU,SAC,29.5,Pts+Asts,30,26,15,19
22023,1627734,22300137,"NOV 04, 2023",SAC @ HOU,L,31,5,10,0.5,0,2,0.0,1,4,0.25,3,12,15,4,1,2,5,2,11,-26,1,Domantas Sabonis,SAC,HOU,SAC,20.5,Rebs+Asts,30,26,15,19
22023,1627734,22300126,"NOV 01, 2023",SAC @ GSW,L,37,8,16,0.5,0,1,0.0,7,12,0.583,3,8,11,8,0,0,2,2,23,-4,1,Domantas Sabonis,SAC,GSW,SAC,21.0,Points,42,34,31,19
22023,1627734,22300126,"NOV 01, 2023",SAC @ GSW,L,37,8,16,0.5,0,1,0.0,7,12,0.583,3,8,11,8,0,0,2,2,23,-4,1,Domantas Sabonis,SAC,GSW,SAC,12.5,Rebounds,42,34,31,19
22023,1627734,22300126,"NOV 01, 2023",SAC @ GSW,L,37,8,16,0.5,0,1,0.0,7,12,0.583,3,8,11,8,0,0,2,2,23,-4,1,Domantas Sabonis,SAC,GSW,SAC,42.5,Pts+Rebs+Asts,42,34,31,19
22023,1627734,22300126,"NOV 01, 2023",SAC @ GSW,L,37,8,16,0.5,0,1,0.0,7,12,0.583,3,8,11,8,0,0,2,2,23,-4,1,Domantas Sabonis,SAC,GSW,SAC,8.0,Assists,42,34,31,19
22023,1627734,22300126,"NOV 01, 2023",SAC @ GSW,L,37,8,16,0.5,0,1,0.0,7,12,0.583,3,8,11,8,0,0,2,2,23,-4,1,Domantas Sabonis,SAC,GSW,SAC,47.0,Fantasy Score,42,34,31,19
22023,1627734,22300126,"NOV 01, 2023",SAC @ GSW,L,37,8,16,0.5,0,1,0.0,7,12,0.583,3,8,11,8,0,0,2,2,23,-4,1,Domantas Sabonis,SAC,GSW,SAC,9.0,Defensive Rebounds,42,34,31,19
22023,1627734,22300126,"NOV 01, 2023",SAC @ GSW,L,37,8,16,0.5,0,1,0.0,7,12,0.583,3,8,11,8,0,0,2,2,23,-4,1,Domantas Sabonis,SAC,GSW,SAC,3.5,Free Throws Made,42,34,31,19
22023,1627734,22300126,"NOV 01, 2023",SAC @ GSW,L,37,8,16,0.5,0,1,0.0,7,12,0.583,3,8,11,8,0,0,2,2,23,-4,1,Domantas Sabonis,SAC,GSW,SAC,14.0,FG Attempted,42,34,31,19
22023,1627734,22300126,"NOV 01, 2023",SAC @ GSW,L,37,8,16,0.5,0,1,0.0,7,12,0.583,3,8,11,8,0,0,2,2,23,-4,1,Domantas Sabonis,SAC,GSW,SAC,34.0,Pts+Rebs,42,34,31,19
22023,1627734,22300126,"NOV 01, 2023",SAC @ GSW,L,37,8,16,0.5,0,1,0.0,7,12,0.583,3,8,11,8,0,0,2,2,23,-4,1,Domantas Sabonis,SAC,GSW,SAC,29.5,Pts+Asts,42,34,31,19
22023,1627734,22300126,"NOV 01, 2023",SAC @ GSW,L,37,8,16,0.5,0,1,0.0,7,12,0.583,3,8,11,8,0,0,2,2,23,-4,1,Domantas Sabonis,SAC,GSW,SAC,20.5,Rebs+Asts,42,34,31,19
22023,1627734,22300100,"OCT 29, 2023",SAC vs. LAL,W,34,5,8,0.625,1,1,1.0,1,3,0.333,1,14,15,5,1,0,3,6,12,5,1,Domantas Sabonis,SAC,SAC,LAL,21.0,Points,32,27,17,20
22023,1627734,22300100,"OCT 29, 2023",SAC vs. LAL,W,34,5,8,0.625,1,1,1.0,1,3,0.333,1,14,15,5,1,0,3,6,12,5,1,Domantas Sabonis,SAC,SAC,LAL,12.5,Rebounds,32,27,17,20
22023,1627734,22300100,"OCT 29, 2023",SAC vs. LAL,W,34,5,8,0.625,1,1,1.0,1,3,0.333,1,14,15,5,1,0,3,6,12,5,1,Domantas Sabonis,SAC,SAC,LAL,42.5,Pts+Rebs+Asts,32,27,17,20
22023,1627734,22300100,"OCT 29, 2023",SAC vs. LAL,W,34,5,8,0.625,1,1,1.0,1,3,0.333,1,14,15,5,1,0,3,6,12,5,1,Domantas Sabonis,SAC,SAC,LAL,8.0,Assists,32,27,17,20
22023,1627734,22300100,"OCT 29, 2023",SAC vs. LAL,W,34,5,8,0.625,1,1,1.0,1,3,0.333,1,14,15,5,1,0,3,6,12,5,1,Domantas Sabonis,SAC,SAC,LAL,47.0,Fantasy Score,32,27,17,20
22023,1627734,22300100,"OCT 29, 2023",SAC vs. LAL,W,34,5,8,0.625,1,1,1.0,1,3,0.333,1,14,15,5,1,0,3,6,12,5,1,Domantas Sabonis,SAC,SAC,LAL,9.0,Defensive Rebounds,32,27,17,20
22023,1627734,22300100,"OCT 29, 2023",SAC vs. LAL,W,34,5,8,0.625,1,1,1.0,1,3,0.333,1,14,15,5,1,0,3,6,12,5,1,Domantas Sabonis,SAC,SAC,LAL,3.5,Free Throws Made,32,27,17,20
22023,1627734,22300100,"OCT 29, 2023",SAC vs. LAL,W,34,5,8,0.625,1,1,1.0,1,3,0.333,1,14,15,5,1,0,3,6,12,5,1,Domantas Sabonis,SAC,SAC,LAL,14.0,FG Attempted,32,27,17,20
22023,1627734,22300100,"OCT 29, 2023",SAC vs. LAL,W,34,5,8,0.625,1,1,1.0,1,3,0.333,1,14,15,5,1,0,3,6,12,5,1,Domantas Sabonis,SAC,SAC,LAL,34.0,Pts+Rebs,32,27,17,20
22023,1627734,22300100,"OCT 29, 2023",SAC vs. LAL,W,34,5,8,0.625,1,1,1.0,1,3,0.333,1,14,15,5,1,0,3,6,12,5,1,Domantas Sabonis,SAC,SAC,LAL,29.5,Pts+Asts,32,27,17,20
22023,1627734,22300100,"OCT 29, 2023",SAC vs. LAL,W,34,5,8,0.625,1,1,1.0,1,3,0.333,1,14,15,5,1,0,3,6,12,5,1,Domantas Sabonis,SAC,SAC,LAL,20.5,Rebs+Asts,32,27,17,20
22023,1627734,22300087,"OCT 27, 2023",SAC vs. GSW,L,36,7,15,0.467,0,2,0.0,5,6,0.833,4,14,18,7,3,0,1,1,19,-9,1,Domantas Sabonis,SAC,SAC,GSW,21.0,Points,44,37,26,25
22023,1627734,22300087,"OCT 27, 2023",SAC vs. GSW,L,36,7,15,0.467,0,2,0.0,5,6,0.833,4,14,18,7,3,0,1,1,19,-9,1,Domantas Sabonis,SAC,SAC,GSW,12.5,Rebounds,44,37,26,25
22023,1627734,22300087,"OCT 27, 2023",SAC vs. GSW,L,36,7,15,0.467,0,2,0.0,5,6,0.833,4,14,18,7,3,0,1,1,19,-9,1,Domantas Sabonis,SAC,SAC,GSW,42.5,Pts+Rebs+Asts,44,37,26,25
22023,1627734,22300087,"OCT 27, 2023",SAC vs. GSW,L,36,7,15,0.467,0,2,0.0,5,6,0.833,4,14,18,7,3,0,1,1,19,-9,1,Domantas Sabonis,SAC,SAC,GSW,8.0,Assists,44,37,26,25
22023,1627734,22300087,"OCT 27, 2023",SAC vs. GSW,L,36,7,15,0.467,0,2,0.0,5,6,0.833,4,14,18,7,3,0,1,1,19,-9,1,Domantas Sabonis,SAC,SAC,GSW,47.0,Fantasy Score,44,37,26,25
22023,1627734,22300087,"OCT 27, 2023",SAC vs. GSW,L,36,7,15,0.467,0,2,0.0,5,6,0.833,4,14,18,7,3,0,1,1,19,-9,1,Domantas Sabonis,SAC,SAC,GSW,9.0,Defensive Rebounds,44,37,26,25
22023,1627734,22300087,"OCT 27, 2023",SAC vs. GSW,L,36,7,15,0.467,0,2,0.0,5,6,0.833,4,14,18,7,3,0,1,1,19,-9,1,Domantas Sabonis,SAC,SAC,GSW,3.5,Free Throws Made,44,37,26,25
22023,1627734,22300087,"OCT 27, 2023",SAC vs. GSW,L,36,7,15,0.467,0,2,0.0,5,6,0.833,4,14,18,7,3,0,1,1,19,-9,1,Domantas Sabonis,SAC,SAC,GSW,14.0,FG Attempted,44,37,26,25
22023,1627734,22300087,"OCT 27, 2023",SAC vs. GSW,L,36,7,15,0.467,0,2,0.0,5,6,0.833,4,14,18,7,3,0,1,1,19,-9,1,Domantas Sabonis,SAC,SAC,GSW,34.0,Pts+Rebs,44,37,26,25
22023,1627734,22300087,"OCT 27, 2023",SAC vs. GSW,L,36,7,15,0.467,0,2,0.0,5,6,0.833,4,14,18,7,3,0,1,1,19,-9,1,Domantas Sabonis,SAC,SAC,GSW,29.5,Pts+Asts,44,37,26,25
22023,1627734,22300087,"OCT 27, 2023",SAC vs. GSW,L,36,7,15,0.467,0,2,0.0,5,6,0.833,4,14,18,7,3,0,1,1,19,-9,1,Domantas Sabonis,SAC,SAC,GSW,20.5,Rebs+Asts,44,37,26,25
22023,1627734,22300072,"OCT 25, 2023",SAC @ UTA,W,32,8,14,0.571,1,2,0.5,5,7,0.714,6,6,12,5,1,2,3,3,22,5,1,Domantas Sabonis,SAC,UTA,SAC,21.0,Points,39,34,27,17
22023,1627734,22300072,"OCT 25, 2023",SAC @ UTA,W,32,8,14,0.571,1,2,0.5,5,7,0.714,6,6,12,5,1,2,3,3,22,5,1,Domantas Sabonis,SAC,UTA,SAC,12.5,Rebounds,39,34,27,17
22023,1627734,22300072,"OCT 25, 2023",SAC @ UTA,W,32,8,14,0.571,1,2,0.5,5,7,0.714,6,6,12,5,1,2,3,3,22,5,1,Domantas Sabonis,SAC,UTA,SAC,42.5,Pts+Rebs+Asts,39,34,27,17
22023,1627734,22300072,"OCT 25, 2023",SAC @ UTA,W,32,8,14,0.571,1,2,0.5,5,7,0.714,6,6,12,5,1,2,3,3,22,5,1,Domantas Sabonis,SAC,UTA,SAC,8.0,Assists,39,34,27,17
22023,1627734,22300072,"OCT 25, 2023",SAC @ UTA,W,32,8,14,0.571,1,2,0.5,5,7,0.714,6,6,12,5,1,2,3,3,22,5,1,Domantas Sabonis,SAC,UTA,SAC,47.0,Fantasy Score,39,34,27,17
22023,1627734,22300072,"OCT 25, 2023",SAC @ UTA,W,32,8,14,0.571,1,2,0.5,5,7,0.714,6,6,12,5,1,2,3,3,22,5,1,Domantas Sabonis,SAC,UTA,SAC,9.0,Defensive Rebounds,39,34,27,17
22023,1627734,22300072,"OCT 25, 2023",SAC @ UTA,W,32,8,14,0.571,1,2,0.5,5,7,0.714,6,6,12,5,1,2,3,3,22,5,1,Domantas Sabonis,SAC,UTA,SAC,3.5,Free Throws Made,39,34,27,17
22023,1627734,22300072,"OCT 25, 2023",SAC @ UTA,W,32,8,14,0.571,1,2,0.5,5,7,0.714,6,6,12,5,1,2,3,3,22,5,1,Domantas Sabonis,SAC,UTA,SAC,14.0,FG Attempted,39,34,27,17
22023,1627734,22300072,"OCT 25, 2023",SAC @ UTA,W,32,8,14,0.571,1,2,0.5,5,7,0.714,6,6,12,5,1,2,3,3,22,5,1,Domantas Sabonis,SAC,UTA,SAC,34.0,Pts+Rebs,39,34,27,17
22023,1627734,22300072,"OCT 25, 2023",SAC @ UTA,W,32,8,14,0.571,1,2,0.5,5,7,0.714,6,6,12,5,1,2,3,3,22,5,1,Domantas Sabonis,SAC,UTA,SAC,29.5,Pts+Asts,39,34,27,17
22023,1627734,22300072,"OCT 25, 2023",SAC @ UTA,W,32,8,14,0.571,1,2,0.5,5,7,0.714,6,6,12,5,1,2,3,3,22,5,1,Domantas Sabonis,SAC,UTA,SAC,20.5,Rebs+Asts,39,34,27,17
22023,1629677,22300564,"JAN 15, 2024",UTA vs. IND,W,3,0,0,0.0,0,0,0.0,0,0,0.0,0,1,1,0,0,0,0,1,0,7,1,Luka Samanic,UTA,UTA,IND,,,1,1,0,1
22023,1629677,22300540,"JAN 12, 2024",UTA vs. TOR,W,6,1,2,0.5,0,0,0.0,2,2,1.0,0,1,1,0,0,0,1,2,4,13,1,Luka Samanic,UTA,UTA,TOR,,,5,5,4,1
22023,1629677,22300524,"JAN 10, 2024",UTA vs. DEN,W,3,0,0,0.0,0,0,0.0,1,2,0.5,0,0,0,1,0,0,0,0,1,-5,1,Luka Samanic,UTA,UTA,DEN,,,2,1,2,1
22023,1629677,22300479,"JAN 05, 2024",UTA @ BOS,L,12,1,3,0.333,0,1,0.0,4,5,0.8,2,3,5,0,0,0,2,0,6,3,1,Luka Samanic,UTA,BOS,UTA,,,11,11,6,5
22023,1629677,22300457,"JAN 01, 2024",UTA vs. DAL,W,4,1,4,0.25,0,0,0.0,0,0,0.0,1,0,1,0,0,0,0,0,2,1,1,Luka Samanic,UTA,UTA,DAL,,,3,3,2,1
22023,1629677,22300412,"DEC 26, 2023",UTA @ SAS,W,2,0,0,0.0,0,0,0.0,0,0,0.0,0,0,0,0,0,0,0,0,0,-7,1,Luka Samanic,UTA,SAS,UTA,,,0,0,0,0
22023,1629677,22300374,"DEC 21, 2023",UTA @ DET,W,10,0,5,0.0,0,1,0.0,2,2,1.0,1,4,5,0,0,0,0,1,2,4,1,Luka Samanic,UTA,DET,UTA,,,7,7,2,5
22023,1629677,22300357,"DEC 18, 2023",UTA vs. BKN,W,2,2,2,1.0,1,1,1.0,0,0,0.0,0,1,1,0,0,0,0,1,5,-2,1,Luka Samanic,UTA,UTA,BKN,,,6,6,5,1
22023,1629677,22300302,"DEC 11, 2023",UTA @ OKC,L,17,6,10,0.6,1,4,0.25,1,1,1.0,0,7,7,1,0,0,2,3,14,22,1,Luka Samanic,UTA,OKC,UTA,,,22,21,15,8
22023,1629677,22301213,"DEC 06, 2023",UTA @ DAL,L,7,1,5,0.2,0,2,0.0,0,0,0.0,0,1,1,0,0,0,0,0,2,-7,1,Luka Samanic,UTA,DAL,UTA,,,3,3,2,1
22023,1629677,22300289,"DEC 02, 2023",UTA vs. POR,W,12,1,5,0.2,0,2,0.0,0,0,0.0,1,2,3,0,0,1,0,3,2,1,1,Luka Samanic,UTA,UTA,POR,,,5,5,2,3
22023,1629677,22300270,"NOV 30, 2023",UTA @ MIN,L,12,1,4,0.25,0,1,0.0,0,0,0.0,1,3,4,0,0,0,2,0,2,-2,1,Luka Samanic,UTA,MIN,UTA,,,6,6,2,4
22023,1629677,22300261,"NOV 29, 2023",UTA @ MEM,L,6,2,2,1.0,1,1,1.0,0,0,0.0,1,1,2,0,0,1,1,0,5,6,1,Luka Samanic,UTA,MEM,UTA,,,7,7,5,2
22023,1629677,22300042,"NOV 21, 2023",UTA @ LAL,L,9,0,3,0.0,0,2,0.0,0,0,0.0,0,3,3,1,0,0,1,1,0,-5,1,Luka Samanic,UTA,LAL,UTA,,,4,3,1,4
22023,1629677,22300023,"NOV 14, 2023",UTA vs. POR,W,1,0,0,0.0,0,0,0.0,0,0,0.0,0,0,0,0,0,0,0,0,0,0,1,Luka Samanic,UTA,UTA,POR,,,0,0,0,0
22023,1629677,22300152,"NOV 06, 2023",UTA @ CHI,L,4,1,2,0.5,1,2,0.5,0,0,0.0,0,1,1,1,0,0,0,1,3,5,1,Luka Samanic,UTA,CHI,UTA,,,5,4,4,2
22023,1629677,22300138,"NOV 04, 2023",UTA @ MIN,L,4,1,2,0.5,0,1,0.0,1,1,1.0,0,2,2,0,0,0,0,0,3,-5,1,Luka Samanic,UTA,MIN,UTA,,,5,5,3,2
22023,1629677,22300094,"OCT 28, 2023",UTA @ PHX,L,6,2,4,0.5,1,1,1.0,0,0,0.0,0,1,1,0,1,0,0,0,5,4,1,Luka Samanic,UTA,PHX,UTA,,,6,6,5,1
22023,1629677,22300072,"OCT 25, 2023",UTA vs. SAC,L,2,1,2,0.5,0,1,0.0,0,0,0.0,0,0,0,0,0,0,0,0,2,2,1,Luka Samanic,UTA,UTA,SAC,,,2,2,2,0
22023,1631257,22300385,"DEC 22, 2023",HOU vs. DAL,W,9,3,3,1.0,0,0,0.0,0,0,0.0,0,1,1,0,1,0,0,0,6,-5,1,Jermaine Samuels Jr.,HOU,HOU,DAL,,,7,7,6,1
22023,1631257,22300291,"DEC 02, 2023",HOU @ LAL,L,3,0,0,0.0,0,0,0.0,0,0,0.0,0,2,2,0,0,0,0,0,0,8,1,Jermaine Samuels Jr.,HOU,LAL,HOU,,,2,2,0,2
22023,1631257,22300263,"NOV 29, 2023",HOU @ DEN,L,6,0,1,0.0,0,1,0.0,0,0,0.0,0,2,2,2,0,0,0,0,0,6,1,Jermaine Samuels Jr.,HOU,DEN,HOU,,,4,2,2,4
22023,1631257,22300153,"NOV 06, 2023",HOU vs. SAC,W,12,2,2,1.0,0,0,0.0,0,0,0.0,1,2,3,0,0,1,0,1,4,-12,1,Jermaine Samuels Jr.,HOU,HOU,SAC,,,7,7,4,3
22023,1631257,22300137,"NOV 04, 2023",HOU vs. SAC,W,1,0,1,0.0,0,1,0.0,2,2,1.0,0,0,0,0,0,0,0,1,2,0,1,Jermaine Samuels Jr.,HOU,HOU,SAC,,,2,2,2,0
22023,1631257,22300066,"OCT 25, 2023",HOU @ ORL,L,6,0,0,0.0,0,0,0.0,0,0,0.0,0,0,0,0,0,0,0,1,0,-10,1,Jermaine Samuels Jr.,HOU,ORL,HOU,,,0,0,0,0
22023,1641766,22300468,"JAN 03, 2024",CHI @ NYK,L,1,0,0,0.0,0,0,0.0,0,0,0.0,0,0,0,0,0,0,0,0,0,0,1,Adama Sanogo,CHI,NYK,CHI,,,0,0,0,0
22023,1641766,22300459,"JAN 02, 2024",CHI @ PHI,L,9,3,3,1.0,0,0,0.0,2,3,0.667,2,4,6,0,0,0,1,0,8,17,1,Adama Sanogo,CHI,PHI,CHI,,,14,14,8,6
22023,1641766,22300422,"DEC 28, 2023",CHI vs. IND,L,1,0,0,0.0,0,0,0.0,0,0,0.0,0,0,0,0,0,0,0,0,0,0,1,Adama Sanogo,CHI,CHI,IND,,,0,0,0,0
22023,1630611,22300525,"JAN 10, 2024",GSW vs. NOP,L,10,0,3,0.0,0,3,0.0,2,2,1.0,0,3,3,1,0,0,0,0,2,-6,1,Gui Santos,GSW,GSW,NOP,,,6,5,3,4
22023,1630611,22300399,"DEC 23, 2023",GSW vs. POR,W,4,0,0,0.0,0,0,0.0,2,2,1.0,1,1,2,0,0,0,0,0,2,1,1,Gui Santos,GSW,GSW,POR,,,4,4,2,2
22023,1630611,22300386,"DEC 22, 2023",GSW vs. WAS,W,6,2,3,0.667,1,2,0.5,2,2,1.0,1,1,2,0,0,0,0,1,7,-12,1,Gui Santos,GSW,GSW,WAS,,,9,9,7,2
22023,1630611,22300236,"NOV 22, 2023",GSW @ PHX,L,8,1,1,1.0,0,0,0.0,0,0,0.0,0,1,1,0,0,0,2,2,2,3,1,Gui Santos,GSW,PHX,GSW,,,3,3,2,1
22023,1630611,22300201,"NOV 16, 2023",GSW vs. OKC,L,4,1,3,0.333,0,1,0.0,0,0,0.0,2,1,3,1,0,0,0,0,2,-1,1,Gui Santos,GSW,GSW,OKC,,,6,5,3,4
22023,203967,22300560,"JAN 15, 2024",GSW @ MEM,L,23,3,6,0.5,3,5,0.6,4,4,1.0,0,7,7,3,0,1,4,5,13,-6,1,Dario Saric,GSW,MEM,GSW,,,23,20,16,10
22023,203967,22300545,"JAN 13, 2024",GSW @ MIL,L,34,5,9,0.556,1,5,0.2,1,2,0.5,0,6,6,6,1,0,3,1,12,-6,1,Dario Saric,GSW,MIL,GSW,,,24,18,18,12
22023,203967,22300536,"JAN 12, 2024",GSW @ CHI,W,28,4,6,0.667,2,3,0.667,2,4,0.5,1,6,7,6,2,0,0,2,12,6,1,Dario Saric,GSW,CHI,GSW,,,25,19,18,13
22023,203967,22300525,"JAN 10, 2024",GSW vs. NOP,L,13,1,3,0.333,0,2,0.0,2,2,1.0,1,2,3,3,1,0,2,2,4,-24,1,Dario Saric,GSW,GSW,NOP,,,10,7,7,6
22023,203967,22300504,"JAN 07, 2024",GSW vs. TOR,L,18,4,10,0.4,2,5,0.4,1,1,1.0,2,3,5,4,2,0,0,1,11,-4,1,Dario Saric,GSW,GSW,TOR,,,20,16,15,9
22023,203967,22300490,"JAN 05, 2024",GSW vs. DET,W,22,6,10,0.6,3,5,0.6,2,2,1.0,0,3,3,1,0,0,1,3,17,-7,1,Dario Saric,GSW,GSW,DET,,,21,20,18,4
22023,203967,22300478,"JAN 04, 2024",GSW vs. DEN,L,23,5,7,0.714,1,2,0.5,2,2,1.0,1,6,7,6,1,0,2,1,13,3,1,Dario Saric,GSW,GSW,DEN,,,26,20,19,13
22023,203967,22300463,"JAN 02, 2024",GSW vs. ORL,W,14,1,3,0.333,0,1,0.0,0,0,0.0,1,2,3,1,0,0,2,0,2,-8,1,Dario Saric,GSW,GSW,ORL,,,6,5,3,4
22023,203967,22300444,"DEC 30, 2023",GSW vs. DAL,L,15,1,4,0.25,1,4,0.25,0,0,0.0,2,7,9,4,1,0,2,1,3,-1,1,Dario Saric,GSW,GSW,DAL,,,16,12,7,13
22023,203967,22300426,"DEC 28, 2023",GSW vs. MIA,L,20,4,5,0.8,1,1,1.0,1,1,1.0,1,5,6,1,0,0,0,1,10,-10,1,Dario Saric,GSW,GSW,MIA,,,17,16,11,7
22023,203967,22300402,"DEC 25, 2023",GSW @ DEN,L,20,5,11,0.455,0,3,0.0,4,4,1.0,2,3,5,2,0,0,0,2,14,11,1,Dario Saric,GSW,DEN,GSW,,,21,19,16,7
22023,203967,22300399,"DEC 23, 2023",GSW vs. POR,W,19,3,7,0.429,0,2,0.0,2,2,1.0,2,3,5,1,1,0,1,2,8,6,1,Dario Saric,GSW,GSW,POR,,,14,13,9,6
22023,203967,22300386,"DEC 22, 2023",GSW vs. WAS,W,20,5,11,0.455,1,4,0.25,2,2,1.0,0,3,3,1,0,0,0,1,13,17,1,Dario Saric,GSW,GSW,WAS,,,17,16,14,4
22023,203967,22300362,"DEC 19, 2023",GSW vs. BOS,W,15,3,6,0.5,3,4,0.75,2,2,1.0,2,4,6,0,0,0,1,2,11,0,1,Dario Saric,GSW,GSW,BOS,,,17,17,11,6
22023,203967,22300348,"DEC 17, 2023",GSW @ POR,W,15,2,4,0.5,2,3,0.667,2,2,1.0,0,1,1,1,0,0,2,3,8,-2,1,Dario Saric,GSW,POR,GSW,,,10,9,9,2
22023,203967,22300339,"DEC 16, 2023",GSW vs. BKN,W,21,5,8,0.625,2,3,0.667,0,0,0.0,3,3,6,2,1,0,2,3,12,-4,1,Dario Saric,GSW,GSW,BKN,,,20,18,14,8
22023,203967,22300325,"DEC 14, 2023",GSW @ LAC,L,17,2,5,0.4,1,4,0.25,0,0,0.0,0,6,6,1,0,0,1,2,5,3,1,Dario Saric,GSW,LAC,GSW,,,12,11,6,7
22023,203967,22300308,"DEC 12, 2023",GSW @ PHX,L,20,5,9,0.556,2,4,0.5,3,4,0.75,1,3,4,1,0,0,0,5,15,21,1,Dario Saric,GSW,PHX,GSW,,,20,19,16,5
22023,203967,22301222,"DEC 08, 2023",GSW @ OKC,L,23,3,8,0.375,2,6,0.333,3,4,0.75,6,6,12,3,1,0,3,2,11,4,1,Dario Saric,GSW,OKC,GSW,,,26,23,14,15
22023,203967,22301214,"DEC 06, 2023",GSW vs. POR,W,20,4,7,0.571,2,3,0.667,3,4,0.75,2,4,6,0,0,0,4,3,13,7,1,Dario Saric,GSW,GSW,POR,,,19,19,13,6
22023,203967,22300280,"DEC 02, 2023",GSW @ LAC,L,20,3,7,0.429,0,2,0.0,0,0,0.0,0,2,2,3,1,0,3,2,6,-8,1,Dario Saric,GSW,LAC,GSW,,,11,8,9,5
22023,203967,22300273,"NOV 30, 2023",GSW vs. LAC,W,27,4,7,0.571,2,4,0.5,3,4,0.75,0,5,5,5,1,0,0,2,13,15,1,Dario Saric,GSW,GSW,LAC,,,23,18,18,10
22023,203967,22300060,"NOV 28, 2023",GSW @ SAC,L,17,3,7,0.429,2,4,0.5,2,2,1.0,1,1,2,3,0,0,0,3,10,-10,1,Dario Saric,GSW,SAC,GSW,,,15,12,13,5
22023,203967,22300051,"NOV 24, 2023",GSW vs. SAS,W,26,7,11,0.636,4,7,0.571,2,2,1.0,2,5,7,4,2,0,3,3,20,13,1,Dario Saric,GSW,GSW,SAS,,,31,27,24,11
22023,203967,22300236,"NOV 22, 2023",GSW @ PHX,L,22,6,9,0.667,2,3,0.667,3,5,0.6,2,4,6,4,2,0,1,4,17,12,1,Dario Saric,GSW,PHX,GSW,,,27,23,21,10
22023,203967,22300224,"NOV 20, 2023",GSW vs. HOU,W,26,5,10,0.5,3,7,0.429,5,6,0.833,0,5,5,2,1,1,1,2,18,5,1,Dario Saric,GSW,GSW,HOU,,,25,23,20,7
22023,203967,22300207,"NOV 18, 2023",GSW vs. OKC,L,18,3,9,0.333,0,2,0.0,0,0,0.0,2,6,8,1,0,0,1,1,6,-6,1,Dario Saric,GSW,GSW,OKC,,,15,14,7,9
22023,203967,22300201,"NOV 16, 2023",GSW vs. OKC,L,24,4,10,0.4,2,3,0.667,2,2,1.0,1,2,3,4,1,0,1,4,12,-3,1,Dario Saric,GSW,GSW,OKC,,,19,15,16,7
22023,203967,22300025,"NOV 14, 2023",GSW vs. MIN,L,32,6,15,0.4,3,11,0.273,6,6,1.0,1,3,4,4,2,0,2,4,21,-5,1,Dario Saric,GSW,GSW,MIN,,,29,25,25,8
22023,203967,22300186,"NOV 12, 2023",GSW vs. MIN,L,27,5,10,0.5,1,4,0.25,0,0,0.0,3,7,10,1,1,0,1,4,11,2,1,Dario Saric,GSW,GSW,MIN,,,22,21,12,11
22023,203967,22300176,"NOV 11, 2023",GSW vs. CLE,L,16,2,5,0.4,0,3,0.0,1,1,1.0,0,5,5,1,0,1,0,3,5,0,1,Dario Saric,GSW,GSW,CLE,,,11,10,6,6
22023,203967,22300169,"NOV 08, 2023",GSW @ DEN,L,26,2,5,0.4,0,3,0.0,0,0,0.0,1,7,8,2,0,0,0,0,4,-12,1,Dario Saric,GSW,DEN,GSW,,,14,12,6,10
22023,203967,22300145,"NOV 06, 2023",GSW @ DET,W,21,4,8,0.5,2,5,0.4,2,2,1.0,3,3,6,1,1,0,0,1,12,1,1,Dario Saric,GSW,DET,GSW,,,19,18,13,7
22023,203967,22300142,"NOV 05, 2023",GSW @ CLE,L,13,0,3,0.0,0,1,0.0,0,0,0.0,1,4,5,0,0,0,1,2,0,-4,1,Dario Saric,GSW,CLE,GSW,,,5,5,0,5
22023,203967,22300005,"NOV 03, 2023",GSW @ OKC,W,20,6,9,0.667,4,7,0.571,4,4,1.0,1,5,6,3,1,0,1,2,20,3,1,Dario Saric,GSW,OKC,GSW,,,29,26,23,9
22023,203967,22300126,"NOV 01, 2023",GSW vs. SAC,W,20,6,9,0.667,3,5,0.6,0,0,0.0,0,6,6,2,0,0,4,1,15,3,1,Dario Saric,GSW,GSW,SAC,,,23,21,17,8
22023,203967,22300108,"OCT 30, 2023",GSW @ NOP,W,21,2,7,0.286,1,4,0.25,1,2,0.5,4,6,10,2,0,1,0,2,6,14,1,Dario Saric,GSW,NOP,GSW,,,18,16,8,12
22023,203967,22300096,"OCT 29, 2023",GSW @ HOU,W,21,1,6,0.167,1,3,0.333,1,2,0.5,3,5,8,5,0,1,1,0,4,6,1,Dario Saric,GSW,HOU,GSW,,,17,12,9,13
22023,203967,22300087,"OCT 27, 2023",GSW @ SAC,W,14,2,5,0.4,1,4,0.25,0,0,0.0,1,3,4,1,1,0,1,4,5,-6,1,Dario Saric,GSW,SAC,GSW,,,10,9,6,5
22023,203967,22300062,"OCT 24, 2023",GSW vs. PHX,L,20,3,11,0.273,1,3,0.333,0,0,0.0,4,3,7,1,0,2,0,3,7,7,1,Dario Saric,GSW,GSW,PHX,,,15,14,8,8
22023,1630846,22300435,"DEC 29, 2023",OKC @ DEN,W,3,0,0,0.0,0,0,0.0,2,2,1.0,0,1,1,0,0,0,0,0,2,3,1,Olivier Sarr,OKC,DEN,OKC,,,3,3,2,1
22023,1630846,22300397,"DEC 23, 2023",OKC vs. LAL,L,3,0,0,0.0,0,0,0.0,0,0,0.0,1,1,2,1,0,0,0,1,0,-1,1,Olivier Sarr,OKC,OKC,LAL,,,3,2,1,3
22023,1630846,22300355,"DEC 18, 2023",OKC vs. MEM,W,7,3,5,0.6,0,2,0.0,0,0,0.0,1,2,3,0,0,0,0,3,6,-12,1,Olivier Sarr,OKC,OKC,MEM,,,9,9,6,3
22023,1630846,22300215,"NOV 19, 2023",OKC @ POR,W,10,2,5,0.4,2,3,0.667,0,0,0.0,1,1,2,0,0,0,0,4,6,10,1,Olivier Sarr,OKC,POR,OKC,,,8,8,6,2
22023,1630846,22300121,"NOV 01, 2023",OKC vs. NOP,L,7,0,0,0.0,0,0,0.0,0,0,0.0,1,4,5,0,0,2,1,1,0,-4,1,Olivier Sarr,OKC,OKC,NOP,,,5,5,0,5
22023,1630846,22300109,"OCT 30, 2023",OKC vs. DET,W,21,0,0,0.0,0,0,0.0,2,4,0.5,1,8,9,1,0,3,0,2,2,9,1,Olivier Sarr,OKC,OKC,DET,,,12,11,3,10
22023,1630846,22300095,"OCT 29, 2023",OKC vs. DEN,L,6,0,0,0.0,0,0,0.0,0,0,0.0,0,0,0,0,0,0,0,0,0,-2,1,Olivier Sarr,OKC,OKC,DEN,,,0,0,0,0
22023,1630846,22300070,"OCT 25, 2023",OKC @ CHI,W,11,1,1,1.0,0,0,0.0,2,2,1.0,1,3,4,0,0,0,1,3,4,6,1,Olivier Sarr,OKC,CHI,OKC,,,8,8,4,4
22023,1631204,22300558,"JAN 15, 2024",DET @ WAS,W,11,3,7,0.429,0,0,0.0,0,0,0.0,0,2,2,4,0,2,1,0,6,9,1,Marcus Sasser,DET,WAS,DET,,,12,8,10,6
22023,1631204,22300534,"JAN 12, 2024",DET vs. HOU,L,11,0,2,0.0,0,1,0.0,0,0,0.0,1,0,1,7,1,0,1,2,0,3,1,Marcus Sasser,DET,DET,HOU,,,8,1,7,8
22023,1631204,22300519,"JAN 10, 2024",DET vs. SAS,L,16,3,7,0.429,0,1,0.0,0,0,0.0,1,1,2,5,0,0,1,2,6,-11,1,Marcus Sasser,DET,DET,SAS,,,13,8,11,7
22023,1631204,22300512,"JAN 09, 2024",DET vs. SAC,L,19,0,4,0.0,0,2,0.0,2,2,1.0,0,2,2,4,1,1,0,0,2,-8,1,Marcus Sasser,DET,DET,SAC,,,8,4,6,6
22023,1631204,22300502,"JAN 07, 2024",DET @ DEN,L,11,2,6,0.333,1,2,0.5,2,2,1.0,0,2,2,1,0,0,0,0,7,-6,1,Marcus Sasser,DET,DEN,DET,,,10,9,8,3
22023,1631204,22300490,"JAN 05, 2024",DET @ GSW,L,6,0,0,0.0,0,0,0.0,0,0,0.0,0,0,0,2,0,0,0,1,0,4,1,Marcus Sasser,DET,GSW,DET,,,2,0,2,2
22023,1631204,22300453,"JAN 01, 2024",DET @ HOU,L,7,3,3,1.0,2,2,1.0,1,2,0.5,0,0,0,2,0,0,0,0,9,7,1,Marcus Sasser,DET,HOU,DET,,,11,9,11,2
22023,1631204,22300406,"DEC 26, 2023",DET vs. BKN,L,10,0,1,0.0,0,1,0.0,0,0,0.0,0,0,0,0,0,0,0,0,0,-11,1,Marcus Sasser,DET,DET,BKN,,,0,0,0,0
22023,1631204,22300394,"DEC 23, 2023",DET @ BKN,L,6,0,1,0.0,0,1,0.0,0,0,0.0,0,1,1,0,0,0,2,2,0,-5,1,Marcus Sasser,DET,BKN,DET,,,1,1,0,1
22023,1631204,22300374,"DEC 21, 2023",DET vs. UTA,L,13,3,8,0.375,2,5,0.4,0,0,0.0,1,2,3,0,0,0,2,0,8,-13,1,Marcus Sasser,DET,DET,UTA,,,11,11,8,3
22023,1631204,22300352,"DEC 18, 2023",DET @ ATL,L,21,2,3,0.667,1,1,1.0,0,0,0.0,0,1,1,1,1,1,0,6,5,10,1,Marcus Sasser,DET,ATL,DET,,,7,6,6,2
22023,1631204,22300334,"DEC 16, 2023",DET @ MIL,L,17,2,4,0.5,1,2,0.5,6,6,1.0,0,1,1,2,2,0,2,2,11,-15,1,Marcus Sasser,DET,MIL,DET,,,14,12,13,3
22023,1631204,22300327,"DEC 15, 2023",DET @ PHI,L,17,4,4,1.0,1,1,1.0,2,4,0.5,0,2,2,4,1,1,2,1,11,1,1,Marcus Sasser,DET,PHI,DET,,,17,13,15,6
22023,1631204,22300310,"DEC 13, 2023",DET vs. PHI,L,5,3,3,1.0,2,2,1.0,0,0,0.0,0,0,0,1,0,0,1,0,8,6,1,Marcus Sasser,DET,DET,PHI,,,9,8,9,1
22023,1631204,22301217,"DEC 08, 2023",DET @ ORL,L,5,2,3,0.667,0,1,0.0,0,0,0.0,0,0,0,1,0,0,0,0,4,-3,1,Marcus Sasser,DET,ORL,DET,,,5,4,5,1
22023,1631204,22301206,"DEC 06, 2023",DET vs. MEM,L,5,0,2,0.0,0,0,0.0,0,0,0.0,0,1,1,2,0,0,0,1,0,-5,1,Marcus Sasser,DET,DET,MEM,,,3,1,2,3
22023,1631204,22300283,"DEC 02, 2023",DET vs. CLE,L,16,2,5,0.4,0,2,0.0,0,0,0.0,0,2,2,1,0,0,2,1,4,-21,1,Marcus Sasser,DET,DET,CLE,,,7,6,5,3
22023,1631204,22300268,"NOV 30, 2023",DET @ NYK,L,20,6,11,0.545,5,7,0.714,0,0,0.0,0,2,2,4,1,0,0,3,17,-3,1,Marcus Sasser,DET,NYK,DET,,,23,19,21,6
22023,1631204,22300258,"NOV 29, 2023",DET vs. LAL,L,28,3,8,0.375,1,2,0.5,2,2,1.0,0,1,1,8,2,1,1,2,9,-8,1,Marcus Sasser,DET,DET,LAL,,,18,10,17,9
22023,1631204,22300253,"NOV 27, 2023",DET vs. WAS,L,22,3,10,0.3,1,5,0.2,0,0,0.0,1,0,1,3,0,1,1,1,7,-15,1,Marcus Sasser,DET,DET,WAS,,,11,8,10,4
22023,1631204,22300047,"NOV 24, 2023",DET @ IND,L,5,0,1,0.0,0,0,0.0,0,0,0.0,0,0,0,0,0,0,0,0,0,-2,1,Marcus Sasser,DET,IND,DET,,,0,0,0,0
22023,1631204,22300218,"NOV 20, 2023",DET vs. DEN,L,5,1,2,0.5,0,1,0.0,0,0,0.0,0,0,0,0,0,0,0,0,2,2,1,Marcus Sasser,DET,DET,DEN,,,2,2,2,0
22023,1631204,22300211,"NOV 19, 2023",DET @ TOR,L,21,4,6,0.667,1,2,0.5,0,0,0.0,0,1,1,6,1,0,3,1,9,-7,1,Marcus Sasser,DET,TOR,DET,,,16,10,15,7
22023,1631204,22300030,"NOV 17, 2023",DET @ CLE,L,15,2,7,0.286,0,3,0.0,2,2,1.0,0,0,0,0,0,0,0,1,6,-8,1,Marcus Sasser,DET,CLE,DET,,,6,6,6,0
22023,1631204,22300018,"NOV 14, 2023",DET vs. ATL,L,8,0,2,0.0,0,2,0.0,0,0,0.0,0,1,1,1,0,0,0,0,0,-1,1,Marcus Sasser,DET,DET,ATL,,,2,1,1,2
22023,1631204,22300181,"NOV 12, 2023",DET @ CHI,L,20,2,6,0.333,1,3,0.333,0,0,0.0,0,3,3,6,1,0,2,1,5,1,1,Marcus Sasser,DET,CHI,DET,,,14,8,11,9
22023,1631204,22300008,"NOV 10, 2023",DET vs. PHI,L,35,3,13,0.231,1,7,0.143,2,2,1.0,0,3,3,4,0,0,0,4,9,-6,1,Marcus Sasser,DET,DET,PHI,,,16,12,13,7
22023,1631204,22300165,"NOV 08, 2023",DET @ MIL,L,28,11,17,0.647,3,7,0.429,1,1,1.0,0,6,6,2,1,0,3,1,26,6,1,Marcus Sasser,DET,MIL,DET,,,34,32,28,8
22023,1631204,22300145,"NOV 06, 2023",DET vs. GSW,L,33,3,10,0.3,1,5,0.2,0,0,0.0,0,3,3,4,1,0,2,5,7,-18,1,Marcus Sasser,DET,DET,GSW,,,14,10,11,7
22023,1631204,22300140,"NOV 05, 2023",DET vs. PHX,L,30,9,16,0.563,4,6,0.667,0,0,0.0,0,3,3,4,1,0,0,3,22,3,1,Marcus Sasser,DET,DET,PHX,,,29,25,26,7
22023,1631204,22300129,"NOV 02, 2023",DET @ NOP,L,23,6,10,0.6,5,8,0.625,2,2,1.0,1,1,2,3,1,0,0,2,19,-14,1,Marcus Sasser,DET,NOP,DET,,,24,21,22,5
22023,1631204,22300115,"NOV 01, 2023",DET vs. POR,L,23,4,6,0.667,0,1,0.0,0,0,0.0,0,3,3,6,4,1,0,3,8,1,1,Marcus Sasser,DET,DET,POR,,,17,11,14,9
22023,1631204,22300109,"OCT 30, 2023",DET @ OKC,L,14,2,4,0.5,2,2,1.0,0,0,0.0,0,2,2,2,1,0,0,1,6,-1,1,Marcus Sasser,DET,OKC,DET,,,10,8,8,4
22023,1631204,22300088,"OCT 28, 2023",DET vs. CHI,W,6,1,2,0.5,0,1,0.0,0,0,0.0,1,2,3,1,0,0,0,0,2,2,1,Marcus Sasser,DET,DET,CHI,,,6,5,3,4
22023,1631204,22300077,"OCT 27, 2023",DET @ CHA,W,8,0,1,0.0,0,1,0.0,0,0,0.0,0,1,1,1,0,0,1,1,0,3,1,Marcus Sasser,DET,CHA,DET,,,2,1,1,2
22023,1631204,22300068,"OCT 25, 2023",DET @ MIA,L,10,3,4,0.75,2,3,0.667,0,0,0.0,0,2,2,1,0,0,1,0,8,2,1,Marcus Sasser,DET,MIA,DET,,,11,10,9,3
22023,1629678,22300488,"JAN 05, 2024",ORL @ DEN,W,9,2,3,0.667,1,2,0.5,0,0,0.0,1,0,1,1,0,0,0,0,5,0,1,Admiral Schofield,ORL,DEN,ORL,,,7,6,6,2
22023,1629678,22300476,"JAN 03, 2024",ORL @ SAC,L,6,0,0,0.0,0,0,0.0,0,0,0.0,0,0,0,1,0,0,0,1,0,5,1,Admiral Schofield,ORL,SAC,ORL,,,1,0,1,1
22023,1629678,22300415,"DEC 27, 2023",ORL vs. PHI,L,1,0,0,0.0,0,0,0.0,0,0,0.0,0,0,0,0,0,0,0,0,0,3,1,Admiral Schofield,ORL,ORL,PHI,,,0,0,0,0
22023,1629678,22300344,"DEC 17, 2023",ORL @ BOS,L,2,0,0,0.0,0,0,0.0,0,0,0.0,0,0,0,1,0,0,0,0,0,4,1,Admiral Schofield,ORL,BOS,ORL,,,1,0,1,1
22023,1629678,22300329,"DEC 15, 2023",ORL @ BOS,L,3,0,1,0.0,0,0,0.0,0,0,0.0,0,2,2,0,0,0,1,1,0,3,1,Admiral Schofield,ORL,BOS,ORL,,,2,2,0,2
22023,1629678,22301217,"DEC 08, 2023",ORL vs. DET,W,4,1,2,0.5,0,0,0.0,0,0,0.0,0,2,2,0,0,0,2,3,2,1,1,Admiral Schofield,ORL,ORL,DET,,,4,4,2,2
22023,1629678,22300282,"DEC 02, 2023",ORL @ BKN,L,4,0,2,0.0,0,2,0.0,0,0,0.0,0,1,1,1,0,0,0,0,0,-5,1,Admiral Schofield,ORL,BKN,ORL,,,2,1,1,2
22023,1629678,22300259,"NOV 29, 2023",ORL vs. WAS,W,4,0,0,0.0,0,0,0.0,0,0,0.0,0,0,0,0,0,0,0,1,0,0,1,Admiral Schofield,ORL,ORL,WAS,,,0,0,0,0
22023,1629678,22300038,"NOV 21, 2023",ORL vs. TOR,W,2,0,0,0.0,0,0,0.0,0,0,0.0,0,0,0,0,0,0,0,0,0,2,1,Admiral Schofield,ORL,ORL,TOR,,,0,0,0,0
22023,1629678,22300209,"NOV 19, 2023",ORL @ IND,W,5,0,1,0.0,0,1,0.0,0,2,0.0,0,0,0,0,0,0,1,1,0,-12,1,Admiral Schofield,ORL,IND,ORL,,,0,0,0,0
22023,1629678,22300134,"NOV 04, 2023",ORL vs. LAL,W,3,2,4,0.5,1,3,0.333,0,0,0.0,0,0,0,0,0,0,0,0,5,3,1,Admiral Schofield,ORL,ORL,LAL,,,5,5,5,0
22023,203471,22300563,"JAN 15, 2024",TOR vs. BOS,L,33,5,9,0.556,1,3,0.333,2,2,1.0,0,7,7,2,0,0,2,4,13,-15,1,Dennis Schroder,TOR,TOR,BOS,,,22,20,15,9
22023,203471,22300540,"JAN 12, 2024",TOR @ UTA,L,23,4,9,0.444,4,7,0.571,0,0,0.0,0,0,0,4,1,0,1,2,12,-9,1,Dennis Schroder,TOR,UTA,TOR,,,16,12,16,4
22023,203471,22300526,"JAN 10, 2024",TOR @ LAC,L,34,8,13,0.615,1,5,0.2,5,5,1.0,0,1,1,4,0,0,2,1,22,-1,1,Dennis Schroder,TOR,LAC,TOR,,,27,23,26,5
22023,203471,22300516,"JAN 09, 2024",TOR @ LAL,L,30,3,6,0.5,2,3,0.667,2,2,1.0,1,1,2,6,0,0,2,2,10,-2,1,Dennis Schroder,TOR,LAL,TOR,,,18,12,16,8
22023,203471,22300504,"JAN 07, 2024",TOR @ GSW,W,28,6,10,0.6,1,3,0.333,0,1,0.0,0,3,3,4,0,0,0,5,13,14,1,Dennis Schroder,TOR,GSW,TOR,,,20,16,17,7
22023,203471,22300492,"JAN 05, 2024",TOR @ SAC,L,32,7,11,0.636,0,4,0.0,4,5,0.8,1,1,2,3,1,1,0,1,18,12,1,Dennis Schroder,TOR,SAC,TOR,,,23,20,21,5
22023,203471,22300470,"JAN 03, 2024",TOR @ MEM,W,29,6,11,0.545,1,3,0.333,3,4,0.75,0,7,7,5,0,0,0,0,16,5,1,Dennis Schroder,TOR,MEM,TOR,,,28,23,21,12
22023,203471,22300452,"JAN 01, 2024",TOR vs. CLE,W,30,3,7,0.429,1,5,0.2,5,7,0.714,0,3,3,8,0,0,1,2,12,12,1,Dennis Schroder,TOR,TOR,CLE,,,23,15,20,11
22023,203471,22300440,"DEC 30, 2023",TOR @ DET,L,37,11,18,0.611,3,6,0.5,5,5,1.0,0,0,0,9,0,0,1,1,30,4,1,Dennis Schroder,TOR,DET,TOR,,,39,30,39,9
22023,203471,22300432,"DEC 29, 2023",TOR @ BOS,L,35,6,12,0.5,2,5,0.4,1,2,0.5,2,0,2,9,0,1,0,2,15,2,1,Dennis Schroder,TOR,BOS,TOR,,,26,17,24,11
22023,203471,22300416,"DEC 27, 2023",TOR @ WAS,W,28,4,6,0.667,1,2,0.5,0,0,0.0,0,4,4,10,0,0,3,1,9,29,1,Dennis Schroder,TOR,WAS,TOR,,,23,13,19,14
22023,203471,22300395,"DEC 23, 2023",TOR vs. UTA,L,33,4,9,0.444,1,3,0.333,2,3,0.667,1,2,3,7,3,0,4,2,11,-1,1,Dennis Schroder,TOR,TOR,UTA,,,21,14,18,10
22023,203471,22300382,"DEC 22, 2023",TOR @ PHI,L,34,2,8,0.25,0,2,0.0,2,2,1.0,1,2,3,6,2,0,0,0,6,-16,1,Dennis Schroder,TOR,PHI,TOR,,,15,9,12,9
22023,203471,22300369,"DEC 20, 2023",TOR vs. DEN,L,31,3,8,0.375,1,2,0.5,0,0,0.0,0,2,2,7,1,0,2,2,7,-17,1,Dennis Schroder,TOR,TOR,DEN,,,16,9,14,9
22023,203471,22300354,"DEC 18, 2023",TOR vs. CHA,W,34,4,6,0.667,3,5,0.6,2,2,1.0,0,0,0,5,0,0,3,2,13,12,1,Dennis Schroder,TOR,TOR,CHA,,,18,13,18,5
22023,203471,22300330,"DEC 15, 2023",TOR vs. ATL,L,31,3,7,0.429,0,2,0.0,0,0,0.0,0,2,2,4,2,0,1,5,6,-20,1,Dennis Schroder,TOR,TOR,ATL,,,12,8,10,6
22023,203471,22300313,"DEC 13, 2023",TOR vs. ATL,W,37,5,11,0.455,3,4,0.75,4,4,1.0,0,3,3,7,1,1,2,5,17,15,1,Dennis Schroder,TOR,TOR,ATL,,,27,20,24,10
22023,203471,22300297,"DEC 11, 2023",TOR @ NYK,L,33,6,12,0.5,2,4,0.5,6,7,0.857,0,2,2,10,4,0,0,2,20,-5,1,Dennis Schroder,TOR,NYK,TOR,,,32,22,30,12
22023,203471,22301216,"DEC 08, 2023",TOR @ CHA,L,30,3,10,0.3,0,4,0.0,1,1,1.0,0,1,1,5,1,0,2,4,7,-9,1,Dennis Schroder,TOR,CHA,TOR,,,13,8,12,6
22023,203471,22301207,"DEC 06, 2023",TOR vs. MIA,L,35,4,18,0.222,1,5,0.2,0,0,0.0,2,3,5,5,0,0,3,5,9,-6,1,Dennis Schroder,TOR,TOR,MIA,,,19,14,14,10
22023,203471,22300276,"DEC 01, 2023",TOR vs. NYK,L,37,3,10,0.3,1,6,0.167,3,4,0.75,0,1,1,9,0,0,2,1,10,-10,1,Dennis Schroder,TOR,TOR,NYK,,,20,11,19,10
22023,203471,22300260,"NOV 29, 2023",TOR vs. PHX,W,34,3,11,0.273,1,2,0.5,1,1,1.0,1,5,6,12,1,0,0,2,8,-2,1,Dennis Schroder,TOR,TOR,PHX,,,26,14,20,18
22023,203471,22300054,"NOV 28, 2023",TOR @ BKN,L,32,5,15,0.333,2,5,0.4,2,3,0.667,1,4,5,9,1,0,0,3,14,-2,1,Dennis Schroder,TOR,BKN,TOR,,,28,19,23,14
22023,203471,22300251,"NOV 26, 2023",TOR @ CLE,L,29,5,11,0.455,2,5,0.4,3,3,1.0,0,2,2,4,2,0,1,5,15,10,1,Dennis Schroder,TOR,CLE,TOR,,,21,17,19,6
22023,203471,22300046,"NOV 24, 2023",TOR vs. CHI,W,34,6,16,0.375,1,9,0.111,4,4,1.0,0,0,0,5,0,0,3,2,17,9,1,Dennis Schroder,TOR,TOR,CHI,,,22,17,22,5
22023,203471,22300230,"NOV 22, 2023",TOR @ IND,W,32,10,16,0.625,2,5,0.4,4,4,1.0,0,6,6,5,1,0,4,3,26,-2,1,Dennis Schroder,TOR,IND,TOR,,,37,32,31,11
22023,203471,22300038,"NOV 21, 2023",TOR @ ORL,L,27,8,13,0.615,4,4,1.0,4,4,1.0,0,1,1,1,0,0,2,2,24,-11,1,Dennis Schroder,TOR,ORL,TOR,,,26,25,25,2
22023,203471,22300211,"NOV 19, 2023",TOR vs. DET,W,26,8,15,0.533,0,4,0.0,1,2,0.5,0,2,2,7,1,0,0,0,17,19,1,Dennis Schroder,TOR,TOR,DET,,,26,19,24,9
22023,203471,22300031,"NOV 17, 2023",TOR vs. BOS,L,35,9,19,0.474,5,11,0.455,0,0,0.0,0,7,7,6,0,0,2,2,23,1,1,Dennis Schroder,TOR,TOR,BOS,,,36,30,29,13
22023,203471,22300195,"NOV 15, 2023",TOR vs. MIL,L,23,2,9,0.222,1,4,0.25,4,4,1.0,0,3,3,5,2,0,2,3,9,-29,1,Dennis Schroder,TOR,TOR,MIL,,,17,12,14,8
22023,203471,22300189,"NOV 13, 2023",TOR vs. WAS,W,35,1,12,0.083,0,4,0.0,2,2,1.0,1,3,4,6,0,0,3,2,4,2,1,Dennis Schroder,TOR,TOR,WAS,,,14,8,10,10
22023,203471,22300174,"NOV 11, 2023",TOR @ BOS,L,25,3,7,0.429,1,3,0.333,7,7,1.0,0,1,1,4,1,0,1,3,14,-2,1,Dennis Schroder,TOR,BOS,TOR,,,19,15,18,5
22023,203471,22300168,"NOV 08, 2023",TOR @ DAL,W,30,7,13,0.538,1,4,0.25,3,4,0.75,0,2,2,5,2,1,2,4,18,1,1,Dennis Schroder,TOR,DAL,TOR,,,25,20,23,7
22023,203471,22300141,"NOV 05, 2023",TOR @ SAS,W,38,10,19,0.526,1,8,0.125,3,4,0.75,2,1,3,6,2,1,2,1,24,1,1,Dennis Schroder,TOR,SAS,TOR,,,33,27,30,9
22023,203471,22300128,"NOV 02, 2023",TOR @ PHI,L,31,4,9,0.444,1,2,0.5,4,6,0.667,0,3,3,10,1,0,3,0,13,-7,1,Dennis Schroder,TOR,PHI,TOR,,,26,16,23,13
22023,203471,22300116,"NOV 01, 2023",TOR vs. MIL,W,29,9,13,0.692,2,4,0.5,4,4,1.0,1,3,4,11,1,0,2,2,24,21,1,Dennis Schroder,TOR,TOR,MIL,,,39,28,35,15
22023,203471,22300105,"OCT 30, 2023",TOR vs. POR,L,32,4,10,0.4,1,3,0.333,1,1,1.0,0,1,1,8,1,0,1,1,10,1,1,Dennis Schroder,TOR,TOR,POR,,,19,11,18,9
22023,203471,22300092,"OCT 28, 2023",TOR vs. PHI,L,35,5,14,0.357,4,6,0.667,1,2,0.5,3,1,4,10,2,0,1,1,15,-5,1,Dennis Schroder,TOR,TOR,PHI,,,29,19,25,14
22023,203471,22300082,"OCT 27, 2023",TOR @ CHI,L,35,3,11,0.273,2,5,0.4,2,3,0.667,0,2,2,10,0,0,2,1,10,-6,1,Dennis Schroder,TOR,CHI,TOR,,,22,12,20,12
22023,203471,22300069,"OCT 25, 2023",TOR vs. MIN,W,33,8,17,0.471,4,8,0.5,2,2,1.0,1,2,3,7,0,0,2,1,22,10,1,Dennis Schroder,TOR,TOR,MIN,,,32,25,29,10
22023,1631220,22300022,"NOV 14, 2023",NOP vs. DAL,W,2,0,0,0.0,0,0,0.0,0,0,0.0,0,0,0,0,1,0,0,0,0,0,1,Dereon Seabron,NOP,NOP,DAL,,,0,0,0,0
22023,1631220,22300183,"NOV 12, 2023",NOP vs. DAL,L,8,1,1,1.0,0,0,0.0,1,2,0.5,0,3,3,2,0,1,0,2,3,16,1,Dereon Seabron,NOP,NOP,DAL,,,8,6,5,5
22023,1631220,22300011,"NOV 10, 2023",NOP @ HOU,L,12,0,3,0.0,0,0,0.0,0,0,0.0,0,1,1,0,1,0,0,0,0,-9,1,Dereon Seabron,NOP,HOU,NOP,,,1,1,0,1
22023,1631220,22300166,"NOV 08, 2023",NOP @ MIN,L,17,3,7,0.429,1,2,0.5,2,2,1.0,1,2,3,1,0,0,0,1,9,5,1,Dereon Seabron,NOP,MIN,NOP,,,13,12,10,4
22023,1631220,22300129,"NOV 02, 2023",NOP vs. DET,W,13,0,2,0.0,0,0,0.0,2,2,1.0,0,0,0,1,0,0,0,1,2,15,1,Dereon Seabron,NOP,NOP,DET,,,3,2,3,1
22023,1630578,22300555,"JAN 15, 2024",HOU @ PHI,L,30,7,15,0.467,1,1,1.0,4,6,0.667,5,4,9,6,1,2,5,1,19,-4,1,Alperen Sengun,HOU,PHI,HOU,,,34,28,25,15
22023,1630578,22300542,"JAN 13, 2024",HOU @ BOS,L,24,8,17,0.471,0,2,0.0,3,3,1.0,2,8,10,3,4,0,3,3,19,-14,1,Alperen Sengun,HOU,BOS,HOU,,,32,29,22,13
22023,1630578,22300534,"JAN 12, 2024",HOU @ DET,W,37,12,19,0.632,0,1,0.0,5,7,0.714,0,6,6,1,1,0,4,3,29,10,1,Alperen Sengun,HOU,DET,HOU,,,36,35,30,7
22023,1630578,22300523,"JAN 10, 2024",HOU @ CHI,L,41,11,19,0.579,0,3,0.0,3,8,0.375,2,7,9,5,2,0,2,5,25,-8,1,Alperen Sengun,HOU,CHI,HOU,,,39,34,30,14
22023,1630578,22300509,"JAN 08, 2024",HOU @ MIA,L,33,9,15,0.6,1,2,0.5,3,4,0.75,3,7,10,2,3,0,3,6,22,-10,1,Alperen Sengun,HOU,MIA,HOU,,,34,32,24,12
22023,1630578,22300496,"JAN 06, 2024",HOU vs. MIL,W,31,7,21,0.333,0,1,0.0,7,10,0.7,1,10,11,4,0,0,3,5,21,0,1,Alperen Sengun,HOU,HOU,MIL,,,36,32,25,15
22023,1630578,22300485,"JAN 05, 2024",HOU vs. MIN,L,33,8,17,0.471,0,1,0.0,3,3,1.0,1,4,5,1,0,0,2,3,19,-16,1,Alperen Sengun,HOU,HOU,MIN,,,25,24,20,6
22023,1630578,22300469,"JAN 03, 2024",HOU vs. BKN,W,34,11,17,0.647,0,2,0.0,8,10,0.8,4,4,8,4,3,1,2,1,30,17,1,Alperen Sengun,HOU,HOU,BKN,,,42,38,34,12
22023,1630578,22300453,"JAN 01, 2024",HOU vs. DET,W,27,9,13,0.692,0,2,0.0,8,9,0.889,1,3,4,9,3,0,2,3,26,20,1,Alperen Sengun,HOU,HOU,DET,,,39,30,35,13
22023,1630578,22300434,"DEC 29, 2023",HOU vs. PHI,L,34,12,16,0.75,1,2,0.5,3,4,0.75,3,4,7,8,1,1,5,6,28,12,1,Alperen Sengun,HOU,HOU,PHI,,,43,35,36,15
22023,1630578,22300418,"DEC 27, 2023",HOU vs. PHX,L,29,9,18,0.5,1,4,0.25,5,6,0.833,1,4,5,1,2,0,0,3,24,-11,1,Alperen Sengun,HOU,HOU,PHX,,,30,29,25,6
22023,1630578,22300409,"DEC 26, 2023",HOU vs. IND,L,37,11,20,0.55,0,0,0.0,8,9,0.889,7,9,16,5,4,0,4,2,30,-8,1,Alperen Sengun,HOU,HOU,IND,,,51,46,35,21
22023,1630578,22300392,"DEC 23, 2023",HOU @ NOP,W,38,11,21,0.524,1,1,1.0,14,17,0.824,4,7,11,6,1,1,2,4,37,-2,1,Alperen Sengun,HOU,NOP,HOU,,,54,48,43,17
22023,1630578,22300385,"DEC 22, 2023",HOU vs. DAL,W,25,8,12,0.667,1,1,1.0,5,5,1.0,2,13,15,3,0,0,0,2,22,30,1,Alperen Sengun,HOU,HOU,DAL,,,40,37,25,18
22023,1630578,22300371,"DEC 20, 2023",HOU vs. ATL,L,27,7,12,0.583,0,0,0.0,0,0,0.0,2,7,9,5,0,1,0,2,14,-10,1,Alperen Sengun,HOU,HOU,ATL,,,28,23,19,14
22023,1630578,22300349,"DEC 18, 2023",HOU @ CLE,L,31,11,20,0.55,1,3,0.333,1,2,0.5,4,4,8,6,1,0,4,5,24,-3,1,Alperen Sengun,HOU,CLE,HOU,,,38,32,30,14
22023,1630578,22300346,"DEC 17, 2023",HOU @ MIL,L,31,8,15,0.533,0,3,0.0,4,6,0.667,2,6,8,5,1,1,0,4,20,-7,1,Alperen Sengun,HOU,MIL,HOU,,,33,28,25,13
22023,1630578,22300332,"DEC 15, 2023",HOU @ MEM,W,32,4,12,0.333,0,0,0.0,7,7,1.0,4,3,7,1,2,3,4,3,15,1,1,Alperen Sengun,HOU,MEM,HOU,,,23,22,16,8
22023,1630578,22300314,"DEC 13, 2023",HOU vs. MEM,W,24,2,8,0.25,0,1,0.0,5,6,0.833,1,9,10,2,0,0,2,4,9,-10,1,Alperen Sengun,HOU,HOU,MEM,,,21,19,11,12
22023,1630578,22300298,"DEC 11, 2023",HOU vs. SAS,W,30,6,12,0.5,1,1,1.0,2,4,0.5,2,7,9,4,2,1,6,3,15,10,1,Alperen Sengun,HOU,HOU,SAS,,,28,24,19,13
22023,1630578,22301224,"DEC 08, 2023",HOU @ DEN,W,34,7,14,0.5,0,1,0.0,3,5,0.6,2,8,10,7,0,1,1,3,17,11,1,Alperen Sengun,HOU,DEN,HOU,,,34,27,24,17
22023,1630578,22301212,"DEC 06, 2023",HOU vs. OKC,W,35,8,13,0.615,0,2,0.0,5,11,0.455,1,5,6,7,1,2,4,4,21,12,1,Alperen Sengun,HOU,HOU,OKC,,,34,27,28,13
22023,1630578,22300291,"DEC 02, 2023",HOU @ LAL,L,34,8,25,0.32,3,8,0.375,2,2,1.0,3,10,13,5,2,2,0,2,21,-6,1,Alperen Sengun,HOU,LAL,HOU,,,39,34,26,18
22023,1630578,22300263,"NOV 29, 2023",HOU @ DEN,L,28,10,18,0.556,2,6,0.333,0,0,0.0,2,5,7,4,1,0,1,3,22,-19,1,Alperen Sengun,HOU,DEN,HOU,,,33,29,26,11
22023,1630578,22300059,"NOV 28, 2023",HOU @ DAL,L,35,10,19,0.526,0,2,0.0,11,14,0.786,4,5,9,6,0,1,3,2,31,-8,1,Alperen Sengun,HOU,DAL,HOU,,,46,40,37,15
22023,1630578,22300048,"NOV 24, 2023",HOU vs. DEN,W,43,8,19,0.421,0,4,0.0,5,6,0.833,1,14,15,8,2,1,5,4,21,12,1,Alperen Sengun,HOU,HOU,DEN,,,44,36,29,23
22023,1630578,22300231,"NOV 22, 2023",HOU vs. MEM,W,32,4,9,0.444,1,1,1.0,2,3,0.667,1,6,7,3,0,3,2,5,11,21,1,Alperen Sengun,HOU,HOU,MEM,,,21,18,14,10
22023,1630578,22300224,"NOV 20, 2023",HOU @ GSW,L,37,13,23,0.565,2,3,0.667,2,5,0.4,7,6,13,5,1,1,3,4,30,6,1,Alperen Sengun,HOU,GSW,HOU,,,48,43,35,18
22023,1630578,22300216,"NOV 19, 2023",HOU @ LAL,L,31,11,16,0.688,1,2,0.5,0,0,0.0,2,8,10,5,0,1,4,4,23,21,1,Alperen Sengun,HOU,LAL,HOU,,,38,33,28,15
22023,1630578,22300037,"NOV 17, 2023",HOU @ LAC,L,34,8,18,0.444,2,5,0.4,5,7,0.714,2,6,8,4,1,0,6,4,23,-17,1,Alperen Sengun,HOU,LAC,HOU,,,35,31,27,12
22023,1630578,22300182,"NOV 12, 2023",HOU vs. DEN,W,35,9,18,0.5,0,2,0.0,5,6,0.833,4,4,8,5,1,2,3,2,23,-8,1,Alperen Sengun,HOU,HOU,DEN,,,36,31,28,13
22023,1630578,22300011,"NOV 10, 2023",HOU vs. NOP,W,34,11,15,0.733,0,2,0.0,2,5,0.4,4,4,8,3,2,1,4,3,24,-2,1,Alperen Sengun,HOU,HOU,NOP,,,35,32,27,11
22023,1630578,22300163,"NOV 08, 2023",HOU vs. LAL,W,25,8,10,0.8,0,0,0.0,3,4,0.75,0,7,7,4,0,0,1,1,19,18,1,Alperen Sengun,HOU,HOU,LAL,,,30,26,23,11
22023,1630578,22300153,"NOV 06, 2023",HOU vs. SAC,W,26,7,13,0.538,0,2,0.0,3,4,0.75,2,6,8,12,1,0,1,3,17,30,1,Alperen Sengun,HOU,HOU,SAC,,,37,25,29,20
22023,1630578,22300137,"NOV 04, 2023",HOU vs. SAC,W,34,7,13,0.538,1,3,0.333,0,0,0.0,0,9,9,6,2,0,2,2,15,27,1,Alperen Sengun,HOU,HOU,SAC,,,30,24,21,15
22023,1630578,22300122,"NOV 01, 2023",HOU vs. CHA,W,27,9,12,0.75,1,1,1.0,0,1,0.0,1,6,7,4,1,0,1,1,19,9,1,Alperen Sengun,HOU,HOU,CHA,,,30,26,23,11
22023,1630578,22300096,"OCT 29, 2023",HOU vs. GSW,L,33,7,15,0.467,1,2,0.5,4,4,1.0,4,1,5,7,0,0,0,3,19,-10,1,Alperen Sengun,HOU,HOU,GSW,,,31,24,26,12
22023,1630578,22300083,"OCT 27, 2023",HOU @ SAS,L,41,11,18,0.611,1,3,0.333,2,6,0.333,6,8,14,7,2,1,6,6,25,-4,1,Alperen Sengun,HOU,SAS,HOU,,,46,39,32,21
22023,1630578,22300066,"OCT 25, 2023",HOU @ ORL,L,28,6,11,0.545,0,1,0.0,2,4,0.5,2,6,8,6,0,0,1,4,14,-4,1,Alperen Sengun,HOU,ORL,HOU,,,28,22,20,14
22023,1641729,22300540,"JAN 12, 2024",UTA vs. TOR,W,4,2,4,0.5,1,2,0.5,0,0,0.0,0,0,0,2,0,0,0,1,5,5,1,Brice Sensabaugh,UTA,UTA,TOR,,,7,5,7,2
22023,1641729,22300524,"JAN 10, 2024",UTA vs. DEN,W,3,0,0,0.0,0,0,0.0,0,0,0.0,0,0,0,0,0,0,0,0,0,-5,1,Brice Sensabaugh,UTA,UTA,DEN,,,0,0,0,0
22023,1641729,22300412,"DEC 26, 2023",UTA @ SAS,W,2,0,0,0.0,0,0,0.0,0,0,0.0,0,1,1,0,0,0,0,0,0,-7,1,Brice Sensabaugh,UTA,SAS,UTA,,,1,1,0,1
22023,1641729,22300072,"OCT 25, 2023",UTA vs. SAC,L,2,0,2,0.0,0,0,0.0,0,0,0.0,1,1,2,0,0,0,0,0,0,2,1,Brice Sensabaugh,UTA,UTA,SAC,,,2,2,0,2
22023,1629012,22300564,"JAN 15, 2024",UTA vs. IND,W,24,11,17,0.647,4,5,0.8,4,4,1.0,1,2,3,5,0,0,1,2,30,14,1,Collin Sexton,UTA,UTA,IND,,,38,33,35,8
22023,1629012,22300549,"JAN 13, 2024",UTA vs. LAL,W,28,8,13,0.615,1,4,0.25,10,10,1.0,1,3,4,5,0,0,1,5,27,18,1,Collin Sexton,UTA,UTA,LAL,,,36,31,32,9
22023,1629012,22300540,"JAN 12, 2024",UTA vs. TOR,W,20,5,10,0.5,3,3,1.0,7,8,0.875,0,2,2,5,2,0,2,0,20,15,1,Collin Sexton,UTA,UTA,TOR,,,27,22,25,7
22023,1629012,22300524,"JAN 10, 2024",UTA vs. DEN,W,21,8,14,0.571,2,4,0.5,4,4,1.0,1,1,2,4,1,1,1,3,22,11,1,Collin Sexton,UTA,UTA,DEN,,,28,24,26,6
22023,1629012,22300510,"JAN 08, 2024",UTA @ MIL,W,18,8,13,0.615,3,6,0.5,0,0,0.0,0,0,0,3,1,0,0,0,19,1,1,Collin Sexton,UTA,MIL,UTA,,,22,19,22,3
22023,1629012,22300495,"JAN 06, 2024",UTA @ PHI,W,27,9,14,0.643,1,3,0.333,3,4,0.75,1,2,3,10,0,0,5,3,22,7,1,Collin Sexton,UTA,PHI,UTA,,,35,25,32,13
22023,1629012,22300479,"JAN 05, 2024",UTA @ BOS,L,20,5,12,0.417,0,3,0.0,3,3,1.0,0,1,1,3,3,0,3,1,13,-13,1,Collin Sexton,UTA,BOS,UTA,,,17,14,16,4
22023,1629012,22300474,"JAN 03, 2024",UTA vs. DET,W,30,7,14,0.5,1,2,0.5,10,10,1.0,1,1,2,5,1,0,0,5,25,2,1,Collin Sexton,UTA,UTA,DET,,,32,27,30,7
22023,1629012,22300457,"JAN 01, 2024",UTA vs. DAL,W,19,2,8,0.25,0,3,0.0,4,4,1.0,1,2,3,6,0,0,1,1,8,1,1,Collin Sexton,UTA,UTA,DAL,,,17,11,14,9
22023,1629012,22300439,"DEC 30, 2023",UTA vs. MIA,W,26,8,14,0.571,1,4,0.25,5,6,0.833,1,1,2,5,1,0,3,1,22,-2,1,Collin Sexton,UTA,UTA,MIA,,,29,24,27,7
22023,1629012,22300424,"DEC 28, 2023",UTA @ NOP,L,30,8,17,0.471,3,6,0.5,7,9,0.778,1,4,5,3,0,0,0,4,26,3,1,Collin Sexton,UTA,NOP,UTA,,,34,31,29,8
22023,1629012,22300412,"DEC 26, 2023",UTA @ SAS,W,29,8,10,0.8,0,2,0.0,4,5,0.8,0,3,3,6,1,1,1,4,20,-7,1,Collin Sexton,UTA,SAS,UTA,,,29,23,26,9
22023,1629012,22300395,"DEC 23, 2023",UTA @ TOR,W,25,5,11,0.455,1,2,0.5,5,6,0.833,0,0,0,3,1,0,1,0,16,-11,1,Collin Sexton,UTA,TOR,UTA,,,19,16,19,3
22023,1629012,22300374,"DEC 21, 2023",UTA @ DET,W,32,6,18,0.333,1,3,0.333,6,6,1.0,3,1,4,8,4,0,3,3,19,-10,1,Collin Sexton,UTA,DET,UTA,,,31,23,27,12
22023,1629012,22300364,"DEC 20, 2023",UTA @ CLE,L,34,7,17,0.412,3,6,0.5,3,4,0.75,0,3,3,2,0,1,2,5,20,6,1,Collin Sexton,UTA,CLE,UTA,,,25,23,22,5
22023,1629012,22300357,"DEC 18, 2023",UTA vs. BKN,W,35,6,17,0.353,3,7,0.429,12,13,0.923,1,2,3,6,0,0,2,3,27,18,1,Collin Sexton,UTA,UTA,BKN,,,36,30,33,9
22023,1629012,22300342,"DEC 16, 2023",UTA @ SAC,L,33,10,18,0.556,2,6,0.333,6,7,0.857,1,2,3,1,1,0,1,2,28,-27,1,Collin Sexton,UTA,SAC,UTA,,,32,31,29,4
22023,1629012,22300323,"DEC 14, 2023",UTA @ POR,W,32,11,17,0.647,2,5,0.4,3,3,1.0,1,1,2,4,1,0,2,2,27,17,1,Collin Sexton,UTA,POR,UTA,,,33,29,31,6
22023,1629012,22300318,"DEC 13, 2023",UTA vs. NYK,W,30,10,18,0.556,3,8,0.375,3,3,1.0,1,3,4,7,0,0,2,4,26,-9,1,Collin Sexton,UTA,UTA,NYK,,,37,30,33,11
22023,1629012,22300302,"DEC 11, 2023",UTA @ OKC,L,26,7,13,0.538,1,4,0.25,5,6,0.833,2,2,4,2,2,0,0,1,20,-1,1,Collin Sexton,UTA,OKC,UTA,,,26,24,22,6
22023,1629012,22301225,"DEC 08, 2023",UTA vs. LAC,L,18,5,12,0.417,1,4,0.25,2,2,1.0,0,3,3,3,1,0,1,2,13,-1,1,Collin Sexton,UTA,UTA,LAC,,,19,16,16,6
22023,1629012,22301213,"DEC 06, 2023",UTA @ DAL,L,18,0,4,0.0,0,1,0.0,7,8,0.875,0,3,3,5,1,0,2,1,7,-3,1,Collin Sexton,UTA,DAL,UTA,,,15,10,12,8
22023,1629012,22300289,"DEC 02, 2023",UTA vs. POR,W,30,9,13,0.692,0,2,0.0,7,7,1.0,1,3,4,5,0,0,3,2,25,4,1,Collin Sexton,UTA,UTA,POR,,,34,29,30,9
22023,1629012,22300270,"NOV 30, 2023",UTA @ MIN,L,23,4,8,0.5,1,2,0.5,5,5,1.0,0,3,3,4,0,0,3,1,14,-3,1,Collin Sexton,UTA,MIN,UTA,,,21,17,18,7
22023,1629012,22300261,"NOV 29, 2023",UTA @ MEM,L,22,3,10,0.3,1,4,0.25,2,3,0.667,1,0,1,3,1,0,2,3,9,-3,1,Collin Sexton,UTA,MEM,UTA,,,13,10,12,4
22023,1629012,22300256,"NOV 27, 2023",UTA vs. NOP,W,18,4,9,0.444,3,6,0.5,0,0,0.0,1,1,2,0,2,0,4,2,11,6,1,Collin Sexton,UTA,UTA,NOP,,,13,13,11,2
22023,1629012,22300243,"NOV 25, 2023",UTA vs. NOP,W,28,5,13,0.385,3,8,0.375,3,4,0.75,2,1,3,6,0,0,2,0,16,3,1,Collin Sexton,UTA,UTA,NOP,,,25,19,22,9
22023,1629012,22300237,"NOV 22, 2023",UTA @ POR,L,11,0,5,0.0,0,3,0.0,1,2,0.5,1,1,2,2,1,0,2,2,1,-16,1,Collin Sexton,UTA,POR,UTA,,,5,3,3,4
22023,1629012,22300042,"NOV 21, 2023",UTA @ LAL,L,22,6,11,0.545,2,3,0.667,0,0,0.0,0,3,3,4,0,0,1,2,14,-9,1,Collin Sexton,UTA,LAL,UTA,,,21,17,18,7
22023,1629012,22300214,"NOV 19, 2023",UTA vs. PHX,L,23,6,13,0.462,3,6,0.5,3,3,1.0,3,2,5,2,1,0,2,0,18,12,1,Collin Sexton,UTA,UTA,PHX,,,25,23,20,7
22023,1629012,22300035,"NOV 17, 2023",UTA vs. PHX,L,20,3,8,0.375,0,2,0.0,2,2,1.0,2,2,4,4,0,2,0,3,8,-6,1,Collin Sexton,UTA,UTA,PHX,,,16,12,12,8
22023,1629012,22300023,"NOV 14, 2023",UTA vs. POR,W,28,5,11,0.455,1,5,0.2,2,2,1.0,0,4,4,7,2,1,2,3,13,14,1,Collin Sexton,UTA,UTA,POR,,,24,17,20,11
22023,1629012,22300012,"NOV 10, 2023",UTA @ MEM,W,18,3,8,0.375,0,2,0.0,4,4,1.0,1,1,2,6,1,0,3,0,10,3,1,Collin Sexton,UTA,MEM,UTA,,,18,12,16,8
22023,1629012,22300158,"NOV 08, 2023",UTA @ IND,L,16,3,9,0.333,1,2,0.5,3,3,1.0,0,2,2,2,0,0,0,0,10,-7,1,Collin Sexton,UTA,IND,UTA,,,14,12,12,4
22023,1629012,22300152,"NOV 06, 2023",UTA @ CHI,L,17,6,10,0.6,1,3,0.333,1,1,1.0,1,2,3,2,0,0,1,3,14,1,1,Collin Sexton,UTA,CHI,UTA,,,19,17,16,5
22023,1629012,22300138,"NOV 04, 2023",UTA @ MIN,L,19,1,3,0.333,1,3,0.333,4,4,1.0,2,2,4,4,0,1,6,2,7,-14,1,Collin Sexton,UTA,MIN,UTA,,,15,11,11,8
22023,1629012,22300130,"NOV 02, 2023",UTA vs. ORL,L,17,3,8,0.375,0,2,0.0,4,6,0.667,1,0,1,1,0,0,2,1,10,-5,1,Collin Sexton,UTA,UTA,ORL,,,12,11,11,2
22023,1629012,22300125,"NOV 01, 2023",UTA vs. MEM,W,22,8,10,0.8,4,6,0.667,3,3,1.0,1,2,3,6,0,0,2,1,23,22,1,Collin Sexton,UTA,UTA,MEM,,,32,26,29,9
22023,1629012,22300110,"OCT 30, 2023",UTA @ DEN,L,17,5,10,0.5,2,5,0.4,0,0,0.0,0,0,0,0,0,0,1,2,12,-10,1,Collin Sexton,UTA,DEN,UTA,,,12,12,12,0
22023,1629012,22300094,"OCT 28, 2023",UTA @ PHX,L,23,4,8,0.5,0,0,0.0,6,6,1.0,1,1,2,6,0,0,2,1,14,-7,1,Collin Sexton,UTA,PHX,UTA,,,22,16,20,8
22023,1629012,22300085,"OCT 27, 2023",UTA vs. LAC,W,20,5,12,0.417,0,2,0.0,3,4,0.75,0,1,1,0,0,0,0,3,13,-4,1,Collin Sexton,UTA,UTA,LAC,,,14,14,13,1
22023,1629012,22300072,"OCT 25, 2023",UTA vs. SAC,L,20,2,9,0.222,0,2,0.0,5,7,0.714,0,3,3,0,0,0,3,3,9,-10,1,Collin Sexton,UTA,UTA,SAC,,,12,12,9,3
22023,1629013,22300558,"JAN 15, 2024",WAS vs. DET,L,14,4,7,0.571,2,3,0.667,1,1,1.0,0,0,0,0,1,1,0,1,11,6,1,Landry Shamet,WAS,WAS,DET,,,11,11,11,0
22023,1629013,22300508,"JAN 08, 2024",WAS vs. OKC,L,16,3,7,0.429,1,4,0.25,8,9,0.889,1,1,2,1,2,2,3,4,15,-6,1,Landry Shamet,WAS,WAS,OKC,,,18,17,16,3
22023,1629013,22300465,"JAN 03, 2024",WAS @ CLE,L,15,3,6,0.5,2,3,0.667,1,2,0.5,0,3,3,2,1,0,0,0,9,-15,1,Landry Shamet,WAS,CLE,WAS,,,14,12,11,5
22023,1629013,22300445,"DEC 31, 2023",WAS vs. ATL,L,19,2,6,0.333,0,2,0.0,0,0,0.0,0,2,2,2,1,2,0,1,4,-11,1,Landry Shamet,WAS,WAS,ATL,,,8,6,6,4
22023,1629013,22300430,"DEC 29, 2023",WAS vs. BKN,W,18,3,7,0.429,1,4,0.25,1,1,1.0,0,1,1,2,1,0,0,0,8,8,1,Landry Shamet,WAS,WAS,BKN,,,11,9,10,3
22023,1629013,22300416,"DEC 27, 2023",WAS vs. TOR,L,11,3,5,0.6,1,1,1.0,0,0,0.0,0,0,0,1,0,0,3,0,7,-6,1,Landry Shamet,WAS,WAS,TOR,,,8,7,8,1
22023,1629013,22300407,"DEC 26, 2023",WAS vs. ORL,L,8,0,3,0.0,0,3,0.0,0,0,0.0,0,0,0,0,0,0,0,0,0,-12,1,Landry Shamet,WAS,WAS,ORL,,,0,0,0,0
22023,1629013,22300386,"DEC 22, 2023",WAS @ GSW,L,13,0,2,0.0,0,1,0.0,0,0,0.0,0,0,0,1,0,0,0,2,0,-16,1,Landry Shamet,WAS,GSW,WAS,,,1,0,1,1
22023,1629013,22300274,"DEC 01, 2023",WAS @ ORL,L,18,5,8,0.625,3,3,1.0,0,3,0.0,0,0,0,2,0,0,2,4,13,3,1,Landry Shamet,WAS,ORL,WAS,,,15,13,15,2
22023,1629013,22300259,"NOV 29, 2023",WAS @ ORL,L,18,2,6,0.333,1,3,0.333,0,0,0.0,0,1,1,1,1,0,1,4,5,-8,1,Landry Shamet,WAS,ORL,WAS,,,7,6,6,2
22023,1629013,22300253,"NOV 27, 2023",WAS @ DET,W,22,4,7,0.571,2,3,0.667,2,2,1.0,0,2,2,4,2,1,1,2,12,8,1,Landry Shamet,WAS,DET,WAS,,,18,14,16,6
22023,1629013,22300241,"NOV 25, 2023",WAS vs. ATL,L,17,5,9,0.556,2,5,0.4,0,0,0.0,0,1,1,2,0,0,1,1,12,-18,1,Landry Shamet,WAS,WAS,ATL,,,15,13,14,3
22023,1629013,22300049,"NOV 24, 2023",WAS @ MIL,L,24,6,11,0.545,3,7,0.429,0,1,0.0,0,2,2,0,1,0,0,2,15,0,1,Landry Shamet,WAS,MIL,WAS,,,17,17,15,2
22023,1629013,22300225,"NOV 22, 2023",WAS @ CHA,L,18,2,6,0.333,1,3,0.333,2,3,0.667,1,1,2,1,0,0,0,3,7,1,1,Landry Shamet,WAS,CHA,WAS,,,10,9,8,3
22023,1629013,22300219,"NOV 20, 2023",WAS vs. MIL,L,14,3,4,0.75,2,3,0.667,0,0,0.0,0,3,3,2,0,0,1,2,8,-3,1,Landry Shamet,WAS,WAS,MIL,,,13,11,10,5
22023,1629013,22300028,"NOV 17, 2023",WAS vs. NYK,L,7,2,3,0.667,1,2,0.5,0,0,0.0,0,0,0,2,0,0,0,0,5,-5,1,Landry Shamet,WAS,WAS,NYK,,,7,5,7,2
22023,1629013,22300192,"NOV 15, 2023",WAS vs. DAL,L,21,2,12,0.167,0,7,0.0,0,0,0.0,0,2,2,1,0,0,0,2,4,-12,1,Landry Shamet,WAS,WAS,DAL,,,7,6,5,3
22023,1629013,22300189,"NOV 13, 2023",WAS @ TOR,L,15,1,2,0.5,0,1,0.0,0,0,0.0,0,0,0,0,3,0,1,1,2,3,1,Landry Shamet,WAS,TOR,WAS,,,2,2,2,0
22023,1629013,22300178,"NOV 12, 2023",WAS @ BKN,L,20,3,7,0.429,2,4,0.5,0,0,0.0,1,4,5,1,0,0,1,1,8,12,1,Landry Shamet,WAS,BKN,WAS,,,14,13,9,6
22023,1629013,22300009,"NOV 10, 2023",WAS vs. CHA,L,17,4,10,0.4,2,7,0.286,1,1,1.0,0,0,0,0,0,0,1,3,11,-3,1,Landry Shamet,WAS,WAS,CHA,,,11,11,11,0
22023,1629013,22300157,"NOV 08, 2023",WAS @ CHA,W,17,6,9,0.667,3,6,0.5,0,1,0.0,0,1,1,2,1,1,0,3,15,24,1,Landry Shamet,WAS,CHA,WAS,,,18,16,17,3
22023,1629013,22300003,"NOV 03, 2023",WAS @ MIA,L,14,0,2,0.0,0,2,0.0,0,0,0.0,0,1,1,2,0,0,0,0,0,-13,1,Landry Shamet,WAS,MIA,WAS,,,3,1,2,3
22023,1629013,22300117,"NOV 01, 2023",WAS @ ATL,L,12,3,5,0.6,2,4,0.5,0,0,0.0,0,1,1,2,1,0,0,3,8,-4,1,Landry Shamet,WAS,ATL,WAS,,,11,9,10,3
22023,1630549,22300498,"JAN 07, 2024",BKN vs. POR,L,17,4,7,0.571,0,0,0.0,3,4,0.75,3,3,6,2,0,1,0,3,11,-5,1,Day'Ron Sharpe,BKN,BKN,POR,,,19,17,13,8
22023,1630549,22300481,"JAN 05, 2024",BKN vs. OKC,W,9,1,3,0.333,0,0,0.0,4,4,1.0,1,1,2,2,1,0,0,1,6,-1,1,Day'Ron Sharpe,BKN,BKN,OKC,,,10,8,8,4
22023,1630549,22300469,"JAN 03, 2024",BKN @ HOU,L,20,4,7,0.571,0,0,0.0,3,6,0.5,4,8,12,1,1,1,1,5,11,-5,1,Day'Ron Sharpe,BKN,HOU,BKN,,,24,23,12,13
22023,1630549,22300461,"JAN 02, 2024",BKN @ NOP,L,17,6,9,0.667,0,0,0.0,0,0,0.0,3,6,9,2,0,1,1,0,12,-8,1,Day'Ron Sharpe,BKN,NOP,BKN,,,23,21,14,11
22023,1630549,22300447,"DEC 31, 2023",BKN @ OKC,L,8,1,1,1.0,0,0,0.0,1,2,0.5,1,1,2,0,1,1,0,1,3,6,1,Day'Ron Sharpe,BKN,OKC,BKN,,,5,5,3,2
22023,1630549,22300430,"DEC 29, 2023",BKN @ WAS,L,18,5,7,0.714,0,0,0.0,0,0,0.0,5,4,9,3,0,0,2,3,10,-10,1,Day'Ron Sharpe,BKN,WAS,BKN,,,22,19,13,12
22023,1630549,22300417,"DEC 27, 2023",BKN vs. MIL,L,16,5,6,0.833,1,1,1.0,1,2,0.5,2,2,4,4,0,1,0,3,12,2,1,Day'Ron Sharpe,BKN,BKN,MIL,,,20,16,16,8
22023,1630549,22300406,"DEC 26, 2023",BKN @ DET,W,22,3,4,0.75,0,0,0.0,5,7,0.714,3,8,11,3,2,4,1,1,11,15,1,Day'Ron Sharpe,BKN,DET,BKN,,,25,22,14,14
22023,1630549,22300394,"DEC 23, 2023",BKN vs. DET,W,18,5,6,0.833,0,0,0.0,1,3,0.333,1,2,3,1,0,0,1,4,11,6,1,Day'Ron Sharpe,BKN,BKN,DET,,,15,14,12,4
22023,1630549,22300383,"DEC 22, 2023",BKN vs. DEN,L,19,5,8,0.625,0,0,0.0,3,6,0.5,5,5,10,4,2,2,0,2,13,2,1,Day'Ron Sharpe,BKN,BKN,DEN,,,27,23,17,14
22023,1630549,22300368,"DEC 20, 2023",BKN vs. NYK,L,19,3,7,0.429,0,0,0.0,3,4,0.75,9,6,15,3,1,0,1,4,9,6,1,Day'Ron Sharpe,BKN,BKN,NYK,,,27,24,12,18
22023,1630549,22300357,"DEC 18, 2023",BKN @ UTA,L,16,3,5,0.6,0,0,0.0,0,1,0.0,3,2,5,0,0,1,1,1,6,6,1,Day'Ron Sharpe,BKN,UTA,BKN,,,11,11,6,5
22023,1630549,22300339,"DEC 16, 2023",BKN @ GSW,L,9,0,3,0.0,0,0,0.0,0,0,0.0,3,1,4,2,0,2,0,3,0,-2,1,Day'Ron Sharpe,BKN,GSW,BKN,,,6,4,2,6
22023,1630549,22300322,"DEC 14, 2023",BKN @ DEN,L,26,4,9,0.444,0,1,0.0,0,0,0.0,4,9,13,5,0,1,3,4,8,-8,1,Day'Ron Sharpe,BKN,DEN,BKN,,,26,21,13,18
22023,1630549,22300317,"DEC 13, 2023",BKN @ PHX,W,8,1,3,0.333,0,1,0.0,1,2,0.5,3,0,3,0,0,0,0,0,3,-6,1,Day'Ron Sharpe,BKN,PHX,BKN,,,6,6,3,3
22023,1630549,22300303,"DEC 11, 2023",BKN @ SAC,L,14,2,4,0.5,0,0,0.0,0,0,0.0,1,6,7,2,1,1,1,2,4,7,1,Day'Ron Sharpe,BKN,SAC,BKN,,,13,11,6,9
22023,1630549,22301219,"DEC 08, 2023",BKN vs. WAS,W,20,7,13,0.538,0,0,0.0,1,1,1.0,5,6,11,4,1,1,2,3,15,11,1,Day'Ron Sharpe,BKN,BKN,WAS,,,30,26,19,15
22023,1630549,22301209,"DEC 06, 2023",BKN @ ATL,W,19,3,5,0.6,0,0,0.0,2,5,0.4,4,6,10,0,0,2,3,4,8,5,1,Day'Ron Sharpe,BKN,ATL,BKN,,,18,18,8,10
22023,1630549,22300282,"DEC 02, 2023",BKN vs. ORL,W,24,2,2,1.0,0,0,0.0,1,3,0.333,1,5,6,2,0,1,1,3,5,21,1,Day'Ron Sharpe,BKN,BKN,ORL,,,13,11,7,8
22023,1630549,22300266,"NOV 30, 2023",BKN vs. CHA,L,18,4,5,0.8,0,0,0.0,1,3,0.333,2,3,5,0,1,0,0,3,9,4,1,Day'Ron Sharpe,BKN,BKN,CHA,,,14,14,9,5
22023,1630549,22300054,"NOV 28, 2023",BKN vs. TOR,W,15,2,4,0.5,0,0,0.0,1,1,1.0,1,4,5,2,0,0,0,2,5,-13,1,Day'Ron Sharpe,BKN,BKN,TOR,,,12,10,7,7
22023,1630549,22300250,"NOV 26, 2023",BKN vs. CHI,W,27,4,7,0.571,0,2,0.0,1,2,0.5,3,6,9,3,0,1,1,4,9,31,1,Day'Ron Sharpe,BKN,BKN,CHI,,,21,18,12,12
22023,1630549,22300240,"NOV 25, 2023",BKN vs. MIA,W,12,0,1,0.0,0,0,0.0,4,4,1.0,0,4,4,1,0,2,0,2,4,4,1,Day'Ron Sharpe,BKN,BKN,MIA,,,9,8,5,5
22023,1630549,22300227,"NOV 22, 2023",BKN @ ATL,L,14,3,6,0.5,0,0,0.0,0,0,0.0,4,3,7,0,2,1,1,2,6,4,1,Day'Ron Sharpe,BKN,ATL,BKN,,,13,13,6,7
22023,1630549,22300208,"NOV 19, 2023",BKN vs. PHI,L,20,3,3,1.0,0,0,0.0,0,0,0.0,2,6,8,2,0,2,1,1,6,-8,1,Day'Ron Sharpe,BKN,BKN,PHI,,,16,14,8,10
22023,1630549,22300200,"NOV 16, 2023",BKN @ MIA,L,15,1,6,0.167,0,0,0.0,0,0,0.0,2,3,5,0,0,0,1,0,2,-6,1,Day'Ron Sharpe,BKN,MIA,BKN,,,7,7,2,5
22023,1630549,22300020,"NOV 14, 2023",BKN vs. ORL,W,24,4,7,0.571,0,0,0.0,3,5,0.6,5,5,10,0,0,1,2,6,11,-2,1,Day'Ron Sharpe,BKN,BKN,ORL,,,21,21,11,10
22023,1630549,22300178,"NOV 12, 2023",BKN vs. WAS,W,19,3,6,0.5,0,1,0.0,2,2,1.0,7,5,12,1,1,1,1,1,8,-4,1,Day'Ron Sharpe,BKN,BKN,WAS,,,21,20,9,13
22023,1630549,22300010,"NOV 10, 2023",BKN @ BOS,L,13,1,4,0.25,0,1,0.0,3,4,0.75,0,3,3,1,0,0,2,2,5,5,1,Day'Ron Sharpe,BKN,BOS,BKN,,,9,8,6,4
22023,1630549,22300160,"NOV 08, 2023",BKN vs. LAC,W,19,4,9,0.444,0,0,0.0,3,3,1.0,4,6,10,0,1,0,2,3,11,7,1,Day'Ron Sharpe,BKN,BKN,LAC,,,21,21,11,10
22023,1630549,22300149,"NOV 06, 2023",BKN vs. MIL,L,8,2,3,0.667,0,0,0.0,0,0,0.0,0,0,0,0,0,1,0,0,4,-7,1,Day'Ron Sharpe,BKN,BKN,MIL,,,4,4,4,0
22023,1630549,22300136,"NOV 04, 2023",BKN vs. BOS,L,17,3,4,0.75,0,0,0.0,5,8,0.625,3,4,7,1,0,0,2,3,11,6,1,Day'Ron Sharpe,BKN,BKN,BOS,,,19,18,12,8
22023,1630549,22300004,"NOV 03, 2023",BKN @ CHI,W,15,3,3,1.0,0,0,0.0,0,1,0.0,1,9,10,0,0,0,0,1,6,8,1,Day'Ron Sharpe,BKN,CHI,BKN,,,16,16,6,10
22023,1630549,22300119,"NOV 01, 2023",BKN @ MIA,W,13,2,3,0.667,0,0,0.0,1,2,0.5,1,6,7,1,1,0,0,0,5,15,1,Day'Ron Sharpe,BKN,MIA,BKN,,,13,12,6,8
22023,1630549,22300101,"OCT 30, 2023",BKN @ CHA,W,10,5,8,0.625,0,0,0.0,1,3,0.333,4,4,8,1,0,1,1,5,11,2,1,Day'Ron Sharpe,BKN,CHA,BKN,,,20,19,12,9
22023,1630549,22300084,"OCT 27, 2023",BKN @ DAL,L,3,1,2,0.5,0,0,0.0,0,0,0.0,2,2,4,0,1,0,2,1,2,5,1,Day'Ron Sharpe,BKN,DAL,BKN,,,6,6,2,4
22023,1630549,22300067,"OCT 25, 2023",BKN vs. CLE,L,12,2,3,0.667,0,0,0.0,0,0,0.0,1,1,2,0,0,2,3,2,4,2,1,Day'Ron Sharpe,BKN,BKN,CLE,,,6,6,4,2
22023,1631101,22300529,"JAN 11, 2024",POR @ OKC,L,21,3,14,0.214,1,6,0.167,0,0,0.0,3,3,6,1,0,0,1,3,7,-39,1,Shaedon Sharpe,POR,OKC,POR,,,14,13,8,7
22023,1631101,22300514,"JAN 09, 2024",POR @ NYK,L,22,4,8,0.5,0,2,0.0,1,1,1.0,1,3,4,4,2,1,1,1,9,-23,1,Shaedon Sharpe,POR,NYK,POR,,,17,13,13,8
22023,1631101,22300498,"JAN 07, 2024",POR @ BKN,W,40,7,14,0.5,3,6,0.5,4,7,0.571,0,1,1,1,2,1,0,2,21,14,1,Shaedon Sharpe,POR,BKN,POR,,,23,22,22,2
22023,1631101,22300487,"JAN 05, 2024",POR @ DAL,L,24,5,15,0.333,1,6,0.167,4,4,1.0,1,4,5,2,0,1,2,2,15,-11,1,Shaedon Sharpe,POR,DAL,POR,,,22,20,17,7
22023,1631101,22300472,"JAN 03, 2024",POR @ DAL,L,22,6,12,0.5,1,5,0.2,3,3,1.0,1,3,4,0,0,0,0,3,16,-12,1,Shaedon Sharpe,POR,DAL,POR,,,20,20,16,4
22023,1631101,22300456,"JAN 01, 2024",POR @ PHX,L,18,2,8,0.25,0,5,0.0,2,2,1.0,1,0,1,1,0,0,1,0,6,-14,1,Shaedon Sharpe,POR,PHX,POR,,,8,7,7,2
22023,1631101,22300363,"DEC 19, 2023",POR vs. PHX,W,8,0,1,0.0,0,0,0.0,0,0,0.0,0,1,1,0,0,0,0,2,0,1,1,Shaedon Sharpe,POR,POR,PHX,,,1,1,0,1
22023,1631101,22300348,"DEC 17, 2023",POR vs. GSW,L,27,4,10,0.4,3,5,0.6,1,1,1.0,1,4,5,1,1,0,2,3,12,0,1,Shaedon Sharpe,POR,POR,GSW,,,18,17,13,6
22023,1631101,22300341,"DEC 16, 2023",POR vs. DAL,L,32,2,7,0.286,1,3,0.333,2,3,0.667,0,2,2,2,0,0,2,4,7,0,1,Shaedon Sharpe,POR,POR,DAL,,,11,9,9,4
22023,1631101,22300323,"DEC 14, 2023",POR vs. UTA,L,27,1,12,0.083,0,5,0.0,2,2,1.0,2,5,7,2,0,1,0,3,4,-23,1,Shaedon Sharpe,POR,POR,UTA,,,13,11,6,9
22023,1631101,22300304,"DEC 11, 2023",POR @ LAC,L,41,8,17,0.471,4,9,0.444,7,9,0.778,1,2,3,6,1,0,2,2,27,-15,1,Shaedon Sharpe,POR,LAC,POR,,,36,30,33,9
22023,1631101,22301226,"DEC 08, 2023",POR vs. DAL,L,32,7,15,0.467,5,10,0.5,5,6,0.833,2,7,9,5,1,0,2,4,24,1,1,Shaedon Sharpe,POR,POR,DAL,,,38,33,29,14
22023,1631101,22301214,"DEC 06, 2023",POR @ GSW,L,42,10,18,0.556,4,9,0.444,2,4,0.5,0,6,6,5,0,0,1,1,26,-7,1,Shaedon Sharpe,POR,GSW,POR,,,37,32,31,11
22023,1631101,22300289,"DEC 02, 2023",POR @ UTA,L,44,9,20,0.45,3,8,0.375,4,4,1.0,2,3,5,4,2,0,0,5,25,-5,1,Shaedon Sharpe,POR,UTA,POR,,,34,30,29,9
22023,1631101,22300265,"NOV 30, 2023",POR @ CLE,W,39,11,15,0.733,4,7,0.571,3,3,1.0,0,10,10,5,1,0,5,3,29,10,1,Shaedon Sharpe,POR,CLE,POR,,,44,39,34,15
22023,1631101,22300254,"NOV 27, 2023",POR @ IND,W,35,4,15,0.267,1,3,0.333,2,2,1.0,1,4,5,6,3,0,2,5,11,3,1,Shaedon Sharpe,POR,IND,POR,,,22,16,17,11
22023,1631101,22300245,"NOV 26, 2023",POR @ MIL,L,37,7,19,0.368,1,5,0.2,2,3,0.667,1,5,6,3,2,0,3,0,17,-19,1,Shaedon Sharpe,POR,MIL,POR,,,26,23,20,9
22023,1631101,22300237,"NOV 22, 2023",POR vs. UTA,W,31,6,11,0.545,2,4,0.5,0,0,0.0,0,4,4,4,1,1,1,4,14,10,1,Shaedon Sharpe,POR,POR,UTA,,,22,18,18,8
22023,1631101,22300041,"NOV 21, 2023",POR @ PHX,L,32,3,13,0.231,0,5,0.0,4,4,1.0,1,2,3,0,1,0,4,3,10,-20,1,Shaedon Sharpe,POR,PHX,POR,,,13,13,10,3
22023,1631101,22300215,"NOV 19, 2023",POR vs. OKC,L,24,3,8,0.375,1,1,1.0,0,0,0.0,2,2,4,1,0,0,1,3,7,-20,1,Shaedon Sharpe,POR,POR,OKC,,,12,11,8,5
22023,1631101,22300036,"NOV 17, 2023",POR vs. LAL,L,38,7,17,0.412,1,5,0.2,2,2,1.0,2,7,9,2,1,1,10,4,17,-5,1,Shaedon Sharpe,POR,POR,LAL,,,28,26,19,11
22023,1631101,22300199,"NOV 15, 2023",POR vs. CLE,L,27,2,12,0.167,1,5,0.2,6,7,0.857,3,4,7,5,0,0,0,3,11,-27,1,Shaedon Sharpe,POR,POR,CLE,,,23,18,16,12
22023,1631101,22300023,"NOV 14, 2023",POR @ UTA,L,41,4,16,0.25,2,10,0.2,7,10,0.7,2,6,8,7,2,0,3,3,17,-10,1,Shaedon Sharpe,POR,UTA,POR,,,32,25,24,15
22023,1631101,22300187,"NOV 12, 2023",POR @ LAL,L,42,7,15,0.467,3,6,0.5,2,2,1.0,0,3,3,4,0,0,7,4,19,-10,1,Shaedon Sharpe,POR,LAL,POR,,,26,22,23,7
22023,1631101,22300170,"NOV 08, 2023",POR @ SAC,L,40,5,14,0.357,1,5,0.2,7,8,0.875,0,1,1,3,1,0,4,6,18,2,1,Shaedon Sharpe,POR,SAC,POR,,,22,19,21,4
22023,1631101,22300144,"NOV 05, 2023",POR vs. MEM,L,41,7,15,0.467,3,8,0.375,1,3,0.333,1,7,8,3,1,1,3,1,18,-16,1,Shaedon Sharpe,POR,POR,MEM,,,29,26,21,11
22023,1631101,22300007,"NOV 03, 2023",POR vs. MEM,W,46,7,17,0.412,2,5,0.4,6,7,0.857,1,4,5,2,1,1,3,2,22,-1,1,Shaedon Sharpe,POR,POR,MEM,,,29,27,24,7
22023,1631101,22300115,"NOV 01, 2023",POR @ DET,W,42,9,16,0.563,3,6,0.5,8,10,0.8,2,5,7,5,1,2,2,1,29,3,1,Shaedon Sharpe,POR,DET,POR,,,41,36,34,12
22023,1631101,22300105,"OCT 30, 2023",POR @ TOR,W,38,4,10,0.4,2,5,0.4,4,4,1.0,2,3,5,3,1,2,4,3,14,4,1,Shaedon Sharpe,POR,TOR,POR,,,22,19,17,8
22023,1631101,22300098,"OCT 29, 2023",POR @ PHI,L,36,7,13,0.538,2,4,0.5,4,5,0.8,1,4,5,2,0,0,3,3,20,-23,1,Shaedon Sharpe,POR,PHI,POR,,,27,25,22,7
22023,1631101,22300086,"OCT 27, 2023",POR vs. ORL,L,41,9,23,0.391,4,11,0.364,2,2,1.0,4,1,5,2,2,0,3,1,24,-4,1,Shaedon Sharpe,POR,POR,ORL,,,31,29,26,7
22023,1631101,22300074,"OCT 25, 2023",POR @ LAC,L,28,6,14,0.429,1,6,0.167,1,1,1.0,4,2,6,3,1,0,0,4,14,10,1,Shaedon Sharpe,POR,LAC,POR,,,23,20,17,9
22023,1641767,22300564,"JAN 15, 2024",IND @ UTA,L,25,1,7,0.143,0,5,0.0,2,2,1.0,2,1,3,2,0,0,0,4,4,-2,1,Ben Sheppard,IND,UTA,IND,,,9,7,6,5
22023,1641767,22300533,"JAN 12, 2024",IND @ ATL,W,4,0,0,0.0,0,0,0.0,0,0,0.0,0,0,0,0,0,0,0,0,0,-2,1,Ben Sheppard,IND,ATL,IND,,,0,0,0,0
22023,1641767,22300493,"JAN 06, 2024",IND vs. BOS,L,3,0,0,0.0,0,0,0.0,0,0,0.0,0,1,1,0,0,0,0,0,0,-3,1,Ben Sheppard,IND,IND,BOS,,,1,1,0,1
22023,1641767,22300480,"JAN 05, 2024",IND vs. ATL,W,9,1,3,0.333,1,3,0.333,0,0,0.0,0,1,1,1,1,0,0,0,3,0,1,Ben Sheppard,IND,IND,ATL,,,5,4,4,2
22023,1641767,22300466,"JAN 03, 2024",IND vs. MIL,W,2,0,1,0.0,0,1,0.0,0,0,0.0,0,0,0,0,0,0,0,0,0,-5,1,Ben Sheppard,IND,IND,MIL,,,0,0,0,0
22023,1641767,22300441,"DEC 30, 2023",IND vs. NYK,W,1,0,0,0.0,0,0,0.0,0,0,0.0,0,0,0,0,0,0,0,0,0,-3,1,Ben Sheppard,IND,IND,NYK,,,0,0,0,0
22023,1641767,22300338,"DEC 16, 2023",IND @ MIN,L,17,3,5,0.6,0,2,0.0,2,4,0.5,1,2,3,0,2,0,0,1,8,-6,1,Ben Sheppard,IND,MIN,IND,,,11,11,8,3
22023,1641767,22300328,"DEC 15, 2023",IND @ WAS,L,9,0,1,0.0,0,1,0.0,0,0,0.0,0,0,0,3,0,0,0,2,0,3,1,Ben Sheppard,IND,WAS,IND,,,3,0,3,3
22023,1641767,22300315,"DEC 13, 2023",IND @ MIL,L,6,3,6,0.5,2,3,0.667,0,0,0.0,0,0,0,0,1,0,0,2,8,4,1,Ben Sheppard,IND,MIL,IND,,,8,8,8,0
22023,1641767,22300284,"DEC 02, 2023",IND @ MIA,W,3,0,0,0.0,0,0,0.0,0,0,0.0,0,0,0,0,0,0,0,2,0,-7,1,Ben Sheppard,IND,MIA,IND,,,0,0,0,0
22023,1641767,22300267,"NOV 30, 2023",IND @ MIA,L,0,0,0,0.0,0,0,0.0,0,0,0.0,0,0,0,0,0,0,0,0,0,0,1,Ben Sheppard,IND,MIA,IND,,,0,0,0,0
22023,1641767,22300254,"NOV 27, 2023",IND vs. POR,L,1,0,0,0.0,0,0,0.0,0,0,0.0,0,0,0,0,0,0,0,0,0,-3,1,Ben Sheppard,IND,IND,POR,,,0,0,0,0
22023,1641767,22300047,"NOV 24, 2023",IND vs. DET,W,1,0,0,0.0,0,0,0.0,0,0,0.0,0,0,0,0,0,0,0,0,0,2,1,Ben Sheppard,IND,IND,DET,,,0,0,0,0
22023,1641767,22300039,"NOV 21, 2023",IND @ ATL,W,5,2,5,0.4,1,4,0.25,0,0,0.0,0,1,1,1,0,0,0,0,5,-9,1,Ben Sheppard,IND,ATL,IND,,,7,6,6,2
22023,1641767,22300209,"NOV 19, 2023",IND vs. ORL,L,16,2,5,0.4,1,3,0.333,2,2,1.0,0,0,0,2,1,0,1,0,7,25,1,Ben Sheppard,IND,IND,ORL,,,9,7,9,2
22023,1641767,22300146,"NOV 06, 2023",IND vs. SAS,W,12,3,7,0.429,1,4,0.25,0,0,0.0,0,2,2,0,0,0,0,1,7,9,1,Ben Sheppard,IND,IND,SAS,,,9,9,7,2
22023,1641767,22300118,"NOV 01, 2023",IND @ BOS,L,15,2,4,0.5,2,4,0.5,0,0,0.0,1,1,2,2,0,0,0,3,6,-15,1,Ben Sheppard,IND,BOS,IND,,,10,8,8,4
22023,1641767,22300064,"OCT 25, 2023",IND vs. WAS,W,6,0,1,0.0,0,0,0.0,0,0,0.0,0,0,0,0,0,0,0,0,0,3,1,Ben Sheppard,IND,IND,WAS,,,0,0,0,0
22023,1627783,22300563,"JAN 15, 2024",TOR vs. BOS,L,37,5,15,0.333,0,6,0.0,7,8,0.875,2,3,5,4,1,0,0,1,17,-5,1,Pascal Siakam,TOR,TOR,BOS,,,26,22,21,9
22023,1627783,22300540,"JAN 12, 2024",TOR @ UTA,L,30,8,14,0.571,5,6,0.833,6,8,0.75,0,4,4,2,0,0,2,1,27,-23,1,Pascal Siakam,TOR,UTA,TOR,,,33,31,29,6
22023,1627783,22300516,"JAN 09, 2024",TOR @ LAL,L,32,10,17,0.588,3,5,0.6,2,3,0.667,0,4,4,3,0,1,1,2,25,-4,1,Pascal Siakam,TOR,LAL,TOR,,,32,29,28,7
22023,1627783,22300504,"JAN 07, 2024",TOR @ GSW,W,30,7,11,0.636,2,3,0.667,0,0,0.0,1,5,6,6,0,2,1,0,16,5,1,Pascal Siakam,TOR,GSW,TOR,,,28,22,22,12
22023,1627783,22300492,"JAN 05, 2024",TOR @ SAC,L,37,6,11,0.545,0,0,0.0,6,7,0.857,1,3,4,9,2,1,2,3,18,5,1,Pascal Siakam,TOR,SAC,TOR,,,31,22,27,13
22023,1627783,22300470,"JAN 03, 2024",TOR @ MEM,W,30,9,14,0.643,1,2,0.5,5,6,0.833,1,6,7,0,1,0,3,5,24,-1,1,Pascal Siakam,TOR,MEM,TOR,,,31,31,24,7
22023,1627783,22300452,"JAN 01, 2024",TOR vs. CLE,W,40,13,20,0.65,5,8,0.625,5,6,0.833,0,5,5,2,1,0,1,3,36,1,1,Pascal Siakam,TOR,TOR,CLE,,,43,41,38,7
22023,1627783,22300440,"DEC 30, 2023",TOR @ DET,L,40,14,24,0.583,2,2,1.0,5,8,0.625,1,4,5,4,0,0,2,5,35,-5,1,Pascal Siakam,TOR,DET,TOR,,,44,40,39,9
22023,1627783,22300432,"DEC 29, 2023",TOR @ BOS,L,41,10,18,0.556,2,5,0.4,5,8,0.625,0,5,5,5,2,0,1,1,27,8,1,Pascal Siakam,TOR,BOS,TOR,,,37,32,32,10
22023,1627783,22300416,"DEC 27, 2023",TOR @ WAS,W,32,9,15,0.6,0,2,0.0,4,5,0.8,1,5,6,11,1,0,4,3,22,16,1,Pascal Siakam,TOR,WAS,TOR,,,39,28,33,17
22023,1627783,22300395,"DEC 23, 2023",TOR vs. UTA,L,36,7,20,0.35,0,2,0.0,5,6,0.833,3,6,9,6,1,0,1,4,19,0,1,Pascal Siakam,TOR,TOR,UTA,,,34,28,25,15
22023,1627783,22300382,"DEC 22, 2023",TOR @ PHI,L,36,10,16,0.625,0,4,0.0,11,12,0.917,1,4,5,5,0,1,2,1,31,-4,1,Pascal Siakam,TOR,PHI,TOR,,,41,36,36,10
22023,1627783,22300369,"DEC 20, 2023",TOR vs. DEN,L,36,7,16,0.438,1,5,0.2,3,5,0.6,1,4,5,1,0,0,1,2,18,-17,1,Pascal Siakam,TOR,TOR,DEN,,,24,23,19,6
22023,1627783,22300354,"DEC 18, 2023",TOR vs. CHA,W,36,11,16,0.688,0,1,0.0,5,6,0.833,4,4,8,8,1,0,2,1,27,2,1,Pascal Siakam,TOR,TOR,CHA,,,43,35,35,16
22023,1627783,22300330,"DEC 15, 2023",TOR vs. ATL,L,34,5,11,0.455,2,3,0.667,3,4,0.75,0,5,5,4,2,0,1,1,15,-9,1,Pascal Siakam,TOR,TOR,ATL,,,24,20,19,9
22023,1627783,22300313,"DEC 13, 2023",TOR vs. ATL,W,36,12,19,0.632,5,6,0.833,4,7,0.571,1,6,7,7,0,0,2,0,33,15,1,Pascal Siakam,TOR,TOR,ATL,,,47,40,40,14
22023,1627783,22300297,"DEC 11, 2023",TOR @ NYK,L,37,8,15,0.533,1,2,0.5,3,7,0.429,2,2,4,4,4,0,1,5,20,6,1,Pascal Siakam,TOR,NYK,TOR,,,28,24,24,8
22023,1627783,22301216,"DEC 08, 2023",TOR @ CHA,L,33,11,15,0.733,0,1,0.0,3,4,0.75,1,4,5,4,1,0,1,2,25,-9,1,Pascal Siakam,TOR,CHA,TOR,,,34,30,29,9
22023,1627783,22301207,"DEC 06, 2023",TOR vs. MIA,L,36,9,13,0.692,1,1,1.0,11,11,1.0,1,3,4,6,0,1,2,1,30,-9,1,Pascal Siakam,TOR,TOR,MIA,,,40,34,36,10
22023,1627783,22300276,"DEC 01, 2023",TOR vs. NYK,L,34,7,16,0.438,0,4,0.0,7,8,0.875,3,5,8,3,0,0,3,3,21,-14,1,Pascal Siakam,TOR,TOR,NYK,,,32,29,24,11
22023,1627783,22300260,"NOV 29, 2023",TOR vs. PHX,W,36,9,21,0.429,1,5,0.2,3,3,1.0,3,6,9,3,1,0,3,4,22,9,1,Pascal Siakam,TOR,TOR,PHX,,,34,31,25,12
22023,1627783,22300054,"NOV 28, 2023",TOR @ BKN,L,35,6,18,0.333,0,4,0.0,5,7,0.714,2,8,10,2,1,0,2,2,17,-14,1,Pascal Siakam,TOR,BKN,TOR,,,29,27,19,12
22023,1627783,22300251,"NOV 26, 2023",TOR @ CLE,L,38,7,17,0.412,0,4,0.0,4,6,0.667,4,4,8,6,1,1,4,0,18,6,1,Pascal Siakam,TOR,CLE,TOR,,,32,26,24,14
22023,1627783,22300046,"NOV 24, 2023",TOR vs. CHI,W,37,6,12,0.5,1,6,0.167,5,6,0.833,0,3,3,8,1,0,3,2,18,14,1,Pascal Siakam,TOR,TOR,CHI,,,29,21,26,11
22023,1627783,22300230,"NOV 22, 2023",TOR @ IND,W,38,13,24,0.542,1,3,0.333,9,11,0.818,3,7,10,5,0,1,2,2,36,-5,1,Pascal Siakam,TOR,IND,TOR,,,51,46,41,15
22023,1627783,22300038,"NOV 21, 2023",TOR @ ORL,L,30,5,10,0.5,0,2,0.0,6,8,0.75,0,2,2,8,1,0,2,1,16,-7,1,Pascal Siakam,TOR,ORL,TOR,,,26,18,24,10
22023,1627783,22300211,"NOV 19, 2023",TOR vs. DET,W,29,10,18,0.556,1,2,0.5,2,3,0.667,3,4,7,6,1,0,0,1,23,23,1,Pascal Siakam,TOR,TOR,DET,,,36,30,29,13
22023,1627783,22300031,"NOV 17, 2023",TOR vs. BOS,L,29,11,16,0.688,0,1,0.0,1,1,1.0,1,5,6,5,0,0,3,5,23,17,1,Pascal Siakam,TOR,TOR,BOS,,,34,29,28,11
22023,1627783,22300195,"NOV 15, 2023",TOR vs. MIL,L,29,4,9,0.444,0,2,0.0,3,5,0.6,2,5,7,5,0,1,4,1,11,-21,1,Pascal Siakam,TOR,TOR,MIL,,,23,18,16,12
22023,1627783,22300189,"NOV 13, 2023",TOR vs. WAS,W,38,15,23,0.652,0,3,0.0,9,14,0.643,2,9,11,7,3,0,6,1,39,18,1,Pascal Siakam,TOR,TOR,WAS,,,57,50,46,18
22023,1627783,22300174,"NOV 11, 2023",TOR @ BOS,L,28,6,17,0.353,0,4,0.0,5,6,0.833,2,5,7,3,3,0,3,0,17,-9,1,Pascal Siakam,TOR,BOS,TOR,,,27,24,20,10
22023,1627783,22300168,"NOV 08, 2023",TOR @ DAL,W,37,15,25,0.6,0,5,0.0,1,4,0.25,4,8,12,5,0,0,3,2,31,7,1,Pascal Siakam,TOR,DAL,TOR,,,48,43,36,17
22023,1627783,22300141,"NOV 05, 2023",TOR @ SAS,W,36,2,12,0.167,1,4,0.25,3,3,1.0,0,6,6,5,1,0,3,3,8,7,1,Pascal Siakam,TOR,SAS,TOR,,,19,14,13,11
22023,1627783,22300128,"NOV 02, 2023",TOR @ PHI,L,33,5,11,0.455,0,3,0.0,0,0,0.0,1,2,3,6,0,0,2,5,10,-14,1,Pascal Siakam,TOR,PHI,TOR,,,19,13,16,9
22023,1627783,22300116,"NOV 01, 2023",TOR vs. MIL,W,33,9,13,0.692,5,8,0.625,3,3,1.0,0,6,6,7,0,0,3,3,26,22,1,Pascal Siakam,TOR,TOR,MIL,,,39,32,33,13
22023,1627783,22300105,"OCT 30, 2023",TOR vs. POR,L,35,9,21,0.429,0,6,0.0,2,3,0.667,1,5,6,3,1,0,0,1,20,-2,1,Pascal Siakam,TOR,TOR,POR,,,29,26,23,9
22023,1627783,22300092,"OCT 28, 2023",TOR vs. PHI,L,36,3,8,0.375,2,5,0.4,3,4,0.75,1,6,7,4,0,1,2,4,11,-5,1,Pascal Siakam,TOR,TOR,PHI,,,22,18,15,11
22023,1627783,22300082,"OCT 27, 2023",TOR @ CHI,L,41,7,15,0.467,1,5,0.2,3,5,0.6,1,7,8,2,0,0,3,4,18,-2,1,Pascal Siakam,TOR,CHI,TOR,,,28,26,20,10
22023,1627783,22300069,"OCT 25, 2023",TOR vs. MIN,W,34,5,17,0.294,3,5,0.6,2,2,1.0,0,7,7,6,1,0,2,2,15,7,1,Pascal Siakam,TOR,TOR,MIN,,,28,22,21,13
22023,1627732,22300149,"NOV 06, 2023",BKN vs. MIL,L,33,1,3,0.333,0,0,0.0,0,0,0.0,3,12,15,4,0,0,1,3,2,-12,1,Ben Simmons,BKN,BKN,MIL,,,21,17,6,19
22023,1627732,22300004,"NOV 03, 2023",BKN @ CHI,W,33,4,8,0.5,0,0,0.0,0,0,0.0,3,6,9,6,1,0,4,3,8,-9,1,Ben Simmons,BKN,CHI,BKN,,,23,17,14,15
22023,1627732,22300119,"NOV 01, 2023",BKN @ MIA,W,34,2,5,0.4,0,0,0.0,0,2,0.0,2,9,11,5,0,1,4,4,4,-9,1,Ben Simmons,BKN,MIA,BKN,,,20,15,9,16
22023,1627732,22300101,"OCT 30, 2023",BKN @ CHA,W,35,5,6,0.833,0,0,0.0,1,2,0.5,3,7,10,8,0,1,2,1,11,3,1,Ben Simmons,BKN,CHA,BKN,,,29,21,19,18
22023,1627732,22300084,"OCT 27, 2023",BKN @ DAL,L,32,5,8,0.625,0,0,0.0,0,0,0.0,4,6,10,8,2,2,2,3,10,0,1,Ben Simmons,BKN,DAL,BKN,,,28,20,18,18
22023,1627732,22300067,"OCT 25, 2023",BKN vs. CLE,L,23,2,6,0.333,0,0,0.0,0,0,0.0,1,9,10,9,0,1,2,2,4,-6,1,Ben Simmons,BKN,BKN,CLE,,,23,14,13,19
22023,1629014,22300554,"JAN 14, 2024",POR vs. PHX,L,41,8,18,0.444,6,12,0.5,6,7,0.857,0,5,5,5,0,0,3,2,28,-11,1,Anfernee Simons,POR,POR,PHX,,,38,33,33,10
22023,1629014,22300538,"JAN 12, 2024",POR @ MIN,L,29,0,10,0.0,0,2,0.0,5,5,1.0,0,2,2,3,0,1,3,0,5,-34,1,Anfernee Simons,POR,MIN,POR,,,10,7,8,5
22023,1629014,22300529,"JAN 11, 2024",POR @ OKC,L,20,4,13,0.308,4,8,0.5,2,4,0.5,1,2,3,2,0,0,3,2,14,-36,1,Anfernee Simons,POR,OKC,POR,,,19,17,16,5
22023,1629014,22300514,"JAN 09, 2024",POR @ NYK,L,27,4,14,0.286,2,7,0.286,2,2,1.0,0,4,4,3,0,0,3,2,12,-26,1,Anfernee Simons,POR,NYK,POR,,,19,16,15,7
22023,1629014,22300498,"JAN 07, 2024",POR @ BKN,W,45,13,25,0.52,5,10,0.5,7,8,0.875,0,4,4,11,0,0,2,2,38,7,1,Anfernee Simons,POR,BKN,POR,,,53,42,49,15
22023,1629014,22300487,"JAN 05, 2024",POR @ DAL,L,23,1,8,0.125,1,4,0.25,3,3,1.0,0,5,5,4,0,0,2,1,6,-14,1,Anfernee Simons,POR,DAL,POR,,,15,11,10,9
22023,1629014,22300472,"JAN 03, 2024",POR @ DAL,L,27,5,16,0.313,1,7,0.143,4,4,1.0,1,4,5,3,0,0,2,1,15,-31,1,Anfernee Simons,POR,DAL,POR,,,23,20,18,8
22023,1629014,22300413,"DEC 26, 2023",POR vs. SAC,W,35,12,25,0.48,5,12,0.417,0,0,0.0,0,4,4,3,1,0,2,2,29,4,1,Anfernee Simons,POR,POR,SAC,,,36,33,32,7
22023,1629014,22300399,"DEC 23, 2023",POR @ GSW,L,34,7,17,0.412,7,13,0.538,4,4,1.0,0,2,2,2,1,0,1,0,25,-8,1,Anfernee Simons,POR,GSW,POR,,,29,27,27,4
22023,1629014,22300381,"DEC 21, 2023",POR vs. WAS,L,38,15,28,0.536,7,14,0.5,4,5,0.8,1,3,4,7,0,0,3,2,41,-2,1,Anfernee Simons,POR,POR,WAS,,,52,45,48,11
22023,1629014,22300363,"DEC 19, 2023",POR vs. PHX,W,38,9,23,0.391,2,7,0.286,3,5,0.6,0,3,3,7,1,0,1,2,23,4,1,Anfernee Simons,POR,POR,PHX,,,33,26,30,10
22023,1629014,22300348,"DEC 17, 2023",POR vs. GSW,L,36,9,20,0.45,0,5,0.0,6,6,1.0,0,3,3,7,1,0,4,3,24,-1,1,Anfernee Simons,POR,POR,GSW,,,34,27,31,10
22023,1629014,22300341,"DEC 16, 2023",POR vs. DAL,L,35,13,22,0.591,2,8,0.25,5,5,1.0,2,6,8,6,2,0,3,2,33,4,1,Anfernee Simons,POR,POR,DAL,,,47,41,39,14
22023,1629014,22300323,"DEC 14, 2023",POR vs. UTA,L,22,3,8,0.375,2,6,0.333,1,2,0.5,0,1,1,6,1,0,2,1,9,-24,1,Anfernee Simons,POR,POR,UTA,,,16,10,15,7
22023,1629014,22300304,"DEC 11, 2023",POR @ LAC,L,38,10,23,0.435,5,11,0.455,13,13,1.0,0,1,1,4,0,1,3,1,38,-9,1,Anfernee Simons,POR,LAC,POR,,,43,39,42,5
22023,1629014,22301226,"DEC 08, 2023",POR vs. DAL,L,36,10,21,0.476,4,10,0.4,6,6,1.0,2,3,5,8,1,0,6,4,30,-10,1,Anfernee Simons,POR,POR,DAL,,,43,35,38,13
22023,1629014,22301214,"DEC 06, 2023",POR @ GSW,L,37,10,27,0.37,6,13,0.462,2,2,1.0,1,0,1,4,0,0,1,3,28,2,1,Anfernee Simons,POR,GSW,POR,,,33,29,32,5
22023,1629014,22300074,"OCT 25, 2023",POR @ LAC,L,27,6,14,0.429,2,6,0.333,4,4,1.0,1,1,2,4,2,0,0,2,18,-27,1,Anfernee Simons,POR,LAC,POR,,,24,20,22,6
22023,1630579,22300514,"JAN 09, 2024",NYK vs. POR,W,7,0,0,0.0,0,0,0.0,0,0,0.0,0,1,1,0,1,0,1,0,0,-4,1,Jericho Sims,NYK,NYK,POR,,,1,1,0,1
22023,1630579,22300494,"JAN 06, 2024",NYK @ WAS,W,2,0,0,0.0,0,0,0.0,0,0,0.0,0,0,0,0,0,0,0,0,0,-7,1,Jericho Sims,NYK,WAS,NYK,,,0,0,0,0
22023,1630579,22300483,"JAN 05, 2024",NYK @ PHI,W,2,0,0,0.0,0,0,0.0,0,0,0.0,0,0,0,0,0,0,0,0,0,-3,1,Jericho Sims,NYK,PHI,NYK,,,0,0,0,0
22023,1630579,22300468,"JAN 03, 2024",NYK vs. CHI,W,1,0,0,0.0,0,0,0.0,0,0,0.0,0,1,1,0,0,0,0,0,0,0,1,Jericho Sims,NYK,NYK,CHI,,,1,1,0,1
22023,1630579,22300359,"DEC 18, 2023",NYK @ LAL,W,3,0,0,0.0,0,0,0.0,0,0,0.0,0,0,0,0,0,0,0,2,0,-2,1,Jericho Sims,NYK,LAL,NYK,,,0,0,0,0
22023,1630579,22300343,"DEC 16, 2023",NYK @ LAC,L,18,3,4,0.75,0,0,0.0,1,1,1.0,0,2,2,1,1,0,0,3,7,-13,1,Jericho Sims,NYK,LAC,NYK,,,10,9,8,3
22023,1630579,22300333,"DEC 15, 2023",NYK @ PHX,W,17,2,4,0.5,0,0,0.0,1,1,1.0,1,2,3,0,0,0,0,3,5,-12,1,Jericho Sims,NYK,PHX,NYK,,,8,8,5,3
22023,1630579,22300318,"DEC 13, 2023",NYK @ UTA,L,18,2,2,1.0,0,0,0.0,0,0,0.0,1,1,2,0,0,1,1,2,4,-8,1,Jericho Sims,NYK,UTA,NYK,,,6,6,4,2
22023,1630579,22300297,"DEC 11, 2023",NYK vs. TOR,W,21,1,2,0.5,0,0,0.0,0,0,0.0,3,4,7,1,0,0,0,3,2,5,1,Jericho Sims,NYK,NYK,TOR,,,10,9,3,8
22023,1630579,22301201,"DEC 05, 2023",NYK @ MIL,L,3,0,0,0.0,0,0,0.0,0,0,0.0,0,0,0,0,0,0,1,0,0,-2,1,Jericho Sims,NYK,MIL,NYK,,,0,0,0,0
22023,1630579,22300057,"NOV 28, 2023",NYK vs. CHA,W,2,0,0,0.0,0,0,0.0,0,0,0.0,0,0,0,0,0,0,0,0,0,-1,1,Jericho Sims,NYK,NYK,CHA,,,0,0,0,0
22023,1630579,22300221,"NOV 20, 2023",NYK @ MIN,L,3,1,1,1.0,0,0,0.0,0,0,0.0,0,1,1,0,0,0,0,0,2,0,1,Jericho Sims,NYK,MIN,NYK,,,3,3,2,1
22023,1630579,22300028,"NOV 17, 2023",NYK @ WAS,W,1,0,0,0.0,0,0,0.0,0,0,0.0,0,1,1,0,0,0,0,0,0,1,1,Jericho Sims,NYK,WAS,NYK,,,1,1,0,1
22023,1630579,22300188,"NOV 13, 2023",NYK @ BOS,L,1,0,0,0.0,0,0,0.0,0,0,0.0,0,0,0,0,0,0,0,0,0,0,1,Jericho Sims,NYK,BOS,NYK,,,0,0,0,0
22023,1630579,22300177,"NOV 12, 2023",NYK vs. CHA,W,7,1,1,1.0,0,0,0.0,1,3,0.333,0,3,3,0,0,0,0,1,3,-6,1,Jericho Sims,NYK,NYK,CHA,,,6,6,3,3
22023,1630579,22300161,"NOV 08, 2023",NYK vs. SAS,W,2,0,0,0.0,0,0,0.0,0,0,0.0,0,1,1,0,0,0,0,0,0,-2,1,Jericho Sims,NYK,NYK,SAS,,,1,1,0,1
22023,1630579,22300112,"OCT 31, 2023",NYK @ CLE,W,3,0,1,0.0,0,0,0.0,0,0,0.0,1,0,1,1,0,0,0,0,0,0,1,Jericho Sims,NYK,CLE,NYK,,,2,1,1,2
22023,1630579,22300090,"OCT 28, 2023",NYK @ NOP,L,5,0,0,0.0,0,0,0.0,0,0,0.0,0,3,3,0,0,0,0,0,0,10,1,Jericho Sims,NYK,NOP,NYK,,,3,3,0,3
22023,1641771,22300303,"DEC 11, 2023",SAC vs. BKN,W,1,0,0,0.0,0,0,0.0,0,0,0.0,0,0,0,0,0,0,1,2,0,-6,1,Jalen Slawson,SAC,SAC,BKN,,,0,0,0,0
22023,1641771,22300264,"NOV 29, 2023",SAC vs. LAC,L,1,0,0,0.0,0,0,0.0,0,0,0.0,0,0,0,0,0,0,0,0,0,0,1,Jalen Slawson,SAC,SAC,LAC,,,0,0,0,0
22023,1641771,22300222,"NOV 20, 2023",SAC @ NOP,L,12,2,3,0.667,0,1,0.0,0,0,0.0,0,3,3,2,0,1,1,1,4,-5,1,Jalen Slawson,SAC,NOP,SAC,,,9,7,6,5
22023,1641771,22300212,"NOV 19, 2023",SAC @ DAL,W,4,0,0,0.0,0,0,0.0,0,0,0.0,0,1,1,0,0,0,0,0,0,-3,1,Jalen Slawson,SAC,DAL,SAC,,,1,1,0,1
22023,1641771,22300198,"NOV 15, 2023",SAC @ LAL,W,0,0,0,0.0,0,0,0.0,0,0,0.0,0,0,0,0,0,0,0,0,0,0,1,Jalen Slawson,SAC,LAL,SAC,,,0,0,0,0
22023,1630606,22300382,"DEC 22, 2023",PHI vs. TOR,W,1,0,0,0.0,0,0,0.0,0,0,0.0,0,0,0,0,0,0,0,0,0,-3,1,Javonte Smart,PHI,PHI,TOR,,,0,0,0,0
22023,203935,22300515,"JAN 09, 2024",MEM @ DAL,W,21,9,16,0.563,4,8,0.5,1,1,1.0,0,4,4,1,2,0,1,0,23,16,1,Marcus Smart,MEM,DAL,MEM,,,28,27,24,5
22023,203935,22300503,"JAN 07, 2024",MEM @ PHX,W,38,9,20,0.45,4,13,0.308,3,5,0.6,0,6,6,8,3,0,5,2,25,10,1,Marcus Smart,MEM,PHX,MEM,,,39,31,33,14
22023,203935,22300491,"JAN 05, 2024",MEM @ LAL,W,39,9,16,0.563,8,14,0.571,3,4,0.75,1,1,2,5,1,0,3,2,29,13,1,Marcus Smart,MEM,LAL,MEM,,,36,31,34,7
22023,203935,22300470,"JAN 03, 2024",MEM vs. TOR,L,33,2,10,0.2,0,5,0.0,2,3,0.667,0,5,5,2,1,0,3,4,6,11,1,Marcus Smart,MEM,MEM,TOR,,,13,11,8,7
22023,203935,22300460,"JAN 02, 2024",MEM vs. SAS,W,30,1,7,0.143,0,4,0.0,3,4,0.75,1,1,2,3,0,0,3,3,5,2,1,Marcus Smart,MEM,MEM,SAS,,,10,7,8,5
22023,203935,22300449,"DEC 31, 2023",MEM vs. SAC,L,31,4,11,0.364,0,4,0.0,4,7,0.571,0,1,1,2,3,0,2,2,12,-15,1,Marcus Smart,MEM,MEM,SAC,,,15,13,14,3
22023,203935,22300438,"DEC 29, 2023",MEM @ LAC,L,32,7,14,0.5,4,11,0.364,4,4,1.0,0,2,2,2,3,0,2,0,22,-5,1,Marcus Smart,MEM,LAC,MEM,,,26,24,24,4
22023,203935,22300425,"DEC 28, 2023",MEM @ DEN,L,23,6,14,0.429,2,6,0.333,3,4,0.75,1,2,3,5,1,0,3,1,17,-7,1,Marcus Smart,MEM,DEN,MEM,,,25,20,22,8
22023,203935,22300410,"DEC 26, 2023",MEM @ NOP,W,29,4,10,0.4,2,8,0.25,3,3,1.0,0,1,1,3,5,1,3,4,13,9,1,Marcus Smart,MEM,NOP,MEM,,,17,14,16,4
22023,203935,22300026,"NOV 14, 2023",MEM @ LAL,L,8,1,3,0.333,1,2,0.5,0,0,0.0,0,1,1,1,1,1,0,0,3,-7,1,Marcus Smart,MEM,LAL,MEM,,,5,4,4,2
22023,203935,22300179,"NOV 12, 2023",MEM @ LAC,W,36,5,12,0.417,3,7,0.429,4,4,1.0,0,3,3,7,0,0,5,3,17,16,1,Marcus Smart,MEM,LAC,MEM,,,27,20,24,10
22023,203935,22300012,"NOV 10, 2023",MEM vs. UTA,L,25,3,9,0.333,0,4,0.0,2,2,1.0,0,1,1,2,0,1,1,6,8,10,1,Marcus Smart,MEM,MEM,UTA,,,11,9,10,3
22023,203935,22300164,"NOV 08, 2023",MEM vs. MIA,L,32,4,14,0.286,0,3,0.0,3,4,0.75,0,4,4,7,2,0,3,4,11,-17,1,Marcus Smart,MEM,MEM,MIA,,,22,15,18,11
22023,203935,22300144,"NOV 05, 2023",MEM @ POR,W,29,4,9,0.444,2,5,0.4,0,0,0.0,0,2,2,5,2,0,3,3,10,10,1,Marcus Smart,MEM,POR,MEM,,,17,12,15,7
22023,203935,22300007,"NOV 03, 2023",MEM @ POR,L,39,4,12,0.333,0,5,0.0,0,0,0.0,1,2,3,4,1,0,5,2,8,-19,1,Marcus Smart,MEM,POR,MEM,,,15,11,12,7
22023,203935,22300125,"NOV 01, 2023",MEM @ UTA,L,28,4,11,0.364,1,7,0.143,2,2,1.0,0,2,2,6,4,0,5,3,11,-28,1,Marcus Smart,MEM,UTA,MEM,,,19,13,17,8
22023,203935,22300106,"OCT 30, 2023",MEM vs. DAL,L,35,9,17,0.529,5,10,0.5,0,0,0.0,1,4,5,9,3,0,6,6,23,-1,1,Marcus Smart,MEM,MEM,DAL,,,37,28,32,14
22023,203935,22300089,"OCT 28, 2023",MEM @ WAS,L,32,4,8,0.5,1,5,0.2,0,0,0.0,0,4,4,6,2,2,2,2,9,-14,1,Marcus Smart,MEM,WAS,MEM,,,19,13,15,10
22023,203935,22300078,"OCT 27, 2023",MEM vs. DEN,L,31,7,13,0.538,3,7,0.429,3,3,1.0,1,1,2,5,5,0,2,3,20,-6,1,Marcus Smart,MEM,MEM,DEN,,,27,22,25,7
22023,203935,22300071,"OCT 25, 2023",MEM vs. NOP,L,32,6,11,0.545,2,6,0.333,3,6,0.5,0,0,0,3,2,0,5,3,17,3,1,Marcus Smart,MEM,MEM,NOP,,,20,17,20,3
22023,1630696,22300229,"NOV 22, 2023",MIA @ CLE,W,1,0,0,0.0,0,0,0.0,0,0,0.0,0,0,0,0,0,0,0,1,0,-5,1,Dru Smith,MIA,CLE,MIA,,,0,0,0,0
22023,1630696,22300220,"NOV 20, 2023",MIA @ CHI,W,2,0,1,0.0,0,1,0.0,0,0,0.0,0,1,1,0,1,0,0,0,0,-6,1,Dru Smith,MIA,CHI,MIA,,,1,1,0,1
22023,1630696,22300017,"NOV 14, 2023",MIA @ CHA,W,3,0,0,0.0,0,0,0.0,0,0,0.0,0,0,0,0,0,0,0,2,0,1,1,Dru Smith,MIA,CHA,MIA,,,0,0,0,0
22023,1630696,22300184,"NOV 12, 2023",MIA @ SAS,W,27,4,9,0.444,2,5,0.4,2,2,1.0,2,2,4,3,0,0,1,2,12,5,1,Dru Smith,MIA,SAS,MIA,,,19,16,15,7
22023,1630696,22300175,"NOV 11, 2023",MIA @ ATL,W,28,4,8,0.5,1,3,0.333,0,0,0.0,1,1,2,2,3,1,2,3,9,-1,1,Dru Smith,MIA,ATL,MIA,,,13,11,11,4
22023,1630696,22300164,"NOV 08, 2023",MIA @ MEM,W,15,1,3,0.333,0,2,0.0,0,0,0.0,2,2,4,1,1,1,0,0,2,-3,1,Dru Smith,MIA,MEM,MIA,,,7,6,3,5
22023,1630696,22300093,"OCT 28, 2023",MIA @ MIN,L,22,2,4,0.5,1,1,1.0,0,0,0.0,0,1,1,4,1,0,1,1,5,-12,1,Dru Smith,MIA,MIN,MIA,,,10,6,9,5
22023,1630696,22300080,"OCT 27, 2023",MIA @ BOS,L,23,3,6,0.5,3,4,0.75,0,0,0.0,1,1,2,3,3,1,1,2,9,-18,1,Dru Smith,MIA,BOS,MIA,,,14,11,12,5
22023,1630696,22300068,"OCT 25, 2023",MIA vs. DET,W,9,1,2,0.5,0,1,0.0,0,0,0.0,0,0,0,1,0,0,0,1,2,-4,1,Dru Smith,MIA,MIA,DET,,,3,2,3,1
22023,202397,22300551,"JAN 14, 2024",CHA @ MIA,L,12,0,1,0.0,0,0,0.0,1,2,0.5,1,1,2,0,0,0,0,0,1,-6,1,Ish Smith,CHA,MIA,CHA,,,3,3,1,2
22023,202397,22300541,"JAN 12, 2024",CHA @ SAS,L,22,0,4,0.0,0,0,0.0,0,0,0.0,0,2,2,6,1,0,2,0,0,-14,1,Ish Smith,CHA,SAS,CHA,,,8,2,6,8
22023,202397,22300518,"JAN 10, 2024",CHA vs. SAC,L,16,1,3,0.333,0,0,0.0,0,0,0.0,0,1,1,0,0,0,0,1,2,-5,1,Ish Smith,CHA,CHA,SAC,,,3,3,2,1
22023,202397,22300506,"JAN 08, 2024",CHA vs. CHI,L,15,1,4,0.25,0,0,0.0,0,0,0.0,0,0,0,1,0,0,0,1,2,1,1,Ish Smith,CHA,CHA,CHI,,,3,2,3,1
22023,202397,22300484,"JAN 05, 2024",CHA @ CHI,L,16,3,9,0.333,0,2,0.0,0,0,0.0,1,1,2,4,1,0,0,1,6,-8,1,Ish Smith,CHA,CHI,CHA,,,12,8,10,6
22023,202397,22300464,"JAN 02, 2024",CHA @ SAC,W,18,2,4,0.5,0,0,0.0,0,0,0.0,1,5,6,4,1,0,4,1,4,13,1,Ish Smith,CHA,SAC,CHA,,,14,10,8,10
22023,202397,22300455,"JAN 01, 2024",CHA @ DEN,L,29,5,12,0.417,0,0,0.0,0,0,0.0,1,2,3,4,0,0,4,2,10,-28,1,Ish Smith,CHA,DEN,CHA,,,17,13,14,7
22023,202397,22300436,"DEC 29, 2023",CHA @ PHX,L,13,0,1,0.0,0,0,0.0,0,0,0.0,0,1,1,6,0,0,0,1,0,-13,1,Ish Smith,CHA,PHX,CHA,,,7,1,6,7
22023,202397,22300428,"DEC 28, 2023",CHA @ LAL,L,14,3,4,0.75,0,0,0.0,0,0,0.0,0,3,3,4,0,0,1,1,6,-6,1,Ish Smith,CHA,LAL,CHA,,,13,9,10,7
22023,202397,22300414,"DEC 26, 2023",CHA @ LAC,L,16,2,4,0.5,0,0,0.0,0,0,0.0,0,1,1,4,0,0,1,1,4,0,1,Ish Smith,CHA,LAC,CHA,,,9,5,8,5
22023,202397,22300390,"DEC 23, 2023",CHA vs. DEN,L,26,1,4,0.25,0,0,0.0,2,2,1.0,1,2,3,8,0,0,2,2,4,-12,1,Ish Smith,CHA,CHA,DEN,,,15,7,12,11
22023,202397,22300365,"DEC 20, 2023",CHA @ IND,L,16,2,3,0.667,0,0,0.0,0,0,0.0,0,0,0,6,0,0,1,1,4,-5,1,Ish Smith,CHA,IND,CHA,,,10,4,10,6
22023,202397,22300354,"DEC 18, 2023",CHA @ TOR,L,23,4,10,0.4,0,0,0.0,0,0,0.0,0,0,0,1,0,1,1,1,8,-21,1,Ish Smith,CHA,TOR,CHA,,,9,8,9,1
22023,202397,22300335,"DEC 16, 2023",CHA vs. PHI,L,18,3,7,0.429,0,0,0.0,0,0,0.0,0,1,1,4,1,0,0,0,6,-7,1,Ish Smith,CHA,CHA,PHI,,,11,7,10,5
22023,202397,22300326,"DEC 15, 2023",CHA vs. NOP,L,15,0,2,0.0,0,0,0.0,0,0,0.0,1,0,1,2,0,0,0,0,0,10,1,Ish Smith,CHA,CHA,NOP,,,3,1,2,3
22023,202397,22300312,"DEC 13, 2023",CHA @ MIA,L,17,3,5,0.6,0,1,0.0,0,0,0.0,0,2,2,4,0,0,3,3,6,-5,1,Ish Smith,CHA,MIA,CHA,,,12,8,10,6
22023,202397,22300292,"DEC 11, 2023",CHA vs. MIA,L,15,2,4,0.5,1,1,1.0,0,0,0.0,0,0,0,3,1,0,2,0,5,-3,1,Ish Smith,CHA,CHA,MIA,,,8,5,8,3
22023,202397,22301216,"DEC 08, 2023",CHA vs. TOR,W,14,1,1,1.0,0,0,0.0,0,0,0.0,0,0,0,4,0,0,1,0,2,1,1,Ish Smith,CHA,CHA,TOR,,,6,2,6,4
22023,202397,22301211,"DEC 06, 2023",CHA @ CHI,L,14,0,0,0.0,0,0,0.0,0,0,0.0,0,1,1,3,0,0,2,1,0,-6,1,Ish Smith,CHA,CHI,CHA,,,4,1,3,4
22023,202397,22300281,"DEC 02, 2023",CHA vs. MIN,L,16,3,3,1.0,0,0,0.0,0,0,0.0,1,3,4,5,0,0,0,0,6,3,1,Ish Smith,CHA,CHA,MIN,,,15,10,11,9
22023,202397,22300266,"NOV 30, 2023",CHA @ BKN,W,13,0,0,0.0,0,0,0.0,0,0,0.0,1,0,1,0,0,0,2,4,0,-2,1,Ish Smith,CHA,BKN,CHA,,,1,1,0,1
22023,202397,22300057,"NOV 28, 2023",CHA @ NYK,L,14,2,3,0.667,0,0,0.0,0,0,0.0,0,1,1,1,0,0,3,1,4,-17,1,Ish Smith,CHA,NYK,CHA,,,6,5,5,2
22023,202397,22300248,"NOV 26, 2023",CHA @ ORL,L,17,2,3,0.667,0,0,0.0,0,0,0.0,0,2,2,4,1,0,1,2,4,-13,1,Ish Smith,CHA,ORL,CHA,,,10,6,8,6
22023,202397,22300225,"NOV 22, 2023",CHA vs. WAS,W,20,0,1,0.0,0,0,0.0,0,0,0.0,0,0,0,4,1,0,1,1,0,14,1,Ish Smith,CHA,CHA,WAS,,,4,0,4,4
22023,202397,22300217,"NOV 20, 2023",CHA vs. BOS,W,20,3,4,0.75,0,0,0.0,0,0,0.0,0,2,2,3,0,0,1,0,6,-12,1,Ish Smith,CHA,CHA,BOS,,,11,8,9,5
22023,202397,22300202,"NOV 18, 2023",CHA vs. NYK,L,17,3,6,0.5,1,2,0.5,0,0,0.0,0,3,3,4,0,0,0,1,7,0,1,Ish Smith,CHA,CHA,NYK,,,14,10,11,7
22023,202397,22300027,"NOV 17, 2023",CHA vs. MIL,L,23,4,7,0.571,0,0,0.0,0,0,0.0,0,2,2,2,0,1,1,0,8,-6,1,Ish Smith,CHA,CHA,MIL,,,12,10,10,4
22023,202397,22300017,"NOV 14, 2023",CHA vs. MIA,L,19,1,3,0.333,0,0,0.0,0,0,0.0,1,1,2,3,0,0,3,1,2,-11,1,Ish Smith,CHA,CHA,MIA,,,7,4,5,5
22023,202397,22300177,"NOV 12, 2023",CHA @ NYK,L,17,2,4,0.5,0,0,0.0,0,0,0.0,1,4,5,2,2,0,0,1,4,-9,1,Ish Smith,CHA,NYK,CHA,,,11,9,6,7
22023,202397,22300157,"NOV 08, 2023",CHA vs. WAS,L,10,0,0,0.0,0,0,0.0,0,0,0.0,0,1,1,0,1,0,2,0,0,-8,1,Ish Smith,CHA,CHA,WAS,,,1,1,0,1
22023,202397,22300143,"NOV 05, 2023",CHA @ DAL,L,3,0,0,0.0,0,0,0.0,0,0,0.0,0,0,0,0,0,0,1,3,0,-4,1,Ish Smith,CHA,DAL,CHA,,,0,0,0,0
22023,1630188,22300564,"JAN 15, 2024",IND @ UTA,L,19,5,10,0.5,2,5,0.4,0,0,0.0,1,5,6,3,0,1,2,5,12,-28,1,Jalen Smith,IND,UTA,IND,,,21,18,15,9
22023,1630188,22300550,"JAN 14, 2024",IND @ DEN,L,25,4,7,0.571,0,1,0.0,0,1,0.0,2,1,3,3,0,0,0,2,8,-16,1,Jalen Smith,IND,DEN,IND,,,14,11,11,6
22023,1630188,22300533,"JAN 12, 2024",IND @ ATL,W,19,3,7,0.429,0,0,0.0,0,0,0.0,3,4,7,0,0,0,0,1,6,11,1,Jalen Smith,IND,ATL,IND,,,13,13,6,7
22023,1630188,22300507,"JAN 08, 2024",IND vs. BOS,W,27,3,8,0.375,1,4,0.25,4,4,1.0,2,7,9,1,0,3,2,1,11,5,1,Jalen Smith,IND,IND,BOS,,,21,20,12,10
22023,1630188,22300493,"JAN 06, 2024",IND vs. BOS,L,26,2,6,0.333,1,4,0.25,2,2,1.0,1,6,7,2,0,0,0,2,7,-7,1,Jalen Smith,IND,IND,BOS,,,16,14,9,9
22023,1630188,22300480,"JAN 05, 2024",IND vs. ATL,W,23,5,7,0.714,1,3,0.333,0,0,0.0,0,2,2,2,0,0,0,2,11,4,1,Jalen Smith,IND,IND,ATL,,,15,13,13,4
22023,1630188,22300466,"JAN 03, 2024",IND vs. MIL,W,19,5,8,0.625,1,4,0.25,2,2,1.0,2,5,7,3,0,0,1,2,13,23,1,Jalen Smith,IND,IND,MIL,,,23,20,16,10
22023,1630188,22300454,"JAN 01, 2024",IND @ MIL,W,12,3,10,0.3,1,6,0.167,0,0,0.0,1,1,2,0,0,0,0,1,7,-19,1,Jalen Smith,IND,MIL,IND,,,9,9,7,2
22023,1630188,22300441,"DEC 30, 2023",IND vs. NYK,W,21,3,5,0.6,1,2,0.5,2,4,0.5,0,4,4,2,0,2,1,5,9,3,1,Jalen Smith,IND,IND,NYK,,,15,13,11,6
22023,1630188,22300422,"DEC 28, 2023",IND @ CHI,W,25,6,7,0.857,1,2,0.5,2,5,0.4,2,5,7,1,0,0,0,3,15,4,1,Jalen Smith,IND,CHI,IND,,,23,22,16,8
22023,1630188,22300409,"DEC 26, 2023",IND @ HOU,W,23,5,11,0.455,1,4,0.25,1,1,1.0,2,6,8,1,1,2,1,3,12,11,1,Jalen Smith,IND,HOU,IND,,,21,20,13,9
22023,1630188,22300391,"DEC 23, 2023",IND vs. ORL,L,15,4,5,0.8,3,4,0.75,0,1,0.0,1,1,2,1,0,0,2,5,11,-19,1,Jalen Smith,IND,IND,ORL,,,14,13,12,3
22023,1630188,22300365,"DEC 20, 2023",IND vs. CHA,W,8,4,4,1.0,2,2,1.0,0,0,0.0,2,2,4,0,0,0,0,2,10,3,1,Jalen Smith,IND,IND,CHA,,,14,14,10,4
22023,1630188,22300254,"NOV 27, 2023",IND vs. POR,L,12,3,5,0.6,1,2,0.5,2,2,1.0,0,5,5,1,0,0,1,1,9,-8,1,Jalen Smith,IND,IND,POR,,,15,14,10,6
22023,1630188,22300047,"NOV 24, 2023",IND vs. DET,W,21,2,3,0.667,2,2,1.0,2,2,1.0,1,5,6,0,1,0,1,1,8,0,1,Jalen Smith,IND,IND,DET,,,14,14,8,6
22023,1630188,22300230,"NOV 22, 2023",IND vs. TOR,L,19,3,5,0.6,0,1,0.0,2,2,1.0,0,5,5,0,0,1,1,2,8,-14,1,Jalen Smith,IND,IND,TOR,,,13,13,8,5
22023,1630188,22300039,"NOV 21, 2023",IND @ ATL,W,5,2,2,1.0,0,0,0.0,2,4,0.5,2,1,3,0,0,0,0,0,6,-10,1,Jalen Smith,IND,ATL,IND,,,9,9,6,3
22023,1630188,22300209,"NOV 19, 2023",IND vs. ORL,L,13,4,5,0.8,1,1,1.0,1,2,0.5,2,2,4,0,0,0,2,3,10,-9,1,Jalen Smith,IND,IND,ORL,,,14,14,10,4
22023,1630188,22300019,"NOV 14, 2023",IND @ PHI,W,3,2,2,1.0,1,1,1.0,0,1,0.0,0,0,0,1,0,0,0,2,5,-2,1,Jalen Smith,IND,PHI,IND,,,6,5,6,1
22023,1630188,22300180,"NOV 12, 2023",IND @ PHI,L,19,4,7,0.571,1,2,0.5,2,2,1.0,1,5,6,1,0,0,2,2,11,-5,1,Jalen Smith,IND,PHI,IND,,,18,17,12,7
22023,1630188,22300158,"NOV 08, 2023",IND vs. UTA,W,25,5,8,0.625,0,0,0.0,6,7,0.857,3,8,11,1,2,1,1,0,16,12,1,Jalen Smith,IND,IND,UTA,,,28,27,17,12
22023,1630188,22300146,"NOV 06, 2023",IND vs. SAS,W,12,4,4,1.0,1,1,1.0,0,0,0.0,1,6,7,2,0,0,1,3,9,10,1,Jalen Smith,IND,IND,SAS,,,18,16,11,9
22023,1630188,22300133,"NOV 04, 2023",IND vs. CHA,L,21,4,6,0.667,2,3,0.667,1,2,0.5,3,6,9,1,0,0,1,4,11,-13,1,Jalen Smith,IND,IND,CHA,,,21,20,12,10
22023,1630188,22300001,"NOV 03, 2023",IND vs. CLE,W,17,6,8,0.75,1,1,1.0,0,0,0.0,2,3,5,2,0,1,3,2,13,-4,1,Jalen Smith,IND,IND,CLE,,,20,18,15,7
22023,1630188,22300102,"OCT 30, 2023",IND vs. CHI,L,16,4,7,0.571,0,2,0.0,0,0,0.0,0,2,2,0,1,1,1,3,8,2,1,Jalen Smith,IND,IND,CHI,,,10,10,8,2
22023,1630188,22300091,"OCT 28, 2023",IND @ CLE,W,19,5,7,0.714,2,3,0.667,1,2,0.5,2,4,6,3,0,0,1,2,13,17,1,Jalen Smith,IND,CLE,IND,,,22,19,16,9
22023,1630188,22300064,"OCT 25, 2023",IND vs. WAS,W,13,5,6,0.833,2,2,1.0,1,1,1.0,3,5,8,0,1,0,0,4,13,6,1,Jalen Smith,IND,IND,WAS,,,21,21,13,8
22023,1628372,22300562,"JAN 15, 2024",BKN vs. MIA,L,32,3,8,0.375,1,4,0.25,1,2,0.5,1,4,5,5,4,1,2,2,8,10,1,Dennis Smith Jr.,BKN,BKN,MIA,,,18,13,13,10
22023,1628372,22300527,"JAN 11, 2024",BKN @ CLE,L,23,1,2,0.5,0,0,0.0,0,0,0.0,1,3,4,5,0,1,1,1,2,6,1,Dennis Smith Jr.,BKN,CLE,BKN,,,11,6,7,9
22023,1628372,22300498,"JAN 07, 2024",BKN vs. POR,L,29,3,8,0.375,0,1,0.0,4,4,1.0,0,2,2,10,2,1,1,6,10,-19,1,Dennis Smith Jr.,BKN,BKN,POR,,,22,12,20,12
22023,1628372,22300481,"JAN 05, 2024",BKN vs. OKC,W,25,6,11,0.545,1,4,0.25,0,0,0.0,6,6,12,7,2,0,0,4,13,14,1,Dennis Smith Jr.,BKN,BKN,OKC,,,32,25,20,19
22023,1628372,22300461,"JAN 02, 2024",BKN @ NOP,L,20,3,7,0.429,2,4,0.5,1,2,0.5,0,1,1,4,1,0,1,1,9,-5,1,Dennis Smith Jr.,BKN,NOP,BKN,,,14,10,13,5
22023,1628372,22300447,"DEC 31, 2023",BKN @ OKC,L,15,2,3,0.667,0,1,0.0,3,3,1.0,1,2,3,4,1,0,3,4,7,-7,1,Dennis Smith Jr.,BKN,OKC,BKN,,,14,10,11,7
22023,1628372,22300430,"DEC 29, 2023",BKN @ WAS,L,20,2,6,0.333,0,1,0.0,1,2,0.5,0,2,2,3,2,0,0,3,5,-21,1,Dennis Smith Jr.,BKN,WAS,BKN,,,10,7,8,5
22023,1628372,22300417,"DEC 27, 2023",BKN vs. MIL,L,30,7,17,0.412,0,4,0.0,0,0,0.0,1,6,7,8,1,0,2,0,14,-11,1,Dennis Smith Jr.,BKN,BKN,MIL,,,29,21,22,15
22023,1628372,22300406,"DEC 26, 2023",BKN @ DET,W,21,3,8,0.375,0,1,0.0,0,0,0.0,0,2,2,3,1,0,3,3,6,3,1,Dennis Smith Jr.,BKN,DET,BKN,,,11,8,9,5
22023,1628372,22300394,"DEC 23, 2023",BKN vs. DET,W,19,2,6,0.333,1,2,0.5,1,2,0.5,0,0,0,3,0,0,1,3,6,0,1,Dennis Smith Jr.,BKN,BKN,DET,,,9,6,9,3
22023,1628372,22300383,"DEC 22, 2023",BKN vs. DEN,L,19,2,7,0.286,1,4,0.25,2,2,1.0,1,3,4,5,1,0,0,5,7,9,1,Dennis Smith Jr.,BKN,BKN,DEN,,,16,11,12,9
22023,1628372,22301209,"DEC 06, 2023",BKN @ ATL,W,22,4,7,0.571,0,0,0.0,5,5,1.0,2,1,3,4,2,0,0,3,13,5,1,Dennis Smith Jr.,BKN,ATL,BKN,,,20,16,17,7
22023,1628372,22300282,"DEC 02, 2023",BKN vs. ORL,W,21,5,10,0.5,0,3,0.0,0,1,0.0,1,10,11,6,2,1,1,0,10,18,1,Dennis Smith Jr.,BKN,BKN,ORL,,,27,21,16,17
22023,1628372,22300200,"NOV 16, 2023",BKN @ MIA,L,16,2,6,0.333,1,2,0.5,0,0,0.0,0,2,2,5,0,0,0,2,5,-9,1,Dennis Smith Jr.,BKN,MIA,BKN,,,12,7,10,7
22023,1628372,22300020,"NOV 14, 2023",BKN vs. ORL,W,19,3,7,0.429,0,1,0.0,0,0,0.0,1,2,3,5,2,0,1,3,6,9,1,Dennis Smith Jr.,BKN,BKN,ORL,,,14,9,11,8
22023,1628372,22300178,"NOV 12, 2023",BKN vs. WAS,W,19,2,4,0.5,2,2,1.0,2,2,1.0,1,3,4,6,0,0,4,1,8,-10,1,Dennis Smith Jr.,BKN,BKN,WAS,,,18,12,14,10
22023,1628372,22300010,"NOV 10, 2023",BKN @ BOS,L,27,5,10,0.5,0,1,0.0,4,4,1.0,1,3,4,7,0,0,0,4,14,1,1,Dennis Smith Jr.,BKN,BOS,BKN,,,25,18,21,11
22023,1628372,22300160,"NOV 08, 2023",BKN vs. LAC,W,25,2,7,0.286,0,3,0.0,0,0,0.0,1,0,1,5,2,0,1,4,4,5,1,Dennis Smith Jr.,BKN,BKN,LAC,,,10,5,9,6
22023,1628372,22300149,"NOV 06, 2023",BKN vs. MIL,L,11,1,3,0.333,0,0,0.0,0,0,0.0,0,0,0,1,0,0,0,1,2,-14,1,Dennis Smith Jr.,BKN,BKN,MIL,,,3,2,3,1
22023,1628372,22300136,"NOV 04, 2023",BKN vs. BOS,L,15,2,5,0.4,1,4,0.25,0,0,0.0,0,1,1,1,1,2,1,3,5,-5,1,Dennis Smith Jr.,BKN,BKN,BOS,,,7,6,6,2
22023,1628372,22300004,"NOV 03, 2023",BKN @ CHI,W,16,3,9,0.333,1,2,0.5,0,0,0.0,1,0,1,1,1,0,1,0,7,8,1,Dennis Smith Jr.,BKN,CHI,BKN,,,9,8,8,2
22023,1628372,22300101,"OCT 30, 2023",BKN @ CHA,W,14,1,4,0.25,0,1,0.0,1,2,0.5,1,3,4,2,1,0,1,2,3,7,1,Dennis Smith Jr.,BKN,CHA,BKN,,,9,7,5,6
22023,1628372,22300084,"OCT 27, 2023",BKN @ DAL,L,8,0,3,0.0,0,0,0.0,0,0,0.0,0,1,1,1,0,0,1,4,0,-7,1,Dennis Smith Jr.,BKN,DAL,BKN,,,2,1,1,2
22023,1628372,22300067,"OCT 25, 2023",BKN vs. CLE,L,16,4,5,0.8,2,3,0.667,0,0,0.0,2,2,4,1,0,0,1,1,10,5,1,Dennis Smith Jr.,BKN,BKN,CLE,,,15,14,11,5
22023,1631095,22300555,"JAN 15, 2024",HOU @ PHI,L,31,5,9,0.556,0,1,0.0,3,5,0.6,1,6,7,2,0,0,2,3,13,-8,1,Jabari Smith Jr.,HOU,PHI,HOU,,,22,20,15,9
22023,1631095,22300542,"JAN 13, 2024",HOU @ BOS,L,27,4,11,0.364,0,4,0.0,1,1,1.0,1,5,6,2,0,0,2,2,9,-20,1,Jabari Smith Jr.,HOU,BOS,HOU,,,17,15,11,8
22023,1631095,22300534,"JAN 12, 2024",HOU @ DET,W,41,7,15,0.467,1,3,0.333,4,4,1.0,5,6,11,1,1,2,1,0,19,-3,1,Jabari Smith Jr.,HOU,DET,HOU,,,31,30,20,12
22023,1631095,22300523,"JAN 10, 2024",HOU @ CHI,L,47,7,14,0.5,4,9,0.444,0,0,0.0,2,13,15,1,0,1,2,3,18,8,1,Jabari Smith Jr.,HOU,CHI,HOU,,,34,33,19,16
22023,1631095,22300509,"JAN 08, 2024",HOU @ MIA,L,32,3,13,0.231,1,5,0.2,3,3,1.0,3,3,6,0,0,0,1,3,10,-11,1,Jabari Smith Jr.,HOU,MIA,HOU,,,16,16,10,6
22023,1631095,22300496,"JAN 06, 2024",HOU vs. MIL,W,40,3,7,0.429,3,5,0.6,5,6,0.833,1,11,12,2,2,1,1,4,14,1,1,Jabari Smith Jr.,HOU,HOU,MIL,,,28,26,16,14
22023,1631095,22300485,"JAN 05, 2024",HOU vs. MIN,L,32,6,13,0.462,3,5,0.6,1,2,0.5,1,8,9,2,0,0,4,3,16,-12,1,Jabari Smith Jr.,HOU,HOU,MIN,,,27,25,18,11
22023,1631095,22300469,"JAN 03, 2024",HOU vs. BKN,W,33,2,8,0.25,1,4,0.25,2,2,1.0,1,11,12,0,0,1,1,4,7,11,1,Jabari Smith Jr.,HOU,HOU,BKN,,,19,19,7,12
22023,1631095,22300453,"JAN 01, 2024",HOU vs. DET,W,27,3,7,0.429,3,5,0.6,0,0,0.0,0,6,6,1,0,1,1,1,9,20,1,Jabari Smith Jr.,HOU,HOU,DET,,,16,15,10,7
22023,1631095,22300418,"DEC 27, 2023",HOU vs. PHX,L,22,2,5,0.4,1,3,0.333,4,4,1.0,0,3,3,0,2,0,1,1,9,-11,1,Jabari Smith Jr.,HOU,HOU,PHX,,,12,12,9,3
22023,1631095,22300409,"DEC 26, 2023",HOU vs. IND,L,34,4,11,0.364,0,5,0.0,2,2,1.0,2,4,6,0,1,1,0,4,10,-13,1,Jabari Smith Jr.,HOU,HOU,IND,,,16,16,10,6
22023,1631095,22300392,"DEC 23, 2023",HOU @ NOP,W,37,10,14,0.714,4,5,0.8,2,3,0.667,4,7,11,2,1,1,1,3,26,1,1,Jabari Smith Jr.,HOU,NOP,HOU,,,39,37,28,13
22023,1631095,22300385,"DEC 22, 2023",HOU vs. DAL,W,31,8,13,0.615,1,3,0.333,4,5,0.8,2,6,8,1,0,0,1,0,21,37,1,Jabari Smith Jr.,HOU,HOU,DAL,,,30,29,22,9
22023,1631095,22300371,"DEC 20, 2023",HOU vs. ATL,L,42,8,14,0.571,4,7,0.571,14,14,1.0,5,8,13,1,0,4,0,3,34,3,1,Jabari Smith Jr.,HOU,HOU,ATL,,,48,47,35,14
22023,1631095,22300349,"DEC 18, 2023",HOU @ CLE,L,23,2,7,0.286,1,4,0.25,0,0,0.0,3,4,7,0,0,0,2,4,5,-17,1,Jabari Smith Jr.,HOU,CLE,HOU,,,12,12,5,7
22023,1631095,22300346,"DEC 17, 2023",HOU @ MIL,L,28,7,13,0.538,1,4,0.25,1,1,1.0,0,5,5,2,0,1,0,5,16,-4,1,Jabari Smith Jr.,HOU,MIL,HOU,,,23,21,18,7
22023,1631095,22300332,"DEC 15, 2023",HOU @ MEM,W,30,1,9,0.111,1,4,0.25,2,2,1.0,3,9,12,2,0,1,1,5,5,-2,1,Jabari Smith Jr.,HOU,MEM,HOU,,,19,17,7,14
22023,1631095,22300314,"DEC 13, 2023",HOU vs. MEM,W,30,7,10,0.7,3,5,0.6,3,6,0.5,2,8,10,1,1,1,1,2,20,11,1,Jabari Smith Jr.,HOU,HOU,MEM,,,31,30,21,11
22023,1631095,22300298,"DEC 11, 2023",HOU vs. SAS,W,36,3,12,0.25,1,3,0.333,2,2,1.0,3,9,12,5,1,1,1,3,9,15,1,Jabari Smith Jr.,HOU,HOU,SAS,,,26,21,14,17
22023,1631095,22301224,"DEC 08, 2023",HOU @ DEN,W,25,3,9,0.333,0,2,0.0,3,4,0.75,4,6,10,5,0,0,1,1,9,-2,1,Jabari Smith Jr.,HOU,DEN,HOU,,,24,19,14,15
22023,1631095,22301212,"DEC 06, 2023",HOU vs. OKC,W,32,2,4,0.5,1,1,1.0,1,1,1.0,4,14,18,1,0,0,3,1,6,9,1,Jabari Smith Jr.,HOU,HOU,OKC,,,25,24,7,19
22023,1631095,22300291,"DEC 02, 2023",HOU @ LAL,L,30,4,7,0.571,0,3,0.0,2,2,1.0,1,8,9,3,2,3,3,5,10,-16,1,Jabari Smith Jr.,HOU,LAL,HOU,,,22,19,13,12
22023,1631095,22300263,"NOV 29, 2023",HOU @ DEN,L,32,6,14,0.429,2,7,0.286,1,2,0.5,1,6,7,2,0,1,0,3,15,-22,1,Jabari Smith Jr.,HOU,DEN,HOU,,,24,22,17,9
22023,1631095,22300059,"NOV 28, 2023",HOU @ DAL,L,37,7,11,0.636,2,5,0.4,0,0,0.0,1,8,9,2,0,1,1,2,16,-5,1,Jabari Smith Jr.,HOU,DAL,HOU,,,27,25,18,11
22023,1631095,22300048,"NOV 24, 2023",HOU vs. DEN,W,38,6,9,0.667,2,3,0.667,2,2,1.0,3,12,15,1,1,1,2,2,16,16,1,Jabari Smith Jr.,HOU,HOU,DEN,,,32,31,17,16
22023,1631095,22300231,"NOV 22, 2023",HOU vs. MEM,W,27,6,10,0.6,3,4,0.75,3,4,0.75,0,9,9,2,0,1,0,2,18,4,1,Jabari Smith Jr.,HOU,HOU,MEM,,,29,27,20,11
22023,1631095,22300224,"NOV 20, 2023",HOU @ GSW,L,32,7,12,0.583,1,5,0.2,2,2,1.0,2,7,9,2,1,2,2,4,17,1,1,Jabari Smith Jr.,HOU,GSW,HOU,,,28,26,19,11
22023,1631095,22300216,"NOV 19, 2023",HOU @ LAL,L,32,5,10,0.5,2,6,0.333,2,2,1.0,1,4,5,1,1,0,3,4,14,-5,1,Jabari Smith Jr.,HOU,LAL,HOU,,,20,19,15,6
22023,1631095,22300037,"NOV 17, 2023",HOU @ LAC,L,33,4,12,0.333,1,4,0.25,0,0,0.0,2,5,7,0,1,1,0,5,9,-3,1,Jabari Smith Jr.,HOU,LAC,HOU,,,16,16,9,7
22023,1631095,22300182,"NOV 12, 2023",HOU vs. DEN,W,20,4,7,0.571,0,2,0.0,0,0,0.0,2,5,7,0,0,1,1,1,8,-6,1,Jabari Smith Jr.,HOU,HOU,DEN,,,15,15,8,7
22023,1631095,22300011,"NOV 10, 2023",HOU vs. NOP,W,23,2,8,0.25,1,4,0.25,1,1,1.0,1,6,7,2,0,0,2,3,6,-8,1,Jabari Smith Jr.,HOU,HOU,NOP,,,15,13,8,9
22023,1631095,22300163,"NOV 08, 2023",HOU vs. LAL,W,26,4,8,0.5,2,4,0.5,2,2,1.0,1,5,6,0,1,0,2,2,12,19,1,Jabari Smith Jr.,HOU,HOU,LAL,,,18,18,12,6
22023,1631095,22300153,"NOV 06, 2023",HOU vs. SAC,W,22,5,8,0.625,3,5,0.6,0,0,0.0,0,4,4,0,0,1,0,4,13,10,1,Jabari Smith Jr.,HOU,HOU,SAC,,,17,17,13,4
22023,1631095,22300137,"NOV 04, 2023",HOU vs. SAC,W,35,9,15,0.6,3,6,0.5,0,0,0.0,3,8,11,0,0,1,0,4,21,4,1,Jabari Smith Jr.,HOU,HOU,SAC,,,32,32,21,11
22023,1631095,22300122,"NOV 01, 2023",HOU vs. CHA,W,30,7,10,0.7,3,5,0.6,0,0,0.0,0,6,6,4,0,1,2,3,17,-1,1,Jabari Smith Jr.,HOU,HOU,CHA,,,27,23,21,10
22023,1631095,22300096,"OCT 29, 2023",HOU vs. GSW,L,34,6,12,0.5,2,6,0.333,0,0,0.0,2,6,8,5,2,0,1,3,14,12,1,Jabari Smith Jr.,HOU,HOU,GSW,,,27,22,19,13
22023,1631095,22300083,"OCT 27, 2023",HOU @ SAS,L,37,5,16,0.313,2,8,0.25,1,4,0.25,4,5,9,0,1,0,2,4,13,-6,1,Jabari Smith Jr.,HOU,SAS,HOU,,,22,22,13,9
22023,1631095,22300066,"OCT 25, 2023",HOU @ ORL,L,26,3,9,0.333,0,4,0.0,1,2,0.5,1,4,5,1,1,0,1,6,7,-8,1,Jabari Smith Jr.,HOU,ORL,HOU,,,13,12,8,6
22023,1641733,22300551,"JAN 14, 2024",CHA @ MIA,L,16,2,5,0.4,0,2,0.0,0,0,0.0,0,2,2,0,0,0,2,0,4,-19,1,Nick Smith Jr.,CHA,MIA,CHA,,,6,6,4,2
22023,1641733,22300541,"JAN 12, 2024",CHA @ SAS,L,25,4,9,0.444,1,3,0.333,0,0,0.0,2,4,6,5,0,0,1,2,9,-16,1,Nick Smith Jr.,CHA,SAS,CHA,,,20,15,14,11
22023,1641733,22300518,"JAN 10, 2024",CHA vs. SAC,L,25,4,15,0.267,2,8,0.25,1,2,0.5,0,3,3,1,0,0,2,3,11,-22,1,Nick Smith Jr.,CHA,CHA,SAC,,,15,14,12,4
22023,1641733,22300506,"JAN 08, 2024",CHA vs. CHI,L,32,6,15,0.4,3,6,0.5,0,0,0.0,2,2,4,3,1,0,3,2,15,-4,1,Nick Smith Jr.,CHA,CHA,CHI,,,22,19,18,7
22023,1641733,22300484,"JAN 05, 2024",CHA @ CHI,L,16,4,6,0.667,2,2,1.0,0,0,0.0,0,2,2,0,1,0,1,0,10,-9,1,Nick Smith Jr.,CHA,CHI,CHA,,,12,12,10,2
22023,1641733,22300464,"JAN 02, 2024",CHA @ SAC,W,14,2,3,0.667,2,3,0.667,0,0,0.0,0,0,0,1,0,2,0,1,6,-2,1,Nick Smith Jr.,CHA,SAC,CHA,,,7,6,7,1
22023,1641733,22300455,"JAN 01, 2024",CHA @ DEN,L,19,2,8,0.25,1,3,0.333,0,0,0.0,2,1,3,2,0,1,2,2,5,10,1,Nick Smith Jr.,CHA,DEN,CHA,,,10,8,7,5
22023,1641733,22300436,"DEC 29, 2023",CHA @ PHX,L,13,4,7,0.571,2,4,0.5,0,0,0.0,1,1,2,1,0,0,1,1,10,-1,1,Nick Smith Jr.,CHA,PHX,CHA,,,13,12,11,3
22023,1641733,22300428,"DEC 28, 2023",CHA @ LAL,L,18,2,4,0.5,2,2,1.0,0,0,0.0,0,3,3,4,0,1,2,1,6,-1,1,Nick Smith Jr.,CHA,LAL,CHA,,,13,9,10,7
22023,1641733,22300414,"DEC 26, 2023",CHA @ LAC,L,12,2,5,0.4,1,4,0.25,0,0,0.0,0,0,0,1,0,0,0,3,5,-10,1,Nick Smith Jr.,CHA,LAC,CHA,,,6,5,6,1
22023,1641733,22300390,"DEC 23, 2023",CHA vs. DEN,L,25,6,12,0.5,5,7,0.714,2,2,1.0,1,2,3,2,0,0,1,2,19,6,1,Nick Smith Jr.,CHA,CHA,DEN,,,24,22,21,5
22023,1641733,22300365,"DEC 20, 2023",CHA @ IND,L,6,3,6,0.5,0,3,0.0,0,0,0.0,0,0,0,0,0,0,1,0,6,-5,1,Nick Smith Jr.,CHA,IND,CHA,,,6,6,6,0
22023,1641733,22300354,"DEC 18, 2023",CHA @ TOR,L,20,3,9,0.333,1,5,0.2,0,0,0.0,0,1,1,0,0,1,1,2,7,-12,1,Nick Smith Jr.,CHA,TOR,CHA,,,8,8,7,1
22023,1641733,22300335,"DEC 16, 2023",CHA vs. PHI,L,26,4,8,0.5,1,4,0.25,0,0,0.0,1,0,1,1,0,0,0,2,9,-35,1,Nick Smith Jr.,CHA,CHA,PHI,,,11,10,10,2
22023,1641733,22300266,"NOV 30, 2023",CHA @ BKN,W,14,3,4,0.75,3,3,1.0,0,0,0.0,1,0,1,0,0,1,0,2,9,4,1,Nick Smith Jr.,CHA,BKN,CHA,,,10,10,9,1
22023,1641733,22300057,"NOV 28, 2023",CHA @ NYK,L,5,3,4,0.75,2,2,1.0,0,0,0.0,0,0,0,0,0,0,0,0,8,-1,1,Nick Smith Jr.,CHA,NYK,CHA,,,8,8,8,0
22023,1641733,22300225,"NOV 22, 2023",CHA vs. WAS,W,1,1,1,1.0,0,0,0.0,0,0,0.0,0,0,0,0,0,0,0,1,2,-6,1,Nick Smith Jr.,CHA,CHA,WAS,,,2,2,2,0
22023,1641733,22300027,"NOV 17, 2023",CHA vs. MIL,L,9,1,6,0.167,0,1,0.0,0,0,0.0,1,1,2,0,0,1,1,1,2,-18,1,Nick Smith Jr.,CHA,CHA,MIL,,,4,4,2,2
22023,1641733,22300017,"NOV 14, 2023",CHA vs. MIA,L,15,1,2,0.5,1,1,1.0,0,0,0.0,0,1,1,0,0,0,0,1,3,-2,1,Nick Smith Jr.,CHA,CHA,MIA,,,4,4,3,1
22023,1641733,22300177,"NOV 12, 2023",CHA @ NYK,L,8,1,6,0.167,1,4,0.25,0,0,0.0,0,0,0,2,0,0,0,0,3,6,1,Nick Smith Jr.,CHA,NYK,CHA,,,5,3,5,2
22023,1641733,22300157,"NOV 08, 2023",CHA vs. WAS,L,4,2,2,1.0,1,1,1.0,0,0,0.0,0,1,1,0,1,0,1,0,5,4,1,Nick Smith Jr.,CHA,CHA,WAS,,,6,6,5,1
22023,1641733,22300063,"OCT 25, 2023",CHA vs. ATL,W,1,0,0,0.0,0,0,0.0,0,0,0.0,0,0,0,0,0,0,0,0,0,0,1,Nick Smith Jr.,CHA,CHA,ATL,,,0,0,0,0
22023,1631110,22300559,"JAN 15, 2024",SAS @ ATL,L,38,8,16,0.5,2,4,0.5,5,5,1.0,3,5,8,4,2,2,4,4,23,-4,1,Jeremy Sochan,SAS,ATL,SAS,,,35,31,27,12
22023,1631110,22300548,"JAN 13, 2024",SAS vs. CHI,L,31,4,15,0.267,2,6,0.333,1,1,1.0,4,3,7,2,0,0,1,3,11,-10,1,Jeremy Sochan,SAS,SAS,CHI,,,20,18,13,9
22023,1631110,22300541,"JAN 12, 2024",SAS vs. CHA,W,26,5,7,0.714,1,2,0.5,2,3,0.667,0,6,6,4,2,1,1,0,13,35,1,Jeremy Sochan,SAS,SAS,CHA,,,23,19,17,10
22023,1631110,22300519,"JAN 10, 2024",SAS @ DET,W,28,7,15,0.467,1,2,0.5,0,0,0.0,1,3,4,2,0,0,1,1,15,12,1,Jeremy Sochan,SAS,DET,SAS,,,21,19,17,6
22023,1631110,22300497,"JAN 07, 2024",SAS @ CLE,L,28,4,9,0.444,2,5,0.4,1,1,1.0,1,4,5,4,0,0,1,2,11,16,1,Jeremy Sochan,SAS,CLE,SAS,,,20,16,15,9
22023,1631110,22300477,"JAN 04, 2024",SAS vs. MIL,L,33,3,11,0.273,1,5,0.2,2,2,1.0,2,6,8,5,2,1,1,1,9,-14,1,Jeremy Sochan,SAS,SAS,MIL,,,22,17,14,13
22023,1631110,22300460,"JAN 02, 2024",SAS @ MEM,L,28,4,6,0.667,1,2,0.5,3,4,0.75,0,2,2,1,0,2,1,1,12,1,1,Jeremy Sochan,SAS,MEM,SAS,,,15,14,13,3
22023,1631110,22300448,"DEC 31, 2023",SAS vs. BOS,L,24,4,11,0.364,1,4,0.25,0,0,0.0,0,3,3,5,0,0,1,1,9,-25,1,Jeremy Sochan,SAS,SAS,BOS,,,17,12,14,8
22023,1631110,22300437,"DEC 29, 2023",SAS @ POR,L,29,0,3,0.0,0,0,0.0,2,2,1.0,1,3,4,4,1,0,3,2,2,-15,1,Jeremy Sochan,SAS,POR,SAS,,,10,6,6,8
22023,1631110,22300427,"DEC 28, 2023",SAS @ POR,W,31,6,10,0.6,0,2,0.0,4,5,0.8,1,6,7,3,0,1,2,4,16,17,1,Jeremy Sochan,SAS,POR,SAS,,,26,23,19,10
22023,1631110,22300412,"DEC 26, 2023",SAS vs. UTA,L,27,7,10,0.7,3,4,0.75,2,2,1.0,2,3,5,3,0,0,0,2,19,-15,1,Jeremy Sochan,SAS,SAS,UTA,,,27,24,22,8
22023,1631110,22300398,"DEC 23, 2023",SAS @ DAL,L,30,9,16,0.563,4,6,0.667,1,2,0.5,2,7,9,4,0,0,3,2,23,-23,1,Jeremy Sochan,SAS,DAL,SAS,,,36,32,27,13
22023,1631110,22300376,"DEC 21, 2023",SAS @ CHI,L,34,4,8,0.5,1,2,0.5,0,0,0.0,3,4,7,2,1,0,1,0,9,-12,1,Jeremy Sochan,SAS,CHI,SAS,,,18,16,11,9
22023,1631110,22300361,"DEC 19, 2023",SAS @ MIL,L,33,4,11,0.364,0,2,0.0,1,2,0.5,3,8,11,8,1,0,0,3,9,-13,1,Jeremy Sochan,SAS,MIL,SAS,,,28,20,17,19
22023,1631110,22300345,"DEC 17, 2023",SAS vs. NOP,L,25,1,7,0.143,0,0,0.0,3,4,0.75,1,2,3,4,1,0,0,1,5,-15,1,Jeremy Sochan,SAS,SAS,NOP,,,12,8,9,7
22023,1631110,22300331,"DEC 15, 2023",SAS vs. LAL,W,27,5,10,0.5,0,3,0.0,1,1,1.0,1,7,8,2,1,1,1,3,11,21,1,Jeremy Sochan,SAS,SAS,LAL,,,21,19,13,10
22023,1631110,22300316,"DEC 13, 2023",SAS vs. LAL,L,29,2,9,0.222,1,4,0.25,0,2,0.0,4,4,8,5,0,0,3,3,5,-4,1,Jeremy Sochan,SAS,SAS,LAL,,,18,13,10,13
22023,1631110,22300298,"DEC 11, 2023",SAS @ HOU,L,35,3,11,0.273,1,5,0.2,0,0,0.0,2,4,6,2,1,0,2,2,7,-8,1,Jeremy Sochan,SAS,HOU,SAS,,,15,13,9,8
22023,1631110,22301223,"DEC 08, 2023",SAS vs. CHI,L,34,2,6,0.333,0,2,0.0,0,0,0.0,0,3,3,4,0,1,5,3,4,-9,1,Jeremy Sochan,SAS,SAS,CHI,,,11,7,8,7
22023,1631110,22301210,"DEC 06, 2023",SAS @ MIN,L,22,3,10,0.3,0,2,0.0,0,0,0.0,1,1,2,0,0,1,1,1,6,-5,1,Jeremy Sochan,SAS,MIN,SAS,,,8,8,6,2
22023,1631110,22300278,"DEC 01, 2023",SAS @ NOP,L,31,4,13,0.308,2,4,0.5,3,4,0.75,0,3,3,4,0,0,2,2,13,-9,1,Jeremy Sochan,SAS,NOP,SAS,,,20,16,17,7
22023,1631110,22300272,"NOV 30, 2023",SAS vs. ATL,L,36,12,14,0.857,3,3,1.0,6,6,1.0,3,5,8,6,1,0,5,5,33,-4,1,Jeremy Sochan,SAS,SAS,ATL,,,47,41,39,14
22023,1631110,22300252,"NOV 26, 2023",SAS @ DEN,L,17,2,6,0.333,0,1,0.0,0,0,0.0,0,2,2,3,0,0,3,0,4,-14,1,Jeremy Sochan,SAS,DEN,SAS,,,9,6,7,5
22023,1631110,22300051,"NOV 24, 2023",SAS @ GSW,L,33,3,7,0.429,1,2,0.5,0,0,0.0,3,3,6,4,0,0,2,2,7,1,1,Jeremy Sochan,SAS,GSW,SAS,,,17,13,11,10
22023,1631110,22300235,"NOV 22, 2023",SAS vs. LAC,L,32,6,15,0.4,2,5,0.4,5,6,0.833,2,3,5,7,0,0,1,3,19,5,1,Jeremy Sochan,SAS,SAS,LAC,,,31,24,26,12
22023,1631110,22300223,"NOV 20, 2023",SAS vs. LAC,L,29,3,12,0.25,0,3,0.0,2,2,1.0,2,6,8,1,0,0,1,1,8,-12,1,Jeremy Sochan,SAS,SAS,LAC,,,17,16,9,9
22023,1631110,22300206,"NOV 18, 2023",SAS vs. MEM,L,32,5,8,0.625,1,2,0.5,5,6,0.833,2,3,5,3,2,0,3,3,16,-6,1,Jeremy Sochan,SAS,SAS,MEM,,,24,21,19,8
22023,1631110,22300032,"NOV 17, 2023",SAS vs. SAC,L,37,3,11,0.273,1,3,0.333,1,2,0.5,1,7,8,6,1,0,2,4,8,-3,1,Jeremy Sochan,SAS,SAS,SAC,,,22,16,14,14
22023,1631110,22300021,"NOV 14, 2023",SAS @ OKC,L,28,4,11,0.364,1,1,1.0,0,0,0.0,1,2,3,5,0,0,3,2,9,-31,1,Jeremy Sochan,SAS,OKC,SAS,,,17,12,14,8
22023,1631110,22300184,"NOV 12, 2023",SAS vs. MIA,L,34,6,9,0.667,2,3,0.667,2,2,1.0,1,4,5,3,0,2,3,4,16,-5,1,Jeremy Sochan,SAS,SAS,MIA,,,24,21,19,8
22023,1631110,22300013,"NOV 10, 2023",SAS vs. MIN,L,30,6,11,0.545,1,1,1.0,1,2,0.5,3,4,7,5,3,0,6,3,14,-8,1,Jeremy Sochan,SAS,SAS,MIN,,,26,21,19,12
22023,1631110,22300161,"NOV 08, 2023",SAS @ NYK,L,29,7,12,0.583,2,4,0.5,0,0,0.0,0,6,6,5,0,0,0,5,16,-19,1,Jeremy Sochan,SAS,NYK,SAS,,,27,22,21,11
22023,1631110,22300146,"NOV 06, 2023",SAS @ IND,L,21,3,9,0.333,0,1,0.0,0,0,0.0,1,2,3,1,0,0,2,2,6,-18,1,Jeremy Sochan,SAS,IND,SAS,,,10,9,7,4
22023,1631110,22300141,"NOV 05, 2023",SAS vs. TOR,L,29,2,8,0.25,0,1,0.0,0,0,0.0,1,3,4,5,3,0,3,1,4,-7,1,Jeremy Sochan,SAS,SAS,TOR,,,13,8,9,9
22023,1631110,22300131,"NOV 02, 2023",SAS @ PHX,W,26,7,13,0.538,0,0,0.0,0,0,0.0,1,4,5,9,0,1,1,4,14,0,1,Jeremy Sochan,SAS,PHX,SAS,,,28,19,23,14
22023,1631110,22300113,"OCT 31, 2023",SAS @ PHX,W,30,3,8,0.375,0,1,0.0,2,3,0.667,1,6,7,5,0,0,0,5,8,-7,1,Jeremy Sochan,SAS,PHX,SAS,,,20,15,13,12
22023,1631110,22300099,"OCT 29, 2023",SAS @ LAC,L,22,0,2,0.0,0,2,0.0,0,0,0.0,2,2,4,3,1,1,4,3,0,-30,1,Jeremy Sochan,SAS,LAC,SAS,,,7,4,3,7
22023,1631110,22300083,"OCT 27, 2023",SAS vs. HOU,W,26,5,9,0.556,0,1,0.0,4,4,1.0,1,4,5,4,2,0,2,3,14,-8,1,Jeremy Sochan,SAS,SAS,HOU,,,23,19,18,9
22023,1631110,22300073,"OCT 25, 2023",SAS vs. DAL,L,29,4,12,0.333,2,4,0.5,3,6,0.5,3,5,8,5,1,0,3,4,13,-10,1,Jeremy Sochan,SAS,SAS,DAL,,,26,21,18,13
22023,1630531,22300532,"JAN 12, 2024",PHI vs. SAC,W,3,1,3,0.333,0,0,0.0,0,0,0.0,0,1,1,0,0,0,0,1,2,1,1,Jaden Springer,PHI,PHI,SAC,,,3,3,2,1
22023,1630531,22300521,"JAN 10, 2024",PHI @ ATL,L,13,1,2,0.5,0,0,0.0,0,0,0.0,0,1,1,0,1,0,0,2,2,-3,1,Jaden Springer,PHI,ATL,PHI,,,3,3,2,1
22023,1630531,22300495,"JAN 06, 2024",PHI vs. UTA,L,13,0,3,0.0,0,3,0.0,0,0,0.0,1,1,2,2,0,0,0,1,0,-15,1,Jaden Springer,PHI,PHI,UTA,,,4,2,2,4
22023,1630531,22300483,"JAN 05, 2024",PHI vs. NYK,L,15,1,7,0.143,0,3,0.0,1,2,0.5,1,0,1,1,1,1,0,1,3,-12,1,Jaden Springer,PHI,PHI,NYK,,,5,4,4,2
22023,1630531,22300459,"JAN 02, 2024",PHI vs. CHI,W,21,2,4,0.5,0,2,0.0,0,0,0.0,2,0,2,2,1,1,2,4,4,-15,1,Jaden Springer,PHI,PHI,CHI,,,8,6,6,4
22023,1630531,22300415,"DEC 27, 2023",PHI @ ORL,W,1,0,0,0.0,0,0,0.0,0,0,0.0,0,0,0,0,0,0,1,0,0,-3,1,Jaden Springer,PHI,ORL,PHI,,,0,0,0,0
22023,1630531,22300404,"DEC 25, 2023",PHI @ MIA,L,1,0,0,0.0,0,0,0.0,0,0,0.0,0,0,0,0,0,0,0,0,0,-2,1,Jaden Springer,PHI,MIA,PHI,,,0,0,0,0
22023,1630531,22300382,"DEC 22, 2023",PHI vs. TOR,W,1,0,0,0.0,0,0,0.0,0,0,0.0,0,0,0,0,0,0,0,0,0,-3,1,Jaden Springer,PHI,PHI,TOR,,,0,0,0,0
22023,1630531,22300367,"DEC 20, 2023",PHI vs. MIN,W,2,0,0,0.0,0,0,0.0,0,0,0.0,0,0,0,1,0,0,0,0,0,2,1,Jaden Springer,PHI,PHI,MIN,,,1,0,1,1
22023,1630531,22300335,"DEC 16, 2023",PHI @ CHA,W,12,2,5,0.4,0,0,0.0,2,2,1.0,1,1,2,1,1,0,2,0,6,12,1,Jaden Springer,PHI,CHA,PHI,,,9,8,7,3
22023,1630531,22300327,"DEC 15, 2023",PHI vs. DET,W,12,4,9,0.444,1,3,0.333,0,0,0.0,1,1,2,3,2,1,0,3,9,0,1,Jaden Springer,PHI,PHI,DET,,,14,11,12,5
22023,1630531,22300310,"DEC 13, 2023",PHI @ DET,W,7,1,2,0.5,1,1,1.0,2,4,0.5,0,0,0,2,0,0,0,1,5,-12,1,Jaden Springer,PHI,DET,PHI,,,7,5,7,2
22023,1630531,22300295,"DEC 11, 2023",PHI vs. WAS,W,9,2,5,0.4,0,1,0.0,2,2,1.0,0,0,0,0,2,0,1,3,6,4,1,Jaden Springer,PHI,PHI,WAS,,,6,6,6,0
22023,1630531,22300232,"NOV 22, 2023",PHI @ MIN,L,8,0,4,0.0,0,2,0.0,0,0,0.0,2,1,3,1,1,0,2,1,0,2,1,Jaden Springer,PHI,MIN,PHI,,,4,3,1,4
22023,1630531,22300040,"NOV 21, 2023",PHI vs. CLE,L,7,0,1,0.0,0,0,0.0,0,0,0.0,1,0,1,0,0,0,1,2,0,-7,1,Jaden Springer,PHI,PHI,CLE,,,1,1,0,1
22023,1630531,22300208,"NOV 19, 2023",PHI @ BKN,W,21,3,6,0.5,2,4,0.5,2,2,1.0,2,3,5,2,0,0,0,1,10,-1,1,Jaden Springer,PHI,BKN,PHI,,,17,15,12,7
22023,1630531,22300029,"NOV 17, 2023",PHI @ ATL,W,22,3,7,0.429,0,2,0.0,2,2,1.0,3,0,3,2,1,2,3,3,8,0,1,Jaden Springer,PHI,ATL,PHI,,,13,11,10,5
22023,1630531,22300194,"NOV 15, 2023",PHI vs. BOS,L,20,4,5,0.8,1,1,1.0,0,0,0.0,0,2,2,0,2,0,2,2,9,20,1,Jaden Springer,PHI,PHI,BOS,,,11,11,9,2
22023,1630531,22300008,"NOV 10, 2023",PHI @ DET,W,5,1,1,1.0,0,0,0.0,0,0,0.0,0,0,0,0,0,0,0,1,2,-6,1,Jaden Springer,PHI,DET,PHI,,,2,2,2,0
22023,1630531,22300148,"NOV 06, 2023",PHI vs. WAS,W,12,0,4,0.0,0,1,0.0,2,4,0.5,1,0,1,0,1,0,1,1,2,5,1,Jaden Springer,PHI,PHI,WAS,,,3,3,2,1
22023,1630531,22300132,"NOV 04, 2023",PHI vs. PHX,W,11,1,4,0.25,0,1,0.0,0,0,0.0,1,2,3,2,0,1,1,1,2,-6,1,Jaden Springer,PHI,PHI,PHX,,,7,5,4,5
22023,1630531,22300128,"NOV 02, 2023",PHI vs. TOR,W,9,0,1,0.0,0,0,0.0,0,0,0.0,1,1,2,1,0,0,1,1,0,8,1,Jaden Springer,PHI,PHI,TOR,,,3,2,1,3
22023,1630531,22300098,"OCT 29, 2023",PHI vs. POR,W,8,1,3,0.333,0,0,0.0,0,0,0.0,1,1,2,2,0,1,1,4,2,-1,1,Jaden Springer,PHI,PHI,POR,,,6,4,4,4
22023,1630531,22300075,"OCT 26, 2023",PHI @ MIL,L,5,0,1,0.0,0,1,0.0,0,0,0.0,0,0,0,0,0,2,0,1,0,-10,1,Jaden Springer,PHI,MIL,PHI,,,0,0,0,0
22023,1630205,22300542,"JAN 13, 2024",BOS vs. HOU,W,7,0,2,0.0,0,0,0.0,0,0,0.0,0,0,0,0,0,0,1,0,0,-2,1,Lamar Stevens,BOS,BOS,HOU,,,0,0,0,0
22023,1630205,22300528,"JAN 11, 2024",BOS @ MIL,L,19,1,6,0.167,0,0,0.0,3,4,0.75,1,3,4,0,0,1,0,2,5,3,1,Lamar Stevens,BOS,MIL,BOS,,,9,9,5,4
22023,1630205,22300479,"JAN 05, 2024",BOS vs. UTA,W,12,2,4,0.5,0,1,0.0,0,0,0.0,1,4,5,0,1,1,1,1,4,-3,1,Lamar Stevens,BOS,BOS,UTA,,,9,9,4,5
22023,1630205,22300448,"DEC 31, 2023",BOS @ SAS,W,7,1,1,1.0,0,0,0.0,0,0,0.0,0,2,2,2,0,0,0,0,2,-1,1,Lamar Stevens,BOS,SAS,BOS,,,6,4,4,4
22023,1630205,22300389,"DEC 23, 2023",BOS @ LAC,W,5,2,3,0.667,0,0,0.0,0,0,0.0,1,1,2,1,0,0,0,0,4,4,1,Lamar Stevens,BOS,LAC,BOS,,,7,6,5,3
22023,1630205,22300373,"DEC 20, 2023",BOS @ SAC,W,2,1,1,1.0,0,0,0.0,0,0,0.0,0,0,0,0,0,0,0,0,2,0,1,Lamar Stevens,BOS,SAC,BOS,,,2,2,2,0
22023,1630205,22300344,"DEC 17, 2023",BOS vs. ORL,W,2,0,0,0.0,0,0,0.0,0,0,0.0,0,0,0,0,0,0,0,1,0,-4,1,Lamar Stevens,BOS,BOS,ORL,,,0,0,0,0
22023,1630205,22300329,"DEC 15, 2023",BOS vs. ORL,W,14,3,7,0.429,1,3,0.333,1,2,0.5,1,2,3,0,2,1,1,2,8,-7,1,Lamar Stevens,BOS,BOS,ORL,,,11,11,8,3
22023,1630205,22300319,"DEC 14, 2023",BOS vs. CLE,W,9,1,3,0.333,0,2,0.0,2,2,1.0,0,1,1,1,1,1,0,3,4,1,1,Lamar Stevens,BOS,BOS,CLE,,,6,5,5,2
22023,1630205,22300053,"NOV 28, 2023",BOS vs. CHI,W,0,0,0,0.0,0,0,0.0,0,0,0.0,0,0,0,0,0,1,0,0,0,0,1,Lamar Stevens,BOS,BOS,CHI,,,0,0,0,0
22023,1630205,22300043,"NOV 24, 2023",BOS @ ORL,L,1,0,0,0.0,0,0,0.0,0,0,0.0,0,0,0,0,0,0,0,0,0,-2,1,Lamar Stevens,BOS,ORL,BOS,,,0,0,0,0
22023,1630205,22300213,"NOV 19, 2023",BOS @ MEM,W,3,0,0,0.0,0,0,0.0,0,0,0.0,0,1,1,0,0,0,0,1,0,-2,1,Lamar Stevens,BOS,MEM,BOS,,,1,1,0,1
22023,1630205,22300154,"NOV 06, 2023",BOS @ MIN,L,4,0,1,0.0,0,0,0.0,0,0,0.0,0,1,1,0,1,0,0,0,0,-5,1,Lamar Stevens,BOS,MIN,BOS,,,1,1,0,1
22023,1630205,22300118,"NOV 01, 2023",BOS vs. IND,W,7,2,4,0.5,0,0,0.0,0,0,0.0,2,0,2,2,0,0,0,2,4,6,1,Lamar Stevens,BOS,BOS,IND,,,8,6,6,4
22023,1630205,22300103,"OCT 30, 2023",BOS @ WAS,W,6,2,2,1.0,1,1,1.0,0,0,0.0,2,0,2,0,0,0,3,1,5,-4,1,Lamar Stevens,BOS,WAS,BOS,,,7,7,5,2
22023,1630191,22300558,"JAN 15, 2024",DET @ WAS,W,38,7,17,0.412,1,6,0.167,1,2,0.5,4,2,6,4,1,2,3,4,16,19,1,Isaiah Stewart,DET,WAS,DET,,,26,22,20,10
22023,1630191,22300534,"JAN 12, 2024",DET vs. HOU,L,29,6,13,0.462,3,8,0.375,1,2,0.5,0,7,7,1,0,0,3,1,16,-10,1,Isaiah Stewart,DET,DET,HOU,,,24,23,17,8
22023,1630191,22300406,"DEC 26, 2023",DET vs. BKN,L,36,2,7,0.286,1,2,0.5,2,4,0.5,4,7,11,4,0,0,0,2,7,12,1,Isaiah Stewart,DET,DET,BKN,,,22,18,11,15
22023,1630191,22300394,"DEC 23, 2023",DET @ BKN,L,33,8,9,0.889,4,5,0.8,0,0,0.0,1,4,5,5,1,1,0,5,20,-2,1,Isaiah Stewart,DET,BKN,DET,,,30,25,25,10
22023,1630191,22300374,"DEC 21, 2023",DET vs. UTA,L,32,3,4,0.75,1,1,1.0,0,1,0.0,2,8,10,4,0,1,0,0,7,12,1,Isaiah Stewart,DET,DET,UTA,,,21,17,11,14
22023,1630191,22300327,"DEC 15, 2023",DET @ PHI,L,20,2,6,0.333,0,1,0.0,0,0,0.0,1,3,4,0,0,1,2,4,4,-27,1,Isaiah Stewart,DET,PHI,DET,,,8,8,4,4
22023,1630191,22300310,"DEC 13, 2023",DET vs. PHI,L,22,1,3,0.333,0,1,0.0,2,2,1.0,2,2,4,2,0,0,2,3,4,-5,1,Isaiah Stewart,DET,DET,PHI,,,10,8,6,6
22023,1630191,22300293,"DEC 11, 2023",DET vs. IND,L,34,5,5,1.0,1,1,1.0,2,4,0.5,1,6,7,2,0,0,2,3,13,-10,1,Isaiah Stewart,DET,DET,IND,,,22,20,15,9
22023,1630191,22301217,"DEC 08, 2023",DET @ ORL,L,29,1,3,0.333,1,3,0.333,0,0,0.0,0,6,6,2,0,0,1,3,3,-19,1,Isaiah Stewart,DET,ORL,DET,,,11,9,5,8
22023,1630191,22301206,"DEC 06, 2023",DET vs. MEM,L,28,3,7,0.429,1,3,0.333,2,2,1.0,2,5,7,1,0,0,1,5,9,-4,1,Isaiah Stewart,DET,DET,MEM,,,17,16,10,8
22023,1630191,22300283,"DEC 02, 2023",DET vs. CLE,L,30,4,9,0.444,1,5,0.2,2,2,1.0,1,6,7,5,2,0,3,0,11,6,1,Isaiah Stewart,DET,DET,CLE,,,23,18,16,12
22023,1630191,22300268,"NOV 30, 2023",DET @ NYK,L,32,2,6,0.333,1,4,0.25,0,0,0.0,2,5,7,0,0,0,2,2,5,-4,1,Isaiah Stewart,DET,NYK,DET,,,12,12,5,7
22023,1630191,22300258,"NOV 29, 2023",DET vs. LAL,L,25,4,9,0.444,3,7,0.429,1,1,1.0,2,1,3,0,0,1,2,3,12,-20,1,Isaiah Stewart,DET,DET,LAL,,,15,15,12,3
22023,1630191,22300253,"NOV 27, 2023",DET vs. WAS,L,29,3,11,0.273,1,7,0.143,0,0,0.0,2,6,8,0,1,0,0,2,7,-2,1,Isaiah Stewart,DET,DET,WAS,,,15,15,7,8
22023,1630191,22300047,"NOV 24, 2023",DET @ IND,L,27,4,8,0.5,0,0,0.0,2,2,1.0,3,3,6,1,2,1,0,1,10,-11,1,Isaiah Stewart,DET,IND,DET,,,17,16,11,7
22023,1630191,22300218,"NOV 20, 2023",DET vs. DEN,L,35,4,8,0.5,1,2,0.5,2,2,1.0,1,10,11,1,0,2,1,3,11,-1,1,Isaiah Stewart,DET,DET,DEN,,,23,22,12,12
22023,1630191,22300211,"NOV 19, 2023",DET @ TOR,L,21,3,7,0.429,1,2,0.5,1,1,1.0,1,4,5,1,0,0,0,1,8,-11,1,Isaiah Stewart,DET,TOR,DET,,,14,13,9,6
22023,1630191,22300030,"NOV 17, 2023",DET @ CLE,L,31,4,11,0.364,1,4,0.25,2,2,1.0,4,6,10,2,1,2,1,0,11,1,1,Isaiah Stewart,DET,CLE,DET,,,23,21,13,12
22023,1630191,22300018,"NOV 14, 2023",DET vs. ATL,L,19,4,9,0.444,1,5,0.2,1,1,1.0,0,1,1,0,0,1,0,1,10,0,1,Isaiah Stewart,DET,DET,ATL,,,11,11,10,1
22023,1630191,22300181,"NOV 12, 2023",DET @ CHI,L,31,6,13,0.462,3,5,0.6,2,4,0.5,6,5,11,2,0,0,3,3,17,-10,1,Isaiah Stewart,DET,CHI,DET,,,30,28,19,13
22023,1630191,22300008,"NOV 10, 2023",DET vs. PHI,L,32,4,10,0.4,2,5,0.4,0,0,0.0,1,5,6,2,0,1,3,5,10,-16,1,Isaiah Stewart,DET,DET,PHI,,,18,16,12,8
22023,1630191,22300165,"NOV 08, 2023",DET @ MIL,L,37,3,9,0.333,2,7,0.286,0,0,0.0,1,3,4,1,0,2,1,4,8,-5,1,Isaiah Stewart,DET,MIL,DET,,,13,12,9,5
22023,1630191,22300145,"NOV 06, 2023",DET vs. GSW,L,39,5,9,0.556,3,5,0.6,4,4,1.0,2,9,11,4,0,1,3,3,17,-1,1,Isaiah Stewart,DET,DET,GSW,,,32,28,21,15
22023,1630191,22300140,"NOV 05, 2023",DET vs. PHX,L,34,3,6,0.5,1,2,0.5,1,2,0.5,0,2,2,1,0,0,3,0,8,-10,1,Isaiah Stewart,DET,DET,PHX,,,11,10,9,3
22023,1630191,22300129,"NOV 02, 2023",DET @ NOP,L,35,3,7,0.429,1,3,0.333,4,6,0.667,2,6,8,0,0,2,2,3,11,-18,1,Isaiah Stewart,DET,NOP,DET,,,19,19,11,8
22023,1630191,22300115,"NOV 01, 2023",DET vs. POR,L,33,5,8,0.625,2,4,0.5,0,0,0.0,2,4,6,4,1,0,2,5,12,3,1,Isaiah Stewart,DET,DET,POR,,,22,18,16,10
22023,1630191,22300109,"OCT 30, 2023",DET @ OKC,L,31,4,9,0.444,2,3,0.667,2,2,1.0,0,7,7,1,0,0,2,2,12,-7,1,Isaiah Stewart,DET,OKC,DET,,,20,19,13,8
22023,1630191,22300088,"OCT 28, 2023",DET vs. CHI,W,34,6,14,0.429,0,3,0.0,2,3,0.667,2,7,9,0,0,0,2,4,14,17,1,Isaiah Stewart,DET,DET,CHI,,,23,23,14,9
22023,1630191,22300077,"OCT 27, 2023",DET @ CHA,W,36,6,11,0.545,2,5,0.4,1,2,0.5,1,6,7,1,0,1,4,3,15,6,1,Isaiah Stewart,DET,CHA,DET,,,23,22,16,8
22023,1630191,22300068,"OCT 25, 2023",DET @ MIA,L,35,6,11,0.545,2,3,0.667,0,0,0.0,6,8,14,2,0,0,1,3,14,7,1,Isaiah Stewart,DET,MIA,DET,,,30,28,16,16
22023,1631124,22300478,"JAN 04, 2024",DEN @ GSW,W,9,0,1,0.0,0,1,0.0,0,0,0.0,1,0,1,1,1,0,0,0,0,-6,1,Julian Strawther,DEN,GSW,DEN,,,2,1,1,2
22023,1631124,22300455,"JAN 01, 2024",DEN vs. CHA,W,13,1,2,0.5,0,1,0.0,0,0,0.0,0,1,1,1,0,0,1,1,2,-14,1,Julian Strawther,DEN,DEN,CHA,,,4,3,3,2
22023,1631124,22300435,"DEC 29, 2023",DEN vs. OKC,L,12,3,7,0.429,1,4,0.25,3,4,0.75,0,1,1,0,0,0,3,3,10,-15,1,Julian Strawther,DEN,DEN,OKC,,,11,11,10,1
22023,1631124,22300425,"DEC 28, 2023",DEN vs. MEM,W,25,5,13,0.385,2,8,0.25,0,0,0.0,0,3,3,2,0,1,1,4,12,6,1,Julian Strawther,DEN,DEN,MEM,,,17,15,14,5
22023,1631124,22300402,"DEC 25, 2023",DEN vs. GSW,W,8,1,1,1.0,0,0,0.0,0,1,0.0,0,0,0,0,0,0,0,0,2,-4,1,Julian Strawther,DEN,DEN,GSW,,,2,2,2,0
22023,1631124,22300390,"DEC 23, 2023",DEN @ CHA,W,16,4,10,0.4,2,5,0.4,0,0,0.0,1,0,1,1,1,0,1,0,10,-4,1,Julian Strawther,DEN,CHA,DEN,,,12,11,11,2
22023,1631124,22300383,"DEC 22, 2023",DEN @ BKN,W,11,0,5,0.0,0,3,0.0,0,0,0.0,1,2,3,0,0,0,1,1,0,-10,1,Julian Strawther,DEN,BKN,DEN,,,3,3,0,3
22023,1631124,22300369,"DEC 20, 2023",DEN @ TOR,W,14,3,6,0.5,1,4,0.25,0,0,0.0,0,1,1,2,2,0,0,2,7,1,1,Julian Strawther,DEN,TOR,DEN,,,10,8,9,3
22023,1631124,22300356,"DEC 18, 2023",DEN vs. DAL,W,21,5,10,0.5,2,4,0.5,0,0,0.0,0,3,3,2,1,0,0,1,12,9,1,Julian Strawther,DEN,DEN,DAL,,,17,15,14,5
22023,1631124,22300340,"DEC 16, 2023",DEN vs. OKC,L,15,0,3,0.0,0,2,0.0,0,0,0.0,0,1,1,1,0,0,0,0,0,8,1,Julian Strawther,DEN,DEN,OKC,,,2,1,1,2
22023,1631124,22300322,"DEC 14, 2023",DEN vs. BKN,W,20,3,11,0.273,2,6,0.333,0,0,0.0,0,4,4,1,0,0,0,0,8,5,1,Julian Strawther,DEN,DEN,BKN,,,13,12,9,5
22023,1631124,22300307,"DEC 12, 2023",DEN @ CHI,W,23,4,9,0.444,2,5,0.4,6,8,0.75,0,6,6,3,1,0,2,1,16,12,1,Julian Strawther,DEN,CHI,DEN,,,25,22,19,9
22023,1631124,22300296,"DEC 11, 2023",DEN @ ATL,W,28,8,16,0.5,6,11,0.545,0,0,0.0,0,1,1,2,5,0,2,1,22,-2,1,Julian Strawther,DEN,ATL,DEN,,,25,23,24,3
22023,1631124,22301224,"DEC 08, 2023",DEN vs. HOU,L,4,0,0,0.0,0,0,0.0,0,0,0.0,0,0,0,0,0,0,0,1,0,-15,1,Julian Strawther,DEN,DEN,HOU,,,0,0,0,0
22023,1631124,22301215,"DEC 06, 2023",DEN @ LAC,L,13,0,2,0.0,0,2,0.0,0,0,0.0,0,1,1,2,0,0,1,4,0,-9,1,Julian Strawther,DEN,LAC,DEN,,,3,1,2,3
22023,1631124,22300290,"DEC 02, 2023",DEN @ SAC,L,12,1,3,0.333,0,2,0.0,1,2,0.5,0,1,1,2,0,0,0,0,3,-7,1,Julian Strawther,DEN,SAC,DEN,,,6,4,5,3
22023,1631124,22300279,"DEC 01, 2023",DEN @ PHX,W,18,4,9,0.444,3,8,0.375,0,0,0.0,0,3,3,0,0,1,0,2,11,0,1,Julian Strawther,DEN,PHX,DEN,,,14,14,11,3
22023,1631124,22300263,"NOV 29, 2023",DEN vs. HOU,W,13,0,4,0.0,0,2,0.0,0,0,0.0,0,1,1,1,0,0,0,1,0,-2,1,Julian Strawther,DEN,DEN,HOU,,,2,1,1,2
22023,1631124,22300257,"NOV 27, 2023",DEN @ LAC,W,19,3,8,0.375,3,5,0.6,0,0,0.0,0,3,3,1,0,1,1,1,9,9,1,Julian Strawther,DEN,LAC,DEN,,,13,12,10,4
22023,1631124,22300252,"NOV 26, 2023",DEN vs. SAS,W,19,4,8,0.5,2,4,0.5,0,0,0.0,0,1,1,4,3,0,1,4,10,7,1,Julian Strawther,DEN,DEN,SAS,,,15,11,14,5
22023,1631124,22300048,"NOV 24, 2023",DEN @ HOU,L,6,0,0,0.0,0,0,0.0,0,0,0.0,0,0,0,0,0,0,0,1,0,-15,1,Julian Strawther,DEN,HOU,DEN,,,0,0,0,0
22023,1631124,22300226,"NOV 22, 2023",DEN @ ORL,L,17,2,6,0.333,1,4,0.25,2,2,1.0,1,1,2,2,0,0,0,5,7,-5,1,Julian Strawther,DEN,ORL,DEN,,,11,9,9,4
22023,1631124,22300218,"NOV 20, 2023",DEN @ DET,W,15,1,5,0.2,0,3,0.0,2,2,1.0,0,2,2,2,0,0,0,1,4,-8,1,Julian Strawther,DEN,DET,DEN,,,8,6,6,4
22023,1631124,22300210,"NOV 19, 2023",DEN @ CLE,L,20,2,6,0.333,1,3,0.333,2,2,1.0,0,2,2,1,0,1,0,4,7,8,1,Julian Strawther,DEN,CLE,DEN,,,10,9,8,3
22023,1631124,22300034,"NOV 17, 2023",DEN @ NOP,L,9,1,4,0.25,0,3,0.0,0,0,0.0,0,0,0,1,1,0,0,2,2,-16,1,Julian Strawther,DEN,NOP,DEN,,,3,2,3,1
22023,1631124,22300182,"NOV 12, 2023",DEN @ HOU,L,8,0,2,0.0,0,2,0.0,0,0,0.0,0,0,0,1,0,0,0,2,0,-5,1,Julian Strawther,DEN,HOU,DEN,,,1,0,1,1
22023,1631124,22300169,"NOV 08, 2023",DEN vs. GSW,W,8,0,1,0.0,0,1,0.0,0,0,0.0,0,1,1,0,0,0,0,2,0,-12,1,Julian Strawther,DEN,DEN,GSW,,,1,1,0,1
22023,1631124,22300156,"NOV 06, 2023",DEN vs. NOP,W,19,8,13,0.615,5,9,0.556,0,1,0.0,0,2,2,1,0,0,1,1,21,-7,1,Julian Strawther,DEN,DEN,NOP,,,24,23,22,3
22023,1631124,22300139,"NOV 04, 2023",DEN vs. CHI,W,9,1,2,0.5,1,2,0.5,0,0,0.0,0,1,1,1,0,0,0,0,3,-8,1,Julian Strawther,DEN,DEN,CHI,,,5,4,4,2
22023,1631124,22300123,"NOV 01, 2023",DEN @ MIN,L,16,2,7,0.286,1,6,0.167,0,1,0.0,0,0,0,0,1,2,0,0,5,2,1,Julian Strawther,DEN,MIN,DEN,,,5,5,5,0
22023,1631124,22300110,"OCT 30, 2023",DEN vs. UTA,W,6,2,4,0.5,0,2,0.0,0,0,0.0,0,2,2,0,0,0,0,0,4,1,1,Julian Strawther,DEN,DEN,UTA,,,6,6,4,2
22023,1631124,22300095,"OCT 29, 2023",DEN @ OKC,W,8,3,5,0.6,2,3,0.667,0,0,0.0,0,1,1,1,0,0,0,0,8,4,1,Julian Strawther,DEN,OKC,DEN,,,10,9,9,2
22023,1631124,22300078,"OCT 27, 2023",DEN @ MEM,W,5,0,2,0.0,0,0,0.0,0,0,0.0,0,0,0,0,0,0,0,2,0,-2,1,Julian Strawther,DEN,MEM,DEN,,,0,0,0,0
22023,1629622,22300561,"JAN 15, 2024",CLE vs. CHI,W,35,1,8,0.125,0,6,0.0,0,0,0.0,1,4,5,4,0,1,2,2,2,19,1,Max Strus,CLE,CLE,CHI,,,11,7,6,9
22023,1629622,22300527,"JAN 11, 2024",CLE vs. BKN,W,7,0,2,0.0,0,2,0.0,0,0,0.0,0,0,0,0,0,0,0,0,0,8,1,Max Strus,CLE,CLE,BKN,,,0,0,0,0
22023,1629622,22300497,"JAN 07, 2024",CLE vs. SAS,W,37,3,11,0.273,2,9,0.222,0,0,0.0,1,4,5,4,2,0,2,2,8,-9,1,Max Strus,CLE,CLE,SAS,,,17,13,12,9
22023,1629622,22300482,"JAN 05, 2024",CLE vs. WAS,W,30,4,6,0.667,1,3,0.333,0,0,0.0,0,5,5,3,0,0,3,1,9,10,1,Max Strus,CLE,CLE,WAS,,,17,14,12,8
22023,1629622,22300465,"JAN 03, 2024",CLE vs. WAS,W,28,9,13,0.692,6,8,0.75,0,0,0.0,2,2,4,3,1,1,1,4,24,32,1,Max Strus,CLE,CLE,WAS,,,31,28,27,7
22023,1629622,22300452,"JAN 01, 2024",CLE @ TOR,L,37,2,7,0.286,2,5,0.4,0,0,0.0,0,6,6,3,1,1,3,4,6,9,1,Max Strus,CLE,TOR,CLE,,,15,12,9,9
22023,1629622,22300433,"DEC 29, 2023",CLE vs. MIL,L,36,5,18,0.278,2,11,0.182,0,0,0.0,1,3,4,2,4,2,1,3,12,-5,1,Max Strus,CLE,CLE,MIL,,,18,16,14,6
22023,1629622,22300420,"DEC 27, 2023",CLE @ DAL,W,34,3,10,0.3,2,8,0.25,0,0,0.0,1,4,5,6,1,1,2,3,8,4,1,Max Strus,CLE,DAL,CLE,,,19,13,14,11
22023,1629622,22300396,"DEC 23, 2023",CLE @ CHI,W,41,9,22,0.409,5,17,0.294,3,3,1.0,0,1,1,7,2,1,3,2,26,14,1,Max Strus,CLE,CHI,CLE,,,34,27,33,8
22023,1629622,22300375,"DEC 21, 2023",CLE vs. NOP,L,33,4,16,0.25,2,12,0.167,3,5,0.6,0,3,3,5,0,0,3,2,13,-15,1,Max Strus,CLE,CLE,NOP,,,21,16,18,8
22023,1629622,22300364,"DEC 20, 2023",CLE vs. UTA,W,33,6,15,0.4,6,12,0.5,0,0,0.0,1,3,4,4,0,0,5,3,18,-5,1,Max Strus,CLE,CLE,UTA,,,26,22,22,8
22023,1629622,22300349,"DEC 18, 2023",CLE vs. HOU,W,34,5,13,0.385,3,9,0.333,4,5,0.8,0,3,3,2,0,0,0,3,17,2,1,Max Strus,CLE,CLE,HOU,,,22,20,19,5
22023,1629622,22300336,"DEC 16, 2023",CLE vs. ATL,W,34,4,13,0.308,1,8,0.125,2,2,1.0,1,5,6,5,1,1,1,2,11,12,1,Max Strus,CLE,CLE,ATL,,,22,17,16,11
22023,1629622,22300319,"DEC 14, 2023",CLE @ BOS,L,31,2,5,0.4,1,4,0.25,0,0,0.0,2,2,4,2,0,0,1,5,5,-4,1,Max Strus,CLE,BOS,CLE,,,11,9,7,6
22023,1629622,22300305,"DEC 12, 2023",CLE @ BOS,L,37,6,15,0.4,5,11,0.455,0,0,0.0,0,9,9,3,0,0,1,4,17,1,1,Max Strus,CLE,BOS,CLE,,,29,26,20,12
22023,1629622,22300294,"DEC 11, 2023",CLE @ ORL,L,26,1,9,0.111,0,5,0.0,4,6,0.667,1,1,2,3,1,0,3,4,6,0,1,Max Strus,CLE,ORL,CLE,,,11,8,9,5
22023,1629622,22301220,"DEC 08, 2023",CLE @ MIA,W,34,4,17,0.235,2,11,0.182,1,1,1.0,2,5,7,1,1,0,0,3,11,18,1,Max Strus,CLE,MIA,CLE,,,19,18,12,8
22023,1629622,22301205,"DEC 06, 2023",CLE vs. ORL,W,31,5,10,0.5,4,8,0.5,3,4,0.75,1,4,5,6,1,0,1,5,17,4,1,Max Strus,CLE,CLE,ORL,,,28,22,23,11
22023,1629622,22300283,"DEC 02, 2023",CLE @ DET,W,38,9,16,0.563,4,10,0.4,0,0,0.0,0,5,5,5,1,0,1,4,22,10,1,Max Strus,CLE,DET,CLE,,,32,27,27,10
22023,1629622,22300265,"NOV 30, 2023",CLE vs. POR,L,36,4,11,0.364,1,6,0.167,0,0,0.0,0,3,3,3,2,0,2,6,9,-10,1,Max Strus,CLE,CLE,POR,,,15,12,12,6
22023,1629622,22300055,"NOV 28, 2023",CLE vs. ATL,W,35,4,11,0.364,3,7,0.429,0,0,0.0,2,1,3,7,2,2,0,2,11,30,1,Max Strus,CLE,CLE,ATL,,,21,14,18,10
22023,1629622,22300251,"NOV 26, 2023",CLE vs. TOR,W,37,8,16,0.5,4,9,0.444,0,0,0.0,1,10,11,5,0,1,2,4,20,-4,1,Max Strus,CLE,CLE,TOR,,,36,31,25,16
22023,1629622,22300242,"NOV 25, 2023",CLE vs. LAL,L,34,5,11,0.455,3,7,0.429,0,0,0.0,0,4,4,2,1,0,3,2,13,-19,1,Max Strus,CLE,CLE,LAL,,,19,17,15,6
22023,1629622,22300229,"NOV 22, 2023",CLE vs. MIA,L,25,2,6,0.333,2,4,0.5,0,0,0.0,0,3,3,3,0,1,2,0,6,-11,1,Max Strus,CLE,CLE,MIA,,,12,9,9,6
22023,1629622,22300040,"NOV 21, 2023",CLE @ PHI,W,44,7,15,0.467,5,10,0.5,1,2,0.5,2,3,5,6,2,1,2,5,20,-4,1,Max Strus,CLE,PHI,CLE,,,31,25,26,11
22023,1629622,22300210,"NOV 19, 2023",CLE vs. DEN,W,32,3,7,0.429,2,6,0.333,3,4,0.75,1,5,6,5,0,1,3,3,11,14,1,Max Strus,CLE,CLE,DEN,,,22,17,16,11
22023,1629622,22300030,"NOV 17, 2023",CLE vs. DET,W,39,7,15,0.467,4,8,0.5,0,0,0.0,1,6,7,3,4,1,2,1,18,9,1,Max Strus,CLE,CLE,DET,,,28,25,21,10
22023,1629622,22300199,"NOV 15, 2023",CLE @ POR,W,37,5,12,0.417,1,7,0.143,3,3,1.0,1,2,3,7,1,0,5,3,14,25,1,Max Strus,CLE,POR,CLE,,,24,17,21,10
22023,1629622,22300191,"NOV 13, 2023",CLE @ SAC,L,34,7,12,0.583,5,9,0.556,0,0,0.0,2,3,5,4,1,0,1,3,19,10,1,Max Strus,CLE,SAC,CLE,,,28,24,23,9
22023,1629622,22300176,"NOV 11, 2023",CLE @ GSW,W,33,6,9,0.667,2,3,0.667,2,2,1.0,1,7,8,4,1,0,0,2,16,6,1,Max Strus,CLE,GSW,CLE,,,28,24,20,12
22023,1629622,22300167,"NOV 08, 2023",CLE @ OKC,L,32,4,7,0.571,4,6,0.667,0,0,0.0,2,5,7,3,0,1,0,2,12,-5,1,Max Strus,CLE,OKC,CLE,,,22,19,15,10
22023,1629622,22300142,"NOV 05, 2023",CLE vs. GSW,W,36,6,13,0.462,3,10,0.3,0,0,0.0,0,4,4,4,1,0,0,3,15,4,1,Max Strus,CLE,CLE,GSW,,,23,19,19,8
22023,1629622,22300001,"NOV 03, 2023",CLE @ IND,L,28,4,9,0.444,1,6,0.167,1,2,0.5,0,1,1,0,1,1,1,2,10,3,1,Max Strus,CLE,IND,CLE,,,11,11,10,1
22023,1629622,22300120,"NOV 01, 2023",CLE @ NYK,W,35,3,9,0.333,0,5,0.0,3,3,1.0,0,4,4,4,0,2,5,3,9,3,1,Max Strus,CLE,NYK,CLE,,,17,13,13,8
22023,1629622,22300112,"OCT 31, 2023",CLE vs. NYK,L,33,2,9,0.222,1,7,0.143,1,2,0.5,0,3,3,3,0,0,0,2,6,-12,1,Max Strus,CLE,CLE,NYK,,,12,9,9,6
22023,1629622,22300091,"OCT 28, 2023",CLE vs. IND,L,42,7,20,0.35,4,9,0.444,3,3,1.0,1,10,11,6,0,0,1,2,21,-5,1,Max Strus,CLE,CLE,IND,,,38,32,27,17
22023,1629622,22300081,"OCT 27, 2023",CLE vs. OKC,L,38,3,14,0.214,2,11,0.182,0,0,0.0,0,5,5,4,2,1,2,1,8,8,1,Max Strus,CLE,CLE,OKC,,,17,13,12,9
22023,1629622,22300067,"OCT 25, 2023",CLE @ BKN,W,39,9,17,0.529,7,13,0.538,2,2,1.0,0,12,12,2,1,1,0,4,27,13,1,Max Strus,CLE,BKN,CLE,,,41,39,29,14
22023,1630591,22300557,"JAN 15, 2024",ORL @ NYK,W,27,1,8,0.125,1,6,0.167,1,2,0.5,0,5,5,4,0,0,2,3,4,-6,1,Jalen Suggs,ORL,NYK,ORL,,,13,9,8,9
22023,1630591,22300546,"JAN 13, 2024",ORL @ OKC,L,20,4,8,0.5,1,3,0.333,0,0,0.0,1,3,4,0,0,0,1,3,9,-9,1,Jalen Suggs,ORL,OKC,ORL,,,13,13,9,4
22023,1630591,22300535,"JAN 12, 2024",ORL @ MIA,L,14,1,5,0.2,0,4,0.0,0,0,0.0,0,0,0,0,0,3,0,3,2,-11,1,Jalen Suggs,ORL,MIA,ORL,,,2,2,2,0
22023,1630591,22300513,"JAN 09, 2024",ORL vs. MIN,L,27,8,14,0.571,4,8,0.5,0,1,0.0,1,4,5,2,3,0,2,2,20,-16,1,Jalen Suggs,ORL,ORL,MIN,,,27,25,22,7
22023,1630591,22300499,"JAN 07, 2024",ORL vs. ATL,W,29,6,13,0.462,4,7,0.571,0,0,0.0,1,4,5,3,1,0,1,6,16,16,1,Jalen Suggs,ORL,ORL,ATL,,,24,21,19,8
22023,1630591,22300488,"JAN 05, 2024",ORL @ DEN,W,34,9,15,0.6,7,9,0.778,2,4,0.5,2,2,4,1,0,1,2,3,27,1,1,Jalen Suggs,ORL,DEN,ORL,,,32,31,28,5
22023,1630591,22300476,"JAN 03, 2024",ORL @ SAC,L,39,8,18,0.444,6,12,0.5,2,2,1.0,1,2,3,4,2,2,4,4,24,-13,1,Jalen Suggs,ORL,SAC,ORL,,,31,27,28,7
22023,1630591,22300463,"JAN 02, 2024",ORL @ GSW,L,31,3,14,0.214,3,7,0.429,1,2,0.5,1,1,2,3,0,0,4,2,10,-9,1,Jalen Suggs,ORL,GSW,ORL,,,15,12,13,5
22023,1630591,22300450,"DEC 31, 2023",ORL @ PHX,L,29,1,10,0.1,1,7,0.143,1,2,0.5,0,4,4,3,0,1,1,4,4,-10,1,Jalen Suggs,ORL,PHX,ORL,,,11,8,7,7
22023,1630591,22300429,"DEC 29, 2023",ORL vs. NYK,W,31,8,15,0.533,2,7,0.286,3,6,0.5,0,2,2,6,0,1,3,4,21,9,1,Jalen Suggs,ORL,ORL,NYK,,,29,23,27,8
22023,1630591,22300415,"DEC 27, 2023",ORL vs. PHI,L,28,8,12,0.667,1,2,0.5,3,3,1.0,1,1,2,1,1,1,3,5,20,-17,1,Jalen Suggs,ORL,ORL,PHI,,,23,22,21,3
22023,1630591,22300407,"DEC 26, 2023",ORL @ WAS,W,29,4,11,0.364,3,10,0.3,0,0,0.0,1,2,3,1,3,1,2,1,11,-1,1,Jalen Suggs,ORL,WAS,ORL,,,15,14,12,4
22023,1630591,22300366,"DEC 20, 2023",ORL vs. MIA,L,21,5,9,0.556,1,5,0.2,0,0,0.0,0,1,1,3,0,1,1,0,11,-23,1,Jalen Suggs,ORL,ORL,MIA,,,15,12,14,4
22023,1630591,22300344,"DEC 17, 2023",ORL @ BOS,L,28,5,9,0.556,1,4,0.25,2,2,1.0,0,5,5,0,1,0,2,4,13,-9,1,Jalen Suggs,ORL,BOS,ORL,,,18,18,13,5
22023,1630591,22300329,"DEC 15, 2023",ORL @ BOS,L,26,7,12,0.583,5,9,0.556,0,0,0.0,0,4,4,1,0,1,1,2,19,-9,1,Jalen Suggs,ORL,BOS,ORL,,,24,23,20,5
22023,1630591,22300294,"DEC 11, 2023",ORL vs. CLE,W,28,4,6,0.667,2,4,0.5,2,2,1.0,1,3,4,3,0,1,1,2,12,10,1,Jalen Suggs,ORL,ORL,CLE,,,19,16,15,7
22023,1630591,22301205,"DEC 06, 2023",ORL @ CLE,L,9,0,2,0.0,0,1,0.0,0,0,0.0,0,0,0,1,2,1,1,0,0,-6,1,Jalen Suggs,ORL,CLE,ORL,,,1,0,1,1
22023,1630591,22300282,"DEC 02, 2023",ORL @ BKN,L,22,3,7,0.429,1,3,0.333,0,0,0.0,0,0,0,2,1,1,4,5,7,-14,1,Jalen Suggs,ORL,BKN,ORL,,,9,7,9,2
22023,1630591,22300274,"DEC 01, 2023",ORL vs. WAS,W,27,5,9,0.556,2,6,0.333,3,5,0.6,0,2,2,4,3,2,3,4,15,10,1,Jalen Suggs,ORL,ORL,WAS,,,21,17,19,6
22023,1630591,22300259,"NOV 29, 2023",ORL vs. WAS,W,29,9,15,0.6,3,6,0.5,1,1,1.0,1,2,3,3,2,0,2,4,22,4,1,Jalen Suggs,ORL,ORL,WAS,,,28,25,25,6
22023,1630591,22300248,"NOV 26, 2023",ORL vs. CHA,W,32,5,9,0.556,2,5,0.4,0,0,0.0,0,5,5,1,1,2,1,2,12,6,1,Jalen Suggs,ORL,ORL,CHA,,,18,17,13,6
22023,1630591,22300043,"NOV 24, 2023",ORL vs. BOS,W,28,3,8,0.375,3,4,0.75,1,2,0.5,0,4,4,1,1,0,3,2,10,0,1,Jalen Suggs,ORL,ORL,BOS,,,15,14,11,5
22023,1630591,22300226,"NOV 22, 2023",ORL vs. DEN,W,29,4,8,0.5,0,3,0.0,2,2,1.0,0,4,4,4,1,0,2,5,10,3,1,Jalen Suggs,ORL,ORL,DEN,,,18,14,14,8
22023,1630591,22300038,"NOV 21, 2023",ORL vs. TOR,W,21,6,10,0.6,2,4,0.5,4,4,1.0,1,2,3,4,2,0,2,3,18,5,1,Jalen Suggs,ORL,ORL,TOR,,,25,21,22,7
22023,1630591,22300209,"NOV 19, 2023",ORL @ IND,W,18,6,8,0.75,1,2,0.5,5,6,0.833,1,2,3,1,1,0,0,1,18,20,1,Jalen Suggs,ORL,IND,ORL,,,22,21,19,4
22023,1630591,22300196,"NOV 15, 2023",ORL @ CHI,W,27,2,8,0.25,2,7,0.286,4,4,1.0,0,2,2,5,3,0,4,4,10,-2,1,Jalen Suggs,ORL,CHI,ORL,,,17,12,15,7
22023,1630591,22300020,"NOV 14, 2023",ORL @ BKN,L,32,4,13,0.308,2,7,0.286,0,0,0.0,0,2,2,2,2,1,3,2,10,-27,1,Jalen Suggs,ORL,BKN,ORL,,,14,12,12,4
22023,1630591,22300173,"NOV 11, 2023",ORL vs. MIL,W,38,5,11,0.455,2,4,0.5,8,10,0.8,0,2,2,2,1,0,1,0,20,10,1,Jalen Suggs,ORL,ORL,MIL,,,24,22,22,4
22023,1630591,22300172,"NOV 09, 2023",ORL vs. ATL,L,31,7,10,0.7,4,5,0.8,3,6,0.5,0,2,2,1,6,0,2,5,21,1,1,Jalen Suggs,ORL,ORL,ATL,,,24,23,22,3
22023,1630591,22300147,"NOV 06, 2023",ORL vs. DAL,L,24,4,12,0.333,1,6,0.167,1,2,0.5,1,3,4,7,1,1,4,3,10,-6,1,Jalen Suggs,ORL,ORL,DAL,,,21,14,17,11
22023,1630591,22300134,"NOV 04, 2023",ORL vs. LAL,W,27,4,11,0.364,0,2,0.0,1,1,1.0,1,5,6,5,1,1,2,1,9,26,1,Jalen Suggs,ORL,ORL,LAL,,,20,15,14,11
22023,1630591,22300130,"NOV 02, 2023",ORL @ UTA,W,21,1,7,0.143,0,0,0.0,4,4,1.0,2,2,4,3,4,0,3,4,6,-4,1,Jalen Suggs,ORL,UTA,ORL,,,13,10,9,7
22023,1630591,22300114,"OCT 31, 2023",ORL @ LAC,L,32,5,10,0.5,1,5,0.2,0,0,0.0,2,4,6,3,1,1,3,5,11,-12,1,Jalen Suggs,ORL,LAC,ORL,,,20,17,14,9
22023,1630591,22300111,"OCT 30, 2023",ORL @ LAL,L,26,4,12,0.333,3,7,0.429,4,4,1.0,3,5,8,2,1,0,0,2,15,10,1,Jalen Suggs,ORL,LAL,ORL,,,25,23,17,10
22023,1630591,22300086,"OCT 27, 2023",ORL @ POR,W,27,4,5,0.8,0,1,0.0,3,3,1.0,0,5,5,2,4,2,1,3,11,3,1,Jalen Suggs,ORL,POR,ORL,,,18,16,13,7
22023,1630591,22300066,"OCT 25, 2023",ORL vs. HOU,W,21,3,12,0.25,2,7,0.286,0,0,0.0,1,3,4,0,0,0,0,2,8,5,1,Jalen Suggs,ORL,ORL,HOU,,,12,12,8,4
22023,1631306,22300489,"JAN 05, 2024",MIA @ PHX,L,2,0,0,0.0,0,0,0.0,0,0,0.0,0,0,0,0,0,0,1,0,0,5,1,Cole Swider,MIA,PHX,MIA,,,0,0,0,0
22023,1631306,22300475,"JAN 03, 2024",MIA @ LAL,W,1,0,1,0.0,0,1,0.0,0,0,0.0,0,0,0,0,0,0,0,0,0,0,1,Cole Swider,MIA,LAL,MIA,,,0,0,0,0
22023,1631306,22300458,"JAN 01, 2024",MIA @ LAC,L,3,1,1,1.0,1,1,1.0,0,0,0.0,0,0,0,0,0,0,0,0,3,3,1,Cole Swider,MIA,LAC,MIA,,,3,3,3,0
22023,1631306,22300426,"DEC 28, 2023",MIA @ GSW,W,1,1,1,1.0,0,0,0.0,0,0,0.0,1,0,1,0,0,0,0,0,2,-3,1,Cole Swider,MIA,GSW,MIA,,,3,3,2,1
22023,1631306,22300240,"NOV 25, 2023",MIA @ BKN,L,20,4,8,0.5,3,7,0.429,0,0,0.0,0,0,0,1,1,1,1,1,11,-2,1,Cole Swider,MIA,BKN,MIA,,,12,11,12,1
22023,1631306,22300045,"NOV 24, 2023",MIA @ NYK,L,6,0,3,0.0,0,2,0.0,0,0,0.0,0,0,0,2,0,0,0,0,0,-3,1,Cole Swider,MIA,NYK,MIA,,,2,0,2,2
22023,1631306,22300093,"OCT 28, 2023",MIA @ MIN,L,2,2,3,0.667,1,2,0.5,0,0,0.0,0,1,1,0,0,0,0,0,5,7,1,Cole Swider,MIA,MIN,MIA,,,6,6,5,1
22023,1630256,22300555,"JAN 15, 2024",HOU @ PHI,L,13,1,4,0.25,0,3,0.0,0,0,0.0,1,3,4,2,0,0,0,4,2,5,1,Jae'Sean Tate,HOU,PHI,HOU,,,8,6,4,6
22023,1630256,22300542,"JAN 13, 2024",HOU @ BOS,L,9,0,0,0.0,0,0,0.0,0,0,0.0,0,0,0,0,1,0,1,1,0,-13,1,Jae'Sean Tate,HOU,BOS,HOU,,,0,0,0,0
22023,1630256,22300534,"JAN 12, 2024",HOU @ DET,W,20,1,2,0.5,0,0,0.0,0,0,0.0,2,5,7,1,0,0,1,1,2,-1,1,Jae'Sean Tate,HOU,DET,HOU,,,10,9,3,8
22023,1630256,22300523,"JAN 10, 2024",HOU @ CHI,L,18,1,3,0.333,0,2,0.0,1,2,0.5,1,1,2,0,0,0,0,1,3,-13,1,Jae'Sean Tate,HOU,CHI,HOU,,,5,5,3,2
22023,1630256,22300509,"JAN 08, 2024",HOU @ MIA,L,34,3,8,0.375,1,4,0.25,2,2,1.0,3,1,4,1,2,0,0,5,9,-4,1,Jae'Sean Tate,HOU,MIA,HOU,,,14,13,10,5
22023,1630256,22300496,"JAN 06, 2024",HOU vs. MIL,W,19,2,3,0.667,0,0,0.0,0,0,0.0,3,5,8,0,1,0,0,4,4,3,1,Jae'Sean Tate,HOU,HOU,MIL,,,12,12,4,8
22023,1630256,22300485,"JAN 05, 2024",HOU vs. MIN,L,21,0,1,0.0,0,1,0.0,0,0,0.0,0,3,3,2,1,0,0,1,0,-13,1,Jae'Sean Tate,HOU,HOU,MIN,,,5,3,2,5
22023,1630256,22300469,"JAN 03, 2024",HOU vs. BKN,W,31,2,2,1.0,2,2,1.0,2,2,1.0,0,4,4,3,0,0,1,4,8,17,1,Jae'Sean Tate,HOU,HOU,BKN,,,15,12,11,7
22023,1630256,22300453,"JAN 01, 2024",HOU vs. DET,W,26,6,10,0.6,0,2,0.0,4,6,0.667,0,3,3,0,1,0,1,6,16,15,1,Jae'Sean Tate,HOU,HOU,DET,,,19,19,16,3
22023,1630256,22300434,"DEC 29, 2023",HOU vs. PHI,L,35,2,4,0.5,0,1,0.0,0,0,0.0,1,4,5,2,0,0,0,3,4,4,1,Jae'Sean Tate,HOU,HOU,PHI,,,11,9,6,7
22023,1630256,22300418,"DEC 27, 2023",HOU vs. PHX,L,24,3,3,1.0,1,1,1.0,0,0,0.0,1,1,2,1,1,0,0,3,7,-4,1,Jae'Sean Tate,HOU,HOU,PHX,,,10,9,8,3
22023,1630256,22300409,"DEC 26, 2023",HOU vs. IND,L,14,2,3,0.667,0,0,0.0,1,2,0.5,0,1,1,0,1,0,0,1,5,4,1,Jae'Sean Tate,HOU,HOU,IND,,,6,6,5,1
22023,1630256,22300392,"DEC 23, 2023",HOU @ NOP,W,11,1,4,0.25,0,2,0.0,0,0,0.0,2,3,5,0,0,0,0,2,2,1,1,Jae'Sean Tate,HOU,NOP,HOU,,,7,7,2,5
22023,1630256,22300385,"DEC 22, 2023",HOU vs. DAL,W,18,1,2,0.5,0,1,0.0,0,0,0.0,1,7,8,1,0,0,3,4,2,-4,1,Jae'Sean Tate,HOU,HOU,DAL,,,11,10,3,9
22023,1630256,22300371,"DEC 20, 2023",HOU vs. ATL,L,19,0,3,0.0,0,1,0.0,0,0,0.0,0,0,0,1,0,0,0,3,0,-2,1,Jae'Sean Tate,HOU,HOU,ATL,,,1,0,1,1
22023,1630256,22300349,"DEC 18, 2023",HOU @ CLE,L,16,1,4,0.25,0,0,0.0,1,1,1.0,2,1,3,1,0,0,0,2,3,-5,1,Jae'Sean Tate,HOU,CLE,HOU,,,7,6,4,4
22023,1630256,22300346,"DEC 17, 2023",HOU @ MIL,L,19,0,2,0.0,0,0,0.0,0,0,0.0,2,1,3,1,1,0,2,2,0,4,1,Jae'Sean Tate,HOU,MIL,HOU,,,4,3,1,4
22023,1630256,22300314,"DEC 13, 2023",HOU vs. MEM,W,23,4,9,0.444,1,4,0.25,1,3,0.333,3,4,7,3,1,0,0,1,10,-4,1,Jae'Sean Tate,HOU,HOU,MEM,,,20,17,13,10
22023,1630256,22300298,"DEC 11, 2023",HOU vs. SAS,W,9,2,2,1.0,1,1,1.0,0,0,0.0,1,1,2,0,0,0,1,0,5,1,1,Jae'Sean Tate,HOU,HOU,SAS,,,7,7,5,2
22023,1630256,22301224,"DEC 08, 2023",HOU @ DEN,W,13,2,3,0.667,1,2,0.5,0,0,0.0,0,2,2,0,0,0,0,2,5,2,1,Jae'Sean Tate,HOU,DEN,HOU,,,7,7,5,2
22023,1630256,22301212,"DEC 06, 2023",HOU vs. OKC,W,14,0,2,0.0,0,1,0.0,0,0,0.0,0,1,1,0,0,0,2,1,0,3,1,Jae'Sean Tate,HOU,HOU,OKC,,,1,1,0,1
22023,1630256,22300291,"DEC 02, 2023",HOU @ LAL,L,14,1,2,0.5,0,0,0.0,0,0,0.0,0,2,2,0,0,0,0,2,2,-8,1,Jae'Sean Tate,HOU,LAL,HOU,,,4,4,2,2
22023,1630256,22300059,"NOV 28, 2023",HOU @ DAL,L,11,1,2,0.5,0,1,0.0,3,3,1.0,1,1,2,2,1,0,0,2,5,-3,1,Jae'Sean Tate,HOU,DAL,HOU,,,9,7,7,4
22023,1630256,22300048,"NOV 24, 2023",HOU vs. DEN,W,16,2,4,0.5,0,1,0.0,0,0,0.0,0,3,3,0,0,1,1,4,4,6,1,Jae'Sean Tate,HOU,HOU,DEN,,,7,7,4,3
22023,1630256,22300231,"NOV 22, 2023",HOU vs. MEM,W,26,1,4,0.25,0,3,0.0,0,0,0.0,1,8,9,4,1,0,0,4,2,26,1,Jae'Sean Tate,HOU,HOU,MEM,,,15,11,6,13
22023,1630256,22300224,"NOV 20, 2023",HOU @ GSW,L,21,4,7,0.571,1,2,0.5,0,0,0.0,2,1,3,1,0,0,1,3,9,-7,1,Jae'Sean Tate,HOU,GSW,HOU,,,13,12,10,4
22023,1630256,22300216,"NOV 19, 2023",HOU @ LAL,L,16,2,3,0.667,0,0,0.0,0,0,0.0,1,2,3,2,1,0,0,1,4,6,1,Jae'Sean Tate,HOU,LAL,HOU,,,9,7,6,5
22023,1630256,22300037,"NOV 17, 2023",HOU @ LAC,L,9,3,5,0.6,0,1,0.0,0,0,0.0,3,1,4,0,0,0,1,5,6,-9,1,Jae'Sean Tate,HOU,LAC,HOU,,,10,10,6,4
22023,1630256,22300182,"NOV 12, 2023",HOU vs. DEN,W,20,1,3,0.333,0,0,0.0,1,2,0.5,3,3,6,0,3,0,0,2,3,2,1,Jae'Sean Tate,HOU,HOU,DEN,,,9,9,3,6
22023,1630256,22300011,"NOV 10, 2023",HOU vs. NOP,W,24,3,7,0.429,1,4,0.25,0,0,0.0,0,3,3,2,3,0,0,4,7,1,1,Jae'Sean Tate,HOU,HOU,NOP,,,12,10,9,5
22023,1630256,22300163,"NOV 08, 2023",HOU vs. LAL,W,27,6,10,0.6,2,6,0.333,0,0,0.0,1,0,1,1,0,2,0,3,14,16,1,Jae'Sean Tate,HOU,HOU,LAL,,,16,15,15,2
22023,1630256,22300153,"NOV 06, 2023",HOU vs. SAC,W,21,3,5,0.6,2,4,0.5,0,0,0.0,1,3,4,1,2,0,0,2,8,28,1,Jae'Sean Tate,HOU,HOU,SAC,,,13,12,9,5
22023,1630256,22300137,"NOV 04, 2023",HOU vs. SAC,W,21,4,6,0.667,3,3,1.0,0,0,0.0,0,4,4,1,0,0,0,4,11,4,1,Jae'Sean Tate,HOU,HOU,SAC,,,16,15,12,5
22023,1630256,22300122,"NOV 01, 2023",HOU vs. CHA,W,19,1,5,0.2,1,2,0.5,1,2,0.5,1,5,6,5,0,0,0,4,4,17,1,Jae'Sean Tate,HOU,HOU,CHA,,,15,10,9,11
22023,1630256,22300096,"OCT 29, 2023",HOU vs. GSW,L,22,2,6,0.333,0,2,0.0,2,2,1.0,2,6,8,1,2,2,1,2,6,-24,1,Jae'Sean Tate,HOU,HOU,GSW,,,15,14,7,9
22023,1630256,22300083,"OCT 27, 2023",HOU @ SAS,L,14,1,2,0.5,0,1,0.0,1,1,1.0,0,0,0,0,3,0,1,1,3,-8,1,Jae'Sean Tate,HOU,SAS,HOU,,,3,3,3,0
22023,1630256,22300066,"OCT 25, 2023",HOU @ ORL,L,15,2,2,1.0,1,1,1.0,0,0,0.0,0,2,2,0,1,1,0,1,5,-11,1,Jae'Sean Tate,HOU,ORL,HOU,,,7,7,5,2
22023,1628369,22300563,"JAN 15, 2024",BOS @ TOR,W,37,7,19,0.368,1,6,0.167,4,4,1.0,0,14,14,6,1,1,1,2,19,8,1,Jayson Tatum,BOS,TOR,BOS,,,39,33,25,20
22023,1628369,22300542,"JAN 13, 2024",BOS vs. HOU,W,30,9,17,0.529,4,7,0.571,5,7,0.714,1,7,8,5,1,1,2,2,27,9,1,Jayson Tatum,BOS,BOS,HOU,,,40,35,32,13
22023,1628369,22300528,"JAN 11, 2024",BOS @ MIL,L,16,2,6,0.333,0,1,0.0,3,4,0.75,0,1,1,3,0,0,1,2,7,-31,1,Jayson Tatum,BOS,MIL,BOS,,,11,8,10,4
22023,1628369,22300517,"JAN 10, 2024",BOS vs. MIN,W,42,13,26,0.5,6,11,0.545,13,14,0.929,0,4,4,2,1,0,1,3,45,3,1,Jayson Tatum,BOS,BOS,MIN,,,51,49,47,6
22023,1628369,22300493,"JAN 06, 2024",BOS @ IND,W,38,14,23,0.609,8,13,0.615,2,4,0.5,1,12,13,6,1,0,4,4,38,19,1,Jayson Tatum,BOS,IND,BOS,,,57,51,44,19
22023,1628369,22300479,"JAN 05, 2024",BOS vs. UTA,W,25,6,12,0.5,5,8,0.625,13,14,0.929,0,9,9,5,1,1,1,1,30,34,1,Jayson Tatum,BOS,BOS,UTA,,,44,39,35,14
22023,1628369,22300462,"JAN 02, 2024",BOS @ OKC,L,38,10,21,0.476,2,5,0.4,8,10,0.8,5,8,13,8,1,0,4,3,30,0,1,Jayson Tatum,BOS,OKC,BOS,,,51,43,38,21
22023,1628369,22300448,"DEC 31, 2023",BOS @ SAS,W,31,10,17,0.588,5,10,0.5,0,0,0.0,1,5,6,2,0,2,3,1,25,32,1,Jayson Tatum,BOS,SAS,BOS,,,33,31,27,8
22023,1628369,22300421,"DEC 28, 2023",BOS vs. DET,W,43,11,31,0.355,2,11,0.182,7,8,0.875,2,5,7,10,5,0,3,4,31,10,1,Jayson Tatum,BOS,BOS,DET,,,48,38,41,17
22023,1628369,22300403,"DEC 25, 2023",BOS @ LAL,W,41,6,15,0.4,1,6,0.167,12,13,0.923,0,8,8,7,0,1,1,0,25,10,1,Jayson Tatum,BOS,LAL,BOS,,,40,33,32,15
22023,1628369,22300389,"DEC 23, 2023",BOS @ LAC,W,30,9,16,0.563,5,10,0.5,7,9,0.778,0,4,4,2,1,0,2,0,30,19,1,Jayson Tatum,BOS,LAC,BOS,,,36,34,32,6
22023,1628369,22300362,"DEC 19, 2023",BOS @ GSW,L,41,5,17,0.294,2,9,0.222,3,3,1.0,3,5,8,7,2,0,0,0,15,-9,1,Jayson Tatum,BOS,GSW,BOS,,,30,23,22,15
22023,1628369,22300344,"DEC 17, 2023",BOS vs. ORL,W,31,8,21,0.381,4,6,0.667,3,4,0.75,3,5,8,3,0,1,1,3,23,9,1,Jayson Tatum,BOS,BOS,ORL,,,34,31,26,11
22023,1628369,22300329,"DEC 15, 2023",BOS vs. ORL,W,39,11,22,0.5,2,9,0.222,6,9,0.667,0,6,6,4,0,0,2,3,30,14,1,Jayson Tatum,BOS,BOS,ORL,,,40,36,34,10
22023,1628369,22300319,"DEC 14, 2023",BOS vs. CLE,W,36,9,22,0.409,3,10,0.3,6,8,0.75,3,8,11,3,0,3,3,1,27,2,1,Jayson Tatum,BOS,BOS,CLE,,,41,38,30,14
22023,1628369,22300305,"DEC 12, 2023",BOS vs. CLE,W,41,7,19,0.368,2,9,0.222,9,9,1.0,0,10,10,5,0,2,4,3,25,9,1,Jayson Tatum,BOS,BOS,CLE,,,40,35,30,15
22023,1628369,22301227,"DEC 08, 2023",BOS vs. NYK,W,39,8,18,0.444,3,9,0.333,6,8,0.75,0,6,6,5,1,0,0,3,25,17,1,Jayson Tatum,BOS,BOS,NYK,,,36,31,30,11
22023,1628369,22301202,"DEC 04, 2023",BOS @ IND,L,37,13,26,0.5,2,8,0.25,4,7,0.571,1,11,12,6,1,0,2,2,32,-14,1,Jayson Tatum,BOS,IND,BOS,,,50,44,38,18
22023,1628369,22300275,"DEC 01, 2023",BOS vs. PHI,W,27,6,9,0.667,2,5,0.4,7,9,0.778,0,7,7,4,1,1,7,1,21,-7,1,Jayson Tatum,BOS,BOS,PHI,,,32,28,25,11
22023,1628369,22300053,"NOV 28, 2023",BOS vs. CHI,W,36,8,16,0.5,2,8,0.25,3,3,1.0,1,6,7,4,0,0,4,2,21,18,1,Jayson Tatum,BOS,BOS,CHI,,,32,28,25,11
22023,1628369,22300246,"NOV 26, 2023",BOS vs. ATL,W,39,11,25,0.44,5,13,0.385,7,10,0.7,1,8,9,4,2,0,6,2,34,3,1,Jayson Tatum,BOS,BOS,ATL,,,47,43,38,13
22023,1628369,22300043,"NOV 24, 2023",BOS @ ORL,L,39,7,16,0.438,0,3,0.0,12,13,0.923,0,5,5,3,2,0,2,3,26,-21,1,Jayson Tatum,BOS,ORL,BOS,,,34,31,29,8
22023,1628369,22300228,"NOV 22, 2023",BOS vs. MIL,W,36,7,17,0.412,2,9,0.222,7,9,0.778,0,11,11,4,0,1,2,2,23,-2,1,Jayson Tatum,BOS,BOS,MIL,,,38,34,27,15
22023,1628369,22300217,"NOV 20, 2023",BOS @ CHA,L,44,15,28,0.536,7,15,0.467,8,10,0.8,0,13,13,6,0,2,3,1,45,-5,1,Jayson Tatum,BOS,CHA,BOS,,,64,58,51,19
22023,1628369,22300213,"NOV 19, 2023",BOS @ MEM,W,35,7,13,0.538,1,1,1.0,5,6,0.833,2,7,9,5,1,1,8,4,20,-1,1,Jayson Tatum,BOS,MEM,BOS,,,34,29,25,14
22023,1628369,22300031,"NOV 17, 2023",BOS @ TOR,W,37,8,22,0.364,1,11,0.091,0,0,0.0,1,6,7,2,1,0,3,3,17,-4,1,Jayson Tatum,BOS,TOR,BOS,,,26,24,19,9
22023,1628369,22300194,"NOV 15, 2023",BOS @ PHI,W,39,10,23,0.435,4,10,0.4,5,6,0.833,2,6,8,6,2,0,3,1,29,2,1,Jayson Tatum,BOS,PHI,BOS,,,43,37,35,14
22023,1628369,22300188,"NOV 13, 2023",BOS vs. NYK,W,39,13,23,0.565,5,12,0.417,4,5,0.8,1,5,6,7,1,0,3,5,35,12,1,Jayson Tatum,BOS,BOS,NYK,,,48,41,42,13
22023,1628369,22300174,"NOV 11, 2023",BOS vs. TOR,W,34,10,18,0.556,3,9,0.333,4,6,0.667,0,5,5,4,0,1,1,2,27,42,1,Jayson Tatum,BOS,BOS,TOR,,,36,32,31,9
22023,1628369,22300010,"NOV 10, 2023",BOS vs. BKN,W,33,6,17,0.353,4,11,0.364,7,9,0.778,1,9,10,3,0,0,2,1,23,28,1,Jayson Tatum,BOS,BOS,BKN,,,36,33,26,13
22023,1628369,22300159,"NOV 08, 2023",BOS @ PHI,L,37,6,14,0.429,2,6,0.333,2,3,0.667,1,14,15,6,3,0,2,2,16,-1,1,Jayson Tatum,BOS,PHI,BOS,,,37,31,22,21
22023,1628369,22300154,"NOV 06, 2023",BOS @ MIN,L,43,12,22,0.545,2,8,0.25,6,8,0.75,0,5,5,2,5,0,6,2,32,3,1,Jayson Tatum,BOS,MIN,BOS,,,39,37,34,7
22023,1628369,22300136,"NOV 04, 2023",BOS @ BKN,W,41,10,20,0.5,6,10,0.6,6,6,1.0,1,10,11,1,0,0,3,1,32,18,1,Jayson Tatum,BOS,BKN,BOS,,,44,43,33,12
22023,1628369,22300118,"NOV 01, 2023",BOS vs. IND,W,27,9,15,0.6,3,5,0.6,9,10,0.9,2,10,12,4,0,0,2,1,30,36,1,Jayson Tatum,BOS,BOS,IND,,,46,42,34,16
22023,1628369,22300103,"OCT 30, 2023",BOS @ WAS,W,28,14,21,0.667,4,9,0.444,1,1,1.0,0,6,6,3,0,0,2,2,33,27,1,Jayson Tatum,BOS,WAS,BOS,,,42,39,36,9
22023,1628369,22300080,"OCT 27, 2023",BOS vs. MIA,W,41,9,22,0.409,3,10,0.3,1,3,0.333,0,8,8,5,1,0,2,4,22,13,1,Jayson Tatum,BOS,BOS,MIA,,,35,30,27,13
22023,1628369,22300065,"OCT 25, 2023",BOS @ NYK,W,39,13,22,0.591,3,8,0.375,5,6,0.833,0,11,11,4,2,1,4,3,34,0,1,Jayson Tatum,BOS,NYK,BOS,,,49,45,38,15
22023,1630678,22300561,"JAN 15, 2024",CHI @ CLE,L,5,0,1,0.0,0,1,0.0,0,0,0.0,0,1,1,0,0,0,0,1,0,-5,1,Terry Taylor,CHI,CLE,CHI,,,1,1,0,1
22023,1630678,22300484,"JAN 05, 2024",CHI vs. CHA,W,9,2,3,0.667,0,1,0.0,1,1,1.0,0,0,0,0,0,1,1,2,5,5,1,Terry Taylor,CHI,CHI,CHA,,,5,5,5,0
22023,1630678,22300468,"JAN 03, 2024",CHI @ NYK,L,16,2,3,0.667,0,0,0.0,0,0,0.0,1,1,2,0,0,0,0,0,4,0,1,Terry Taylor,CHI,NYK,CHI,,,6,6,4,2
22023,1630678,22300459,"JAN 02, 2024",CHI @ PHI,L,20,0,5,0.0,0,2,0.0,0,0,0.0,4,1,5,1,1,1,4,2,0,18,1,Terry Taylor,CHI,PHI,CHI,,,6,5,1,6
22023,1630678,22300442,"DEC 30, 2023",CHI vs. PHI,W,17,3,3,1.0,0,0,0.0,0,0,0.0,3,3,6,1,1,0,0,0,6,1,1,Terry Taylor,CHI,CHI,PHI,,,13,12,7,7
22023,1630678,22300422,"DEC 28, 2023",CHI vs. IND,L,14,1,2,0.5,0,1,0.0,0,0,0.0,1,0,1,1,0,0,0,3,2,1,1,Terry Taylor,CHI,CHI,IND,,,4,3,3,2
22023,1630678,22300408,"DEC 26, 2023",CHI vs. ATL,W,8,2,2,1.0,0,0,0.0,0,0,0.0,1,0,1,0,0,0,0,2,4,4,1,Terry Taylor,CHI,CHI,ATL,,,5,5,4,1
22023,1630678,22300376,"DEC 21, 2023",CHI vs. SAS,W,2,0,0,0.0,0,0,0.0,0,0,0.0,0,0,0,0,0,0,1,1,0,-1,1,Terry Taylor,CHI,CHI,SAS,,,0,0,0,0
22023,1630678,22300370,"DEC 20, 2023",CHI vs. LAL,W,1,0,0,0.0,0,0,0.0,0,0,0.0,0,0,0,0,0,0,0,0,0,-2,1,Terry Taylor,CHI,CHI,LAL,,,0,0,0,0
22023,1630678,22300307,"DEC 12, 2023",CHI vs. DEN,L,1,1,1,1.0,0,0,0.0,0,0,0.0,1,0,1,0,0,0,0,0,2,2,1,Terry Taylor,CHI,CHI,DEN,,,3,3,2,1
22023,1630678,22300053,"NOV 28, 2023",CHI @ BOS,L,3,0,0,0.0,0,0,0.0,0,0,0.0,0,0,0,0,1,0,0,0,0,1,1,Terry Taylor,CHI,BOS,CHI,,,0,0,0,0
22023,1630678,22300220,"NOV 20, 2023",CHI vs. MIA,L,2,0,0,0.0,0,0,0.0,0,0,0.0,0,0,0,0,0,0,0,0,0,6,1,Terry Taylor,CHI,CHI,MIA,,,0,0,0,0
22023,1630678,22300152,"NOV 06, 2023",CHI vs. UTA,W,2,0,0,0.0,0,0,0.0,0,0,0.0,0,1,1,0,0,0,0,0,0,-5,1,Terry Taylor,CHI,CHI,UTA,,,1,1,0,1
22023,1630678,22300139,"NOV 04, 2023",CHI @ DEN,L,3,1,1,1.0,0,0,0.0,0,0,0.0,0,0,0,0,0,0,0,0,2,-2,1,Terry Taylor,CHI,DEN,CHI,,,2,2,2,0
22023,1630678,22300088,"OCT 28, 2023",CHI @ DET,L,1,0,0,0.0,0,0,0.0,0,0,0.0,0,0,0,0,0,0,0,0,0,0,1,Terry Taylor,CHI,DET,CHI,,,0,0,0,0
22023,202066,22300540,"JAN 12, 2024",TOR @ UTA,L,8,0,1,0.0,0,1,0.0,0,0,0.0,1,0,1,2,0,0,1,1,0,-8,1,Garrett Temple,TOR,UTA,TOR,,,3,1,2,3
22023,202066,22300526,"JAN 10, 2024",TOR @ LAC,L,8,1,2,0.5,1,1,1.0,0,0,0.0,0,2,2,1,0,0,0,2,3,4,1,Garrett Temple,TOR,LAC,TOR,,,6,5,4,3
22023,202066,22300504,"JAN 07, 2024",TOR @ GSW,W,4,1,1,1.0,0,0,0.0,0,0,0.0,0,0,0,0,0,0,1,0,2,-5,1,Garrett Temple,TOR,GSW,TOR,,,2,2,2,0
22023,202066,22300330,"DEC 15, 2023",TOR vs. ATL,L,3,0,0,0.0,0,0,0.0,0,0,0.0,0,0,0,1,0,0,0,0,0,1,1,Garrett Temple,TOR,TOR,ATL,,,1,0,1,1
22023,202066,22300038,"NOV 21, 2023",TOR @ ORL,L,4,1,1,1.0,0,0,0.0,0,0,0.0,0,0,0,2,0,0,0,0,2,4,1,Garrett Temple,TOR,ORL,TOR,,,4,2,4,2
22023,202066,22300195,"NOV 15, 2023",TOR vs. MIL,L,4,1,1,1.0,1,1,1.0,0,0,0.0,0,1,1,0,0,0,0,0,3,4,1,Garrett Temple,TOR,TOR,MIL,,,4,4,3,1
22023,202066,22300174,"NOV 11, 2023",TOR @ BOS,L,4,1,2,0.5,0,0,0.0,0,0,0.0,0,1,1,0,1,0,0,0,2,6,1,Garrett Temple,TOR,BOS,TOR,,,3,3,2,1
22023,202066,22300128,"NOV 02, 2023",TOR @ PHI,L,2,1,1,1.0,0,0,0.0,0,0,0.0,0,0,0,0,0,0,0,0,2,1,1,Garrett Temple,TOR,PHI,TOR,,,2,2,2,0
22023,202066,22300116,"NOV 01, 2023",TOR vs. MIL,W,3,0,0,0.0,0,0,0.0,2,2,1.0,0,0,0,0,0,0,0,0,2,-4,1,Garrett Temple,TOR,TOR,MIL,,,2,2,2,0
22023,1631207,22300561,"JAN 15, 2024",CHI @ CLE,L,4,0,3,0.0,0,2,0.0,0,0,0.0,0,0,0,0,0,0,0,0,0,-11,1,Dalen Terry,CHI,CLE,CHI,,,0,0,0,0
22023,1631207,22300548,"JAN 13, 2024",CHI @ SAS,W,3,0,0,0.0,0,0,0.0,0,0,0.0,0,0,0,0,0,0,0,1,0,-1,1,Dalen Terry,CHI,SAS,CHI,,,0,0,0,0
22023,1631207,22300536,"JAN 12, 2024",CHI vs. GSW,L,8,1,5,0.2,0,3,0.0,0,0,0.0,1,0,1,0,0,0,1,1,2,-12,1,Dalen Terry,CHI,CHI,GSW,,,3,3,2,1
22023,1631207,22300523,"JAN 10, 2024",CHI vs. HOU,W,6,1,1,1.0,1,1,1.0,0,0,0.0,0,0,0,1,0,0,0,1,3,4,1,Dalen Terry,CHI,CHI,HOU,,,4,3,4,1
22023,1631207,22300506,"JAN 08, 2024",CHI @ CHA,W,12,0,1,0.0,0,1,0.0,2,2,1.0,1,1,2,1,0,0,1,1,2,-4,1,Dalen Terry,CHI,CHA,CHI,,,5,4,3,3
22023,1631207,22300484,"JAN 05, 2024",CHI vs. CHA,W,21,3,5,0.6,2,4,0.5,0,0,0.0,0,1,1,4,2,0,0,2,8,6,1,Dalen Terry,CHI,CHI,CHA,,,13,9,12,5
22023,1631207,22300468,"JAN 03, 2024",CHI @ NYK,L,8,1,2,0.5,0,0,0.0,0,0,0.0,0,1,1,1,0,0,0,2,2,6,1,Dalen Terry,CHI,NYK,CHI,,,4,3,3,2
22023,1631207,22300459,"JAN 02, 2024",CHI @ PHI,L,21,2,7,0.286,0,3,0.0,2,2,1.0,1,7,8,7,0,1,3,4,6,14,1,Dalen Terry,CHI,PHI,CHI,,,21,14,13,15
22023,1631207,22300442,"DEC 30, 2023",CHI vs. PHI,W,11,1,2,0.5,1,2,0.5,0,0,0.0,0,0,0,0,0,0,1,1,3,-1,1,Dalen Terry,CHI,CHI,PHI,,,3,3,3,0
22023,1631207,22300422,"DEC 28, 2023",CHI vs. IND,L,18,2,3,0.667,0,0,0.0,2,2,1.0,1,2,3,1,1,3,2,1,6,29,1,Dalen Terry,CHI,CHI,IND,,,10,9,7,4
22023,1631207,22300408,"DEC 26, 2023",CHI vs. ATL,W,7,0,1,0.0,0,1,0.0,0,0,0.0,0,0,0,0,0,0,1,1,0,-12,1,Dalen Terry,CHI,CHI,ATL,,,0,0,0,0
22023,1631207,22300396,"DEC 23, 2023",CHI vs. CLE,L,17,2,3,0.667,0,1,0.0,2,2,1.0,0,1,1,0,1,0,0,1,6,-12,1,Dalen Terry,CHI,CHI,CLE,,,7,7,6,1
22023,1631207,22300376,"DEC 21, 2023",CHI vs. SAS,W,17,0,2,0.0,0,2,0.0,1,2,0.5,0,3,3,3,0,0,0,1,1,11,1,Dalen Terry,CHI,CHI,SAS,,,7,4,4,6
22023,1631207,22300370,"DEC 20, 2023",CHI vs. LAL,W,21,1,2,0.5,0,1,0.0,0,0,0.0,0,5,5,3,0,0,1,0,2,11,1,Dalen Terry,CHI,CHI,LAL,,,10,7,5,8
22023,1631207,22300351,"DEC 18, 2023",CHI @ PHI,W,10,1,1,1.0,0,0,0.0,0,0,0.0,1,2,3,1,0,0,0,2,2,10,1,Dalen Terry,CHI,PHI,CHI,,,6,5,3,4
22023,1631207,22300337,"DEC 16, 2023",CHI @ MIA,L,16,1,3,0.333,0,2,0.0,0,0,0.0,1,0,1,2,1,0,1,4,2,-7,1,Dalen Terry,CHI,MIA,CHI,,,5,3,4,3
22023,1631207,22300320,"DEC 14, 2023",CHI @ MIA,W,3,0,0,0.0,0,0,0.0,0,0,0.0,0,1,1,0,0,0,1,1,0,-9,1,Dalen Terry,CHI,MIA,CHI,,,1,1,0,1
22023,1631207,22300307,"DEC 12, 2023",CHI vs. DEN,L,11,0,2,0.0,0,2,0.0,2,2,1.0,0,0,0,1,0,1,0,1,2,9,1,Dalen Terry,CHI,CHI,DEN,,,3,2,3,1
22023,1631207,22300300,"DEC 11, 2023",CHI @ MIL,L,11,1,2,0.5,1,2,0.5,0,0,0.0,0,0,0,1,0,1,0,2,3,-6,1,Dalen Terry,CHI,MIL,CHI,,,4,3,4,1
22023,1631207,22301211,"DEC 06, 2023",CHI vs. CHA,W,3,0,0,0.0,0,0,0.0,0,0,0.0,0,0,0,0,0,0,0,0,0,4,1,Dalen Terry,CHI,CHI,CHA,,,0,0,0,0
22023,1631207,22300269,"NOV 30, 2023",CHI vs. MIL,W,4,0,1,0.0,0,0,0.0,0,0,0.0,1,0,1,0,0,0,0,0,0,1,1,Dalen Terry,CHI,CHI,MIL,,,1,1,0,1
22023,1631207,22300053,"NOV 28, 2023",CHI @ BOS,L,8,0,0,0.0,0,0,0.0,0,0,0.0,1,4,5,1,0,1,0,1,0,2,1,Dalen Terry,CHI,BOS,CHI,,,6,5,1,6
22023,1631207,22300152,"NOV 06, 2023",CHI vs. UTA,W,3,1,3,0.333,0,1,0.0,0,0,0.0,0,1,1,1,0,0,1,0,2,-5,1,Dalen Terry,CHI,CHI,UTA,,,4,3,3,2
22023,1631207,22300139,"NOV 04, 2023",CHI @ DEN,L,3,1,2,0.5,0,1,0.0,0,2,0.0,0,1,1,1,0,0,0,1,2,-2,1,Dalen Terry,CHI,DEN,CHI,,,4,3,3,2
22023,1631207,22300088,"OCT 28, 2023",CHI @ DET,L,1,1,1,1.0,1,1,1.0,0,0,0.0,0,0,0,0,0,0,0,0,3,0,1,Dalen Terry,CHI,DET,CHI,,,3,3,3,0
22023,1631207,22300070,"OCT 25, 2023",CHI vs. OKC,L,4,0,2,0.0,0,1,0.0,0,0,0.0,0,2,2,1,0,0,0,0,0,1,1,Dalen Terry,CHI,CHI,OKC,,,3,2,1,3
22023,1628464,22300553,"JAN 14, 2024",LAC @ MIN,L,22,1,3,0.333,1,2,0.5,0,0,0.0,1,3,4,0,1,0,0,3,3,-7,1,Daniel Theis,LAC,MIN,LAC,,,7,7,3,4
22023,1628464,22300537,"JAN 12, 2024",LAC @ MEM,W,22,2,4,0.5,1,1,1.0,2,4,0.5,2,3,5,4,2,3,0,2,7,14,1,Daniel Theis,LAC,MEM,LAC,,,16,12,11,9
22023,1628464,22300526,"JAN 10, 2024",LAC vs. TOR,W,16,1,2,0.5,0,0,0.0,2,2,1.0,2,2,4,1,1,1,1,1,4,2,1,Daniel Theis,LAC,LAC,TOR,,,9,8,5,5
22023,1628464,22300511,"JAN 08, 2024",LAC vs. PHX,W,14,3,6,0.5,0,1,0.0,0,0,0.0,2,1,3,3,1,1,1,3,6,15,1,Daniel Theis,LAC,LAC,PHX,,,12,9,9,6
22023,1628464,22300505,"JAN 07, 2024",LAC @ LAL,L,9,1,3,0.333,0,0,0.0,0,0,0.0,1,2,3,0,0,1,0,0,2,-3,1,Daniel Theis,LAC,LAL,LAC,,,5,5,2,3
22023,1628464,22300486,"JAN 05, 2024",LAC @ NOP,W,17,1,3,0.333,0,1,0.0,0,0,0.0,2,3,5,0,0,0,1,1,2,13,1,Daniel Theis,LAC,NOP,LAC,,,7,7,2,5
22023,1628464,22300473,"JAN 03, 2024",LAC @ PHX,W,20,3,5,0.6,0,0,0.0,0,0,0.0,1,2,3,1,1,0,0,3,6,7,1,Daniel Theis,LAC,PHX,LAC,,,10,9,7,4
22023,1628464,22300458,"JAN 01, 2024",LAC vs. MIA,W,16,2,3,0.667,0,1,0.0,2,2,1.0,0,1,1,0,0,0,2,3,6,-8,1,Daniel Theis,LAC,LAC,MIA,,,7,7,6,1
22023,1628464,22300438,"DEC 29, 2023",LAC vs. MEM,W,13,2,3,0.667,0,1,0.0,1,2,0.5,1,1,2,0,0,2,1,3,5,-1,1,Daniel Theis,LAC,LAC,MEM,,,7,7,5,2
22023,1628464,22300414,"DEC 26, 2023",LAC vs. CHA,W,15,5,7,0.714,0,0,0.0,0,0,0.0,2,2,4,0,0,0,1,0,10,-2,1,Daniel Theis,LAC,LAC,CHA,,,14,14,10,4
22023,1628464,22300389,"DEC 23, 2023",LAC vs. BOS,L,21,5,5,1.0,2,2,1.0,3,3,1.0,0,1,1,1,1,0,0,2,15,-9,1,Daniel Theis,LAC,LAC,BOS,,,17,16,16,2
22023,1628464,22300379,"DEC 21, 2023",LAC @ OKC,L,15,2,2,1.0,0,0,0.0,0,0,0.0,0,1,1,0,0,1,2,1,4,-14,1,Daniel Theis,LAC,OKC,LAC,,,5,5,4,1
22023,1628464,22300372,"DEC 20, 2023",LAC @ DAL,W,16,4,4,1.0,2,2,1.0,1,2,0.5,1,1,2,2,0,0,0,4,11,-1,1,Daniel Theis,LAC,DAL,LAC,,,15,13,13,4
22023,1628464,22300350,"DEC 18, 2023",LAC @ IND,W,22,1,4,0.25,0,0,0.0,2,2,1.0,5,4,9,0,0,2,2,2,4,0,1,Daniel Theis,LAC,IND,LAC,,,13,13,4,9
22023,1628464,22300343,"DEC 16, 2023",LAC vs. NYK,W,15,1,3,0.333,0,0,0.0,5,6,0.833,0,1,1,0,1,0,0,4,7,-3,1,Daniel Theis,LAC,LAC,NYK,,,8,8,7,1
22023,1628464,22300325,"DEC 14, 2023",LAC vs. GSW,W,16,0,2,0.0,0,1,0.0,4,4,1.0,0,1,1,1,1,1,0,2,4,8,1,Daniel Theis,LAC,LAC,GSW,,,6,5,5,2
22023,1628464,22300309,"DEC 12, 2023",LAC vs. SAC,W,16,4,8,0.5,0,1,0.0,0,0,0.0,1,2,3,0,1,0,0,2,8,15,1,Daniel Theis,LAC,LAC,SAC,,,11,11,8,3
22023,1628464,22300304,"DEC 11, 2023",LAC vs. POR,W,14,1,3,0.333,1,1,1.0,0,0,0.0,0,0,0,0,1,1,0,2,3,1,1,Daniel Theis,LAC,LAC,POR,,,3,3,3,0
22023,1628464,22301215,"DEC 06, 2023",LAC vs. DEN,W,21,3,8,0.375,2,4,0.5,0,0,0.0,5,6,11,0,0,3,1,2,8,14,1,Daniel Theis,LAC,LAC,DEN,,,19,19,8,11
22023,1628464,22300280,"DEC 02, 2023",LAC vs. GSW,W,22,6,11,0.545,0,2,0.0,0,0,0.0,2,2,4,1,1,2,1,3,12,-1,1,Daniel Theis,LAC,LAC,GSW,,,17,16,13,5
22023,1628464,22300273,"NOV 30, 2023",LAC @ GSW,L,15,4,9,0.444,1,1,1.0,1,2,0.5,1,1,2,2,0,0,0,2,10,-20,1,Daniel Theis,LAC,GSW,LAC,,,14,12,12,4
22023,1628464,22300264,"NOV 29, 2023",LAC @ SAC,W,17,2,5,0.4,0,0,0.0,1,2,0.5,3,0,3,0,0,0,0,5,5,-12,1,Daniel Theis,LAC,SAC,LAC,,,8,8,5,3
22023,1628464,22300257,"NOV 27, 2023",LAC vs. DEN,L,12,2,4,0.5,0,0,0.0,0,0,0.0,1,0,1,1,0,2,1,3,4,0,1,Daniel Theis,LAC,LAC,DEN,,,6,5,5,2
22023,1628464,22300244,"NOV 25, 2023",LAC vs. DAL,W,16,2,6,0.333,0,1,0.0,1,2,0.5,2,1,3,0,0,1,1,2,5,-1,1,Daniel Theis,LAC,LAC,DAL,,,8,8,5,3
22023,1628464,22300052,"NOV 24, 2023",LAC vs. NOP,L,21,1,3,0.333,1,2,0.5,0,0,0.0,0,4,4,2,0,3,1,2,3,5,1,Daniel Theis,LAC,LAC,NOP,,,9,7,5,6
22023,1628464,22300235,"NOV 22, 2023",LAC @ SAS,W,20,4,11,0.364,0,0,0.0,0,0,0.0,5,6,11,4,0,0,1,2,8,12,1,Daniel Theis,LAC,SAS,LAC,,,23,19,12,15
22023,1628464,22300223,"NOV 20, 2023",LAC @ SAS,W,21,8,10,0.8,1,1,1.0,2,2,1.0,3,4,7,2,1,0,1,4,19,18,1,Daniel Theis,LAC,SAS,LAC,,,28,26,21,9
22023,1628464,22300037,"NOV 17, 2023",LAC vs. HOU,W,10,1,3,0.333,0,1,0.0,0,2,0.0,0,3,3,0,1,0,0,2,2,-6,1,Daniel Theis,LAC,LAC,HOU,,,5,5,2,3
22023,1628464,22300171,"NOV 09, 2023",IND vs. MIL,W,8,1,4,0.25,0,1,0.0,0,0,0.0,0,0,0,0,0,0,0,1,2,0,1,Daniel Theis,IND,IND,MIL,,,2,2,2,0
22023,1630560,22300562,"JAN 15, 2024",BKN vs. MIA,L,32,7,20,0.35,2,10,0.2,7,7,1.0,0,2,2,3,0,0,2,2,23,9,1,Cam Thomas,BKN,BKN,MIA,,,28,25,26,5
22023,1630560,22300527,"JAN 11, 2024",BKN @ CLE,L,35,9,21,0.429,1,5,0.2,7,11,0.636,0,6,6,2,0,1,0,3,26,2,1,Cam Thomas,BKN,CLE,BKN,,,34,32,28,8
22023,1630560,22300498,"JAN 07, 2024",BKN vs. POR,L,18,4,9,0.444,1,3,0.333,0,0,0.0,0,3,3,0,0,0,1,0,9,-5,1,Cam Thomas,BKN,BKN,POR,,,12,12,9,3
22023,1630560,22300481,"JAN 05, 2024",BKN vs. OKC,W,24,6,14,0.429,3,5,0.6,4,5,0.8,0,2,2,0,1,0,1,0,19,6,1,Cam Thomas,BKN,BKN,OKC,,,21,21,19,2
22023,1630560,22300469,"JAN 03, 2024",BKN @ HOU,L,17,0,7,0.0,0,2,0.0,4,4,1.0,0,0,0,5,1,0,1,1,4,-10,1,Cam Thomas,BKN,HOU,BKN,,,9,4,9,5
22023,1630560,22300461,"JAN 02, 2024",BKN @ NOP,L,20,0,11,0.0,0,4,0.0,0,0,0.0,1,1,2,0,1,0,1,0,0,-14,1,Cam Thomas,BKN,NOP,BKN,,,2,2,0,2
22023,1630560,22300447,"DEC 31, 2023",BKN @ OKC,L,26,7,18,0.389,3,8,0.375,3,7,0.429,1,0,1,1,1,0,1,2,20,-9,1,Cam Thomas,BKN,OKC,BKN,,,22,21,21,2
22023,1630560,22300430,"DEC 29, 2023",BKN @ WAS,L,24,6,15,0.4,0,1,0.0,3,6,0.5,0,1,1,3,0,0,1,0,15,-14,1,Cam Thomas,BKN,WAS,BKN,,,19,16,18,4
22023,1630560,22300417,"DEC 27, 2023",BKN vs. MIL,L,12,4,9,0.444,0,2,0.0,0,0,0.0,0,0,0,0,1,0,0,1,8,-1,1,Cam Thomas,BKN,BKN,MIL,,,8,8,8,0
22023,1630560,22300406,"DEC 26, 2023",BKN @ DET,W,23,7,13,0.538,0,1,0.0,3,4,0.75,0,1,1,1,0,0,2,4,17,-4,1,Cam Thomas,BKN,DET,BKN,,,19,18,18,2
22023,1630560,22300394,"DEC 23, 2023",BKN vs. DET,W,28,7,16,0.438,1,3,0.333,5,5,1.0,0,2,2,3,1,0,2,3,20,2,1,Cam Thomas,BKN,BKN,DET,,,25,22,23,5
22023,1630560,22300383,"DEC 22, 2023",BKN vs. DEN,L,34,8,21,0.381,1,6,0.167,6,6,1.0,0,0,0,2,0,0,2,5,23,-5,1,Cam Thomas,BKN,BKN,DEN,,,25,23,25,2
22023,1630560,22300368,"DEC 20, 2023",BKN vs. NYK,L,32,8,18,0.444,4,7,0.571,0,1,0.0,1,1,2,5,0,0,1,2,20,-25,1,Cam Thomas,BKN,BKN,NYK,,,27,22,25,7
22023,1630560,22300357,"DEC 18, 2023",BKN @ UTA,L,37,12,23,0.522,5,7,0.714,3,3,1.0,2,2,4,3,1,1,3,1,32,-17,1,Cam Thomas,BKN,UTA,BKN,,,39,36,35,7
22023,1630560,22300339,"DEC 16, 2023",BKN @ GSW,L,37,15,24,0.625,5,13,0.385,6,6,1.0,0,5,5,2,1,0,5,5,41,-3,1,Cam Thomas,BKN,GSW,BKN,,,48,46,43,7
22023,1630560,22300322,"DEC 14, 2023",BKN @ DEN,L,27,5,13,0.385,0,2,0.0,3,6,0.5,0,3,3,0,0,0,0,3,13,-25,1,Cam Thomas,BKN,DEN,BKN,,,16,16,13,3
22023,1630560,22300317,"DEC 13, 2023",BKN @ PHX,W,28,6,17,0.353,4,8,0.5,8,8,1.0,1,1,2,4,1,1,2,0,24,-5,1,Cam Thomas,BKN,PHX,BKN,,,30,26,28,6
22023,1630560,22300303,"DEC 11, 2023",BKN @ SAC,L,31,8,21,0.381,2,6,0.333,2,2,1.0,0,0,0,2,0,0,2,2,20,-15,1,Cam Thomas,BKN,SAC,BKN,,,22,20,22,2
22023,1630560,22301219,"DEC 08, 2023",BKN vs. WAS,W,29,7,19,0.368,2,4,0.5,1,2,0.5,0,2,2,4,1,1,2,3,17,14,1,Cam Thomas,BKN,BKN,WAS,,,23,19,21,6
22023,1630560,22301209,"DEC 06, 2023",BKN @ ATL,W,27,3,10,0.3,0,2,0.0,0,0,0.0,0,1,1,1,0,0,5,2,6,-5,1,Cam Thomas,BKN,ATL,BKN,,,8,7,7,2
22023,1630560,22300282,"DEC 02, 2023",BKN vs. ORL,W,38,7,23,0.304,4,9,0.444,2,2,1.0,0,7,7,5,0,0,2,3,20,11,1,Cam Thomas,BKN,BKN,ORL,,,32,27,25,12
22023,1630560,22300266,"NOV 30, 2023",BKN vs. CHA,L,25,11,21,0.524,2,5,0.4,2,3,0.667,0,2,2,1,0,1,1,1,26,0,1,Cam Thomas,BKN,BKN,CHA,,,29,28,27,3
22023,1630560,22300160,"NOV 08, 2023",BKN vs. LAC,W,20,6,14,0.429,0,2,0.0,2,2,1.0,0,2,2,0,0,1,2,1,14,1,1,Cam Thomas,BKN,BKN,LAC,,,16,16,14,2
22023,1630560,22300149,"NOV 06, 2023",BKN vs. MIL,L,41,17,33,0.515,6,16,0.375,5,6,0.833,1,3,4,3,1,0,1,3,45,3,1,Cam Thomas,BKN,BKN,MIL,,,52,49,48,7
22023,1630560,22300136,"NOV 04, 2023",BKN vs. BOS,L,37,11,24,0.458,2,6,0.333,3,3,1.0,0,5,5,3,1,1,0,2,27,-9,1,Cam Thomas,BKN,BKN,BOS,,,35,32,30,8
22023,1630560,22300004,"NOV 03, 2023",BKN @ CHI,W,31,6,18,0.333,3,9,0.333,2,2,1.0,1,4,5,4,0,1,0,1,17,-5,1,Cam Thomas,BKN,CHI,BKN,,,26,22,21,9
22023,1630560,22300119,"NOV 01, 2023",BKN @ MIA,W,34,4,19,0.211,2,7,0.286,3,4,0.75,0,2,2,1,3,1,4,2,13,-9,1,Cam Thomas,BKN,MIA,BKN,,,16,15,14,3
22023,1630560,22300101,"OCT 30, 2023",BKN @ CHA,W,38,10,17,0.588,1,4,0.25,12,14,0.857,0,2,2,2,0,0,2,4,33,8,1,Cam Thomas,BKN,CHA,BKN,,,37,35,35,4
22023,1630560,22300084,"OCT 27, 2023",BKN @ DAL,L,33,12,19,0.632,1,4,0.25,5,5,1.0,0,7,7,2,1,1,0,2,30,3,1,Cam Thomas,BKN,DAL,BKN,,,39,37,32,9
22023,1630560,22300067,"OCT 25, 2023",BKN vs. CLE,L,25,13,21,0.619,2,5,0.4,8,11,0.727,0,3,3,2,1,0,1,0,36,5,1,Cam Thomas,BKN,BKN,CLE,,,41,39,38,5
22023,1641708,22300555,"JAN 15, 2024",HOU @ PHI,L,19,7,8,0.875,0,1,0.0,0,1,0.0,2,1,3,0,1,0,1,2,14,-5,1,Amen Thompson,HOU,PHI,HOU,,,17,17,14,3
22023,1641708,22300542,"JAN 13, 2024",HOU @ BOS,L,25,3,10,0.3,0,0,0.0,4,4,1.0,3,7,10,3,3,0,4,0,10,-14,1,Amen Thompson,HOU,BOS,HOU,,,23,20,13,13
22023,1641708,22300534,"JAN 12, 2024",HOU @ DET,W,8,1,2,0.5,0,0,0.0,0,0,0.0,0,1,1,2,1,0,0,0,2,-8,1,Amen Thompson,HOU,DET,HOU,,,5,3,4,3
22023,1641708,22300523,"JAN 10, 2024",HOU @ CHI,L,14,3,7,0.429,0,3,0.0,0,0,0.0,0,2,2,3,1,0,2,2,6,3,1,Amen Thompson,HOU,CHI,HOU,,,11,8,9,5
22023,1641708,22300509,"JAN 08, 2024",HOU @ MIA,L,11,1,2,0.5,0,0,0.0,3,3,1.0,0,2,2,1,1,1,2,3,5,-5,1,Amen Thompson,HOU,MIA,HOU,,,8,7,6,3
22023,1641708,22300496,"JAN 06, 2024",HOU vs. MIL,W,16,2,3,0.667,0,1,0.0,0,0,0.0,1,2,3,5,0,0,1,2,4,7,1,Amen Thompson,HOU,HOU,MIL,,,12,7,9,8
22023,1641708,22300485,"JAN 05, 2024",HOU vs. MIN,L,20,2,9,0.222,0,2,0.0,2,3,0.667,1,5,6,1,3,0,2,3,6,-20,1,Amen Thompson,HOU,HOU,MIN,,,13,12,7,7
22023,1641708,22300469,"JAN 03, 2024",HOU vs. BKN,W,20,3,7,0.429,1,3,0.333,3,7,0.429,0,6,6,1,0,0,1,1,10,0,1,Amen Thompson,HOU,HOU,BKN,,,17,16,11,7
22023,1641708,22300453,"JAN 01, 2024",HOU vs. DET,W,28,5,6,0.833,1,1,1.0,1,1,1.0,1,3,4,6,2,0,2,3,12,10,1,Amen Thompson,HOU,HOU,DET,,,22,16,18,10
22023,1641708,22300434,"DEC 29, 2023",HOU vs. PHI,L,9,0,1,0.0,0,0,0.0,1,2,0.5,1,2,3,1,0,0,0,1,1,0,1,Amen Thompson,HOU,HOU,PHI,,,5,4,2,4
22023,1641708,22300418,"DEC 27, 2023",HOU vs. PHX,L,17,1,6,0.167,0,1,0.0,0,0,0.0,2,2,4,3,0,1,0,2,2,2,1,Amen Thompson,HOU,HOU,PHX,,,9,6,5,7
22023,1641708,22300409,"DEC 26, 2023",HOU vs. IND,L,12,3,5,0.6,0,0,0.0,1,1,1.0,2,2,4,0,2,0,1,1,7,9,1,Amen Thompson,HOU,HOU,IND,,,11,11,7,4
22023,1641708,22300392,"DEC 23, 2023",HOU @ NOP,W,10,0,1,0.0,0,1,0.0,2,4,0.5,0,0,0,0,1,0,0,0,2,3,1,Amen Thompson,HOU,NOP,HOU,,,2,2,2,0
22023,1641708,22300385,"DEC 22, 2023",HOU vs. DAL,W,22,4,9,0.444,0,2,0.0,1,2,0.5,0,6,6,4,1,0,3,4,9,-3,1,Amen Thompson,HOU,HOU,DAL,,,19,15,13,10
22023,1641708,22300371,"DEC 20, 2023",HOU vs. ATL,L,8,1,2,0.5,0,0,0.0,0,0,0.0,0,2,2,0,0,0,0,1,2,-10,1,Amen Thompson,HOU,HOU,ATL,,,4,4,2,2
22023,1641708,22300298,"DEC 11, 2023",HOU vs. SAS,W,10,1,2,0.5,0,1,0.0,0,0,0.0,2,3,5,1,0,0,0,1,2,7,1,Amen Thompson,HOU,HOU,SAS,,,8,7,3,6
22023,1641708,22300122,"NOV 01, 2023",HOU vs. CHA,W,13,1,3,0.333,0,1,0.0,2,2,1.0,0,1,1,1,1,0,1,3,4,10,1,Amen Thompson,HOU,HOU,CHA,,,6,5,5,2
22023,1641708,22300096,"OCT 29, 2023",HOU vs. GSW,L,20,3,5,0.6,1,2,0.5,2,2,1.0,0,4,4,0,1,0,0,3,9,2,1,Amen Thompson,HOU,HOU,GSW,,,13,13,9,4
22023,1641708,22300083,"OCT 27, 2023",HOU @ SAS,L,13,2,4,0.5,0,1,0.0,0,2,0.0,0,1,1,3,0,1,1,1,4,1,1,Amen Thompson,HOU,SAS,HOU,,,8,5,7,4
22023,1641708,22300066,"OCT 25, 2023",HOU @ ORL,L,21,3,10,0.3,1,7,0.143,1,2,0.5,1,4,5,2,0,0,4,2,8,-34,1,Amen Thompson,HOU,ORL,HOU,,,15,13,10,7
22023,1641709,22300558,"JAN 15, 2024",DET @ WAS,W,27,6,8,0.75,0,1,0.0,2,3,0.667,1,7,8,2,3,0,0,2,14,9,1,Ausar Thompson,DET,WAS,DET,,,24,22,16,10
22023,1641709,22300534,"JAN 12, 2024",DET vs. HOU,L,18,2,3,0.667,0,1,0.0,0,0,0.0,2,6,8,0,0,0,1,2,4,5,1,Ausar Thompson,DET,DET,HOU,,,12,12,4,8
22023,1641709,22300519,"JAN 10, 2024",DET vs. SAS,L,15,1,6,0.167,0,3,0.0,1,1,1.0,0,6,6,1,0,1,1,4,3,-10,1,Ausar Thompson,DET,DET,SAS,,,10,9,4,7
22023,1641709,22300512,"JAN 09, 2024",DET vs. SAC,L,14,0,2,0.0,0,0,0.0,0,0,0.0,0,2,2,0,3,0,0,3,0,-2,1,Ausar Thompson,DET,DET,SAC,,,2,2,0,2
22023,1641709,22300502,"JAN 07, 2024",DET @ DEN,L,20,2,5,0.4,0,1,0.0,1,2,0.5,3,2,5,4,0,0,1,2,5,0,1,Ausar Thompson,DET,DEN,DET,,,14,10,9,9
22023,1641709,22300490,"JAN 05, 2024",DET @ GSW,L,9,0,3,0.0,0,1,0.0,2,2,1.0,0,4,4,1,2,0,1,3,2,3,1,Ausar Thompson,DET,GSW,DET,,,7,6,3,5
22023,1641709,22300474,"JAN 03, 2024",DET @ UTA,L,11,1,4,0.25,0,1,0.0,0,2,0.0,2,1,3,1,1,1,0,2,2,6,1,Ausar Thompson,DET,UTA,DET,,,6,5,3,4
22023,1641709,22300453,"JAN 01, 2024",DET @ HOU,L,24,2,4,0.5,0,0,0.0,1,2,0.5,1,3,4,2,0,2,2,2,5,-10,1,Ausar Thompson,DET,HOU,DET,,,11,9,7,6
22023,1641709,22300440,"DEC 30, 2023",DET vs. TOR,W,12,2,4,0.5,0,2,0.0,2,2,1.0,0,1,1,0,0,0,0,1,6,3,1,Ausar Thompson,DET,DET,TOR,,,7,7,6,1
22023,1641709,22300421,"DEC 28, 2023",DET @ BOS,L,12,1,2,0.5,0,1,0.0,0,0,0.0,0,3,3,2,0,0,0,1,2,-1,1,Ausar Thompson,DET,BOS,DET,,,7,5,4,5
22023,1641709,22300406,"DEC 26, 2023",DET vs. BKN,L,9,0,2,0.0,0,0,0.0,2,2,1.0,0,1,1,1,1,1,0,2,2,-5,1,Ausar Thompson,DET,DET,BKN,,,4,3,3,2
22023,1641709,22300394,"DEC 23, 2023",DET @ BKN,L,31,2,7,0.286,1,3,0.333,2,3,0.667,1,4,5,2,1,0,0,2,7,-2,1,Ausar Thompson,DET,BKN,DET,,,14,12,9,7
22023,1641709,22300374,"DEC 21, 2023",DET vs. UTA,L,19,3,3,1.0,0,0,0.0,1,2,0.5,1,1,2,1,1,2,3,2,7,-18,1,Ausar Thompson,DET,DET,UTA,,,10,9,8,3
22023,1641709,22300352,"DEC 18, 2023",DET @ ATL,L,19,1,5,0.2,0,1,0.0,0,0,0.0,3,5,8,3,1,0,2,2,2,-16,1,Ausar Thompson,DET,ATL,DET,,,13,10,5,11
22023,1641709,22300334,"DEC 16, 2023",DET @ MIL,L,24,3,6,0.5,1,3,0.333,0,0,0.0,0,6,6,1,0,0,0,4,7,-17,1,Ausar Thompson,DET,MIL,DET,,,14,13,8,7
22023,1641709,22300327,"DEC 15, 2023",DET @ PHI,L,22,3,5,0.6,0,0,0.0,2,2,1.0,0,3,3,1,0,1,1,2,8,-15,1,Ausar Thompson,DET,PHI,DET,,,12,11,9,4
22023,1641709,22300310,"DEC 13, 2023",DET vs. PHI,L,30,5,7,0.714,0,1,0.0,0,0,0.0,2,6,8,3,1,0,0,3,10,-1,1,Ausar Thompson,DET,DET,PHI,,,21,18,13,11
22023,1641709,22300293,"DEC 11, 2023",DET vs. IND,L,33,8,10,0.8,1,2,0.5,3,5,0.6,2,4,6,2,1,1,1,4,20,-8,1,Ausar Thompson,DET,DET,IND,,,28,26,22,8
22023,1641709,22301217,"DEC 08, 2023",DET @ ORL,L,20,2,12,0.167,0,5,0.0,1,2,0.5,1,1,2,2,1,0,0,3,5,-15,1,Ausar Thompson,DET,ORL,DET,,,9,7,7,4
22023,1641709,22301206,"DEC 06, 2023",DET vs. MEM,L,16,2,6,0.333,1,4,0.25,0,0,0.0,2,2,4,0,0,0,0,0,5,-15,1,Ausar Thompson,DET,DET,MEM,,,9,9,5,4
22023,1641709,22300283,"DEC 02, 2023",DET vs. CLE,L,16,2,6,0.333,0,2,0.0,0,0,0.0,4,4,8,0,0,0,2,5,4,-14,1,Ausar Thompson,DET,DET,CLE,,,12,12,4,8
22023,1641709,22300268,"NOV 30, 2023",DET @ NYK,L,13,1,2,0.5,1,1,1.0,0,0,0.0,1,6,7,0,0,0,3,5,3,-13,1,Ausar Thompson,DET,NYK,DET,,,10,10,3,7
22023,1641709,22300258,"NOV 29, 2023",DET vs. LAL,L,21,6,11,0.545,0,3,0.0,0,0,0.0,1,5,6,0,1,0,0,4,12,-23,1,Ausar Thompson,DET,DET,LAL,,,18,18,12,6
22023,1641709,22300253,"NOV 27, 2023",DET vs. WAS,L,28,8,14,0.571,0,2,0.0,0,0,0.0,0,4,4,2,2,1,1,4,16,-3,1,Ausar Thompson,DET,DET,WAS,,,22,20,18,6
22023,1641709,22300047,"NOV 24, 2023",DET @ IND,L,30,4,5,0.8,0,0,0.0,0,0,0.0,1,5,6,3,0,2,1,2,8,6,1,Ausar Thompson,DET,IND,DET,,,17,14,11,9
22023,1641709,22300218,"NOV 20, 2023",DET vs. DEN,L,24,4,10,0.4,0,0,0.0,0,0,0.0,3,4,7,0,0,2,0,5,8,-7,1,Ausar Thompson,DET,DET,DEN,,,15,15,8,7
22023,1641709,22300211,"NOV 19, 2023",DET @ TOR,L,30,3,5,0.6,0,1,0.0,3,4,0.75,1,9,10,2,1,1,5,6,9,-21,1,Ausar Thompson,DET,TOR,DET,,,21,19,11,12
22023,1641709,22300030,"NOV 17, 2023",DET @ CLE,L,17,4,8,0.5,0,1,0.0,1,3,0.333,5,5,10,2,0,0,5,4,9,-5,1,Ausar Thompson,DET,CLE,DET,,,21,19,11,12
22023,1641709,22300018,"NOV 14, 2023",DET vs. ATL,L,35,9,12,0.75,0,1,0.0,3,6,0.5,1,7,8,5,3,2,2,3,21,-4,1,Ausar Thompson,DET,DET,ATL,,,34,29,26,13
22023,1641709,22300181,"NOV 12, 2023",DET @ CHI,L,32,2,9,0.222,0,1,0.0,5,7,0.714,6,10,16,2,0,2,3,1,9,-19,1,Ausar Thompson,DET,CHI,DET,,,27,25,11,18
22023,1641709,22300008,"NOV 10, 2023",DET vs. PHI,L,32,6,11,0.545,0,1,0.0,0,1,0.0,3,10,13,4,1,3,2,4,12,2,1,Ausar Thompson,DET,DET,PHI,,,29,25,16,17
22023,1641709,22300165,"NOV 08, 2023",DET @ MIL,L,37,3,8,0.375,0,1,0.0,0,0,0.0,3,12,15,3,0,1,2,4,6,-6,1,Ausar Thompson,DET,MIL,DET,,,24,21,9,18
22023,1641709,22300145,"NOV 06, 2023",DET vs. GSW,L,38,6,10,0.6,1,4,0.25,3,3,1.0,4,3,7,2,4,0,1,2,16,3,1,Ausar Thompson,DET,DET,GSW,,,25,23,18,9
22023,1641709,22300140,"NOV 05, 2023",DET vs. PHX,L,38,6,14,0.429,2,3,0.667,0,0,0.0,5,4,9,4,4,4,1,3,14,-13,1,Ausar Thompson,DET,DET,PHX,,,27,23,18,13
22023,1641709,22300129,"NOV 02, 2023",DET @ NOP,L,25,5,17,0.294,0,6,0.0,6,7,0.857,5,2,7,5,0,1,3,5,16,-16,1,Ausar Thompson,DET,NOP,DET,,,28,23,21,12
22023,1641709,22300115,"NOV 01, 2023",DET vs. POR,L,30,8,14,0.571,0,3,0.0,0,0,0.0,3,4,7,2,2,0,2,4,16,-9,1,Ausar Thompson,DET,DET,POR,,,25,23,18,9
22023,1641709,22300109,"OCT 30, 2023",DET @ OKC,L,31,6,14,0.429,0,2,0.0,3,4,0.75,7,3,10,3,1,3,3,4,15,-13,1,Ausar Thompson,DET,OKC,DET,,,28,25,18,13
22023,1641709,22300088,"OCT 28, 2023",DET vs. CHI,W,31,3,7,0.429,0,2,0.0,3,4,0.75,3,9,12,5,1,1,2,3,9,6,1,Ausar Thompson,DET,DET,CHI,,,26,21,14,17
22023,1641709,22300077,"OCT 27, 2023",DET @ CHA,W,30,2,9,0.222,0,1,0.0,2,2,1.0,4,9,13,6,0,1,3,5,6,10,1,Ausar Thompson,DET,CHA,DET,,,25,19,12,19
22023,1641709,22300068,"OCT 25, 2023",DET @ MIA,L,27,1,7,0.143,1,2,0.5,1,2,0.5,3,4,7,3,0,5,2,2,4,-14,1,Ausar Thompson,DET,MIA,DET,,,14,11,7,10
22023,202691,22300560,"JAN 15, 2024",GSW @ MEM,L,34,4,10,0.4,1,4,0.25,0,0,0.0,0,0,0,3,0,0,0,1,9,-22,1,Klay Thompson,GSW,MEM,GSW,,,12,9,12,3
22023,202691,22300545,"JAN 13, 2024",GSW @ MIL,L,36,7,23,0.304,6,17,0.353,1,1,1.0,2,1,3,3,0,0,2,2,21,-8,1,Klay Thompson,GSW,MIL,GSW,,,27,24,24,6
22023,202691,22300536,"JAN 12, 2024",GSW @ CHI,W,34,9,19,0.474,7,15,0.467,5,6,0.833,2,4,6,6,1,1,1,1,30,10,1,Klay Thompson,GSW,CHI,GSW,,,42,36,36,12
22023,202691,22300525,"JAN 10, 2024",GSW vs. NOP,L,24,5,10,0.5,3,7,0.429,0,0,0.0,1,3,4,2,0,1,3,1,13,-17,1,Klay Thompson,GSW,GSW,NOP,,,19,17,15,6
22023,202691,22300504,"JAN 07, 2024",GSW vs. TOR,L,28,10,15,0.667,5,7,0.714,0,0,0.0,0,0,0,3,0,0,2,0,25,-16,1,Klay Thompson,GSW,GSW,TOR,,,28,25,28,3
22023,202691,22300490,"JAN 05, 2024",GSW vs. DET,W,35,6,18,0.333,3,9,0.333,4,4,1.0,1,2,3,4,1,2,2,2,19,14,1,Klay Thompson,GSW,GSW,DET,,,26,22,23,7
22023,202691,22300478,"JAN 04, 2024",GSW vs. DEN,L,35,9,18,0.5,4,10,0.4,2,2,1.0,0,3,3,3,1,1,0,2,24,-9,1,Klay Thompson,GSW,GSW,DEN,,,30,27,27,6
22023,202691,22300463,"JAN 02, 2024",GSW vs. ORL,W,25,6,11,0.545,3,8,0.375,0,0,0.0,0,3,3,2,0,1,1,4,15,4,1,Klay Thompson,GSW,GSW,ORL,,,20,18,17,5
22023,202691,22300444,"DEC 30, 2023",GSW vs. DAL,L,26,1,11,0.091,1,6,0.167,0,0,0.0,0,2,2,1,0,0,1,0,3,-7,1,Klay Thompson,GSW,GSW,DAL,,,6,5,4,3
22023,202691,22300426,"DEC 28, 2023",GSW vs. MIA,L,25,4,11,0.364,2,6,0.333,3,4,0.75,0,0,0,5,2,0,0,2,13,-26,1,Klay Thompson,GSW,GSW,MIA,,,18,13,18,5
22023,202691,22300402,"DEC 25, 2023",GSW @ DEN,L,32,3,12,0.25,3,10,0.3,0,0,0.0,0,6,6,1,1,1,3,1,9,-2,1,Klay Thompson,GSW,DEN,GSW,,,16,15,10,7
22023,202691,22300399,"DEC 23, 2023",GSW vs. POR,W,31,11,16,0.688,6,10,0.6,0,0,0.0,1,2,3,0,0,0,3,1,28,14,1,Klay Thompson,GSW,GSW,POR,,,31,31,28,3
22023,202691,22300386,"DEC 22, 2023",GSW vs. WAS,W,27,8,17,0.471,4,10,0.4,0,0,0.0,0,3,3,2,0,0,2,0,20,7,1,Klay Thompson,GSW,GSW,WAS,,,25,23,22,5
22023,202691,22300362,"DEC 19, 2023",GSW vs. BOS,W,40,9,21,0.429,6,15,0.4,0,0,0.0,0,4,4,4,1,1,1,0,24,7,1,Klay Thompson,GSW,GSW,BOS,,,32,28,28,8
22023,202691,22300348,"DEC 17, 2023",GSW @ POR,W,29,11,16,0.688,5,10,0.5,1,1,1.0,0,4,4,1,1,0,1,3,28,-5,1,Klay Thompson,GSW,POR,GSW,,,33,32,29,5
22023,202691,22300339,"DEC 16, 2023",GSW vs. BKN,W,34,7,19,0.368,4,9,0.444,6,6,1.0,2,3,5,3,1,0,0,2,24,6,1,Klay Thompson,GSW,GSW,BKN,,,32,29,27,8
22023,202691,22300325,"DEC 14, 2023",GSW @ LAC,L,32,9,15,0.6,8,12,0.667,4,4,1.0,0,1,1,5,2,0,0,1,30,-12,1,Klay Thompson,GSW,LAC,GSW,,,36,31,35,6
22023,202691,22300308,"DEC 12, 2023",GSW @ PHX,L,27,2,10,0.2,1,8,0.125,2,2,1.0,0,5,5,0,0,0,1,1,7,4,1,Klay Thompson,GSW,PHX,GSW,,,12,12,7,5
22023,202691,22301222,"DEC 08, 2023",GSW @ OKC,L,39,8,15,0.533,4,9,0.444,2,2,1.0,1,3,4,0,0,1,4,4,22,11,1,Klay Thompson,GSW,OKC,GSW,,,26,26,22,4
22023,202691,22301214,"DEC 06, 2023",GSW vs. POR,W,27,3,13,0.231,1,8,0.125,4,4,1.0,0,5,5,1,0,0,0,0,11,-6,1,Klay Thompson,GSW,GSW,POR,,,17,16,12,6
22023,202691,22300280,"DEC 02, 2023",GSW @ LAC,L,33,5,13,0.385,4,11,0.364,3,4,0.75,1,5,6,2,1,0,2,3,17,-2,1,Klay Thompson,GSW,LAC,GSW,,,25,23,19,8
22023,202691,22300273,"NOV 30, 2023",GSW vs. LAC,W,34,8,18,0.444,2,7,0.286,4,4,1.0,2,4,6,2,0,1,2,2,22,8,1,Klay Thompson,GSW,GSW,LAC,,,30,28,24,8
22023,202691,22300060,"NOV 28, 2023",GSW @ SAC,L,36,6,14,0.429,3,9,0.333,5,6,0.833,0,9,9,2,1,2,3,2,20,-5,1,Klay Thompson,GSW,SAC,GSW,,,31,29,22,11
22023,202691,22300051,"NOV 24, 2023",GSW vs. SAS,W,29,3,11,0.273,3,8,0.375,6,7,0.857,1,2,3,6,1,0,2,3,15,7,1,Klay Thompson,GSW,GSW,SAS,,,24,18,21,9
22023,202691,22300236,"NOV 22, 2023",GSW @ PHX,L,25,8,17,0.471,6,10,0.6,1,1,1.0,1,2,3,1,0,1,2,3,23,-24,1,Klay Thompson,GSW,PHX,GSW,,,27,26,24,4
22023,202691,22300224,"NOV 20, 2023",GSW vs. HOU,W,31,7,16,0.438,5,11,0.455,1,1,1.0,0,3,3,3,0,0,1,1,20,-3,1,Klay Thompson,GSW,GSW,HOU,,,26,23,23,6
22023,202691,22300207,"NOV 18, 2023",GSW vs. OKC,L,37,5,13,0.385,3,9,0.333,3,3,1.0,0,2,2,4,0,1,4,4,16,4,1,Klay Thompson,GSW,GSW,OKC,,,22,18,20,6
22023,202691,22300201,"NOV 16, 2023",GSW vs. OKC,L,27,1,10,0.1,1,6,0.167,2,2,1.0,0,2,2,3,1,0,2,1,5,-2,1,Klay Thompson,GSW,GSW,OKC,,,10,7,8,5
22023,202691,22300025,"NOV 14, 2023",GSW vs. MIN,L,2,0,1,0.0,0,1,0.0,0,0,0.0,0,0,0,0,0,0,0,0,0,-2,1,Klay Thompson,GSW,GSW,MIN,,,0,0,0,0
22023,202691,22300186,"NOV 12, 2023",GSW vs. MIN,L,33,5,16,0.313,3,10,0.3,3,3,1.0,0,5,5,3,1,0,1,1,16,4,1,Klay Thompson,GSW,GSW,MIN,,,24,21,19,8
22023,202691,22300176,"NOV 11, 2023",GSW vs. CLE,L,28,5,16,0.313,2,5,0.4,2,2,1.0,1,4,5,1,0,1,3,3,14,-7,1,Klay Thompson,GSW,GSW,CLE,,,20,19,15,6
22023,202691,22300169,"NOV 08, 2023",GSW @ DEN,L,32,5,12,0.417,2,8,0.25,3,6,0.5,0,6,6,1,1,0,2,1,15,-13,1,Klay Thompson,GSW,DEN,GSW,,,22,21,16,7
22023,202691,22300145,"NOV 06, 2023",GSW @ DET,W,28,8,16,0.5,1,8,0.125,0,0,0.0,1,0,1,3,0,0,2,1,17,1,1,Klay Thompson,GSW,DET,GSW,,,21,18,20,4
22023,202691,22300142,"NOV 05, 2023",GSW @ CLE,L,32,5,14,0.357,3,9,0.333,2,2,1.0,2,1,3,2,1,0,2,2,15,-12,1,Klay Thompson,GSW,CLE,GSW,,,20,18,17,5
22023,202691,22300005,"NOV 03, 2023",GSW @ OKC,W,33,6,10,0.6,4,6,0.667,2,2,1.0,0,3,3,1,0,0,1,4,18,0,1,Klay Thompson,GSW,OKC,GSW,,,22,21,19,4
22023,202691,22300126,"NOV 01, 2023",GSW vs. SAC,W,29,6,15,0.4,1,4,0.25,1,1,1.0,1,1,2,2,0,3,2,3,14,10,1,Klay Thompson,GSW,GSW,SAC,,,18,16,16,4
22023,202691,22300096,"OCT 29, 2023",GSW @ HOU,W,29,7,12,0.583,5,10,0.5,0,0,0.0,1,3,4,0,0,1,1,3,19,-2,1,Klay Thompson,GSW,HOU,GSW,,,23,23,19,4
22023,202691,22300087,"OCT 27, 2023",GSW @ SAC,W,33,7,12,0.583,2,4,0.5,2,2,1.0,0,3,3,4,1,0,3,4,18,4,1,Klay Thompson,GSW,SAC,GSW,,,25,21,22,7
22023,202691,22300062,"OCT 24, 2023",GSW vs. PHX,L,36,6,18,0.333,3,11,0.273,0,0,0.0,1,6,7,3,0,1,3,3,15,9,1,Klay Thompson,GSW,GSW,PHX,,,25,22,18,10
22023,202684,22300561,"JAN 15, 2024",CLE vs. CHI,W,14,2,4,0.5,0,0,0.0,0,0,0.0,1,1,2,1,0,0,0,0,4,-14,1,Tristan Thompson,CLE,CLE,CHI,,,7,6,5,3
22023,202684,22300527,"JAN 11, 2024",CLE vs. BKN,W,10,0,0,0.0,0,0,0.0,1,4,0.25,1,1,2,0,1,0,1,3,1,3,1,Tristan Thompson,CLE,CLE,BKN,,,3,3,1,2
22023,202684,22300497,"JAN 07, 2024",CLE vs. SAS,W,17,3,4,0.75,0,0,0.0,2,4,0.5,2,2,4,2,0,0,1,4,8,12,1,Tristan Thompson,CLE,CLE,SAS,,,14,12,10,6
22023,202684,22300482,"JAN 05, 2024",CLE vs. WAS,W,17,4,5,0.8,0,0,0.0,0,2,0.0,2,2,4,2,0,0,2,6,8,7,1,Tristan Thompson,CLE,CLE,WAS,,,14,12,10,6
22023,202684,22300465,"JAN 03, 2024",CLE vs. WAS,W,19,3,7,0.429,0,0,0.0,1,3,0.333,3,6,9,4,0,1,3,1,7,12,1,Tristan Thompson,CLE,CLE,WAS,,,20,16,11,13
22023,202684,22300452,"JAN 01, 2024",CLE @ TOR,L,14,0,0,0.0,0,0,0.0,0,0,0.0,2,1,3,1,0,0,0,3,0,-1,1,Tristan Thompson,CLE,TOR,CLE,,,4,3,1,4
22023,202684,22300433,"DEC 29, 2023",CLE vs. MIL,L,8,1,2,0.5,0,0,0.0,0,2,0.0,2,4,6,1,0,0,0,2,2,4,1,Tristan Thompson,CLE,CLE,MIL,,,9,8,3,7
22023,202684,22300420,"DEC 27, 2023",CLE @ DAL,W,13,1,3,0.333,0,0,0.0,0,0,0.0,1,0,1,0,0,0,2,4,2,-11,1,Tristan Thompson,CLE,DAL,CLE,,,3,3,2,1
22023,202684,22300396,"DEC 23, 2023",CLE @ CHI,W,13,3,4,0.75,0,0,0.0,0,0,0.0,4,2,6,1,0,0,1,1,6,8,1,Tristan Thompson,CLE,CHI,CLE,,,13,12,7,7
22023,202684,22300375,"DEC 21, 2023",CLE vs. NOP,L,21,3,5,0.6,0,0,0.0,0,0,0.0,4,3,7,3,0,0,0,2,6,-13,1,Tristan Thompson,CLE,CLE,NOP,,,16,13,9,10
22023,202684,22300364,"DEC 20, 2023",CLE vs. UTA,W,18,5,7,0.714,0,0,0.0,0,0,0.0,2,3,5,4,4,0,0,2,10,12,1,Tristan Thompson,CLE,CLE,UTA,,,19,15,14,9
22023,202684,22300349,"DEC 18, 2023",CLE vs. HOU,W,18,1,2,0.5,0,0,0.0,2,8,0.25,3,2,5,1,0,0,0,2,4,2,1,Tristan Thompson,CLE,CLE,HOU,,,10,9,5,6
22023,202684,22300336,"DEC 16, 2023",CLE vs. ATL,W,13,3,3,1.0,0,0,0.0,0,0,0.0,2,3,5,0,0,0,0,3,6,3,1,Tristan Thompson,CLE,CLE,ATL,,,11,11,6,5
22023,202684,22300319,"DEC 14, 2023",CLE @ BOS,L,3,1,1,1.0,0,0,0.0,0,0,0.0,1,1,2,0,0,0,1,1,2,-3,1,Tristan Thompson,CLE,BOS,CLE,,,4,4,2,2
22023,202684,22300305,"DEC 12, 2023",CLE @ BOS,L,12,1,1,1.0,0,0,0.0,0,0,0.0,3,1,4,1,0,0,0,0,2,-11,1,Tristan Thompson,CLE,BOS,CLE,,,7,6,3,5
22023,202684,22300294,"DEC 11, 2023",CLE @ ORL,L,29,5,7,0.714,0,0,0.0,0,0,0.0,4,9,13,2,0,2,1,1,10,8,1,Tristan Thompson,CLE,ORL,CLE,,,25,23,12,15
22023,202684,22301220,"DEC 08, 2023",CLE @ MIA,W,16,2,3,0.667,0,0,0.0,1,2,0.5,2,1,3,0,0,0,1,0,5,21,1,Tristan Thompson,CLE,MIA,CLE,,,8,8,5,3
22023,202684,22301205,"DEC 06, 2023",CLE vs. ORL,W,6,0,0,0.0,0,0,0.0,1,2,0.5,0,3,3,0,0,1,0,1,1,-3,1,Tristan Thompson,CLE,CLE,ORL,,,4,4,1,3
22023,202684,22300283,"DEC 02, 2023",CLE @ DET,W,3,0,1,0.0,0,0,0.0,0,0,0.0,1,1,2,0,0,0,0,0,0,0,1,Tristan Thompson,CLE,DET,CLE,,,2,2,0,2
22023,202684,22300251,"NOV 26, 2023",CLE vs. TOR,W,7,2,2,1.0,0,0,0.0,0,0,0.0,4,0,4,4,0,0,1,0,4,7,1,Tristan Thompson,CLE,CLE,TOR,,,12,8,8,8
22023,202684,22300229,"NOV 22, 2023",CLE vs. MIA,L,13,2,3,0.667,0,0,0.0,0,2,0.0,2,1,3,0,0,1,0,1,4,2,1,Tristan Thompson,CLE,CLE,MIA,,,7,7,4,3
22023,202684,22300040,"NOV 21, 2023",CLE @ PHI,W,15,1,1,1.0,0,0,0.0,0,2,0.0,1,2,3,2,1,1,0,0,2,4,1,Tristan Thompson,CLE,PHI,CLE,,,7,5,4,5
22023,202684,22300210,"NOV 19, 2023",CLE vs. DEN,W,11,2,4,0.5,0,0,0.0,1,2,0.5,1,2,3,0,0,0,0,2,5,-23,1,Tristan Thompson,CLE,CLE,DEN,,,8,8,5,3
22023,202684,22300030,"NOV 17, 2023",CLE vs. DET,W,1,0,0,0.0,0,0,0.0,0,0,0.0,0,0,0,0,0,0,0,0,0,-2,1,Tristan Thompson,CLE,CLE,DET,,,0,0,0,0
22023,202684,22300199,"NOV 15, 2023",CLE @ POR,W,2,0,0,0.0,0,0,0.0,0,0,0.0,0,1,1,0,0,0,0,0,0,0,1,Tristan Thompson,CLE,POR,CLE,,,1,1,0,1
22023,202684,22300191,"NOV 13, 2023",CLE @ SAC,L,13,1,1,1.0,0,0,0.0,0,0,0.0,0,1,1,0,0,0,0,2,2,8,1,Tristan Thompson,CLE,SAC,CLE,,,3,3,2,1
22023,202684,22300176,"NOV 11, 2023",CLE @ GSW,W,2,0,0,0.0,0,0,0.0,0,0,0.0,0,0,0,0,0,0,0,0,0,-8,1,Tristan Thompson,CLE,GSW,CLE,,,0,0,0,0
22023,202684,22300167,"NOV 08, 2023",CLE @ OKC,L,13,0,0,0.0,0,0,0.0,1,2,0.5,0,2,2,2,1,0,2,2,1,-2,1,Tristan Thompson,CLE,OKC,CLE,,,5,3,3,4
22023,202684,22300142,"NOV 05, 2023",CLE vs. GSW,W,11,1,2,0.5,0,0,0.0,1,3,0.333,1,4,5,0,0,1,0,2,3,2,1,Tristan Thompson,CLE,CLE,GSW,,,8,8,3,5
22023,202684,22300001,"NOV 03, 2023",CLE @ IND,L,3,0,0,0.0,0,0,0.0,0,0,0.0,0,1,1,0,0,0,0,1,0,-8,1,Tristan Thompson,CLE,IND,CLE,,,1,1,0,1
22023,202684,22300120,"NOV 01, 2023",CLE @ NYK,W,13,3,4,0.75,0,0,0.0,0,0,0.0,2,3,5,0,0,0,2,1,6,-2,1,Tristan Thompson,CLE,NYK,CLE,,,11,11,6,5
22023,202684,22300112,"OCT 31, 2023",CLE vs. NYK,L,19,1,1,1.0,0,0,0.0,2,2,1.0,1,1,2,1,0,2,2,2,4,-1,1,Tristan Thompson,CLE,CLE,NYK,,,7,6,5,3
22023,202684,22300091,"OCT 28, 2023",CLE vs. IND,L,8,2,3,0.667,0,0,0.0,0,0,0.0,4,1,5,2,0,0,0,0,4,1,1,Tristan Thompson,CLE,CLE,IND,,,11,9,6,7
22023,1630550,22300551,"JAN 14, 2024",CHA @ MIA,L,10,0,6,0.0,0,0,0.0,0,0,0.0,4,0,4,1,0,1,0,1,0,-10,1,JT Thor,CHA,MIA,CHA,,,5,4,1,5
22023,1630550,22300541,"JAN 12, 2024",CHA @ SAS,L,19,2,7,0.286,1,3,0.333,0,0,0.0,2,2,4,0,0,0,1,3,5,-1,1,JT Thor,CHA,SAS,CHA,,,9,9,5,4
22023,1630550,22300518,"JAN 10, 2024",CHA vs. SAC,L,21,1,7,0.143,0,2,0.0,0,0,0.0,2,3,5,0,0,0,0,2,2,-27,1,JT Thor,CHA,CHA,SAC,,,7,7,2,5
22023,1630550,22300506,"JAN 08, 2024",CHA vs. CHI,L,21,4,12,0.333,1,2,0.5,0,0,0.0,6,2,8,0,0,2,0,1,9,0,1,JT Thor,CHA,CHA,CHI,,,17,17,9,8
22023,1630550,22300484,"JAN 05, 2024",CHA @ CHI,L,16,1,2,0.5,0,0,0.0,0,0,0.0,0,2,2,1,0,0,0,1,2,-6,1,JT Thor,CHA,CHI,CHA,,,5,4,3,3
22023,1630550,22300464,"JAN 02, 2024",CHA @ SAC,W,6,1,2,0.5,0,1,0.0,0,0,0.0,0,2,2,0,0,0,0,0,2,12,1,JT Thor,CHA,SAC,CHA,,,4,4,2,2
22023,1630550,22300455,"JAN 01, 2024",CHA @ DEN,L,4,1,2,0.5,0,0,0.0,0,0,0.0,0,2,2,0,0,1,0,0,2,6,1,JT Thor,CHA,DEN,CHA,,,4,4,2,2
22023,1630550,22300428,"DEC 28, 2023",CHA @ LAL,L,6,1,1,1.0,1,1,1.0,0,0,0.0,0,0,0,1,0,0,0,0,3,6,1,JT Thor,CHA,LAL,CHA,,,4,3,4,1
22023,1630550,22300365,"DEC 20, 2023",CHA @ IND,L,6,0,0,0.0,0,0,0.0,2,2,1.0,1,0,1,0,0,0,0,2,2,-5,1,JT Thor,CHA,IND,CHA,,,3,3,2,1
22023,1630550,22300354,"DEC 18, 2023",CHA @ TOR,L,14,2,2,1.0,0,0,0.0,1,1,1.0,2,1,3,0,0,1,0,0,5,2,1,JT Thor,CHA,TOR,CHA,,,8,8,5,3
22023,1630550,22300335,"DEC 16, 2023",CHA vs. PHI,L,22,1,8,0.125,0,3,0.0,0,0,0.0,1,1,2,0,0,0,1,1,2,-13,1,JT Thor,CHA,CHA,PHI,,,4,4,2,2
22023,1630550,22300326,"DEC 15, 2023",CHA vs. NOP,L,14,0,2,0.0,0,1,0.0,0,0,0.0,1,1,2,0,0,2,0,1,0,1,1,JT Thor,CHA,CHA,NOP,,,2,2,0,2
22023,1630550,22300312,"DEC 13, 2023",CHA @ MIA,L,16,0,2,0.0,0,2,0.0,0,0,0.0,0,1,1,0,1,0,1,3,0,-19,1,JT Thor,CHA,MIA,CHA,,,1,1,0,1
22023,1630550,22300292,"DEC 11, 2023",CHA vs. MIA,L,9,0,2,0.0,0,2,0.0,0,0,0.0,0,0,0,0,1,1,0,0,0,-5,1,JT Thor,CHA,CHA,MIA,,,0,0,0,0
22023,1630550,22300266,"NOV 30, 2023",CHA @ BKN,W,16,1,3,0.333,0,2,0.0,0,0,0.0,1,1,2,0,0,0,0,1,2,-2,1,JT Thor,CHA,BKN,CHA,,,4,4,2,2
22023,1630550,22300057,"NOV 28, 2023",CHA @ NYK,L,13,0,0,0.0,0,0,0.0,0,0,0.0,0,2,2,0,0,0,1,1,0,-8,1,JT Thor,CHA,NYK,CHA,,,2,2,0,2
22023,1630550,22300248,"NOV 26, 2023",CHA @ ORL,L,9,2,4,0.5,2,3,0.667,0,0,0.0,0,0,0,0,0,0,0,1,6,-4,1,JT Thor,CHA,ORL,CHA,,,6,6,6,0
22023,1630550,22300225,"NOV 22, 2023",CHA vs. WAS,W,23,2,5,0.4,1,3,0.333,0,0,0.0,0,4,4,1,0,0,0,1,5,7,1,JT Thor,CHA,CHA,WAS,,,10,9,6,5
22023,1630550,22300217,"NOV 20, 2023",CHA vs. BOS,W,5,0,0,0.0,0,0,0.0,0,0,0.0,0,0,0,0,0,0,0,1,0,-7,1,JT Thor,CHA,CHA,BOS,,,0,0,0,0
22023,1630550,22300202,"NOV 18, 2023",CHA vs. NYK,L,11,2,3,0.667,1,2,0.5,0,0,0.0,1,1,2,0,0,1,0,1,5,-9,1,JT Thor,CHA,CHA,NYK,,,7,7,5,2
22023,1630550,22300027,"NOV 17, 2023",CHA vs. MIL,L,6,1,1,1.0,0,0,0.0,0,0,0.0,0,1,1,0,0,0,0,1,2,-12,1,JT Thor,CHA,CHA,MIL,,,3,3,2,1
22023,1630550,22300017,"NOV 14, 2023",CHA vs. MIA,L,28,2,6,0.333,1,2,0.5,0,0,0.0,3,1,4,1,0,0,0,1,5,-7,1,JT Thor,CHA,CHA,MIA,,,10,9,6,5
22023,1630550,22300177,"NOV 12, 2023",CHA @ NYK,L,23,2,6,0.333,2,5,0.4,0,2,0.0,2,2,4,0,0,1,1,4,6,1,1,JT Thor,CHA,NYK,CHA,,,10,10,6,4
22023,1630550,22300009,"NOV 10, 2023",CHA @ WAS,W,20,3,7,0.429,1,2,0.5,0,2,0.0,1,4,5,2,0,0,0,1,7,17,1,JT Thor,CHA,WAS,CHA,,,14,12,9,7
22023,1630550,22300157,"NOV 08, 2023",CHA vs. WAS,L,21,0,3,0.0,0,2,0.0,0,0,0.0,2,3,5,1,0,1,0,3,0,-21,1,JT Thor,CHA,CHA,WAS,,,6,5,1,6
22023,1630550,22300143,"NOV 05, 2023",CHA @ DAL,L,15,0,1,0.0,0,0,0.0,0,0,0.0,1,2,3,1,0,0,0,0,0,-10,1,JT Thor,CHA,DAL,CHA,,,4,3,1,4
22023,1630550,22300133,"NOV 04, 2023",CHA @ IND,W,15,3,3,1.0,1,1,1.0,0,0,0.0,1,3,4,0,0,0,0,1,7,14,1,JT Thor,CHA,IND,CHA,,,11,11,7,4
22023,1630550,22300122,"NOV 01, 2023",CHA @ HOU,L,13,2,4,0.5,1,3,0.333,0,0,0.0,0,5,5,0,3,1,1,2,5,-15,1,JT Thor,CHA,HOU,CHA,,,10,10,5,5
22023,1630550,22300101,"OCT 30, 2023",CHA vs. BKN,L,19,3,6,0.5,1,4,0.25,0,0,0.0,0,2,2,3,0,0,1,1,7,-1,1,JT Thor,CHA,CHA,BKN,,,12,9,10,5
22023,1630550,22300077,"OCT 27, 2023",CHA vs. DET,L,25,1,3,0.333,0,1,0.0,0,0,0.0,1,3,4,0,1,1,0,1,2,0,1,JT Thor,CHA,CHA,DET,,,6,6,2,4
22023,1630550,22300063,"OCT 25, 2023",CHA vs. ATL,W,20,2,7,0.286,1,3,0.333,0,0,0.0,1,1,2,1,0,0,0,0,5,2,1,JT Thor,CHA,CHA,ATL,,,8,7,6,3
22023,1629680,22300538,"JAN 12, 2024",POR @ MIN,L,14,1,3,0.333,1,2,0.5,0,0,0.0,0,1,1,0,2,0,0,1,3,-14,1,Matisse Thybulle,POR,MIN,POR,,,4,4,3,1
22023,1629680,22300529,"JAN 11, 2024",POR @ OKC,L,19,1,5,0.2,0,4,0.0,2,2,1.0,0,0,0,1,1,0,0,1,4,-10,1,Matisse Thybulle,POR,OKC,POR,,,5,4,5,1
22023,1629680,22300514,"JAN 09, 2024",POR @ NYK,L,12,0,1,0.0,0,1,0.0,0,0,0.0,0,1,1,0,1,1,0,0,0,-12,1,Matisse Thybulle,POR,NYK,POR,,,1,1,0,1
22023,1629680,22300487,"JAN 05, 2024",POR @ DAL,L,14,0,2,0.0,0,1,0.0,0,0,0.0,0,2,2,0,1,1,0,0,0,-14,1,Matisse Thybulle,POR,DAL,POR,,,2,2,0,2
22023,1629680,22300472,"JAN 03, 2024",POR @ DAL,L,23,4,6,0.667,4,6,0.667,0,0,0.0,0,2,2,1,1,0,0,4,12,-2,1,Matisse Thybulle,POR,DAL,POR,,,15,14,13,3
22023,1629680,22300456,"JAN 01, 2024",POR @ PHX,L,29,1,5,0.2,1,4,0.25,0,0,0.0,1,3,4,0,2,2,0,2,3,-10,1,Matisse Thybulle,POR,PHX,POR,,,7,7,3,4
22023,1629680,22300437,"DEC 29, 2023",POR vs. SAS,W,27,3,6,0.5,1,4,0.25,0,0,0.0,0,1,1,0,1,2,1,1,7,10,1,Matisse Thybulle,POR,POR,SAS,,,8,8,7,1
22023,1629680,22300427,"DEC 28, 2023",POR vs. SAS,L,28,1,7,0.143,1,7,0.143,1,2,0.5,0,2,2,1,2,0,0,1,4,-6,1,Matisse Thybulle,POR,POR,SAS,,,7,6,5,3
22023,1629680,22300413,"DEC 26, 2023",POR vs. SAC,W,26,2,5,0.4,2,4,0.5,0,0,0.0,1,3,4,4,2,2,1,3,6,26,1,Matisse Thybulle,POR,POR,SAC,,,14,10,10,8
22023,1629680,22300399,"DEC 23, 2023",POR @ GSW,L,16,2,6,0.333,1,5,0.2,0,0,0.0,1,1,2,2,1,0,0,0,5,-14,1,Matisse Thybulle,POR,GSW,POR,,,9,7,7,4
22023,1629680,22300381,"DEC 21, 2023",POR vs. WAS,L,30,0,3,0.0,0,2,0.0,0,0,0.0,2,2,4,2,3,3,0,2,0,19,1,Matisse Thybulle,POR,POR,WAS,,,6,4,2,6
22023,1629680,22300363,"DEC 19, 2023",POR vs. PHX,W,21,2,3,0.667,2,3,0.667,2,2,1.0,0,1,1,0,3,1,0,0,8,17,1,Matisse Thybulle,POR,POR,PHX,,,9,9,8,1
22023,1629680,22300348,"DEC 17, 2023",POR vs. GSW,L,18,1,4,0.25,1,4,0.25,0,0,0.0,1,3,4,1,3,2,0,1,3,4,1,Matisse Thybulle,POR,POR,GSW,,,8,7,4,5
22023,1629680,22300341,"DEC 16, 2023",POR vs. DAL,L,19,2,6,0.333,1,4,0.25,0,0,0.0,1,3,4,0,2,1,1,0,5,-16,1,Matisse Thybulle,POR,POR,DAL,,,9,9,5,4
22023,1629680,22300323,"DEC 14, 2023",POR vs. UTA,L,17,1,5,0.2,1,4,0.25,0,0,0.0,0,3,3,2,1,0,0,1,3,-24,1,Matisse Thybulle,POR,POR,UTA,,,8,6,5,5
22023,1629680,22300304,"DEC 11, 2023",POR @ LAC,L,31,4,6,0.667,3,5,0.6,0,0,0.0,0,1,1,0,1,0,0,3,11,-9,1,Matisse Thybulle,POR,LAC,POR,,,12,12,11,1
22023,1629680,22301226,"DEC 08, 2023",POR vs. DAL,L,36,3,7,0.429,3,5,0.6,0,0,0.0,3,5,8,1,3,1,2,0,9,-11,1,Matisse Thybulle,POR,POR,DAL,,,18,17,10,9
22023,1629680,22301214,"DEC 06, 2023",POR @ GSW,L,31,3,6,0.5,3,5,0.6,0,0,0.0,0,1,1,1,3,1,1,1,9,-2,1,Matisse Thybulle,POR,GSW,POR,,,11,10,10,2
22023,1629680,22300289,"DEC 02, 2023",POR @ UTA,L,33,2,5,0.4,2,4,0.5,0,0,0.0,0,3,3,2,1,2,0,1,6,9,1,Matisse Thybulle,POR,UTA,POR,,,11,9,8,5
22023,1629680,22300265,"NOV 30, 2023",POR @ CLE,W,24,4,8,0.5,2,5,0.4,0,0,0.0,1,1,2,0,1,0,0,1,10,10,1,Matisse Thybulle,POR,CLE,POR,,,12,12,10,2
22023,1629680,22300254,"NOV 27, 2023",POR @ IND,W,29,0,2,0.0,0,2,0.0,0,0,0.0,0,1,1,1,1,1,2,3,0,10,1,Matisse Thybulle,POR,IND,POR,,,2,1,1,2
22023,1629680,22300245,"NOV 26, 2023",POR @ MIL,L,26,1,4,0.25,1,4,0.25,2,2,1.0,0,1,1,1,4,1,2,1,5,4,1,Matisse Thybulle,POR,MIL,POR,,,7,6,6,2
22023,1629680,22300237,"NOV 22, 2023",POR vs. UTA,W,32,5,9,0.556,3,6,0.5,0,1,0.0,1,0,1,2,3,2,3,2,13,24,1,Matisse Thybulle,POR,POR,UTA,,,16,14,15,3
22023,1629680,22300041,"NOV 21, 2023",POR @ PHX,L,22,0,2,0.0,0,2,0.0,0,0,0.0,1,1,2,0,1,1,0,1,0,4,1,Matisse Thybulle,POR,PHX,POR,,,2,2,0,2
22023,1629680,22300215,"NOV 19, 2023",POR vs. OKC,L,19,1,3,0.333,0,2,0.0,0,0,0.0,0,1,1,2,2,0,0,0,2,-27,1,Matisse Thybulle,POR,POR,OKC,,,5,3,4,3
22023,1629680,22300036,"NOV 17, 2023",POR vs. LAL,L,24,2,3,0.667,1,2,0.5,0,0,0.0,1,3,4,1,2,0,2,1,5,-10,1,Matisse Thybulle,POR,POR,LAL,,,10,9,6,5
22023,1629680,22300199,"NOV 15, 2023",POR vs. CLE,L,26,5,6,0.833,3,4,0.75,0,0,0.0,0,3,3,3,3,1,0,1,13,-4,1,Matisse Thybulle,POR,POR,CLE,,,19,16,16,6
22023,1629680,22300023,"NOV 14, 2023",POR @ UTA,L,22,2,5,0.4,2,5,0.4,0,0,0.0,0,2,2,1,0,0,0,1,6,-13,1,Matisse Thybulle,POR,UTA,POR,,,9,8,7,3
22023,1629680,22300187,"NOV 12, 2023",POR @ LAL,L,20,5,9,0.556,4,8,0.5,0,0,0.0,0,2,2,3,1,2,0,2,14,-6,1,Matisse Thybulle,POR,LAL,POR,,,19,16,17,5
22023,1629680,22300170,"NOV 08, 2023",POR @ SAC,L,34,4,8,0.5,1,4,0.25,4,5,0.8,1,1,2,1,4,0,2,1,13,-2,1,Matisse Thybulle,POR,SAC,POR,,,16,15,14,3
22023,1629680,22300144,"NOV 05, 2023",POR vs. MEM,L,19,2,3,0.667,2,3,0.667,0,0,0.0,0,3,3,1,1,2,1,1,6,0,1,Matisse Thybulle,POR,POR,MEM,,,10,9,7,4
22023,1629680,22300007,"NOV 03, 2023",POR vs. MEM,W,19,2,4,0.5,1,3,0.333,0,0,0.0,0,0,0,0,0,2,0,1,5,-3,1,Matisse Thybulle,POR,POR,MEM,,,5,5,5,0
22023,1629680,22300115,"NOV 01, 2023",POR @ DET,W,17,0,3,0.0,0,3,0.0,0,0,0.0,0,1,1,1,1,0,0,1,0,-3,1,Matisse Thybulle,POR,DET,POR,,,2,1,1,2
22023,1629680,22300105,"OCT 30, 2023",POR @ TOR,W,19,3,4,0.75,3,4,0.75,0,0,0.0,0,0,0,2,0,0,0,1,9,-5,1,Matisse Thybulle,POR,TOR,POR,,,11,9,11,2
22023,1629680,22300098,"OCT 29, 2023",POR @ PHI,L,11,1,3,0.333,0,2,0.0,0,0,0.0,0,0,0,0,0,0,0,1,2,-14,1,Matisse Thybulle,POR,PHI,POR,,,2,2,2,0
22023,1629680,22300086,"OCT 27, 2023",POR vs. ORL,L,17,0,1,0.0,0,1,0.0,0,0,0.0,0,2,2,0,1,1,0,2,0,-15,1,Matisse Thybulle,POR,POR,ORL,,,2,2,0,2
22023,1629680,22300074,"OCT 25, 2023",POR @ LAC,L,20,3,7,0.429,2,6,0.333,0,0,0.0,1,0,1,1,1,0,2,0,8,-12,1,Matisse Thybulle,POR,LAC,POR,,,10,9,9,2
22023,1630214,22300560,"JAN 15, 2024",MEM vs. GSW,W,30,1,6,0.167,0,2,0.0,0,0,0.0,1,3,4,3,1,2,0,0,2,13,1,Xavier Tillman,MEM,MEM,GSW,,,9,6,5,7
22023,1630214,22300544,"JAN 13, 2024",MEM vs. NYK,L,36,6,15,0.4,0,2,0.0,0,0,0.0,0,5,5,5,6,1,2,4,12,-6,1,Xavier Tillman,MEM,MEM,NYK,,,22,17,17,10
22023,1630214,22300537,"JAN 12, 2024",MEM vs. LAC,L,31,8,10,0.8,1,2,0.5,3,7,0.429,4,5,9,2,1,2,2,1,20,-5,1,Xavier Tillman,MEM,MEM,LAC,,,31,29,22,11
22023,1630214,22300515,"JAN 09, 2024",MEM @ DAL,W,28,6,9,0.667,0,1,0.0,2,4,0.5,6,5,11,2,0,2,3,3,14,17,1,Xavier Tillman,MEM,DAL,MEM,,,27,25,16,13
22023,1630214,22300503,"JAN 07, 2024",MEM @ PHX,W,3,0,3,0.0,0,1,0.0,0,0,0.0,3,0,3,0,0,0,0,1,0,-7,1,Xavier Tillman,MEM,PHX,MEM,,,3,3,0,3
22023,1630214,22300491,"JAN 05, 2024",MEM @ LAL,W,12,0,1,0.0,0,0,0.0,1,2,0.5,1,4,5,1,2,0,1,3,1,6,1,Xavier Tillman,MEM,LAL,MEM,,,7,6,2,6
22023,1630214,22300470,"JAN 03, 2024",MEM vs. TOR,L,23,2,3,0.667,0,0,0.0,0,0,0.0,2,3,5,2,0,0,0,3,4,-15,1,Xavier Tillman,MEM,MEM,TOR,,,11,9,6,7
22023,1630214,22300460,"JAN 02, 2024",MEM vs. SAS,W,0,0,0,0.0,0,0,0.0,0,0,0.0,0,0,0,0,0,0,0,0,0,-4,1,Xavier Tillman,MEM,MEM,SAS,,,0,0,0,0
22023,1630214,22300449,"DEC 31, 2023",MEM vs. SAC,L,8,1,4,0.25,0,2,0.0,0,0,0.0,1,1,2,0,0,0,0,0,2,-9,1,Xavier Tillman,MEM,MEM,SAC,,,4,4,2,2
22023,1630214,22300438,"DEC 29, 2023",MEM @ LAC,L,17,1,5,0.2,0,1,0.0,0,0,0.0,2,2,4,0,1,1,1,3,2,-14,1,Xavier Tillman,MEM,LAC,MEM,,,6,6,2,4
22023,1630214,22300425,"DEC 28, 2023",MEM @ DEN,L,22,2,7,0.286,1,4,0.25,1,2,0.5,0,3,3,4,1,1,2,0,6,-18,1,Xavier Tillman,MEM,DEN,MEM,,,13,9,10,7
22023,1630214,22300410,"DEC 26, 2023",MEM @ NOP,W,28,1,3,0.333,0,1,0.0,0,0,0.0,3,5,8,0,1,5,0,1,2,2,1,Xavier Tillman,MEM,NOP,MEM,,,10,10,2,8
22023,1630214,22300393,"DEC 23, 2023",MEM @ ATL,W,16,3,7,0.429,0,0,0.0,0,0,0.0,2,1,3,0,1,2,0,0,6,4,1,Xavier Tillman,MEM,ATL,MEM,,,9,9,6,3
22023,1630214,22300377,"DEC 21, 2023",MEM vs. IND,W,21,2,3,0.667,0,0,0.0,1,4,0.25,3,2,5,2,0,1,1,2,5,10,1,Xavier Tillman,MEM,MEM,IND,,,12,10,7,7
22023,1630214,22300360,"DEC 19, 2023",MEM @ NOP,W,20,3,5,0.6,1,1,1.0,0,0,0.0,2,4,6,1,1,0,1,3,7,3,1,Xavier Tillman,MEM,NOP,MEM,,,14,13,8,7
22023,1630214,22300355,"DEC 18, 2023",MEM @ OKC,L,25,0,8,0.0,0,3,0.0,0,0,0.0,0,8,8,2,1,1,1,1,0,-15,1,Xavier Tillman,MEM,OKC,MEM,,,10,8,2,10
22023,1630214,22300299,"DEC 11, 2023",MEM vs. DAL,L,7,0,1,0.0,0,0,0.0,0,2,0.0,0,0,0,0,1,0,0,0,0,-9,1,Xavier Tillman,MEM,MEM,DAL,,,0,0,0,0
22023,1630214,22301221,"DEC 08, 2023",MEM vs. MIN,L,17,5,8,0.625,1,2,0.5,1,3,0.333,2,0,2,0,4,0,0,1,12,-9,1,Xavier Tillman,MEM,MEM,MIN,,,14,14,12,2
22023,1630214,22301206,"DEC 06, 2023",MEM @ DET,W,7,1,4,0.25,0,0,0.0,0,0,0.0,1,0,1,1,0,0,0,0,2,-1,1,Xavier Tillman,MEM,DET,MEM,,,4,3,3,2
22023,1630214,22300288,"DEC 02, 2023",MEM @ PHX,L,12,1,4,0.25,0,2,0.0,0,0,0.0,0,0,0,0,0,1,1,0,2,0,1,Xavier Tillman,MEM,PHX,MEM,,,2,2,2,0
22023,1630214,22300277,"DEC 01, 2023",MEM @ DAL,W,22,2,6,0.333,0,3,0.0,0,0,0.0,0,2,2,2,2,2,0,0,4,9,1,Xavier Tillman,MEM,DAL,MEM,,,8,6,6,4
22023,1630214,22300026,"NOV 14, 2023",MEM @ LAL,L,22,6,7,0.857,3,3,1.0,0,0,0.0,1,1,2,2,1,0,1,1,15,-4,1,Xavier Tillman,MEM,LAL,MEM,,,19,17,17,4
22023,1630214,22300007,"NOV 03, 2023",MEM @ POR,L,24,3,8,0.375,0,2,0.0,0,0,0.0,1,6,7,5,1,2,1,5,6,-11,1,Xavier Tillman,MEM,POR,MEM,,,18,13,11,12
22023,1630214,22300125,"NOV 01, 2023",MEM @ UTA,L,14,0,3,0.0,0,0,0.0,0,0,0.0,3,1,4,0,1,0,2,3,0,-7,1,Xavier Tillman,MEM,UTA,MEM,,,4,4,0,4
22023,1630214,22300106,"OCT 30, 2023",MEM vs. DAL,L,29,3,14,0.214,0,5,0.0,0,3,0.0,2,5,7,1,2,1,0,0,6,4,1,Xavier Tillman,MEM,MEM,DAL,,,14,13,7,8
22023,1630214,22300089,"OCT 28, 2023",MEM @ WAS,L,24,3,7,0.429,2,2,1.0,0,0,0.0,1,6,7,3,0,0,1,4,8,-14,1,Xavier Tillman,MEM,WAS,MEM,,,18,15,11,10
22023,1630214,22300078,"OCT 27, 2023",MEM vs. DEN,L,34,5,9,0.556,1,3,0.333,2,4,0.5,2,6,8,2,3,2,5,5,13,-5,1,Xavier Tillman,MEM,MEM,DEN,,,23,21,15,10
22023,1630214,22300071,"OCT 25, 2023",MEM vs. NOP,L,34,7,16,0.438,1,5,0.2,2,2,1.0,4,8,12,4,3,1,0,2,17,3,1,Xavier Tillman,MEM,MEM,NOP,,,33,29,21,16
22023,1631210,22300441,"DEC 30, 2023",NYK @ IND,L,1,0,0,0.0,0,0,0.0,0,0,0.0,0,0,0,1,0,0,0,0,0,3,1,Jacob Toppin,NYK,IND,NYK,,,1,0,1,1
22023,1631210,22300388,"DEC 23, 2023",NYK vs. MIL,L,0,0,0,0.0,0,0,0.0,0,0,0.0,0,0,0,0,0,0,0,0,0,0,1,Jacob Toppin,NYK,NYK,MIL,,,0,0,0,0
22023,1631210,22301201,"DEC 05, 2023",NYK @ MIL,L,2,0,0,0.0,0,0,0.0,0,0,0.0,0,0,0,0,0,1,0,0,0,-4,1,Jacob Toppin,NYK,MIL,NYK,,,0,0,0,0
22023,1630167,22300564,"JAN 15, 2024",IND @ UTA,L,13,1,3,0.333,0,0,0.0,0,0,0.0,1,2,3,2,1,0,0,1,2,5,1,Obi Toppin,IND,UTA,IND,,,7,5,4,5
22023,1630167,22300550,"JAN 14, 2024",IND @ DEN,L,25,4,5,0.8,3,3,1.0,0,0,0.0,0,3,3,1,1,0,0,2,11,8,1,Obi Toppin,IND,DEN,IND,,,15,14,12,4
22023,1630167,22300533,"JAN 12, 2024",IND @ ATL,W,21,7,7,1.0,0,0,0.0,4,4,1.0,2,5,7,4,0,0,1,4,18,10,1,Obi Toppin,IND,ATL,IND,,,29,25,22,11
22023,1630167,22300520,"JAN 10, 2024",IND vs. WAS,W,28,6,10,0.6,3,6,0.5,0,0,0.0,1,6,7,3,0,0,2,2,15,3,1,Obi Toppin,IND,IND,WAS,,,25,22,18,10
22023,1630167,22300507,"JAN 08, 2024",IND vs. BOS,W,20,4,5,0.8,3,4,0.75,2,2,1.0,0,0,0,1,0,0,0,2,13,3,1,Obi Toppin,IND,IND,BOS,,,14,13,14,1
22023,1630167,22300493,"JAN 06, 2024",IND vs. BOS,L,23,4,8,0.5,2,4,0.5,0,0,0.0,1,2,3,1,0,0,0,1,10,-8,1,Obi Toppin,IND,IND,BOS,,,14,13,11,4
22023,1630167,22300480,"JAN 05, 2024",IND vs. ATL,W,22,3,6,0.5,3,5,0.6,0,0,0.0,0,3,3,2,1,0,1,2,9,23,1,Obi Toppin,IND,IND,ATL,,,14,12,11,5
22023,1630167,22300466,"JAN 03, 2024",IND vs. MIL,W,27,5,12,0.417,2,6,0.333,3,4,0.75,3,5,8,4,1,0,0,3,15,-6,1,Obi Toppin,IND,IND,MIL,,,27,23,19,12
22023,1630167,22300454,"JAN 01, 2024",IND @ MIL,W,29,4,9,0.444,1,3,0.333,2,2,1.0,2,1,3,2,1,0,0,4,11,35,1,Obi Toppin,IND,MIL,IND,,,16,14,13,5
22023,1630167,22300441,"DEC 30, 2023",IND vs. NYK,W,20,4,6,0.667,1,1,1.0,0,1,0.0,2,6,8,2,0,3,0,4,9,2,1,Obi Toppin,IND,IND,NYK,,,19,17,11,10
22023,1630167,22300422,"DEC 28, 2023",IND @ CHI,W,25,1,4,0.25,1,3,0.333,0,0,0.0,1,11,12,0,0,1,1,0,3,-11,1,Obi Toppin,IND,CHI,IND,,,15,15,3,12
22023,1630167,22300409,"DEC 26, 2023",IND @ HOU,W,15,2,3,0.667,1,2,0.5,2,3,0.667,1,1,2,3,1,0,3,2,7,-14,1,Obi Toppin,IND,HOU,IND,,,12,9,10,5
22023,1630167,22300391,"DEC 23, 2023",IND vs. ORL,L,24,1,6,0.167,0,3,0.0,1,2,0.5,0,6,6,0,0,1,0,2,3,2,1,Obi Toppin,IND,IND,ORL,,,9,9,3,6
22023,1630167,22300377,"DEC 21, 2023",IND @ MEM,L,28,8,14,0.571,5,9,0.556,1,2,0.5,2,3,5,1,2,0,1,3,22,9,1,Obi Toppin,IND,MEM,IND,,,28,27,23,6
22023,1630167,22300365,"DEC 20, 2023",IND vs. CHA,W,23,2,5,0.4,0,3,0.0,2,2,1.0,0,4,4,0,0,0,1,1,6,25,1,Obi Toppin,IND,IND,CHA,,,10,10,6,4
22023,1630167,22300350,"DEC 18, 2023",IND vs. LAC,L,30,6,8,0.75,2,3,0.667,0,0,0.0,1,2,3,4,0,2,0,3,14,-26,1,Obi Toppin,IND,IND,LAC,,,21,17,18,7
22023,1630167,22300338,"DEC 16, 2023",IND @ MIN,L,17,3,4,0.75,1,2,0.5,0,0,0.0,2,2,4,1,0,0,1,2,7,-17,1,Obi Toppin,IND,MIN,IND,,,12,11,8,5
22023,1630167,22300328,"DEC 15, 2023",IND @ WAS,L,26,6,8,0.75,2,3,0.667,2,3,0.667,1,4,5,2,0,0,1,2,16,-11,1,Obi Toppin,IND,WAS,IND,,,23,21,18,7
22023,1630167,22300315,"DEC 13, 2023",IND @ MIL,L,20,2,7,0.286,1,3,0.333,0,0,0.0,3,4,7,1,0,1,0,6,5,-6,1,Obi Toppin,IND,MIL,IND,,,13,12,6,8
22023,1630167,22300293,"DEC 11, 2023",IND @ DET,W,12,3,5,0.6,0,2,0.0,0,0,0.0,0,3,3,0,0,0,2,1,6,0,1,Obi Toppin,IND,DET,IND,,,9,9,6,3
22023,1630167,22301229,"DEC 07, 2023",IND @ MIL,W,21,6,8,0.75,1,3,0.333,1,2,0.5,3,3,6,2,0,0,0,3,14,-7,1,Obi Toppin,IND,MIL,IND,,,22,20,16,8
22023,1630167,22301202,"DEC 04, 2023",IND vs. BOS,W,26,4,8,0.5,2,4,0.5,2,2,1.0,0,2,2,1,0,2,0,1,12,-2,1,Obi Toppin,IND,IND,BOS,,,15,14,13,3
22023,1630167,22300284,"DEC 02, 2023",IND @ MIA,W,35,7,8,0.875,4,5,0.8,2,2,1.0,0,2,2,2,1,4,0,5,20,18,1,Obi Toppin,IND,MIA,IND,,,24,22,22,4
22023,1630167,22300267,"NOV 30, 2023",IND @ MIA,L,33,10,15,0.667,3,7,0.429,2,5,0.4,1,1,2,3,0,1,2,5,25,6,1,Obi Toppin,IND,MIA,IND,,,30,27,28,5
22023,1630167,22300254,"NOV 27, 2023",IND vs. POR,L,19,3,9,0.333,1,4,0.25,2,2,1.0,2,2,4,2,0,1,1,0,9,0,1,Obi Toppin,IND,IND,POR,,,15,13,11,6
22023,1630167,22300047,"NOV 24, 2023",IND vs. DET,W,24,6,8,0.75,3,5,0.6,0,0,0.0,1,2,3,2,0,0,0,1,15,5,1,Obi Toppin,IND,IND,DET,,,20,18,17,5
22023,1630167,22300230,"NOV 22, 2023",IND vs. TOR,L,36,6,9,0.667,2,5,0.4,2,2,1.0,0,3,3,1,2,0,3,1,16,5,1,Obi Toppin,IND,IND,TOR,,,20,19,17,4
22023,1630167,22300039,"NOV 21, 2023",IND @ ATL,W,34,9,16,0.563,1,6,0.167,2,2,1.0,0,1,1,6,1,1,2,3,21,-3,1,Obi Toppin,IND,ATL,IND,,,28,22,27,7
22023,1630167,22300209,"NOV 19, 2023",IND vs. ORL,L,16,3,8,0.375,0,3,0.0,0,0,0.0,2,2,4,2,0,0,2,2,6,-14,1,Obi Toppin,IND,IND,ORL,,,12,10,8,6
22023,1630167,22300019,"NOV 14, 2023",IND @ PHI,W,37,12,15,0.8,1,3,0.333,2,4,0.5,1,5,6,1,0,1,0,1,27,13,1,Obi Toppin,IND,PHI,IND,,,34,33,28,7
22023,1630167,22300180,"NOV 12, 2023",IND @ PHI,L,21,6,7,0.857,2,3,0.667,0,0,0.0,0,1,1,1,0,0,0,2,14,-14,1,Obi Toppin,IND,PHI,IND,,,16,15,15,2
22023,1630167,22300171,"NOV 09, 2023",IND vs. MIL,W,13,2,3,0.667,1,2,0.5,2,2,1.0,0,0,0,0,0,0,1,4,7,6,1,Obi Toppin,IND,IND,MIL,,,7,7,7,0
22023,1630167,22300158,"NOV 08, 2023",IND vs. UTA,W,19,3,7,0.429,0,3,0.0,0,0,0.0,0,1,1,0,3,1,1,2,6,-5,1,Obi Toppin,IND,IND,UTA,,,7,7,6,1
22023,1630167,22300146,"NOV 06, 2023",IND vs. SAS,W,27,6,11,0.545,1,3,0.333,6,6,1.0,0,2,2,1,2,0,1,3,19,25,1,Obi Toppin,IND,IND,SAS,,,22,21,20,3
22023,1630167,22300133,"NOV 04, 2023",IND vs. CHA,L,26,5,7,0.714,1,2,0.5,0,0,0.0,1,3,4,0,0,0,0,2,11,1,1,Obi Toppin,IND,IND,CHA,,,15,15,11,4
22023,1630167,22300001,"NOV 03, 2023",IND vs. CLE,W,21,3,6,0.5,0,1,0.0,0,0,0.0,1,3,4,1,0,0,0,2,6,0,1,Obi Toppin,IND,IND,CLE,,,11,10,7,5
22023,1630167,22300118,"NOV 01, 2023",IND @ BOS,L,25,5,6,0.833,0,1,0.0,1,2,0.5,2,0,2,1,2,0,1,1,11,-41,1,Obi Toppin,IND,BOS,IND,,,14,13,12,3
22023,1630167,22300102,"OCT 30, 2023",IND vs. CHI,L,24,2,5,0.4,0,2,0.0,2,2,1.0,2,6,8,0,1,0,0,1,6,9,1,Obi Toppin,IND,IND,CHI,,,14,14,6,8
22023,1630167,22300091,"OCT 28, 2023",IND @ CLE,W,18,2,5,0.4,0,1,0.0,0,0,0.0,2,2,4,0,0,1,1,1,4,-6,1,Obi Toppin,IND,CLE,IND,,,8,8,4,4
22023,1630167,22300064,"OCT 25, 2023",IND vs. WAS,W,19,4,9,0.444,2,5,0.4,1,1,1.0,1,3,4,1,1,0,0,0,11,7,1,Obi Toppin,IND,IND,WAS,,,16,15,12,5
22023,1626157,22300553,"JAN 14, 2024",MIN vs. LAC,W,37,7,12,0.583,2,4,0.5,1,2,0.5,0,6,6,5,0,0,4,4,17,12,1,Karl-Anthony Towns,MIN,MIN,LAC,,,28,23,22,11
22023,1626157,22300538,"JAN 12, 2024",MIN vs. POR,W,28,7,8,0.875,3,3,1.0,6,7,0.857,1,7,8,1,2,0,0,2,23,38,1,Karl-Anthony Towns,MIN,MIN,POR,,,32,31,24,9
22023,1626157,22300517,"JAN 10, 2024",MIN @ BOS,L,44,8,17,0.471,2,7,0.286,7,7,1.0,1,12,13,6,2,0,1,6,25,-5,1,Karl-Anthony Towns,MIN,BOS,MIN,,,44,38,31,19
22023,1626157,22300513,"JAN 09, 2024",MIN @ ORL,W,34,11,19,0.579,5,5,1.0,1,1,1.0,1,5,6,5,3,0,2,2,28,28,1,Karl-Anthony Towns,MIN,ORL,MIN,,,39,34,33,11
22023,1626157,22300501,"JAN 07, 2024",MIN @ DAL,L,27,8,16,0.5,3,9,0.333,5,6,0.833,0,7,7,1,0,2,3,5,24,-6,1,Karl-Anthony Towns,MIN,DAL,MIN,,,32,31,25,8
22023,1626157,22300485,"JAN 05, 2024",MIN @ HOU,W,31,8,17,0.471,1,4,0.25,5,5,1.0,2,6,8,6,0,1,4,2,22,11,1,Karl-Anthony Towns,MIN,HOU,MIN,,,36,30,28,14
22023,1626157,22300471,"JAN 03, 2024",MIN vs. NOP,L,36,8,19,0.421,0,4,0.0,6,7,0.857,2,4,6,2,0,0,1,2,22,-18,1,Karl-Anthony Towns,MIN,MIN,NOP,,,30,28,24,8
22023,1626157,22300451,"JAN 01, 2024",MIN @ NYK,L,32,10,18,0.556,3,5,0.6,6,6,1.0,1,5,6,3,0,0,3,5,29,4,1,Karl-Anthony Towns,MIN,NYK,MIN,,,38,35,32,9
22023,1626157,22300443,"DEC 30, 2023",MIN vs. LAL,W,29,3,7,0.429,1,4,0.25,2,2,1.0,2,7,9,2,0,0,5,5,9,-23,1,Karl-Anthony Towns,MIN,MIN,LAL,,,20,18,11,11
22023,1626157,22300423,"DEC 28, 2023",MIN vs. DAL,W,27,3,12,0.25,2,6,0.333,2,4,0.5,2,6,8,3,0,0,5,5,10,14,1,Karl-Anthony Towns,MIN,MIN,DAL,,,21,18,13,11
22023,1626157,22300411,"DEC 26, 2023",MIN @ OKC,L,29,5,10,0.5,0,2,0.0,6,6,1.0,2,4,6,1,0,0,5,2,16,-11,1,Karl-Anthony Towns,MIN,OKC,MIN,,,23,22,17,7
22023,1626157,22300380,"DEC 21, 2023",MIN vs. LAL,W,33,7,17,0.412,2,6,0.333,5,6,0.833,0,6,6,4,1,0,0,3,21,12,1,Karl-Anthony Towns,MIN,MIN,LAL,,,31,27,25,10
22023,1626157,22300367,"DEC 20, 2023",MIN @ PHI,L,38,9,14,0.643,1,2,0.5,4,5,0.8,3,10,13,2,0,0,4,4,23,8,1,Karl-Anthony Towns,MIN,PHI,MIN,,,38,36,25,15
22023,1626157,22300353,"DEC 18, 2023",MIN @ MIA,W,32,7,14,0.5,1,4,0.25,3,3,1.0,4,4,8,2,1,0,1,3,18,-3,1,Karl-Anthony Towns,MIN,MIA,MIN,,,28,26,20,10
22023,1626157,22300338,"DEC 16, 2023",MIN vs. IND,W,35,15,25,0.6,2,3,0.667,8,8,1.0,5,7,12,4,3,2,3,2,40,18,1,Karl-Anthony Towns,MIN,MIN,IND,,,56,52,44,16
22023,1626157,22300321,"DEC 14, 2023",MIN @ DAL,W,31,8,14,0.571,1,3,0.333,4,5,0.8,5,12,17,2,0,0,3,1,21,11,1,Karl-Anthony Towns,MIN,DAL,MIN,,,40,38,23,19
22023,1626157,22300301,"DEC 11, 2023",MIN @ NOP,L,33,5,11,0.455,1,3,0.333,6,7,0.857,3,9,12,1,0,0,1,6,17,-12,1,Karl-Anthony Towns,MIN,NOP,MIN,,,30,29,18,13
22023,1626157,22301221,"DEC 08, 2023",MIN @ MEM,W,29,7,14,0.5,2,4,0.5,8,9,0.889,2,5,7,5,1,0,1,4,24,17,1,Karl-Anthony Towns,MIN,MEM,MIN,,,36,31,29,12
22023,1626157,22301210,"DEC 06, 2023",MIN vs. SAS,W,32,5,6,0.833,2,3,0.667,2,3,0.667,1,9,10,2,0,1,6,2,14,-14,1,Karl-Anthony Towns,MIN,MIN,SAS,,,26,24,16,12
22023,1626157,22300281,"DEC 02, 2023",MIN @ CHA,W,32,12,23,0.522,4,8,0.5,0,0,0.0,3,4,7,5,0,0,3,3,28,12,1,Karl-Anthony Towns,MIN,CHA,MIN,,,40,35,33,12
22023,1626157,22300270,"NOV 30, 2023",MIN vs. UTA,W,37,12,22,0.545,4,7,0.571,4,5,0.8,4,7,11,4,2,1,4,3,32,9,1,Karl-Anthony Towns,MIN,MIN,UTA,,,47,43,36,15
22023,1626157,22300058,"NOV 28, 2023",MIN vs. OKC,W,32,2,8,0.25,1,3,0.333,8,8,1.0,0,10,10,3,0,0,6,4,13,12,1,Karl-Anthony Towns,MIN,MIN,OKC,,,26,23,16,13
22023,1626157,22300249,"NOV 26, 2023",MIN @ MEM,W,26,7,11,0.636,1,3,0.333,3,3,1.0,0,8,8,2,1,1,4,5,18,7,1,Karl-Anthony Towns,MIN,MEM,MIN,,,28,26,20,10
22023,1626157,22300050,"NOV 24, 2023",MIN vs. SAC,L,38,9,15,0.6,4,5,0.8,5,5,1.0,1,10,11,4,0,0,4,3,27,-8,1,Karl-Anthony Towns,MIN,MIN,SAC,,,42,38,31,15
22023,1626157,22300232,"NOV 22, 2023",MIN vs. PHI,W,36,9,19,0.474,1,2,0.5,4,5,0.8,0,11,11,3,2,2,4,5,23,18,1,Karl-Anthony Towns,MIN,MIN,PHI,,,37,34,26,14
22023,1626157,22300221,"NOV 20, 2023",MIN vs. NYK,W,36,6,10,0.6,2,3,0.667,6,7,0.857,0,5,5,4,3,2,3,6,20,14,1,Karl-Anthony Towns,MIN,MIN,NYK,,,29,25,24,9
22023,1626157,22300203,"NOV 18, 2023",MIN @ NOP,W,33,10,11,0.909,2,2,1.0,7,8,0.875,2,4,6,9,0,2,0,5,29,9,1,Karl-Anthony Towns,MIN,NOP,MIN,,,44,35,38,15
22023,1626157,22300197,"NOV 15, 2023",MIN @ PHX,L,31,10,17,0.588,0,4,0.0,5,5,1.0,1,6,7,2,0,0,1,3,25,-14,1,Karl-Anthony Towns,MIN,PHX,MIN,,,34,32,27,9
22023,1626157,22300025,"NOV 14, 2023",MIN @ GSW,W,42,12,26,0.462,5,12,0.417,4,4,1.0,1,10,11,2,2,0,5,1,33,8,1,Karl-Anthony Towns,MIN,GSW,MIN,,,46,44,35,13
22023,1626157,22300186,"NOV 12, 2023",MIN @ GSW,W,37,8,14,0.571,2,3,0.667,3,3,1.0,2,12,14,3,2,1,1,1,21,11,1,Karl-Anthony Towns,MIN,GSW,MIN,,,38,35,24,17
22023,1626157,22300013,"NOV 10, 2023",MIN @ SAS,W,34,11,21,0.524,3,7,0.429,4,4,1.0,1,11,12,2,0,0,3,1,29,1,1,Karl-Anthony Towns,MIN,SAS,MIN,,,43,41,31,14
22023,1626157,22300166,"NOV 08, 2023",MIN vs. NOP,W,28,9,12,0.75,4,5,0.8,1,2,0.5,0,3,3,0,0,1,3,6,23,12,1,Karl-Anthony Towns,MIN,MIN,NOP,,,26,26,23,3
22023,1626157,22300154,"NOV 06, 2023",MIN vs. BOS,W,28,3,10,0.3,1,7,0.143,0,0,0.0,0,10,10,3,0,0,7,6,7,-5,1,Karl-Anthony Towns,MIN,MIN,BOS,,,20,17,10,13
22023,1626157,22300138,"NOV 04, 2023",MIN vs. UTA,W,32,7,14,0.5,2,6,0.333,9,10,0.9,0,7,7,1,2,0,2,4,25,24,1,Karl-Anthony Towns,MIN,MIN,UTA,,,33,32,26,8
22023,1626157,22300123,"NOV 01, 2023",MIN vs. DEN,W,31,7,19,0.368,1,4,0.25,6,6,1.0,2,6,8,4,2,0,1,2,21,22,1,Karl-Anthony Towns,MIN,MIN,DEN,,,33,29,25,12
22023,1626157,22300104,"OCT 30, 2023",MIN @ ATL,L,36,7,17,0.412,1,3,0.333,1,1,1.0,2,8,10,3,1,0,0,2,16,-8,1,Karl-Anthony Towns,MIN,ATL,MIN,,,29,26,19,13
22023,1626157,22300093,"OCT 28, 2023",MIN vs. MIA,W,31,5,12,0.417,1,4,0.25,1,2,0.5,0,10,10,2,1,0,1,3,12,6,1,Karl-Anthony Towns,MIN,MIN,MIA,,,24,22,14,12
22023,1626157,22300069,"OCT 25, 2023",MIN @ TOR,L,36,8,25,0.32,2,10,0.2,1,1,1.0,2,8,10,3,0,4,4,2,19,-1,1,Karl-Anthony Towns,MIN,TOR,MIN,,,32,29,22,13
22023,1629018,22300540,"JAN 12, 2024",TOR @ UTA,L,22,2,6,0.333,1,2,0.5,0,0,0.0,1,0,1,2,0,0,1,1,5,-6,1,Gary Trent Jr.,TOR,UTA,TOR,,,8,6,7,3
22023,1629018,22300526,"JAN 10, 2024",TOR @ LAC,L,24,5,9,0.556,2,4,0.5,0,0,0.0,1,2,3,2,0,0,0,1,12,-9,1,Gary Trent Jr.,TOR,LAC,TOR,,,17,15,14,5
22023,1629018,22300516,"JAN 09, 2024",TOR @ LAL,L,24,5,10,0.5,4,6,0.667,0,0,0.0,0,1,1,1,0,0,0,1,14,-6,1,Gary Trent Jr.,TOR,LAL,TOR,,,16,15,15,2
22023,1629018,22300504,"JAN 07, 2024",TOR @ GSW,W,26,6,11,0.545,2,5,0.4,0,0,0.0,0,1,1,1,2,1,0,1,14,10,1,Gary Trent Jr.,TOR,GSW,TOR,,,16,15,15,2
22023,1629018,22300470,"JAN 03, 2024",TOR @ MEM,W,21,2,5,0.4,1,1,1.0,0,0,0.0,0,1,1,0,1,0,2,2,5,2,1,Gary Trent Jr.,TOR,MEM,TOR,,,6,6,5,1
22023,1629018,22300452,"JAN 01, 2024",TOR vs. CLE,W,26,3,10,0.3,1,5,0.2,2,2,1.0,2,4,6,2,1,0,0,1,9,-1,1,Gary Trent Jr.,TOR,TOR,CLE,,,17,15,11,8
22023,1629018,22300440,"DEC 30, 2023",TOR @ DET,L,39,8,16,0.5,6,9,0.667,2,2,1.0,0,1,1,4,4,1,0,3,24,4,1,Gary Trent Jr.,TOR,DET,TOR,,,29,25,28,5
22023,1629018,22300432,"DEC 29, 2023",TOR @ BOS,L,29,2,10,0.2,1,4,0.25,1,2,0.5,0,4,4,1,2,0,0,0,6,-10,1,Gary Trent Jr.,TOR,BOS,TOR,,,11,10,7,5
22023,1629018,22300416,"DEC 27, 2023",TOR @ WAS,W,26,4,10,0.4,3,8,0.375,1,2,0.5,0,2,2,4,2,0,1,1,12,8,1,Gary Trent Jr.,TOR,WAS,TOR,,,18,14,16,6
22023,1629018,22300395,"DEC 23, 2023",TOR vs. UTA,L,28,6,12,0.5,4,9,0.444,0,0,0.0,0,0,0,0,0,0,2,0,16,-10,1,Gary Trent Jr.,TOR,TOR,UTA,,,16,16,16,0
22023,1629018,22300382,"DEC 22, 2023",TOR @ PHI,L,26,6,11,0.545,5,8,0.625,0,0,0.0,1,3,4,1,1,0,0,3,17,-10,1,Gary Trent Jr.,TOR,PHI,TOR,,,22,21,18,5
22023,1629018,22300369,"DEC 20, 2023",TOR vs. DEN,L,29,4,9,0.444,1,5,0.2,3,3,1.0,0,3,3,4,0,0,1,0,12,-11,1,Gary Trent Jr.,TOR,TOR,DEN,,,19,15,16,7
22023,1629018,22300354,"DEC 18, 2023",TOR vs. CHA,W,35,9,17,0.529,4,10,0.4,0,0,0.0,0,10,10,3,1,0,1,1,22,25,1,Gary Trent Jr.,TOR,TOR,CHA,,,35,32,25,13
22023,1629018,22300330,"DEC 15, 2023",TOR vs. ATL,L,20,3,8,0.375,2,5,0.4,0,0,0.0,0,2,2,3,0,0,1,1,8,-11,1,Gary Trent Jr.,TOR,TOR,ATL,,,13,10,11,5
22023,1629018,22300313,"DEC 13, 2023",TOR vs. ATL,W,20,4,11,0.364,4,8,0.5,0,0,0.0,0,0,0,1,0,0,0,0,12,-8,1,Gary Trent Jr.,TOR,TOR,ATL,,,13,12,13,1
22023,1629018,22300297,"DEC 11, 2023",TOR @ NYK,L,19,2,8,0.25,0,4,0.0,0,0,0.0,1,0,1,2,0,0,0,0,4,3,1,Gary Trent Jr.,TOR,NYK,TOR,,,7,5,6,3
22023,1629018,22301216,"DEC 08, 2023",TOR @ CHA,L,20,0,7,0.0,0,3,0.0,0,0,0.0,0,2,2,2,0,0,0,0,0,-7,1,Gary Trent Jr.,TOR,CHA,TOR,,,4,2,2,4
22023,1629018,22301207,"DEC 06, 2023",TOR vs. MIA,L,25,5,11,0.455,3,7,0.429,2,2,1.0,0,2,2,2,0,0,1,3,15,7,1,Gary Trent Jr.,TOR,TOR,MIA,,,19,17,17,4
22023,1629018,22300276,"DEC 01, 2023",TOR vs. NYK,L,23,2,6,0.333,0,1,0.0,0,1,0.0,0,1,1,4,0,0,0,0,4,-18,1,Gary Trent Jr.,TOR,TOR,NYK,,,9,5,8,5
22023,1629018,22300260,"NOV 29, 2023",TOR vs. PHX,W,25,5,13,0.385,3,7,0.429,0,0,0.0,0,5,5,2,0,0,0,1,13,0,1,Gary Trent Jr.,TOR,TOR,PHX,,,20,18,15,7
22023,1629018,22300054,"NOV 28, 2023",TOR @ BKN,L,25,7,12,0.583,1,4,0.25,0,0,0.0,0,2,2,1,1,0,0,1,15,-6,1,Gary Trent Jr.,TOR,BKN,TOR,,,18,17,16,3
22023,1629018,22300251,"NOV 26, 2023",TOR @ CLE,L,26,5,13,0.385,1,7,0.143,2,2,1.0,0,1,1,0,1,0,1,0,13,10,1,Gary Trent Jr.,TOR,CLE,TOR,,,14,14,13,1
22023,1629018,22300046,"NOV 24, 2023",TOR vs. CHI,W,21,6,13,0.462,4,9,0.444,0,0,0.0,0,1,1,2,1,0,0,3,16,-4,1,Gary Trent Jr.,TOR,TOR,CHI,,,19,17,18,3
22023,1629018,22300230,"NOV 22, 2023",TOR @ IND,W,25,2,5,0.4,2,4,0.5,2,4,0.5,0,1,1,1,1,0,2,1,8,14,1,Gary Trent Jr.,TOR,IND,TOR,,,10,9,9,2
22023,1629018,22300038,"NOV 21, 2023",TOR @ ORL,L,21,1,6,0.167,1,2,0.5,0,0,0.0,0,0,0,1,0,0,0,1,3,-3,1,Gary Trent Jr.,TOR,ORL,TOR,,,4,3,4,1
22023,1629018,22300211,"NOV 19, 2023",TOR vs. DET,W,26,6,12,0.5,2,7,0.286,4,4,1.0,0,1,1,3,1,1,0,1,18,20,1,Gary Trent Jr.,TOR,TOR,DET,,,22,19,21,4
22023,1629018,22300031,"NOV 17, 2023",TOR vs. BOS,L,31,4,9,0.444,3,5,0.6,3,4,0.75,0,2,2,1,1,0,0,0,14,14,1,Gary Trent Jr.,TOR,TOR,BOS,,,17,16,15,3
22023,1629018,22300168,"NOV 08, 2023",TOR @ DAL,W,26,6,11,0.545,4,8,0.5,0,0,0.0,0,2,2,1,1,0,0,0,16,9,1,Gary Trent Jr.,TOR,DAL,TOR,,,19,18,17,3
22023,1629018,22300141,"NOV 05, 2023",TOR @ SAS,W,29,4,8,0.5,2,4,0.5,0,0,0.0,0,0,0,0,1,0,2,1,10,-1,1,Gary Trent Jr.,TOR,SAS,TOR,,,10,10,10,0
22023,1629018,22300128,"NOV 02, 2023",TOR @ PHI,L,23,2,8,0.25,2,5,0.4,2,4,0.5,0,5,5,0,1,0,3,1,8,-15,1,Gary Trent Jr.,TOR,PHI,TOR,,,13,13,8,5
22023,1629018,22300116,"NOV 01, 2023",TOR vs. MIL,W,23,4,11,0.364,0,5,0.0,0,0,0.0,1,2,3,1,0,0,1,2,8,8,1,Gary Trent Jr.,TOR,TOR,MIL,,,12,11,9,4
22023,1629018,22300105,"OCT 30, 2023",TOR vs. POR,L,19,1,7,0.143,0,1,0.0,1,3,0.333,0,1,1,2,1,0,0,2,3,-10,1,Gary Trent Jr.,TOR,TOR,POR,,,6,4,5,3
22023,1629018,22300092,"OCT 28, 2023",TOR vs. PHI,L,33,6,16,0.375,3,5,0.6,2,4,0.5,1,1,2,0,1,0,1,0,17,3,1,Gary Trent Jr.,TOR,TOR,PHI,,,19,19,17,2
22023,1629018,22300082,"OCT 27, 2023",TOR @ CHI,L,36,6,15,0.4,3,10,0.3,1,4,0.25,2,3,5,1,2,0,1,1,16,-15,1,Gary Trent Jr.,TOR,CHI,TOR,,,22,21,17,6
22023,1629018,22300069,"OCT 25, 2023",TOR vs. MIN,W,27,2,8,0.25,1,4,0.25,0,0,0.0,0,2,2,2,1,1,0,3,5,3,1,Gary Trent Jr.,TOR,TOR,MIN,,,9,7,7,4
22023,1631131,22300564,"JAN 15, 2024",IND @ UTA,L,12,1,5,0.2,0,0,0.0,2,2,1.0,4,2,6,0,2,0,0,0,4,-1,1,Oscar Tshiebwe,IND,UTA,IND,,,10,10,4,6
22023,1631131,22300533,"JAN 12, 2024",IND @ ATL,W,4,2,2,1.0,0,0,0.0,0,0,0.0,0,1,1,0,0,0,0,0,4,-2,1,Oscar Tshiebwe,IND,ATL,IND,,,5,5,4,1
22023,1631131,22300493,"JAN 06, 2024",IND vs. BOS,L,1,1,1,1.0,0,0,0.0,0,0,0.0,0,0,0,0,0,0,0,0,2,0,1,Oscar Tshiebwe,IND,IND,BOS,,,2,2,2,0
22023,1631131,22300338,"DEC 16, 2023",IND @ MIN,L,7,3,6,0.5,0,0,0.0,2,2,1.0,2,2,4,1,0,0,0,0,8,8,1,Oscar Tshiebwe,IND,MIN,IND,,,13,12,9,5
22023,1631131,22300328,"DEC 15, 2023",IND @ WAS,L,4,1,1,1.0,0,0,0.0,0,0,0.0,0,0,0,1,0,0,0,0,2,3,1,Oscar Tshiebwe,IND,WAS,IND,,,3,2,3,1
22023,1631131,22300315,"DEC 13, 2023",IND @ MIL,L,6,0,1,0.0,0,0,0.0,1,2,0.5,0,1,1,0,0,0,0,1,1,4,1,Oscar Tshiebwe,IND,MIL,IND,,,2,2,1,1
22023,200782,22300257,"NOV 27, 2023",LAC vs. DEN,L,6,0,0,0.0,0,0,0.0,0,0,0.0,0,0,0,1,2,0,0,1,0,3,1,P.J. Tucker,LAC,LAC,DEN,,,1,0,1,1
22023,200782,22300244,"NOV 25, 2023",LAC vs. DAL,W,8,0,0,0.0,0,0,0.0,0,0,0.0,0,1,1,0,0,0,0,2,0,3,1,P.J. Tucker,LAC,LAC,DAL,,,1,1,0,1
22023,200782,22300052,"NOV 24, 2023",LAC vs. NOP,L,22,0,2,0.0,0,2,0.0,0,0,0.0,2,0,2,3,1,0,0,4,0,7,1,P.J. Tucker,LAC,LAC,NOP,,,5,2,3,5
22023,200782,22300235,"NOV 22, 2023",LAC @ SAS,W,13,0,0,0.0,0,0,0.0,0,0,0.0,1,0,1,0,0,0,1,2,0,9,1,P.J. Tucker,LAC,SAS,LAC,,,1,1,0,1
22023,200782,22300223,"NOV 20, 2023",LAC @ SAS,W,16,0,0,0.0,0,0,0.0,0,0,0.0,0,5,5,0,0,0,0,2,0,5,1,P.J. Tucker,LAC,SAS,LAC,,,5,5,0,5
22023,200782,22300037,"NOV 17, 2023",LAC vs. HOU,W,15,0,0,0.0,0,0,0.0,0,0,0.0,0,0,0,0,0,0,0,3,0,-24,1,P.J. Tucker,LAC,LAC,HOU,,,0,0,0,0
22023,200782,22300024,"NOV 14, 2023",LAC @ DEN,L,21,2,3,0.667,2,3,0.667,0,0,0.0,2,3,5,0,0,0,1,1,6,-7,1,P.J. Tucker,LAC,DEN,LAC,,,11,11,6,5
22023,200782,22300179,"NOV 12, 2023",LAC vs. MEM,L,13,1,2,0.5,1,2,0.5,0,0,0.0,1,1,2,1,1,0,0,1,3,5,1,P.J. Tucker,LAC,LAC,MEM,,,6,5,4,3
22023,200782,22300014,"NOV 10, 2023",LAC @ DAL,L,6,0,1,0.0,0,1,0.0,0,0,0.0,0,1,1,0,0,0,0,2,0,-20,1,P.J. Tucker,LAC,DAL,LAC,,,1,1,0,1
22023,200782,22300160,"NOV 08, 2023",LAC @ BKN,L,21,1,3,0.333,0,1,0.0,1,1,1.0,3,3,6,3,1,1,0,3,3,10,1,P.J. Tucker,LAC,BKN,LAC,,,12,9,6,9
22023,200782,22300151,"NOV 06, 2023",LAC @ NYK,L,11,0,2,0.0,0,2,0.0,2,2,1.0,1,0,1,0,1,0,0,1,2,-9,1,P.J. Tucker,LAC,NYK,LAC,,,3,3,2,1
22023,200782,22300127,"NOV 01, 2023",LAC @ LAL,L,21,0,1,0.0,0,0,0.0,0,0,0.0,5,0,5,0,0,0,0,4,0,-15,1,P.J. Tucker,LAC,LAL,LAC,,,5,5,0,5
22023,200782,22300098,"OCT 29, 2023",PHI vs. POR,W,20,1,2,0.5,1,2,0.5,0,0,0.0,0,4,4,0,1,2,1,1,3,26,1,P.J. Tucker,PHI,PHI,POR,,,7,7,3,4
22023,200782,22300092,"OCT 28, 2023",PHI @ TOR,W,21,1,1,1.0,1,1,1.0,0,0,0.0,0,3,3,0,0,0,1,3,3,0,1,P.J. Tucker,PHI,TOR,PHI,,,6,6,3,3
22023,200782,22300075,"OCT 26, 2023",PHI @ MIL,L,26,0,2,0.0,0,2,0.0,0,0,0.0,1,6,7,0,2,0,0,5,0,2,1,P.J. Tucker,PHI,MIL,PHI,,,7,7,0,7
22023,1626167,22300564,"JAN 15, 2024",IND @ UTA,L,17,4,8,0.5,1,2,0.5,3,4,0.75,1,3,4,0,0,0,2,5,12,-8,1,Myles Turner,IND,UTA,IND,,,16,16,12,4
22023,1626167,22300550,"JAN 14, 2024",IND @ DEN,L,26,5,11,0.455,0,4,0.0,2,3,0.667,1,3,4,1,2,1,3,5,12,-5,1,Myles Turner,IND,DEN,IND,,,17,16,13,5
22023,1626167,22300533,"JAN 12, 2024",IND @ ATL,W,26,5,9,0.556,0,3,0.0,2,3,0.667,2,5,7,4,2,2,3,2,12,9,1,Myles Turner,IND,ATL,IND,,,23,19,16,11
22023,1626167,22300520,"JAN 10, 2024",IND vs. WAS,W,31,7,15,0.467,1,5,0.2,3,3,1.0,6,7,13,3,0,2,2,3,18,4,1,Myles Turner,IND,IND,WAS,,,34,31,21,16
22023,1626167,22300507,"JAN 08, 2024",IND vs. BOS,W,35,7,13,0.538,1,3,0.333,1,2,0.5,2,6,8,1,0,0,2,2,16,-1,1,Myles Turner,IND,IND,BOS,,,25,24,17,9
22023,1626167,22300493,"JAN 06, 2024",IND vs. BOS,L,30,5,11,0.455,0,5,0.0,2,4,0.5,3,4,7,2,0,0,0,3,12,-11,1,Myles Turner,IND,IND,BOS,,,21,19,14,9
22023,1626167,22300480,"JAN 05, 2024",IND vs. ATL,W,22,10,14,0.714,2,3,0.667,5,5,1.0,2,3,5,3,1,1,1,0,27,25,1,Myles Turner,IND,IND,ATL,,,35,32,30,8
22023,1626167,22300466,"JAN 03, 2024",IND vs. MIL,W,30,6,9,0.667,1,4,0.25,2,4,0.5,0,7,7,2,0,2,2,4,15,15,1,Myles Turner,IND,IND,MIL,,,24,22,17,9
22023,1626167,22300454,"JAN 01, 2024",IND @ MIL,W,28,3,5,0.6,0,2,0.0,7,7,1.0,1,3,4,0,0,2,0,5,13,-20,1,Myles Turner,IND,MIL,IND,,,17,17,13,4
22023,1626167,22300441,"DEC 30, 2023",IND vs. NYK,W,31,10,17,0.588,6,8,0.75,2,3,0.667,1,7,8,2,0,0,1,0,28,17,1,Myles Turner,IND,IND,NYK,,,38,36,30,10
22023,1626167,22300422,"DEC 28, 2023",IND @ CHI,W,26,8,12,0.667,1,2,0.5,7,7,1.0,0,6,6,0,0,3,3,5,24,30,1,Myles Turner,IND,CHI,IND,,,30,30,24,6
22023,1626167,22300409,"DEC 26, 2023",IND @ HOU,W,24,5,9,0.556,2,3,0.667,6,7,0.857,1,4,5,1,0,2,0,5,18,4,1,Myles Turner,IND,HOU,IND,,,24,23,19,6
22023,1626167,22300391,"DEC 23, 2023",IND vs. ORL,L,29,9,11,0.818,2,4,0.5,4,4,1.0,1,6,7,0,1,4,1,4,24,18,1,Myles Turner,IND,IND,ORL,,,31,31,24,7
22023,1626167,22300377,"DEC 21, 2023",IND @ MEM,L,36,5,10,0.5,0,2,0.0,5,5,1.0,3,3,6,2,1,4,4,5,15,-2,1,Myles Turner,IND,MEM,IND,,,23,21,17,8
22023,1626167,22300365,"DEC 20, 2023",IND vs. CHA,W,25,5,9,0.556,1,4,0.25,7,7,1.0,1,5,6,0,0,2,1,2,18,19,1,Myles Turner,IND,IND,CHA,,,24,24,18,6
22023,1626167,22300338,"DEC 16, 2023",IND @ MIN,L,21,2,7,0.286,1,2,0.5,7,8,0.875,2,3,5,0,1,0,1,1,12,-15,1,Myles Turner,IND,MIN,IND,,,17,17,12,5
22023,1626167,22300328,"DEC 15, 2023",IND @ WAS,L,20,2,10,0.2,1,4,0.25,1,2,0.5,2,2,4,1,0,3,1,1,6,-17,1,Myles Turner,IND,WAS,IND,,,11,10,7,5
22023,1626167,22300315,"DEC 13, 2023",IND @ MIL,L,33,8,14,0.571,2,2,1.0,4,4,1.0,4,5,9,0,0,2,2,4,22,-5,1,Myles Turner,IND,MIL,IND,,,31,31,22,9
22023,1626167,22300293,"DEC 11, 2023",IND @ DET,W,31,10,15,0.667,0,2,0.0,3,6,0.5,3,5,8,1,1,3,2,2,23,12,1,Myles Turner,IND,DET,IND,,,32,31,24,9
22023,1626167,22301229,"DEC 07, 2023",IND @ MIL,W,32,9,18,0.5,2,8,0.25,6,8,0.75,1,9,10,2,1,3,0,2,26,-5,1,Myles Turner,IND,MIL,IND,,,38,36,28,12
22023,1626167,22301202,"DEC 04, 2023",IND vs. BOS,W,34,7,16,0.438,2,6,0.333,1,1,1.0,1,9,10,1,1,1,0,1,17,22,1,Myles Turner,IND,IND,BOS,,,28,27,18,11
22023,1626167,22300284,"DEC 02, 2023",IND @ MIA,W,30,8,12,0.667,1,4,0.25,0,0,0.0,2,8,10,1,0,2,2,4,17,10,1,Myles Turner,IND,MIA,IND,,,28,27,18,11
22023,1626167,22300267,"NOV 30, 2023",IND @ MIA,L,29,5,14,0.357,0,5,0.0,3,5,0.6,4,5,9,2,0,1,0,3,13,-13,1,Myles Turner,IND,MIA,IND,,,24,22,15,11
22023,1626167,22300254,"NOV 27, 2023",IND vs. POR,L,27,5,11,0.455,0,3,0.0,1,1,1.0,1,7,8,0,2,2,1,4,11,2,1,Myles Turner,IND,IND,POR,,,19,19,11,8
22023,1626167,22300047,"NOV 24, 2023",IND vs. DET,W,27,8,14,0.571,1,3,0.333,6,6,1.0,5,5,10,2,1,5,2,5,23,23,1,Myles Turner,IND,IND,DET,,,35,33,25,12
22023,1626167,22300230,"NOV 22, 2023",IND vs. TOR,L,29,7,11,0.636,2,3,0.667,1,2,0.5,1,7,8,0,1,2,2,3,17,13,1,Myles Turner,IND,IND,TOR,,,25,25,17,8
22023,1626167,22300039,"NOV 21, 2023",IND @ ATL,W,25,4,7,0.571,0,2,0.0,3,4,0.75,1,8,9,1,0,4,1,3,11,5,1,Myles Turner,IND,ATL,IND,,,21,20,12,10
22023,1626167,22300209,"NOV 19, 2023",IND vs. ORL,L,23,3,10,0.3,0,3,0.0,4,6,0.667,3,1,4,3,1,3,1,2,10,-20,1,Myles Turner,IND,IND,ORL,,,17,14,13,7
22023,1626167,22300019,"NOV 14, 2023",IND @ PHI,W,19,5,11,0.455,1,4,0.25,6,8,0.75,1,2,3,0,1,1,1,6,17,5,1,Myles Turner,IND,PHI,IND,,,20,20,17,3
22023,1626167,22300180,"NOV 12, 2023",IND @ PHI,L,29,7,17,0.412,4,9,0.444,4,4,1.0,2,3,5,0,1,3,3,4,22,-6,1,Myles Turner,IND,PHI,IND,,,27,27,22,5
22023,1626167,22300171,"NOV 09, 2023",IND vs. MIL,W,37,8,16,0.5,4,9,0.444,1,1,1.0,1,5,6,4,0,1,1,4,21,14,1,Myles Turner,IND,IND,MIL,,,31,27,25,10
22023,1626167,22300158,"NOV 08, 2023",IND vs. UTA,W,23,8,12,0.667,0,2,0.0,6,8,0.75,3,3,6,0,0,3,0,2,22,3,1,Myles Turner,IND,IND,UTA,,,28,28,22,6
22023,1626167,22300146,"NOV 06, 2023",IND vs. SAS,W,21,5,7,0.714,1,1,1.0,4,4,1.0,4,7,11,2,0,1,0,3,15,19,1,Myles Turner,IND,IND,SAS,,,28,26,17,13
22023,1626167,22300133,"NOV 04, 2023",IND vs. CHA,L,27,5,9,0.556,3,5,0.6,1,2,0.5,0,6,6,2,1,0,4,4,14,12,1,Myles Turner,IND,IND,CHA,,,22,20,16,8
22023,1626167,22300001,"NOV 03, 2023",IND vs. CLE,W,31,9,14,0.643,4,5,0.8,5,6,0.833,1,8,9,0,2,2,3,4,27,11,1,Myles Turner,IND,IND,CLE,,,36,36,27,9
22023,1626167,22300118,"NOV 01, 2023",IND @ BOS,L,22,4,12,0.333,0,3,0.0,0,0,0.0,1,4,5,3,1,1,1,1,8,-20,1,Myles Turner,IND,BOS,IND,,,16,13,11,8
22023,1626167,22300102,"OCT 30, 2023",IND vs. CHI,L,32,6,14,0.429,3,8,0.375,5,8,0.625,2,9,11,3,0,2,1,2,20,-9,1,Myles Turner,IND,IND,CHI,,,34,31,23,14
22023,1626167,22300091,"OCT 28, 2023",IND @ CLE,W,29,7,14,0.5,1,5,0.2,5,5,1.0,1,11,12,1,0,2,2,5,20,-5,1,Myles Turner,IND,CLE,IND,,,33,32,21,13
22023,1626167,22300064,"OCT 25, 2023",IND vs. WAS,W,23,5,8,0.625,0,2,0.0,1,2,0.5,0,8,8,1,0,3,2,4,11,14,1,Myles Turner,IND,IND,WAS,,,20,19,12,9
22023,1641816,22300322,"DEC 14, 2023",DEN vs. BKN,W,1,0,0,0.0,0,0,0.0,0,0,0.0,0,1,1,0,0,0,0,0,0,3,1,Hunter Tyson,DEN,DEN,BKN,,,1,1,0,1
22023,1641816,22300263,"NOV 29, 2023",DEN vs. HOU,W,3,0,0,0.0,0,0,0.0,0,0,0.0,0,0,0,0,0,0,0,1,0,-9,1,Hunter Tyson,DEN,DEN,HOU,,,0,0,0,0
22023,1641816,22300252,"NOV 26, 2023",DEN vs. SAS,W,1,0,0,0.0,0,0,0.0,0,0,0.0,0,1,1,0,0,0,0,0,0,-1,1,Hunter Tyson,DEN,DEN,SAS,,,1,1,0,1
22023,1641816,22300210,"NOV 19, 2023",DEN @ CLE,L,3,0,1,0.0,0,1,0.0,0,0,0.0,0,0,0,1,0,0,0,0,0,10,1,Hunter Tyson,DEN,CLE,DEN,,,1,0,1,1
22023,1641816,22300156,"NOV 06, 2023",DEN vs. NOP,W,1,0,0,0.0,0,0,0.0,0,0,0.0,0,0,0,0,0,0,0,0,0,3,1,Hunter Tyson,DEN,DEN,NOP,,,0,0,0,0
22023,1641816,22300139,"NOV 04, 2023",DEN vs. CHI,W,2,0,1,0.0,0,1,0.0,0,0,0.0,0,1,1,0,0,0,0,1,0,-1,1,Hunter Tyson,DEN,DEN,CHI,,,1,1,0,1
22023,1641816,22300123,"NOV 01, 2023",DEN @ MIN,L,4,1,2,0.5,0,1,0.0,0,0,0.0,0,1,1,0,0,0,0,2,2,-2,1,Hunter Tyson,DEN,MIN,DEN,,,3,3,2,1
22023,1641816,22300095,"OCT 29, 2023",DEN @ OKC,W,3,0,0,0.0,0,0,0.0,0,0,0.0,0,1,1,0,0,0,0,1,0,0,1,Hunter Tyson,DEN,OKC,DEN,,,1,1,0,1
22023,1630649,22300268,"NOV 30, 2023",DET @ NYK,L,2,0,0,0.0,0,0,0.0,0,0,0.0,0,0,0,0,0,0,0,0,0,-3,1,Stanley Umude,DET,NYK,DET,,,0,0,0,0
22023,1630649,22300258,"NOV 29, 2023",DET vs. LAL,L,20,2,9,0.222,2,5,0.4,2,2,1.0,0,5,5,2,1,0,3,5,8,3,1,Stanley Umude,DET,DET,LAL,,,15,13,10,7
22023,1630649,22300253,"NOV 27, 2023",DET vs. WAS,L,2,0,1,0.0,0,1,0.0,0,0,0.0,1,0,1,0,0,0,1,2,0,-1,1,Stanley Umude,DET,DET,WAS,,,1,1,0,1
22023,1630649,22300047,"NOV 24, 2023",DET @ IND,L,8,0,1,0.0,0,0,0.0,0,0,0.0,1,1,2,0,1,2,1,3,0,-14,1,Stanley Umude,DET,IND,DET,,,2,2,0,2
22023,1630649,22300218,"NOV 20, 2023",DET vs. DEN,L,18,4,8,0.5,3,5,0.6,0,0,0.0,0,1,1,2,0,0,1,1,11,-2,1,Stanley Umude,DET,DET,DEN,,,14,12,13,3
22023,1630649,22300211,"NOV 19, 2023",DET @ TOR,L,25,5,6,0.833,2,3,0.667,7,8,0.875,0,4,4,3,0,1,1,2,19,-12,1,Stanley Umude,DET,TOR,DET,,,26,23,22,7
22023,1630649,22300030,"NOV 17, 2023",DET @ CLE,L,17,2,3,0.667,2,3,0.667,4,4,1.0,1,5,6,0,1,1,0,1,10,0,1,Stanley Umude,DET,CLE,DET,,,16,16,10,6
22023,1630649,22300008,"NOV 10, 2023",DET vs. PHI,L,17,1,2,0.5,1,2,0.5,7,8,0.875,0,4,4,1,0,0,0,2,10,-2,1,Stanley Umude,DET,DET,PHI,,,15,14,11,5
22023,1630649,22300165,"NOV 08, 2023",DET @ MIL,L,9,1,2,0.5,0,1,0.0,0,0,0.0,0,0,0,0,0,1,2,1,2,-2,1,Stanley Umude,DET,MIL,DET,,,2,2,2,0
22023,1630649,22300145,"NOV 06, 2023",DET vs. GSW,L,16,5,8,0.625,4,5,0.8,1,1,1.0,0,3,3,0,0,0,1,3,15,-10,1,Stanley Umude,DET,DET,GSW,,,18,18,15,3
22023,1630649,22300140,"NOV 05, 2023",DET vs. PHX,L,4,0,2,0.0,0,1,0.0,0,0,0.0,0,0,0,0,0,0,0,1,0,0,1,Stanley Umude,DET,DET,PHX,,,0,0,0,0
22023,1630649,22300129,"NOV 02, 2023",DET @ NOP,L,1,0,1,0.0,0,1,0.0,0,0,0.0,0,0,0,0,0,0,0,0,0,0,1,Stanley Umude,DET,NOP,DET,,,0,0,0,0
22023,1630649,22300115,"NOV 01, 2023",DET vs. POR,L,12,0,1,0.0,0,0,0.0,0,0,0.0,0,2,2,0,0,0,0,3,0,-8,1,Stanley Umude,DET,DET,POR,,,2,2,0,2
22023,1630649,22300109,"OCT 30, 2023",DET @ OKC,L,2,0,0,0.0,0,0,0.0,0,0,0.0,0,0,0,0,1,0,0,0,0,8,1,Stanley Umude,DET,OKC,DET,,,0,0,0,0
22023,1630649,22300088,"OCT 28, 2023",DET vs. CHI,W,1,0,0,0.0,0,0,0.0,0,0,0.0,0,0,0,0,0,0,0,0,0,-3,1,Stanley Umude,DET,DET,CHI,,,0,0,0,0
22023,202685,22300556,"JAN 15, 2024",NOP @ DAL,L,19,2,5,0.4,0,0,0.0,2,2,1.0,4,2,6,2,0,2,3,4,6,-22,1,Jonas Valanciunas,NOP,DAL,NOP,,,14,12,8,8
22023,202685,22300547,"JAN 13, 2024",NOP @ DAL,W,28,4,6,0.667,0,0,0.0,6,9,0.667,5,7,12,7,0,2,0,4,14,-4,1,Jonas Valanciunas,NOP,DAL,NOP,,,33,26,21,19
22023,202685,22300539,"JAN 12, 2024",NOP @ DEN,L,26,5,11,0.455,1,3,0.333,6,6,1.0,2,4,6,1,0,0,0,3,17,-9,1,Jonas Valanciunas,NOP,DEN,NOP,,,24,23,18,7
22023,202685,22300525,"JAN 10, 2024",NOP @ GSW,W,21,9,13,0.692,2,3,0.667,1,2,0.5,4,5,9,2,2,1,0,4,21,18,1,Jonas Valanciunas,NOP,GSW,NOP,,,32,30,23,11
22023,202685,22300500,"JAN 07, 2024",NOP @ SAC,W,22,6,10,0.6,1,2,0.5,2,2,1.0,1,11,12,1,0,1,1,2,15,20,1,Jonas Valanciunas,NOP,SAC,NOP,,,28,27,16,13
22023,202685,22300486,"JAN 05, 2024",NOP vs. LAC,L,23,6,12,0.5,1,1,1.0,0,0,0.0,4,7,11,1,0,1,3,2,13,-7,1,Jonas Valanciunas,NOP,NOP,LAC,,,25,24,14,12
22023,202685,22300471,"JAN 03, 2024",NOP @ MIN,W,20,2,5,0.4,0,2,0.0,0,0,0.0,1,6,7,3,0,0,1,5,4,14,1,Jonas Valanciunas,NOP,MIN,NOP,,,14,11,7,10
22023,202685,22300461,"JAN 02, 2024",NOP vs. BKN,W,20,5,5,1.0,1,1,1.0,0,0,0.0,3,9,12,0,1,1,1,0,11,17,1,Jonas Valanciunas,NOP,NOP,BKN,,,23,23,11,12
22023,202685,22300446,"DEC 31, 2023",NOP vs. LAL,W,25,4,7,0.571,0,0,0.0,5,5,1.0,2,6,8,1,1,1,0,1,13,3,1,Jonas Valanciunas,NOP,NOP,LAL,,,22,21,14,9
22023,202685,22300424,"DEC 28, 2023",NOP vs. UTA,W,23,2,6,0.333,0,1,0.0,2,2,1.0,2,2,4,1,0,1,2,1,6,-9,1,Jonas Valanciunas,NOP,NOP,UTA,,,11,10,7,5
22023,202685,22300410,"DEC 26, 2023",NOP vs. MEM,L,36,8,14,0.571,0,1,0.0,1,3,0.333,3,10,13,0,1,1,1,5,17,-7,1,Jonas Valanciunas,NOP,NOP,MEM,,,30,30,17,13
22023,202685,22300392,"DEC 23, 2023",NOP vs. HOU,L,26,5,11,0.455,0,2,0.0,0,0,0.0,2,9,11,5,2,1,6,6,10,5,1,Jonas Valanciunas,NOP,NOP,HOU,,,26,21,15,16
22023,202685,22300375,"DEC 21, 2023",NOP @ CLE,W,28,6,9,0.667,1,3,0.333,0,0,0.0,1,6,7,5,1,1,2,3,13,-3,1,Jonas Valanciunas,NOP,CLE,NOP,,,25,20,18,12
22023,202685,22300360,"DEC 19, 2023",NOP vs. MEM,L,33,9,12,0.75,1,1,1.0,3,3,1.0,4,10,14,1,1,1,2,5,22,5,1,Jonas Valanciunas,NOP,NOP,MEM,,,37,36,23,15
22023,202685,22300345,"DEC 17, 2023",NOP @ SAS,W,23,6,12,0.5,1,4,0.25,2,3,0.667,3,12,15,3,1,1,1,3,15,25,1,Jonas Valanciunas,NOP,SAS,NOP,,,33,30,18,18
22023,202685,22300326,"DEC 15, 2023",NOP @ CHA,W,37,11,16,0.688,2,4,0.5,5,6,0.833,4,9,13,4,0,2,2,3,29,5,1,Jonas Valanciunas,NOP,CHA,NOP,,,46,42,33,17
22023,202685,22300311,"DEC 13, 2023",NOP @ WAS,W,33,6,9,0.667,1,1,1.0,3,4,0.75,3,15,18,3,1,1,4,4,16,13,1,Jonas Valanciunas,NOP,WAS,NOP,,,37,34,19,21
22023,202685,22300301,"DEC 11, 2023",NOP vs. MIN,W,35,5,9,0.556,0,1,0.0,4,7,0.571,3,10,13,4,2,2,3,3,14,13,1,Jonas Valanciunas,NOP,NOP,MIN,,,31,27,18,17
22023,202685,22301230,"DEC 07, 2023",NOP @ LAL,L,23,3,9,0.333,1,4,0.25,2,2,1.0,0,3,3,2,1,3,1,2,9,-25,1,Jonas Valanciunas,NOP,LAL,NOP,,,14,12,11,5
22023,202685,22301204,"DEC 04, 2023",NOP @ SAC,W,29,7,11,0.636,0,0,0.0,4,4,1.0,4,7,11,0,0,0,1,6,18,-7,1,Jonas Valanciunas,NOP,SAC,NOP,,,29,29,18,11
22023,202685,22300285,"DEC 02, 2023",NOP @ CHI,L,36,6,11,0.545,2,4,0.5,1,2,0.5,2,8,10,1,0,0,0,3,15,13,1,Jonas Valanciunas,NOP,CHI,NOP,,,26,25,16,11
22023,202685,22300278,"DEC 01, 2023",NOP vs. SAS,W,31,9,12,0.75,0,1,0.0,6,7,0.857,2,10,12,1,1,2,1,3,24,15,1,Jonas Valanciunas,NOP,NOP,SAS,,,37,36,25,13
22023,202685,22300262,"NOV 29, 2023",NOP vs. PHI,W,32,8,9,0.889,0,1,0.0,3,3,1.0,3,3,6,3,0,0,2,5,19,18,1,Jonas Valanciunas,NOP,NOP,PHI,,,28,25,22,9
22023,202685,22300256,"NOV 27, 2023",NOP @ UTA,L,30,5,10,0.5,0,1,0.0,4,6,0.667,5,8,13,2,0,1,0,3,14,3,1,Jonas Valanciunas,NOP,UTA,NOP,,,29,27,16,15
22023,202685,22300243,"NOV 25, 2023",NOP @ UTA,L,26,3,10,0.3,0,2,0.0,2,4,0.5,5,2,7,2,1,0,1,2,8,-17,1,Jonas Valanciunas,NOP,UTA,NOP,,,17,15,10,9
22023,202685,22300052,"NOV 24, 2023",NOP @ LAC,W,28,4,6,0.667,2,2,1.0,2,2,1.0,2,6,8,4,1,0,1,4,12,15,1,Jonas Valanciunas,NOP,LAC,NOP,,,24,20,16,12
22023,202685,22300233,"NOV 22, 2023",NOP vs. SAC,W,28,6,9,0.667,0,0,0.0,3,4,0.75,3,8,11,2,0,0,1,5,15,2,1,Jonas Valanciunas,NOP,NOP,SAC,,,28,26,17,13
22023,202685,22300222,"NOV 20, 2023",NOP vs. SAC,W,21,3,4,0.75,0,0,0.0,4,4,1.0,1,12,13,7,1,3,0,3,10,33,1,Jonas Valanciunas,NOP,NOP,SAC,,,30,23,17,20
22023,202685,22300203,"NOV 18, 2023",NOP vs. MIN,L,30,10,15,0.667,0,1,0.0,6,6,1.0,5,6,11,3,1,3,3,5,26,2,1,Jonas Valanciunas,NOP,NOP,MIN,,,40,37,29,14
22023,202685,22300034,"NOV 17, 2023",NOP vs. DEN,W,34,10,18,0.556,1,3,0.333,1,3,0.333,2,6,8,3,0,1,0,4,22,-8,1,Jonas Valanciunas,NOP,NOP,DEN,,,33,30,25,11
22023,202685,22300022,"NOV 14, 2023",NOP vs. DAL,W,22,3,5,0.6,0,2,0.0,0,0,0.0,0,3,3,4,1,2,0,1,6,22,1,Jonas Valanciunas,NOP,NOP,DAL,,,13,9,10,7
22023,202685,22300183,"NOV 12, 2023",NOP vs. DAL,L,21,6,11,0.545,3,5,0.6,0,0,0.0,2,8,10,3,0,2,0,0,15,-13,1,Jonas Valanciunas,NOP,NOP,DAL,,,28,25,18,13
22023,202685,22300011,"NOV 10, 2023",NOP @ HOU,L,29,7,12,0.583,1,1,1.0,0,1,0.0,3,6,9,2,0,4,2,6,15,1,1,Jonas Valanciunas,NOP,HOU,NOP,,,26,24,17,11
22023,202685,22300166,"NOV 08, 2023",NOP @ MIN,L,22,4,9,0.444,0,2,0.0,0,0,0.0,1,5,6,0,0,0,0,1,8,-29,1,Jonas Valanciunas,NOP,MIN,NOP,,,14,14,8,6
22023,202685,22300156,"NOV 06, 2023",NOP @ DEN,L,24,2,6,0.333,0,1,0.0,2,2,1.0,2,9,11,2,0,1,2,6,6,-10,1,Jonas Valanciunas,NOP,DEN,NOP,,,19,17,8,13
22023,202685,22300135,"NOV 04, 2023",NOP vs. ATL,L,21,3,6,0.5,0,0,0.0,0,0,0.0,2,5,7,0,1,1,3,1,6,-20,1,Jonas Valanciunas,NOP,NOP,ATL,,,13,13,6,7
22023,202685,22300129,"NOV 02, 2023",NOP vs. DET,W,33,9,16,0.563,2,3,0.667,3,4,0.75,4,9,13,5,0,3,2,5,23,20,1,Jonas Valanciunas,NOP,NOP,DET,,,41,36,28,18
22023,202685,22300121,"NOV 01, 2023",NOP @ OKC,W,21,6,10,0.6,1,1,1.0,6,7,0.857,3,6,9,2,1,1,0,2,19,8,1,Jonas Valanciunas,NOP,OKC,NOP,,,30,28,21,11
22023,202685,22300108,"OCT 30, 2023",NOP vs. GSW,L,23,4,11,0.364,1,5,0.2,2,2,1.0,2,4,6,3,0,2,0,1,11,-17,1,Jonas Valanciunas,NOP,NOP,GSW,,,20,17,14,9
22023,202685,22300090,"OCT 28, 2023",NOP vs. NYK,W,21,3,7,0.429,0,1,0.0,2,2,1.0,0,4,4,0,0,0,4,4,8,5,1,Jonas Valanciunas,NOP,NOP,NYK,,,12,12,8,4
22023,202685,22300071,"OCT 25, 2023",NOP @ MEM,W,29,4,7,0.571,2,4,0.5,2,2,1.0,0,12,12,1,0,1,3,1,12,16,1,Jonas Valanciunas,NOP,MEM,NOP,,,25,24,13,13
22023,1627832,22300555,"JAN 15, 2024",HOU @ PHI,L,33,2,5,0.4,2,4,0.5,2,4,0.5,0,1,1,5,0,2,1,4,8,-12,1,Fred VanVleet,HOU,PHI,HOU,,,14,9,13,6
22023,1627832,22300542,"JAN 13, 2024",HOU @ BOS,L,23,2,6,0.333,1,3,0.333,0,0,0.0,1,0,1,7,0,1,0,2,5,-15,1,Fred VanVleet,HOU,BOS,HOU,,,13,6,12,8
22023,1627832,22300534,"JAN 12, 2024",HOU @ DET,W,43,7,15,0.467,3,9,0.333,3,3,1.0,1,3,4,12,2,2,0,5,20,12,1,Fred VanVleet,HOU,DET,HOU,,,36,24,32,16
22023,1627832,22300523,"JAN 10, 2024",HOU @ CHI,L,42,7,19,0.368,3,14,0.214,3,4,0.75,0,6,6,10,1,3,2,3,20,-10,1,Fred VanVleet,HOU,CHI,HOU,,,36,26,30,16
22023,1627832,22300509,"JAN 08, 2024",HOU @ MIA,L,39,10,22,0.455,7,14,0.5,5,5,1.0,2,3,5,7,0,2,1,2,32,-3,1,Fred VanVleet,HOU,MIA,HOU,,,44,37,39,12
22023,1627832,22300496,"JAN 06, 2024",HOU vs. MIL,W,37,4,13,0.308,3,10,0.3,3,3,1.0,1,1,2,7,2,0,1,3,14,-4,1,Fred VanVleet,HOU,HOU,MIL,,,23,16,21,9
22023,1627832,22300485,"JAN 05, 2024",HOU vs. MIN,L,31,2,9,0.222,2,5,0.4,1,1,1.0,0,1,1,8,1,1,1,0,7,-13,1,Fred VanVleet,HOU,HOU,MIN,,,16,8,15,9
22023,1627832,22300469,"JAN 03, 2024",HOU vs. BKN,W,36,7,9,0.778,6,8,0.75,1,2,0.5,0,6,6,10,0,2,4,2,21,24,1,Fred VanVleet,HOU,HOU,BKN,,,37,27,31,16
22023,1627832,22300453,"JAN 01, 2024",HOU vs. DET,W,26,6,11,0.545,3,6,0.5,0,0,0.0,0,1,1,7,1,0,1,1,15,20,1,Fred VanVleet,HOU,HOU,DET,,,23,16,22,8
22023,1627832,22300434,"DEC 29, 2023",HOU vs. PHI,L,43,9,16,0.563,8,12,0.667,7,8,0.875,0,3,3,10,1,1,5,3,33,-3,1,Fred VanVleet,HOU,HOU,PHI,,,46,36,43,13
22023,1627832,22300418,"DEC 27, 2023",HOU vs. PHX,L,29,4,11,0.364,1,3,0.333,1,2,0.5,1,1,2,6,0,0,1,2,10,-14,1,Fred VanVleet,HOU,HOU,PHX,,,18,12,16,8
22023,1627832,22300409,"DEC 26, 2023",HOU vs. IND,L,40,7,18,0.389,1,7,0.143,3,3,1.0,0,4,4,9,2,1,3,2,18,-11,1,Fred VanVleet,HOU,HOU,IND,,,31,22,27,13
22023,1627832,22300392,"DEC 23, 2023",HOU @ NOP,W,36,3,11,0.273,2,7,0.286,2,3,0.667,0,0,0,3,1,0,1,1,10,1,1,Fred VanVleet,HOU,NOP,HOU,,,13,10,13,3
22023,1627832,22300385,"DEC 22, 2023",HOU vs. DAL,W,26,3,8,0.375,1,5,0.2,3,3,1.0,0,2,2,4,1,0,0,2,10,29,1,Fred VanVleet,HOU,HOU,DAL,,,16,12,14,6
22023,1627832,22300371,"DEC 20, 2023",HOU vs. ATL,L,44,10,20,0.5,3,7,0.429,9,9,1.0,0,4,4,15,1,0,2,3,32,-2,1,Fred VanVleet,HOU,HOU,ATL,,,51,36,47,19
22023,1627832,22300349,"DEC 18, 2023",HOU @ CLE,L,45,9,19,0.474,4,8,0.5,5,5,1.0,0,8,8,17,2,1,2,4,27,2,1,Fred VanVleet,HOU,CLE,HOU,,,52,35,44,25
22023,1627832,22300346,"DEC 17, 2023",HOU @ MIL,L,39,8,16,0.5,4,8,0.5,2,2,1.0,1,1,2,6,1,2,1,2,22,-6,1,Fred VanVleet,HOU,MIL,HOU,,,30,24,28,8
22023,1627832,22300332,"DEC 15, 2023",HOU @ MEM,W,36,5,12,0.417,2,4,0.5,4,5,0.8,1,5,6,8,4,2,0,2,16,2,1,Fred VanVleet,HOU,MEM,HOU,,,30,22,24,14
22023,1627832,22300314,"DEC 13, 2023",HOU vs. MEM,W,39,2,8,0.25,0,3,0.0,7,9,0.778,0,5,5,9,3,0,3,4,11,18,1,Fred VanVleet,HOU,HOU,MEM,,,25,16,20,14
22023,1627832,22300298,"DEC 11, 2023",HOU vs. SAS,W,39,6,17,0.353,4,11,0.364,0,0,0.0,0,6,6,5,2,0,3,0,16,9,1,Fred VanVleet,HOU,HOU,SAS,,,27,22,21,11
22023,1627832,22301224,"DEC 08, 2023",HOU @ DEN,W,40,6,17,0.353,4,10,0.4,10,13,0.769,1,3,4,3,0,1,1,3,26,16,1,Fred VanVleet,HOU,DEN,HOU,,,33,30,29,7
22023,1627832,22301212,"DEC 06, 2023",HOU vs. OKC,W,38,4,14,0.286,3,7,0.429,0,0,0.0,0,3,3,9,3,1,3,0,11,11,1,Fred VanVleet,HOU,HOU,OKC,,,23,14,20,12
22023,1627832,22300291,"DEC 02, 2023",HOU @ LAL,L,40,7,15,0.467,4,7,0.571,4,4,1.0,1,4,5,7,0,0,3,1,22,-22,1,Fred VanVleet,HOU,LAL,HOU,,,34,27,29,12
22023,1627832,22300059,"NOV 28, 2023",HOU @ DAL,L,41,3,9,0.333,1,7,0.143,3,3,1.0,0,4,4,12,1,1,0,3,10,-12,1,Fred VanVleet,HOU,DAL,HOU,,,26,14,22,16
22023,1627832,22300048,"NOV 24, 2023",HOU vs. DEN,W,39,6,12,0.5,3,5,0.6,2,2,1.0,0,6,6,11,1,2,1,3,17,30,1,Fred VanVleet,HOU,HOU,DEN,,,34,23,28,17
22023,1627832,22300231,"NOV 22, 2023",HOU vs. MEM,W,39,5,12,0.417,4,8,0.5,2,3,0.667,1,6,7,4,2,0,1,0,16,22,1,Fred VanVleet,HOU,HOU,MEM,,,27,23,20,11
22023,1627832,22300224,"NOV 20, 2023",HOU @ GSW,L,41,3,13,0.231,1,8,0.125,3,3,1.0,0,5,5,14,0,0,0,2,10,-3,1,Fred VanVleet,HOU,GSW,HOU,,,29,15,24,19
22023,1627832,22300216,"NOV 19, 2023",HOU @ LAL,L,40,5,14,0.357,3,10,0.3,2,2,1.0,0,1,1,16,1,0,3,1,15,4,1,Fred VanVleet,HOU,LAL,HOU,,,32,16,31,17
22023,1627832,22300037,"NOV 17, 2023",HOU @ LAC,L,41,7,14,0.5,5,9,0.556,0,0,0.0,1,7,8,10,1,1,2,0,19,-14,1,Fred VanVleet,HOU,LAC,HOU,,,37,27,29,18
22023,1627832,22300182,"NOV 12, 2023",HOU vs. DEN,W,41,9,21,0.429,3,9,0.333,5,7,0.714,0,2,2,4,0,0,2,2,26,-4,1,Fred VanVleet,HOU,HOU,DEN,,,32,28,30,6
22023,1627832,22300011,"NOV 10, 2023",HOU vs. NOP,W,40,7,15,0.467,4,9,0.444,2,2,1.0,1,2,3,8,1,1,1,2,20,-8,1,Fred VanVleet,HOU,HOU,NOP,,,31,23,28,11
22023,1627832,22300163,"NOV 08, 2023",HOU vs. LAL,W,29,2,9,0.222,1,6,0.167,4,4,1.0,1,3,4,10,1,0,1,2,9,28,1,Fred VanVleet,HOU,HOU,LAL,,,23,13,19,14
22023,1627832,22300153,"NOV 06, 2023",HOU vs. SAC,W,27,3,8,0.375,3,5,0.6,2,2,1.0,0,4,4,5,0,0,1,1,11,34,1,Fred VanVleet,HOU,HOU,SAC,,,20,15,16,9
22023,1627832,22300137,"NOV 04, 2023",HOU vs. SAC,W,36,7,22,0.318,4,14,0.286,3,3,1.0,0,6,6,12,0,2,2,4,21,13,1,Fred VanVleet,HOU,HOU,SAC,,,39,27,33,18
22023,1627832,22300122,"NOV 01, 2023",HOU vs. CHA,W,39,8,17,0.471,5,10,0.5,1,1,1.0,0,3,3,11,0,0,2,1,22,14,1,Fred VanVleet,HOU,HOU,CHA,,,36,25,33,14
22023,1627832,22300096,"OCT 29, 2023",HOU vs. GSW,L,32,2,13,0.154,2,7,0.286,2,2,1.0,0,0,0,4,2,0,0,2,8,-13,1,Fred VanVleet,HOU,HOU,GSW,,,12,8,12,4
22023,1627832,22300083,"OCT 27, 2023",HOU @ SAS,L,45,10,20,0.5,2,10,0.2,2,3,0.667,0,8,8,12,0,0,3,5,24,-9,1,Fred VanVleet,HOU,SAS,HOU,,,44,32,36,20
22023,1627832,22300066,"OCT 25, 2023",HOU @ ORL,L,34,5,13,0.385,4,6,0.667,0,0,0.0,0,1,1,5,1,0,3,0,14,-3,1,Fred VanVleet,HOU,ORL,HOU,,,20,15,19,6
22023,1629020,22300565,"JAN 15, 2024",LAL vs. OKC,W,18,2,2,1.0,0,0,0.0,1,1,1.0,0,4,4,2,3,0,0,0,5,5,1,Jarred Vanderbilt,LAL,LAL,OKC,,,11,9,7,6
22023,1629020,22300549,"JAN 13, 2024",LAL @ UTA,L,23,2,2,1.0,1,1,1.0,0,0,0.0,2,1,3,1,1,0,2,4,5,4,1,Jarred Vanderbilt,LAL,UTA,LAL,,,9,8,6,4
22023,1629020,22300531,"JAN 11, 2024",LAL vs. PHX,L,29,2,5,0.4,1,3,0.333,1,4,0.25,3,6,9,2,2,0,1,0,6,-1,1,Jarred Vanderbilt,LAL,LAL,PHX,,,17,15,8,11
22023,1629020,22300516,"JAN 09, 2024",LAL vs. TOR,W,18,1,2,0.5,0,0,0.0,1,2,0.5,2,4,6,1,0,0,3,1,3,6,1,Jarred Vanderbilt,LAL,LAL,TOR,,,10,9,4,7
22023,1629020,22300505,"JAN 07, 2024",LAL vs. LAC,W,21,1,3,0.333,0,1,0.0,0,0,0.0,2,2,4,4,1,0,1,0,2,6,1,Jarred Vanderbilt,LAL,LAL,LAC,,,10,6,6,8
22023,1629020,22300491,"JAN 05, 2024",LAL vs. MEM,L,17,0,0,0.0,0,0,0.0,0,0,0.0,1,4,5,1,1,0,0,1,0,3,1,Jarred Vanderbilt,LAL,LAL,MEM,,,6,5,1,6
22023,1629020,22300475,"JAN 03, 2024",LAL vs. MIA,L,16,2,3,0.667,0,0,0.0,0,0,0.0,0,2,2,0,0,0,2,0,4,-6,1,Jarred Vanderbilt,LAL,LAL,MIA,,,6,6,4,2
22023,1629020,22300446,"DEC 31, 2023",LAL @ NOP,L,21,2,4,0.5,0,1,0.0,0,0,0.0,0,2,2,0,1,0,1,0,4,-13,1,Jarred Vanderbilt,LAL,NOP,LAL,,,6,6,4,2
22023,1629020,22300443,"DEC 30, 2023",LAL @ MIN,L,27,3,7,0.429,0,2,0.0,2,2,1.0,1,4,5,1,2,0,0,5,8,10,1,Jarred Vanderbilt,LAL,MIN,LAL,,,14,13,9,6
22023,1629020,22300428,"DEC 28, 2023",LAL vs. CHA,W,24,3,8,0.375,1,2,0.5,0,0,0.0,2,2,4,3,2,0,0,1,7,2,1,Jarred Vanderbilt,LAL,LAL,CHA,,,14,11,10,7
22023,1629020,22300403,"DEC 25, 2023",LAL vs. BOS,L,23,3,5,0.6,0,0,0.0,0,0,0.0,4,2,6,0,1,0,0,4,6,-10,1,Jarred Vanderbilt,LAL,LAL,BOS,,,12,12,6,6
22023,1629020,22300397,"DEC 23, 2023",LAL @ OKC,W,24,1,4,0.25,0,1,0.0,0,0,0.0,1,5,6,0,1,1,1,0,2,5,1,Jarred Vanderbilt,LAL,OKC,LAL,,,8,8,2,6
22023,1629020,22300380,"DEC 21, 2023",LAL @ MIN,L,14,0,3,0.0,0,1,0.0,0,0,0.0,1,4,5,0,0,0,0,3,0,1,1,Jarred Vanderbilt,LAL,MIN,LAL,,,5,5,0,5
22023,1629020,22300370,"DEC 20, 2023",LAL @ CHI,L,13,1,3,0.333,0,2,0.0,0,0,0.0,0,0,0,0,0,0,0,1,2,-15,1,Jarred Vanderbilt,LAL,CHI,LAL,,,2,2,2,0
22023,1629020,22300359,"DEC 18, 2023",LAL vs. NYK,L,14,0,0,0.0,0,0,0.0,0,0,0.0,2,0,2,1,0,0,1,3,0,3,1,Jarred Vanderbilt,LAL,LAL,NYK,,,3,2,1,3
22023,1629020,22300331,"DEC 15, 2023",LAL @ SAS,L,13,0,3,0.0,0,1,0.0,0,0,0.0,0,5,5,1,0,0,0,4,0,-2,1,Jarred Vanderbilt,LAL,SAS,LAL,,,6,5,1,6
22023,1629020,22300316,"DEC 13, 2023",LAL @ SAS,W,17,1,1,1.0,0,0,0.0,0,0,0.0,0,3,3,0,1,1,0,1,2,-2,1,Jarred Vanderbilt,LAL,SAS,LAL,,,5,5,2,3
22023,1629020,22301230,"DEC 07, 2023",LAL vs. NOP,W,14,1,2,0.5,0,0,0.0,0,0,0.0,0,5,5,1,0,1,0,0,2,9,1,Jarred Vanderbilt,LAL,LAL,NOP,,,8,7,3,6
22023,1629020,22301203,"DEC 05, 2023",LAL vs. PHX,W,15,0,2,0.0,0,2,0.0,1,2,0.5,4,2,6,2,1,0,1,2,1,6,1,Jarred Vanderbilt,LAL,LAL,PHX,,,9,7,3,8
22023,1629020,22300291,"DEC 02, 2023",LAL vs. HOU,W,14,0,2,0.0,0,2,0.0,0,0,0.0,1,3,4,1,0,0,0,1,0,2,1,Jarred Vanderbilt,LAL,LAL,HOU,,,5,4,1,5
22023,1630170,22300559,"JAN 15, 2024",SAS @ ATL,L,30,2,11,0.182,0,5,0.0,0,0,0.0,1,3,4,4,0,1,0,0,4,-4,1,Devin Vassell,SAS,ATL,SAS,,,12,8,8,8
22023,1630170,22300548,"JAN 13, 2024",SAS vs. CHI,L,34,1,13,0.077,1,8,0.125,2,3,0.667,0,4,4,2,1,0,2,0,5,-13,1,Devin Vassell,SAS,SAS,CHI,,,11,9,7,6
22023,1630170,22300541,"JAN 12, 2024",SAS vs. CHA,W,26,4,10,0.4,1,3,0.333,3,3,1.0,0,3,3,5,2,0,2,2,12,28,1,Devin Vassell,SAS,SAS,CHA,,,20,15,17,8
22023,1630170,22300519,"JAN 10, 2024",SAS @ DET,W,27,6,12,0.5,1,5,0.2,3,4,0.75,0,3,3,5,1,0,1,0,16,13,1,Devin Vassell,SAS,DET,SAS,,,24,19,21,8
22023,1630170,22300497,"JAN 07, 2024",SAS @ CLE,L,35,9,19,0.474,4,9,0.444,0,0,0.0,0,2,2,3,3,0,0,2,22,12,1,Devin Vassell,SAS,CLE,SAS,,,27,24,25,5
22023,1630170,22300477,"JAN 04, 2024",SAS vs. MIL,L,35,14,21,0.667,6,9,0.667,0,0,0.0,1,5,6,4,1,0,0,0,34,-10,1,Devin Vassell,SAS,SAS,MIL,,,44,40,38,10
22023,1630170,22300460,"JAN 02, 2024",SAS @ MEM,L,34,3,8,0.375,1,2,0.5,4,5,0.8,1,1,2,3,1,1,2,2,11,-7,1,Devin Vassell,SAS,MEM,SAS,,,16,13,14,5
22023,1630170,22300448,"DEC 31, 2023",SAS vs. BOS,L,31,9,15,0.6,2,4,0.5,2,2,1.0,0,4,4,1,2,0,2,3,22,-34,1,Devin Vassell,SAS,SAS,BOS,,,27,26,23,5
22023,1630170,22300437,"DEC 29, 2023",SAS @ POR,L,31,8,16,0.5,3,6,0.5,3,4,0.75,0,3,3,5,4,1,0,1,22,-6,1,Devin Vassell,SAS,POR,SAS,,,30,25,27,8
22023,1630170,22300427,"DEC 28, 2023",SAS @ POR,W,35,7,16,0.438,2,9,0.222,1,1,1.0,0,5,5,7,4,1,1,0,17,18,1,Devin Vassell,SAS,POR,SAS,,,29,22,24,12
22023,1630170,22300412,"DEC 26, 2023",SAS vs. UTA,L,34,8,18,0.444,5,10,0.5,1,1,1.0,1,3,4,3,3,0,1,2,22,-11,1,Devin Vassell,SAS,SAS,UTA,,,29,26,25,7
22023,1630170,22300398,"DEC 23, 2023",SAS @ DAL,L,30,3,13,0.231,0,6,0.0,3,3,1.0,0,0,0,5,0,0,0,1,9,-38,1,Devin Vassell,SAS,DAL,SAS,,,14,9,14,5
22023,1630170,22300376,"DEC 21, 2023",SAS @ CHI,L,31,7,15,0.467,3,8,0.375,4,4,1.0,1,3,4,2,1,0,1,0,21,-4,1,Devin Vassell,SAS,CHI,SAS,,,27,25,23,6
22023,1630170,22300361,"DEC 19, 2023",SAS @ MIL,L,33,7,18,0.389,2,6,0.333,1,1,1.0,0,3,3,2,0,0,2,0,17,-12,1,Devin Vassell,SAS,MIL,SAS,,,22,20,19,5
22023,1630170,22300345,"DEC 17, 2023",SAS vs. NOP,L,30,5,13,0.385,3,7,0.429,0,1,0.0,0,2,2,3,0,0,1,2,13,-15,1,Devin Vassell,SAS,SAS,NOP,,,18,15,16,5
22023,1630170,22300331,"DEC 15, 2023",SAS vs. LAL,W,35,12,19,0.632,5,10,0.5,7,7,1.0,0,6,6,3,1,1,1,1,36,20,1,Devin Vassell,SAS,SAS,LAL,,,45,42,39,9
22023,1630170,22300316,"DEC 13, 2023",SAS vs. LAL,L,35,5,15,0.333,1,7,0.143,2,2,1.0,0,5,5,4,2,0,2,0,13,5,1,Devin Vassell,SAS,SAS,LAL,,,22,18,17,9
22023,1630170,22300298,"DEC 11, 2023",SAS @ HOU,L,31,5,16,0.313,1,9,0.111,3,5,0.6,3,3,6,2,0,0,0,1,14,1,1,Devin Vassell,SAS,HOU,SAS,,,22,20,16,8
22023,1630170,22301223,"DEC 08, 2023",SAS vs. CHI,L,34,4,15,0.267,1,9,0.111,2,3,0.667,0,2,2,5,1,0,3,1,11,-14,1,Devin Vassell,SAS,SAS,CHI,,,18,13,16,7
22023,1630170,22301210,"DEC 06, 2023",SAS @ MIN,L,31,9,16,0.563,4,8,0.5,0,0,0.0,0,3,3,2,1,1,0,1,22,4,1,Devin Vassell,SAS,MIN,SAS,,,27,25,24,5
22023,1630170,22300278,"DEC 01, 2023",SAS @ NOP,L,27,5,12,0.417,2,7,0.286,2,2,1.0,0,0,0,1,2,0,3,2,14,-16,1,Devin Vassell,SAS,NOP,SAS,,,15,14,15,1
22023,1630170,22300272,"NOV 30, 2023",SAS vs. ATL,L,27,8,14,0.571,4,10,0.4,5,5,1.0,0,4,4,4,0,0,2,1,25,-4,1,Devin Vassell,SAS,SAS,ATL,,,33,29,29,8
22023,1630170,22300252,"NOV 26, 2023",SAS @ DEN,L,26,7,13,0.538,4,7,0.571,1,1,1.0,0,1,1,3,1,0,0,1,19,5,1,Devin Vassell,SAS,DEN,SAS,,,23,20,22,4
22023,1630170,22300051,"NOV 24, 2023",SAS @ GSW,L,27,10,19,0.526,4,10,0.4,0,0,0.0,1,3,4,1,1,0,2,2,24,-9,1,Devin Vassell,SAS,GSW,SAS,,,29,28,25,5
22023,1630170,22300235,"NOV 22, 2023",SAS vs. LAC,L,27,6,15,0.4,2,8,0.25,4,5,0.8,1,3,4,4,1,0,2,2,18,-7,1,Devin Vassell,SAS,SAS,LAC,,,26,22,22,8
22023,1630170,22300021,"NOV 14, 2023",SAS @ OKC,L,25,5,12,0.417,1,2,0.5,1,2,0.5,0,3,3,4,2,1,1,1,12,-20,1,Devin Vassell,SAS,OKC,SAS,,,19,15,16,7
22023,1630170,22300184,"NOV 12, 2023",SAS vs. MIA,L,33,5,12,0.417,4,9,0.444,0,0,0.0,2,5,7,4,0,0,1,0,14,-15,1,Devin Vassell,SAS,SAS,MIA,,,25,21,18,11
22023,1630170,22300013,"NOV 10, 2023",SAS vs. MIN,L,35,8,16,0.5,6,11,0.545,7,9,0.778,0,3,3,4,1,0,1,1,29,2,1,Devin Vassell,SAS,SAS,MIN,,,36,32,33,7
22023,1630170,22300161,"NOV 08, 2023",SAS @ NYK,L,12,2,6,0.333,0,2,0.0,0,0,0.0,0,2,2,2,0,0,1,0,4,-3,1,Devin Vassell,SAS,NYK,SAS,,,8,6,6,4
22023,1630170,22300131,"NOV 02, 2023",SAS @ PHX,W,17,7,10,0.7,3,3,1.0,0,0,0.0,0,2,2,1,0,0,0,2,17,16,1,Devin Vassell,SAS,PHX,SAS,,,20,19,18,3
22023,1630170,22300113,"OCT 31, 2023",SAS @ PHX,W,36,7,17,0.412,3,8,0.375,1,2,0.5,1,5,6,5,3,0,3,0,18,-1,1,Devin Vassell,SAS,PHX,SAS,,,29,24,23,11
22023,1630170,22300099,"OCT 29, 2023",SAS @ LAC,L,28,6,10,0.6,1,3,0.333,1,1,1.0,0,1,1,0,1,0,2,2,14,-30,1,Devin Vassell,SAS,LAC,SAS,,,15,15,14,1
22023,1630170,22300083,"OCT 27, 2023",SAS vs. HOU,W,40,7,13,0.538,3,7,0.429,8,11,0.727,0,3,3,2,0,0,1,0,25,2,1,Devin Vassell,SAS,SAS,HOU,,,30,28,27,5
22023,1630170,22300073,"OCT 25, 2023",SAS vs. DAL,L,35,9,17,0.529,1,6,0.167,4,5,0.8,1,4,5,3,2,0,2,2,23,4,1,Devin Vassell,SAS,SAS,DAL,,,31,28,26,8
22023,1628426,22300552,"JAN 14, 2024",SAC @ MIL,L,6,2,4,0.5,0,2,0.0,0,0,0.0,0,1,1,0,0,0,0,0,4,-5,1,Sasha Vezenkov,SAC,MIL,SAC,,,5,5,4,1
22023,1628426,22300532,"JAN 12, 2024",SAC @ PHI,L,9,1,5,0.2,0,1,0.0,0,0,0.0,5,0,5,0,0,0,1,0,2,-5,1,Sasha Vezenkov,SAC,PHI,SAC,,,7,7,2,5
22023,1628426,22300500,"JAN 07, 2024",SAC vs. NOP,L,21,5,9,0.556,1,5,0.2,0,0,0.0,1,1,2,0,0,0,0,0,11,-24,1,Sasha Vezenkov,SAC,SAC,NOP,,,13,13,11,2
22023,1628426,22300449,"DEC 31, 2023",SAC @ MEM,W,3,1,2,0.5,0,0,0.0,0,0,0.0,0,1,1,0,0,0,0,0,2,2,1,Sasha Vezenkov,SAC,MEM,SAC,,,3,3,2,1
22023,1628426,22300413,"DEC 26, 2023",SAC @ POR,L,9,0,3,0.0,0,3,0.0,0,0,0.0,1,0,1,1,0,0,0,1,0,-12,1,Sasha Vezenkov,SAC,POR,SAC,,,2,1,1,2
22023,1628426,22300400,"DEC 23, 2023",SAC vs. MIN,L,8,0,1,0.0,0,1,0.0,0,0,0.0,0,1,1,0,1,0,0,1,0,-5,1,Sasha Vezenkov,SAC,SAC,MIN,,,1,1,0,1
22023,1628426,22300387,"DEC 22, 2023",SAC vs. PHX,W,6,1,1,1.0,1,1,1.0,0,0,0.0,1,0,1,0,0,0,1,1,3,-4,1,Sasha Vezenkov,SAC,SAC,PHX,,,4,4,3,1
22023,1628426,22300373,"DEC 20, 2023",SAC vs. BOS,L,13,1,4,0.25,1,3,0.333,0,0,0.0,2,1,3,0,0,0,0,0,3,1,1,Sasha Vezenkov,SAC,SAC,BOS,,,6,6,3,3
22023,1628426,22300358,"DEC 18, 2023",SAC vs. WAS,W,12,3,5,0.6,2,3,0.667,0,0,0.0,4,3,7,1,2,0,1,1,8,-4,1,Sasha Vezenkov,SAC,SAC,WAS,,,16,15,9,8
22023,1628426,22300342,"DEC 16, 2023",SAC vs. UTA,W,11,1,3,0.333,1,2,0.5,0,0,0.0,0,4,4,2,0,0,0,0,3,-7,1,Sasha Vezenkov,SAC,SAC,UTA,,,9,7,5,6
22023,1628426,22300324,"DEC 14, 2023",SAC vs. OKC,W,10,1,4,0.25,1,4,0.25,0,0,0.0,1,3,4,0,0,0,0,1,3,9,1,Sasha Vezenkov,SAC,SAC,OKC,,,7,7,3,4
22023,1628426,22300309,"DEC 12, 2023",SAC @ LAC,L,20,4,7,0.571,1,3,0.333,0,0,0.0,0,3,3,3,1,0,0,0,9,2,1,Sasha Vezenkov,SAC,LAC,SAC,,,15,12,12,6
22023,1628426,22300303,"DEC 11, 2023",SAC vs. BKN,W,11,1,4,0.25,0,2,0.0,0,0,0.0,1,4,5,0,0,1,1,2,2,-3,1,Sasha Vezenkov,SAC,SAC,BKN,,,7,7,2,5
22023,1628426,22301228,"DEC 08, 2023",SAC @ PHX,W,20,5,7,0.714,2,3,0.667,2,2,1.0,3,0,3,2,3,0,1,1,14,5,1,Sasha Vezenkov,SAC,PHX,SAC,,,19,17,16,5
22023,1628426,22301204,"DEC 04, 2023",SAC vs. NOP,L,6,0,3,0.0,0,1,0.0,0,0,0.0,2,0,2,0,0,0,0,2,0,-12,1,Sasha Vezenkov,SAC,SAC,NOP,,,2,2,0,2
22023,1628426,22300290,"DEC 02, 2023",SAC vs. DEN,W,14,1,3,0.333,1,1,1.0,1,3,0.333,1,2,3,0,0,0,1,0,4,14,1,Sasha Vezenkov,SAC,SAC,DEN,,,7,7,4,3
22023,1628426,22300264,"NOV 29, 2023",SAC vs. LAC,L,24,5,7,0.714,3,5,0.6,0,0,0.0,1,4,5,0,0,0,0,2,13,6,1,Sasha Vezenkov,SAC,SAC,LAC,,,18,18,13,5
22023,1628426,22300060,"NOV 28, 2023",SAC vs. GSW,W,15,3,9,0.333,2,6,0.333,0,0,0.0,1,3,4,1,0,2,0,1,8,17,1,Sasha Vezenkov,SAC,SAC,GSW,,,13,12,9,5
22023,1628426,22300233,"NOV 22, 2023",SAC @ NOP,L,10,1,5,0.2,1,4,0.25,0,0,0.0,0,2,2,0,0,0,2,0,3,-14,1,Sasha Vezenkov,SAC,NOP,SAC,,,5,5,3,2
22023,1628426,22300212,"NOV 19, 2023",SAC @ DAL,W,13,3,5,0.6,1,2,0.5,0,0,0.0,1,0,1,1,0,1,1,2,7,2,1,Sasha Vezenkov,SAC,DAL,SAC,,,9,8,8,2
22023,1628426,22300032,"NOV 17, 2023",SAC @ SAS,W,17,2,4,0.5,1,2,0.5,0,0,0.0,0,4,4,0,0,0,0,3,5,10,1,Sasha Vezenkov,SAC,SAS,SAC,,,9,9,5,4
22023,1628426,22300198,"NOV 15, 2023",SAC @ LAL,W,12,1,4,0.25,0,3,0.0,2,2,1.0,0,0,0,0,2,0,0,0,4,-6,1,Sasha Vezenkov,SAC,LAL,SAC,,,4,4,4,0
22023,1628426,22300191,"NOV 13, 2023",SAC vs. CLE,W,17,4,6,0.667,3,5,0.6,0,0,0.0,0,2,2,0,0,0,0,1,11,7,1,Sasha Vezenkov,SAC,SAC,CLE,,,13,13,11,2
22023,1628426,22300016,"NOV 10, 2023",SAC vs. OKC,W,8,2,3,0.667,2,3,0.667,0,0,0.0,0,1,1,0,1,0,0,1,6,5,1,Sasha Vezenkov,SAC,SAC,OKC,,,7,7,6,1
22023,1628426,22300153,"NOV 06, 2023",SAC @ HOU,L,12,1,4,0.25,0,3,0.0,0,0,0.0,0,0,0,1,0,0,0,2,2,-15,1,Sasha Vezenkov,SAC,HOU,SAC,,,3,2,3,1
22023,1628426,22300137,"NOV 04, 2023",SAC @ HOU,L,11,0,2,0.0,0,1,0.0,0,0,0.0,0,1,1,0,1,1,0,3,0,3,1,Sasha Vezenkov,SAC,HOU,SAC,,,1,1,0,1
22023,1628426,22300126,"NOV 01, 2023",SAC @ GSW,L,17,1,6,0.167,0,3,0.0,0,0,0.0,0,5,5,0,0,0,1,2,2,-3,1,Sasha Vezenkov,SAC,GSW,SAC,,,7,7,2,5
22023,1628426,22300100,"OCT 29, 2023",SAC vs. LAL,W,18,4,10,0.4,2,6,0.333,1,1,1.0,0,4,4,1,0,1,0,0,11,-1,1,Sasha Vezenkov,SAC,SAC,LAL,,,16,15,12,5
22023,1628426,22300087,"OCT 27, 2023",SAC vs. GSW,L,12,4,6,0.667,2,4,0.5,0,0,0.0,0,1,1,0,0,0,0,0,10,1,1,Sasha Vezenkov,SAC,SAC,GSW,,,11,11,10,1
22023,1628426,22300072,"OCT 25, 2023",SAC @ UTA,W,16,3,6,0.5,2,5,0.4,0,0,0.0,1,1,2,0,2,0,0,1,8,9,1,Sasha Vezenkov,SAC,UTA,SAC,,,10,10,8,2
22023,1629216,22300370,"DEC 20, 2023",LAL @ CHI,L,14,1,4,0.25,1,3,0.333,0,0,0.0,0,1,1,3,0,0,0,2,3,-12,1,Gabe Vincent,LAL,CHI,LAL,,,7,4,6,4
22023,1629216,22300111,"OCT 30, 2023",LAL vs. ORL,W,25,4,7,0.571,1,3,0.333,0,0,0.0,0,0,0,2,1,0,0,2,9,10,1,Gabe Vincent,LAL,LAL,ORL,,,11,9,11,2
22023,1629216,22300100,"OCT 29, 2023",LAL @ SAC,L,32,1,3,0.333,0,2,0.0,0,0,0.0,0,0,0,2,1,0,0,4,2,4,1,Gabe Vincent,LAL,SAC,LAL,,,4,2,4,2
22023,1629216,22300076,"OCT 26, 2023",LAL vs. PHX,W,35,3,10,0.3,0,5,0.0,1,2,0.5,1,2,3,6,3,0,0,1,7,13,1,Gabe Vincent,LAL,LAL,PHX,,,16,10,13,9
22023,1629216,22300061,"OCT 24, 2023",LAL @ DEN,L,22,3,8,0.375,0,4,0.0,0,0,0.0,1,0,1,2,1,0,2,3,6,-17,1,Gabe Vincent,LAL,DEN,LAL,,,9,7,8,3
22023,202696,22300561,"JAN 15, 2024",CHI @ CLE,L,37,8,19,0.421,1,7,0.143,0,0,0.0,0,10,10,4,0,0,2,3,17,-8,1,Nikola Vucevic,CHI,CLE,CHI,,,31,27,21,14
22023,202696,22300548,"JAN 13, 2024",CHI @ SAS,W,31,10,17,0.588,2,5,0.4,2,3,0.667,3,13,16,5,0,3,1,2,24,13,1,Nikola Vucevic,CHI,SAS,CHI,,,45,40,29,21
22023,202696,22300536,"JAN 12, 2024",CHI vs. GSW,L,33,6,12,0.5,2,5,0.4,0,0,0.0,2,5,7,2,0,0,3,1,14,-7,1,Nikola Vucevic,CHI,CHI,GSW,,,23,21,16,9
22023,202696,22300523,"JAN 10, 2024",CHI vs. HOU,W,41,9,17,0.529,0,5,0.0,0,0,0.0,3,12,15,3,0,1,0,4,18,16,1,Nikola Vucevic,CHI,CHI,HOU,,,36,33,21,18
22023,202696,22300506,"JAN 08, 2024",CHI @ CHA,W,30,10,18,0.556,1,3,0.333,0,0,0.0,3,7,10,4,1,1,1,4,21,-9,1,Nikola Vucevic,CHI,CHA,CHI,,,35,31,25,14
22023,202696,22300484,"JAN 05, 2024",CHI vs. CHA,W,25,5,12,0.417,1,5,0.2,0,0,0.0,0,7,7,3,0,0,1,3,11,5,1,Nikola Vucevic,CHI,CHI,CHA,,,21,18,14,10
22023,202696,22300396,"DEC 23, 2023",CHI vs. CLE,L,34,7,11,0.636,2,5,0.4,4,4,1.0,1,11,12,4,1,1,1,1,20,-12,1,Nikola Vucevic,CHI,CHI,CLE,,,36,32,24,16
22023,202696,22300376,"DEC 21, 2023",CHI vs. SAS,W,27,8,19,0.421,0,7,0.0,0,0,0.0,1,4,5,3,1,0,2,2,16,3,1,Nikola Vucevic,CHI,CHI,SAS,,,24,21,19,8
22023,202696,22300370,"DEC 20, 2023",CHI vs. LAL,W,31,4,13,0.308,3,5,0.6,2,2,1.0,1,9,10,2,1,1,1,2,13,6,1,Nikola Vucevic,CHI,CHI,LAL,,,25,23,15,12
22023,202696,22300351,"DEC 18, 2023",CHI @ PHI,W,34,10,18,0.556,3,7,0.429,0,0,0.0,3,5,8,4,0,2,2,4,23,-4,1,Nikola Vucevic,CHI,PHI,CHI,,,35,31,27,12
22023,202696,22300337,"DEC 16, 2023",CHI @ MIA,L,32,3,13,0.231,1,4,0.25,5,6,0.833,4,7,11,3,1,0,2,1,12,-5,1,Nikola Vucevic,CHI,MIA,CHI,,,26,23,15,14
22023,202696,22300320,"DEC 14, 2023",CHI @ MIA,W,36,10,21,0.476,2,5,0.4,2,2,1.0,2,10,12,7,2,0,0,2,24,12,1,Nikola Vucevic,CHI,MIA,CHI,,,43,36,31,19
22023,202696,22300307,"DEC 12, 2023",CHI vs. DEN,L,33,12,21,0.571,1,4,0.25,1,1,1.0,4,12,16,5,0,2,3,1,26,-5,1,Nikola Vucevic,CHI,CHI,DEN,,,47,42,31,21
22023,202696,22300300,"DEC 11, 2023",CHI @ MIL,L,39,6,16,0.375,2,5,0.4,0,0,0.0,1,9,10,5,1,1,1,5,14,-2,1,Nikola Vucevic,CHI,MIL,CHI,,,29,24,19,15
22023,202696,22301223,"DEC 08, 2023",CHI @ SAS,W,36,9,22,0.409,0,2,0.0,3,3,1.0,10,6,16,2,0,1,0,2,21,15,1,Nikola Vucevic,CHI,SAS,CHI,,,39,37,23,18
22023,202696,22301211,"DEC 06, 2023",CHI vs. CHA,W,34,8,17,0.471,2,3,0.667,2,2,1.0,6,6,12,3,0,1,2,0,20,2,1,Nikola Vucevic,CHI,CHI,CHA,,,35,32,23,15
22023,202696,22300285,"DEC 02, 2023",CHI vs. NOP,W,33,3,12,0.25,0,5,0.0,0,0,0.0,3,4,7,4,0,3,1,1,6,8,1,Nikola Vucevic,CHI,CHI,NOP,,,17,13,10,11
22023,202696,22300269,"NOV 30, 2023",CHI vs. MIL,W,40,11,21,0.524,2,4,0.5,5,6,0.833,1,9,10,6,1,0,4,2,29,-6,1,Nikola Vucevic,CHI,CHI,MIL,,,45,39,35,16
22023,202696,22300053,"NOV 28, 2023",CHI @ BOS,L,25,4,11,0.364,0,2,0.0,0,0,0.0,0,8,8,2,2,1,1,1,8,-26,1,Nikola Vucevic,CHI,BOS,CHI,,,18,16,10,10
22023,202696,22300250,"NOV 26, 2023",CHI @ BKN,L,37,3,9,0.333,0,3,0.0,0,0,0.0,1,8,9,5,1,1,2,5,6,2,1,Nikola Vucevic,CHI,BKN,CHI,,,20,15,11,14
22023,202696,22300046,"NOV 24, 2023",CHI @ TOR,L,36,4,8,0.5,1,2,0.5,0,0,0.0,0,8,8,5,1,0,1,3,9,-4,1,Nikola Vucevic,CHI,TOR,CHI,,,22,17,14,13
22023,202696,22300234,"NOV 22, 2023",CHI @ OKC,L,37,6,13,0.462,2,5,0.4,2,2,1.0,5,7,12,3,2,0,1,4,16,-3,1,Nikola Vucevic,CHI,OKC,CHI,,,31,28,19,15
22023,202696,22300220,"NOV 20, 2023",CHI vs. MIA,L,32,7,16,0.438,0,4,0.0,4,4,1.0,2,6,8,2,0,0,2,4,18,-22,1,Nikola Vucevic,CHI,CHI,MIA,,,28,26,20,10
22023,202696,22300204,"NOV 18, 2023",CHI vs. MIA,W,33,7,14,0.5,1,5,0.2,0,0,0.0,1,7,8,0,1,1,2,2,15,-5,1,Nikola Vucevic,CHI,CHI,MIA,,,23,23,15,8
22023,202696,22300033,"NOV 17, 2023",CHI vs. ORL,L,30,4,16,0.25,0,3,0.0,2,2,1.0,3,7,10,6,0,0,1,4,10,-4,1,Nikola Vucevic,CHI,CHI,ORL,,,26,20,16,16
22023,202696,22300196,"NOV 15, 2023",CHI vs. ORL,L,36,8,18,0.444,0,4,0.0,1,1,1.0,3,6,9,3,0,1,5,4,17,4,1,Nikola Vucevic,CHI,CHI,ORL,,,29,26,20,12
22023,202696,22300190,"NOV 13, 2023",CHI @ MIL,L,36,11,24,0.458,2,7,0.286,2,3,0.667,6,6,12,5,1,1,1,5,26,-1,1,Nikola Vucevic,CHI,MIL,CHI,,,43,38,31,17
22023,202696,22300181,"NOV 12, 2023",CHI vs. DET,W,33,8,17,0.471,3,7,0.429,2,2,1.0,2,10,12,4,2,1,1,2,21,6,1,Nikola Vucevic,CHI,CHI,DET,,,37,33,25,16
22023,202696,22300162,"NOV 08, 2023",CHI vs. PHX,L,41,11,19,0.579,2,5,0.4,2,3,0.667,2,4,6,3,1,1,2,5,26,-16,1,Nikola Vucevic,CHI,CHI,PHX,,,35,32,29,9
22023,202696,22300152,"NOV 06, 2023",CHI vs. UTA,W,31,5,11,0.455,0,2,0.0,0,0,0.0,1,7,8,4,1,1,0,1,10,18,1,Nikola Vucevic,CHI,CHI,UTA,,,22,18,14,12
22023,202696,22300139,"NOV 04, 2023",CHI @ DEN,L,30,8,17,0.471,1,2,0.5,2,2,1.0,2,5,7,3,0,0,2,3,19,-27,1,Nikola Vucevic,CHI,DEN,CHI,,,29,26,22,10
22023,202696,22300004,"NOV 03, 2023",CHI vs. BKN,L,36,6,13,0.462,1,1,1.0,0,0,0.0,6,7,13,3,0,0,0,1,13,8,1,Nikola Vucevic,CHI,CHI,BKN,,,29,26,16,16
22023,202696,22300124,"NOV 01, 2023",CHI @ DAL,L,36,10,17,0.588,1,3,0.333,0,0,0.0,5,15,20,1,2,0,3,2,21,-6,1,Nikola Vucevic,CHI,DAL,CHI,,,42,41,22,21
22023,202696,22300102,"OCT 30, 2023",CHI @ IND,W,34,10,19,0.526,0,1,0.0,4,6,0.667,5,12,17,3,1,0,1,3,24,0,1,Nikola Vucevic,CHI,IND,CHI,,,44,41,27,20
22023,202696,22300088,"OCT 28, 2023",CHI @ DET,L,32,5,11,0.455,1,2,0.5,1,1,1.0,0,4,4,1,0,0,1,5,12,-11,1,Nikola Vucevic,CHI,DET,CHI,,,17,16,13,5
22023,202696,22300082,"OCT 27, 2023",CHI vs. TOR,W,40,4,15,0.267,1,5,0.2,2,3,0.667,3,9,12,1,0,1,3,2,11,0,1,Nikola Vucevic,CHI,CHI,TOR,,,24,23,12,13
22023,202696,22300070,"OCT 25, 2023",CHI vs. OKC,L,32,5,8,0.625,0,2,0.0,1,1,1.0,1,8,9,4,3,2,4,2,11,-19,1,Nikola Vucevic,CHI,CHI,OKC,,,24,20,15,13
22023,1629731,22300561,"JAN 15, 2024",CLE vs. CHI,W,26,4,10,0.4,4,10,0.4,0,0,0.0,1,6,7,3,3,0,0,2,12,15,1,Dean Wade,CLE,CLE,CHI,,,22,19,15,10
22023,1629731,22300527,"JAN 11, 2024",CLE vs. BKN,W,27,0,1,0.0,0,1,0.0,4,4,1.0,0,1,1,2,2,0,0,5,4,8,1,Dean Wade,CLE,CLE,BKN,,,7,5,6,3
22023,1629731,22300497,"JAN 07, 2024",CLE vs. SAS,W,11,0,3,0.0,0,2,0.0,0,0,0.0,0,2,2,1,0,0,1,2,0,-21,1,Dean Wade,CLE,CLE,SAS,,,3,2,1,3
22023,1629731,22300482,"JAN 05, 2024",CLE vs. WAS,W,22,2,4,0.5,2,3,0.667,0,0,0.0,0,5,5,1,1,0,0,0,6,20,1,Dean Wade,CLE,CLE,WAS,,,12,11,7,6
22023,1629731,22300465,"JAN 03, 2024",CLE vs. WAS,W,20,1,3,0.333,0,1,0.0,0,0,0.0,0,3,3,1,0,0,0,1,2,15,1,Dean Wade,CLE,CLE,WAS,,,6,5,3,4
22023,1629731,22300452,"JAN 01, 2024",CLE @ TOR,L,21,1,2,0.5,0,1,0.0,0,0,0.0,0,3,3,0,1,0,0,2,2,5,1,Dean Wade,CLE,TOR,CLE,,,5,5,2,3
22023,1629731,22300433,"DEC 29, 2023",CLE vs. MIL,L,17,0,3,0.0,0,2,0.0,0,0,0.0,0,5,5,1,1,0,2,1,0,-8,1,Dean Wade,CLE,CLE,MIL,,,6,5,1,6
22023,1629731,22300420,"DEC 27, 2023",CLE @ DAL,W,32,1,5,0.2,1,5,0.2,0,0,0.0,1,7,8,0,0,0,0,2,3,15,1,Dean Wade,CLE,DAL,CLE,,,11,11,3,8
22023,1629731,22300396,"DEC 23, 2023",CLE @ CHI,W,36,4,12,0.333,3,10,0.3,0,0,0.0,1,6,7,1,2,0,1,1,11,12,1,Dean Wade,CLE,CHI,CLE,,,19,18,12,8
22023,1629731,22300375,"DEC 21, 2023",CLE vs. NOP,L,26,7,11,0.636,6,8,0.75,0,0,0.0,0,9,9,0,0,2,0,3,20,-4,1,Dean Wade,CLE,CLE,NOP,,,29,29,20,9
22023,1629731,22300364,"DEC 20, 2023",CLE vs. UTA,W,30,1,3,0.333,1,3,0.333,0,0,0.0,2,5,7,2,0,0,0,4,3,-3,1,Dean Wade,CLE,CLE,UTA,,,12,10,5,9
22023,1629731,22300349,"DEC 18, 2023",CLE vs. HOU,W,22,4,5,0.8,2,3,0.667,2,2,1.0,2,1,3,1,1,2,2,3,12,-1,1,Dean Wade,CLE,CLE,HOU,,,16,15,13,4
22023,1629731,22300336,"DEC 16, 2023",CLE vs. ATL,W,22,5,8,0.625,4,7,0.571,2,2,1.0,1,4,5,3,1,0,0,5,16,6,1,Dean Wade,CLE,CLE,ATL,,,24,21,19,8
22023,1629731,22300319,"DEC 14, 2023",CLE @ BOS,L,16,1,5,0.2,1,5,0.2,2,2,1.0,1,3,4,0,0,0,0,0,5,-11,1,Dean Wade,CLE,BOS,CLE,,,9,9,5,4
22023,1629731,22300305,"DEC 12, 2023",CLE @ BOS,L,20,2,6,0.333,2,6,0.333,2,2,1.0,1,2,3,3,0,1,0,3,8,2,1,Dean Wade,CLE,BOS,CLE,,,14,11,11,6
22023,1629731,22300294,"DEC 11, 2023",CLE @ ORL,L,29,3,5,0.6,2,3,0.667,1,2,0.5,4,2,6,0,3,0,2,2,9,-14,1,Dean Wade,CLE,ORL,CLE,,,15,15,9,6
22023,1629731,22301220,"DEC 08, 2023",CLE @ MIA,W,25,2,5,0.4,1,4,0.25,0,0,0.0,3,3,6,0,3,0,1,1,5,23,1,Dean Wade,CLE,MIA,CLE,,,11,11,5,6
22023,1629731,22301205,"DEC 06, 2023",CLE vs. ORL,W,14,3,6,0.5,2,5,0.4,0,0,0.0,1,4,5,0,0,0,0,2,8,-4,1,Dean Wade,CLE,CLE,ORL,,,13,13,8,5
22023,1629731,22300040,"NOV 21, 2023",CLE @ PHI,W,31,0,4,0.0,0,4,0.0,0,0,0.0,4,4,8,2,3,0,1,5,0,-12,1,Dean Wade,CLE,PHI,CLE,,,10,8,2,10
22023,1629731,22300210,"NOV 19, 2023",CLE vs. DEN,W,24,2,4,0.5,2,4,0.5,0,0,0.0,1,9,10,2,2,0,0,1,6,25,1,Dean Wade,CLE,CLE,DEN,,,18,16,8,12
22023,1629731,22300030,"NOV 17, 2023",CLE vs. DET,W,22,1,1,1.0,1,1,1.0,0,0,0.0,0,1,1,0,0,0,0,1,3,0,1,Dean Wade,CLE,CLE,DET,,,4,4,3,1
22023,1629731,22300199,"NOV 15, 2023",CLE @ POR,W,33,0,3,0.0,0,3,0.0,0,0,0.0,1,2,3,2,0,1,0,1,0,6,1,Dean Wade,CLE,POR,CLE,,,5,3,2,5
22023,1629731,22300191,"NOV 13, 2023",CLE @ SAC,L,13,0,1,0.0,0,1,0.0,0,0,0.0,0,0,0,1,0,0,0,1,0,-18,1,Dean Wade,CLE,SAC,CLE,,,1,0,1,1
22023,1629731,22300176,"NOV 11, 2023",CLE @ GSW,W,17,2,4,0.5,2,4,0.5,2,2,1.0,0,7,7,0,0,0,0,6,8,20,1,Dean Wade,CLE,GSW,CLE,,,15,15,8,7
22023,1629731,22300167,"NOV 08, 2023",CLE @ OKC,L,11,0,1,0.0,0,1,0.0,0,2,0.0,2,4,6,0,1,1,2,4,0,-8,1,Dean Wade,CLE,OKC,CLE,,,6,6,0,6
22023,1629731,22300142,"NOV 05, 2023",CLE vs. GSW,W,13,1,3,0.333,1,3,0.333,0,0,0.0,1,3,4,0,3,0,0,1,3,8,1,Dean Wade,CLE,CLE,GSW,,,7,7,3,4
22023,1629731,22300001,"NOV 03, 2023",CLE @ IND,L,3,0,0,0.0,0,0,0.0,0,0,0.0,0,0,0,0,0,0,0,1,0,-9,1,Dean Wade,CLE,IND,CLE,,,0,0,0,0
22023,1629731,22300120,"NOV 01, 2023",CLE @ NYK,W,20,2,3,0.667,2,3,0.667,0,0,0.0,1,2,3,0,0,0,0,0,6,-1,1,Dean Wade,CLE,NYK,CLE,,,9,9,6,3
22023,1629731,22300112,"OCT 31, 2023",CLE vs. NYK,L,16,0,5,0.0,0,4,0.0,0,0,0.0,2,1,3,1,0,0,1,3,0,-5,1,Dean Wade,CLE,CLE,NYK,,,4,3,1,4
22023,1629731,22300091,"OCT 28, 2023",CLE vs. IND,L,37,2,5,0.4,2,5,0.4,0,0,0.0,0,3,3,3,0,1,0,2,6,3,1,Dean Wade,CLE,CLE,IND,,,12,9,9,6
22023,1629731,22300081,"OCT 27, 2023",CLE vs. OKC,L,27,3,6,0.5,2,5,0.4,0,0,0.0,0,5,5,0,2,0,1,3,8,-9,1,Dean Wade,CLE,CLE,OKC,,,13,13,8,5
22023,1630532,22300476,"JAN 03, 2024",ORL @ SAC,L,5,2,4,0.5,1,1,1.0,1,1,1.0,0,2,2,1,0,0,0,0,6,-1,1,Franz Wagner,ORL,SAC,ORL,,,9,8,7,3
22023,1630532,22300463,"JAN 02, 2024",ORL @ GSW,L,37,10,19,0.526,1,5,0.2,4,4,1.0,2,4,6,3,2,0,4,4,25,-1,1,Franz Wagner,ORL,GSW,ORL,,,34,31,28,9
22023,1630532,22300450,"DEC 31, 2023",ORL @ PHX,L,39,11,25,0.44,2,8,0.25,3,3,1.0,1,6,7,6,0,1,2,4,27,-8,1,Franz Wagner,ORL,PHX,ORL,,,40,34,33,13
22023,1630532,22300429,"DEC 29, 2023",ORL vs. NYK,W,39,11,19,0.579,3,5,0.6,7,7,1.0,2,7,9,2,4,1,4,1,32,15,1,Franz Wagner,ORL,ORL,NYK,,,43,41,34,11
22023,1630532,22300415,"DEC 27, 2023",ORL vs. PHI,L,36,8,16,0.5,1,5,0.2,7,8,0.875,0,5,5,3,1,0,4,4,24,-22,1,Franz Wagner,ORL,ORL,PHI,,,32,29,27,8
22023,1630532,22300407,"DEC 26, 2023",ORL @ WAS,W,38,10,17,0.588,2,4,0.5,6,8,0.75,0,8,8,9,1,1,2,3,28,26,1,Franz Wagner,ORL,WAS,ORL,,,45,36,37,17
22023,1630532,22300391,"DEC 23, 2023",ORL @ IND,W,36,8,14,0.571,0,2,0.0,8,8,1.0,1,5,6,0,1,0,1,4,24,0,1,Franz Wagner,ORL,IND,ORL,,,30,30,24,6
22023,1630532,22300378,"DEC 21, 2023",ORL @ MIL,L,39,13,23,0.565,1,6,0.167,2,4,0.5,1,5,6,6,1,0,2,4,29,-7,1,Franz Wagner,ORL,MIL,ORL,,,41,35,35,12
22023,1630532,22300366,"DEC 20, 2023",ORL vs. MIA,L,32,5,14,0.357,0,4,0.0,5,6,0.833,0,6,6,5,2,1,0,1,15,-13,1,Franz Wagner,ORL,ORL,MIA,,,26,21,20,11
22023,1630532,22300344,"DEC 17, 2023",ORL @ BOS,L,37,3,14,0.214,0,4,0.0,2,2,1.0,2,6,8,6,0,0,0,2,8,-12,1,Franz Wagner,ORL,BOS,ORL,,,22,16,14,14
22023,1630532,22300329,"DEC 15, 2023",ORL @ BOS,L,34,6,14,0.429,1,4,0.25,4,4,1.0,0,5,5,5,3,0,6,4,17,-9,1,Franz Wagner,ORL,BOS,ORL,,,27,22,22,10
22023,1630532,22300294,"DEC 11, 2023",ORL vs. CLE,W,33,7,18,0.389,0,5,0.0,5,7,0.714,1,7,8,4,0,0,1,4,19,11,1,Franz Wagner,ORL,ORL,CLE,,,31,27,23,12
22023,1630532,22301217,"DEC 08, 2023",ORL vs. DET,W,31,12,20,0.6,2,4,0.5,1,1,1.0,0,2,2,3,0,0,0,0,27,19,1,Franz Wagner,ORL,ORL,DET,,,32,29,30,5
22023,1630532,22301205,"DEC 06, 2023",ORL @ CLE,L,41,3,16,0.188,0,5,0.0,8,10,0.8,2,4,6,9,3,0,2,1,14,-2,1,Franz Wagner,ORL,CLE,ORL,,,29,20,23,15
22023,1630532,22300282,"DEC 02, 2023",ORL @ BKN,L,34,6,16,0.375,2,3,0.667,6,6,1.0,1,6,7,5,0,1,1,5,20,-17,1,Franz Wagner,ORL,BKN,ORL,,,32,27,25,12
22023,1630532,22300274,"DEC 01, 2023",ORL vs. WAS,W,34,9,17,0.529,1,3,0.333,12,14,0.857,1,6,7,8,0,0,0,0,31,0,1,Franz Wagner,ORL,ORL,WAS,,,46,38,39,15
22023,1630532,22300259,"NOV 29, 2023",ORL vs. WAS,W,31,11,14,0.786,4,6,0.667,5,6,0.833,3,3,6,3,0,1,2,1,31,9,1,Franz Wagner,ORL,ORL,WAS,,,40,37,34,9
22023,1630532,22300248,"NOV 26, 2023",ORL vs. CHA,W,35,11,15,0.733,2,3,0.667,6,9,0.667,1,6,7,2,2,0,3,3,30,10,1,Franz Wagner,ORL,ORL,CHA,,,39,37,32,9
22023,1630532,22300043,"NOV 24, 2023",ORL vs. BOS,W,35,8,17,0.471,1,6,0.167,0,0,0.0,0,8,8,6,0,1,3,2,17,10,1,Franz Wagner,ORL,ORL,BOS,,,31,25,23,14
22023,1630532,22300226,"NOV 22, 2023",ORL vs. DEN,W,31,11,18,0.611,1,4,0.25,4,4,1.0,1,2,3,4,1,2,1,1,27,-4,1,Franz Wagner,ORL,ORL,DEN,,,34,30,31,7
22023,1630532,22300038,"NOV 21, 2023",ORL vs. TOR,W,31,8,18,0.444,1,4,0.25,0,1,0.0,2,2,4,2,3,0,0,2,17,17,1,Franz Wagner,ORL,ORL,TOR,,,23,21,19,6
22023,1630532,22300209,"NOV 19, 2023",ORL @ IND,W,22,6,14,0.429,0,2,0.0,7,7,1.0,1,6,7,1,2,0,0,2,19,26,1,Franz Wagner,ORL,IND,ORL,,,27,26,20,8
22023,1630532,22300033,"NOV 17, 2023",ORL @ CHI,W,35,9,18,0.5,2,8,0.25,1,2,0.5,0,4,4,2,2,0,2,2,21,-6,1,Franz Wagner,ORL,CHI,ORL,,,27,25,23,6
22023,1630532,22300196,"NOV 15, 2023",ORL @ CHI,W,31,5,16,0.313,0,4,0.0,3,3,1.0,0,2,2,3,0,0,1,0,13,1,1,Franz Wagner,ORL,CHI,ORL,,,18,15,16,5
22023,1630532,22300020,"NOV 14, 2023",ORL @ BKN,L,36,8,16,0.5,3,8,0.375,2,3,0.667,3,5,8,5,0,0,0,2,21,-8,1,Franz Wagner,ORL,BKN,ORL,,,34,29,26,13
22023,1630532,22300173,"NOV 11, 2023",ORL vs. MIL,W,38,8,16,0.5,2,6,0.333,6,7,0.857,0,6,6,3,1,0,3,2,24,3,1,Franz Wagner,ORL,ORL,MIL,,,33,30,27,9
22023,1630532,22300172,"NOV 09, 2023",ORL vs. ATL,L,29,5,12,0.417,0,1,0.0,2,2,1.0,2,5,7,3,0,0,4,2,12,-16,1,Franz Wagner,ORL,ORL,ATL,,,22,19,15,10
22023,1630532,22300147,"NOV 06, 2023",ORL vs. DAL,L,33,5,13,0.385,1,4,0.25,1,2,0.5,0,5,5,4,1,0,1,3,12,-13,1,Franz Wagner,ORL,ORL,DAL,,,21,17,16,9
22023,1630532,22300134,"NOV 04, 2023",ORL vs. LAL,W,33,12,28,0.429,1,3,0.333,1,2,0.5,2,3,5,2,1,1,1,1,26,-8,1,Franz Wagner,ORL,ORL,LAL,,,33,31,28,7
22023,1630532,22300130,"NOV 02, 2023",ORL @ UTA,W,38,9,22,0.409,2,6,0.333,1,2,0.5,1,3,4,5,4,0,2,4,21,8,1,Franz Wagner,ORL,UTA,ORL,,,30,25,26,9
22023,1630532,22300114,"OCT 31, 2023",ORL @ LAC,L,32,6,13,0.462,2,7,0.286,0,0,0.0,1,7,8,3,0,1,3,4,14,5,1,Franz Wagner,ORL,LAC,ORL,,,25,22,17,11
22023,1630532,22300111,"OCT 30, 2023",ORL @ LAL,L,37,5,17,0.294,2,7,0.286,4,4,1.0,2,6,8,4,2,0,2,4,16,-2,1,Franz Wagner,ORL,LAL,ORL,,,28,24,20,12
22023,1630532,22300086,"OCT 27, 2023",ORL @ POR,W,35,6,16,0.375,3,9,0.333,8,9,0.889,0,5,5,3,1,1,3,2,23,11,1,Franz Wagner,ORL,POR,ORL,,,31,28,26,8
22023,1630532,22300066,"OCT 25, 2023",ORL vs. HOU,W,27,5,12,0.417,3,7,0.429,6,6,1.0,3,1,4,2,1,0,3,1,19,10,1,Franz Wagner,ORL,ORL,HOU,,,25,23,21,6
22023,1629021,22300546,"JAN 13, 2024",ORL @ OKC,L,18,2,6,0.333,0,3,0.0,0,0,0.0,0,4,4,2,0,1,3,1,4,-9,1,Moritz Wagner,ORL,OKC,ORL,,,10,8,6,6
22023,1629021,22300535,"JAN 12, 2024",ORL @ MIA,L,29,7,9,0.778,0,1,0.0,5,5,1.0,1,4,5,4,1,1,1,5,19,7,1,Moritz Wagner,ORL,MIA,ORL,,,28,24,23,9
22023,1629021,22300513,"JAN 09, 2024",ORL vs. MIN,L,31,6,9,0.667,1,4,0.25,8,11,0.727,3,5,8,2,2,0,1,3,21,-13,1,Moritz Wagner,ORL,ORL,MIN,,,31,29,23,10
22023,1629021,22300499,"JAN 07, 2024",ORL vs. ATL,W,25,6,12,0.5,1,4,0.25,2,2,1.0,2,5,7,0,1,0,0,2,15,-7,1,Moritz Wagner,ORL,ORL,ATL,,,22,22,15,7
22023,1629021,22300488,"JAN 05, 2024",ORL @ DEN,W,38,8,14,0.571,2,4,0.5,1,2,0.5,3,8,11,3,2,0,0,4,19,1,1,Moritz Wagner,ORL,DEN,ORL,,,33,30,22,14
22023,1629021,22300476,"JAN 03, 2024",ORL @ SAC,L,13,0,2,0.0,0,1,0.0,2,2,1.0,1,2,3,2,0,0,3,2,2,0,1,Moritz Wagner,ORL,SAC,ORL,,,7,5,4,5
22023,1629021,22300463,"JAN 02, 2024",ORL @ GSW,L,16,5,8,0.625,1,2,0.5,1,1,1.0,3,2,5,1,1,0,1,2,12,7,1,Moritz Wagner,ORL,GSW,ORL,,,18,17,13,6
22023,1629021,22300450,"DEC 31, 2023",ORL @ PHX,L,10,2,3,0.667,1,2,0.5,0,0,0.0,1,3,4,1,1,0,0,0,5,-2,1,Moritz Wagner,ORL,PHX,ORL,,,10,9,6,5
22023,1629021,22300429,"DEC 29, 2023",ORL vs. NYK,W,18,2,8,0.25,0,3,0.0,3,3,1.0,4,7,11,1,0,1,1,1,7,-7,1,Moritz Wagner,ORL,ORL,NYK,,,19,18,8,12
22023,1629021,22300415,"DEC 27, 2023",ORL vs. PHI,L,16,0,3,0.0,0,1,0.0,2,2,1.0,0,2,2,1,0,0,1,2,2,-2,1,Moritz Wagner,ORL,ORL,PHI,,,5,4,3,3
22023,1629021,22300407,"DEC 26, 2023",ORL @ WAS,W,15,5,9,0.556,0,0,0.0,1,2,0.5,0,5,5,1,0,0,0,1,11,-3,1,Moritz Wagner,ORL,WAS,ORL,,,17,16,12,6
22023,1629021,22300391,"DEC 23, 2023",ORL @ IND,W,20,3,3,1.0,0,0,0.0,3,4,0.75,2,1,3,3,0,0,0,1,9,12,1,Moritz Wagner,ORL,IND,ORL,,,15,12,12,6
22023,1629021,22300378,"DEC 21, 2023",ORL @ MIL,L,27,10,15,0.667,1,4,0.25,0,0,0.0,3,5,8,2,1,1,1,1,21,23,1,Moritz Wagner,ORL,MIL,ORL,,,31,29,23,10
22023,1629021,22300366,"DEC 20, 2023",ORL vs. MIA,L,18,5,8,0.625,0,0,0.0,1,1,1.0,5,2,7,1,0,0,2,5,11,2,1,Moritz Wagner,ORL,ORL,MIA,,,19,18,12,8
22023,1629021,22300344,"DEC 17, 2023",ORL @ BOS,L,12,1,3,0.333,1,2,0.5,3,4,0.75,0,2,2,0,0,0,0,3,6,-15,1,Moritz Wagner,ORL,BOS,ORL,,,8,8,6,2
22023,1629021,22300329,"DEC 15, 2023",ORL @ BOS,L,13,1,3,0.333,0,1,0.0,0,0,0.0,1,0,1,2,0,0,3,3,2,-9,1,Moritz Wagner,ORL,BOS,ORL,,,5,3,4,3
22023,1629021,22300294,"DEC 11, 2023",ORL vs. CLE,W,18,4,9,0.444,0,2,0.0,0,1,0.0,0,2,2,0,1,0,0,3,8,-2,1,Moritz Wagner,ORL,ORL,CLE,,,10,10,8,2
22023,1629021,22301217,"DEC 08, 2023",ORL vs. DET,W,16,2,4,0.5,0,0,0.0,0,0,0.0,1,4,5,2,0,0,2,1,4,5,1,Moritz Wagner,ORL,ORL,DET,,,11,9,6,7
22023,1629021,22301205,"DEC 06, 2023",ORL @ CLE,L,21,5,7,0.714,0,1,0.0,1,4,0.25,1,3,4,0,2,0,3,2,11,-11,1,Moritz Wagner,ORL,CLE,ORL,,,15,15,11,4
22023,1629021,22300282,"DEC 02, 2023",ORL @ BKN,L,22,6,9,0.667,2,2,1.0,4,5,0.8,1,1,2,2,0,1,2,2,18,-12,1,Moritz Wagner,ORL,BKN,ORL,,,22,20,20,4
22023,1629021,22300274,"DEC 01, 2023",ORL vs. WAS,W,23,8,13,0.615,0,2,0.0,2,3,0.667,4,2,6,0,1,1,3,1,18,9,1,Moritz Wagner,ORL,ORL,WAS,,,24,24,18,6
22023,1629021,22300259,"NOV 29, 2023",ORL vs. WAS,W,19,5,7,0.714,0,1,0.0,1,1,1.0,0,4,4,1,0,1,2,1,11,18,1,Moritz Wagner,ORL,ORL,WAS,,,16,15,12,5
22023,1629021,22300248,"NOV 26, 2023",ORL vs. CHA,W,18,4,7,0.571,1,2,0.5,2,2,1.0,2,5,7,2,0,0,2,3,11,7,1,Moritz Wagner,ORL,ORL,CHA,,,20,18,13,9
22023,1629021,22300043,"NOV 24, 2023",ORL vs. BOS,W,24,9,13,0.692,1,3,0.333,8,9,0.889,2,1,3,0,0,0,1,5,27,16,1,Moritz Wagner,ORL,ORL,BOS,,,30,30,27,3
22023,1629021,22300226,"NOV 22, 2023",ORL vs. DEN,W,15,4,7,0.571,1,3,0.333,3,4,0.75,1,2,3,1,1,0,1,1,12,6,1,Moritz Wagner,ORL,ORL,DEN,,,16,15,13,4
22023,1629021,22300038,"NOV 21, 2023",ORL vs. TOR,W,15,5,9,0.556,0,0,0.0,0,0,0.0,2,2,4,2,1,0,1,0,10,8,1,Moritz Wagner,ORL,ORL,TOR,,,16,14,12,6
22023,1629021,22300209,"NOV 19, 2023",ORL @ IND,W,21,6,10,0.6,1,1,1.0,3,4,0.75,3,0,3,2,0,0,1,3,16,3,1,Moritz Wagner,ORL,IND,ORL,,,21,19,18,5
22023,1629021,22300033,"NOV 17, 2023",ORL @ CHI,W,23,4,5,0.8,0,1,0.0,2,2,1.0,0,4,4,3,0,1,0,3,10,0,1,Moritz Wagner,ORL,CHI,ORL,,,17,14,13,7
22023,1629021,22300196,"NOV 15, 2023",ORL @ CHI,W,20,2,6,0.333,0,1,0.0,1,1,1.0,1,3,4,1,1,0,1,3,5,2,1,Moritz Wagner,ORL,CHI,ORL,,,10,9,6,5
22023,1629021,22300020,"NOV 14, 2023",ORL @ BKN,L,21,3,4,0.75,0,0,0.0,5,6,0.833,1,5,6,4,0,0,1,3,11,-7,1,Moritz Wagner,ORL,BKN,ORL,,,21,17,15,10
22023,1629021,22300173,"NOV 11, 2023",ORL vs. MIL,W,21,7,9,0.778,1,1,1.0,4,5,0.8,3,1,4,1,1,0,1,2,19,11,1,Moritz Wagner,ORL,ORL,MIL,,,24,23,20,5
22023,1629021,22300172,"NOV 09, 2023",ORL vs. ATL,L,20,5,9,0.556,2,4,0.5,1,1,1.0,1,6,7,0,0,0,2,2,13,-8,1,Moritz Wagner,ORL,ORL,ATL,,,20,20,13,7
22023,1629021,22300147,"NOV 06, 2023",ORL vs. DAL,L,26,8,13,0.615,1,4,0.25,2,2,1.0,0,5,5,0,1,0,2,3,19,-15,1,Moritz Wagner,ORL,ORL,DAL,,,24,24,19,5
22023,1629021,22300134,"NOV 04, 2023",ORL vs. LAL,W,19,6,10,0.6,1,3,0.333,0,0,0.0,5,3,8,2,1,0,2,5,13,-11,1,Moritz Wagner,ORL,ORL,LAL,,,23,21,15,10
22023,1629021,22300130,"NOV 02, 2023",ORL @ UTA,W,19,4,6,0.667,1,2,0.5,1,1,1.0,0,1,1,1,0,2,0,2,10,0,1,Moritz Wagner,ORL,UTA,ORL,,,12,11,11,2
22023,1629021,22300114,"OCT 31, 2023",ORL @ LAC,L,14,4,7,0.571,0,2,0.0,5,6,0.833,0,1,1,1,1,1,1,2,13,1,1,Moritz Wagner,ORL,LAC,ORL,,,15,14,14,2
22023,1629021,22300111,"OCT 30, 2023",ORL @ LAL,L,11,2,5,0.4,0,1,0.0,1,2,0.5,1,0,1,0,0,0,1,2,5,-10,1,Moritz Wagner,ORL,LAL,ORL,,,6,6,5,1
22023,1629021,22300086,"OCT 27, 2023",ORL @ POR,W,22,8,8,1.0,1,1,1.0,0,1,0.0,4,5,9,1,1,1,1,2,17,-1,1,Moritz Wagner,ORL,POR,ORL,,,27,26,18,10
22023,1629021,22300066,"OCT 25, 2023",ORL vs. HOU,W,15,0,1,0.0,0,1,0.0,2,2,1.0,0,4,4,0,0,1,3,4,2,13,1,Moritz Wagner,ORL,ORL,HOU,,,6,6,2,4
22023,1630688,22300472,"JAN 03, 2024",POR @ DAL,L,17,3,5,0.6,3,5,0.6,0,0,0.0,0,5,5,0,1,0,0,0,9,2,1,Ish Wainright,POR,DAL,POR,,,14,14,9,5
22023,1630688,22300456,"JAN 01, 2024",POR @ PHX,L,12,2,5,0.4,2,4,0.5,2,2,1.0,0,1,1,0,0,1,1,2,8,3,1,Ish Wainright,POR,PHX,POR,,,9,9,8,1
22023,1630688,22300427,"DEC 28, 2023",POR vs. SAS,L,6,0,5,0.0,0,4,0.0,0,0,0.0,0,1,1,0,0,0,0,0,0,-1,1,Ish Wainright,POR,POR,SAS,,,1,1,0,1
22023,1630688,22300413,"DEC 26, 2023",POR vs. SAC,W,2,0,1,0.0,0,1,0.0,0,0,0.0,0,1,1,0,0,0,0,0,0,-2,1,Ish Wainright,POR,POR,SAC,,,1,1,0,1
22023,1630688,22300399,"DEC 23, 2023",POR @ GSW,L,4,1,1,1.0,1,1,1.0,0,0,0.0,0,1,1,0,0,0,0,1,3,-1,1,Ish Wainright,POR,GSW,POR,,,4,4,3,1
22023,1630688,22300199,"NOV 15, 2023",POR vs. CLE,L,3,0,0,0.0,0,0,0.0,0,0,0.0,0,0,0,0,0,0,0,0,0,0,1,Ish Wainright,POR,POR,CLE,,,0,0,0,0
22023,1630688,22300023,"NOV 14, 2023",POR @ UTA,L,3,0,1,0.0,0,1,0.0,0,0,0.0,0,0,0,0,1,0,0,1,0,-1,1,Ish Wainright,POR,UTA,POR,,,0,0,0,0
22023,1631133,22300554,"JAN 14, 2024",POR vs. PHX,L,29,4,6,0.667,2,3,0.667,1,2,0.5,2,6,8,1,0,0,1,2,11,-15,1,Jabari Walker,POR,POR,PHX,,,20,19,12,9
22023,1631133,22300538,"JAN 12, 2024",POR @ MIN,L,32,6,11,0.545,1,2,0.5,4,4,1.0,2,11,13,3,1,0,4,4,17,1,1,Jabari Walker,POR,MIN,POR,,,33,30,20,16
22023,1631133,22300472,"JAN 03, 2024",POR @ DAL,L,17,1,3,0.333,0,1,0.0,2,2,1.0,1,4,5,4,0,0,1,2,4,-13,1,Jabari Walker,POR,DAL,POR,,,13,9,8,9
22023,1631133,22300456,"JAN 01, 2024",POR @ PHX,L,25,3,7,0.429,0,2,0.0,4,6,0.667,2,7,9,0,1,0,1,2,10,-16,1,Jabari Walker,POR,PHX,POR,,,19,19,10,9
22023,1631133,22300437,"DEC 29, 2023",POR vs. SAS,W,30,7,11,0.636,1,2,0.5,10,13,0.769,6,3,9,1,1,1,1,4,25,12,1,Jabari Walker,POR,POR,SAS,,,35,34,26,10
22023,1631133,22300427,"DEC 28, 2023",POR vs. SAS,L,30,2,4,0.5,0,0,0.0,2,2,1.0,2,7,9,0,1,1,1,4,6,-18,1,Jabari Walker,POR,POR,SAS,,,15,15,6,9
22023,1631133,22300413,"DEC 26, 2023",POR vs. SAC,W,22,6,8,0.75,1,2,0.5,4,5,0.8,2,4,6,1,0,0,0,1,17,13,1,Jabari Walker,POR,POR,SAC,,,24,23,18,7
22023,1631133,22300399,"DEC 23, 2023",POR @ GSW,L,18,2,4,0.5,0,2,0.0,1,2,0.5,2,3,5,0,0,1,1,2,5,-25,1,Jabari Walker,POR,GSW,POR,,,10,10,5,5
22023,1631133,22300381,"DEC 21, 2023",POR vs. WAS,L,24,3,6,0.5,1,2,0.5,1,2,0.5,4,7,11,3,1,1,2,3,8,18,1,Jabari Walker,POR,POR,WAS,,,22,19,11,14
22023,1631133,22300363,"DEC 19, 2023",POR vs. PHX,W,10,3,3,1.0,1,1,1.0,2,2,1.0,1,1,2,0,0,0,0,2,9,13,1,Jabari Walker,POR,POR,PHX,,,11,11,9,2
22023,1631133,22300348,"DEC 17, 2023",POR vs. GSW,L,15,1,3,0.333,0,0,0.0,2,2,1.0,2,3,5,0,1,1,1,4,4,0,1,Jabari Walker,POR,POR,GSW,,,9,9,4,5
22023,1631133,22300341,"DEC 16, 2023",POR vs. DAL,L,5,0,1,0.0,0,1,0.0,0,0,0.0,0,2,2,0,0,0,0,0,0,-2,1,Jabari Walker,POR,POR,DAL,,,2,2,0,2
22023,1631133,22300323,"DEC 14, 2023",POR vs. UTA,L,28,5,10,0.5,0,2,0.0,3,5,0.6,4,5,9,1,1,0,0,0,13,13,1,Jabari Walker,POR,POR,UTA,,,23,22,14,10
22023,1631133,22300304,"DEC 11, 2023",POR @ LAC,L,22,3,4,0.75,1,2,0.5,2,2,1.0,3,5,8,1,1,0,1,1,9,1,1,Jabari Walker,POR,LAC,POR,,,18,17,10,9
22023,1631133,22301226,"DEC 08, 2023",POR vs. DAL,L,27,3,10,0.3,1,3,0.333,3,3,1.0,1,2,3,2,0,0,0,2,10,-15,1,Jabari Walker,POR,POR,DAL,,,15,13,12,5
22023,1631133,22301214,"DEC 06, 2023",POR @ GSW,L,22,5,8,0.625,0,2,0.0,2,2,1.0,2,3,5,1,1,1,2,6,12,-5,1,Jabari Walker,POR,GSW,POR,,,18,17,13,6
22023,1631133,22300289,"DEC 02, 2023",POR @ UTA,L,24,1,5,0.2,0,2,0.0,2,2,1.0,2,4,6,1,1,0,1,0,4,-5,1,Jabari Walker,POR,UTA,POR,,,11,10,5,7
22023,1631133,22300265,"NOV 30, 2023",POR @ CLE,W,24,3,7,0.429,0,2,0.0,0,0,0.0,2,10,12,1,1,0,1,3,6,5,1,Jabari Walker,POR,CLE,POR,,,19,18,7,13
22023,1631133,22300254,"NOV 27, 2023",POR @ IND,W,15,0,3,0.0,0,1,0.0,1,2,0.5,1,2,3,0,0,0,1,2,1,-4,1,Jabari Walker,POR,IND,POR,,,4,4,1,3
22023,1631133,22300245,"NOV 26, 2023",POR @ MIL,L,16,2,3,0.667,0,1,0.0,0,0,0.0,0,3,3,0,0,0,1,4,4,6,1,Jabari Walker,POR,MIL,POR,,,7,7,4,3
22023,1631133,22300237,"NOV 22, 2023",POR vs. UTA,W,28,8,15,0.533,2,3,0.667,1,2,0.5,6,4,10,2,2,0,1,4,19,11,1,Jabari Walker,POR,POR,UTA,,,31,29,21,12
22023,1631133,22300041,"NOV 21, 2023",POR @ PHX,L,14,3,6,0.5,0,2,0.0,2,2,1.0,0,3,3,0,0,0,1,5,8,-4,1,Jabari Walker,POR,PHX,POR,,,11,11,8,3
22023,1631133,22300215,"NOV 19, 2023",POR vs. OKC,L,22,6,15,0.4,1,5,0.2,0,1,0.0,3,4,7,2,1,0,3,2,13,-21,1,Jabari Walker,POR,POR,OKC,,,22,20,15,9
22023,1631133,22300036,"NOV 17, 2023",POR vs. LAL,L,18,2,6,0.333,0,2,0.0,3,5,0.6,2,3,5,1,0,0,0,0,7,2,1,Jabari Walker,POR,POR,LAL,,,13,12,8,6
22023,1631133,22300199,"NOV 15, 2023",POR vs. CLE,L,23,4,7,0.571,3,4,0.75,1,2,0.5,1,2,3,1,0,2,2,2,12,-12,1,Jabari Walker,POR,POR,CLE,,,16,15,13,4
22023,1631133,22300023,"NOV 14, 2023",POR @ UTA,L,21,5,7,0.714,2,3,0.667,0,0,0.0,2,6,8,0,2,1,0,0,12,-8,1,Jabari Walker,POR,UTA,POR,,,20,20,12,8
22023,1631133,22300187,"NOV 12, 2023",POR @ LAL,L,18,4,7,0.571,0,2,0.0,0,0,0.0,0,4,4,1,1,1,0,3,8,7,1,Jabari Walker,POR,LAL,POR,,,13,12,9,5
22023,1631133,22300170,"NOV 08, 2023",POR @ SAC,L,15,1,2,0.5,0,1,0.0,0,0,0.0,0,2,2,1,0,0,1,4,2,-12,1,Jabari Walker,POR,SAC,POR,,,5,4,3,3
22023,1631133,22300144,"NOV 05, 2023",POR vs. MEM,L,16,2,9,0.222,0,5,0.0,1,1,1.0,3,2,5,1,3,1,0,2,5,4,1,Jabari Walker,POR,POR,MEM,,,11,10,6,6
22023,1631133,22300007,"NOV 03, 2023",POR vs. MEM,W,9,0,2,0.0,0,0,0.0,0,0,0.0,1,3,4,0,0,1,0,2,0,-7,1,Jabari Walker,POR,POR,MEM,,,4,4,0,4
22023,1631133,22300115,"NOV 01, 2023",POR @ DET,W,10,0,2,0.0,0,0,0.0,1,2,0.5,0,2,2,0,0,0,1,0,1,-6,1,Jabari Walker,POR,DET,POR,,,3,3,1,2
22023,1631133,22300105,"OCT 30, 2023",POR @ TOR,W,16,2,3,0.667,0,0,0.0,0,0,0.0,0,3,3,0,0,1,1,2,4,1,1,Jabari Walker,POR,TOR,POR,,,7,7,4,3
22023,1631133,22300098,"OCT 29, 2023",POR @ PHI,L,24,4,9,0.444,1,3,0.333,3,3,1.0,3,4,7,1,4,1,2,4,12,5,1,Jabari Walker,POR,PHI,POR,,,20,19,13,8
22023,1631133,22300086,"OCT 27, 2023",POR vs. ORL,L,9,2,3,0.667,1,2,0.5,4,4,1.0,1,3,4,0,0,0,0,3,9,1,1,Jabari Walker,POR,POR,ORL,,,13,13,9,4
22023,1631133,22300074,"OCT 25, 2023",POR @ LAC,L,6,2,3,0.667,0,0,0.0,2,3,0.667,1,0,1,0,0,0,2,0,6,12,1,Jabari Walker,POR,LAC,POR,,,7,7,6,1
22023,1641716,22300564,"JAN 15, 2024",IND @ UTA,L,26,3,11,0.273,2,5,0.4,0,0,0.0,2,2,4,4,4,2,1,2,8,-17,1,Jarace Walker,IND,UTA,IND,,,16,12,12,8
22023,1641716,22300493,"JAN 06, 2024",IND vs. BOS,L,1,0,0,0.0,0,0,0.0,0,0,0.0,0,0,0,1,0,0,0,0,0,0,1,Jarace Walker,IND,IND,BOS,,,1,0,1,1
22023,1641716,22300480,"JAN 05, 2024",IND vs. ATL,W,12,3,6,0.5,2,3,0.667,0,0,0.0,1,0,1,1,0,0,1,1,8,0,1,Jarace Walker,IND,IND,ATL,,,10,9,9,2
22023,1641716,22300466,"JAN 03, 2024",IND vs. MIL,W,2,0,0,0.0,0,0,0.0,3,4,0.75,0,0,0,0,0,0,0,0,3,-5,1,Jarace Walker,IND,IND,MIL,,,3,3,3,0
22023,1641716,22300441,"DEC 30, 2023",IND vs. NYK,W,1,0,0,0.0,0,0,0.0,0,0,0.0,0,0,0,0,0,0,0,0,0,-3,1,Jarace Walker,IND,IND,NYK,,,0,0,0,0
22023,1641716,22300338,"DEC 16, 2023",IND @ MIN,L,24,2,3,0.667,1,2,0.5,0,0,0.0,0,2,2,3,2,0,1,2,5,-4,1,Jarace Walker,IND,MIN,IND,,,10,7,8,5
22023,1641716,22300328,"DEC 15, 2023",IND @ WAS,L,13,2,4,0.5,1,2,0.5,0,0,0.0,0,2,2,0,0,0,0,1,5,8,1,Jarace Walker,IND,WAS,IND,,,7,7,5,2
22023,1641716,22300315,"DEC 13, 2023",IND @ MIL,L,6,1,3,0.333,1,2,0.5,0,0,0.0,0,0,0,2,0,1,1,4,3,2,1,Jarace Walker,IND,MIL,IND,,,5,3,5,2
22023,1641716,22300267,"NOV 30, 2023",IND @ MIA,L,0,0,0,0.0,0,0,0.0,0,0,0.0,0,0,0,0,0,0,0,0,0,0,1,Jarace Walker,IND,MIA,IND,,,0,0,0,0
22023,1641716,22300209,"NOV 19, 2023",IND vs. ORL,L,14,3,6,0.5,0,3,0.0,1,1,1.0,0,1,1,1,1,1,1,2,7,15,1,Jarace Walker,IND,IND,ORL,,,9,8,8,2
22023,1641716,22300146,"NOV 06, 2023",IND vs. SAS,W,9,0,1,0.0,0,0,0.0,2,2,1.0,0,1,1,2,0,0,0,0,2,6,1,Jarace Walker,IND,IND,SAS,,,5,3,4,3
22023,1641716,22300118,"NOV 01, 2023",IND @ BOS,L,12,4,6,0.667,0,1,0.0,0,0,0.0,0,2,2,3,0,1,0,1,8,-13,1,Jarace Walker,IND,BOS,IND,,,13,10,11,5
22023,1641716,22300064,"OCT 25, 2023",IND vs. WAS,W,6,0,5,0.0,0,1,0.0,0,0,0.0,1,3,4,0,1,0,0,1,0,3,1,Jarace Walker,IND,IND,WAS,,,4,4,0,4
22023,1629022,22300562,"JAN 15, 2024",BKN vs. MIA,L,9,0,3,0.0,0,2,0.0,0,0,0.0,0,2,2,1,0,1,1,1,0,0,1,Lonnie Walker IV,BKN,BKN,MIA,,,3,2,1,3
22023,1629022,22300527,"JAN 11, 2024",BKN @ CLE,L,25,8,12,0.667,4,5,0.8,0,0,0.0,1,2,3,2,1,1,1,3,20,2,1,Lonnie Walker IV,BKN,CLE,BKN,,,25,23,22,5
22023,1629022,22300498,"JAN 07, 2024",BKN vs. POR,L,6,0,3,0.0,0,2,0.0,0,0,0.0,0,1,1,0,0,0,0,2,0,1,1,Lonnie Walker IV,BKN,BKN,POR,,,1,1,0,1
22023,1629022,22300481,"JAN 05, 2024",BKN vs. OKC,W,6,0,2,0.0,0,1,0.0,0,0,0.0,0,1,1,0,1,0,0,0,0,7,1,Lonnie Walker IV,BKN,BKN,OKC,,,1,1,0,1
22023,1629022,22300266,"NOV 30, 2023",BKN vs. CHA,L,14,2,5,0.4,2,4,0.5,1,2,0.5,1,1,2,1,0,0,1,1,7,-6,1,Lonnie Walker IV,BKN,BKN,CHA,,,10,9,8,3
22023,1629022,22300054,"NOV 28, 2023",BKN vs. TOR,W,23,2,6,0.333,1,4,0.25,2,3,0.667,0,1,1,2,0,1,3,0,7,-2,1,Lonnie Walker IV,BKN,BKN,TOR,,,10,8,9,3
22023,1629022,22300250,"NOV 26, 2023",BKN vs. CHI,W,25,6,13,0.462,6,10,0.6,2,2,1.0,0,1,1,0,2,0,2,1,20,23,1,Lonnie Walker IV,BKN,BKN,CHI,,,21,21,20,1
22023,1629022,22300240,"NOV 25, 2023",BKN vs. MIA,W,14,2,6,0.333,2,5,0.4,2,2,1.0,0,1,1,0,0,0,2,1,8,-5,1,Lonnie Walker IV,BKN,BKN,MIA,,,9,9,8,1
22023,1629022,22300227,"NOV 22, 2023",BKN @ ATL,L,16,3,7,0.429,2,4,0.5,0,1,0.0,0,2,2,1,0,1,1,1,8,0,1,Lonnie Walker IV,BKN,ATL,BKN,,,11,10,9,3
22023,1629022,22300208,"NOV 19, 2023",BKN vs. PHI,L,32,9,17,0.529,6,11,0.545,2,2,1.0,0,6,6,2,0,0,2,1,26,-2,1,Lonnie Walker IV,BKN,BKN,PHI,,,34,32,28,8
22023,1629022,22300200,"NOV 16, 2023",BKN @ MIA,L,26,9,18,0.5,2,7,0.286,3,4,0.75,1,2,3,1,1,0,2,2,23,-7,1,Lonnie Walker IV,BKN,MIA,BKN,,,27,26,24,4
22023,1629022,22300020,"NOV 14, 2023",BKN vs. ORL,W,20,4,9,0.444,3,6,0.5,0,0,0.0,0,2,2,1,2,0,2,0,11,6,1,Lonnie Walker IV,BKN,BKN,ORL,,,14,13,12,3
22023,1629022,22300178,"NOV 12, 2023",BKN vs. WAS,W,14,2,8,0.25,1,3,0.333,0,0,0.0,0,2,2,2,0,0,1,1,5,-1,1,Lonnie Walker IV,BKN,BKN,WAS,,,9,7,7,4
22023,1629022,22300010,"NOV 10, 2023",BKN @ BOS,L,20,8,12,0.667,3,4,0.75,1,1,1.0,0,7,7,4,0,1,0,0,20,0,1,Lonnie Walker IV,BKN,BOS,BKN,,,31,27,24,11
22023,1629022,22300160,"NOV 08, 2023",BKN vs. LAC,W,28,8,16,0.5,3,7,0.429,2,2,1.0,0,1,1,0,1,1,0,0,21,10,1,Lonnie Walker IV,BKN,BKN,LAC,,,22,22,21,1
22023,1629022,22300149,"NOV 06, 2023",BKN vs. MIL,L,23,8,14,0.571,3,7,0.429,0,0,0.0,0,4,4,2,0,0,3,1,19,-5,1,Lonnie Walker IV,BKN,BKN,MIL,,,25,23,21,6
22023,1629022,22300136,"NOV 04, 2023",BKN vs. BOS,L,17,5,8,0.625,1,2,0.5,2,2,1.0,0,3,3,1,0,0,1,0,13,-2,1,Lonnie Walker IV,BKN,BKN,BOS,,,17,16,14,4
22023,1629022,22300004,"NOV 03, 2023",BKN @ CHI,W,16,5,10,0.5,1,4,0.25,0,0,0.0,0,1,1,1,0,1,0,2,11,9,1,Lonnie Walker IV,BKN,CHI,BKN,,,13,12,12,2
22023,1629022,22300119,"NOV 01, 2023",BKN @ MIA,W,25,4,9,0.444,1,4,0.25,8,11,0.727,1,2,3,4,3,0,3,1,17,15,1,Lonnie Walker IV,BKN,MIA,BKN,,,24,20,21,7
22023,1629022,22300101,"OCT 30, 2023",BKN @ CHA,W,29,6,13,0.462,3,7,0.429,4,6,0.667,0,5,5,4,1,1,0,1,19,11,1,Lonnie Walker IV,BKN,CHA,BKN,,,28,24,23,9
22023,1629022,22300084,"OCT 27, 2023",BKN @ DAL,L,21,5,9,0.556,4,6,0.667,0,0,0.0,0,1,1,2,0,1,2,3,14,8,1,Lonnie Walker IV,BKN,DAL,BKN,,,17,15,16,3
22023,1641717,22300565,"JAN 15, 2024",OKC @ LAL,L,20,2,6,0.333,1,4,0.25,0,0,0.0,0,0,0,1,2,1,1,0,5,-7,1,Cason Wallace,OKC,LAL,OKC,,,6,5,6,1
22023,1641717,22300546,"JAN 13, 2024",OKC vs. ORL,W,20,0,5,0.0,0,4,0.0,1,2,0.5,2,1,3,0,0,0,0,3,1,5,1,Cason Wallace,OKC,OKC,ORL,,,4,4,1,3
22023,1641717,22300529,"JAN 11, 2024",OKC vs. POR,W,17,1,5,0.2,0,3,0.0,2,2,1.0,1,5,6,2,0,0,0,0,4,17,1,Cason Wallace,OKC,OKC,POR,,,12,10,6,8
22023,1641717,22300522,"JAN 10, 2024",OKC @ MIA,W,18,3,5,0.6,2,4,0.5,0,0,0.0,1,1,2,1,0,0,1,2,8,9,1,Cason Wallace,OKC,MIA,OKC,,,11,10,9,3
22023,1641717,22300508,"JAN 08, 2024",OKC @ WAS,W,24,2,7,0.286,1,4,0.25,0,0,0.0,1,1,2,2,2,3,1,1,5,-4,1,Cason Wallace,OKC,WAS,OKC,,,9,7,7,4
22023,1641717,22300481,"JAN 05, 2024",OKC @ BKN,L,23,3,7,0.429,2,4,0.5,0,0,0.0,1,1,2,0,1,0,0,1,8,-5,1,Cason Wallace,OKC,BKN,OKC,,,10,10,8,2
22023,1641717,22300467,"JAN 03, 2024",OKC @ ATL,L,20,5,9,0.556,3,7,0.429,2,2,1.0,0,1,1,2,1,0,0,2,15,-16,1,Cason Wallace,OKC,ATL,OKC,,,18,16,17,3
22023,1641717,22300462,"JAN 02, 2024",OKC vs. BOS,W,17,2,3,0.667,1,2,0.5,0,0,0.0,1,0,1,3,1,0,0,3,5,-14,1,Cason Wallace,OKC,OKC,BOS,,,9,6,8,4
22023,1641717,22300447,"DEC 31, 2023",OKC vs. BKN,W,23,3,7,0.429,2,4,0.5,2,2,1.0,1,2,3,1,0,1,0,5,10,9,1,Cason Wallace,OKC,OKC,BKN,,,14,13,11,4
22023,1641717,22300435,"DEC 29, 2023",OKC @ DEN,W,18,2,5,0.4,0,2,0.0,0,0,0.0,0,3,3,2,0,1,0,1,4,-2,1,Cason Wallace,OKC,DEN,OKC,,,9,7,6,5
22023,1641717,22300419,"DEC 27, 2023",OKC vs. NYK,W,22,2,6,0.333,0,2,0.0,0,0,0.0,0,1,1,0,1,0,1,1,4,6,1,Cason Wallace,OKC,OKC,NYK,,,5,5,4,1
22023,1641717,22300411,"DEC 26, 2023",OKC vs. MIN,W,24,2,5,0.4,1,4,0.25,0,0,0.0,1,0,1,1,2,0,1,0,5,4,1,Cason Wallace,OKC,OKC,MIN,,,7,6,6,2
22023,1641717,22300397,"DEC 23, 2023",OKC vs. LAL,L,24,2,6,0.333,1,4,0.25,0,0,0.0,1,2,3,4,1,0,0,2,5,-5,1,Cason Wallace,OKC,OKC,LAL,,,12,8,9,7
22023,1641717,22300379,"DEC 21, 2023",OKC vs. LAC,W,20,1,4,0.25,0,2,0.0,0,0,0.0,0,0,0,3,0,1,1,2,2,-5,1,Cason Wallace,OKC,OKC,LAC,,,5,2,5,3
22023,1641717,22300355,"DEC 18, 2023",OKC vs. MEM,W,17,3,6,0.5,1,4,0.25,0,0,0.0,0,2,2,2,0,0,1,1,7,12,1,Cason Wallace,OKC,OKC,MEM,,,11,9,9,4
22023,1641717,22300340,"DEC 16, 2023",OKC @ DEN,W,18,1,2,0.5,0,0,0.0,0,0,0.0,1,1,2,1,0,0,1,0,2,-7,1,Cason Wallace,OKC,DEN,OKC,,,5,4,3,3
22023,1641717,22300324,"DEC 14, 2023",OKC @ SAC,L,19,1,3,0.333,1,2,0.5,0,0,0.0,0,0,0,4,0,0,0,3,3,-18,1,Cason Wallace,OKC,SAC,OKC,,,7,3,7,4
22023,1641717,22300302,"DEC 11, 2023",OKC vs. UTA,W,25,4,8,0.5,2,4,0.5,0,0,0.0,0,3,3,2,1,2,0,4,10,17,1,Cason Wallace,OKC,OKC,UTA,,,15,13,12,5
22023,1641717,22301222,"DEC 08, 2023",OKC vs. GSW,W,24,4,5,0.8,1,2,0.5,1,2,0.5,0,1,1,0,1,1,1,0,10,1,1,Cason Wallace,OKC,OKC,GSW,,,11,11,10,1
22023,1641717,22301212,"DEC 06, 2023",OKC @ HOU,L,25,2,5,0.4,1,2,0.5,0,0,0.0,0,3,3,0,2,1,0,3,5,12,1,Cason Wallace,OKC,HOU,OKC,,,8,8,5,3
22023,1641717,22300287,"DEC 02, 2023",OKC @ DAL,W,20,6,12,0.5,2,7,0.286,1,2,0.5,2,4,6,0,0,0,0,3,15,0,1,Cason Wallace,OKC,DAL,OKC,,,21,21,15,6
22023,1641717,22300271,"NOV 30, 2023",OKC vs. LAL,W,22,4,7,0.571,2,4,0.5,0,0,0.0,0,3,3,1,0,1,1,1,10,19,1,Cason Wallace,OKC,OKC,LAL,,,14,13,11,4
22023,1641717,22300058,"NOV 28, 2023",OKC @ MIN,L,17,3,4,0.75,3,3,1.0,1,2,0.5,0,0,0,0,1,0,0,0,10,5,1,Cason Wallace,OKC,MIN,OKC,,,10,10,10,0
22023,1641717,22300239,"NOV 25, 2023",OKC vs. PHI,L,14,0,2,0.0,0,0,0.0,0,0,0.0,1,0,1,1,0,0,0,1,0,-15,1,Cason Wallace,OKC,OKC,PHI,,,2,1,1,2
22023,1641717,22300234,"NOV 22, 2023",OKC vs. CHI,W,24,2,3,0.667,1,2,0.5,0,0,0.0,1,2,3,0,0,1,1,1,5,-2,1,Cason Wallace,OKC,OKC,CHI,,,8,8,5,3
22023,1641717,22300215,"NOV 19, 2023",OKC @ POR,W,21,1,2,0.5,0,0,0.0,0,0,0.0,0,1,1,0,1,0,1,1,2,19,1,Cason Wallace,OKC,POR,OKC,,,3,3,2,1
22023,1641717,22300207,"NOV 18, 2023",OKC @ GSW,W,28,1,3,0.333,0,2,0.0,1,1,1.0,0,1,1,2,0,0,0,3,3,4,1,Cason Wallace,OKC,GSW,OKC,,,6,4,5,3
22023,1641717,22300201,"NOV 16, 2023",OKC @ GSW,W,26,4,7,0.571,2,2,1.0,0,0,0.0,1,1,2,4,1,0,0,1,10,22,1,Cason Wallace,OKC,GSW,OKC,,,16,12,14,6
22023,1641717,22300021,"NOV 14, 2023",OKC vs. SAS,W,21,4,5,0.8,1,1,1.0,0,0,0.0,1,4,5,3,2,2,1,1,9,8,1,Cason Wallace,OKC,OKC,SAS,,,17,14,12,8
22023,1641717,22300185,"NOV 12, 2023",OKC @ PHX,W,17,0,1,0.0,0,0,0.0,0,0,0.0,0,0,0,1,0,0,0,3,0,2,1,Cason Wallace,OKC,PHX,OKC,,,1,0,1,1
22023,1641717,22300016,"NOV 10, 2023",OKC @ SAC,L,24,3,7,0.429,2,5,0.4,0,0,0.0,1,2,3,2,0,1,0,1,8,3,1,Cason Wallace,OKC,SAC,OKC,,,13,11,10,5
22023,1641717,22300167,"NOV 08, 2023",OKC vs. CLE,W,24,5,7,0.714,2,3,0.667,2,2,1.0,1,2,3,2,0,0,2,3,14,6,1,Cason Wallace,OKC,OKC,CLE,,,19,17,16,5
22023,1641717,22300155,"NOV 06, 2023",OKC vs. ATL,W,24,3,6,0.5,0,3,0.0,0,0,0.0,0,2,2,4,4,0,1,1,6,3,1,Cason Wallace,OKC,OKC,ATL,,,12,8,10,6
22023,1641717,22300005,"NOV 03, 2023",OKC vs. GSW,L,36,6,10,0.6,1,2,0.5,0,0,0.0,1,1,2,1,0,0,1,1,13,4,1,Cason Wallace,OKC,OKC,GSW,,,16,15,14,3
22023,1641717,22300121,"NOV 01, 2023",OKC vs. NOP,L,18,1,2,0.5,0,0,0.0,2,2,1.0,0,2,2,1,0,0,0,4,4,-4,1,Cason Wallace,OKC,OKC,NOP,,,7,6,5,3
22023,1641717,22300109,"OCT 30, 2023",OKC vs. DET,W,22,1,2,0.5,0,1,0.0,2,2,1.0,0,4,4,2,0,0,1,2,4,-2,1,Cason Wallace,OKC,OKC,DET,,,10,8,6,6
22023,1641717,22300095,"OCT 29, 2023",OKC vs. DEN,L,22,3,3,1.0,1,1,1.0,0,0,0.0,1,2,3,1,1,1,0,1,7,-11,1,Cason Wallace,OKC,OKC,DEN,,,11,10,8,4
22023,1641717,22300081,"OCT 27, 2023",OKC @ CLE,W,19,3,4,0.75,1,1,1.0,2,2,1.0,1,1,2,0,0,0,0,0,9,3,1,Cason Wallace,OKC,CLE,OKC,,,11,11,9,2
22023,1641717,22300070,"OCT 25, 2023",OKC @ CHI,W,19,5,5,1.0,3,3,1.0,0,0,0.0,0,2,2,1,0,1,1,3,13,9,1,Cason Wallace,OKC,CHI,OKC,,,16,15,14,3
22023,1629023,22300551,"JAN 14, 2024",CHA @ MIA,L,28,2,7,0.286,1,5,0.2,0,2,0.0,2,4,6,1,1,0,1,3,5,-4,1,P.J. Washington,CHA,MIA,CHA,,,12,11,6,7
22023,1629023,22300484,"JAN 05, 2024",CHA @ CHI,L,6,0,2,0.0,0,1,0.0,0,0,0.0,1,2,3,2,0,0,0,0,0,-1,1,P.J. Washington,CHA,CHI,CHA,,,5,3,2,5
22023,1629023,22300464,"JAN 02, 2024",CHA @ SAC,W,29,7,13,0.538,3,6,0.5,0,0,0.0,1,3,4,4,1,0,1,1,17,16,1,P.J. Washington,CHA,SAC,CHA,,,25,21,21,8
22023,1629023,22300455,"JAN 01, 2024",CHA @ DEN,L,26,2,5,0.4,1,3,0.333,1,1,1.0,1,5,6,0,0,0,2,2,6,3,1,P.J. Washington,CHA,DEN,CHA,,,12,12,6,6
22023,1629023,22300436,"DEC 29, 2023",CHA @ PHX,L,28,5,12,0.417,3,8,0.375,0,0,0.0,1,3,4,4,0,1,1,3,13,-7,1,P.J. Washington,CHA,PHX,CHA,,,21,17,17,8
22023,1629023,22300428,"DEC 28, 2023",CHA @ LAL,L,25,4,11,0.364,0,4,0.0,1,2,0.5,1,5,6,0,0,0,3,1,9,-15,1,P.J. Washington,CHA,LAL,CHA,,,15,15,9,6
22023,1629023,22300414,"DEC 26, 2023",CHA @ LAC,L,26,7,10,0.7,0,2,0.0,4,4,1.0,4,4,8,3,2,0,2,3,18,-4,1,P.J. Washington,CHA,LAC,CHA,,,29,26,21,11
22023,1629023,22300390,"DEC 23, 2023",CHA vs. DEN,L,28,6,20,0.3,1,7,0.143,7,9,0.778,1,7,8,2,4,2,2,1,20,-10,1,P.J. Washington,CHA,CHA,DEN,,,30,28,22,10
22023,1629023,22300365,"DEC 20, 2023",CHA @ IND,L,27,4,10,0.4,2,7,0.286,2,2,1.0,3,1,4,0,0,0,1,1,12,-31,1,P.J. Washington,CHA,IND,CHA,,,16,16,12,4
22023,1629023,22300354,"DEC 18, 2023",CHA @ TOR,L,39,5,16,0.313,3,9,0.333,2,2,1.0,1,6,7,5,4,0,2,5,15,-17,1,P.J. Washington,CHA,TOR,CHA,,,27,22,20,12
22023,1629023,22300312,"DEC 13, 2023",CHA @ MIA,L,4,0,0,0.0,0,0,0.0,0,0,0.0,0,0,0,1,1,0,1,0,0,1,1,P.J. Washington,CHA,MIA,CHA,,,1,0,1,1
22023,1629023,22300292,"DEC 11, 2023",CHA vs. MIA,L,32,5,11,0.455,2,6,0.333,3,4,0.75,1,7,8,3,0,1,0,3,15,6,1,P.J. Washington,CHA,CHA,MIA,,,26,23,18,11
22023,1629023,22301216,"DEC 08, 2023",CHA vs. TOR,W,25,4,7,0.571,3,5,0.6,0,0,0.0,0,1,1,2,2,0,2,4,11,-7,1,P.J. Washington,CHA,CHA,TOR,,,14,12,13,3
22023,1629023,22301211,"DEC 06, 2023",CHA @ CHI,L,29,4,13,0.308,1,7,0.143,0,0,0.0,1,5,6,4,1,2,1,5,9,-5,1,P.J. Washington,CHA,CHI,CHA,,,19,15,13,10
22023,1629023,22300281,"DEC 02, 2023",CHA vs. MIN,L,31,7,14,0.5,4,7,0.571,0,0,0.0,3,4,7,5,0,1,1,1,18,8,1,P.J. Washington,CHA,CHA,MIN,,,30,25,23,12
22023,1629023,22300266,"NOV 30, 2023",CHA @ BKN,W,33,2,11,0.182,2,9,0.222,4,4,1.0,2,6,8,5,3,2,2,2,10,4,1,P.J. Washington,CHA,BKN,CHA,,,23,18,15,13
22023,1629023,22300057,"NOV 28, 2023",CHA @ NYK,L,27,4,10,0.4,3,8,0.375,0,2,0.0,3,5,8,3,1,1,3,3,11,-13,1,P.J. Washington,CHA,NYK,CHA,,,22,19,14,11
22023,1629023,22300248,"NOV 26, 2023",CHA @ ORL,L,28,3,10,0.3,3,9,0.333,4,6,0.667,0,4,4,2,0,3,1,5,13,-5,1,P.J. Washington,CHA,ORL,CHA,,,19,17,15,6
22023,1629023,22300217,"NOV 20, 2023",CHA vs. BOS,W,28,6,13,0.462,3,9,0.333,0,0,0.0,0,1,1,1,2,1,0,1,15,-21,1,P.J. Washington,CHA,CHA,BOS,,,17,16,16,2
22023,1629023,22300202,"NOV 18, 2023",CHA vs. NYK,L,33,1,10,0.1,1,7,0.143,0,0,0.0,0,6,6,2,1,2,6,4,3,-25,1,P.J. Washington,CHA,CHA,NYK,,,11,9,5,8
22023,1629023,22300027,"NOV 17, 2023",CHA vs. MIL,L,26,1,3,0.333,1,3,0.333,0,0,0.0,0,3,3,1,0,0,0,4,3,-2,1,P.J. Washington,CHA,CHA,MIL,,,7,6,4,4
22023,1629023,22300017,"NOV 14, 2023",CHA vs. MIA,L,36,12,23,0.522,6,11,0.545,2,2,1.0,2,4,6,1,0,0,1,1,32,-2,1,P.J. Washington,CHA,CHA,MIA,,,39,38,33,7
22023,1629023,22300177,"NOV 12, 2023",CHA @ NYK,L,22,1,8,0.125,1,5,0.2,1,2,0.5,1,1,2,3,0,1,2,4,4,-30,1,P.J. Washington,CHA,NYK,CHA,,,9,6,7,5
22023,1629023,22300009,"NOV 10, 2023",CHA @ WAS,W,38,5,15,0.333,0,6,0.0,1,2,0.5,3,7,10,4,1,0,2,0,11,-1,1,P.J. Washington,CHA,WAS,CHA,,,25,21,15,14
22023,1629023,22300157,"NOV 08, 2023",CHA vs. WAS,L,36,4,11,0.364,0,5,0.0,6,7,0.857,1,6,7,1,0,2,2,2,14,-8,1,P.J. Washington,CHA,CHA,WAS,,,22,21,15,8
22023,1629023,22300143,"NOV 05, 2023",CHA @ DAL,L,34,8,15,0.533,1,4,0.25,3,4,0.75,0,4,4,1,0,0,0,3,20,8,1,P.J. Washington,CHA,DAL,CHA,,,25,24,21,5
22023,1629023,22300133,"NOV 04, 2023",CHA @ IND,W,33,6,13,0.462,1,1,1.0,2,2,1.0,1,2,3,4,1,2,1,0,15,-13,1,P.J. Washington,CHA,IND,CHA,,,22,18,19,7
22023,1629023,22300122,"NOV 01, 2023",CHA @ HOU,L,35,8,13,0.615,5,6,0.833,2,2,1.0,1,2,3,0,0,0,1,2,23,0,1,P.J. Washington,CHA,HOU,CHA,,,26,26,23,3
22023,1629023,22300101,"OCT 30, 2023",CHA vs. BKN,L,35,7,14,0.5,1,3,0.333,0,1,0.0,3,9,12,2,0,0,1,4,15,-14,1,P.J. Washington,CHA,CHA,BKN,,,29,27,17,14
22023,1629023,22300077,"OCT 27, 2023",CHA vs. DET,L,29,6,13,0.462,1,5,0.2,0,1,0.0,0,3,3,3,2,1,2,6,13,-12,1,P.J. Washington,CHA,CHA,DET,,,19,16,16,6
22023,1629023,22300063,"OCT 25, 2023",CHA vs. ATL,W,32,12,18,0.667,1,6,0.167,0,0,0.0,1,4,5,2,0,0,1,4,25,5,1,P.J. Washington,CHA,CHA,ATL,,,32,30,27,7
22023,1631102,22300195,"NOV 15, 2023",MIL @ TOR,W,2,0,1,0.0,0,1,0.0,0,0,0.0,0,1,1,0,1,0,1,0,0,-7,1,TyTy Washington Jr.,MIL,TOR,MIL,,,1,1,0,1
22023,1631102,22300097,"OCT 29, 2023",MIL vs. ATL,L,3,1,2,0.5,1,1,1.0,0,0,0.0,0,0,0,0,0,0,1,0,3,10,1,TyTy Washington Jr.,MIL,MIL,ATL,,,3,3,3,0
22023,1629139,22300531,"JAN 11, 2024",PHX @ LAL,W,5,0,0,0.0,0,0,0.0,0,0,0.0,0,1,1,0,0,0,1,1,0,-7,1,Yuta Watanabe,PHX,LAL,PHX,,,1,1,0,1
22023,1629139,22300511,"JAN 08, 2024",PHX @ LAC,L,5,0,2,0.0,0,2,0.0,1,2,0.5,0,0,0,0,0,0,0,1,1,-3,1,Yuta Watanabe,PHX,LAC,PHX,,,1,1,1,0
22023,1629139,22300489,"JAN 05, 2024",PHX vs. MIA,W,9,1,3,0.333,0,1,0.0,0,0,0.0,1,0,1,0,0,0,0,0,2,-7,1,Yuta Watanabe,PHX,PHX,MIA,,,3,3,2,1
22023,1629139,22300456,"JAN 01, 2024",PHX vs. POR,W,6,1,2,0.5,0,1,0.0,0,0,0.0,0,0,0,0,0,0,0,0,2,-5,1,Yuta Watanabe,PHX,PHX,POR,,,2,2,2,0
22023,1629139,22300418,"DEC 27, 2023",PHX @ HOU,W,2,0,1,0.0,0,0,0.0,0,0,0.0,0,0,0,0,0,0,0,0,0,-2,1,Yuta Watanabe,PHX,HOU,PHX,,,0,0,0,0
22023,1629139,22300387,"DEC 22, 2023",PHX @ SAC,L,12,1,4,0.25,0,3,0.0,0,0,0.0,0,2,2,0,0,0,0,2,2,5,1,Yuta Watanabe,PHX,SAC,PHX,,,4,4,2,2
22023,1629139,22300333,"DEC 15, 2023",PHX vs. NYK,L,8,0,0,0.0,0,0,0.0,0,0,0.0,0,0,0,0,0,0,0,0,0,0,1,Yuta Watanabe,PHX,PHX,NYK,,,0,0,0,0
22023,1629139,22300317,"DEC 13, 2023",PHX vs. BKN,L,7,0,2,0.0,0,2,0.0,0,0,0.0,1,0,1,0,0,0,0,2,0,-13,1,Yuta Watanabe,PHX,PHX,BKN,,,1,1,0,1
22023,1629139,22300308,"DEC 12, 2023",PHX vs. GSW,W,20,1,4,0.25,1,4,0.25,0,0,0.0,0,1,1,1,1,1,1,2,3,11,1,Yuta Watanabe,PHX,PHX,GSW,,,5,4,4,2
22023,1629139,22301228,"DEC 08, 2023",PHX vs. SAC,L,24,3,8,0.375,3,8,0.375,0,0,0.0,0,2,2,1,0,0,0,0,9,-13,1,Yuta Watanabe,PHX,PHX,SAC,,,12,11,10,3
22023,1629139,22300288,"DEC 02, 2023",PHX vs. MEM,W,15,1,2,0.5,1,2,0.5,1,2,0.5,1,1,2,0,1,0,2,3,4,3,1,Yuta Watanabe,PHX,PHX,MEM,,,6,6,4,2
22023,1629139,22300260,"NOV 29, 2023",PHX @ TOR,L,16,0,5,0.0,0,3,0.0,1,2,0.5,1,0,1,0,1,2,1,0,1,4,1,Yuta Watanabe,PHX,TOR,PHX,,,2,2,1,1
22023,1629139,22300247,"NOV 26, 2023",PHX @ NYK,W,15,2,4,0.5,2,4,0.5,1,2,0.5,0,0,0,0,0,0,0,1,7,5,1,Yuta Watanabe,PHX,NYK,PHX,,,7,7,7,0
22023,1629139,22300035,"NOV 17, 2023",PHX @ UTA,W,10,1,3,0.333,1,2,0.5,0,0,0.0,1,1,2,0,0,0,0,1,3,2,1,Yuta Watanabe,PHX,UTA,PHX,,,5,5,3,2
22023,1629139,22300197,"NOV 15, 2023",PHX vs. MIN,W,23,1,6,0.167,1,4,0.25,0,0,0.0,0,2,2,3,0,1,0,1,3,-1,1,Yuta Watanabe,PHX,PHX,MIN,,,8,5,6,5
22023,1629139,22300185,"NOV 12, 2023",PHX vs. OKC,L,17,2,2,1.0,2,2,1.0,0,0,0.0,0,0,0,2,0,0,0,1,6,10,1,Yuta Watanabe,PHX,PHX,OKC,,,8,6,8,2
22023,1629139,22300015,"NOV 10, 2023",PHX vs. LAL,L,14,1,4,0.25,1,3,0.333,0,0,0.0,1,0,1,0,0,0,0,5,3,6,1,Yuta Watanabe,PHX,PHX,LAL,,,4,4,3,1
22023,1629139,22300162,"NOV 08, 2023",PHX @ CHI,W,18,2,5,0.4,2,5,0.4,0,0,0.0,0,5,5,0,0,1,3,2,6,-11,1,Yuta Watanabe,PHX,CHI,PHX,,,11,11,6,5
22023,1629139,22300140,"NOV 05, 2023",PHX @ DET,W,20,2,4,0.5,1,3,0.333,1,1,1.0,0,1,1,0,0,0,2,1,6,13,1,Yuta Watanabe,PHX,DET,PHX,,,7,7,6,1
22023,1629139,22300132,"NOV 04, 2023",PHX @ PHI,L,22,1,4,0.25,1,4,0.25,2,2,1.0,3,2,5,0,1,0,1,2,5,-13,1,Yuta Watanabe,PHX,PHI,PHX,,,10,10,5,5
22023,1629139,22300131,"NOV 02, 2023",PHX vs. SAS,L,26,1,5,0.2,0,4,0.0,1,2,0.5,0,4,4,1,0,0,0,1,3,0,1,Yuta Watanabe,PHX,PHX,SAS,,,8,7,4,5
22023,1629139,22300113,"OCT 31, 2023",PHX vs. SAS,L,19,4,8,0.5,3,7,0.429,0,0,0.0,1,2,3,2,1,0,2,1,11,-6,1,Yuta Watanabe,PHX,PHX,SAS,,,16,14,13,5
22023,1629139,22300094,"OCT 28, 2023",PHX vs. UTA,W,21,2,7,0.286,1,4,0.25,2,2,1.0,1,3,4,0,2,1,0,2,7,2,1,Yuta Watanabe,PHX,PHX,UTA,,,11,11,7,4
22023,1629139,22300076,"OCT 26, 2023",PHX @ LAL,L,15,1,2,0.5,1,1,1.0,0,0,0.0,0,1,1,0,0,0,1,2,3,-16,1,Yuta Watanabe,PHX,LAL,PHX,,,4,4,3,1
22023,1629139,22300062,"OCT 24, 2023",PHX @ GSW,W,18,3,5,0.6,2,4,0.5,0,0,0.0,0,4,4,0,0,1,1,2,8,7,1,Yuta Watanabe,PHX,GSW,PHX,,,12,12,8,4
22023,1630322,22300529,"JAN 11, 2024",OKC vs. POR,W,12,2,5,0.4,2,4,0.5,0,0,0.0,0,2,2,2,0,1,1,1,6,0,1,Lindy Waters III,OKC,OKC,POR,,,10,8,8,4
22023,1630322,22300481,"JAN 05, 2024",OKC @ BKN,L,4,0,1,0.0,0,1,0.0,0,0,0.0,0,0,0,0,0,0,0,1,0,-2,1,Lindy Waters III,OKC,BKN,OKC,,,0,0,0,0
22023,1630322,22300467,"JAN 03, 2024",OKC @ ATL,L,20,3,6,0.5,3,6,0.5,0,0,0.0,0,3,3,1,0,0,1,2,9,5,1,Lindy Waters III,OKC,ATL,OKC,,,13,12,10,4
22023,1630322,22300447,"DEC 31, 2023",OKC vs. BKN,W,2,1,1,1.0,1,1,1.0,0,0,0.0,0,0,0,0,0,0,0,0,3,-1,1,Lindy Waters III,OKC,OKC,BKN,,,3,3,3,0
22023,1630322,22300435,"DEC 29, 2023",OKC @ DEN,W,3,1,2,0.5,1,2,0.5,0,0,0.0,0,1,1,0,0,0,0,0,3,3,1,Lindy Waters III,OKC,DEN,OKC,,,4,4,3,1
22023,1630322,22300302,"DEC 11, 2023",OKC vs. UTA,W,8,1,4,0.25,1,4,0.25,0,0,0.0,0,0,0,1,0,0,0,2,3,-15,1,Lindy Waters III,OKC,OKC,UTA,,,4,3,4,1
22023,1630322,22300271,"NOV 30, 2023",OKC vs. LAL,W,12,2,5,0.4,1,4,0.25,0,0,0.0,0,1,1,1,0,0,0,3,5,12,1,Lindy Waters III,OKC,OKC,LAL,,,7,6,6,2
22023,1630322,22300234,"NOV 22, 2023",OKC vs. CHI,W,5,0,0,0.0,0,0,0.0,0,0,0.0,1,1,2,1,0,1,0,0,0,7,1,Lindy Waters III,OKC,OKC,CHI,,,3,2,1,3
22023,1630322,22300215,"NOV 19, 2023",OKC @ POR,W,16,4,7,0.571,4,7,0.571,0,0,0.0,0,3,3,1,0,0,0,0,12,6,1,Lindy Waters III,OKC,POR,OKC,,,16,15,13,4
22023,1630322,22300021,"NOV 14, 2023",OKC vs. SAS,W,5,2,3,0.667,2,3,0.667,0,0,0.0,0,0,0,0,0,0,0,0,6,-2,1,Lindy Waters III,OKC,OKC,SAS,,,6,6,6,0
22023,1630322,22300016,"NOV 10, 2023",OKC @ SAC,L,19,0,2,0.0,0,2,0.0,0,0,0.0,0,0,0,2,0,0,0,1,0,3,1,Lindy Waters III,OKC,SAC,OKC,,,2,0,2,2
22023,1630322,22300121,"NOV 01, 2023",OKC vs. NOP,L,1,0,0,0.0,0,0,0.0,0,0,0.0,0,0,0,0,0,0,0,0,0,0,1,Lindy Waters III,OKC,OKC,NOP,,,0,0,0,0
22023,1630322,22300081,"OCT 27, 2023",OKC @ CLE,W,1,0,0,0.0,0,0,0.0,0,0,0.0,0,0,0,0,0,0,0,0,0,3,1,Lindy Waters III,OKC,CLE,OKC,,,0,0,0,0
22023,1630322,22300070,"OCT 25, 2023",OKC @ CHI,W,3,0,1,0.0,0,1,0.0,0,0,0.0,0,0,0,0,0,0,0,0,0,0,1,Lindy Waters III,OKC,CHI,OKC,,,0,0,0,0
22023,1630570,22300562,"JAN 15, 2024",BKN vs. MIA,L,4,0,1,0.0,0,0,0.0,0,0,0.0,1,0,1,1,0,0,0,1,0,2,1,Trendon Watford,BKN,BKN,MIA,,,2,1,1,2
22023,1630570,22300527,"JAN 11, 2024",BKN @ CLE,L,13,4,5,0.8,0,1,0.0,0,0,0.0,2,2,4,1,1,0,0,6,8,11,1,Trendon Watford,BKN,CLE,BKN,,,13,12,9,5
22023,1630570,22300498,"JAN 07, 2024",BKN vs. POR,L,0,0,0,0.0,0,0,0.0,0,0,0.0,0,0,0,0,0,0,1,0,0,0,1,Trendon Watford,BKN,BKN,POR,,,0,0,0,0
22023,1630570,22300469,"JAN 03, 2024",BKN @ HOU,L,20,3,6,0.5,2,2,1.0,3,4,0.75,4,3,7,1,2,0,0,1,11,9,1,Trendon Watford,BKN,HOU,BKN,,,19,18,12,8
22023,1630570,22300461,"JAN 02, 2024",BKN @ NOP,L,7,2,4,0.5,0,0,0.0,0,1,0.0,1,0,1,1,0,0,0,1,4,3,1,Trendon Watford,BKN,NOP,BKN,,,6,5,5,2
22023,1630570,22300447,"DEC 31, 2023",BKN @ OKC,L,2,1,1,1.0,0,0,0.0,0,0,0.0,0,0,0,0,0,0,0,0,2,1,1,Trendon Watford,BKN,OKC,BKN,,,2,2,2,0
22023,1630570,22300417,"DEC 27, 2023",BKN vs. MIL,L,28,6,9,0.667,0,1,0.0,5,6,0.833,0,5,5,4,2,0,1,1,17,-15,1,Trendon Watford,BKN,BKN,MIL,,,26,22,21,9
22023,1630570,22300394,"DEC 23, 2023",BKN vs. DET,W,1,0,0,0.0,0,0,0.0,0,0,0.0,0,0,0,0,0,0,0,0,0,-6,1,Trendon Watford,BKN,BKN,DET,,,0,0,0,0
22023,1630570,22300368,"DEC 20, 2023",BKN vs. NYK,L,11,2,3,0.667,0,1,0.0,0,1,0.0,0,3,3,1,0,1,1,1,4,8,1,Trendon Watford,BKN,BKN,NYK,,,8,7,5,4
22023,1630570,22300357,"DEC 18, 2023",BKN @ UTA,L,7,2,3,0.667,1,1,1.0,0,0,0.0,0,3,3,1,0,1,0,0,5,-1,1,Trendon Watford,BKN,UTA,BKN,,,9,8,6,4
22023,1630570,22300339,"DEC 16, 2023",BKN @ GSW,L,8,0,1,0.0,0,0,0.0,0,0,0.0,0,2,2,2,0,0,1,1,0,2,1,Trendon Watford,BKN,GSW,BKN,,,4,2,2,4
22023,1630570,22300322,"DEC 14, 2023",BKN @ DEN,L,22,4,10,0.4,0,1,0.0,0,0,0.0,2,2,4,6,0,2,2,2,8,-7,1,Trendon Watford,BKN,DEN,BKN,,,18,12,14,10
22023,1630570,22300317,"DEC 13, 2023",BKN @ PHX,W,18,3,5,0.6,0,2,0.0,1,1,1.0,0,1,1,1,1,0,0,1,7,11,1,Trendon Watford,BKN,PHX,BKN,,,9,8,8,2
22023,1630570,22300303,"DEC 11, 2023",BKN @ SAC,L,11,3,4,0.75,0,0,0.0,2,2,1.0,1,4,5,2,1,0,1,3,8,4,1,Trendon Watford,BKN,SAC,BKN,,,15,13,10,7
22023,1630570,22301219,"DEC 08, 2023",BKN vs. WAS,W,19,2,5,0.4,0,1,0.0,4,4,1.0,0,2,2,2,0,0,0,2,8,13,1,Trendon Watford,BKN,BKN,WAS,,,12,10,10,4
22023,1630570,22300282,"DEC 02, 2023",BKN vs. ORL,W,7,3,4,0.75,0,0,0.0,1,1,1.0,3,1,4,1,0,1,1,1,7,6,1,Trendon Watford,BKN,BKN,ORL,,,12,11,8,5
22023,1630570,22300266,"NOV 30, 2023",BKN vs. CHA,L,14,3,5,0.6,0,1,0.0,0,0,0.0,1,3,4,2,0,0,0,2,6,-3,1,Trendon Watford,BKN,BKN,CHA,,,12,10,8,6
22023,1630570,22300054,"NOV 28, 2023",BKN vs. TOR,W,11,1,2,0.5,0,0,0.0,0,0,0.0,0,1,1,0,0,0,3,1,2,-8,1,Trendon Watford,BKN,BKN,TOR,,,3,3,2,1
22023,1630570,22300250,"NOV 26, 2023",BKN vs. CHI,W,17,5,8,0.625,1,2,0.5,0,1,0.0,1,3,4,2,1,0,0,2,11,-2,1,Trendon Watford,BKN,BKN,CHI,,,17,15,13,6
22023,1630570,22300240,"NOV 25, 2023",BKN vs. MIA,W,13,3,5,0.6,1,1,1.0,0,0,0.0,0,2,2,0,1,0,1,4,7,-6,1,Trendon Watford,BKN,BKN,MIA,,,9,9,7,2
22023,1630570,22300227,"NOV 22, 2023",BKN @ ATL,L,15,3,8,0.375,1,2,0.5,0,0,0.0,1,6,7,1,0,0,3,3,7,-6,1,Trendon Watford,BKN,ATL,BKN,,,15,14,8,8
22023,1630570,22300208,"NOV 19, 2023",BKN vs. PHI,L,22,3,9,0.333,0,2,0.0,2,2,1.0,2,2,4,4,1,1,2,3,8,0,1,Trendon Watford,BKN,BKN,PHI,,,16,12,12,8
22023,1630570,22300200,"NOV 16, 2023",BKN @ MIA,L,10,2,3,0.667,0,0,0.0,0,0,0.0,2,0,2,1,0,0,0,1,4,-2,1,Trendon Watford,BKN,MIA,BKN,,,7,6,5,3
22023,1630570,22300178,"NOV 12, 2023",BKN vs. WAS,W,9,1,3,0.333,0,0,0.0,0,0,0.0,0,3,3,1,0,0,1,2,2,-3,1,Trendon Watford,BKN,BKN,WAS,,,6,5,3,4
22023,1630570,22300010,"NOV 10, 2023",BKN @ BOS,L,27,6,11,0.545,0,1,0.0,2,2,1.0,3,4,7,3,0,1,0,4,14,1,1,Trendon Watford,BKN,BOS,BKN,,,24,21,17,10
22023,1630570,22300160,"NOV 08, 2023",BKN vs. LAC,W,19,3,6,0.5,1,2,0.5,2,2,1.0,2,3,5,2,3,0,4,2,9,5,1,Trendon Watford,BKN,BKN,LAC,,,16,14,11,7
22023,1630570,22300136,"NOV 04, 2023",BKN vs. BOS,L,5,0,0,0.0,0,0,0.0,0,0,0.0,0,2,2,2,0,0,0,1,0,8,1,Trendon Watford,BKN,BKN,BOS,,,4,2,2,4
22023,1630570,22300119,"NOV 01, 2023",BKN @ MIA,W,14,4,6,0.667,1,2,0.5,2,2,1.0,1,3,4,4,1,0,1,2,11,19,1,Trendon Watford,BKN,MIA,BKN,,,19,15,15,8
22023,1631212,22300550,"JAN 14, 2024",DEN vs. IND,W,14,0,3,0.0,0,0,0.0,0,0,0.0,0,3,3,0,1,0,0,3,0,-1,1,Peyton Watson,DEN,DEN,IND,0.5,3-PT Made,3,3,0,3
22023,1631212,22300539,"JAN 12, 2024",DEN vs. NOP,W,15,3,7,0.429,2,4,0.5,0,0,0.0,1,2,3,0,1,1,0,1,8,9,1,Peyton Watson,DEN,DEN,NOP,0.5,3-PT Made,11,11,8,3
22023,1631212,22300524,"JAN 10, 2024",DEN @ UTA,L,17,1,8,0.125,1,5,0.2,0,0,0.0,1,1,2,0,0,0,0,1,3,-12,1,Peyton Watson,DEN,UTA,DEN,0.5,3-PT Made,5,5,3,2
22023,1631212,22300502,"JAN 07, 2024",DEN vs. DET,W,23,4,10,0.4,2,4,0.5,5,5,1.0,1,5,6,1,1,1,0,0,15,7,1,Peyton Watson,DEN,DEN,DET,0.5,3-PT Made,22,21,16,7
22023,1631212,22300488,"JAN 05, 2024",DEN vs. ORL,L,13,2,6,0.333,0,2,0.0,0,0,0.0,1,0,1,0,0,0,0,4,4,-16,1,Peyton Watson,DEN,DEN,ORL,0.5,3-PT Made,5,5,4,1
22023,1631212,22300478,"JAN 04, 2024",DEN @ GSW,W,19,6,10,0.6,2,4,0.5,5,6,0.833,1,4,5,0,0,0,0,1,19,7,1,Peyton Watson,DEN,GSW,DEN,0.5,3-PT Made,24,24,19,5
22023,1631212,22300455,"JAN 01, 2024",DEN vs. CHA,W,19,3,6,0.5,2,4,0.5,0,0,0.0,0,4,4,1,1,1,0,2,8,-5,1,Peyton Watson,DEN,DEN,CHA,0.5,3-PT Made,13,12,9,5
22023,1631212,22300435,"DEC 29, 2023",DEN vs. OKC,L,32,6,12,0.5,1,6,0.167,1,2,0.5,0,2,2,2,1,2,1,4,14,-7,1,Peyton Watson,DEN,DEN,OKC,0.5,3-PT Made,18,16,16,4
22023,1631212,22300425,"DEC 28, 2023",DEN vs. MEM,W,23,6,14,0.429,4,10,0.4,4,4,1.0,0,5,5,2,0,0,0,1,20,28,1,Peyton Watson,DEN,DEN,MEM,0.5,3-PT Made,27,25,22,7
22023,1631212,22300402,"DEC 25, 2023",DEN vs. GSW,W,21,2,5,0.4,1,2,0.5,0,0,0.0,0,0,0,1,0,0,2,2,5,-11,1,Peyton Watson,DEN,DEN,GSW,0.5,3-PT Made,6,5,6,1
22023,1631212,22300390,"DEC 23, 2023",DEN @ CHA,W,17,1,2,0.5,0,1,0.0,0,0,0.0,0,3,3,0,1,1,1,2,2,-3,1,Peyton Watson,DEN,CHA,DEN,0.5,3-PT Made,5,5,2,3
22023,1631212,22300383,"DEC 22, 2023",DEN @ BKN,W,20,4,5,0.8,1,2,0.5,0,1,0.0,0,3,3,0,0,0,0,2,9,-14,1,Peyton Watson,DEN,BKN,DEN,0.5,3-PT Made,12,12,9,3
22023,1631212,22300369,"DEC 20, 2023",DEN @ TOR,W,18,5,6,0.833,1,1,1.0,0,0,0.0,1,3,4,1,1,1,0,1,11,-5,1,Peyton Watson,DEN,TOR,DEN,0.5,3-PT Made,16,15,12,5
22023,1631212,22300356,"DEC 18, 2023",DEN vs. DAL,W,24,3,5,0.6,2,3,0.667,2,4,0.5,1,6,7,3,1,1,0,1,10,8,1,Peyton Watson,DEN,DEN,DAL,0.5,3-PT Made,20,17,13,10
22023,1631212,22300340,"DEC 16, 2023",DEN vs. OKC,L,16,5,8,0.625,2,2,1.0,1,2,0.5,1,3,4,0,0,0,1,5,13,3,1,Peyton Watson,DEN,DEN,OKC,0.5,3-PT Made,17,17,13,4
22023,1631212,22300322,"DEC 14, 2023",DEN vs. BKN,W,24,7,10,0.7,2,5,0.4,2,3,0.667,3,4,7,5,1,1,1,3,18,7,1,Peyton Watson,DEN,DEN,BKN,0.5,3-PT Made,30,25,23,12
22023,1631212,22300307,"DEC 12, 2023",DEN @ CHI,W,23,1,6,0.167,0,0,0.0,2,2,1.0,1,0,1,1,1,1,1,1,4,7,1,Peyton Watson,DEN,CHI,DEN,0.5,3-PT Made,6,5,5,2
22023,1631212,22300296,"DEC 11, 2023",DEN @ ATL,W,20,1,2,0.5,0,0,0.0,1,2,0.5,1,1,2,0,0,1,0,2,3,-7,1,Peyton Watson,DEN,ATL,DEN,0.5,3-PT Made,5,5,3,2
22023,1631212,22301224,"DEC 08, 2023",DEN vs. HOU,L,26,4,9,0.444,0,1,0.0,5,5,1.0,1,3,4,2,0,0,1,3,13,4,1,Peyton Watson,DEN,DEN,HOU,0.5,3-PT Made,19,17,15,6
22023,1631212,22301215,"DEC 06, 2023",DEN @ LAC,L,16,0,3,0.0,0,2,0.0,2,2,1.0,0,3,3,3,1,1,1,1,2,-15,1,Peyton Watson,DEN,LAC,DEN,0.5,3-PT Made,8,5,5,6
22023,1631212,22300290,"DEC 02, 2023",DEN @ SAC,L,14,1,1,1.0,0,0,0.0,2,2,1.0,0,1,1,1,1,2,0,2,4,8,1,Peyton Watson,DEN,SAC,DEN,0.5,3-PT Made,6,5,5,2
22023,1631212,22300279,"DEC 01, 2023",DEN @ PHX,W,25,4,9,0.444,0,2,0.0,0,0,0.0,0,3,3,0,0,0,0,5,8,5,1,Peyton Watson,DEN,PHX,DEN,0.5,3-PT Made,11,11,8,3
22023,1631212,22300257,"NOV 27, 2023",DEN @ LAC,W,24,4,7,0.571,0,0,0.0,0,2,0.0,0,3,3,1,2,1,1,0,8,2,1,Peyton Watson,DEN,LAC,DEN,0.5,3-PT Made,12,11,9,4
22023,1631212,22300252,"NOV 26, 2023",DEN vs. SAS,W,22,2,6,0.333,0,2,0.0,0,0,0.0,1,3,4,2,1,2,1,1,4,5,1,Peyton Watson,DEN,DEN,SAS,0.5,3-PT Made,10,8,6,6
22023,1631212,22300048,"NOV 24, 2023",DEN @ HOU,L,6,0,3,0.0,0,1,0.0,0,0,0.0,1,0,1,0,0,1,0,1,0,-18,1,Peyton Watson,DEN,HOU,DEN,0.5,3-PT Made,1,1,0,1
22023,1631212,22300226,"NOV 22, 2023",DEN @ ORL,L,10,1,1,1.0,0,0,0.0,0,2,0.0,1,0,1,0,0,0,0,1,2,-9,1,Peyton Watson,DEN,ORL,DEN,0.5,3-PT Made,3,3,2,1
22023,1631212,22300218,"NOV 20, 2023",DEN @ DET,W,13,1,2,0.5,0,0,0.0,2,2,1.0,0,1,1,2,0,2,1,1,4,5,1,Peyton Watson,DEN,DET,DEN,0.5,3-PT Made,7,5,6,3
22023,1631212,22300034,"NOV 17, 2023",DEN @ NOP,L,11,1,3,0.333,0,1,0.0,1,2,0.5,2,1,3,1,0,0,2,2,3,-2,1,Peyton Watson,DEN,NOP,DEN,0.5,3-PT Made,7,6,4,4
22023,1631212,22300024,"NOV 14, 2023",DEN vs. LAC,W,11,2,2,1.0,0,0,0.0,0,0,0.0,0,0,0,0,0,0,0,1,4,2,1,Peyton Watson,DEN,DEN,LAC,0.5,3-PT Made,4,4,4,0
22023,1631212,22300182,"NOV 12, 2023",DEN @ HOU,L,7,0,2,0.0,0,0,0.0,0,0,0.0,0,0,0,1,0,1,0,2,0,-6,1,Peyton Watson,DEN,HOU,DEN,0.5,3-PT Made,1,0,1,1
22023,1631212,22300169,"NOV 08, 2023",DEN vs. GSW,W,11,1,2,0.5,0,0,0.0,0,0,0.0,0,0,0,0,0,0,0,0,2,-8,1,Peyton Watson,DEN,DEN,GSW,0.5,3-PT Made,2,2,2,0
22023,1631212,22300156,"NOV 06, 2023",DEN vs. NOP,W,19,2,3,0.667,0,0,0.0,0,0,0.0,0,3,3,1,2,2,0,0,4,15,1,Peyton Watson,DEN,DEN,NOP,0.5,3-PT Made,8,7,5,4
22023,1631212,22300139,"NOV 04, 2023",DEN vs. CHI,W,18,1,3,0.333,0,1,0.0,0,0,0.0,0,2,2,2,2,0,2,2,2,-8,1,Peyton Watson,DEN,DEN,CHI,0.5,3-PT Made,6,4,4,4
22023,1631212,22300006,"NOV 03, 2023",DEN vs. DAL,W,13,1,4,0.25,0,1,0.0,1,2,0.5,2,1,3,1,0,2,0,2,3,-14,1,Peyton Watson,DEN,DEN,DAL,0.5,3-PT Made,7,6,4,4
22023,1631212,22300123,"NOV 01, 2023",DEN @ MIN,L,16,2,3,0.667,0,1,0.0,0,0,0.0,0,2,2,1,0,0,2,2,4,-6,1,Peyton Watson,DEN,MIN,DEN,0.5,3-PT Made,7,6,5,3
22023,1631212,22300110,"OCT 30, 2023",DEN vs. UTA,W,15,2,4,0.5,0,1,0.0,1,2,0.5,0,2,2,0,0,1,0,0,5,0,1,Peyton Watson,DEN,DEN,UTA,0.5,3-PT Made,7,7,5,2
22023,1631212,22300095,"OCT 29, 2023",DEN @ OKC,W,22,8,11,0.727,1,3,0.333,0,0,0.0,1,3,4,1,1,1,0,1,17,11,1,Peyton Watson,DEN,OKC,DEN,0.5,3-PT Made,22,21,18,5
22023,1631212,22300078,"OCT 27, 2023",DEN @ MEM,W,18,3,4,0.75,2,3,0.667,1,2,0.5,0,3,3,0,1,3,1,3,9,-4,1,Peyton Watson,DEN,MEM,DEN,0.5,3-PT Made,12,12,9,3
22023,1631212,22300061,"OCT 24, 2023",DEN vs. LAL,W,11,1,3,0.333,1,3,0.333,0,0,0.0,0,0,0,0,0,1,1,1,3,1,1,Peyton Watson,DEN,DEN,LAL,0.5,3-PT Made,3,3,3,0
22023,1641705,22300559,"JAN 15, 2024",SAS @ ATL,L,27,12,18,0.667,1,5,0.2,1,1,1.0,2,11,13,2,2,5,3,2,26,-2,1,Victor Wembanyama,SAS,ATL,SAS,,,41,39,28,15
22023,1641705,22300541,"JAN 12, 2024",SAS vs. CHA,W,20,9,14,0.643,2,3,0.667,6,6,1.0,3,8,11,1,0,2,3,2,26,22,1,Victor Wembanyama,SAS,SAS,CHA,,,38,37,27,12
22023,1641705,22300519,"JAN 10, 2024",SAS @ DET,W,21,6,16,0.375,0,4,0.0,4,5,0.8,3,9,12,10,0,0,0,1,16,15,1,Victor Wembanyama,SAS,DET,SAS,,,38,28,26,22
22023,1641705,22300497,"JAN 07, 2024",SAS @ CLE,L,25,6,13,0.462,2,5,0.4,10,11,0.909,0,10,10,3,1,5,3,3,24,17,1,Victor Wembanyama,SAS,CLE,SAS,,,37,34,27,13
22023,1641705,22300477,"JAN 04, 2024",SAS vs. MIL,L,26,10,18,0.556,2,8,0.25,5,6,0.833,3,6,9,1,1,5,5,5,27,-11,1,Victor Wembanyama,SAS,SAS,MIL,,,37,36,28,10
22023,1641705,22300460,"JAN 02, 2024",SAS @ MEM,L,26,8,16,0.5,2,5,0.4,2,4,0.5,0,7,7,1,0,4,1,0,20,-12,1,Victor Wembanyama,SAS,MEM,SAS,,,28,27,21,8
22023,1641705,22300448,"DEC 31, 2023",SAS vs. BOS,L,24,8,16,0.5,3,8,0.375,2,2,1.0,2,5,7,3,0,1,3,0,21,-23,1,Victor Wembanyama,SAS,SAS,BOS,,,31,28,24,10
22023,1641705,22300427,"DEC 28, 2023",SAS @ POR,W,24,9,14,0.643,2,4,0.5,10,10,1.0,0,6,6,6,0,7,1,0,30,18,1,Victor Wembanyama,SAS,POR,SAS,,,42,36,36,12
22023,1641705,22300412,"DEC 26, 2023",SAS vs. UTA,L,24,6,15,0.4,1,4,0.25,2,3,0.667,2,5,7,4,1,5,4,1,15,-9,1,Victor Wembanyama,SAS,SAS,UTA,,,26,22,19,11
22023,1641705,22300376,"DEC 21, 2023",SAS @ CHI,L,22,3,8,0.375,0,1,0.0,1,3,0.333,0,5,5,5,2,3,2,0,7,-7,1,Victor Wembanyama,SAS,CHI,SAS,,,17,12,12,10
22023,1641705,22300345,"DEC 17, 2023",SAS vs. NOP,L,31,6,13,0.462,2,6,0.333,3,4,0.75,1,12,13,4,1,4,3,2,17,-14,1,Victor Wembanyama,SAS,SAS,NOP,,,34,30,21,17
22023,1641705,22300331,"DEC 15, 2023",SAS vs. LAL,W,31,5,13,0.385,1,2,0.5,2,3,0.667,3,12,15,5,2,2,2,3,13,19,1,Victor Wembanyama,SAS,SAS,LAL,,,33,28,18,20
22023,1641705,22300316,"DEC 13, 2023",SAS vs. LAL,L,32,11,21,0.524,4,5,0.8,4,7,0.571,4,9,13,2,3,6,5,6,30,-5,1,Victor Wembanyama,SAS,SAS,LAL,,,45,43,32,15
22023,1641705,22300298,"DEC 11, 2023",SAS @ HOU,L,33,7,15,0.467,1,6,0.167,0,1,0.0,2,16,18,3,0,5,5,3,15,-12,1,Victor Wembanyama,SAS,HOU,SAS,,,36,33,18,21
22023,1641705,22301223,"DEC 08, 2023",SAS vs. CHI,L,32,8,20,0.4,0,4,0.0,5,6,0.833,7,13,20,4,1,4,1,2,21,-22,1,Victor Wembanyama,SAS,SAS,CHI,,,45,41,25,24
22023,1641705,22301210,"DEC 06, 2023",SAS @ MIN,L,32,4,13,0.308,0,2,0.0,4,6,0.667,3,7,10,1,1,1,2,1,12,4,1,Victor Wembanyama,SAS,MIN,SAS,,,23,22,13,11
22023,1641705,22300272,"NOV 30, 2023",SAS vs. ATL,L,29,9,16,0.563,1,5,0.2,2,2,1.0,2,10,12,2,2,4,2,1,21,0,1,Victor Wembanyama,SAS,SAS,ATL,,,35,33,23,14
22023,1641705,22300252,"NOV 26, 2023",SAS @ DEN,L,25,7,17,0.412,2,5,0.4,6,7,0.857,4,7,11,2,6,4,3,4,22,-10,1,Victor Wembanyama,SAS,DEN,SAS,,,35,33,24,13
22023,1641705,22300051,"NOV 24, 2023",SAS @ GSW,L,35,8,18,0.444,1,6,0.167,5,5,1.0,2,7,9,4,1,2,6,2,22,2,1,Victor Wembanyama,SAS,GSW,SAS,,,35,31,26,13
22023,1641705,22300235,"NOV 22, 2023",SAS vs. LAC,L,33,7,13,0.538,1,2,0.5,7,7,1.0,2,13,15,3,1,3,2,2,22,-3,1,Victor Wembanyama,SAS,SAS,LAC,,,40,37,25,18
22023,1641705,22300223,"NOV 20, 2023",SAS vs. LAC,L,27,4,12,0.333,0,4,0.0,1,1,1.0,0,3,3,4,0,2,1,1,9,-17,1,Victor Wembanyama,SAS,SAS,LAC,,,16,12,13,7
22023,1641705,22300206,"NOV 18, 2023",SAS vs. MEM,L,31,6,17,0.353,2,6,0.333,5,6,0.833,4,9,13,4,1,8,2,5,19,-6,1,Victor Wembanyama,SAS,SAS,MEM,,,36,32,23,17
22023,1641705,22300032,"NOV 17, 2023",SAS vs. SAC,L,30,12,26,0.462,2,8,0.25,1,1,1.0,1,8,9,0,2,0,4,3,27,-31,1,Victor Wembanyama,SAS,SAS,SAC,,,36,36,27,9
22023,1641705,22300021,"NOV 14, 2023",SAS @ OKC,L,28,4,15,0.267,0,3,0.0,0,0,0.0,3,11,14,2,0,2,5,2,8,-31,1,Victor Wembanyama,SAS,OKC,SAS,,,24,22,10,16
22023,1641705,22300184,"NOV 12, 2023",SAS vs. MIA,L,34,8,22,0.364,2,9,0.222,0,0,0.0,1,10,11,7,1,1,7,3,18,5,1,Victor Wembanyama,SAS,SAS,MIA,,,36,29,25,18
22023,1641705,22300013,"NOV 10, 2023",SAS vs. MIN,L,35,12,21,0.571,3,7,0.429,2,4,0.5,1,8,9,4,1,4,3,5,29,3,1,Victor Wembanyama,SAS,SAS,MIN,,,42,38,33,13
22023,1641705,22300161,"NOV 08, 2023",SAS @ NYK,L,30,4,14,0.286,0,4,0.0,6,6,1.0,4,5,9,2,0,1,3,2,14,-25,1,Victor Wembanyama,SAS,NYK,SAS,,,25,23,16,11
22023,1641705,22300146,"NOV 06, 2023",SAS @ IND,L,21,3,12,0.25,2,5,0.4,5,6,0.833,1,9,10,0,1,2,2,1,13,-9,1,Victor Wembanyama,SAS,IND,SAS,,,23,23,13,10
22023,1641705,22300141,"NOV 05, 2023",SAS vs. TOR,L,38,7,16,0.438,2,7,0.286,4,5,0.8,2,7,9,4,1,5,2,1,20,-16,1,Victor Wembanyama,SAS,SAS,TOR,,,33,29,24,13
22023,1641705,22300131,"NOV 02, 2023",SAS @ PHX,W,34,15,26,0.577,3,6,0.5,5,6,0.833,2,8,10,2,1,2,2,3,38,21,1,Victor Wembanyama,SAS,PHX,SAS,,,50,48,40,12
22023,1641705,22300113,"OCT 31, 2023",SAS @ PHX,W,28,6,12,0.5,2,6,0.333,4,5,0.8,3,5,8,1,0,4,5,3,18,-3,1,Victor Wembanyama,SAS,PHX,SAS,,,27,26,19,9
22023,1641705,22300099,"OCT 29, 2023",SAS @ LAC,L,26,4,10,0.4,0,2,0.0,3,6,0.5,1,4,5,2,1,1,5,1,11,-14,1,Victor Wembanyama,SAS,LAC,SAS,,,18,16,13,7
22023,1641705,22300083,"OCT 27, 2023",SAS vs. HOU,W,31,7,19,0.368,0,6,0.0,7,8,0.875,5,7,12,1,3,3,4,2,21,9,1,Victor Wembanyama,SAS,SAS,HOU,,,34,33,22,13
22023,1641705,22300073,"OCT 25, 2023",SAS vs. DAL,L,23,6,9,0.667,3,5,0.6,0,1,0.0,0,5,5,2,2,1,5,5,15,0,1,Victor Wembanyama,SAS,SAS,DAL,,,22,20,17,7
22023,1631104,22300559,"JAN 15, 2024",SAS @ ATL,L,13,1,4,0.25,0,2,0.0,1,2,0.5,1,1,2,3,0,0,1,0,3,-6,1,Blake Wesley,SAS,ATL,SAS,,,8,5,6,5
22023,1631104,22300548,"JAN 13, 2024",SAS vs. CHI,L,11,1,3,0.333,0,2,0.0,0,0,0.0,0,1,1,3,0,0,0,2,2,5,1,Blake Wesley,SAS,SAS,CHI,,,6,3,5,4
22023,1631104,22300541,"JAN 12, 2024",SAS vs. CHA,W,17,2,3,0.667,0,0,0.0,0,0,0.0,0,2,2,3,1,0,0,3,4,3,1,Blake Wesley,SAS,SAS,CHA,,,9,6,7,5
22023,1631104,22300519,"JAN 10, 2024",SAS @ DET,W,6,4,4,1.0,0,0,0.0,1,1,1.0,0,1,1,0,0,0,0,2,9,4,1,Blake Wesley,SAS,DET,SAS,,,10,10,9,1
22023,1631104,22300497,"JAN 07, 2024",SAS @ CLE,L,12,1,2,0.5,0,1,0.0,1,2,0.5,0,2,2,0,0,0,2,1,3,-7,1,Blake Wesley,SAS,CLE,SAS,,,5,5,3,2
22023,1631104,22300477,"JAN 04, 2024",SAS vs. MIL,L,15,0,1,0.0,0,0,0.0,0,0,0.0,0,1,1,1,0,0,0,3,0,6,1,Blake Wesley,SAS,SAS,MIL,,,2,1,1,2
22023,1631104,22300460,"JAN 02, 2024",SAS @ MEM,L,21,5,8,0.625,0,2,0.0,0,2,0.0,0,1,1,1,2,0,1,4,10,-4,1,Blake Wesley,SAS,MEM,SAS,,,12,11,11,2
22023,1631104,22300448,"DEC 31, 2023",SAS vs. BOS,L,17,0,3,0.0,0,2,0.0,1,2,0.5,1,1,2,6,0,0,1,2,1,1,1,Blake Wesley,SAS,SAS,BOS,,,9,3,7,8
22023,1631104,22300427,"DEC 28, 2023",SAS @ POR,W,1,0,0,0.0,0,0,0.0,0,0,0.0,0,0,0,0,0,0,0,0,0,-2,1,Blake Wesley,SAS,POR,SAS,,,0,0,0,0
22023,1631104,22300412,"DEC 26, 2023",SAS vs. UTA,L,10,1,4,0.25,0,0,0.0,1,2,0.5,1,1,2,4,0,0,0,2,3,-2,1,Blake Wesley,SAS,SAS,UTA,,,9,5,7,6
22023,1631104,22300398,"DEC 23, 2023",SAS @ DAL,L,12,2,3,0.667,0,0,0.0,1,2,0.5,0,1,1,3,3,0,0,1,5,7,1,Blake Wesley,SAS,DAL,SAS,,,9,6,8,4
22023,1631104,22300376,"DEC 21, 2023",SAS @ CHI,L,3,1,1,1.0,0,0,0.0,1,2,0.5,0,0,0,2,0,0,0,0,3,1,1,Blake Wesley,SAS,CHI,SAS,,,5,3,5,2
22023,1631104,22300331,"DEC 15, 2023",SAS vs. LAL,W,2,0,0,0.0,0,0,0.0,0,0,0.0,0,0,0,1,0,0,0,0,0,-3,1,Blake Wesley,SAS,SAS,LAL,,,1,0,1,1
22023,1631104,22300278,"DEC 01, 2023",SAS @ NOP,L,3,0,0,0.0,0,0,0.0,0,0,0.0,0,0,0,2,0,0,0,0,0,1,1,Blake Wesley,SAS,NOP,SAS,,,2,0,2,2
22023,1631104,22300032,"NOV 17, 2023",SAS vs. SAC,L,4,0,0,0.0,0,0,0.0,0,0,0.0,0,0,0,0,0,0,0,1,0,-15,1,Blake Wesley,SAS,SAS,SAC,,,0,0,0,0
22023,1631104,22300161,"NOV 08, 2023",SAS @ NYK,L,3,2,3,0.667,0,0,0.0,0,0,0.0,1,1,2,1,0,0,0,0,4,0,1,Blake Wesley,SAS,NYK,SAS,,,7,6,5,3
22023,1631104,22300146,"NOV 06, 2023",SAS @ IND,L,8,1,4,0.25,0,0,0.0,0,0,0.0,0,0,0,1,0,0,0,2,2,-1,1,Blake Wesley,SAS,IND,SAS,,,3,2,3,1
22023,1631104,22300099,"OCT 29, 2023",SAS @ LAC,L,7,0,1,0.0,0,1,0.0,1,2,0.5,0,0,0,1,0,1,1,0,1,-13,1,Blake Wesley,SAS,LAC,SAS,,,2,1,2,1
22023,201566,22300553,"JAN 14, 2024",LAC @ MIN,L,29,3,8,0.375,2,2,1.0,4,5,0.8,3,5,8,13,2,0,3,4,12,2,1,Russell Westbrook,LAC,MIN,LAC,10.5,Points,33,20,25,21
22023,201566,22300553,"JAN 14, 2024",LAC @ MIN,L,29,3,8,0.375,2,2,1.0,4,5,0.8,3,5,8,13,2,0,3,4,12,2,1,Russell Westbrook,LAC,MIN,LAC,5.0,Rebounds,33,20,25,21
22023,201566,22300553,"JAN 14, 2024",LAC @ MIN,L,29,3,8,0.375,2,2,1.0,4,5,0.8,3,5,8,13,2,0,3,4,12,2,1,Russell Westbrook,LAC,MIN,LAC,21.0,Pts+Rebs+Asts,33,20,25,21
22023,201566,22300553,"JAN 14, 2024",LAC @ MIN,L,29,3,8,0.375,2,2,1.0,4,5,0.8,3,5,8,13,2,0,3,4,12,2,1,Russell Westbrook,LAC,MIN,LAC,4.5,Assists,33,20,25,21
22023,201566,22300553,"JAN 14, 2024",LAC @ MIN,L,29,3,8,0.375,2,2,1.0,4,5,0.8,3,5,8,13,2,0,3,4,12,2,1,Russell Westbrook,LAC,MIN,LAC,16.0,Pts+Rebs,33,20,25,21
22023,201566,22300553,"JAN 14, 2024",LAC @ MIN,L,29,3,8,0.375,2,2,1.0,4,5,0.8,3,5,8,13,2,0,3,4,12,2,1,Russell Westbrook,LAC,MIN,LAC,14.5,Pts+Asts,33,20,25,21
22023,201566,22300553,"JAN 14, 2024",LAC @ MIN,L,29,3,8,0.375,2,2,1.0,4,5,0.8,3,5,8,13,2,0,3,4,12,2,1,Russell Westbrook,LAC,MIN,LAC,0.5,3-PT Made,33,20,25,21
22023,201566,22300553,"JAN 14, 2024",LAC @ MIN,L,29,3,8,0.375,2,2,1.0,4,5,0.8,3,5,8,13,2,0,3,4,12,2,1,Russell Westbrook,LAC,MIN,LAC,10.0,Rebs+Asts,33,20,25,21
22023,201566,22300537,"JAN 12, 2024",LAC @ MEM,W,16,5,11,0.455,1,3,0.333,1,3,0.333,1,1,2,2,0,0,1,1,12,0,1,Russell Westbrook,LAC,MEM,LAC,10.5,Points,16,14,14,4
22023,201566,22300537,"JAN 12, 2024",LAC @ MEM,W,16,5,11,0.455,1,3,0.333,1,3,0.333,1,1,2,2,0,0,1,1,12,0,1,Russell Westbrook,LAC,MEM,LAC,5.0,Rebounds,16,14,14,4
22023,201566,22300537,"JAN 12, 2024",LAC @ MEM,W,16,5,11,0.455,1,3,0.333,1,3,0.333,1,1,2,2,0,0,1,1,12,0,1,Russell Westbrook,LAC,MEM,LAC,21.0,Pts+Rebs+Asts,16,14,14,4
22023,201566,22300537,"JAN 12, 2024",LAC @ MEM,W,16,5,11,0.455,1,3,0.333,1,3,0.333,1,1,2,2,0,0,1,1,12,0,1,Russell Westbrook,LAC,MEM,LAC,4.5,Assists,16,14,14,4
22023,201566,22300537,"JAN 12, 2024",LAC @ MEM,W,16,5,11,0.455,1,3,0.333,1,3,0.333,1,1,2,2,0,0,1,1,12,0,1,Russell Westbrook,LAC,MEM,LAC,16.0,Pts+Rebs,16,14,14,4
22023,201566,22300537,"JAN 12, 2024",LAC @ MEM,W,16,5,11,0.455,1,3,0.333,1,3,0.333,1,1,2,2,0,0,1,1,12,0,1,Russell Westbrook,LAC,MEM,LAC,14.5,Pts+Asts,16,14,14,4
22023,201566,22300537,"JAN 12, 2024",LAC @ MEM,W,16,5,11,0.455,1,3,0.333,1,3,0.333,1,1,2,2,0,0,1,1,12,0,1,Russell Westbrook,LAC,MEM,LAC,0.5,3-PT Made,16,14,14,4
22023,201566,22300537,"JAN 12, 2024",LAC @ MEM,W,16,5,11,0.455,1,3,0.333,1,3,0.333,1,1,2,2,0,0,1,1,12,0,1,Russell Westbrook,LAC,MEM,LAC,10.0,Rebs+Asts,16,14,14,4
22023,201566,22300526,"JAN 10, 2024",LAC vs. TOR,W,14,3,9,0.333,0,1,0.0,0,0,0.0,0,0,0,3,0,0,0,0,6,-2,1,Russell Westbrook,LAC,LAC,TOR,10.5,Points,9,6,9,3
22023,201566,22300526,"JAN 10, 2024",LAC vs. TOR,W,14,3,9,0.333,0,1,0.0,0,0,0.0,0,0,0,3,0,0,0,0,6,-2,1,Russell Westbrook,LAC,LAC,TOR,5.0,Rebounds,9,6,9,3
22023,201566,22300526,"JAN 10, 2024",LAC vs. TOR,W,14,3,9,0.333,0,1,0.0,0,0,0.0,0,0,0,3,0,0,0,0,6,-2,1,Russell Westbrook,LAC,LAC,TOR,21.0,Pts+Rebs+Asts,9,6,9,3
22023,201566,22300526,"JAN 10, 2024",LAC vs. TOR,W,14,3,9,0.333,0,1,0.0,0,0,0.0,0,0,0,3,0,0,0,0,6,-2,1,Russell Westbrook,LAC,LAC,TOR,4.5,Assists,9,6,9,3
22023,201566,22300526,"JAN 10, 2024",LAC vs. TOR,W,14,3,9,0.333,0,1,0.0,0,0,0.0,0,0,0,3,0,0,0,0,6,-2,1,Russell Westbrook,LAC,LAC,TOR,16.0,Pts+Rebs,9,6,9,3
22023,201566,22300526,"JAN 10, 2024",LAC vs. TOR,W,14,3,9,0.333,0,1,0.0,0,0,0.0,0,0,0,3,0,0,0,0,6,-2,1,Russell Westbrook,LAC,LAC,TOR,14.5,Pts+Asts,9,6,9,3
22023,201566,22300526,"JAN 10, 2024",LAC vs. TOR,W,14,3,9,0.333,0,1,0.0,0,0,0.0,0,0,0,3,0,0,0,0,6,-2,1,Russell Westbrook,LAC,LAC,TOR,0.5,3-PT Made,9,6,9,3
22023,201566,22300526,"JAN 10, 2024",LAC vs. TOR,W,14,3,9,0.333,0,1,0.0,0,0,0.0,0,0,0,3,0,0,0,0,6,-2,1,Russell Westbrook,LAC,LAC,TOR,10.0,Rebs+Asts,9,6,9,3
22023,201566,22300511,"JAN 08, 2024",LAC vs. PHX,W,15,3,6,0.5,0,1,0.0,3,3,1.0,2,0,2,7,2,0,1,2,9,-3,1,Russell Westbrook,LAC,LAC,PHX,10.5,Points,18,11,16,9
22023,201566,22300511,"JAN 08, 2024",LAC vs. PHX,W,15,3,6,0.5,0,1,0.0,3,3,1.0,2,0,2,7,2,0,1,2,9,-3,1,Russell Westbrook,LAC,LAC,PHX,5.0,Rebounds,18,11,16,9
22023,201566,22300511,"JAN 08, 2024",LAC vs. PHX,W,15,3,6,0.5,0,1,0.0,3,3,1.0,2,0,2,7,2,0,1,2,9,-3,1,Russell Westbrook,LAC,LAC,PHX,21.0,Pts+Rebs+Asts,18,11,16,9
22023,201566,22300511,"JAN 08, 2024",LAC vs. PHX,W,15,3,6,0.5,0,1,0.0,3,3,1.0,2,0,2,7,2,0,1,2,9,-3,1,Russell Westbrook,LAC,LAC,PHX,4.5,Assists,18,11,16,9
22023,201566,22300511,"JAN 08, 2024",LAC vs. PHX,W,15,3,6,0.5,0,1,0.0,3,3,1.0,2,0,2,7,2,0,1,2,9,-3,1,Russell Westbrook,LAC,LAC,PHX,16.0,Pts+Rebs,18,11,16,9
22023,201566,22300511,"JAN 08, 2024",LAC vs. PHX,W,15,3,6,0.5,0,1,0.0,3,3,1.0,2,0,2,7,2,0,1,2,9,-3,1,Russell Westbrook,LAC,LAC,PHX,14.5,Pts+Asts,18,11,16,9
22023,201566,22300511,"JAN 08, 2024",LAC vs. PHX,W,15,3,6,0.5,0,1,0.0,3,3,1.0,2,0,2,7,2,0,1,2,9,-3,1,Russell Westbrook,LAC,LAC,PHX,0.5,3-PT Made,18,11,16,9
22023,201566,22300511,"JAN 08, 2024",LAC vs. PHX,W,15,3,6,0.5,0,1,0.0,3,3,1.0,2,0,2,7,2,0,1,2,9,-3,1,Russell Westbrook,LAC,LAC,PHX,10.0,Rebs+Asts,18,11,16,9
22023,201566,22300505,"JAN 07, 2024",LAC @ LAL,L,19,3,9,0.333,1,4,0.25,0,0,0.0,0,1,1,3,1,0,0,1,7,-12,1,Russell Westbrook,LAC,LAL,LAC,10.5,Points,11,8,10,4
22023,201566,22300505,"JAN 07, 2024",LAC @ LAL,L,19,3,9,0.333,1,4,0.25,0,0,0.0,0,1,1,3,1,0,0,1,7,-12,1,Russell Westbrook,LAC,LAL,LAC,5.0,Rebounds,11,8,10,4
22023,201566,22300505,"JAN 07, 2024",LAC @ LAL,L,19,3,9,0.333,1,4,0.25,0,0,0.0,0,1,1,3,1,0,0,1,7,-12,1,Russell Westbrook,LAC,LAL,LAC,21.0,Pts+Rebs+Asts,11,8,10,4
22023,201566,22300505,"JAN 07, 2024",LAC @ LAL,L,19,3,9,0.333,1,4,0.25,0,0,0.0,0,1,1,3,1,0,0,1,7,-12,1,Russell Westbrook,LAC,LAL,LAC,4.5,Assists,11,8,10,4
22023,201566,22300505,"JAN 07, 2024",LAC @ LAL,L,19,3,9,0.333,1,4,0.25,0,0,0.0,0,1,1,3,1,0,0,1,7,-12,1,Russell Westbrook,LAC,LAL,LAC,16.0,Pts+Rebs,11,8,10,4
22023,201566,22300505,"JAN 07, 2024",LAC @ LAL,L,19,3,9,0.333,1,4,0.25,0,0,0.0,0,1,1,3,1,0,0,1,7,-12,1,Russell Westbrook,LAC,LAL,LAC,14.5,Pts+Asts,11,8,10,4
22023,201566,22300505,"JAN 07, 2024",LAC @ LAL,L,19,3,9,0.333,1,4,0.25,0,0,0.0,0,1,1,3,1,0,0,1,7,-12,1,Russell Westbrook,LAC,LAL,LAC,0.5,3-PT Made,11,8,10,4
22023,201566,22300505,"JAN 07, 2024",LAC @ LAL,L,19,3,9,0.333,1,4,0.25,0,0,0.0,0,1,1,3,1,0,0,1,7,-12,1,Russell Westbrook,LAC,LAL,LAC,10.0,Rebs+Asts,11,8,10,4
22023,201566,22300486,"JAN 05, 2024",LAC @ NOP,W,22,3,6,0.5,1,3,0.333,1,2,0.5,2,3,5,5,2,2,4,2,8,7,1,Russell Westbrook,LAC,NOP,LAC,10.5,Points,18,13,13,10
22023,201566,22300486,"JAN 05, 2024",LAC @ NOP,W,22,3,6,0.5,1,3,0.333,1,2,0.5,2,3,5,5,2,2,4,2,8,7,1,Russell Westbrook,LAC,NOP,LAC,5.0,Rebounds,18,13,13,10
22023,201566,22300486,"JAN 05, 2024",LAC @ NOP,W,22,3,6,0.5,1,3,0.333,1,2,0.5,2,3,5,5,2,2,4,2,8,7,1,Russell Westbrook,LAC,NOP,LAC,21.0,Pts+Rebs+Asts,18,13,13,10
22023,201566,22300486,"JAN 05, 2024",LAC @ NOP,W,22,3,6,0.5,1,3,0.333,1,2,0.5,2,3,5,5,2,2,4,2,8,7,1,Russell Westbrook,LAC,NOP,LAC,4.5,Assists,18,13,13,10
22023,201566,22300486,"JAN 05, 2024",LAC @ NOP,W,22,3,6,0.5,1,3,0.333,1,2,0.5,2,3,5,5,2,2,4,2,8,7,1,Russell Westbrook,LAC,NOP,LAC,16.0,Pts+Rebs,18,13,13,10
22023,201566,22300486,"JAN 05, 2024",LAC @ NOP,W,22,3,6,0.5,1,3,0.333,1,2,0.5,2,3,5,5,2,2,4,2,8,7,1,Russell Westbrook,LAC,NOP,LAC,14.5,Pts+Asts,18,13,13,10
22023,201566,22300486,"JAN 05, 2024",LAC @ NOP,W,22,3,6,0.5,1,3,0.333,1,2,0.5,2,3,5,5,2,2,4,2,8,7,1,Russell Westbrook,LAC,NOP,LAC,0.5,3-PT Made,18,13,13,10
22023,201566,22300486,"JAN 05, 2024",LAC @ NOP,W,22,3,6,0.5,1,3,0.333,1,2,0.5,2,3,5,5,2,2,4,2,8,7,1,Russell Westbrook,LAC,NOP,LAC,10.0,Rebs+Asts,18,13,13,10
22023,201566,22300473,"JAN 03, 2024",LAC @ PHX,W,18,2,7,0.286,0,2,0.0,2,2,1.0,2,3,5,2,2,0,2,1,6,5,1,Russell Westbrook,LAC,PHX,LAC,10.5,Points,13,11,8,7
22023,201566,22300473,"JAN 03, 2024",LAC @ PHX,W,18,2,7,0.286,0,2,0.0,2,2,1.0,2,3,5,2,2,0,2,1,6,5,1,Russell Westbrook,LAC,PHX,LAC,5.0,Rebounds,13,11,8,7
22023,201566,22300473,"JAN 03, 2024",LAC @ PHX,W,18,2,7,0.286,0,2,0.0,2,2,1.0,2,3,5,2,2,0,2,1,6,5,1,Russell Westbrook,LAC,PHX,LAC,21.0,Pts+Rebs+Asts,13,11,8,7
22023,201566,22300473,"JAN 03, 2024",LAC @ PHX,W,18,2,7,0.286,0,2,0.0,2,2,1.0,2,3,5,2,2,0,2,1,6,5,1,Russell Westbrook,LAC,PHX,LAC,4.5,Assists,13,11,8,7
22023,201566,22300473,"JAN 03, 2024",LAC @ PHX,W,18,2,7,0.286,0,2,0.0,2,2,1.0,2,3,5,2,2,0,2,1,6,5,1,Russell Westbrook,LAC,PHX,LAC,16.0,Pts+Rebs,13,11,8,7
22023,201566,22300473,"JAN 03, 2024",LAC @ PHX,W,18,2,7,0.286,0,2,0.0,2,2,1.0,2,3,5,2,2,0,2,1,6,5,1,Russell Westbrook,LAC,PHX,LAC,14.5,Pts+Asts,13,11,8,7
22023,201566,22300473,"JAN 03, 2024",LAC @ PHX,W,18,2,7,0.286,0,2,0.0,2,2,1.0,2,3,5,2,2,0,2,1,6,5,1,Russell Westbrook,LAC,PHX,LAC,0.5,3-PT Made,13,11,8,7
22023,201566,22300473,"JAN 03, 2024",LAC @ PHX,W,18,2,7,0.286,0,2,0.0,2,2,1.0,2,3,5,2,2,0,2,1,6,5,1,Russell Westbrook,LAC,PHX,LAC,10.0,Rebs+Asts,13,11,8,7
22023,201566,22300458,"JAN 01, 2024",LAC vs. MIA,W,18,4,10,0.4,0,1,0.0,0,0,0.0,2,2,4,3,2,0,2,0,8,-4,1,Russell Westbrook,LAC,LAC,MIA,10.5,Points,15,12,11,7
22023,201566,22300458,"JAN 01, 2024",LAC vs. MIA,W,18,4,10,0.4,0,1,0.0,0,0,0.0,2,2,4,3,2,0,2,0,8,-4,1,Russell Westbrook,LAC,LAC,MIA,5.0,Rebounds,15,12,11,7
22023,201566,22300458,"JAN 01, 2024",LAC vs. MIA,W,18,4,10,0.4,0,1,0.0,0,0,0.0,2,2,4,3,2,0,2,0,8,-4,1,Russell Westbrook,LAC,LAC,MIA,21.0,Pts+Rebs+Asts,15,12,11,7
22023,201566,22300458,"JAN 01, 2024",LAC vs. MIA,W,18,4,10,0.4,0,1,0.0,0,0,0.0,2,2,4,3,2,0,2,0,8,-4,1,Russell Westbrook,LAC,LAC,MIA,4.5,Assists,15,12,11,7
22023,201566,22300458,"JAN 01, 2024",LAC vs. MIA,W,18,4,10,0.4,0,1,0.0,0,0,0.0,2,2,4,3,2,0,2,0,8,-4,1,Russell Westbrook,LAC,LAC,MIA,16.0,Pts+Rebs,15,12,11,7
22023,201566,22300458,"JAN 01, 2024",LAC vs. MIA,W,18,4,10,0.4,0,1,0.0,0,0,0.0,2,2,4,3,2,0,2,0,8,-4,1,Russell Westbrook,LAC,LAC,MIA,14.5,Pts+Asts,15,12,11,7
22023,201566,22300458,"JAN 01, 2024",LAC vs. MIA,W,18,4,10,0.4,0,1,0.0,0,0,0.0,2,2,4,3,2,0,2,0,8,-4,1,Russell Westbrook,LAC,LAC,MIA,0.5,3-PT Made,15,12,11,7
22023,201566,22300458,"JAN 01, 2024",LAC vs. MIA,W,18,4,10,0.4,0,1,0.0,0,0,0.0,2,2,4,3,2,0,2,0,8,-4,1,Russell Westbrook,LAC,LAC,MIA,10.0,Rebs+Asts,15,12,11,7
22023,201566,22300438,"DEC 29, 2023",LAC vs. MEM,W,20,6,9,0.667,2,4,0.5,0,0,0.0,1,5,6,6,0,0,4,1,14,2,1,Russell Westbrook,LAC,LAC,MEM,10.5,Points,26,20,20,12
22023,201566,22300438,"DEC 29, 2023",LAC vs. MEM,W,20,6,9,0.667,2,4,0.5,0,0,0.0,1,5,6,6,0,0,4,1,14,2,1,Russell Westbrook,LAC,LAC,MEM,5.0,Rebounds,26,20,20,12
22023,201566,22300438,"DEC 29, 2023",LAC vs. MEM,W,20,6,9,0.667,2,4,0.5,0,0,0.0,1,5,6,6,0,0,4,1,14,2,1,Russell Westbrook,LAC,LAC,MEM,21.0,Pts+Rebs+Asts,26,20,20,12
22023,201566,22300438,"DEC 29, 2023",LAC vs. MEM,W,20,6,9,0.667,2,4,0.5,0,0,0.0,1,5,6,6,0,0,4,1,14,2,1,Russell Westbrook,LAC,LAC,MEM,4.5,Assists,26,20,20,12
22023,201566,22300438,"DEC 29, 2023",LAC vs. MEM,W,20,6,9,0.667,2,4,0.5,0,0,0.0,1,5,6,6,0,0,4,1,14,2,1,Russell Westbrook,LAC,LAC,MEM,16.0,Pts+Rebs,26,20,20,12
22023,201566,22300438,"DEC 29, 2023",LAC vs. MEM,W,20,6,9,0.667,2,4,0.5,0,0,0.0,1,5,6,6,0,0,4,1,14,2,1,Russell Westbrook,LAC,LAC,MEM,14.5,Pts+Asts,26,20,20,12
22023,201566,22300438,"DEC 29, 2023",LAC vs. MEM,W,20,6,9,0.667,2,4,0.5,0,0,0.0,1,5,6,6,0,0,4,1,14,2,1,Russell Westbrook,LAC,LAC,MEM,0.5,3-PT Made,26,20,20,12
22023,201566,22300438,"DEC 29, 2023",LAC vs. MEM,W,20,6,9,0.667,2,4,0.5,0,0,0.0,1,5,6,6,0,0,4,1,14,2,1,Russell Westbrook,LAC,LAC,MEM,10.0,Rebs+Asts,26,20,20,12
22023,201566,22300414,"DEC 26, 2023",LAC vs. CHA,W,28,5,8,0.625,2,2,1.0,2,3,0.667,1,10,11,6,2,1,2,2,14,4,1,Russell Westbrook,LAC,LAC,CHA,10.5,Points,31,25,20,17
22023,201566,22300414,"DEC 26, 2023",LAC vs. CHA,W,28,5,8,0.625,2,2,1.0,2,3,0.667,1,10,11,6,2,1,2,2,14,4,1,Russell Westbrook,LAC,LAC,CHA,5.0,Rebounds,31,25,20,17
22023,201566,22300414,"DEC 26, 2023",LAC vs. CHA,W,28,5,8,0.625,2,2,1.0,2,3,0.667,1,10,11,6,2,1,2,2,14,4,1,Russell Westbrook,LAC,LAC,CHA,21.0,Pts+Rebs+Asts,31,25,20,17
22023,201566,22300414,"DEC 26, 2023",LAC vs. CHA,W,28,5,8,0.625,2,2,1.0,2,3,0.667,1,10,11,6,2,1,2,2,14,4,1,Russell Westbrook,LAC,LAC,CHA,4.5,Assists,31,25,20,17
22023,201566,22300414,"DEC 26, 2023",LAC vs. CHA,W,28,5,8,0.625,2,2,1.0,2,3,0.667,1,10,11,6,2,1,2,2,14,4,1,Russell Westbrook,LAC,LAC,CHA,16.0,Pts+Rebs,31,25,20,17
22023,201566,22300414,"DEC 26, 2023",LAC vs. CHA,W,28,5,8,0.625,2,2,1.0,2,3,0.667,1,10,11,6,2,1,2,2,14,4,1,Russell Westbrook,LAC,LAC,CHA,14.5,Pts+Asts,31,25,20,17
22023,201566,22300414,"DEC 26, 2023",LAC vs. CHA,W,28,5,8,0.625,2,2,1.0,2,3,0.667,1,10,11,6,2,1,2,2,14,4,1,Russell Westbrook,LAC,LAC,CHA,0.5,3-PT Made,31,25,20,17
22023,201566,22300414,"DEC 26, 2023",LAC vs. CHA,W,28,5,8,0.625,2,2,1.0,2,3,0.667,1,10,11,6,2,1,2,2,14,4,1,Russell Westbrook,LAC,LAC,CHA,10.0,Rebs+Asts,31,25,20,17
22023,201566,22300389,"DEC 23, 2023",LAC vs. BOS,L,21,4,11,0.364,0,2,0.0,4,4,1.0,1,4,5,5,0,1,1,3,12,0,1,Russell Westbrook,LAC,LAC,BOS,10.5,Points,22,17,17,10
22023,201566,22300389,"DEC 23, 2023",LAC vs. BOS,L,21,4,11,0.364,0,2,0.0,4,4,1.0,1,4,5,5,0,1,1,3,12,0,1,Russell Westbrook,LAC,LAC,BOS,5.0,Rebounds,22,17,17,10
22023,201566,22300389,"DEC 23, 2023",LAC vs. BOS,L,21,4,11,0.364,0,2,0.0,4,4,1.0,1,4,5,5,0,1,1,3,12,0,1,Russell Westbrook,LAC,LAC,BOS,21.0,Pts+Rebs+Asts,22,17,17,10
22023,201566,22300389,"DEC 23, 2023",LAC vs. BOS,L,21,4,11,0.364,0,2,0.0,4,4,1.0,1,4,5,5,0,1,1,3,12,0,1,Russell Westbrook,LAC,LAC,BOS,4.5,Assists,22,17,17,10
22023,201566,22300389,"DEC 23, 2023",LAC vs. BOS,L,21,4,11,0.364,0,2,0.0,4,4,1.0,1,4,5,5,0,1,1,3,12,0,1,Russell Westbrook,LAC,LAC,BOS,16.0,Pts+Rebs,22,17,17,10
22023,201566,22300389,"DEC 23, 2023",LAC vs. BOS,L,21,4,11,0.364,0,2,0.0,4,4,1.0,1,4,5,5,0,1,1,3,12,0,1,Russell Westbrook,LAC,LAC,BOS,14.5,Pts+Asts,22,17,17,10
22023,201566,22300389,"DEC 23, 2023",LAC vs. BOS,L,21,4,11,0.364,0,2,0.0,4,4,1.0,1,4,5,5,0,1,1,3,12,0,1,Russell Westbrook,LAC,LAC,BOS,0.5,3-PT Made,22,17,17,10
22023,201566,22300389,"DEC 23, 2023",LAC vs. BOS,L,21,4,11,0.364,0,2,0.0,4,4,1.0,1,4,5,5,0,1,1,3,12,0,1,Russell Westbrook,LAC,LAC,BOS,10.0,Rebs+Asts,22,17,17,10
22023,201566,22300379,"DEC 21, 2023",LAC @ OKC,L,30,7,12,0.583,0,2,0.0,1,1,1.0,4,9,13,4,0,0,5,3,15,-5,1,Russell Westbrook,LAC,OKC,LAC,10.5,Points,32,28,19,17
22023,201566,22300379,"DEC 21, 2023",LAC @ OKC,L,30,7,12,0.583,0,2,0.0,1,1,1.0,4,9,13,4,0,0,5,3,15,-5,1,Russell Westbrook,LAC,OKC,LAC,5.0,Rebounds,32,28,19,17
22023,201566,22300379,"DEC 21, 2023",LAC @ OKC,L,30,7,12,0.583,0,2,0.0,1,1,1.0,4,9,13,4,0,0,5,3,15,-5,1,Russell Westbrook,LAC,OKC,LAC,21.0,Pts+Rebs+Asts,32,28,19,17
22023,201566,22300379,"DEC 21, 2023",LAC @ OKC,L,30,7,12,0.583,0,2,0.0,1,1,1.0,4,9,13,4,0,0,5,3,15,-5,1,Russell Westbrook,LAC,OKC,LAC,4.5,Assists,32,28,19,17
22023,201566,22300379,"DEC 21, 2023",LAC @ OKC,L,30,7,12,0.583,0,2,0.0,1,1,1.0,4,9,13,4,0,0,5,3,15,-5,1,Russell Westbrook,LAC,OKC,LAC,16.0,Pts+Rebs,32,28,19,17
22023,201566,22300379,"DEC 21, 2023",LAC @ OKC,L,30,7,12,0.583,0,2,0.0,1,1,1.0,4,9,13,4,0,0,5,3,15,-5,1,Russell Westbrook,LAC,OKC,LAC,14.5,Pts+Asts,32,28,19,17
22023,201566,22300379,"DEC 21, 2023",LAC @ OKC,L,30,7,12,0.583,0,2,0.0,1,1,1.0,4,9,13,4,0,0,5,3,15,-5,1,Russell Westbrook,LAC,OKC,LAC,0.5,3-PT Made,32,28,19,17
22023,201566,22300379,"DEC 21, 2023",LAC @ OKC,L,30,7,12,0.583,0,2,0.0,1,1,1.0,4,9,13,4,0,0,5,3,15,-5,1,Russell Westbrook,LAC,OKC,LAC,10.0,Rebs+Asts,32,28,19,17
22023,201566,22300372,"DEC 20, 2023",LAC @ DAL,W,23,5,9,0.556,0,2,0.0,0,0,0.0,0,6,6,3,2,0,2,3,10,15,1,Russell Westbrook,LAC,DAL,LAC,10.5,Points,19,16,13,9
22023,201566,22300372,"DEC 20, 2023",LAC @ DAL,W,23,5,9,0.556,0,2,0.0,0,0,0.0,0,6,6,3,2,0,2,3,10,15,1,Russell Westbrook,LAC,DAL,LAC,5.0,Rebounds,19,16,13,9
22023,201566,22300372,"DEC 20, 2023",LAC @ DAL,W,23,5,9,0.556,0,2,0.0,0,0,0.0,0,6,6,3,2,0,2,3,10,15,1,Russell Westbrook,LAC,DAL,LAC,21.0,Pts+Rebs+Asts,19,16,13,9
22023,201566,22300372,"DEC 20, 2023",LAC @ DAL,W,23,5,9,0.556,0,2,0.0,0,0,0.0,0,6,6,3,2,0,2,3,10,15,1,Russell Westbrook,LAC,DAL,LAC,4.5,Assists,19,16,13,9
22023,201566,22300372,"DEC 20, 2023",LAC @ DAL,W,23,5,9,0.556,0,2,0.0,0,0,0.0,0,6,6,3,2,0,2,3,10,15,1,Russell Westbrook,LAC,DAL,LAC,16.0,Pts+Rebs,19,16,13,9
22023,201566,22300372,"DEC 20, 2023",LAC @ DAL,W,23,5,9,0.556,0,2,0.0,0,0,0.0,0,6,6,3,2,0,2,3,10,15,1,Russell Westbrook,LAC,DAL,LAC,14.5,Pts+Asts,19,16,13,9
22023,201566,22300372,"DEC 20, 2023",LAC @ DAL,W,23,5,9,0.556,0,2,0.0,0,0,0.0,0,6,6,3,2,0,2,3,10,15,1,Russell Westbrook,LAC,DAL,LAC,0.5,3-PT Made,19,16,13,9
22023,201566,22300372,"DEC 20, 2023",LAC @ DAL,W,23,5,9,0.556,0,2,0.0,0,0,0.0,0,6,6,3,2,0,2,3,10,15,1,Russell Westbrook,LAC,DAL,LAC,10.0,Rebs+Asts,19,16,13,9
22023,201566,22300350,"DEC 18, 2023",LAC @ IND,W,17,4,6,0.667,0,0,0.0,2,4,0.5,3,1,4,5,1,1,1,2,10,-2,1,Russell Westbrook,LAC,IND,LAC,10.5,Points,19,14,15,9
22023,201566,22300350,"DEC 18, 2023",LAC @ IND,W,17,4,6,0.667,0,0,0.0,2,4,0.5,3,1,4,5,1,1,1,2,10,-2,1,Russell Westbrook,LAC,IND,LAC,5.0,Rebounds,19,14,15,9
22023,201566,22300350,"DEC 18, 2023",LAC @ IND,W,17,4,6,0.667,0,0,0.0,2,4,0.5,3,1,4,5,1,1,1,2,10,-2,1,Russell Westbrook,LAC,IND,LAC,21.0,Pts+Rebs+Asts,19,14,15,9
22023,201566,22300350,"DEC 18, 2023",LAC @ IND,W,17,4,6,0.667,0,0,0.0,2,4,0.5,3,1,4,5,1,1,1,2,10,-2,1,Russell Westbrook,LAC,IND,LAC,4.5,Assists,19,14,15,9
22023,201566,22300350,"DEC 18, 2023",LAC @ IND,W,17,4,6,0.667,0,0,0.0,2,4,0.5,3,1,4,5,1,1,1,2,10,-2,1,Russell Westbrook,LAC,IND,LAC,16.0,Pts+Rebs,19,14,15,9
22023,201566,22300350,"DEC 18, 2023",LAC @ IND,W,17,4,6,0.667,0,0,0.0,2,4,0.5,3,1,4,5,1,1,1,2,10,-2,1,Russell Westbrook,LAC,IND,LAC,14.5,Pts+Asts,19,14,15,9
22023,201566,22300350,"DEC 18, 2023",LAC @ IND,W,17,4,6,0.667,0,0,0.0,2,4,0.5,3,1,4,5,1,1,1,2,10,-2,1,Russell Westbrook,LAC,IND,LAC,0.5,3-PT Made,19,14,15,9
22023,201566,22300350,"DEC 18, 2023",LAC @ IND,W,17,4,6,0.667,0,0,0.0,2,4,0.5,3,1,4,5,1,1,1,2,10,-2,1,Russell Westbrook,LAC,IND,LAC,10.0,Rebs+Asts,19,14,15,9
22023,201566,22300343,"DEC 16, 2023",LAC vs. NYK,W,15,4,7,0.571,0,1,0.0,2,4,0.5,3,3,6,4,1,0,0,1,10,2,1,Russell Westbrook,LAC,LAC,NYK,10.5,Points,20,16,14,10
22023,201566,22300343,"DEC 16, 2023",LAC vs. NYK,W,15,4,7,0.571,0,1,0.0,2,4,0.5,3,3,6,4,1,0,0,1,10,2,1,Russell Westbrook,LAC,LAC,NYK,5.0,Rebounds,20,16,14,10
22023,201566,22300343,"DEC 16, 2023",LAC vs. NYK,W,15,4,7,0.571,0,1,0.0,2,4,0.5,3,3,6,4,1,0,0,1,10,2,1,Russell Westbrook,LAC,LAC,NYK,21.0,Pts+Rebs+Asts,20,16,14,10
22023,201566,22300343,"DEC 16, 2023",LAC vs. NYK,W,15,4,7,0.571,0,1,0.0,2,4,0.5,3,3,6,4,1,0,0,1,10,2,1,Russell Westbrook,LAC,LAC,NYK,4.5,Assists,20,16,14,10
22023,201566,22300343,"DEC 16, 2023",LAC vs. NYK,W,15,4,7,0.571,0,1,0.0,2,4,0.5,3,3,6,4,1,0,0,1,10,2,1,Russell Westbrook,LAC,LAC,NYK,16.0,Pts+Rebs,20,16,14,10
22023,201566,22300343,"DEC 16, 2023",LAC vs. NYK,W,15,4,7,0.571,0,1,0.0,2,4,0.5,3,3,6,4,1,0,0,1,10,2,1,Russell Westbrook,LAC,LAC,NYK,14.5,Pts+Asts,20,16,14,10
22023,201566,22300343,"DEC 16, 2023",LAC vs. NYK,W,15,4,7,0.571,0,1,0.0,2,4,0.5,3,3,6,4,1,0,0,1,10,2,1,Russell Westbrook,LAC,LAC,NYK,0.5,3-PT Made,20,16,14,10
22023,201566,22300343,"DEC 16, 2023",LAC vs. NYK,W,15,4,7,0.571,0,1,0.0,2,4,0.5,3,3,6,4,1,0,0,1,10,2,1,Russell Westbrook,LAC,LAC,NYK,10.0,Rebs+Asts,20,16,14,10
22023,201566,22300325,"DEC 14, 2023",LAC vs. GSW,W,19,4,7,0.571,1,2,0.5,0,0,0.0,0,4,4,2,0,1,2,0,9,7,1,Russell Westbrook,LAC,LAC,GSW,10.5,Points,15,13,11,6
22023,201566,22300325,"DEC 14, 2023",LAC vs. GSW,W,19,4,7,0.571,1,2,0.5,0,0,0.0,0,4,4,2,0,1,2,0,9,7,1,Russell Westbrook,LAC,LAC,GSW,5.0,Rebounds,15,13,11,6
22023,201566,22300325,"DEC 14, 2023",LAC vs. GSW,W,19,4,7,0.571,1,2,0.5,0,0,0.0,0,4,4,2,0,1,2,0,9,7,1,Russell Westbrook,LAC,LAC,GSW,21.0,Pts+Rebs+Asts,15,13,11,6
22023,201566,22300325,"DEC 14, 2023",LAC vs. GSW,W,19,4,7,0.571,1,2,0.5,0,0,0.0,0,4,4,2,0,1,2,0,9,7,1,Russell Westbrook,LAC,LAC,GSW,4.5,Assists,15,13,11,6
22023,201566,22300325,"DEC 14, 2023",LAC vs. GSW,W,19,4,7,0.571,1,2,0.5,0,0,0.0,0,4,4,2,0,1,2,0,9,7,1,Russell Westbrook,LAC,LAC,GSW,16.0,Pts+Rebs,15,13,11,6
22023,201566,22300325,"DEC 14, 2023",LAC vs. GSW,W,19,4,7,0.571,1,2,0.5,0,0,0.0,0,4,4,2,0,1,2,0,9,7,1,Russell Westbrook,LAC,LAC,GSW,14.5,Pts+Asts,15,13,11,6
22023,201566,22300325,"DEC 14, 2023",LAC vs. GSW,W,19,4,7,0.571,1,2,0.5,0,0,0.0,0,4,4,2,0,1,2,0,9,7,1,Russell Westbrook,LAC,LAC,GSW,0.5,3-PT Made,15,13,11,6
22023,201566,22300325,"DEC 14, 2023",LAC vs. GSW,W,19,4,7,0.571,1,2,0.5,0,0,0.0,0,4,4,2,0,1,2,0,9,7,1,Russell Westbrook,LAC,LAC,GSW,10.0,Rebs+Asts,15,13,11,6
22023,201566,22300309,"DEC 12, 2023",LAC vs. SAC,W,20,4,8,0.5,0,1,0.0,0,0,0.0,2,5,7,3,0,0,4,0,8,12,1,Russell Westbrook,LAC,LAC,SAC,10.5,Points,18,15,11,10
22023,201566,22300309,"DEC 12, 2023",LAC vs. SAC,W,20,4,8,0.5,0,1,0.0,0,0,0.0,2,5,7,3,0,0,4,0,8,12,1,Russell Westbrook,LAC,LAC,SAC,5.0,Rebounds,18,15,11,10
22023,201566,22300309,"DEC 12, 2023",LAC vs. SAC,W,20,4,8,0.5,0,1,0.0,0,0,0.0,2,5,7,3,0,0,4,0,8,12,1,Russell Westbrook,LAC,LAC,SAC,21.0,Pts+Rebs+Asts,18,15,11,10
22023,201566,22300309,"DEC 12, 2023",LAC vs. SAC,W,20,4,8,0.5,0,1,0.0,0,0,0.0,2,5,7,3,0,0,4,0,8,12,1,Russell Westbrook,LAC,LAC,SAC,4.5,Assists,18,15,11,10
22023,201566,22300309,"DEC 12, 2023",LAC vs. SAC,W,20,4,8,0.5,0,1,0.0,0,0,0.0,2,5,7,3,0,0,4,0,8,12,1,Russell Westbrook,LAC,LAC,SAC,16.0,Pts+Rebs,18,15,11,10
22023,201566,22300309,"DEC 12, 2023",LAC vs. SAC,W,20,4,8,0.5,0,1,0.0,0,0,0.0,2,5,7,3,0,0,4,0,8,12,1,Russell Westbrook,LAC,LAC,SAC,14.5,Pts+Asts,18,15,11,10
22023,201566,22300309,"DEC 12, 2023",LAC vs. SAC,W,20,4,8,0.5,0,1,0.0,0,0,0.0,2,5,7,3,0,0,4,0,8,12,1,Russell Westbrook,LAC,LAC,SAC,0.5,3-PT Made,18,15,11,10
22023,201566,22300309,"DEC 12, 2023",LAC vs. SAC,W,20,4,8,0.5,0,1,0.0,0,0,0.0,2,5,7,3,0,0,4,0,8,12,1,Russell Westbrook,LAC,LAC,SAC,10.0,Rebs+Asts,18,15,11,10
22023,201566,22300304,"DEC 11, 2023",LAC vs. POR,W,16,5,7,0.714,1,2,0.5,1,2,0.5,1,1,2,6,0,1,4,1,12,0,1,Russell Westbrook,LAC,LAC,POR,10.5,Points,20,14,18,8
22023,201566,22300304,"DEC 11, 2023",LAC vs. POR,W,16,5,7,0.714,1,2,0.5,1,2,0.5,1,1,2,6,0,1,4,1,12,0,1,Russell Westbrook,LAC,LAC,POR,5.0,Rebounds,20,14,18,8
22023,201566,22300304,"DEC 11, 2023",LAC vs. POR,W,16,5,7,0.714,1,2,0.5,1,2,0.5,1,1,2,6,0,1,4,1,12,0,1,Russell Westbrook,LAC,LAC,POR,21.0,Pts+Rebs+Asts,20,14,18,8
22023,201566,22300304,"DEC 11, 2023",LAC vs. POR,W,16,5,7,0.714,1,2,0.5,1,2,0.5,1,1,2,6,0,1,4,1,12,0,1,Russell Westbrook,LAC,LAC,POR,4.5,Assists,20,14,18,8
22023,201566,22300304,"DEC 11, 2023",LAC vs. POR,W,16,5,7,0.714,1,2,0.5,1,2,0.5,1,1,2,6,0,1,4,1,12,0,1,Russell Westbrook,LAC,LAC,POR,16.0,Pts+Rebs,20,14,18,8
22023,201566,22300304,"DEC 11, 2023",LAC vs. POR,W,16,5,7,0.714,1,2,0.5,1,2,0.5,1,1,2,6,0,1,4,1,12,0,1,Russell Westbrook,LAC,LAC,POR,14.5,Pts+Asts,20,14,18,8
22023,201566,22300304,"DEC 11, 2023",LAC vs. POR,W,16,5,7,0.714,1,2,0.5,1,2,0.5,1,1,2,6,0,1,4,1,12,0,1,Russell Westbrook,LAC,LAC,POR,0.5,3-PT Made,20,14,18,8
22023,201566,22300304,"DEC 11, 2023",LAC vs. POR,W,16,5,7,0.714,1,2,0.5,1,2,0.5,1,1,2,6,0,1,4,1,12,0,1,Russell Westbrook,LAC,LAC,POR,10.0,Rebs+Asts,20,14,18,8
22023,201566,22301225,"DEC 08, 2023",LAC @ UTA,W,17,2,7,0.286,1,2,0.5,0,0,0.0,0,5,5,2,1,2,3,2,5,-5,1,Russell Westbrook,LAC,UTA,LAC,10.5,Points,12,10,7,7
22023,201566,22301225,"DEC 08, 2023",LAC @ UTA,W,17,2,7,0.286,1,2,0.5,0,0,0.0,0,5,5,2,1,2,3,2,5,-5,1,Russell Westbrook,LAC,UTA,LAC,5.0,Rebounds,12,10,7,7
22023,201566,22301225,"DEC 08, 2023",LAC @ UTA,W,17,2,7,0.286,1,2,0.5,0,0,0.0,0,5,5,2,1,2,3,2,5,-5,1,Russell Westbrook,LAC,UTA,LAC,21.0,Pts+Rebs+Asts,12,10,7,7
22023,201566,22301225,"DEC 08, 2023",LAC @ UTA,W,17,2,7,0.286,1,2,0.5,0,0,0.0,0,5,5,2,1,2,3,2,5,-5,1,Russell Westbrook,LAC,UTA,LAC,4.5,Assists,12,10,7,7
22023,201566,22301225,"DEC 08, 2023",LAC @ UTA,W,17,2,7,0.286,1,2,0.5,0,0,0.0,0,5,5,2,1,2,3,2,5,-5,1,Russell Westbrook,LAC,UTA,LAC,16.0,Pts+Rebs,12,10,7,7
22023,201566,22301225,"DEC 08, 2023",LAC @ UTA,W,17,2,7,0.286,1,2,0.5,0,0,0.0,0,5,5,2,1,2,3,2,5,-5,1,Russell Westbrook,LAC,UTA,LAC,14.5,Pts+Asts,12,10,7,7
22023,201566,22301225,"DEC 08, 2023",LAC @ UTA,W,17,2,7,0.286,1,2,0.5,0,0,0.0,0,5,5,2,1,2,3,2,5,-5,1,Russell Westbrook,LAC,UTA,LAC,0.5,3-PT Made,12,10,7,7
22023,201566,22301225,"DEC 08, 2023",LAC @ UTA,W,17,2,7,0.286,1,2,0.5,0,0,0.0,0,5,5,2,1,2,3,2,5,-5,1,Russell Westbrook,LAC,UTA,LAC,10.0,Rebs+Asts,12,10,7,7
22023,201566,22301215,"DEC 06, 2023",LAC vs. DEN,W,16,4,8,0.5,0,2,0.0,1,2,0.5,4,4,8,1,0,2,1,1,9,3,1,Russell Westbrook,LAC,LAC,DEN,10.5,Points,18,17,10,9
22023,201566,22301215,"DEC 06, 2023",LAC vs. DEN,W,16,4,8,0.5,0,2,0.0,1,2,0.5,4,4,8,1,0,2,1,1,9,3,1,Russell Westbrook,LAC,LAC,DEN,5.0,Rebounds,18,17,10,9
22023,201566,22301215,"DEC 06, 2023",LAC vs. DEN,W,16,4,8,0.5,0,2,0.0,1,2,0.5,4,4,8,1,0,2,1,1,9,3,1,Russell Westbrook,LAC,LAC,DEN,21.0,Pts+Rebs+Asts,18,17,10,9
22023,201566,22301215,"DEC 06, 2023",LAC vs. DEN,W,16,4,8,0.5,0,2,0.0,1,2,0.5,4,4,8,1,0,2,1,1,9,3,1,Russell Westbrook,LAC,LAC,DEN,4.5,Assists,18,17,10,9
22023,201566,22301215,"DEC 06, 2023",LAC vs. DEN,W,16,4,8,0.5,0,2,0.0,1,2,0.5,4,4,8,1,0,2,1,1,9,3,1,Russell Westbrook,LAC,LAC,DEN,16.0,Pts+Rebs,18,17,10,9
22023,201566,22301215,"DEC 06, 2023",LAC vs. DEN,W,16,4,8,0.5,0,2,0.0,1,2,0.5,4,4,8,1,0,2,1,1,9,3,1,Russell Westbrook,LAC,LAC,DEN,14.5,Pts+Asts,18,17,10,9
22023,201566,22301215,"DEC 06, 2023",LAC vs. DEN,W,16,4,8,0.5,0,2,0.0,1,2,0.5,4,4,8,1,0,2,1,1,9,3,1,Russell Westbrook,LAC,LAC,DEN,0.5,3-PT Made,18,17,10,9
22023,201566,22301215,"DEC 06, 2023",LAC vs. DEN,W,16,4,8,0.5,0,2,0.0,1,2,0.5,4,4,8,1,0,2,1,1,9,3,1,Russell Westbrook,LAC,LAC,DEN,10.0,Rebs+Asts,18,17,10,9
22023,201566,22300280,"DEC 02, 2023",LAC vs. GSW,W,19,2,5,0.4,2,4,0.5,2,4,0.5,0,6,6,2,0,1,0,0,8,-11,1,Russell Westbrook,LAC,LAC,GSW,10.5,Points,16,14,10,8
22023,201566,22300280,"DEC 02, 2023",LAC vs. GSW,W,19,2,5,0.4,2,4,0.5,2,4,0.5,0,6,6,2,0,1,0,0,8,-11,1,Russell Westbrook,LAC,LAC,GSW,5.0,Rebounds,16,14,10,8
22023,201566,22300280,"DEC 02, 2023",LAC vs. GSW,W,19,2,5,0.4,2,4,0.5,2,4,0.5,0,6,6,2,0,1,0,0,8,-11,1,Russell Westbrook,LAC,LAC,GSW,21.0,Pts+Rebs+Asts,16,14,10,8
22023,201566,22300280,"DEC 02, 2023",LAC vs. GSW,W,19,2,5,0.4,2,4,0.5,2,4,0.5,0,6,6,2,0,1,0,0,8,-11,1,Russell Westbrook,LAC,LAC,GSW,4.5,Assists,16,14,10,8
22023,201566,22300280,"DEC 02, 2023",LAC vs. GSW,W,19,2,5,0.4,2,4,0.5,2,4,0.5,0,6,6,2,0,1,0,0,8,-11,1,Russell Westbrook,LAC,LAC,GSW,16.0,Pts+Rebs,16,14,10,8
22023,201566,22300280,"DEC 02, 2023",LAC vs. GSW,W,19,2,5,0.4,2,4,0.5,2,4,0.5,0,6,6,2,0,1,0,0,8,-11,1,Russell Westbrook,LAC,LAC,GSW,14.5,Pts+Asts,16,14,10,8
22023,201566,22300280,"DEC 02, 2023",LAC vs. GSW,W,19,2,5,0.4,2,4,0.5,2,4,0.5,0,6,6,2,0,1,0,0,8,-11,1,Russell Westbrook,LAC,LAC,GSW,0.5,3-PT Made,16,14,10,8
22023,201566,22300280,"DEC 02, 2023",LAC vs. GSW,W,19,2,5,0.4,2,4,0.5,2,4,0.5,0,6,6,2,0,1,0,0,8,-11,1,Russell Westbrook,LAC,LAC,GSW,10.0,Rebs+Asts,16,14,10,8
22023,201566,22300273,"NOV 30, 2023",LAC @ GSW,L,26,5,13,0.385,0,3,0.0,4,6,0.667,6,5,11,6,0,0,0,1,14,-10,1,Russell Westbrook,LAC,GSW,LAC,10.5,Points,31,25,20,17
22023,201566,22300273,"NOV 30, 2023",LAC @ GSW,L,26,5,13,0.385,0,3,0.0,4,6,0.667,6,5,11,6,0,0,0,1,14,-10,1,Russell Westbrook,LAC,GSW,LAC,5.0,Rebounds,31,25,20,17
22023,201566,22300273,"NOV 30, 2023",LAC @ GSW,L,26,5,13,0.385,0,3,0.0,4,6,0.667,6,5,11,6,0,0,0,1,14,-10,1,Russell Westbrook,LAC,GSW,LAC,21.0,Pts+Rebs+Asts,31,25,20,17
22023,201566,22300273,"NOV 30, 2023",LAC @ GSW,L,26,5,13,0.385,0,3,0.0,4,6,0.667,6,5,11,6,0,0,0,1,14,-10,1,Russell Westbrook,LAC,GSW,LAC,4.5,Assists,31,25,20,17
22023,201566,22300273,"NOV 30, 2023",LAC @ GSW,L,26,5,13,0.385,0,3,0.0,4,6,0.667,6,5,11,6,0,0,0,1,14,-10,1,Russell Westbrook,LAC,GSW,LAC,16.0,Pts+Rebs,31,25,20,17
22023,201566,22300273,"NOV 30, 2023",LAC @ GSW,L,26,5,13,0.385,0,3,0.0,4,6,0.667,6,5,11,6,0,0,0,1,14,-10,1,Russell Westbrook,LAC,GSW,LAC,14.5,Pts+Asts,31,25,20,17
22023,201566,22300273,"NOV 30, 2023",LAC @ GSW,L,26,5,13,0.385,0,3,0.0,4,6,0.667,6,5,11,6,0,0,0,1,14,-10,1,Russell Westbrook,LAC,GSW,LAC,0.5,3-PT Made,31,25,20,17
22023,201566,22300273,"NOV 30, 2023",LAC @ GSW,L,26,5,13,0.385,0,3,0.0,4,6,0.667,6,5,11,6,0,0,0,1,14,-10,1,Russell Westbrook,LAC,GSW,LAC,10.0,Rebs+Asts,31,25,20,17
22023,201566,22300264,"NOV 29, 2023",LAC @ SAC,W,19,2,6,0.333,0,1,0.0,5,6,0.833,1,4,5,8,1,0,1,2,9,-3,1,Russell Westbrook,LAC,SAC,LAC,10.5,Points,22,14,17,13
22023,201566,22300264,"NOV 29, 2023",LAC @ SAC,W,19,2,6,0.333,0,1,0.0,5,6,0.833,1,4,5,8,1,0,1,2,9,-3,1,Russell Westbrook,LAC,SAC,LAC,5.0,Rebounds,22,14,17,13
22023,201566,22300264,"NOV 29, 2023",LAC @ SAC,W,19,2,6,0.333,0,1,0.0,5,6,0.833,1,4,5,8,1,0,1,2,9,-3,1,Russell Westbrook,LAC,SAC,LAC,21.0,Pts+Rebs+Asts,22,14,17,13
22023,201566,22300264,"NOV 29, 2023",LAC @ SAC,W,19,2,6,0.333,0,1,0.0,5,6,0.833,1,4,5,8,1,0,1,2,9,-3,1,Russell Westbrook,LAC,SAC,LAC,4.5,Assists,22,14,17,13
22023,201566,22300264,"NOV 29, 2023",LAC @ SAC,W,19,2,6,0.333,0,1,0.0,5,6,0.833,1,4,5,8,1,0,1,2,9,-3,1,Russell Westbrook,LAC,SAC,LAC,16.0,Pts+Rebs,22,14,17,13
22023,201566,22300264,"NOV 29, 2023",LAC @ SAC,W,19,2,6,0.333,0,1,0.0,5,6,0.833,1,4,5,8,1,0,1,2,9,-3,1,Russell Westbrook,LAC,SAC,LAC,14.5,Pts+Asts,22,14,17,13
22023,201566,22300264,"NOV 29, 2023",LAC @ SAC,W,19,2,6,0.333,0,1,0.0,5,6,0.833,1,4,5,8,1,0,1,2,9,-3,1,Russell Westbrook,LAC,SAC,LAC,0.5,3-PT Made,22,14,17,13
22023,201566,22300264,"NOV 29, 2023",LAC @ SAC,W,19,2,6,0.333,0,1,0.0,5,6,0.833,1,4,5,8,1,0,1,2,9,-3,1,Russell Westbrook,LAC,SAC,LAC,10.0,Rebs+Asts,22,14,17,13
22023,201566,22300257,"NOV 27, 2023",LAC vs. DEN,L,27,5,9,0.556,0,0,0.0,4,6,0.667,1,10,11,3,0,1,2,4,14,-11,1,Russell Westbrook,LAC,LAC,DEN,10.5,Points,28,25,17,14
22023,201566,22300257,"NOV 27, 2023",LAC vs. DEN,L,27,5,9,0.556,0,0,0.0,4,6,0.667,1,10,11,3,0,1,2,4,14,-11,1,Russell Westbrook,LAC,LAC,DEN,5.0,Rebounds,28,25,17,14
22023,201566,22300257,"NOV 27, 2023",LAC vs. DEN,L,27,5,9,0.556,0,0,0.0,4,6,0.667,1,10,11,3,0,1,2,4,14,-11,1,Russell Westbrook,LAC,LAC,DEN,21.0,Pts+Rebs+Asts,28,25,17,14
22023,201566,22300257,"NOV 27, 2023",LAC vs. DEN,L,27,5,9,0.556,0,0,0.0,4,6,0.667,1,10,11,3,0,1,2,4,14,-11,1,Russell Westbrook,LAC,LAC,DEN,4.5,Assists,28,25,17,14
22023,201566,22300257,"NOV 27, 2023",LAC vs. DEN,L,27,5,9,0.556,0,0,0.0,4,6,0.667,1,10,11,3,0,1,2,4,14,-11,1,Russell Westbrook,LAC,LAC,DEN,16.0,Pts+Rebs,28,25,17,14
22023,201566,22300257,"NOV 27, 2023",LAC vs. DEN,L,27,5,9,0.556,0,0,0.0,4,6,0.667,1,10,11,3,0,1,2,4,14,-11,1,Russell Westbrook,LAC,LAC,DEN,14.5,Pts+Asts,28,25,17,14
22023,201566,22300257,"NOV 27, 2023",LAC vs. DEN,L,27,5,9,0.556,0,0,0.0,4,6,0.667,1,10,11,3,0,1,2,4,14,-11,1,Russell Westbrook,LAC,LAC,DEN,0.5,3-PT Made,28,25,17,14
22023,201566,22300257,"NOV 27, 2023",LAC vs. DEN,L,27,5,9,0.556,0,0,0.0,4,6,0.667,1,10,11,3,0,1,2,4,14,-11,1,Russell Westbrook,LAC,LAC,DEN,10.0,Rebs+Asts,28,25,17,14
22023,201566,22300244,"NOV 25, 2023",LAC vs. DAL,W,25,6,9,0.667,0,1,0.0,2,3,0.667,4,4,8,7,0,0,2,2,14,1,1,Russell Westbrook,LAC,LAC,DAL,10.5,Points,29,22,21,15
22023,201566,22300244,"NOV 25, 2023",LAC vs. DAL,W,25,6,9,0.667,0,1,0.0,2,3,0.667,4,4,8,7,0,0,2,2,14,1,1,Russell Westbrook,LAC,LAC,DAL,5.0,Rebounds,29,22,21,15
22023,201566,22300244,"NOV 25, 2023",LAC vs. DAL,W,25,6,9,0.667,0,1,0.0,2,3,0.667,4,4,8,7,0,0,2,2,14,1,1,Russell Westbrook,LAC,LAC,DAL,21.0,Pts+Rebs+Asts,29,22,21,15
22023,201566,22300244,"NOV 25, 2023",LAC vs. DAL,W,25,6,9,0.667,0,1,0.0,2,3,0.667,4,4,8,7,0,0,2,2,14,1,1,Russell Westbrook,LAC,LAC,DAL,4.5,Assists,29,22,21,15
22023,201566,22300244,"NOV 25, 2023",LAC vs. DAL,W,25,6,9,0.667,0,1,0.0,2,3,0.667,4,4,8,7,0,0,2,2,14,1,1,Russell Westbrook,LAC,LAC,DAL,16.0,Pts+Rebs,29,22,21,15
22023,201566,22300244,"NOV 25, 2023",LAC vs. DAL,W,25,6,9,0.667,0,1,0.0,2,3,0.667,4,4,8,7,0,0,2,2,14,1,1,Russell Westbrook,LAC,LAC,DAL,14.5,Pts+Asts,29,22,21,15
22023,201566,22300244,"NOV 25, 2023",LAC vs. DAL,W,25,6,9,0.667,0,1,0.0,2,3,0.667,4,4,8,7,0,0,2,2,14,1,1,Russell Westbrook,LAC,LAC,DAL,0.5,3-PT Made,29,22,21,15
22023,201566,22300244,"NOV 25, 2023",LAC vs. DAL,W,25,6,9,0.667,0,1,0.0,2,3,0.667,4,4,8,7,0,0,2,2,14,1,1,Russell Westbrook,LAC,LAC,DAL,10.0,Rebs+Asts,29,22,21,15
22023,201566,22300052,"NOV 24, 2023",LAC vs. NOP,L,14,1,8,0.125,0,2,0.0,1,2,0.5,1,3,4,2,0,1,0,2,3,-8,1,Russell Westbrook,LAC,LAC,NOP,10.5,Points,9,7,5,6
22023,201566,22300052,"NOV 24, 2023",LAC vs. NOP,L,14,1,8,0.125,0,2,0.0,1,2,0.5,1,3,4,2,0,1,0,2,3,-8,1,Russell Westbrook,LAC,LAC,NOP,5.0,Rebounds,9,7,5,6
22023,201566,22300052,"NOV 24, 2023",LAC vs. NOP,L,14,1,8,0.125,0,2,0.0,1,2,0.5,1,3,4,2,0,1,0,2,3,-8,1,Russell Westbrook,LAC,LAC,NOP,21.0,Pts+Rebs+Asts,9,7,5,6
22023,201566,22300052,"NOV 24, 2023",LAC vs. NOP,L,14,1,8,0.125,0,2,0.0,1,2,0.5,1,3,4,2,0,1,0,2,3,-8,1,Russell Westbrook,LAC,LAC,NOP,4.5,Assists,9,7,5,6
22023,201566,22300052,"NOV 24, 2023",LAC vs. NOP,L,14,1,8,0.125,0,2,0.0,1,2,0.5,1,3,4,2,0,1,0,2,3,-8,1,Russell Westbrook,LAC,LAC,NOP,16.0,Pts+Rebs,9,7,5,6
22023,201566,22300052,"NOV 24, 2023",LAC vs. NOP,L,14,1,8,0.125,0,2,0.0,1,2,0.5,1,3,4,2,0,1,0,2,3,-8,1,Russell Westbrook,LAC,LAC,NOP,14.5,Pts+Asts,9,7,5,6
22023,201566,22300052,"NOV 24, 2023",LAC vs. NOP,L,14,1,8,0.125,0,2,0.0,1,2,0.5,1,3,4,2,0,1,0,2,3,-8,1,Russell Westbrook,LAC,LAC,NOP,0.5,3-PT Made,9,7,5,6
22023,201566,22300052,"NOV 24, 2023",LAC vs. NOP,L,14,1,8,0.125,0,2,0.0,1,2,0.5,1,3,4,2,0,1,0,2,3,-8,1,Russell Westbrook,LAC,LAC,NOP,10.0,Rebs+Asts,9,7,5,6
22023,201566,22300235,"NOV 22, 2023",LAC @ SAS,W,27,3,8,0.375,0,1,0.0,2,2,1.0,1,5,6,7,2,0,4,4,8,3,1,Russell Westbrook,LAC,SAS,LAC,10.5,Points,21,14,15,13
22023,201566,22300235,"NOV 22, 2023",LAC @ SAS,W,27,3,8,0.375,0,1,0.0,2,2,1.0,1,5,6,7,2,0,4,4,8,3,1,Russell Westbrook,LAC,SAS,LAC,5.0,Rebounds,21,14,15,13
22023,201566,22300235,"NOV 22, 2023",LAC @ SAS,W,27,3,8,0.375,0,1,0.0,2,2,1.0,1,5,6,7,2,0,4,4,8,3,1,Russell Westbrook,LAC,SAS,LAC,21.0,Pts+Rebs+Asts,21,14,15,13
22023,201566,22300235,"NOV 22, 2023",LAC @ SAS,W,27,3,8,0.375,0,1,0.0,2,2,1.0,1,5,6,7,2,0,4,4,8,3,1,Russell Westbrook,LAC,SAS,LAC,4.5,Assists,21,14,15,13
22023,201566,22300235,"NOV 22, 2023",LAC @ SAS,W,27,3,8,0.375,0,1,0.0,2,2,1.0,1,5,6,7,2,0,4,4,8,3,1,Russell Westbrook,LAC,SAS,LAC,16.0,Pts+Rebs,21,14,15,13
22023,201566,22300235,"NOV 22, 2023",LAC @ SAS,W,27,3,8,0.375,0,1,0.0,2,2,1.0,1,5,6,7,2,0,4,4,8,3,1,Russell Westbrook,LAC,SAS,LAC,14.5,Pts+Asts,21,14,15,13
22023,201566,22300235,"NOV 22, 2023",LAC @ SAS,W,27,3,8,0.375,0,1,0.0,2,2,1.0,1,5,6,7,2,0,4,4,8,3,1,Russell Westbrook,LAC,SAS,LAC,0.5,3-PT Made,21,14,15,13
22023,201566,22300235,"NOV 22, 2023",LAC @ SAS,W,27,3,8,0.375,0,1,0.0,2,2,1.0,1,5,6,7,2,0,4,4,8,3,1,Russell Westbrook,LAC,SAS,LAC,10.0,Rebs+Asts,21,14,15,13
22023,201566,22300223,"NOV 20, 2023",LAC @ SAS,W,25,4,11,0.364,0,1,0.0,2,4,0.5,0,2,2,6,3,0,0,1,10,7,1,Russell Westbrook,LAC,SAS,LAC,10.5,Points,18,12,16,8
22023,201566,22300223,"NOV 20, 2023",LAC @ SAS,W,25,4,11,0.364,0,1,0.0,2,4,0.5,0,2,2,6,3,0,0,1,10,7,1,Russell Westbrook,LAC,SAS,LAC,5.0,Rebounds,18,12,16,8
22023,201566,22300223,"NOV 20, 2023",LAC @ SAS,W,25,4,11,0.364,0,1,0.0,2,4,0.5,0,2,2,6,3,0,0,1,10,7,1,Russell Westbrook,LAC,SAS,LAC,21.0,Pts+Rebs+Asts,18,12,16,8
22023,201566,22300223,"NOV 20, 2023",LAC @ SAS,W,25,4,11,0.364,0,1,0.0,2,4,0.5,0,2,2,6,3,0,0,1,10,7,1,Russell Westbrook,LAC,SAS,LAC,4.5,Assists,18,12,16,8
22023,201566,22300223,"NOV 20, 2023",LAC @ SAS,W,25,4,11,0.364,0,1,0.0,2,4,0.5,0,2,2,6,3,0,0,1,10,7,1,Russell Westbrook,LAC,SAS,LAC,16.0,Pts+Rebs,18,12,16,8
22023,201566,22300223,"NOV 20, 2023",LAC @ SAS,W,25,4,11,0.364,0,1,0.0,2,4,0.5,0,2,2,6,3,0,0,1,10,7,1,Russell Westbrook,LAC,SAS,LAC,14.5,Pts+Asts,18,12,16,8
22023,201566,22300223,"NOV 20, 2023",LAC @ SAS,W,25,4,11,0.364,0,1,0.0,2,4,0.5,0,2,2,6,3,0,0,1,10,7,1,Russell Westbrook,LAC,SAS,LAC,0.5,3-PT Made,18,12,16,8
22023,201566,22300223,"NOV 20, 2023",LAC @ SAS,W,25,4,11,0.364,0,1,0.0,2,4,0.5,0,2,2,6,3,0,0,1,10,7,1,Russell Westbrook,LAC,SAS,LAC,10.0,Rebs+Asts,18,12,16,8
22023,201566,22300037,"NOV 17, 2023",LAC vs. HOU,W,17,2,9,0.222,2,6,0.333,2,4,0.5,0,3,3,2,0,0,2,1,8,-9,1,Russell Westbrook,LAC,LAC,HOU,10.5,Points,13,11,10,5
22023,201566,22300037,"NOV 17, 2023",LAC vs. HOU,W,17,2,9,0.222,2,6,0.333,2,4,0.5,0,3,3,2,0,0,2,1,8,-9,1,Russell Westbrook,LAC,LAC,HOU,5.0,Rebounds,13,11,10,5
22023,201566,22300037,"NOV 17, 2023",LAC vs. HOU,W,17,2,9,0.222,2,6,0.333,2,4,0.5,0,3,3,2,0,0,2,1,8,-9,1,Russell Westbrook,LAC,LAC,HOU,21.0,Pts+Rebs+Asts,13,11,10,5
22023,201566,22300037,"NOV 17, 2023",LAC vs. HOU,W,17,2,9,0.222,2,6,0.333,2,4,0.5,0,3,3,2,0,0,2,1,8,-9,1,Russell Westbrook,LAC,LAC,HOU,4.5,Assists,13,11,10,5
22023,201566,22300037,"NOV 17, 2023",LAC vs. HOU,W,17,2,9,0.222,2,6,0.333,2,4,0.5,0,3,3,2,0,0,2,1,8,-9,1,Russell Westbrook,LAC,LAC,HOU,16.0,Pts+Rebs,13,11,10,5
22023,201566,22300037,"NOV 17, 2023",LAC vs. HOU,W,17,2,9,0.222,2,6,0.333,2,4,0.5,0,3,3,2,0,0,2,1,8,-9,1,Russell Westbrook,LAC,LAC,HOU,14.5,Pts+Asts,13,11,10,5
22023,201566,22300037,"NOV 17, 2023",LAC vs. HOU,W,17,2,9,0.222,2,6,0.333,2,4,0.5,0,3,3,2,0,0,2,1,8,-9,1,Russell Westbrook,LAC,LAC,HOU,0.5,3-PT Made,13,11,10,5
22023,201566,22300037,"NOV 17, 2023",LAC vs. HOU,W,17,2,9,0.222,2,6,0.333,2,4,0.5,0,3,3,2,0,0,2,1,8,-9,1,Russell Westbrook,LAC,LAC,HOU,10.0,Rebs+Asts,13,11,10,5
22023,201566,22300024,"NOV 14, 2023",LAC @ DEN,L,24,4,12,0.333,0,1,0.0,0,0,0.0,1,5,6,3,2,0,3,3,8,1,1,Russell Westbrook,LAC,DEN,LAC,10.5,Points,17,14,11,9
22023,201566,22300024,"NOV 14, 2023",LAC @ DEN,L,24,4,12,0.333,0,1,0.0,0,0,0.0,1,5,6,3,2,0,3,3,8,1,1,Russell Westbrook,LAC,DEN,LAC,5.0,Rebounds,17,14,11,9
22023,201566,22300024,"NOV 14, 2023",LAC @ DEN,L,24,4,12,0.333,0,1,0.0,0,0,0.0,1,5,6,3,2,0,3,3,8,1,1,Russell Westbrook,LAC,DEN,LAC,21.0,Pts+Rebs+Asts,17,14,11,9
22023,201566,22300024,"NOV 14, 2023",LAC @ DEN,L,24,4,12,0.333,0,1,0.0,0,0,0.0,1,5,6,3,2,0,3,3,8,1,1,Russell Westbrook,LAC,DEN,LAC,4.5,Assists,17,14,11,9
22023,201566,22300024,"NOV 14, 2023",LAC @ DEN,L,24,4,12,0.333,0,1,0.0,0,0,0.0,1,5,6,3,2,0,3,3,8,1,1,Russell Westbrook,LAC,DEN,LAC,16.0,Pts+Rebs,17,14,11,9
22023,201566,22300024,"NOV 14, 2023",LAC @ DEN,L,24,4,12,0.333,0,1,0.0,0,0,0.0,1,5,6,3,2,0,3,3,8,1,1,Russell Westbrook,LAC,DEN,LAC,14.5,Pts+Asts,17,14,11,9
22023,201566,22300024,"NOV 14, 2023",LAC @ DEN,L,24,4,12,0.333,0,1,0.0,0,0,0.0,1,5,6,3,2,0,3,3,8,1,1,Russell Westbrook,LAC,DEN,LAC,0.5,3-PT Made,17,14,11,9
22023,201566,22300024,"NOV 14, 2023",LAC @ DEN,L,24,4,12,0.333,0,1,0.0,0,0,0.0,1,5,6,3,2,0,3,3,8,1,1,Russell Westbrook,LAC,DEN,LAC,10.0,Rebs+Asts,17,14,11,9
22023,201566,22300179,"NOV 12, 2023",LAC vs. MEM,L,31,5,13,0.385,1,4,0.25,1,2,0.5,1,8,9,5,3,0,4,3,12,10,1,Russell Westbrook,LAC,LAC,MEM,10.5,Points,26,21,17,14
22023,201566,22300179,"NOV 12, 2023",LAC vs. MEM,L,31,5,13,0.385,1,4,0.25,1,2,0.5,1,8,9,5,3,0,4,3,12,10,1,Russell Westbrook,LAC,LAC,MEM,5.0,Rebounds,26,21,17,14
22023,201566,22300179,"NOV 12, 2023",LAC vs. MEM,L,31,5,13,0.385,1,4,0.25,1,2,0.5,1,8,9,5,3,0,4,3,12,10,1,Russell Westbrook,LAC,LAC,MEM,21.0,Pts+Rebs+Asts,26,21,17,14
22023,201566,22300179,"NOV 12, 2023",LAC vs. MEM,L,31,5,13,0.385,1,4,0.25,1,2,0.5,1,8,9,5,3,0,4,3,12,10,1,Russell Westbrook,LAC,LAC,MEM,4.5,Assists,26,21,17,14
22023,201566,22300179,"NOV 12, 2023",LAC vs. MEM,L,31,5,13,0.385,1,4,0.25,1,2,0.5,1,8,9,5,3,0,4,3,12,10,1,Russell Westbrook,LAC,LAC,MEM,16.0,Pts+Rebs,26,21,17,14
22023,201566,22300179,"NOV 12, 2023",LAC vs. MEM,L,31,5,13,0.385,1,4,0.25,1,2,0.5,1,8,9,5,3,0,4,3,12,10,1,Russell Westbrook,LAC,LAC,MEM,14.5,Pts+Asts,26,21,17,14
22023,201566,22300179,"NOV 12, 2023",LAC vs. MEM,L,31,5,13,0.385,1,4,0.25,1,2,0.5,1,8,9,5,3,0,4,3,12,10,1,Russell Westbrook,LAC,LAC,MEM,0.5,3-PT Made,26,21,17,14
22023,201566,22300179,"NOV 12, 2023",LAC vs. MEM,L,31,5,13,0.385,1,4,0.25,1,2,0.5,1,8,9,5,3,0,4,3,12,10,1,Russell Westbrook,LAC,LAC,MEM,10.0,Rebs+Asts,26,21,17,14
22023,201566,22300014,"NOV 10, 2023",LAC @ DAL,L,20,5,11,0.455,0,1,0.0,4,5,0.8,2,3,5,2,3,0,2,1,14,-26,1,Russell Westbrook,LAC,DAL,LAC,10.5,Points,21,19,16,7
22023,201566,22300014,"NOV 10, 2023",LAC @ DAL,L,20,5,11,0.455,0,1,0.0,4,5,0.8,2,3,5,2,3,0,2,1,14,-26,1,Russell Westbrook,LAC,DAL,LAC,5.0,Rebounds,21,19,16,7
22023,201566,22300014,"NOV 10, 2023",LAC @ DAL,L,20,5,11,0.455,0,1,0.0,4,5,0.8,2,3,5,2,3,0,2,1,14,-26,1,Russell Westbrook,LAC,DAL,LAC,21.0,Pts+Rebs+Asts,21,19,16,7
22023,201566,22300014,"NOV 10, 2023",LAC @ DAL,L,20,5,11,0.455,0,1,0.0,4,5,0.8,2,3,5,2,3,0,2,1,14,-26,1,Russell Westbrook,LAC,DAL,LAC,4.5,Assists,21,19,16,7
22023,201566,22300014,"NOV 10, 2023",LAC @ DAL,L,20,5,11,0.455,0,1,0.0,4,5,0.8,2,3,5,2,3,0,2,1,14,-26,1,Russell Westbrook,LAC,DAL,LAC,16.0,Pts+Rebs,21,19,16,7
22023,201566,22300014,"NOV 10, 2023",LAC @ DAL,L,20,5,11,0.455,0,1,0.0,4,5,0.8,2,3,5,2,3,0,2,1,14,-26,1,Russell Westbrook,LAC,DAL,LAC,14.5,Pts+Asts,21,19,16,7
22023,201566,22300014,"NOV 10, 2023",LAC @ DAL,L,20,5,11,0.455,0,1,0.0,4,5,0.8,2,3,5,2,3,0,2,1,14,-26,1,Russell Westbrook,LAC,DAL,LAC,0.5,3-PT Made,21,19,16,7
22023,201566,22300014,"NOV 10, 2023",LAC @ DAL,L,20,5,11,0.455,0,1,0.0,4,5,0.8,2,3,5,2,3,0,2,1,14,-26,1,Russell Westbrook,LAC,DAL,LAC,10.0,Rebs+Asts,21,19,16,7
22023,201566,22300160,"NOV 08, 2023",LAC @ BKN,L,31,6,18,0.333,1,5,0.2,0,0,0.0,3,4,7,8,0,0,1,1,13,-5,1,Russell Westbrook,LAC,BKN,LAC,10.5,Points,28,20,21,15
22023,201566,22300160,"NOV 08, 2023",LAC @ BKN,L,31,6,18,0.333,1,5,0.2,0,0,0.0,3,4,7,8,0,0,1,1,13,-5,1,Russell Westbrook,LAC,BKN,LAC,5.0,Rebounds,28,20,21,15
22023,201566,22300160,"NOV 08, 2023",LAC @ BKN,L,31,6,18,0.333,1,5,0.2,0,0,0.0,3,4,7,8,0,0,1,1,13,-5,1,Russell Westbrook,LAC,BKN,LAC,21.0,Pts+Rebs+Asts,28,20,21,15
22023,201566,22300160,"NOV 08, 2023",LAC @ BKN,L,31,6,18,0.333,1,5,0.2,0,0,0.0,3,4,7,8,0,0,1,1,13,-5,1,Russell Westbrook,LAC,BKN,LAC,4.5,Assists,28,20,21,15
22023,201566,22300160,"NOV 08, 2023",LAC @ BKN,L,31,6,18,0.333,1,5,0.2,0,0,0.0,3,4,7,8,0,0,1,1,13,-5,1,Russell Westbrook,LAC,BKN,LAC,16.0,Pts+Rebs,28,20,21,15
22023,201566,22300160,"NOV 08, 2023",LAC @ BKN,L,31,6,18,0.333,1,5,0.2,0,0,0.0,3,4,7,8,0,0,1,1,13,-5,1,Russell Westbrook,LAC,BKN,LAC,14.5,Pts+Asts,28,20,21,15
22023,201566,22300160,"NOV 08, 2023",LAC @ BKN,L,31,6,18,0.333,1,5,0.2,0,0,0.0,3,4,7,8,0,0,1,1,13,-5,1,Russell Westbrook,LAC,BKN,LAC,0.5,3-PT Made,28,20,21,15
22023,201566,22300160,"NOV 08, 2023",LAC @ BKN,L,31,6,18,0.333,1,5,0.2,0,0,0.0,3,4,7,8,0,0,1,1,13,-5,1,Russell Westbrook,LAC,BKN,LAC,10.0,Rebs+Asts,28,20,21,15
22023,201566,22300151,"NOV 06, 2023",LAC @ NYK,L,31,8,13,0.615,1,3,0.333,0,0,0.0,0,4,4,4,0,0,4,2,17,-7,1,Russell Westbrook,LAC,NYK,LAC,10.5,Points,25,21,21,8
22023,201566,22300151,"NOV 06, 2023",LAC @ NYK,L,31,8,13,0.615,1,3,0.333,0,0,0.0,0,4,4,4,0,0,4,2,17,-7,1,Russell Westbrook,LAC,NYK,LAC,5.0,Rebounds,25,21,21,8
22023,201566,22300151,"NOV 06, 2023",LAC @ NYK,L,31,8,13,0.615,1,3,0.333,0,0,0.0,0,4,4,4,0,0,4,2,17,-7,1,Russell Westbrook,LAC,NYK,LAC,21.0,Pts+Rebs+Asts,25,21,21,8
22023,201566,22300151,"NOV 06, 2023",LAC @ NYK,L,31,8,13,0.615,1,3,0.333,0,0,0.0,0,4,4,4,0,0,4,2,17,-7,1,Russell Westbrook,LAC,NYK,LAC,4.5,Assists,25,21,21,8
22023,201566,22300151,"NOV 06, 2023",LAC @ NYK,L,31,8,13,0.615,1,3,0.333,0,0,0.0,0,4,4,4,0,0,4,2,17,-7,1,Russell Westbrook,LAC,NYK,LAC,16.0,Pts+Rebs,25,21,21,8
22023,201566,22300151,"NOV 06, 2023",LAC @ NYK,L,31,8,13,0.615,1,3,0.333,0,0,0.0,0,4,4,4,0,0,4,2,17,-7,1,Russell Westbrook,LAC,NYK,LAC,14.5,Pts+Asts,25,21,21,8
22023,201566,22300151,"NOV 06, 2023",LAC @ NYK,L,31,8,13,0.615,1,3,0.333,0,0,0.0,0,4,4,4,0,0,4,2,17,-7,1,Russell Westbrook,LAC,NYK,LAC,0.5,3-PT Made,25,21,21,8
22023,201566,22300151,"NOV 06, 2023",LAC @ NYK,L,31,8,13,0.615,1,3,0.333,0,0,0.0,0,4,4,4,0,0,4,2,17,-7,1,Russell Westbrook,LAC,NYK,LAC,10.0,Rebs+Asts,25,21,21,8
22023,201566,22300127,"NOV 01, 2023",LAC @ LAL,L,44,9,21,0.429,3,6,0.5,3,5,0.6,4,7,11,8,4,0,6,5,24,-8,1,Russell Westbrook,LAC,LAL,LAC,10.5,Points,43,35,32,19
22023,201566,22300127,"NOV 01, 2023",LAC @ LAL,L,44,9,21,0.429,3,6,0.5,3,5,0.6,4,7,11,8,4,0,6,5,24,-8,1,Russell Westbrook,LAC,LAL,LAC,5.0,Rebounds,43,35,32,19
22023,201566,22300127,"NOV 01, 2023",LAC @ LAL,L,44,9,21,0.429,3,6,0.5,3,5,0.6,4,7,11,8,4,0,6,5,24,-8,1,Russell Westbrook,LAC,LAL,LAC,21.0,Pts+Rebs+Asts,43,35,32,19
22023,201566,22300127,"NOV 01, 2023",LAC @ LAL,L,44,9,21,0.429,3,6,0.5,3,5,0.6,4,7,11,8,4,0,6,5,24,-8,1,Russell Westbrook,LAC,LAL,LAC,4.5,Assists,43,35,32,19
22023,201566,22300127,"NOV 01, 2023",LAC @ LAL,L,44,9,21,0.429,3,6,0.5,3,5,0.6,4,7,11,8,4,0,6,5,24,-8,1,Russell Westbrook,LAC,LAL,LAC,16.0,Pts+Rebs,43,35,32,19
22023,201566,22300127,"NOV 01, 2023",LAC @ LAL,L,44,9,21,0.429,3,6,0.5,3,5,0.6,4,7,11,8,4,0,6,5,24,-8,1,Russell Westbrook,LAC,LAL,LAC,14.5,Pts+Asts,43,35,32,19
22023,201566,22300127,"NOV 01, 2023",LAC @ LAL,L,44,9,21,0.429,3,6,0.5,3,5,0.6,4,7,11,8,4,0,6,5,24,-8,1,Russell Westbrook,LAC,LAL,LAC,0.5,3-PT Made,43,35,32,19
22023,201566,22300127,"NOV 01, 2023",LAC @ LAL,L,44,9,21,0.429,3,6,0.5,3,5,0.6,4,7,11,8,4,0,6,5,24,-8,1,Russell Westbrook,LAC,LAL,LAC,10.0,Rebs+Asts,43,35,32,19
22023,201566,22300114,"OCT 31, 2023",LAC vs. ORL,W,33,8,16,0.5,0,4,0.0,2,2,1.0,0,6,6,7,5,1,3,4,18,16,1,Russell Westbrook,LAC,LAC,ORL,10.5,Points,31,24,25,13
22023,201566,22300114,"OCT 31, 2023",LAC vs. ORL,W,33,8,16,0.5,0,4,0.0,2,2,1.0,0,6,6,7,5,1,3,4,18,16,1,Russell Westbrook,LAC,LAC,ORL,5.0,Rebounds,31,24,25,13
22023,201566,22300114,"OCT 31, 2023",LAC vs. ORL,W,33,8,16,0.5,0,4,0.0,2,2,1.0,0,6,6,7,5,1,3,4,18,16,1,Russell Westbrook,LAC,LAC,ORL,21.0,Pts+Rebs+Asts,31,24,25,13
22023,201566,22300114,"OCT 31, 2023",LAC vs. ORL,W,33,8,16,0.5,0,4,0.0,2,2,1.0,0,6,6,7,5,1,3,4,18,16,1,Russell Westbrook,LAC,LAC,ORL,4.5,Assists,31,24,25,13
22023,201566,22300114,"OCT 31, 2023",LAC vs. ORL,W,33,8,16,0.5,0,4,0.0,2,2,1.0,0,6,6,7,5,1,3,4,18,16,1,Russell Westbrook,LAC,LAC,ORL,16.0,Pts+Rebs,31,24,25,13
22023,201566,22300114,"OCT 31, 2023",LAC vs. ORL,W,33,8,16,0.5,0,4,0.0,2,2,1.0,0,6,6,7,5,1,3,4,18,16,1,Russell Westbrook,LAC,LAC,ORL,14.5,Pts+Asts,31,24,25,13
22023,201566,22300114,"OCT 31, 2023",LAC vs. ORL,W,33,8,16,0.5,0,4,0.0,2,2,1.0,0,6,6,7,5,1,3,4,18,16,1,Russell Westbrook,LAC,LAC,ORL,0.5,3-PT Made,31,24,25,13
22023,201566,22300114,"OCT 31, 2023",LAC vs. ORL,W,33,8,16,0.5,0,4,0.0,2,2,1.0,0,6,6,7,5,1,3,4,18,16,1,Russell Westbrook,LAC,LAC,ORL,10.0,Rebs+Asts,31,24,25,13
22023,201566,22300099,"OCT 29, 2023",LAC vs. SAS,W,27,8,13,0.615,3,5,0.6,0,3,0.0,1,7,8,3,1,1,2,3,19,30,1,Russell Westbrook,LAC,LAC,SAS,10.5,Points,30,27,22,11
22023,201566,22300099,"OCT 29, 2023",LAC vs. SAS,W,27,8,13,0.615,3,5,0.6,0,3,0.0,1,7,8,3,1,1,2,3,19,30,1,Russell Westbrook,LAC,LAC,SAS,5.0,Rebounds,30,27,22,11
22023,201566,22300099,"OCT 29, 2023",LAC vs. SAS,W,27,8,13,0.615,3,5,0.6,0,3,0.0,1,7,8,3,1,1,2,3,19,30,1,Russell Westbrook,LAC,LAC,SAS,21.0,Pts+Rebs+Asts,30,27,22,11
22023,201566,22300099,"OCT 29, 2023",LAC vs. SAS,W,27,8,13,0.615,3,5,0.6,0,3,0.0,1,7,8,3,1,1,2,3,19,30,1,Russell Westbrook,LAC,LAC,SAS,4.5,Assists,30,27,22,11
22023,201566,22300099,"OCT 29, 2023",LAC vs. SAS,W,27,8,13,0.615,3,5,0.6,0,3,0.0,1,7,8,3,1,1,2,3,19,30,1,Russell Westbrook,LAC,LAC,SAS,16.0,Pts+Rebs,30,27,22,11
22023,201566,22300099,"OCT 29, 2023",LAC vs. SAS,W,27,8,13,0.615,3,5,0.6,0,3,0.0,1,7,8,3,1,1,2,3,19,30,1,Russell Westbrook,LAC,LAC,SAS,14.5,Pts+Asts,30,27,22,11
22023,201566,22300099,"OCT 29, 2023",LAC vs. SAS,W,27,8,13,0.615,3,5,0.6,0,3,0.0,1,7,8,3,1,1,2,3,19,30,1,Russell Westbrook,LAC,LAC,SAS,0.5,3-PT Made,30,27,22,11
22023,201566,22300099,"OCT 29, 2023",LAC vs. SAS,W,27,8,13,0.615,3,5,0.6,0,3,0.0,1,7,8,3,1,1,2,3,19,30,1,Russell Westbrook,LAC,LAC,SAS,10.0,Rebs+Asts,30,27,22,11
22023,201566,22300085,"OCT 27, 2023",LAC @ UTA,L,37,2,4,0.5,0,1,0.0,0,0,0.0,1,8,9,4,1,1,5,4,4,-4,1,Russell Westbrook,LAC,UTA,LAC,10.5,Points,17,13,8,13
22023,201566,22300085,"OCT 27, 2023",LAC @ UTA,L,37,2,4,0.5,0,1,0.0,0,0,0.0,1,8,9,4,1,1,5,4,4,-4,1,Russell Westbrook,LAC,UTA,LAC,5.0,Rebounds,17,13,8,13
22023,201566,22300085,"OCT 27, 2023",LAC @ UTA,L,37,2,4,0.5,0,1,0.0,0,0,0.0,1,8,9,4,1,1,5,4,4,-4,1,Russell Westbrook,LAC,UTA,LAC,21.0,Pts+Rebs+Asts,17,13,8,13
22023,201566,22300085,"OCT 27, 2023",LAC @ UTA,L,37,2,4,0.5,0,1,0.0,0,0,0.0,1,8,9,4,1,1,5,4,4,-4,1,Russell Westbrook,LAC,UTA,LAC,4.5,Assists,17,13,8,13
22023,201566,22300085,"OCT 27, 2023",LAC @ UTA,L,37,2,4,0.5,0,1,0.0,0,0,0.0,1,8,9,4,1,1,5,4,4,-4,1,Russell Westbrook,LAC,UTA,LAC,16.0,Pts+Rebs,17,13,8,13
22023,201566,22300085,"OCT 27, 2023",LAC @ UTA,L,37,2,4,0.5,0,1,0.0,0,0,0.0,1,8,9,4,1,1,5,4,4,-4,1,Russell Westbrook,LAC,UTA,LAC,14.5,Pts+Asts,17,13,8,13
22023,201566,22300085,"OCT 27, 2023",LAC @ UTA,L,37,2,4,0.5,0,1,0.0,0,0,0.0,1,8,9,4,1,1,5,4,4,-4,1,Russell Westbrook,LAC,UTA,LAC,0.5,3-PT Made,17,13,8,13
22023,201566,22300085,"OCT 27, 2023",LAC @ UTA,L,37,2,4,0.5,0,1,0.0,0,0,0.0,1,8,9,4,1,1,5,4,4,-4,1,Russell Westbrook,LAC,UTA,LAC,10.0,Rebs+Asts,17,13,8,13
22023,201566,22300074,"OCT 25, 2023",LAC vs. POR,W,29,5,8,0.625,1,2,0.5,0,0,0.0,2,3,5,13,0,0,3,3,11,30,1,Russell Westbrook,LAC,LAC,POR,10.5,Points,29,16,24,18
22023,201566,22300074,"OCT 25, 2023",LAC vs. POR,W,29,5,8,0.625,1,2,0.5,0,0,0.0,2,3,5,13,0,0,3,3,11,30,1,Russell Westbrook,LAC,LAC,POR,5.0,Rebounds,29,16,24,18
22023,201566,22300074,"OCT 25, 2023",LAC vs. POR,W,29,5,8,0.625,1,2,0.5,0,0,0.0,2,3,5,13,0,0,3,3,11,30,1,Russell Westbrook,LAC,LAC,POR,21.0,Pts+Rebs+Asts,29,16,24,18
22023,201566,22300074,"OCT 25, 2023",LAC vs. POR,W,29,5,8,0.625,1,2,0.5,0,0,0.0,2,3,5,13,0,0,3,3,11,30,1,Russell Westbrook,LAC,LAC,POR,4.5,Assists,29,16,24,18
22023,201566,22300074,"OCT 25, 2023",LAC vs. POR,W,29,5,8,0.625,1,2,0.5,0,0,0.0,2,3,5,13,0,0,3,3,11,30,1,Russell Westbrook,LAC,LAC,POR,16.0,Pts+Rebs,29,16,24,18
22023,201566,22300074,"OCT 25, 2023",LAC vs. POR,W,29,5,8,0.625,1,2,0.5,0,0,0.0,2,3,5,13,0,0,3,3,11,30,1,Russell Westbrook,LAC,LAC,POR,14.5,Pts+Asts,29,16,24,18
22023,201566,22300074,"OCT 25, 2023",LAC vs. POR,W,29,5,8,0.625,1,2,0.5,0,0,0.0,2,3,5,13,0,0,3,3,11,30,1,Russell Westbrook,LAC,LAC,POR,0.5,3-PT Made,29,16,24,18
22023,201566,22300074,"OCT 25, 2023",LAC vs. POR,W,29,5,8,0.625,1,2,0.5,0,0,0.0,2,3,5,13,0,0,3,3,11,30,1,Russell Westbrook,LAC,LAC,POR,10.0,Rebs+Asts,29,16,24,18
22023,1629632,22300561,"JAN 15, 2024",CHI @ CLE,L,38,5,15,0.333,1,5,0.2,7,9,0.778,1,3,4,3,1,2,7,0,18,-12,1,Coby White,CHI,CLE,CHI,,,25,22,21,7
22023,1629632,22300548,"JAN 13, 2024",CHI @ SAS,W,32,6,13,0.462,0,3,0.0,3,4,0.75,0,2,2,4,0,1,0,2,15,-11,1,Coby White,CHI,SAS,CHI,,,21,17,19,6
22023,1629632,22300536,"JAN 12, 2024",CHI vs. GSW,L,37,9,13,0.692,5,7,0.714,2,3,0.667,0,4,4,7,0,0,1,4,25,11,1,Coby White,CHI,CHI,GSW,,,36,29,32,11
22023,1629632,22300523,"JAN 10, 2024",CHI vs. HOU,W,43,9,17,0.529,6,11,0.545,6,7,0.857,0,4,4,8,0,1,4,1,30,15,1,Coby White,CHI,CHI,HOU,,,42,34,38,12
22023,1629632,22300506,"JAN 08, 2024",CHI @ CHA,W,42,10,19,0.526,3,7,0.429,4,5,0.8,0,6,6,5,0,0,1,3,27,11,1,Coby White,CHI,CHA,CHI,,,38,33,32,11
22023,1629632,22300484,"JAN 05, 2024",CHI vs. CHA,W,40,7,12,0.583,3,6,0.5,5,6,0.833,1,9,10,6,0,0,5,1,22,0,1,Coby White,CHI,CHI,CHA,,,38,32,28,16
22023,1629632,22300468,"JAN 03, 2024",CHI @ NYK,L,38,9,19,0.474,6,9,0.667,2,2,1.0,0,4,4,8,0,1,3,1,26,-23,1,Coby White,CHI,NYK,CHI,,,38,30,34,12
22023,1629632,22300459,"JAN 02, 2024",CHI @ PHI,L,28,5,15,0.333,0,5,0.0,4,5,0.8,0,4,4,3,2,0,1,4,14,-26,1,Coby White,CHI,PHI,CHI,,,21,18,17,7
22023,1629632,22300442,"DEC 30, 2023",CHI vs. PHI,W,40,7,15,0.467,1,5,0.2,5,6,0.833,2,6,8,2,0,0,5,3,20,10,1,Coby White,CHI,CHI,PHI,,,30,28,22,10
22023,1629632,22300422,"DEC 28, 2023",CHI vs. IND,L,33,5,19,0.263,2,6,0.333,4,4,1.0,0,5,5,2,0,0,2,3,16,-24,1,Coby White,CHI,CHI,IND,,,23,21,18,7
22023,1629632,22300408,"DEC 26, 2023",CHI vs. ATL,W,37,7,22,0.318,0,7,0.0,5,8,0.625,0,5,5,5,0,0,1,2,19,7,1,Coby White,CHI,CHI,ATL,,,29,24,24,10
22023,1629632,22300396,"DEC 23, 2023",CHI vs. CLE,L,40,8,19,0.421,0,8,0.0,1,1,1.0,0,4,4,7,0,1,4,2,17,-5,1,Coby White,CHI,CHI,CLE,,,28,21,24,11
22023,1629632,22300376,"DEC 21, 2023",CHI vs. SAS,W,36,10,15,0.667,2,6,0.333,0,0,0.0,0,6,6,5,0,0,3,2,22,9,1,Coby White,CHI,CHI,SAS,,,33,28,27,11
22023,1629632,22300370,"DEC 20, 2023",CHI vs. LAL,W,33,7,18,0.389,3,6,0.5,0,0,0.0,1,6,7,5,0,0,3,2,17,10,1,Coby White,CHI,CHI,LAL,,,29,24,22,12
22023,1629632,22300351,"DEC 18, 2023",CHI @ PHI,W,40,9,17,0.529,2,6,0.333,4,4,1.0,1,7,8,9,0,1,2,0,24,0,1,Coby White,CHI,PHI,CHI,,,41,32,33,17
22023,1629632,22300337,"DEC 16, 2023",CHI @ MIA,L,39,7,15,0.467,4,10,0.4,4,4,1.0,1,6,7,5,1,0,1,3,22,3,1,Coby White,CHI,MIA,CHI,,,34,29,27,12
22023,1629632,22300320,"DEC 14, 2023",CHI @ MIA,W,40,9,20,0.45,4,11,0.364,4,8,0.5,1,6,7,11,1,0,0,1,26,20,1,Coby White,CHI,MIA,CHI,,,44,33,37,18
22023,1629632,22300307,"DEC 12, 2023",CHI vs. DEN,L,35,8,15,0.533,5,10,0.5,6,6,1.0,2,2,4,8,1,0,2,2,27,-5,1,Coby White,CHI,CHI,DEN,,,39,31,35,12
22023,1629632,22300300,"DEC 11, 2023",CHI @ MIL,L,45,12,20,0.6,6,10,0.6,3,4,0.75,0,6,6,4,1,0,2,3,33,1,1,Coby White,CHI,MIL,CHI,,,43,39,37,10
22023,1629632,22301223,"DEC 08, 2023",CHI @ SAS,W,39,9,15,0.6,5,7,0.714,1,1,1.0,0,4,4,6,1,0,3,0,24,18,1,Coby White,CHI,SAS,CHI,,,34,28,30,10
22023,1629632,22301211,"DEC 06, 2023",CHI vs. CHA,W,38,6,16,0.375,3,7,0.429,4,5,0.8,0,9,9,5,0,0,0,3,19,6,1,Coby White,CHI,CHI,CHA,,,33,28,24,14
22023,1629632,22300285,"DEC 02, 2023",CHI vs. NOP,W,40,10,17,0.588,8,13,0.615,3,3,1.0,2,7,9,6,1,0,3,4,31,6,1,Coby White,CHI,CHI,NOP,,,46,40,37,15
22023,1629632,22300269,"NOV 30, 2023",CHI vs. MIL,W,45,7,20,0.35,4,11,0.364,5,6,0.833,0,4,4,7,1,1,3,3,23,1,1,Coby White,CHI,CHI,MIL,,,34,27,30,11
22023,1629632,22300053,"NOV 28, 2023",CHI @ BOS,L,30,7,12,0.583,3,5,0.6,2,2,1.0,0,1,1,3,0,0,0,0,19,-16,1,Coby White,CHI,BOS,CHI,,,23,20,22,4
22023,1629632,22300250,"NOV 26, 2023",CHI @ BKN,L,38,7,16,0.438,5,12,0.417,4,4,1.0,1,4,5,4,0,1,1,3,23,7,1,Coby White,CHI,BKN,CHI,,,32,28,27,9
22023,1629632,22300046,"NOV 24, 2023",CHI @ TOR,L,34,5,9,0.556,4,7,0.571,0,0,0.0,1,2,3,3,0,0,3,4,14,-9,1,Coby White,CHI,TOR,CHI,,,20,17,17,6
22023,1629632,22300234,"NOV 22, 2023",CHI @ OKC,L,37,8,17,0.471,7,12,0.583,0,0,0.0,0,1,1,5,1,0,3,5,23,-5,1,Coby White,CHI,OKC,CHI,,,29,24,28,6
22023,1629632,22300220,"NOV 20, 2023",CHI vs. MIA,L,34,7,11,0.636,4,8,0.5,2,2,1.0,1,4,5,3,1,1,2,2,20,-16,1,Coby White,CHI,CHI,MIA,,,28,25,23,8
22023,1629632,22300204,"NOV 18, 2023",CHI vs. MIA,W,29,5,13,0.385,4,10,0.4,0,0,0.0,0,3,3,5,1,0,3,5,14,-12,1,Coby White,CHI,CHI,MIA,,,22,17,19,8
22023,1629632,22300033,"NOV 17, 2023",CHI vs. ORL,L,30,2,6,0.333,0,3,0.0,0,1,0.0,0,1,1,4,1,0,2,2,4,9,1,Coby White,CHI,CHI,ORL,,,9,5,8,5
22023,1629632,22300196,"NOV 15, 2023",CHI vs. ORL,L,33,2,10,0.2,1,5,0.2,0,0,0.0,0,1,1,1,1,0,3,4,5,5,1,Coby White,CHI,CHI,ORL,,,7,6,6,2
22023,1629632,22300190,"NOV 13, 2023",CHI @ MIL,L,26,6,14,0.429,3,8,0.375,1,2,0.5,0,3,3,1,2,0,1,3,16,1,1,Coby White,CHI,MIL,CHI,,,20,19,17,4
22023,1629632,22300181,"NOV 12, 2023",CHI vs. DET,W,32,6,14,0.429,3,6,0.5,1,2,0.5,0,0,0,7,2,0,1,6,16,4,1,Coby White,CHI,CHI,DET,,,23,16,23,7
22023,1629632,22300162,"NOV 08, 2023",CHI vs. PHX,L,37,5,14,0.357,1,5,0.2,0,0,0.0,1,6,7,6,3,1,2,3,11,-11,1,Coby White,CHI,CHI,PHX,,,24,18,17,13
22023,1629632,22300152,"NOV 06, 2023",CHI vs. UTA,W,29,7,9,0.778,4,6,0.667,0,0,0.0,0,3,3,7,1,0,1,1,18,15,1,Coby White,CHI,CHI,UTA,,,28,21,25,10
22023,1629632,22300139,"NOV 04, 2023",CHI @ DEN,L,31,4,10,0.4,1,4,0.25,2,2,1.0,0,2,2,5,2,1,2,2,11,-11,1,Coby White,CHI,DEN,CHI,,,18,13,16,7
22023,1629632,22300004,"NOV 03, 2023",CHI vs. BKN,L,35,7,17,0.412,2,8,0.25,2,2,1.0,1,2,3,2,0,1,2,0,18,3,1,Coby White,CHI,CHI,BKN,,,23,21,20,5
22023,1629632,22300124,"NOV 01, 2023",CHI @ DAL,L,33,4,12,0.333,1,6,0.167,1,2,0.5,0,1,1,4,0,0,3,3,10,-6,1,Coby White,CHI,DAL,CHI,,,15,11,14,5
22023,1629632,22300102,"OCT 30, 2023",CHI @ IND,W,25,3,6,0.5,1,2,0.5,0,0,0.0,0,2,2,3,1,0,1,4,7,5,1,Coby White,CHI,IND,CHI,,,12,9,10,5
22023,1629632,22300088,"OCT 28, 2023",CHI @ DET,L,28,0,4,0.0,0,2,0.0,0,0,0.0,0,2,2,1,0,0,1,1,0,-10,1,Coby White,CHI,DET,CHI,,,3,2,1,3
22023,1629632,22300082,"OCT 27, 2023",CHI vs. TOR,W,40,5,15,0.333,2,9,0.222,5,5,1.0,0,6,6,8,1,0,3,2,17,-1,1,Coby White,CHI,CHI,TOR,,,31,23,25,14
22023,1629632,22300070,"OCT 25, 2023",CHI vs. OKC,L,31,4,14,0.286,2,7,0.286,5,6,0.833,1,3,4,4,0,0,0,3,15,-8,1,Coby White,CHI,CHI,OKC,,,23,19,19,8
22023,1628401,22300563,"JAN 15, 2024",BOS @ TOR,W,37,7,18,0.389,5,11,0.455,3,3,1.0,0,2,2,1,0,0,3,1,22,-8,1,Derrick White,BOS,TOR,BOS,,,25,24,23,3
22023,1628401,22300542,"JAN 13, 2024",BOS vs. HOU,W,25,5,9,0.556,3,5,0.6,0,0,0.0,1,2,3,5,2,0,0,1,13,29,1,Derrick White,BOS,BOS,HOU,,,21,16,18,8
22023,1628401,22300528,"JAN 11, 2024",BOS @ MIL,L,18,1,4,0.25,0,1,0.0,0,0,0.0,0,1,1,0,0,0,0,0,2,-14,1,Derrick White,BOS,MIL,BOS,,,3,3,2,1
22023,1628401,22300517,"JAN 10, 2024",BOS vs. MIN,W,43,3,11,0.273,1,5,0.2,2,2,1.0,2,4,6,6,0,0,2,5,9,11,1,Derrick White,BOS,BOS,MIN,,,21,15,15,12
22023,1628401,22300507,"JAN 08, 2024",BOS @ IND,L,36,4,16,0.25,2,8,0.25,3,3,1.0,0,4,4,6,0,2,1,3,13,-2,1,Derrick White,BOS,IND,BOS,,,23,17,19,10
22023,1628401,22300493,"JAN 06, 2024",BOS @ IND,W,24,3,6,0.5,1,2,0.5,0,0,0.0,0,5,5,2,0,1,4,5,7,20,1,Derrick White,BOS,IND,BOS,,,14,12,9,7
22023,1628401,22300479,"JAN 05, 2024",BOS vs. UTA,W,26,3,9,0.333,2,7,0.286,2,2,1.0,0,7,7,3,1,1,0,2,10,19,1,Derrick White,BOS,BOS,UTA,,,20,17,13,10
22023,1628401,22300462,"JAN 02, 2024",BOS @ OKC,L,29,7,12,0.583,5,9,0.556,0,0,0.0,0,5,5,6,1,1,2,4,19,5,1,Derrick White,BOS,OKC,BOS,,,30,24,25,11
22023,1628401,22300448,"DEC 31, 2023",BOS @ SAS,W,26,7,11,0.636,3,6,0.5,0,0,0.0,1,2,3,5,0,0,0,1,17,24,1,Derrick White,BOS,SAS,BOS,,,25,20,22,8
22023,1628401,22300432,"DEC 29, 2023",BOS vs. TOR,W,36,5,19,0.263,2,10,0.2,9,9,1.0,1,4,5,7,3,2,3,2,21,7,1,Derrick White,BOS,BOS,TOR,,,33,26,28,12
22023,1628401,22300421,"DEC 28, 2023",BOS vs. DET,W,38,9,15,0.6,2,4,0.5,3,3,1.0,1,3,4,5,0,2,2,1,23,8,1,Derrick White,BOS,BOS,DET,,,32,27,28,9
22023,1628401,22300403,"DEC 25, 2023",BOS @ LAL,W,35,8,13,0.615,2,4,0.5,0,0,0.0,0,2,2,11,2,2,2,3,18,16,1,Derrick White,BOS,LAL,BOS,,,31,20,29,13
22023,1628401,22300389,"DEC 23, 2023",BOS @ LAC,W,29,5,12,0.417,3,10,0.3,5,5,1.0,0,3,3,3,0,3,2,2,18,27,1,Derrick White,BOS,LAC,BOS,,,24,21,21,6
22023,1628401,22300373,"DEC 20, 2023",BOS @ SAC,W,29,10,13,0.769,6,9,0.667,2,3,0.667,1,1,2,7,1,3,1,1,28,16,1,Derrick White,BOS,SAC,BOS,,,37,30,35,9
22023,1628401,22300362,"DEC 19, 2023",BOS @ GSW,L,40,11,24,0.458,7,18,0.389,1,2,0.5,2,5,7,3,0,3,0,2,30,-1,1,Derrick White,BOS,GSW,BOS,,,40,37,33,10
22023,1628401,22300344,"DEC 17, 2023",BOS vs. ORL,W,27,4,9,0.444,1,5,0.2,1,1,1.0,0,5,5,4,1,3,2,1,10,7,1,Derrick White,BOS,BOS,ORL,,,19,15,14,9
22023,1628401,22300329,"DEC 15, 2023",BOS vs. ORL,W,30,7,15,0.467,3,7,0.429,2,2,1.0,1,3,4,8,4,1,1,0,19,13,1,Derrick White,BOS,BOS,ORL,,,31,23,27,12
22023,1628401,22300319,"DEC 14, 2023",BOS vs. CLE,W,35,5,10,0.5,2,4,0.5,2,2,1.0,2,3,5,3,3,0,3,0,14,9,1,Derrick White,BOS,BOS,CLE,,,22,19,17,8
22023,1628401,22300305,"DEC 12, 2023",BOS vs. CLE,W,37,5,9,0.556,5,8,0.625,2,2,1.0,0,4,4,4,1,2,1,3,17,-6,1,Derrick White,BOS,BOS,CLE,,,25,21,21,8
22023,1628401,22301227,"DEC 08, 2023",BOS vs. NYK,W,32,10,16,0.625,6,10,0.6,4,4,1.0,2,1,3,3,2,2,0,4,30,21,1,Derrick White,BOS,BOS,NYK,,,36,33,33,6
22023,1628401,22301202,"DEC 04, 2023",BOS @ IND,L,36,7,16,0.438,2,9,0.222,2,2,1.0,0,4,4,8,1,1,5,4,18,-4,1,Derrick White,BOS,IND,BOS,,,30,22,26,12
22023,1628401,22300275,"DEC 01, 2023",BOS vs. PHI,W,32,5,11,0.455,3,4,0.75,8,8,1.0,1,5,6,5,1,1,1,2,21,20,1,Derrick White,BOS,BOS,PHI,,,32,27,26,11
22023,1628401,22300053,"NOV 28, 2023",BOS vs. CHI,W,29,5,7,0.714,2,3,0.667,2,2,1.0,0,3,3,7,2,0,0,4,14,15,1,Derrick White,BOS,BOS,CHI,,,24,17,21,10
22023,1628401,22300246,"NOV 26, 2023",BOS vs. ATL,W,37,5,13,0.385,0,6,0.0,5,5,1.0,2,2,4,11,3,0,3,5,15,29,1,Derrick White,BOS,BOS,ATL,,,30,19,26,15
22023,1628401,22300043,"NOV 24, 2023",BOS @ ORL,L,37,3,9,0.333,1,5,0.2,9,12,0.75,0,5,5,4,1,1,3,1,16,-6,1,Derrick White,BOS,ORL,BOS,,,25,21,20,9
22023,1628401,22300228,"NOV 22, 2023",BOS vs. MIL,W,35,5,9,0.556,3,6,0.5,0,0,0.0,0,4,4,5,1,1,6,1,13,-3,1,Derrick White,BOS,BOS,MIL,,,22,17,18,9
22023,1628401,22300213,"NOV 19, 2023",BOS @ MEM,W,34,3,9,0.333,2,5,0.4,2,2,1.0,1,2,3,4,0,1,2,2,10,1,1,Derrick White,BOS,MEM,BOS,,,17,13,14,7
22023,1628401,22300031,"NOV 17, 2023",BOS @ TOR,W,34,4,10,0.4,3,8,0.375,2,2,1.0,0,4,4,5,0,0,1,1,13,-1,1,Derrick White,BOS,TOR,BOS,,,22,17,18,9
22023,1628401,22300194,"NOV 15, 2023",BOS @ PHI,W,36,7,12,0.583,4,8,0.5,9,10,0.9,0,3,3,5,1,0,2,3,27,3,1,Derrick White,BOS,PHI,BOS,,,35,30,32,8
22023,1628401,22300188,"NOV 13, 2023",BOS vs. NYK,W,31,1,7,0.143,1,3,0.333,0,0,0.0,1,1,2,4,1,1,1,2,3,14,1,Derrick White,BOS,BOS,NYK,,,9,5,7,6
22023,1628401,22300174,"NOV 11, 2023",BOS vs. TOR,W,26,2,5,0.4,0,3,0.0,0,1,0.0,0,4,4,5,0,1,0,2,4,20,1,Derrick White,BOS,BOS,TOR,,,13,8,9,9
22023,1628401,22300010,"NOV 10, 2023",BOS vs. BKN,W,27,4,10,0.4,2,5,0.4,1,2,0.5,0,4,4,5,0,1,0,2,11,1,1,Derrick White,BOS,BOS,BKN,,,20,15,16,9
22023,1628401,22300159,"NOV 08, 2023",BOS @ PHI,L,38,6,18,0.333,3,11,0.273,4,4,1.0,1,3,4,5,2,1,2,3,19,2,1,Derrick White,BOS,PHI,BOS,,,28,23,24,9
22023,1628401,22300118,"NOV 01, 2023",BOS vs. IND,W,27,7,10,0.7,4,7,0.571,0,0,0.0,1,2,3,4,0,0,2,3,18,34,1,Derrick White,BOS,BOS,IND,,,25,21,22,7
22023,1628401,22300103,"OCT 30, 2023",BOS @ WAS,W,24,2,3,0.667,1,2,0.5,0,0,0.0,1,0,1,8,2,1,2,1,5,27,1,Derrick White,BOS,WAS,BOS,,,14,6,13,9
22023,1628401,22300080,"OCT 27, 2023",BOS vs. MIA,W,36,9,15,0.6,5,7,0.714,5,6,0.833,3,3,6,3,1,3,2,1,28,4,1,Derrick White,BOS,BOS,MIA,,,37,34,31,9
22023,1628401,22300065,"OCT 25, 2023",BOS @ NYK,W,32,4,6,0.667,1,3,0.333,3,4,0.75,0,6,6,2,2,1,1,3,12,7,1,Derrick White,BOS,NYK,BOS,,,20,18,14,8
22023,1641727,22300417,"DEC 27, 2023",BKN vs. MIL,L,21,1,5,0.2,0,3,0.0,0,0,0.0,0,4,4,3,0,0,0,0,2,-16,1,Dariq Whitehead,BKN,BKN,MIL,,,9,6,5,7
22023,1641727,22300240,"NOV 25, 2023",BKN vs. MIA,W,3,0,0,0.0,0,0,0.0,1,2,0.5,0,0,0,0,0,1,0,0,1,-6,1,Dariq Whitehead,BKN,BKN,MIA,,,1,1,1,0
22023,1641715,22300555,"JAN 15, 2024",HOU @ PHI,L,23,6,12,0.5,2,5,0.4,0,1,0.0,2,4,6,1,1,0,0,3,14,0,1,Cam Whitmore,HOU,PHI,HOU,,,21,20,15,7
22023,1641715,22300542,"JAN 13, 2024",HOU @ BOS,L,28,7,13,0.538,2,7,0.286,6,8,0.75,1,6,7,0,1,1,1,2,22,-15,1,Cam Whitmore,HOU,BOS,HOU,,,29,29,22,7
22023,1641715,22300534,"JAN 12, 2024",HOU @ DET,W,15,1,7,0.143,1,5,0.2,0,0,0.0,0,1,1,0,0,0,0,2,3,6,1,Cam Whitmore,HOU,DET,HOU,,,4,4,3,1
22023,1641715,22300523,"JAN 10, 2024",HOU @ CHI,L,33,6,12,0.5,2,5,0.4,2,2,1.0,1,4,5,1,2,0,1,1,16,-3,1,Cam Whitmore,HOU,CHI,HOU,,,22,21,17,6
22023,1641715,22300509,"JAN 08, 2024",HOU @ MIA,L,17,5,8,0.625,1,2,0.5,0,0,0.0,1,5,6,0,1,0,1,4,11,8,1,Cam Whitmore,HOU,MIA,HOU,,,17,17,11,6
22023,1641715,22300496,"JAN 06, 2024",HOU vs. MIL,W,13,4,6,0.667,1,1,1.0,3,3,1.0,0,3,3,0,1,0,0,0,12,4,1,Cam Whitmore,HOU,HOU,MIL,,,15,15,12,3
22023,1641715,22300485,"JAN 05, 2024",HOU vs. MIN,L,15,4,10,0.4,1,4,0.25,2,2,1.0,0,2,2,0,2,0,4,1,11,-9,1,Cam Whitmore,HOU,HOU,MIN,,,13,13,11,2
22023,1641715,22300469,"JAN 03, 2024",HOU vs. BKN,W,17,4,7,0.571,3,5,0.6,0,0,0.0,0,2,2,1,2,0,1,3,11,-6,1,Cam Whitmore,HOU,HOU,BKN,,,14,13,12,3
22023,1641715,22300453,"JAN 01, 2024",HOU vs. DET,W,8,4,5,0.8,1,1,1.0,0,0,0.0,1,3,4,0,0,0,0,0,9,-2,1,Cam Whitmore,HOU,HOU,DET,,,13,13,9,4
22023,1641715,22300418,"DEC 27, 2023",HOU vs. PHX,L,18,4,7,0.571,3,4,0.75,1,2,0.5,0,1,1,0,0,1,1,2,12,1,1,Cam Whitmore,HOU,HOU,PHX,,,13,13,12,1
22023,1641715,22300385,"DEC 22, 2023",HOU vs. DAL,W,14,6,12,0.5,1,6,0.167,1,2,0.5,2,2,4,0,2,0,0,2,14,-10,1,Cam Whitmore,HOU,HOU,DAL,,,18,18,14,4
22023,1641715,22300291,"DEC 02, 2023",HOU @ LAL,L,3,1,2,0.5,0,0,0.0,3,6,0.5,1,2,3,1,0,0,0,0,5,8,1,Cam Whitmore,HOU,LAL,HOU,,,9,8,6,4
22023,1641715,22300263,"NOV 29, 2023",HOU @ DEN,L,6,3,4,0.75,1,2,0.5,1,2,0.5,0,2,2,0,0,0,0,1,8,6,1,Cam Whitmore,HOU,DEN,HOU,,,10,10,8,2
22023,1641715,22300153,"NOV 06, 2023",HOU vs. SAC,W,12,3,5,0.6,0,1,0.0,1,2,0.5,0,1,1,1,1,0,0,1,7,-12,1,Cam Whitmore,HOU,HOU,SAC,,,9,8,8,2
22023,1641715,22300137,"NOV 04, 2023",HOU vs. SAC,W,1,0,0,0.0,0,0,0.0,0,0,0.0,0,1,1,0,0,0,1,0,0,0,1,Cam Whitmore,HOU,HOU,SAC,,,1,1,0,1
22023,1641715,22300066,"OCT 25, 2023",HOU @ ORL,L,10,0,4,0.0,0,2,0.0,0,0,0.0,0,1,1,0,0,0,1,0,0,-12,1,Cam Whitmore,HOU,ORL,HOU,,,1,1,0,1
22023,1630598,22300546,"JAN 13, 2024",OKC vs. ORL,W,7,0,2,0.0,0,0,0.0,0,0,0.0,1,0,1,1,2,0,0,4,0,-2,1,Aaron Wiggins,OKC,OKC,ORL,,,2,1,1,2
22023,1630598,22300529,"JAN 11, 2024",OKC vs. POR,W,7,0,2,0.0,0,0,0.0,0,0,0.0,0,0,0,0,1,0,0,0,0,6,1,Aaron Wiggins,OKC,OKC,POR,,,0,0,0,0
22023,1630598,22300522,"JAN 10, 2024",OKC @ MIA,W,8,1,4,0.25,0,0,0.0,0,0,0.0,0,0,0,0,0,0,0,1,2,-7,1,Aaron Wiggins,OKC,MIA,OKC,,,2,2,2,0
22023,1630598,22300508,"JAN 08, 2024",OKC @ WAS,W,23,6,8,0.75,1,1,1.0,0,0,0.0,2,3,5,0,1,0,1,1,13,-2,1,Aaron Wiggins,OKC,WAS,OKC,,,18,18,13,5
22023,1630598,22300481,"JAN 05, 2024",OKC @ BKN,L,8,1,2,0.5,0,1,0.0,0,0,0.0,0,0,0,2,0,0,0,2,2,-3,1,Aaron Wiggins,OKC,BKN,OKC,,,4,2,4,2
22023,1630598,22300467,"JAN 03, 2024",OKC @ ATL,L,21,6,7,0.857,1,1,1.0,0,0,0.0,1,2,3,2,1,1,0,1,13,-7,1,Aaron Wiggins,OKC,ATL,OKC,,,18,16,15,5
22023,1630598,22300462,"JAN 02, 2024",OKC vs. BOS,W,13,1,3,0.333,0,1,0.0,2,2,1.0,0,1,1,1,1,0,0,1,4,4,1,Aaron Wiggins,OKC,OKC,BOS,,,6,5,5,2
22023,1630598,22300447,"DEC 31, 2023",OKC vs. BKN,W,11,0,0,0.0,0,0,0.0,0,0,0.0,1,4,5,0,0,0,2,0,0,3,1,Aaron Wiggins,OKC,OKC,BKN,,,5,5,0,5
22023,1630598,22300435,"DEC 29, 2023",OKC @ DEN,W,12,3,5,0.6,1,1,1.0,0,0,0.0,2,3,5,0,0,0,1,2,7,14,1,Aaron Wiggins,OKC,DEN,OKC,,,12,12,7,5
22023,1630598,22300419,"DEC 27, 2023",OKC vs. NYK,W,12,2,4,0.5,1,3,0.333,0,0,0.0,0,0,0,2,0,1,0,4,5,7,1,Aaron Wiggins,OKC,OKC,NYK,,,7,5,7,2
22023,1630598,22300411,"DEC 26, 2023",OKC vs. MIN,W,14,1,2,0.5,1,2,0.5,0,0,0.0,1,4,5,1,0,0,0,1,3,7,1,Aaron Wiggins,OKC,OKC,MIN,,,9,8,4,6
22023,1630598,22300397,"DEC 23, 2023",OKC vs. LAL,L,6,0,1,0.0,0,0,0.0,0,0,0.0,1,0,1,1,0,0,1,0,0,-6,1,Aaron Wiggins,OKC,OKC,LAL,,,2,1,1,2
22023,1630598,22300379,"DEC 21, 2023",OKC vs. LAC,W,25,3,6,0.5,1,2,0.5,1,2,0.5,0,7,7,1,1,0,1,3,8,22,1,Aaron Wiggins,OKC,OKC,LAC,,,16,15,9,8
22023,1630598,22300355,"DEC 18, 2023",OKC vs. MEM,W,12,1,4,0.25,0,0,0.0,0,0,0.0,1,1,2,1,1,0,1,0,2,-8,1,Aaron Wiggins,OKC,OKC,MEM,,,5,4,3,3
22023,1630598,22300340,"DEC 16, 2023",OKC @ DEN,W,12,2,2,1.0,0,0,0.0,2,2,1.0,1,1,2,1,0,0,0,1,6,-4,1,Aaron Wiggins,OKC,DEN,OKC,,,9,8,7,3
22023,1630598,22300324,"DEC 14, 2023",OKC @ SAC,L,7,3,4,0.75,0,0,0.0,0,0,0.0,1,0,1,0,0,0,1,0,6,-5,1,Aaron Wiggins,OKC,SAC,OKC,,,7,7,6,1
22023,1630598,22300302,"DEC 11, 2023",OKC vs. UTA,W,4,1,4,0.25,1,1,1.0,0,0,0.0,1,0,1,0,0,0,0,0,3,2,1,Aaron Wiggins,OKC,OKC,UTA,,,4,4,3,1
22023,1630598,22301222,"DEC 08, 2023",OKC vs. GSW,W,22,4,5,0.8,1,2,0.5,0,0,0.0,1,2,3,1,2,0,1,2,9,-15,1,Aaron Wiggins,OKC,OKC,GSW,,,13,12,10,4
22023,1630598,22301212,"DEC 06, 2023",OKC @ HOU,L,15,4,4,1.0,0,0,0.0,3,4,0.75,0,1,1,0,1,0,0,3,11,-5,1,Aaron Wiggins,OKC,HOU,OKC,,,12,12,11,1
22023,1630598,22300287,"DEC 02, 2023",OKC @ DAL,W,10,0,1,0.0,0,0,0.0,0,0,0.0,0,0,0,0,0,0,0,0,0,0,1,Aaron Wiggins,OKC,DAL,OKC,,,0,0,0,0
22023,1630598,22300271,"NOV 30, 2023",OKC vs. LAL,W,13,2,2,1.0,1,1,1.0,1,2,0.5,2,3,5,2,0,0,0,2,6,5,1,Aaron Wiggins,OKC,OKC,LAL,,,13,11,8,7
22023,1630598,22300058,"NOV 28, 2023",OKC @ MIN,L,16,3,4,0.75,2,2,1.0,0,0,0.0,1,2,3,1,0,0,0,2,8,-7,1,Aaron Wiggins,OKC,MIN,OKC,,,12,11,9,4
22023,1630598,22300239,"NOV 25, 2023",OKC vs. PHI,L,20,2,4,0.5,1,3,0.333,2,4,0.5,2,1,3,1,0,0,0,1,7,0,1,Aaron Wiggins,OKC,OKC,PHI,,,11,10,8,4
22023,1630598,22300234,"NOV 22, 2023",OKC vs. CHI,W,11,2,2,1.0,0,0,0.0,2,2,1.0,0,4,4,1,0,0,1,1,6,2,1,Aaron Wiggins,OKC,OKC,CHI,,,11,10,7,5
22023,1630598,22300215,"NOV 19, 2023",OKC @ POR,W,16,4,7,0.571,2,3,0.667,3,3,1.0,2,3,5,1,3,0,2,1,13,11,1,Aaron Wiggins,OKC,POR,OKC,,,19,18,14,6
22023,1630598,22300207,"NOV 18, 2023",OKC @ GSW,W,6,0,0,0.0,0,0,0.0,0,0,0.0,0,2,2,1,0,0,2,0,0,2,1,Aaron Wiggins,OKC,GSW,OKC,,,3,2,1,3
22023,1630598,22300201,"NOV 16, 2023",OKC @ GSW,W,11,2,3,0.667,0,1,0.0,1,2,0.5,0,2,2,1,0,0,0,0,5,3,1,Aaron Wiggins,OKC,GSW,OKC,,,8,7,6,3
22023,1630598,22300021,"NOV 14, 2023",OKC vs. SAS,W,5,1,1,1.0,1,1,1.0,0,0,0.0,0,0,0,1,1,0,0,0,3,-2,1,Aaron Wiggins,OKC,OKC,SAS,,,4,3,4,1
22023,1630598,22300185,"NOV 12, 2023",OKC @ PHX,W,12,1,4,0.25,0,0,0.0,0,0,0.0,0,2,2,1,1,0,0,1,2,9,1,Aaron Wiggins,OKC,PHX,OKC,,,5,4,3,3
22023,1630598,22300167,"NOV 08, 2023",OKC vs. CLE,W,9,0,3,0.0,0,2,0.0,0,0,0.0,0,0,0,0,0,0,0,0,0,4,1,Aaron Wiggins,OKC,OKC,CLE,,,0,0,0,0
22023,1630598,22300155,"NOV 06, 2023",OKC vs. ATL,W,7,2,2,1.0,1,1,1.0,0,0,0.0,1,0,1,0,0,0,0,0,5,3,1,Aaron Wiggins,OKC,OKC,ATL,,,6,6,5,1
22023,1630598,22300005,"NOV 03, 2023",OKC vs. GSW,L,17,3,6,0.5,1,3,0.333,0,0,0.0,0,2,2,0,1,0,0,1,7,-3,1,Aaron Wiggins,OKC,OKC,GSW,,,9,9,7,2
22023,1630598,22300121,"NOV 01, 2023",OKC vs. NOP,L,14,4,5,0.8,0,1,0.0,2,2,1.0,0,4,4,2,0,0,2,5,10,14,1,Aaron Wiggins,OKC,OKC,NOP,,,16,14,12,6
22023,1630598,22300095,"OCT 29, 2023",OKC vs. DEN,L,10,2,3,0.667,0,1,0.0,1,2,0.5,0,0,0,0,0,0,0,0,5,-8,1,Aaron Wiggins,OKC,OKC,DEN,,,5,5,5,0
22023,1630598,22300081,"OCT 27, 2023",OKC @ CLE,W,11,0,0,0.0,0,0,0.0,0,0,0.0,0,0,0,1,0,1,1,0,0,2,1,Aaron Wiggins,OKC,CLE,OKC,,,1,0,1,1
22023,1630598,22300070,"OCT 25, 2023",OKC @ CHI,W,11,1,3,0.333,0,1,0.0,0,0,0.0,1,2,3,0,0,0,1,2,2,-4,1,Aaron Wiggins,OKC,CHI,OKC,,,5,5,2,3
22023,203952,22300560,"JAN 15, 2024",GSW @ MEM,L,31,7,13,0.538,1,3,0.333,1,2,0.5,1,4,5,1,0,2,1,1,16,9,1,Andrew Wiggins,GSW,MEM,GSW,,,22,21,17,6
22023,203952,22300545,"JAN 13, 2024",GSW @ MIL,L,32,3,13,0.231,1,3,0.333,0,0,0.0,3,1,4,1,0,0,0,3,7,-14,1,Andrew Wiggins,GSW,MIL,GSW,,,12,11,8,5
22023,203952,22300536,"JAN 12, 2024",GSW @ CHI,W,31,8,13,0.615,1,5,0.2,0,0,0.0,3,2,5,8,1,1,0,2,17,4,1,Andrew Wiggins,GSW,CHI,GSW,,,30,22,25,13
22023,203952,22300525,"JAN 10, 2024",GSW vs. NOP,L,23,2,8,0.25,1,3,0.333,0,0,0.0,0,2,2,2,0,0,1,2,5,-29,1,Andrew Wiggins,GSW,GSW,NOP,,,9,7,7,4
22023,203952,22300504,"JAN 07, 2024",GSW vs. TOR,L,17,1,6,0.167,0,2,0.0,1,2,0.5,0,2,2,1,0,0,1,0,3,-29,1,Andrew Wiggins,GSW,GSW,TOR,,,6,5,4,3
22023,203952,22300490,"JAN 05, 2024",GSW vs. DET,W,19,1,5,0.2,1,2,0.5,0,0,0.0,1,1,2,2,0,0,1,2,3,-5,1,Andrew Wiggins,GSW,GSW,DET,,,7,5,5,4
22023,203952,22300478,"JAN 04, 2024",GSW vs. DEN,L,27,5,10,0.5,1,4,0.25,0,0,0.0,2,1,3,0,0,1,1,2,11,-14,1,Andrew Wiggins,GSW,GSW,DEN,,,14,14,11,3
22023,203952,22300463,"JAN 02, 2024",GSW vs. ORL,W,21,4,7,0.571,1,3,0.333,1,3,0.333,0,3,3,0,2,0,1,1,10,-3,1,Andrew Wiggins,GSW,GSW,ORL,,,13,13,10,3
22023,203952,22300444,"DEC 30, 2023",GSW vs. DAL,L,28,5,13,0.385,1,3,0.333,3,3,1.0,3,2,5,4,1,1,0,2,14,-1,1,Andrew Wiggins,GSW,GSW,DAL,,,23,19,18,9
22023,203952,22300426,"DEC 28, 2023",GSW vs. MIA,L,26,4,11,0.364,0,3,0.0,3,4,0.75,1,1,2,4,0,0,1,2,11,5,1,Andrew Wiggins,GSW,GSW,MIA,,,17,13,15,6
22023,203952,22300402,"DEC 25, 2023",GSW @ DEN,L,29,7,11,0.636,2,4,0.5,6,6,1.0,1,2,3,2,0,1,2,5,22,18,1,Andrew Wiggins,GSW,DEN,GSW,,,27,25,24,5
22023,203952,22300362,"DEC 19, 2023",GSW vs. BOS,W,22,2,11,0.182,0,1,0.0,2,2,1.0,5,2,7,1,0,0,0,1,6,-10,1,Andrew Wiggins,GSW,GSW,BOS,,,14,13,7,8
22023,203952,22300348,"DEC 17, 2023",GSW @ POR,W,29,9,12,0.75,4,6,0.667,3,4,0.75,0,7,7,2,1,1,0,2,25,-3,1,Andrew Wiggins,GSW,POR,GSW,,,34,32,27,9
22023,203952,22300339,"DEC 16, 2023",GSW vs. BKN,W,27,4,9,0.444,1,1,1.0,5,5,1.0,2,3,5,1,1,0,0,0,14,0,1,Andrew Wiggins,GSW,GSW,BKN,,,20,19,15,6
22023,203952,22300325,"DEC 14, 2023",GSW @ LAC,L,22,4,9,0.444,0,4,0.0,1,2,0.5,2,1,3,0,0,1,0,5,9,-7,1,Andrew Wiggins,GSW,LAC,GSW,,,12,12,9,3
22023,203952,22300308,"DEC 12, 2023",GSW @ PHX,L,15,1,7,0.143,1,3,0.333,0,0,0.0,2,2,4,1,0,0,3,1,3,-19,1,Andrew Wiggins,GSW,PHX,GSW,,,8,7,4,5
22023,203952,22301222,"DEC 08, 2023",GSW @ OKC,L,32,4,11,0.364,2,4,0.5,2,2,1.0,2,4,6,1,0,0,6,3,12,-1,1,Andrew Wiggins,GSW,OKC,GSW,,,19,18,13,7
22023,203952,22301214,"DEC 06, 2023",GSW vs. POR,W,27,3,12,0.25,0,1,0.0,3,3,1.0,1,2,3,1,0,0,1,1,9,6,1,Andrew Wiggins,GSW,GSW,POR,,,13,12,10,4
22023,203952,22300060,"NOV 28, 2023",GSW @ SAC,L,36,11,18,0.611,2,5,0.4,5,6,0.833,2,8,10,3,0,0,3,5,29,-1,1,Andrew Wiggins,GSW,SAC,GSW,,,42,39,32,13
22023,203952,22300051,"NOV 24, 2023",GSW vs. SAS,W,25,4,10,0.4,2,4,0.5,0,0,0.0,0,4,4,0,0,0,3,3,10,-1,1,Andrew Wiggins,GSW,GSW,SAS,,,14,14,10,4
22023,203952,22300236,"NOV 22, 2023",GSW @ PHX,L,25,4,11,0.364,0,3,0.0,3,4,0.75,2,2,4,1,0,1,2,1,11,-14,1,Andrew Wiggins,GSW,PHX,GSW,,,16,15,12,5
22023,203952,22300224,"NOV 20, 2023",GSW vs. HOU,W,30,3,10,0.3,2,3,0.667,4,4,1.0,4,3,7,1,0,0,0,2,12,-3,1,Andrew Wiggins,GSW,GSW,HOU,,,20,19,13,8
22023,203952,22300207,"NOV 18, 2023",GSW vs. OKC,L,35,12,19,0.632,5,8,0.625,2,4,0.5,0,0,0,3,1,1,0,4,31,6,1,Andrew Wiggins,GSW,GSW,OKC,,,34,31,34,3
22023,203952,22300201,"NOV 16, 2023",GSW vs. OKC,L,26,6,13,0.462,0,4,0.0,0,0,0.0,4,2,6,2,0,0,5,2,12,-2,1,Andrew Wiggins,GSW,GSW,OKC,,,20,18,14,8
22023,203952,22300025,"NOV 14, 2023",GSW vs. MIN,L,28,4,15,0.267,1,7,0.143,0,0,0.0,2,5,7,0,3,1,4,5,9,2,1,Andrew Wiggins,GSW,GSW,MIN,,,16,16,9,7
22023,203952,22300186,"NOV 12, 2023",GSW vs. MIN,L,25,3,7,0.429,0,2,0.0,0,2,0.0,2,2,4,2,1,0,1,4,6,-13,1,Andrew Wiggins,GSW,GSW,MIN,,,12,10,8,6
22023,203952,22300176,"NOV 11, 2023",GSW vs. CLE,L,29,6,12,0.5,1,4,0.25,0,2,0.0,3,2,5,3,0,0,3,2,13,-13,1,Andrew Wiggins,GSW,GSW,CLE,,,21,18,16,8
22023,203952,22300169,"NOV 08, 2023",GSW @ DEN,L,29,4,13,0.308,0,3,0.0,3,4,0.75,3,2,5,0,0,0,1,3,11,-6,1,Andrew Wiggins,GSW,DEN,GSW,,,16,16,11,5
22023,203952,22300145,"NOV 06, 2023",GSW @ DET,W,22,2,9,0.222,0,2,0.0,0,2,0.0,3,3,6,1,1,1,2,0,4,-4,1,Andrew Wiggins,GSW,DET,GSW,,,11,10,5,7
22023,203952,22300142,"NOV 05, 2023",GSW @ CLE,L,26,3,9,0.333,1,2,0.5,1,4,0.25,3,2,5,1,0,0,0,1,8,-5,1,Andrew Wiggins,GSW,CLE,GSW,,,14,13,9,6
22023,203952,22300005,"NOV 03, 2023",GSW @ OKC,W,27,6,11,0.545,0,1,0.0,5,8,0.625,4,1,5,1,0,0,0,1,17,-14,1,Andrew Wiggins,GSW,OKC,GSW,,,23,22,18,6
22023,203952,22300126,"NOV 01, 2023",GSW vs. SAC,W,25,6,10,0.6,0,1,0.0,2,2,1.0,0,2,2,0,0,0,1,2,14,-5,1,Andrew Wiggins,GSW,GSW,SAC,,,16,16,14,2
22023,203952,22300108,"OCT 30, 2023",GSW @ NOP,W,20,4,8,0.5,1,2,0.5,0,2,0.0,1,2,3,0,0,0,3,2,9,10,1,Andrew Wiggins,GSW,NOP,GSW,,,12,12,9,3
22023,203952,22300096,"OCT 29, 2023",GSW @ HOU,W,28,4,10,0.4,1,3,0.333,4,5,0.8,0,0,0,0,0,0,2,2,13,-4,1,Andrew Wiggins,GSW,HOU,GSW,,,13,13,13,0
22023,203952,22300087,"OCT 27, 2023",GSW @ SAC,W,27,5,13,0.385,0,3,0.0,1,2,0.5,1,4,5,3,0,2,2,4,11,2,1,Andrew Wiggins,GSW,SAC,GSW,,,19,16,14,8
22023,203952,22300062,"OCT 24, 2023",GSW vs. PHX,L,27,4,12,0.333,0,3,0.0,2,3,0.667,1,0,1,0,0,1,0,3,10,-22,1,Andrew Wiggins,GSW,GSW,PHX,,,11,11,10,1
22023,1629623,22300346,"DEC 17, 2023",MIL vs. HOU,W,0,0,0,0.0,0,0,0.0,0,0,0.0,0,0,0,0,0,0,0,0,0,-3,1,Lindell Wigginton,MIL,MIL,HOU,,,0,0,0,0
22023,1629623,22300334,"DEC 16, 2023",MIL vs. DET,W,5,2,4,0.5,0,1,0.0,2,2,1.0,0,0,0,0,0,0,0,0,6,0,1,Lindell Wigginton,MIL,MIL,DET,,,6,6,6,0
22023,1629623,22300195,"NOV 15, 2023",MIL @ TOR,W,2,0,1,0.0,0,1,0.0,0,0,0.0,0,0,0,0,0,0,1,1,0,-7,1,Lindell Wigginton,MIL,TOR,MIL,,,0,0,0,0
22023,1629684,22300556,"JAN 15, 2024",DAL vs. NOP,W,31,3,7,0.429,1,4,0.25,0,0,0.0,0,3,3,7,3,0,0,5,7,16,1,Grant Williams,DAL,DAL,NOP,,,17,10,14,10
22023,1629684,22300547,"JAN 13, 2024",DAL vs. NOP,L,14,0,2,0.0,0,2,0.0,0,0,0.0,1,0,1,1,0,1,2,5,0,-16,1,Grant Williams,DAL,DAL,NOP,,,2,1,1,2
22023,1629684,22300530,"JAN 11, 2024",DAL vs. NYK,W,27,3,7,0.429,2,6,0.333,3,3,1.0,3,3,6,3,0,1,1,3,11,-4,1,Grant Williams,DAL,DAL,NYK,,,20,17,14,9
22023,1629684,22300515,"JAN 09, 2024",DAL vs. MEM,L,7,0,2,0.0,0,0,0.0,0,0,0.0,0,0,0,0,0,0,1,1,0,-20,1,Grant Williams,DAL,DAL,MEM,,,0,0,0,0
22023,1629684,22300501,"JAN 07, 2024",DAL vs. MIN,W,20,3,5,0.6,1,3,0.333,2,2,1.0,0,2,2,0,0,2,3,3,9,-7,1,Grant Williams,DAL,DAL,MIN,,,11,11,9,2
22023,1629684,22300472,"JAN 03, 2024",DAL vs. POR,W,15,1,2,0.5,0,0,0.0,0,0,0.0,1,1,2,2,0,0,3,2,2,4,1,Grant Williams,DAL,DAL,POR,,,6,4,4,4
22023,1629684,22300457,"JAN 01, 2024",DAL @ UTA,L,18,2,7,0.286,0,4,0.0,0,1,0.0,0,0,0,1,1,2,3,2,4,-17,1,Grant Williams,DAL,UTA,DAL,,,5,4,5,1
22023,1629684,22300444,"DEC 30, 2023",DAL @ GSW,W,19,3,3,1.0,2,2,1.0,2,2,1.0,1,5,6,0,1,0,0,1,10,2,1,Grant Williams,DAL,GSW,DAL,,,16,16,10,6
22023,1629684,22300423,"DEC 28, 2023",DAL @ MIN,L,30,3,9,0.333,2,5,0.4,0,0,0.0,0,3,3,3,1,0,2,4,8,-30,1,Grant Williams,DAL,MIN,DAL,,,14,11,11,6
22023,1629684,22300420,"DEC 27, 2023",DAL vs. CLE,L,26,2,7,0.286,0,4,0.0,0,0,0.0,2,4,6,0,2,0,0,5,4,-5,1,Grant Williams,DAL,DAL,CLE,,,10,10,4,6
22023,1629684,22300405,"DEC 25, 2023",DAL @ PHX,W,27,1,3,0.333,0,2,0.0,1,2,0.5,0,3,3,1,0,3,2,4,3,-4,1,Grant Williams,DAL,PHX,DAL,,,7,6,4,4
22023,1629684,22300398,"DEC 23, 2023",DAL vs. SAS,W,25,5,8,0.625,4,6,0.667,0,0,0.0,0,2,2,3,0,1,1,3,14,9,1,Grant Williams,DAL,DAL,SAS,,,19,16,17,5
22023,1629684,22300385,"DEC 22, 2023",DAL @ HOU,L,26,0,5,0.0,0,3,0.0,0,0,0.0,0,4,4,2,2,1,0,2,0,-28,1,Grant Williams,DAL,HOU,DAL,,,6,4,2,6
22023,1629684,22300372,"DEC 20, 2023",DAL vs. LAC,L,31,4,7,0.571,1,4,0.25,0,0,0.0,5,4,9,4,0,1,0,6,9,-18,1,Grant Williams,DAL,DAL,LAC,,,22,18,13,13
22023,1629684,22300356,"DEC 18, 2023",DAL @ DEN,L,22,3,8,0.375,1,2,0.5,0,0,0.0,1,2,3,0,0,0,0,2,7,-13,1,Grant Williams,DAL,DEN,DAL,,,10,10,7,3
22023,1629684,22300341,"DEC 16, 2023",DAL @ POR,W,31,1,4,0.25,0,3,0.0,1,1,1.0,1,3,4,3,1,1,1,4,3,0,1,Grant Williams,DAL,POR,DAL,,,10,7,6,7
22023,1629684,22300321,"DEC 14, 2023",DAL vs. MIN,L,36,2,11,0.182,1,7,0.143,0,0,0.0,0,3,3,1,1,0,1,3,5,-14,1,Grant Williams,DAL,DAL,MIN,,,9,8,6,4
22023,1629684,22300306,"DEC 12, 2023",DAL vs. LAL,W,40,7,9,0.778,5,7,0.714,0,0,0.0,1,2,3,1,1,0,1,4,19,7,1,Grant Williams,DAL,DAL,LAL,,,23,22,20,4
22023,1629684,22300287,"DEC 02, 2023",DAL vs. OKC,L,27,1,6,0.167,0,4,0.0,3,4,0.75,1,0,1,1,0,0,0,3,5,-7,1,Grant Williams,DAL,DAL,OKC,,,7,6,6,2
22023,1629684,22300277,"DEC 01, 2023",DAL vs. MEM,L,31,4,12,0.333,3,9,0.333,5,6,0.833,2,6,8,3,1,1,1,3,16,-18,1,Grant Williams,DAL,DAL,MEM,,,27,24,19,11
22023,1629684,22300059,"NOV 28, 2023",DAL vs. HOU,W,18,0,5,0.0,0,3,0.0,0,0,0.0,0,4,4,3,0,0,2,4,0,2,1,Grant Williams,DAL,DAL,HOU,,,7,4,3,7
22023,1629684,22300244,"NOV 25, 2023",DAL @ LAC,L,35,2,3,0.667,1,2,0.5,0,0,0.0,3,1,4,1,0,0,1,4,5,-9,1,Grant Williams,DAL,LAC,DAL,,,10,9,6,5
22023,1629684,22300238,"NOV 22, 2023",DAL @ LAL,W,32,2,9,0.222,2,9,0.222,0,0,0.0,1,2,3,2,0,1,0,4,6,-7,1,Grant Williams,DAL,LAL,DAL,,,11,9,8,5
22023,1629684,22300212,"NOV 19, 2023",DAL vs. SAC,L,20,3,6,0.5,1,4,0.25,0,2,0.0,2,1,3,2,0,0,1,1,7,-7,1,Grant Williams,DAL,DAL,SAC,,,12,10,9,5
22023,1629684,22300205,"NOV 18, 2023",DAL @ MIL,L,38,5,11,0.455,4,10,0.4,0,0,0.0,3,4,7,2,0,1,1,1,14,8,1,Grant Williams,DAL,MIL,DAL,,,23,21,16,9
22023,1629684,22300192,"NOV 15, 2023",DAL @ WAS,W,36,4,13,0.308,2,7,0.286,0,0,0.0,2,1,3,7,1,0,1,1,10,14,1,Grant Williams,DAL,WAS,DAL,,,20,13,17,10
22023,1629684,22300022,"NOV 14, 2023",DAL @ NOP,L,24,3,6,0.5,3,4,0.75,1,2,0.5,0,1,1,0,0,1,2,0,10,-11,1,Grant Williams,DAL,NOP,DAL,,,11,11,10,1
22023,1629684,22300183,"NOV 12, 2023",DAL @ NOP,W,22,0,4,0.0,0,2,0.0,0,0,0.0,1,1,2,1,1,2,0,1,0,19,1,Grant Williams,DAL,NOP,DAL,,,3,2,1,3
22023,1629684,22300014,"NOV 10, 2023",DAL vs. LAC,W,16,1,2,0.5,0,1,0.0,0,0,0.0,0,2,2,1,0,0,1,4,2,3,1,Grant Williams,DAL,DAL,LAC,,,5,4,3,3
22023,1629684,22300168,"NOV 08, 2023",DAL vs. TOR,L,27,2,7,0.286,2,5,0.4,0,0,0.0,0,2,2,1,0,0,0,4,6,-4,1,Grant Williams,DAL,DAL,TOR,,,9,8,7,3
22023,1629684,22300147,"NOV 06, 2023",DAL @ ORL,W,33,5,9,0.556,2,5,0.4,1,3,0.333,1,1,2,0,0,1,0,2,13,18,1,Grant Williams,DAL,ORL,DAL,,,15,15,13,2
22023,1629684,22300143,"NOV 05, 2023",DAL vs. CHA,W,31,7,9,0.778,4,5,0.8,0,1,0.0,0,4,4,3,0,1,0,3,18,2,1,Grant Williams,DAL,DAL,CHA,,,25,22,21,7
22023,1629684,22300006,"NOV 03, 2023",DAL @ DEN,L,33,4,10,0.4,3,7,0.429,2,2,1.0,2,3,5,2,1,2,1,4,13,-21,1,Grant Williams,DAL,DEN,DAL,,,20,18,15,7
22023,1629684,22300124,"NOV 01, 2023",DAL vs. CHI,W,30,7,10,0.7,7,9,0.778,4,6,0.667,2,3,5,1,1,0,0,1,25,13,1,Grant Williams,DAL,DAL,CHI,,,31,30,26,6
22023,1629684,22300106,"OCT 30, 2023",DAL @ MEM,W,31,4,8,0.5,4,8,0.5,3,4,0.75,1,2,3,2,0,0,1,1,15,18,1,Grant Williams,DAL,MEM,DAL,,,20,18,17,5
22023,1629684,22300084,"OCT 27, 2023",DAL vs. BKN,W,29,2,6,0.333,1,4,0.25,0,0,0.0,0,6,6,0,0,0,2,5,5,-4,1,Grant Williams,DAL,DAL,BKN,,,11,11,5,6
22023,1629684,22300073,"OCT 25, 2023",DAL @ SAS,W,35,6,11,0.545,4,8,0.5,1,1,1.0,1,5,6,0,0,1,3,4,17,2,1,Grant Williams,DAL,SAS,DAL,,,23,23,17,6
22023,1631114,22300565,"JAN 15, 2024",OKC @ LAL,L,35,10,18,0.556,2,4,0.5,3,4,0.75,2,1,3,6,3,0,1,1,25,1,1,Jalen Williams,OKC,LAL,OKC,17.5,Points,34,28,31,9
22023,1631114,22300565,"JAN 15, 2024",OKC @ LAL,L,35,10,18,0.556,2,4,0.5,3,4,0.75,2,1,3,6,3,0,1,1,25,1,1,Jalen Williams,OKC,LAL,OKC,4.0,Rebounds,34,28,31,9
22023,1631114,22300565,"JAN 15, 2024",OKC @ LAL,L,35,10,18,0.556,2,4,0.5,3,4,0.75,2,1,3,6,3,0,1,1,25,1,1,Jalen Williams,OKC,LAL,OKC,26.5,Pts+Rebs+Asts,34,28,31,9
22023,1631114,22300565,"JAN 15, 2024",OKC @ LAL,L,35,10,18,0.556,2,4,0.5,3,4,0.75,2,1,3,6,3,0,1,1,25,1,1,Jalen Williams,OKC,LAL,OKC,4.0,Assists,34,28,31,9
22023,1631114,22300565,"JAN 15, 2024",OKC @ LAL,L,35,10,18,0.556,2,4,0.5,3,4,0.75,2,1,3,6,3,0,1,1,25,1,1,Jalen Williams,OKC,LAL,OKC,31.5,Fantasy Score,34,28,31,9
22023,1631114,22300565,"JAN 15, 2024",OKC @ LAL,L,35,10,18,0.556,2,4,0.5,3,4,0.75,2,1,3,6,3,0,1,1,25,1,1,Jalen Williams,OKC,LAL,OKC,21.5,Pts+Rebs,34,28,31,9
22023,1631114,22300565,"JAN 15, 2024",OKC @ LAL,L,35,10,18,0.556,2,4,0.5,3,4,0.75,2,1,3,6,3,0,1,1,25,1,1,Jalen Williams,OKC,LAL,OKC,22.0,Pts+Asts,34,28,31,9
22023,1631114,22300565,"JAN 15, 2024",OKC @ LAL,L,35,10,18,0.556,2,4,0.5,3,4,0.75,2,1,3,6,3,0,1,1,25,1,1,Jalen Williams,OKC,LAL,OKC,8.5,Rebs+Asts,34,28,31,9
22023,1631114,22300565,"JAN 15, 2024",OKC @ LAL,L,35,10,18,0.556,2,4,0.5,3,4,0.75,2,1,3,6,3,0,1,1,25,1,1,Jalen Williams,OKC,LAL,OKC,1.5,Blks+Stls,34,28,31,9
22023,1631114,22300546,"JAN 13, 2024",OKC vs. ORL,W,33,7,16,0.438,1,3,0.333,1,1,1.0,2,4,6,2,0,0,2,1,16,12,1,Jalen Williams,OKC,OKC,ORL,17.5,Points,24,22,18,8
22023,1631114,22300546,"JAN 13, 2024",OKC vs. ORL,W,33,7,16,0.438,1,3,0.333,1,1,1.0,2,4,6,2,0,0,2,1,16,12,1,Jalen Williams,OKC,OKC,ORL,4.0,Rebounds,24,22,18,8
22023,1631114,22300546,"JAN 13, 2024",OKC vs. ORL,W,33,7,16,0.438,1,3,0.333,1,1,1.0,2,4,6,2,0,0,2,1,16,12,1,Jalen Williams,OKC,OKC,ORL,26.5,Pts+Rebs+Asts,24,22,18,8
22023,1631114,22300546,"JAN 13, 2024",OKC vs. ORL,W,33,7,16,0.438,1,3,0.333,1,1,1.0,2,4,6,2,0,0,2,1,16,12,1,Jalen Williams,OKC,OKC,ORL,4.0,Assists,24,22,18,8
22023,1631114,22300546,"JAN 13, 2024",OKC vs. ORL,W,33,7,16,0.438,1,3,0.333,1,1,1.0,2,4,6,2,0,0,2,1,16,12,1,Jalen Williams,OKC,OKC,ORL,31.5,Fantasy Score,24,22,18,8
22023,1631114,22300546,"JAN 13, 2024",OKC vs. ORL,W,33,7,16,0.438,1,3,0.333,1,1,1.0,2,4,6,2,0,0,2,1,16,12,1,Jalen Williams,OKC,OKC,ORL,21.5,Pts+Rebs,24,22,18,8
22023,1631114,22300546,"JAN 13, 2024",OKC vs. ORL,W,33,7,16,0.438,1,3,0.333,1,1,1.0,2,4,6,2,0,0,2,1,16,12,1,Jalen Williams,OKC,OKC,ORL,22.0,Pts+Asts,24,22,18,8
22023,1631114,22300546,"JAN 13, 2024",OKC vs. ORL,W,33,7,16,0.438,1,3,0.333,1,1,1.0,2,4,6,2,0,0,2,1,16,12,1,Jalen Williams,OKC,OKC,ORL,8.5,Rebs+Asts,24,22,18,8
22023,1631114,22300546,"JAN 13, 2024",OKC vs. ORL,W,33,7,16,0.438,1,3,0.333,1,1,1.0,2,4,6,2,0,0,2,1,16,12,1,Jalen Williams,OKC,OKC,ORL,1.5,Blks+Stls,24,22,18,8
22023,1631114,22300529,"JAN 11, 2024",OKC vs. POR,W,19,9,10,0.9,1,1,1.0,2,3,0.667,3,4,7,4,0,2,1,0,21,39,1,Jalen Williams,OKC,OKC,POR,17.5,Points,32,28,25,11
22023,1631114,22300529,"JAN 11, 2024",OKC vs. POR,W,19,9,10,0.9,1,1,1.0,2,3,0.667,3,4,7,4,0,2,1,0,21,39,1,Jalen Williams,OKC,OKC,POR,4.0,Rebounds,32,28,25,11
22023,1631114,22300529,"JAN 11, 2024",OKC vs. POR,W,19,9,10,0.9,1,1,1.0,2,3,0.667,3,4,7,4,0,2,1,0,21,39,1,Jalen Williams,OKC,OKC,POR,26.5,Pts+Rebs+Asts,32,28,25,11
22023,1631114,22300529,"JAN 11, 2024",OKC vs. POR,W,19,9,10,0.9,1,1,1.0,2,3,0.667,3,4,7,4,0,2,1,0,21,39,1,Jalen Williams,OKC,OKC,POR,4.0,Assists,32,28,25,11
22023,1631114,22300529,"JAN 11, 2024",OKC vs. POR,W,19,9,10,0.9,1,1,1.0,2,3,0.667,3,4,7,4,0,2,1,0,21,39,1,Jalen Williams,OKC,OKC,POR,31.5,Fantasy Score,32,28,25,11
22023,1631114,22300529,"JAN 11, 2024",OKC vs. POR,W,19,9,10,0.9,1,1,1.0,2,3,0.667,3,4,7,4,0,2,1,0,21,39,1,Jalen Williams,OKC,OKC,POR,21.5,Pts+Rebs,32,28,25,11
22023,1631114,22300529,"JAN 11, 2024",OKC vs. POR,W,19,9,10,0.9,1,1,1.0,2,3,0.667,3,4,7,4,0,2,1,0,21,39,1,Jalen Williams,OKC,OKC,POR,22.0,Pts+Asts,32,28,25,11
22023,1631114,22300529,"JAN 11, 2024",OKC vs. POR,W,19,9,10,0.9,1,1,1.0,2,3,0.667,3,4,7,4,0,2,1,0,21,39,1,Jalen Williams,OKC,OKC,POR,8.5,Rebs+Asts,32,28,25,11
22023,1631114,22300529,"JAN 11, 2024",OKC vs. POR,W,19,9,10,0.9,1,1,1.0,2,3,0.667,3,4,7,4,0,2,1,0,21,39,1,Jalen Williams,OKC,OKC,POR,1.5,Blks+Stls,32,28,25,11
22023,1631114,22300522,"JAN 10, 2024",OKC @ MIA,W,35,8,15,0.533,1,3,0.333,2,2,1.0,1,8,9,12,1,0,1,2,19,13,1,Jalen Williams,OKC,MIA,OKC,17.5,Points,40,28,31,21
22023,1631114,22300522,"JAN 10, 2024",OKC @ MIA,W,35,8,15,0.533,1,3,0.333,2,2,1.0,1,8,9,12,1,0,1,2,19,13,1,Jalen Williams,OKC,MIA,OKC,4.0,Rebounds,40,28,31,21
22023,1631114,22300522,"JAN 10, 2024",OKC @ MIA,W,35,8,15,0.533,1,3,0.333,2,2,1.0,1,8,9,12,1,0,1,2,19,13,1,Jalen Williams,OKC,MIA,OKC,26.5,Pts+Rebs+Asts,40,28,31,21
22023,1631114,22300522,"JAN 10, 2024",OKC @ MIA,W,35,8,15,0.533,1,3,0.333,2,2,1.0,1,8,9,12,1,0,1,2,19,13,1,Jalen Williams,OKC,MIA,OKC,4.0,Assists,40,28,31,21
22023,1631114,22300522,"JAN 10, 2024",OKC @ MIA,W,35,8,15,0.533,1,3,0.333,2,2,1.0,1,8,9,12,1,0,1,2,19,13,1,Jalen Williams,OKC,MIA,OKC,31.5,Fantasy Score,40,28,31,21
22023,1631114,22300522,"JAN 10, 2024",OKC @ MIA,W,35,8,15,0.533,1,3,0.333,2,2,1.0,1,8,9,12,1,0,1,2,19,13,1,Jalen Williams,OKC,MIA,OKC,21.5,Pts+Rebs,40,28,31,21
22023,1631114,22300522,"JAN 10, 2024",OKC @ MIA,W,35,8,15,0.533,1,3,0.333,2,2,1.0,1,8,9,12,1,0,1,2,19,13,1,Jalen Williams,OKC,MIA,OKC,22.0,Pts+Asts,40,28,31,21
22023,1631114,22300522,"JAN 10, 2024",OKC @ MIA,W,35,8,15,0.533,1,3,0.333,2,2,1.0,1,8,9,12,1,0,1,2,19,13,1,Jalen Williams,OKC,MIA,OKC,8.5,Rebs+Asts,40,28,31,21
22023,1631114,22300522,"JAN 10, 2024",OKC @ MIA,W,35,8,15,0.533,1,3,0.333,2,2,1.0,1,8,9,12,1,0,1,2,19,13,1,Jalen Williams,OKC,MIA,OKC,1.5,Blks+Stls,40,28,31,21
22023,1631114,22300508,"JAN 08, 2024",OKC @ WAS,W,34,9,13,0.692,1,1,1.0,2,2,1.0,1,6,7,10,2,0,4,3,21,22,1,Jalen Williams,OKC,WAS,OKC,17.5,Points,38,28,31,17
22023,1631114,22300508,"JAN 08, 2024",OKC @ WAS,W,34,9,13,0.692,1,1,1.0,2,2,1.0,1,6,7,10,2,0,4,3,21,22,1,Jalen Williams,OKC,WAS,OKC,4.0,Rebounds,38,28,31,17
22023,1631114,22300508,"JAN 08, 2024",OKC @ WAS,W,34,9,13,0.692,1,1,1.0,2,2,1.0,1,6,7,10,2,0,4,3,21,22,1,Jalen Williams,OKC,WAS,OKC,26.5,Pts+Rebs+Asts,38,28,31,17
22023,1631114,22300508,"JAN 08, 2024",OKC @ WAS,W,34,9,13,0.692,1,1,1.0,2,2,1.0,1,6,7,10,2,0,4,3,21,22,1,Jalen Williams,OKC,WAS,OKC,4.0,Assists,38,28,31,17
22023,1631114,22300508,"JAN 08, 2024",OKC @ WAS,W,34,9,13,0.692,1,1,1.0,2,2,1.0,1,6,7,10,2,0,4,3,21,22,1,Jalen Williams,OKC,WAS,OKC,31.5,Fantasy Score,38,28,31,17
22023,1631114,22300508,"JAN 08, 2024",OKC @ WAS,W,34,9,13,0.692,1,1,1.0,2,2,1.0,1,6,7,10,2,0,4,3,21,22,1,Jalen Williams,OKC,WAS,OKC,21.5,Pts+Rebs,38,28,31,17
22023,1631114,22300508,"JAN 08, 2024",OKC @ WAS,W,34,9,13,0.692,1,1,1.0,2,2,1.0,1,6,7,10,2,0,4,3,21,22,1,Jalen Williams,OKC,WAS,OKC,22.0,Pts+Asts,38,28,31,17
22023,1631114,22300508,"JAN 08, 2024",OKC @ WAS,W,34,9,13,0.692,1,1,1.0,2,2,1.0,1,6,7,10,2,0,4,3,21,22,1,Jalen Williams,OKC,WAS,OKC,8.5,Rebs+Asts,38,28,31,17
22023,1631114,22300508,"JAN 08, 2024",OKC @ WAS,W,34,9,13,0.692,1,1,1.0,2,2,1.0,1,6,7,10,2,0,4,3,21,22,1,Jalen Williams,OKC,WAS,OKC,1.5,Blks+Stls,38,28,31,17
22023,1631114,22300481,"JAN 05, 2024",OKC @ BKN,L,36,8,11,0.727,2,4,0.5,2,3,0.667,0,5,5,5,0,1,3,3,20,3,1,Jalen Williams,OKC,BKN,OKC,17.5,Points,30,25,25,10
22023,1631114,22300481,"JAN 05, 2024",OKC @ BKN,L,36,8,11,0.727,2,4,0.5,2,3,0.667,0,5,5,5,0,1,3,3,20,3,1,Jalen Williams,OKC,BKN,OKC,4.0,Rebounds,30,25,25,10
22023,1631114,22300481,"JAN 05, 2024",OKC @ BKN,L,36,8,11,0.727,2,4,0.5,2,3,0.667,0,5,5,5,0,1,3,3,20,3,1,Jalen Williams,OKC,BKN,OKC,26.5,Pts+Rebs+Asts,30,25,25,10
22023,1631114,22300481,"JAN 05, 2024",OKC @ BKN,L,36,8,11,0.727,2,4,0.5,2,3,0.667,0,5,5,5,0,1,3,3,20,3,1,Jalen Williams,OKC,BKN,OKC,4.0,Assists,30,25,25,10
22023,1631114,22300481,"JAN 05, 2024",OKC @ BKN,L,36,8,11,0.727,2,4,0.5,2,3,0.667,0,5,5,5,0,1,3,3,20,3,1,Jalen Williams,OKC,BKN,OKC,31.5,Fantasy Score,30,25,25,10
22023,1631114,22300481,"JAN 05, 2024",OKC @ BKN,L,36,8,11,0.727,2,4,0.5,2,3,0.667,0,5,5,5,0,1,3,3,20,3,1,Jalen Williams,OKC,BKN,OKC,21.5,Pts+Rebs,30,25,25,10
22023,1631114,22300481,"JAN 05, 2024",OKC @ BKN,L,36,8,11,0.727,2,4,0.5,2,3,0.667,0,5,5,5,0,1,3,3,20,3,1,Jalen Williams,OKC,BKN,OKC,22.0,Pts+Asts,30,25,25,10
22023,1631114,22300481,"JAN 05, 2024",OKC @ BKN,L,36,8,11,0.727,2,4,0.5,2,3,0.667,0,5,5,5,0,1,3,3,20,3,1,Jalen Williams,OKC,BKN,OKC,8.5,Rebs+Asts,30,25,25,10
22023,1631114,22300481,"JAN 05, 2024",OKC @ BKN,L,36,8,11,0.727,2,4,0.5,2,3,0.667,0,5,5,5,0,1,3,3,20,3,1,Jalen Williams,OKC,BKN,OKC,1.5,Blks+Stls,30,25,25,10
22023,1631114,22300467,"JAN 03, 2024",OKC @ ATL,L,35,9,12,0.75,1,1,1.0,2,5,0.4,1,2,3,6,4,0,2,4,21,3,1,Jalen Williams,OKC,ATL,OKC,17.5,Points,30,24,27,9
22023,1631114,22300467,"JAN 03, 2024",OKC @ ATL,L,35,9,12,0.75,1,1,1.0,2,5,0.4,1,2,3,6,4,0,2,4,21,3,1,Jalen Williams,OKC,ATL,OKC,4.0,Rebounds,30,24,27,9
22023,1631114,22300467,"JAN 03, 2024",OKC @ ATL,L,35,9,12,0.75,1,1,1.0,2,5,0.4,1,2,3,6,4,0,2,4,21,3,1,Jalen Williams,OKC,ATL,OKC,26.5,Pts+Rebs+Asts,30,24,27,9
22023,1631114,22300467,"JAN 03, 2024",OKC @ ATL,L,35,9,12,0.75,1,1,1.0,2,5,0.4,1,2,3,6,4,0,2,4,21,3,1,Jalen Williams,OKC,ATL,OKC,4.0,Assists,30,24,27,9
22023,1631114,22300467,"JAN 03, 2024",OKC @ ATL,L,35,9,12,0.75,1,1,1.0,2,5,0.4,1,2,3,6,4,0,2,4,21,3,1,Jalen Williams,OKC,ATL,OKC,31.5,Fantasy Score,30,24,27,9
22023,1631114,22300467,"JAN 03, 2024",OKC @ ATL,L,35,9,12,0.75,1,1,1.0,2,5,0.4,1,2,3,6,4,0,2,4,21,3,1,Jalen Williams,OKC,ATL,OKC,21.5,Pts+Rebs,30,24,27,9
22023,1631114,22300467,"JAN 03, 2024",OKC @ ATL,L,35,9,12,0.75,1,1,1.0,2,5,0.4,1,2,3,6,4,0,2,4,21,3,1,Jalen Williams,OKC,ATL,OKC,22.0,Pts+Asts,30,24,27,9
22023,1631114,22300467,"JAN 03, 2024",OKC @ ATL,L,35,9,12,0.75,1,1,1.0,2,5,0.4,1,2,3,6,4,0,2,4,21,3,1,Jalen Williams,OKC,ATL,OKC,8.5,Rebs+Asts,30,24,27,9
22023,1631114,22300467,"JAN 03, 2024",OKC @ ATL,L,35,9,12,0.75,1,1,1.0,2,5,0.4,1,2,3,6,4,0,2,4,21,3,1,Jalen Williams,OKC,ATL,OKC,1.5,Blks+Stls,30,24,27,9
22023,1631114,22300462,"JAN 02, 2024",OKC vs. BOS,W,31,6,9,0.667,2,2,1.0,2,2,1.0,0,1,1,1,3,2,5,3,16,2,1,Jalen Williams,OKC,OKC,BOS,17.5,Points,18,17,17,2
22023,1631114,22300462,"JAN 02, 2024",OKC vs. BOS,W,31,6,9,0.667,2,2,1.0,2,2,1.0,0,1,1,1,3,2,5,3,16,2,1,Jalen Williams,OKC,OKC,BOS,4.0,Rebounds,18,17,17,2
22023,1631114,22300462,"JAN 02, 2024",OKC vs. BOS,W,31,6,9,0.667,2,2,1.0,2,2,1.0,0,1,1,1,3,2,5,3,16,2,1,Jalen Williams,OKC,OKC,BOS,26.5,Pts+Rebs+Asts,18,17,17,2
22023,1631114,22300462,"JAN 02, 2024",OKC vs. BOS,W,31,6,9,0.667,2,2,1.0,2,2,1.0,0,1,1,1,3,2,5,3,16,2,1,Jalen Williams,OKC,OKC,BOS,4.0,Assists,18,17,17,2
22023,1631114,22300462,"JAN 02, 2024",OKC vs. BOS,W,31,6,9,0.667,2,2,1.0,2,2,1.0,0,1,1,1,3,2,5,3,16,2,1,Jalen Williams,OKC,OKC,BOS,31.5,Fantasy Score,18,17,17,2
22023,1631114,22300462,"JAN 02, 2024",OKC vs. BOS,W,31,6,9,0.667,2,2,1.0,2,2,1.0,0,1,1,1,3,2,5,3,16,2,1,Jalen Williams,OKC,OKC,BOS,21.5,Pts+Rebs,18,17,17,2
22023,1631114,22300462,"JAN 02, 2024",OKC vs. BOS,W,31,6,9,0.667,2,2,1.0,2,2,1.0,0,1,1,1,3,2,5,3,16,2,1,Jalen Williams,OKC,OKC,BOS,22.0,Pts+Asts,18,17,17,2
22023,1631114,22300462,"JAN 02, 2024",OKC vs. BOS,W,31,6,9,0.667,2,2,1.0,2,2,1.0,0,1,1,1,3,2,5,3,16,2,1,Jalen Williams,OKC,OKC,BOS,8.5,Rebs+Asts,18,17,17,2
22023,1631114,22300462,"JAN 02, 2024",OKC vs. BOS,W,31,6,9,0.667,2,2,1.0,2,2,1.0,0,1,1,1,3,2,5,3,16,2,1,Jalen Williams,OKC,OKC,BOS,1.5,Blks+Stls,18,17,17,2
22023,1631114,22300447,"DEC 31, 2023",OKC vs. BKN,W,29,7,14,0.5,1,3,0.333,2,4,0.5,0,3,3,5,0,1,3,1,17,7,1,Jalen Williams,OKC,OKC,BKN,17.5,Points,25,20,22,8
22023,1631114,22300447,"DEC 31, 2023",OKC vs. BKN,W,29,7,14,0.5,1,3,0.333,2,4,0.5,0,3,3,5,0,1,3,1,17,7,1,Jalen Williams,OKC,OKC,BKN,4.0,Rebounds,25,20,22,8
22023,1631114,22300447,"DEC 31, 2023",OKC vs. BKN,W,29,7,14,0.5,1,3,0.333,2,4,0.5,0,3,3,5,0,1,3,1,17,7,1,Jalen Williams,OKC,OKC,BKN,26.5,Pts+Rebs+Asts,25,20,22,8
22023,1631114,22300447,"DEC 31, 2023",OKC vs. BKN,W,29,7,14,0.5,1,3,0.333,2,4,0.5,0,3,3,5,0,1,3,1,17,7,1,Jalen Williams,OKC,OKC,BKN,4.0,Assists,25,20,22,8
22023,1631114,22300447,"DEC 31, 2023",OKC vs. BKN,W,29,7,14,0.5,1,3,0.333,2,4,0.5,0,3,3,5,0,1,3,1,17,7,1,Jalen Williams,OKC,OKC,BKN,31.5,Fantasy Score,25,20,22,8
22023,1631114,22300447,"DEC 31, 2023",OKC vs. BKN,W,29,7,14,0.5,1,3,0.333,2,4,0.5,0,3,3,5,0,1,3,1,17,7,1,Jalen Williams,OKC,OKC,BKN,21.5,Pts+Rebs,25,20,22,8
22023,1631114,22300447,"DEC 31, 2023",OKC vs. BKN,W,29,7,14,0.5,1,3,0.333,2,4,0.5,0,3,3,5,0,1,3,1,17,7,1,Jalen Williams,OKC,OKC,BKN,22.0,Pts+Asts,25,20,22,8
22023,1631114,22300447,"DEC 31, 2023",OKC vs. BKN,W,29,7,14,0.5,1,3,0.333,2,4,0.5,0,3,3,5,0,1,3,1,17,7,1,Jalen Williams,OKC,OKC,BKN,8.5,Rebs+Asts,25,20,22,8
22023,1631114,22300447,"DEC 31, 2023",OKC vs. BKN,W,29,7,14,0.5,1,3,0.333,2,4,0.5,0,3,3,5,0,1,3,1,17,7,1,Jalen Williams,OKC,OKC,BKN,1.5,Blks+Stls,25,20,22,8
22023,1631114,22300435,"DEC 29, 2023",OKC @ DEN,W,31,4,10,0.4,2,5,0.4,1,2,0.5,1,6,7,9,2,1,3,2,11,17,1,Jalen Williams,OKC,DEN,OKC,17.5,Points,27,18,20,16
22023,1631114,22300435,"DEC 29, 2023",OKC @ DEN,W,31,4,10,0.4,2,5,0.4,1,2,0.5,1,6,7,9,2,1,3,2,11,17,1,Jalen Williams,OKC,DEN,OKC,4.0,Rebounds,27,18,20,16
22023,1631114,22300435,"DEC 29, 2023",OKC @ DEN,W,31,4,10,0.4,2,5,0.4,1,2,0.5,1,6,7,9,2,1,3,2,11,17,1,Jalen Williams,OKC,DEN,OKC,26.5,Pts+Rebs+Asts,27,18,20,16
22023,1631114,22300435,"DEC 29, 2023",OKC @ DEN,W,31,4,10,0.4,2,5,0.4,1,2,0.5,1,6,7,9,2,1,3,2,11,17,1,Jalen Williams,OKC,DEN,OKC,4.0,Assists,27,18,20,16
22023,1631114,22300435,"DEC 29, 2023",OKC @ DEN,W,31,4,10,0.4,2,5,0.4,1,2,0.5,1,6,7,9,2,1,3,2,11,17,1,Jalen Williams,OKC,DEN,OKC,31.5,Fantasy Score,27,18,20,16
22023,1631114,22300435,"DEC 29, 2023",OKC @ DEN,W,31,4,10,0.4,2,5,0.4,1,2,0.5,1,6,7,9,2,1,3,2,11,17,1,Jalen Williams,OKC,DEN,OKC,21.5,Pts+Rebs,27,18,20,16
22023,1631114,22300435,"DEC 29, 2023",OKC @ DEN,W,31,4,10,0.4,2,5,0.4,1,2,0.5,1,6,7,9,2,1,3,2,11,17,1,Jalen Williams,OKC,DEN,OKC,22.0,Pts+Asts,27,18,20,16
22023,1631114,22300435,"DEC 29, 2023",OKC @ DEN,W,31,4,10,0.4,2,5,0.4,1,2,0.5,1,6,7,9,2,1,3,2,11,17,1,Jalen Williams,OKC,DEN,OKC,8.5,Rebs+Asts,27,18,20,16
22023,1631114,22300435,"DEC 29, 2023",OKC @ DEN,W,31,4,10,0.4,2,5,0.4,1,2,0.5,1,6,7,9,2,1,3,2,11,17,1,Jalen Williams,OKC,DEN,OKC,1.5,Blks+Stls,27,18,20,16
22023,1631114,22300419,"DEC 27, 2023",OKC vs. NYK,W,33,13,17,0.765,5,5,1.0,5,7,0.714,0,0,0,3,1,1,0,4,36,-2,1,Jalen Williams,OKC,OKC,NYK,17.5,Points,39,36,39,3
22023,1631114,22300419,"DEC 27, 2023",OKC vs. NYK,W,33,13,17,0.765,5,5,1.0,5,7,0.714,0,0,0,3,1,1,0,4,36,-2,1,Jalen Williams,OKC,OKC,NYK,4.0,Rebounds,39,36,39,3
22023,1631114,22300419,"DEC 27, 2023",OKC vs. NYK,W,33,13,17,0.765,5,5,1.0,5,7,0.714,0,0,0,3,1,1,0,4,36,-2,1,Jalen Williams,OKC,OKC,NYK,26.5,Pts+Rebs+Asts,39,36,39,3
22023,1631114,22300419,"DEC 27, 2023",OKC vs. NYK,W,33,13,17,0.765,5,5,1.0,5,7,0.714,0,0,0,3,1,1,0,4,36,-2,1,Jalen Williams,OKC,OKC,NYK,4.0,Assists,39,36,39,3
22023,1631114,22300419,"DEC 27, 2023",OKC vs. NYK,W,33,13,17,0.765,5,5,1.0,5,7,0.714,0,0,0,3,1,1,0,4,36,-2,1,Jalen Williams,OKC,OKC,NYK,31.5,Fantasy Score,39,36,39,3
22023,1631114,22300419,"DEC 27, 2023",OKC vs. NYK,W,33,13,17,0.765,5,5,1.0,5,7,0.714,0,0,0,3,1,1,0,4,36,-2,1,Jalen Williams,OKC,OKC,NYK,21.5,Pts+Rebs,39,36,39,3
22023,1631114,22300419,"DEC 27, 2023",OKC vs. NYK,W,33,13,17,0.765,5,5,1.0,5,7,0.714,0,0,0,3,1,1,0,4,36,-2,1,Jalen Williams,OKC,OKC,NYK,22.0,Pts+Asts,39,36,39,3
22023,1631114,22300419,"DEC 27, 2023",OKC vs. NYK,W,33,13,17,0.765,5,5,1.0,5,7,0.714,0,0,0,3,1,1,0,4,36,-2,1,Jalen Williams,OKC,OKC,NYK,8.5,Rebs+Asts,39,36,39,3
22023,1631114,22300419,"DEC 27, 2023",OKC vs. NYK,W,33,13,17,0.765,5,5,1.0,5,7,0.714,0,0,0,3,1,1,0,4,36,-2,1,Jalen Williams,OKC,OKC,NYK,1.5,Blks+Stls,39,36,39,3
22023,1631114,22300411,"DEC 26, 2023",OKC vs. MIN,W,26,7,11,0.636,4,6,0.667,3,3,1.0,0,1,1,3,0,2,1,3,21,12,1,Jalen Williams,OKC,OKC,MIN,17.5,Points,25,22,24,4
22023,1631114,22300411,"DEC 26, 2023",OKC vs. MIN,W,26,7,11,0.636,4,6,0.667,3,3,1.0,0,1,1,3,0,2,1,3,21,12,1,Jalen Williams,OKC,OKC,MIN,4.0,Rebounds,25,22,24,4
22023,1631114,22300411,"DEC 26, 2023",OKC vs. MIN,W,26,7,11,0.636,4,6,0.667,3,3,1.0,0,1,1,3,0,2,1,3,21,12,1,Jalen Williams,OKC,OKC,MIN,26.5,Pts+Rebs+Asts,25,22,24,4
22023,1631114,22300411,"DEC 26, 2023",OKC vs. MIN,W,26,7,11,0.636,4,6,0.667,3,3,1.0,0,1,1,3,0,2,1,3,21,12,1,Jalen Williams,OKC,OKC,MIN,4.0,Assists,25,22,24,4
22023,1631114,22300411,"DEC 26, 2023",OKC vs. MIN,W,26,7,11,0.636,4,6,0.667,3,3,1.0,0,1,1,3,0,2,1,3,21,12,1,Jalen Williams,OKC,OKC,MIN,31.5,Fantasy Score,25,22,24,4
22023,1631114,22300411,"DEC 26, 2023",OKC vs. MIN,W,26,7,11,0.636,4,6,0.667,3,3,1.0,0,1,1,3,0,2,1,3,21,12,1,Jalen Williams,OKC,OKC,MIN,21.5,Pts+Rebs,25,22,24,4
22023,1631114,22300411,"DEC 26, 2023",OKC vs. MIN,W,26,7,11,0.636,4,6,0.667,3,3,1.0,0,1,1,3,0,2,1,3,21,12,1,Jalen Williams,OKC,OKC,MIN,22.0,Pts+Asts,25,22,24,4
22023,1631114,22300411,"DEC 26, 2023",OKC vs. MIN,W,26,7,11,0.636,4,6,0.667,3,3,1.0,0,1,1,3,0,2,1,3,21,12,1,Jalen Williams,OKC,OKC,MIN,8.5,Rebs+Asts,25,22,24,4
22023,1631114,22300411,"DEC 26, 2023",OKC vs. MIN,W,26,7,11,0.636,4,6,0.667,3,3,1.0,0,1,1,3,0,2,1,3,21,12,1,Jalen Williams,OKC,OKC,MIN,1.5,Blks+Stls,25,22,24,4
22023,1631114,22300397,"DEC 23, 2023",OKC vs. LAL,L,34,11,17,0.647,2,5,0.4,4,4,1.0,0,6,6,3,0,0,1,3,28,2,1,Jalen Williams,OKC,OKC,LAL,17.5,Points,37,34,31,9
22023,1631114,22300397,"DEC 23, 2023",OKC vs. LAL,L,34,11,17,0.647,2,5,0.4,4,4,1.0,0,6,6,3,0,0,1,3,28,2,1,Jalen Williams,OKC,OKC,LAL,4.0,Rebounds,37,34,31,9
22023,1631114,22300397,"DEC 23, 2023",OKC vs. LAL,L,34,11,17,0.647,2,5,0.4,4,4,1.0,0,6,6,3,0,0,1,3,28,2,1,Jalen Williams,OKC,OKC,LAL,26.5,Pts+Rebs+Asts,37,34,31,9
22023,1631114,22300397,"DEC 23, 2023",OKC vs. LAL,L,34,11,17,0.647,2,5,0.4,4,4,1.0,0,6,6,3,0,0,1,3,28,2,1,Jalen Williams,OKC,OKC,LAL,4.0,Assists,37,34,31,9
22023,1631114,22300397,"DEC 23, 2023",OKC vs. LAL,L,34,11,17,0.647,2,5,0.4,4,4,1.0,0,6,6,3,0,0,1,3,28,2,1,Jalen Williams,OKC,OKC,LAL,31.5,Fantasy Score,37,34,31,9
22023,1631114,22300397,"DEC 23, 2023",OKC vs. LAL,L,34,11,17,0.647,2,5,0.4,4,4,1.0,0,6,6,3,0,0,1,3,28,2,1,Jalen Williams,OKC,OKC,LAL,21.5,Pts+Rebs,37,34,31,9
22023,1631114,22300397,"DEC 23, 2023",OKC vs. LAL,L,34,11,17,0.647,2,5,0.4,4,4,1.0,0,6,6,3,0,0,1,3,28,2,1,Jalen Williams,OKC,OKC,LAL,22.0,Pts+Asts,37,34,31,9
22023,1631114,22300397,"DEC 23, 2023",OKC vs. LAL,L,34,11,17,0.647,2,5,0.4,4,4,1.0,0,6,6,3,0,0,1,3,28,2,1,Jalen Williams,OKC,OKC,LAL,8.5,Rebs+Asts,37,34,31,9
22023,1631114,22300397,"DEC 23, 2023",OKC vs. LAL,L,34,11,17,0.647,2,5,0.4,4,4,1.0,0,6,6,3,0,0,1,3,28,2,1,Jalen Williams,OKC,OKC,LAL,1.5,Blks+Stls,37,34,31,9
22023,1631114,22300379,"DEC 21, 2023",OKC vs. LAC,W,29,6,11,0.545,1,3,0.333,0,0,0.0,1,3,4,7,2,0,2,0,13,24,1,Jalen Williams,OKC,OKC,LAC,17.5,Points,24,17,20,11
22023,1631114,22300379,"DEC 21, 2023",OKC vs. LAC,W,29,6,11,0.545,1,3,0.333,0,0,0.0,1,3,4,7,2,0,2,0,13,24,1,Jalen Williams,OKC,OKC,LAC,4.0,Rebounds,24,17,20,11
22023,1631114,22300379,"DEC 21, 2023",OKC vs. LAC,W,29,6,11,0.545,1,3,0.333,0,0,0.0,1,3,4,7,2,0,2,0,13,24,1,Jalen Williams,OKC,OKC,LAC,26.5,Pts+Rebs+Asts,24,17,20,11
22023,1631114,22300379,"DEC 21, 2023",OKC vs. LAC,W,29,6,11,0.545,1,3,0.333,0,0,0.0,1,3,4,7,2,0,2,0,13,24,1,Jalen Williams,OKC,OKC,LAC,4.0,Assists,24,17,20,11
22023,1631114,22300379,"DEC 21, 2023",OKC vs. LAC,W,29,6,11,0.545,1,3,0.333,0,0,0.0,1,3,4,7,2,0,2,0,13,24,1,Jalen Williams,OKC,OKC,LAC,31.5,Fantasy Score,24,17,20,11
22023,1631114,22300379,"DEC 21, 2023",OKC vs. LAC,W,29,6,11,0.545,1,3,0.333,0,0,0.0,1,3,4,7,2,0,2,0,13,24,1,Jalen Williams,OKC,OKC,LAC,21.5,Pts+Rebs,24,17,20,11
22023,1631114,22300379,"DEC 21, 2023",OKC vs. LAC,W,29,6,11,0.545,1,3,0.333,0,0,0.0,1,3,4,7,2,0,2,0,13,24,1,Jalen Williams,OKC,OKC,LAC,22.0,Pts+Asts,24,17,20,11
22023,1631114,22300379,"DEC 21, 2023",OKC vs. LAC,W,29,6,11,0.545,1,3,0.333,0,0,0.0,1,3,4,7,2,0,2,0,13,24,1,Jalen Williams,OKC,OKC,LAC,8.5,Rebs+Asts,24,17,20,11
22023,1631114,22300379,"DEC 21, 2023",OKC vs. LAC,W,29,6,11,0.545,1,3,0.333,0,0,0.0,1,3,4,7,2,0,2,0,13,24,1,Jalen Williams,OKC,OKC,LAC,1.5,Blks+Stls,24,17,20,11
22023,1631114,22300355,"DEC 18, 2023",OKC vs. MEM,W,28,3,9,0.333,1,3,0.333,3,4,0.75,0,4,4,5,2,1,0,2,10,14,1,Jalen Williams,OKC,OKC,MEM,17.5,Points,19,14,15,9
22023,1631114,22300355,"DEC 18, 2023",OKC vs. MEM,W,28,3,9,0.333,1,3,0.333,3,4,0.75,0,4,4,5,2,1,0,2,10,14,1,Jalen Williams,OKC,OKC,MEM,4.0,Rebounds,19,14,15,9
22023,1631114,22300355,"DEC 18, 2023",OKC vs. MEM,W,28,3,9,0.333,1,3,0.333,3,4,0.75,0,4,4,5,2,1,0,2,10,14,1,Jalen Williams,OKC,OKC,MEM,26.5,Pts+Rebs+Asts,19,14,15,9
22023,1631114,22300355,"DEC 18, 2023",OKC vs. MEM,W,28,3,9,0.333,1,3,0.333,3,4,0.75,0,4,4,5,2,1,0,2,10,14,1,Jalen Williams,OKC,OKC,MEM,4.0,Assists,19,14,15,9
22023,1631114,22300355,"DEC 18, 2023",OKC vs. MEM,W,28,3,9,0.333,1,3,0.333,3,4,0.75,0,4,4,5,2,1,0,2,10,14,1,Jalen Williams,OKC,OKC,MEM,31.5,Fantasy Score,19,14,15,9
22023,1631114,22300355,"DEC 18, 2023",OKC vs. MEM,W,28,3,9,0.333,1,3,0.333,3,4,0.75,0,4,4,5,2,1,0,2,10,14,1,Jalen Williams,OKC,OKC,MEM,21.5,Pts+Rebs,19,14,15,9
22023,1631114,22300355,"DEC 18, 2023",OKC vs. MEM,W,28,3,9,0.333,1,3,0.333,3,4,0.75,0,4,4,5,2,1,0,2,10,14,1,Jalen Williams,OKC,OKC,MEM,22.0,Pts+Asts,19,14,15,9
22023,1631114,22300355,"DEC 18, 2023",OKC vs. MEM,W,28,3,9,0.333,1,3,0.333,3,4,0.75,0,4,4,5,2,1,0,2,10,14,1,Jalen Williams,OKC,OKC,MEM,8.5,Rebs+Asts,19,14,15,9
22023,1631114,22300355,"DEC 18, 2023",OKC vs. MEM,W,28,3,9,0.333,1,3,0.333,3,4,0.75,0,4,4,5,2,1,0,2,10,14,1,Jalen Williams,OKC,OKC,MEM,1.5,Blks+Stls,19,14,15,9
22023,1631114,22300340,"DEC 16, 2023",OKC @ DEN,W,33,11,20,0.55,0,1,0.0,2,2,1.0,0,1,1,3,1,0,2,1,24,10,1,Jalen Williams,OKC,DEN,OKC,17.5,Points,28,25,27,4
22023,1631114,22300340,"DEC 16, 2023",OKC @ DEN,W,33,11,20,0.55,0,1,0.0,2,2,1.0,0,1,1,3,1,0,2,1,24,10,1,Jalen Williams,OKC,DEN,OKC,4.0,Rebounds,28,25,27,4
22023,1631114,22300340,"DEC 16, 2023",OKC @ DEN,W,33,11,20,0.55,0,1,0.0,2,2,1.0,0,1,1,3,1,0,2,1,24,10,1,Jalen Williams,OKC,DEN,OKC,26.5,Pts+Rebs+Asts,28,25,27,4
22023,1631114,22300340,"DEC 16, 2023",OKC @ DEN,W,33,11,20,0.55,0,1,0.0,2,2,1.0,0,1,1,3,1,0,2,1,24,10,1,Jalen Williams,OKC,DEN,OKC,4.0,Assists,28,25,27,4
22023,1631114,22300340,"DEC 16, 2023",OKC @ DEN,W,33,11,20,0.55,0,1,0.0,2,2,1.0,0,1,1,3,1,0,2,1,24,10,1,Jalen Williams,OKC,DEN,OKC,31.5,Fantasy Score,28,25,27,4
22023,1631114,22300340,"DEC 16, 2023",OKC @ DEN,W,33,11,20,0.55,0,1,0.0,2,2,1.0,0,1,1,3,1,0,2,1,24,10,1,Jalen Williams,OKC,DEN,OKC,21.5,Pts+Rebs,28,25,27,4
22023,1631114,22300340,"DEC 16, 2023",OKC @ DEN,W,33,11,20,0.55,0,1,0.0,2,2,1.0,0,1,1,3,1,0,2,1,24,10,1,Jalen Williams,OKC,DEN,OKC,22.0,Pts+Asts,28,25,27,4
22023,1631114,22300340,"DEC 16, 2023",OKC @ DEN,W,33,11,20,0.55,0,1,0.0,2,2,1.0,0,1,1,3,1,0,2,1,24,10,1,Jalen Williams,OKC,DEN,OKC,8.5,Rebs+Asts,28,25,27,4
22023,1631114,22300340,"DEC 16, 2023",OKC @ DEN,W,33,11,20,0.55,0,1,0.0,2,2,1.0,0,1,1,3,1,0,2,1,24,10,1,Jalen Williams,OKC,DEN,OKC,1.5,Blks+Stls,28,25,27,4
22023,1631114,22300324,"DEC 14, 2023",OKC @ SAC,L,29,2,14,0.143,0,4,0.0,1,1,1.0,2,2,4,3,1,1,1,3,5,2,1,Jalen Williams,OKC,SAC,OKC,17.5,Points,12,9,8,7
22023,1631114,22300324,"DEC 14, 2023",OKC @ SAC,L,29,2,14,0.143,0,4,0.0,1,1,1.0,2,2,4,3,1,1,1,3,5,2,1,Jalen Williams,OKC,SAC,OKC,4.0,Rebounds,12,9,8,7
22023,1631114,22300324,"DEC 14, 2023",OKC @ SAC,L,29,2,14,0.143,0,4,0.0,1,1,1.0,2,2,4,3,1,1,1,3,5,2,1,Jalen Williams,OKC,SAC,OKC,26.5,Pts+Rebs+Asts,12,9,8,7
22023,1631114,22300324,"DEC 14, 2023",OKC @ SAC,L,29,2,14,0.143,0,4,0.0,1,1,1.0,2,2,4,3,1,1,1,3,5,2,1,Jalen Williams,OKC,SAC,OKC,4.0,Assists,12,9,8,7
22023,1631114,22300324,"DEC 14, 2023",OKC @ SAC,L,29,2,14,0.143,0,4,0.0,1,1,1.0,2,2,4,3,1,1,1,3,5,2,1,Jalen Williams,OKC,SAC,OKC,31.5,Fantasy Score,12,9,8,7
22023,1631114,22300324,"DEC 14, 2023",OKC @ SAC,L,29,2,14,0.143,0,4,0.0,1,1,1.0,2,2,4,3,1,1,1,3,5,2,1,Jalen Williams,OKC,SAC,OKC,21.5,Pts+Rebs,12,9,8,7
22023,1631114,22300324,"DEC 14, 2023",OKC @ SAC,L,29,2,14,0.143,0,4,0.0,1,1,1.0,2,2,4,3,1,1,1,3,5,2,1,Jalen Williams,OKC,SAC,OKC,22.0,Pts+Asts,12,9,8,7
22023,1631114,22300324,"DEC 14, 2023",OKC @ SAC,L,29,2,14,0.143,0,4,0.0,1,1,1.0,2,2,4,3,1,1,1,3,5,2,1,Jalen Williams,OKC,SAC,OKC,8.5,Rebs+Asts,12,9,8,7
22023,1631114,22300324,"DEC 14, 2023",OKC @ SAC,L,29,2,14,0.143,0,4,0.0,1,1,1.0,2,2,4,3,1,1,1,3,5,2,1,Jalen Williams,OKC,SAC,OKC,1.5,Blks+Stls,12,9,8,7
22023,1631114,22300302,"DEC 11, 2023",OKC vs. UTA,W,22,5,10,0.5,2,2,1.0,3,3,1.0,1,2,3,3,0,0,2,1,15,16,1,Jalen Williams,OKC,OKC,UTA,17.5,Points,21,18,18,6
22023,1631114,22300302,"DEC 11, 2023",OKC vs. UTA,W,22,5,10,0.5,2,2,1.0,3,3,1.0,1,2,3,3,0,0,2,1,15,16,1,Jalen Williams,OKC,OKC,UTA,4.0,Rebounds,21,18,18,6
22023,1631114,22300302,"DEC 11, 2023",OKC vs. UTA,W,22,5,10,0.5,2,2,1.0,3,3,1.0,1,2,3,3,0,0,2,1,15,16,1,Jalen Williams,OKC,OKC,UTA,26.5,Pts+Rebs+Asts,21,18,18,6
22023,1631114,22300302,"DEC 11, 2023",OKC vs. UTA,W,22,5,10,0.5,2,2,1.0,3,3,1.0,1,2,3,3,0,0,2,1,15,16,1,Jalen Williams,OKC,OKC,UTA,4.0,Assists,21,18,18,6
22023,1631114,22300302,"DEC 11, 2023",OKC vs. UTA,W,22,5,10,0.5,2,2,1.0,3,3,1.0,1,2,3,3,0,0,2,1,15,16,1,Jalen Williams,OKC,OKC,UTA,31.5,Fantasy Score,21,18,18,6
22023,1631114,22300302,"DEC 11, 2023",OKC vs. UTA,W,22,5,10,0.5,2,2,1.0,3,3,1.0,1,2,3,3,0,0,2,1,15,16,1,Jalen Williams,OKC,OKC,UTA,21.5,Pts+Rebs,21,18,18,6
22023,1631114,22300302,"DEC 11, 2023",OKC vs. UTA,W,22,5,10,0.5,2,2,1.0,3,3,1.0,1,2,3,3,0,0,2,1,15,16,1,Jalen Williams,OKC,OKC,UTA,22.0,Pts+Asts,21,18,18,6
22023,1631114,22300302,"DEC 11, 2023",OKC vs. UTA,W,22,5,10,0.5,2,2,1.0,3,3,1.0,1,2,3,3,0,0,2,1,15,16,1,Jalen Williams,OKC,OKC,UTA,8.5,Rebs+Asts,21,18,18,6
22023,1631114,22300302,"DEC 11, 2023",OKC vs. UTA,W,22,5,10,0.5,2,2,1.0,3,3,1.0,1,2,3,3,0,0,2,1,15,16,1,Jalen Williams,OKC,OKC,UTA,1.5,Blks+Stls,21,18,18,6
22023,1631114,22301222,"DEC 08, 2023",OKC vs. GSW,W,40,12,15,0.8,1,1,1.0,3,4,0.75,0,5,5,2,3,1,1,3,28,-8,1,Jalen Williams,OKC,OKC,GSW,17.5,Points,35,33,30,7
22023,1631114,22301222,"DEC 08, 2023",OKC vs. GSW,W,40,12,15,0.8,1,1,1.0,3,4,0.75,0,5,5,2,3,1,1,3,28,-8,1,Jalen Williams,OKC,OKC,GSW,4.0,Rebounds,35,33,30,7
22023,1631114,22301222,"DEC 08, 2023",OKC vs. GSW,W,40,12,15,0.8,1,1,1.0,3,4,0.75,0,5,5,2,3,1,1,3,28,-8,1,Jalen Williams,OKC,OKC,GSW,26.5,Pts+Rebs+Asts,35,33,30,7
22023,1631114,22301222,"DEC 08, 2023",OKC vs. GSW,W,40,12,15,0.8,1,1,1.0,3,4,0.75,0,5,5,2,3,1,1,3,28,-8,1,Jalen Williams,OKC,OKC,GSW,4.0,Assists,35,33,30,7
22023,1631114,22301222,"DEC 08, 2023",OKC vs. GSW,W,40,12,15,0.8,1,1,1.0,3,4,0.75,0,5,5,2,3,1,1,3,28,-8,1,Jalen Williams,OKC,OKC,GSW,31.5,Fantasy Score,35,33,30,7
22023,1631114,22301222,"DEC 08, 2023",OKC vs. GSW,W,40,12,15,0.8,1,1,1.0,3,4,0.75,0,5,5,2,3,1,1,3,28,-8,1,Jalen Williams,OKC,OKC,GSW,21.5,Pts+Rebs,35,33,30,7
22023,1631114,22301222,"DEC 08, 2023",OKC vs. GSW,W,40,12,15,0.8,1,1,1.0,3,4,0.75,0,5,5,2,3,1,1,3,28,-8,1,Jalen Williams,OKC,OKC,GSW,22.0,Pts+Asts,35,33,30,7
22023,1631114,22301222,"DEC 08, 2023",OKC vs. GSW,W,40,12,15,0.8,1,1,1.0,3,4,0.75,0,5,5,2,3,1,1,3,28,-8,1,Jalen Williams,OKC,OKC,GSW,8.5,Rebs+Asts,35,33,30,7
22023,1631114,22301222,"DEC 08, 2023",OKC vs. GSW,W,40,12,15,0.8,1,1,1.0,3,4,0.75,0,5,5,2,3,1,1,3,28,-8,1,Jalen Williams,OKC,OKC,GSW,1.5,Blks+Stls,35,33,30,7
22023,1631114,22301212,"DEC 06, 2023",OKC @ HOU,L,33,5,13,0.385,0,1,0.0,3,3,1.0,0,5,5,3,1,0,2,2,13,-6,1,Jalen Williams,OKC,HOU,OKC,17.5,Points,21,18,16,8
22023,1631114,22301212,"DEC 06, 2023",OKC @ HOU,L,33,5,13,0.385,0,1,0.0,3,3,1.0,0,5,5,3,1,0,2,2,13,-6,1,Jalen Williams,OKC,HOU,OKC,4.0,Rebounds,21,18,16,8
22023,1631114,22301212,"DEC 06, 2023",OKC @ HOU,L,33,5,13,0.385,0,1,0.0,3,3,1.0,0,5,5,3,1,0,2,2,13,-6,1,Jalen Williams,OKC,HOU,OKC,26.5,Pts+Rebs+Asts,21,18,16,8
22023,1631114,22301212,"DEC 06, 2023",OKC @ HOU,L,33,5,13,0.385,0,1,0.0,3,3,1.0,0,5,5,3,1,0,2,2,13,-6,1,Jalen Williams,OKC,HOU,OKC,4.0,Assists,21,18,16,8
22023,1631114,22301212,"DEC 06, 2023",OKC @ HOU,L,33,5,13,0.385,0,1,0.0,3,3,1.0,0,5,5,3,1,0,2,2,13,-6,1,Jalen Williams,OKC,HOU,OKC,31.5,Fantasy Score,21,18,16,8
22023,1631114,22301212,"DEC 06, 2023",OKC @ HOU,L,33,5,13,0.385,0,1,0.0,3,3,1.0,0,5,5,3,1,0,2,2,13,-6,1,Jalen Williams,OKC,HOU,OKC,21.5,Pts+Rebs,21,18,16,8
22023,1631114,22301212,"DEC 06, 2023",OKC @ HOU,L,33,5,13,0.385,0,1,0.0,3,3,1.0,0,5,5,3,1,0,2,2,13,-6,1,Jalen Williams,OKC,HOU,OKC,22.0,Pts+Asts,21,18,16,8
22023,1631114,22301212,"DEC 06, 2023",OKC @ HOU,L,33,5,13,0.385,0,1,0.0,3,3,1.0,0,5,5,3,1,0,2,2,13,-6,1,Jalen Williams,OKC,HOU,OKC,8.5,Rebs+Asts,21,18,16,8
22023,1631114,22301212,"DEC 06, 2023",OKC @ HOU,L,33,5,13,0.385,0,1,0.0,3,3,1.0,0,5,5,3,1,0,2,2,13,-6,1,Jalen Williams,OKC,HOU,OKC,1.5,Blks+Stls,21,18,16,8
22023,1631114,22300287,"DEC 02, 2023",OKC @ DAL,W,30,9,19,0.474,3,5,0.6,2,2,1.0,2,3,5,5,1,0,1,3,23,-2,1,Jalen Williams,OKC,DAL,OKC,17.5,Points,33,28,28,10
22023,1631114,22300287,"DEC 02, 2023",OKC @ DAL,W,30,9,19,0.474,3,5,0.6,2,2,1.0,2,3,5,5,1,0,1,3,23,-2,1,Jalen Williams,OKC,DAL,OKC,4.0,Rebounds,33,28,28,10
22023,1631114,22300287,"DEC 02, 2023",OKC @ DAL,W,30,9,19,0.474,3,5,0.6,2,2,1.0,2,3,5,5,1,0,1,3,23,-2,1,Jalen Williams,OKC,DAL,OKC,26.5,Pts+Rebs+Asts,33,28,28,10
22023,1631114,22300287,"DEC 02, 2023",OKC @ DAL,W,30,9,19,0.474,3,5,0.6,2,2,1.0,2,3,5,5,1,0,1,3,23,-2,1,Jalen Williams,OKC,DAL,OKC,4.0,Assists,33,28,28,10
22023,1631114,22300287,"DEC 02, 2023",OKC @ DAL,W,30,9,19,0.474,3,5,0.6,2,2,1.0,2,3,5,5,1,0,1,3,23,-2,1,Jalen Williams,OKC,DAL,OKC,31.5,Fantasy Score,33,28,28,10
22023,1631114,22300287,"DEC 02, 2023",OKC @ DAL,W,30,9,19,0.474,3,5,0.6,2,2,1.0,2,3,5,5,1,0,1,3,23,-2,1,Jalen Williams,OKC,DAL,OKC,21.5,Pts+Rebs,33,28,28,10
22023,1631114,22300287,"DEC 02, 2023",OKC @ DAL,W,30,9,19,0.474,3,5,0.6,2,2,1.0,2,3,5,5,1,0,1,3,23,-2,1,Jalen Williams,OKC,DAL,OKC,22.0,Pts+Asts,33,28,28,10
22023,1631114,22300287,"DEC 02, 2023",OKC @ DAL,W,30,9,19,0.474,3,5,0.6,2,2,1.0,2,3,5,5,1,0,1,3,23,-2,1,Jalen Williams,OKC,DAL,OKC,8.5,Rebs+Asts,33,28,28,10
22023,1631114,22300287,"DEC 02, 2023",OKC @ DAL,W,30,9,19,0.474,3,5,0.6,2,2,1.0,2,3,5,5,1,0,1,3,23,-2,1,Jalen Williams,OKC,DAL,OKC,1.5,Blks+Stls,33,28,28,10
22023,1631114,22300271,"NOV 30, 2023",OKC vs. LAL,W,29,8,13,0.615,1,4,0.25,4,5,0.8,0,5,5,7,0,1,0,3,21,0,1,Jalen Williams,OKC,OKC,LAL,17.5,Points,33,26,28,12
22023,1631114,22300271,"NOV 30, 2023",OKC vs. LAL,W,29,8,13,0.615,1,4,0.25,4,5,0.8,0,5,5,7,0,1,0,3,21,0,1,Jalen Williams,OKC,OKC,LAL,4.0,Rebounds,33,26,28,12
22023,1631114,22300271,"NOV 30, 2023",OKC vs. LAL,W,29,8,13,0.615,1,4,0.25,4,5,0.8,0,5,5,7,0,1,0,3,21,0,1,Jalen Williams,OKC,OKC,LAL,26.5,Pts+Rebs+Asts,33,26,28,12
22023,1631114,22300271,"NOV 30, 2023",OKC vs. LAL,W,29,8,13,0.615,1,4,0.25,4,5,0.8,0,5,5,7,0,1,0,3,21,0,1,Jalen Williams,OKC,OKC,LAL,4.0,Assists,33,26,28,12
22023,1631114,22300271,"NOV 30, 2023",OKC vs. LAL,W,29,8,13,0.615,1,4,0.25,4,5,0.8,0,5,5,7,0,1,0,3,21,0,1,Jalen Williams,OKC,OKC,LAL,31.5,Fantasy Score,33,26,28,12
22023,1631114,22300271,"NOV 30, 2023",OKC vs. LAL,W,29,8,13,0.615,1,4,0.25,4,5,0.8,0,5,5,7,0,1,0,3,21,0,1,Jalen Williams,OKC,OKC,LAL,21.5,Pts+Rebs,33,26,28,12
22023,1631114,22300271,"NOV 30, 2023",OKC vs. LAL,W,29,8,13,0.615,1,4,0.25,4,5,0.8,0,5,5,7,0,1,0,3,21,0,1,Jalen Williams,OKC,OKC,LAL,22.0,Pts+Asts,33,26,28,12
22023,1631114,22300271,"NOV 30, 2023",OKC vs. LAL,W,29,8,13,0.615,1,4,0.25,4,5,0.8,0,5,5,7,0,1,0,3,21,0,1,Jalen Williams,OKC,OKC,LAL,8.5,Rebs+Asts,33,26,28,12
22023,1631114,22300271,"NOV 30, 2023",OKC vs. LAL,W,29,8,13,0.615,1,4,0.25,4,5,0.8,0,5,5,7,0,1,0,3,21,0,1,Jalen Williams,OKC,OKC,LAL,1.5,Blks+Stls,33,26,28,12
22023,1631114,22300058,"NOV 28, 2023",OKC @ MIN,L,34,2,10,0.2,0,3,0.0,6,7,0.857,0,3,3,3,0,1,1,4,10,-15,1,Jalen Williams,OKC,MIN,OKC,17.5,Points,16,13,13,6
22023,1631114,22300058,"NOV 28, 2023",OKC @ MIN,L,34,2,10,0.2,0,3,0.0,6,7,0.857,0,3,3,3,0,1,1,4,10,-15,1,Jalen Williams,OKC,MIN,OKC,4.0,Rebounds,16,13,13,6
22023,1631114,22300058,"NOV 28, 2023",OKC @ MIN,L,34,2,10,0.2,0,3,0.0,6,7,0.857,0,3,3,3,0,1,1,4,10,-15,1,Jalen Williams,OKC,MIN,OKC,26.5,Pts+Rebs+Asts,16,13,13,6
22023,1631114,22300058,"NOV 28, 2023",OKC @ MIN,L,34,2,10,0.2,0,3,0.0,6,7,0.857,0,3,3,3,0,1,1,4,10,-15,1,Jalen Williams,OKC,MIN,OKC,4.0,Assists,16,13,13,6
22023,1631114,22300058,"NOV 28, 2023",OKC @ MIN,L,34,2,10,0.2,0,3,0.0,6,7,0.857,0,3,3,3,0,1,1,4,10,-15,1,Jalen Williams,OKC,MIN,OKC,31.5,Fantasy Score,16,13,13,6
22023,1631114,22300058,"NOV 28, 2023",OKC @ MIN,L,34,2,10,0.2,0,3,0.0,6,7,0.857,0,3,3,3,0,1,1,4,10,-15,1,Jalen Williams,OKC,MIN,OKC,21.5,Pts+Rebs,16,13,13,6
22023,1631114,22300058,"NOV 28, 2023",OKC @ MIN,L,34,2,10,0.2,0,3,0.0,6,7,0.857,0,3,3,3,0,1,1,4,10,-15,1,Jalen Williams,OKC,MIN,OKC,22.0,Pts+Asts,16,13,13,6
22023,1631114,22300058,"NOV 28, 2023",OKC @ MIN,L,34,2,10,0.2,0,3,0.0,6,7,0.857,0,3,3,3,0,1,1,4,10,-15,1,Jalen Williams,OKC,MIN,OKC,8.5,Rebs+Asts,16,13,13,6
22023,1631114,22300058,"NOV 28, 2023",OKC @ MIN,L,34,2,10,0.2,0,3,0.0,6,7,0.857,0,3,3,3,0,1,1,4,10,-15,1,Jalen Williams,OKC,MIN,OKC,1.5,Blks+Stls,16,13,13,6
22023,1631114,22300207,"NOV 18, 2023",OKC @ GSW,W,41,8,16,0.5,0,2,0.0,6,6,1.0,0,6,6,3,1,0,1,2,22,6,1,Jalen Williams,OKC,GSW,OKC,17.5,Points,31,28,25,9
22023,1631114,22300207,"NOV 18, 2023",OKC @ GSW,W,41,8,16,0.5,0,2,0.0,6,6,1.0,0,6,6,3,1,0,1,2,22,6,1,Jalen Williams,OKC,GSW,OKC,4.0,Rebounds,31,28,25,9
22023,1631114,22300207,"NOV 18, 2023",OKC @ GSW,W,41,8,16,0.5,0,2,0.0,6,6,1.0,0,6,6,3,1,0,1,2,22,6,1,Jalen Williams,OKC,GSW,OKC,26.5,Pts+Rebs+Asts,31,28,25,9
22023,1631114,22300207,"NOV 18, 2023",OKC @ GSW,W,41,8,16,0.5,0,2,0.0,6,6,1.0,0,6,6,3,1,0,1,2,22,6,1,Jalen Williams,OKC,GSW,OKC,4.0,Assists,31,28,25,9
22023,1631114,22300207,"NOV 18, 2023",OKC @ GSW,W,41,8,16,0.5,0,2,0.0,6,6,1.0,0,6,6,3,1,0,1,2,22,6,1,Jalen Williams,OKC,GSW,OKC,31.5,Fantasy Score,31,28,25,9
22023,1631114,22300207,"NOV 18, 2023",OKC @ GSW,W,41,8,16,0.5,0,2,0.0,6,6,1.0,0,6,6,3,1,0,1,2,22,6,1,Jalen Williams,OKC,GSW,OKC,21.5,Pts+Rebs,31,28,25,9
22023,1631114,22300207,"NOV 18, 2023",OKC @ GSW,W,41,8,16,0.5,0,2,0.0,6,6,1.0,0,6,6,3,1,0,1,2,22,6,1,Jalen Williams,OKC,GSW,OKC,22.0,Pts+Asts,31,28,25,9
22023,1631114,22300207,"NOV 18, 2023",OKC @ GSW,W,41,8,16,0.5,0,2,0.0,6,6,1.0,0,6,6,3,1,0,1,2,22,6,1,Jalen Williams,OKC,GSW,OKC,8.5,Rebs+Asts,31,28,25,9
22023,1631114,22300207,"NOV 18, 2023",OKC @ GSW,W,41,8,16,0.5,0,2,0.0,6,6,1.0,0,6,6,3,1,0,1,2,22,6,1,Jalen Williams,OKC,GSW,OKC,1.5,Blks+Stls,31,28,25,9
22023,1631114,22300201,"NOV 16, 2023",OKC @ GSW,W,29,6,13,0.462,2,3,0.667,2,2,1.0,0,3,3,5,2,0,2,3,16,7,1,Jalen Williams,OKC,GSW,OKC,17.5,Points,24,19,21,8
22023,1631114,22300201,"NOV 16, 2023",OKC @ GSW,W,29,6,13,0.462,2,3,0.667,2,2,1.0,0,3,3,5,2,0,2,3,16,7,1,Jalen Williams,OKC,GSW,OKC,4.0,Rebounds,24,19,21,8
22023,1631114,22300201,"NOV 16, 2023",OKC @ GSW,W,29,6,13,0.462,2,3,0.667,2,2,1.0,0,3,3,5,2,0,2,3,16,7,1,Jalen Williams,OKC,GSW,OKC,26.5,Pts+Rebs+Asts,24,19,21,8
22023,1631114,22300201,"NOV 16, 2023",OKC @ GSW,W,29,6,13,0.462,2,3,0.667,2,2,1.0,0,3,3,5,2,0,2,3,16,7,1,Jalen Williams,OKC,GSW,OKC,4.0,Assists,24,19,21,8
22023,1631114,22300201,"NOV 16, 2023",OKC @ GSW,W,29,6,13,0.462,2,3,0.667,2,2,1.0,0,3,3,5,2,0,2,3,16,7,1,Jalen Williams,OKC,GSW,OKC,31.5,Fantasy Score,24,19,21,8
22023,1631114,22300201,"NOV 16, 2023",OKC @ GSW,W,29,6,13,0.462,2,3,0.667,2,2,1.0,0,3,3,5,2,0,2,3,16,7,1,Jalen Williams,OKC,GSW,OKC,21.5,Pts+Rebs,24,19,21,8
22023,1631114,22300201,"NOV 16, 2023",OKC @ GSW,W,29,6,13,0.462,2,3,0.667,2,2,1.0,0,3,3,5,2,0,2,3,16,7,1,Jalen Williams,OKC,GSW,OKC,22.0,Pts+Asts,24,19,21,8
22023,1631114,22300201,"NOV 16, 2023",OKC @ GSW,W,29,6,13,0.462,2,3,0.667,2,2,1.0,0,3,3,5,2,0,2,3,16,7,1,Jalen Williams,OKC,GSW,OKC,8.5,Rebs+Asts,24,19,21,8
22023,1631114,22300201,"NOV 16, 2023",OKC @ GSW,W,29,6,13,0.462,2,3,0.667,2,2,1.0,0,3,3,5,2,0,2,3,16,7,1,Jalen Williams,OKC,GSW,OKC,1.5,Blks+Stls,24,19,21,8
22023,1631114,22300021,"NOV 14, 2023",OKC vs. SAS,W,23,5,9,0.556,1,3,0.333,0,0,0.0,0,2,2,3,0,0,3,3,11,23,1,Jalen Williams,OKC,OKC,SAS,17.5,Points,16,13,14,5
22023,1631114,22300021,"NOV 14, 2023",OKC vs. SAS,W,23,5,9,0.556,1,3,0.333,0,0,0.0,0,2,2,3,0,0,3,3,11,23,1,Jalen Williams,OKC,OKC,SAS,4.0,Rebounds,16,13,14,5
22023,1631114,22300021,"NOV 14, 2023",OKC vs. SAS,W,23,5,9,0.556,1,3,0.333,0,0,0.0,0,2,2,3,0,0,3,3,11,23,1,Jalen Williams,OKC,OKC,SAS,26.5,Pts+Rebs+Asts,16,13,14,5
22023,1631114,22300021,"NOV 14, 2023",OKC vs. SAS,W,23,5,9,0.556,1,3,0.333,0,0,0.0,0,2,2,3,0,0,3,3,11,23,1,Jalen Williams,OKC,OKC,SAS,4.0,Assists,16,13,14,5
22023,1631114,22300021,"NOV 14, 2023",OKC vs. SAS,W,23,5,9,0.556,1,3,0.333,0,0,0.0,0,2,2,3,0,0,3,3,11,23,1,Jalen Williams,OKC,OKC,SAS,31.5,Fantasy Score,16,13,14,5
22023,1631114,22300021,"NOV 14, 2023",OKC vs. SAS,W,23,5,9,0.556,1,3,0.333,0,0,0.0,0,2,2,3,0,0,3,3,11,23,1,Jalen Williams,OKC,OKC,SAS,21.5,Pts+Rebs,16,13,14,5
22023,1631114,22300021,"NOV 14, 2023",OKC vs. SAS,W,23,5,9,0.556,1,3,0.333,0,0,0.0,0,2,2,3,0,0,3,3,11,23,1,Jalen Williams,OKC,OKC,SAS,22.0,Pts+Asts,16,13,14,5
22023,1631114,22300021,"NOV 14, 2023",OKC vs. SAS,W,23,5,9,0.556,1,3,0.333,0,0,0.0,0,2,2,3,0,0,3,3,11,23,1,Jalen Williams,OKC,OKC,SAS,8.5,Rebs+Asts,16,13,14,5
22023,1631114,22300021,"NOV 14, 2023",OKC vs. SAS,W,23,5,9,0.556,1,3,0.333,0,0,0.0,0,2,2,3,0,0,3,3,11,23,1,Jalen Williams,OKC,OKC,SAS,1.5,Blks+Stls,16,13,14,5
22023,1631114,22300185,"NOV 12, 2023",OKC @ PHX,W,38,11,16,0.688,3,4,0.75,6,8,0.75,0,1,1,1,2,0,1,4,31,23,1,Jalen Williams,OKC,PHX,OKC,17.5,Points,33,32,32,2
22023,1631114,22300185,"NOV 12, 2023",OKC @ PHX,W,38,11,16,0.688,3,4,0.75,6,8,0.75,0,1,1,1,2,0,1,4,31,23,1,Jalen Williams,OKC,PHX,OKC,4.0,Rebounds,33,32,32,2
22023,1631114,22300185,"NOV 12, 2023",OKC @ PHX,W,38,11,16,0.688,3,4,0.75,6,8,0.75,0,1,1,1,2,0,1,4,31,23,1,Jalen Williams,OKC,PHX,OKC,26.5,Pts+Rebs+Asts,33,32,32,2
22023,1631114,22300185,"NOV 12, 2023",OKC @ PHX,W,38,11,16,0.688,3,4,0.75,6,8,0.75,0,1,1,1,2,0,1,4,31,23,1,Jalen Williams,OKC,PHX,OKC,4.0,Assists,33,32,32,2
22023,1631114,22300185,"NOV 12, 2023",OKC @ PHX,W,38,11,16,0.688,3,4,0.75,6,8,0.75,0,1,1,1,2,0,1,4,31,23,1,Jalen Williams,OKC,PHX,OKC,31.5,Fantasy Score,33,32,32,2
22023,1631114,22300185,"NOV 12, 2023",OKC @ PHX,W,38,11,16,0.688,3,4,0.75,6,8,0.75,0,1,1,1,2,0,1,4,31,23,1,Jalen Williams,OKC,PHX,OKC,21.5,Pts+Rebs,33,32,32,2
22023,1631114,22300185,"NOV 12, 2023",OKC @ PHX,W,38,11,16,0.688,3,4,0.75,6,8,0.75,0,1,1,1,2,0,1,4,31,23,1,Jalen Williams,OKC,PHX,OKC,22.0,Pts+Asts,33,32,32,2
22023,1631114,22300185,"NOV 12, 2023",OKC @ PHX,W,38,11,16,0.688,3,4,0.75,6,8,0.75,0,1,1,1,2,0,1,4,31,23,1,Jalen Williams,OKC,PHX,OKC,8.5,Rebs+Asts,33,32,32,2
22023,1631114,22300185,"NOV 12, 2023",OKC @ PHX,W,38,11,16,0.688,3,4,0.75,6,8,0.75,0,1,1,1,2,0,1,4,31,23,1,Jalen Williams,OKC,PHX,OKC,1.5,Blks+Stls,33,32,32,2
22023,1631114,22300016,"NOV 10, 2023",OKC @ SAC,L,31,6,14,0.429,0,3,0.0,2,2,1.0,0,5,5,2,1,0,3,1,14,-14,1,Jalen Williams,OKC,SAC,OKC,17.5,Points,21,19,16,7
22023,1631114,22300016,"NOV 10, 2023",OKC @ SAC,L,31,6,14,0.429,0,3,0.0,2,2,1.0,0,5,5,2,1,0,3,1,14,-14,1,Jalen Williams,OKC,SAC,OKC,4.0,Rebounds,21,19,16,7
22023,1631114,22300016,"NOV 10, 2023",OKC @ SAC,L,31,6,14,0.429,0,3,0.0,2,2,1.0,0,5,5,2,1,0,3,1,14,-14,1,Jalen Williams,OKC,SAC,OKC,26.5,Pts+Rebs+Asts,21,19,16,7
22023,1631114,22300016,"NOV 10, 2023",OKC @ SAC,L,31,6,14,0.429,0,3,0.0,2,2,1.0,0,5,5,2,1,0,3,1,14,-14,1,Jalen Williams,OKC,SAC,OKC,4.0,Assists,21,19,16,7
22023,1631114,22300016,"NOV 10, 2023",OKC @ SAC,L,31,6,14,0.429,0,3,0.0,2,2,1.0,0,5,5,2,1,0,3,1,14,-14,1,Jalen Williams,OKC,SAC,OKC,31.5,Fantasy Score,21,19,16,7
22023,1631114,22300016,"NOV 10, 2023",OKC @ SAC,L,31,6,14,0.429,0,3,0.0,2,2,1.0,0,5,5,2,1,0,3,1,14,-14,1,Jalen Williams,OKC,SAC,OKC,21.5,Pts+Rebs,21,19,16,7
22023,1631114,22300016,"NOV 10, 2023",OKC @ SAC,L,31,6,14,0.429,0,3,0.0,2,2,1.0,0,5,5,2,1,0,3,1,14,-14,1,Jalen Williams,OKC,SAC,OKC,22.0,Pts+Asts,21,19,16,7
22023,1631114,22300016,"NOV 10, 2023",OKC @ SAC,L,31,6,14,0.429,0,3,0.0,2,2,1.0,0,5,5,2,1,0,3,1,14,-14,1,Jalen Williams,OKC,SAC,OKC,8.5,Rebs+Asts,21,19,16,7
22023,1631114,22300016,"NOV 10, 2023",OKC @ SAC,L,31,6,14,0.429,0,3,0.0,2,2,1.0,0,5,5,2,1,0,3,1,14,-14,1,Jalen Williams,OKC,SAC,OKC,1.5,Blks+Stls,21,19,16,7
22023,1631114,22300167,"NOV 08, 2023",OKC vs. CLE,W,33,5,10,0.5,1,1,1.0,4,4,1.0,1,3,4,2,1,0,1,3,15,-2,1,Jalen Williams,OKC,OKC,CLE,17.5,Points,21,19,17,6
22023,1631114,22300167,"NOV 08, 2023",OKC vs. CLE,W,33,5,10,0.5,1,1,1.0,4,4,1.0,1,3,4,2,1,0,1,3,15,-2,1,Jalen Williams,OKC,OKC,CLE,4.0,Rebounds,21,19,17,6
22023,1631114,22300167,"NOV 08, 2023",OKC vs. CLE,W,33,5,10,0.5,1,1,1.0,4,4,1.0,1,3,4,2,1,0,1,3,15,-2,1,Jalen Williams,OKC,OKC,CLE,26.5,Pts+Rebs+Asts,21,19,17,6
22023,1631114,22300167,"NOV 08, 2023",OKC vs. CLE,W,33,5,10,0.5,1,1,1.0,4,4,1.0,1,3,4,2,1,0,1,3,15,-2,1,Jalen Williams,OKC,OKC,CLE,4.0,Assists,21,19,17,6
22023,1631114,22300167,"NOV 08, 2023",OKC vs. CLE,W,33,5,10,0.5,1,1,1.0,4,4,1.0,1,3,4,2,1,0,1,3,15,-2,1,Jalen Williams,OKC,OKC,CLE,31.5,Fantasy Score,21,19,17,6
22023,1631114,22300167,"NOV 08, 2023",OKC vs. CLE,W,33,5,10,0.5,1,1,1.0,4,4,1.0,1,3,4,2,1,0,1,3,15,-2,1,Jalen Williams,OKC,OKC,CLE,21.5,Pts+Rebs,21,19,17,6
22023,1631114,22300167,"NOV 08, 2023",OKC vs. CLE,W,33,5,10,0.5,1,1,1.0,4,4,1.0,1,3,4,2,1,0,1,3,15,-2,1,Jalen Williams,OKC,OKC,CLE,22.0,Pts+Asts,21,19,17,6
22023,1631114,22300167,"NOV 08, 2023",OKC vs. CLE,W,33,5,10,0.5,1,1,1.0,4,4,1.0,1,3,4,2,1,0,1,3,15,-2,1,Jalen Williams,OKC,OKC,CLE,8.5,Rebs+Asts,21,19,17,6
22023,1631114,22300167,"NOV 08, 2023",OKC vs. CLE,W,33,5,10,0.5,1,1,1.0,4,4,1.0,1,3,4,2,1,0,1,3,15,-2,1,Jalen Williams,OKC,OKC,CLE,1.5,Blks+Stls,21,19,17,6
22023,1631114,22300155,"NOV 06, 2023",OKC vs. ATL,W,36,8,13,0.615,2,5,0.4,3,3,1.0,0,3,3,2,0,1,2,5,21,4,1,Jalen Williams,OKC,OKC,ATL,17.5,Points,26,24,23,5
22023,1631114,22300155,"NOV 06, 2023",OKC vs. ATL,W,36,8,13,0.615,2,5,0.4,3,3,1.0,0,3,3,2,0,1,2,5,21,4,1,Jalen Williams,OKC,OKC,ATL,4.0,Rebounds,26,24,23,5
22023,1631114,22300155,"NOV 06, 2023",OKC vs. ATL,W,36,8,13,0.615,2,5,0.4,3,3,1.0,0,3,3,2,0,1,2,5,21,4,1,Jalen Williams,OKC,OKC,ATL,26.5,Pts+Rebs+Asts,26,24,23,5
22023,1631114,22300155,"NOV 06, 2023",OKC vs. ATL,W,36,8,13,0.615,2,5,0.4,3,3,1.0,0,3,3,2,0,1,2,5,21,4,1,Jalen Williams,OKC,OKC,ATL,4.0,Assists,26,24,23,5
22023,1631114,22300155,"NOV 06, 2023",OKC vs. ATL,W,36,8,13,0.615,2,5,0.4,3,3,1.0,0,3,3,2,0,1,2,5,21,4,1,Jalen Williams,OKC,OKC,ATL,31.5,Fantasy Score,26,24,23,5
22023,1631114,22300155,"NOV 06, 2023",OKC vs. ATL,W,36,8,13,0.615,2,5,0.4,3,3,1.0,0,3,3,2,0,1,2,5,21,4,1,Jalen Williams,OKC,OKC,ATL,21.5,Pts+Rebs,26,24,23,5
22023,1631114,22300155,"NOV 06, 2023",OKC vs. ATL,W,36,8,13,0.615,2,5,0.4,3,3,1.0,0,3,3,2,0,1,2,5,21,4,1,Jalen Williams,OKC,OKC,ATL,22.0,Pts+Asts,26,24,23,5
22023,1631114,22300155,"NOV 06, 2023",OKC vs. ATL,W,36,8,13,0.615,2,5,0.4,3,3,1.0,0,3,3,2,0,1,2,5,21,4,1,Jalen Williams,OKC,OKC,ATL,8.5,Rebs+Asts,26,24,23,5
22023,1631114,22300155,"NOV 06, 2023",OKC vs. ATL,W,36,8,13,0.615,2,5,0.4,3,3,1.0,0,3,3,2,0,1,2,5,21,4,1,Jalen Williams,OKC,OKC,ATL,1.5,Blks+Stls,26,24,23,5
22023,1631114,22300005,"NOV 03, 2023",OKC vs. GSW,L,35,8,12,0.667,0,0,0.0,2,5,0.4,1,2,3,8,1,0,6,6,18,0,1,Jalen Williams,OKC,OKC,GSW,17.5,Points,29,21,26,11
22023,1631114,22300005,"NOV 03, 2023",OKC vs. GSW,L,35,8,12,0.667,0,0,0.0,2,5,0.4,1,2,3,8,1,0,6,6,18,0,1,Jalen Williams,OKC,OKC,GSW,4.0,Rebounds,29,21,26,11
22023,1631114,22300005,"NOV 03, 2023",OKC vs. GSW,L,35,8,12,0.667,0,0,0.0,2,5,0.4,1,2,3,8,1,0,6,6,18,0,1,Jalen Williams,OKC,OKC,GSW,26.5,Pts+Rebs+Asts,29,21,26,11
22023,1631114,22300005,"NOV 03, 2023",OKC vs. GSW,L,35,8,12,0.667,0,0,0.0,2,5,0.4,1,2,3,8,1,0,6,6,18,0,1,Jalen Williams,OKC,OKC,GSW,4.0,Assists,29,21,26,11
22023,1631114,22300005,"NOV 03, 2023",OKC vs. GSW,L,35,8,12,0.667,0,0,0.0,2,5,0.4,1,2,3,8,1,0,6,6,18,0,1,Jalen Williams,OKC,OKC,GSW,31.5,Fantasy Score,29,21,26,11
22023,1631114,22300005,"NOV 03, 2023",OKC vs. GSW,L,35,8,12,0.667,0,0,0.0,2,5,0.4,1,2,3,8,1,0,6,6,18,0,1,Jalen Williams,OKC,OKC,GSW,21.5,Pts+Rebs,29,21,26,11
22023,1631114,22300005,"NOV 03, 2023",OKC vs. GSW,L,35,8,12,0.667,0,0,0.0,2,5,0.4,1,2,3,8,1,0,6,6,18,0,1,Jalen Williams,OKC,OKC,GSW,22.0,Pts+Asts,29,21,26,11
22023,1631114,22300005,"NOV 03, 2023",OKC vs. GSW,L,35,8,12,0.667,0,0,0.0,2,5,0.4,1,2,3,8,1,0,6,6,18,0,1,Jalen Williams,OKC,OKC,GSW,8.5,Rebs+Asts,29,21,26,11
22023,1631114,22300005,"NOV 03, 2023",OKC vs. GSW,L,35,8,12,0.667,0,0,0.0,2,5,0.4,1,2,3,8,1,0,6,6,18,0,1,Jalen Williams,OKC,OKC,GSW,1.5,Blks+Stls,29,21,26,11
22023,1631114,22300121,"NOV 01, 2023",OKC vs. NOP,L,38,5,13,0.385,0,3,0.0,8,9,0.889,1,7,8,3,0,0,1,3,18,-8,1,Jalen Williams,OKC,OKC,NOP,17.5,Points,29,26,21,11
22023,1631114,22300121,"NOV 01, 2023",OKC vs. NOP,L,38,5,13,0.385,0,3,0.0,8,9,0.889,1,7,8,3,0,0,1,3,18,-8,1,Jalen Williams,OKC,OKC,NOP,4.0,Rebounds,29,26,21,11
22023,1631114,22300121,"NOV 01, 2023",OKC vs. NOP,L,38,5,13,0.385,0,3,0.0,8,9,0.889,1,7,8,3,0,0,1,3,18,-8,1,Jalen Williams,OKC,OKC,NOP,26.5,Pts+Rebs+Asts,29,26,21,11
22023,1631114,22300121,"NOV 01, 2023",OKC vs. NOP,L,38,5,13,0.385,0,3,0.0,8,9,0.889,1,7,8,3,0,0,1,3,18,-8,1,Jalen Williams,OKC,OKC,NOP,4.0,Assists,29,26,21,11
22023,1631114,22300121,"NOV 01, 2023",OKC vs. NOP,L,38,5,13,0.385,0,3,0.0,8,9,0.889,1,7,8,3,0,0,1,3,18,-8,1,Jalen Williams,OKC,OKC,NOP,31.5,Fantasy Score,29,26,21,11
22023,1631114,22300121,"NOV 01, 2023",OKC vs. NOP,L,38,5,13,0.385,0,3,0.0,8,9,0.889,1,7,8,3,0,0,1,3,18,-8,1,Jalen Williams,OKC,OKC,NOP,21.5,Pts+Rebs,29,26,21,11
22023,1631114,22300121,"NOV 01, 2023",OKC vs. NOP,L,38,5,13,0.385,0,3,0.0,8,9,0.889,1,7,8,3,0,0,1,3,18,-8,1,Jalen Williams,OKC,OKC,NOP,22.0,Pts+Asts,29,26,21,11
22023,1631114,22300121,"NOV 01, 2023",OKC vs. NOP,L,38,5,13,0.385,0,3,0.0,8,9,0.889,1,7,8,3,0,0,1,3,18,-8,1,Jalen Williams,OKC,OKC,NOP,8.5,Rebs+Asts,29,26,21,11
22023,1631114,22300121,"NOV 01, 2023",OKC vs. NOP,L,38,5,13,0.385,0,3,0.0,8,9,0.889,1,7,8,3,0,0,1,3,18,-8,1,Jalen Williams,OKC,OKC,NOP,1.5,Blks+Stls,29,26,21,11
22023,1631114,22300109,"OCT 30, 2023",OKC vs. DET,W,31,8,14,0.571,1,3,0.333,2,2,1.0,0,7,7,6,1,1,2,2,19,13,1,Jalen Williams,OKC,OKC,DET,17.5,Points,32,26,25,13
22023,1631114,22300109,"OCT 30, 2023",OKC vs. DET,W,31,8,14,0.571,1,3,0.333,2,2,1.0,0,7,7,6,1,1,2,2,19,13,1,Jalen Williams,OKC,OKC,DET,4.0,Rebounds,32,26,25,13
22023,1631114,22300109,"OCT 30, 2023",OKC vs. DET,W,31,8,14,0.571,1,3,0.333,2,2,1.0,0,7,7,6,1,1,2,2,19,13,1,Jalen Williams,OKC,OKC,DET,26.5,Pts+Rebs+Asts,32,26,25,13
22023,1631114,22300109,"OCT 30, 2023",OKC vs. DET,W,31,8,14,0.571,1,3,0.333,2,2,1.0,0,7,7,6,1,1,2,2,19,13,1,Jalen Williams,OKC,OKC,DET,4.0,Assists,32,26,25,13
22023,1631114,22300109,"OCT 30, 2023",OKC vs. DET,W,31,8,14,0.571,1,3,0.333,2,2,1.0,0,7,7,6,1,1,2,2,19,13,1,Jalen Williams,OKC,OKC,DET,31.5,Fantasy Score,32,26,25,13
22023,1631114,22300109,"OCT 30, 2023",OKC vs. DET,W,31,8,14,0.571,1,3,0.333,2,2,1.0,0,7,7,6,1,1,2,2,19,13,1,Jalen Williams,OKC,OKC,DET,21.5,Pts+Rebs,32,26,25,13
22023,1631114,22300109,"OCT 30, 2023",OKC vs. DET,W,31,8,14,0.571,1,3,0.333,2,2,1.0,0,7,7,6,1,1,2,2,19,13,1,Jalen Williams,OKC,OKC,DET,22.0,Pts+Asts,32,26,25,13
22023,1631114,22300109,"OCT 30, 2023",OKC vs. DET,W,31,8,14,0.571,1,3,0.333,2,2,1.0,0,7,7,6,1,1,2,2,19,13,1,Jalen Williams,OKC,OKC,DET,8.5,Rebs+Asts,32,26,25,13
22023,1631114,22300109,"OCT 30, 2023",OKC vs. DET,W,31,8,14,0.571,1,3,0.333,2,2,1.0,0,7,7,6,1,1,2,2,19,13,1,Jalen Williams,OKC,OKC,DET,1.5,Blks+Stls,32,26,25,13
22023,1631114,22300095,"OCT 29, 2023",OKC vs. DEN,L,28,6,9,0.667,0,1,0.0,1,1,1.0,0,3,3,5,0,1,0,2,13,-21,1,Jalen Williams,OKC,OKC,DEN,17.5,Points,21,16,18,8
22023,1631114,22300095,"OCT 29, 2023",OKC vs. DEN,L,28,6,9,0.667,0,1,0.0,1,1,1.0,0,3,3,5,0,1,0,2,13,-21,1,Jalen Williams,OKC,OKC,DEN,4.0,Rebounds,21,16,18,8
22023,1631114,22300095,"OCT 29, 2023",OKC vs. DEN,L,28,6,9,0.667,0,1,0.0,1,1,1.0,0,3,3,5,0,1,0,2,13,-21,1,Jalen Williams,OKC,OKC,DEN,26.5,Pts+Rebs+Asts,21,16,18,8
22023,1631114,22300095,"OCT 29, 2023",OKC vs. DEN,L,28,6,9,0.667,0,1,0.0,1,1,1.0,0,3,3,5,0,1,0,2,13,-21,1,Jalen Williams,OKC,OKC,DEN,4.0,Assists,21,16,18,8
22023,1631114,22300095,"OCT 29, 2023",OKC vs. DEN,L,28,6,9,0.667,0,1,0.0,1,1,1.0,0,3,3,5,0,1,0,2,13,-21,1,Jalen Williams,OKC,OKC,DEN,31.5,Fantasy Score,21,16,18,8
22023,1631114,22300095,"OCT 29, 2023",OKC vs. DEN,L,28,6,9,0.667,0,1,0.0,1,1,1.0,0,3,3,5,0,1,0,2,13,-21,1,Jalen Williams,OKC,OKC,DEN,21.5,Pts+Rebs,21,16,18,8
22023,1631114,22300095,"OCT 29, 2023",OKC vs. DEN,L,28,6,9,0.667,0,1,0.0,1,1,1.0,0,3,3,5,0,1,0,2,13,-21,1,Jalen Williams,OKC,OKC,DEN,22.0,Pts+Asts,21,16,18,8
22023,1631114,22300095,"OCT 29, 2023",OKC vs. DEN,L,28,6,9,0.667,0,1,0.0,1,1,1.0,0,3,3,5,0,1,0,2,13,-21,1,Jalen Williams,OKC,OKC,DEN,8.5,Rebs+Asts,21,16,18,8
22023,1631114,22300095,"OCT 29, 2023",OKC vs. DEN,L,28,6,9,0.667,0,1,0.0,1,1,1.0,0,3,3,5,0,1,0,2,13,-21,1,Jalen Williams,OKC,OKC,DEN,1.5,Blks+Stls,21,16,18,8
22023,1631114,22300081,"OCT 27, 2023",OKC @ CLE,W,35,4,14,0.286,2,4,0.5,4,4,1.0,0,5,5,2,1,0,4,2,14,5,1,Jalen Williams,OKC,CLE,OKC,17.5,Points,21,19,16,7
22023,1631114,22300081,"OCT 27, 2023",OKC @ CLE,W,35,4,14,0.286,2,4,0.5,4,4,1.0,0,5,5,2,1,0,4,2,14,5,1,Jalen Williams,OKC,CLE,OKC,4.0,Rebounds,21,19,16,7
22023,1631114,22300081,"OCT 27, 2023",OKC @ CLE,W,35,4,14,0.286,2,4,0.5,4,4,1.0,0,5,5,2,1,0,4,2,14,5,1,Jalen Williams,OKC,CLE,OKC,26.5,Pts+Rebs+Asts,21,19,16,7
22023,1631114,22300081,"OCT 27, 2023",OKC @ CLE,W,35,4,14,0.286,2,4,0.5,4,4,1.0,0,5,5,2,1,0,4,2,14,5,1,Jalen Williams,OKC,CLE,OKC,4.0,Assists,21,19,16,7
22023,1631114,22300081,"OCT 27, 2023",OKC @ CLE,W,35,4,14,0.286,2,4,0.5,4,4,1.0,0,5,5,2,1,0,4,2,14,5,1,Jalen Williams,OKC,CLE,OKC,31.5,Fantasy Score,21,19,16,7
22023,1631114,22300081,"OCT 27, 2023",OKC @ CLE,W,35,4,14,0.286,2,4,0.5,4,4,1.0,0,5,5,2,1,0,4,2,14,5,1,Jalen Williams,OKC,CLE,OKC,21.5,Pts+Rebs,21,19,16,7
22023,1631114,22300081,"OCT 27, 2023",OKC @ CLE,W,35,4,14,0.286,2,4,0.5,4,4,1.0,0,5,5,2,1,0,4,2,14,5,1,Jalen Williams,OKC,CLE,OKC,22.0,Pts+Asts,21,19,16,7
22023,1631114,22300081,"OCT 27, 2023",OKC @ CLE,W,35,4,14,0.286,2,4,0.5,4,4,1.0,0,5,5,2,1,0,4,2,14,5,1,Jalen Williams,OKC,CLE,OKC,8.5,Rebs+Asts,21,19,16,7
22023,1631114,22300081,"OCT 27, 2023",OKC @ CLE,W,35,4,14,0.286,2,4,0.5,4,4,1.0,0,5,5,2,1,0,4,2,14,5,1,Jalen Williams,OKC,CLE,OKC,1.5,Blks+Stls,21,19,16,7
22023,1631114,22300070,"OCT 25, 2023",OKC @ CHI,W,32,5,11,0.455,2,6,0.333,4,4,1.0,0,3,3,5,1,0,2,3,16,8,1,Jalen Williams,OKC,CHI,OKC,17.5,Points,24,19,21,8
22023,1631114,22300070,"OCT 25, 2023",OKC @ CHI,W,32,5,11,0.455,2,6,0.333,4,4,1.0,0,3,3,5,1,0,2,3,16,8,1,Jalen Williams,OKC,CHI,OKC,4.0,Rebounds,24,19,21,8
22023,1631114,22300070,"OCT 25, 2023",OKC @ CHI,W,32,5,11,0.455,2,6,0.333,4,4,1.0,0,3,3,5,1,0,2,3,16,8,1,Jalen Williams,OKC,CHI,OKC,26.5,Pts+Rebs+Asts,24,19,21,8
22023,1631114,22300070,"OCT 25, 2023",OKC @ CHI,W,32,5,11,0.455,2,6,0.333,4,4,1.0,0,3,3,5,1,0,2,3,16,8,1,Jalen Williams,OKC,CHI,OKC,4.0,Assists,24,19,21,8
22023,1631114,22300070,"OCT 25, 2023",OKC @ CHI,W,32,5,11,0.455,2,6,0.333,4,4,1.0,0,3,3,5,1,0,2,3,16,8,1,Jalen Williams,OKC,CHI,OKC,31.5,Fantasy Score,24,19,21,8
22023,1631114,22300070,"OCT 25, 2023",OKC @ CHI,W,32,5,11,0.455,2,6,0.333,4,4,1.0,0,3,3,5,1,0,2,3,16,8,1,Jalen Williams,OKC,CHI,OKC,21.5,Pts+Rebs,24,19,21,8
22023,1631114,22300070,"OCT 25, 2023",OKC @ CHI,W,32,5,11,0.455,2,6,0.333,4,4,1.0,0,3,3,5,1,0,2,3,16,8,1,Jalen Williams,OKC,CHI,OKC,22.0,Pts+Asts,24,19,21,8
22023,1631114,22300070,"OCT 25, 2023",OKC @ CHI,W,32,5,11,0.455,2,6,0.333,4,4,1.0,0,3,3,5,1,0,2,3,16,8,1,Jalen Williams,OKC,CHI,OKC,8.5,Rebs+Asts,24,19,21,8
22023,1631114,22300070,"OCT 25, 2023",OKC @ CHI,W,32,5,11,0.455,2,6,0.333,4,4,1.0,0,3,3,5,1,0,2,3,16,8,1,Jalen Williams,OKC,CHI,OKC,1.5,Blks+Stls,24,19,21,8
22023,1631119,22300565,"JAN 15, 2024",OKC @ LAL,L,6,1,3,0.333,1,3,0.333,0,0,0.0,1,0,1,0,0,0,0,0,3,-6,1,Jaylin Williams,OKC,LAL,OKC,,,4,4,3,1
22023,1631119,22300529,"JAN 11, 2024",OKC vs. POR,W,18,2,6,0.333,2,4,0.5,0,0,0.0,0,4,4,1,1,0,2,0,6,13,1,Jaylin Williams,OKC,OKC,POR,,,11,10,7,5
22023,1631119,22300522,"JAN 10, 2024",OKC @ MIA,W,12,1,2,0.5,1,2,0.5,0,0,0.0,0,2,2,4,0,0,0,2,3,3,1,Jaylin Williams,OKC,MIA,OKC,,,9,5,7,6
22023,1631119,22300481,"JAN 05, 2024",OKC @ BKN,L,2,0,1,0.0,0,1,0.0,0,0,0.0,0,0,0,0,0,0,0,1,0,-5,1,Jaylin Williams,OKC,BKN,OKC,,,0,0,0,0
22023,1631119,22300467,"JAN 03, 2024",OKC @ ATL,L,15,1,2,0.5,1,2,0.5,0,0,0.0,0,3,3,2,2,0,0,4,3,-10,1,Jaylin Williams,OKC,ATL,OKC,,,8,6,5,5
22023,1631119,22300462,"JAN 02, 2024",OKC vs. BOS,W,8,2,4,0.5,1,3,0.333,0,0,0.0,0,2,2,1,0,1,0,0,5,4,1,Jaylin Williams,OKC,OKC,BOS,,,8,7,6,3
22023,1631119,22300447,"DEC 31, 2023",OKC vs. BKN,W,7,1,3,0.333,0,1,0.0,1,1,1.0,1,2,3,2,0,1,0,1,3,-2,1,Jaylin Williams,OKC,OKC,BKN,,,8,6,5,5
22023,1631119,22300435,"DEC 29, 2023",OKC @ DEN,W,17,0,2,0.0,0,2,0.0,0,0,0.0,0,8,8,4,1,1,0,3,0,14,1,Jaylin Williams,OKC,DEN,OKC,,,12,8,4,12
22023,1631119,22300419,"DEC 27, 2023",OKC vs. NYK,W,7,0,1,0.0,0,1,0.0,0,0,0.0,0,2,2,0,0,0,0,1,0,-8,1,Jaylin Williams,OKC,OKC,NYK,,,2,2,0,2
22023,1631119,22300411,"DEC 26, 2023",OKC vs. MIN,W,5,0,0,0.0,0,0,0.0,0,0,0.0,0,1,1,1,0,1,0,0,0,1,1,Jaylin Williams,OKC,OKC,MIN,,,2,1,1,2
22023,1631119,22300397,"DEC 23, 2023",OKC vs. LAL,L,6,0,1,0.0,0,1,0.0,0,0,0.0,0,2,2,1,0,0,0,1,0,0,1,Jaylin Williams,OKC,OKC,LAL,,,3,2,1,3
22023,1631119,22300379,"DEC 21, 2023",OKC vs. LAC,W,6,1,1,1.0,0,0,0.0,0,0,0.0,0,2,2,1,0,0,0,0,2,4,1,Jaylin Williams,OKC,OKC,LAC,,,5,4,3,3
22023,1631119,22300355,"DEC 18, 2023",OKC vs. MEM,W,9,1,3,0.333,0,1,0.0,0,0,0.0,1,2,3,0,1,0,2,2,2,0,1,Jaylin Williams,OKC,OKC,MEM,,,5,5,2,3
22023,1631119,22300340,"DEC 16, 2023",OKC @ DEN,W,22,3,4,0.75,3,4,0.75,2,2,1.0,1,3,4,1,0,0,0,4,11,-6,1,Jaylin Williams,OKC,DEN,OKC,,,16,15,12,5
22023,1631119,22300324,"DEC 14, 2023",OKC @ SAC,L,15,1,3,0.333,1,3,0.333,0,0,0.0,1,5,6,3,0,0,0,2,3,7,1,Jaylin Williams,OKC,SAC,OKC,,,12,9,6,9
22023,1631119,22300302,"DEC 11, 2023",OKC vs. UTA,W,10,2,2,1.0,1,1,1.0,2,2,1.0,0,1,1,1,1,0,1,0,7,4,1,Jaylin Williams,OKC,OKC,UTA,,,9,8,8,2
22023,1631119,22301222,"DEC 08, 2023",OKC vs. GSW,W,6,0,2,0.0,0,2,0.0,0,0,0.0,0,1,1,0,0,0,1,1,0,-4,1,Jaylin Williams,OKC,OKC,GSW,,,1,1,0,1
22023,1631119,22301212,"DEC 06, 2023",OKC @ HOU,L,12,0,4,0.0,0,2,0.0,2,2,1.0,0,0,0,0,0,0,0,1,2,5,1,Jaylin Williams,OKC,HOU,OKC,,,2,2,2,0
22023,1631119,22300287,"DEC 02, 2023",OKC @ DAL,W,15,4,6,0.667,4,5,0.8,2,2,1.0,1,2,3,0,0,0,1,1,14,16,1,Jaylin Williams,OKC,DAL,OKC,,,17,17,14,3
22023,1631119,22300271,"NOV 30, 2023",OKC vs. LAL,W,7,1,2,0.5,1,2,0.5,0,0,0.0,0,2,2,1,0,0,0,0,3,-4,1,Jaylin Williams,OKC,OKC,LAL,,,6,5,4,3
22023,1631119,22300058,"NOV 28, 2023",OKC @ MIN,L,11,1,6,0.167,1,3,0.333,0,0,0.0,1,4,5,3,0,0,1,1,3,8,1,Jaylin Williams,OKC,MIN,OKC,,,11,8,6,8
22023,1631119,22300239,"NOV 25, 2023",OKC vs. PHI,L,26,3,9,0.333,2,5,0.4,0,0,0.0,1,5,6,5,0,0,0,4,8,-1,1,Jaylin Williams,OKC,OKC,PHI,,,19,14,13,11
22023,1631119,22300234,"NOV 22, 2023",OKC vs. CHI,W,15,0,2,0.0,0,1,0.0,0,0,0.0,1,3,4,0,0,0,0,3,0,-2,1,Jaylin Williams,OKC,OKC,CHI,,,4,4,0,4
22023,1631119,22300215,"NOV 19, 2023",OKC @ POR,W,18,3,5,0.6,0,1,0.0,0,0,0.0,3,4,7,3,1,0,1,3,6,23,1,Jaylin Williams,OKC,POR,OKC,,,16,13,9,10
22023,1631119,22300207,"NOV 18, 2023",OKC @ GSW,W,6,1,1,1.0,0,0,0.0,0,0,0.0,0,2,2,0,0,0,0,0,2,-9,1,Jaylin Williams,OKC,GSW,OKC,,,4,4,2,2
22023,1631119,22300201,"NOV 16, 2023",OKC @ GSW,W,4,1,2,0.5,0,1,0.0,0,0,0.0,0,3,3,1,0,0,0,0,2,1,1,Jaylin Williams,OKC,GSW,OKC,,,6,5,3,4
22023,1631119,22300021,"NOV 14, 2023",OKC vs. SAS,W,18,1,7,0.143,1,4,0.25,0,0,0.0,0,4,4,2,2,0,0,2,3,6,1,Jaylin Williams,OKC,OKC,SAS,,,9,7,5,6
22023,1631119,22300185,"NOV 12, 2023",OKC @ PHX,W,13,1,3,0.333,1,3,0.333,0,0,0.0,1,3,4,0,0,1,1,0,3,-11,1,Jaylin Williams,OKC,PHX,OKC,,,7,7,3,4
22023,1631119,22300016,"NOV 10, 2023",OKC @ SAC,L,18,0,2,0.0,0,2,0.0,1,2,0.5,0,4,4,2,1,0,0,3,1,6,1,Jaylin Williams,OKC,SAC,OKC,,,7,5,3,6
22023,1631119,22300167,"NOV 08, 2023",OKC vs. CLE,W,10,2,2,1.0,2,2,1.0,0,0,0.0,1,2,3,0,0,0,1,4,6,1,1,Jaylin Williams,OKC,OKC,CLE,,,9,9,6,3
22023,1631119,22300155,"NOV 06, 2023",OKC vs. ATL,W,13,2,4,0.5,0,1,0.0,2,2,1.0,0,2,2,2,1,1,0,3,6,2,1,Jaylin Williams,OKC,OKC,ATL,,,10,8,8,4
22023,1631119,22300005,"NOV 03, 2023",OKC vs. GSW,L,15,2,5,0.4,0,3,0.0,2,2,1.0,0,5,5,3,0,0,1,1,6,-2,1,Jaylin Williams,OKC,OKC,GSW,,,14,11,9,8
22023,1629026,22300565,"JAN 15, 2024",OKC @ LAL,L,17,2,5,0.4,1,3,0.333,0,0,0.0,0,2,2,0,1,0,0,1,5,3,1,Kenrich Williams,OKC,LAL,OKC,,,7,7,5,2
22023,1629026,22300546,"JAN 13, 2024",OKC vs. ORL,W,16,1,2,0.5,1,2,0.5,0,0,0.0,0,5,5,2,0,0,0,1,3,7,1,Kenrich Williams,OKC,OKC,ORL,,,10,8,5,7
22023,1629026,22300529,"JAN 11, 2024",OKC vs. POR,W,10,1,4,0.25,0,2,0.0,0,0,0.0,0,0,0,0,0,0,0,0,2,8,1,Kenrich Williams,OKC,OKC,POR,,,2,2,2,0
22023,1629026,22300522,"JAN 10, 2024",OKC @ MIA,W,17,3,4,0.75,1,2,0.5,0,0,0.0,1,5,6,2,0,0,2,0,7,6,1,Kenrich Williams,OKC,MIA,OKC,,,15,13,9,8
22023,1629026,22300508,"JAN 08, 2024",OKC @ WAS,W,17,1,3,0.333,0,1,0.0,0,0,0.0,2,1,3,2,1,0,1,2,2,3,1,Kenrich Williams,OKC,WAS,OKC,,,7,5,4,5
22023,1629026,22300481,"JAN 05, 2024",OKC @ BKN,L,12,0,1,0.0,0,0,0.0,0,0,0.0,0,1,1,1,1,0,3,2,0,-12,1,Kenrich Williams,OKC,BKN,OKC,,,2,1,1,2
22023,1629026,22300462,"JAN 02, 2024",OKC vs. BOS,W,13,1,3,0.333,0,1,0.0,0,0,0.0,3,1,4,2,0,0,0,4,2,-1,1,Kenrich Williams,OKC,OKC,BOS,,,8,6,4,6
22023,1629026,22300447,"DEC 31, 2023",OKC vs. BKN,W,18,1,4,0.25,0,2,0.0,0,0,0.0,0,4,4,2,0,0,0,0,2,7,1,Kenrich Williams,OKC,OKC,BKN,,,8,6,4,6
22023,1629026,22300435,"DEC 29, 2023",OKC @ DEN,W,15,2,7,0.286,1,4,0.25,0,0,0.0,1,1,2,0,1,0,0,2,5,-4,1,Kenrich Williams,OKC,DEN,OKC,,,7,7,5,2
22023,1629026,22300419,"DEC 27, 2023",OKC vs. NYK,W,21,1,1,1.0,1,1,1.0,0,0,0.0,0,1,1,1,2,0,0,1,3,3,1,Kenrich Williams,OKC,OKC,NYK,,,5,4,4,2
22023,1629026,22300411,"DEC 26, 2023",OKC vs. MIN,W,16,2,4,0.5,2,3,0.667,0,0,0.0,0,3,3,2,1,0,0,0,6,9,1,Kenrich Williams,OKC,OKC,MIN,,,11,9,8,5
22023,1629026,22300397,"DEC 23, 2023",OKC vs. LAL,L,23,4,6,0.667,3,4,0.75,0,0,0.0,1,1,2,5,1,1,0,2,11,1,1,Kenrich Williams,OKC,OKC,LAL,,,18,13,16,7
22023,1629026,22300379,"DEC 21, 2023",OKC vs. LAC,W,18,2,2,1.0,1,1,1.0,0,0,0.0,0,2,2,3,2,0,0,1,5,0,1,Kenrich Williams,OKC,OKC,LAC,,,10,7,8,5
22023,1629026,22300355,"DEC 18, 2023",OKC vs. MEM,W,15,2,3,0.667,2,3,0.667,0,0,0.0,0,4,4,3,0,0,1,0,6,26,1,Kenrich Williams,OKC,OKC,MEM,,,13,10,9,7
22023,1629026,22300340,"DEC 16, 2023",OKC @ DEN,W,13,1,4,0.25,0,1,0.0,0,0,0.0,3,2,5,0,0,0,0,4,2,-7,1,Kenrich Williams,OKC,DEN,OKC,,,7,7,2,5
22023,1629026,22300324,"DEC 14, 2023",OKC @ SAC,L,11,1,5,0.2,0,2,0.0,0,0,0.0,0,0,0,1,0,0,0,1,2,-5,1,Kenrich Williams,OKC,SAC,OKC,,,3,2,3,1
22023,1629026,22300302,"DEC 11, 2023",OKC vs. UTA,W,7,1,1,1.0,0,0,0.0,0,0,0.0,0,2,2,1,1,0,0,0,2,0,1,Kenrich Williams,OKC,OKC,UTA,,,5,4,3,3
22023,1629026,22301222,"DEC 08, 2023",OKC vs. GSW,W,9,1,4,0.25,0,3,0.0,0,0,0.0,0,2,2,0,0,0,0,1,2,2,1,Kenrich Williams,OKC,OKC,GSW,,,4,4,2,2
22023,1629026,22301212,"DEC 06, 2023",OKC @ HOU,L,15,3,5,0.6,2,4,0.5,0,2,0.0,0,2,2,1,0,2,0,1,8,-1,1,Kenrich Williams,OKC,HOU,OKC,,,11,10,9,3
22023,1629026,22300287,"DEC 02, 2023",OKC @ DAL,W,11,2,4,0.5,1,1,1.0,0,0,0.0,3,3,6,0,0,0,2,1,5,-13,1,Kenrich Williams,OKC,DAL,OKC,,,11,11,5,6
22023,1629026,22300271,"NOV 30, 2023",OKC vs. LAL,W,19,0,4,0.0,0,1,0.0,1,2,0.5,0,2,2,3,2,0,0,3,1,10,1,Kenrich Williams,OKC,OKC,LAL,,,6,3,4,5
22023,1629026,22300058,"NOV 28, 2023",OKC @ MIN,L,15,1,3,0.333,0,2,0.0,0,0,0.0,1,1,2,0,0,0,0,4,2,1,1,Kenrich Williams,OKC,MIN,OKC,,,4,4,2,2
22023,1629026,22300239,"NOV 25, 2023",OKC vs. PHI,L,19,4,5,0.8,2,3,0.667,1,2,0.5,0,2,2,2,1,0,0,2,11,-3,1,Kenrich Williams,OKC,OKC,PHI,,,15,13,13,4
22023,1629026,22300234,"NOV 22, 2023",OKC vs. CHI,W,23,5,6,0.833,3,3,1.0,0,2,0.0,1,4,5,2,0,0,0,0,13,10,1,Kenrich Williams,OKC,OKC,CHI,,,20,18,15,7
22023,1629026,22300215,"NOV 19, 2023",OKC @ POR,W,8,1,2,0.5,1,1,1.0,0,0,0.0,0,1,1,3,0,0,0,2,3,11,1,Kenrich Williams,OKC,POR,OKC,,,7,4,6,4
22023,1629026,22300207,"NOV 18, 2023",OKC @ GSW,W,22,0,3,0.0,0,1,0.0,1,2,0.5,1,3,4,1,1,0,0,2,1,7,1,Kenrich Williams,OKC,GSW,OKC,,,6,5,2,5
22023,1629026,22300201,"NOV 16, 2023",OKC @ GSW,W,18,3,3,1.0,0,0,0.0,0,0,0.0,2,3,5,3,0,0,0,3,6,16,1,Kenrich Williams,OKC,GSW,OKC,,,14,11,9,8
22023,1629026,22300021,"NOV 14, 2023",OKC vs. SAS,W,15,4,7,0.571,1,3,0.333,0,0,0.0,0,0,0,2,0,0,1,3,9,13,1,Kenrich Williams,OKC,OKC,SAS,,,11,9,11,2
22023,1631109,22301216,"DEC 08, 2023",CHA vs. TOR,W,20,2,4,0.5,0,0,0.0,0,0,0.0,2,1,3,1,1,2,1,2,4,5,1,Mark Williams,CHA,CHA,TOR,,,8,7,5,4
22023,1631109,22300281,"DEC 02, 2023",CHA vs. MIN,L,29,4,6,0.667,0,0,0.0,3,4,0.75,2,4,6,0,0,0,1,6,11,-8,1,Mark Williams,CHA,CHA,MIN,,,17,17,11,6
22023,1631109,22300266,"NOV 30, 2023",CHA @ BKN,W,32,5,12,0.417,0,0,0.0,2,2,1.0,5,7,12,1,1,3,0,2,12,-2,1,Mark Williams,CHA,BKN,CHA,,,25,24,13,13
22023,1631109,22300057,"NOV 28, 2023",CHA @ NYK,L,25,5,9,0.556,0,0,0.0,2,2,1.0,6,6,12,0,1,0,0,2,12,-7,1,Mark Williams,CHA,NYK,CHA,,,24,24,12,12
22023,1631109,22300248,"NOV 26, 2023",CHA @ ORL,L,22,5,6,0.833,0,0,0.0,2,2,1.0,1,5,6,1,1,1,1,4,12,-11,1,Mark Williams,CHA,ORL,CHA,,,19,18,13,7
22023,1631109,22300225,"NOV 22, 2023",CHA vs. WAS,W,35,4,10,0.4,0,0,0.0,3,6,0.5,5,10,15,0,0,3,0,4,11,6,1,Mark Williams,CHA,CHA,WAS,,,26,26,11,15
22023,1631109,22300217,"NOV 20, 2023",CHA vs. BOS,W,33,8,14,0.571,0,0,0.0,2,2,1.0,8,8,16,2,1,3,1,4,18,33,1,Mark Williams,CHA,CHA,BOS,,,36,34,20,18
22023,1631109,22300202,"NOV 18, 2023",CHA vs. NYK,L,30,3,5,0.6,0,0,0.0,1,2,0.5,2,6,8,4,0,1,1,3,7,-1,1,Mark Williams,CHA,CHA,NYK,,,19,15,11,12
22023,1631109,22300027,"NOV 17, 2023",CHA vs. MIL,L,32,4,7,0.571,0,0,0.0,3,4,0.75,6,10,16,2,1,0,0,1,11,-14,1,Mark Williams,CHA,CHA,MIL,,,29,27,13,18
22023,1631109,22300017,"NOV 14, 2023",CHA vs. MIA,L,23,5,5,1.0,0,0,0.0,1,4,0.25,4,3,7,0,1,0,0,2,11,-11,1,Mark Williams,CHA,CHA,MIA,,,18,18,11,7
22023,1631109,22300177,"NOV 12, 2023",CHA @ NYK,L,23,4,5,0.8,0,0,0.0,2,2,1.0,2,2,4,2,2,0,1,3,10,-22,1,Mark Williams,CHA,NYK,CHA,,,16,14,12,6
22023,1631109,22300009,"NOV 10, 2023",CHA @ WAS,W,30,10,21,0.476,0,0,0.0,1,2,0.5,15,9,24,3,0,0,0,0,21,19,1,Mark Williams,CHA,WAS,CHA,,,48,45,24,27
22023,1631109,22300157,"NOV 08, 2023",CHA vs. WAS,L,18,5,5,1.0,0,0,0.0,4,6,0.667,2,5,7,0,0,1,1,4,14,2,1,Mark Williams,CHA,CHA,WAS,,,21,21,14,7
22023,1631109,22300143,"NOV 05, 2023",CHA @ DAL,L,27,8,8,1.0,0,0,0.0,3,6,0.5,2,8,10,1,0,0,2,3,19,-1,1,Mark Williams,CHA,DAL,CHA,,,30,29,20,11
22023,1631109,22300133,"NOV 04, 2023",CHA @ IND,W,30,9,12,0.75,0,0,0.0,9,9,1.0,4,3,7,1,2,2,3,2,27,-3,1,Mark Williams,CHA,IND,CHA,,,35,34,28,8
22023,1631109,22300122,"NOV 01, 2023",CHA @ HOU,L,25,3,4,0.75,0,0,0.0,3,6,0.5,3,3,6,1,2,2,1,0,9,-1,1,Mark Williams,CHA,HOU,CHA,,,16,15,10,7
22023,1631109,22300101,"OCT 30, 2023",CHA vs. BKN,L,23,8,8,1.0,0,0,0.0,2,2,1.0,1,6,7,1,0,0,1,1,18,-7,1,Mark Williams,CHA,CHA,BKN,,,26,25,19,8
22023,1631109,22300077,"OCT 27, 2023",CHA vs. DET,L,21,1,4,0.25,0,0,0.0,0,0,0.0,2,1,3,1,0,1,1,5,2,-17,1,Mark Williams,CHA,CHA,DET,,,6,5,3,4
22023,1631109,22300063,"OCT 25, 2023",CHA vs. ATL,W,30,5,6,0.833,0,0,0.0,3,3,1.0,4,11,15,1,3,1,2,2,13,19,1,Mark Williams,CHA,CHA,ATL,,,29,28,14,16
22023,1631466,22300555,"JAN 15, 2024",HOU @ PHI,L,5,0,2,0.0,0,0,0.0,2,2,1.0,1,0,1,1,1,0,1,1,2,10,1,Nate Williams,HOU,PHI,HOU,,,4,3,3,2
22023,1631466,22300542,"JAN 13, 2024",HOU @ BOS,L,9,2,3,0.667,0,0,0.0,1,1,1.0,2,0,2,0,0,0,0,1,5,1,1,Nate Williams,HOU,BOS,HOU,,,7,7,5,2
22023,1631466,22300263,"NOV 29, 2023",HOU @ DEN,L,6,1,2,0.5,0,0,0.0,0,0,0.0,0,0,0,1,0,0,0,1,2,6,1,Nate Williams,HOU,DEN,HOU,,,3,2,3,1
22023,1631466,22300231,"NOV 22, 2023",HOU vs. MEM,W,3,1,2,0.5,0,0,0.0,0,0,0.0,0,0,0,0,0,0,0,1,2,-4,1,Nate Williams,HOU,HOU,MEM,,,2,2,2,0
22023,1631466,22300163,"NOV 08, 2023",HOU vs. LAL,W,8,2,4,0.5,0,1,0.0,1,2,0.5,0,0,0,1,1,0,0,0,5,5,1,Nate Williams,HOU,HOU,LAL,,,6,5,6,1
22023,1631466,22300066,"OCT 25, 2023",HOU @ ORL,L,5,2,3,0.667,0,1,0.0,0,0,0.0,0,0,0,0,0,0,0,0,4,-9,1,Nate Williams,HOU,ORL,HOU,,,4,4,4,0
22023,1630172,22300536,"JAN 12, 2024",CHI vs. GSW,L,29,4,8,0.5,1,3,0.333,0,0,0.0,1,2,3,7,1,0,2,3,9,-2,1,Patrick Williams,CHI,CHI,GSW,,,19,12,16,10
22023,1630172,22300523,"JAN 10, 2024",CHI vs. HOU,W,29,2,6,0.333,1,3,0.333,0,0,0.0,0,0,0,1,3,0,2,2,5,9,1,Patrick Williams,CHI,CHI,HOU,,,6,5,6,1
22023,1630172,22300506,"JAN 08, 2024",CHI @ CHA,W,23,2,6,0.333,1,2,0.5,3,4,0.75,1,4,5,0,1,1,2,1,8,2,1,Patrick Williams,CHI,CHA,CHI,,,13,13,8,5
22023,1630172,22300468,"JAN 03, 2024",CHI @ NYK,L,27,2,8,0.25,1,2,0.5,0,0,0.0,1,3,4,2,1,0,5,3,5,-14,1,Patrick Williams,CHI,NYK,CHI,,,11,9,7,6
22023,1630172,22300459,"JAN 02, 2024",CHI @ PHI,L,11,1,3,0.333,1,2,0.5,0,0,0.0,1,0,1,0,0,0,1,1,3,-20,1,Patrick Williams,CHI,PHI,CHI,,,4,4,3,1
22023,1630172,22300442,"DEC 30, 2023",CHI vs. PHI,W,33,6,11,0.545,1,3,0.333,0,0,0.0,2,1,3,3,0,0,2,0,13,13,1,Patrick Williams,CHI,CHI,PHI,,,19,16,16,6
22023,1630172,22300422,"DEC 28, 2023",CHI vs. IND,L,38,9,14,0.643,2,5,0.4,2,2,1.0,1,4,5,3,2,0,0,3,22,-23,1,Patrick Williams,CHI,CHI,IND,,,30,27,25,8
22023,1630172,22300408,"DEC 26, 2023",CHI vs. ATL,W,25,2,7,0.286,0,1,0.0,2,2,1.0,1,0,1,0,1,0,1,2,6,-4,1,Patrick Williams,CHI,CHI,ATL,,,7,7,6,1
22023,1630172,22300396,"DEC 23, 2023",CHI vs. CLE,L,35,5,11,0.455,2,5,0.4,1,1,1.0,0,2,2,2,0,1,2,3,13,0,1,Patrick Williams,CHI,CHI,CLE,,,17,15,15,4
22023,1630172,22300376,"DEC 21, 2023",CHI vs. SAS,W,31,7,11,0.636,2,4,0.5,2,2,1.0,0,4,4,2,1,1,2,2,18,15,1,Patrick Williams,CHI,CHI,SAS,,,24,22,20,6
22023,1630172,22300370,"DEC 20, 2023",CHI vs. LAL,W,34,6,10,0.6,3,3,1.0,0,0,0.0,2,1,3,2,1,1,0,2,15,8,1,Patrick Williams,CHI,CHI,LAL,,,20,18,17,5
22023,1630172,22300351,"DEC 18, 2023",CHI @ PHI,W,37,5,13,0.385,3,4,0.75,0,0,0.0,0,6,6,0,0,1,0,1,13,-2,1,Patrick Williams,CHI,PHI,CHI,,,19,19,13,6
22023,1630172,22300337,"DEC 16, 2023",CHI @ MIA,L,33,8,10,0.8,4,5,0.8,5,5,1.0,1,6,7,4,0,0,3,3,25,12,1,Patrick Williams,CHI,MIA,CHI,,,36,32,29,11
22023,1630172,22300320,"DEC 14, 2023",CHI @ MIA,W,32,3,9,0.333,2,5,0.4,1,2,0.5,2,0,2,3,2,2,0,5,9,8,1,Patrick Williams,CHI,MIA,CHI,,,14,11,12,5
22023,1630172,22300307,"DEC 12, 2023",CHI vs. DEN,L,31,2,8,0.25,2,5,0.4,1,2,0.5,0,2,2,0,0,1,1,1,7,-7,1,Patrick Williams,CHI,CHI,DEN,,,9,9,7,2
22023,1630172,22300300,"DEC 11, 2023",CHI @ MIL,L,41,6,14,0.429,1,2,0.5,2,2,1.0,4,3,7,2,0,0,1,4,15,-3,1,Patrick Williams,CHI,MIL,CHI,,,24,22,17,9
22023,1630172,22301223,"DEC 08, 2023",CHI @ SAS,W,34,8,11,0.727,2,3,0.667,2,4,0.5,1,5,6,3,1,1,0,3,20,20,1,Patrick Williams,CHI,SAS,CHI,,,29,26,23,9
22023,1630172,22301211,"DEC 06, 2023",CHI vs. CHA,W,29,3,6,0.5,1,2,0.5,1,2,0.5,3,6,9,1,2,2,3,2,8,5,1,Patrick Williams,CHI,CHI,CHA,,,18,17,9,10
22023,1630172,22300285,"DEC 02, 2023",CHI vs. NOP,W,29,6,11,0.545,1,5,0.2,1,4,0.25,1,3,4,2,2,2,1,3,14,-10,1,Patrick Williams,CHI,CHI,NOP,,,20,18,16,6
22023,1630172,22300269,"NOV 30, 2023",CHI vs. MIL,W,36,6,14,0.429,0,4,0.0,0,0,0.0,1,1,2,1,2,1,1,1,12,-7,1,Patrick Williams,CHI,CHI,MIL,,,15,14,13,3
22023,1630172,22300053,"NOV 28, 2023",CHI @ BOS,L,28,6,10,0.6,1,3,0.333,1,2,0.5,4,3,7,2,1,2,2,2,14,-7,1,Patrick Williams,CHI,BOS,CHI,,,23,21,16,9
22023,1630172,22300250,"NOV 26, 2023",CHI @ BKN,L,35,7,9,0.778,4,5,0.8,2,2,1.0,1,3,4,0,0,0,1,2,20,14,1,Patrick Williams,CHI,BKN,CHI,,,24,24,20,4
22023,1630172,22300046,"NOV 24, 2023",CHI @ TOR,L,22,4,8,0.5,2,2,1.0,2,2,1.0,2,3,5,1,1,0,0,0,12,2,1,Patrick Williams,CHI,TOR,CHI,,,18,17,13,6
22023,1630172,22300234,"NOV 22, 2023",CHI @ OKC,L,37,3,9,0.333,2,5,0.4,2,2,1.0,3,4,7,2,0,0,2,1,10,-3,1,Patrick Williams,CHI,OKC,CHI,,,19,17,12,9
22023,1630172,22300220,"NOV 20, 2023",CHI vs. MIA,L,17,4,7,0.571,1,3,0.333,0,0,0.0,0,3,3,0,0,2,2,0,9,0,1,Patrick Williams,CHI,CHI,MIA,,,12,12,9,3
22023,1630172,22300204,"NOV 18, 2023",CHI vs. MIA,W,15,1,5,0.2,0,1,0.0,0,0,0.0,3,1,4,1,1,1,0,2,2,15,1,Patrick Williams,CHI,CHI,MIA,,,7,6,3,5
22023,1630172,22300033,"NOV 17, 2023",CHI vs. ORL,L,13,0,3,0.0,0,1,0.0,0,0,0.0,0,2,2,1,1,0,3,1,0,-9,1,Patrick Williams,CHI,CHI,ORL,,,3,2,1,3
22023,1630172,22300196,"NOV 15, 2023",CHI vs. ORL,L,32,2,7,0.286,0,2,0.0,5,6,0.833,1,8,9,2,1,2,1,2,9,-2,1,Patrick Williams,CHI,CHI,ORL,,,20,18,11,11
22023,1630172,22300190,"NOV 13, 2023",CHI @ MIL,L,27,4,7,0.571,3,4,0.75,2,2,1.0,0,3,3,2,2,3,0,3,13,-6,1,Patrick Williams,CHI,MIL,CHI,,,18,16,15,5
22023,1630172,22300181,"NOV 12, 2023",CHI vs. DET,W,19,0,2,0.0,0,1,0.0,4,6,0.667,0,0,0,0,1,1,1,1,4,-4,1,Patrick Williams,CHI,CHI,DET,,,4,4,4,0
22023,1630172,22300162,"NOV 08, 2023",CHI vs. PHX,L,21,1,7,0.143,1,2,0.5,0,0,0.0,1,3,4,1,1,0,1,0,3,18,1,Patrick Williams,CHI,CHI,PHX,,,8,7,4,5
22023,1630172,22300152,"NOV 06, 2023",CHI vs. UTA,W,25,4,10,0.4,2,4,0.5,0,0,0.0,0,3,3,0,0,0,0,1,10,6,1,Patrick Williams,CHI,CHI,UTA,,,13,13,10,3
22023,1630172,22300139,"NOV 04, 2023",CHI @ DEN,L,28,2,7,0.286,0,5,0.0,3,4,0.75,1,2,3,3,1,2,1,0,7,3,1,Patrick Williams,CHI,DEN,CHI,,,13,10,10,6
22023,1630172,22300004,"NOV 03, 2023",CHI vs. BKN,L,21,4,6,0.667,2,3,0.667,0,0,0.0,0,5,5,1,0,1,2,1,10,10,1,Patrick Williams,CHI,CHI,BKN,,,16,15,11,6
22023,1630172,22300124,"NOV 01, 2023",CHI @ DAL,L,25,0,6,0.0,0,5,0.0,0,0,0.0,1,2,3,1,1,1,2,3,0,-8,1,Patrick Williams,CHI,DAL,CHI,,,4,3,1,4
22023,1630172,22300102,"OCT 30, 2023",CHI @ IND,W,22,3,6,0.5,1,2,0.5,2,2,1.0,0,4,4,0,1,1,1,0,9,-7,1,Patrick Williams,CHI,IND,CHI,,,13,13,9,4
22023,1630172,22300088,"OCT 28, 2023",CHI @ DET,L,21,0,3,0.0,0,1,0.0,0,0,0.0,1,2,3,1,1,0,1,3,0,4,1,Patrick Williams,CHI,DET,CHI,,,4,3,1,4
22023,1630172,22300082,"OCT 27, 2023",CHI vs. TOR,W,13,1,5,0.2,1,4,0.25,0,0,0.0,0,3,3,1,2,0,2,3,3,-7,1,Patrick Williams,CHI,CHI,TOR,,,7,6,4,4
22023,1630172,22300070,"OCT 25, 2023",CHI vs. OKC,L,30,4,10,0.4,0,4,0.0,0,0,0.0,2,1,3,4,2,0,0,3,8,-3,1,Patrick Williams,CHI,CHI,OKC,,,15,11,12,7
22023,1630533,22300560,"JAN 15, 2024",MEM vs. GSW,W,20,1,6,0.167,1,5,0.2,1,4,0.25,2,1,3,0,1,0,1,2,4,-13,1,Ziaire Williams,MEM,MEM,GSW,,,7,7,4,3
22023,1630533,22300544,"JAN 13, 2024",MEM vs. NYK,L,20,2,8,0.25,1,4,0.25,5,5,1.0,1,3,4,2,1,0,2,0,10,-9,1,Ziaire Williams,MEM,MEM,NYK,,,16,14,12,6
22023,1630533,22300537,"JAN 12, 2024",MEM vs. LAC,L,19,5,12,0.417,3,5,0.6,0,0,0.0,2,1,3,2,0,0,1,2,13,4,1,Ziaire Williams,MEM,MEM,LAC,,,18,16,15,5
22023,1630533,22300515,"JAN 09, 2024",MEM @ DAL,W,27,6,9,0.667,2,5,0.4,0,0,0.0,1,3,4,0,1,0,1,1,14,12,1,Ziaire Williams,MEM,DAL,MEM,,,18,18,14,4
22023,1630533,22300503,"JAN 07, 2024",MEM @ PHX,W,27,4,10,0.4,1,5,0.2,0,1,0.0,2,2,4,3,2,0,1,4,9,6,1,Ziaire Williams,MEM,PHX,MEM,,,16,13,12,7
22023,1630533,22300491,"JAN 05, 2024",MEM @ LAL,W,20,6,11,0.545,2,6,0.333,1,1,1.0,0,1,1,1,1,0,2,2,15,10,1,Ziaire Williams,MEM,LAL,MEM,,,17,16,16,2
22023,1630533,22300470,"JAN 03, 2024",MEM vs. TOR,L,18,7,12,0.583,4,7,0.571,0,0,0.0,2,4,6,0,1,0,0,1,18,-1,1,Ziaire Williams,MEM,MEM,TOR,,,24,24,18,6
22023,1630533,22300460,"JAN 02, 2024",MEM vs. SAS,W,0,0,0,0.0,0,0,0.0,0,0,0.0,0,0,0,0,0,0,0,0,0,-4,1,Ziaire Williams,MEM,MEM,SAS,,,0,0,0,0
22023,1630533,22300449,"DEC 31, 2023",MEM vs. SAC,L,5,0,2,0.0,0,0,0.0,0,0,0.0,0,1,1,0,0,0,1,0,0,-6,1,Ziaire Williams,MEM,MEM,SAC,,,1,1,0,1
22023,1630533,22300438,"DEC 29, 2023",MEM @ LAC,L,6,0,3,0.0,0,2,0.0,0,0,0.0,0,2,2,1,0,0,0,1,0,-3,1,Ziaire Williams,MEM,LAC,MEM,,,3,2,1,3
22023,1630533,22300425,"DEC 28, 2023",MEM @ DEN,L,24,2,8,0.25,1,3,0.333,2,2,1.0,1,1,2,1,1,1,1,1,7,-16,1,Ziaire Williams,MEM,DEN,MEM,,,10,9,8,3
22023,1630533,22300410,"DEC 26, 2023",MEM @ NOP,W,12,0,2,0.0,0,2,0.0,2,2,1.0,0,1,1,1,1,1,2,1,2,-7,1,Ziaire Williams,MEM,NOP,MEM,,,4,3,3,2
22023,1630533,22300393,"DEC 23, 2023",MEM @ ATL,W,23,3,8,0.375,1,3,0.333,1,3,0.333,1,2,3,3,0,0,1,3,8,6,1,Ziaire Williams,MEM,ATL,MEM,,,14,11,11,6
22023,1630533,22300377,"DEC 21, 2023",MEM vs. IND,W,18,6,9,0.667,3,4,0.75,1,2,0.5,0,1,1,2,1,2,2,2,16,6,1,Ziaire Williams,MEM,MEM,IND,,,19,17,18,3
22023,1630533,22300360,"DEC 19, 2023",MEM @ NOP,W,18,2,5,0.4,0,3,0.0,0,0,0.0,1,1,2,0,0,0,1,1,4,1,1,Ziaire Williams,MEM,NOP,MEM,,,6,6,4,2
22023,1630533,22300355,"DEC 18, 2023",MEM @ OKC,L,22,6,12,0.5,2,7,0.286,5,5,1.0,0,7,7,5,0,0,4,3,19,6,1,Ziaire Williams,MEM,OKC,MEM,,,31,26,24,12
22023,1630533,22300332,"DEC 15, 2023",MEM vs. HOU,L,15,0,1,0.0,0,0,0.0,0,0,0.0,1,3,4,2,0,0,2,1,0,-12,1,Ziaire Williams,MEM,MEM,HOU,,,6,4,2,6
22023,1630533,22300314,"DEC 13, 2023",MEM @ HOU,L,26,1,8,0.125,0,6,0.0,3,3,1.0,0,4,4,3,0,0,1,2,5,-4,1,Ziaire Williams,MEM,HOU,MEM,,,12,9,8,7
22023,1630533,22300299,"DEC 11, 2023",MEM vs. DAL,L,16,2,5,0.4,1,3,0.333,0,0,0.0,1,2,3,1,1,0,0,2,5,-4,1,Ziaire Williams,MEM,MEM,DAL,,,9,8,6,4
22023,1630533,22301221,"DEC 08, 2023",MEM vs. MIN,L,4,2,3,0.667,0,0,0.0,0,0,0.0,0,0,0,0,0,0,0,0,4,0,1,Ziaire Williams,MEM,MEM,MIN,,,4,4,4,0
22023,1630533,22301206,"DEC 06, 2023",MEM @ DET,W,0,0,0,0.0,0,0,0.0,0,0,0.0,0,0,0,0,0,0,0,0,0,0,1,Ziaire Williams,MEM,DET,MEM,,,0,0,0,0
22023,1630533,22300277,"DEC 01, 2023",MEM @ DAL,W,10,1,2,0.5,1,1,1.0,0,0,0.0,0,0,0,1,1,0,2,1,3,-8,1,Ziaire Williams,MEM,DAL,MEM,,,4,3,4,1
22023,1630533,22300261,"NOV 29, 2023",MEM vs. UTA,W,25,6,8,0.75,3,3,1.0,0,0,0.0,2,6,8,0,2,0,2,0,15,8,1,Ziaire Williams,MEM,MEM,UTA,,,23,23,15,8
22023,1630533,22300249,"NOV 26, 2023",MEM vs. MIN,L,18,4,8,0.5,2,3,0.667,1,2,0.5,0,2,2,1,0,0,2,5,11,-9,1,Ziaire Williams,MEM,MEM,MIN,,,14,13,12,3
22023,1630533,22300044,"NOV 24, 2023",MEM vs. PHX,L,2,0,1,0.0,0,1,0.0,0,0,0.0,0,0,0,1,0,0,0,1,0,-4,1,Ziaire Williams,MEM,MEM,PHX,,,1,0,1,1
22023,1630533,22300231,"NOV 22, 2023",MEM @ HOU,L,20,4,10,0.4,2,5,0.4,3,3,1.0,0,2,2,0,0,0,0,2,13,-27,1,Ziaire Williams,MEM,HOU,MEM,,,15,15,13,2
22023,1630533,22300213,"NOV 19, 2023",MEM vs. BOS,L,24,3,11,0.273,0,4,0.0,0,0,0.0,2,5,7,4,0,0,0,2,6,-5,1,Ziaire Williams,MEM,MEM,BOS,,,17,13,10,11
22023,1630533,22300206,"NOV 18, 2023",MEM @ SAS,W,25,4,8,0.5,2,3,0.667,7,8,0.875,1,6,7,5,1,0,1,1,17,27,1,Ziaire Williams,MEM,SAS,MEM,,,29,24,22,12
22023,1630533,22300026,"NOV 14, 2023",MEM @ LAL,L,26,4,16,0.25,2,7,0.286,0,0,0.0,0,1,1,0,1,1,1,3,10,-15,1,Ziaire Williams,MEM,LAL,MEM,,,11,11,10,1
22023,1630533,22300179,"NOV 12, 2023",MEM @ LAC,W,9,0,4,0.0,0,3,0.0,0,0,0.0,1,0,1,1,0,0,0,1,0,-6,1,Ziaire Williams,MEM,LAC,MEM,,,2,1,1,2
22023,1630533,22300164,"NOV 08, 2023",MEM vs. MIA,L,21,1,9,0.111,0,5,0.0,0,0,0.0,1,1,2,0,2,0,1,2,2,-10,1,Ziaire Williams,MEM,MEM,MIA,,,4,4,2,2
22023,1630533,22300144,"NOV 05, 2023",MEM @ POR,W,28,2,4,0.5,1,2,0.5,1,2,0.5,1,6,7,1,0,1,2,2,6,-17,1,Ziaire Williams,MEM,POR,MEM,,,14,13,7,8
22023,1630533,22300007,"NOV 03, 2023",MEM @ POR,L,27,5,8,0.625,1,1,1.0,2,2,1.0,0,6,6,3,1,1,2,6,13,-16,1,Ziaire Williams,MEM,POR,MEM,,,22,19,16,9
22023,1630533,22300125,"NOV 01, 2023",MEM @ UTA,L,19,2,5,0.4,2,5,0.4,2,2,1.0,1,3,4,0,0,2,1,2,8,-12,1,Ziaire Williams,MEM,UTA,MEM,,,12,12,8,4
22023,1630533,22300106,"OCT 30, 2023",MEM vs. DAL,L,33,3,8,0.375,2,4,0.5,0,0,0.0,1,6,7,2,1,0,3,2,8,-21,1,Ziaire Williams,MEM,MEM,DAL,,,17,15,10,9
22023,1630533,22300089,"OCT 28, 2023",MEM @ WAS,L,34,6,14,0.429,4,12,0.333,0,0,0.0,0,10,10,1,0,0,1,2,16,-1,1,Ziaire Williams,MEM,WAS,MEM,,,27,26,17,11
22023,1630533,22300078,"OCT 27, 2023",MEM vs. DEN,L,31,3,10,0.3,0,3,0.0,5,5,1.0,2,7,9,3,0,0,4,0,11,0,1,Ziaire Williams,MEM,MEM,DEN,,,23,20,14,12
22023,1630533,22300071,"OCT 25, 2023",MEM vs. NOP,L,29,4,7,0.571,1,3,0.333,0,0,0.0,0,4,4,0,0,0,1,2,9,-8,1,Ziaire Williams,MEM,MEM,NOP,,,13,13,9,4
22023,1629057,22300144,"NOV 05, 2023",POR vs. MEM,L,11,2,3,0.667,0,0,0.0,1,1,1.0,2,1,3,0,0,0,1,4,5,4,1,Robert Williams III,POR,POR,MEM,,,8,8,5,3
22023,1629057,22300007,"NOV 03, 2023",POR vs. MEM,W,20,3,4,0.75,0,0,0.0,2,3,0.667,4,6,10,0,2,1,1,1,8,-5,1,Robert Williams III,POR,POR,MEM,,,18,18,8,10
22023,1629057,22300115,"NOV 01, 2023",POR @ DET,W,19,2,4,0.5,0,0,0.0,2,2,1.0,0,8,8,1,0,3,1,4,6,10,1,Robert Williams III,POR,DET,POR,,,15,14,7,9
22023,1629057,22300098,"OCT 29, 2023",POR @ PHI,L,26,2,3,0.667,0,0,0.0,2,2,1.0,2,5,7,2,2,2,1,2,6,-6,1,Robert Williams III,POR,PHI,POR,,,15,13,8,9
22023,1629057,22300086,"OCT 27, 2023",POR vs. ORL,L,20,3,5,0.6,0,0,0.0,0,0,0.0,1,2,3,2,0,0,1,2,6,-10,1,Robert Williams III,POR,POR,ORL,,,11,9,8,5
22023,1629057,22300074,"OCT 25, 2023",POR @ LAC,L,23,5,7,0.714,0,0,0.0,0,1,0.0,2,5,7,0,3,1,2,4,10,-23,1,Robert Williams III,POR,LAC,POR,,,17,17,10,7
22023,1631246,22300560,"JAN 15, 2024",MEM vs. GSW,W,38,6,11,0.545,3,6,0.5,9,10,0.9,3,4,7,4,2,1,3,2,24,2,1,Vince Williams Jr.,MEM,MEM,GSW,,,35,31,28,11
22023,1631246,22300544,"JAN 13, 2024",MEM vs. NYK,L,36,5,13,0.385,1,7,0.143,6,8,0.75,3,5,8,8,2,1,4,1,17,-4,1,Vince Williams Jr.,MEM,MEM,NYK,,,33,25,25,16
22023,1631246,22300537,"JAN 12, 2024",MEM vs. LAC,L,27,2,6,0.333,2,5,0.4,0,0,0.0,2,1,3,1,1,0,1,2,6,-8,1,Vince Williams Jr.,MEM,MEM,LAC,,,10,9,7,4
22023,1631246,22300515,"JAN 09, 2024",MEM @ DAL,W,30,2,8,0.25,2,5,0.4,0,0,0.0,2,4,6,6,3,0,3,5,6,0,1,Vince Williams Jr.,MEM,DAL,MEM,,,18,12,12,12
22023,1631246,22300503,"JAN 07, 2024",MEM @ PHX,W,37,6,11,0.545,3,4,0.75,4,4,1.0,4,5,9,1,0,2,0,2,19,22,1,Vince Williams Jr.,MEM,PHX,MEM,,,29,28,20,10
22023,1631246,22300460,"JAN 02, 2024",MEM vs. SAS,W,22,3,6,0.5,2,5,0.4,0,0,0.0,1,4,5,2,0,0,2,5,8,13,1,Vince Williams Jr.,MEM,MEM,SAS,,,15,13,10,7
22023,1631246,22300449,"DEC 31, 2023",MEM vs. SAC,L,18,0,4,0.0,0,4,0.0,0,0,0.0,0,6,6,1,0,0,0,1,0,-16,1,Vince Williams Jr.,MEM,MEM,SAC,,,7,6,1,7
22023,1631246,22300438,"DEC 29, 2023",MEM @ LAC,L,22,1,6,0.167,1,4,0.25,2,3,0.667,0,1,1,5,0,1,1,3,5,0,1,Vince Williams Jr.,MEM,LAC,MEM,,,11,6,10,6
22023,1631246,22300425,"DEC 28, 2023",MEM @ DEN,L,30,1,7,0.143,1,4,0.25,2,2,1.0,4,7,11,2,0,0,0,3,5,-23,1,Vince Williams Jr.,MEM,DEN,MEM,,,18,16,7,13
22023,1631246,22300410,"DEC 26, 2023",MEM @ NOP,W,27,1,4,0.25,1,4,0.25,3,4,0.75,2,6,8,3,1,3,2,0,6,0,1,Vince Williams Jr.,MEM,NOP,MEM,,,17,14,9,11
22023,1631246,22300393,"DEC 23, 2023",MEM @ ATL,W,35,2,6,0.333,1,5,0.2,0,0,0.0,2,9,11,1,2,0,1,4,5,13,1,Vince Williams Jr.,MEM,ATL,MEM,,,17,16,6,12
22023,1631246,22300377,"DEC 21, 2023",MEM vs. IND,W,35,1,5,0.2,0,3,0.0,0,0,0.0,1,3,4,3,3,1,2,2,2,14,1,Vince Williams Jr.,MEM,MEM,IND,,,9,6,5,7
22023,1631246,22300360,"DEC 19, 2023",MEM @ NOP,W,35,3,6,0.5,3,5,0.6,0,0,0.0,1,6,7,3,0,1,1,1,9,-8,1,Vince Williams Jr.,MEM,NOP,MEM,,,19,16,12,10
22023,1631246,22300355,"DEC 18, 2023",MEM @ OKC,L,23,2,7,0.286,1,5,0.2,0,0,0.0,2,3,5,1,0,0,1,3,5,-26,1,Vince Williams Jr.,MEM,OKC,MEM,,,11,10,6,6
22023,1631246,22300332,"DEC 15, 2023",MEM vs. HOU,L,30,4,8,0.5,3,6,0.5,0,0,0.0,1,7,8,3,1,2,3,2,11,-8,1,Vince Williams Jr.,MEM,MEM,HOU,,,22,19,14,11
22023,1631246,22300314,"DEC 13, 2023",MEM @ HOU,L,28,2,5,0.4,2,4,0.5,4,6,0.667,1,6,7,1,1,0,0,6,10,-3,1,Vince Williams Jr.,MEM,HOU,MEM,,,18,17,11,8
22023,1631246,22300299,"DEC 11, 2023",MEM vs. DAL,L,26,3,4,0.75,2,3,0.667,2,2,1.0,3,6,9,1,0,0,1,3,10,0,1,Vince Williams Jr.,MEM,MEM,DAL,,,20,19,11,10
22023,1631246,22301221,"DEC 08, 2023",MEM vs. MIN,L,17,1,5,0.2,1,4,0.25,1,2,0.5,1,1,2,1,0,0,1,1,4,-8,1,Vince Williams Jr.,MEM,MEM,MIN,,,7,6,5,3
22023,1631246,22301206,"DEC 06, 2023",MEM @ DET,W,25,1,2,0.5,1,2,0.5,0,0,0.0,0,4,4,1,1,0,0,0,3,17,1,Vince Williams Jr.,MEM,DET,MEM,,,8,7,4,5
22023,1631246,22300288,"DEC 02, 2023",MEM @ PHX,L,30,3,5,0.6,1,3,0.333,5,5,1.0,0,5,5,2,0,0,1,6,12,2,1,Vince Williams Jr.,MEM,PHX,MEM,,,19,17,14,7
22023,1631246,22300277,"DEC 01, 2023",MEM @ DAL,W,26,6,9,0.667,3,6,0.5,0,0,0.0,2,7,9,3,0,2,1,4,15,11,1,Vince Williams Jr.,MEM,DAL,MEM,,,27,24,18,12
22023,1631246,22300261,"NOV 29, 2023",MEM vs. UTA,W,20,1,3,0.333,1,3,0.333,0,0,0.0,2,6,8,2,1,0,2,3,3,6,1,Vince Williams Jr.,MEM,MEM,UTA,,,13,11,5,10
22023,1631246,22300249,"NOV 26, 2023",MEM vs. MIN,L,10,0,2,0.0,0,2,0.0,0,0,0.0,1,2,3,1,1,0,0,1,0,-11,1,Vince Williams Jr.,MEM,MEM,MIN,,,4,3,1,4
22023,1631246,22300044,"NOV 24, 2023",MEM vs. PHX,L,14,1,2,0.5,1,2,0.5,0,0,0.0,0,5,5,1,0,0,0,4,3,-6,1,Vince Williams Jr.,MEM,MEM,PHX,,,9,8,4,6
22023,1631246,22300231,"NOV 22, 2023",MEM @ HOU,L,4,0,1,0.0,0,1,0.0,0,0,0.0,0,1,1,0,0,0,0,0,0,3,1,Vince Williams Jr.,MEM,HOU,MEM,,,1,1,0,1
22023,1631246,22300213,"NOV 19, 2023",MEM vs. BOS,L,17,2,4,0.5,2,3,0.667,0,0,0.0,0,0,0,0,0,2,0,2,6,8,1,Vince Williams Jr.,MEM,MEM,BOS,,,6,6,6,0
22023,1631246,22300026,"NOV 14, 2023",MEM @ LAL,L,5,0,1,0.0,0,1,0.0,0,0,0.0,0,1,1,0,0,0,0,0,0,-5,1,Vince Williams Jr.,MEM,LAL,MEM,,,1,1,0,1
22023,1631246,22300007,"NOV 03, 2023",MEM @ POR,L,10,0,2,0.0,0,2,0.0,0,0,0.0,0,2,2,1,0,0,1,1,0,15,1,Vince Williams Jr.,MEM,POR,MEM,,,3,2,1,3
22023,1631246,22300125,"NOV 01, 2023",MEM @ UTA,L,16,2,5,0.4,1,4,0.25,7,8,0.875,0,2,2,3,1,3,1,3,12,9,1,Vince Williams Jr.,MEM,UTA,MEM,,,17,14,15,5
22023,1631246,22300106,"OCT 30, 2023",MEM vs. DAL,L,1,0,0,0.0,0,0,0.0,0,0,0.0,0,0,0,0,0,0,0,0,0,0,1,Vince Williams Jr.,MEM,MEM,DAL,,,0,0,0,0
22023,1629627,22300556,"JAN 15, 2024",NOP @ DAL,L,32,12,17,0.706,0,0,0.0,6,11,0.545,0,1,1,3,1,0,3,2,30,6,1,Zion Williamson,NOP,DAL,NOP,,,34,31,33,4
22023,1629627,22300539,"JAN 12, 2024",NOP @ DEN,L,35,13,22,0.591,0,0,0.0,4,6,0.667,2,4,6,5,0,1,1,1,30,-7,1,Zion Williamson,NOP,DEN,NOP,,,41,36,35,11
22023,1629627,22300525,"JAN 10, 2024",NOP @ GSW,W,30,8,12,0.667,0,0,0.0,3,5,0.6,1,4,5,7,1,0,4,2,19,23,1,Zion Williamson,NOP,GSW,NOP,,,31,24,26,12
22023,1629627,22300486,"JAN 05, 2024",NOP vs. LAC,L,19,3,9,0.333,0,0,0.0,6,8,0.75,2,4,6,1,1,1,1,3,12,-17,1,Zion Williamson,NOP,NOP,LAC,,,19,18,13,7
22023,1629627,22300471,"JAN 03, 2024",NOP @ MIN,W,29,11,15,0.733,0,0,0.0,5,6,0.833,1,3,4,6,1,1,2,3,27,20,1,Zion Williamson,NOP,MIN,NOP,,,37,31,33,10
22023,1629627,22300461,"JAN 02, 2024",NOP vs. BKN,W,26,5,9,0.556,0,0,0.0,0,0,0.0,1,2,3,5,0,1,4,3,10,16,1,Zion Williamson,NOP,NOP,BKN,,,18,13,15,8
22023,1629627,22300446,"DEC 31, 2023",NOP vs. LAL,W,32,8,12,0.667,0,0,0.0,10,12,0.833,2,2,4,6,0,0,4,5,26,12,1,Zion Williamson,NOP,NOP,LAL,,,36,30,32,10
22023,1629627,22300424,"DEC 28, 2023",NOP vs. UTA,W,30,10,14,0.714,0,0,0.0,1,3,0.333,1,9,10,8,0,1,0,2,21,7,1,Zion Williamson,NOP,NOP,UTA,,,39,31,29,18
22023,1629627,22300410,"DEC 26, 2023",NOP vs. MEM,L,36,7,17,0.412,0,0,0.0,9,12,0.75,2,9,11,1,1,0,6,5,23,4,1,Zion Williamson,NOP,NOP,MEM,,,35,34,24,12
22023,1629627,22300392,"DEC 23, 2023",NOP vs. HOU,L,34,11,16,0.688,1,2,0.5,5,10,0.5,2,6,8,4,2,1,3,1,28,2,1,Zion Williamson,NOP,NOP,HOU,,,40,36,32,12
22023,1629627,22300360,"DEC 19, 2023",NOP vs. MEM,L,25,5,12,0.417,0,0,0.0,3,4,0.75,0,3,3,4,0,0,2,4,13,-13,1,Zion Williamson,NOP,NOP,MEM,,,20,16,17,7
22023,1629627,22300345,"DEC 17, 2023",NOP @ SAS,W,26,7,12,0.583,0,1,0.0,1,4,0.25,5,3,8,3,2,1,1,2,15,5,1,Zion Williamson,NOP,SAS,NOP,,,26,23,18,11
22023,1629627,22300326,"DEC 15, 2023",NOP @ CHA,W,30,9,16,0.563,0,0,0.0,3,4,0.75,3,8,11,4,0,0,1,4,21,-1,1,Zion Williamson,NOP,CHA,NOP,,,36,32,25,15
22023,1629627,22300301,"DEC 11, 2023",NOP vs. MIN,W,33,13,17,0.765,0,0,0.0,10,12,0.833,2,3,5,2,1,1,1,1,36,26,1,Zion Williamson,NOP,NOP,MIN,,,43,41,38,7
22023,1629627,22301230,"DEC 07, 2023",NOP @ LAL,L,26,6,8,0.75,0,0,0.0,1,6,0.167,1,1,2,3,0,0,3,3,13,-33,1,Zion Williamson,NOP,LAL,NOP,,,18,15,16,5
22023,1629627,22301204,"DEC 04, 2023",NOP @ SAC,W,28,5,8,0.625,0,2,0.0,0,0,0.0,1,5,6,6,3,0,4,3,10,4,1,Zion Williamson,NOP,SAC,NOP,,,22,16,16,12
22023,1629627,22300285,"DEC 02, 2023",NOP @ CHI,L,30,10,15,0.667,0,0,0.0,7,9,0.778,2,3,5,3,1,0,5,3,27,-12,1,Zion Williamson,NOP,CHI,NOP,,,35,32,30,8
22023,1629627,22300278,"DEC 01, 2023",NOP vs. SAS,W,26,4,9,0.444,0,0,0.0,4,5,0.8,1,3,4,7,0,1,1,2,12,12,1,Zion Williamson,NOP,NOP,SAS,,,23,16,19,11
22023,1629627,22300262,"NOV 29, 2023",NOP vs. PHI,W,33,11,12,0.917,0,0,0.0,11,12,0.917,1,7,8,6,3,0,2,1,33,16,1,Zion Williamson,NOP,NOP,PHI,,,47,41,39,14
22023,1629627,22300256,"NOV 27, 2023",NOP @ UTA,L,34,9,16,0.563,1,1,1.0,7,9,0.778,1,3,4,7,1,0,0,2,26,3,1,Zion Williamson,NOP,UTA,NOP,,,37,30,33,11
22023,1629627,22300052,"NOV 24, 2023",NOP @ LAC,W,34,13,25,0.52,0,1,0.0,6,9,0.667,2,4,6,5,2,0,5,2,32,-1,1,Zion Williamson,NOP,LAC,NOP,,,43,38,37,11
22023,1629627,22300233,"NOV 22, 2023",NOP vs. SAC,W,35,10,16,0.625,0,0,0.0,5,7,0.714,1,4,5,6,0,0,2,3,25,-1,1,Zion Williamson,NOP,NOP,SAC,,,36,30,31,11
22023,1629627,22300222,"NOV 20, 2023",NOP vs. SAC,W,30,12,16,0.75,0,0,0.0,2,2,1.0,0,3,3,5,3,1,1,2,26,32,1,Zion Williamson,NOP,NOP,SAC,,,34,29,31,8
22023,1629627,22300034,"NOV 17, 2023",NOP vs. DEN,W,33,10,17,0.588,1,1,1.0,5,11,0.455,0,4,4,6,0,2,4,3,26,21,1,Zion Williamson,NOP,NOP,DEN,,,36,30,32,10
22023,1629627,22300022,"NOV 14, 2023",NOP vs. DAL,W,27,8,15,0.533,0,0,0.0,3,7,0.429,3,4,7,5,2,0,2,3,19,11,1,Zion Williamson,NOP,NOP,DAL,,,31,26,24,12
22023,1629627,22300183,"NOV 12, 2023",NOP vs. DAL,L,27,7,11,0.636,0,0,0.0,4,8,0.5,1,1,2,4,1,0,6,3,18,-21,1,Zion Williamson,NOP,NOP,DAL,,,24,20,22,6
22023,1629627,22300011,"NOV 10, 2023",NOP @ HOU,L,34,8,16,0.5,0,0,0.0,8,11,0.727,2,6,8,1,0,1,5,5,24,2,1,Zion Williamson,NOP,HOU,NOP,,,33,32,25,9
22023,1629627,22300156,"NOV 06, 2023",NOP @ DEN,L,37,10,22,0.455,0,0,0.0,0,1,0.0,3,7,10,9,2,0,0,2,20,-11,1,Zion Williamson,NOP,DEN,NOP,,,39,30,29,19
22023,1629627,22300135,"NOV 04, 2023",NOP vs. ATL,L,32,9,16,0.563,0,0,0.0,7,10,0.7,2,3,5,3,0,0,0,2,25,-4,1,Zion Williamson,NOP,NOP,ATL,,,33,30,28,8
22023,1629627,22300121,"NOV 01, 2023",NOP @ OKC,W,33,7,20,0.35,0,0,0.0,6,9,0.667,7,3,10,8,0,0,4,4,20,-7,1,Zion Williamson,NOP,OKC,NOP,,,38,30,28,18
22023,1629627,22300108,"OCT 30, 2023",NOP vs. GSW,L,30,7,15,0.467,0,1,0.0,5,9,0.556,3,2,5,3,2,0,5,5,19,-17,1,Zion Williamson,NOP,NOP,GSW,,,27,24,22,8
22023,1629627,22300090,"OCT 28, 2023",NOP vs. NYK,W,28,12,17,0.706,0,0,0.0,0,2,0.0,1,4,5,2,1,0,0,0,24,11,1,Zion Williamson,NOP,NOP,NYK,,,31,29,26,7
22023,1629627,22300071,"OCT 25, 2023",NOP @ MEM,W,32,9,17,0.529,0,0,0.0,5,7,0.714,4,3,7,3,0,0,3,1,23,-8,1,Zion Williamson,NOP,MEM,NOP,,,33,30,26,10
22023,1630592,22300469,"JAN 03, 2024",BKN @ HOU,L,5,0,0,0.0,0,0,0.0,0,0,0.0,0,0,0,0,1,0,0,0,0,-2,1,Jalen Wilson,BKN,HOU,BKN,,,0,0,0,0
22023,1630592,22300461,"JAN 02, 2024",BKN @ NOP,L,12,4,8,0.5,0,2,0.0,0,0,0.0,4,0,4,2,1,0,0,0,8,0,1,Jalen Wilson,BKN,NOP,BKN,,,14,12,10,6
22023,1630592,22300417,"DEC 27, 2023",BKN vs. MIL,L,30,5,13,0.385,0,3,0.0,11,11,1.0,7,3,10,2,0,0,1,4,21,-14,1,Jalen Wilson,BKN,BKN,MIL,,,33,31,23,12
22023,1630592,22300394,"DEC 23, 2023",BKN vs. DET,W,6,1,2,0.5,0,0,0.0,0,0,0.0,1,1,2,1,0,0,0,2,2,-4,1,Jalen Wilson,BKN,BKN,DET,,,5,4,3,3
22023,1630592,22300368,"DEC 20, 2023",BKN vs. NYK,L,6,1,2,0.5,0,1,0.0,0,0,0.0,0,1,1,2,1,0,0,0,2,-1,1,Jalen Wilson,BKN,BKN,NYK,,,5,3,4,3
22023,1630592,22300357,"DEC 18, 2023",BKN @ UTA,L,8,1,1,1.0,1,1,1.0,2,2,1.0,0,0,0,0,0,0,1,2,5,4,1,Jalen Wilson,BKN,UTA,BKN,,,5,5,5,0
22023,1630592,22300339,"DEC 16, 2023",BKN @ GSW,L,11,1,1,1.0,0,0,0.0,0,0,0.0,1,0,1,0,0,0,1,1,2,-5,1,Jalen Wilson,BKN,GSW,BKN,,,3,3,2,1
22023,1630592,22300322,"DEC 14, 2023",BKN @ DEN,L,17,2,3,0.667,1,1,1.0,2,2,1.0,1,3,4,2,0,0,0,0,7,-4,1,Jalen Wilson,BKN,DEN,BKN,,,13,11,9,6
22023,1630592,22300303,"DEC 11, 2023",BKN @ SAC,L,4,1,1,1.0,0,0,0.0,0,0,0.0,1,0,1,0,0,0,0,0,2,4,1,Jalen Wilson,BKN,SAC,BKN,,,3,3,2,1
22023,1630592,22300136,"NOV 04, 2023",BKN vs. BOS,L,1,0,0,0.0,0,0,0.0,0,0,0.0,0,0,0,0,0,0,0,0,0,2,1,Jalen Wilson,BKN,BKN,BOS,,,0,0,0,0
22023,1630592,22300119,"NOV 01, 2023",BKN @ MIA,W,6,0,1,0.0,0,0,0.0,0,0,0.0,0,1,1,0,0,1,0,0,0,-4,1,Jalen Wilson,BKN,MIA,BKN,,,1,1,0,1
22023,1629685,22300531,"JAN 11, 2024",LAL vs. PHX,L,5,1,1,1.0,1,1,1.0,0,0,0.0,0,0,0,1,0,0,0,1,3,4,1,Dylan Windler,LAL,LAL,PHX,,,4,3,4,1
22023,1629685,22300161,"NOV 08, 2023",NYK vs. SAS,W,1,0,0,0.0,0,0,0.0,0,0,0.0,0,0,0,0,0,0,0,0,0,-2,1,Dylan Windler,NYK,NYK,SAS,,,0,0,0,0
22023,1629685,22300112,"OCT 31, 2023",NYK @ CLE,W,3,0,1,0.0,0,1,0.0,0,0,0.0,0,1,1,0,0,0,0,0,0,0,1,Dylan Windler,NYK,CLE,NYK,,,1,1,0,1
22023,1629685,22300090,"OCT 28, 2023",NYK @ NOP,L,3,1,1,1.0,1,1,1.0,0,0,0.0,0,0,0,1,0,0,0,1,3,10,1,Dylan Windler,NYK,NOP,NYK,,,4,3,4,1
22023,1630164,22300558,"JAN 15, 2024",DET @ WAS,W,15,3,4,0.75,0,0,0.0,0,0,0.0,2,3,5,0,0,2,0,1,6,1,1,James Wiseman,DET,WAS,DET,,,11,11,6,5
22023,1630164,22300519,"JAN 10, 2024",DET vs. SAS,L,17,1,1,1.0,0,0,0.0,1,2,0.5,0,3,3,3,0,0,0,2,3,-15,1,James Wiseman,DET,DET,SAS,,,9,6,6,6
22023,1630164,22300512,"JAN 09, 2024",DET vs. SAC,L,24,2,3,0.667,0,0,0.0,0,0,0.0,1,4,5,1,0,1,1,2,4,1,1,James Wiseman,DET,DET,SAC,,,10,9,5,6
22023,1630164,22300502,"JAN 07, 2024",DET @ DEN,L,18,4,7,0.571,0,0,0.0,1,3,0.333,2,1,3,0,0,0,0,1,9,-3,1,James Wiseman,DET,DEN,DET,,,12,12,9,3
22023,1630164,22300490,"JAN 05, 2024",DET @ GSW,L,15,1,5,0.2,0,1,0.0,2,3,0.667,1,2,3,0,0,2,0,2,4,1,1,James Wiseman,DET,GSW,DET,,,7,7,4,3
22023,1630164,22300474,"JAN 03, 2024",DET @ UTA,L,17,4,7,0.571,0,0,0.0,0,0,0.0,5,4,9,0,0,0,3,1,8,11,1,James Wiseman,DET,UTA,DET,,,17,17,8,9
22023,1630164,22300453,"JAN 01, 2024",DET @ HOU,L,16,1,1,1.0,0,0,0.0,2,2,1.0,1,3,4,0,0,1,1,5,4,-24,1,James Wiseman,DET,HOU,DET,,,8,8,4,4
22023,1630164,22300440,"DEC 30, 2023",DET vs. TOR,W,13,4,4,1.0,0,0,0.0,0,0,0.0,0,4,4,0,0,3,0,1,8,4,1,James Wiseman,DET,DET,TOR,,,12,12,8,4
22023,1630164,22300421,"DEC 28, 2023",DET @ BOS,L,13,3,3,1.0,0,0,0.0,0,0,0.0,2,3,5,1,0,0,1,0,6,0,1,James Wiseman,DET,BOS,DET,,,12,11,7,6
22023,1630164,22300406,"DEC 26, 2023",DET vs. BKN,L,12,0,2,0.0,0,0,0.0,0,0,0.0,2,0,2,0,0,0,1,2,0,-12,1,James Wiseman,DET,DET,BKN,,,2,2,0,2
22023,1630164,22300374,"DEC 21, 2023",DET vs. UTA,L,15,1,2,0.5,0,0,0.0,0,0,0.0,2,3,5,0,0,1,2,1,2,-16,1,James Wiseman,DET,DET,UTA,,,7,7,2,5
22023,1630164,22300352,"DEC 18, 2023",DET @ ATL,L,25,5,5,1.0,0,0,0.0,0,2,0.0,2,5,7,2,0,0,2,2,10,4,1,James Wiseman,DET,ATL,DET,,,19,17,12,9
22023,1630164,22300334,"DEC 16, 2023",DET @ MIL,L,26,7,9,0.778,0,0,0.0,3,3,1.0,3,3,6,5,1,0,0,4,17,-15,1,James Wiseman,DET,MIL,DET,,,28,23,22,11
22023,1630164,22300327,"DEC 15, 2023",DET @ PHI,L,28,9,12,0.75,0,0,0.0,2,2,1.0,3,10,13,1,0,1,2,2,20,-5,1,James Wiseman,DET,PHI,DET,,,34,33,21,14
22023,1630164,22300310,"DEC 13, 2023",DET vs. PHI,L,16,5,7,0.714,0,0,0.0,0,0,0.0,0,3,3,0,1,1,1,6,10,-21,1,James Wiseman,DET,DET,PHI,,,13,13,10,3
22023,1630164,22300293,"DEC 11, 2023",DET vs. IND,L,13,1,1,1.0,0,0,0.0,2,2,1.0,2,2,4,1,1,3,1,3,4,4,1,James Wiseman,DET,DET,IND,,,9,8,5,5
22023,1630164,22301217,"DEC 08, 2023",DET @ ORL,L,16,0,0,0.0,0,0,0.0,2,4,0.5,2,3,5,0,0,0,1,2,2,-6,1,James Wiseman,DET,ORL,DET,,,7,7,2,5
22023,1630164,22301206,"DEC 06, 2023",DET vs. MEM,L,8,2,3,0.667,0,0,0.0,0,0,0.0,1,0,1,1,0,2,1,2,4,-8,1,James Wiseman,DET,DET,MEM,,,6,5,5,2
22023,1630164,22300258,"NOV 29, 2023",DET vs. LAL,L,12,2,2,1.0,0,0,0.0,0,0,0.0,1,4,5,0,0,0,1,2,4,0,1,James Wiseman,DET,DET,LAL,,,9,9,4,5
22023,1630164,22300253,"NOV 27, 2023",DET vs. WAS,L,9,3,4,0.75,0,0,0.0,2,4,0.5,3,1,4,0,0,0,1,0,8,-12,1,James Wiseman,DET,DET,WAS,,,12,12,8,4
22023,1630164,22300218,"NOV 20, 2023",DET vs. DEN,L,10,0,1,0.0,0,0,0.0,0,0,0.0,1,2,3,0,0,0,1,2,0,-10,1,James Wiseman,DET,DET,DEN,,,3,3,0,3
22023,1630164,22300211,"NOV 19, 2023",DET @ TOR,L,24,6,8,0.75,0,0,0.0,3,5,0.6,0,3,3,1,0,1,2,4,15,0,1,James Wiseman,DET,TOR,DET,,,19,18,16,4
22023,1630164,22300030,"NOV 17, 2023",DET @ CLE,L,4,0,0,0.0,0,0,0.0,0,0,0.0,0,2,2,0,0,0,0,0,0,8,1,James Wiseman,DET,CLE,DET,,,2,2,0,2
22023,1630164,22300018,"NOV 14, 2023",DET vs. ATL,L,14,5,6,0.833,0,0,0.0,1,2,0.5,1,3,4,1,0,0,0,2,11,-9,1,James Wiseman,DET,DET,ATL,,,16,15,12,5
22023,1630164,22300181,"NOV 12, 2023",DET @ CHI,L,14,3,6,0.5,0,1,0.0,0,0,0.0,1,1,2,0,1,2,2,3,6,5,1,James Wiseman,DET,CHI,DET,,,8,8,6,2
22023,1630164,22300008,"NOV 10, 2023",DET vs. PHI,L,7,3,3,1.0,0,0,0.0,0,0,0.0,3,1,4,0,0,0,0,1,6,0,1,James Wiseman,DET,DET,PHI,,,10,10,6,4
22023,1630164,22300145,"NOV 06, 2023",DET vs. GSW,L,11,0,3,0.0,0,0,0.0,0,0,0.0,0,3,3,0,0,0,0,0,0,-6,1,James Wiseman,DET,DET,GSW,,,3,3,0,3
22023,1630164,22300115,"NOV 01, 2023",DET vs. POR,L,6,2,4,0.5,0,0,0.0,0,0,0.0,0,2,2,1,0,0,1,4,4,-15,1,James Wiseman,DET,DET,POR,,,7,6,5,3
22023,1626174,22300565,"JAN 15, 2024",LAL vs. OKC,W,14,4,7,0.571,1,2,0.5,2,2,1.0,2,5,7,1,0,3,1,2,11,-2,1,Christian Wood,LAL,LAL,OKC,,,19,18,12,8
22023,1626174,22300549,"JAN 13, 2024",LAL @ UTA,L,22,5,10,0.5,2,6,0.333,3,3,1.0,1,8,9,1,0,1,0,1,15,-4,1,Christian Wood,LAL,UTA,LAL,,,25,24,16,10
22023,1626174,22300516,"JAN 09, 2024",LAL vs. TOR,W,24,5,10,0.5,2,4,0.5,2,2,1.0,0,4,4,1,1,1,2,5,14,3,1,Christian Wood,LAL,LAL,TOR,,,19,18,15,5
22023,1626174,22300505,"JAN 07, 2024",LAL vs. LAC,W,16,4,6,0.667,1,2,0.5,0,0,0.0,1,9,10,0,0,2,1,2,9,7,1,Christian Wood,LAL,LAL,LAC,,,19,19,9,10
22023,1626174,22300491,"JAN 05, 2024",LAL vs. MEM,L,16,3,5,0.6,1,2,0.5,4,4,1.0,0,5,5,0,1,0,1,0,11,6,1,Christian Wood,LAL,LAL,MEM,,,16,16,11,5
22023,1626174,22300475,"JAN 03, 2024",LAL vs. MIA,L,24,5,10,0.5,0,2,0.0,3,3,1.0,4,4,8,3,0,1,2,1,13,1,1,Christian Wood,LAL,LAL,MIA,,,24,21,16,11
22023,1626174,22300446,"DEC 31, 2023",LAL @ NOP,L,25,1,4,0.25,1,4,0.25,0,0,0.0,0,5,5,1,0,1,0,1,3,-12,1,Christian Wood,LAL,NOP,LAL,,,9,8,4,6
22023,1626174,22300443,"DEC 30, 2023",LAL @ MIN,L,13,2,4,0.5,2,2,1.0,1,2,0.5,0,5,5,0,0,1,2,1,7,3,1,Christian Wood,LAL,MIN,LAL,,,12,12,7,5
22023,1626174,22300428,"DEC 28, 2023",LAL vs. CHA,W,23,3,4,0.75,3,3,1.0,0,0,0.0,0,5,5,4,0,1,2,2,9,19,1,Christian Wood,LAL,LAL,CHA,,,18,14,13,9
22023,1626174,22300380,"DEC 21, 2023",LAL @ MIN,L,3,0,0,0.0,0,0,0.0,0,0,0.0,0,0,0,0,0,0,1,0,0,-12,1,Christian Wood,LAL,MIN,LAL,,,0,0,0,0
22023,1626174,22300370,"DEC 20, 2023",LAL @ CHI,L,1,0,0,0.0,0,0,0.0,0,0,0.0,0,0,0,0,0,1,1,0,0,0,1,Christian Wood,LAL,CHI,LAL,,,0,0,0,0
22023,1626174,22300331,"DEC 15, 2023",LAL @ SAS,L,30,6,10,0.6,2,5,0.4,3,8,0.375,2,6,8,3,1,2,0,1,17,13,1,Christian Wood,LAL,SAS,LAL,,,28,25,20,11
22023,1626174,22300316,"DEC 13, 2023",LAL @ SAS,W,21,4,7,0.571,1,3,0.333,0,2,0.0,1,5,6,1,0,0,0,2,9,-13,1,Christian Wood,LAL,SAS,LAL,,,16,15,10,7
22023,1626174,22301230,"DEC 07, 2023",LAL vs. NOP,W,8,2,4,0.5,0,1,0.0,0,0,0.0,3,3,6,2,0,0,2,0,4,6,1,Christian Wood,LAL,LAL,NOP,,,12,10,6,8
22023,1626174,22300291,"DEC 02, 2023",LAL vs. HOU,W,11,0,1,0.0,0,0,0.0,1,2,0.5,0,2,2,1,0,0,1,0,1,-6,1,Christian Wood,LAL,LAL,HOU,,,4,3,2,3
22023,1626174,22300271,"NOV 30, 2023",LAL @ OKC,L,20,1,6,0.167,0,2,0.0,5,7,0.714,1,3,4,1,0,0,1,1,7,-11,1,Christian Wood,LAL,OKC,LAL,,,12,11,8,5
22023,1626174,22300258,"NOV 29, 2023",LAL @ DET,W,25,4,9,0.444,0,4,0.0,4,4,1.0,0,9,9,0,1,2,1,1,12,2,1,Christian Wood,LAL,DET,LAL,,,21,21,12,9
22023,1626174,22300255,"NOV 27, 2023",LAL @ PHI,L,22,3,9,0.333,0,5,0.0,0,0,0.0,0,7,7,1,0,1,3,1,6,-15,1,Christian Wood,LAL,PHI,LAL,,,14,13,7,8
22023,1626174,22300242,"NOV 25, 2023",LAL @ CLE,W,17,5,7,0.714,2,3,0.667,1,1,1.0,1,2,3,0,0,0,1,1,13,-8,1,Christian Wood,LAL,CLE,LAL,,,16,16,13,3
22023,1626174,22300238,"NOV 22, 2023",LAL vs. DAL,L,15,0,1,0.0,0,0,0.0,1,2,0.5,0,5,5,1,0,0,0,1,1,-15,1,Christian Wood,LAL,LAL,DAL,,,7,6,2,6
22023,1626174,22300042,"NOV 21, 2023",LAL vs. UTA,W,27,6,7,0.857,1,2,0.5,3,3,1.0,1,7,8,2,0,1,2,5,16,13,1,Christian Wood,LAL,LAL,UTA,,,26,24,18,10
22023,1626174,22300216,"NOV 19, 2023",LAL vs. HOU,W,18,0,4,0.0,0,3,0.0,0,0,0.0,0,2,2,0,0,0,1,3,0,8,1,Christian Wood,LAL,LAL,HOU,,,2,2,0,2
22023,1626174,22300036,"NOV 17, 2023",LAL @ POR,W,20,5,9,0.556,0,3,0.0,0,0,0.0,2,8,10,0,0,0,0,1,10,6,1,Christian Wood,LAL,POR,LAL,,,20,20,10,10
22023,1626174,22300198,"NOV 15, 2023",LAL vs. SAC,L,9,2,2,1.0,0,0,0.0,1,2,0.5,0,2,2,0,0,0,1,1,5,-6,1,Christian Wood,LAL,LAL,SAC,,,7,7,5,2
22023,1626174,22300026,"NOV 14, 2023",LAL vs. MEM,W,22,1,8,0.125,0,3,0.0,0,0,0.0,3,7,10,2,0,1,3,2,2,9,1,Christian Wood,LAL,LAL,MEM,,,14,12,4,12
22023,1626174,22300187,"NOV 12, 2023",LAL vs. POR,W,15,1,4,0.25,0,2,0.0,5,7,0.714,1,0,1,0,0,0,1,2,7,-11,1,Christian Wood,LAL,LAL,POR,,,8,8,7,1
22023,1626174,22300015,"NOV 10, 2023",LAL @ PHX,W,18,2,5,0.4,1,1,1.0,0,0,0.0,3,6,9,0,0,1,1,0,5,8,1,Christian Wood,LAL,PHX,LAL,,,14,14,5,9
22023,1626174,22300163,"NOV 08, 2023",LAL @ HOU,L,22,0,1,0.0,0,0,0.0,0,2,0.0,0,4,4,1,0,0,0,4,0,-19,1,Christian Wood,LAL,HOU,LAL,,,5,4,1,5
22023,1626174,22300150,"NOV 06, 2023",LAL @ MIA,L,30,4,10,0.4,3,6,0.5,1,2,0.5,0,6,6,1,1,0,1,2,12,-1,1,Christian Wood,LAL,MIA,LAL,,,19,18,13,7
22023,1626174,22300134,"NOV 04, 2023",LAL @ ORL,L,29,2,6,0.333,2,5,0.4,0,0,0.0,0,2,2,2,1,2,3,3,6,-11,1,Christian Wood,LAL,ORL,LAL,,,10,8,8,4
22023,1626174,22300127,"NOV 01, 2023",LAL vs. LAC,W,29,4,6,0.667,2,4,0.5,0,0,0.0,2,9,11,0,1,1,2,3,10,14,1,Christian Wood,LAL,LAL,LAC,,,21,21,10,11
22023,1626174,22300111,"OCT 30, 2023",LAL vs. ORL,W,26,3,6,0.5,1,4,0.25,2,4,0.5,1,8,9,3,0,3,3,3,9,12,1,Christian Wood,LAL,LAL,ORL,,,21,18,12,12
22023,1626174,22300100,"OCT 29, 2023",LAL @ SAC,L,14,3,3,1.0,2,2,1.0,3,3,1.0,0,5,5,1,0,0,0,0,11,12,1,Christian Wood,LAL,SAC,LAL,,,17,16,12,6
22023,1626174,22300076,"OCT 26, 2023",LAL vs. PHX,W,21,2,7,0.286,0,2,0.0,3,4,0.75,2,8,10,1,0,0,1,2,7,23,1,Christian Wood,LAL,LAL,PHX,,,18,17,8,11
22023,1626174,22300061,"OCT 24, 2023",LAL @ DEN,L,15,3,4,0.75,0,1,0.0,1,2,0.5,1,3,4,0,0,0,1,1,7,2,1,Christian Wood,LAL,DEN,LAL,,,11,11,7,4
22023,1626153,22300558,"JAN 15, 2024",WAS vs. DET,L,16,2,6,0.333,1,2,0.5,0,0,0.0,1,0,1,4,1,0,0,2,5,0,1,Delon Wright,WAS,WAS,DET,,,10,6,9,5
22023,1626153,22300543,"JAN 13, 2024",WAS @ ATL,W,22,3,7,0.429,2,3,0.667,0,0,0.0,1,1,2,4,2,1,0,1,8,10,1,Delon Wright,WAS,ATL,WAS,,,14,10,12,6
22023,1626153,22300520,"JAN 10, 2024",WAS @ IND,L,14,1,4,0.25,0,1,0.0,1,4,0.25,1,0,1,2,0,0,0,1,3,-3,1,Delon Wright,WAS,IND,WAS,,,6,4,5,3
22023,1626153,22300508,"JAN 08, 2024",WAS vs. OKC,L,17,3,6,0.5,1,1,1.0,0,0,0.0,1,0,1,2,0,0,0,2,7,-8,1,Delon Wright,WAS,WAS,OKC,,,10,8,9,3
22023,1626153,22300494,"JAN 06, 2024",WAS vs. NYK,L,17,1,6,0.167,0,1,0.0,0,0,0.0,0,3,3,3,0,0,0,0,2,-20,1,Delon Wright,WAS,WAS,NYK,,,8,5,5,6
22023,1626153,22300482,"JAN 05, 2024",WAS @ CLE,L,16,3,6,0.5,1,3,0.333,0,0,0.0,0,2,2,2,5,0,1,0,7,-6,1,Delon Wright,WAS,CLE,WAS,,,11,9,9,4
22023,1626153,22300465,"JAN 03, 2024",WAS @ CLE,L,18,0,3,0.0,0,1,0.0,0,0,0.0,0,2,2,4,1,1,1,1,0,-21,1,Delon Wright,WAS,CLE,WAS,,,6,2,4,6
22023,1626153,22300445,"DEC 31, 2023",WAS vs. ATL,L,18,1,2,0.5,1,2,0.5,0,0,0.0,0,0,0,2,0,0,3,2,3,-9,1,Delon Wright,WAS,WAS,ATL,,,5,3,5,2
22023,1626153,22300430,"DEC 29, 2023",WAS vs. BKN,W,17,2,3,0.667,0,1,0.0,0,0,0.0,1,2,3,2,2,1,0,0,4,18,1,Delon Wright,WAS,WAS,BKN,,,9,7,6,5
22023,1626153,22300407,"DEC 26, 2023",WAS vs. ORL,L,13,2,5,0.4,0,2,0.0,3,3,1.0,0,4,4,1,1,0,1,1,7,-4,1,Delon Wright,WAS,WAS,ORL,,,12,11,8,5
22023,1626153,22300009,"NOV 10, 2023",WAS vs. CHA,L,14,1,3,0.333,0,2,0.0,2,3,0.667,0,2,2,6,1,0,0,3,4,22,1,Delon Wright,WAS,WAS,CHA,,,12,6,10,8
22023,1626153,22300157,"NOV 08, 2023",WAS @ CHA,W,26,4,5,0.8,2,3,0.667,8,8,1.0,2,1,3,3,4,0,1,1,18,26,1,Delon Wright,WAS,CHA,WAS,,,24,21,21,6
22023,1626153,22300148,"NOV 06, 2023",WAS @ PHI,L,5,2,3,0.667,0,1,0.0,0,0,0.0,0,0,0,0,0,0,0,0,4,-16,1,Delon Wright,WAS,PHI,WAS,,,4,4,4,0
22023,1626153,22300003,"NOV 03, 2023",WAS @ MIA,L,17,0,3,0.0,0,0,0.0,0,0,0.0,0,2,2,2,1,0,2,0,0,-11,1,Delon Wright,WAS,MIA,WAS,,,4,2,2,4
22023,1626153,22300117,"NOV 01, 2023",WAS @ ATL,L,22,1,3,0.333,1,3,0.333,0,0,0.0,0,3,3,9,2,0,0,1,3,6,1,Delon Wright,WAS,ATL,WAS,,,15,6,12,12
22023,1626153,22300103,"OCT 30, 2023",WAS vs. BOS,L,12,0,2,0.0,0,0,0.0,1,2,0.5,0,2,2,2,0,0,0,0,1,-6,1,Delon Wright,WAS,WAS,BOS,,,5,3,3,4
22023,1626153,22300089,"OCT 28, 2023",WAS vs. MEM,W,20,0,3,0.0,0,1,0.0,2,2,1.0,0,2,2,7,2,1,1,0,2,2,1,Delon Wright,WAS,WAS,MEM,,,11,4,9,9
22023,1626153,22300064,"OCT 25, 2023",WAS @ IND,L,25,3,8,0.375,1,1,1.0,1,1,1.0,1,5,6,6,3,0,0,1,8,-15,1,Delon Wright,WAS,IND,WAS,,,20,14,14,12
22023,201152,22300563,"JAN 15, 2024",TOR vs. BOS,L,16,0,4,0.0,0,1,0.0,0,0,0.0,2,2,4,7,2,0,0,2,0,6,1,Thaddeus Young,TOR,TOR,BOS,,,11,4,7,11
22023,201152,22300540,"JAN 12, 2024",TOR @ UTA,L,12,0,1,0.0,0,0,0.0,0,0,0.0,0,2,2,2,0,0,0,5,0,2,1,Thaddeus Young,TOR,UTA,TOR,,,4,2,2,4
22023,201152,22300526,"JAN 10, 2024",TOR @ LAC,L,23,4,5,0.8,0,1,0.0,0,0,0.0,2,2,4,3,2,0,2,1,8,-2,1,Thaddeus Young,TOR,LAC,TOR,,,15,12,11,7
22023,201152,22300516,"JAN 09, 2024",TOR @ LAL,L,29,5,9,0.556,0,1,0.0,0,0,0.0,1,4,5,4,3,1,0,4,10,7,1,Thaddeus Young,TOR,LAL,TOR,,,19,15,14,9
22023,201152,22300504,"JAN 07, 2024",TOR @ GSW,W,4,1,2,0.5,1,1,1.0,0,0,0.0,0,0,0,0,0,0,1,0,3,-5,1,Thaddeus Young,TOR,GSW,TOR,,,3,3,3,0
22023,201152,22300452,"JAN 01, 2024",TOR vs. CLE,W,2,0,0,0.0,0,0,0.0,0,0,0.0,0,0,0,0,0,0,0,0,0,4,1,Thaddeus Young,TOR,TOR,CLE,,,0,0,0,0
22023,201152,22300440,"DEC 30, 2023",TOR @ DET,L,11,3,5,0.6,0,0,0.0,0,0,0.0,1,0,1,1,2,0,2,3,6,-9,1,Thaddeus Young,TOR,DET,TOR,,,8,7,7,2
22023,201152,22300416,"DEC 27, 2023",TOR @ WAS,W,5,1,1,1.0,0,0,0.0,1,1,1.0,1,2,3,3,0,0,1,0,3,4,1,Thaddeus Young,TOR,WAS,TOR,,,9,6,6,6
22023,201152,22300330,"DEC 15, 2023",TOR vs. ATL,L,3,0,0,0.0,0,0,0.0,0,0,0.0,0,0,0,0,0,0,0,0,0,1,1,Thaddeus Young,TOR,TOR,ATL,,,0,0,0,0
22023,201152,22300195,"NOV 15, 2023",TOR vs. MIL,L,4,0,1,0.0,0,0,0.0,0,0,0.0,0,1,1,0,0,0,1,0,0,4,1,Thaddeus Young,TOR,TOR,MIL,,,1,1,0,1
22023,201152,22300174,"NOV 11, 2023",TOR @ BOS,L,4,2,3,0.667,0,0,0.0,0,0,0.0,1,0,1,2,0,0,0,0,4,6,1,Thaddeus Young,TOR,BOS,TOR,,,7,5,6,3
22023,201152,22300128,"NOV 02, 2023",TOR @ PHI,L,2,0,0,0.0,0,0,0.0,0,2,0.0,0,1,1,1,0,0,0,0,0,1,1,Thaddeus Young,TOR,PHI,TOR,,,2,1,1,2
22023,1629027,22300559,"JAN 15, 2024",ATL vs. SAS,W,38,11,24,0.458,6,11,0.545,8,9,0.889,0,6,6,13,1,1,3,0,36,16,1,Trae Young,ATL,ATL,SAS,,,55,42,49,19
22023,1629027,22300543,"JAN 13, 2024",ATL vs. WAS,L,36,6,19,0.316,2,10,0.2,7,9,0.778,1,1,2,10,1,1,1,5,21,-23,1,Trae Young,ATL,ATL,WAS,,,33,23,31,12
22023,1629027,22300533,"JAN 12, 2024",ATL vs. IND,L,30,4,17,0.235,2,6,0.333,3,3,1.0,3,0,3,6,2,0,5,1,13,-19,1,Trae Young,ATL,ATL,IND,,,22,16,19,9
22023,1629027,22300521,"JAN 10, 2024",ATL vs. PHI,W,43,7,22,0.318,2,8,0.25,12,14,0.857,0,1,1,11,1,1,5,2,28,7,1,Trae Young,ATL,ATL,PHI,,,40,29,39,12
22023,1629027,22300499,"JAN 07, 2024",ATL @ ORL,L,42,11,23,0.478,2,9,0.222,7,10,0.7,0,4,4,9,1,1,5,2,31,-10,1,Trae Young,ATL,ORL,ATL,,,44,35,40,13
22023,1629027,22300480,"JAN 05, 2024",ATL @ IND,L,28,4,18,0.222,1,11,0.091,4,5,0.8,0,2,2,6,2,0,3,2,13,-28,1,Trae Young,ATL,IND,ATL,,,21,15,19,8
22023,1629027,22300467,"JAN 03, 2024",ATL vs. OKC,W,34,6,13,0.462,2,9,0.222,10,11,0.909,0,4,4,11,2,0,6,2,24,-9,1,Trae Young,ATL,ATL,OKC,,,39,28,35,15
22023,1629027,22300445,"DEC 31, 2023",ATL @ WAS,W,40,11,19,0.579,4,8,0.5,14,19,0.737,0,3,3,13,3,0,5,2,40,-13,1,Trae Young,ATL,WAS,ATL,,,56,43,53,16
22023,1629027,22300431,"DEC 29, 2023",ATL vs. SAC,L,38,7,18,0.389,3,10,0.3,7,7,1.0,1,2,3,9,4,0,4,4,24,-11,1,Trae Young,ATL,ATL,SAC,,,36,27,33,12
22023,1629027,22300408,"DEC 26, 2023",ATL @ CHI,L,40,6,17,0.353,3,12,0.25,6,7,0.857,0,2,2,13,1,0,6,3,21,-3,1,Trae Young,ATL,CHI,ATL,,,36,23,34,15
22023,1629027,22300393,"DEC 23, 2023",ATL vs. MEM,L,41,11,24,0.458,3,10,0.3,5,7,0.714,0,5,5,13,1,1,2,3,30,2,1,Trae Young,ATL,ATL,MEM,,,48,35,43,18
22023,1629027,22300384,"DEC 22, 2023",ATL @ MIA,L,40,10,22,0.455,7,13,0.538,3,3,1.0,0,3,3,13,2,0,6,1,30,-11,1,Trae Young,ATL,MIA,ATL,,,46,33,43,16
22023,1629027,22300371,"DEC 20, 2023",ATL @ HOU,W,36,10,18,0.556,5,8,0.625,5,7,0.714,0,4,4,14,1,0,4,4,30,11,1,Trae Young,ATL,HOU,ATL,,,48,34,44,18
22023,1629027,22300352,"DEC 18, 2023",ATL vs. DET,W,38,8,17,0.471,4,11,0.364,11,12,0.917,0,4,4,15,0,0,5,3,31,16,1,Trae Young,ATL,ATL,DET,,,50,35,46,19
22023,1629027,22300336,"DEC 16, 2023",ATL @ CLE,L,38,11,21,0.524,7,12,0.583,6,6,1.0,0,4,4,10,0,1,5,3,35,-9,1,Trae Young,ATL,CLE,ATL,,,49,39,45,14
22023,1629027,22300330,"DEC 15, 2023",ATL @ TOR,W,36,15,29,0.517,7,15,0.467,1,2,0.5,1,4,5,11,1,0,8,2,38,14,1,Trae Young,ATL,TOR,ATL,,,54,43,49,16
22023,1629027,22300313,"DEC 13, 2023",ATL @ TOR,L,39,13,27,0.481,4,9,0.444,5,6,0.833,0,4,4,17,0,1,5,3,35,0,1,Trae Young,ATL,TOR,ATL,,,56,39,52,21
22023,1629027,22300296,"DEC 11, 2023",ATL vs. DEN,L,26,5,12,0.417,2,5,0.4,7,7,1.0,0,1,1,9,1,0,5,2,19,-10,1,Trae Young,ATL,ATL,DEN,,,29,20,28,10
22023,1629027,22301209,"DEC 06, 2023",ATL vs. BKN,L,37,11,24,0.458,3,9,0.333,5,5,1.0,1,0,1,9,0,2,5,2,30,3,1,Trae Young,ATL,ATL,BKN,,,40,31,39,10
22023,1629027,22300286,"DEC 02, 2023",ATL @ MIL,L,37,13,28,0.464,5,13,0.385,1,2,0.5,2,0,2,12,2,0,4,0,32,-8,1,Trae Young,ATL,MIL,ATL,,,46,34,44,14
22023,1629027,22300272,"NOV 30, 2023",ATL @ SAS,W,40,15,29,0.517,2,9,0.222,13,16,0.813,0,4,4,14,2,0,2,1,45,-1,1,Trae Young,ATL,SAS,ATL,,,63,49,59,18
22023,1629027,22300055,"NOV 28, 2023",ATL @ CLE,L,32,3,14,0.214,2,8,0.25,5,6,0.833,0,1,1,10,1,0,3,3,13,-27,1,Trae Young,ATL,CLE,ATL,,,24,14,23,11
22023,1629027,22300246,"NOV 26, 2023",ATL @ BOS,L,37,12,27,0.444,6,16,0.375,3,6,0.5,1,4,5,7,0,0,5,3,33,-11,1,Trae Young,ATL,BOS,ATL,,,45,38,40,12
22023,1629027,22300241,"NOV 25, 2023",ATL @ WAS,W,30,9,17,0.529,5,8,0.625,3,3,1.0,0,6,6,10,2,0,2,1,26,40,1,Trae Young,ATL,WAS,ATL,,,42,32,36,16
22023,1629027,22300227,"NOV 22, 2023",ATL vs. BKN,W,40,12,31,0.387,8,16,0.5,11,13,0.846,2,2,4,9,2,0,4,0,43,-11,1,Trae Young,ATL,ATL,BKN,,,56,47,52,13
22023,1629027,22300039,"NOV 21, 2023",ATL vs. IND,L,39,13,17,0.765,5,8,0.625,7,8,0.875,0,1,1,8,3,0,3,3,38,-2,1,Trae Young,ATL,ATL,IND,,,47,39,46,9
22023,1629027,22300029,"NOV 17, 2023",ATL vs. PHI,L,37,5,14,0.357,2,6,0.333,10,10,1.0,0,2,2,13,1,0,4,3,22,12,1,Trae Young,ATL,ATL,PHI,,,37,24,35,15
22023,1629027,22300193,"NOV 15, 2023",ATL vs. NYK,L,34,4,12,0.333,0,4,0.0,7,9,0.778,0,1,1,17,2,0,3,0,15,1,1,Trae Young,ATL,ATL,NYK,,,33,16,32,18
22023,1629027,22300175,"NOV 11, 2023",ATL vs. MIA,L,38,7,19,0.368,3,9,0.333,10,11,0.909,0,2,2,11,1,0,5,0,27,4,1,Trae Young,ATL,ATL,MIA,,,40,29,38,13
22023,1629027,22300172,"NOV 09, 2023",ATL @ ORL,W,34,12,27,0.444,5,15,0.333,12,13,0.923,2,2,4,8,3,0,3,1,41,1,1,Trae Young,ATL,ORL,ATL,,,53,45,49,12
22023,1629027,22300155,"NOV 06, 2023",ATL @ OKC,L,36,5,18,0.278,1,5,0.2,11,11,1.0,1,3,4,11,1,0,7,1,22,-18,1,Trae Young,ATL,OKC,ATL,,,37,26,33,15
22023,1629027,22300135,"NOV 04, 2023",ATL @ NOP,W,39,7,15,0.467,3,7,0.429,5,6,0.833,3,2,5,12,1,0,5,3,22,18,1,Trae Young,ATL,NOP,ATL,,,39,27,34,17
22023,1629027,22300117,"NOV 01, 2023",ATL vs. WAS,W,35,7,18,0.389,1,3,0.333,8,9,0.889,0,3,3,10,2,0,3,1,23,4,1,Trae Young,ATL,ATL,WAS,,,36,26,33,13
22023,1629027,22300104,"OCT 30, 2023",ATL vs. MIN,W,35,9,22,0.409,1,7,0.143,5,5,1.0,0,1,1,8,1,0,1,1,24,4,1,Trae Young,ATL,ATL,MIN,,,33,25,32,9
22023,1629027,22300097,"OCT 29, 2023",ATL @ MIL,W,32,5,14,0.357,3,8,0.375,7,9,0.778,0,3,3,11,1,0,3,1,20,13,1,Trae Young,ATL,MIL,ATL,,,34,23,31,14
22023,1629027,22300079,"OCT 27, 2023",ATL vs. NYK,L,35,4,16,0.25,2,5,0.4,8,10,0.8,1,2,3,12,3,0,6,2,18,-5,1,Trae Young,ATL,ATL,NYK,,,33,21,30,15
22023,1629027,22300063,"OCT 25, 2023",ATL @ CHA,L,36,4,19,0.211,1,9,0.111,14,15,0.933,0,1,1,9,1,0,5,3,23,-11,1,Trae Young,ATL,CHA,ATL,,,33,24,32,10
22023,1630209,22300564,"JAN 15, 2024",UTA vs. IND,W,3,0,0,0.0,0,0,0.0,0,0,0.0,0,2,2,0,0,0,0,0,0,7,1,Omer Yurtseven,UTA,UTA,IND,,,2,2,0,2
22023,1630209,22300540,"JAN 12, 2024",UTA vs. TOR,W,5,2,2,1.0,0,0,0.0,0,0,0.0,2,2,4,0,0,0,0,1,4,9,1,Omer Yurtseven,UTA,UTA,TOR,,,8,8,4,4
22023,1630209,22300524,"JAN 10, 2024",UTA vs. DEN,W,3,1,1,1.0,0,0,0.0,0,0,0.0,0,2,2,0,0,0,2,0,2,-5,1,Omer Yurtseven,UTA,UTA,DEN,,,4,4,2,2
22023,1630209,22300479,"JAN 05, 2024",UTA @ BOS,L,12,0,4,0.0,0,2,0.0,0,2,0.0,3,4,7,0,0,0,1,1,0,3,1,Omer Yurtseven,UTA,BOS,UTA,,,7,7,0,7
22023,1630209,22300457,"JAN 01, 2024",UTA vs. DAL,W,4,0,0,0.0,0,0,0.0,0,0,0.0,0,1,1,0,0,0,0,0,0,1,1,Omer Yurtseven,UTA,UTA,DAL,,,1,1,0,1
22023,1630209,22300412,"DEC 26, 2023",UTA @ SAS,W,2,0,1,0.0,0,0,0.0,0,0,0.0,0,0,0,0,0,0,0,0,0,-7,1,Omer Yurtseven,UTA,SAS,UTA,,,0,0,0,0
22023,1630209,22300323,"DEC 14, 2023",UTA @ POR,W,22,2,7,0.286,0,0,0.0,0,0,0.0,3,1,4,1,1,2,2,3,4,-15,1,Omer Yurtseven,UTA,POR,UTA,,,9,8,5,5
22023,1630209,22300318,"DEC 13, 2023",UTA vs. NYK,W,5,0,1,0.0,0,0,0.0,0,0,0.0,1,2,3,0,0,0,0,0,0,5,1,Omer Yurtseven,UTA,UTA,NYK,,,3,3,0,3
22023,1630209,22300302,"DEC 11, 2023",UTA @ OKC,L,10,1,2,0.5,0,0,0.0,0,0,0.0,2,3,5,0,0,1,3,3,2,-17,1,Omer Yurtseven,UTA,OKC,UTA,,,7,7,2,5
22023,1630209,22301213,"DEC 06, 2023",UTA @ DAL,L,21,4,7,0.571,0,0,0.0,0,0,0.0,3,6,9,0,0,0,4,5,8,-35,1,Omer Yurtseven,UTA,DAL,UTA,,,17,17,8,9
22023,1630209,22300289,"DEC 02, 2023",UTA vs. POR,W,27,4,8,0.5,0,1,0.0,1,1,1.0,4,11,15,4,1,1,1,3,9,10,1,Omer Yurtseven,UTA,UTA,POR,,,28,24,13,19
22023,1630209,22300270,"NOV 30, 2023",UTA @ MIN,L,14,1,4,0.25,0,1,0.0,0,0,0.0,1,6,7,0,0,1,2,3,2,-4,1,Omer Yurtseven,UTA,MIN,UTA,,,9,9,2,7
22023,1630209,22300261,"NOV 29, 2023",UTA @ MEM,L,15,2,5,0.4,0,0,0.0,0,0,0.0,2,2,4,1,1,0,2,2,4,-11,1,Omer Yurtseven,UTA,MEM,UTA,,,9,8,5,5
22023,1630209,22300256,"NOV 27, 2023",UTA vs. NOP,W,22,2,4,0.5,1,2,0.5,2,2,1.0,5,5,10,2,0,2,2,4,7,-1,1,Omer Yurtseven,UTA,UTA,NOP,,,19,17,9,12
22023,1630209,22300243,"NOV 25, 2023",UTA vs. NOP,W,27,3,6,0.5,0,3,0.0,0,0,0.0,2,5,7,0,1,2,0,0,6,4,1,Omer Yurtseven,UTA,UTA,NOP,,,13,13,6,7
22023,1630209,22300237,"NOV 22, 2023",UTA @ POR,L,16,1,3,0.333,1,2,0.5,0,0,0.0,0,6,6,1,0,0,2,1,3,-8,1,Omer Yurtseven,UTA,POR,UTA,,,10,9,4,7
22023,1630209,22300042,"NOV 21, 2023",UTA @ LAL,L,17,8,11,0.727,0,1,0.0,2,3,0.667,4,2,6,1,0,0,0,1,18,-9,1,Omer Yurtseven,UTA,LAL,UTA,,,25,24,19,7
22023,1630209,22300023,"NOV 14, 2023",UTA vs. POR,W,1,0,0,0.0,0,0,0.0,0,0,0.0,0,0,0,0,0,0,0,0,0,0,1,Omer Yurtseven,UTA,UTA,POR,,,0,0,0,0
22023,1630209,22300152,"NOV 06, 2023",UTA @ CHI,L,4,1,1,1.0,0,0,0.0,0,0,0.0,0,0,0,0,0,1,0,0,2,5,1,Omer Yurtseven,UTA,CHI,UTA,,,2,2,2,0
22023,1630209,22300138,"NOV 04, 2023",UTA @ MIN,L,4,0,1,0.0,0,1,0.0,0,0,0.0,0,0,0,1,0,0,0,1,0,-5,1,Omer Yurtseven,UTA,MIN,UTA,,,1,0,1,1
22023,1630209,22300130,"NOV 02, 2023",UTA vs. ORL,L,8,3,3,1.0,1,1,1.0,0,0,0.0,1,2,3,0,0,0,0,2,7,8,1,Omer Yurtseven,UTA,UTA,ORL,,,10,10,7,3
22023,1630209,22300125,"NOV 01, 2023",UTA vs. MEM,W,7,1,2,0.5,0,0,0.0,1,2,0.5,1,2,3,1,0,0,1,3,3,-3,1,Omer Yurtseven,UTA,UTA,MEM,,,7,6,4,4
22023,1630209,22300094,"OCT 28, 2023",UTA @ PHX,L,6,2,3,0.667,0,1,0.0,0,0,0.0,1,3,4,1,0,0,0,0,4,4,1,Omer Yurtseven,UTA,PHX,UTA,,,9,8,5,5
22023,1630209,22300072,"OCT 25, 2023",UTA vs. SAC,L,2,0,0,0.0,0,0,0.0,0,0,0.0,0,1,1,0,0,0,0,0,0,2,1,Omer Yurtseven,UTA,UTA,SAC,,,1,1,0,1
22023,203469,22300525,"JAN 10, 2024",NOP @ GSW,W,8,3,3,1.0,0,0,0.0,0,0,0.0,2,1,3,1,0,0,1,2,6,1,1,Cody Zeller,NOP,GSW,NOP,,,10,9,7,4
22023,203469,22300500,"JAN 07, 2024",NOP @ SAC,W,7,2,3,0.667,1,1,1.0,2,2,1.0,1,1,2,1,0,0,2,0,7,-5,1,Cody Zeller,NOP,SAC,NOP,,,10,9,8,3
22023,203469,22300486,"JAN 05, 2024",NOP vs. LAC,L,6,0,1,0.0,0,1,0.0,1,2,0.5,1,2,3,2,0,0,0,3,1,12,1,Cody Zeller,NOP,NOP,LAC,,,6,4,3,5
22023,203469,22300471,"JAN 03, 2024",NOP @ MIN,W,2,0,0,0.0,0,0,0.0,0,0,0.0,1,0,1,1,0,0,0,0,0,-2,1,Cody Zeller,NOP,MIN,NOP,,,2,1,1,2
22023,203469,22300461,"JAN 02, 2024",NOP vs. BKN,W,8,1,3,0.333,0,0,0.0,2,3,0.667,1,1,2,0,0,0,0,2,4,0,1,Cody Zeller,NOP,NOP,BKN,,,6,6,4,2
22023,203469,22300410,"DEC 26, 2023",NOP vs. MEM,L,0,0,0,0.0,0,0,0.0,0,0,0.0,0,0,0,0,0,0,0,0,0,0,1,Cody Zeller,NOP,NOP,MEM,,,0,0,0,0
22023,203469,22300360,"DEC 19, 2023",NOP vs. MEM,L,13,1,3,0.333,0,0,0.0,2,2,1.0,4,2,6,1,0,1,1,1,4,-2,1,Cody Zeller,NOP,NOP,MEM,,,11,10,5,7
22023,203469,22300345,"DEC 17, 2023",NOP @ SAS,W,18,1,2,0.5,0,0,0.0,0,0,0.0,1,4,5,4,0,0,1,4,2,24,1,Cody Zeller,NOP,SAS,NOP,,,11,7,6,9
22023,203469,22300311,"DEC 13, 2023",NOP @ WAS,W,5,1,1,1.0,0,0,0.0,0,0,0.0,0,0,0,2,0,0,0,1,2,-4,1,Cody Zeller,NOP,WAS,NOP,,,4,2,4,2
22023,203469,22301230,"DEC 07, 2023",NOP @ LAL,L,12,0,1,0.0,0,0,0.0,2,2,1.0,1,1,2,1,0,0,0,2,2,-5,1,Cody Zeller,NOP,LAL,NOP,,,5,4,3,3
22023,203469,22301204,"DEC 04, 2023",NOP @ SAC,W,5,0,0,0.0,0,0,0.0,0,0,0.0,0,0,0,0,1,0,0,0,0,-1,1,Cody Zeller,NOP,SAC,NOP,,,0,0,0,0
22023,203469,22300285,"DEC 02, 2023",NOP @ CHI,L,12,1,4,0.25,0,0,0.0,2,2,1.0,3,1,4,0,0,0,0,2,4,-17,1,Cody Zeller,NOP,CHI,NOP,,,8,8,4,4
22023,203469,22300278,"DEC 01, 2023",NOP vs. SAS,W,13,0,0,0.0,0,0,0.0,2,2,1.0,1,2,3,1,0,0,0,1,2,2,1,Cody Zeller,NOP,NOP,SAS,,,6,5,3,4
22023,203469,22300262,"NOV 29, 2023",NOP vs. PHI,W,13,0,3,0.0,0,0,0.0,1,2,0.5,0,1,1,0,1,0,2,4,1,-9,1,Cody Zeller,NOP,NOP,PHI,,,2,2,1,1
22023,203469,22300256,"NOV 27, 2023",NOP @ UTA,L,9,0,0,0.0,0,0,0.0,1,2,0.5,0,1,1,2,0,0,0,2,1,0,1,Cody Zeller,NOP,UTA,NOP,,,4,2,3,3
22023,203469,22300243,"NOV 25, 2023",NOP @ UTA,L,21,2,2,1.0,0,0,0.0,0,0,0.0,2,4,6,5,0,1,0,0,4,14,1,Cody Zeller,NOP,UTA,NOP,,,15,10,9,11
22023,203469,22300233,"NOV 22, 2023",NOP vs. SAC,W,8,0,2,0.0,0,0,0.0,0,0,0.0,2,1,3,0,0,0,0,2,0,7,1,Cody Zeller,NOP,NOP,SAC,,,3,3,0,3
22023,203469,22300222,"NOV 20, 2023",NOP vs. SAC,W,23,4,7,0.571,0,1,0.0,1,4,0.25,3,6,9,2,0,0,1,2,9,12,1,Cody Zeller,NOP,NOP,SAC,,,20,18,11,11
22023,203469,22300203,"NOV 18, 2023",NOP vs. MIN,L,13,1,4,0.25,0,0,0.0,0,0,0.0,3,4,7,0,1,0,1,3,2,3,1,Cody Zeller,NOP,NOP,MIN,,,9,9,2,7
22023,203469,22300034,"NOV 17, 2023",NOP vs. DEN,W,2,0,0,0.0,0,0,0.0,0,0,0.0,0,1,1,0,0,1,0,0,0,3,1,Cody Zeller,NOP,NOP,DEN,,,1,1,0,1
22023,203469,22300022,"NOV 14, 2023",NOP vs. DAL,W,5,0,1,0.0,0,0,0.0,0,2,0.0,1,2,3,0,0,0,1,0,0,1,1,Cody Zeller,NOP,NOP,DAL,,,3,3,0,3
22023,203469,22300183,"NOV 12, 2023",NOP vs. DAL,L,13,1,2,0.5,0,0,0.0,1,2,0.5,1,4,5,2,0,0,1,1,3,11,1,Cody Zeller,NOP,NOP,DAL,,,10,8,5,7
22023,203469,22300011,"NOV 10, 2023",NOP @ HOU,L,4,0,0,0.0,0,0,0.0,1,1,1.0,0,1,1,0,1,0,0,1,1,4,1,Cody Zeller,NOP,HOU,NOP,,,2,2,1,1
22023,203469,22300166,"NOV 08, 2023",NOP @ MIN,L,12,1,2,0.5,0,0,0.0,2,3,0.667,2,3,5,6,0,0,0,3,4,8,1,Cody Zeller,NOP,MIN,NOP,,,15,9,10,11
22023,203469,22300156,"NOV 06, 2023",NOP @ DEN,L,4,0,0,0.0,0,0,0.0,0,0,0.0,0,1,1,0,0,0,0,0,0,-9,1,Cody Zeller,NOP,DEN,NOP,,,1,1,0,1
22023,203469,22300121,"NOV 01, 2023",NOP @ OKC,W,2,0,2,0.0,0,0,0.0,0,0,0.0,2,0,2,0,0,0,0,0,0,-6,1,Cody Zeller,NOP,OKC,NOP,,,2,2,0,2
22023,203469,22300108,"OCT 30, 2023",NOP vs. GSW,L,5,0,2,0.0,0,0,0.0,0,2,0.0,1,1,2,0,0,0,0,0,0,0,1,Cody Zeller,NOP,NOP,GSW,,,2,2,0,2
22023,203469,22300090,"OCT 28, 2023",NOP vs. NYK,W,8,0,1,0.0,0,0,0.0,0,0,0.0,0,1,1,0,0,0,0,0,0,-7,1,Cody Zeller,NOP,NOP,NYK,,,1,1,0,1
22023,1627826,22300537,"JAN 12, 2024",LAC @ MEM,W,22,2,5,0.4,0,0,0.0,2,2,1.0,4,7,11,0,0,2,0,3,6,6,1,Ivica Zubac,LAC,MEM,LAC,,,17,17,6,11
22023,1627826,22300526,"JAN 10, 2024",LAC vs. TOR,W,31,6,8,0.75,0,0,0.0,0,0,0.0,5,6,11,3,0,1,2,2,12,1,1,Ivica Zubac,LAC,LAC,TOR,,,26,23,15,14
22023,1627826,22300511,"JAN 08, 2024",LAC vs. PHX,W,28,8,9,0.889,0,0,0.0,3,6,0.5,2,6,8,3,1,1,0,3,19,14,1,Ivica Zubac,LAC,LAC,PHX,,,30,27,22,11
22023,1627826,22300505,"JAN 07, 2024",LAC @ LAL,L,37,9,13,0.692,0,0,0.0,4,4,1.0,10,9,19,1,0,1,2,4,22,1,1,Ivica Zubac,LAC,LAL,LAC,,,42,41,23,20
22023,1627826,22300486,"JAN 05, 2024",LAC @ NOP,W,23,6,7,0.857,0,0,0.0,3,4,0.75,0,8,8,2,0,2,1,3,15,18,1,Ivica Zubac,LAC,NOP,LAC,,,25,23,17,10
22023,1627826,22300473,"JAN 03, 2024",LAC @ PHX,W,27,2,4,0.5,0,0,0.0,2,2,1.0,1,2,3,2,0,2,0,5,6,1,1,Ivica Zubac,LAC,PHX,LAC,,,11,9,8,5
22023,1627826,22300458,"JAN 01, 2024",LAC vs. MIA,W,29,3,4,0.75,0,0,0.0,0,0,0.0,1,11,12,1,0,0,1,4,6,28,1,Ivica Zubac,LAC,LAC,MIA,,,19,18,7,13
22023,1627826,22300438,"DEC 29, 2023",LAC vs. MEM,W,33,7,8,0.875,0,0,0.0,1,1,1.0,6,14,20,1,0,1,2,3,15,9,1,Ivica Zubac,LAC,LAC,MEM,,,36,35,16,21
22023,1627826,22300414,"DEC 26, 2023",LAC vs. CHA,W,31,7,11,0.636,0,0,0.0,4,8,0.5,5,9,14,4,1,1,2,3,18,13,1,Ivica Zubac,LAC,LAC,CHA,,,36,32,22,18
22023,1627826,22300389,"DEC 23, 2023",LAC vs. BOS,L,27,7,9,0.778,0,0,0.0,2,2,1.0,5,5,10,0,0,1,2,3,16,-28,1,Ivica Zubac,LAC,LAC,BOS,,,26,26,16,10
22023,1627826,22300379,"DEC 21, 2023",LAC @ OKC,L,17,3,4,0.75,0,0,0.0,0,0,0.0,2,1,3,3,0,0,0,2,6,-3,1,Ivica Zubac,LAC,OKC,LAC,,,12,9,9,6
22023,1627826,22300372,"DEC 20, 2023",LAC @ DAL,W,25,5,6,0.833,0,0,0.0,2,2,1.0,2,7,9,0,1,0,1,2,12,0,1,Ivica Zubac,LAC,DAL,LAC,,,21,21,12,9
22023,1627826,22300350,"DEC 18, 2023",LAC @ IND,W,26,7,10,0.7,0,0,0.0,4,5,0.8,4,12,16,3,0,3,0,2,18,27,1,Ivica Zubac,LAC,IND,LAC,,,37,34,21,19
22023,1627826,22300343,"DEC 16, 2023",LAC vs. NYK,W,28,5,9,0.556,0,0,0.0,3,4,0.75,4,7,11,2,1,2,0,2,13,29,1,Ivica Zubac,LAC,LAC,NYK,,,26,24,15,13
22023,1627826,22300325,"DEC 14, 2023",LAC vs. GSW,W,30,5,10,0.5,0,0,0.0,0,0,0.0,3,5,8,2,0,2,3,5,10,-3,1,Ivica Zubac,LAC,LAC,GSW,,,20,18,12,10
22023,1627826,22300309,"DEC 12, 2023",LAC vs. SAC,W,23,3,5,0.6,0,0,0.0,0,1,0.0,0,9,9,0,0,0,1,4,6,17,1,Ivica Zubac,LAC,LAC,SAC,,,15,15,6,9
22023,1627826,22300304,"DEC 11, 2023",LAC vs. POR,W,33,9,13,0.692,0,0,0.0,0,0,0.0,3,3,6,2,0,2,0,2,18,2,1,Ivica Zubac,LAC,LAC,POR,,,26,24,20,8
22023,1627826,22301225,"DEC 08, 2023",LAC @ UTA,W,42,9,15,0.6,0,0,0.0,0,0,0.0,5,7,12,3,0,2,1,5,18,13,1,Ivica Zubac,LAC,UTA,LAC,,,33,30,21,15
22023,1627826,22301215,"DEC 06, 2023",LAC vs. DEN,W,27,4,7,0.571,0,0,0.0,2,6,0.333,2,7,9,0,2,1,0,3,10,-6,1,Ivica Zubac,LAC,LAC,DEN,,,19,19,10,9
22023,1627826,22300280,"DEC 02, 2023",LAC vs. GSW,W,23,6,6,1.0,0,0,0.0,0,0,0.0,1,6,7,1,0,3,3,4,12,1,1,Ivica Zubac,LAC,LAC,GSW,,,20,19,13,8
22023,1627826,22300273,"NOV 30, 2023",LAC @ GSW,L,27,7,11,0.636,0,0,0.0,4,5,0.8,4,9,13,0,0,1,0,1,18,7,1,Ivica Zubac,LAC,GSW,LAC,,,31,31,18,13
22023,1627826,22300264,"NOV 29, 2023",LAC @ SAC,W,30,7,12,0.583,0,0,0.0,0,0,0.0,3,5,8,3,0,3,0,1,14,23,1,Ivica Zubac,LAC,SAC,LAC,,,25,22,17,11
22023,1627826,22300257,"NOV 27, 2023",LAC vs. DEN,L,32,9,15,0.6,0,0,0.0,5,8,0.625,8,6,14,1,0,1,1,2,23,-6,1,Ivica Zubac,LAC,LAC,DEN,,,38,37,24,15
22023,1627826,22300244,"NOV 25, 2023",LAC vs. DAL,W,23,5,8,0.625,0,0,0.0,1,5,0.2,4,10,14,1,0,0,1,1,11,18,1,Ivica Zubac,LAC,LAC,DAL,,,26,25,12,15
22023,1627826,22300052,"NOV 24, 2023",LAC vs. NOP,L,22,5,6,0.833,0,0,0.0,1,1,1.0,3,2,5,0,0,1,4,4,11,-18,1,Ivica Zubac,LAC,LAC,NOP,,,16,16,11,5
22023,1627826,22300235,"NOV 22, 2023",LAC @ SAS,W,26,5,7,0.714,0,0,0.0,2,2,1.0,2,6,8,1,0,0,0,2,12,-4,1,Ivica Zubac,LAC,SAS,LAC,,,21,20,13,9
22023,1627826,22300223,"NOV 20, 2023",LAC @ SAS,W,22,3,5,0.6,0,0,0.0,2,2,1.0,2,9,11,0,0,1,1,0,8,4,1,Ivica Zubac,LAC,SAS,LAC,,,19,19,8,11
22023,1627826,22300037,"NOV 17, 2023",LAC vs. HOU,W,35,6,8,0.75,0,0,0.0,0,2,0.0,3,4,7,2,0,2,1,2,12,12,1,Ivica Zubac,LAC,LAC,HOU,,,21,19,14,9
22023,1627826,22300024,"NOV 14, 2023",LAC @ DEN,L,26,2,8,0.25,0,0,0.0,5,6,0.833,7,6,13,3,0,1,0,4,9,-3,1,Ivica Zubac,LAC,DEN,LAC,,,25,22,12,16
22023,1627826,22300179,"NOV 12, 2023",LAC vs. MEM,L,23,2,4,0.5,0,0,0.0,2,2,1.0,0,6,6,1,1,0,1,3,6,-6,1,Ivica Zubac,LAC,LAC,MEM,,,13,12,7,7
22023,1627826,22300014,"NOV 10, 2023",LAC @ DAL,L,22,5,9,0.556,0,0,0.0,2,4,0.5,5,3,8,1,0,2,1,3,12,1,1,Ivica Zubac,LAC,DAL,LAC,,,21,20,13,9
22023,1627826,22300160,"NOV 08, 2023",LAC @ BKN,L,29,5,9,0.556,0,0,0.0,0,0,0.0,3,7,10,1,0,3,1,5,10,-11,1,Ivica Zubac,LAC,BKN,LAC,,,21,20,11,11
22023,1627826,22300151,"NOV 06, 2023",LAC @ NYK,L,30,3,3,1.0,0,0,0.0,2,4,0.5,4,3,7,0,1,2,5,3,8,-18,1,Ivica Zubac,LAC,NYK,LAC,,,15,15,8,7
22023,1627826,22300127,"NOV 01, 2023",LAC @ LAL,L,29,3,8,0.375,0,0,0.0,1,2,0.5,2,7,9,0,0,0,1,5,7,-6,1,Ivica Zubac,LAC,LAL,LAC,,,16,16,7,9
22023,1627826,22300114,"OCT 31, 2023",LAC vs. ORL,W,23,4,8,0.5,0,0,0.0,1,2,0.5,2,7,9,1,0,1,1,1,9,19,1,Ivica Zubac,LAC,LAC,ORL,,,19,18,10,10
22023,1627826,22300099,"OCT 29, 2023",LAC vs. SAS,W,22,6,7,0.857,0,0,0.0,4,6,0.667,2,6,8,0,0,1,1,4,16,23,1,Ivica Zubac,LAC,LAC,SAS,,,24,24,16,8
22023,1627826,22300085,"OCT 27, 2023",LAC @ UTA,L,19,3,6,0.5,0,0,0.0,0,2,0.0,0,2,2,0,0,2,1,2,6,1,1,Ivica Zubac,LAC,UTA,LAC,,,8,8,6,2
22023,1627826,22300074,"OCT 25, 2023",LAC vs. POR,W,26,8,10,0.8,0,0,0.0,4,5,0.8,5,7,12,0,0,4,2,3,20,25,1,Ivica Zubac,LAC,LAC,POR,,,32,32,20,12
