PlayerName,POS,SEASON_ID,Player_ID,Game_ID,GAME_DATE,MATCHUP,WL,MIN,FGM,FGA,FG_PCT,FG3M,FG3A,FG3_PCT,FTM,FTA,FT_PCT,OREB,DREB,Rebounds,Assists,STL,BLK,TOV,PF,Points,PLUS_MINUS,VIDEO_AVAILABLE,Team,Home,Away,PTS_Team_Total,Value,Prop,Pts+Rebs+Asts,Pts+Rebs,Pts+Asts,Rebs+Asts
Joel Embiid,C,22023,203954,22300483,"JAN 05, 2024",PHI vs. NYK,L,36,10,23,0.435,1,1,1.0,9,12,0.75,3,7,10,3,1,3,6,3,30,-29,1,PHI,PHI,NYK,92,,,43,40,33,13
Joel Embiid,C,22023,203954,22300459,"JAN 02, 2024",PHI vs. CHI,W,31,10,20,0.5,2,5,0.4,9,12,0.75,0,15,15,10,1,2,4,4,31,32,1,PHI,PHI,CHI,110,,,56,46,41,25
Joel Embiid,C,22023,203954,22300367,"DEC 20, 2023",PHI vs. MIN,W,36,17,25,0.68,0,1,0.0,17,18,0.944,2,10,12,3,2,1,2,5,51,3,1,PHI,PHI,MIN,127,,,66,63,54,15
Joel Embiid,C,22023,203954,22300335,"DEC 16, 2023",PHI @ CHA,W,30,18,23,0.783,0,1,0.0,6,6,1.0,0,15,15,3,1,2,4,2,42,36,1,PHI,CHA,PHI,135,,,60,57,45,18
Joel Embiid,C,22023,203954,22300327,"DEC 15, 2023",PHI vs. DET,W,29,9,19,0.474,2,3,0.667,15,16,0.938,0,13,13,2,2,4,4,2,35,28,1,PHI,PHI,DET,124,,,50,48,37,15
Joel Embiid,C,22023,203954,22300310,"DEC 13, 2023",PHI @ DET,W,31,14,24,0.583,1,3,0.333,12,12,1.0,4,7,11,5,2,0,2,1,41,27,1,PHI,DET,PHI,129,,,57,52,46,16
Joel Embiid,C,22023,203954,22300295,"DEC 11, 2023",PHI vs. WAS,W,30,14,20,0.7,2,5,0.4,4,4,1.0,0,11,11,6,2,1,7,4,34,30,1,PHI,PHI,WAS,146,,,51,45,40,17
Joel Embiid,C,22023,203954,22301218,"DEC 08, 2023",PHI vs. ATL,W,36,12,24,0.5,1,3,0.333,13,15,0.867,4,10,14,3,1,4,2,1,38,16,1,PHI,PHI,ATL,125,,,55,52,41,17
Joel Embiid,C,22023,203954,22300255,"NOV 27, 2023",PHI vs. LAL,W,31,9,15,0.6,2,3,0.667,10,12,0.833,4,7,11,11,1,1,3,2,30,11,1,PHI,PHI,LAL,138,,,52,41,41,22
Joel Embiid,C,22023,203954,22300208,"NOV 19, 2023",PHI @ BKN,W,31,11,24,0.458,1,2,0.5,9,10,0.9,2,10,12,9,0,1,1,3,32,25,1,PHI,BKN,PHI,121,,,53,44,41,21
Joel Embiid,C,22023,203954,22300148,"NOV 06, 2023",PHI vs. WAS,W,31,17,25,0.68,0,2,0.0,14,14,1.0,2,9,11,6,1,1,1,2,48,15,1,PHI,PHI,WAS,146,,,65,59,54,17
Joel Embiid,C,22023,203954,22300132,"NOV 04, 2023",PHI vs. PHX,W,31,9,18,0.5,3,3,1.0,5,5,1.0,3,8,11,3,0,1,4,2,26,4,1,PHI,PHI,PHX,112,,,40,37,29,14
Joel Embiid,C,22023,203954,22300128,"NOV 02, 2023",PHI vs. TOR,W,35,8,22,0.364,0,2,0.0,12,13,0.923,5,8,13,7,0,1,4,2,28,22,1,PHI,PHI,TOR,114,,,48,41,35,20
Joel Embiid,C,22023,203954,22300098,"OCT 29, 2023",PHI vs. POR,W,29,12,22,0.545,2,4,0.5,9,12,0.75,5,10,15,7,2,6,3,3,35,28,1,PHI,PHI,POR,126,,,57,50,42,22
Joel Embiid,C,22023,203954,22300627,"JAN 25, 2024",PHI @ IND,L,31,11,20,0.55,2,4,0.5,7,10,0.7,1,6,7,3,0,0,2,1,31,-20,1,PHI,IND,PHI,122,,,41,38,34,10
Joel Embiid,C,22023,203954,22300608,"JAN 22, 2024",PHI vs. SAS,W,37,24,41,0.585,1,2,0.5,21,23,0.913,9,9,18,5,1,1,1,2,70,11,1,PHI,PHI,SAS,133,,,93,88,75,23
Joel Embiid,C,22023,203954,22300593,"JAN 20, 2024",PHI @ CHA,W,37,11,23,0.478,0,1,0.0,11,12,0.917,1,9,10,5,0,3,3,2,33,-2,1,PHI,CHA,PHI,97,,,48,43,38,15
Joel Embiid,C,22023,203954,22300585,"JAN 19, 2024",PHI @ ORL,W,31,12,22,0.545,1,2,0.5,11,11,1.0,1,6,7,2,4,0,1,1,36,12,1,PHI,ORL,PHI,124,,,45,43,38,9
Joel Embiid,C,22023,203954,22300566,"JAN 16, 2024",PHI vs. DEN,W,39,13,22,0.591,3,6,0.5,12,15,0.8,1,6,7,10,0,1,3,4,41,0,1,PHI,PHI,DEN,126,,,58,48,51,17
Joel Embiid,C,22023,203954,22300555,"JAN 15, 2024",PHI vs. HOU,W,31,12,21,0.571,1,5,0.2,16,17,0.941,2,8,10,3,1,1,2,5,41,7,1,PHI,PHI,HOU,124,,,54,51,44,13
Joel Embiid,C,22023,203954,22300351,"DEC 18, 2023",PHI vs. CHI,L,37,15,28,0.536,2,6,0.333,8,9,0.889,1,13,14,6,0,2,4,5,40,-5,1,PHI,PHI,CHI,104,,,60,54,46,20
Joel Embiid,C,22023,203954,22301208,"DEC 06, 2023",PHI @ WAS,W,38,19,29,0.655,1,2,0.5,11,13,0.846,6,7,13,7,1,1,6,2,50,8,1,PHI,WAS,PHI,131,,,70,63,57,20
Joel Embiid,C,22023,203954,22300239,"NOV 25, 2023",PHI @ OKC,W,37,8,18,0.444,0,4,0.0,19,21,0.905,4,7,11,9,1,4,4,5,35,7,1,PHI,OKC,PHI,127,,,55,46,44,20
Joel Embiid,C,22023,203954,22300040,"NOV 21, 2023",PHI vs. CLE,L,41,9,21,0.429,1,3,0.333,13,16,0.813,3,10,13,5,2,5,6,6,32,3,1,PHI,PHI,CLE,119,,,50,45,37,18
Joel Embiid,C,22023,203954,22300180,"NOV 12, 2023",PHI vs. IND,W,33,12,26,0.462,1,4,0.25,12,14,0.857,8,5,13,7,1,1,3,2,37,-1,1,PHI,PHI,IND,137,,,57,50,44,20
Joel Embiid,C,22023,203954,22300008,"NOV 10, 2023",PHI @ DET,W,36,8,21,0.381,1,4,0.25,16,19,0.842,7,9,16,3,0,2,5,3,33,1,1,PHI,DET,PHI,114,,,52,49,36,19
Joel Embiid,C,22023,203954,22300159,"NOV 08, 2023",PHI vs. BOS,W,37,10,20,0.5,1,4,0.25,6,6,1.0,1,9,10,4,1,4,6,3,27,4,1,PHI,PHI,BOS,106,,,41,37,31,14
Joel Embiid,C,22023,203954,22300673,"JAN 30, 2024",PHI @ GSW,L,30,5,18,0.278,2,6,0.333,2,2,1.0,1,6,7,2,2,0,8,5,14,-21,1,PHI,GSW,PHI,107,,,23,21,16,9
Joel Embiid,C,22023,203954,22300029,"NOV 17, 2023",PHI @ ATL,W,37,10,19,0.526,1,3,0.333,11,11,1.0,2,5,7,8,2,0,4,3,32,16,1,PHI,ATL,PHI,126,,,47,39,40,15
Joel Embiid,C,22023,203954,22300194,"NOV 15, 2023",PHI vs. BOS,L,34,8,16,0.5,0,2,0.0,4,4,1.0,3,6,9,7,1,0,2,3,20,-25,1,PHI,PHI,BOS,107,,,36,29,27,16
Joel Embiid,C,22023,203954,22300019,"NOV 14, 2023",PHI vs. IND,L,38,11,22,0.5,0,4,0.0,17,17,1.0,3,9,12,6,3,0,5,4,39,-9,1,PHI,PHI,IND,126,,,57,51,45,18
Joel Embiid,C,22023,203954,22300092,"OCT 28, 2023",PHI @ TOR,W,35,14,21,0.667,1,3,0.333,5,6,0.833,0,9,9,8,1,2,1,0,34,-2,1,PHI,TOR,PHI,114,,,51,43,42,17
Joel Embiid,C,22023,203954,22300075,"OCT 26, 2023",PHI @ MIL,L,36,9,21,0.429,3,7,0.429,3,8,0.375,0,7,7,6,0,1,7,5,24,-1,1,PHI,MIL,PHI,117,,,37,31,30,13
Joel Embiid,C,22023,203954,22300382,"DEC 22, 2023",PHI vs. TOR,W,35,11,21,0.524,2,2,1.0,7,8,0.875,1,9,10,9,2,4,6,1,31,2,1,PHI,PHI,TOR,121,,,50,41,40,19
Luka Doncic,G,22023,1629029,22300398,"DEC 23, 2023",DAL vs. SAS,W,32,13,27,0.481,5,10,0.5,8,11,0.727,2,10,12,10,1,1,2,1,39,37,1,DAL,DAL,SAS,144,,,61,51,49,22
Luka Doncic,G,22023,1629029,22300356,"DEC 18, 2023",DAL @ DEN,L,36,13,24,0.542,6,12,0.5,6,10,0.6,3,8,11,8,0,0,3,1,38,-29,1,DAL,DEN,DAL,104,,,57,49,46,19
Luka Doncic,G,22023,1629029,22300341,"DEC 16, 2023",DAL @ POR,W,37,15,28,0.536,4,12,0.333,6,6,1.0,2,10,12,10,1,0,4,3,40,-4,1,DAL,POR,DAL,131,,,62,52,50,22
Luka Doncic,G,22023,1629029,22300321,"DEC 14, 2023",DAL vs. MIN,L,39,15,27,0.556,2,7,0.286,7,7,1.0,1,5,6,13,2,0,8,2,39,-12,1,DAL,DAL,MIN,101,,,58,45,52,19
Luka Doncic,G,22023,1629029,22300666,"JAN 29, 2024",DAL vs. ORL,W,43,12,23,0.522,3,8,0.375,18,21,0.857,0,9,9,15,2,0,4,4,45,3,1,DAL,DAL,ORL,131,,,69,54,60,24
Luka Doncic,G,22023,1629029,22300651,"JAN 27, 2024",DAL vs. SAC,L,46,9,26,0.346,1,9,0.111,9,12,0.75,2,8,10,17,2,1,3,3,28,2,1,DAL,DAL,SAC,115,,,55,38,45,27
Luka Doncic,G,22023,1629029,22300577,"JAN 17, 2024",DAL @ LAL,L,36,12,24,0.5,2,9,0.222,7,9,0.778,0,13,13,10,2,2,4,2,33,-15,1,DAL,LAL,DAL,105,,,56,46,43,23
Luka Doncic,G,22023,1629029,22300515,"JAN 09, 2024",DAL vs. MEM,L,36,9,21,0.429,2,8,0.25,11,15,0.733,0,6,6,6,3,0,3,1,31,-14,1,DAL,DAL,MEM,103,,,43,37,37,12
Luka Doncic,G,22023,1629029,22300501,"JAN 07, 2024",DAL vs. MIN,W,39,12,26,0.462,5,12,0.417,5,8,0.625,0,6,6,8,1,0,3,3,34,5,1,DAL,DAL,MIN,115,,,48,40,42,14
Luka Doncic,G,22023,1629029,22300472,"JAN 03, 2024",DAL vs. POR,W,31,13,21,0.619,4,7,0.571,11,14,0.786,0,6,6,5,1,0,4,1,41,23,1,DAL,DAL,POR,126,,,52,47,46,11
Luka Doncic,G,22023,1629029,22300420,"DEC 27, 2023",DAL vs. CLE,L,37,14,29,0.483,3,10,0.3,8,10,0.8,0,7,7,6,2,2,5,0,39,-9,1,DAL,DAL,CLE,110,,,52,46,45,13
Luka Doncic,G,22023,1629029,22300405,"DEC 25, 2023",DAL @ PHX,W,44,15,25,0.6,8,16,0.5,12,12,1.0,1,5,6,15,4,3,4,2,50,16,1,DAL,PHX,DAL,128,,,71,56,65,21
Luka Doncic,G,22023,1629029,22300306,"DEC 12, 2023",DAL vs. LAL,W,43,12,28,0.429,3,10,0.3,6,6,1.0,0,6,6,17,1,0,4,0,33,10,1,DAL,DAL,LAL,127,,,56,39,50,23
Luka Doncic,G,22023,1629029,22300299,"DEC 11, 2023",DAL @ MEM,W,44,9,21,0.429,5,10,0.5,12,13,0.923,0,8,8,6,2,2,3,3,35,3,1,DAL,MEM,DAL,120,,,49,43,41,14
Luka Doncic,G,22023,1629029,22301226,"DEC 08, 2023",DAL @ POR,W,41,11,28,0.393,3,14,0.214,7,8,0.875,0,6,6,10,1,1,5,1,32,13,1,DAL,POR,DAL,125,,,48,38,42,16
Luka Doncic,G,22023,1629029,22301213,"DEC 06, 2023",DAL vs. UTA,W,32,14,25,0.56,6,12,0.5,6,8,0.75,2,8,10,11,1,0,4,2,40,34,1,DAL,DAL,UTA,147,,,61,50,51,21
Luka Doncic,G,22023,1629029,22300287,"DEC 02, 2023",DAL vs. OKC,L,46,11,22,0.5,5,13,0.385,9,14,0.643,2,13,15,18,2,2,7,2,36,-7,1,DAL,DAL,OKC,120,,,69,51,54,33
Luka Doncic,G,22023,1629029,22300059,"NOV 28, 2023",DAL vs. HOU,W,38,15,29,0.517,3,10,0.3,8,9,0.889,0,9,9,9,2,0,0,3,41,12,1,DAL,DAL,HOU,121,,,59,50,50,18
Luka Doncic,G,22023,1629029,22300244,"NOV 25, 2023",DAL @ LAC,L,38,12,27,0.444,1,8,0.125,5,5,1.0,0,3,3,4,2,2,4,4,30,-14,1,DAL,LAC,DAL,88,,,37,33,34,7
Luka Doncic,G,22023,1629029,22300238,"NOV 22, 2023",DAL @ LAL,W,39,10,26,0.385,3,12,0.25,7,8,0.875,0,12,12,8,2,0,0,2,30,-11,1,DAL,LAL,DAL,104,,,50,42,38,20
Luka Doncic,G,22023,1629029,22300205,"NOV 18, 2023",DAL @ MIL,L,35,15,26,0.577,4,9,0.444,1,4,0.25,1,8,9,9,0,0,3,1,35,-17,1,DAL,MIL,DAL,125,,,53,44,44,18
Luka Doncic,G,22023,1629029,22300192,"NOV 15, 2023",DAL @ WAS,W,32,7,18,0.389,4,11,0.364,8,12,0.667,1,6,7,10,0,0,3,2,26,12,1,DAL,WAS,DAL,130,,,43,33,36,17
Luka Doncic,G,22023,1629029,22300022,"NOV 14, 2023",DAL @ NOP,L,26,5,16,0.313,3,5,0.6,3,5,0.6,1,1,2,2,0,0,8,0,16,-26,1,DAL,NOP,DAL,110,,,20,18,18,4
Luka Doncic,G,22023,1629029,22300183,"NOV 12, 2023",DAL @ NOP,W,28,11,18,0.611,4,9,0.444,4,5,0.8,0,4,4,9,1,0,2,0,30,14,1,DAL,NOP,DAL,136,,,43,34,39,13
Luka Doncic,G,22023,1629029,22300014,"NOV 10, 2023",DAL vs. LAC,W,32,17,21,0.81,6,9,0.667,4,4,1.0,0,6,6,6,1,0,1,1,44,32,1,DAL,DAL,LAC,144,,,56,50,50,12
Luka Doncic,G,22023,1629029,22300006,"NOV 03, 2023",DAL @ DEN,L,38,11,24,0.458,6,11,0.545,6,7,0.857,3,7,10,8,0,1,9,2,34,-4,1,DAL,DEN,DAL,114,,,52,44,42,18
Luka Doncic,G,22023,1629029,22300124,"NOV 01, 2023",DAL vs. CHI,W,40,5,16,0.313,1,8,0.125,7,9,0.778,0,7,7,10,2,1,6,2,18,11,1,DAL,DAL,CHI,114,,,35,25,28,17
Luka Doncic,G,22023,1629029,22300106,"OCT 30, 2023",DAL @ MEM,W,40,11,22,0.5,6,12,0.5,7,10,0.7,0,12,12,12,1,1,6,4,35,6,1,DAL,MEM,DAL,125,,,59,47,47,24
Luka Doncic,G,22023,1629029,22300084,"OCT 27, 2023",DAL vs. BKN,W,36,16,25,0.64,9,14,0.643,8,10,0.8,1,9,10,7,0,0,0,1,49,9,1,DAL,DAL,BKN,125,,,66,59,56,17
Luka Doncic,G,22023,1629029,22300073,"OCT 25, 2023",DAL @ SAS,W,34,13,25,0.52,3,11,0.273,4,7,0.571,1,12,13,10,2,0,4,1,33,4,1,DAL,SAS,DAL,126,,,56,46,43,23
Luka Doncic,G,22023,1629029,22300748,"FEB 10, 2024",DAL vs. OKC,W,31,9,14,0.643,4,8,0.5,10,13,0.769,0,8,8,9,0,0,3,3,32,18,1,DAL,DAL,OKC,146,,,49,40,41,17
Luka Doncic,G,22023,1629029,22300736,"FEB 08, 2024",DAL @ NYK,W,40,13,24,0.542,7,14,0.5,6,7,0.857,0,8,8,11,4,1,3,1,39,18,1,DAL,NYK,DAL,121,,,58,47,50,19
Luka Doncic,G,22023,1629029,22300720,"FEB 06, 2024",DAL @ BKN,W,43,13,27,0.481,4,11,0.364,5,10,0.5,1,17,18,9,2,1,1,3,35,6,1,DAL,BKN,DAL,119,,,62,53,44,27
Luka Doncic,G,22023,1629029,22300715,"FEB 05, 2024",DAL @ PHI,W,36,6,15,0.4,4,10,0.4,3,5,0.6,0,8,8,3,1,0,3,3,19,17,1,DAL,PHI,DAL,118,,,30,27,22,11
Luka Doncic,G,22023,1629029,22300702,"FEB 03, 2024",DAL vs. MIL,L,42,13,26,0.5,4,12,0.333,10,11,0.909,1,8,9,11,1,0,9,4,40,-12,1,DAL,DAL,MIL,117,,,60,49,51,20
Luka Doncic,G,22023,1629029,22300634,"JAN 26, 2024",DAL @ ATL,W,45,25,33,0.758,8,13,0.615,15,16,0.938,0,10,10,7,1,0,4,1,73,13,1,DAL,ATL,DAL,148,,,90,83,80,17
Luka Doncic,G,22023,1629029,22300625,"JAN 24, 2024",DAL vs. PHX,L,39,11,24,0.458,4,11,0.364,8,12,0.667,1,7,8,9,1,2,5,1,34,-22,1,DAL,DAL,PHX,107,,,51,42,43,17
Luka Doncic,G,22023,1629029,22300611,"JAN 22, 2024",DAL vs. BOS,L,40,12,30,0.4,2,8,0.25,7,11,0.636,5,13,18,13,2,0,3,5,33,-13,1,DAL,DAL,BOS,110,,,64,51,46,31
Luka Doncic,G,22023,1629029,22300457,"JAN 01, 2024",DAL @ UTA,L,34,6,20,0.3,3,13,0.231,4,6,0.667,0,6,6,14,1,0,4,1,19,-17,1,DAL,UTA,DAL,86,,,39,25,33,20
Luka Doncic,G,22023,1629029,22300444,"DEC 30, 2023",DAL @ GSW,W,38,14,29,0.483,5,13,0.385,6,7,0.857,0,8,8,10,1,1,4,3,39,9,1,DAL,GSW,DAL,132,,,57,47,49,18
Luka Doncic,G,22023,1629029,22300372,"DEC 20, 2023",DAL vs. LAC,L,44,9,25,0.36,2,11,0.182,8,14,0.571,1,8,9,10,1,0,5,1,28,-4,1,DAL,DAL,LAC,111,,,47,37,38,19
Luka Doncic,G,22023,1629029,22300212,"NOV 19, 2023",DAL vs. SAC,L,32,7,19,0.368,3,7,0.429,8,10,0.8,1,9,10,7,3,0,2,0,25,-14,1,DAL,DAL,SAC,113,,,42,35,32,17
Luka Doncic,G,22023,1629029,22300168,"NOV 08, 2023",DAL vs. TOR,L,38,11,26,0.423,2,10,0.2,7,10,0.7,0,7,7,8,4,1,4,3,31,-7,1,DAL,DAL,TOR,116,,,46,38,39,15
Luka Doncic,G,22023,1629029,22300147,"NOV 06, 2023",DAL @ ORL,W,35,9,17,0.529,5,10,0.5,6,6,1.0,0,3,3,6,2,0,6,2,29,7,1,DAL,ORL,DAL,117,,,38,32,35,9
Luka Doncic,G,22023,1629029,22300143,"NOV 05, 2023",DAL vs. CHA,W,36,8,19,0.421,1,9,0.111,6,7,0.857,1,11,12,9,0,1,4,3,23,3,1,DAL,DAL,CHA,124,,,44,35,32,21
Shai Gilgeous-Alexander,G,22023,1628983,22300682,"JAN 31, 2024",OKC vs. DEN,W,36,10,22,0.455,2,3,0.667,12,13,0.923,1,6,7,5,1,2,2,4,34,-1,1,OKC,OKC,DEN,105,31.5,Points,46,41,39,12
Shai Gilgeous-Alexander,G,22023,1628983,22300682,"JAN 31, 2024",OKC vs. DEN,W,36,10,22,0.455,2,3,0.667,12,13,0.923,1,6,7,5,1,2,2,4,34,-1,1,OKC,OKC,DEN,105,6.0,Rebounds,46,41,39,12
Shai Gilgeous-Alexander,G,22023,1628983,22300682,"JAN 31, 2024",OKC vs. DEN,W,36,10,22,0.455,2,3,0.667,12,13,0.923,1,6,7,5,1,2,2,4,34,-1,1,OKC,OKC,DEN,105,45.5,Pts+Rebs+Asts,46,41,39,12
Shai Gilgeous-Alexander,G,22023,1628983,22300682,"JAN 31, 2024",OKC vs. DEN,W,36,10,22,0.455,2,3,0.667,12,13,0.923,1,6,7,5,1,2,2,4,34,-1,1,OKC,OKC,DEN,105,7.0,Assists,46,41,39,12
Shai Gilgeous-Alexander,G,22023,1628983,22300682,"JAN 31, 2024",OKC vs. DEN,W,36,10,22,0.455,2,3,0.667,12,13,0.923,1,6,7,5,1,2,2,4,34,-1,1,OKC,OKC,DEN,105,53.0,Fantasy Score,46,41,39,12
Shai Gilgeous-Alexander,G,22023,1628983,22300682,"JAN 31, 2024",OKC vs. DEN,W,36,10,22,0.455,2,3,0.667,12,13,0.923,1,6,7,5,1,2,2,4,34,-1,1,OKC,OKC,DEN,105,8.0,Free Throws Made,46,41,39,12
Shai Gilgeous-Alexander,G,22023,1628983,22300682,"JAN 31, 2024",OKC vs. DEN,W,36,10,22,0.455,2,3,0.667,12,13,0.923,1,6,7,5,1,2,2,4,34,-1,1,OKC,OKC,DEN,105,20.5,FG Attempted,46,41,39,12
Shai Gilgeous-Alexander,G,22023,1628983,22300682,"JAN 31, 2024",OKC vs. DEN,W,36,10,22,0.455,2,3,0.667,12,13,0.923,1,6,7,5,1,2,2,4,34,-1,1,OKC,OKC,DEN,105,37.5,Pts+Rebs,46,41,39,12
Shai Gilgeous-Alexander,G,22023,1628983,22300682,"JAN 31, 2024",OKC vs. DEN,W,36,10,22,0.455,2,3,0.667,12,13,0.923,1,6,7,5,1,2,2,4,34,-1,1,OKC,OKC,DEN,105,0.5,Dunks,46,41,39,12
Shai Gilgeous-Alexander,G,22023,1628983,22300682,"JAN 31, 2024",OKC vs. DEN,W,36,10,22,0.455,2,3,0.667,12,13,0.923,1,6,7,5,1,2,2,4,34,-1,1,OKC,OKC,DEN,105,38.5,Pts+Asts,46,41,39,12
Shai Gilgeous-Alexander,G,22023,1628983,22300682,"JAN 31, 2024",OKC vs. DEN,W,36,10,22,0.455,2,3,0.667,12,13,0.923,1,6,7,5,1,2,2,4,34,-1,1,OKC,OKC,DEN,105,1.5,Steals,46,41,39,12
Shai Gilgeous-Alexander,G,22023,1628983,22300682,"JAN 31, 2024",OKC vs. DEN,W,36,10,22,0.455,2,3,0.667,12,13,0.923,1,6,7,5,1,2,2,4,34,-1,1,OKC,OKC,DEN,105,13.0,Rebs+Asts,46,41,39,12
Shai Gilgeous-Alexander,G,22023,1628983,22300622,"JAN 24, 2024",OKC @ SAS,W,29,9,15,0.6,2,2,1.0,12,12,1.0,2,4,6,10,2,1,4,3,32,20,1,OKC,SAS,OKC,140,31.5,Points,48,38,42,16
Shai Gilgeous-Alexander,G,22023,1628983,22300622,"JAN 24, 2024",OKC @ SAS,W,29,9,15,0.6,2,2,1.0,12,12,1.0,2,4,6,10,2,1,4,3,32,20,1,OKC,SAS,OKC,140,6.0,Rebounds,48,38,42,16
Shai Gilgeous-Alexander,G,22023,1628983,22300622,"JAN 24, 2024",OKC @ SAS,W,29,9,15,0.6,2,2,1.0,12,12,1.0,2,4,6,10,2,1,4,3,32,20,1,OKC,SAS,OKC,140,45.5,Pts+Rebs+Asts,48,38,42,16
Shai Gilgeous-Alexander,G,22023,1628983,22300622,"JAN 24, 2024",OKC @ SAS,W,29,9,15,0.6,2,2,1.0,12,12,1.0,2,4,6,10,2,1,4,3,32,20,1,OKC,SAS,OKC,140,7.0,Assists,48,38,42,16
Shai Gilgeous-Alexander,G,22023,1628983,22300622,"JAN 24, 2024",OKC @ SAS,W,29,9,15,0.6,2,2,1.0,12,12,1.0,2,4,6,10,2,1,4,3,32,20,1,OKC,SAS,OKC,140,53.0,Fantasy Score,48,38,42,16
Shai Gilgeous-Alexander,G,22023,1628983,22300622,"JAN 24, 2024",OKC @ SAS,W,29,9,15,0.6,2,2,1.0,12,12,1.0,2,4,6,10,2,1,4,3,32,20,1,OKC,SAS,OKC,140,8.0,Free Throws Made,48,38,42,16
Shai Gilgeous-Alexander,G,22023,1628983,22300622,"JAN 24, 2024",OKC @ SAS,W,29,9,15,0.6,2,2,1.0,12,12,1.0,2,4,6,10,2,1,4,3,32,20,1,OKC,SAS,OKC,140,20.5,FG Attempted,48,38,42,16
Shai Gilgeous-Alexander,G,22023,1628983,22300622,"JAN 24, 2024",OKC @ SAS,W,29,9,15,0.6,2,2,1.0,12,12,1.0,2,4,6,10,2,1,4,3,32,20,1,OKC,SAS,OKC,140,37.5,Pts+Rebs,48,38,42,16
Shai Gilgeous-Alexander,G,22023,1628983,22300622,"JAN 24, 2024",OKC @ SAS,W,29,9,15,0.6,2,2,1.0,12,12,1.0,2,4,6,10,2,1,4,3,32,20,1,OKC,SAS,OKC,140,0.5,Dunks,48,38,42,16
Shai Gilgeous-Alexander,G,22023,1628983,22300622,"JAN 24, 2024",OKC @ SAS,W,29,9,15,0.6,2,2,1.0,12,12,1.0,2,4,6,10,2,1,4,3,32,20,1,OKC,SAS,OKC,140,38.5,Pts+Asts,48,38,42,16
Shai Gilgeous-Alexander,G,22023,1628983,22300622,"JAN 24, 2024",OKC @ SAS,W,29,9,15,0.6,2,2,1.0,12,12,1.0,2,4,6,10,2,1,4,3,32,20,1,OKC,SAS,OKC,140,1.5,Steals,48,38,42,16
Shai Gilgeous-Alexander,G,22023,1628983,22300622,"JAN 24, 2024",OKC @ SAS,W,29,9,15,0.6,2,2,1.0,12,12,1.0,2,4,6,10,2,1,4,3,32,20,1,OKC,SAS,OKC,140,13.0,Rebs+Asts,48,38,42,16
Shai Gilgeous-Alexander,G,22023,1628983,22300617,"JAN 23, 2024",OKC vs. POR,W,35,10,24,0.417,0,3,0.0,13,17,0.765,2,4,6,10,5,0,3,3,33,17,1,OKC,OKC,POR,111,31.5,Points,49,39,43,16
Shai Gilgeous-Alexander,G,22023,1628983,22300617,"JAN 23, 2024",OKC vs. POR,W,35,10,24,0.417,0,3,0.0,13,17,0.765,2,4,6,10,5,0,3,3,33,17,1,OKC,OKC,POR,111,6.0,Rebounds,49,39,43,16
Shai Gilgeous-Alexander,G,22023,1628983,22300617,"JAN 23, 2024",OKC vs. POR,W,35,10,24,0.417,0,3,0.0,13,17,0.765,2,4,6,10,5,0,3,3,33,17,1,OKC,OKC,POR,111,45.5,Pts+Rebs+Asts,49,39,43,16
Shai Gilgeous-Alexander,G,22023,1628983,22300617,"JAN 23, 2024",OKC vs. POR,W,35,10,24,0.417,0,3,0.0,13,17,0.765,2,4,6,10,5,0,3,3,33,17,1,OKC,OKC,POR,111,7.0,Assists,49,39,43,16
Shai Gilgeous-Alexander,G,22023,1628983,22300617,"JAN 23, 2024",OKC vs. POR,W,35,10,24,0.417,0,3,0.0,13,17,0.765,2,4,6,10,5,0,3,3,33,17,1,OKC,OKC,POR,111,53.0,Fantasy Score,49,39,43,16
Shai Gilgeous-Alexander,G,22023,1628983,22300617,"JAN 23, 2024",OKC vs. POR,W,35,10,24,0.417,0,3,0.0,13,17,0.765,2,4,6,10,5,0,3,3,33,17,1,OKC,OKC,POR,111,8.0,Free Throws Made,49,39,43,16
Shai Gilgeous-Alexander,G,22023,1628983,22300617,"JAN 23, 2024",OKC vs. POR,W,35,10,24,0.417,0,3,0.0,13,17,0.765,2,4,6,10,5,0,3,3,33,17,1,OKC,OKC,POR,111,20.5,FG Attempted,49,39,43,16
Shai Gilgeous-Alexander,G,22023,1628983,22300617,"JAN 23, 2024",OKC vs. POR,W,35,10,24,0.417,0,3,0.0,13,17,0.765,2,4,6,10,5,0,3,3,33,17,1,OKC,OKC,POR,111,37.5,Pts+Rebs,49,39,43,16
Shai Gilgeous-Alexander,G,22023,1628983,22300617,"JAN 23, 2024",OKC vs. POR,W,35,10,24,0.417,0,3,0.0,13,17,0.765,2,4,6,10,5,0,3,3,33,17,1,OKC,OKC,POR,111,0.5,Dunks,49,39,43,16
Shai Gilgeous-Alexander,G,22023,1628983,22300617,"JAN 23, 2024",OKC vs. POR,W,35,10,24,0.417,0,3,0.0,13,17,0.765,2,4,6,10,5,0,3,3,33,17,1,OKC,OKC,POR,111,38.5,Pts+Asts,49,39,43,16
Shai Gilgeous-Alexander,G,22023,1628983,22300617,"JAN 23, 2024",OKC vs. POR,W,35,10,24,0.417,0,3,0.0,13,17,0.765,2,4,6,10,5,0,3,3,33,17,1,OKC,OKC,POR,111,1.5,Steals,49,39,43,16
Shai Gilgeous-Alexander,G,22023,1628983,22300617,"JAN 23, 2024",OKC vs. POR,W,35,10,24,0.417,0,3,0.0,13,17,0.765,2,4,6,10,5,0,3,3,33,17,1,OKC,OKC,POR,111,13.0,Rebs+Asts,49,39,43,16
Shai Gilgeous-Alexander,G,22023,1628983,22300481,"JAN 05, 2024",OKC @ BKN,L,36,11,19,0.579,2,5,0.4,10,15,0.667,1,8,9,6,0,0,2,5,34,-10,1,OKC,BKN,OKC,115,31.5,Points,49,43,40,15
Shai Gilgeous-Alexander,G,22023,1628983,22300481,"JAN 05, 2024",OKC @ BKN,L,36,11,19,0.579,2,5,0.4,10,15,0.667,1,8,9,6,0,0,2,5,34,-10,1,OKC,BKN,OKC,115,6.0,Rebounds,49,43,40,15
Shai Gilgeous-Alexander,G,22023,1628983,22300481,"JAN 05, 2024",OKC @ BKN,L,36,11,19,0.579,2,5,0.4,10,15,0.667,1,8,9,6,0,0,2,5,34,-10,1,OKC,BKN,OKC,115,45.5,Pts+Rebs+Asts,49,43,40,15
Shai Gilgeous-Alexander,G,22023,1628983,22300481,"JAN 05, 2024",OKC @ BKN,L,36,11,19,0.579,2,5,0.4,10,15,0.667,1,8,9,6,0,0,2,5,34,-10,1,OKC,BKN,OKC,115,7.0,Assists,49,43,40,15
Shai Gilgeous-Alexander,G,22023,1628983,22300481,"JAN 05, 2024",OKC @ BKN,L,36,11,19,0.579,2,5,0.4,10,15,0.667,1,8,9,6,0,0,2,5,34,-10,1,OKC,BKN,OKC,115,53.0,Fantasy Score,49,43,40,15
Shai Gilgeous-Alexander,G,22023,1628983,22300481,"JAN 05, 2024",OKC @ BKN,L,36,11,19,0.579,2,5,0.4,10,15,0.667,1,8,9,6,0,0,2,5,34,-10,1,OKC,BKN,OKC,115,8.0,Free Throws Made,49,43,40,15
Shai Gilgeous-Alexander,G,22023,1628983,22300481,"JAN 05, 2024",OKC @ BKN,L,36,11,19,0.579,2,5,0.4,10,15,0.667,1,8,9,6,0,0,2,5,34,-10,1,OKC,BKN,OKC,115,20.5,FG Attempted,49,43,40,15
Shai Gilgeous-Alexander,G,22023,1628983,22300481,"JAN 05, 2024",OKC @ BKN,L,36,11,19,0.579,2,5,0.4,10,15,0.667,1,8,9,6,0,0,2,5,34,-10,1,OKC,BKN,OKC,115,37.5,Pts+Rebs,49,43,40,15
Shai Gilgeous-Alexander,G,22023,1628983,22300481,"JAN 05, 2024",OKC @ BKN,L,36,11,19,0.579,2,5,0.4,10,15,0.667,1,8,9,6,0,0,2,5,34,-10,1,OKC,BKN,OKC,115,0.5,Dunks,49,43,40,15
Shai Gilgeous-Alexander,G,22023,1628983,22300481,"JAN 05, 2024",OKC @ BKN,L,36,11,19,0.579,2,5,0.4,10,15,0.667,1,8,9,6,0,0,2,5,34,-10,1,OKC,BKN,OKC,115,38.5,Pts+Asts,49,43,40,15
Shai Gilgeous-Alexander,G,22023,1628983,22300481,"JAN 05, 2024",OKC @ BKN,L,36,11,19,0.579,2,5,0.4,10,15,0.667,1,8,9,6,0,0,2,5,34,-10,1,OKC,BKN,OKC,115,1.5,Steals,49,43,40,15
Shai Gilgeous-Alexander,G,22023,1628983,22300481,"JAN 05, 2024",OKC @ BKN,L,36,11,19,0.579,2,5,0.4,10,15,0.667,1,8,9,6,0,0,2,5,34,-10,1,OKC,BKN,OKC,115,13.0,Rebs+Asts,49,43,40,15
Shai Gilgeous-Alexander,G,22023,1628983,22300419,"DEC 27, 2023",OKC vs. NYK,W,36,13,23,0.565,2,5,0.4,8,9,0.889,1,6,7,8,2,2,1,0,36,12,1,OKC,OKC,NYK,129,31.5,Points,51,43,44,15
Shai Gilgeous-Alexander,G,22023,1628983,22300419,"DEC 27, 2023",OKC vs. NYK,W,36,13,23,0.565,2,5,0.4,8,9,0.889,1,6,7,8,2,2,1,0,36,12,1,OKC,OKC,NYK,129,6.0,Rebounds,51,43,44,15
Shai Gilgeous-Alexander,G,22023,1628983,22300419,"DEC 27, 2023",OKC vs. NYK,W,36,13,23,0.565,2,5,0.4,8,9,0.889,1,6,7,8,2,2,1,0,36,12,1,OKC,OKC,NYK,129,45.5,Pts+Rebs+Asts,51,43,44,15
Shai Gilgeous-Alexander,G,22023,1628983,22300419,"DEC 27, 2023",OKC vs. NYK,W,36,13,23,0.565,2,5,0.4,8,9,0.889,1,6,7,8,2,2,1,0,36,12,1,OKC,OKC,NYK,129,7.0,Assists,51,43,44,15
Shai Gilgeous-Alexander,G,22023,1628983,22300419,"DEC 27, 2023",OKC vs. NYK,W,36,13,23,0.565,2,5,0.4,8,9,0.889,1,6,7,8,2,2,1,0,36,12,1,OKC,OKC,NYK,129,53.0,Fantasy Score,51,43,44,15
Shai Gilgeous-Alexander,G,22023,1628983,22300419,"DEC 27, 2023",OKC vs. NYK,W,36,13,23,0.565,2,5,0.4,8,9,0.889,1,6,7,8,2,2,1,0,36,12,1,OKC,OKC,NYK,129,8.0,Free Throws Made,51,43,44,15
Shai Gilgeous-Alexander,G,22023,1628983,22300419,"DEC 27, 2023",OKC vs. NYK,W,36,13,23,0.565,2,5,0.4,8,9,0.889,1,6,7,8,2,2,1,0,36,12,1,OKC,OKC,NYK,129,20.5,FG Attempted,51,43,44,15
Shai Gilgeous-Alexander,G,22023,1628983,22300419,"DEC 27, 2023",OKC vs. NYK,W,36,13,23,0.565,2,5,0.4,8,9,0.889,1,6,7,8,2,2,1,0,36,12,1,OKC,OKC,NYK,129,37.5,Pts+Rebs,51,43,44,15
Shai Gilgeous-Alexander,G,22023,1628983,22300419,"DEC 27, 2023",OKC vs. NYK,W,36,13,23,0.565,2,5,0.4,8,9,0.889,1,6,7,8,2,2,1,0,36,12,1,OKC,OKC,NYK,129,0.5,Dunks,51,43,44,15
Shai Gilgeous-Alexander,G,22023,1628983,22300419,"DEC 27, 2023",OKC vs. NYK,W,36,13,23,0.565,2,5,0.4,8,9,0.889,1,6,7,8,2,2,1,0,36,12,1,OKC,OKC,NYK,129,38.5,Pts+Asts,51,43,44,15
Shai Gilgeous-Alexander,G,22023,1628983,22300419,"DEC 27, 2023",OKC vs. NYK,W,36,13,23,0.565,2,5,0.4,8,9,0.889,1,6,7,8,2,2,1,0,36,12,1,OKC,OKC,NYK,129,1.5,Steals,51,43,44,15
Shai Gilgeous-Alexander,G,22023,1628983,22300419,"DEC 27, 2023",OKC vs. NYK,W,36,13,23,0.565,2,5,0.4,8,9,0.889,1,6,7,8,2,2,1,0,36,12,1,OKC,OKC,NYK,129,13.0,Rebs+Asts,51,43,44,15
Shai Gilgeous-Alexander,G,22023,1628983,22300397,"DEC 23, 2023",OKC vs. LAL,L,38,12,21,0.571,1,5,0.2,9,10,0.9,1,4,5,7,3,0,3,2,34,-6,1,OKC,OKC,LAL,120,31.5,Points,46,39,41,12
Shai Gilgeous-Alexander,G,22023,1628983,22300397,"DEC 23, 2023",OKC vs. LAL,L,38,12,21,0.571,1,5,0.2,9,10,0.9,1,4,5,7,3,0,3,2,34,-6,1,OKC,OKC,LAL,120,6.0,Rebounds,46,39,41,12
Shai Gilgeous-Alexander,G,22023,1628983,22300397,"DEC 23, 2023",OKC vs. LAL,L,38,12,21,0.571,1,5,0.2,9,10,0.9,1,4,5,7,3,0,3,2,34,-6,1,OKC,OKC,LAL,120,45.5,Pts+Rebs+Asts,46,39,41,12
Shai Gilgeous-Alexander,G,22023,1628983,22300397,"DEC 23, 2023",OKC vs. LAL,L,38,12,21,0.571,1,5,0.2,9,10,0.9,1,4,5,7,3,0,3,2,34,-6,1,OKC,OKC,LAL,120,7.0,Assists,46,39,41,12
Shai Gilgeous-Alexander,G,22023,1628983,22300397,"DEC 23, 2023",OKC vs. LAL,L,38,12,21,0.571,1,5,0.2,9,10,0.9,1,4,5,7,3,0,3,2,34,-6,1,OKC,OKC,LAL,120,53.0,Fantasy Score,46,39,41,12
Shai Gilgeous-Alexander,G,22023,1628983,22300397,"DEC 23, 2023",OKC vs. LAL,L,38,12,21,0.571,1,5,0.2,9,10,0.9,1,4,5,7,3,0,3,2,34,-6,1,OKC,OKC,LAL,120,8.0,Free Throws Made,46,39,41,12
Shai Gilgeous-Alexander,G,22023,1628983,22300397,"DEC 23, 2023",OKC vs. LAL,L,38,12,21,0.571,1,5,0.2,9,10,0.9,1,4,5,7,3,0,3,2,34,-6,1,OKC,OKC,LAL,120,20.5,FG Attempted,46,39,41,12
Shai Gilgeous-Alexander,G,22023,1628983,22300397,"DEC 23, 2023",OKC vs. LAL,L,38,12,21,0.571,1,5,0.2,9,10,0.9,1,4,5,7,3,0,3,2,34,-6,1,OKC,OKC,LAL,120,37.5,Pts+Rebs,46,39,41,12
Shai Gilgeous-Alexander,G,22023,1628983,22300397,"DEC 23, 2023",OKC vs. LAL,L,38,12,21,0.571,1,5,0.2,9,10,0.9,1,4,5,7,3,0,3,2,34,-6,1,OKC,OKC,LAL,120,0.5,Dunks,46,39,41,12
Shai Gilgeous-Alexander,G,22023,1628983,22300397,"DEC 23, 2023",OKC vs. LAL,L,38,12,21,0.571,1,5,0.2,9,10,0.9,1,4,5,7,3,0,3,2,34,-6,1,OKC,OKC,LAL,120,38.5,Pts+Asts,46,39,41,12
Shai Gilgeous-Alexander,G,22023,1628983,22300397,"DEC 23, 2023",OKC vs. LAL,L,38,12,21,0.571,1,5,0.2,9,10,0.9,1,4,5,7,3,0,3,2,34,-6,1,OKC,OKC,LAL,120,1.5,Steals,46,39,41,12
Shai Gilgeous-Alexander,G,22023,1628983,22300397,"DEC 23, 2023",OKC vs. LAL,L,38,12,21,0.571,1,5,0.2,9,10,0.9,1,4,5,7,3,0,3,2,34,-6,1,OKC,OKC,LAL,120,13.0,Rebs+Asts,46,39,41,12
Shai Gilgeous-Alexander,G,22023,1628983,22300324,"DEC 14, 2023",OKC @ SAC,L,38,13,27,0.481,1,5,0.2,16,18,0.889,2,4,6,9,2,0,3,2,43,3,1,OKC,SAC,OKC,123,31.5,Points,58,49,52,15
Shai Gilgeous-Alexander,G,22023,1628983,22300324,"DEC 14, 2023",OKC @ SAC,L,38,13,27,0.481,1,5,0.2,16,18,0.889,2,4,6,9,2,0,3,2,43,3,1,OKC,SAC,OKC,123,6.0,Rebounds,58,49,52,15
Shai Gilgeous-Alexander,G,22023,1628983,22300324,"DEC 14, 2023",OKC @ SAC,L,38,13,27,0.481,1,5,0.2,16,18,0.889,2,4,6,9,2,0,3,2,43,3,1,OKC,SAC,OKC,123,45.5,Pts+Rebs+Asts,58,49,52,15
Shai Gilgeous-Alexander,G,22023,1628983,22300324,"DEC 14, 2023",OKC @ SAC,L,38,13,27,0.481,1,5,0.2,16,18,0.889,2,4,6,9,2,0,3,2,43,3,1,OKC,SAC,OKC,123,7.0,Assists,58,49,52,15
Shai Gilgeous-Alexander,G,22023,1628983,22300324,"DEC 14, 2023",OKC @ SAC,L,38,13,27,0.481,1,5,0.2,16,18,0.889,2,4,6,9,2,0,3,2,43,3,1,OKC,SAC,OKC,123,53.0,Fantasy Score,58,49,52,15
Shai Gilgeous-Alexander,G,22023,1628983,22300324,"DEC 14, 2023",OKC @ SAC,L,38,13,27,0.481,1,5,0.2,16,18,0.889,2,4,6,9,2,0,3,2,43,3,1,OKC,SAC,OKC,123,8.0,Free Throws Made,58,49,52,15
Shai Gilgeous-Alexander,G,22023,1628983,22300324,"DEC 14, 2023",OKC @ SAC,L,38,13,27,0.481,1,5,0.2,16,18,0.889,2,4,6,9,2,0,3,2,43,3,1,OKC,SAC,OKC,123,20.5,FG Attempted,58,49,52,15
Shai Gilgeous-Alexander,G,22023,1628983,22300324,"DEC 14, 2023",OKC @ SAC,L,38,13,27,0.481,1,5,0.2,16,18,0.889,2,4,6,9,2,0,3,2,43,3,1,OKC,SAC,OKC,123,37.5,Pts+Rebs,58,49,52,15
Shai Gilgeous-Alexander,G,22023,1628983,22300324,"DEC 14, 2023",OKC @ SAC,L,38,13,27,0.481,1,5,0.2,16,18,0.889,2,4,6,9,2,0,3,2,43,3,1,OKC,SAC,OKC,123,0.5,Dunks,58,49,52,15
Shai Gilgeous-Alexander,G,22023,1628983,22300324,"DEC 14, 2023",OKC @ SAC,L,38,13,27,0.481,1,5,0.2,16,18,0.889,2,4,6,9,2,0,3,2,43,3,1,OKC,SAC,OKC,123,38.5,Pts+Asts,58,49,52,15
Shai Gilgeous-Alexander,G,22023,1628983,22300324,"DEC 14, 2023",OKC @ SAC,L,38,13,27,0.481,1,5,0.2,16,18,0.889,2,4,6,9,2,0,3,2,43,3,1,OKC,SAC,OKC,123,1.5,Steals,58,49,52,15
Shai Gilgeous-Alexander,G,22023,1628983,22300324,"DEC 14, 2023",OKC @ SAC,L,38,13,27,0.481,1,5,0.2,16,18,0.889,2,4,6,9,2,0,3,2,43,3,1,OKC,SAC,OKC,123,13.0,Rebs+Asts,58,49,52,15
Shai Gilgeous-Alexander,G,22023,1628983,22300302,"DEC 11, 2023",OKC vs. UTA,W,28,12,17,0.706,0,1,0.0,6,6,1.0,1,3,4,7,3,0,1,1,30,35,1,OKC,OKC,UTA,134,31.5,Points,41,34,37,11
Shai Gilgeous-Alexander,G,22023,1628983,22300302,"DEC 11, 2023",OKC vs. UTA,W,28,12,17,0.706,0,1,0.0,6,6,1.0,1,3,4,7,3,0,1,1,30,35,1,OKC,OKC,UTA,134,6.0,Rebounds,41,34,37,11
Shai Gilgeous-Alexander,G,22023,1628983,22300302,"DEC 11, 2023",OKC vs. UTA,W,28,12,17,0.706,0,1,0.0,6,6,1.0,1,3,4,7,3,0,1,1,30,35,1,OKC,OKC,UTA,134,45.5,Pts+Rebs+Asts,41,34,37,11
Shai Gilgeous-Alexander,G,22023,1628983,22300302,"DEC 11, 2023",OKC vs. UTA,W,28,12,17,0.706,0,1,0.0,6,6,1.0,1,3,4,7,3,0,1,1,30,35,1,OKC,OKC,UTA,134,7.0,Assists,41,34,37,11
Shai Gilgeous-Alexander,G,22023,1628983,22300302,"DEC 11, 2023",OKC vs. UTA,W,28,12,17,0.706,0,1,0.0,6,6,1.0,1,3,4,7,3,0,1,1,30,35,1,OKC,OKC,UTA,134,53.0,Fantasy Score,41,34,37,11
Shai Gilgeous-Alexander,G,22023,1628983,22300302,"DEC 11, 2023",OKC vs. UTA,W,28,12,17,0.706,0,1,0.0,6,6,1.0,1,3,4,7,3,0,1,1,30,35,1,OKC,OKC,UTA,134,8.0,Free Throws Made,41,34,37,11
Shai Gilgeous-Alexander,G,22023,1628983,22300302,"DEC 11, 2023",OKC vs. UTA,W,28,12,17,0.706,0,1,0.0,6,6,1.0,1,3,4,7,3,0,1,1,30,35,1,OKC,OKC,UTA,134,20.5,FG Attempted,41,34,37,11
Shai Gilgeous-Alexander,G,22023,1628983,22300302,"DEC 11, 2023",OKC vs. UTA,W,28,12,17,0.706,0,1,0.0,6,6,1.0,1,3,4,7,3,0,1,1,30,35,1,OKC,OKC,UTA,134,37.5,Pts+Rebs,41,34,37,11
Shai Gilgeous-Alexander,G,22023,1628983,22300302,"DEC 11, 2023",OKC vs. UTA,W,28,12,17,0.706,0,1,0.0,6,6,1.0,1,3,4,7,3,0,1,1,30,35,1,OKC,OKC,UTA,134,0.5,Dunks,41,34,37,11
Shai Gilgeous-Alexander,G,22023,1628983,22300302,"DEC 11, 2023",OKC vs. UTA,W,28,12,17,0.706,0,1,0.0,6,6,1.0,1,3,4,7,3,0,1,1,30,35,1,OKC,OKC,UTA,134,38.5,Pts+Asts,41,34,37,11
Shai Gilgeous-Alexander,G,22023,1628983,22300302,"DEC 11, 2023",OKC vs. UTA,W,28,12,17,0.706,0,1,0.0,6,6,1.0,1,3,4,7,3,0,1,1,30,35,1,OKC,OKC,UTA,134,1.5,Steals,41,34,37,11
Shai Gilgeous-Alexander,G,22023,1628983,22300302,"DEC 11, 2023",OKC vs. UTA,W,28,12,17,0.706,0,1,0.0,6,6,1.0,1,3,4,7,3,0,1,1,30,35,1,OKC,OKC,UTA,134,13.0,Rebs+Asts,41,34,37,11
Shai Gilgeous-Alexander,G,22023,1628983,22301222,"DEC 08, 2023",OKC vs. GSW,W,42,15,30,0.5,0,3,0.0,8,11,0.727,3,2,5,5,5,1,0,4,38,11,1,OKC,OKC,GSW,138,31.5,Points,48,43,43,10
Shai Gilgeous-Alexander,G,22023,1628983,22301222,"DEC 08, 2023",OKC vs. GSW,W,42,15,30,0.5,0,3,0.0,8,11,0.727,3,2,5,5,5,1,0,4,38,11,1,OKC,OKC,GSW,138,6.0,Rebounds,48,43,43,10
Shai Gilgeous-Alexander,G,22023,1628983,22301222,"DEC 08, 2023",OKC vs. GSW,W,42,15,30,0.5,0,3,0.0,8,11,0.727,3,2,5,5,5,1,0,4,38,11,1,OKC,OKC,GSW,138,45.5,Pts+Rebs+Asts,48,43,43,10
Shai Gilgeous-Alexander,G,22023,1628983,22301222,"DEC 08, 2023",OKC vs. GSW,W,42,15,30,0.5,0,3,0.0,8,11,0.727,3,2,5,5,5,1,0,4,38,11,1,OKC,OKC,GSW,138,7.0,Assists,48,43,43,10
Shai Gilgeous-Alexander,G,22023,1628983,22301222,"DEC 08, 2023",OKC vs. GSW,W,42,15,30,0.5,0,3,0.0,8,11,0.727,3,2,5,5,5,1,0,4,38,11,1,OKC,OKC,GSW,138,53.0,Fantasy Score,48,43,43,10
Shai Gilgeous-Alexander,G,22023,1628983,22301222,"DEC 08, 2023",OKC vs. GSW,W,42,15,30,0.5,0,3,0.0,8,11,0.727,3,2,5,5,5,1,0,4,38,11,1,OKC,OKC,GSW,138,8.0,Free Throws Made,48,43,43,10
Shai Gilgeous-Alexander,G,22023,1628983,22301222,"DEC 08, 2023",OKC vs. GSW,W,42,15,30,0.5,0,3,0.0,8,11,0.727,3,2,5,5,5,1,0,4,38,11,1,OKC,OKC,GSW,138,20.5,FG Attempted,48,43,43,10
Shai Gilgeous-Alexander,G,22023,1628983,22301222,"DEC 08, 2023",OKC vs. GSW,W,42,15,30,0.5,0,3,0.0,8,11,0.727,3,2,5,5,5,1,0,4,38,11,1,OKC,OKC,GSW,138,37.5,Pts+Rebs,48,43,43,10
Shai Gilgeous-Alexander,G,22023,1628983,22301222,"DEC 08, 2023",OKC vs. GSW,W,42,15,30,0.5,0,3,0.0,8,11,0.727,3,2,5,5,5,1,0,4,38,11,1,OKC,OKC,GSW,138,0.5,Dunks,48,43,43,10
Shai Gilgeous-Alexander,G,22023,1628983,22301222,"DEC 08, 2023",OKC vs. GSW,W,42,15,30,0.5,0,3,0.0,8,11,0.727,3,2,5,5,5,1,0,4,38,11,1,OKC,OKC,GSW,138,38.5,Pts+Asts,48,43,43,10
Shai Gilgeous-Alexander,G,22023,1628983,22301222,"DEC 08, 2023",OKC vs. GSW,W,42,15,30,0.5,0,3,0.0,8,11,0.727,3,2,5,5,5,1,0,4,38,11,1,OKC,OKC,GSW,138,1.5,Steals,48,43,43,10
Shai Gilgeous-Alexander,G,22023,1628983,22301222,"DEC 08, 2023",OKC vs. GSW,W,42,15,30,0.5,0,3,0.0,8,11,0.727,3,2,5,5,5,1,0,4,38,11,1,OKC,OKC,GSW,138,13.0,Rebs+Asts,48,43,43,10
Shai Gilgeous-Alexander,G,22023,1628983,22300287,"DEC 02, 2023",OKC @ DAL,W,39,6,13,0.462,2,3,0.667,3,4,0.75,1,2,3,9,5,1,2,4,17,8,1,OKC,DAL,OKC,126,31.5,Points,29,20,26,12
Shai Gilgeous-Alexander,G,22023,1628983,22300287,"DEC 02, 2023",OKC @ DAL,W,39,6,13,0.462,2,3,0.667,3,4,0.75,1,2,3,9,5,1,2,4,17,8,1,OKC,DAL,OKC,126,6.0,Rebounds,29,20,26,12
Shai Gilgeous-Alexander,G,22023,1628983,22300287,"DEC 02, 2023",OKC @ DAL,W,39,6,13,0.462,2,3,0.667,3,4,0.75,1,2,3,9,5,1,2,4,17,8,1,OKC,DAL,OKC,126,45.5,Pts+Rebs+Asts,29,20,26,12
Shai Gilgeous-Alexander,G,22023,1628983,22300287,"DEC 02, 2023",OKC @ DAL,W,39,6,13,0.462,2,3,0.667,3,4,0.75,1,2,3,9,5,1,2,4,17,8,1,OKC,DAL,OKC,126,7.0,Assists,29,20,26,12
Shai Gilgeous-Alexander,G,22023,1628983,22300287,"DEC 02, 2023",OKC @ DAL,W,39,6,13,0.462,2,3,0.667,3,4,0.75,1,2,3,9,5,1,2,4,17,8,1,OKC,DAL,OKC,126,53.0,Fantasy Score,29,20,26,12
Shai Gilgeous-Alexander,G,22023,1628983,22300287,"DEC 02, 2023",OKC @ DAL,W,39,6,13,0.462,2,3,0.667,3,4,0.75,1,2,3,9,5,1,2,4,17,8,1,OKC,DAL,OKC,126,8.0,Free Throws Made,29,20,26,12
Shai Gilgeous-Alexander,G,22023,1628983,22300287,"DEC 02, 2023",OKC @ DAL,W,39,6,13,0.462,2,3,0.667,3,4,0.75,1,2,3,9,5,1,2,4,17,8,1,OKC,DAL,OKC,126,20.5,FG Attempted,29,20,26,12
Shai Gilgeous-Alexander,G,22023,1628983,22300287,"DEC 02, 2023",OKC @ DAL,W,39,6,13,0.462,2,3,0.667,3,4,0.75,1,2,3,9,5,1,2,4,17,8,1,OKC,DAL,OKC,126,37.5,Pts+Rebs,29,20,26,12
Shai Gilgeous-Alexander,G,22023,1628983,22300287,"DEC 02, 2023",OKC @ DAL,W,39,6,13,0.462,2,3,0.667,3,4,0.75,1,2,3,9,5,1,2,4,17,8,1,OKC,DAL,OKC,126,0.5,Dunks,29,20,26,12
Shai Gilgeous-Alexander,G,22023,1628983,22300287,"DEC 02, 2023",OKC @ DAL,W,39,6,13,0.462,2,3,0.667,3,4,0.75,1,2,3,9,5,1,2,4,17,8,1,OKC,DAL,OKC,126,38.5,Pts+Asts,29,20,26,12
Shai Gilgeous-Alexander,G,22023,1628983,22300287,"DEC 02, 2023",OKC @ DAL,W,39,6,13,0.462,2,3,0.667,3,4,0.75,1,2,3,9,5,1,2,4,17,8,1,OKC,DAL,OKC,126,1.5,Steals,29,20,26,12
Shai Gilgeous-Alexander,G,22023,1628983,22300287,"DEC 02, 2023",OKC @ DAL,W,39,6,13,0.462,2,3,0.667,3,4,0.75,1,2,3,9,5,1,2,4,17,8,1,OKC,DAL,OKC,126,13.0,Rebs+Asts,29,20,26,12
Shai Gilgeous-Alexander,G,22023,1628983,22300239,"NOV 25, 2023",OKC vs. PHI,L,36,10,21,0.476,1,2,0.5,10,10,1.0,3,3,6,5,2,0,1,3,31,1,1,OKC,OKC,PHI,123,31.5,Points,42,37,36,11
Shai Gilgeous-Alexander,G,22023,1628983,22300239,"NOV 25, 2023",OKC vs. PHI,L,36,10,21,0.476,1,2,0.5,10,10,1.0,3,3,6,5,2,0,1,3,31,1,1,OKC,OKC,PHI,123,6.0,Rebounds,42,37,36,11
Shai Gilgeous-Alexander,G,22023,1628983,22300239,"NOV 25, 2023",OKC vs. PHI,L,36,10,21,0.476,1,2,0.5,10,10,1.0,3,3,6,5,2,0,1,3,31,1,1,OKC,OKC,PHI,123,45.5,Pts+Rebs+Asts,42,37,36,11
Shai Gilgeous-Alexander,G,22023,1628983,22300239,"NOV 25, 2023",OKC vs. PHI,L,36,10,21,0.476,1,2,0.5,10,10,1.0,3,3,6,5,2,0,1,3,31,1,1,OKC,OKC,PHI,123,7.0,Assists,42,37,36,11
Shai Gilgeous-Alexander,G,22023,1628983,22300239,"NOV 25, 2023",OKC vs. PHI,L,36,10,21,0.476,1,2,0.5,10,10,1.0,3,3,6,5,2,0,1,3,31,1,1,OKC,OKC,PHI,123,53.0,Fantasy Score,42,37,36,11
Shai Gilgeous-Alexander,G,22023,1628983,22300239,"NOV 25, 2023",OKC vs. PHI,L,36,10,21,0.476,1,2,0.5,10,10,1.0,3,3,6,5,2,0,1,3,31,1,1,OKC,OKC,PHI,123,8.0,Free Throws Made,42,37,36,11
Shai Gilgeous-Alexander,G,22023,1628983,22300239,"NOV 25, 2023",OKC vs. PHI,L,36,10,21,0.476,1,2,0.5,10,10,1.0,3,3,6,5,2,0,1,3,31,1,1,OKC,OKC,PHI,123,20.5,FG Attempted,42,37,36,11
Shai Gilgeous-Alexander,G,22023,1628983,22300239,"NOV 25, 2023",OKC vs. PHI,L,36,10,21,0.476,1,2,0.5,10,10,1.0,3,3,6,5,2,0,1,3,31,1,1,OKC,OKC,PHI,123,37.5,Pts+Rebs,42,37,36,11
Shai Gilgeous-Alexander,G,22023,1628983,22300239,"NOV 25, 2023",OKC vs. PHI,L,36,10,21,0.476,1,2,0.5,10,10,1.0,3,3,6,5,2,0,1,3,31,1,1,OKC,OKC,PHI,123,0.5,Dunks,42,37,36,11
Shai Gilgeous-Alexander,G,22023,1628983,22300239,"NOV 25, 2023",OKC vs. PHI,L,36,10,21,0.476,1,2,0.5,10,10,1.0,3,3,6,5,2,0,1,3,31,1,1,OKC,OKC,PHI,123,38.5,Pts+Asts,42,37,36,11
Shai Gilgeous-Alexander,G,22023,1628983,22300239,"NOV 25, 2023",OKC vs. PHI,L,36,10,21,0.476,1,2,0.5,10,10,1.0,3,3,6,5,2,0,1,3,31,1,1,OKC,OKC,PHI,123,1.5,Steals,42,37,36,11
Shai Gilgeous-Alexander,G,22023,1628983,22300239,"NOV 25, 2023",OKC vs. PHI,L,36,10,21,0.476,1,2,0.5,10,10,1.0,3,3,6,5,2,0,1,3,31,1,1,OKC,OKC,PHI,123,13.0,Rebs+Asts,42,37,36,11
Shai Gilgeous-Alexander,G,22023,1628983,22300215,"NOV 19, 2023",OKC @ POR,W,23,10,13,0.769,1,1,1.0,7,7,1.0,0,3,3,4,1,0,3,2,28,26,1,OKC,POR,OKC,134,31.5,Points,35,31,32,7
Shai Gilgeous-Alexander,G,22023,1628983,22300215,"NOV 19, 2023",OKC @ POR,W,23,10,13,0.769,1,1,1.0,7,7,1.0,0,3,3,4,1,0,3,2,28,26,1,OKC,POR,OKC,134,6.0,Rebounds,35,31,32,7
Shai Gilgeous-Alexander,G,22023,1628983,22300215,"NOV 19, 2023",OKC @ POR,W,23,10,13,0.769,1,1,1.0,7,7,1.0,0,3,3,4,1,0,3,2,28,26,1,OKC,POR,OKC,134,45.5,Pts+Rebs+Asts,35,31,32,7
Shai Gilgeous-Alexander,G,22023,1628983,22300215,"NOV 19, 2023",OKC @ POR,W,23,10,13,0.769,1,1,1.0,7,7,1.0,0,3,3,4,1,0,3,2,28,26,1,OKC,POR,OKC,134,7.0,Assists,35,31,32,7
Shai Gilgeous-Alexander,G,22023,1628983,22300215,"NOV 19, 2023",OKC @ POR,W,23,10,13,0.769,1,1,1.0,7,7,1.0,0,3,3,4,1,0,3,2,28,26,1,OKC,POR,OKC,134,53.0,Fantasy Score,35,31,32,7
Shai Gilgeous-Alexander,G,22023,1628983,22300215,"NOV 19, 2023",OKC @ POR,W,23,10,13,0.769,1,1,1.0,7,7,1.0,0,3,3,4,1,0,3,2,28,26,1,OKC,POR,OKC,134,8.0,Free Throws Made,35,31,32,7
Shai Gilgeous-Alexander,G,22023,1628983,22300215,"NOV 19, 2023",OKC @ POR,W,23,10,13,0.769,1,1,1.0,7,7,1.0,0,3,3,4,1,0,3,2,28,26,1,OKC,POR,OKC,134,20.5,FG Attempted,35,31,32,7
Shai Gilgeous-Alexander,G,22023,1628983,22300215,"NOV 19, 2023",OKC @ POR,W,23,10,13,0.769,1,1,1.0,7,7,1.0,0,3,3,4,1,0,3,2,28,26,1,OKC,POR,OKC,134,37.5,Pts+Rebs,35,31,32,7
Shai Gilgeous-Alexander,G,22023,1628983,22300215,"NOV 19, 2023",OKC @ POR,W,23,10,13,0.769,1,1,1.0,7,7,1.0,0,3,3,4,1,0,3,2,28,26,1,OKC,POR,OKC,134,0.5,Dunks,35,31,32,7
Shai Gilgeous-Alexander,G,22023,1628983,22300215,"NOV 19, 2023",OKC @ POR,W,23,10,13,0.769,1,1,1.0,7,7,1.0,0,3,3,4,1,0,3,2,28,26,1,OKC,POR,OKC,134,38.5,Pts+Asts,35,31,32,7
Shai Gilgeous-Alexander,G,22023,1628983,22300215,"NOV 19, 2023",OKC @ POR,W,23,10,13,0.769,1,1,1.0,7,7,1.0,0,3,3,4,1,0,3,2,28,26,1,OKC,POR,OKC,134,1.5,Steals,35,31,32,7
Shai Gilgeous-Alexander,G,22023,1628983,22300215,"NOV 19, 2023",OKC @ POR,W,23,10,13,0.769,1,1,1.0,7,7,1.0,0,3,3,4,1,0,3,2,28,26,1,OKC,POR,OKC,134,13.0,Rebs+Asts,35,31,32,7
Shai Gilgeous-Alexander,G,22023,1628983,22300185,"NOV 12, 2023",OKC @ PHX,W,37,13,22,0.591,2,5,0.4,7,8,0.875,0,7,7,4,1,1,1,3,35,7,1,OKC,PHX,OKC,111,31.5,Points,46,42,39,11
Shai Gilgeous-Alexander,G,22023,1628983,22300185,"NOV 12, 2023",OKC @ PHX,W,37,13,22,0.591,2,5,0.4,7,8,0.875,0,7,7,4,1,1,1,3,35,7,1,OKC,PHX,OKC,111,6.0,Rebounds,46,42,39,11
Shai Gilgeous-Alexander,G,22023,1628983,22300185,"NOV 12, 2023",OKC @ PHX,W,37,13,22,0.591,2,5,0.4,7,8,0.875,0,7,7,4,1,1,1,3,35,7,1,OKC,PHX,OKC,111,45.5,Pts+Rebs+Asts,46,42,39,11
Shai Gilgeous-Alexander,G,22023,1628983,22300185,"NOV 12, 2023",OKC @ PHX,W,37,13,22,0.591,2,5,0.4,7,8,0.875,0,7,7,4,1,1,1,3,35,7,1,OKC,PHX,OKC,111,7.0,Assists,46,42,39,11
Shai Gilgeous-Alexander,G,22023,1628983,22300185,"NOV 12, 2023",OKC @ PHX,W,37,13,22,0.591,2,5,0.4,7,8,0.875,0,7,7,4,1,1,1,3,35,7,1,OKC,PHX,OKC,111,53.0,Fantasy Score,46,42,39,11
Shai Gilgeous-Alexander,G,22023,1628983,22300185,"NOV 12, 2023",OKC @ PHX,W,37,13,22,0.591,2,5,0.4,7,8,0.875,0,7,7,4,1,1,1,3,35,7,1,OKC,PHX,OKC,111,8.0,Free Throws Made,46,42,39,11
Shai Gilgeous-Alexander,G,22023,1628983,22300185,"NOV 12, 2023",OKC @ PHX,W,37,13,22,0.591,2,5,0.4,7,8,0.875,0,7,7,4,1,1,1,3,35,7,1,OKC,PHX,OKC,111,20.5,FG Attempted,46,42,39,11
Shai Gilgeous-Alexander,G,22023,1628983,22300185,"NOV 12, 2023",OKC @ PHX,W,37,13,22,0.591,2,5,0.4,7,8,0.875,0,7,7,4,1,1,1,3,35,7,1,OKC,PHX,OKC,111,37.5,Pts+Rebs,46,42,39,11
Shai Gilgeous-Alexander,G,22023,1628983,22300185,"NOV 12, 2023",OKC @ PHX,W,37,13,22,0.591,2,5,0.4,7,8,0.875,0,7,7,4,1,1,1,3,35,7,1,OKC,PHX,OKC,111,0.5,Dunks,46,42,39,11
Shai Gilgeous-Alexander,G,22023,1628983,22300185,"NOV 12, 2023",OKC @ PHX,W,37,13,22,0.591,2,5,0.4,7,8,0.875,0,7,7,4,1,1,1,3,35,7,1,OKC,PHX,OKC,111,38.5,Pts+Asts,46,42,39,11
Shai Gilgeous-Alexander,G,22023,1628983,22300185,"NOV 12, 2023",OKC @ PHX,W,37,13,22,0.591,2,5,0.4,7,8,0.875,0,7,7,4,1,1,1,3,35,7,1,OKC,PHX,OKC,111,1.5,Steals,46,42,39,11
Shai Gilgeous-Alexander,G,22023,1628983,22300185,"NOV 12, 2023",OKC @ PHX,W,37,13,22,0.591,2,5,0.4,7,8,0.875,0,7,7,4,1,1,1,3,35,7,1,OKC,PHX,OKC,111,13.0,Rebs+Asts,46,42,39,11
Shai Gilgeous-Alexander,G,22023,1628983,22300167,"NOV 08, 2023",OKC vs. CLE,W,38,15,22,0.682,1,2,0.5,12,13,0.923,2,5,7,6,2,1,3,3,43,10,1,OKC,OKC,CLE,128,31.5,Points,56,50,49,13
Shai Gilgeous-Alexander,G,22023,1628983,22300167,"NOV 08, 2023",OKC vs. CLE,W,38,15,22,0.682,1,2,0.5,12,13,0.923,2,5,7,6,2,1,3,3,43,10,1,OKC,OKC,CLE,128,6.0,Rebounds,56,50,49,13
Shai Gilgeous-Alexander,G,22023,1628983,22300167,"NOV 08, 2023",OKC vs. CLE,W,38,15,22,0.682,1,2,0.5,12,13,0.923,2,5,7,6,2,1,3,3,43,10,1,OKC,OKC,CLE,128,45.5,Pts+Rebs+Asts,56,50,49,13
Shai Gilgeous-Alexander,G,22023,1628983,22300167,"NOV 08, 2023",OKC vs. CLE,W,38,15,22,0.682,1,2,0.5,12,13,0.923,2,5,7,6,2,1,3,3,43,10,1,OKC,OKC,CLE,128,7.0,Assists,56,50,49,13
Shai Gilgeous-Alexander,G,22023,1628983,22300167,"NOV 08, 2023",OKC vs. CLE,W,38,15,22,0.682,1,2,0.5,12,13,0.923,2,5,7,6,2,1,3,3,43,10,1,OKC,OKC,CLE,128,53.0,Fantasy Score,56,50,49,13
Shai Gilgeous-Alexander,G,22023,1628983,22300167,"NOV 08, 2023",OKC vs. CLE,W,38,15,22,0.682,1,2,0.5,12,13,0.923,2,5,7,6,2,1,3,3,43,10,1,OKC,OKC,CLE,128,8.0,Free Throws Made,56,50,49,13
Shai Gilgeous-Alexander,G,22023,1628983,22300167,"NOV 08, 2023",OKC vs. CLE,W,38,15,22,0.682,1,2,0.5,12,13,0.923,2,5,7,6,2,1,3,3,43,10,1,OKC,OKC,CLE,128,20.5,FG Attempted,56,50,49,13
Shai Gilgeous-Alexander,G,22023,1628983,22300167,"NOV 08, 2023",OKC vs. CLE,W,38,15,22,0.682,1,2,0.5,12,13,0.923,2,5,7,6,2,1,3,3,43,10,1,OKC,OKC,CLE,128,37.5,Pts+Rebs,56,50,49,13
Shai Gilgeous-Alexander,G,22023,1628983,22300167,"NOV 08, 2023",OKC vs. CLE,W,38,15,22,0.682,1,2,0.5,12,13,0.923,2,5,7,6,2,1,3,3,43,10,1,OKC,OKC,CLE,128,0.5,Dunks,56,50,49,13
Shai Gilgeous-Alexander,G,22023,1628983,22300167,"NOV 08, 2023",OKC vs. CLE,W,38,15,22,0.682,1,2,0.5,12,13,0.923,2,5,7,6,2,1,3,3,43,10,1,OKC,OKC,CLE,128,38.5,Pts+Asts,56,50,49,13
Shai Gilgeous-Alexander,G,22023,1628983,22300167,"NOV 08, 2023",OKC vs. CLE,W,38,15,22,0.682,1,2,0.5,12,13,0.923,2,5,7,6,2,1,3,3,43,10,1,OKC,OKC,CLE,128,1.5,Steals,56,50,49,13
Shai Gilgeous-Alexander,G,22023,1628983,22300167,"NOV 08, 2023",OKC vs. CLE,W,38,15,22,0.682,1,2,0.5,12,13,0.923,2,5,7,6,2,1,3,3,43,10,1,OKC,OKC,CLE,128,13.0,Rebs+Asts,56,50,49,13
Shai Gilgeous-Alexander,G,22023,1628983,22300109,"OCT 30, 2023",OKC vs. DET,W,33,11,23,0.478,1,3,0.333,9,9,1.0,1,8,9,4,3,0,5,2,32,17,1,OKC,OKC,DET,124,31.5,Points,45,41,36,13
Shai Gilgeous-Alexander,G,22023,1628983,22300109,"OCT 30, 2023",OKC vs. DET,W,33,11,23,0.478,1,3,0.333,9,9,1.0,1,8,9,4,3,0,5,2,32,17,1,OKC,OKC,DET,124,6.0,Rebounds,45,41,36,13
Shai Gilgeous-Alexander,G,22023,1628983,22300109,"OCT 30, 2023",OKC vs. DET,W,33,11,23,0.478,1,3,0.333,9,9,1.0,1,8,9,4,3,0,5,2,32,17,1,OKC,OKC,DET,124,45.5,Pts+Rebs+Asts,45,41,36,13
Shai Gilgeous-Alexander,G,22023,1628983,22300109,"OCT 30, 2023",OKC vs. DET,W,33,11,23,0.478,1,3,0.333,9,9,1.0,1,8,9,4,3,0,5,2,32,17,1,OKC,OKC,DET,124,7.0,Assists,45,41,36,13
Shai Gilgeous-Alexander,G,22023,1628983,22300109,"OCT 30, 2023",OKC vs. DET,W,33,11,23,0.478,1,3,0.333,9,9,1.0,1,8,9,4,3,0,5,2,32,17,1,OKC,OKC,DET,124,53.0,Fantasy Score,45,41,36,13
Shai Gilgeous-Alexander,G,22023,1628983,22300109,"OCT 30, 2023",OKC vs. DET,W,33,11,23,0.478,1,3,0.333,9,9,1.0,1,8,9,4,3,0,5,2,32,17,1,OKC,OKC,DET,124,8.0,Free Throws Made,45,41,36,13
Shai Gilgeous-Alexander,G,22023,1628983,22300109,"OCT 30, 2023",OKC vs. DET,W,33,11,23,0.478,1,3,0.333,9,9,1.0,1,8,9,4,3,0,5,2,32,17,1,OKC,OKC,DET,124,20.5,FG Attempted,45,41,36,13
Shai Gilgeous-Alexander,G,22023,1628983,22300109,"OCT 30, 2023",OKC vs. DET,W,33,11,23,0.478,1,3,0.333,9,9,1.0,1,8,9,4,3,0,5,2,32,17,1,OKC,OKC,DET,124,37.5,Pts+Rebs,45,41,36,13
Shai Gilgeous-Alexander,G,22023,1628983,22300109,"OCT 30, 2023",OKC vs. DET,W,33,11,23,0.478,1,3,0.333,9,9,1.0,1,8,9,4,3,0,5,2,32,17,1,OKC,OKC,DET,124,0.5,Dunks,45,41,36,13
Shai Gilgeous-Alexander,G,22023,1628983,22300109,"OCT 30, 2023",OKC vs. DET,W,33,11,23,0.478,1,3,0.333,9,9,1.0,1,8,9,4,3,0,5,2,32,17,1,OKC,OKC,DET,124,38.5,Pts+Asts,45,41,36,13
Shai Gilgeous-Alexander,G,22023,1628983,22300109,"OCT 30, 2023",OKC vs. DET,W,33,11,23,0.478,1,3,0.333,9,9,1.0,1,8,9,4,3,0,5,2,32,17,1,OKC,OKC,DET,124,1.5,Steals,45,41,36,13
Shai Gilgeous-Alexander,G,22023,1628983,22300109,"OCT 30, 2023",OKC vs. DET,W,33,11,23,0.478,1,3,0.333,9,9,1.0,1,8,9,4,3,0,5,2,32,17,1,OKC,OKC,DET,124,13.0,Rebs+Asts,45,41,36,13
Shai Gilgeous-Alexander,G,22023,1628983,22300748,"FEB 10, 2024",OKC @ DAL,L,29,9,16,0.563,0,0,0.0,7,8,0.875,2,4,6,5,0,1,3,1,25,-31,1,OKC,DAL,OKC,111,31.5,Points,36,31,30,11
Shai Gilgeous-Alexander,G,22023,1628983,22300748,"FEB 10, 2024",OKC @ DAL,L,29,9,16,0.563,0,0,0.0,7,8,0.875,2,4,6,5,0,1,3,1,25,-31,1,OKC,DAL,OKC,111,6.0,Rebounds,36,31,30,11
Shai Gilgeous-Alexander,G,22023,1628983,22300748,"FEB 10, 2024",OKC @ DAL,L,29,9,16,0.563,0,0,0.0,7,8,0.875,2,4,6,5,0,1,3,1,25,-31,1,OKC,DAL,OKC,111,45.5,Pts+Rebs+Asts,36,31,30,11
Shai Gilgeous-Alexander,G,22023,1628983,22300748,"FEB 10, 2024",OKC @ DAL,L,29,9,16,0.563,0,0,0.0,7,8,0.875,2,4,6,5,0,1,3,1,25,-31,1,OKC,DAL,OKC,111,7.0,Assists,36,31,30,11
Shai Gilgeous-Alexander,G,22023,1628983,22300748,"FEB 10, 2024",OKC @ DAL,L,29,9,16,0.563,0,0,0.0,7,8,0.875,2,4,6,5,0,1,3,1,25,-31,1,OKC,DAL,OKC,111,53.0,Fantasy Score,36,31,30,11
Shai Gilgeous-Alexander,G,22023,1628983,22300748,"FEB 10, 2024",OKC @ DAL,L,29,9,16,0.563,0,0,0.0,7,8,0.875,2,4,6,5,0,1,3,1,25,-31,1,OKC,DAL,OKC,111,8.0,Free Throws Made,36,31,30,11
Shai Gilgeous-Alexander,G,22023,1628983,22300748,"FEB 10, 2024",OKC @ DAL,L,29,9,16,0.563,0,0,0.0,7,8,0.875,2,4,6,5,0,1,3,1,25,-31,1,OKC,DAL,OKC,111,20.5,FG Attempted,36,31,30,11
Shai Gilgeous-Alexander,G,22023,1628983,22300748,"FEB 10, 2024",OKC @ DAL,L,29,9,16,0.563,0,0,0.0,7,8,0.875,2,4,6,5,0,1,3,1,25,-31,1,OKC,DAL,OKC,111,37.5,Pts+Rebs,36,31,30,11
Shai Gilgeous-Alexander,G,22023,1628983,22300748,"FEB 10, 2024",OKC @ DAL,L,29,9,16,0.563,0,0,0.0,7,8,0.875,2,4,6,5,0,1,3,1,25,-31,1,OKC,DAL,OKC,111,0.5,Dunks,36,31,30,11
Shai Gilgeous-Alexander,G,22023,1628983,22300748,"FEB 10, 2024",OKC @ DAL,L,29,9,16,0.563,0,0,0.0,7,8,0.875,2,4,6,5,0,1,3,1,25,-31,1,OKC,DAL,OKC,111,38.5,Pts+Asts,36,31,30,11
Shai Gilgeous-Alexander,G,22023,1628983,22300748,"FEB 10, 2024",OKC @ DAL,L,29,9,16,0.563,0,0,0.0,7,8,0.875,2,4,6,5,0,1,3,1,25,-31,1,OKC,DAL,OKC,111,1.5,Steals,36,31,30,11
Shai Gilgeous-Alexander,G,22023,1628983,22300748,"FEB 10, 2024",OKC @ DAL,L,29,9,16,0.563,0,0,0.0,7,8,0.875,2,4,6,5,0,1,3,1,25,-31,1,OKC,DAL,OKC,111,13.0,Rebs+Asts,36,31,30,11
Shai Gilgeous-Alexander,G,22023,1628983,22300724,"FEB 06, 2024",OKC @ UTA,L,36,11,22,0.5,2,3,0.667,4,5,0.8,1,3,4,7,1,1,2,1,28,-3,1,OKC,UTA,OKC,117,31.5,Points,39,32,35,11
Shai Gilgeous-Alexander,G,22023,1628983,22300724,"FEB 06, 2024",OKC @ UTA,L,36,11,22,0.5,2,3,0.667,4,5,0.8,1,3,4,7,1,1,2,1,28,-3,1,OKC,UTA,OKC,117,6.0,Rebounds,39,32,35,11
Shai Gilgeous-Alexander,G,22023,1628983,22300724,"FEB 06, 2024",OKC @ UTA,L,36,11,22,0.5,2,3,0.667,4,5,0.8,1,3,4,7,1,1,2,1,28,-3,1,OKC,UTA,OKC,117,45.5,Pts+Rebs+Asts,39,32,35,11
Shai Gilgeous-Alexander,G,22023,1628983,22300724,"FEB 06, 2024",OKC @ UTA,L,36,11,22,0.5,2,3,0.667,4,5,0.8,1,3,4,7,1,1,2,1,28,-3,1,OKC,UTA,OKC,117,7.0,Assists,39,32,35,11
Shai Gilgeous-Alexander,G,22023,1628983,22300724,"FEB 06, 2024",OKC @ UTA,L,36,11,22,0.5,2,3,0.667,4,5,0.8,1,3,4,7,1,1,2,1,28,-3,1,OKC,UTA,OKC,117,53.0,Fantasy Score,39,32,35,11
Shai Gilgeous-Alexander,G,22023,1628983,22300724,"FEB 06, 2024",OKC @ UTA,L,36,11,22,0.5,2,3,0.667,4,5,0.8,1,3,4,7,1,1,2,1,28,-3,1,OKC,UTA,OKC,117,8.0,Free Throws Made,39,32,35,11
Shai Gilgeous-Alexander,G,22023,1628983,22300724,"FEB 06, 2024",OKC @ UTA,L,36,11,22,0.5,2,3,0.667,4,5,0.8,1,3,4,7,1,1,2,1,28,-3,1,OKC,UTA,OKC,117,20.5,FG Attempted,39,32,35,11
Shai Gilgeous-Alexander,G,22023,1628983,22300724,"FEB 06, 2024",OKC @ UTA,L,36,11,22,0.5,2,3,0.667,4,5,0.8,1,3,4,7,1,1,2,1,28,-3,1,OKC,UTA,OKC,117,37.5,Pts+Rebs,39,32,35,11
Shai Gilgeous-Alexander,G,22023,1628983,22300724,"FEB 06, 2024",OKC @ UTA,L,36,11,22,0.5,2,3,0.667,4,5,0.8,1,3,4,7,1,1,2,1,28,-3,1,OKC,UTA,OKC,117,0.5,Dunks,39,32,35,11
Shai Gilgeous-Alexander,G,22023,1628983,22300724,"FEB 06, 2024",OKC @ UTA,L,36,11,22,0.5,2,3,0.667,4,5,0.8,1,3,4,7,1,1,2,1,28,-3,1,OKC,UTA,OKC,117,38.5,Pts+Asts,39,32,35,11
Shai Gilgeous-Alexander,G,22023,1628983,22300724,"FEB 06, 2024",OKC @ UTA,L,36,11,22,0.5,2,3,0.667,4,5,0.8,1,3,4,7,1,1,2,1,28,-3,1,OKC,UTA,OKC,117,1.5,Steals,39,32,35,11
Shai Gilgeous-Alexander,G,22023,1628983,22300724,"FEB 06, 2024",OKC @ UTA,L,36,11,22,0.5,2,3,0.667,4,5,0.8,1,3,4,7,1,1,2,1,28,-3,1,OKC,UTA,OKC,117,13.0,Rebs+Asts,39,32,35,11
Shai Gilgeous-Alexander,G,22023,1628983,22300710,"FEB 04, 2024",OKC vs. TOR,W,48,9,17,0.529,2,5,0.4,3,3,1.0,1,8,9,14,2,3,2,5,23,7,1,OKC,OKC,TOR,135,31.5,Points,46,32,37,23
Shai Gilgeous-Alexander,G,22023,1628983,22300710,"FEB 04, 2024",OKC vs. TOR,W,48,9,17,0.529,2,5,0.4,3,3,1.0,1,8,9,14,2,3,2,5,23,7,1,OKC,OKC,TOR,135,6.0,Rebounds,46,32,37,23
Shai Gilgeous-Alexander,G,22023,1628983,22300710,"FEB 04, 2024",OKC vs. TOR,W,48,9,17,0.529,2,5,0.4,3,3,1.0,1,8,9,14,2,3,2,5,23,7,1,OKC,OKC,TOR,135,45.5,Pts+Rebs+Asts,46,32,37,23
Shai Gilgeous-Alexander,G,22023,1628983,22300710,"FEB 04, 2024",OKC vs. TOR,W,48,9,17,0.529,2,5,0.4,3,3,1.0,1,8,9,14,2,3,2,5,23,7,1,OKC,OKC,TOR,135,7.0,Assists,46,32,37,23
Shai Gilgeous-Alexander,G,22023,1628983,22300710,"FEB 04, 2024",OKC vs. TOR,W,48,9,17,0.529,2,5,0.4,3,3,1.0,1,8,9,14,2,3,2,5,23,7,1,OKC,OKC,TOR,135,53.0,Fantasy Score,46,32,37,23
Shai Gilgeous-Alexander,G,22023,1628983,22300710,"FEB 04, 2024",OKC vs. TOR,W,48,9,17,0.529,2,5,0.4,3,3,1.0,1,8,9,14,2,3,2,5,23,7,1,OKC,OKC,TOR,135,8.0,Free Throws Made,46,32,37,23
Shai Gilgeous-Alexander,G,22023,1628983,22300710,"FEB 04, 2024",OKC vs. TOR,W,48,9,17,0.529,2,5,0.4,3,3,1.0,1,8,9,14,2,3,2,5,23,7,1,OKC,OKC,TOR,135,20.5,FG Attempted,46,32,37,23
Shai Gilgeous-Alexander,G,22023,1628983,22300710,"FEB 04, 2024",OKC vs. TOR,W,48,9,17,0.529,2,5,0.4,3,3,1.0,1,8,9,14,2,3,2,5,23,7,1,OKC,OKC,TOR,135,37.5,Pts+Rebs,46,32,37,23
Shai Gilgeous-Alexander,G,22023,1628983,22300710,"FEB 04, 2024",OKC vs. TOR,W,48,9,17,0.529,2,5,0.4,3,3,1.0,1,8,9,14,2,3,2,5,23,7,1,OKC,OKC,TOR,135,0.5,Dunks,46,32,37,23
Shai Gilgeous-Alexander,G,22023,1628983,22300710,"FEB 04, 2024",OKC vs. TOR,W,48,9,17,0.529,2,5,0.4,3,3,1.0,1,8,9,14,2,3,2,5,23,7,1,OKC,OKC,TOR,135,38.5,Pts+Asts,46,32,37,23
Shai Gilgeous-Alexander,G,22023,1628983,22300710,"FEB 04, 2024",OKC vs. TOR,W,48,9,17,0.529,2,5,0.4,3,3,1.0,1,8,9,14,2,3,2,5,23,7,1,OKC,OKC,TOR,135,1.5,Steals,46,32,37,23
Shai Gilgeous-Alexander,G,22023,1628983,22300710,"FEB 04, 2024",OKC vs. TOR,W,48,9,17,0.529,2,5,0.4,3,3,1.0,1,8,9,14,2,3,2,5,23,7,1,OKC,OKC,TOR,135,13.0,Rebs+Asts,46,32,37,23
Shai Gilgeous-Alexander,G,22023,1628983,22300695,"FEB 02, 2024",OKC vs. CHA,W,30,11,15,0.733,1,1,1.0,8,10,0.8,0,3,3,9,5,3,3,2,31,34,1,OKC,OKC,CHA,126,31.5,Points,43,34,40,12
Shai Gilgeous-Alexander,G,22023,1628983,22300695,"FEB 02, 2024",OKC vs. CHA,W,30,11,15,0.733,1,1,1.0,8,10,0.8,0,3,3,9,5,3,3,2,31,34,1,OKC,OKC,CHA,126,6.0,Rebounds,43,34,40,12
Shai Gilgeous-Alexander,G,22023,1628983,22300695,"FEB 02, 2024",OKC vs. CHA,W,30,11,15,0.733,1,1,1.0,8,10,0.8,0,3,3,9,5,3,3,2,31,34,1,OKC,OKC,CHA,126,45.5,Pts+Rebs+Asts,43,34,40,12
Shai Gilgeous-Alexander,G,22023,1628983,22300695,"FEB 02, 2024",OKC vs. CHA,W,30,11,15,0.733,1,1,1.0,8,10,0.8,0,3,3,9,5,3,3,2,31,34,1,OKC,OKC,CHA,126,7.0,Assists,43,34,40,12
Shai Gilgeous-Alexander,G,22023,1628983,22300695,"FEB 02, 2024",OKC vs. CHA,W,30,11,15,0.733,1,1,1.0,8,10,0.8,0,3,3,9,5,3,3,2,31,34,1,OKC,OKC,CHA,126,53.0,Fantasy Score,43,34,40,12
Shai Gilgeous-Alexander,G,22023,1628983,22300695,"FEB 02, 2024",OKC vs. CHA,W,30,11,15,0.733,1,1,1.0,8,10,0.8,0,3,3,9,5,3,3,2,31,34,1,OKC,OKC,CHA,126,8.0,Free Throws Made,43,34,40,12
Shai Gilgeous-Alexander,G,22023,1628983,22300695,"FEB 02, 2024",OKC vs. CHA,W,30,11,15,0.733,1,1,1.0,8,10,0.8,0,3,3,9,5,3,3,2,31,34,1,OKC,OKC,CHA,126,20.5,FG Attempted,43,34,40,12
Shai Gilgeous-Alexander,G,22023,1628983,22300695,"FEB 02, 2024",OKC vs. CHA,W,30,11,15,0.733,1,1,1.0,8,10,0.8,0,3,3,9,5,3,3,2,31,34,1,OKC,OKC,CHA,126,37.5,Pts+Rebs,43,34,40,12
Shai Gilgeous-Alexander,G,22023,1628983,22300695,"FEB 02, 2024",OKC vs. CHA,W,30,11,15,0.733,1,1,1.0,8,10,0.8,0,3,3,9,5,3,3,2,31,34,1,OKC,OKC,CHA,126,0.5,Dunks,43,34,40,12
Shai Gilgeous-Alexander,G,22023,1628983,22300695,"FEB 02, 2024",OKC vs. CHA,W,30,11,15,0.733,1,1,1.0,8,10,0.8,0,3,3,9,5,3,3,2,31,34,1,OKC,OKC,CHA,126,38.5,Pts+Asts,43,34,40,12
Shai Gilgeous-Alexander,G,22023,1628983,22300695,"FEB 02, 2024",OKC vs. CHA,W,30,11,15,0.733,1,1,1.0,8,10,0.8,0,3,3,9,5,3,3,2,31,34,1,OKC,OKC,CHA,126,1.5,Steals,43,34,40,12
Shai Gilgeous-Alexander,G,22023,1628983,22300695,"FEB 02, 2024",OKC vs. CHA,W,30,11,15,0.733,1,1,1.0,8,10,0.8,0,3,3,9,5,3,3,2,31,34,1,OKC,OKC,CHA,126,13.0,Rebs+Asts,43,34,40,12
Shai Gilgeous-Alexander,G,22023,1628983,22300568,"JAN 16, 2024",OKC @ LAC,L,34,6,16,0.375,0,3,0.0,7,8,0.875,1,1,2,4,0,2,2,4,19,-19,1,OKC,LAC,OKC,117,31.5,Points,25,21,23,6
Shai Gilgeous-Alexander,G,22023,1628983,22300568,"JAN 16, 2024",OKC @ LAC,L,34,6,16,0.375,0,3,0.0,7,8,0.875,1,1,2,4,0,2,2,4,19,-19,1,OKC,LAC,OKC,117,6.0,Rebounds,25,21,23,6
Shai Gilgeous-Alexander,G,22023,1628983,22300568,"JAN 16, 2024",OKC @ LAC,L,34,6,16,0.375,0,3,0.0,7,8,0.875,1,1,2,4,0,2,2,4,19,-19,1,OKC,LAC,OKC,117,45.5,Pts+Rebs+Asts,25,21,23,6
Shai Gilgeous-Alexander,G,22023,1628983,22300568,"JAN 16, 2024",OKC @ LAC,L,34,6,16,0.375,0,3,0.0,7,8,0.875,1,1,2,4,0,2,2,4,19,-19,1,OKC,LAC,OKC,117,7.0,Assists,25,21,23,6
Shai Gilgeous-Alexander,G,22023,1628983,22300568,"JAN 16, 2024",OKC @ LAC,L,34,6,16,0.375,0,3,0.0,7,8,0.875,1,1,2,4,0,2,2,4,19,-19,1,OKC,LAC,OKC,117,53.0,Fantasy Score,25,21,23,6
Shai Gilgeous-Alexander,G,22023,1628983,22300568,"JAN 16, 2024",OKC @ LAC,L,34,6,16,0.375,0,3,0.0,7,8,0.875,1,1,2,4,0,2,2,4,19,-19,1,OKC,LAC,OKC,117,8.0,Free Throws Made,25,21,23,6
Shai Gilgeous-Alexander,G,22023,1628983,22300568,"JAN 16, 2024",OKC @ LAC,L,34,6,16,0.375,0,3,0.0,7,8,0.875,1,1,2,4,0,2,2,4,19,-19,1,OKC,LAC,OKC,117,20.5,FG Attempted,25,21,23,6
Shai Gilgeous-Alexander,G,22023,1628983,22300568,"JAN 16, 2024",OKC @ LAC,L,34,6,16,0.375,0,3,0.0,7,8,0.875,1,1,2,4,0,2,2,4,19,-19,1,OKC,LAC,OKC,117,37.5,Pts+Rebs,25,21,23,6
Shai Gilgeous-Alexander,G,22023,1628983,22300568,"JAN 16, 2024",OKC @ LAC,L,34,6,16,0.375,0,3,0.0,7,8,0.875,1,1,2,4,0,2,2,4,19,-19,1,OKC,LAC,OKC,117,0.5,Dunks,25,21,23,6
Shai Gilgeous-Alexander,G,22023,1628983,22300568,"JAN 16, 2024",OKC @ LAC,L,34,6,16,0.375,0,3,0.0,7,8,0.875,1,1,2,4,0,2,2,4,19,-19,1,OKC,LAC,OKC,117,38.5,Pts+Asts,25,21,23,6
Shai Gilgeous-Alexander,G,22023,1628983,22300568,"JAN 16, 2024",OKC @ LAC,L,34,6,16,0.375,0,3,0.0,7,8,0.875,1,1,2,4,0,2,2,4,19,-19,1,OKC,LAC,OKC,117,1.5,Steals,25,21,23,6
Shai Gilgeous-Alexander,G,22023,1628983,22300568,"JAN 16, 2024",OKC @ LAC,L,34,6,16,0.375,0,3,0.0,7,8,0.875,1,1,2,4,0,2,2,4,19,-19,1,OKC,LAC,OKC,117,13.0,Rebs+Asts,25,21,23,6
Shai Gilgeous-Alexander,G,22023,1628983,22300565,"JAN 15, 2024",OKC @ LAL,L,34,9,19,0.474,1,6,0.167,5,5,1.0,0,3,3,6,1,1,3,3,24,-12,1,OKC,LAL,OKC,105,31.5,Points,33,27,30,9
Shai Gilgeous-Alexander,G,22023,1628983,22300565,"JAN 15, 2024",OKC @ LAL,L,34,9,19,0.474,1,6,0.167,5,5,1.0,0,3,3,6,1,1,3,3,24,-12,1,OKC,LAL,OKC,105,6.0,Rebounds,33,27,30,9
Shai Gilgeous-Alexander,G,22023,1628983,22300565,"JAN 15, 2024",OKC @ LAL,L,34,9,19,0.474,1,6,0.167,5,5,1.0,0,3,3,6,1,1,3,3,24,-12,1,OKC,LAL,OKC,105,45.5,Pts+Rebs+Asts,33,27,30,9
Shai Gilgeous-Alexander,G,22023,1628983,22300565,"JAN 15, 2024",OKC @ LAL,L,34,9,19,0.474,1,6,0.167,5,5,1.0,0,3,3,6,1,1,3,3,24,-12,1,OKC,LAL,OKC,105,7.0,Assists,33,27,30,9
Shai Gilgeous-Alexander,G,22023,1628983,22300565,"JAN 15, 2024",OKC @ LAL,L,34,9,19,0.474,1,6,0.167,5,5,1.0,0,3,3,6,1,1,3,3,24,-12,1,OKC,LAL,OKC,105,53.0,Fantasy Score,33,27,30,9
Shai Gilgeous-Alexander,G,22023,1628983,22300565,"JAN 15, 2024",OKC @ LAL,L,34,9,19,0.474,1,6,0.167,5,5,1.0,0,3,3,6,1,1,3,3,24,-12,1,OKC,LAL,OKC,105,8.0,Free Throws Made,33,27,30,9
Shai Gilgeous-Alexander,G,22023,1628983,22300565,"JAN 15, 2024",OKC @ LAL,L,34,9,19,0.474,1,6,0.167,5,5,1.0,0,3,3,6,1,1,3,3,24,-12,1,OKC,LAL,OKC,105,20.5,FG Attempted,33,27,30,9
Shai Gilgeous-Alexander,G,22023,1628983,22300565,"JAN 15, 2024",OKC @ LAL,L,34,9,19,0.474,1,6,0.167,5,5,1.0,0,3,3,6,1,1,3,3,24,-12,1,OKC,LAL,OKC,105,37.5,Pts+Rebs,33,27,30,9
Shai Gilgeous-Alexander,G,22023,1628983,22300565,"JAN 15, 2024",OKC @ LAL,L,34,9,19,0.474,1,6,0.167,5,5,1.0,0,3,3,6,1,1,3,3,24,-12,1,OKC,LAL,OKC,105,0.5,Dunks,33,27,30,9
Shai Gilgeous-Alexander,G,22023,1628983,22300565,"JAN 15, 2024",OKC @ LAL,L,34,9,19,0.474,1,6,0.167,5,5,1.0,0,3,3,6,1,1,3,3,24,-12,1,OKC,LAL,OKC,105,38.5,Pts+Asts,33,27,30,9
Shai Gilgeous-Alexander,G,22023,1628983,22300565,"JAN 15, 2024",OKC @ LAL,L,34,9,19,0.474,1,6,0.167,5,5,1.0,0,3,3,6,1,1,3,3,24,-12,1,OKC,LAL,OKC,105,1.5,Steals,33,27,30,9
Shai Gilgeous-Alexander,G,22023,1628983,22300565,"JAN 15, 2024",OKC @ LAL,L,34,9,19,0.474,1,6,0.167,5,5,1.0,0,3,3,6,1,1,3,3,24,-12,1,OKC,LAL,OKC,105,13.0,Rebs+Asts,33,27,30,9
Shai Gilgeous-Alexander,G,22023,1628983,22300546,"JAN 13, 2024",OKC vs. ORL,W,36,13,20,0.65,0,4,0.0,11,12,0.917,2,4,6,7,3,1,0,2,37,14,1,OKC,OKC,ORL,112,31.5,Points,50,43,44,13
Shai Gilgeous-Alexander,G,22023,1628983,22300546,"JAN 13, 2024",OKC vs. ORL,W,36,13,20,0.65,0,4,0.0,11,12,0.917,2,4,6,7,3,1,0,2,37,14,1,OKC,OKC,ORL,112,6.0,Rebounds,50,43,44,13
Shai Gilgeous-Alexander,G,22023,1628983,22300546,"JAN 13, 2024",OKC vs. ORL,W,36,13,20,0.65,0,4,0.0,11,12,0.917,2,4,6,7,3,1,0,2,37,14,1,OKC,OKC,ORL,112,45.5,Pts+Rebs+Asts,50,43,44,13
Shai Gilgeous-Alexander,G,22023,1628983,22300546,"JAN 13, 2024",OKC vs. ORL,W,36,13,20,0.65,0,4,0.0,11,12,0.917,2,4,6,7,3,1,0,2,37,14,1,OKC,OKC,ORL,112,7.0,Assists,50,43,44,13
Shai Gilgeous-Alexander,G,22023,1628983,22300546,"JAN 13, 2024",OKC vs. ORL,W,36,13,20,0.65,0,4,0.0,11,12,0.917,2,4,6,7,3,1,0,2,37,14,1,OKC,OKC,ORL,112,53.0,Fantasy Score,50,43,44,13
Shai Gilgeous-Alexander,G,22023,1628983,22300546,"JAN 13, 2024",OKC vs. ORL,W,36,13,20,0.65,0,4,0.0,11,12,0.917,2,4,6,7,3,1,0,2,37,14,1,OKC,OKC,ORL,112,8.0,Free Throws Made,50,43,44,13
Shai Gilgeous-Alexander,G,22023,1628983,22300546,"JAN 13, 2024",OKC vs. ORL,W,36,13,20,0.65,0,4,0.0,11,12,0.917,2,4,6,7,3,1,0,2,37,14,1,OKC,OKC,ORL,112,20.5,FG Attempted,50,43,44,13
Shai Gilgeous-Alexander,G,22023,1628983,22300546,"JAN 13, 2024",OKC vs. ORL,W,36,13,20,0.65,0,4,0.0,11,12,0.917,2,4,6,7,3,1,0,2,37,14,1,OKC,OKC,ORL,112,37.5,Pts+Rebs,50,43,44,13
Shai Gilgeous-Alexander,G,22023,1628983,22300546,"JAN 13, 2024",OKC vs. ORL,W,36,13,20,0.65,0,4,0.0,11,12,0.917,2,4,6,7,3,1,0,2,37,14,1,OKC,OKC,ORL,112,0.5,Dunks,50,43,44,13
Shai Gilgeous-Alexander,G,22023,1628983,22300546,"JAN 13, 2024",OKC vs. ORL,W,36,13,20,0.65,0,4,0.0,11,12,0.917,2,4,6,7,3,1,0,2,37,14,1,OKC,OKC,ORL,112,38.5,Pts+Asts,50,43,44,13
Shai Gilgeous-Alexander,G,22023,1628983,22300546,"JAN 13, 2024",OKC vs. ORL,W,36,13,20,0.65,0,4,0.0,11,12,0.917,2,4,6,7,3,1,0,2,37,14,1,OKC,OKC,ORL,112,1.5,Steals,50,43,44,13
Shai Gilgeous-Alexander,G,22023,1628983,22300546,"JAN 13, 2024",OKC vs. ORL,W,36,13,20,0.65,0,4,0.0,11,12,0.917,2,4,6,7,3,1,0,2,37,14,1,OKC,OKC,ORL,112,13.0,Rebs+Asts,50,43,44,13
Shai Gilgeous-Alexander,G,22023,1628983,22300529,"JAN 11, 2024",OKC vs. POR,W,21,11,15,0.733,1,3,0.333,8,8,1.0,1,4,5,4,0,1,2,2,31,41,1,OKC,OKC,POR,139,31.5,Points,40,36,35,9
Shai Gilgeous-Alexander,G,22023,1628983,22300529,"JAN 11, 2024",OKC vs. POR,W,21,11,15,0.733,1,3,0.333,8,8,1.0,1,4,5,4,0,1,2,2,31,41,1,OKC,OKC,POR,139,6.0,Rebounds,40,36,35,9
Shai Gilgeous-Alexander,G,22023,1628983,22300529,"JAN 11, 2024",OKC vs. POR,W,21,11,15,0.733,1,3,0.333,8,8,1.0,1,4,5,4,0,1,2,2,31,41,1,OKC,OKC,POR,139,45.5,Pts+Rebs+Asts,40,36,35,9
Shai Gilgeous-Alexander,G,22023,1628983,22300529,"JAN 11, 2024",OKC vs. POR,W,21,11,15,0.733,1,3,0.333,8,8,1.0,1,4,5,4,0,1,2,2,31,41,1,OKC,OKC,POR,139,7.0,Assists,40,36,35,9
Shai Gilgeous-Alexander,G,22023,1628983,22300529,"JAN 11, 2024",OKC vs. POR,W,21,11,15,0.733,1,3,0.333,8,8,1.0,1,4,5,4,0,1,2,2,31,41,1,OKC,OKC,POR,139,53.0,Fantasy Score,40,36,35,9
Shai Gilgeous-Alexander,G,22023,1628983,22300529,"JAN 11, 2024",OKC vs. POR,W,21,11,15,0.733,1,3,0.333,8,8,1.0,1,4,5,4,0,1,2,2,31,41,1,OKC,OKC,POR,139,8.0,Free Throws Made,40,36,35,9
Shai Gilgeous-Alexander,G,22023,1628983,22300529,"JAN 11, 2024",OKC vs. POR,W,21,11,15,0.733,1,3,0.333,8,8,1.0,1,4,5,4,0,1,2,2,31,41,1,OKC,OKC,POR,139,20.5,FG Attempted,40,36,35,9
Shai Gilgeous-Alexander,G,22023,1628983,22300529,"JAN 11, 2024",OKC vs. POR,W,21,11,15,0.733,1,3,0.333,8,8,1.0,1,4,5,4,0,1,2,2,31,41,1,OKC,OKC,POR,139,37.5,Pts+Rebs,40,36,35,9
Shai Gilgeous-Alexander,G,22023,1628983,22300529,"JAN 11, 2024",OKC vs. POR,W,21,11,15,0.733,1,3,0.333,8,8,1.0,1,4,5,4,0,1,2,2,31,41,1,OKC,OKC,POR,139,0.5,Dunks,40,36,35,9
Shai Gilgeous-Alexander,G,22023,1628983,22300529,"JAN 11, 2024",OKC vs. POR,W,21,11,15,0.733,1,3,0.333,8,8,1.0,1,4,5,4,0,1,2,2,31,41,1,OKC,OKC,POR,139,38.5,Pts+Asts,40,36,35,9
Shai Gilgeous-Alexander,G,22023,1628983,22300529,"JAN 11, 2024",OKC vs. POR,W,21,11,15,0.733,1,3,0.333,8,8,1.0,1,4,5,4,0,1,2,2,31,41,1,OKC,OKC,POR,139,1.5,Steals,40,36,35,9
Shai Gilgeous-Alexander,G,22023,1628983,22300529,"JAN 11, 2024",OKC vs. POR,W,21,11,15,0.733,1,3,0.333,8,8,1.0,1,4,5,4,0,1,2,2,31,41,1,OKC,OKC,POR,139,13.0,Rebs+Asts,40,36,35,9
Shai Gilgeous-Alexander,G,22023,1628983,22300379,"DEC 21, 2023",OKC vs. LAC,W,32,11,25,0.44,1,6,0.167,8,9,0.889,2,6,8,4,4,2,1,0,31,9,1,OKC,OKC,LAC,134,31.5,Points,43,39,35,12
Shai Gilgeous-Alexander,G,22023,1628983,22300379,"DEC 21, 2023",OKC vs. LAC,W,32,11,25,0.44,1,6,0.167,8,9,0.889,2,6,8,4,4,2,1,0,31,9,1,OKC,OKC,LAC,134,6.0,Rebounds,43,39,35,12
Shai Gilgeous-Alexander,G,22023,1628983,22300379,"DEC 21, 2023",OKC vs. LAC,W,32,11,25,0.44,1,6,0.167,8,9,0.889,2,6,8,4,4,2,1,0,31,9,1,OKC,OKC,LAC,134,45.5,Pts+Rebs+Asts,43,39,35,12
Shai Gilgeous-Alexander,G,22023,1628983,22300379,"DEC 21, 2023",OKC vs. LAC,W,32,11,25,0.44,1,6,0.167,8,9,0.889,2,6,8,4,4,2,1,0,31,9,1,OKC,OKC,LAC,134,7.0,Assists,43,39,35,12
Shai Gilgeous-Alexander,G,22023,1628983,22300379,"DEC 21, 2023",OKC vs. LAC,W,32,11,25,0.44,1,6,0.167,8,9,0.889,2,6,8,4,4,2,1,0,31,9,1,OKC,OKC,LAC,134,53.0,Fantasy Score,43,39,35,12
Shai Gilgeous-Alexander,G,22023,1628983,22300379,"DEC 21, 2023",OKC vs. LAC,W,32,11,25,0.44,1,6,0.167,8,9,0.889,2,6,8,4,4,2,1,0,31,9,1,OKC,OKC,LAC,134,8.0,Free Throws Made,43,39,35,12
Shai Gilgeous-Alexander,G,22023,1628983,22300379,"DEC 21, 2023",OKC vs. LAC,W,32,11,25,0.44,1,6,0.167,8,9,0.889,2,6,8,4,4,2,1,0,31,9,1,OKC,OKC,LAC,134,20.5,FG Attempted,43,39,35,12
Shai Gilgeous-Alexander,G,22023,1628983,22300379,"DEC 21, 2023",OKC vs. LAC,W,32,11,25,0.44,1,6,0.167,8,9,0.889,2,6,8,4,4,2,1,0,31,9,1,OKC,OKC,LAC,134,37.5,Pts+Rebs,43,39,35,12
Shai Gilgeous-Alexander,G,22023,1628983,22300379,"DEC 21, 2023",OKC vs. LAC,W,32,11,25,0.44,1,6,0.167,8,9,0.889,2,6,8,4,4,2,1,0,31,9,1,OKC,OKC,LAC,134,0.5,Dunks,43,39,35,12
Shai Gilgeous-Alexander,G,22023,1628983,22300379,"DEC 21, 2023",OKC vs. LAC,W,32,11,25,0.44,1,6,0.167,8,9,0.889,2,6,8,4,4,2,1,0,31,9,1,OKC,OKC,LAC,134,38.5,Pts+Asts,43,39,35,12
Shai Gilgeous-Alexander,G,22023,1628983,22300379,"DEC 21, 2023",OKC vs. LAC,W,32,11,25,0.44,1,6,0.167,8,9,0.889,2,6,8,4,4,2,1,0,31,9,1,OKC,OKC,LAC,134,1.5,Steals,43,39,35,12
Shai Gilgeous-Alexander,G,22023,1628983,22300379,"DEC 21, 2023",OKC vs. LAC,W,32,11,25,0.44,1,6,0.167,8,9,0.889,2,6,8,4,4,2,1,0,31,9,1,OKC,OKC,LAC,134,13.0,Rebs+Asts,43,39,35,12
Shai Gilgeous-Alexander,G,22023,1628983,22300355,"DEC 18, 2023",OKC vs. MEM,W,28,8,18,0.444,1,3,0.333,13,14,0.929,0,9,9,5,4,0,2,4,30,30,1,OKC,OKC,MEM,116,31.5,Points,44,39,35,14
Shai Gilgeous-Alexander,G,22023,1628983,22300355,"DEC 18, 2023",OKC vs. MEM,W,28,8,18,0.444,1,3,0.333,13,14,0.929,0,9,9,5,4,0,2,4,30,30,1,OKC,OKC,MEM,116,6.0,Rebounds,44,39,35,14
Shai Gilgeous-Alexander,G,22023,1628983,22300355,"DEC 18, 2023",OKC vs. MEM,W,28,8,18,0.444,1,3,0.333,13,14,0.929,0,9,9,5,4,0,2,4,30,30,1,OKC,OKC,MEM,116,45.5,Pts+Rebs+Asts,44,39,35,14
Shai Gilgeous-Alexander,G,22023,1628983,22300355,"DEC 18, 2023",OKC vs. MEM,W,28,8,18,0.444,1,3,0.333,13,14,0.929,0,9,9,5,4,0,2,4,30,30,1,OKC,OKC,MEM,116,7.0,Assists,44,39,35,14
Shai Gilgeous-Alexander,G,22023,1628983,22300355,"DEC 18, 2023",OKC vs. MEM,W,28,8,18,0.444,1,3,0.333,13,14,0.929,0,9,9,5,4,0,2,4,30,30,1,OKC,OKC,MEM,116,53.0,Fantasy Score,44,39,35,14
Shai Gilgeous-Alexander,G,22023,1628983,22300355,"DEC 18, 2023",OKC vs. MEM,W,28,8,18,0.444,1,3,0.333,13,14,0.929,0,9,9,5,4,0,2,4,30,30,1,OKC,OKC,MEM,116,8.0,Free Throws Made,44,39,35,14
Shai Gilgeous-Alexander,G,22023,1628983,22300355,"DEC 18, 2023",OKC vs. MEM,W,28,8,18,0.444,1,3,0.333,13,14,0.929,0,9,9,5,4,0,2,4,30,30,1,OKC,OKC,MEM,116,20.5,FG Attempted,44,39,35,14
Shai Gilgeous-Alexander,G,22023,1628983,22300355,"DEC 18, 2023",OKC vs. MEM,W,28,8,18,0.444,1,3,0.333,13,14,0.929,0,9,9,5,4,0,2,4,30,30,1,OKC,OKC,MEM,116,37.5,Pts+Rebs,44,39,35,14
Shai Gilgeous-Alexander,G,22023,1628983,22300355,"DEC 18, 2023",OKC vs. MEM,W,28,8,18,0.444,1,3,0.333,13,14,0.929,0,9,9,5,4,0,2,4,30,30,1,OKC,OKC,MEM,116,0.5,Dunks,44,39,35,14
Shai Gilgeous-Alexander,G,22023,1628983,22300355,"DEC 18, 2023",OKC vs. MEM,W,28,8,18,0.444,1,3,0.333,13,14,0.929,0,9,9,5,4,0,2,4,30,30,1,OKC,OKC,MEM,116,38.5,Pts+Asts,44,39,35,14
Shai Gilgeous-Alexander,G,22023,1628983,22300355,"DEC 18, 2023",OKC vs. MEM,W,28,8,18,0.444,1,3,0.333,13,14,0.929,0,9,9,5,4,0,2,4,30,30,1,OKC,OKC,MEM,116,1.5,Steals,44,39,35,14
Shai Gilgeous-Alexander,G,22023,1628983,22300355,"DEC 18, 2023",OKC vs. MEM,W,28,8,18,0.444,1,3,0.333,13,14,0.929,0,9,9,5,4,0,2,4,30,30,1,OKC,OKC,MEM,116,13.0,Rebs+Asts,44,39,35,14
Shai Gilgeous-Alexander,G,22023,1628983,22300340,"DEC 16, 2023",OKC @ DEN,W,37,9,20,0.45,0,2,0.0,7,8,0.875,0,6,6,8,2,0,2,1,25,3,1,OKC,DEN,OKC,118,31.5,Points,39,31,33,14
Shai Gilgeous-Alexander,G,22023,1628983,22300340,"DEC 16, 2023",OKC @ DEN,W,37,9,20,0.45,0,2,0.0,7,8,0.875,0,6,6,8,2,0,2,1,25,3,1,OKC,DEN,OKC,118,6.0,Rebounds,39,31,33,14
Shai Gilgeous-Alexander,G,22023,1628983,22300340,"DEC 16, 2023",OKC @ DEN,W,37,9,20,0.45,0,2,0.0,7,8,0.875,0,6,6,8,2,0,2,1,25,3,1,OKC,DEN,OKC,118,45.5,Pts+Rebs+Asts,39,31,33,14
Shai Gilgeous-Alexander,G,22023,1628983,22300340,"DEC 16, 2023",OKC @ DEN,W,37,9,20,0.45,0,2,0.0,7,8,0.875,0,6,6,8,2,0,2,1,25,3,1,OKC,DEN,OKC,118,7.0,Assists,39,31,33,14
Shai Gilgeous-Alexander,G,22023,1628983,22300340,"DEC 16, 2023",OKC @ DEN,W,37,9,20,0.45,0,2,0.0,7,8,0.875,0,6,6,8,2,0,2,1,25,3,1,OKC,DEN,OKC,118,53.0,Fantasy Score,39,31,33,14
Shai Gilgeous-Alexander,G,22023,1628983,22300340,"DEC 16, 2023",OKC @ DEN,W,37,9,20,0.45,0,2,0.0,7,8,0.875,0,6,6,8,2,0,2,1,25,3,1,OKC,DEN,OKC,118,8.0,Free Throws Made,39,31,33,14
Shai Gilgeous-Alexander,G,22023,1628983,22300340,"DEC 16, 2023",OKC @ DEN,W,37,9,20,0.45,0,2,0.0,7,8,0.875,0,6,6,8,2,0,2,1,25,3,1,OKC,DEN,OKC,118,20.5,FG Attempted,39,31,33,14
Shai Gilgeous-Alexander,G,22023,1628983,22300340,"DEC 16, 2023",OKC @ DEN,W,37,9,20,0.45,0,2,0.0,7,8,0.875,0,6,6,8,2,0,2,1,25,3,1,OKC,DEN,OKC,118,37.5,Pts+Rebs,39,31,33,14
Shai Gilgeous-Alexander,G,22023,1628983,22300340,"DEC 16, 2023",OKC @ DEN,W,37,9,20,0.45,0,2,0.0,7,8,0.875,0,6,6,8,2,0,2,1,25,3,1,OKC,DEN,OKC,118,0.5,Dunks,39,31,33,14
Shai Gilgeous-Alexander,G,22023,1628983,22300340,"DEC 16, 2023",OKC @ DEN,W,37,9,20,0.45,0,2,0.0,7,8,0.875,0,6,6,8,2,0,2,1,25,3,1,OKC,DEN,OKC,118,38.5,Pts+Asts,39,31,33,14
Shai Gilgeous-Alexander,G,22023,1628983,22300340,"DEC 16, 2023",OKC @ DEN,W,37,9,20,0.45,0,2,0.0,7,8,0.875,0,6,6,8,2,0,2,1,25,3,1,OKC,DEN,OKC,118,1.5,Steals,39,31,33,14
Shai Gilgeous-Alexander,G,22023,1628983,22300340,"DEC 16, 2023",OKC @ DEN,W,37,9,20,0.45,0,2,0.0,7,8,0.875,0,6,6,8,2,0,2,1,25,3,1,OKC,DEN,OKC,118,13.0,Rebs+Asts,39,31,33,14
Shai Gilgeous-Alexander,G,22023,1628983,22300058,"NOV 28, 2023",OKC @ MIN,L,34,13,22,0.591,0,1,0.0,6,6,1.0,1,3,4,4,3,2,3,2,32,4,1,OKC,MIN,OKC,103,31.5,Points,40,36,36,8
Shai Gilgeous-Alexander,G,22023,1628983,22300058,"NOV 28, 2023",OKC @ MIN,L,34,13,22,0.591,0,1,0.0,6,6,1.0,1,3,4,4,3,2,3,2,32,4,1,OKC,MIN,OKC,103,6.0,Rebounds,40,36,36,8
Shai Gilgeous-Alexander,G,22023,1628983,22300058,"NOV 28, 2023",OKC @ MIN,L,34,13,22,0.591,0,1,0.0,6,6,1.0,1,3,4,4,3,2,3,2,32,4,1,OKC,MIN,OKC,103,45.5,Pts+Rebs+Asts,40,36,36,8
Shai Gilgeous-Alexander,G,22023,1628983,22300058,"NOV 28, 2023",OKC @ MIN,L,34,13,22,0.591,0,1,0.0,6,6,1.0,1,3,4,4,3,2,3,2,32,4,1,OKC,MIN,OKC,103,7.0,Assists,40,36,36,8
Shai Gilgeous-Alexander,G,22023,1628983,22300058,"NOV 28, 2023",OKC @ MIN,L,34,13,22,0.591,0,1,0.0,6,6,1.0,1,3,4,4,3,2,3,2,32,4,1,OKC,MIN,OKC,103,53.0,Fantasy Score,40,36,36,8
Shai Gilgeous-Alexander,G,22023,1628983,22300058,"NOV 28, 2023",OKC @ MIN,L,34,13,22,0.591,0,1,0.0,6,6,1.0,1,3,4,4,3,2,3,2,32,4,1,OKC,MIN,OKC,103,8.0,Free Throws Made,40,36,36,8
Shai Gilgeous-Alexander,G,22023,1628983,22300058,"NOV 28, 2023",OKC @ MIN,L,34,13,22,0.591,0,1,0.0,6,6,1.0,1,3,4,4,3,2,3,2,32,4,1,OKC,MIN,OKC,103,20.5,FG Attempted,40,36,36,8
Shai Gilgeous-Alexander,G,22023,1628983,22300058,"NOV 28, 2023",OKC @ MIN,L,34,13,22,0.591,0,1,0.0,6,6,1.0,1,3,4,4,3,2,3,2,32,4,1,OKC,MIN,OKC,103,37.5,Pts+Rebs,40,36,36,8
Shai Gilgeous-Alexander,G,22023,1628983,22300058,"NOV 28, 2023",OKC @ MIN,L,34,13,22,0.591,0,1,0.0,6,6,1.0,1,3,4,4,3,2,3,2,32,4,1,OKC,MIN,OKC,103,0.5,Dunks,40,36,36,8
Shai Gilgeous-Alexander,G,22023,1628983,22300058,"NOV 28, 2023",OKC @ MIN,L,34,13,22,0.591,0,1,0.0,6,6,1.0,1,3,4,4,3,2,3,2,32,4,1,OKC,MIN,OKC,103,38.5,Pts+Asts,40,36,36,8
Shai Gilgeous-Alexander,G,22023,1628983,22300058,"NOV 28, 2023",OKC @ MIN,L,34,13,22,0.591,0,1,0.0,6,6,1.0,1,3,4,4,3,2,3,2,32,4,1,OKC,MIN,OKC,103,1.5,Steals,40,36,36,8
Shai Gilgeous-Alexander,G,22023,1628983,22300058,"NOV 28, 2023",OKC @ MIN,L,34,13,22,0.591,0,1,0.0,6,6,1.0,1,3,4,4,3,2,3,2,32,4,1,OKC,MIN,OKC,103,13.0,Rebs+Asts,40,36,36,8
Shai Gilgeous-Alexander,G,22023,1628983,22300016,"NOV 10, 2023",OKC @ SAC,L,38,14,25,0.56,0,2,0.0,5,6,0.833,0,7,7,5,2,2,2,1,33,-3,1,OKC,SAC,OKC,98,31.5,Points,45,40,38,12
Shai Gilgeous-Alexander,G,22023,1628983,22300016,"NOV 10, 2023",OKC @ SAC,L,38,14,25,0.56,0,2,0.0,5,6,0.833,0,7,7,5,2,2,2,1,33,-3,1,OKC,SAC,OKC,98,6.0,Rebounds,45,40,38,12
Shai Gilgeous-Alexander,G,22023,1628983,22300016,"NOV 10, 2023",OKC @ SAC,L,38,14,25,0.56,0,2,0.0,5,6,0.833,0,7,7,5,2,2,2,1,33,-3,1,OKC,SAC,OKC,98,45.5,Pts+Rebs+Asts,45,40,38,12
Shai Gilgeous-Alexander,G,22023,1628983,22300016,"NOV 10, 2023",OKC @ SAC,L,38,14,25,0.56,0,2,0.0,5,6,0.833,0,7,7,5,2,2,2,1,33,-3,1,OKC,SAC,OKC,98,7.0,Assists,45,40,38,12
Shai Gilgeous-Alexander,G,22023,1628983,22300016,"NOV 10, 2023",OKC @ SAC,L,38,14,25,0.56,0,2,0.0,5,6,0.833,0,7,7,5,2,2,2,1,33,-3,1,OKC,SAC,OKC,98,53.0,Fantasy Score,45,40,38,12
Shai Gilgeous-Alexander,G,22023,1628983,22300016,"NOV 10, 2023",OKC @ SAC,L,38,14,25,0.56,0,2,0.0,5,6,0.833,0,7,7,5,2,2,2,1,33,-3,1,OKC,SAC,OKC,98,8.0,Free Throws Made,45,40,38,12
Shai Gilgeous-Alexander,G,22023,1628983,22300016,"NOV 10, 2023",OKC @ SAC,L,38,14,25,0.56,0,2,0.0,5,6,0.833,0,7,7,5,2,2,2,1,33,-3,1,OKC,SAC,OKC,98,20.5,FG Attempted,45,40,38,12
Shai Gilgeous-Alexander,G,22023,1628983,22300016,"NOV 10, 2023",OKC @ SAC,L,38,14,25,0.56,0,2,0.0,5,6,0.833,0,7,7,5,2,2,2,1,33,-3,1,OKC,SAC,OKC,98,37.5,Pts+Rebs,45,40,38,12
Shai Gilgeous-Alexander,G,22023,1628983,22300016,"NOV 10, 2023",OKC @ SAC,L,38,14,25,0.56,0,2,0.0,5,6,0.833,0,7,7,5,2,2,2,1,33,-3,1,OKC,SAC,OKC,98,0.5,Dunks,45,40,38,12
Shai Gilgeous-Alexander,G,22023,1628983,22300016,"NOV 10, 2023",OKC @ SAC,L,38,14,25,0.56,0,2,0.0,5,6,0.833,0,7,7,5,2,2,2,1,33,-3,1,OKC,SAC,OKC,98,38.5,Pts+Asts,45,40,38,12
Shai Gilgeous-Alexander,G,22023,1628983,22300016,"NOV 10, 2023",OKC @ SAC,L,38,14,25,0.56,0,2,0.0,5,6,0.833,0,7,7,5,2,2,2,1,33,-3,1,OKC,SAC,OKC,98,1.5,Steals,45,40,38,12
Shai Gilgeous-Alexander,G,22023,1628983,22300016,"NOV 10, 2023",OKC @ SAC,L,38,14,25,0.56,0,2,0.0,5,6,0.833,0,7,7,5,2,2,2,1,33,-3,1,OKC,SAC,OKC,98,13.0,Rebs+Asts,45,40,38,12
Shai Gilgeous-Alexander,G,22023,1628983,22300155,"NOV 06, 2023",OKC vs. ATL,W,37,11,20,0.55,3,7,0.429,5,6,0.833,1,7,8,6,1,0,2,5,30,14,1,OKC,OKC,ATL,126,31.5,Points,44,38,36,14
Shai Gilgeous-Alexander,G,22023,1628983,22300155,"NOV 06, 2023",OKC vs. ATL,W,37,11,20,0.55,3,7,0.429,5,6,0.833,1,7,8,6,1,0,2,5,30,14,1,OKC,OKC,ATL,126,6.0,Rebounds,44,38,36,14
Shai Gilgeous-Alexander,G,22023,1628983,22300155,"NOV 06, 2023",OKC vs. ATL,W,37,11,20,0.55,3,7,0.429,5,6,0.833,1,7,8,6,1,0,2,5,30,14,1,OKC,OKC,ATL,126,45.5,Pts+Rebs+Asts,44,38,36,14
Shai Gilgeous-Alexander,G,22023,1628983,22300155,"NOV 06, 2023",OKC vs. ATL,W,37,11,20,0.55,3,7,0.429,5,6,0.833,1,7,8,6,1,0,2,5,30,14,1,OKC,OKC,ATL,126,7.0,Assists,44,38,36,14
Shai Gilgeous-Alexander,G,22023,1628983,22300155,"NOV 06, 2023",OKC vs. ATL,W,37,11,20,0.55,3,7,0.429,5,6,0.833,1,7,8,6,1,0,2,5,30,14,1,OKC,OKC,ATL,126,53.0,Fantasy Score,44,38,36,14
Shai Gilgeous-Alexander,G,22023,1628983,22300155,"NOV 06, 2023",OKC vs. ATL,W,37,11,20,0.55,3,7,0.429,5,6,0.833,1,7,8,6,1,0,2,5,30,14,1,OKC,OKC,ATL,126,8.0,Free Throws Made,44,38,36,14
Shai Gilgeous-Alexander,G,22023,1628983,22300155,"NOV 06, 2023",OKC vs. ATL,W,37,11,20,0.55,3,7,0.429,5,6,0.833,1,7,8,6,1,0,2,5,30,14,1,OKC,OKC,ATL,126,20.5,FG Attempted,44,38,36,14
Shai Gilgeous-Alexander,G,22023,1628983,22300155,"NOV 06, 2023",OKC vs. ATL,W,37,11,20,0.55,3,7,0.429,5,6,0.833,1,7,8,6,1,0,2,5,30,14,1,OKC,OKC,ATL,126,37.5,Pts+Rebs,44,38,36,14
Shai Gilgeous-Alexander,G,22023,1628983,22300155,"NOV 06, 2023",OKC vs. ATL,W,37,11,20,0.55,3,7,0.429,5,6,0.833,1,7,8,6,1,0,2,5,30,14,1,OKC,OKC,ATL,126,0.5,Dunks,44,38,36,14
Shai Gilgeous-Alexander,G,22023,1628983,22300155,"NOV 06, 2023",OKC vs. ATL,W,37,11,20,0.55,3,7,0.429,5,6,0.833,1,7,8,6,1,0,2,5,30,14,1,OKC,OKC,ATL,126,38.5,Pts+Asts,44,38,36,14
Shai Gilgeous-Alexander,G,22023,1628983,22300155,"NOV 06, 2023",OKC vs. ATL,W,37,11,20,0.55,3,7,0.429,5,6,0.833,1,7,8,6,1,0,2,5,30,14,1,OKC,OKC,ATL,126,1.5,Steals,44,38,36,14
Shai Gilgeous-Alexander,G,22023,1628983,22300155,"NOV 06, 2023",OKC vs. ATL,W,37,11,20,0.55,3,7,0.429,5,6,0.833,1,7,8,6,1,0,2,5,30,14,1,OKC,OKC,ATL,126,13.0,Rebs+Asts,44,38,36,14
Shai Gilgeous-Alexander,G,22023,1628983,22300121,"NOV 01, 2023",OKC vs. NOP,L,38,8,20,0.4,0,5,0.0,4,5,0.8,0,5,5,8,3,0,2,2,20,1,1,OKC,OKC,NOP,106,31.5,Points,33,25,28,13
Shai Gilgeous-Alexander,G,22023,1628983,22300121,"NOV 01, 2023",OKC vs. NOP,L,38,8,20,0.4,0,5,0.0,4,5,0.8,0,5,5,8,3,0,2,2,20,1,1,OKC,OKC,NOP,106,6.0,Rebounds,33,25,28,13
Shai Gilgeous-Alexander,G,22023,1628983,22300121,"NOV 01, 2023",OKC vs. NOP,L,38,8,20,0.4,0,5,0.0,4,5,0.8,0,5,5,8,3,0,2,2,20,1,1,OKC,OKC,NOP,106,45.5,Pts+Rebs+Asts,33,25,28,13
Shai Gilgeous-Alexander,G,22023,1628983,22300121,"NOV 01, 2023",OKC vs. NOP,L,38,8,20,0.4,0,5,0.0,4,5,0.8,0,5,5,8,3,0,2,2,20,1,1,OKC,OKC,NOP,106,7.0,Assists,33,25,28,13
Shai Gilgeous-Alexander,G,22023,1628983,22300121,"NOV 01, 2023",OKC vs. NOP,L,38,8,20,0.4,0,5,0.0,4,5,0.8,0,5,5,8,3,0,2,2,20,1,1,OKC,OKC,NOP,106,53.0,Fantasy Score,33,25,28,13
Shai Gilgeous-Alexander,G,22023,1628983,22300121,"NOV 01, 2023",OKC vs. NOP,L,38,8,20,0.4,0,5,0.0,4,5,0.8,0,5,5,8,3,0,2,2,20,1,1,OKC,OKC,NOP,106,8.0,Free Throws Made,33,25,28,13
Shai Gilgeous-Alexander,G,22023,1628983,22300121,"NOV 01, 2023",OKC vs. NOP,L,38,8,20,0.4,0,5,0.0,4,5,0.8,0,5,5,8,3,0,2,2,20,1,1,OKC,OKC,NOP,106,20.5,FG Attempted,33,25,28,13
Shai Gilgeous-Alexander,G,22023,1628983,22300121,"NOV 01, 2023",OKC vs. NOP,L,38,8,20,0.4,0,5,0.0,4,5,0.8,0,5,5,8,3,0,2,2,20,1,1,OKC,OKC,NOP,106,37.5,Pts+Rebs,33,25,28,13
Shai Gilgeous-Alexander,G,22023,1628983,22300121,"NOV 01, 2023",OKC vs. NOP,L,38,8,20,0.4,0,5,0.0,4,5,0.8,0,5,5,8,3,0,2,2,20,1,1,OKC,OKC,NOP,106,0.5,Dunks,33,25,28,13
Shai Gilgeous-Alexander,G,22023,1628983,22300121,"NOV 01, 2023",OKC vs. NOP,L,38,8,20,0.4,0,5,0.0,4,5,0.8,0,5,5,8,3,0,2,2,20,1,1,OKC,OKC,NOP,106,38.5,Pts+Asts,33,25,28,13
Shai Gilgeous-Alexander,G,22023,1628983,22300121,"NOV 01, 2023",OKC vs. NOP,L,38,8,20,0.4,0,5,0.0,4,5,0.8,0,5,5,8,3,0,2,2,20,1,1,OKC,OKC,NOP,106,1.5,Steals,33,25,28,13
Shai Gilgeous-Alexander,G,22023,1628983,22300121,"NOV 01, 2023",OKC vs. NOP,L,38,8,20,0.4,0,5,0.0,4,5,0.8,0,5,5,8,3,0,2,2,20,1,1,OKC,OKC,NOP,106,13.0,Rebs+Asts,33,25,28,13
Shai Gilgeous-Alexander,G,22023,1628983,22300095,"OCT 29, 2023",OKC vs. DEN,L,28,2,16,0.125,0,4,0.0,3,4,0.75,1,3,4,7,1,0,0,2,7,-22,1,OKC,OKC,DEN,95,31.5,Points,18,11,14,11
Shai Gilgeous-Alexander,G,22023,1628983,22300095,"OCT 29, 2023",OKC vs. DEN,L,28,2,16,0.125,0,4,0.0,3,4,0.75,1,3,4,7,1,0,0,2,7,-22,1,OKC,OKC,DEN,95,6.0,Rebounds,18,11,14,11
Shai Gilgeous-Alexander,G,22023,1628983,22300095,"OCT 29, 2023",OKC vs. DEN,L,28,2,16,0.125,0,4,0.0,3,4,0.75,1,3,4,7,1,0,0,2,7,-22,1,OKC,OKC,DEN,95,45.5,Pts+Rebs+Asts,18,11,14,11
Shai Gilgeous-Alexander,G,22023,1628983,22300095,"OCT 29, 2023",OKC vs. DEN,L,28,2,16,0.125,0,4,0.0,3,4,0.75,1,3,4,7,1,0,0,2,7,-22,1,OKC,OKC,DEN,95,7.0,Assists,18,11,14,11
Shai Gilgeous-Alexander,G,22023,1628983,22300095,"OCT 29, 2023",OKC vs. DEN,L,28,2,16,0.125,0,4,0.0,3,4,0.75,1,3,4,7,1,0,0,2,7,-22,1,OKC,OKC,DEN,95,53.0,Fantasy Score,18,11,14,11
Shai Gilgeous-Alexander,G,22023,1628983,22300095,"OCT 29, 2023",OKC vs. DEN,L,28,2,16,0.125,0,4,0.0,3,4,0.75,1,3,4,7,1,0,0,2,7,-22,1,OKC,OKC,DEN,95,8.0,Free Throws Made,18,11,14,11
Shai Gilgeous-Alexander,G,22023,1628983,22300095,"OCT 29, 2023",OKC vs. DEN,L,28,2,16,0.125,0,4,0.0,3,4,0.75,1,3,4,7,1,0,0,2,7,-22,1,OKC,OKC,DEN,95,20.5,FG Attempted,18,11,14,11
Shai Gilgeous-Alexander,G,22023,1628983,22300095,"OCT 29, 2023",OKC vs. DEN,L,28,2,16,0.125,0,4,0.0,3,4,0.75,1,3,4,7,1,0,0,2,7,-22,1,OKC,OKC,DEN,95,37.5,Pts+Rebs,18,11,14,11
Shai Gilgeous-Alexander,G,22023,1628983,22300095,"OCT 29, 2023",OKC vs. DEN,L,28,2,16,0.125,0,4,0.0,3,4,0.75,1,3,4,7,1,0,0,2,7,-22,1,OKC,OKC,DEN,95,0.5,Dunks,18,11,14,11
Shai Gilgeous-Alexander,G,22023,1628983,22300095,"OCT 29, 2023",OKC vs. DEN,L,28,2,16,0.125,0,4,0.0,3,4,0.75,1,3,4,7,1,0,0,2,7,-22,1,OKC,OKC,DEN,95,38.5,Pts+Asts,18,11,14,11
Shai Gilgeous-Alexander,G,22023,1628983,22300095,"OCT 29, 2023",OKC vs. DEN,L,28,2,16,0.125,0,4,0.0,3,4,0.75,1,3,4,7,1,0,0,2,7,-22,1,OKC,OKC,DEN,95,1.5,Steals,18,11,14,11
Shai Gilgeous-Alexander,G,22023,1628983,22300095,"OCT 29, 2023",OKC vs. DEN,L,28,2,16,0.125,0,4,0.0,3,4,0.75,1,3,4,7,1,0,0,2,7,-22,1,OKC,OKC,DEN,95,13.0,Rebs+Asts,18,11,14,11
Shai Gilgeous-Alexander,G,22023,1628983,22300081,"OCT 27, 2023",OKC @ CLE,W,36,15,26,0.577,2,2,1.0,2,2,1.0,1,10,11,4,5,1,5,2,34,4,1,OKC,CLE,OKC,108,31.5,Points,49,45,38,15
Shai Gilgeous-Alexander,G,22023,1628983,22300081,"OCT 27, 2023",OKC @ CLE,W,36,15,26,0.577,2,2,1.0,2,2,1.0,1,10,11,4,5,1,5,2,34,4,1,OKC,CLE,OKC,108,6.0,Rebounds,49,45,38,15
Shai Gilgeous-Alexander,G,22023,1628983,22300081,"OCT 27, 2023",OKC @ CLE,W,36,15,26,0.577,2,2,1.0,2,2,1.0,1,10,11,4,5,1,5,2,34,4,1,OKC,CLE,OKC,108,45.5,Pts+Rebs+Asts,49,45,38,15
Shai Gilgeous-Alexander,G,22023,1628983,22300081,"OCT 27, 2023",OKC @ CLE,W,36,15,26,0.577,2,2,1.0,2,2,1.0,1,10,11,4,5,1,5,2,34,4,1,OKC,CLE,OKC,108,7.0,Assists,49,45,38,15
Shai Gilgeous-Alexander,G,22023,1628983,22300081,"OCT 27, 2023",OKC @ CLE,W,36,15,26,0.577,2,2,1.0,2,2,1.0,1,10,11,4,5,1,5,2,34,4,1,OKC,CLE,OKC,108,53.0,Fantasy Score,49,45,38,15
Shai Gilgeous-Alexander,G,22023,1628983,22300081,"OCT 27, 2023",OKC @ CLE,W,36,15,26,0.577,2,2,1.0,2,2,1.0,1,10,11,4,5,1,5,2,34,4,1,OKC,CLE,OKC,108,8.0,Free Throws Made,49,45,38,15
Shai Gilgeous-Alexander,G,22023,1628983,22300081,"OCT 27, 2023",OKC @ CLE,W,36,15,26,0.577,2,2,1.0,2,2,1.0,1,10,11,4,5,1,5,2,34,4,1,OKC,CLE,OKC,108,20.5,FG Attempted,49,45,38,15
Shai Gilgeous-Alexander,G,22023,1628983,22300081,"OCT 27, 2023",OKC @ CLE,W,36,15,26,0.577,2,2,1.0,2,2,1.0,1,10,11,4,5,1,5,2,34,4,1,OKC,CLE,OKC,108,37.5,Pts+Rebs,49,45,38,15
Shai Gilgeous-Alexander,G,22023,1628983,22300081,"OCT 27, 2023",OKC @ CLE,W,36,15,26,0.577,2,2,1.0,2,2,1.0,1,10,11,4,5,1,5,2,34,4,1,OKC,CLE,OKC,108,0.5,Dunks,49,45,38,15
Shai Gilgeous-Alexander,G,22023,1628983,22300081,"OCT 27, 2023",OKC @ CLE,W,36,15,26,0.577,2,2,1.0,2,2,1.0,1,10,11,4,5,1,5,2,34,4,1,OKC,CLE,OKC,108,38.5,Pts+Asts,49,45,38,15
Shai Gilgeous-Alexander,G,22023,1628983,22300081,"OCT 27, 2023",OKC @ CLE,W,36,15,26,0.577,2,2,1.0,2,2,1.0,1,10,11,4,5,1,5,2,34,4,1,OKC,CLE,OKC,108,1.5,Steals,49,45,38,15
Shai Gilgeous-Alexander,G,22023,1628983,22300081,"OCT 27, 2023",OKC @ CLE,W,36,15,26,0.577,2,2,1.0,2,2,1.0,1,10,11,4,5,1,5,2,34,4,1,OKC,CLE,OKC,108,13.0,Rebs+Asts,49,45,38,15
Shai Gilgeous-Alexander,G,22023,1628983,22300070,"OCT 25, 2023",OKC @ CHI,W,36,12,18,0.667,2,5,0.4,5,5,1.0,0,5,5,10,1,2,1,0,31,19,1,OKC,CHI,OKC,124,31.5,Points,46,36,41,15
Shai Gilgeous-Alexander,G,22023,1628983,22300070,"OCT 25, 2023",OKC @ CHI,W,36,12,18,0.667,2,5,0.4,5,5,1.0,0,5,5,10,1,2,1,0,31,19,1,OKC,CHI,OKC,124,6.0,Rebounds,46,36,41,15
Shai Gilgeous-Alexander,G,22023,1628983,22300070,"OCT 25, 2023",OKC @ CHI,W,36,12,18,0.667,2,5,0.4,5,5,1.0,0,5,5,10,1,2,1,0,31,19,1,OKC,CHI,OKC,124,45.5,Pts+Rebs+Asts,46,36,41,15
Shai Gilgeous-Alexander,G,22023,1628983,22300070,"OCT 25, 2023",OKC @ CHI,W,36,12,18,0.667,2,5,0.4,5,5,1.0,0,5,5,10,1,2,1,0,31,19,1,OKC,CHI,OKC,124,7.0,Assists,46,36,41,15
Shai Gilgeous-Alexander,G,22023,1628983,22300070,"OCT 25, 2023",OKC @ CHI,W,36,12,18,0.667,2,5,0.4,5,5,1.0,0,5,5,10,1,2,1,0,31,19,1,OKC,CHI,OKC,124,53.0,Fantasy Score,46,36,41,15
Shai Gilgeous-Alexander,G,22023,1628983,22300070,"OCT 25, 2023",OKC @ CHI,W,36,12,18,0.667,2,5,0.4,5,5,1.0,0,5,5,10,1,2,1,0,31,19,1,OKC,CHI,OKC,124,8.0,Free Throws Made,46,36,41,15
Shai Gilgeous-Alexander,G,22023,1628983,22300070,"OCT 25, 2023",OKC @ CHI,W,36,12,18,0.667,2,5,0.4,5,5,1.0,0,5,5,10,1,2,1,0,31,19,1,OKC,CHI,OKC,124,20.5,FG Attempted,46,36,41,15
Shai Gilgeous-Alexander,G,22023,1628983,22300070,"OCT 25, 2023",OKC @ CHI,W,36,12,18,0.667,2,5,0.4,5,5,1.0,0,5,5,10,1,2,1,0,31,19,1,OKC,CHI,OKC,124,37.5,Pts+Rebs,46,36,41,15
Shai Gilgeous-Alexander,G,22023,1628983,22300070,"OCT 25, 2023",OKC @ CHI,W,36,12,18,0.667,2,5,0.4,5,5,1.0,0,5,5,10,1,2,1,0,31,19,1,OKC,CHI,OKC,124,0.5,Dunks,46,36,41,15
Shai Gilgeous-Alexander,G,22023,1628983,22300070,"OCT 25, 2023",OKC @ CHI,W,36,12,18,0.667,2,5,0.4,5,5,1.0,0,5,5,10,1,2,1,0,31,19,1,OKC,CHI,OKC,124,38.5,Pts+Asts,46,36,41,15
Shai Gilgeous-Alexander,G,22023,1628983,22300070,"OCT 25, 2023",OKC @ CHI,W,36,12,18,0.667,2,5,0.4,5,5,1.0,0,5,5,10,1,2,1,0,31,19,1,OKC,CHI,OKC,124,1.5,Steals,46,36,41,15
Shai Gilgeous-Alexander,G,22023,1628983,22300070,"OCT 25, 2023",OKC @ CHI,W,36,12,18,0.667,2,5,0.4,5,5,1.0,0,5,5,10,1,2,1,0,31,19,1,OKC,CHI,OKC,124,13.0,Rebs+Asts,46,36,41,15
Shai Gilgeous-Alexander,G,22023,1628983,22300664,"JAN 29, 2024",OKC vs. MIN,L,39,10,18,0.556,2,3,0.667,15,16,0.938,2,5,7,8,2,0,4,2,37,5,1,OKC,OKC,MIN,101,31.5,Points,52,44,45,15
Shai Gilgeous-Alexander,G,22023,1628983,22300664,"JAN 29, 2024",OKC vs. MIN,L,39,10,18,0.556,2,3,0.667,15,16,0.938,2,5,7,8,2,0,4,2,37,5,1,OKC,OKC,MIN,101,6.0,Rebounds,52,44,45,15
Shai Gilgeous-Alexander,G,22023,1628983,22300664,"JAN 29, 2024",OKC vs. MIN,L,39,10,18,0.556,2,3,0.667,15,16,0.938,2,5,7,8,2,0,4,2,37,5,1,OKC,OKC,MIN,101,45.5,Pts+Rebs+Asts,52,44,45,15
Shai Gilgeous-Alexander,G,22023,1628983,22300664,"JAN 29, 2024",OKC vs. MIN,L,39,10,18,0.556,2,3,0.667,15,16,0.938,2,5,7,8,2,0,4,2,37,5,1,OKC,OKC,MIN,101,7.0,Assists,52,44,45,15
Shai Gilgeous-Alexander,G,22023,1628983,22300664,"JAN 29, 2024",OKC vs. MIN,L,39,10,18,0.556,2,3,0.667,15,16,0.938,2,5,7,8,2,0,4,2,37,5,1,OKC,OKC,MIN,101,53.0,Fantasy Score,52,44,45,15
Shai Gilgeous-Alexander,G,22023,1628983,22300664,"JAN 29, 2024",OKC vs. MIN,L,39,10,18,0.556,2,3,0.667,15,16,0.938,2,5,7,8,2,0,4,2,37,5,1,OKC,OKC,MIN,101,8.0,Free Throws Made,52,44,45,15
Shai Gilgeous-Alexander,G,22023,1628983,22300664,"JAN 29, 2024",OKC vs. MIN,L,39,10,18,0.556,2,3,0.667,15,16,0.938,2,5,7,8,2,0,4,2,37,5,1,OKC,OKC,MIN,101,20.5,FG Attempted,52,44,45,15
Shai Gilgeous-Alexander,G,22023,1628983,22300664,"JAN 29, 2024",OKC vs. MIN,L,39,10,18,0.556,2,3,0.667,15,16,0.938,2,5,7,8,2,0,4,2,37,5,1,OKC,OKC,MIN,101,37.5,Pts+Rebs,52,44,45,15
Shai Gilgeous-Alexander,G,22023,1628983,22300664,"JAN 29, 2024",OKC vs. MIN,L,39,10,18,0.556,2,3,0.667,15,16,0.938,2,5,7,8,2,0,4,2,37,5,1,OKC,OKC,MIN,101,0.5,Dunks,52,44,45,15
Shai Gilgeous-Alexander,G,22023,1628983,22300664,"JAN 29, 2024",OKC vs. MIN,L,39,10,18,0.556,2,3,0.667,15,16,0.938,2,5,7,8,2,0,4,2,37,5,1,OKC,OKC,MIN,101,38.5,Pts+Asts,52,44,45,15
Shai Gilgeous-Alexander,G,22023,1628983,22300664,"JAN 29, 2024",OKC vs. MIN,L,39,10,18,0.556,2,3,0.667,15,16,0.938,2,5,7,8,2,0,4,2,37,5,1,OKC,OKC,MIN,101,1.5,Steals,52,44,45,15
Shai Gilgeous-Alexander,G,22023,1628983,22300664,"JAN 29, 2024",OKC vs. MIN,L,39,10,18,0.556,2,3,0.667,15,16,0.938,2,5,7,8,2,0,4,2,37,5,1,OKC,OKC,MIN,101,13.0,Rebs+Asts,52,44,45,15
Shai Gilgeous-Alexander,G,22023,1628983,22300654,"JAN 28, 2024",OKC @ DET,L,29,13,20,0.65,1,1,1.0,4,5,0.8,3,2,5,4,1,0,3,3,31,-6,1,OKC,DET,OKC,104,31.5,Points,40,36,35,9
Shai Gilgeous-Alexander,G,22023,1628983,22300654,"JAN 28, 2024",OKC @ DET,L,29,13,20,0.65,1,1,1.0,4,5,0.8,3,2,5,4,1,0,3,3,31,-6,1,OKC,DET,OKC,104,6.0,Rebounds,40,36,35,9
Shai Gilgeous-Alexander,G,22023,1628983,22300654,"JAN 28, 2024",OKC @ DET,L,29,13,20,0.65,1,1,1.0,4,5,0.8,3,2,5,4,1,0,3,3,31,-6,1,OKC,DET,OKC,104,45.5,Pts+Rebs+Asts,40,36,35,9
Shai Gilgeous-Alexander,G,22023,1628983,22300654,"JAN 28, 2024",OKC @ DET,L,29,13,20,0.65,1,1,1.0,4,5,0.8,3,2,5,4,1,0,3,3,31,-6,1,OKC,DET,OKC,104,7.0,Assists,40,36,35,9
Shai Gilgeous-Alexander,G,22023,1628983,22300654,"JAN 28, 2024",OKC @ DET,L,29,13,20,0.65,1,1,1.0,4,5,0.8,3,2,5,4,1,0,3,3,31,-6,1,OKC,DET,OKC,104,53.0,Fantasy Score,40,36,35,9
Shai Gilgeous-Alexander,G,22023,1628983,22300654,"JAN 28, 2024",OKC @ DET,L,29,13,20,0.65,1,1,1.0,4,5,0.8,3,2,5,4,1,0,3,3,31,-6,1,OKC,DET,OKC,104,8.0,Free Throws Made,40,36,35,9
Shai Gilgeous-Alexander,G,22023,1628983,22300654,"JAN 28, 2024",OKC @ DET,L,29,13,20,0.65,1,1,1.0,4,5,0.8,3,2,5,4,1,0,3,3,31,-6,1,OKC,DET,OKC,104,20.5,FG Attempted,40,36,35,9
Shai Gilgeous-Alexander,G,22023,1628983,22300654,"JAN 28, 2024",OKC @ DET,L,29,13,20,0.65,1,1,1.0,4,5,0.8,3,2,5,4,1,0,3,3,31,-6,1,OKC,DET,OKC,104,37.5,Pts+Rebs,40,36,35,9
Shai Gilgeous-Alexander,G,22023,1628983,22300654,"JAN 28, 2024",OKC @ DET,L,29,13,20,0.65,1,1,1.0,4,5,0.8,3,2,5,4,1,0,3,3,31,-6,1,OKC,DET,OKC,104,0.5,Dunks,40,36,35,9
Shai Gilgeous-Alexander,G,22023,1628983,22300654,"JAN 28, 2024",OKC @ DET,L,29,13,20,0.65,1,1,1.0,4,5,0.8,3,2,5,4,1,0,3,3,31,-6,1,OKC,DET,OKC,104,38.5,Pts+Asts,40,36,35,9
Shai Gilgeous-Alexander,G,22023,1628983,22300654,"JAN 28, 2024",OKC @ DET,L,29,13,20,0.65,1,1,1.0,4,5,0.8,3,2,5,4,1,0,3,3,31,-6,1,OKC,DET,OKC,104,1.5,Steals,40,36,35,9
Shai Gilgeous-Alexander,G,22023,1628983,22300654,"JAN 28, 2024",OKC @ DET,L,29,13,20,0.65,1,1,1.0,4,5,0.8,3,2,5,4,1,0,3,3,31,-6,1,OKC,DET,OKC,104,13.0,Rebs+Asts,40,36,35,9
Shai Gilgeous-Alexander,G,22023,1628983,22300640,"JAN 26, 2024",OKC @ NOP,W,32,10,21,0.476,3,8,0.375,8,9,0.889,0,4,4,5,2,1,4,0,31,12,1,OKC,NOP,OKC,107,31.5,Points,40,35,36,9
Shai Gilgeous-Alexander,G,22023,1628983,22300640,"JAN 26, 2024",OKC @ NOP,W,32,10,21,0.476,3,8,0.375,8,9,0.889,0,4,4,5,2,1,4,0,31,12,1,OKC,NOP,OKC,107,6.0,Rebounds,40,35,36,9
Shai Gilgeous-Alexander,G,22023,1628983,22300640,"JAN 26, 2024",OKC @ NOP,W,32,10,21,0.476,3,8,0.375,8,9,0.889,0,4,4,5,2,1,4,0,31,12,1,OKC,NOP,OKC,107,45.5,Pts+Rebs+Asts,40,35,36,9
Shai Gilgeous-Alexander,G,22023,1628983,22300640,"JAN 26, 2024",OKC @ NOP,W,32,10,21,0.476,3,8,0.375,8,9,0.889,0,4,4,5,2,1,4,0,31,12,1,OKC,NOP,OKC,107,7.0,Assists,40,35,36,9
Shai Gilgeous-Alexander,G,22023,1628983,22300640,"JAN 26, 2024",OKC @ NOP,W,32,10,21,0.476,3,8,0.375,8,9,0.889,0,4,4,5,2,1,4,0,31,12,1,OKC,NOP,OKC,107,53.0,Fantasy Score,40,35,36,9
Shai Gilgeous-Alexander,G,22023,1628983,22300640,"JAN 26, 2024",OKC @ NOP,W,32,10,21,0.476,3,8,0.375,8,9,0.889,0,4,4,5,2,1,4,0,31,12,1,OKC,NOP,OKC,107,8.0,Free Throws Made,40,35,36,9
Shai Gilgeous-Alexander,G,22023,1628983,22300640,"JAN 26, 2024",OKC @ NOP,W,32,10,21,0.476,3,8,0.375,8,9,0.889,0,4,4,5,2,1,4,0,31,12,1,OKC,NOP,OKC,107,20.5,FG Attempted,40,35,36,9
Shai Gilgeous-Alexander,G,22023,1628983,22300640,"JAN 26, 2024",OKC @ NOP,W,32,10,21,0.476,3,8,0.375,8,9,0.889,0,4,4,5,2,1,4,0,31,12,1,OKC,NOP,OKC,107,37.5,Pts+Rebs,40,35,36,9
Shai Gilgeous-Alexander,G,22023,1628983,22300640,"JAN 26, 2024",OKC @ NOP,W,32,10,21,0.476,3,8,0.375,8,9,0.889,0,4,4,5,2,1,4,0,31,12,1,OKC,NOP,OKC,107,0.5,Dunks,40,35,36,9
Shai Gilgeous-Alexander,G,22023,1628983,22300640,"JAN 26, 2024",OKC @ NOP,W,32,10,21,0.476,3,8,0.375,8,9,0.889,0,4,4,5,2,1,4,0,31,12,1,OKC,NOP,OKC,107,38.5,Pts+Asts,40,35,36,9
Shai Gilgeous-Alexander,G,22023,1628983,22300640,"JAN 26, 2024",OKC @ NOP,W,32,10,21,0.476,3,8,0.375,8,9,0.889,0,4,4,5,2,1,4,0,31,12,1,OKC,NOP,OKC,107,1.5,Steals,40,35,36,9
Shai Gilgeous-Alexander,G,22023,1628983,22300640,"JAN 26, 2024",OKC @ NOP,W,32,10,21,0.476,3,8,0.375,8,9,0.889,0,4,4,5,2,1,4,0,31,12,1,OKC,NOP,OKC,107,13.0,Rebs+Asts,40,35,36,9
Shai Gilgeous-Alexander,G,22023,1628983,22300599,"JAN 20, 2024",OKC @ MIN,W,37,10,22,0.455,1,2,0.5,12,13,0.923,1,1,2,6,2,0,2,0,33,14,1,OKC,MIN,OKC,102,31.5,Points,41,35,39,8
Shai Gilgeous-Alexander,G,22023,1628983,22300599,"JAN 20, 2024",OKC @ MIN,W,37,10,22,0.455,1,2,0.5,12,13,0.923,1,1,2,6,2,0,2,0,33,14,1,OKC,MIN,OKC,102,6.0,Rebounds,41,35,39,8
Shai Gilgeous-Alexander,G,22023,1628983,22300599,"JAN 20, 2024",OKC @ MIN,W,37,10,22,0.455,1,2,0.5,12,13,0.923,1,1,2,6,2,0,2,0,33,14,1,OKC,MIN,OKC,102,45.5,Pts+Rebs+Asts,41,35,39,8
Shai Gilgeous-Alexander,G,22023,1628983,22300599,"JAN 20, 2024",OKC @ MIN,W,37,10,22,0.455,1,2,0.5,12,13,0.923,1,1,2,6,2,0,2,0,33,14,1,OKC,MIN,OKC,102,7.0,Assists,41,35,39,8
Shai Gilgeous-Alexander,G,22023,1628983,22300599,"JAN 20, 2024",OKC @ MIN,W,37,10,22,0.455,1,2,0.5,12,13,0.923,1,1,2,6,2,0,2,0,33,14,1,OKC,MIN,OKC,102,53.0,Fantasy Score,41,35,39,8
Shai Gilgeous-Alexander,G,22023,1628983,22300599,"JAN 20, 2024",OKC @ MIN,W,37,10,22,0.455,1,2,0.5,12,13,0.923,1,1,2,6,2,0,2,0,33,14,1,OKC,MIN,OKC,102,8.0,Free Throws Made,41,35,39,8
Shai Gilgeous-Alexander,G,22023,1628983,22300599,"JAN 20, 2024",OKC @ MIN,W,37,10,22,0.455,1,2,0.5,12,13,0.923,1,1,2,6,2,0,2,0,33,14,1,OKC,MIN,OKC,102,20.5,FG Attempted,41,35,39,8
Shai Gilgeous-Alexander,G,22023,1628983,22300599,"JAN 20, 2024",OKC @ MIN,W,37,10,22,0.455,1,2,0.5,12,13,0.923,1,1,2,6,2,0,2,0,33,14,1,OKC,MIN,OKC,102,37.5,Pts+Rebs,41,35,39,8
Shai Gilgeous-Alexander,G,22023,1628983,22300599,"JAN 20, 2024",OKC @ MIN,W,37,10,22,0.455,1,2,0.5,12,13,0.923,1,1,2,6,2,0,2,0,33,14,1,OKC,MIN,OKC,102,0.5,Dunks,41,35,39,8
Shai Gilgeous-Alexander,G,22023,1628983,22300599,"JAN 20, 2024",OKC @ MIN,W,37,10,22,0.455,1,2,0.5,12,13,0.923,1,1,2,6,2,0,2,0,33,14,1,OKC,MIN,OKC,102,38.5,Pts+Asts,41,35,39,8
Shai Gilgeous-Alexander,G,22023,1628983,22300599,"JAN 20, 2024",OKC @ MIN,W,37,10,22,0.455,1,2,0.5,12,13,0.923,1,1,2,6,2,0,2,0,33,14,1,OKC,MIN,OKC,102,1.5,Steals,41,35,39,8
Shai Gilgeous-Alexander,G,22023,1628983,22300599,"JAN 20, 2024",OKC @ MIN,W,37,10,22,0.455,1,2,0.5,12,13,0.923,1,1,2,6,2,0,2,0,33,14,1,OKC,MIN,OKC,102,13.0,Rebs+Asts,41,35,39,8
Shai Gilgeous-Alexander,G,22023,1628983,22300522,"JAN 10, 2024",OKC @ MIA,W,34,11,17,0.647,2,5,0.4,4,5,0.8,0,2,2,8,1,1,3,3,28,-3,1,OKC,MIA,OKC,128,31.5,Points,38,30,36,10
Shai Gilgeous-Alexander,G,22023,1628983,22300522,"JAN 10, 2024",OKC @ MIA,W,34,11,17,0.647,2,5,0.4,4,5,0.8,0,2,2,8,1,1,3,3,28,-3,1,OKC,MIA,OKC,128,6.0,Rebounds,38,30,36,10
Shai Gilgeous-Alexander,G,22023,1628983,22300522,"JAN 10, 2024",OKC @ MIA,W,34,11,17,0.647,2,5,0.4,4,5,0.8,0,2,2,8,1,1,3,3,28,-3,1,OKC,MIA,OKC,128,45.5,Pts+Rebs+Asts,38,30,36,10
Shai Gilgeous-Alexander,G,22023,1628983,22300522,"JAN 10, 2024",OKC @ MIA,W,34,11,17,0.647,2,5,0.4,4,5,0.8,0,2,2,8,1,1,3,3,28,-3,1,OKC,MIA,OKC,128,7.0,Assists,38,30,36,10
Shai Gilgeous-Alexander,G,22023,1628983,22300522,"JAN 10, 2024",OKC @ MIA,W,34,11,17,0.647,2,5,0.4,4,5,0.8,0,2,2,8,1,1,3,3,28,-3,1,OKC,MIA,OKC,128,53.0,Fantasy Score,38,30,36,10
Shai Gilgeous-Alexander,G,22023,1628983,22300522,"JAN 10, 2024",OKC @ MIA,W,34,11,17,0.647,2,5,0.4,4,5,0.8,0,2,2,8,1,1,3,3,28,-3,1,OKC,MIA,OKC,128,8.0,Free Throws Made,38,30,36,10
Shai Gilgeous-Alexander,G,22023,1628983,22300522,"JAN 10, 2024",OKC @ MIA,W,34,11,17,0.647,2,5,0.4,4,5,0.8,0,2,2,8,1,1,3,3,28,-3,1,OKC,MIA,OKC,128,20.5,FG Attempted,38,30,36,10
Shai Gilgeous-Alexander,G,22023,1628983,22300522,"JAN 10, 2024",OKC @ MIA,W,34,11,17,0.647,2,5,0.4,4,5,0.8,0,2,2,8,1,1,3,3,28,-3,1,OKC,MIA,OKC,128,37.5,Pts+Rebs,38,30,36,10
Shai Gilgeous-Alexander,G,22023,1628983,22300522,"JAN 10, 2024",OKC @ MIA,W,34,11,17,0.647,2,5,0.4,4,5,0.8,0,2,2,8,1,1,3,3,28,-3,1,OKC,MIA,OKC,128,0.5,Dunks,38,30,36,10
Shai Gilgeous-Alexander,G,22023,1628983,22300522,"JAN 10, 2024",OKC @ MIA,W,34,11,17,0.647,2,5,0.4,4,5,0.8,0,2,2,8,1,1,3,3,28,-3,1,OKC,MIA,OKC,128,38.5,Pts+Asts,38,30,36,10
Shai Gilgeous-Alexander,G,22023,1628983,22300522,"JAN 10, 2024",OKC @ MIA,W,34,11,17,0.647,2,5,0.4,4,5,0.8,0,2,2,8,1,1,3,3,28,-3,1,OKC,MIA,OKC,128,1.5,Steals,38,30,36,10
Shai Gilgeous-Alexander,G,22023,1628983,22300522,"JAN 10, 2024",OKC @ MIA,W,34,11,17,0.647,2,5,0.4,4,5,0.8,0,2,2,8,1,1,3,3,28,-3,1,OKC,MIA,OKC,128,13.0,Rebs+Asts,38,30,36,10
Shai Gilgeous-Alexander,G,22023,1628983,22300508,"JAN 08, 2024",OKC @ WAS,W,36,11,17,0.647,2,3,0.667,8,10,0.8,1,5,6,5,3,1,3,5,32,3,1,OKC,WAS,OKC,136,31.5,Points,43,38,37,11
Shai Gilgeous-Alexander,G,22023,1628983,22300508,"JAN 08, 2024",OKC @ WAS,W,36,11,17,0.647,2,3,0.667,8,10,0.8,1,5,6,5,3,1,3,5,32,3,1,OKC,WAS,OKC,136,6.0,Rebounds,43,38,37,11
Shai Gilgeous-Alexander,G,22023,1628983,22300508,"JAN 08, 2024",OKC @ WAS,W,36,11,17,0.647,2,3,0.667,8,10,0.8,1,5,6,5,3,1,3,5,32,3,1,OKC,WAS,OKC,136,45.5,Pts+Rebs+Asts,43,38,37,11
Shai Gilgeous-Alexander,G,22023,1628983,22300508,"JAN 08, 2024",OKC @ WAS,W,36,11,17,0.647,2,3,0.667,8,10,0.8,1,5,6,5,3,1,3,5,32,3,1,OKC,WAS,OKC,136,7.0,Assists,43,38,37,11
Shai Gilgeous-Alexander,G,22023,1628983,22300508,"JAN 08, 2024",OKC @ WAS,W,36,11,17,0.647,2,3,0.667,8,10,0.8,1,5,6,5,3,1,3,5,32,3,1,OKC,WAS,OKC,136,53.0,Fantasy Score,43,38,37,11
Shai Gilgeous-Alexander,G,22023,1628983,22300508,"JAN 08, 2024",OKC @ WAS,W,36,11,17,0.647,2,3,0.667,8,10,0.8,1,5,6,5,3,1,3,5,32,3,1,OKC,WAS,OKC,136,8.0,Free Throws Made,43,38,37,11
Shai Gilgeous-Alexander,G,22023,1628983,22300508,"JAN 08, 2024",OKC @ WAS,W,36,11,17,0.647,2,3,0.667,8,10,0.8,1,5,6,5,3,1,3,5,32,3,1,OKC,WAS,OKC,136,20.5,FG Attempted,43,38,37,11
Shai Gilgeous-Alexander,G,22023,1628983,22300508,"JAN 08, 2024",OKC @ WAS,W,36,11,17,0.647,2,3,0.667,8,10,0.8,1,5,6,5,3,1,3,5,32,3,1,OKC,WAS,OKC,136,37.5,Pts+Rebs,43,38,37,11
Shai Gilgeous-Alexander,G,22023,1628983,22300508,"JAN 08, 2024",OKC @ WAS,W,36,11,17,0.647,2,3,0.667,8,10,0.8,1,5,6,5,3,1,3,5,32,3,1,OKC,WAS,OKC,136,0.5,Dunks,43,38,37,11
Shai Gilgeous-Alexander,G,22023,1628983,22300508,"JAN 08, 2024",OKC @ WAS,W,36,11,17,0.647,2,3,0.667,8,10,0.8,1,5,6,5,3,1,3,5,32,3,1,OKC,WAS,OKC,136,38.5,Pts+Asts,43,38,37,11
Shai Gilgeous-Alexander,G,22023,1628983,22300508,"JAN 08, 2024",OKC @ WAS,W,36,11,17,0.647,2,3,0.667,8,10,0.8,1,5,6,5,3,1,3,5,32,3,1,OKC,WAS,OKC,136,1.5,Steals,43,38,37,11
Shai Gilgeous-Alexander,G,22023,1628983,22300508,"JAN 08, 2024",OKC @ WAS,W,36,11,17,0.647,2,3,0.667,8,10,0.8,1,5,6,5,3,1,3,5,32,3,1,OKC,WAS,OKC,136,13.0,Rebs+Asts,43,38,37,11
Shai Gilgeous-Alexander,G,22023,1628983,22300467,"JAN 03, 2024",OKC @ ATL,L,35,11,24,0.458,2,3,0.667,9,11,0.818,1,12,13,8,0,0,2,2,33,2,1,OKC,ATL,OKC,138,31.5,Points,54,46,41,21
Shai Gilgeous-Alexander,G,22023,1628983,22300467,"JAN 03, 2024",OKC @ ATL,L,35,11,24,0.458,2,3,0.667,9,11,0.818,1,12,13,8,0,0,2,2,33,2,1,OKC,ATL,OKC,138,6.0,Rebounds,54,46,41,21
Shai Gilgeous-Alexander,G,22023,1628983,22300467,"JAN 03, 2024",OKC @ ATL,L,35,11,24,0.458,2,3,0.667,9,11,0.818,1,12,13,8,0,0,2,2,33,2,1,OKC,ATL,OKC,138,45.5,Pts+Rebs+Asts,54,46,41,21
Shai Gilgeous-Alexander,G,22023,1628983,22300467,"JAN 03, 2024",OKC @ ATL,L,35,11,24,0.458,2,3,0.667,9,11,0.818,1,12,13,8,0,0,2,2,33,2,1,OKC,ATL,OKC,138,7.0,Assists,54,46,41,21
Shai Gilgeous-Alexander,G,22023,1628983,22300467,"JAN 03, 2024",OKC @ ATL,L,35,11,24,0.458,2,3,0.667,9,11,0.818,1,12,13,8,0,0,2,2,33,2,1,OKC,ATL,OKC,138,53.0,Fantasy Score,54,46,41,21
Shai Gilgeous-Alexander,G,22023,1628983,22300467,"JAN 03, 2024",OKC @ ATL,L,35,11,24,0.458,2,3,0.667,9,11,0.818,1,12,13,8,0,0,2,2,33,2,1,OKC,ATL,OKC,138,8.0,Free Throws Made,54,46,41,21
Shai Gilgeous-Alexander,G,22023,1628983,22300467,"JAN 03, 2024",OKC @ ATL,L,35,11,24,0.458,2,3,0.667,9,11,0.818,1,12,13,8,0,0,2,2,33,2,1,OKC,ATL,OKC,138,20.5,FG Attempted,54,46,41,21
Shai Gilgeous-Alexander,G,22023,1628983,22300467,"JAN 03, 2024",OKC @ ATL,L,35,11,24,0.458,2,3,0.667,9,11,0.818,1,12,13,8,0,0,2,2,33,2,1,OKC,ATL,OKC,138,37.5,Pts+Rebs,54,46,41,21
Shai Gilgeous-Alexander,G,22023,1628983,22300467,"JAN 03, 2024",OKC @ ATL,L,35,11,24,0.458,2,3,0.667,9,11,0.818,1,12,13,8,0,0,2,2,33,2,1,OKC,ATL,OKC,138,0.5,Dunks,54,46,41,21
Shai Gilgeous-Alexander,G,22023,1628983,22300467,"JAN 03, 2024",OKC @ ATL,L,35,11,24,0.458,2,3,0.667,9,11,0.818,1,12,13,8,0,0,2,2,33,2,1,OKC,ATL,OKC,138,38.5,Pts+Asts,54,46,41,21
Shai Gilgeous-Alexander,G,22023,1628983,22300467,"JAN 03, 2024",OKC @ ATL,L,35,11,24,0.458,2,3,0.667,9,11,0.818,1,12,13,8,0,0,2,2,33,2,1,OKC,ATL,OKC,138,1.5,Steals,54,46,41,21
Shai Gilgeous-Alexander,G,22023,1628983,22300467,"JAN 03, 2024",OKC @ ATL,L,35,11,24,0.458,2,3,0.667,9,11,0.818,1,12,13,8,0,0,2,2,33,2,1,OKC,ATL,OKC,138,13.0,Rebs+Asts,54,46,41,21
Shai Gilgeous-Alexander,G,22023,1628983,22300462,"JAN 02, 2024",OKC vs. BOS,W,37,14,22,0.636,3,5,0.6,5,8,0.625,0,6,6,7,1,0,0,5,36,3,1,OKC,OKC,BOS,127,31.5,Points,49,42,43,13
Shai Gilgeous-Alexander,G,22023,1628983,22300462,"JAN 02, 2024",OKC vs. BOS,W,37,14,22,0.636,3,5,0.6,5,8,0.625,0,6,6,7,1,0,0,5,36,3,1,OKC,OKC,BOS,127,6.0,Rebounds,49,42,43,13
Shai Gilgeous-Alexander,G,22023,1628983,22300462,"JAN 02, 2024",OKC vs. BOS,W,37,14,22,0.636,3,5,0.6,5,8,0.625,0,6,6,7,1,0,0,5,36,3,1,OKC,OKC,BOS,127,45.5,Pts+Rebs+Asts,49,42,43,13
Shai Gilgeous-Alexander,G,22023,1628983,22300462,"JAN 02, 2024",OKC vs. BOS,W,37,14,22,0.636,3,5,0.6,5,8,0.625,0,6,6,7,1,0,0,5,36,3,1,OKC,OKC,BOS,127,7.0,Assists,49,42,43,13
Shai Gilgeous-Alexander,G,22023,1628983,22300462,"JAN 02, 2024",OKC vs. BOS,W,37,14,22,0.636,3,5,0.6,5,8,0.625,0,6,6,7,1,0,0,5,36,3,1,OKC,OKC,BOS,127,53.0,Fantasy Score,49,42,43,13
Shai Gilgeous-Alexander,G,22023,1628983,22300462,"JAN 02, 2024",OKC vs. BOS,W,37,14,22,0.636,3,5,0.6,5,8,0.625,0,6,6,7,1,0,0,5,36,3,1,OKC,OKC,BOS,127,8.0,Free Throws Made,49,42,43,13
Shai Gilgeous-Alexander,G,22023,1628983,22300462,"JAN 02, 2024",OKC vs. BOS,W,37,14,22,0.636,3,5,0.6,5,8,0.625,0,6,6,7,1,0,0,5,36,3,1,OKC,OKC,BOS,127,20.5,FG Attempted,49,42,43,13
Shai Gilgeous-Alexander,G,22023,1628983,22300462,"JAN 02, 2024",OKC vs. BOS,W,37,14,22,0.636,3,5,0.6,5,8,0.625,0,6,6,7,1,0,0,5,36,3,1,OKC,OKC,BOS,127,37.5,Pts+Rebs,49,42,43,13
Shai Gilgeous-Alexander,G,22023,1628983,22300462,"JAN 02, 2024",OKC vs. BOS,W,37,14,22,0.636,3,5,0.6,5,8,0.625,0,6,6,7,1,0,0,5,36,3,1,OKC,OKC,BOS,127,0.5,Dunks,49,42,43,13
Shai Gilgeous-Alexander,G,22023,1628983,22300462,"JAN 02, 2024",OKC vs. BOS,W,37,14,22,0.636,3,5,0.6,5,8,0.625,0,6,6,7,1,0,0,5,36,3,1,OKC,OKC,BOS,127,38.5,Pts+Asts,49,42,43,13
Shai Gilgeous-Alexander,G,22023,1628983,22300462,"JAN 02, 2024",OKC vs. BOS,W,37,14,22,0.636,3,5,0.6,5,8,0.625,0,6,6,7,1,0,0,5,36,3,1,OKC,OKC,BOS,127,1.5,Steals,49,42,43,13
Shai Gilgeous-Alexander,G,22023,1628983,22300462,"JAN 02, 2024",OKC vs. BOS,W,37,14,22,0.636,3,5,0.6,5,8,0.625,0,6,6,7,1,0,0,5,36,3,1,OKC,OKC,BOS,127,13.0,Rebs+Asts,49,42,43,13
Shai Gilgeous-Alexander,G,22023,1628983,22300447,"DEC 31, 2023",OKC vs. BKN,W,35,7,15,0.467,1,2,0.5,9,9,1.0,0,4,4,6,0,0,1,2,24,9,1,OKC,OKC,BKN,124,31.5,Points,34,28,30,10
Shai Gilgeous-Alexander,G,22023,1628983,22300447,"DEC 31, 2023",OKC vs. BKN,W,35,7,15,0.467,1,2,0.5,9,9,1.0,0,4,4,6,0,0,1,2,24,9,1,OKC,OKC,BKN,124,6.0,Rebounds,34,28,30,10
Shai Gilgeous-Alexander,G,22023,1628983,22300447,"DEC 31, 2023",OKC vs. BKN,W,35,7,15,0.467,1,2,0.5,9,9,1.0,0,4,4,6,0,0,1,2,24,9,1,OKC,OKC,BKN,124,45.5,Pts+Rebs+Asts,34,28,30,10
Shai Gilgeous-Alexander,G,22023,1628983,22300447,"DEC 31, 2023",OKC vs. BKN,W,35,7,15,0.467,1,2,0.5,9,9,1.0,0,4,4,6,0,0,1,2,24,9,1,OKC,OKC,BKN,124,7.0,Assists,34,28,30,10
Shai Gilgeous-Alexander,G,22023,1628983,22300447,"DEC 31, 2023",OKC vs. BKN,W,35,7,15,0.467,1,2,0.5,9,9,1.0,0,4,4,6,0,0,1,2,24,9,1,OKC,OKC,BKN,124,53.0,Fantasy Score,34,28,30,10
Shai Gilgeous-Alexander,G,22023,1628983,22300447,"DEC 31, 2023",OKC vs. BKN,W,35,7,15,0.467,1,2,0.5,9,9,1.0,0,4,4,6,0,0,1,2,24,9,1,OKC,OKC,BKN,124,8.0,Free Throws Made,34,28,30,10
Shai Gilgeous-Alexander,G,22023,1628983,22300447,"DEC 31, 2023",OKC vs. BKN,W,35,7,15,0.467,1,2,0.5,9,9,1.0,0,4,4,6,0,0,1,2,24,9,1,OKC,OKC,BKN,124,20.5,FG Attempted,34,28,30,10
Shai Gilgeous-Alexander,G,22023,1628983,22300447,"DEC 31, 2023",OKC vs. BKN,W,35,7,15,0.467,1,2,0.5,9,9,1.0,0,4,4,6,0,0,1,2,24,9,1,OKC,OKC,BKN,124,37.5,Pts+Rebs,34,28,30,10
Shai Gilgeous-Alexander,G,22023,1628983,22300447,"DEC 31, 2023",OKC vs. BKN,W,35,7,15,0.467,1,2,0.5,9,9,1.0,0,4,4,6,0,0,1,2,24,9,1,OKC,OKC,BKN,124,0.5,Dunks,34,28,30,10
Shai Gilgeous-Alexander,G,22023,1628983,22300447,"DEC 31, 2023",OKC vs. BKN,W,35,7,15,0.467,1,2,0.5,9,9,1.0,0,4,4,6,0,0,1,2,24,9,1,OKC,OKC,BKN,124,38.5,Pts+Asts,34,28,30,10
Shai Gilgeous-Alexander,G,22023,1628983,22300447,"DEC 31, 2023",OKC vs. BKN,W,35,7,15,0.467,1,2,0.5,9,9,1.0,0,4,4,6,0,0,1,2,24,9,1,OKC,OKC,BKN,124,1.5,Steals,34,28,30,10
Shai Gilgeous-Alexander,G,22023,1628983,22300447,"DEC 31, 2023",OKC vs. BKN,W,35,7,15,0.467,1,2,0.5,9,9,1.0,0,4,4,6,0,0,1,2,24,9,1,OKC,OKC,BKN,124,13.0,Rebs+Asts,34,28,30,10
Shai Gilgeous-Alexander,G,22023,1628983,22300435,"DEC 29, 2023",OKC @ DEN,W,33,14,20,0.7,2,3,0.667,10,10,1.0,0,4,4,3,2,1,1,3,40,21,1,OKC,DEN,OKC,119,31.5,Points,47,44,43,7
Shai Gilgeous-Alexander,G,22023,1628983,22300435,"DEC 29, 2023",OKC @ DEN,W,33,14,20,0.7,2,3,0.667,10,10,1.0,0,4,4,3,2,1,1,3,40,21,1,OKC,DEN,OKC,119,6.0,Rebounds,47,44,43,7
Shai Gilgeous-Alexander,G,22023,1628983,22300435,"DEC 29, 2023",OKC @ DEN,W,33,14,20,0.7,2,3,0.667,10,10,1.0,0,4,4,3,2,1,1,3,40,21,1,OKC,DEN,OKC,119,45.5,Pts+Rebs+Asts,47,44,43,7
Shai Gilgeous-Alexander,G,22023,1628983,22300435,"DEC 29, 2023",OKC @ DEN,W,33,14,20,0.7,2,3,0.667,10,10,1.0,0,4,4,3,2,1,1,3,40,21,1,OKC,DEN,OKC,119,7.0,Assists,47,44,43,7
Shai Gilgeous-Alexander,G,22023,1628983,22300435,"DEC 29, 2023",OKC @ DEN,W,33,14,20,0.7,2,3,0.667,10,10,1.0,0,4,4,3,2,1,1,3,40,21,1,OKC,DEN,OKC,119,53.0,Fantasy Score,47,44,43,7
Shai Gilgeous-Alexander,G,22023,1628983,22300435,"DEC 29, 2023",OKC @ DEN,W,33,14,20,0.7,2,3,0.667,10,10,1.0,0,4,4,3,2,1,1,3,40,21,1,OKC,DEN,OKC,119,8.0,Free Throws Made,47,44,43,7
Shai Gilgeous-Alexander,G,22023,1628983,22300435,"DEC 29, 2023",OKC @ DEN,W,33,14,20,0.7,2,3,0.667,10,10,1.0,0,4,4,3,2,1,1,3,40,21,1,OKC,DEN,OKC,119,20.5,FG Attempted,47,44,43,7
Shai Gilgeous-Alexander,G,22023,1628983,22300435,"DEC 29, 2023",OKC @ DEN,W,33,14,20,0.7,2,3,0.667,10,10,1.0,0,4,4,3,2,1,1,3,40,21,1,OKC,DEN,OKC,119,37.5,Pts+Rebs,47,44,43,7
Shai Gilgeous-Alexander,G,22023,1628983,22300435,"DEC 29, 2023",OKC @ DEN,W,33,14,20,0.7,2,3,0.667,10,10,1.0,0,4,4,3,2,1,1,3,40,21,1,OKC,DEN,OKC,119,0.5,Dunks,47,44,43,7
Shai Gilgeous-Alexander,G,22023,1628983,22300435,"DEC 29, 2023",OKC @ DEN,W,33,14,20,0.7,2,3,0.667,10,10,1.0,0,4,4,3,2,1,1,3,40,21,1,OKC,DEN,OKC,119,38.5,Pts+Asts,47,44,43,7
Shai Gilgeous-Alexander,G,22023,1628983,22300435,"DEC 29, 2023",OKC @ DEN,W,33,14,20,0.7,2,3,0.667,10,10,1.0,0,4,4,3,2,1,1,3,40,21,1,OKC,DEN,OKC,119,1.5,Steals,47,44,43,7
Shai Gilgeous-Alexander,G,22023,1628983,22300435,"DEC 29, 2023",OKC @ DEN,W,33,14,20,0.7,2,3,0.667,10,10,1.0,0,4,4,3,2,1,1,3,40,21,1,OKC,DEN,OKC,119,13.0,Rebs+Asts,47,44,43,7
Shai Gilgeous-Alexander,G,22023,1628983,22300411,"DEC 26, 2023",OKC vs. MIN,W,33,14,19,0.737,0,3,0.0,6,7,0.857,0,6,6,9,2,1,3,3,34,16,1,OKC,OKC,MIN,129,31.5,Points,49,40,43,15
Shai Gilgeous-Alexander,G,22023,1628983,22300411,"DEC 26, 2023",OKC vs. MIN,W,33,14,19,0.737,0,3,0.0,6,7,0.857,0,6,6,9,2,1,3,3,34,16,1,OKC,OKC,MIN,129,6.0,Rebounds,49,40,43,15
Shai Gilgeous-Alexander,G,22023,1628983,22300411,"DEC 26, 2023",OKC vs. MIN,W,33,14,19,0.737,0,3,0.0,6,7,0.857,0,6,6,9,2,1,3,3,34,16,1,OKC,OKC,MIN,129,45.5,Pts+Rebs+Asts,49,40,43,15
Shai Gilgeous-Alexander,G,22023,1628983,22300411,"DEC 26, 2023",OKC vs. MIN,W,33,14,19,0.737,0,3,0.0,6,7,0.857,0,6,6,9,2,1,3,3,34,16,1,OKC,OKC,MIN,129,7.0,Assists,49,40,43,15
Shai Gilgeous-Alexander,G,22023,1628983,22300411,"DEC 26, 2023",OKC vs. MIN,W,33,14,19,0.737,0,3,0.0,6,7,0.857,0,6,6,9,2,1,3,3,34,16,1,OKC,OKC,MIN,129,53.0,Fantasy Score,49,40,43,15
Shai Gilgeous-Alexander,G,22023,1628983,22300411,"DEC 26, 2023",OKC vs. MIN,W,33,14,19,0.737,0,3,0.0,6,7,0.857,0,6,6,9,2,1,3,3,34,16,1,OKC,OKC,MIN,129,8.0,Free Throws Made,49,40,43,15
Shai Gilgeous-Alexander,G,22023,1628983,22300411,"DEC 26, 2023",OKC vs. MIN,W,33,14,19,0.737,0,3,0.0,6,7,0.857,0,6,6,9,2,1,3,3,34,16,1,OKC,OKC,MIN,129,20.5,FG Attempted,49,40,43,15
Shai Gilgeous-Alexander,G,22023,1628983,22300411,"DEC 26, 2023",OKC vs. MIN,W,33,14,19,0.737,0,3,0.0,6,7,0.857,0,6,6,9,2,1,3,3,34,16,1,OKC,OKC,MIN,129,37.5,Pts+Rebs,49,40,43,15
Shai Gilgeous-Alexander,G,22023,1628983,22300411,"DEC 26, 2023",OKC vs. MIN,W,33,14,19,0.737,0,3,0.0,6,7,0.857,0,6,6,9,2,1,3,3,34,16,1,OKC,OKC,MIN,129,0.5,Dunks,49,40,43,15
Shai Gilgeous-Alexander,G,22023,1628983,22300411,"DEC 26, 2023",OKC vs. MIN,W,33,14,19,0.737,0,3,0.0,6,7,0.857,0,6,6,9,2,1,3,3,34,16,1,OKC,OKC,MIN,129,38.5,Pts+Asts,49,40,43,15
Shai Gilgeous-Alexander,G,22023,1628983,22300411,"DEC 26, 2023",OKC vs. MIN,W,33,14,19,0.737,0,3,0.0,6,7,0.857,0,6,6,9,2,1,3,3,34,16,1,OKC,OKC,MIN,129,1.5,Steals,49,40,43,15
Shai Gilgeous-Alexander,G,22023,1628983,22300411,"DEC 26, 2023",OKC vs. MIN,W,33,14,19,0.737,0,3,0.0,6,7,0.857,0,6,6,9,2,1,3,3,34,16,1,OKC,OKC,MIN,129,13.0,Rebs+Asts,49,40,43,15
Shai Gilgeous-Alexander,G,22023,1628983,22301212,"DEC 06, 2023",OKC @ HOU,L,37,13,18,0.722,0,0,0.0,7,9,0.778,0,3,3,6,6,1,2,4,33,-6,1,OKC,HOU,OKC,101,31.5,Points,42,36,39,9
Shai Gilgeous-Alexander,G,22023,1628983,22301212,"DEC 06, 2023",OKC @ HOU,L,37,13,18,0.722,0,0,0.0,7,9,0.778,0,3,3,6,6,1,2,4,33,-6,1,OKC,HOU,OKC,101,6.0,Rebounds,42,36,39,9
Shai Gilgeous-Alexander,G,22023,1628983,22301212,"DEC 06, 2023",OKC @ HOU,L,37,13,18,0.722,0,0,0.0,7,9,0.778,0,3,3,6,6,1,2,4,33,-6,1,OKC,HOU,OKC,101,45.5,Pts+Rebs+Asts,42,36,39,9
Shai Gilgeous-Alexander,G,22023,1628983,22301212,"DEC 06, 2023",OKC @ HOU,L,37,13,18,0.722,0,0,0.0,7,9,0.778,0,3,3,6,6,1,2,4,33,-6,1,OKC,HOU,OKC,101,7.0,Assists,42,36,39,9
Shai Gilgeous-Alexander,G,22023,1628983,22301212,"DEC 06, 2023",OKC @ HOU,L,37,13,18,0.722,0,0,0.0,7,9,0.778,0,3,3,6,6,1,2,4,33,-6,1,OKC,HOU,OKC,101,53.0,Fantasy Score,42,36,39,9
Shai Gilgeous-Alexander,G,22023,1628983,22301212,"DEC 06, 2023",OKC @ HOU,L,37,13,18,0.722,0,0,0.0,7,9,0.778,0,3,3,6,6,1,2,4,33,-6,1,OKC,HOU,OKC,101,8.0,Free Throws Made,42,36,39,9
Shai Gilgeous-Alexander,G,22023,1628983,22301212,"DEC 06, 2023",OKC @ HOU,L,37,13,18,0.722,0,0,0.0,7,9,0.778,0,3,3,6,6,1,2,4,33,-6,1,OKC,HOU,OKC,101,20.5,FG Attempted,42,36,39,9
Shai Gilgeous-Alexander,G,22023,1628983,22301212,"DEC 06, 2023",OKC @ HOU,L,37,13,18,0.722,0,0,0.0,7,9,0.778,0,3,3,6,6,1,2,4,33,-6,1,OKC,HOU,OKC,101,37.5,Pts+Rebs,42,36,39,9
Shai Gilgeous-Alexander,G,22023,1628983,22301212,"DEC 06, 2023",OKC @ HOU,L,37,13,18,0.722,0,0,0.0,7,9,0.778,0,3,3,6,6,1,2,4,33,-6,1,OKC,HOU,OKC,101,0.5,Dunks,42,36,39,9
Shai Gilgeous-Alexander,G,22023,1628983,22301212,"DEC 06, 2023",OKC @ HOU,L,37,13,18,0.722,0,0,0.0,7,9,0.778,0,3,3,6,6,1,2,4,33,-6,1,OKC,HOU,OKC,101,38.5,Pts+Asts,42,36,39,9
Shai Gilgeous-Alexander,G,22023,1628983,22301212,"DEC 06, 2023",OKC @ HOU,L,37,13,18,0.722,0,0,0.0,7,9,0.778,0,3,3,6,6,1,2,4,33,-6,1,OKC,HOU,OKC,101,1.5,Steals,42,36,39,9
Shai Gilgeous-Alexander,G,22023,1628983,22301212,"DEC 06, 2023",OKC @ HOU,L,37,13,18,0.722,0,0,0.0,7,9,0.778,0,3,3,6,6,1,2,4,33,-6,1,OKC,HOU,OKC,101,13.0,Rebs+Asts,42,36,39,9
Shai Gilgeous-Alexander,G,22023,1628983,22300271,"NOV 30, 2023",OKC vs. LAL,W,35,11,18,0.611,1,4,0.25,10,10,1.0,0,4,4,7,1,0,0,4,33,15,1,OKC,OKC,LAL,133,31.5,Points,44,37,40,11
Shai Gilgeous-Alexander,G,22023,1628983,22300271,"NOV 30, 2023",OKC vs. LAL,W,35,11,18,0.611,1,4,0.25,10,10,1.0,0,4,4,7,1,0,0,4,33,15,1,OKC,OKC,LAL,133,6.0,Rebounds,44,37,40,11
Shai Gilgeous-Alexander,G,22023,1628983,22300271,"NOV 30, 2023",OKC vs. LAL,W,35,11,18,0.611,1,4,0.25,10,10,1.0,0,4,4,7,1,0,0,4,33,15,1,OKC,OKC,LAL,133,45.5,Pts+Rebs+Asts,44,37,40,11
Shai Gilgeous-Alexander,G,22023,1628983,22300271,"NOV 30, 2023",OKC vs. LAL,W,35,11,18,0.611,1,4,0.25,10,10,1.0,0,4,4,7,1,0,0,4,33,15,1,OKC,OKC,LAL,133,7.0,Assists,44,37,40,11
Shai Gilgeous-Alexander,G,22023,1628983,22300271,"NOV 30, 2023",OKC vs. LAL,W,35,11,18,0.611,1,4,0.25,10,10,1.0,0,4,4,7,1,0,0,4,33,15,1,OKC,OKC,LAL,133,53.0,Fantasy Score,44,37,40,11
Shai Gilgeous-Alexander,G,22023,1628983,22300271,"NOV 30, 2023",OKC vs. LAL,W,35,11,18,0.611,1,4,0.25,10,10,1.0,0,4,4,7,1,0,0,4,33,15,1,OKC,OKC,LAL,133,8.0,Free Throws Made,44,37,40,11
Shai Gilgeous-Alexander,G,22023,1628983,22300271,"NOV 30, 2023",OKC vs. LAL,W,35,11,18,0.611,1,4,0.25,10,10,1.0,0,4,4,7,1,0,0,4,33,15,1,OKC,OKC,LAL,133,20.5,FG Attempted,44,37,40,11
Shai Gilgeous-Alexander,G,22023,1628983,22300271,"NOV 30, 2023",OKC vs. LAL,W,35,11,18,0.611,1,4,0.25,10,10,1.0,0,4,4,7,1,0,0,4,33,15,1,OKC,OKC,LAL,133,37.5,Pts+Rebs,44,37,40,11
Shai Gilgeous-Alexander,G,22023,1628983,22300271,"NOV 30, 2023",OKC vs. LAL,W,35,11,18,0.611,1,4,0.25,10,10,1.0,0,4,4,7,1,0,0,4,33,15,1,OKC,OKC,LAL,133,0.5,Dunks,44,37,40,11
Shai Gilgeous-Alexander,G,22023,1628983,22300271,"NOV 30, 2023",OKC vs. LAL,W,35,11,18,0.611,1,4,0.25,10,10,1.0,0,4,4,7,1,0,0,4,33,15,1,OKC,OKC,LAL,133,38.5,Pts+Asts,44,37,40,11
Shai Gilgeous-Alexander,G,22023,1628983,22300271,"NOV 30, 2023",OKC vs. LAL,W,35,11,18,0.611,1,4,0.25,10,10,1.0,0,4,4,7,1,0,0,4,33,15,1,OKC,OKC,LAL,133,1.5,Steals,44,37,40,11
Shai Gilgeous-Alexander,G,22023,1628983,22300271,"NOV 30, 2023",OKC vs. LAL,W,35,11,18,0.611,1,4,0.25,10,10,1.0,0,4,4,7,1,0,0,4,33,15,1,OKC,OKC,LAL,133,13.0,Rebs+Asts,44,37,40,11
Shai Gilgeous-Alexander,G,22023,1628983,22300234,"NOV 22, 2023",OKC vs. CHI,W,37,11,19,0.579,1,3,0.333,17,18,0.944,1,4,5,12,1,3,2,2,40,16,1,OKC,OKC,CHI,116,31.5,Points,57,45,52,17
Shai Gilgeous-Alexander,G,22023,1628983,22300234,"NOV 22, 2023",OKC vs. CHI,W,37,11,19,0.579,1,3,0.333,17,18,0.944,1,4,5,12,1,3,2,2,40,16,1,OKC,OKC,CHI,116,6.0,Rebounds,57,45,52,17
Shai Gilgeous-Alexander,G,22023,1628983,22300234,"NOV 22, 2023",OKC vs. CHI,W,37,11,19,0.579,1,3,0.333,17,18,0.944,1,4,5,12,1,3,2,2,40,16,1,OKC,OKC,CHI,116,45.5,Pts+Rebs+Asts,57,45,52,17
Shai Gilgeous-Alexander,G,22023,1628983,22300234,"NOV 22, 2023",OKC vs. CHI,W,37,11,19,0.579,1,3,0.333,17,18,0.944,1,4,5,12,1,3,2,2,40,16,1,OKC,OKC,CHI,116,7.0,Assists,57,45,52,17
Shai Gilgeous-Alexander,G,22023,1628983,22300234,"NOV 22, 2023",OKC vs. CHI,W,37,11,19,0.579,1,3,0.333,17,18,0.944,1,4,5,12,1,3,2,2,40,16,1,OKC,OKC,CHI,116,53.0,Fantasy Score,57,45,52,17
Shai Gilgeous-Alexander,G,22023,1628983,22300234,"NOV 22, 2023",OKC vs. CHI,W,37,11,19,0.579,1,3,0.333,17,18,0.944,1,4,5,12,1,3,2,2,40,16,1,OKC,OKC,CHI,116,8.0,Free Throws Made,57,45,52,17
Shai Gilgeous-Alexander,G,22023,1628983,22300234,"NOV 22, 2023",OKC vs. CHI,W,37,11,19,0.579,1,3,0.333,17,18,0.944,1,4,5,12,1,3,2,2,40,16,1,OKC,OKC,CHI,116,20.5,FG Attempted,57,45,52,17
Shai Gilgeous-Alexander,G,22023,1628983,22300234,"NOV 22, 2023",OKC vs. CHI,W,37,11,19,0.579,1,3,0.333,17,18,0.944,1,4,5,12,1,3,2,2,40,16,1,OKC,OKC,CHI,116,37.5,Pts+Rebs,57,45,52,17
Shai Gilgeous-Alexander,G,22023,1628983,22300234,"NOV 22, 2023",OKC vs. CHI,W,37,11,19,0.579,1,3,0.333,17,18,0.944,1,4,5,12,1,3,2,2,40,16,1,OKC,OKC,CHI,116,0.5,Dunks,57,45,52,17
Shai Gilgeous-Alexander,G,22023,1628983,22300234,"NOV 22, 2023",OKC vs. CHI,W,37,11,19,0.579,1,3,0.333,17,18,0.944,1,4,5,12,1,3,2,2,40,16,1,OKC,OKC,CHI,116,38.5,Pts+Asts,57,45,52,17
Shai Gilgeous-Alexander,G,22023,1628983,22300234,"NOV 22, 2023",OKC vs. CHI,W,37,11,19,0.579,1,3,0.333,17,18,0.944,1,4,5,12,1,3,2,2,40,16,1,OKC,OKC,CHI,116,1.5,Steals,57,45,52,17
Shai Gilgeous-Alexander,G,22023,1628983,22300234,"NOV 22, 2023",OKC vs. CHI,W,37,11,19,0.579,1,3,0.333,17,18,0.944,1,4,5,12,1,3,2,2,40,16,1,OKC,OKC,CHI,116,13.0,Rebs+Asts,57,45,52,17
Shai Gilgeous-Alexander,G,22023,1628983,22300207,"NOV 18, 2023",OKC @ GSW,W,41,18,29,0.621,2,3,0.667,2,2,1.0,1,6,7,6,2,2,3,1,40,7,1,OKC,GSW,OKC,130,31.5,Points,53,47,46,13
Shai Gilgeous-Alexander,G,22023,1628983,22300207,"NOV 18, 2023",OKC @ GSW,W,41,18,29,0.621,2,3,0.667,2,2,1.0,1,6,7,6,2,2,3,1,40,7,1,OKC,GSW,OKC,130,6.0,Rebounds,53,47,46,13
Shai Gilgeous-Alexander,G,22023,1628983,22300207,"NOV 18, 2023",OKC @ GSW,W,41,18,29,0.621,2,3,0.667,2,2,1.0,1,6,7,6,2,2,3,1,40,7,1,OKC,GSW,OKC,130,45.5,Pts+Rebs+Asts,53,47,46,13
Shai Gilgeous-Alexander,G,22023,1628983,22300207,"NOV 18, 2023",OKC @ GSW,W,41,18,29,0.621,2,3,0.667,2,2,1.0,1,6,7,6,2,2,3,1,40,7,1,OKC,GSW,OKC,130,7.0,Assists,53,47,46,13
Shai Gilgeous-Alexander,G,22023,1628983,22300207,"NOV 18, 2023",OKC @ GSW,W,41,18,29,0.621,2,3,0.667,2,2,1.0,1,6,7,6,2,2,3,1,40,7,1,OKC,GSW,OKC,130,53.0,Fantasy Score,53,47,46,13
Shai Gilgeous-Alexander,G,22023,1628983,22300207,"NOV 18, 2023",OKC @ GSW,W,41,18,29,0.621,2,3,0.667,2,2,1.0,1,6,7,6,2,2,3,1,40,7,1,OKC,GSW,OKC,130,8.0,Free Throws Made,53,47,46,13
Shai Gilgeous-Alexander,G,22023,1628983,22300207,"NOV 18, 2023",OKC @ GSW,W,41,18,29,0.621,2,3,0.667,2,2,1.0,1,6,7,6,2,2,3,1,40,7,1,OKC,GSW,OKC,130,20.5,FG Attempted,53,47,46,13
Shai Gilgeous-Alexander,G,22023,1628983,22300207,"NOV 18, 2023",OKC @ GSW,W,41,18,29,0.621,2,3,0.667,2,2,1.0,1,6,7,6,2,2,3,1,40,7,1,OKC,GSW,OKC,130,37.5,Pts+Rebs,53,47,46,13
Shai Gilgeous-Alexander,G,22023,1628983,22300207,"NOV 18, 2023",OKC @ GSW,W,41,18,29,0.621,2,3,0.667,2,2,1.0,1,6,7,6,2,2,3,1,40,7,1,OKC,GSW,OKC,130,0.5,Dunks,53,47,46,13
Shai Gilgeous-Alexander,G,22023,1628983,22300207,"NOV 18, 2023",OKC @ GSW,W,41,18,29,0.621,2,3,0.667,2,2,1.0,1,6,7,6,2,2,3,1,40,7,1,OKC,GSW,OKC,130,38.5,Pts+Asts,53,47,46,13
Shai Gilgeous-Alexander,G,22023,1628983,22300207,"NOV 18, 2023",OKC @ GSW,W,41,18,29,0.621,2,3,0.667,2,2,1.0,1,6,7,6,2,2,3,1,40,7,1,OKC,GSW,OKC,130,1.5,Steals,53,47,46,13
Shai Gilgeous-Alexander,G,22023,1628983,22300207,"NOV 18, 2023",OKC @ GSW,W,41,18,29,0.621,2,3,0.667,2,2,1.0,1,6,7,6,2,2,3,1,40,7,1,OKC,GSW,OKC,130,13.0,Rebs+Asts,53,47,46,13
Shai Gilgeous-Alexander,G,22023,1628983,22300201,"NOV 16, 2023",OKC @ GSW,W,29,6,21,0.286,3,7,0.429,9,9,1.0,1,1,2,7,3,1,2,4,24,12,1,OKC,GSW,OKC,128,31.5,Points,33,26,31,9
Shai Gilgeous-Alexander,G,22023,1628983,22300201,"NOV 16, 2023",OKC @ GSW,W,29,6,21,0.286,3,7,0.429,9,9,1.0,1,1,2,7,3,1,2,4,24,12,1,OKC,GSW,OKC,128,6.0,Rebounds,33,26,31,9
Shai Gilgeous-Alexander,G,22023,1628983,22300201,"NOV 16, 2023",OKC @ GSW,W,29,6,21,0.286,3,7,0.429,9,9,1.0,1,1,2,7,3,1,2,4,24,12,1,OKC,GSW,OKC,128,45.5,Pts+Rebs+Asts,33,26,31,9
Shai Gilgeous-Alexander,G,22023,1628983,22300201,"NOV 16, 2023",OKC @ GSW,W,29,6,21,0.286,3,7,0.429,9,9,1.0,1,1,2,7,3,1,2,4,24,12,1,OKC,GSW,OKC,128,7.0,Assists,33,26,31,9
Shai Gilgeous-Alexander,G,22023,1628983,22300201,"NOV 16, 2023",OKC @ GSW,W,29,6,21,0.286,3,7,0.429,9,9,1.0,1,1,2,7,3,1,2,4,24,12,1,OKC,GSW,OKC,128,53.0,Fantasy Score,33,26,31,9
Shai Gilgeous-Alexander,G,22023,1628983,22300201,"NOV 16, 2023",OKC @ GSW,W,29,6,21,0.286,3,7,0.429,9,9,1.0,1,1,2,7,3,1,2,4,24,12,1,OKC,GSW,OKC,128,8.0,Free Throws Made,33,26,31,9
Shai Gilgeous-Alexander,G,22023,1628983,22300201,"NOV 16, 2023",OKC @ GSW,W,29,6,21,0.286,3,7,0.429,9,9,1.0,1,1,2,7,3,1,2,4,24,12,1,OKC,GSW,OKC,128,20.5,FG Attempted,33,26,31,9
Shai Gilgeous-Alexander,G,22023,1628983,22300201,"NOV 16, 2023",OKC @ GSW,W,29,6,21,0.286,3,7,0.429,9,9,1.0,1,1,2,7,3,1,2,4,24,12,1,OKC,GSW,OKC,128,37.5,Pts+Rebs,33,26,31,9
Shai Gilgeous-Alexander,G,22023,1628983,22300201,"NOV 16, 2023",OKC @ GSW,W,29,6,21,0.286,3,7,0.429,9,9,1.0,1,1,2,7,3,1,2,4,24,12,1,OKC,GSW,OKC,128,0.5,Dunks,33,26,31,9
Shai Gilgeous-Alexander,G,22023,1628983,22300201,"NOV 16, 2023",OKC @ GSW,W,29,6,21,0.286,3,7,0.429,9,9,1.0,1,1,2,7,3,1,2,4,24,12,1,OKC,GSW,OKC,128,38.5,Pts+Asts,33,26,31,9
Shai Gilgeous-Alexander,G,22023,1628983,22300201,"NOV 16, 2023",OKC @ GSW,W,29,6,21,0.286,3,7,0.429,9,9,1.0,1,1,2,7,3,1,2,4,24,12,1,OKC,GSW,OKC,128,1.5,Steals,33,26,31,9
Shai Gilgeous-Alexander,G,22023,1628983,22300201,"NOV 16, 2023",OKC @ GSW,W,29,6,21,0.286,3,7,0.429,9,9,1.0,1,1,2,7,3,1,2,4,24,12,1,OKC,GSW,OKC,128,13.0,Rebs+Asts,33,26,31,9
Shai Gilgeous-Alexander,G,22023,1628983,22300021,"NOV 14, 2023",OKC vs. SAS,W,28,10,16,0.625,1,4,0.25,7,7,1.0,1,5,6,5,7,0,2,2,28,25,1,OKC,OKC,SAS,123,31.5,Points,39,34,33,11
Shai Gilgeous-Alexander,G,22023,1628983,22300021,"NOV 14, 2023",OKC vs. SAS,W,28,10,16,0.625,1,4,0.25,7,7,1.0,1,5,6,5,7,0,2,2,28,25,1,OKC,OKC,SAS,123,6.0,Rebounds,39,34,33,11
Shai Gilgeous-Alexander,G,22023,1628983,22300021,"NOV 14, 2023",OKC vs. SAS,W,28,10,16,0.625,1,4,0.25,7,7,1.0,1,5,6,5,7,0,2,2,28,25,1,OKC,OKC,SAS,123,45.5,Pts+Rebs+Asts,39,34,33,11
Shai Gilgeous-Alexander,G,22023,1628983,22300021,"NOV 14, 2023",OKC vs. SAS,W,28,10,16,0.625,1,4,0.25,7,7,1.0,1,5,6,5,7,0,2,2,28,25,1,OKC,OKC,SAS,123,7.0,Assists,39,34,33,11
Shai Gilgeous-Alexander,G,22023,1628983,22300021,"NOV 14, 2023",OKC vs. SAS,W,28,10,16,0.625,1,4,0.25,7,7,1.0,1,5,6,5,7,0,2,2,28,25,1,OKC,OKC,SAS,123,53.0,Fantasy Score,39,34,33,11
Shai Gilgeous-Alexander,G,22023,1628983,22300021,"NOV 14, 2023",OKC vs. SAS,W,28,10,16,0.625,1,4,0.25,7,7,1.0,1,5,6,5,7,0,2,2,28,25,1,OKC,OKC,SAS,123,8.0,Free Throws Made,39,34,33,11
Shai Gilgeous-Alexander,G,22023,1628983,22300021,"NOV 14, 2023",OKC vs. SAS,W,28,10,16,0.625,1,4,0.25,7,7,1.0,1,5,6,5,7,0,2,2,28,25,1,OKC,OKC,SAS,123,20.5,FG Attempted,39,34,33,11
Shai Gilgeous-Alexander,G,22023,1628983,22300021,"NOV 14, 2023",OKC vs. SAS,W,28,10,16,0.625,1,4,0.25,7,7,1.0,1,5,6,5,7,0,2,2,28,25,1,OKC,OKC,SAS,123,37.5,Pts+Rebs,39,34,33,11
Shai Gilgeous-Alexander,G,22023,1628983,22300021,"NOV 14, 2023",OKC vs. SAS,W,28,10,16,0.625,1,4,0.25,7,7,1.0,1,5,6,5,7,0,2,2,28,25,1,OKC,OKC,SAS,123,0.5,Dunks,39,34,33,11
Shai Gilgeous-Alexander,G,22023,1628983,22300021,"NOV 14, 2023",OKC vs. SAS,W,28,10,16,0.625,1,4,0.25,7,7,1.0,1,5,6,5,7,0,2,2,28,25,1,OKC,OKC,SAS,123,38.5,Pts+Asts,39,34,33,11
Shai Gilgeous-Alexander,G,22023,1628983,22300021,"NOV 14, 2023",OKC vs. SAS,W,28,10,16,0.625,1,4,0.25,7,7,1.0,1,5,6,5,7,0,2,2,28,25,1,OKC,OKC,SAS,123,1.5,Steals,39,34,33,11
Shai Gilgeous-Alexander,G,22023,1628983,22300021,"NOV 14, 2023",OKC vs. SAS,W,28,10,16,0.625,1,4,0.25,7,7,1.0,1,5,6,5,7,0,2,2,28,25,1,OKC,OKC,SAS,123,13.0,Rebs+Asts,39,34,33,11
Shai Gilgeous-Alexander,G,22023,1628983,22300581,"JAN 18, 2024",OKC @ UTA,W,35,8,15,0.533,0,1,0.0,15,17,0.882,1,5,6,6,1,1,4,4,31,-1,1,OKC,UTA,OKC,134,31.5,Points,43,37,37,12
Shai Gilgeous-Alexander,G,22023,1628983,22300581,"JAN 18, 2024",OKC @ UTA,W,35,8,15,0.533,0,1,0.0,15,17,0.882,1,5,6,6,1,1,4,4,31,-1,1,OKC,UTA,OKC,134,6.0,Rebounds,43,37,37,12
Shai Gilgeous-Alexander,G,22023,1628983,22300581,"JAN 18, 2024",OKC @ UTA,W,35,8,15,0.533,0,1,0.0,15,17,0.882,1,5,6,6,1,1,4,4,31,-1,1,OKC,UTA,OKC,134,45.5,Pts+Rebs+Asts,43,37,37,12
Shai Gilgeous-Alexander,G,22023,1628983,22300581,"JAN 18, 2024",OKC @ UTA,W,35,8,15,0.533,0,1,0.0,15,17,0.882,1,5,6,6,1,1,4,4,31,-1,1,OKC,UTA,OKC,134,7.0,Assists,43,37,37,12
Shai Gilgeous-Alexander,G,22023,1628983,22300581,"JAN 18, 2024",OKC @ UTA,W,35,8,15,0.533,0,1,0.0,15,17,0.882,1,5,6,6,1,1,4,4,31,-1,1,OKC,UTA,OKC,134,53.0,Fantasy Score,43,37,37,12
Shai Gilgeous-Alexander,G,22023,1628983,22300581,"JAN 18, 2024",OKC @ UTA,W,35,8,15,0.533,0,1,0.0,15,17,0.882,1,5,6,6,1,1,4,4,31,-1,1,OKC,UTA,OKC,134,8.0,Free Throws Made,43,37,37,12
Shai Gilgeous-Alexander,G,22023,1628983,22300581,"JAN 18, 2024",OKC @ UTA,W,35,8,15,0.533,0,1,0.0,15,17,0.882,1,5,6,6,1,1,4,4,31,-1,1,OKC,UTA,OKC,134,20.5,FG Attempted,43,37,37,12
Shai Gilgeous-Alexander,G,22023,1628983,22300581,"JAN 18, 2024",OKC @ UTA,W,35,8,15,0.533,0,1,0.0,15,17,0.882,1,5,6,6,1,1,4,4,31,-1,1,OKC,UTA,OKC,134,37.5,Pts+Rebs,43,37,37,12
Shai Gilgeous-Alexander,G,22023,1628983,22300581,"JAN 18, 2024",OKC @ UTA,W,35,8,15,0.533,0,1,0.0,15,17,0.882,1,5,6,6,1,1,4,4,31,-1,1,OKC,UTA,OKC,134,0.5,Dunks,43,37,37,12
Shai Gilgeous-Alexander,G,22023,1628983,22300581,"JAN 18, 2024",OKC @ UTA,W,35,8,15,0.533,0,1,0.0,15,17,0.882,1,5,6,6,1,1,4,4,31,-1,1,OKC,UTA,OKC,134,38.5,Pts+Asts,43,37,37,12
Shai Gilgeous-Alexander,G,22023,1628983,22300581,"JAN 18, 2024",OKC @ UTA,W,35,8,15,0.533,0,1,0.0,15,17,0.882,1,5,6,6,1,1,4,4,31,-1,1,OKC,UTA,OKC,134,1.5,Steals,43,37,37,12
Shai Gilgeous-Alexander,G,22023,1628983,22300581,"JAN 18, 2024",OKC @ UTA,W,35,8,15,0.533,0,1,0.0,15,17,0.882,1,5,6,6,1,1,4,4,31,-1,1,OKC,UTA,OKC,134,13.0,Rebs+Asts,43,37,37,12
Giannis Antetokounmpo,F,22023,203507,22300745,"FEB 09, 2024",MIL vs. CHA,W,24,5,10,0.5,0,1,0.0,5,7,0.714,1,13,14,3,1,1,0,5,15,28,1,MIL,MIL,CHA,120,,,32,29,18,17
Giannis Antetokounmpo,F,22023,203507,22300738,"FEB 08, 2024",MIL vs. MIN,L,27,7,14,0.5,0,2,0.0,3,7,0.429,1,2,3,7,1,0,3,1,17,-18,1,MIL,MIL,MIN,105,,,27,20,24,10
Giannis Antetokounmpo,F,22023,203507,22300725,"FEB 06, 2024",MIL @ PHX,L,39,13,24,0.542,1,3,0.333,7,13,0.538,4,6,10,6,0,0,5,5,34,1,1,MIL,PHX,MIL,106,,,50,44,40,16
Giannis Antetokounmpo,F,22023,203507,22300711,"FEB 04, 2024",MIL @ UTA,L,40,11,15,0.733,0,2,0.0,11,15,0.733,2,5,7,13,0,1,5,3,33,-8,1,MIL,UTA,MIL,108,,,53,40,46,20
Giannis Antetokounmpo,F,22023,203507,22300702,"FEB 03, 2024",MIL @ DAL,W,40,20,28,0.714,2,5,0.4,6,10,0.6,1,5,6,10,5,1,1,3,48,15,1,MIL,DAL,MIL,129,,,64,54,58,16
Giannis Antetokounmpo,F,22023,203507,22300683,"JAN 31, 2024",MIL @ POR,L,38,10,16,0.625,0,2,0.0,7,11,0.636,3,5,8,4,3,1,6,5,27,6,1,MIL,POR,MIL,116,,,39,35,31,12
Giannis Antetokounmpo,F,22023,203507,22300667,"JAN 29, 2024",MIL @ DEN,L,37,11,19,0.579,1,1,1.0,6,11,0.545,2,10,12,4,1,1,2,4,29,-3,1,MIL,DEN,MIL,107,,,45,41,33,16
Giannis Antetokounmpo,F,22023,203507,22300648,"JAN 27, 2024",MIL vs. NOP,W,29,11,16,0.688,1,1,1.0,7,11,0.636,1,11,12,4,2,0,1,3,30,23,1,MIL,MIL,NOP,141,,,46,42,34,16
Giannis Antetokounmpo,F,22023,203507,22300639,"JAN 26, 2024",MIL vs. CLE,L,36,9,13,0.692,0,0,0.0,4,9,0.444,2,9,11,9,1,1,6,5,22,8,1,MIL,MIL,CLE,100,,,42,33,31,20
Giannis Antetokounmpo,F,22023,203507,22300624,"JAN 24, 2024",MIL vs. CLE,W,35,16,24,0.667,1,1,1.0,2,3,0.667,2,16,18,10,0,2,2,3,35,11,1,MIL,MIL,CLE,126,,,63,53,45,28
Giannis Antetokounmpo,F,22023,203507,22300606,"JAN 22, 2024",MIL @ DET,W,36,11,25,0.44,1,5,0.2,8,12,0.667,3,14,17,10,3,2,2,3,31,12,1,MIL,DET,MIL,122,,,58,48,41,27
Giannis Antetokounmpo,F,22023,203507,22300592,"JAN 20, 2024",MIL @ DET,W,38,10,16,0.625,0,1,0.0,11,22,0.5,3,7,10,9,2,1,5,1,31,13,1,MIL,DET,MIL,141,,,50,41,40,19
Giannis Antetokounmpo,F,22023,203507,22300552,"JAN 14, 2024",MIL vs. SAC,W,40,9,16,0.563,0,2,0.0,9,14,0.643,1,9,10,10,3,0,4,4,27,-13,1,MIL,MIL,SAC,143,,,47,37,37,20
Giannis Antetokounmpo,F,22023,203507,22300545,"JAN 13, 2024",MIL vs. GSW,W,37,13,22,0.591,1,3,0.333,6,8,0.75,3,6,9,5,0,0,4,3,33,1,1,MIL,MIL,GSW,129,,,47,42,38,14
Giannis Antetokounmpo,F,22023,203507,22300528,"JAN 11, 2024",MIL vs. BOS,W,26,10,13,0.769,0,0,0.0,4,5,0.8,5,7,12,6,1,1,4,2,24,38,1,MIL,MIL,BOS,135,,,42,36,30,18
Giannis Antetokounmpo,F,22023,203507,22300510,"JAN 08, 2024",MIL vs. UTA,L,38,10,20,0.5,0,2,0.0,5,9,0.556,4,6,10,11,0,0,4,5,25,-14,1,MIL,MIL,UTA,116,,,46,35,36,21
Giannis Antetokounmpo,F,22023,203507,22300496,"JAN 06, 2024",MIL @ HOU,L,39,16,25,0.64,1,2,0.5,15,21,0.714,3,14,17,2,0,1,2,4,48,-1,1,MIL,HOU,MIL,108,,,67,65,50,19
Giannis Antetokounmpo,F,22023,203507,22300477,"JAN 04, 2024",MIL @ SAS,W,40,19,28,0.679,2,3,0.667,4,6,0.667,3,11,14,7,2,1,1,3,44,11,1,MIL,SAS,MIL,125,,,65,58,51,21
Giannis Antetokounmpo,F,22023,203507,22300466,"JAN 03, 2024",MIL @ IND,L,36,8,13,0.615,1,2,0.5,9,13,0.692,0,11,11,8,3,1,3,2,26,-12,1,MIL,IND,MIL,130,,,45,37,34,19
Giannis Antetokounmpo,F,22023,203507,22300454,"JAN 01, 2024",MIL vs. IND,L,37,11,20,0.55,0,3,0.0,8,11,0.727,3,15,18,11,1,2,4,3,30,3,1,MIL,MIL,IND,113,,,59,48,41,29
Giannis Antetokounmpo,F,22023,203507,22300433,"DEC 29, 2023",MIL @ CLE,W,37,14,22,0.636,0,1,0.0,6,7,0.857,2,14,16,5,1,0,3,2,34,12,1,MIL,CLE,MIL,119,,,55,50,39,21
Giannis Antetokounmpo,F,22023,203507,22300417,"DEC 27, 2023",MIL @ BKN,W,30,10,12,0.833,0,0,0.0,12,17,0.706,2,8,10,8,0,2,2,2,32,8,1,MIL,BKN,MIL,144,,,50,42,40,18
Giannis Antetokounmpo,F,22023,203507,22300401,"DEC 25, 2023",MIL @ NYK,L,39,13,24,0.542,1,2,0.5,5,9,0.556,5,8,13,6,1,2,2,4,32,-5,1,MIL,NYK,MIL,122,,,51,45,38,19
Giannis Antetokounmpo,F,22023,203507,22300388,"DEC 23, 2023",MIL @ NYK,W,32,11,17,0.647,0,0,0.0,6,8,0.75,2,5,7,7,1,1,5,4,28,3,1,MIL,NYK,MIL,130,,,42,35,35,14
Giannis Antetokounmpo,F,22023,203507,22300378,"DEC 21, 2023",MIL vs. ORL,W,37,11,25,0.44,0,3,0.0,15,19,0.789,2,8,10,6,0,2,5,4,37,9,1,MIL,MIL,ORL,118,,,53,47,43,16
Giannis Antetokounmpo,F,22023,203507,22300361,"DEC 19, 2023",MIL vs. SAS,W,34,4,12,0.333,0,2,0.0,3,6,0.5,2,12,14,16,2,1,3,1,11,13,1,MIL,MIL,SAS,132,,,41,25,27,30
Giannis Antetokounmpo,F,22023,203507,22300346,"DEC 17, 2023",MIL vs. HOU,W,39,10,22,0.455,1,3,0.333,5,11,0.455,6,11,17,3,0,0,6,3,26,11,1,MIL,MIL,HOU,128,,,46,43,29,20
Giannis Antetokounmpo,F,22023,203507,22300334,"DEC 16, 2023",MIL vs. DET,W,26,7,9,0.778,0,0,0.0,8,13,0.615,1,7,8,6,1,0,0,1,22,22,1,MIL,MIL,DET,146,,,36,30,28,14
Giannis Antetokounmpo,F,22023,203507,22300315,"DEC 13, 2023",MIL vs. IND,W,37,20,28,0.714,0,3,0.0,24,32,0.75,3,11,14,3,4,1,4,1,64,29,1,MIL,MIL,IND,140,,,81,78,67,17
Giannis Antetokounmpo,F,22023,203507,22300300,"DEC 11, 2023",MIL vs. CHI,W,41,9,13,0.692,0,0,0.0,14,18,0.778,1,11,12,6,2,0,2,2,32,13,1,MIL,MIL,CHI,133,,,50,44,38,18
Giannis Antetokounmpo,F,22023,203507,22301229,"DEC 07, 2023",MIL vs. IND,L,41,13,19,0.684,0,1,0.0,11,13,0.846,1,9,10,2,0,2,1,3,37,-5,1,MIL,MIL,IND,119,,,49,47,39,12
Giannis Antetokounmpo,F,22023,203507,22301201,"DEC 05, 2023",MIL vs. NYK,W,34,15,22,0.682,1,1,1.0,4,9,0.444,3,5,8,10,3,0,4,3,35,19,1,MIL,MIL,NYK,146,,,53,43,45,18
Giannis Antetokounmpo,F,22023,203507,22300286,"DEC 02, 2023",MIL vs. ATL,W,36,14,20,0.7,0,1,0.0,4,5,0.8,2,9,11,10,2,1,5,1,32,8,1,MIL,MIL,ATL,132,,,53,43,42,21
Giannis Antetokounmpo,F,22023,203507,22300269,"NOV 30, 2023",MIL @ CHI,L,39,11,17,0.647,0,1,0.0,4,4,1.0,6,8,14,5,2,5,5,5,26,-8,1,MIL,CHI,MIL,113,,,45,40,31,19
Giannis Antetokounmpo,F,22023,203507,22300056,"NOV 28, 2023",MIL @ MIA,W,40,11,16,0.688,1,2,0.5,10,13,0.769,2,8,10,5,3,1,4,3,33,18,1,MIL,MIA,MIL,131,,,48,43,38,15
Giannis Antetokounmpo,F,22023,203507,22300245,"NOV 26, 2023",MIL vs. POR,W,39,11,21,0.524,0,1,0.0,11,18,0.611,6,10,16,6,1,3,4,5,33,9,1,MIL,MIL,POR,108,,,55,49,39,22
Giannis Antetokounmpo,F,22023,203507,22300049,"NOV 24, 2023",MIL vs. WAS,W,37,11,19,0.579,0,0,0.0,9,12,0.75,3,6,9,3,3,1,3,2,31,-10,1,MIL,MIL,WAS,131,,,43,40,34,12
Giannis Antetokounmpo,F,22023,203507,22300228,"NOV 22, 2023",MIL @ BOS,L,37,7,20,0.35,0,3,0.0,7,10,0.7,3,10,13,5,2,0,3,4,21,6,1,MIL,BOS,MIL,116,,,39,34,26,18
Giannis Antetokounmpo,F,22023,203507,22300219,"NOV 20, 2023",MIL @ WAS,W,34,20,23,0.87,0,0,0.0,2,6,0.333,6,7,13,8,1,1,5,2,42,10,1,MIL,WAS,MIL,142,,,63,55,50,21
Giannis Antetokounmpo,F,22023,203507,22300205,"NOV 18, 2023",MIL vs. DAL,W,38,18,26,0.692,1,3,0.333,3,5,0.6,2,13,15,7,2,1,3,3,40,-7,1,MIL,MIL,DAL,132,,,62,55,47,22
Giannis Antetokounmpo,F,22023,203507,22300027,"NOV 17, 2023",MIL @ CHA,W,28,6,10,0.6,0,0,0.0,4,7,0.571,0,8,8,9,1,0,4,5,16,6,1,MIL,CHA,MIL,130,,,33,24,25,17
Giannis Antetokounmpo,F,22023,203507,22300190,"NOV 13, 2023",MIL vs. CHI,W,35,13,22,0.591,1,3,0.333,8,14,0.571,3,8,11,2,0,0,3,4,35,13,1,MIL,MIL,CHI,118,,,48,46,37,13
Giannis Antetokounmpo,F,22023,203507,22300173,"NOV 11, 2023",MIL @ ORL,L,37,15,22,0.682,0,1,0.0,5,12,0.417,2,8,10,7,4,2,6,4,35,-11,1,MIL,ORL,MIL,97,,,52,45,42,17
Giannis Antetokounmpo,F,22023,203507,22300171,"NOV 09, 2023",MIL @ IND,L,36,19,25,0.76,0,1,0.0,16,18,0.889,2,10,12,3,0,0,8,4,54,6,1,MIL,IND,MIL,124,,,69,66,57,15
Giannis Antetokounmpo,F,22023,203507,22300165,"NOV 08, 2023",MIL vs. DET,W,22,6,16,0.375,0,2,0.0,3,6,0.5,0,9,9,5,0,3,1,1,15,5,1,MIL,MIL,DET,120,,,29,24,20,14
Giannis Antetokounmpo,F,22023,203507,22300149,"NOV 06, 2023",MIL @ BKN,W,35,15,27,0.556,1,7,0.143,5,6,0.833,2,10,12,3,1,2,3,1,36,15,1,MIL,BKN,MIL,129,,,51,48,39,15
Giannis Antetokounmpo,F,22023,203507,22300002,"NOV 03, 2023",MIL vs. NYK,W,36,6,10,0.6,3,3,1.0,7,13,0.538,1,7,8,6,0,1,7,3,22,13,1,MIL,MIL,NYK,110,,,36,30,28,14
Giannis Antetokounmpo,F,22023,203507,22300116,"NOV 01, 2023",MIL @ TOR,L,28,5,11,0.455,0,0,0.0,6,9,0.667,3,1,4,2,1,0,3,3,16,-10,1,MIL,TOR,MIL,111,,,22,20,18,6
Giannis Antetokounmpo,F,22023,203507,22300107,"OCT 30, 2023",MIL vs. MIA,W,32,12,21,0.571,1,3,0.333,8,11,0.727,1,6,7,2,0,1,2,3,33,18,1,MIL,MIL,MIA,122,,,42,40,35,9
Giannis Antetokounmpo,F,22023,203507,22300097,"OCT 29, 2023",MIL vs. ATL,L,29,9,14,0.643,0,1,0.0,8,10,0.8,5,6,11,3,1,2,3,2,26,-11,1,MIL,MIL,ATL,110,,,40,37,29,14
Giannis Antetokounmpo,F,22023,203507,22300075,"OCT 26, 2023",MIL vs. PHI,W,35,10,21,0.476,0,3,0.0,3,9,0.333,4,8,12,3,2,2,7,4,23,-13,1,MIL,MIL,PHI,118,,,38,35,26,15
Kevin Durant,F,22023,201142,22300757,"FEB 10, 2024",PHX @ GSW,L,39,10,25,0.4,2,8,0.25,2,2,1.0,1,9,10,7,1,2,6,0,24,0,1,PHX,GSW,PHX,112,,,41,34,31,17
Kevin Durant,F,22023,201142,22300739,"FEB 08, 2024",PHX vs. UTA,W,35,14,23,0.609,2,6,0.333,1,1,1.0,0,8,8,7,3,2,3,1,31,17,1,PHX,PHX,UTA,129,,,46,39,38,15
Kevin Durant,F,22023,201142,22300725,"FEB 06, 2024",PHX vs. MIL,W,39,11,21,0.524,1,5,0.2,5,7,0.714,0,10,10,1,1,2,5,3,28,8,1,PHX,PHX,MIL,114,,,39,38,29,11
Kevin Durant,F,22023,201142,22300705,"FEB 04, 2024",PHX @ WAS,W,26,7,9,0.778,3,3,1.0,1,2,0.5,0,4,4,3,2,1,1,0,18,18,1,PHX,WAS,PHX,140,,,25,22,21,7
Kevin Durant,F,22023,201142,22300690,"FEB 02, 2024",PHX @ ATL,L,38,14,24,0.583,5,9,0.556,2,2,1.0,1,7,8,8,2,1,4,3,35,-1,1,PHX,ATL,PHX,120,,,51,43,43,16
Kevin Durant,F,22023,201142,22300661,"JAN 29, 2024",PHX @ MIA,W,42,8,15,0.533,2,5,0.4,2,2,1.0,2,6,8,7,1,2,1,0,20,6,1,PHX,MIA,PHX,118,,,35,28,27,15
Kevin Durant,F,22023,201142,22300655,"JAN 28, 2024",PHX @ ORL,L,37,7,12,0.583,1,3,0.333,0,0,0.0,0,4,4,5,0,1,7,3,15,-25,1,PHX,ORL,PHX,98,,,24,19,20,9
Kevin Durant,F,22023,201142,22300636,"JAN 26, 2024",PHX @ IND,L,39,9,15,0.6,2,4,0.5,0,0,0.0,1,6,7,6,1,1,2,1,20,-9,1,PHX,IND,PHX,131,,,33,27,26,13
Kevin Durant,F,22023,201142,22300625,"JAN 24, 2024",PHX @ DAL,W,38,4,10,0.4,0,4,0.0,4,7,0.571,0,10,10,7,1,2,1,4,12,19,1,PHX,DAL,PHX,132,,,29,22,19,17
Kevin Durant,F,22023,201142,22300612,"JAN 22, 2024",PHX vs. CHI,W,41,16,32,0.5,6,15,0.4,5,6,0.833,1,5,6,8,1,2,1,2,43,3,1,PHX,PHX,CHI,115,,,57,49,51,14
Kevin Durant,F,22023,201142,22300604,"JAN 21, 2024",PHX vs. IND,W,40,18,25,0.72,4,7,0.571,0,0,0.0,1,8,9,2,0,3,2,4,40,7,1,PHX,PHX,IND,117,,,51,49,42,11
Kevin Durant,F,22023,201142,22300588,"JAN 19, 2024",PHX @ NOP,W,35,11,19,0.579,3,8,0.375,1,1,1.0,1,4,5,2,2,2,1,1,26,25,1,PHX,NOP,PHX,123,,,33,31,28,7
Kevin Durant,F,22023,201142,22300567,"JAN 16, 2024",PHX vs. SAC,W,39,7,16,0.438,4,8,0.5,9,9,1.0,1,4,5,4,0,2,7,3,27,-4,1,PHX,PHX,SAC,119,,,36,32,31,9
Kevin Durant,F,22023,201142,22300554,"JAN 14, 2024",PHX @ POR,W,38,8,16,0.5,2,5,0.4,3,3,1.0,1,4,5,6,0,0,3,4,21,0,1,PHX,POR,PHX,127,,,32,26,27,11
Kevin Durant,F,22023,201142,22300531,"JAN 11, 2024",PHX @ LAL,W,32,7,12,0.583,2,5,0.4,2,2,1.0,0,5,5,5,3,1,1,0,18,15,1,PHX,LAL,PHX,127,,,28,23,23,10
Kevin Durant,F,22023,201142,22300511,"JAN 08, 2024",PHX @ LAC,L,35,10,17,0.588,3,6,0.5,7,8,0.875,0,7,7,2,0,1,3,2,30,-14,1,PHX,LAC,PHX,111,,,39,37,32,9
Kevin Durant,F,22023,201142,22300503,"JAN 07, 2024",PHX vs. MEM,L,36,11,23,0.478,0,1,0.0,1,1,1.0,2,8,10,5,0,1,1,1,23,-7,1,PHX,PHX,MEM,115,,,38,33,28,15
Kevin Durant,F,22023,201142,22300450,"DEC 31, 2023",PHX vs. ORL,W,39,12,21,0.571,2,5,0.4,5,5,1.0,0,5,5,5,3,1,0,1,31,9,1,PHX,PHX,ORL,112,,,41,36,36,10
Kevin Durant,F,22023,201142,22300436,"DEC 29, 2023",PHX vs. CHA,W,39,8,11,0.727,3,3,1.0,2,2,1.0,1,3,4,11,1,3,1,2,21,10,1,PHX,PHX,CHA,133,,,36,25,32,15
Kevin Durant,F,22023,201142,22300418,"DEC 27, 2023",PHX @ HOU,W,41,9,16,0.563,3,7,0.429,6,8,0.75,0,10,10,16,2,1,3,2,27,17,1,PHX,HOU,PHX,129,,,53,37,43,26
Kevin Durant,F,22023,201142,22300405,"DEC 25, 2023",PHX vs. DAL,L,43,4,11,0.364,1,3,0.333,7,7,1.0,1,7,8,7,0,1,6,2,16,-5,1,PHX,PHX,DAL,114,,,31,24,23,15
Kevin Durant,F,22023,201142,22300387,"DEC 22, 2023",PHX @ SAC,L,34,9,14,0.643,2,3,0.667,8,9,0.889,0,7,7,2,1,0,7,0,28,-14,1,PHX,SAC,PHX,105,,,37,35,30,9
Kevin Durant,F,22023,201142,22300363,"DEC 19, 2023",PHX @ POR,L,38,16,28,0.571,1,3,0.333,7,8,0.875,0,4,4,5,2,0,5,1,40,8,1,PHX,POR,PHX,104,,,49,44,45,9
Kevin Durant,F,22023,201142,22300347,"DEC 17, 2023",PHX vs. WAS,W,35,11,24,0.458,0,2,0.0,6,9,0.667,3,2,5,5,1,1,2,1,28,-2,1,PHX,PHX,WAS,112,,,38,33,33,10
Kevin Durant,F,22023,201142,22300333,"DEC 15, 2023",PHX vs. NYK,L,36,10,21,0.476,4,9,0.444,5,7,0.714,0,3,3,6,0,0,0,1,29,-7,1,PHX,PHX,NYK,122,,,38,32,35,9
Kevin Durant,F,22023,201142,22301203,"DEC 05, 2023",PHX @ LAL,L,39,12,17,0.706,4,7,0.571,3,4,0.75,0,7,7,4,0,1,5,5,31,6,1,PHX,LAL,PHX,103,,,42,38,35,11
Kevin Durant,F,22023,201142,22300288,"DEC 02, 2023",PHX vs. MEM,W,33,10,14,0.714,2,3,0.667,5,7,0.714,0,2,2,5,1,1,2,1,27,8,1,PHX,PHX,MEM,116,,,34,29,32,7
Kevin Durant,F,22023,201142,22300279,"DEC 01, 2023",PHX vs. DEN,L,36,8,25,0.32,1,3,0.333,13,13,1.0,0,4,4,11,1,3,1,2,30,-6,1,PHX,PHX,DEN,111,,,45,34,41,15
Kevin Durant,F,22023,201142,22300236,"NOV 22, 2023",PHX vs. GSW,W,34,7,14,0.5,3,4,0.75,15,15,1.0,0,8,8,2,0,2,6,2,32,5,1,PHX,PHX,GSW,123,,,42,40,34,10
Kevin Durant,F,22023,201142,22300041,"NOV 21, 2023",PHX vs. POR,W,37,13,21,0.619,2,2,1.0,3,3,1.0,0,4,4,9,0,1,3,4,31,20,1,PHX,PHX,POR,120,,,44,35,40,13
Kevin Durant,F,22023,201142,22300214,"NOV 19, 2023",PHX @ UTA,W,46,14,27,0.519,4,9,0.444,7,7,1.0,0,8,8,10,2,2,7,2,39,4,1,PHX,UTA,PHX,140,,,57,47,49,18
Kevin Durant,F,22023,201142,22300035,"NOV 17, 2023",PHX @ UTA,W,33,15,22,0.682,6,8,0.75,2,2,1.0,0,9,9,9,0,0,1,1,38,-8,1,PHX,UTA,PHX,131,,,56,47,47,18
Kevin Durant,F,22023,201142,22300197,"NOV 15, 2023",PHX vs. MIN,W,35,11,15,0.733,2,2,1.0,7,7,1.0,0,6,6,6,0,1,2,3,31,27,1,PHX,PHX,MIN,133,,,43,37,37,12
Kevin Durant,F,22023,201142,22300185,"NOV 12, 2023",PHX vs. OKC,L,36,7,18,0.389,3,5,0.6,11,11,1.0,0,9,9,4,1,2,3,1,28,-13,1,PHX,PHX,OKC,99,,,41,37,32,13
Kevin Durant,F,22023,201142,22300015,"NOV 10, 2023",PHX vs. LAL,L,39,13,27,0.481,4,6,0.667,8,10,0.8,1,8,9,5,0,0,4,4,38,8,1,PHX,PHX,LAL,119,,,52,47,43,14
Kevin Durant,F,22023,201142,22300162,"NOV 08, 2023",PHX @ CHI,W,42,7,16,0.438,2,5,0.4,9,9,1.0,1,6,7,9,2,1,6,2,25,5,1,PHX,CHI,PHX,116,,,41,32,34,16
Kevin Durant,F,22023,201142,22300140,"NOV 05, 2023",PHX @ DET,W,35,14,27,0.519,1,3,0.333,12,12,1.0,0,4,4,5,1,2,3,1,41,7,1,PHX,DET,PHX,120,,,50,45,46,9
Kevin Durant,F,22023,201142,22300132,"NOV 04, 2023",PHX @ PHI,L,36,9,20,0.45,1,4,0.25,12,14,0.857,1,7,8,3,1,2,5,1,31,-13,1,PHX,PHI,PHX,100,,,42,39,34,11
Kevin Durant,F,22023,201142,22300131,"NOV 02, 2023",PHX vs. SAS,L,37,10,15,0.667,3,5,0.6,5,9,0.556,0,6,6,1,0,2,3,3,28,-17,1,PHX,PHX,SAS,121,,,35,34,29,7
Kevin Durant,F,22023,201142,22300113,"OCT 31, 2023",PHX vs. SAS,L,37,12,19,0.632,1,3,0.333,1,2,0.5,0,2,2,7,2,0,5,0,26,3,1,PHX,PHX,SAS,114,,,35,28,33,9
Kevin Durant,F,22023,201142,22300094,"OCT 28, 2023",PHX vs. UTA,W,29,8,11,0.727,1,4,0.25,9,9,1.0,0,4,4,7,1,1,2,1,26,30,1,PHX,PHX,UTA,126,,,37,30,33,11
Kevin Durant,F,22023,201142,22300076,"OCT 26, 2023",PHX @ LAL,L,39,14,28,0.5,1,5,0.2,10,13,0.769,0,11,11,2,1,1,8,2,39,18,1,PHX,LAL,PHX,95,,,52,50,41,13
Kevin Durant,F,22023,201142,22300062,"OCT 24, 2023",PHX @ GSW,W,37,7,22,0.318,1,2,0.5,3,5,0.6,2,9,11,3,0,1,2,1,18,0,1,PHX,GSW,PHX,108,,,32,29,21,14
Kevin Durant,F,22023,201142,22300677,"JAN 31, 2024",PHX @ BKN,W,38,10,16,0.625,2,6,0.333,11,12,0.917,0,5,5,8,0,2,3,1,33,20,1,PHX,BKN,PHX,136,,,46,38,41,13
Kevin Durant,F,22023,201142,22300317,"DEC 13, 2023",PHX vs. BKN,L,38,9,18,0.5,1,5,0.2,8,10,0.8,1,5,6,4,1,2,2,3,27,0,1,PHX,PHX,BKN,112,,,37,33,31,10
Kevin Durant,F,22023,201142,22300260,"NOV 29, 2023",PHX @ TOR,L,36,11,30,0.367,2,8,0.25,6,6,1.0,0,4,4,6,1,0,1,1,30,-1,1,PHX,TOR,PHX,105,,,40,34,36,10
Devin Booker,G,22023,1626164,22300757,"FEB 10, 2024",PHX @ GSW,L,38,11,21,0.524,2,8,0.25,8,9,0.889,1,3,4,6,1,1,2,3,32,-3,1,PHX,GSW,PHX,112,,,42,36,38,10
Devin Booker,G,22023,1626164,22300725,"FEB 06, 2024",PHX vs. MIL,W,38,12,21,0.571,2,6,0.333,6,10,0.6,0,1,1,4,0,0,1,3,32,5,1,PHX,PHX,MIL,114,,,37,33,36,5
Devin Booker,G,22023,1626164,22300705,"FEB 04, 2024",PHX @ WAS,W,26,4,11,0.364,1,3,0.333,5,5,1.0,0,1,1,6,0,0,0,4,14,22,1,PHX,WAS,PHX,140,,,21,15,20,7
Devin Booker,G,22023,1626164,22300690,"FEB 02, 2024",PHX @ ATL,L,38,8,16,0.5,3,8,0.375,5,6,0.833,2,4,6,4,1,0,2,4,24,4,1,PHX,ATL,PHX,120,,,34,30,28,10
Devin Booker,G,22023,1626164,22300661,"JAN 29, 2024",PHX @ MIA,W,41,9,23,0.391,2,10,0.2,2,3,0.667,0,8,8,7,1,1,0,2,22,18,1,PHX,MIA,PHX,118,,,37,30,29,15
Devin Booker,G,22023,1626164,22300655,"JAN 28, 2024",PHX @ ORL,L,36,17,26,0.654,1,2,0.5,9,11,0.818,1,3,4,3,1,2,4,3,44,-4,1,PHX,ORL,PHX,98,,,51,48,47,7
Devin Booker,G,22023,1626164,22300636,"JAN 26, 2024",PHX @ IND,L,38,22,37,0.595,6,12,0.5,12,13,0.923,0,5,5,4,1,2,4,2,62,1,1,PHX,IND,PHX,131,,,71,67,66,9
Devin Booker,G,22023,1626164,22300625,"JAN 24, 2024",PHX @ DAL,W,35,17,23,0.739,6,10,0.6,6,8,0.75,1,6,7,3,2,0,2,0,46,33,1,PHX,DAL,PHX,132,,,56,53,49,10
Devin Booker,G,22023,1626164,22300612,"JAN 22, 2024",PHX vs. CHI,W,41,6,11,0.545,2,6,0.333,2,3,0.667,0,4,4,5,1,0,2,2,16,-3,1,PHX,PHX,CHI,115,,,25,20,21,9
Devin Booker,G,22023,1626164,22300604,"JAN 21, 2024",PHX vs. IND,W,36,9,24,0.375,1,7,0.143,7,9,0.778,1,5,6,8,2,0,2,2,26,14,1,PHX,PHX,IND,117,,,40,32,34,14
Devin Booker,G,22023,1626164,22300588,"JAN 19, 2024",PHX @ NOP,W,37,18,30,0.6,6,11,0.545,10,10,1.0,1,3,4,5,0,0,1,0,52,12,1,PHX,NOP,PHX,123,,,61,56,57,9
Devin Booker,G,22023,1626164,22300567,"JAN 16, 2024",PHX vs. SAC,W,38,5,14,0.357,1,3,0.333,5,6,0.833,0,4,4,11,0,0,2,4,16,16,1,PHX,PHX,SAC,119,,,31,20,27,15
Devin Booker,G,22023,1626164,22300554,"JAN 14, 2024",PHX @ POR,W,39,14,22,0.636,1,6,0.167,5,5,1.0,0,6,6,7,0,0,0,2,34,17,1,PHX,POR,PHX,127,,,47,40,41,13
Devin Booker,G,22023,1626164,22300531,"JAN 11, 2024",PHX @ LAL,W,34,11,22,0.5,2,6,0.333,7,7,1.0,0,5,5,5,3,0,3,2,31,20,1,PHX,LAL,PHX,127,,,41,36,36,10
Devin Booker,G,22023,1626164,22300511,"JAN 08, 2024",PHX @ LAC,L,34,8,14,0.571,2,6,0.333,2,2,1.0,0,0,0,5,0,0,6,4,20,-31,1,PHX,LAC,PHX,111,,,25,20,25,5
Devin Booker,G,22023,1626164,22300503,"JAN 07, 2024",PHX vs. MEM,L,37,9,17,0.529,2,6,0.333,4,5,0.8,0,0,0,8,2,1,2,4,24,11,1,PHX,PHX,MEM,115,,,32,24,32,8
Devin Booker,G,22023,1626164,22300489,"JAN 05, 2024",PHX vs. MIA,W,35,9,19,0.474,2,7,0.286,0,0,0.0,0,5,5,10,2,0,3,2,20,25,1,PHX,PHX,MIA,113,,,35,25,30,15
Devin Booker,G,22023,1626164,22300473,"JAN 03, 2024",PHX vs. LAC,L,37,11,15,0.733,5,8,0.625,8,9,0.889,0,2,2,6,0,0,6,4,35,-12,1,PHX,PHX,LAC,122,,,43,37,41,8
Devin Booker,G,22023,1626164,22300456,"JAN 01, 2024",PHX vs. POR,W,31,4,16,0.25,1,4,0.25,1,2,0.5,3,5,8,6,1,0,2,2,10,12,1,PHX,PHX,POR,109,,,24,18,16,14
Devin Booker,G,22023,1626164,22300450,"DEC 31, 2023",PHX vs. ORL,W,37,7,17,0.412,3,8,0.375,4,5,0.8,0,4,4,5,3,0,1,3,21,13,1,PHX,PHX,ORL,112,,,30,25,26,9
Devin Booker,G,22023,1626164,22300436,"DEC 29, 2023",PHX vs. CHA,W,37,10,18,0.556,5,7,0.714,10,10,1.0,0,4,4,7,0,1,2,4,35,11,1,PHX,PHX,CHA,133,,,46,39,42,11
Devin Booker,G,22023,1626164,22300418,"DEC 27, 2023",PHX @ HOU,W,36,9,19,0.474,1,6,0.167,1,1,1.0,1,3,4,7,2,0,4,2,20,13,1,PHX,HOU,PHX,129,,,31,24,27,11
Devin Booker,G,22023,1626164,22300405,"DEC 25, 2023",PHX vs. DAL,L,40,6,14,0.429,1,4,0.25,7,10,0.7,0,3,3,10,1,1,3,5,20,-18,1,PHX,PHX,DAL,114,,,33,23,30,13
Devin Booker,G,22023,1626164,22300387,"DEC 22, 2023",PHX @ SAC,L,36,9,20,0.45,0,3,0.0,6,9,0.667,2,2,4,7,0,0,0,1,24,-24,1,PHX,SAC,PHX,105,,,35,28,31,11
Devin Booker,G,22023,1626164,22300363,"DEC 19, 2023",PHX @ POR,L,38,11,25,0.44,1,5,0.2,3,4,0.75,0,3,3,7,0,0,1,3,26,-9,1,PHX,POR,PHX,104,,,36,29,33,10
Devin Booker,G,22023,1626164,22300347,"DEC 17, 2023",PHX vs. WAS,W,41,10,24,0.417,3,11,0.273,4,5,0.8,0,4,4,8,1,1,5,4,27,2,1,PHX,PHX,WAS,112,,,39,31,35,12
Devin Booker,G,22023,1626164,22300333,"DEC 15, 2023",PHX vs. NYK,L,37,11,26,0.423,1,5,0.2,5,6,0.833,1,1,2,9,0,0,3,4,28,-18,1,PHX,PHX,NYK,122,,,39,30,37,11
Devin Booker,G,22023,1626164,22301203,"DEC 05, 2023",PHX @ LAL,L,37,6,16,0.375,1,1,1.0,8,8,1.0,2,9,11,6,1,1,7,5,21,2,1,PHX,LAL,PHX,103,,,38,32,27,17
Devin Booker,G,22023,1626164,22300288,"DEC 02, 2023",PHX vs. MEM,W,37,9,21,0.429,3,8,0.375,13,13,1.0,1,9,10,7,1,0,2,2,34,9,1,PHX,PHX,MEM,116,,,51,44,41,17
Devin Booker,G,22023,1626164,22300044,"NOV 24, 2023",PHX @ MEM,W,33,15,21,0.714,3,4,0.75,7,9,0.778,1,4,5,4,4,1,5,3,40,28,1,PHX,MEM,PHX,110,,,49,45,44,9
Devin Booker,G,22023,1626164,22300236,"NOV 22, 2023",PHX vs. GSW,W,31,5,15,0.333,2,3,0.667,13,14,0.929,3,5,8,10,1,0,3,2,25,23,1,PHX,PHX,GSW,123,,,43,33,35,18
Devin Booker,G,22023,1626164,22300041,"NOV 21, 2023",PHX vs. POR,W,33,9,20,0.45,0,3,0.0,10,10,1.0,0,3,3,6,1,1,1,1,28,18,1,PHX,PHX,POR,120,,,37,31,34,9
Devin Booker,G,22023,1626164,22300214,"NOV 19, 2023",PHX @ UTA,W,40,8,21,0.381,2,7,0.286,8,8,1.0,1,4,5,8,0,1,3,5,26,2,1,PHX,UTA,PHX,140,,,39,31,34,13
Devin Booker,G,22023,1626164,22300035,"NOV 17, 2023",PHX @ UTA,W,32,7,15,0.467,2,3,0.667,8,10,0.8,0,4,4,15,0,0,1,3,24,9,1,PHX,UTA,PHX,131,,,43,28,39,19
Devin Booker,G,22023,1626164,22300197,"NOV 15, 2023",PHX vs. MIN,W,26,12,22,0.545,2,7,0.286,5,5,1.0,1,3,4,5,0,0,2,2,31,0,1,PHX,PHX,MIN,133,,,40,35,36,9
Devin Booker,G,22023,1626164,22300131,"NOV 02, 2023",PHX vs. SAS,L,35,10,19,0.526,5,7,0.714,6,6,1.0,1,8,9,13,0,0,5,4,31,-2,1,PHX,PHX,SAS,121,,,53,40,44,22
Devin Booker,G,22023,1626164,22300062,"OCT 24, 2023",PHX @ GSW,W,37,13,21,0.619,3,8,0.375,3,3,1.0,1,5,6,8,1,0,6,4,32,5,1,PHX,GSW,PHX,108,,,46,38,40,14
Devin Booker,G,22023,1626164,22300677,"JAN 31, 2024",PHX @ BKN,W,36,9,17,0.529,4,6,0.667,0,0,0.0,0,3,3,8,2,1,2,5,22,19,1,PHX,BKN,PHX,136,,,33,25,30,11
Devin Booker,G,22023,1626164,22300317,"DEC 13, 2023",PHX vs. BKN,L,40,9,15,0.6,2,6,0.333,14,15,0.933,1,5,6,12,0,0,2,5,34,16,1,PHX,PHX,BKN,112,,,52,40,46,18
Devin Booker,G,22023,1626164,22300308,"DEC 12, 2023",PHX vs. GSW,W,36,12,23,0.522,3,6,0.5,5,5,1.0,1,3,4,7,1,1,2,5,32,15,1,PHX,PHX,GSW,119,,,43,36,39,11
Devin Booker,G,22023,1626164,22301228,"DEC 08, 2023",PHX vs. SAC,L,38,10,14,0.714,2,2,1.0,6,9,0.667,0,7,7,7,1,0,3,4,28,-6,1,PHX,PHX,SAC,106,,,42,35,35,14
Devin Booker,G,22023,1626164,22300260,"NOV 29, 2023",PHX @ TOR,L,33,2,12,0.167,0,4,0.0,4,4,1.0,0,5,5,5,0,0,2,3,8,-15,1,PHX,TOR,PHX,105,,,18,13,13,10
Devin Booker,G,22023,1626164,22300247,"NOV 26, 2023",PHX @ NYK,W,38,10,25,0.4,1,4,0.25,7,8,0.875,2,3,5,11,0,2,2,3,28,15,1,PHX,NYK,PHX,116,,,44,33,39,16
Donovan Mitchell,G,22023,1628378,22300756,"FEB 10, 2024",CLE @ TOR,W,31,5,11,0.455,3,6,0.5,2,2,1.0,1,3,4,6,2,1,3,2,15,6,1,CLE,TOR,CLE,119,,,25,19,21,10
Donovan Mitchell,G,22023,1628378,22300735,"FEB 08, 2024",CLE @ BKN,W,30,10,18,0.556,4,10,0.4,3,3,1.0,0,5,5,4,3,3,4,1,27,17,1,CLE,BKN,CLE,118,,,36,32,31,9
Donovan Mitchell,G,22023,1628378,22300728,"FEB 07, 2024",CLE @ WAS,W,38,14,25,0.56,5,10,0.5,7,7,1.0,0,8,8,5,1,0,5,1,40,0,1,CLE,WAS,CLE,114,,,53,48,45,13
Donovan Mitchell,G,22023,1628378,22300714,"FEB 05, 2024",CLE vs. SAC,W,33,11,20,0.55,5,11,0.455,2,2,1.0,0,2,2,5,2,0,0,1,29,28,1,CLE,CLE,SAC,136,,,36,31,34,7
Donovan Mitchell,G,22023,1628378,22300703,"FEB 03, 2024",CLE @ SAS,W,35,12,20,0.6,4,9,0.444,3,3,1.0,3,5,8,7,2,2,2,2,31,22,1,CLE,SAS,CLE,117,,,46,39,38,15
Donovan Mitchell,G,22023,1628378,22300687,"FEB 01, 2024",CLE @ MEM,W,33,10,19,0.526,3,9,0.333,2,4,0.5,0,4,4,7,0,0,4,3,25,16,1,CLE,MEM,CLE,108,,,36,29,32,11
Donovan Mitchell,G,22023,1628378,22300675,"JAN 31, 2024",CLE vs. DET,W,35,14,25,0.56,6,13,0.462,11,12,0.917,2,4,6,8,2,1,2,2,45,22,1,CLE,CLE,DET,128,,,59,51,53,14
Donovan Mitchell,G,22023,1628378,22300658,"JAN 29, 2024",CLE vs. LAC,W,39,11,21,0.524,2,10,0.2,4,6,0.667,1,3,4,12,2,1,2,3,28,11,1,CLE,CLE,LAC,118,,,44,32,40,16
Donovan Mitchell,G,22023,1628378,22300639,"JAN 26, 2024",CLE @ MIL,W,37,12,27,0.444,6,12,0.5,2,4,0.5,1,7,8,6,1,1,5,2,32,15,1,CLE,MIL,CLE,112,,,46,40,38,14
Donovan Mitchell,G,22023,1628378,22300624,"JAN 24, 2024",CLE @ MIL,L,39,10,24,0.417,2,11,0.182,1,4,0.25,0,7,7,8,1,0,6,5,23,-11,1,CLE,MIL,CLE,116,,,38,30,31,15
Donovan Mitchell,G,22023,1628378,22300607,"JAN 22, 2024",CLE @ ORL,W,30,9,19,0.474,3,8,0.375,4,4,1.0,0,3,3,13,4,0,3,3,25,34,1,CLE,ORL,CLE,126,,,41,28,38,16
Donovan Mitchell,G,22023,1628378,22300595,"JAN 20, 2024",CLE @ ATL,W,36,6,17,0.353,0,6,0.0,6,6,1.0,0,6,6,8,0,1,1,3,18,17,1,CLE,ATL,CLE,116,,,32,24,26,14
Donovan Mitchell,G,22023,1628378,22300572,"JAN 17, 2024",CLE vs. MIL,W,26,12,19,0.632,4,8,0.5,3,4,0.75,1,4,5,7,3,0,1,1,31,37,1,CLE,CLE,MIL,135,,,43,36,38,12
Donovan Mitchell,G,22023,1628378,22300561,"JAN 15, 2024",CLE vs. CHI,W,37,11,21,0.524,4,10,0.4,8,8,1.0,2,1,3,7,2,0,2,0,34,19,1,CLE,CLE,CHI,109,,,44,37,41,10
Donovan Mitchell,G,22023,1628378,22300527,"JAN 11, 2024",CLE vs. BKN,W,41,15,30,0.5,4,12,0.333,11,13,0.846,2,10,12,6,4,0,7,1,45,11,1,CLE,CLE,BKN,111,,,63,57,51,18
Donovan Mitchell,G,22023,1628378,22300497,"JAN 07, 2024",CLE vs. SAS,W,37,7,18,0.389,1,10,0.1,2,4,0.5,0,2,2,9,1,0,4,1,17,-6,1,CLE,CLE,SAS,117,,,28,19,26,11
Donovan Mitchell,G,22023,1628378,22300482,"JAN 05, 2024",CLE vs. WAS,W,26,8,15,0.533,5,8,0.625,5,8,0.625,1,1,2,4,1,0,3,2,26,22,1,CLE,CLE,WAS,114,,,32,28,30,6
Donovan Mitchell,G,22023,1628378,22300465,"JAN 03, 2024",CLE vs. WAS,W,24,6,16,0.375,4,9,0.444,6,6,1.0,1,2,3,4,2,2,2,0,22,18,1,CLE,CLE,WAS,140,,,29,25,26,7
Donovan Mitchell,G,22023,1628378,22300452,"JAN 01, 2024",CLE @ TOR,L,38,8,21,0.381,4,9,0.444,6,6,1.0,1,6,7,7,4,0,3,4,26,7,1,CLE,TOR,CLE,121,,,40,33,33,14
Donovan Mitchell,G,22023,1628378,22300433,"DEC 29, 2023",CLE vs. MIL,L,36,14,23,0.609,2,10,0.2,4,4,1.0,1,5,6,9,2,1,2,3,34,3,1,CLE,CLE,MIL,111,,,49,40,43,15
Donovan Mitchell,G,22023,1628378,22300349,"DEC 18, 2023",CLE vs. HOU,W,45,14,27,0.519,4,11,0.364,5,5,1.0,0,1,1,6,0,2,2,5,37,4,1,CLE,CLE,HOU,135,,,44,38,43,7
Donovan Mitchell,G,22023,1628378,22300336,"DEC 16, 2023",CLE vs. ATL,W,41,7,21,0.333,4,9,0.444,4,4,1.0,3,2,5,13,2,0,1,4,22,7,1,CLE,CLE,ATL,127,,,40,27,35,18
Donovan Mitchell,G,22023,1628378,22300319,"DEC 14, 2023",CLE @ BOS,L,40,12,24,0.5,2,8,0.25,5,5,1.0,1,7,8,6,1,0,3,2,31,-11,1,CLE,BOS,CLE,107,,,45,39,37,14
Donovan Mitchell,G,22023,1628378,22300305,"DEC 12, 2023",CLE @ BOS,L,35,11,22,0.5,5,13,0.385,2,2,1.0,0,6,6,3,1,0,3,3,29,6,1,CLE,BOS,CLE,113,,,38,35,32,9
Donovan Mitchell,G,22023,1628378,22300294,"DEC 11, 2023",CLE @ ORL,L,37,6,18,0.333,2,10,0.2,8,9,0.889,1,2,3,3,3,1,2,3,22,-11,1,CLE,ORL,CLE,94,,,28,25,25,6
Donovan Mitchell,G,22023,1628378,22301220,"DEC 08, 2023",CLE @ MIA,W,36,9,17,0.529,3,8,0.375,6,8,0.75,1,12,13,6,1,0,5,1,27,15,1,CLE,MIA,CLE,111,,,46,40,33,19
Donovan Mitchell,G,22023,1628378,22301205,"DEC 06, 2023",CLE vs. ORL,W,37,12,24,0.5,5,10,0.5,6,9,0.667,2,5,7,6,1,0,4,3,35,0,1,CLE,CLE,ORL,121,,,48,42,41,13
Donovan Mitchell,G,22023,1628378,22300283,"DEC 02, 2023",CLE @ DET,W,33,7,19,0.368,2,5,0.4,4,5,0.8,1,2,3,4,2,0,4,2,20,-13,1,CLE,DET,CLE,110,,,27,23,24,7
Donovan Mitchell,G,22023,1628378,22300265,"NOV 30, 2023",CLE vs. POR,L,34,7,20,0.35,1,9,0.111,8,8,1.0,3,4,7,6,4,0,1,1,23,1,1,CLE,CLE,POR,95,,,36,30,29,13
Donovan Mitchell,G,22023,1628378,22300055,"NOV 28, 2023",CLE vs. ATL,W,35,14,25,0.56,3,11,0.273,9,9,1.0,2,9,11,5,3,1,6,3,40,29,1,CLE,CLE,ATL,128,,,56,51,45,16
Donovan Mitchell,G,22023,1628378,22300251,"NOV 26, 2023",CLE vs. TOR,W,34,4,17,0.235,0,5,0.0,2,3,0.667,1,4,5,4,1,0,0,0,10,1,1,CLE,CLE,TOR,105,,,19,15,14,9
Donovan Mitchell,G,22023,1628378,22300242,"NOV 25, 2023",CLE vs. LAL,L,35,4,18,0.222,2,6,0.333,12,13,0.923,0,5,5,6,1,0,1,0,22,-2,1,CLE,CLE,LAL,115,,,33,27,28,11
Donovan Mitchell,G,22023,1628378,22300199,"NOV 15, 2023",CLE @ POR,W,36,13,20,0.65,5,8,0.625,3,4,0.75,0,6,6,4,1,0,3,4,34,22,1,CLE,POR,CLE,109,,,44,40,38,10
Donovan Mitchell,G,22023,1628378,22300191,"NOV 13, 2023",CLE @ SAC,L,38,7,21,0.333,4,9,0.444,4,4,1.0,0,2,2,5,1,1,2,0,22,-1,1,CLE,SAC,CLE,120,,,29,24,27,7
Donovan Mitchell,G,22023,1628378,22300176,"NOV 11, 2023",CLE @ GSW,W,36,7,22,0.318,2,6,0.333,5,6,0.833,1,6,7,5,2,1,2,4,21,15,1,CLE,GSW,CLE,118,,,33,28,26,12
Donovan Mitchell,G,22023,1628378,22300167,"NOV 08, 2023",CLE @ OKC,L,37,8,23,0.348,1,9,0.111,3,3,1.0,0,5,5,5,2,0,0,2,20,2,1,CLE,OKC,CLE,120,,,30,25,25,10
Donovan Mitchell,G,22023,1628378,22300142,"NOV 05, 2023",CLE vs. GSW,W,34,11,19,0.579,5,11,0.455,4,4,1.0,1,1,2,7,2,0,4,3,31,6,1,CLE,CLE,GSW,115,,,40,33,38,9
Donovan Mitchell,G,22023,1628378,22300001,"NOV 03, 2023",CLE @ IND,L,37,13,21,0.619,4,7,0.571,8,10,0.8,1,4,5,9,1,0,3,1,38,0,1,CLE,IND,CLE,116,,,52,43,47,14
Donovan Mitchell,G,22023,1628378,22300112,"OCT 31, 2023",CLE vs. NYK,L,29,11,20,0.55,0,3,0.0,4,4,1.0,2,1,3,3,3,0,2,2,26,-11,1,CLE,CLE,NYK,91,,,32,29,29,6
Donovan Mitchell,G,22023,1628378,22300067,"OCT 25, 2023",CLE @ BKN,W,36,11,21,0.524,4,10,0.4,1,1,1.0,2,3,5,6,4,1,0,1,27,7,1,CLE,BKN,CLE,114,,,38,32,33,11
Donovan Mitchell,G,22023,1628378,22300081,"OCT 27, 2023",CLE vs. OKC,L,42,15,27,0.556,4,11,0.364,9,11,0.818,1,7,8,5,3,2,5,1,43,7,1,CLE,CLE,OKC,105,,,56,51,48,13
Donovan Mitchell,G,22023,1628378,22300120,"NOV 01, 2023",CLE @ NYK,W,37,9,22,0.409,6,15,0.4,6,6,1.0,1,5,6,4,1,1,5,5,30,3,1,CLE,NYK,CLE,95,,,40,36,34,10
Stephen Curry,G,22023,201939,22300757,"FEB 10, 2024",GSW vs. PHX,W,34,10,22,0.455,9,16,0.563,1,2,0.5,1,8,9,6,1,0,3,0,30,10,1,GSW,GSW,PHX,113,,,45,39,36,15
Stephen Curry,G,22023,201939,22300733,"FEB 08, 2024",GSW @ IND,W,30,15,22,0.682,11,16,0.688,1,2,0.5,0,2,2,2,0,1,2,2,42,13,1,GSW,IND,GSW,131,,,46,44,44,4
Stephen Curry,G,22023,201939,22300727,"FEB 07, 2024",GSW @ PHI,W,25,2,7,0.286,1,4,0.25,4,4,1.0,0,3,3,1,0,1,4,2,9,13,1,GSW,PHI,GSW,127,,,13,12,10,4
Stephen Curry,G,22023,201939,22300717,"FEB 05, 2024",GSW @ BKN,W,34,12,24,0.5,4,11,0.364,1,1,1.0,1,4,5,3,0,0,4,2,29,6,1,GSW,BKN,GSW,109,,,37,34,32,8
Stephen Curry,G,22023,201939,22300699,"FEB 03, 2024",GSW @ ATL,L,41,22,38,0.579,10,23,0.435,6,6,1.0,1,5,6,4,0,1,2,1,60,-1,1,GSW,ATL,GSW,134,,,70,66,64,10
Stephen Curry,G,22023,201939,22300693,"FEB 02, 2024",GSW @ MEM,W,32,6,16,0.375,4,9,0.444,4,4,1.0,0,6,6,6,1,0,3,1,20,12,1,GSW,MEM,GSW,121,,,32,26,26,12
Stephen Curry,G,22023,201939,22300673,"JAN 30, 2024",GSW vs. PHI,W,35,12,17,0.706,8,13,0.615,5,5,1.0,1,7,8,7,0,1,5,2,37,26,1,GSW,GSW,PHI,119,,,52,45,44,15
Stephen Curry,G,22023,201939,22300650,"JAN 27, 2024",GSW vs. LAL,L,43,17,35,0.486,9,21,0.429,3,3,1.0,0,3,3,7,1,0,4,4,46,-2,1,GSW,GSW,LAL,144,,,56,49,53,10
Stephen Curry,G,22023,201939,22300632,"JAN 25, 2024",GSW vs. SAC,L,36,13,26,0.5,6,14,0.429,1,1,1.0,1,5,6,2,1,0,2,0,33,-8,1,GSW,GSW,SAC,133,,,41,39,35,8
Stephen Curry,G,22023,201939,22300626,"JAN 24, 2024",GSW vs. ATL,W,31,7,16,0.438,5,8,0.625,6,6,1.0,0,3,3,8,0,0,1,3,25,9,1,GSW,GSW,ATL,134,,,36,28,33,11
Stephen Curry,G,22023,201939,22300560,"JAN 15, 2024",GSW @ MEM,L,33,11,20,0.55,3,9,0.333,1,1,1.0,1,3,4,8,2,1,5,4,26,-2,1,GSW,MEM,GSW,107,,,38,30,34,12
Stephen Curry,G,22023,201939,22300536,"JAN 12, 2024",GSW @ CHI,W,35,8,24,0.333,6,15,0.4,5,5,1.0,0,5,5,9,1,0,1,1,27,5,1,GSW,CHI,GSW,140,,,41,32,36,14
Stephen Curry,G,22023,201939,22300525,"JAN 10, 2024",GSW vs. NOP,L,25,4,13,0.308,3,8,0.375,4,4,1.0,0,1,1,6,1,0,3,0,15,-4,1,GSW,GSW,NOP,105,,,22,16,21,7
Stephen Curry,G,22023,201939,22300504,"JAN 07, 2024",GSW vs. TOR,L,30,2,14,0.143,0,9,0.0,5,5,1.0,0,1,1,6,0,0,2,3,9,-17,1,GSW,GSW,TOR,118,,,16,10,15,7
Stephen Curry,G,22023,201939,22300490,"JAN 05, 2024",GSW vs. DET,W,31,7,19,0.368,4,12,0.333,8,9,0.889,0,6,6,4,1,1,4,0,26,0,1,GSW,GSW,DET,113,,,36,32,30,10
Stephen Curry,G,22023,201939,22300478,"JAN 04, 2024",GSW vs. DEN,L,35,11,23,0.478,5,12,0.417,3,3,1.0,0,4,4,6,1,1,2,1,30,-1,1,GSW,GSW,DEN,127,,,40,34,36,10
Stephen Curry,G,22023,201939,22300463,"JAN 02, 2024",GSW vs. ORL,W,35,12,20,0.6,4,9,0.444,8,11,0.727,1,1,2,6,4,1,2,4,36,12,1,GSW,GSW,ORL,121,,,44,38,42,8
Stephen Curry,G,22023,201939,22300444,"DEC 30, 2023",GSW vs. DAL,L,35,9,25,0.36,6,15,0.4,1,1,1.0,0,2,2,7,1,0,3,3,25,-6,1,GSW,GSW,DAL,122,,,34,27,32,9
Stephen Curry,G,22023,201939,22300426,"DEC 28, 2023",GSW vs. MIA,L,32,3,15,0.2,2,8,0.25,5,6,0.833,0,4,4,5,2,1,1,1,13,-14,1,GSW,GSW,MIA,102,,,22,17,18,9
Stephen Curry,G,22023,201939,22300402,"DEC 25, 2023",GSW @ DEN,L,34,7,21,0.333,3,13,0.231,1,1,1.0,1,1,2,4,1,1,3,4,18,-26,1,GSW,DEN,GSW,114,,,24,20,22,6
Stephen Curry,G,22023,201939,22300399,"DEC 23, 2023",GSW vs. POR,W,30,11,18,0.611,2,7,0.286,3,3,1.0,0,3,3,2,0,0,1,1,27,4,1,GSW,GSW,POR,126,,,32,30,29,5
Stephen Curry,G,22023,201939,22300386,"DEC 22, 2023",GSW vs. WAS,W,27,9,18,0.5,8,13,0.615,4,5,0.8,0,4,4,7,0,1,2,0,30,-1,1,GSW,GSW,WAS,129,,,41,34,37,11
Stephen Curry,G,22023,201939,22300362,"DEC 19, 2023",GSW vs. BOS,W,38,11,21,0.524,6,11,0.545,5,5,1.0,0,3,3,6,0,0,4,5,33,8,1,GSW,GSW,BOS,132,,,42,36,39,9
Stephen Curry,G,22023,201939,22300348,"DEC 17, 2023",GSW @ POR,W,31,2,12,0.167,0,8,0.0,3,4,0.75,0,2,2,8,1,1,4,1,7,14,1,GSW,POR,GSW,118,,,17,9,15,10
Stephen Curry,G,22023,201939,22300339,"DEC 16, 2023",GSW vs. BKN,W,35,14,22,0.636,6,8,0.75,3,3,1.0,0,3,3,1,0,3,3,1,37,7,1,GSW,GSW,BKN,124,,,41,40,38,4
Stephen Curry,G,22023,201939,22300325,"DEC 14, 2023",GSW @ LAC,L,34,5,17,0.294,3,13,0.231,4,4,1.0,0,4,4,4,0,0,1,3,17,-3,1,GSW,LAC,GSW,113,,,25,21,21,8
Stephen Curry,G,22023,201939,22300308,"DEC 12, 2023",GSW @ PHX,L,32,8,24,0.333,4,15,0.267,4,4,1.0,0,5,5,4,3,0,1,2,24,-15,1,GSW,PHX,GSW,116,,,33,29,28,9
Stephen Curry,G,22023,201939,22301222,"DEC 08, 2023",GSW @ OKC,L,40,10,20,0.5,6,12,0.5,8,8,1.0,0,6,6,3,1,0,3,0,34,-5,1,GSW,OKC,GSW,136,,,43,40,37,9
Stephen Curry,G,22023,201939,22301214,"DEC 06, 2023",GSW vs. POR,W,34,8,18,0.444,5,13,0.385,10,11,0.909,0,5,5,1,0,0,4,2,31,4,1,GSW,GSW,POR,110,,,37,36,32,6
Stephen Curry,G,22023,201939,22300280,"DEC 02, 2023",GSW @ LAC,L,37,7,18,0.389,4,9,0.444,4,4,1.0,1,3,4,11,0,0,2,0,22,2,1,GSW,LAC,GSW,112,,,37,26,33,15
Stephen Curry,G,22023,201939,22300273,"NOV 30, 2023",GSW vs. LAC,W,33,8,15,0.533,3,9,0.333,7,9,0.778,0,7,7,8,1,1,2,2,26,-4,1,GSW,GSW,LAC,120,,,41,33,34,15
Stephen Curry,G,22023,201939,22300060,"NOV 28, 2023",GSW @ SAC,L,37,8,20,0.4,4,12,0.333,9,9,1.0,3,7,10,6,0,1,5,5,29,7,1,GSW,SAC,GSW,123,,,45,39,35,16
Stephen Curry,G,22023,201939,22300051,"NOV 24, 2023",GSW vs. SAS,W,35,11,20,0.55,7,14,0.5,6,6,1.0,0,3,3,6,1,0,6,2,35,4,1,GSW,GSW,SAS,118,,,44,38,41,9
Stephen Curry,G,22023,201939,22300236,"NOV 22, 2023",GSW @ PHX,L,28,6,15,0.4,1,8,0.125,3,3,1.0,0,3,3,6,0,0,2,2,16,-17,1,GSW,PHX,GSW,115,,,25,19,22,9
Stephen Curry,G,22023,201939,22300224,"NOV 20, 2023",GSW vs. HOU,W,35,8,14,0.571,5,9,0.556,11,12,0.917,0,5,5,1,0,0,4,2,32,-3,1,GSW,GSW,HOU,121,,,38,37,33,6
Stephen Curry,G,22023,201939,22300207,"NOV 18, 2023",GSW vs. OKC,L,40,8,21,0.381,5,11,0.455,4,4,1.0,0,7,7,3,0,0,2,2,25,0,1,GSW,GSW,OKC,123,,,35,32,28,10
Stephen Curry,G,22023,201939,22300186,"NOV 12, 2023",GSW vs. MIN,L,36,11,25,0.44,5,13,0.385,11,12,0.917,1,4,5,3,1,0,5,2,38,-4,1,GSW,GSW,MIN,110,,,46,43,41,8
Stephen Curry,G,22023,201939,22300176,"NOV 11, 2023",GSW vs. CLE,L,33,9,24,0.375,4,14,0.286,8,8,1.0,1,2,3,2,1,1,4,1,30,-8,1,GSW,GSW,CLE,110,,,35,33,32,5
Stephen Curry,G,22023,201939,22300169,"NOV 08, 2023",GSW @ DEN,L,34,6,17,0.353,6,13,0.462,5,5,1.0,1,4,5,4,1,0,3,2,23,-10,1,GSW,DEN,GSW,105,,,32,28,27,9
Stephen Curry,G,22023,201939,22300145,"NOV 06, 2023",GSW @ DET,W,33,12,26,0.462,7,17,0.412,3,4,0.75,0,2,2,4,0,0,3,1,34,17,1,GSW,DET,GSW,120,,,40,36,38,6
Stephen Curry,G,22023,201939,22300142,"NOV 05, 2023",GSW @ CLE,L,31,8,16,0.5,7,11,0.636,5,6,0.833,0,2,2,4,1,0,6,0,28,-6,1,GSW,CLE,GSW,104,,,34,30,32,6
Stephen Curry,G,22023,201939,22300005,"NOV 03, 2023",GSW @ OKC,W,31,9,15,0.6,5,10,0.5,7,7,1.0,3,5,8,7,2,0,3,1,30,5,1,GSW,OKC,GSW,141,,,45,38,37,15
Stephen Curry,G,22023,201939,22300126,"NOV 01, 2023",GSW vs. SAC,W,32,7,15,0.467,4,10,0.4,3,3,1.0,1,4,5,3,0,0,7,3,21,-6,1,GSW,GSW,SAC,102,,,29,26,24,8
Stephen Curry,G,22023,201939,22300108,"OCT 30, 2023",GSW @ NOP,W,30,15,22,0.682,7,13,0.538,5,7,0.714,0,5,5,5,2,0,3,1,42,13,1,GSW,NOP,GSW,130,,,52,47,47,10
Stephen Curry,G,22023,201939,22300096,"OCT 29, 2023",GSW @ HOU,W,31,6,16,0.375,6,14,0.429,6,6,1.0,1,6,7,6,0,1,1,1,24,-2,1,GSW,HOU,GSW,106,,,37,31,30,13
Stephen Curry,G,22023,201939,22300087,"OCT 27, 2023",GSW @ SAC,W,35,14,19,0.737,7,10,0.7,6,6,1.0,1,3,4,4,2,0,4,0,41,10,1,GSW,SAC,GSW,122,,,49,45,45,8
Stephen Curry,G,22023,201939,22300062,"OCT 24, 2023",GSW vs. PHX,L,31,8,20,0.4,4,14,0.286,7,7,1.0,1,4,5,1,1,0,2,5,27,-9,1,GSW,GSW,PHX,104,,,33,32,28,6
De'Aaron Fox,G,22023,1628368,22300746,"FEB 09, 2024",SAC vs. DEN,W,28,7,15,0.467,1,2,0.5,0,0,0.0,0,2,2,10,5,0,3,3,15,26,1,SAC,SAC,DEN,135,24.5,Points,27,17,25,12
De'Aaron Fox,G,22023,1628368,22300746,"FEB 09, 2024",SAC vs. DEN,W,28,7,15,0.467,1,2,0.5,0,0,0.0,0,2,2,10,5,0,3,3,15,26,1,SAC,SAC,DEN,135,3.5,Rebounds,27,17,25,12
De'Aaron Fox,G,22023,1628368,22300746,"FEB 09, 2024",SAC vs. DEN,W,28,7,15,0.467,1,2,0.5,0,0,0.0,0,2,2,10,5,0,3,3,15,26,1,SAC,SAC,DEN,135,32.5,Pts+Rebs+Asts,27,17,25,12
De'Aaron Fox,G,22023,1628368,22300746,"FEB 09, 2024",SAC vs. DEN,W,28,7,15,0.467,1,2,0.5,0,0,0.0,0,2,2,10,5,0,3,3,15,26,1,SAC,SAC,DEN,135,39.5,Fantasy Score,27,17,25,12
De'Aaron Fox,G,22023,1628368,22300746,"FEB 09, 2024",SAC vs. DEN,W,28,7,15,0.467,1,2,0.5,0,0,0.0,0,2,2,10,5,0,3,3,15,26,1,SAC,SAC,DEN,135,2.5,3-PT Made,27,17,25,12
De'Aaron Fox,G,22023,1628368,22300746,"FEB 09, 2024",SAC vs. DEN,W,28,7,15,0.467,1,2,0.5,0,0,0.0,0,2,2,10,5,0,3,3,15,26,1,SAC,SAC,DEN,135,7.0,3-PT Attempted,27,17,25,12
De'Aaron Fox,G,22023,1628368,22300746,"FEB 09, 2024",SAC vs. DEN,W,28,7,15,0.467,1,2,0.5,0,0,0.0,0,2,2,10,5,0,3,3,15,26,1,SAC,SAC,DEN,135,3.5,Free Throws Made,27,17,25,12
De'Aaron Fox,G,22023,1628368,22300746,"FEB 09, 2024",SAC vs. DEN,W,28,7,15,0.467,1,2,0.5,0,0,0.0,0,2,2,10,5,0,3,3,15,26,1,SAC,SAC,DEN,135,19.0,FG Attempted,27,17,25,12
De'Aaron Fox,G,22023,1628368,22300746,"FEB 09, 2024",SAC vs. DEN,W,28,7,15,0.467,1,2,0.5,0,0,0.0,0,2,2,10,5,0,3,3,15,26,1,SAC,SAC,DEN,135,28.5,Pts+Rebs,27,17,25,12
De'Aaron Fox,G,22023,1628368,22300746,"FEB 09, 2024",SAC vs. DEN,W,28,7,15,0.467,1,2,0.5,0,0,0.0,0,2,2,10,5,0,3,3,15,26,1,SAC,SAC,DEN,135,29.0,Pts+Asts,27,17,25,12
De'Aaron Fox,G,22023,1628368,22300746,"FEB 09, 2024",SAC vs. DEN,W,28,7,15,0.467,1,2,0.5,0,0,0.0,0,2,2,10,5,0,3,3,15,26,1,SAC,SAC,DEN,135,8.5,Rebs+Asts,27,17,25,12
De'Aaron Fox,G,22023,1628368,22300746,"FEB 09, 2024",SAC vs. DEN,W,28,7,15,0.467,1,2,0.5,0,0,0.0,0,2,2,10,5,0,3,3,15,26,1,SAC,SAC,DEN,135,2.5,Turnovers,27,17,25,12
De'Aaron Fox,G,22023,1628368,22300732,"FEB 07, 2024",SAC vs. DET,L,35,5,14,0.357,2,5,0.4,0,4,0.0,1,2,3,7,3,1,2,4,12,-17,1,SAC,SAC,DET,120,24.5,Points,22,15,19,10
De'Aaron Fox,G,22023,1628368,22300732,"FEB 07, 2024",SAC vs. DET,L,35,5,14,0.357,2,5,0.4,0,4,0.0,1,2,3,7,3,1,2,4,12,-17,1,SAC,SAC,DET,120,3.5,Rebounds,22,15,19,10
De'Aaron Fox,G,22023,1628368,22300732,"FEB 07, 2024",SAC vs. DET,L,35,5,14,0.357,2,5,0.4,0,4,0.0,1,2,3,7,3,1,2,4,12,-17,1,SAC,SAC,DET,120,32.5,Pts+Rebs+Asts,22,15,19,10
De'Aaron Fox,G,22023,1628368,22300732,"FEB 07, 2024",SAC vs. DET,L,35,5,14,0.357,2,5,0.4,0,4,0.0,1,2,3,7,3,1,2,4,12,-17,1,SAC,SAC,DET,120,39.5,Fantasy Score,22,15,19,10
De'Aaron Fox,G,22023,1628368,22300732,"FEB 07, 2024",SAC vs. DET,L,35,5,14,0.357,2,5,0.4,0,4,0.0,1,2,3,7,3,1,2,4,12,-17,1,SAC,SAC,DET,120,2.5,3-PT Made,22,15,19,10
De'Aaron Fox,G,22023,1628368,22300732,"FEB 07, 2024",SAC vs. DET,L,35,5,14,0.357,2,5,0.4,0,4,0.0,1,2,3,7,3,1,2,4,12,-17,1,SAC,SAC,DET,120,7.0,3-PT Attempted,22,15,19,10
De'Aaron Fox,G,22023,1628368,22300732,"FEB 07, 2024",SAC vs. DET,L,35,5,14,0.357,2,5,0.4,0,4,0.0,1,2,3,7,3,1,2,4,12,-17,1,SAC,SAC,DET,120,3.5,Free Throws Made,22,15,19,10
De'Aaron Fox,G,22023,1628368,22300732,"FEB 07, 2024",SAC vs. DET,L,35,5,14,0.357,2,5,0.4,0,4,0.0,1,2,3,7,3,1,2,4,12,-17,1,SAC,SAC,DET,120,19.0,FG Attempted,22,15,19,10
De'Aaron Fox,G,22023,1628368,22300732,"FEB 07, 2024",SAC vs. DET,L,35,5,14,0.357,2,5,0.4,0,4,0.0,1,2,3,7,3,1,2,4,12,-17,1,SAC,SAC,DET,120,28.5,Pts+Rebs,22,15,19,10
De'Aaron Fox,G,22023,1628368,22300732,"FEB 07, 2024",SAC vs. DET,L,35,5,14,0.357,2,5,0.4,0,4,0.0,1,2,3,7,3,1,2,4,12,-17,1,SAC,SAC,DET,120,29.0,Pts+Asts,22,15,19,10
De'Aaron Fox,G,22023,1628368,22300732,"FEB 07, 2024",SAC vs. DET,L,35,5,14,0.357,2,5,0.4,0,4,0.0,1,2,3,7,3,1,2,4,12,-17,1,SAC,SAC,DET,120,8.5,Rebs+Asts,22,15,19,10
De'Aaron Fox,G,22023,1628368,22300732,"FEB 07, 2024",SAC vs. DET,L,35,5,14,0.357,2,5,0.4,0,4,0.0,1,2,3,7,3,1,2,4,12,-17,1,SAC,SAC,DET,120,2.5,Turnovers,22,15,19,10
De'Aaron Fox,G,22023,1628368,22300714,"FEB 05, 2024",SAC @ CLE,L,35,8,20,0.4,3,9,0.333,0,0,0.0,1,3,4,1,2,1,3,4,19,-12,1,SAC,CLE,SAC,110,24.5,Points,24,23,20,5
De'Aaron Fox,G,22023,1628368,22300714,"FEB 05, 2024",SAC @ CLE,L,35,8,20,0.4,3,9,0.333,0,0,0.0,1,3,4,1,2,1,3,4,19,-12,1,SAC,CLE,SAC,110,3.5,Rebounds,24,23,20,5
De'Aaron Fox,G,22023,1628368,22300714,"FEB 05, 2024",SAC @ CLE,L,35,8,20,0.4,3,9,0.333,0,0,0.0,1,3,4,1,2,1,3,4,19,-12,1,SAC,CLE,SAC,110,32.5,Pts+Rebs+Asts,24,23,20,5
De'Aaron Fox,G,22023,1628368,22300714,"FEB 05, 2024",SAC @ CLE,L,35,8,20,0.4,3,9,0.333,0,0,0.0,1,3,4,1,2,1,3,4,19,-12,1,SAC,CLE,SAC,110,39.5,Fantasy Score,24,23,20,5
De'Aaron Fox,G,22023,1628368,22300714,"FEB 05, 2024",SAC @ CLE,L,35,8,20,0.4,3,9,0.333,0,0,0.0,1,3,4,1,2,1,3,4,19,-12,1,SAC,CLE,SAC,110,2.5,3-PT Made,24,23,20,5
De'Aaron Fox,G,22023,1628368,22300714,"FEB 05, 2024",SAC @ CLE,L,35,8,20,0.4,3,9,0.333,0,0,0.0,1,3,4,1,2,1,3,4,19,-12,1,SAC,CLE,SAC,110,7.0,3-PT Attempted,24,23,20,5
De'Aaron Fox,G,22023,1628368,22300714,"FEB 05, 2024",SAC @ CLE,L,35,8,20,0.4,3,9,0.333,0,0,0.0,1,3,4,1,2,1,3,4,19,-12,1,SAC,CLE,SAC,110,3.5,Free Throws Made,24,23,20,5
De'Aaron Fox,G,22023,1628368,22300714,"FEB 05, 2024",SAC @ CLE,L,35,8,20,0.4,3,9,0.333,0,0,0.0,1,3,4,1,2,1,3,4,19,-12,1,SAC,CLE,SAC,110,19.0,FG Attempted,24,23,20,5
De'Aaron Fox,G,22023,1628368,22300714,"FEB 05, 2024",SAC @ CLE,L,35,8,20,0.4,3,9,0.333,0,0,0.0,1,3,4,1,2,1,3,4,19,-12,1,SAC,CLE,SAC,110,28.5,Pts+Rebs,24,23,20,5
De'Aaron Fox,G,22023,1628368,22300714,"FEB 05, 2024",SAC @ CLE,L,35,8,20,0.4,3,9,0.333,0,0,0.0,1,3,4,1,2,1,3,4,19,-12,1,SAC,CLE,SAC,110,29.0,Pts+Asts,24,23,20,5
De'Aaron Fox,G,22023,1628368,22300714,"FEB 05, 2024",SAC @ CLE,L,35,8,20,0.4,3,9,0.333,0,0,0.0,1,3,4,1,2,1,3,4,19,-12,1,SAC,CLE,SAC,110,8.5,Rebs+Asts,24,23,20,5
De'Aaron Fox,G,22023,1628368,22300714,"FEB 05, 2024",SAC @ CLE,L,35,8,20,0.4,3,9,0.333,0,0,0.0,1,3,4,1,2,1,3,4,19,-12,1,SAC,CLE,SAC,110,2.5,Turnovers,24,23,20,5
De'Aaron Fox,G,22023,1628368,22300700,"FEB 03, 2024",SAC @ CHI,W,35,13,24,0.542,5,11,0.455,10,12,0.833,0,4,4,4,5,0,3,5,41,5,1,SAC,CHI,SAC,123,24.5,Points,49,45,45,8
De'Aaron Fox,G,22023,1628368,22300700,"FEB 03, 2024",SAC @ CHI,W,35,13,24,0.542,5,11,0.455,10,12,0.833,0,4,4,4,5,0,3,5,41,5,1,SAC,CHI,SAC,123,3.5,Rebounds,49,45,45,8
De'Aaron Fox,G,22023,1628368,22300700,"FEB 03, 2024",SAC @ CHI,W,35,13,24,0.542,5,11,0.455,10,12,0.833,0,4,4,4,5,0,3,5,41,5,1,SAC,CHI,SAC,123,32.5,Pts+Rebs+Asts,49,45,45,8
De'Aaron Fox,G,22023,1628368,22300700,"FEB 03, 2024",SAC @ CHI,W,35,13,24,0.542,5,11,0.455,10,12,0.833,0,4,4,4,5,0,3,5,41,5,1,SAC,CHI,SAC,123,39.5,Fantasy Score,49,45,45,8
De'Aaron Fox,G,22023,1628368,22300700,"FEB 03, 2024",SAC @ CHI,W,35,13,24,0.542,5,11,0.455,10,12,0.833,0,4,4,4,5,0,3,5,41,5,1,SAC,CHI,SAC,123,2.5,3-PT Made,49,45,45,8
De'Aaron Fox,G,22023,1628368,22300700,"FEB 03, 2024",SAC @ CHI,W,35,13,24,0.542,5,11,0.455,10,12,0.833,0,4,4,4,5,0,3,5,41,5,1,SAC,CHI,SAC,123,7.0,3-PT Attempted,49,45,45,8
De'Aaron Fox,G,22023,1628368,22300700,"FEB 03, 2024",SAC @ CHI,W,35,13,24,0.542,5,11,0.455,10,12,0.833,0,4,4,4,5,0,3,5,41,5,1,SAC,CHI,SAC,123,3.5,Free Throws Made,49,45,45,8
De'Aaron Fox,G,22023,1628368,22300700,"FEB 03, 2024",SAC @ CHI,W,35,13,24,0.542,5,11,0.455,10,12,0.833,0,4,4,4,5,0,3,5,41,5,1,SAC,CHI,SAC,123,19.0,FG Attempted,49,45,45,8
De'Aaron Fox,G,22023,1628368,22300700,"FEB 03, 2024",SAC @ CHI,W,35,13,24,0.542,5,11,0.455,10,12,0.833,0,4,4,4,5,0,3,5,41,5,1,SAC,CHI,SAC,123,28.5,Pts+Rebs,49,45,45,8
De'Aaron Fox,G,22023,1628368,22300700,"FEB 03, 2024",SAC @ CHI,W,35,13,24,0.542,5,11,0.455,10,12,0.833,0,4,4,4,5,0,3,5,41,5,1,SAC,CHI,SAC,123,29.0,Pts+Asts,49,45,45,8
De'Aaron Fox,G,22023,1628368,22300700,"FEB 03, 2024",SAC @ CHI,W,35,13,24,0.542,5,11,0.455,10,12,0.833,0,4,4,4,5,0,3,5,41,5,1,SAC,CHI,SAC,123,8.5,Rebs+Asts,49,45,45,8
De'Aaron Fox,G,22023,1628368,22300700,"FEB 03, 2024",SAC @ CHI,W,35,13,24,0.542,5,11,0.455,10,12,0.833,0,4,4,4,5,0,3,5,41,5,1,SAC,CHI,SAC,123,2.5,Turnovers,49,45,45,8
De'Aaron Fox,G,22023,1628368,22300691,"FEB 02, 2024",SAC @ IND,W,35,11,21,0.524,1,5,0.2,2,6,0.333,0,3,3,3,6,1,3,1,25,7,1,SAC,IND,SAC,133,24.5,Points,31,28,28,6
De'Aaron Fox,G,22023,1628368,22300691,"FEB 02, 2024",SAC @ IND,W,35,11,21,0.524,1,5,0.2,2,6,0.333,0,3,3,3,6,1,3,1,25,7,1,SAC,IND,SAC,133,3.5,Rebounds,31,28,28,6
De'Aaron Fox,G,22023,1628368,22300691,"FEB 02, 2024",SAC @ IND,W,35,11,21,0.524,1,5,0.2,2,6,0.333,0,3,3,3,6,1,3,1,25,7,1,SAC,IND,SAC,133,32.5,Pts+Rebs+Asts,31,28,28,6
De'Aaron Fox,G,22023,1628368,22300691,"FEB 02, 2024",SAC @ IND,W,35,11,21,0.524,1,5,0.2,2,6,0.333,0,3,3,3,6,1,3,1,25,7,1,SAC,IND,SAC,133,39.5,Fantasy Score,31,28,28,6
De'Aaron Fox,G,22023,1628368,22300691,"FEB 02, 2024",SAC @ IND,W,35,11,21,0.524,1,5,0.2,2,6,0.333,0,3,3,3,6,1,3,1,25,7,1,SAC,IND,SAC,133,2.5,3-PT Made,31,28,28,6
De'Aaron Fox,G,22023,1628368,22300691,"FEB 02, 2024",SAC @ IND,W,35,11,21,0.524,1,5,0.2,2,6,0.333,0,3,3,3,6,1,3,1,25,7,1,SAC,IND,SAC,133,7.0,3-PT Attempted,31,28,28,6
De'Aaron Fox,G,22023,1628368,22300691,"FEB 02, 2024",SAC @ IND,W,35,11,21,0.524,1,5,0.2,2,6,0.333,0,3,3,3,6,1,3,1,25,7,1,SAC,IND,SAC,133,3.5,Free Throws Made,31,28,28,6
De'Aaron Fox,G,22023,1628368,22300691,"FEB 02, 2024",SAC @ IND,W,35,11,21,0.524,1,5,0.2,2,6,0.333,0,3,3,3,6,1,3,1,25,7,1,SAC,IND,SAC,133,19.0,FG Attempted,31,28,28,6
De'Aaron Fox,G,22023,1628368,22300691,"FEB 02, 2024",SAC @ IND,W,35,11,21,0.524,1,5,0.2,2,6,0.333,0,3,3,3,6,1,3,1,25,7,1,SAC,IND,SAC,133,28.5,Pts+Rebs,31,28,28,6
De'Aaron Fox,G,22023,1628368,22300691,"FEB 02, 2024",SAC @ IND,W,35,11,21,0.524,1,5,0.2,2,6,0.333,0,3,3,3,6,1,3,1,25,7,1,SAC,IND,SAC,133,29.0,Pts+Asts,31,28,28,6
De'Aaron Fox,G,22023,1628368,22300691,"FEB 02, 2024",SAC @ IND,W,35,11,21,0.524,1,5,0.2,2,6,0.333,0,3,3,3,6,1,3,1,25,7,1,SAC,IND,SAC,133,8.5,Rebs+Asts,31,28,28,6
De'Aaron Fox,G,22023,1628368,22300691,"FEB 02, 2024",SAC @ IND,W,35,11,21,0.524,1,5,0.2,2,6,0.333,0,3,3,3,6,1,3,1,25,7,1,SAC,IND,SAC,133,2.5,Turnovers,31,28,28,6
De'Aaron Fox,G,22023,1628368,22300678,"JAN 31, 2024",SAC @ MIA,L,37,4,16,0.25,1,8,0.125,4,6,0.667,0,5,5,3,2,0,2,3,13,-4,1,SAC,MIA,SAC,106,24.5,Points,21,18,16,8
De'Aaron Fox,G,22023,1628368,22300678,"JAN 31, 2024",SAC @ MIA,L,37,4,16,0.25,1,8,0.125,4,6,0.667,0,5,5,3,2,0,2,3,13,-4,1,SAC,MIA,SAC,106,3.5,Rebounds,21,18,16,8
De'Aaron Fox,G,22023,1628368,22300678,"JAN 31, 2024",SAC @ MIA,L,37,4,16,0.25,1,8,0.125,4,6,0.667,0,5,5,3,2,0,2,3,13,-4,1,SAC,MIA,SAC,106,32.5,Pts+Rebs+Asts,21,18,16,8
De'Aaron Fox,G,22023,1628368,22300678,"JAN 31, 2024",SAC @ MIA,L,37,4,16,0.25,1,8,0.125,4,6,0.667,0,5,5,3,2,0,2,3,13,-4,1,SAC,MIA,SAC,106,39.5,Fantasy Score,21,18,16,8
De'Aaron Fox,G,22023,1628368,22300678,"JAN 31, 2024",SAC @ MIA,L,37,4,16,0.25,1,8,0.125,4,6,0.667,0,5,5,3,2,0,2,3,13,-4,1,SAC,MIA,SAC,106,2.5,3-PT Made,21,18,16,8
De'Aaron Fox,G,22023,1628368,22300678,"JAN 31, 2024",SAC @ MIA,L,37,4,16,0.25,1,8,0.125,4,6,0.667,0,5,5,3,2,0,2,3,13,-4,1,SAC,MIA,SAC,106,7.0,3-PT Attempted,21,18,16,8
De'Aaron Fox,G,22023,1628368,22300678,"JAN 31, 2024",SAC @ MIA,L,37,4,16,0.25,1,8,0.125,4,6,0.667,0,5,5,3,2,0,2,3,13,-4,1,SAC,MIA,SAC,106,3.5,Free Throws Made,21,18,16,8
De'Aaron Fox,G,22023,1628368,22300678,"JAN 31, 2024",SAC @ MIA,L,37,4,16,0.25,1,8,0.125,4,6,0.667,0,5,5,3,2,0,2,3,13,-4,1,SAC,MIA,SAC,106,19.0,FG Attempted,21,18,16,8
De'Aaron Fox,G,22023,1628368,22300678,"JAN 31, 2024",SAC @ MIA,L,37,4,16,0.25,1,8,0.125,4,6,0.667,0,5,5,3,2,0,2,3,13,-4,1,SAC,MIA,SAC,106,28.5,Pts+Rebs,21,18,16,8
De'Aaron Fox,G,22023,1628368,22300678,"JAN 31, 2024",SAC @ MIA,L,37,4,16,0.25,1,8,0.125,4,6,0.667,0,5,5,3,2,0,2,3,13,-4,1,SAC,MIA,SAC,106,29.0,Pts+Asts,21,18,16,8
De'Aaron Fox,G,22023,1628368,22300678,"JAN 31, 2024",SAC @ MIA,L,37,4,16,0.25,1,8,0.125,4,6,0.667,0,5,5,3,2,0,2,3,13,-4,1,SAC,MIA,SAC,106,8.5,Rebs+Asts,21,18,16,8
De'Aaron Fox,G,22023,1628368,22300678,"JAN 31, 2024",SAC @ MIA,L,37,4,16,0.25,1,8,0.125,4,6,0.667,0,5,5,3,2,0,2,3,13,-4,1,SAC,MIA,SAC,106,2.5,Turnovers,21,18,16,8
De'Aaron Fox,G,22023,1628368,22300663,"JAN 29, 2024",SAC @ MEM,W,34,8,14,0.571,1,4,0.25,6,10,0.6,1,4,5,4,2,0,3,1,23,8,1,SAC,MEM,SAC,103,24.5,Points,32,28,27,9
De'Aaron Fox,G,22023,1628368,22300663,"JAN 29, 2024",SAC @ MEM,W,34,8,14,0.571,1,4,0.25,6,10,0.6,1,4,5,4,2,0,3,1,23,8,1,SAC,MEM,SAC,103,3.5,Rebounds,32,28,27,9
De'Aaron Fox,G,22023,1628368,22300663,"JAN 29, 2024",SAC @ MEM,W,34,8,14,0.571,1,4,0.25,6,10,0.6,1,4,5,4,2,0,3,1,23,8,1,SAC,MEM,SAC,103,32.5,Pts+Rebs+Asts,32,28,27,9
De'Aaron Fox,G,22023,1628368,22300663,"JAN 29, 2024",SAC @ MEM,W,34,8,14,0.571,1,4,0.25,6,10,0.6,1,4,5,4,2,0,3,1,23,8,1,SAC,MEM,SAC,103,39.5,Fantasy Score,32,28,27,9
De'Aaron Fox,G,22023,1628368,22300663,"JAN 29, 2024",SAC @ MEM,W,34,8,14,0.571,1,4,0.25,6,10,0.6,1,4,5,4,2,0,3,1,23,8,1,SAC,MEM,SAC,103,2.5,3-PT Made,32,28,27,9
De'Aaron Fox,G,22023,1628368,22300663,"JAN 29, 2024",SAC @ MEM,W,34,8,14,0.571,1,4,0.25,6,10,0.6,1,4,5,4,2,0,3,1,23,8,1,SAC,MEM,SAC,103,7.0,3-PT Attempted,32,28,27,9
De'Aaron Fox,G,22023,1628368,22300663,"JAN 29, 2024",SAC @ MEM,W,34,8,14,0.571,1,4,0.25,6,10,0.6,1,4,5,4,2,0,3,1,23,8,1,SAC,MEM,SAC,103,3.5,Free Throws Made,32,28,27,9
De'Aaron Fox,G,22023,1628368,22300663,"JAN 29, 2024",SAC @ MEM,W,34,8,14,0.571,1,4,0.25,6,10,0.6,1,4,5,4,2,0,3,1,23,8,1,SAC,MEM,SAC,103,19.0,FG Attempted,32,28,27,9
De'Aaron Fox,G,22023,1628368,22300663,"JAN 29, 2024",SAC @ MEM,W,34,8,14,0.571,1,4,0.25,6,10,0.6,1,4,5,4,2,0,3,1,23,8,1,SAC,MEM,SAC,103,28.5,Pts+Rebs,32,28,27,9
De'Aaron Fox,G,22023,1628368,22300663,"JAN 29, 2024",SAC @ MEM,W,34,8,14,0.571,1,4,0.25,6,10,0.6,1,4,5,4,2,0,3,1,23,8,1,SAC,MEM,SAC,103,29.0,Pts+Asts,32,28,27,9
De'Aaron Fox,G,22023,1628368,22300663,"JAN 29, 2024",SAC @ MEM,W,34,8,14,0.571,1,4,0.25,6,10,0.6,1,4,5,4,2,0,3,1,23,8,1,SAC,MEM,SAC,103,8.5,Rebs+Asts,32,28,27,9
De'Aaron Fox,G,22023,1628368,22300663,"JAN 29, 2024",SAC @ MEM,W,34,8,14,0.571,1,4,0.25,6,10,0.6,1,4,5,4,2,0,3,1,23,8,1,SAC,MEM,SAC,103,2.5,Turnovers,32,28,27,9
De'Aaron Fox,G,22023,1628368,22300651,"JAN 27, 2024",SAC @ DAL,W,37,13,24,0.542,1,5,0.2,7,8,0.875,1,2,3,5,2,2,2,3,34,18,1,SAC,DAL,SAC,120,24.5,Points,42,37,39,8
De'Aaron Fox,G,22023,1628368,22300651,"JAN 27, 2024",SAC @ DAL,W,37,13,24,0.542,1,5,0.2,7,8,0.875,1,2,3,5,2,2,2,3,34,18,1,SAC,DAL,SAC,120,3.5,Rebounds,42,37,39,8
De'Aaron Fox,G,22023,1628368,22300651,"JAN 27, 2024",SAC @ DAL,W,37,13,24,0.542,1,5,0.2,7,8,0.875,1,2,3,5,2,2,2,3,34,18,1,SAC,DAL,SAC,120,32.5,Pts+Rebs+Asts,42,37,39,8
De'Aaron Fox,G,22023,1628368,22300651,"JAN 27, 2024",SAC @ DAL,W,37,13,24,0.542,1,5,0.2,7,8,0.875,1,2,3,5,2,2,2,3,34,18,1,SAC,DAL,SAC,120,39.5,Fantasy Score,42,37,39,8
De'Aaron Fox,G,22023,1628368,22300651,"JAN 27, 2024",SAC @ DAL,W,37,13,24,0.542,1,5,0.2,7,8,0.875,1,2,3,5,2,2,2,3,34,18,1,SAC,DAL,SAC,120,2.5,3-PT Made,42,37,39,8
De'Aaron Fox,G,22023,1628368,22300651,"JAN 27, 2024",SAC @ DAL,W,37,13,24,0.542,1,5,0.2,7,8,0.875,1,2,3,5,2,2,2,3,34,18,1,SAC,DAL,SAC,120,7.0,3-PT Attempted,42,37,39,8
De'Aaron Fox,G,22023,1628368,22300651,"JAN 27, 2024",SAC @ DAL,W,37,13,24,0.542,1,5,0.2,7,8,0.875,1,2,3,5,2,2,2,3,34,18,1,SAC,DAL,SAC,120,3.5,Free Throws Made,42,37,39,8
De'Aaron Fox,G,22023,1628368,22300651,"JAN 27, 2024",SAC @ DAL,W,37,13,24,0.542,1,5,0.2,7,8,0.875,1,2,3,5,2,2,2,3,34,18,1,SAC,DAL,SAC,120,19.0,FG Attempted,42,37,39,8
De'Aaron Fox,G,22023,1628368,22300651,"JAN 27, 2024",SAC @ DAL,W,37,13,24,0.542,1,5,0.2,7,8,0.875,1,2,3,5,2,2,2,3,34,18,1,SAC,DAL,SAC,120,28.5,Pts+Rebs,42,37,39,8
De'Aaron Fox,G,22023,1628368,22300651,"JAN 27, 2024",SAC @ DAL,W,37,13,24,0.542,1,5,0.2,7,8,0.875,1,2,3,5,2,2,2,3,34,18,1,SAC,DAL,SAC,120,29.0,Pts+Asts,42,37,39,8
De'Aaron Fox,G,22023,1628368,22300651,"JAN 27, 2024",SAC @ DAL,W,37,13,24,0.542,1,5,0.2,7,8,0.875,1,2,3,5,2,2,2,3,34,18,1,SAC,DAL,SAC,120,8.5,Rebs+Asts,42,37,39,8
De'Aaron Fox,G,22023,1628368,22300651,"JAN 27, 2024",SAC @ DAL,W,37,13,24,0.542,1,5,0.2,7,8,0.875,1,2,3,5,2,2,2,3,34,18,1,SAC,DAL,SAC,120,2.5,Turnovers,42,37,39,8
De'Aaron Fox,G,22023,1628368,22300632,"JAN 25, 2024",SAC @ GSW,W,36,9,16,0.563,3,7,0.429,8,8,1.0,0,1,1,5,1,1,1,3,29,-12,1,SAC,GSW,SAC,134,24.5,Points,35,30,34,6
De'Aaron Fox,G,22023,1628368,22300632,"JAN 25, 2024",SAC @ GSW,W,36,9,16,0.563,3,7,0.429,8,8,1.0,0,1,1,5,1,1,1,3,29,-12,1,SAC,GSW,SAC,134,3.5,Rebounds,35,30,34,6
De'Aaron Fox,G,22023,1628368,22300632,"JAN 25, 2024",SAC @ GSW,W,36,9,16,0.563,3,7,0.429,8,8,1.0,0,1,1,5,1,1,1,3,29,-12,1,SAC,GSW,SAC,134,32.5,Pts+Rebs+Asts,35,30,34,6
De'Aaron Fox,G,22023,1628368,22300632,"JAN 25, 2024",SAC @ GSW,W,36,9,16,0.563,3,7,0.429,8,8,1.0,0,1,1,5,1,1,1,3,29,-12,1,SAC,GSW,SAC,134,39.5,Fantasy Score,35,30,34,6
De'Aaron Fox,G,22023,1628368,22300632,"JAN 25, 2024",SAC @ GSW,W,36,9,16,0.563,3,7,0.429,8,8,1.0,0,1,1,5,1,1,1,3,29,-12,1,SAC,GSW,SAC,134,2.5,3-PT Made,35,30,34,6
De'Aaron Fox,G,22023,1628368,22300632,"JAN 25, 2024",SAC @ GSW,W,36,9,16,0.563,3,7,0.429,8,8,1.0,0,1,1,5,1,1,1,3,29,-12,1,SAC,GSW,SAC,134,7.0,3-PT Attempted,35,30,34,6
De'Aaron Fox,G,22023,1628368,22300632,"JAN 25, 2024",SAC @ GSW,W,36,9,16,0.563,3,7,0.429,8,8,1.0,0,1,1,5,1,1,1,3,29,-12,1,SAC,GSW,SAC,134,3.5,Free Throws Made,35,30,34,6
De'Aaron Fox,G,22023,1628368,22300632,"JAN 25, 2024",SAC @ GSW,W,36,9,16,0.563,3,7,0.429,8,8,1.0,0,1,1,5,1,1,1,3,29,-12,1,SAC,GSW,SAC,134,19.0,FG Attempted,35,30,34,6
De'Aaron Fox,G,22023,1628368,22300632,"JAN 25, 2024",SAC @ GSW,W,36,9,16,0.563,3,7,0.429,8,8,1.0,0,1,1,5,1,1,1,3,29,-12,1,SAC,GSW,SAC,134,28.5,Pts+Rebs,35,30,34,6
De'Aaron Fox,G,22023,1628368,22300632,"JAN 25, 2024",SAC @ GSW,W,36,9,16,0.563,3,7,0.429,8,8,1.0,0,1,1,5,1,1,1,3,29,-12,1,SAC,GSW,SAC,134,29.0,Pts+Asts,35,30,34,6
De'Aaron Fox,G,22023,1628368,22300632,"JAN 25, 2024",SAC @ GSW,W,36,9,16,0.563,3,7,0.429,8,8,1.0,0,1,1,5,1,1,1,3,29,-12,1,SAC,GSW,SAC,134,8.5,Rebs+Asts,35,30,34,6
De'Aaron Fox,G,22023,1628368,22300632,"JAN 25, 2024",SAC @ GSW,W,36,9,16,0.563,3,7,0.429,8,8,1.0,0,1,1,5,1,1,1,3,29,-12,1,SAC,GSW,SAC,134,2.5,Turnovers,35,30,34,6
De'Aaron Fox,G,22023,1628368,22300613,"JAN 22, 2024",SAC vs. ATL,W,35,5,16,0.313,0,5,0.0,2,3,0.667,0,3,3,1,1,0,1,1,12,7,1,SAC,SAC,ATL,122,24.5,Points,16,15,13,4
De'Aaron Fox,G,22023,1628368,22300613,"JAN 22, 2024",SAC vs. ATL,W,35,5,16,0.313,0,5,0.0,2,3,0.667,0,3,3,1,1,0,1,1,12,7,1,SAC,SAC,ATL,122,3.5,Rebounds,16,15,13,4
De'Aaron Fox,G,22023,1628368,22300613,"JAN 22, 2024",SAC vs. ATL,W,35,5,16,0.313,0,5,0.0,2,3,0.667,0,3,3,1,1,0,1,1,12,7,1,SAC,SAC,ATL,122,32.5,Pts+Rebs+Asts,16,15,13,4
De'Aaron Fox,G,22023,1628368,22300613,"JAN 22, 2024",SAC vs. ATL,W,35,5,16,0.313,0,5,0.0,2,3,0.667,0,3,3,1,1,0,1,1,12,7,1,SAC,SAC,ATL,122,39.5,Fantasy Score,16,15,13,4
De'Aaron Fox,G,22023,1628368,22300613,"JAN 22, 2024",SAC vs. ATL,W,35,5,16,0.313,0,5,0.0,2,3,0.667,0,3,3,1,1,0,1,1,12,7,1,SAC,SAC,ATL,122,2.5,3-PT Made,16,15,13,4
De'Aaron Fox,G,22023,1628368,22300613,"JAN 22, 2024",SAC vs. ATL,W,35,5,16,0.313,0,5,0.0,2,3,0.667,0,3,3,1,1,0,1,1,12,7,1,SAC,SAC,ATL,122,7.0,3-PT Attempted,16,15,13,4
De'Aaron Fox,G,22023,1628368,22300613,"JAN 22, 2024",SAC vs. ATL,W,35,5,16,0.313,0,5,0.0,2,3,0.667,0,3,3,1,1,0,1,1,12,7,1,SAC,SAC,ATL,122,3.5,Free Throws Made,16,15,13,4
De'Aaron Fox,G,22023,1628368,22300613,"JAN 22, 2024",SAC vs. ATL,W,35,5,16,0.313,0,5,0.0,2,3,0.667,0,3,3,1,1,0,1,1,12,7,1,SAC,SAC,ATL,122,19.0,FG Attempted,16,15,13,4
De'Aaron Fox,G,22023,1628368,22300613,"JAN 22, 2024",SAC vs. ATL,W,35,5,16,0.313,0,5,0.0,2,3,0.667,0,3,3,1,1,0,1,1,12,7,1,SAC,SAC,ATL,122,28.5,Pts+Rebs,16,15,13,4
De'Aaron Fox,G,22023,1628368,22300613,"JAN 22, 2024",SAC vs. ATL,W,35,5,16,0.313,0,5,0.0,2,3,0.667,0,3,3,1,1,0,1,1,12,7,1,SAC,SAC,ATL,122,29.0,Pts+Asts,16,15,13,4
De'Aaron Fox,G,22023,1628368,22300613,"JAN 22, 2024",SAC vs. ATL,W,35,5,16,0.313,0,5,0.0,2,3,0.667,0,3,3,1,1,0,1,1,12,7,1,SAC,SAC,ATL,122,8.5,Rebs+Asts,16,15,13,4
De'Aaron Fox,G,22023,1628368,22300613,"JAN 22, 2024",SAC vs. ATL,W,35,5,16,0.313,0,5,0.0,2,3,0.667,0,3,3,1,1,0,1,1,12,7,1,SAC,SAC,ATL,122,2.5,Turnovers,16,15,13,4
De'Aaron Fox,G,22023,1628368,22300583,"JAN 18, 2024",SAC vs. IND,L,40,8,20,0.4,3,7,0.429,5,9,0.556,1,5,6,6,1,0,1,2,24,3,1,SAC,SAC,IND,121,24.5,Points,36,30,30,12
De'Aaron Fox,G,22023,1628368,22300583,"JAN 18, 2024",SAC vs. IND,L,40,8,20,0.4,3,7,0.429,5,9,0.556,1,5,6,6,1,0,1,2,24,3,1,SAC,SAC,IND,121,3.5,Rebounds,36,30,30,12
De'Aaron Fox,G,22023,1628368,22300583,"JAN 18, 2024",SAC vs. IND,L,40,8,20,0.4,3,7,0.429,5,9,0.556,1,5,6,6,1,0,1,2,24,3,1,SAC,SAC,IND,121,32.5,Pts+Rebs+Asts,36,30,30,12
De'Aaron Fox,G,22023,1628368,22300583,"JAN 18, 2024",SAC vs. IND,L,40,8,20,0.4,3,7,0.429,5,9,0.556,1,5,6,6,1,0,1,2,24,3,1,SAC,SAC,IND,121,39.5,Fantasy Score,36,30,30,12
De'Aaron Fox,G,22023,1628368,22300583,"JAN 18, 2024",SAC vs. IND,L,40,8,20,0.4,3,7,0.429,5,9,0.556,1,5,6,6,1,0,1,2,24,3,1,SAC,SAC,IND,121,2.5,3-PT Made,36,30,30,12
De'Aaron Fox,G,22023,1628368,22300583,"JAN 18, 2024",SAC vs. IND,L,40,8,20,0.4,3,7,0.429,5,9,0.556,1,5,6,6,1,0,1,2,24,3,1,SAC,SAC,IND,121,7.0,3-PT Attempted,36,30,30,12
De'Aaron Fox,G,22023,1628368,22300583,"JAN 18, 2024",SAC vs. IND,L,40,8,20,0.4,3,7,0.429,5,9,0.556,1,5,6,6,1,0,1,2,24,3,1,SAC,SAC,IND,121,3.5,Free Throws Made,36,30,30,12
De'Aaron Fox,G,22023,1628368,22300583,"JAN 18, 2024",SAC vs. IND,L,40,8,20,0.4,3,7,0.429,5,9,0.556,1,5,6,6,1,0,1,2,24,3,1,SAC,SAC,IND,121,19.0,FG Attempted,36,30,30,12
De'Aaron Fox,G,22023,1628368,22300583,"JAN 18, 2024",SAC vs. IND,L,40,8,20,0.4,3,7,0.429,5,9,0.556,1,5,6,6,1,0,1,2,24,3,1,SAC,SAC,IND,121,28.5,Pts+Rebs,36,30,30,12
De'Aaron Fox,G,22023,1628368,22300583,"JAN 18, 2024",SAC vs. IND,L,40,8,20,0.4,3,7,0.429,5,9,0.556,1,5,6,6,1,0,1,2,24,3,1,SAC,SAC,IND,121,29.0,Pts+Asts,36,30,30,12
De'Aaron Fox,G,22023,1628368,22300583,"JAN 18, 2024",SAC vs. IND,L,40,8,20,0.4,3,7,0.429,5,9,0.556,1,5,6,6,1,0,1,2,24,3,1,SAC,SAC,IND,121,8.5,Rebs+Asts,36,30,30,12
De'Aaron Fox,G,22023,1628368,22300583,"JAN 18, 2024",SAC vs. IND,L,40,8,20,0.4,3,7,0.429,5,9,0.556,1,5,6,6,1,0,1,2,24,3,1,SAC,SAC,IND,121,2.5,Turnovers,36,30,30,12
De'Aaron Fox,G,22023,1628368,22300567,"JAN 16, 2024",SAC @ PHX,L,37,12,24,0.5,6,10,0.6,3,5,0.6,1,1,2,6,2,0,1,2,33,6,1,SAC,PHX,SAC,117,24.5,Points,41,35,39,8
De'Aaron Fox,G,22023,1628368,22300567,"JAN 16, 2024",SAC @ PHX,L,37,12,24,0.5,6,10,0.6,3,5,0.6,1,1,2,6,2,0,1,2,33,6,1,SAC,PHX,SAC,117,3.5,Rebounds,41,35,39,8
De'Aaron Fox,G,22023,1628368,22300567,"JAN 16, 2024",SAC @ PHX,L,37,12,24,0.5,6,10,0.6,3,5,0.6,1,1,2,6,2,0,1,2,33,6,1,SAC,PHX,SAC,117,32.5,Pts+Rebs+Asts,41,35,39,8
De'Aaron Fox,G,22023,1628368,22300567,"JAN 16, 2024",SAC @ PHX,L,37,12,24,0.5,6,10,0.6,3,5,0.6,1,1,2,6,2,0,1,2,33,6,1,SAC,PHX,SAC,117,39.5,Fantasy Score,41,35,39,8
De'Aaron Fox,G,22023,1628368,22300567,"JAN 16, 2024",SAC @ PHX,L,37,12,24,0.5,6,10,0.6,3,5,0.6,1,1,2,6,2,0,1,2,33,6,1,SAC,PHX,SAC,117,2.5,3-PT Made,41,35,39,8
De'Aaron Fox,G,22023,1628368,22300567,"JAN 16, 2024",SAC @ PHX,L,37,12,24,0.5,6,10,0.6,3,5,0.6,1,1,2,6,2,0,1,2,33,6,1,SAC,PHX,SAC,117,7.0,3-PT Attempted,41,35,39,8
De'Aaron Fox,G,22023,1628368,22300567,"JAN 16, 2024",SAC @ PHX,L,37,12,24,0.5,6,10,0.6,3,5,0.6,1,1,2,6,2,0,1,2,33,6,1,SAC,PHX,SAC,117,3.5,Free Throws Made,41,35,39,8
De'Aaron Fox,G,22023,1628368,22300567,"JAN 16, 2024",SAC @ PHX,L,37,12,24,0.5,6,10,0.6,3,5,0.6,1,1,2,6,2,0,1,2,33,6,1,SAC,PHX,SAC,117,19.0,FG Attempted,41,35,39,8
De'Aaron Fox,G,22023,1628368,22300567,"JAN 16, 2024",SAC @ PHX,L,37,12,24,0.5,6,10,0.6,3,5,0.6,1,1,2,6,2,0,1,2,33,6,1,SAC,PHX,SAC,117,28.5,Pts+Rebs,41,35,39,8
De'Aaron Fox,G,22023,1628368,22300567,"JAN 16, 2024",SAC @ PHX,L,37,12,24,0.5,6,10,0.6,3,5,0.6,1,1,2,6,2,0,1,2,33,6,1,SAC,PHX,SAC,117,29.0,Pts+Asts,41,35,39,8
De'Aaron Fox,G,22023,1628368,22300567,"JAN 16, 2024",SAC @ PHX,L,37,12,24,0.5,6,10,0.6,3,5,0.6,1,1,2,6,2,0,1,2,33,6,1,SAC,PHX,SAC,117,8.5,Rebs+Asts,41,35,39,8
De'Aaron Fox,G,22023,1628368,22300567,"JAN 16, 2024",SAC @ PHX,L,37,12,24,0.5,6,10,0.6,3,5,0.6,1,1,2,6,2,0,1,2,33,6,1,SAC,PHX,SAC,117,2.5,Turnovers,41,35,39,8
De'Aaron Fox,G,22023,1628368,22300552,"JAN 14, 2024",SAC @ MIL,L,43,12,26,0.462,2,6,0.333,6,7,0.857,1,1,2,5,3,0,4,4,32,-3,1,SAC,MIL,SAC,142,24.5,Points,39,34,37,7
De'Aaron Fox,G,22023,1628368,22300552,"JAN 14, 2024",SAC @ MIL,L,43,12,26,0.462,2,6,0.333,6,7,0.857,1,1,2,5,3,0,4,4,32,-3,1,SAC,MIL,SAC,142,3.5,Rebounds,39,34,37,7
De'Aaron Fox,G,22023,1628368,22300552,"JAN 14, 2024",SAC @ MIL,L,43,12,26,0.462,2,6,0.333,6,7,0.857,1,1,2,5,3,0,4,4,32,-3,1,SAC,MIL,SAC,142,32.5,Pts+Rebs+Asts,39,34,37,7
De'Aaron Fox,G,22023,1628368,22300552,"JAN 14, 2024",SAC @ MIL,L,43,12,26,0.462,2,6,0.333,6,7,0.857,1,1,2,5,3,0,4,4,32,-3,1,SAC,MIL,SAC,142,39.5,Fantasy Score,39,34,37,7
De'Aaron Fox,G,22023,1628368,22300552,"JAN 14, 2024",SAC @ MIL,L,43,12,26,0.462,2,6,0.333,6,7,0.857,1,1,2,5,3,0,4,4,32,-3,1,SAC,MIL,SAC,142,2.5,3-PT Made,39,34,37,7
De'Aaron Fox,G,22023,1628368,22300552,"JAN 14, 2024",SAC @ MIL,L,43,12,26,0.462,2,6,0.333,6,7,0.857,1,1,2,5,3,0,4,4,32,-3,1,SAC,MIL,SAC,142,7.0,3-PT Attempted,39,34,37,7
De'Aaron Fox,G,22023,1628368,22300552,"JAN 14, 2024",SAC @ MIL,L,43,12,26,0.462,2,6,0.333,6,7,0.857,1,1,2,5,3,0,4,4,32,-3,1,SAC,MIL,SAC,142,3.5,Free Throws Made,39,34,37,7
De'Aaron Fox,G,22023,1628368,22300552,"JAN 14, 2024",SAC @ MIL,L,43,12,26,0.462,2,6,0.333,6,7,0.857,1,1,2,5,3,0,4,4,32,-3,1,SAC,MIL,SAC,142,19.0,FG Attempted,39,34,37,7
De'Aaron Fox,G,22023,1628368,22300552,"JAN 14, 2024",SAC @ MIL,L,43,12,26,0.462,2,6,0.333,6,7,0.857,1,1,2,5,3,0,4,4,32,-3,1,SAC,MIL,SAC,142,28.5,Pts+Rebs,39,34,37,7
De'Aaron Fox,G,22023,1628368,22300552,"JAN 14, 2024",SAC @ MIL,L,43,12,26,0.462,2,6,0.333,6,7,0.857,1,1,2,5,3,0,4,4,32,-3,1,SAC,MIL,SAC,142,29.0,Pts+Asts,39,34,37,7
De'Aaron Fox,G,22023,1628368,22300552,"JAN 14, 2024",SAC @ MIL,L,43,12,26,0.462,2,6,0.333,6,7,0.857,1,1,2,5,3,0,4,4,32,-3,1,SAC,MIL,SAC,142,8.5,Rebs+Asts,39,34,37,7
De'Aaron Fox,G,22023,1628368,22300552,"JAN 14, 2024",SAC @ MIL,L,43,12,26,0.462,2,6,0.333,6,7,0.857,1,1,2,5,3,0,4,4,32,-3,1,SAC,MIL,SAC,142,2.5,Turnovers,39,34,37,7
De'Aaron Fox,G,22023,1628368,22300532,"JAN 12, 2024",SAC @ PHI,L,38,5,15,0.333,2,7,0.286,9,11,0.818,1,4,5,4,1,0,2,2,21,-25,1,SAC,PHI,SAC,90,24.5,Points,30,26,25,9
De'Aaron Fox,G,22023,1628368,22300532,"JAN 12, 2024",SAC @ PHI,L,38,5,15,0.333,2,7,0.286,9,11,0.818,1,4,5,4,1,0,2,2,21,-25,1,SAC,PHI,SAC,90,3.5,Rebounds,30,26,25,9
De'Aaron Fox,G,22023,1628368,22300532,"JAN 12, 2024",SAC @ PHI,L,38,5,15,0.333,2,7,0.286,9,11,0.818,1,4,5,4,1,0,2,2,21,-25,1,SAC,PHI,SAC,90,32.5,Pts+Rebs+Asts,30,26,25,9
De'Aaron Fox,G,22023,1628368,22300532,"JAN 12, 2024",SAC @ PHI,L,38,5,15,0.333,2,7,0.286,9,11,0.818,1,4,5,4,1,0,2,2,21,-25,1,SAC,PHI,SAC,90,39.5,Fantasy Score,30,26,25,9
De'Aaron Fox,G,22023,1628368,22300532,"JAN 12, 2024",SAC @ PHI,L,38,5,15,0.333,2,7,0.286,9,11,0.818,1,4,5,4,1,0,2,2,21,-25,1,SAC,PHI,SAC,90,2.5,3-PT Made,30,26,25,9
De'Aaron Fox,G,22023,1628368,22300532,"JAN 12, 2024",SAC @ PHI,L,38,5,15,0.333,2,7,0.286,9,11,0.818,1,4,5,4,1,0,2,2,21,-25,1,SAC,PHI,SAC,90,7.0,3-PT Attempted,30,26,25,9
De'Aaron Fox,G,22023,1628368,22300532,"JAN 12, 2024",SAC @ PHI,L,38,5,15,0.333,2,7,0.286,9,11,0.818,1,4,5,4,1,0,2,2,21,-25,1,SAC,PHI,SAC,90,3.5,Free Throws Made,30,26,25,9
De'Aaron Fox,G,22023,1628368,22300532,"JAN 12, 2024",SAC @ PHI,L,38,5,15,0.333,2,7,0.286,9,11,0.818,1,4,5,4,1,0,2,2,21,-25,1,SAC,PHI,SAC,90,19.0,FG Attempted,30,26,25,9
De'Aaron Fox,G,22023,1628368,22300532,"JAN 12, 2024",SAC @ PHI,L,38,5,15,0.333,2,7,0.286,9,11,0.818,1,4,5,4,1,0,2,2,21,-25,1,SAC,PHI,SAC,90,28.5,Pts+Rebs,30,26,25,9
De'Aaron Fox,G,22023,1628368,22300532,"JAN 12, 2024",SAC @ PHI,L,38,5,15,0.333,2,7,0.286,9,11,0.818,1,4,5,4,1,0,2,2,21,-25,1,SAC,PHI,SAC,90,29.0,Pts+Asts,30,26,25,9
De'Aaron Fox,G,22023,1628368,22300532,"JAN 12, 2024",SAC @ PHI,L,38,5,15,0.333,2,7,0.286,9,11,0.818,1,4,5,4,1,0,2,2,21,-25,1,SAC,PHI,SAC,90,8.5,Rebs+Asts,30,26,25,9
De'Aaron Fox,G,22023,1628368,22300532,"JAN 12, 2024",SAC @ PHI,L,38,5,15,0.333,2,7,0.286,9,11,0.818,1,4,5,4,1,0,2,2,21,-25,1,SAC,PHI,SAC,90,2.5,Turnovers,30,26,25,9
De'Aaron Fox,G,22023,1628368,22300518,"JAN 10, 2024",SAC @ CHA,W,28,8,14,0.571,3,7,0.429,0,2,0.0,0,1,1,3,1,1,1,0,19,25,1,SAC,CHA,SAC,121,24.5,Points,23,20,22,4
De'Aaron Fox,G,22023,1628368,22300518,"JAN 10, 2024",SAC @ CHA,W,28,8,14,0.571,3,7,0.429,0,2,0.0,0,1,1,3,1,1,1,0,19,25,1,SAC,CHA,SAC,121,3.5,Rebounds,23,20,22,4
De'Aaron Fox,G,22023,1628368,22300518,"JAN 10, 2024",SAC @ CHA,W,28,8,14,0.571,3,7,0.429,0,2,0.0,0,1,1,3,1,1,1,0,19,25,1,SAC,CHA,SAC,121,32.5,Pts+Rebs+Asts,23,20,22,4
De'Aaron Fox,G,22023,1628368,22300518,"JAN 10, 2024",SAC @ CHA,W,28,8,14,0.571,3,7,0.429,0,2,0.0,0,1,1,3,1,1,1,0,19,25,1,SAC,CHA,SAC,121,39.5,Fantasy Score,23,20,22,4
De'Aaron Fox,G,22023,1628368,22300518,"JAN 10, 2024",SAC @ CHA,W,28,8,14,0.571,3,7,0.429,0,2,0.0,0,1,1,3,1,1,1,0,19,25,1,SAC,CHA,SAC,121,2.5,3-PT Made,23,20,22,4
De'Aaron Fox,G,22023,1628368,22300518,"JAN 10, 2024",SAC @ CHA,W,28,8,14,0.571,3,7,0.429,0,2,0.0,0,1,1,3,1,1,1,0,19,25,1,SAC,CHA,SAC,121,7.0,3-PT Attempted,23,20,22,4
De'Aaron Fox,G,22023,1628368,22300518,"JAN 10, 2024",SAC @ CHA,W,28,8,14,0.571,3,7,0.429,0,2,0.0,0,1,1,3,1,1,1,0,19,25,1,SAC,CHA,SAC,121,3.5,Free Throws Made,23,20,22,4
De'Aaron Fox,G,22023,1628368,22300518,"JAN 10, 2024",SAC @ CHA,W,28,8,14,0.571,3,7,0.429,0,2,0.0,0,1,1,3,1,1,1,0,19,25,1,SAC,CHA,SAC,121,19.0,FG Attempted,23,20,22,4
De'Aaron Fox,G,22023,1628368,22300518,"JAN 10, 2024",SAC @ CHA,W,28,8,14,0.571,3,7,0.429,0,2,0.0,0,1,1,3,1,1,1,0,19,25,1,SAC,CHA,SAC,121,28.5,Pts+Rebs,23,20,22,4
De'Aaron Fox,G,22023,1628368,22300518,"JAN 10, 2024",SAC @ CHA,W,28,8,14,0.571,3,7,0.429,0,2,0.0,0,1,1,3,1,1,1,0,19,25,1,SAC,CHA,SAC,121,29.0,Pts+Asts,23,20,22,4
De'Aaron Fox,G,22023,1628368,22300518,"JAN 10, 2024",SAC @ CHA,W,28,8,14,0.571,3,7,0.429,0,2,0.0,0,1,1,3,1,1,1,0,19,25,1,SAC,CHA,SAC,121,8.5,Rebs+Asts,23,20,22,4
De'Aaron Fox,G,22023,1628368,22300518,"JAN 10, 2024",SAC @ CHA,W,28,8,14,0.571,3,7,0.429,0,2,0.0,0,1,1,3,1,1,1,0,19,25,1,SAC,CHA,SAC,121,2.5,Turnovers,23,20,22,4
De'Aaron Fox,G,22023,1628368,22300512,"JAN 09, 2024",SAC @ DET,W,33,10,19,0.526,4,7,0.571,2,2,1.0,0,3,3,4,2,0,5,2,26,2,1,SAC,DET,SAC,131,24.5,Points,33,29,30,7
De'Aaron Fox,G,22023,1628368,22300512,"JAN 09, 2024",SAC @ DET,W,33,10,19,0.526,4,7,0.571,2,2,1.0,0,3,3,4,2,0,5,2,26,2,1,SAC,DET,SAC,131,3.5,Rebounds,33,29,30,7
De'Aaron Fox,G,22023,1628368,22300512,"JAN 09, 2024",SAC @ DET,W,33,10,19,0.526,4,7,0.571,2,2,1.0,0,3,3,4,2,0,5,2,26,2,1,SAC,DET,SAC,131,32.5,Pts+Rebs+Asts,33,29,30,7
De'Aaron Fox,G,22023,1628368,22300512,"JAN 09, 2024",SAC @ DET,W,33,10,19,0.526,4,7,0.571,2,2,1.0,0,3,3,4,2,0,5,2,26,2,1,SAC,DET,SAC,131,39.5,Fantasy Score,33,29,30,7
De'Aaron Fox,G,22023,1628368,22300512,"JAN 09, 2024",SAC @ DET,W,33,10,19,0.526,4,7,0.571,2,2,1.0,0,3,3,4,2,0,5,2,26,2,1,SAC,DET,SAC,131,2.5,3-PT Made,33,29,30,7
De'Aaron Fox,G,22023,1628368,22300512,"JAN 09, 2024",SAC @ DET,W,33,10,19,0.526,4,7,0.571,2,2,1.0,0,3,3,4,2,0,5,2,26,2,1,SAC,DET,SAC,131,7.0,3-PT Attempted,33,29,30,7
De'Aaron Fox,G,22023,1628368,22300512,"JAN 09, 2024",SAC @ DET,W,33,10,19,0.526,4,7,0.571,2,2,1.0,0,3,3,4,2,0,5,2,26,2,1,SAC,DET,SAC,131,3.5,Free Throws Made,33,29,30,7
De'Aaron Fox,G,22023,1628368,22300512,"JAN 09, 2024",SAC @ DET,W,33,10,19,0.526,4,7,0.571,2,2,1.0,0,3,3,4,2,0,5,2,26,2,1,SAC,DET,SAC,131,19.0,FG Attempted,33,29,30,7
De'Aaron Fox,G,22023,1628368,22300512,"JAN 09, 2024",SAC @ DET,W,33,10,19,0.526,4,7,0.571,2,2,1.0,0,3,3,4,2,0,5,2,26,2,1,SAC,DET,SAC,131,28.5,Pts+Rebs,33,29,30,7
De'Aaron Fox,G,22023,1628368,22300512,"JAN 09, 2024",SAC @ DET,W,33,10,19,0.526,4,7,0.571,2,2,1.0,0,3,3,4,2,0,5,2,26,2,1,SAC,DET,SAC,131,29.0,Pts+Asts,33,29,30,7
De'Aaron Fox,G,22023,1628368,22300512,"JAN 09, 2024",SAC @ DET,W,33,10,19,0.526,4,7,0.571,2,2,1.0,0,3,3,4,2,0,5,2,26,2,1,SAC,DET,SAC,131,8.5,Rebs+Asts,33,29,30,7
De'Aaron Fox,G,22023,1628368,22300512,"JAN 09, 2024",SAC @ DET,W,33,10,19,0.526,4,7,0.571,2,2,1.0,0,3,3,4,2,0,5,2,26,2,1,SAC,DET,SAC,131,2.5,Turnovers,33,29,30,7
De'Aaron Fox,G,22023,1628368,22300500,"JAN 07, 2024",SAC vs. NOP,L,26,1,10,0.1,1,4,0.25,0,0,0.0,0,2,2,4,0,0,4,3,3,-30,1,SAC,SAC,NOP,100,24.5,Points,9,5,7,6
De'Aaron Fox,G,22023,1628368,22300500,"JAN 07, 2024",SAC vs. NOP,L,26,1,10,0.1,1,4,0.25,0,0,0.0,0,2,2,4,0,0,4,3,3,-30,1,SAC,SAC,NOP,100,3.5,Rebounds,9,5,7,6
De'Aaron Fox,G,22023,1628368,22300500,"JAN 07, 2024",SAC vs. NOP,L,26,1,10,0.1,1,4,0.25,0,0,0.0,0,2,2,4,0,0,4,3,3,-30,1,SAC,SAC,NOP,100,32.5,Pts+Rebs+Asts,9,5,7,6
De'Aaron Fox,G,22023,1628368,22300500,"JAN 07, 2024",SAC vs. NOP,L,26,1,10,0.1,1,4,0.25,0,0,0.0,0,2,2,4,0,0,4,3,3,-30,1,SAC,SAC,NOP,100,39.5,Fantasy Score,9,5,7,6
De'Aaron Fox,G,22023,1628368,22300500,"JAN 07, 2024",SAC vs. NOP,L,26,1,10,0.1,1,4,0.25,0,0,0.0,0,2,2,4,0,0,4,3,3,-30,1,SAC,SAC,NOP,100,2.5,3-PT Made,9,5,7,6
De'Aaron Fox,G,22023,1628368,22300500,"JAN 07, 2024",SAC vs. NOP,L,26,1,10,0.1,1,4,0.25,0,0,0.0,0,2,2,4,0,0,4,3,3,-30,1,SAC,SAC,NOP,100,7.0,3-PT Attempted,9,5,7,6
De'Aaron Fox,G,22023,1628368,22300500,"JAN 07, 2024",SAC vs. NOP,L,26,1,10,0.1,1,4,0.25,0,0,0.0,0,2,2,4,0,0,4,3,3,-30,1,SAC,SAC,NOP,100,3.5,Free Throws Made,9,5,7,6
De'Aaron Fox,G,22023,1628368,22300500,"JAN 07, 2024",SAC vs. NOP,L,26,1,10,0.1,1,4,0.25,0,0,0.0,0,2,2,4,0,0,4,3,3,-30,1,SAC,SAC,NOP,100,19.0,FG Attempted,9,5,7,6
De'Aaron Fox,G,22023,1628368,22300500,"JAN 07, 2024",SAC vs. NOP,L,26,1,10,0.1,1,4,0.25,0,0,0.0,0,2,2,4,0,0,4,3,3,-30,1,SAC,SAC,NOP,100,28.5,Pts+Rebs,9,5,7,6
De'Aaron Fox,G,22023,1628368,22300500,"JAN 07, 2024",SAC vs. NOP,L,26,1,10,0.1,1,4,0.25,0,0,0.0,0,2,2,4,0,0,4,3,3,-30,1,SAC,SAC,NOP,100,29.0,Pts+Asts,9,5,7,6
De'Aaron Fox,G,22023,1628368,22300500,"JAN 07, 2024",SAC vs. NOP,L,26,1,10,0.1,1,4,0.25,0,0,0.0,0,2,2,4,0,0,4,3,3,-30,1,SAC,SAC,NOP,100,8.5,Rebs+Asts,9,5,7,6
De'Aaron Fox,G,22023,1628368,22300500,"JAN 07, 2024",SAC vs. NOP,L,26,1,10,0.1,1,4,0.25,0,0,0.0,0,2,2,4,0,0,4,3,3,-30,1,SAC,SAC,NOP,100,2.5,Turnovers,9,5,7,6
De'Aaron Fox,G,22023,1628368,22300492,"JAN 05, 2024",SAC vs. TOR,W,37,10,20,0.5,1,3,0.333,3,3,1.0,1,1,2,4,2,1,2,4,24,-1,1,SAC,SAC,TOR,135,24.5,Points,30,26,28,6
De'Aaron Fox,G,22023,1628368,22300492,"JAN 05, 2024",SAC vs. TOR,W,37,10,20,0.5,1,3,0.333,3,3,1.0,1,1,2,4,2,1,2,4,24,-1,1,SAC,SAC,TOR,135,3.5,Rebounds,30,26,28,6
De'Aaron Fox,G,22023,1628368,22300492,"JAN 05, 2024",SAC vs. TOR,W,37,10,20,0.5,1,3,0.333,3,3,1.0,1,1,2,4,2,1,2,4,24,-1,1,SAC,SAC,TOR,135,32.5,Pts+Rebs+Asts,30,26,28,6
De'Aaron Fox,G,22023,1628368,22300492,"JAN 05, 2024",SAC vs. TOR,W,37,10,20,0.5,1,3,0.333,3,3,1.0,1,1,2,4,2,1,2,4,24,-1,1,SAC,SAC,TOR,135,39.5,Fantasy Score,30,26,28,6
De'Aaron Fox,G,22023,1628368,22300492,"JAN 05, 2024",SAC vs. TOR,W,37,10,20,0.5,1,3,0.333,3,3,1.0,1,1,2,4,2,1,2,4,24,-1,1,SAC,SAC,TOR,135,2.5,3-PT Made,30,26,28,6
De'Aaron Fox,G,22023,1628368,22300492,"JAN 05, 2024",SAC vs. TOR,W,37,10,20,0.5,1,3,0.333,3,3,1.0,1,1,2,4,2,1,2,4,24,-1,1,SAC,SAC,TOR,135,7.0,3-PT Attempted,30,26,28,6
De'Aaron Fox,G,22023,1628368,22300492,"JAN 05, 2024",SAC vs. TOR,W,37,10,20,0.5,1,3,0.333,3,3,1.0,1,1,2,4,2,1,2,4,24,-1,1,SAC,SAC,TOR,135,3.5,Free Throws Made,30,26,28,6
De'Aaron Fox,G,22023,1628368,22300492,"JAN 05, 2024",SAC vs. TOR,W,37,10,20,0.5,1,3,0.333,3,3,1.0,1,1,2,4,2,1,2,4,24,-1,1,SAC,SAC,TOR,135,19.0,FG Attempted,30,26,28,6
De'Aaron Fox,G,22023,1628368,22300492,"JAN 05, 2024",SAC vs. TOR,W,37,10,20,0.5,1,3,0.333,3,3,1.0,1,1,2,4,2,1,2,4,24,-1,1,SAC,SAC,TOR,135,28.5,Pts+Rebs,30,26,28,6
De'Aaron Fox,G,22023,1628368,22300492,"JAN 05, 2024",SAC vs. TOR,W,37,10,20,0.5,1,3,0.333,3,3,1.0,1,1,2,4,2,1,2,4,24,-1,1,SAC,SAC,TOR,135,29.0,Pts+Asts,30,26,28,6
De'Aaron Fox,G,22023,1628368,22300492,"JAN 05, 2024",SAC vs. TOR,W,37,10,20,0.5,1,3,0.333,3,3,1.0,1,1,2,4,2,1,2,4,24,-1,1,SAC,SAC,TOR,135,8.5,Rebs+Asts,30,26,28,6
De'Aaron Fox,G,22023,1628368,22300492,"JAN 05, 2024",SAC vs. TOR,W,37,10,20,0.5,1,3,0.333,3,3,1.0,1,1,2,4,2,1,2,4,24,-1,1,SAC,SAC,TOR,135,2.5,Turnovers,30,26,28,6
De'Aaron Fox,G,22023,1628368,22300476,"JAN 03, 2024",SAC vs. ORL,W,44,6,22,0.273,0,5,0.0,3,4,0.75,3,1,4,7,1,0,3,1,15,-1,1,SAC,SAC,ORL,138,24.5,Points,26,19,22,11
De'Aaron Fox,G,22023,1628368,22300476,"JAN 03, 2024",SAC vs. ORL,W,44,6,22,0.273,0,5,0.0,3,4,0.75,3,1,4,7,1,0,3,1,15,-1,1,SAC,SAC,ORL,138,3.5,Rebounds,26,19,22,11
De'Aaron Fox,G,22023,1628368,22300476,"JAN 03, 2024",SAC vs. ORL,W,44,6,22,0.273,0,5,0.0,3,4,0.75,3,1,4,7,1,0,3,1,15,-1,1,SAC,SAC,ORL,138,32.5,Pts+Rebs+Asts,26,19,22,11
De'Aaron Fox,G,22023,1628368,22300476,"JAN 03, 2024",SAC vs. ORL,W,44,6,22,0.273,0,5,0.0,3,4,0.75,3,1,4,7,1,0,3,1,15,-1,1,SAC,SAC,ORL,138,39.5,Fantasy Score,26,19,22,11
De'Aaron Fox,G,22023,1628368,22300476,"JAN 03, 2024",SAC vs. ORL,W,44,6,22,0.273,0,5,0.0,3,4,0.75,3,1,4,7,1,0,3,1,15,-1,1,SAC,SAC,ORL,138,2.5,3-PT Made,26,19,22,11
De'Aaron Fox,G,22023,1628368,22300476,"JAN 03, 2024",SAC vs. ORL,W,44,6,22,0.273,0,5,0.0,3,4,0.75,3,1,4,7,1,0,3,1,15,-1,1,SAC,SAC,ORL,138,7.0,3-PT Attempted,26,19,22,11
De'Aaron Fox,G,22023,1628368,22300476,"JAN 03, 2024",SAC vs. ORL,W,44,6,22,0.273,0,5,0.0,3,4,0.75,3,1,4,7,1,0,3,1,15,-1,1,SAC,SAC,ORL,138,3.5,Free Throws Made,26,19,22,11
De'Aaron Fox,G,22023,1628368,22300476,"JAN 03, 2024",SAC vs. ORL,W,44,6,22,0.273,0,5,0.0,3,4,0.75,3,1,4,7,1,0,3,1,15,-1,1,SAC,SAC,ORL,138,19.0,FG Attempted,26,19,22,11
De'Aaron Fox,G,22023,1628368,22300476,"JAN 03, 2024",SAC vs. ORL,W,44,6,22,0.273,0,5,0.0,3,4,0.75,3,1,4,7,1,0,3,1,15,-1,1,SAC,SAC,ORL,138,28.5,Pts+Rebs,26,19,22,11
De'Aaron Fox,G,22023,1628368,22300476,"JAN 03, 2024",SAC vs. ORL,W,44,6,22,0.273,0,5,0.0,3,4,0.75,3,1,4,7,1,0,3,1,15,-1,1,SAC,SAC,ORL,138,29.0,Pts+Asts,26,19,22,11
De'Aaron Fox,G,22023,1628368,22300476,"JAN 03, 2024",SAC vs. ORL,W,44,6,22,0.273,0,5,0.0,3,4,0.75,3,1,4,7,1,0,3,1,15,-1,1,SAC,SAC,ORL,138,8.5,Rebs+Asts,26,19,22,11
De'Aaron Fox,G,22023,1628368,22300476,"JAN 03, 2024",SAC vs. ORL,W,44,6,22,0.273,0,5,0.0,3,4,0.75,3,1,4,7,1,0,3,1,15,-1,1,SAC,SAC,ORL,138,2.5,Turnovers,26,19,22,11
De'Aaron Fox,G,22023,1628368,22300464,"JAN 02, 2024",SAC vs. CHA,L,38,11,25,0.44,3,10,0.3,5,8,0.625,0,5,5,6,1,1,3,2,30,4,1,SAC,SAC,CHA,104,24.5,Points,41,35,36,11
De'Aaron Fox,G,22023,1628368,22300464,"JAN 02, 2024",SAC vs. CHA,L,38,11,25,0.44,3,10,0.3,5,8,0.625,0,5,5,6,1,1,3,2,30,4,1,SAC,SAC,CHA,104,3.5,Rebounds,41,35,36,11
De'Aaron Fox,G,22023,1628368,22300464,"JAN 02, 2024",SAC vs. CHA,L,38,11,25,0.44,3,10,0.3,5,8,0.625,0,5,5,6,1,1,3,2,30,4,1,SAC,SAC,CHA,104,32.5,Pts+Rebs+Asts,41,35,36,11
De'Aaron Fox,G,22023,1628368,22300464,"JAN 02, 2024",SAC vs. CHA,L,38,11,25,0.44,3,10,0.3,5,8,0.625,0,5,5,6,1,1,3,2,30,4,1,SAC,SAC,CHA,104,39.5,Fantasy Score,41,35,36,11
De'Aaron Fox,G,22023,1628368,22300464,"JAN 02, 2024",SAC vs. CHA,L,38,11,25,0.44,3,10,0.3,5,8,0.625,0,5,5,6,1,1,3,2,30,4,1,SAC,SAC,CHA,104,2.5,3-PT Made,41,35,36,11
De'Aaron Fox,G,22023,1628368,22300464,"JAN 02, 2024",SAC vs. CHA,L,38,11,25,0.44,3,10,0.3,5,8,0.625,0,5,5,6,1,1,3,2,30,4,1,SAC,SAC,CHA,104,7.0,3-PT Attempted,41,35,36,11
De'Aaron Fox,G,22023,1628368,22300464,"JAN 02, 2024",SAC vs. CHA,L,38,11,25,0.44,3,10,0.3,5,8,0.625,0,5,5,6,1,1,3,2,30,4,1,SAC,SAC,CHA,104,3.5,Free Throws Made,41,35,36,11
De'Aaron Fox,G,22023,1628368,22300464,"JAN 02, 2024",SAC vs. CHA,L,38,11,25,0.44,3,10,0.3,5,8,0.625,0,5,5,6,1,1,3,2,30,4,1,SAC,SAC,CHA,104,19.0,FG Attempted,41,35,36,11
De'Aaron Fox,G,22023,1628368,22300464,"JAN 02, 2024",SAC vs. CHA,L,38,11,25,0.44,3,10,0.3,5,8,0.625,0,5,5,6,1,1,3,2,30,4,1,SAC,SAC,CHA,104,28.5,Pts+Rebs,41,35,36,11
De'Aaron Fox,G,22023,1628368,22300464,"JAN 02, 2024",SAC vs. CHA,L,38,11,25,0.44,3,10,0.3,5,8,0.625,0,5,5,6,1,1,3,2,30,4,1,SAC,SAC,CHA,104,29.0,Pts+Asts,41,35,36,11
De'Aaron Fox,G,22023,1628368,22300464,"JAN 02, 2024",SAC vs. CHA,L,38,11,25,0.44,3,10,0.3,5,8,0.625,0,5,5,6,1,1,3,2,30,4,1,SAC,SAC,CHA,104,8.5,Rebs+Asts,41,35,36,11
De'Aaron Fox,G,22023,1628368,22300464,"JAN 02, 2024",SAC vs. CHA,L,38,11,25,0.44,3,10,0.3,5,8,0.625,0,5,5,6,1,1,3,2,30,4,1,SAC,SAC,CHA,104,2.5,Turnovers,41,35,36,11
De'Aaron Fox,G,22023,1628368,22300449,"DEC 31, 2023",SAC @ MEM,W,34,9,23,0.391,3,8,0.375,3,5,0.6,1,3,4,4,0,1,1,3,24,20,1,SAC,MEM,SAC,123,24.5,Points,32,28,28,8
De'Aaron Fox,G,22023,1628368,22300449,"DEC 31, 2023",SAC @ MEM,W,34,9,23,0.391,3,8,0.375,3,5,0.6,1,3,4,4,0,1,1,3,24,20,1,SAC,MEM,SAC,123,3.5,Rebounds,32,28,28,8
De'Aaron Fox,G,22023,1628368,22300449,"DEC 31, 2023",SAC @ MEM,W,34,9,23,0.391,3,8,0.375,3,5,0.6,1,3,4,4,0,1,1,3,24,20,1,SAC,MEM,SAC,123,32.5,Pts+Rebs+Asts,32,28,28,8
De'Aaron Fox,G,22023,1628368,22300449,"DEC 31, 2023",SAC @ MEM,W,34,9,23,0.391,3,8,0.375,3,5,0.6,1,3,4,4,0,1,1,3,24,20,1,SAC,MEM,SAC,123,39.5,Fantasy Score,32,28,28,8
De'Aaron Fox,G,22023,1628368,22300449,"DEC 31, 2023",SAC @ MEM,W,34,9,23,0.391,3,8,0.375,3,5,0.6,1,3,4,4,0,1,1,3,24,20,1,SAC,MEM,SAC,123,2.5,3-PT Made,32,28,28,8
De'Aaron Fox,G,22023,1628368,22300449,"DEC 31, 2023",SAC @ MEM,W,34,9,23,0.391,3,8,0.375,3,5,0.6,1,3,4,4,0,1,1,3,24,20,1,SAC,MEM,SAC,123,7.0,3-PT Attempted,32,28,28,8
De'Aaron Fox,G,22023,1628368,22300449,"DEC 31, 2023",SAC @ MEM,W,34,9,23,0.391,3,8,0.375,3,5,0.6,1,3,4,4,0,1,1,3,24,20,1,SAC,MEM,SAC,123,3.5,Free Throws Made,32,28,28,8
De'Aaron Fox,G,22023,1628368,22300449,"DEC 31, 2023",SAC @ MEM,W,34,9,23,0.391,3,8,0.375,3,5,0.6,1,3,4,4,0,1,1,3,24,20,1,SAC,MEM,SAC,123,19.0,FG Attempted,32,28,28,8
De'Aaron Fox,G,22023,1628368,22300449,"DEC 31, 2023",SAC @ MEM,W,34,9,23,0.391,3,8,0.375,3,5,0.6,1,3,4,4,0,1,1,3,24,20,1,SAC,MEM,SAC,123,28.5,Pts+Rebs,32,28,28,8
De'Aaron Fox,G,22023,1628368,22300449,"DEC 31, 2023",SAC @ MEM,W,34,9,23,0.391,3,8,0.375,3,5,0.6,1,3,4,4,0,1,1,3,24,20,1,SAC,MEM,SAC,123,29.0,Pts+Asts,32,28,28,8
De'Aaron Fox,G,22023,1628368,22300449,"DEC 31, 2023",SAC @ MEM,W,34,9,23,0.391,3,8,0.375,3,5,0.6,1,3,4,4,0,1,1,3,24,20,1,SAC,MEM,SAC,123,8.5,Rebs+Asts,32,28,28,8
De'Aaron Fox,G,22023,1628368,22300449,"DEC 31, 2023",SAC @ MEM,W,34,9,23,0.391,3,8,0.375,3,5,0.6,1,3,4,4,0,1,1,3,24,20,1,SAC,MEM,SAC,123,2.5,Turnovers,32,28,28,8
De'Aaron Fox,G,22023,1628368,22300431,"DEC 29, 2023",SAC @ ATL,W,41,10,20,0.5,8,16,0.5,3,7,0.429,1,4,5,8,5,0,3,3,31,9,1,SAC,ATL,SAC,117,24.5,Points,44,36,39,13
De'Aaron Fox,G,22023,1628368,22300431,"DEC 29, 2023",SAC @ ATL,W,41,10,20,0.5,8,16,0.5,3,7,0.429,1,4,5,8,5,0,3,3,31,9,1,SAC,ATL,SAC,117,3.5,Rebounds,44,36,39,13
De'Aaron Fox,G,22023,1628368,22300431,"DEC 29, 2023",SAC @ ATL,W,41,10,20,0.5,8,16,0.5,3,7,0.429,1,4,5,8,5,0,3,3,31,9,1,SAC,ATL,SAC,117,32.5,Pts+Rebs+Asts,44,36,39,13
De'Aaron Fox,G,22023,1628368,22300431,"DEC 29, 2023",SAC @ ATL,W,41,10,20,0.5,8,16,0.5,3,7,0.429,1,4,5,8,5,0,3,3,31,9,1,SAC,ATL,SAC,117,39.5,Fantasy Score,44,36,39,13
De'Aaron Fox,G,22023,1628368,22300431,"DEC 29, 2023",SAC @ ATL,W,41,10,20,0.5,8,16,0.5,3,7,0.429,1,4,5,8,5,0,3,3,31,9,1,SAC,ATL,SAC,117,2.5,3-PT Made,44,36,39,13
De'Aaron Fox,G,22023,1628368,22300431,"DEC 29, 2023",SAC @ ATL,W,41,10,20,0.5,8,16,0.5,3,7,0.429,1,4,5,8,5,0,3,3,31,9,1,SAC,ATL,SAC,117,7.0,3-PT Attempted,44,36,39,13
De'Aaron Fox,G,22023,1628368,22300431,"DEC 29, 2023",SAC @ ATL,W,41,10,20,0.5,8,16,0.5,3,7,0.429,1,4,5,8,5,0,3,3,31,9,1,SAC,ATL,SAC,117,3.5,Free Throws Made,44,36,39,13
De'Aaron Fox,G,22023,1628368,22300431,"DEC 29, 2023",SAC @ ATL,W,41,10,20,0.5,8,16,0.5,3,7,0.429,1,4,5,8,5,0,3,3,31,9,1,SAC,ATL,SAC,117,19.0,FG Attempted,44,36,39,13
De'Aaron Fox,G,22023,1628368,22300431,"DEC 29, 2023",SAC @ ATL,W,41,10,20,0.5,8,16,0.5,3,7,0.429,1,4,5,8,5,0,3,3,31,9,1,SAC,ATL,SAC,117,28.5,Pts+Rebs,44,36,39,13
De'Aaron Fox,G,22023,1628368,22300431,"DEC 29, 2023",SAC @ ATL,W,41,10,20,0.5,8,16,0.5,3,7,0.429,1,4,5,8,5,0,3,3,31,9,1,SAC,ATL,SAC,117,29.0,Pts+Asts,44,36,39,13
De'Aaron Fox,G,22023,1628368,22300431,"DEC 29, 2023",SAC @ ATL,W,41,10,20,0.5,8,16,0.5,3,7,0.429,1,4,5,8,5,0,3,3,31,9,1,SAC,ATL,SAC,117,8.5,Rebs+Asts,44,36,39,13
De'Aaron Fox,G,22023,1628368,22300431,"DEC 29, 2023",SAC @ ATL,W,41,10,20,0.5,8,16,0.5,3,7,0.429,1,4,5,8,5,0,3,3,31,9,1,SAC,ATL,SAC,117,2.5,Turnovers,44,36,39,13
De'Aaron Fox,G,22023,1628368,22300413,"DEC 26, 2023",SAC @ POR,L,38,16,26,0.615,7,15,0.467,4,6,0.667,2,6,8,4,1,1,5,2,43,-2,1,SAC,POR,SAC,113,24.5,Points,55,51,47,12
De'Aaron Fox,G,22023,1628368,22300413,"DEC 26, 2023",SAC @ POR,L,38,16,26,0.615,7,15,0.467,4,6,0.667,2,6,8,4,1,1,5,2,43,-2,1,SAC,POR,SAC,113,3.5,Rebounds,55,51,47,12
De'Aaron Fox,G,22023,1628368,22300413,"DEC 26, 2023",SAC @ POR,L,38,16,26,0.615,7,15,0.467,4,6,0.667,2,6,8,4,1,1,5,2,43,-2,1,SAC,POR,SAC,113,32.5,Pts+Rebs+Asts,55,51,47,12
De'Aaron Fox,G,22023,1628368,22300413,"DEC 26, 2023",SAC @ POR,L,38,16,26,0.615,7,15,0.467,4,6,0.667,2,6,8,4,1,1,5,2,43,-2,1,SAC,POR,SAC,113,39.5,Fantasy Score,55,51,47,12
De'Aaron Fox,G,22023,1628368,22300413,"DEC 26, 2023",SAC @ POR,L,38,16,26,0.615,7,15,0.467,4,6,0.667,2,6,8,4,1,1,5,2,43,-2,1,SAC,POR,SAC,113,2.5,3-PT Made,55,51,47,12
De'Aaron Fox,G,22023,1628368,22300413,"DEC 26, 2023",SAC @ POR,L,38,16,26,0.615,7,15,0.467,4,6,0.667,2,6,8,4,1,1,5,2,43,-2,1,SAC,POR,SAC,113,7.0,3-PT Attempted,55,51,47,12
De'Aaron Fox,G,22023,1628368,22300413,"DEC 26, 2023",SAC @ POR,L,38,16,26,0.615,7,15,0.467,4,6,0.667,2,6,8,4,1,1,5,2,43,-2,1,SAC,POR,SAC,113,3.5,Free Throws Made,55,51,47,12
De'Aaron Fox,G,22023,1628368,22300413,"DEC 26, 2023",SAC @ POR,L,38,16,26,0.615,7,15,0.467,4,6,0.667,2,6,8,4,1,1,5,2,43,-2,1,SAC,POR,SAC,113,19.0,FG Attempted,55,51,47,12
De'Aaron Fox,G,22023,1628368,22300413,"DEC 26, 2023",SAC @ POR,L,38,16,26,0.615,7,15,0.467,4,6,0.667,2,6,8,4,1,1,5,2,43,-2,1,SAC,POR,SAC,113,28.5,Pts+Rebs,55,51,47,12
De'Aaron Fox,G,22023,1628368,22300413,"DEC 26, 2023",SAC @ POR,L,38,16,26,0.615,7,15,0.467,4,6,0.667,2,6,8,4,1,1,5,2,43,-2,1,SAC,POR,SAC,113,29.0,Pts+Asts,55,51,47,12
De'Aaron Fox,G,22023,1628368,22300413,"DEC 26, 2023",SAC @ POR,L,38,16,26,0.615,7,15,0.467,4,6,0.667,2,6,8,4,1,1,5,2,43,-2,1,SAC,POR,SAC,113,8.5,Rebs+Asts,55,51,47,12
De'Aaron Fox,G,22023,1628368,22300413,"DEC 26, 2023",SAC @ POR,L,38,16,26,0.615,7,15,0.467,4,6,0.667,2,6,8,4,1,1,5,2,43,-2,1,SAC,POR,SAC,113,2.5,Turnovers,55,51,47,12
De'Aaron Fox,G,22023,1628368,22300400,"DEC 23, 2023",SAC vs. MIN,L,39,10,23,0.435,3,11,0.273,4,4,1.0,2,2,4,6,2,0,3,1,27,-4,1,SAC,SAC,MIN,98,24.5,Points,37,31,33,10
De'Aaron Fox,G,22023,1628368,22300400,"DEC 23, 2023",SAC vs. MIN,L,39,10,23,0.435,3,11,0.273,4,4,1.0,2,2,4,6,2,0,3,1,27,-4,1,SAC,SAC,MIN,98,3.5,Rebounds,37,31,33,10
De'Aaron Fox,G,22023,1628368,22300400,"DEC 23, 2023",SAC vs. MIN,L,39,10,23,0.435,3,11,0.273,4,4,1.0,2,2,4,6,2,0,3,1,27,-4,1,SAC,SAC,MIN,98,32.5,Pts+Rebs+Asts,37,31,33,10
De'Aaron Fox,G,22023,1628368,22300400,"DEC 23, 2023",SAC vs. MIN,L,39,10,23,0.435,3,11,0.273,4,4,1.0,2,2,4,6,2,0,3,1,27,-4,1,SAC,SAC,MIN,98,39.5,Fantasy Score,37,31,33,10
De'Aaron Fox,G,22023,1628368,22300400,"DEC 23, 2023",SAC vs. MIN,L,39,10,23,0.435,3,11,0.273,4,4,1.0,2,2,4,6,2,0,3,1,27,-4,1,SAC,SAC,MIN,98,2.5,3-PT Made,37,31,33,10
De'Aaron Fox,G,22023,1628368,22300400,"DEC 23, 2023",SAC vs. MIN,L,39,10,23,0.435,3,11,0.273,4,4,1.0,2,2,4,6,2,0,3,1,27,-4,1,SAC,SAC,MIN,98,7.0,3-PT Attempted,37,31,33,10
De'Aaron Fox,G,22023,1628368,22300400,"DEC 23, 2023",SAC vs. MIN,L,39,10,23,0.435,3,11,0.273,4,4,1.0,2,2,4,6,2,0,3,1,27,-4,1,SAC,SAC,MIN,98,3.5,Free Throws Made,37,31,33,10
De'Aaron Fox,G,22023,1628368,22300400,"DEC 23, 2023",SAC vs. MIN,L,39,10,23,0.435,3,11,0.273,4,4,1.0,2,2,4,6,2,0,3,1,27,-4,1,SAC,SAC,MIN,98,19.0,FG Attempted,37,31,33,10
De'Aaron Fox,G,22023,1628368,22300400,"DEC 23, 2023",SAC vs. MIN,L,39,10,23,0.435,3,11,0.273,4,4,1.0,2,2,4,6,2,0,3,1,27,-4,1,SAC,SAC,MIN,98,28.5,Pts+Rebs,37,31,33,10
De'Aaron Fox,G,22023,1628368,22300400,"DEC 23, 2023",SAC vs. MIN,L,39,10,23,0.435,3,11,0.273,4,4,1.0,2,2,4,6,2,0,3,1,27,-4,1,SAC,SAC,MIN,98,29.0,Pts+Asts,37,31,33,10
De'Aaron Fox,G,22023,1628368,22300400,"DEC 23, 2023",SAC vs. MIN,L,39,10,23,0.435,3,11,0.273,4,4,1.0,2,2,4,6,2,0,3,1,27,-4,1,SAC,SAC,MIN,98,8.5,Rebs+Asts,37,31,33,10
De'Aaron Fox,G,22023,1628368,22300400,"DEC 23, 2023",SAC vs. MIN,L,39,10,23,0.435,3,11,0.273,4,4,1.0,2,2,4,6,2,0,3,1,27,-4,1,SAC,SAC,MIN,98,2.5,Turnovers,37,31,33,10
De'Aaron Fox,G,22023,1628368,22300387,"DEC 22, 2023",SAC vs. PHX,W,32,9,17,0.529,2,6,0.333,3,4,0.75,0,6,6,7,3,2,2,2,23,21,1,SAC,SAC,PHX,120,24.5,Points,36,29,30,13
De'Aaron Fox,G,22023,1628368,22300387,"DEC 22, 2023",SAC vs. PHX,W,32,9,17,0.529,2,6,0.333,3,4,0.75,0,6,6,7,3,2,2,2,23,21,1,SAC,SAC,PHX,120,3.5,Rebounds,36,29,30,13
De'Aaron Fox,G,22023,1628368,22300387,"DEC 22, 2023",SAC vs. PHX,W,32,9,17,0.529,2,6,0.333,3,4,0.75,0,6,6,7,3,2,2,2,23,21,1,SAC,SAC,PHX,120,32.5,Pts+Rebs+Asts,36,29,30,13
De'Aaron Fox,G,22023,1628368,22300387,"DEC 22, 2023",SAC vs. PHX,W,32,9,17,0.529,2,6,0.333,3,4,0.75,0,6,6,7,3,2,2,2,23,21,1,SAC,SAC,PHX,120,39.5,Fantasy Score,36,29,30,13
De'Aaron Fox,G,22023,1628368,22300387,"DEC 22, 2023",SAC vs. PHX,W,32,9,17,0.529,2,6,0.333,3,4,0.75,0,6,6,7,3,2,2,2,23,21,1,SAC,SAC,PHX,120,2.5,3-PT Made,36,29,30,13
De'Aaron Fox,G,22023,1628368,22300387,"DEC 22, 2023",SAC vs. PHX,W,32,9,17,0.529,2,6,0.333,3,4,0.75,0,6,6,7,3,2,2,2,23,21,1,SAC,SAC,PHX,120,7.0,3-PT Attempted,36,29,30,13
De'Aaron Fox,G,22023,1628368,22300387,"DEC 22, 2023",SAC vs. PHX,W,32,9,17,0.529,2,6,0.333,3,4,0.75,0,6,6,7,3,2,2,2,23,21,1,SAC,SAC,PHX,120,3.5,Free Throws Made,36,29,30,13
De'Aaron Fox,G,22023,1628368,22300387,"DEC 22, 2023",SAC vs. PHX,W,32,9,17,0.529,2,6,0.333,3,4,0.75,0,6,6,7,3,2,2,2,23,21,1,SAC,SAC,PHX,120,19.0,FG Attempted,36,29,30,13
De'Aaron Fox,G,22023,1628368,22300387,"DEC 22, 2023",SAC vs. PHX,W,32,9,17,0.529,2,6,0.333,3,4,0.75,0,6,6,7,3,2,2,2,23,21,1,SAC,SAC,PHX,120,28.5,Pts+Rebs,36,29,30,13
De'Aaron Fox,G,22023,1628368,22300387,"DEC 22, 2023",SAC vs. PHX,W,32,9,17,0.529,2,6,0.333,3,4,0.75,0,6,6,7,3,2,2,2,23,21,1,SAC,SAC,PHX,120,29.0,Pts+Asts,36,29,30,13
De'Aaron Fox,G,22023,1628368,22300387,"DEC 22, 2023",SAC vs. PHX,W,32,9,17,0.529,2,6,0.333,3,4,0.75,0,6,6,7,3,2,2,2,23,21,1,SAC,SAC,PHX,120,8.5,Rebs+Asts,36,29,30,13
De'Aaron Fox,G,22023,1628368,22300387,"DEC 22, 2023",SAC vs. PHX,W,32,9,17,0.529,2,6,0.333,3,4,0.75,0,6,6,7,3,2,2,2,23,21,1,SAC,SAC,PHX,120,2.5,Turnovers,36,29,30,13
De'Aaron Fox,G,22023,1628368,22300373,"DEC 20, 2023",SAC vs. BOS,L,26,9,16,0.563,6,8,0.75,5,6,0.833,2,1,3,3,3,0,3,4,29,-19,1,SAC,SAC,BOS,119,24.5,Points,35,32,32,6
De'Aaron Fox,G,22023,1628368,22300373,"DEC 20, 2023",SAC vs. BOS,L,26,9,16,0.563,6,8,0.75,5,6,0.833,2,1,3,3,3,0,3,4,29,-19,1,SAC,SAC,BOS,119,3.5,Rebounds,35,32,32,6
De'Aaron Fox,G,22023,1628368,22300373,"DEC 20, 2023",SAC vs. BOS,L,26,9,16,0.563,6,8,0.75,5,6,0.833,2,1,3,3,3,0,3,4,29,-19,1,SAC,SAC,BOS,119,32.5,Pts+Rebs+Asts,35,32,32,6
De'Aaron Fox,G,22023,1628368,22300373,"DEC 20, 2023",SAC vs. BOS,L,26,9,16,0.563,6,8,0.75,5,6,0.833,2,1,3,3,3,0,3,4,29,-19,1,SAC,SAC,BOS,119,39.5,Fantasy Score,35,32,32,6
De'Aaron Fox,G,22023,1628368,22300373,"DEC 20, 2023",SAC vs. BOS,L,26,9,16,0.563,6,8,0.75,5,6,0.833,2,1,3,3,3,0,3,4,29,-19,1,SAC,SAC,BOS,119,2.5,3-PT Made,35,32,32,6
De'Aaron Fox,G,22023,1628368,22300373,"DEC 20, 2023",SAC vs. BOS,L,26,9,16,0.563,6,8,0.75,5,6,0.833,2,1,3,3,3,0,3,4,29,-19,1,SAC,SAC,BOS,119,7.0,3-PT Attempted,35,32,32,6
De'Aaron Fox,G,22023,1628368,22300373,"DEC 20, 2023",SAC vs. BOS,L,26,9,16,0.563,6,8,0.75,5,6,0.833,2,1,3,3,3,0,3,4,29,-19,1,SAC,SAC,BOS,119,3.5,Free Throws Made,35,32,32,6
De'Aaron Fox,G,22023,1628368,22300373,"DEC 20, 2023",SAC vs. BOS,L,26,9,16,0.563,6,8,0.75,5,6,0.833,2,1,3,3,3,0,3,4,29,-19,1,SAC,SAC,BOS,119,19.0,FG Attempted,35,32,32,6
De'Aaron Fox,G,22023,1628368,22300373,"DEC 20, 2023",SAC vs. BOS,L,26,9,16,0.563,6,8,0.75,5,6,0.833,2,1,3,3,3,0,3,4,29,-19,1,SAC,SAC,BOS,119,28.5,Pts+Rebs,35,32,32,6
De'Aaron Fox,G,22023,1628368,22300373,"DEC 20, 2023",SAC vs. BOS,L,26,9,16,0.563,6,8,0.75,5,6,0.833,2,1,3,3,3,0,3,4,29,-19,1,SAC,SAC,BOS,119,29.0,Pts+Asts,35,32,32,6
De'Aaron Fox,G,22023,1628368,22300373,"DEC 20, 2023",SAC vs. BOS,L,26,9,16,0.563,6,8,0.75,5,6,0.833,2,1,3,3,3,0,3,4,29,-19,1,SAC,SAC,BOS,119,8.5,Rebs+Asts,35,32,32,6
De'Aaron Fox,G,22023,1628368,22300373,"DEC 20, 2023",SAC vs. BOS,L,26,9,16,0.563,6,8,0.75,5,6,0.833,2,1,3,3,3,0,3,4,29,-19,1,SAC,SAC,BOS,119,2.5,Turnovers,35,32,32,6
De'Aaron Fox,G,22023,1628368,22300358,"DEC 18, 2023",SAC vs. WAS,W,33,10,19,0.526,2,7,0.286,8,12,0.667,0,5,5,6,3,1,1,2,30,20,1,SAC,SAC,WAS,141,24.5,Points,41,35,36,11
De'Aaron Fox,G,22023,1628368,22300358,"DEC 18, 2023",SAC vs. WAS,W,33,10,19,0.526,2,7,0.286,8,12,0.667,0,5,5,6,3,1,1,2,30,20,1,SAC,SAC,WAS,141,3.5,Rebounds,41,35,36,11
De'Aaron Fox,G,22023,1628368,22300358,"DEC 18, 2023",SAC vs. WAS,W,33,10,19,0.526,2,7,0.286,8,12,0.667,0,5,5,6,3,1,1,2,30,20,1,SAC,SAC,WAS,141,32.5,Pts+Rebs+Asts,41,35,36,11
De'Aaron Fox,G,22023,1628368,22300358,"DEC 18, 2023",SAC vs. WAS,W,33,10,19,0.526,2,7,0.286,8,12,0.667,0,5,5,6,3,1,1,2,30,20,1,SAC,SAC,WAS,141,39.5,Fantasy Score,41,35,36,11
De'Aaron Fox,G,22023,1628368,22300358,"DEC 18, 2023",SAC vs. WAS,W,33,10,19,0.526,2,7,0.286,8,12,0.667,0,5,5,6,3,1,1,2,30,20,1,SAC,SAC,WAS,141,2.5,3-PT Made,41,35,36,11
De'Aaron Fox,G,22023,1628368,22300358,"DEC 18, 2023",SAC vs. WAS,W,33,10,19,0.526,2,7,0.286,8,12,0.667,0,5,5,6,3,1,1,2,30,20,1,SAC,SAC,WAS,141,7.0,3-PT Attempted,41,35,36,11
De'Aaron Fox,G,22023,1628368,22300358,"DEC 18, 2023",SAC vs. WAS,W,33,10,19,0.526,2,7,0.286,8,12,0.667,0,5,5,6,3,1,1,2,30,20,1,SAC,SAC,WAS,141,3.5,Free Throws Made,41,35,36,11
De'Aaron Fox,G,22023,1628368,22300358,"DEC 18, 2023",SAC vs. WAS,W,33,10,19,0.526,2,7,0.286,8,12,0.667,0,5,5,6,3,1,1,2,30,20,1,SAC,SAC,WAS,141,19.0,FG Attempted,41,35,36,11
De'Aaron Fox,G,22023,1628368,22300358,"DEC 18, 2023",SAC vs. WAS,W,33,10,19,0.526,2,7,0.286,8,12,0.667,0,5,5,6,3,1,1,2,30,20,1,SAC,SAC,WAS,141,28.5,Pts+Rebs,41,35,36,11
De'Aaron Fox,G,22023,1628368,22300358,"DEC 18, 2023",SAC vs. WAS,W,33,10,19,0.526,2,7,0.286,8,12,0.667,0,5,5,6,3,1,1,2,30,20,1,SAC,SAC,WAS,141,29.0,Pts+Asts,41,35,36,11
De'Aaron Fox,G,22023,1628368,22300358,"DEC 18, 2023",SAC vs. WAS,W,33,10,19,0.526,2,7,0.286,8,12,0.667,0,5,5,6,3,1,1,2,30,20,1,SAC,SAC,WAS,141,8.5,Rebs+Asts,41,35,36,11
De'Aaron Fox,G,22023,1628368,22300358,"DEC 18, 2023",SAC vs. WAS,W,33,10,19,0.526,2,7,0.286,8,12,0.667,0,5,5,6,3,1,1,2,30,20,1,SAC,SAC,WAS,141,2.5,Turnovers,41,35,36,11
De'Aaron Fox,G,22023,1628368,22300324,"DEC 14, 2023",SAC vs. OKC,W,34,14,25,0.56,5,11,0.455,8,11,0.727,0,3,3,7,2,0,5,3,41,3,1,SAC,SAC,OKC,128,24.5,Points,51,44,48,10
De'Aaron Fox,G,22023,1628368,22300324,"DEC 14, 2023",SAC vs. OKC,W,34,14,25,0.56,5,11,0.455,8,11,0.727,0,3,3,7,2,0,5,3,41,3,1,SAC,SAC,OKC,128,3.5,Rebounds,51,44,48,10
De'Aaron Fox,G,22023,1628368,22300324,"DEC 14, 2023",SAC vs. OKC,W,34,14,25,0.56,5,11,0.455,8,11,0.727,0,3,3,7,2,0,5,3,41,3,1,SAC,SAC,OKC,128,32.5,Pts+Rebs+Asts,51,44,48,10
De'Aaron Fox,G,22023,1628368,22300324,"DEC 14, 2023",SAC vs. OKC,W,34,14,25,0.56,5,11,0.455,8,11,0.727,0,3,3,7,2,0,5,3,41,3,1,SAC,SAC,OKC,128,39.5,Fantasy Score,51,44,48,10
De'Aaron Fox,G,22023,1628368,22300324,"DEC 14, 2023",SAC vs. OKC,W,34,14,25,0.56,5,11,0.455,8,11,0.727,0,3,3,7,2,0,5,3,41,3,1,SAC,SAC,OKC,128,2.5,3-PT Made,51,44,48,10
De'Aaron Fox,G,22023,1628368,22300324,"DEC 14, 2023",SAC vs. OKC,W,34,14,25,0.56,5,11,0.455,8,11,0.727,0,3,3,7,2,0,5,3,41,3,1,SAC,SAC,OKC,128,7.0,3-PT Attempted,51,44,48,10
De'Aaron Fox,G,22023,1628368,22300324,"DEC 14, 2023",SAC vs. OKC,W,34,14,25,0.56,5,11,0.455,8,11,0.727,0,3,3,7,2,0,5,3,41,3,1,SAC,SAC,OKC,128,3.5,Free Throws Made,51,44,48,10
De'Aaron Fox,G,22023,1628368,22300324,"DEC 14, 2023",SAC vs. OKC,W,34,14,25,0.56,5,11,0.455,8,11,0.727,0,3,3,7,2,0,5,3,41,3,1,SAC,SAC,OKC,128,19.0,FG Attempted,51,44,48,10
De'Aaron Fox,G,22023,1628368,22300324,"DEC 14, 2023",SAC vs. OKC,W,34,14,25,0.56,5,11,0.455,8,11,0.727,0,3,3,7,2,0,5,3,41,3,1,SAC,SAC,OKC,128,28.5,Pts+Rebs,51,44,48,10
De'Aaron Fox,G,22023,1628368,22300324,"DEC 14, 2023",SAC vs. OKC,W,34,14,25,0.56,5,11,0.455,8,11,0.727,0,3,3,7,2,0,5,3,41,3,1,SAC,SAC,OKC,128,29.0,Pts+Asts,51,44,48,10
De'Aaron Fox,G,22023,1628368,22300324,"DEC 14, 2023",SAC vs. OKC,W,34,14,25,0.56,5,11,0.455,8,11,0.727,0,3,3,7,2,0,5,3,41,3,1,SAC,SAC,OKC,128,8.5,Rebs+Asts,51,44,48,10
De'Aaron Fox,G,22023,1628368,22300324,"DEC 14, 2023",SAC vs. OKC,W,34,14,25,0.56,5,11,0.455,8,11,0.727,0,3,3,7,2,0,5,3,41,3,1,SAC,SAC,OKC,128,2.5,Turnovers,51,44,48,10
De'Aaron Fox,G,22023,1628368,22300309,"DEC 12, 2023",SAC @ LAC,L,25,5,16,0.313,3,7,0.429,1,1,1.0,0,3,3,3,0,0,4,3,14,-14,1,SAC,LAC,SAC,99,24.5,Points,20,17,17,6
De'Aaron Fox,G,22023,1628368,22300309,"DEC 12, 2023",SAC @ LAC,L,25,5,16,0.313,3,7,0.429,1,1,1.0,0,3,3,3,0,0,4,3,14,-14,1,SAC,LAC,SAC,99,3.5,Rebounds,20,17,17,6
De'Aaron Fox,G,22023,1628368,22300309,"DEC 12, 2023",SAC @ LAC,L,25,5,16,0.313,3,7,0.429,1,1,1.0,0,3,3,3,0,0,4,3,14,-14,1,SAC,LAC,SAC,99,32.5,Pts+Rebs+Asts,20,17,17,6
De'Aaron Fox,G,22023,1628368,22300309,"DEC 12, 2023",SAC @ LAC,L,25,5,16,0.313,3,7,0.429,1,1,1.0,0,3,3,3,0,0,4,3,14,-14,1,SAC,LAC,SAC,99,39.5,Fantasy Score,20,17,17,6
De'Aaron Fox,G,22023,1628368,22300309,"DEC 12, 2023",SAC @ LAC,L,25,5,16,0.313,3,7,0.429,1,1,1.0,0,3,3,3,0,0,4,3,14,-14,1,SAC,LAC,SAC,99,2.5,3-PT Made,20,17,17,6
De'Aaron Fox,G,22023,1628368,22300309,"DEC 12, 2023",SAC @ LAC,L,25,5,16,0.313,3,7,0.429,1,1,1.0,0,3,3,3,0,0,4,3,14,-14,1,SAC,LAC,SAC,99,7.0,3-PT Attempted,20,17,17,6
De'Aaron Fox,G,22023,1628368,22300309,"DEC 12, 2023",SAC @ LAC,L,25,5,16,0.313,3,7,0.429,1,1,1.0,0,3,3,3,0,0,4,3,14,-14,1,SAC,LAC,SAC,99,3.5,Free Throws Made,20,17,17,6
De'Aaron Fox,G,22023,1628368,22300309,"DEC 12, 2023",SAC @ LAC,L,25,5,16,0.313,3,7,0.429,1,1,1.0,0,3,3,3,0,0,4,3,14,-14,1,SAC,LAC,SAC,99,19.0,FG Attempted,20,17,17,6
De'Aaron Fox,G,22023,1628368,22300309,"DEC 12, 2023",SAC @ LAC,L,25,5,16,0.313,3,7,0.429,1,1,1.0,0,3,3,3,0,0,4,3,14,-14,1,SAC,LAC,SAC,99,28.5,Pts+Rebs,20,17,17,6
De'Aaron Fox,G,22023,1628368,22300309,"DEC 12, 2023",SAC @ LAC,L,25,5,16,0.313,3,7,0.429,1,1,1.0,0,3,3,3,0,0,4,3,14,-14,1,SAC,LAC,SAC,99,29.0,Pts+Asts,20,17,17,6
De'Aaron Fox,G,22023,1628368,22300309,"DEC 12, 2023",SAC @ LAC,L,25,5,16,0.313,3,7,0.429,1,1,1.0,0,3,3,3,0,0,4,3,14,-14,1,SAC,LAC,SAC,99,8.5,Rebs+Asts,20,17,17,6
De'Aaron Fox,G,22023,1628368,22300309,"DEC 12, 2023",SAC @ LAC,L,25,5,16,0.313,3,7,0.429,1,1,1.0,0,3,3,3,0,0,4,3,14,-14,1,SAC,LAC,SAC,99,2.5,Turnovers,20,17,17,6
De'Aaron Fox,G,22023,1628368,22300303,"DEC 11, 2023",SAC vs. BKN,W,33,10,22,0.455,5,10,0.5,4,6,0.667,0,3,3,8,0,0,3,4,29,31,1,SAC,SAC,BKN,131,24.5,Points,40,32,37,11
De'Aaron Fox,G,22023,1628368,22300303,"DEC 11, 2023",SAC vs. BKN,W,33,10,22,0.455,5,10,0.5,4,6,0.667,0,3,3,8,0,0,3,4,29,31,1,SAC,SAC,BKN,131,3.5,Rebounds,40,32,37,11
De'Aaron Fox,G,22023,1628368,22300303,"DEC 11, 2023",SAC vs. BKN,W,33,10,22,0.455,5,10,0.5,4,6,0.667,0,3,3,8,0,0,3,4,29,31,1,SAC,SAC,BKN,131,32.5,Pts+Rebs+Asts,40,32,37,11
De'Aaron Fox,G,22023,1628368,22300303,"DEC 11, 2023",SAC vs. BKN,W,33,10,22,0.455,5,10,0.5,4,6,0.667,0,3,3,8,0,0,3,4,29,31,1,SAC,SAC,BKN,131,39.5,Fantasy Score,40,32,37,11
De'Aaron Fox,G,22023,1628368,22300303,"DEC 11, 2023",SAC vs. BKN,W,33,10,22,0.455,5,10,0.5,4,6,0.667,0,3,3,8,0,0,3,4,29,31,1,SAC,SAC,BKN,131,2.5,3-PT Made,40,32,37,11
De'Aaron Fox,G,22023,1628368,22300303,"DEC 11, 2023",SAC vs. BKN,W,33,10,22,0.455,5,10,0.5,4,6,0.667,0,3,3,8,0,0,3,4,29,31,1,SAC,SAC,BKN,131,7.0,3-PT Attempted,40,32,37,11
De'Aaron Fox,G,22023,1628368,22300303,"DEC 11, 2023",SAC vs. BKN,W,33,10,22,0.455,5,10,0.5,4,6,0.667,0,3,3,8,0,0,3,4,29,31,1,SAC,SAC,BKN,131,3.5,Free Throws Made,40,32,37,11
De'Aaron Fox,G,22023,1628368,22300303,"DEC 11, 2023",SAC vs. BKN,W,33,10,22,0.455,5,10,0.5,4,6,0.667,0,3,3,8,0,0,3,4,29,31,1,SAC,SAC,BKN,131,19.0,FG Attempted,40,32,37,11
De'Aaron Fox,G,22023,1628368,22300303,"DEC 11, 2023",SAC vs. BKN,W,33,10,22,0.455,5,10,0.5,4,6,0.667,0,3,3,8,0,0,3,4,29,31,1,SAC,SAC,BKN,131,28.5,Pts+Rebs,40,32,37,11
De'Aaron Fox,G,22023,1628368,22300303,"DEC 11, 2023",SAC vs. BKN,W,33,10,22,0.455,5,10,0.5,4,6,0.667,0,3,3,8,0,0,3,4,29,31,1,SAC,SAC,BKN,131,29.0,Pts+Asts,40,32,37,11
De'Aaron Fox,G,22023,1628368,22300303,"DEC 11, 2023",SAC vs. BKN,W,33,10,22,0.455,5,10,0.5,4,6,0.667,0,3,3,8,0,0,3,4,29,31,1,SAC,SAC,BKN,131,8.5,Rebs+Asts,40,32,37,11
De'Aaron Fox,G,22023,1628368,22300303,"DEC 11, 2023",SAC vs. BKN,W,33,10,22,0.455,5,10,0.5,4,6,0.667,0,3,3,8,0,0,3,4,29,31,1,SAC,SAC,BKN,131,2.5,Turnovers,40,32,37,11
De'Aaron Fox,G,22023,1628368,22301228,"DEC 08, 2023",SAC @ PHX,W,35,11,24,0.458,4,7,0.571,8,10,0.8,2,2,4,7,1,0,2,0,34,3,1,SAC,PHX,SAC,114,24.5,Points,45,38,41,11
De'Aaron Fox,G,22023,1628368,22301228,"DEC 08, 2023",SAC @ PHX,W,35,11,24,0.458,4,7,0.571,8,10,0.8,2,2,4,7,1,0,2,0,34,3,1,SAC,PHX,SAC,114,3.5,Rebounds,45,38,41,11
De'Aaron Fox,G,22023,1628368,22301228,"DEC 08, 2023",SAC @ PHX,W,35,11,24,0.458,4,7,0.571,8,10,0.8,2,2,4,7,1,0,2,0,34,3,1,SAC,PHX,SAC,114,32.5,Pts+Rebs+Asts,45,38,41,11
De'Aaron Fox,G,22023,1628368,22301228,"DEC 08, 2023",SAC @ PHX,W,35,11,24,0.458,4,7,0.571,8,10,0.8,2,2,4,7,1,0,2,0,34,3,1,SAC,PHX,SAC,114,39.5,Fantasy Score,45,38,41,11
De'Aaron Fox,G,22023,1628368,22301228,"DEC 08, 2023",SAC @ PHX,W,35,11,24,0.458,4,7,0.571,8,10,0.8,2,2,4,7,1,0,2,0,34,3,1,SAC,PHX,SAC,114,2.5,3-PT Made,45,38,41,11
De'Aaron Fox,G,22023,1628368,22301228,"DEC 08, 2023",SAC @ PHX,W,35,11,24,0.458,4,7,0.571,8,10,0.8,2,2,4,7,1,0,2,0,34,3,1,SAC,PHX,SAC,114,7.0,3-PT Attempted,45,38,41,11
De'Aaron Fox,G,22023,1628368,22301228,"DEC 08, 2023",SAC @ PHX,W,35,11,24,0.458,4,7,0.571,8,10,0.8,2,2,4,7,1,0,2,0,34,3,1,SAC,PHX,SAC,114,3.5,Free Throws Made,45,38,41,11
De'Aaron Fox,G,22023,1628368,22301228,"DEC 08, 2023",SAC @ PHX,W,35,11,24,0.458,4,7,0.571,8,10,0.8,2,2,4,7,1,0,2,0,34,3,1,SAC,PHX,SAC,114,19.0,FG Attempted,45,38,41,11
De'Aaron Fox,G,22023,1628368,22301228,"DEC 08, 2023",SAC @ PHX,W,35,11,24,0.458,4,7,0.571,8,10,0.8,2,2,4,7,1,0,2,0,34,3,1,SAC,PHX,SAC,114,28.5,Pts+Rebs,45,38,41,11
De'Aaron Fox,G,22023,1628368,22301228,"DEC 08, 2023",SAC @ PHX,W,35,11,24,0.458,4,7,0.571,8,10,0.8,2,2,4,7,1,0,2,0,34,3,1,SAC,PHX,SAC,114,29.0,Pts+Asts,45,38,41,11
De'Aaron Fox,G,22023,1628368,22301228,"DEC 08, 2023",SAC @ PHX,W,35,11,24,0.458,4,7,0.571,8,10,0.8,2,2,4,7,1,0,2,0,34,3,1,SAC,PHX,SAC,114,8.5,Rebs+Asts,45,38,41,11
De'Aaron Fox,G,22023,1628368,22301228,"DEC 08, 2023",SAC @ PHX,W,35,11,24,0.458,4,7,0.571,8,10,0.8,2,2,4,7,1,0,2,0,34,3,1,SAC,PHX,SAC,114,2.5,Turnovers,45,38,41,11
De'Aaron Fox,G,22023,1628368,22301204,"DEC 04, 2023",SAC vs. NOP,L,40,10,25,0.4,1,7,0.143,9,13,0.692,1,4,5,4,1,0,6,3,30,-9,1,SAC,SAC,NOP,117,24.5,Points,39,35,34,9
De'Aaron Fox,G,22023,1628368,22301204,"DEC 04, 2023",SAC vs. NOP,L,40,10,25,0.4,1,7,0.143,9,13,0.692,1,4,5,4,1,0,6,3,30,-9,1,SAC,SAC,NOP,117,3.5,Rebounds,39,35,34,9
De'Aaron Fox,G,22023,1628368,22301204,"DEC 04, 2023",SAC vs. NOP,L,40,10,25,0.4,1,7,0.143,9,13,0.692,1,4,5,4,1,0,6,3,30,-9,1,SAC,SAC,NOP,117,32.5,Pts+Rebs+Asts,39,35,34,9
De'Aaron Fox,G,22023,1628368,22301204,"DEC 04, 2023",SAC vs. NOP,L,40,10,25,0.4,1,7,0.143,9,13,0.692,1,4,5,4,1,0,6,3,30,-9,1,SAC,SAC,NOP,117,39.5,Fantasy Score,39,35,34,9
De'Aaron Fox,G,22023,1628368,22301204,"DEC 04, 2023",SAC vs. NOP,L,40,10,25,0.4,1,7,0.143,9,13,0.692,1,4,5,4,1,0,6,3,30,-9,1,SAC,SAC,NOP,117,2.5,3-PT Made,39,35,34,9
De'Aaron Fox,G,22023,1628368,22301204,"DEC 04, 2023",SAC vs. NOP,L,40,10,25,0.4,1,7,0.143,9,13,0.692,1,4,5,4,1,0,6,3,30,-9,1,SAC,SAC,NOP,117,7.0,3-PT Attempted,39,35,34,9
De'Aaron Fox,G,22023,1628368,22301204,"DEC 04, 2023",SAC vs. NOP,L,40,10,25,0.4,1,7,0.143,9,13,0.692,1,4,5,4,1,0,6,3,30,-9,1,SAC,SAC,NOP,117,3.5,Free Throws Made,39,35,34,9
De'Aaron Fox,G,22023,1628368,22301204,"DEC 04, 2023",SAC vs. NOP,L,40,10,25,0.4,1,7,0.143,9,13,0.692,1,4,5,4,1,0,6,3,30,-9,1,SAC,SAC,NOP,117,19.0,FG Attempted,39,35,34,9
De'Aaron Fox,G,22023,1628368,22301204,"DEC 04, 2023",SAC vs. NOP,L,40,10,25,0.4,1,7,0.143,9,13,0.692,1,4,5,4,1,0,6,3,30,-9,1,SAC,SAC,NOP,117,28.5,Pts+Rebs,39,35,34,9
De'Aaron Fox,G,22023,1628368,22301204,"DEC 04, 2023",SAC vs. NOP,L,40,10,25,0.4,1,7,0.143,9,13,0.692,1,4,5,4,1,0,6,3,30,-9,1,SAC,SAC,NOP,117,29.0,Pts+Asts,39,35,34,9
De'Aaron Fox,G,22023,1628368,22301204,"DEC 04, 2023",SAC vs. NOP,L,40,10,25,0.4,1,7,0.143,9,13,0.692,1,4,5,4,1,0,6,3,30,-9,1,SAC,SAC,NOP,117,8.5,Rebs+Asts,39,35,34,9
De'Aaron Fox,G,22023,1628368,22301204,"DEC 04, 2023",SAC vs. NOP,L,40,10,25,0.4,1,7,0.143,9,13,0.692,1,4,5,4,1,0,6,3,30,-9,1,SAC,SAC,NOP,117,2.5,Turnovers,39,35,34,9
De'Aaron Fox,G,22023,1628368,22300290,"DEC 02, 2023",SAC vs. DEN,W,38,10,22,0.455,3,6,0.5,3,4,0.75,1,3,4,16,3,1,1,1,26,22,1,SAC,SAC,DEN,123,24.5,Points,46,30,42,20
De'Aaron Fox,G,22023,1628368,22300290,"DEC 02, 2023",SAC vs. DEN,W,38,10,22,0.455,3,6,0.5,3,4,0.75,1,3,4,16,3,1,1,1,26,22,1,SAC,SAC,DEN,123,3.5,Rebounds,46,30,42,20
De'Aaron Fox,G,22023,1628368,22300290,"DEC 02, 2023",SAC vs. DEN,W,38,10,22,0.455,3,6,0.5,3,4,0.75,1,3,4,16,3,1,1,1,26,22,1,SAC,SAC,DEN,123,32.5,Pts+Rebs+Asts,46,30,42,20
De'Aaron Fox,G,22023,1628368,22300290,"DEC 02, 2023",SAC vs. DEN,W,38,10,22,0.455,3,6,0.5,3,4,0.75,1,3,4,16,3,1,1,1,26,22,1,SAC,SAC,DEN,123,39.5,Fantasy Score,46,30,42,20
De'Aaron Fox,G,22023,1628368,22300290,"DEC 02, 2023",SAC vs. DEN,W,38,10,22,0.455,3,6,0.5,3,4,0.75,1,3,4,16,3,1,1,1,26,22,1,SAC,SAC,DEN,123,2.5,3-PT Made,46,30,42,20
De'Aaron Fox,G,22023,1628368,22300290,"DEC 02, 2023",SAC vs. DEN,W,38,10,22,0.455,3,6,0.5,3,4,0.75,1,3,4,16,3,1,1,1,26,22,1,SAC,SAC,DEN,123,7.0,3-PT Attempted,46,30,42,20
De'Aaron Fox,G,22023,1628368,22300290,"DEC 02, 2023",SAC vs. DEN,W,38,10,22,0.455,3,6,0.5,3,4,0.75,1,3,4,16,3,1,1,1,26,22,1,SAC,SAC,DEN,123,3.5,Free Throws Made,46,30,42,20
De'Aaron Fox,G,22023,1628368,22300290,"DEC 02, 2023",SAC vs. DEN,W,38,10,22,0.455,3,6,0.5,3,4,0.75,1,3,4,16,3,1,1,1,26,22,1,SAC,SAC,DEN,123,19.0,FG Attempted,46,30,42,20
De'Aaron Fox,G,22023,1628368,22300290,"DEC 02, 2023",SAC vs. DEN,W,38,10,22,0.455,3,6,0.5,3,4,0.75,1,3,4,16,3,1,1,1,26,22,1,SAC,SAC,DEN,123,28.5,Pts+Rebs,46,30,42,20
De'Aaron Fox,G,22023,1628368,22300290,"DEC 02, 2023",SAC vs. DEN,W,38,10,22,0.455,3,6,0.5,3,4,0.75,1,3,4,16,3,1,1,1,26,22,1,SAC,SAC,DEN,123,29.0,Pts+Asts,46,30,42,20
De'Aaron Fox,G,22023,1628368,22300290,"DEC 02, 2023",SAC vs. DEN,W,38,10,22,0.455,3,6,0.5,3,4,0.75,1,3,4,16,3,1,1,1,26,22,1,SAC,SAC,DEN,123,8.5,Rebs+Asts,46,30,42,20
De'Aaron Fox,G,22023,1628368,22300290,"DEC 02, 2023",SAC vs. DEN,W,38,10,22,0.455,3,6,0.5,3,4,0.75,1,3,4,16,3,1,1,1,26,22,1,SAC,SAC,DEN,123,2.5,Turnovers,46,30,42,20
De'Aaron Fox,G,22023,1628368,22300264,"NOV 29, 2023",SAC vs. LAC,L,38,14,23,0.609,3,8,0.375,9,10,0.9,1,4,5,3,0,1,4,3,40,-17,1,SAC,SAC,LAC,117,24.5,Points,48,45,43,8
De'Aaron Fox,G,22023,1628368,22300264,"NOV 29, 2023",SAC vs. LAC,L,38,14,23,0.609,3,8,0.375,9,10,0.9,1,4,5,3,0,1,4,3,40,-17,1,SAC,SAC,LAC,117,3.5,Rebounds,48,45,43,8
De'Aaron Fox,G,22023,1628368,22300264,"NOV 29, 2023",SAC vs. LAC,L,38,14,23,0.609,3,8,0.375,9,10,0.9,1,4,5,3,0,1,4,3,40,-17,1,SAC,SAC,LAC,117,32.5,Pts+Rebs+Asts,48,45,43,8
De'Aaron Fox,G,22023,1628368,22300264,"NOV 29, 2023",SAC vs. LAC,L,38,14,23,0.609,3,8,0.375,9,10,0.9,1,4,5,3,0,1,4,3,40,-17,1,SAC,SAC,LAC,117,39.5,Fantasy Score,48,45,43,8
De'Aaron Fox,G,22023,1628368,22300264,"NOV 29, 2023",SAC vs. LAC,L,38,14,23,0.609,3,8,0.375,9,10,0.9,1,4,5,3,0,1,4,3,40,-17,1,SAC,SAC,LAC,117,2.5,3-PT Made,48,45,43,8
De'Aaron Fox,G,22023,1628368,22300264,"NOV 29, 2023",SAC vs. LAC,L,38,14,23,0.609,3,8,0.375,9,10,0.9,1,4,5,3,0,1,4,3,40,-17,1,SAC,SAC,LAC,117,7.0,3-PT Attempted,48,45,43,8
De'Aaron Fox,G,22023,1628368,22300264,"NOV 29, 2023",SAC vs. LAC,L,38,14,23,0.609,3,8,0.375,9,10,0.9,1,4,5,3,0,1,4,3,40,-17,1,SAC,SAC,LAC,117,3.5,Free Throws Made,48,45,43,8
De'Aaron Fox,G,22023,1628368,22300264,"NOV 29, 2023",SAC vs. LAC,L,38,14,23,0.609,3,8,0.375,9,10,0.9,1,4,5,3,0,1,4,3,40,-17,1,SAC,SAC,LAC,117,19.0,FG Attempted,48,45,43,8
De'Aaron Fox,G,22023,1628368,22300264,"NOV 29, 2023",SAC vs. LAC,L,38,14,23,0.609,3,8,0.375,9,10,0.9,1,4,5,3,0,1,4,3,40,-17,1,SAC,SAC,LAC,117,28.5,Pts+Rebs,48,45,43,8
De'Aaron Fox,G,22023,1628368,22300264,"NOV 29, 2023",SAC vs. LAC,L,38,14,23,0.609,3,8,0.375,9,10,0.9,1,4,5,3,0,1,4,3,40,-17,1,SAC,SAC,LAC,117,29.0,Pts+Asts,48,45,43,8
De'Aaron Fox,G,22023,1628368,22300264,"NOV 29, 2023",SAC vs. LAC,L,38,14,23,0.609,3,8,0.375,9,10,0.9,1,4,5,3,0,1,4,3,40,-17,1,SAC,SAC,LAC,117,8.5,Rebs+Asts,48,45,43,8
De'Aaron Fox,G,22023,1628368,22300264,"NOV 29, 2023",SAC vs. LAC,L,38,14,23,0.609,3,8,0.375,9,10,0.9,1,4,5,3,0,1,4,3,40,-17,1,SAC,SAC,LAC,117,2.5,Turnovers,48,45,43,8
De'Aaron Fox,G,22023,1628368,22300060,"NOV 28, 2023",SAC vs. GSW,W,40,9,20,0.45,2,8,0.25,9,17,0.529,1,8,9,7,2,0,2,4,29,9,1,SAC,SAC,GSW,124,24.5,Points,45,38,36,16
De'Aaron Fox,G,22023,1628368,22300060,"NOV 28, 2023",SAC vs. GSW,W,40,9,20,0.45,2,8,0.25,9,17,0.529,1,8,9,7,2,0,2,4,29,9,1,SAC,SAC,GSW,124,3.5,Rebounds,45,38,36,16
De'Aaron Fox,G,22023,1628368,22300060,"NOV 28, 2023",SAC vs. GSW,W,40,9,20,0.45,2,8,0.25,9,17,0.529,1,8,9,7,2,0,2,4,29,9,1,SAC,SAC,GSW,124,32.5,Pts+Rebs+Asts,45,38,36,16
De'Aaron Fox,G,22023,1628368,22300060,"NOV 28, 2023",SAC vs. GSW,W,40,9,20,0.45,2,8,0.25,9,17,0.529,1,8,9,7,2,0,2,4,29,9,1,SAC,SAC,GSW,124,39.5,Fantasy Score,45,38,36,16
De'Aaron Fox,G,22023,1628368,22300060,"NOV 28, 2023",SAC vs. GSW,W,40,9,20,0.45,2,8,0.25,9,17,0.529,1,8,9,7,2,0,2,4,29,9,1,SAC,SAC,GSW,124,2.5,3-PT Made,45,38,36,16
De'Aaron Fox,G,22023,1628368,22300060,"NOV 28, 2023",SAC vs. GSW,W,40,9,20,0.45,2,8,0.25,9,17,0.529,1,8,9,7,2,0,2,4,29,9,1,SAC,SAC,GSW,124,7.0,3-PT Attempted,45,38,36,16
De'Aaron Fox,G,22023,1628368,22300060,"NOV 28, 2023",SAC vs. GSW,W,40,9,20,0.45,2,8,0.25,9,17,0.529,1,8,9,7,2,0,2,4,29,9,1,SAC,SAC,GSW,124,3.5,Free Throws Made,45,38,36,16
De'Aaron Fox,G,22023,1628368,22300060,"NOV 28, 2023",SAC vs. GSW,W,40,9,20,0.45,2,8,0.25,9,17,0.529,1,8,9,7,2,0,2,4,29,9,1,SAC,SAC,GSW,124,19.0,FG Attempted,45,38,36,16
De'Aaron Fox,G,22023,1628368,22300060,"NOV 28, 2023",SAC vs. GSW,W,40,9,20,0.45,2,8,0.25,9,17,0.529,1,8,9,7,2,0,2,4,29,9,1,SAC,SAC,GSW,124,28.5,Pts+Rebs,45,38,36,16
De'Aaron Fox,G,22023,1628368,22300060,"NOV 28, 2023",SAC vs. GSW,W,40,9,20,0.45,2,8,0.25,9,17,0.529,1,8,9,7,2,0,2,4,29,9,1,SAC,SAC,GSW,124,29.0,Pts+Asts,45,38,36,16
De'Aaron Fox,G,22023,1628368,22300060,"NOV 28, 2023",SAC vs. GSW,W,40,9,20,0.45,2,8,0.25,9,17,0.529,1,8,9,7,2,0,2,4,29,9,1,SAC,SAC,GSW,124,8.5,Rebs+Asts,45,38,36,16
De'Aaron Fox,G,22023,1628368,22300060,"NOV 28, 2023",SAC vs. GSW,W,40,9,20,0.45,2,8,0.25,9,17,0.529,1,8,9,7,2,0,2,4,29,9,1,SAC,SAC,GSW,124,2.5,Turnovers,45,38,36,16
De'Aaron Fox,G,22023,1628368,22300050,"NOV 24, 2023",SAC @ MIN,W,37,14,32,0.438,3,7,0.429,5,6,0.833,2,5,7,12,1,0,2,3,36,19,1,SAC,MIN,SAC,124,24.5,Points,55,43,48,19
De'Aaron Fox,G,22023,1628368,22300050,"NOV 24, 2023",SAC @ MIN,W,37,14,32,0.438,3,7,0.429,5,6,0.833,2,5,7,12,1,0,2,3,36,19,1,SAC,MIN,SAC,124,3.5,Rebounds,55,43,48,19
De'Aaron Fox,G,22023,1628368,22300050,"NOV 24, 2023",SAC @ MIN,W,37,14,32,0.438,3,7,0.429,5,6,0.833,2,5,7,12,1,0,2,3,36,19,1,SAC,MIN,SAC,124,32.5,Pts+Rebs+Asts,55,43,48,19
De'Aaron Fox,G,22023,1628368,22300050,"NOV 24, 2023",SAC @ MIN,W,37,14,32,0.438,3,7,0.429,5,6,0.833,2,5,7,12,1,0,2,3,36,19,1,SAC,MIN,SAC,124,39.5,Fantasy Score,55,43,48,19
De'Aaron Fox,G,22023,1628368,22300050,"NOV 24, 2023",SAC @ MIN,W,37,14,32,0.438,3,7,0.429,5,6,0.833,2,5,7,12,1,0,2,3,36,19,1,SAC,MIN,SAC,124,2.5,3-PT Made,55,43,48,19
De'Aaron Fox,G,22023,1628368,22300050,"NOV 24, 2023",SAC @ MIN,W,37,14,32,0.438,3,7,0.429,5,6,0.833,2,5,7,12,1,0,2,3,36,19,1,SAC,MIN,SAC,124,7.0,3-PT Attempted,55,43,48,19
De'Aaron Fox,G,22023,1628368,22300050,"NOV 24, 2023",SAC @ MIN,W,37,14,32,0.438,3,7,0.429,5,6,0.833,2,5,7,12,1,0,2,3,36,19,1,SAC,MIN,SAC,124,3.5,Free Throws Made,55,43,48,19
De'Aaron Fox,G,22023,1628368,22300050,"NOV 24, 2023",SAC @ MIN,W,37,14,32,0.438,3,7,0.429,5,6,0.833,2,5,7,12,1,0,2,3,36,19,1,SAC,MIN,SAC,124,19.0,FG Attempted,55,43,48,19
De'Aaron Fox,G,22023,1628368,22300050,"NOV 24, 2023",SAC @ MIN,W,37,14,32,0.438,3,7,0.429,5,6,0.833,2,5,7,12,1,0,2,3,36,19,1,SAC,MIN,SAC,124,28.5,Pts+Rebs,55,43,48,19
De'Aaron Fox,G,22023,1628368,22300050,"NOV 24, 2023",SAC @ MIN,W,37,14,32,0.438,3,7,0.429,5,6,0.833,2,5,7,12,1,0,2,3,36,19,1,SAC,MIN,SAC,124,29.0,Pts+Asts,55,43,48,19
De'Aaron Fox,G,22023,1628368,22300050,"NOV 24, 2023",SAC @ MIN,W,37,14,32,0.438,3,7,0.429,5,6,0.833,2,5,7,12,1,0,2,3,36,19,1,SAC,MIN,SAC,124,8.5,Rebs+Asts,55,43,48,19
De'Aaron Fox,G,22023,1628368,22300050,"NOV 24, 2023",SAC @ MIN,W,37,14,32,0.438,3,7,0.429,5,6,0.833,2,5,7,12,1,0,2,3,36,19,1,SAC,MIN,SAC,124,2.5,Turnovers,55,43,48,19
De'Aaron Fox,G,22023,1628368,22300233,"NOV 22, 2023",SAC @ NOP,L,38,9,17,0.529,2,7,0.286,6,7,0.857,0,2,2,5,1,0,2,5,26,-14,1,SAC,NOP,SAC,112,24.5,Points,33,28,31,7
De'Aaron Fox,G,22023,1628368,22300233,"NOV 22, 2023",SAC @ NOP,L,38,9,17,0.529,2,7,0.286,6,7,0.857,0,2,2,5,1,0,2,5,26,-14,1,SAC,NOP,SAC,112,3.5,Rebounds,33,28,31,7
De'Aaron Fox,G,22023,1628368,22300233,"NOV 22, 2023",SAC @ NOP,L,38,9,17,0.529,2,7,0.286,6,7,0.857,0,2,2,5,1,0,2,5,26,-14,1,SAC,NOP,SAC,112,32.5,Pts+Rebs+Asts,33,28,31,7
De'Aaron Fox,G,22023,1628368,22300233,"NOV 22, 2023",SAC @ NOP,L,38,9,17,0.529,2,7,0.286,6,7,0.857,0,2,2,5,1,0,2,5,26,-14,1,SAC,NOP,SAC,112,39.5,Fantasy Score,33,28,31,7
De'Aaron Fox,G,22023,1628368,22300233,"NOV 22, 2023",SAC @ NOP,L,38,9,17,0.529,2,7,0.286,6,7,0.857,0,2,2,5,1,0,2,5,26,-14,1,SAC,NOP,SAC,112,2.5,3-PT Made,33,28,31,7
De'Aaron Fox,G,22023,1628368,22300233,"NOV 22, 2023",SAC @ NOP,L,38,9,17,0.529,2,7,0.286,6,7,0.857,0,2,2,5,1,0,2,5,26,-14,1,SAC,NOP,SAC,112,7.0,3-PT Attempted,33,28,31,7
De'Aaron Fox,G,22023,1628368,22300233,"NOV 22, 2023",SAC @ NOP,L,38,9,17,0.529,2,7,0.286,6,7,0.857,0,2,2,5,1,0,2,5,26,-14,1,SAC,NOP,SAC,112,3.5,Free Throws Made,33,28,31,7
De'Aaron Fox,G,22023,1628368,22300233,"NOV 22, 2023",SAC @ NOP,L,38,9,17,0.529,2,7,0.286,6,7,0.857,0,2,2,5,1,0,2,5,26,-14,1,SAC,NOP,SAC,112,19.0,FG Attempted,33,28,31,7
De'Aaron Fox,G,22023,1628368,22300233,"NOV 22, 2023",SAC @ NOP,L,38,9,17,0.529,2,7,0.286,6,7,0.857,0,2,2,5,1,0,2,5,26,-14,1,SAC,NOP,SAC,112,28.5,Pts+Rebs,33,28,31,7
De'Aaron Fox,G,22023,1628368,22300233,"NOV 22, 2023",SAC @ NOP,L,38,9,17,0.529,2,7,0.286,6,7,0.857,0,2,2,5,1,0,2,5,26,-14,1,SAC,NOP,SAC,112,29.0,Pts+Asts,33,28,31,7
De'Aaron Fox,G,22023,1628368,22300233,"NOV 22, 2023",SAC @ NOP,L,38,9,17,0.529,2,7,0.286,6,7,0.857,0,2,2,5,1,0,2,5,26,-14,1,SAC,NOP,SAC,112,8.5,Rebs+Asts,33,28,31,7
De'Aaron Fox,G,22023,1628368,22300233,"NOV 22, 2023",SAC @ NOP,L,38,9,17,0.529,2,7,0.286,6,7,0.857,0,2,2,5,1,0,2,5,26,-14,1,SAC,NOP,SAC,112,2.5,Turnovers,33,28,31,7
De'Aaron Fox,G,22023,1628368,22300222,"NOV 20, 2023",SAC @ NOP,L,29,5,18,0.278,2,12,0.167,2,4,0.5,0,2,2,0,1,0,2,1,14,-32,1,SAC,NOP,SAC,93,24.5,Points,16,16,14,2
De'Aaron Fox,G,22023,1628368,22300222,"NOV 20, 2023",SAC @ NOP,L,29,5,18,0.278,2,12,0.167,2,4,0.5,0,2,2,0,1,0,2,1,14,-32,1,SAC,NOP,SAC,93,3.5,Rebounds,16,16,14,2
De'Aaron Fox,G,22023,1628368,22300222,"NOV 20, 2023",SAC @ NOP,L,29,5,18,0.278,2,12,0.167,2,4,0.5,0,2,2,0,1,0,2,1,14,-32,1,SAC,NOP,SAC,93,32.5,Pts+Rebs+Asts,16,16,14,2
De'Aaron Fox,G,22023,1628368,22300222,"NOV 20, 2023",SAC @ NOP,L,29,5,18,0.278,2,12,0.167,2,4,0.5,0,2,2,0,1,0,2,1,14,-32,1,SAC,NOP,SAC,93,39.5,Fantasy Score,16,16,14,2
De'Aaron Fox,G,22023,1628368,22300222,"NOV 20, 2023",SAC @ NOP,L,29,5,18,0.278,2,12,0.167,2,4,0.5,0,2,2,0,1,0,2,1,14,-32,1,SAC,NOP,SAC,93,2.5,3-PT Made,16,16,14,2
De'Aaron Fox,G,22023,1628368,22300222,"NOV 20, 2023",SAC @ NOP,L,29,5,18,0.278,2,12,0.167,2,4,0.5,0,2,2,0,1,0,2,1,14,-32,1,SAC,NOP,SAC,93,7.0,3-PT Attempted,16,16,14,2
De'Aaron Fox,G,22023,1628368,22300222,"NOV 20, 2023",SAC @ NOP,L,29,5,18,0.278,2,12,0.167,2,4,0.5,0,2,2,0,1,0,2,1,14,-32,1,SAC,NOP,SAC,93,3.5,Free Throws Made,16,16,14,2
De'Aaron Fox,G,22023,1628368,22300222,"NOV 20, 2023",SAC @ NOP,L,29,5,18,0.278,2,12,0.167,2,4,0.5,0,2,2,0,1,0,2,1,14,-32,1,SAC,NOP,SAC,93,19.0,FG Attempted,16,16,14,2
De'Aaron Fox,G,22023,1628368,22300222,"NOV 20, 2023",SAC @ NOP,L,29,5,18,0.278,2,12,0.167,2,4,0.5,0,2,2,0,1,0,2,1,14,-32,1,SAC,NOP,SAC,93,28.5,Pts+Rebs,16,16,14,2
De'Aaron Fox,G,22023,1628368,22300222,"NOV 20, 2023",SAC @ NOP,L,29,5,18,0.278,2,12,0.167,2,4,0.5,0,2,2,0,1,0,2,1,14,-32,1,SAC,NOP,SAC,93,29.0,Pts+Asts,16,16,14,2
De'Aaron Fox,G,22023,1628368,22300222,"NOV 20, 2023",SAC @ NOP,L,29,5,18,0.278,2,12,0.167,2,4,0.5,0,2,2,0,1,0,2,1,14,-32,1,SAC,NOP,SAC,93,8.5,Rebs+Asts,16,16,14,2
De'Aaron Fox,G,22023,1628368,22300222,"NOV 20, 2023",SAC @ NOP,L,29,5,18,0.278,2,12,0.167,2,4,0.5,0,2,2,0,1,0,2,1,14,-32,1,SAC,NOP,SAC,93,2.5,Turnovers,16,16,14,2
De'Aaron Fox,G,22023,1628368,22300212,"NOV 19, 2023",SAC @ DAL,W,31,10,20,0.5,6,10,0.6,4,5,0.8,1,3,4,7,3,0,0,1,30,2,1,SAC,DAL,SAC,129,24.5,Points,41,34,37,11
De'Aaron Fox,G,22023,1628368,22300212,"NOV 19, 2023",SAC @ DAL,W,31,10,20,0.5,6,10,0.6,4,5,0.8,1,3,4,7,3,0,0,1,30,2,1,SAC,DAL,SAC,129,3.5,Rebounds,41,34,37,11
De'Aaron Fox,G,22023,1628368,22300212,"NOV 19, 2023",SAC @ DAL,W,31,10,20,0.5,6,10,0.6,4,5,0.8,1,3,4,7,3,0,0,1,30,2,1,SAC,DAL,SAC,129,32.5,Pts+Rebs+Asts,41,34,37,11
De'Aaron Fox,G,22023,1628368,22300212,"NOV 19, 2023",SAC @ DAL,W,31,10,20,0.5,6,10,0.6,4,5,0.8,1,3,4,7,3,0,0,1,30,2,1,SAC,DAL,SAC,129,39.5,Fantasy Score,41,34,37,11
De'Aaron Fox,G,22023,1628368,22300212,"NOV 19, 2023",SAC @ DAL,W,31,10,20,0.5,6,10,0.6,4,5,0.8,1,3,4,7,3,0,0,1,30,2,1,SAC,DAL,SAC,129,2.5,3-PT Made,41,34,37,11
De'Aaron Fox,G,22023,1628368,22300212,"NOV 19, 2023",SAC @ DAL,W,31,10,20,0.5,6,10,0.6,4,5,0.8,1,3,4,7,3,0,0,1,30,2,1,SAC,DAL,SAC,129,7.0,3-PT Attempted,41,34,37,11
De'Aaron Fox,G,22023,1628368,22300212,"NOV 19, 2023",SAC @ DAL,W,31,10,20,0.5,6,10,0.6,4,5,0.8,1,3,4,7,3,0,0,1,30,2,1,SAC,DAL,SAC,129,3.5,Free Throws Made,41,34,37,11
De'Aaron Fox,G,22023,1628368,22300212,"NOV 19, 2023",SAC @ DAL,W,31,10,20,0.5,6,10,0.6,4,5,0.8,1,3,4,7,3,0,0,1,30,2,1,SAC,DAL,SAC,129,19.0,FG Attempted,41,34,37,11
De'Aaron Fox,G,22023,1628368,22300212,"NOV 19, 2023",SAC @ DAL,W,31,10,20,0.5,6,10,0.6,4,5,0.8,1,3,4,7,3,0,0,1,30,2,1,SAC,DAL,SAC,129,28.5,Pts+Rebs,41,34,37,11
De'Aaron Fox,G,22023,1628368,22300212,"NOV 19, 2023",SAC @ DAL,W,31,10,20,0.5,6,10,0.6,4,5,0.8,1,3,4,7,3,0,0,1,30,2,1,SAC,DAL,SAC,129,29.0,Pts+Asts,41,34,37,11
De'Aaron Fox,G,22023,1628368,22300212,"NOV 19, 2023",SAC @ DAL,W,31,10,20,0.5,6,10,0.6,4,5,0.8,1,3,4,7,3,0,0,1,30,2,1,SAC,DAL,SAC,129,8.5,Rebs+Asts,41,34,37,11
De'Aaron Fox,G,22023,1628368,22300212,"NOV 19, 2023",SAC @ DAL,W,31,10,20,0.5,6,10,0.6,4,5,0.8,1,3,4,7,3,0,0,1,30,2,1,SAC,DAL,SAC,129,2.5,Turnovers,41,34,37,11
De'Aaron Fox,G,22023,1628368,22300032,"NOV 17, 2023",SAC @ SAS,W,41,14,24,0.583,5,11,0.455,10,13,0.769,0,8,8,7,1,1,1,2,43,3,1,SAC,SAS,SAC,129,24.5,Points,58,51,50,15
De'Aaron Fox,G,22023,1628368,22300032,"NOV 17, 2023",SAC @ SAS,W,41,14,24,0.583,5,11,0.455,10,13,0.769,0,8,8,7,1,1,1,2,43,3,1,SAC,SAS,SAC,129,3.5,Rebounds,58,51,50,15
De'Aaron Fox,G,22023,1628368,22300032,"NOV 17, 2023",SAC @ SAS,W,41,14,24,0.583,5,11,0.455,10,13,0.769,0,8,8,7,1,1,1,2,43,3,1,SAC,SAS,SAC,129,32.5,Pts+Rebs+Asts,58,51,50,15
De'Aaron Fox,G,22023,1628368,22300032,"NOV 17, 2023",SAC @ SAS,W,41,14,24,0.583,5,11,0.455,10,13,0.769,0,8,8,7,1,1,1,2,43,3,1,SAC,SAS,SAC,129,39.5,Fantasy Score,58,51,50,15
De'Aaron Fox,G,22023,1628368,22300032,"NOV 17, 2023",SAC @ SAS,W,41,14,24,0.583,5,11,0.455,10,13,0.769,0,8,8,7,1,1,1,2,43,3,1,SAC,SAS,SAC,129,2.5,3-PT Made,58,51,50,15
De'Aaron Fox,G,22023,1628368,22300032,"NOV 17, 2023",SAC @ SAS,W,41,14,24,0.583,5,11,0.455,10,13,0.769,0,8,8,7,1,1,1,2,43,3,1,SAC,SAS,SAC,129,7.0,3-PT Attempted,58,51,50,15
De'Aaron Fox,G,22023,1628368,22300032,"NOV 17, 2023",SAC @ SAS,W,41,14,24,0.583,5,11,0.455,10,13,0.769,0,8,8,7,1,1,1,2,43,3,1,SAC,SAS,SAC,129,3.5,Free Throws Made,58,51,50,15
De'Aaron Fox,G,22023,1628368,22300032,"NOV 17, 2023",SAC @ SAS,W,41,14,24,0.583,5,11,0.455,10,13,0.769,0,8,8,7,1,1,1,2,43,3,1,SAC,SAS,SAC,129,19.0,FG Attempted,58,51,50,15
De'Aaron Fox,G,22023,1628368,22300032,"NOV 17, 2023",SAC @ SAS,W,41,14,24,0.583,5,11,0.455,10,13,0.769,0,8,8,7,1,1,1,2,43,3,1,SAC,SAS,SAC,129,28.5,Pts+Rebs,58,51,50,15
De'Aaron Fox,G,22023,1628368,22300032,"NOV 17, 2023",SAC @ SAS,W,41,14,24,0.583,5,11,0.455,10,13,0.769,0,8,8,7,1,1,1,2,43,3,1,SAC,SAS,SAC,129,29.0,Pts+Asts,58,51,50,15
De'Aaron Fox,G,22023,1628368,22300032,"NOV 17, 2023",SAC @ SAS,W,41,14,24,0.583,5,11,0.455,10,13,0.769,0,8,8,7,1,1,1,2,43,3,1,SAC,SAS,SAC,129,8.5,Rebs+Asts,58,51,50,15
De'Aaron Fox,G,22023,1628368,22300032,"NOV 17, 2023",SAC @ SAS,W,41,14,24,0.583,5,11,0.455,10,13,0.769,0,8,8,7,1,1,1,2,43,3,1,SAC,SAS,SAC,129,2.5,Turnovers,58,51,50,15
De'Aaron Fox,G,22023,1628368,22300198,"NOV 15, 2023",SAC @ LAL,W,38,10,22,0.455,3,9,0.333,5,7,0.714,3,2,5,5,4,0,3,3,28,15,1,SAC,LAL,SAC,125,24.5,Points,38,33,33,10
De'Aaron Fox,G,22023,1628368,22300198,"NOV 15, 2023",SAC @ LAL,W,38,10,22,0.455,3,9,0.333,5,7,0.714,3,2,5,5,4,0,3,3,28,15,1,SAC,LAL,SAC,125,3.5,Rebounds,38,33,33,10
De'Aaron Fox,G,22023,1628368,22300198,"NOV 15, 2023",SAC @ LAL,W,38,10,22,0.455,3,9,0.333,5,7,0.714,3,2,5,5,4,0,3,3,28,15,1,SAC,LAL,SAC,125,32.5,Pts+Rebs+Asts,38,33,33,10
De'Aaron Fox,G,22023,1628368,22300198,"NOV 15, 2023",SAC @ LAL,W,38,10,22,0.455,3,9,0.333,5,7,0.714,3,2,5,5,4,0,3,3,28,15,1,SAC,LAL,SAC,125,39.5,Fantasy Score,38,33,33,10
De'Aaron Fox,G,22023,1628368,22300198,"NOV 15, 2023",SAC @ LAL,W,38,10,22,0.455,3,9,0.333,5,7,0.714,3,2,5,5,4,0,3,3,28,15,1,SAC,LAL,SAC,125,2.5,3-PT Made,38,33,33,10
De'Aaron Fox,G,22023,1628368,22300198,"NOV 15, 2023",SAC @ LAL,W,38,10,22,0.455,3,9,0.333,5,7,0.714,3,2,5,5,4,0,3,3,28,15,1,SAC,LAL,SAC,125,7.0,3-PT Attempted,38,33,33,10
De'Aaron Fox,G,22023,1628368,22300198,"NOV 15, 2023",SAC @ LAL,W,38,10,22,0.455,3,9,0.333,5,7,0.714,3,2,5,5,4,0,3,3,28,15,1,SAC,LAL,SAC,125,3.5,Free Throws Made,38,33,33,10
De'Aaron Fox,G,22023,1628368,22300198,"NOV 15, 2023",SAC @ LAL,W,38,10,22,0.455,3,9,0.333,5,7,0.714,3,2,5,5,4,0,3,3,28,15,1,SAC,LAL,SAC,125,19.0,FG Attempted,38,33,33,10
De'Aaron Fox,G,22023,1628368,22300198,"NOV 15, 2023",SAC @ LAL,W,38,10,22,0.455,3,9,0.333,5,7,0.714,3,2,5,5,4,0,3,3,28,15,1,SAC,LAL,SAC,125,28.5,Pts+Rebs,38,33,33,10
De'Aaron Fox,G,22023,1628368,22300198,"NOV 15, 2023",SAC @ LAL,W,38,10,22,0.455,3,9,0.333,5,7,0.714,3,2,5,5,4,0,3,3,28,15,1,SAC,LAL,SAC,125,29.0,Pts+Asts,38,33,33,10
De'Aaron Fox,G,22023,1628368,22300198,"NOV 15, 2023",SAC @ LAL,W,38,10,22,0.455,3,9,0.333,5,7,0.714,3,2,5,5,4,0,3,3,28,15,1,SAC,LAL,SAC,125,8.5,Rebs+Asts,38,33,33,10
De'Aaron Fox,G,22023,1628368,22300198,"NOV 15, 2023",SAC @ LAL,W,38,10,22,0.455,3,9,0.333,5,7,0.714,3,2,5,5,4,0,3,3,28,15,1,SAC,LAL,SAC,125,2.5,Turnovers,38,33,33,10
De'Aaron Fox,G,22023,1628368,22300191,"NOV 13, 2023",SAC vs. CLE,W,36,11,20,0.55,2,6,0.333,4,7,0.571,1,1,2,6,1,0,1,2,28,17,1,SAC,SAC,CLE,132,24.5,Points,36,30,34,8
De'Aaron Fox,G,22023,1628368,22300191,"NOV 13, 2023",SAC vs. CLE,W,36,11,20,0.55,2,6,0.333,4,7,0.571,1,1,2,6,1,0,1,2,28,17,1,SAC,SAC,CLE,132,3.5,Rebounds,36,30,34,8
De'Aaron Fox,G,22023,1628368,22300191,"NOV 13, 2023",SAC vs. CLE,W,36,11,20,0.55,2,6,0.333,4,7,0.571,1,1,2,6,1,0,1,2,28,17,1,SAC,SAC,CLE,132,32.5,Pts+Rebs+Asts,36,30,34,8
De'Aaron Fox,G,22023,1628368,22300191,"NOV 13, 2023",SAC vs. CLE,W,36,11,20,0.55,2,6,0.333,4,7,0.571,1,1,2,6,1,0,1,2,28,17,1,SAC,SAC,CLE,132,39.5,Fantasy Score,36,30,34,8
De'Aaron Fox,G,22023,1628368,22300191,"NOV 13, 2023",SAC vs. CLE,W,36,11,20,0.55,2,6,0.333,4,7,0.571,1,1,2,6,1,0,1,2,28,17,1,SAC,SAC,CLE,132,2.5,3-PT Made,36,30,34,8
De'Aaron Fox,G,22023,1628368,22300191,"NOV 13, 2023",SAC vs. CLE,W,36,11,20,0.55,2,6,0.333,4,7,0.571,1,1,2,6,1,0,1,2,28,17,1,SAC,SAC,CLE,132,7.0,3-PT Attempted,36,30,34,8
De'Aaron Fox,G,22023,1628368,22300191,"NOV 13, 2023",SAC vs. CLE,W,36,11,20,0.55,2,6,0.333,4,7,0.571,1,1,2,6,1,0,1,2,28,17,1,SAC,SAC,CLE,132,3.5,Free Throws Made,36,30,34,8
De'Aaron Fox,G,22023,1628368,22300191,"NOV 13, 2023",SAC vs. CLE,W,36,11,20,0.55,2,6,0.333,4,7,0.571,1,1,2,6,1,0,1,2,28,17,1,SAC,SAC,CLE,132,19.0,FG Attempted,36,30,34,8
De'Aaron Fox,G,22023,1628368,22300191,"NOV 13, 2023",SAC vs. CLE,W,36,11,20,0.55,2,6,0.333,4,7,0.571,1,1,2,6,1,0,1,2,28,17,1,SAC,SAC,CLE,132,28.5,Pts+Rebs,36,30,34,8
De'Aaron Fox,G,22023,1628368,22300191,"NOV 13, 2023",SAC vs. CLE,W,36,11,20,0.55,2,6,0.333,4,7,0.571,1,1,2,6,1,0,1,2,28,17,1,SAC,SAC,CLE,132,29.0,Pts+Asts,36,30,34,8
De'Aaron Fox,G,22023,1628368,22300191,"NOV 13, 2023",SAC vs. CLE,W,36,11,20,0.55,2,6,0.333,4,7,0.571,1,1,2,6,1,0,1,2,28,17,1,SAC,SAC,CLE,132,8.5,Rebs+Asts,36,30,34,8
De'Aaron Fox,G,22023,1628368,22300191,"NOV 13, 2023",SAC vs. CLE,W,36,11,20,0.55,2,6,0.333,4,7,0.571,1,1,2,6,1,0,1,2,28,17,1,SAC,SAC,CLE,132,2.5,Turnovers,36,30,34,8
De'Aaron Fox,G,22023,1628368,22300100,"OCT 29, 2023",SAC vs. LAL,W,34,14,24,0.583,3,8,0.375,6,8,0.75,1,3,4,8,1,1,3,5,37,15,1,SAC,SAC,LAL,132,24.5,Points,49,41,45,12
De'Aaron Fox,G,22023,1628368,22300100,"OCT 29, 2023",SAC vs. LAL,W,34,14,24,0.583,3,8,0.375,6,8,0.75,1,3,4,8,1,1,3,5,37,15,1,SAC,SAC,LAL,132,3.5,Rebounds,49,41,45,12
De'Aaron Fox,G,22023,1628368,22300100,"OCT 29, 2023",SAC vs. LAL,W,34,14,24,0.583,3,8,0.375,6,8,0.75,1,3,4,8,1,1,3,5,37,15,1,SAC,SAC,LAL,132,32.5,Pts+Rebs+Asts,49,41,45,12
De'Aaron Fox,G,22023,1628368,22300100,"OCT 29, 2023",SAC vs. LAL,W,34,14,24,0.583,3,8,0.375,6,8,0.75,1,3,4,8,1,1,3,5,37,15,1,SAC,SAC,LAL,132,39.5,Fantasy Score,49,41,45,12
De'Aaron Fox,G,22023,1628368,22300100,"OCT 29, 2023",SAC vs. LAL,W,34,14,24,0.583,3,8,0.375,6,8,0.75,1,3,4,8,1,1,3,5,37,15,1,SAC,SAC,LAL,132,2.5,3-PT Made,49,41,45,12
De'Aaron Fox,G,22023,1628368,22300100,"OCT 29, 2023",SAC vs. LAL,W,34,14,24,0.583,3,8,0.375,6,8,0.75,1,3,4,8,1,1,3,5,37,15,1,SAC,SAC,LAL,132,7.0,3-PT Attempted,49,41,45,12
De'Aaron Fox,G,22023,1628368,22300100,"OCT 29, 2023",SAC vs. LAL,W,34,14,24,0.583,3,8,0.375,6,8,0.75,1,3,4,8,1,1,3,5,37,15,1,SAC,SAC,LAL,132,3.5,Free Throws Made,49,41,45,12
De'Aaron Fox,G,22023,1628368,22300100,"OCT 29, 2023",SAC vs. LAL,W,34,14,24,0.583,3,8,0.375,6,8,0.75,1,3,4,8,1,1,3,5,37,15,1,SAC,SAC,LAL,132,19.0,FG Attempted,49,41,45,12
De'Aaron Fox,G,22023,1628368,22300100,"OCT 29, 2023",SAC vs. LAL,W,34,14,24,0.583,3,8,0.375,6,8,0.75,1,3,4,8,1,1,3,5,37,15,1,SAC,SAC,LAL,132,28.5,Pts+Rebs,49,41,45,12
De'Aaron Fox,G,22023,1628368,22300100,"OCT 29, 2023",SAC vs. LAL,W,34,14,24,0.583,3,8,0.375,6,8,0.75,1,3,4,8,1,1,3,5,37,15,1,SAC,SAC,LAL,132,29.0,Pts+Asts,49,41,45,12
De'Aaron Fox,G,22023,1628368,22300100,"OCT 29, 2023",SAC vs. LAL,W,34,14,24,0.583,3,8,0.375,6,8,0.75,1,3,4,8,1,1,3,5,37,15,1,SAC,SAC,LAL,132,8.5,Rebs+Asts,49,41,45,12
De'Aaron Fox,G,22023,1628368,22300100,"OCT 29, 2023",SAC vs. LAL,W,34,14,24,0.583,3,8,0.375,6,8,0.75,1,3,4,8,1,1,3,5,37,15,1,SAC,SAC,LAL,132,2.5,Turnovers,49,41,45,12
De'Aaron Fox,G,22023,1628368,22300087,"OCT 27, 2023",SAC vs. GSW,L,39,14,28,0.5,5,9,0.556,6,7,0.857,0,4,4,4,2,0,2,3,39,1,1,SAC,SAC,GSW,114,24.5,Points,47,43,43,8
De'Aaron Fox,G,22023,1628368,22300087,"OCT 27, 2023",SAC vs. GSW,L,39,14,28,0.5,5,9,0.556,6,7,0.857,0,4,4,4,2,0,2,3,39,1,1,SAC,SAC,GSW,114,3.5,Rebounds,47,43,43,8
De'Aaron Fox,G,22023,1628368,22300087,"OCT 27, 2023",SAC vs. GSW,L,39,14,28,0.5,5,9,0.556,6,7,0.857,0,4,4,4,2,0,2,3,39,1,1,SAC,SAC,GSW,114,32.5,Pts+Rebs+Asts,47,43,43,8
De'Aaron Fox,G,22023,1628368,22300087,"OCT 27, 2023",SAC vs. GSW,L,39,14,28,0.5,5,9,0.556,6,7,0.857,0,4,4,4,2,0,2,3,39,1,1,SAC,SAC,GSW,114,39.5,Fantasy Score,47,43,43,8
De'Aaron Fox,G,22023,1628368,22300087,"OCT 27, 2023",SAC vs. GSW,L,39,14,28,0.5,5,9,0.556,6,7,0.857,0,4,4,4,2,0,2,3,39,1,1,SAC,SAC,GSW,114,2.5,3-PT Made,47,43,43,8
De'Aaron Fox,G,22023,1628368,22300087,"OCT 27, 2023",SAC vs. GSW,L,39,14,28,0.5,5,9,0.556,6,7,0.857,0,4,4,4,2,0,2,3,39,1,1,SAC,SAC,GSW,114,7.0,3-PT Attempted,47,43,43,8
De'Aaron Fox,G,22023,1628368,22300087,"OCT 27, 2023",SAC vs. GSW,L,39,14,28,0.5,5,9,0.556,6,7,0.857,0,4,4,4,2,0,2,3,39,1,1,SAC,SAC,GSW,114,3.5,Free Throws Made,47,43,43,8
De'Aaron Fox,G,22023,1628368,22300087,"OCT 27, 2023",SAC vs. GSW,L,39,14,28,0.5,5,9,0.556,6,7,0.857,0,4,4,4,2,0,2,3,39,1,1,SAC,SAC,GSW,114,19.0,FG Attempted,47,43,43,8
De'Aaron Fox,G,22023,1628368,22300087,"OCT 27, 2023",SAC vs. GSW,L,39,14,28,0.5,5,9,0.556,6,7,0.857,0,4,4,4,2,0,2,3,39,1,1,SAC,SAC,GSW,114,28.5,Pts+Rebs,47,43,43,8
De'Aaron Fox,G,22023,1628368,22300087,"OCT 27, 2023",SAC vs. GSW,L,39,14,28,0.5,5,9,0.556,6,7,0.857,0,4,4,4,2,0,2,3,39,1,1,SAC,SAC,GSW,114,29.0,Pts+Asts,47,43,43,8
De'Aaron Fox,G,22023,1628368,22300087,"OCT 27, 2023",SAC vs. GSW,L,39,14,28,0.5,5,9,0.556,6,7,0.857,0,4,4,4,2,0,2,3,39,1,1,SAC,SAC,GSW,114,8.5,Rebs+Asts,47,43,43,8
De'Aaron Fox,G,22023,1628368,22300087,"OCT 27, 2023",SAC vs. GSW,L,39,14,28,0.5,5,9,0.556,6,7,0.857,0,4,4,4,2,0,2,3,39,1,1,SAC,SAC,GSW,114,2.5,Turnovers,47,43,43,8
De'Aaron Fox,G,22023,1628368,22300072,"OCT 25, 2023",SAC @ UTA,W,33,6,18,0.333,1,7,0.143,5,6,0.833,2,3,5,6,1,1,3,4,18,14,1,SAC,UTA,SAC,130,24.5,Points,29,23,24,11
De'Aaron Fox,G,22023,1628368,22300072,"OCT 25, 2023",SAC @ UTA,W,33,6,18,0.333,1,7,0.143,5,6,0.833,2,3,5,6,1,1,3,4,18,14,1,SAC,UTA,SAC,130,3.5,Rebounds,29,23,24,11
De'Aaron Fox,G,22023,1628368,22300072,"OCT 25, 2023",SAC @ UTA,W,33,6,18,0.333,1,7,0.143,5,6,0.833,2,3,5,6,1,1,3,4,18,14,1,SAC,UTA,SAC,130,32.5,Pts+Rebs+Asts,29,23,24,11
De'Aaron Fox,G,22023,1628368,22300072,"OCT 25, 2023",SAC @ UTA,W,33,6,18,0.333,1,7,0.143,5,6,0.833,2,3,5,6,1,1,3,4,18,14,1,SAC,UTA,SAC,130,39.5,Fantasy Score,29,23,24,11
De'Aaron Fox,G,22023,1628368,22300072,"OCT 25, 2023",SAC @ UTA,W,33,6,18,0.333,1,7,0.143,5,6,0.833,2,3,5,6,1,1,3,4,18,14,1,SAC,UTA,SAC,130,2.5,3-PT Made,29,23,24,11
De'Aaron Fox,G,22023,1628368,22300072,"OCT 25, 2023",SAC @ UTA,W,33,6,18,0.333,1,7,0.143,5,6,0.833,2,3,5,6,1,1,3,4,18,14,1,SAC,UTA,SAC,130,7.0,3-PT Attempted,29,23,24,11
De'Aaron Fox,G,22023,1628368,22300072,"OCT 25, 2023",SAC @ UTA,W,33,6,18,0.333,1,7,0.143,5,6,0.833,2,3,5,6,1,1,3,4,18,14,1,SAC,UTA,SAC,130,3.5,Free Throws Made,29,23,24,11
De'Aaron Fox,G,22023,1628368,22300072,"OCT 25, 2023",SAC @ UTA,W,33,6,18,0.333,1,7,0.143,5,6,0.833,2,3,5,6,1,1,3,4,18,14,1,SAC,UTA,SAC,130,19.0,FG Attempted,29,23,24,11
De'Aaron Fox,G,22023,1628368,22300072,"OCT 25, 2023",SAC @ UTA,W,33,6,18,0.333,1,7,0.143,5,6,0.833,2,3,5,6,1,1,3,4,18,14,1,SAC,UTA,SAC,130,28.5,Pts+Rebs,29,23,24,11
De'Aaron Fox,G,22023,1628368,22300072,"OCT 25, 2023",SAC @ UTA,W,33,6,18,0.333,1,7,0.143,5,6,0.833,2,3,5,6,1,1,3,4,18,14,1,SAC,UTA,SAC,130,29.0,Pts+Asts,29,23,24,11
De'Aaron Fox,G,22023,1628368,22300072,"OCT 25, 2023",SAC @ UTA,W,33,6,18,0.333,1,7,0.143,5,6,0.833,2,3,5,6,1,1,3,4,18,14,1,SAC,UTA,SAC,130,8.5,Rebs+Asts,29,23,24,11
De'Aaron Fox,G,22023,1628368,22300072,"OCT 25, 2023",SAC @ UTA,W,33,6,18,0.333,1,7,0.143,5,6,0.833,2,3,5,6,1,1,3,4,18,14,1,SAC,UTA,SAC,130,2.5,Turnovers,29,23,24,11
Trae Young,G,22023,1629027,22300754,"FEB 10, 2024",ATL vs. HOU,W,33,6,16,0.375,2,9,0.222,4,6,0.667,0,4,4,8,2,1,4,3,18,-1,1,ATL,ATL,HOU,122,,,30,22,26,12
Trae Young,G,22023,1629027,22300742,"FEB 09, 2024",ATL @ PHI,W,40,10,21,0.476,5,12,0.417,12,16,0.75,0,1,1,12,1,0,7,1,37,5,1,ATL,PHI,ATL,127,,,50,38,49,13
Trae Young,G,22023,1629027,22300729,"FEB 07, 2024",ATL @ BOS,L,38,8,25,0.32,2,10,0.2,2,2,1.0,0,2,2,10,1,0,4,0,20,-10,1,ATL,BOS,ATL,117,,,32,22,30,12
Trae Young,G,22023,1629027,22300716,"FEB 05, 2024",ATL vs. LAC,L,36,8,14,0.571,3,7,0.429,6,6,1.0,0,2,2,12,2,0,5,5,25,-6,1,ATL,ATL,LAC,144,,,39,27,37,14
Trae Young,G,22023,1629027,22300690,"FEB 02, 2024",ATL vs. PHX,W,42,12,17,0.706,7,11,0.636,1,2,0.5,0,1,1,15,3,1,7,2,32,-1,1,ATL,ATL,PHX,129,,,48,33,47,16
Trae Young,G,22023,1629027,22300669,"JAN 30, 2024",ATL vs. LAL,W,34,9,20,0.45,6,9,0.667,2,2,1.0,1,1,2,13,1,0,5,0,26,5,1,ATL,ATL,LAL,138,,,41,28,39,15
Trae Young,G,22023,1629027,22300653,"JAN 28, 2024",ATL vs. TOR,W,42,9,24,0.375,1,4,0.25,11,12,0.917,0,2,2,12,2,0,5,3,30,8,1,ATL,ATL,TOR,126,,,44,32,42,14
Trae Young,G,22023,1629027,22300634,"JAN 26, 2024",ATL vs. DAL,L,33,9,18,0.5,2,7,0.286,10,11,0.909,0,1,1,11,3,0,2,3,30,9,1,ATL,ATL,DAL,143,,,42,31,41,12
Trae Young,G,22023,1629027,22300595,"JAN 20, 2024",ATL vs. CLE,L,28,6,12,0.5,3,4,0.75,0,0,0.0,0,1,1,5,0,0,4,2,15,-20,1,ATL,ATL,CLE,95,,,21,16,20,6
Trae Young,G,22023,1629027,22300570,"JAN 17, 2024",ATL vs. ORL,W,39,5,14,0.357,1,6,0.167,7,7,1.0,1,2,3,12,1,0,8,3,18,2,1,ATL,ATL,ORL,106,,,33,21,30,15
Trae Young,G,22023,1629027,22300559,"JAN 15, 2024",ATL vs. SAS,W,38,11,24,0.458,6,11,0.545,8,9,0.889,0,6,6,13,1,1,3,0,36,16,1,ATL,ATL,SAS,109,,,55,42,49,19
Trae Young,G,22023,1629027,22300543,"JAN 13, 2024",ATL vs. WAS,L,36,6,19,0.316,2,10,0.2,7,9,0.778,1,1,2,10,1,1,1,5,21,-23,1,ATL,ATL,WAS,99,,,33,23,31,12
Trae Young,G,22023,1629027,22300533,"JAN 12, 2024",ATL vs. IND,L,30,4,17,0.235,2,6,0.333,3,3,1.0,3,0,3,6,2,0,5,1,13,-19,1,ATL,ATL,IND,108,,,22,16,19,9
Trae Young,G,22023,1629027,22300521,"JAN 10, 2024",ATL vs. PHI,W,43,7,22,0.318,2,8,0.25,12,14,0.857,0,1,1,11,1,1,5,2,28,7,1,ATL,ATL,PHI,139,,,40,29,39,12
Trae Young,G,22023,1629027,22300499,"JAN 07, 2024",ATL @ ORL,L,42,11,23,0.478,2,9,0.222,7,10,0.7,0,4,4,9,1,1,5,2,31,-10,1,ATL,ORL,ATL,110,,,44,35,40,13
Trae Young,G,22023,1629027,22300480,"JAN 05, 2024",ATL @ IND,L,28,4,18,0.222,1,11,0.091,4,5,0.8,0,2,2,6,2,0,3,2,13,-28,1,ATL,IND,ATL,116,,,21,15,19,8
Trae Young,G,22023,1629027,22300467,"JAN 03, 2024",ATL vs. OKC,W,34,6,13,0.462,2,9,0.222,10,11,0.909,0,4,4,11,2,0,6,2,24,-9,1,ATL,ATL,OKC,141,,,39,28,35,15
Trae Young,G,22023,1629027,22300445,"DEC 31, 2023",ATL @ WAS,W,40,11,19,0.579,4,8,0.5,14,19,0.737,0,3,3,13,3,0,5,2,40,-13,1,ATL,WAS,ATL,130,,,56,43,53,16
Trae Young,G,22023,1629027,22300431,"DEC 29, 2023",ATL vs. SAC,L,38,7,18,0.389,3,10,0.3,7,7,1.0,1,2,3,9,4,0,4,4,24,-11,1,ATL,ATL,SAC,110,,,36,27,33,12
Trae Young,G,22023,1629027,22300408,"DEC 26, 2023",ATL @ CHI,L,40,6,17,0.353,3,12,0.25,6,7,0.857,0,2,2,13,1,0,6,3,21,-3,1,ATL,CHI,ATL,113,,,36,23,34,15
Trae Young,G,22023,1629027,22300393,"DEC 23, 2023",ATL vs. MEM,L,41,11,24,0.458,3,10,0.3,5,7,0.714,0,5,5,13,1,1,2,3,30,2,1,ATL,ATL,MEM,119,,,48,35,43,18
Trae Young,G,22023,1629027,22300384,"DEC 22, 2023",ATL @ MIA,L,40,10,22,0.455,7,13,0.538,3,3,1.0,0,3,3,13,2,0,6,1,30,-11,1,ATL,MIA,ATL,113,,,46,33,43,16
Trae Young,G,22023,1629027,22300371,"DEC 20, 2023",ATL @ HOU,W,36,10,18,0.556,5,8,0.625,5,7,0.714,0,4,4,14,1,0,4,4,30,11,1,ATL,HOU,ATL,134,,,48,34,44,18
Trae Young,G,22023,1629027,22300352,"DEC 18, 2023",ATL vs. DET,W,38,8,17,0.471,4,11,0.364,11,12,0.917,0,4,4,15,0,0,5,3,31,16,1,ATL,ATL,DET,130,,,50,35,46,19
Trae Young,G,22023,1629027,22300336,"DEC 16, 2023",ATL @ CLE,L,38,11,21,0.524,7,12,0.583,6,6,1.0,0,4,4,10,0,1,5,3,35,-9,1,ATL,CLE,ATL,119,,,49,39,45,14
Trae Young,G,22023,1629027,22300330,"DEC 15, 2023",ATL @ TOR,W,36,15,29,0.517,7,15,0.467,1,2,0.5,1,4,5,11,1,0,8,2,38,14,1,ATL,TOR,ATL,125,,,54,43,49,16
Trae Young,G,22023,1629027,22300313,"DEC 13, 2023",ATL @ TOR,L,39,13,27,0.481,4,9,0.444,5,6,0.833,0,4,4,17,0,1,5,3,35,0,1,ATL,TOR,ATL,128,,,56,39,52,21
Trae Young,G,22023,1629027,22300296,"DEC 11, 2023",ATL vs. DEN,L,26,5,12,0.417,2,5,0.4,7,7,1.0,0,1,1,9,1,0,5,2,19,-10,1,ATL,ATL,DEN,122,,,29,20,28,10
Trae Young,G,22023,1629027,22301209,"DEC 06, 2023",ATL vs. BKN,L,37,11,24,0.458,3,9,0.333,5,5,1.0,1,0,1,9,0,2,5,2,30,3,1,ATL,ATL,BKN,113,,,40,31,39,10
Trae Young,G,22023,1629027,22300286,"DEC 02, 2023",ATL @ MIL,L,37,13,28,0.464,5,13,0.385,1,2,0.5,2,0,2,12,2,0,4,0,32,-8,1,ATL,MIL,ATL,121,,,46,34,44,14
Trae Young,G,22023,1629027,22300272,"NOV 30, 2023",ATL @ SAS,W,40,15,29,0.517,2,9,0.222,13,16,0.813,0,4,4,14,2,0,2,1,45,-1,1,ATL,SAS,ATL,137,,,63,49,59,18
Trae Young,G,22023,1629027,22300055,"NOV 28, 2023",ATL @ CLE,L,32,3,14,0.214,2,8,0.25,5,6,0.833,0,1,1,10,1,0,3,3,13,-27,1,ATL,CLE,ATL,105,,,24,14,23,11
Trae Young,G,22023,1629027,22300246,"NOV 26, 2023",ATL @ BOS,L,37,12,27,0.444,6,16,0.375,3,6,0.5,1,4,5,7,0,0,5,3,33,-11,1,ATL,BOS,ATL,103,,,45,38,40,12
Trae Young,G,22023,1629027,22300241,"NOV 25, 2023",ATL @ WAS,W,30,9,17,0.529,5,8,0.625,3,3,1.0,0,6,6,10,2,0,2,1,26,40,1,ATL,WAS,ATL,136,,,42,32,36,16
Trae Young,G,22023,1629027,22300227,"NOV 22, 2023",ATL vs. BKN,W,40,12,31,0.387,8,16,0.5,11,13,0.846,2,2,4,9,2,0,4,0,43,-11,1,ATL,ATL,BKN,147,,,56,47,52,13
Trae Young,G,22023,1629027,22300039,"NOV 21, 2023",ATL vs. IND,L,39,13,17,0.765,5,8,0.625,7,8,0.875,0,1,1,8,3,0,3,3,38,-2,1,ATL,ATL,IND,152,,,47,39,46,9
Trae Young,G,22023,1629027,22300029,"NOV 17, 2023",ATL vs. PHI,L,37,5,14,0.357,2,6,0.333,10,10,1.0,0,2,2,13,1,0,4,3,22,12,1,ATL,ATL,PHI,116,,,37,24,35,15
Trae Young,G,22023,1629027,22300193,"NOV 15, 2023",ATL vs. NYK,L,34,4,12,0.333,0,4,0.0,7,9,0.778,0,1,1,17,2,0,3,0,15,1,1,ATL,ATL,NYK,114,,,33,16,32,18
Trae Young,G,22023,1629027,22300175,"NOV 11, 2023",ATL vs. MIA,L,38,7,19,0.368,3,9,0.333,10,11,0.909,0,2,2,11,1,0,5,0,27,4,1,ATL,ATL,MIA,109,,,40,29,38,13
Trae Young,G,22023,1629027,22300172,"NOV 09, 2023",ATL @ ORL,W,34,12,27,0.444,5,15,0.333,12,13,0.923,2,2,4,8,3,0,3,1,41,1,1,ATL,ORL,ATL,120,,,53,45,49,12
Trae Young,G,22023,1629027,22300155,"NOV 06, 2023",ATL @ OKC,L,36,5,18,0.278,1,5,0.2,11,11,1.0,1,3,4,11,1,0,7,1,22,-18,1,ATL,OKC,ATL,117,,,37,26,33,15
Trae Young,G,22023,1629027,22300135,"NOV 04, 2023",ATL @ NOP,W,39,7,15,0.467,3,7,0.429,5,6,0.833,3,2,5,12,1,0,5,3,22,18,1,ATL,NOP,ATL,123,,,39,27,34,17
Trae Young,G,22023,1629027,22300117,"NOV 01, 2023",ATL vs. WAS,W,35,7,18,0.389,1,3,0.333,8,9,0.889,0,3,3,10,2,0,3,1,23,4,1,ATL,ATL,WAS,130,,,36,26,33,13
Trae Young,G,22023,1629027,22300104,"OCT 30, 2023",ATL vs. MIN,W,35,9,22,0.409,1,7,0.143,5,5,1.0,0,1,1,8,1,0,1,1,24,4,1,ATL,ATL,MIN,127,,,33,25,32,9
Trae Young,G,22023,1629027,22300097,"OCT 29, 2023",ATL @ MIL,W,32,5,14,0.357,3,8,0.375,7,9,0.778,0,3,3,11,1,0,3,1,20,13,1,ATL,MIL,ATL,127,,,34,23,31,14
Trae Young,G,22023,1629027,22300079,"OCT 27, 2023",ATL vs. NYK,L,35,4,16,0.25,2,5,0.4,8,10,0.8,1,2,3,12,3,0,6,2,18,-5,1,ATL,ATL,NYK,120,,,33,21,30,15
Trae Young,G,22023,1629027,22300063,"OCT 25, 2023",ATL @ CHA,L,36,4,19,0.211,1,9,0.111,14,15,0.933,0,1,1,9,1,0,5,3,23,-11,1,ATL,CHA,ATL,110,,,33,24,32,10
Trae Young,G,22023,1629027,22300699,"FEB 03, 2024",ATL vs. GSW,W,42,12,21,0.571,7,11,0.636,4,5,0.8,0,0,0,6,1,0,3,3,35,5,1,ATL,ATL,GSW,141,,,41,35,41,6
Jayson Tatum,F,22023,1628369,22300706,"FEB 04, 2024",BOS vs. MEM,W,31,12,22,0.545,6,12,0.5,4,4,1.0,1,7,8,7,1,0,2,1,34,27,1,BOS,BOS,MEM,131,26.5,Points,49,42,41,15
Jayson Tatum,F,22023,1628369,22300706,"FEB 04, 2024",BOS vs. MEM,W,31,12,22,0.545,6,12,0.5,4,4,1.0,1,7,8,7,1,0,2,1,34,27,1,BOS,BOS,MEM,131,8.5,Rebounds,49,42,41,15
Jayson Tatum,F,22023,1628369,22300706,"FEB 04, 2024",BOS vs. MEM,W,31,12,22,0.545,6,12,0.5,4,4,1.0,1,7,8,7,1,0,2,1,34,27,1,BOS,BOS,MEM,131,39.5,Pts+Rebs+Asts,49,42,41,15
Jayson Tatum,F,22023,1628369,22300706,"FEB 04, 2024",BOS vs. MEM,W,31,12,22,0.545,6,12,0.5,4,4,1.0,1,7,8,7,1,0,2,1,34,27,1,BOS,BOS,MEM,131,4.5,Assists,49,42,41,15
Jayson Tatum,F,22023,1628369,22300706,"FEB 04, 2024",BOS vs. MEM,W,31,12,22,0.545,6,12,0.5,4,4,1.0,1,7,8,7,1,0,2,1,34,27,1,BOS,BOS,MEM,131,45.5,Fantasy Score,49,42,41,15
Jayson Tatum,F,22023,1628369,22300706,"FEB 04, 2024",BOS vs. MEM,W,31,12,22,0.545,6,12,0.5,4,4,1.0,1,7,8,7,1,0,2,1,34,27,1,BOS,BOS,MEM,131,7.0,Defensive Rebounds,49,42,41,15
Jayson Tatum,F,22023,1628369,22300706,"FEB 04, 2024",BOS vs. MEM,W,31,12,22,0.545,6,12,0.5,4,4,1.0,1,7,8,7,1,0,2,1,34,27,1,BOS,BOS,MEM,131,9.0,3-PT Attempted,49,42,41,15
Jayson Tatum,F,22023,1628369,22300706,"FEB 04, 2024",BOS vs. MEM,W,31,12,22,0.545,6,12,0.5,4,4,1.0,1,7,8,7,1,0,2,1,34,27,1,BOS,BOS,MEM,131,5.5,Free Throws Made,49,42,41,15
Jayson Tatum,F,22023,1628369,22300706,"FEB 04, 2024",BOS vs. MEM,W,31,12,22,0.545,6,12,0.5,4,4,1.0,1,7,8,7,1,0,2,1,34,27,1,BOS,BOS,MEM,131,19.5,FG Attempted,49,42,41,15
Jayson Tatum,F,22023,1628369,22300706,"FEB 04, 2024",BOS vs. MEM,W,31,12,22,0.545,6,12,0.5,4,4,1.0,1,7,8,7,1,0,2,1,34,27,1,BOS,BOS,MEM,131,35.5,Pts+Rebs,49,42,41,15
Jayson Tatum,F,22023,1628369,22300706,"FEB 04, 2024",BOS vs. MEM,W,31,12,22,0.545,6,12,0.5,4,4,1.0,1,7,8,7,1,0,2,1,34,27,1,BOS,BOS,MEM,131,31.5,Pts+Asts,49,42,41,15
Jayson Tatum,F,22023,1628369,22300706,"FEB 04, 2024",BOS vs. MEM,W,31,12,22,0.545,6,12,0.5,4,4,1.0,1,7,8,7,1,0,2,1,34,27,1,BOS,BOS,MEM,131,13.0,Rebs+Asts,49,42,41,15
Jayson Tatum,F,22023,1628369,22300706,"FEB 04, 2024",BOS vs. MEM,W,31,12,22,0.545,6,12,0.5,4,4,1.0,1,7,8,7,1,0,2,1,34,27,1,BOS,BOS,MEM,131,1.5,Blks+Stls,49,42,41,15
Jayson Tatum,F,22023,1628369,22300684,"FEB 01, 2024",BOS vs. LAL,L,37,8,21,0.381,5,10,0.5,2,2,1.0,2,5,7,3,1,1,2,3,23,-12,1,BOS,BOS,LAL,105,26.5,Points,33,30,26,10
Jayson Tatum,F,22023,1628369,22300684,"FEB 01, 2024",BOS vs. LAL,L,37,8,21,0.381,5,10,0.5,2,2,1.0,2,5,7,3,1,1,2,3,23,-12,1,BOS,BOS,LAL,105,8.5,Rebounds,33,30,26,10
Jayson Tatum,F,22023,1628369,22300684,"FEB 01, 2024",BOS vs. LAL,L,37,8,21,0.381,5,10,0.5,2,2,1.0,2,5,7,3,1,1,2,3,23,-12,1,BOS,BOS,LAL,105,39.5,Pts+Rebs+Asts,33,30,26,10
Jayson Tatum,F,22023,1628369,22300684,"FEB 01, 2024",BOS vs. LAL,L,37,8,21,0.381,5,10,0.5,2,2,1.0,2,5,7,3,1,1,2,3,23,-12,1,BOS,BOS,LAL,105,4.5,Assists,33,30,26,10
Jayson Tatum,F,22023,1628369,22300684,"FEB 01, 2024",BOS vs. LAL,L,37,8,21,0.381,5,10,0.5,2,2,1.0,2,5,7,3,1,1,2,3,23,-12,1,BOS,BOS,LAL,105,45.5,Fantasy Score,33,30,26,10
Jayson Tatum,F,22023,1628369,22300684,"FEB 01, 2024",BOS vs. LAL,L,37,8,21,0.381,5,10,0.5,2,2,1.0,2,5,7,3,1,1,2,3,23,-12,1,BOS,BOS,LAL,105,7.0,Defensive Rebounds,33,30,26,10
Jayson Tatum,F,22023,1628369,22300684,"FEB 01, 2024",BOS vs. LAL,L,37,8,21,0.381,5,10,0.5,2,2,1.0,2,5,7,3,1,1,2,3,23,-12,1,BOS,BOS,LAL,105,9.0,3-PT Attempted,33,30,26,10
Jayson Tatum,F,22023,1628369,22300684,"FEB 01, 2024",BOS vs. LAL,L,37,8,21,0.381,5,10,0.5,2,2,1.0,2,5,7,3,1,1,2,3,23,-12,1,BOS,BOS,LAL,105,5.5,Free Throws Made,33,30,26,10
Jayson Tatum,F,22023,1628369,22300684,"FEB 01, 2024",BOS vs. LAL,L,37,8,21,0.381,5,10,0.5,2,2,1.0,2,5,7,3,1,1,2,3,23,-12,1,BOS,BOS,LAL,105,19.5,FG Attempted,33,30,26,10
Jayson Tatum,F,22023,1628369,22300684,"FEB 01, 2024",BOS vs. LAL,L,37,8,21,0.381,5,10,0.5,2,2,1.0,2,5,7,3,1,1,2,3,23,-12,1,BOS,BOS,LAL,105,35.5,Pts+Rebs,33,30,26,10
Jayson Tatum,F,22023,1628369,22300684,"FEB 01, 2024",BOS vs. LAL,L,37,8,21,0.381,5,10,0.5,2,2,1.0,2,5,7,3,1,1,2,3,23,-12,1,BOS,BOS,LAL,105,31.5,Pts+Asts,33,30,26,10
Jayson Tatum,F,22023,1628369,22300684,"FEB 01, 2024",BOS vs. LAL,L,37,8,21,0.381,5,10,0.5,2,2,1.0,2,5,7,3,1,1,2,3,23,-12,1,BOS,BOS,LAL,105,13.0,Rebs+Asts,33,30,26,10
Jayson Tatum,F,22023,1628369,22300684,"FEB 01, 2024",BOS vs. LAL,L,37,8,21,0.381,5,10,0.5,2,2,1.0,2,5,7,3,1,1,2,3,23,-12,1,BOS,BOS,LAL,105,1.5,Blks+Stls,33,30,26,10
Jayson Tatum,F,22023,1628369,22300646,"JAN 27, 2024",BOS vs. LAC,L,30,8,18,0.444,2,4,0.5,3,3,1.0,3,8,11,1,0,1,3,2,21,-32,1,BOS,BOS,LAC,96,26.5,Points,33,32,22,12
Jayson Tatum,F,22023,1628369,22300646,"JAN 27, 2024",BOS vs. LAC,L,30,8,18,0.444,2,4,0.5,3,3,1.0,3,8,11,1,0,1,3,2,21,-32,1,BOS,BOS,LAC,96,8.5,Rebounds,33,32,22,12
Jayson Tatum,F,22023,1628369,22300646,"JAN 27, 2024",BOS vs. LAC,L,30,8,18,0.444,2,4,0.5,3,3,1.0,3,8,11,1,0,1,3,2,21,-32,1,BOS,BOS,LAC,96,39.5,Pts+Rebs+Asts,33,32,22,12
Jayson Tatum,F,22023,1628369,22300646,"JAN 27, 2024",BOS vs. LAC,L,30,8,18,0.444,2,4,0.5,3,3,1.0,3,8,11,1,0,1,3,2,21,-32,1,BOS,BOS,LAC,96,4.5,Assists,33,32,22,12
Jayson Tatum,F,22023,1628369,22300646,"JAN 27, 2024",BOS vs. LAC,L,30,8,18,0.444,2,4,0.5,3,3,1.0,3,8,11,1,0,1,3,2,21,-32,1,BOS,BOS,LAC,96,45.5,Fantasy Score,33,32,22,12
Jayson Tatum,F,22023,1628369,22300646,"JAN 27, 2024",BOS vs. LAC,L,30,8,18,0.444,2,4,0.5,3,3,1.0,3,8,11,1,0,1,3,2,21,-32,1,BOS,BOS,LAC,96,7.0,Defensive Rebounds,33,32,22,12
Jayson Tatum,F,22023,1628369,22300646,"JAN 27, 2024",BOS vs. LAC,L,30,8,18,0.444,2,4,0.5,3,3,1.0,3,8,11,1,0,1,3,2,21,-32,1,BOS,BOS,LAC,96,9.0,3-PT Attempted,33,32,22,12
Jayson Tatum,F,22023,1628369,22300646,"JAN 27, 2024",BOS vs. LAC,L,30,8,18,0.444,2,4,0.5,3,3,1.0,3,8,11,1,0,1,3,2,21,-32,1,BOS,BOS,LAC,96,5.5,Free Throws Made,33,32,22,12
Jayson Tatum,F,22023,1628369,22300646,"JAN 27, 2024",BOS vs. LAC,L,30,8,18,0.444,2,4,0.5,3,3,1.0,3,8,11,1,0,1,3,2,21,-32,1,BOS,BOS,LAC,96,19.5,FG Attempted,33,32,22,12
Jayson Tatum,F,22023,1628369,22300646,"JAN 27, 2024",BOS vs. LAC,L,30,8,18,0.444,2,4,0.5,3,3,1.0,3,8,11,1,0,1,3,2,21,-32,1,BOS,BOS,LAC,96,35.5,Pts+Rebs,33,32,22,12
Jayson Tatum,F,22023,1628369,22300646,"JAN 27, 2024",BOS vs. LAC,L,30,8,18,0.444,2,4,0.5,3,3,1.0,3,8,11,1,0,1,3,2,21,-32,1,BOS,BOS,LAC,96,31.5,Pts+Asts,33,32,22,12
Jayson Tatum,F,22023,1628369,22300646,"JAN 27, 2024",BOS vs. LAC,L,30,8,18,0.444,2,4,0.5,3,3,1.0,3,8,11,1,0,1,3,2,21,-32,1,BOS,BOS,LAC,96,13.0,Rebs+Asts,33,32,22,12
Jayson Tatum,F,22023,1628369,22300646,"JAN 27, 2024",BOS vs. LAC,L,30,8,18,0.444,2,4,0.5,3,3,1.0,3,8,11,1,0,1,3,2,21,-32,1,BOS,BOS,LAC,96,1.5,Blks+Stls,33,32,22,12
Jayson Tatum,F,22023,1628369,22300630,"JAN 25, 2024",BOS @ MIA,W,32,7,15,0.467,3,7,0.429,9,10,0.9,1,7,8,4,0,0,1,1,26,22,1,BOS,MIA,BOS,143,26.5,Points,38,34,30,12
Jayson Tatum,F,22023,1628369,22300630,"JAN 25, 2024",BOS @ MIA,W,32,7,15,0.467,3,7,0.429,9,10,0.9,1,7,8,4,0,0,1,1,26,22,1,BOS,MIA,BOS,143,8.5,Rebounds,38,34,30,12
Jayson Tatum,F,22023,1628369,22300630,"JAN 25, 2024",BOS @ MIA,W,32,7,15,0.467,3,7,0.429,9,10,0.9,1,7,8,4,0,0,1,1,26,22,1,BOS,MIA,BOS,143,39.5,Pts+Rebs+Asts,38,34,30,12
Jayson Tatum,F,22023,1628369,22300630,"JAN 25, 2024",BOS @ MIA,W,32,7,15,0.467,3,7,0.429,9,10,0.9,1,7,8,4,0,0,1,1,26,22,1,BOS,MIA,BOS,143,4.5,Assists,38,34,30,12
Jayson Tatum,F,22023,1628369,22300630,"JAN 25, 2024",BOS @ MIA,W,32,7,15,0.467,3,7,0.429,9,10,0.9,1,7,8,4,0,0,1,1,26,22,1,BOS,MIA,BOS,143,45.5,Fantasy Score,38,34,30,12
Jayson Tatum,F,22023,1628369,22300630,"JAN 25, 2024",BOS @ MIA,W,32,7,15,0.467,3,7,0.429,9,10,0.9,1,7,8,4,0,0,1,1,26,22,1,BOS,MIA,BOS,143,7.0,Defensive Rebounds,38,34,30,12
Jayson Tatum,F,22023,1628369,22300630,"JAN 25, 2024",BOS @ MIA,W,32,7,15,0.467,3,7,0.429,9,10,0.9,1,7,8,4,0,0,1,1,26,22,1,BOS,MIA,BOS,143,9.0,3-PT Attempted,38,34,30,12
Jayson Tatum,F,22023,1628369,22300630,"JAN 25, 2024",BOS @ MIA,W,32,7,15,0.467,3,7,0.429,9,10,0.9,1,7,8,4,0,0,1,1,26,22,1,BOS,MIA,BOS,143,5.5,Free Throws Made,38,34,30,12
Jayson Tatum,F,22023,1628369,22300630,"JAN 25, 2024",BOS @ MIA,W,32,7,15,0.467,3,7,0.429,9,10,0.9,1,7,8,4,0,0,1,1,26,22,1,BOS,MIA,BOS,143,19.5,FG Attempted,38,34,30,12
Jayson Tatum,F,22023,1628369,22300630,"JAN 25, 2024",BOS @ MIA,W,32,7,15,0.467,3,7,0.429,9,10,0.9,1,7,8,4,0,0,1,1,26,22,1,BOS,MIA,BOS,143,35.5,Pts+Rebs,38,34,30,12
Jayson Tatum,F,22023,1628369,22300630,"JAN 25, 2024",BOS @ MIA,W,32,7,15,0.467,3,7,0.429,9,10,0.9,1,7,8,4,0,0,1,1,26,22,1,BOS,MIA,BOS,143,31.5,Pts+Asts,38,34,30,12
Jayson Tatum,F,22023,1628369,22300630,"JAN 25, 2024",BOS @ MIA,W,32,7,15,0.467,3,7,0.429,9,10,0.9,1,7,8,4,0,0,1,1,26,22,1,BOS,MIA,BOS,143,13.0,Rebs+Asts,38,34,30,12
Jayson Tatum,F,22023,1628369,22300630,"JAN 25, 2024",BOS @ MIA,W,32,7,15,0.467,3,7,0.429,9,10,0.9,1,7,8,4,0,0,1,1,26,22,1,BOS,MIA,BOS,143,1.5,Blks+Stls,38,34,30,12
Jayson Tatum,F,22023,1628369,22300571,"JAN 17, 2024",BOS vs. SAS,W,32,9,21,0.429,3,8,0.375,3,5,0.6,0,5,5,2,0,0,2,2,24,11,1,BOS,BOS,SAS,117,26.5,Points,31,29,26,7
Jayson Tatum,F,22023,1628369,22300571,"JAN 17, 2024",BOS vs. SAS,W,32,9,21,0.429,3,8,0.375,3,5,0.6,0,5,5,2,0,0,2,2,24,11,1,BOS,BOS,SAS,117,8.5,Rebounds,31,29,26,7
Jayson Tatum,F,22023,1628369,22300571,"JAN 17, 2024",BOS vs. SAS,W,32,9,21,0.429,3,8,0.375,3,5,0.6,0,5,5,2,0,0,2,2,24,11,1,BOS,BOS,SAS,117,39.5,Pts+Rebs+Asts,31,29,26,7
Jayson Tatum,F,22023,1628369,22300571,"JAN 17, 2024",BOS vs. SAS,W,32,9,21,0.429,3,8,0.375,3,5,0.6,0,5,5,2,0,0,2,2,24,11,1,BOS,BOS,SAS,117,4.5,Assists,31,29,26,7
Jayson Tatum,F,22023,1628369,22300571,"JAN 17, 2024",BOS vs. SAS,W,32,9,21,0.429,3,8,0.375,3,5,0.6,0,5,5,2,0,0,2,2,24,11,1,BOS,BOS,SAS,117,45.5,Fantasy Score,31,29,26,7
Jayson Tatum,F,22023,1628369,22300571,"JAN 17, 2024",BOS vs. SAS,W,32,9,21,0.429,3,8,0.375,3,5,0.6,0,5,5,2,0,0,2,2,24,11,1,BOS,BOS,SAS,117,7.0,Defensive Rebounds,31,29,26,7
Jayson Tatum,F,22023,1628369,22300571,"JAN 17, 2024",BOS vs. SAS,W,32,9,21,0.429,3,8,0.375,3,5,0.6,0,5,5,2,0,0,2,2,24,11,1,BOS,BOS,SAS,117,9.0,3-PT Attempted,31,29,26,7
Jayson Tatum,F,22023,1628369,22300571,"JAN 17, 2024",BOS vs. SAS,W,32,9,21,0.429,3,8,0.375,3,5,0.6,0,5,5,2,0,0,2,2,24,11,1,BOS,BOS,SAS,117,5.5,Free Throws Made,31,29,26,7
Jayson Tatum,F,22023,1628369,22300571,"JAN 17, 2024",BOS vs. SAS,W,32,9,21,0.429,3,8,0.375,3,5,0.6,0,5,5,2,0,0,2,2,24,11,1,BOS,BOS,SAS,117,19.5,FG Attempted,31,29,26,7
Jayson Tatum,F,22023,1628369,22300571,"JAN 17, 2024",BOS vs. SAS,W,32,9,21,0.429,3,8,0.375,3,5,0.6,0,5,5,2,0,0,2,2,24,11,1,BOS,BOS,SAS,117,35.5,Pts+Rebs,31,29,26,7
Jayson Tatum,F,22023,1628369,22300571,"JAN 17, 2024",BOS vs. SAS,W,32,9,21,0.429,3,8,0.375,3,5,0.6,0,5,5,2,0,0,2,2,24,11,1,BOS,BOS,SAS,117,31.5,Pts+Asts,31,29,26,7
Jayson Tatum,F,22023,1628369,22300571,"JAN 17, 2024",BOS vs. SAS,W,32,9,21,0.429,3,8,0.375,3,5,0.6,0,5,5,2,0,0,2,2,24,11,1,BOS,BOS,SAS,117,13.0,Rebs+Asts,31,29,26,7
Jayson Tatum,F,22023,1628369,22300571,"JAN 17, 2024",BOS vs. SAS,W,32,9,21,0.429,3,8,0.375,3,5,0.6,0,5,5,2,0,0,2,2,24,11,1,BOS,BOS,SAS,117,1.5,Blks+Stls,31,29,26,7
Jayson Tatum,F,22023,1628369,22300528,"JAN 11, 2024",BOS @ MIL,L,16,2,6,0.333,0,1,0.0,3,4,0.75,0,1,1,3,0,0,1,2,7,-31,1,BOS,MIL,BOS,102,26.5,Points,11,8,10,4
Jayson Tatum,F,22023,1628369,22300528,"JAN 11, 2024",BOS @ MIL,L,16,2,6,0.333,0,1,0.0,3,4,0.75,0,1,1,3,0,0,1,2,7,-31,1,BOS,MIL,BOS,102,8.5,Rebounds,11,8,10,4
Jayson Tatum,F,22023,1628369,22300528,"JAN 11, 2024",BOS @ MIL,L,16,2,6,0.333,0,1,0.0,3,4,0.75,0,1,1,3,0,0,1,2,7,-31,1,BOS,MIL,BOS,102,39.5,Pts+Rebs+Asts,11,8,10,4
Jayson Tatum,F,22023,1628369,22300528,"JAN 11, 2024",BOS @ MIL,L,16,2,6,0.333,0,1,0.0,3,4,0.75,0,1,1,3,0,0,1,2,7,-31,1,BOS,MIL,BOS,102,4.5,Assists,11,8,10,4
Jayson Tatum,F,22023,1628369,22300528,"JAN 11, 2024",BOS @ MIL,L,16,2,6,0.333,0,1,0.0,3,4,0.75,0,1,1,3,0,0,1,2,7,-31,1,BOS,MIL,BOS,102,45.5,Fantasy Score,11,8,10,4
Jayson Tatum,F,22023,1628369,22300528,"JAN 11, 2024",BOS @ MIL,L,16,2,6,0.333,0,1,0.0,3,4,0.75,0,1,1,3,0,0,1,2,7,-31,1,BOS,MIL,BOS,102,7.0,Defensive Rebounds,11,8,10,4
Jayson Tatum,F,22023,1628369,22300528,"JAN 11, 2024",BOS @ MIL,L,16,2,6,0.333,0,1,0.0,3,4,0.75,0,1,1,3,0,0,1,2,7,-31,1,BOS,MIL,BOS,102,9.0,3-PT Attempted,11,8,10,4
Jayson Tatum,F,22023,1628369,22300528,"JAN 11, 2024",BOS @ MIL,L,16,2,6,0.333,0,1,0.0,3,4,0.75,0,1,1,3,0,0,1,2,7,-31,1,BOS,MIL,BOS,102,5.5,Free Throws Made,11,8,10,4
Jayson Tatum,F,22023,1628369,22300528,"JAN 11, 2024",BOS @ MIL,L,16,2,6,0.333,0,1,0.0,3,4,0.75,0,1,1,3,0,0,1,2,7,-31,1,BOS,MIL,BOS,102,19.5,FG Attempted,11,8,10,4
Jayson Tatum,F,22023,1628369,22300528,"JAN 11, 2024",BOS @ MIL,L,16,2,6,0.333,0,1,0.0,3,4,0.75,0,1,1,3,0,0,1,2,7,-31,1,BOS,MIL,BOS,102,35.5,Pts+Rebs,11,8,10,4
Jayson Tatum,F,22023,1628369,22300528,"JAN 11, 2024",BOS @ MIL,L,16,2,6,0.333,0,1,0.0,3,4,0.75,0,1,1,3,0,0,1,2,7,-31,1,BOS,MIL,BOS,102,31.5,Pts+Asts,11,8,10,4
Jayson Tatum,F,22023,1628369,22300528,"JAN 11, 2024",BOS @ MIL,L,16,2,6,0.333,0,1,0.0,3,4,0.75,0,1,1,3,0,0,1,2,7,-31,1,BOS,MIL,BOS,102,13.0,Rebs+Asts,11,8,10,4
Jayson Tatum,F,22023,1628369,22300528,"JAN 11, 2024",BOS @ MIL,L,16,2,6,0.333,0,1,0.0,3,4,0.75,0,1,1,3,0,0,1,2,7,-31,1,BOS,MIL,BOS,102,1.5,Blks+Stls,11,8,10,4
Jayson Tatum,F,22023,1628369,22300493,"JAN 06, 2024",BOS @ IND,W,38,14,23,0.609,8,13,0.615,2,4,0.5,1,12,13,6,1,0,4,4,38,19,1,BOS,IND,BOS,118,26.5,Points,57,51,44,19
Jayson Tatum,F,22023,1628369,22300493,"JAN 06, 2024",BOS @ IND,W,38,14,23,0.609,8,13,0.615,2,4,0.5,1,12,13,6,1,0,4,4,38,19,1,BOS,IND,BOS,118,8.5,Rebounds,57,51,44,19
Jayson Tatum,F,22023,1628369,22300493,"JAN 06, 2024",BOS @ IND,W,38,14,23,0.609,8,13,0.615,2,4,0.5,1,12,13,6,1,0,4,4,38,19,1,BOS,IND,BOS,118,39.5,Pts+Rebs+Asts,57,51,44,19
Jayson Tatum,F,22023,1628369,22300493,"JAN 06, 2024",BOS @ IND,W,38,14,23,0.609,8,13,0.615,2,4,0.5,1,12,13,6,1,0,4,4,38,19,1,BOS,IND,BOS,118,4.5,Assists,57,51,44,19
Jayson Tatum,F,22023,1628369,22300493,"JAN 06, 2024",BOS @ IND,W,38,14,23,0.609,8,13,0.615,2,4,0.5,1,12,13,6,1,0,4,4,38,19,1,BOS,IND,BOS,118,45.5,Fantasy Score,57,51,44,19
Jayson Tatum,F,22023,1628369,22300493,"JAN 06, 2024",BOS @ IND,W,38,14,23,0.609,8,13,0.615,2,4,0.5,1,12,13,6,1,0,4,4,38,19,1,BOS,IND,BOS,118,7.0,Defensive Rebounds,57,51,44,19
Jayson Tatum,F,22023,1628369,22300493,"JAN 06, 2024",BOS @ IND,W,38,14,23,0.609,8,13,0.615,2,4,0.5,1,12,13,6,1,0,4,4,38,19,1,BOS,IND,BOS,118,9.0,3-PT Attempted,57,51,44,19
Jayson Tatum,F,22023,1628369,22300493,"JAN 06, 2024",BOS @ IND,W,38,14,23,0.609,8,13,0.615,2,4,0.5,1,12,13,6,1,0,4,4,38,19,1,BOS,IND,BOS,118,5.5,Free Throws Made,57,51,44,19
Jayson Tatum,F,22023,1628369,22300493,"JAN 06, 2024",BOS @ IND,W,38,14,23,0.609,8,13,0.615,2,4,0.5,1,12,13,6,1,0,4,4,38,19,1,BOS,IND,BOS,118,19.5,FG Attempted,57,51,44,19
Jayson Tatum,F,22023,1628369,22300493,"JAN 06, 2024",BOS @ IND,W,38,14,23,0.609,8,13,0.615,2,4,0.5,1,12,13,6,1,0,4,4,38,19,1,BOS,IND,BOS,118,35.5,Pts+Rebs,57,51,44,19
Jayson Tatum,F,22023,1628369,22300493,"JAN 06, 2024",BOS @ IND,W,38,14,23,0.609,8,13,0.615,2,4,0.5,1,12,13,6,1,0,4,4,38,19,1,BOS,IND,BOS,118,31.5,Pts+Asts,57,51,44,19
Jayson Tatum,F,22023,1628369,22300493,"JAN 06, 2024",BOS @ IND,W,38,14,23,0.609,8,13,0.615,2,4,0.5,1,12,13,6,1,0,4,4,38,19,1,BOS,IND,BOS,118,13.0,Rebs+Asts,57,51,44,19
Jayson Tatum,F,22023,1628369,22300493,"JAN 06, 2024",BOS @ IND,W,38,14,23,0.609,8,13,0.615,2,4,0.5,1,12,13,6,1,0,4,4,38,19,1,BOS,IND,BOS,118,1.5,Blks+Stls,57,51,44,19
Jayson Tatum,F,22023,1628369,22300479,"JAN 05, 2024",BOS vs. UTA,W,25,6,12,0.5,5,8,0.625,13,14,0.929,0,9,9,5,1,1,1,1,30,34,1,BOS,BOS,UTA,126,26.5,Points,44,39,35,14
Jayson Tatum,F,22023,1628369,22300479,"JAN 05, 2024",BOS vs. UTA,W,25,6,12,0.5,5,8,0.625,13,14,0.929,0,9,9,5,1,1,1,1,30,34,1,BOS,BOS,UTA,126,8.5,Rebounds,44,39,35,14
Jayson Tatum,F,22023,1628369,22300479,"JAN 05, 2024",BOS vs. UTA,W,25,6,12,0.5,5,8,0.625,13,14,0.929,0,9,9,5,1,1,1,1,30,34,1,BOS,BOS,UTA,126,39.5,Pts+Rebs+Asts,44,39,35,14
Jayson Tatum,F,22023,1628369,22300479,"JAN 05, 2024",BOS vs. UTA,W,25,6,12,0.5,5,8,0.625,13,14,0.929,0,9,9,5,1,1,1,1,30,34,1,BOS,BOS,UTA,126,4.5,Assists,44,39,35,14
Jayson Tatum,F,22023,1628369,22300479,"JAN 05, 2024",BOS vs. UTA,W,25,6,12,0.5,5,8,0.625,13,14,0.929,0,9,9,5,1,1,1,1,30,34,1,BOS,BOS,UTA,126,45.5,Fantasy Score,44,39,35,14
Jayson Tatum,F,22023,1628369,22300479,"JAN 05, 2024",BOS vs. UTA,W,25,6,12,0.5,5,8,0.625,13,14,0.929,0,9,9,5,1,1,1,1,30,34,1,BOS,BOS,UTA,126,7.0,Defensive Rebounds,44,39,35,14
Jayson Tatum,F,22023,1628369,22300479,"JAN 05, 2024",BOS vs. UTA,W,25,6,12,0.5,5,8,0.625,13,14,0.929,0,9,9,5,1,1,1,1,30,34,1,BOS,BOS,UTA,126,9.0,3-PT Attempted,44,39,35,14
Jayson Tatum,F,22023,1628369,22300479,"JAN 05, 2024",BOS vs. UTA,W,25,6,12,0.5,5,8,0.625,13,14,0.929,0,9,9,5,1,1,1,1,30,34,1,BOS,BOS,UTA,126,5.5,Free Throws Made,44,39,35,14
Jayson Tatum,F,22023,1628369,22300479,"JAN 05, 2024",BOS vs. UTA,W,25,6,12,0.5,5,8,0.625,13,14,0.929,0,9,9,5,1,1,1,1,30,34,1,BOS,BOS,UTA,126,19.5,FG Attempted,44,39,35,14
Jayson Tatum,F,22023,1628369,22300479,"JAN 05, 2024",BOS vs. UTA,W,25,6,12,0.5,5,8,0.625,13,14,0.929,0,9,9,5,1,1,1,1,30,34,1,BOS,BOS,UTA,126,35.5,Pts+Rebs,44,39,35,14
Jayson Tatum,F,22023,1628369,22300479,"JAN 05, 2024",BOS vs. UTA,W,25,6,12,0.5,5,8,0.625,13,14,0.929,0,9,9,5,1,1,1,1,30,34,1,BOS,BOS,UTA,126,31.5,Pts+Asts,44,39,35,14
Jayson Tatum,F,22023,1628369,22300479,"JAN 05, 2024",BOS vs. UTA,W,25,6,12,0.5,5,8,0.625,13,14,0.929,0,9,9,5,1,1,1,1,30,34,1,BOS,BOS,UTA,126,13.0,Rebs+Asts,44,39,35,14
Jayson Tatum,F,22023,1628369,22300479,"JAN 05, 2024",BOS vs. UTA,W,25,6,12,0.5,5,8,0.625,13,14,0.929,0,9,9,5,1,1,1,1,30,34,1,BOS,BOS,UTA,126,1.5,Blks+Stls,44,39,35,14
Jayson Tatum,F,22023,1628369,22300448,"DEC 31, 2023",BOS @ SAS,W,31,10,17,0.588,5,10,0.5,0,0,0.0,1,5,6,2,0,2,3,1,25,32,1,BOS,SAS,BOS,134,26.5,Points,33,31,27,8
Jayson Tatum,F,22023,1628369,22300448,"DEC 31, 2023",BOS @ SAS,W,31,10,17,0.588,5,10,0.5,0,0,0.0,1,5,6,2,0,2,3,1,25,32,1,BOS,SAS,BOS,134,8.5,Rebounds,33,31,27,8
Jayson Tatum,F,22023,1628369,22300448,"DEC 31, 2023",BOS @ SAS,W,31,10,17,0.588,5,10,0.5,0,0,0.0,1,5,6,2,0,2,3,1,25,32,1,BOS,SAS,BOS,134,39.5,Pts+Rebs+Asts,33,31,27,8
Jayson Tatum,F,22023,1628369,22300448,"DEC 31, 2023",BOS @ SAS,W,31,10,17,0.588,5,10,0.5,0,0,0.0,1,5,6,2,0,2,3,1,25,32,1,BOS,SAS,BOS,134,4.5,Assists,33,31,27,8
Jayson Tatum,F,22023,1628369,22300448,"DEC 31, 2023",BOS @ SAS,W,31,10,17,0.588,5,10,0.5,0,0,0.0,1,5,6,2,0,2,3,1,25,32,1,BOS,SAS,BOS,134,45.5,Fantasy Score,33,31,27,8
Jayson Tatum,F,22023,1628369,22300448,"DEC 31, 2023",BOS @ SAS,W,31,10,17,0.588,5,10,0.5,0,0,0.0,1,5,6,2,0,2,3,1,25,32,1,BOS,SAS,BOS,134,7.0,Defensive Rebounds,33,31,27,8
Jayson Tatum,F,22023,1628369,22300448,"DEC 31, 2023",BOS @ SAS,W,31,10,17,0.588,5,10,0.5,0,0,0.0,1,5,6,2,0,2,3,1,25,32,1,BOS,SAS,BOS,134,9.0,3-PT Attempted,33,31,27,8
Jayson Tatum,F,22023,1628369,22300448,"DEC 31, 2023",BOS @ SAS,W,31,10,17,0.588,5,10,0.5,0,0,0.0,1,5,6,2,0,2,3,1,25,32,1,BOS,SAS,BOS,134,5.5,Free Throws Made,33,31,27,8
Jayson Tatum,F,22023,1628369,22300448,"DEC 31, 2023",BOS @ SAS,W,31,10,17,0.588,5,10,0.5,0,0,0.0,1,5,6,2,0,2,3,1,25,32,1,BOS,SAS,BOS,134,19.5,FG Attempted,33,31,27,8
Jayson Tatum,F,22023,1628369,22300448,"DEC 31, 2023",BOS @ SAS,W,31,10,17,0.588,5,10,0.5,0,0,0.0,1,5,6,2,0,2,3,1,25,32,1,BOS,SAS,BOS,134,35.5,Pts+Rebs,33,31,27,8
Jayson Tatum,F,22023,1628369,22300448,"DEC 31, 2023",BOS @ SAS,W,31,10,17,0.588,5,10,0.5,0,0,0.0,1,5,6,2,0,2,3,1,25,32,1,BOS,SAS,BOS,134,31.5,Pts+Asts,33,31,27,8
Jayson Tatum,F,22023,1628369,22300448,"DEC 31, 2023",BOS @ SAS,W,31,10,17,0.588,5,10,0.5,0,0,0.0,1,5,6,2,0,2,3,1,25,32,1,BOS,SAS,BOS,134,13.0,Rebs+Asts,33,31,27,8
Jayson Tatum,F,22023,1628369,22300448,"DEC 31, 2023",BOS @ SAS,W,31,10,17,0.588,5,10,0.5,0,0,0.0,1,5,6,2,0,2,3,1,25,32,1,BOS,SAS,BOS,134,1.5,Blks+Stls,33,31,27,8
Jayson Tatum,F,22023,1628369,22300389,"DEC 23, 2023",BOS @ LAC,W,30,9,16,0.563,5,10,0.5,7,9,0.778,0,4,4,2,1,0,2,0,30,19,1,BOS,LAC,BOS,142,26.5,Points,36,34,32,6
Jayson Tatum,F,22023,1628369,22300389,"DEC 23, 2023",BOS @ LAC,W,30,9,16,0.563,5,10,0.5,7,9,0.778,0,4,4,2,1,0,2,0,30,19,1,BOS,LAC,BOS,142,8.5,Rebounds,36,34,32,6
Jayson Tatum,F,22023,1628369,22300389,"DEC 23, 2023",BOS @ LAC,W,30,9,16,0.563,5,10,0.5,7,9,0.778,0,4,4,2,1,0,2,0,30,19,1,BOS,LAC,BOS,142,39.5,Pts+Rebs+Asts,36,34,32,6
Jayson Tatum,F,22023,1628369,22300389,"DEC 23, 2023",BOS @ LAC,W,30,9,16,0.563,5,10,0.5,7,9,0.778,0,4,4,2,1,0,2,0,30,19,1,BOS,LAC,BOS,142,4.5,Assists,36,34,32,6
Jayson Tatum,F,22023,1628369,22300389,"DEC 23, 2023",BOS @ LAC,W,30,9,16,0.563,5,10,0.5,7,9,0.778,0,4,4,2,1,0,2,0,30,19,1,BOS,LAC,BOS,142,45.5,Fantasy Score,36,34,32,6
Jayson Tatum,F,22023,1628369,22300389,"DEC 23, 2023",BOS @ LAC,W,30,9,16,0.563,5,10,0.5,7,9,0.778,0,4,4,2,1,0,2,0,30,19,1,BOS,LAC,BOS,142,7.0,Defensive Rebounds,36,34,32,6
Jayson Tatum,F,22023,1628369,22300389,"DEC 23, 2023",BOS @ LAC,W,30,9,16,0.563,5,10,0.5,7,9,0.778,0,4,4,2,1,0,2,0,30,19,1,BOS,LAC,BOS,142,9.0,3-PT Attempted,36,34,32,6
Jayson Tatum,F,22023,1628369,22300389,"DEC 23, 2023",BOS @ LAC,W,30,9,16,0.563,5,10,0.5,7,9,0.778,0,4,4,2,1,0,2,0,30,19,1,BOS,LAC,BOS,142,5.5,Free Throws Made,36,34,32,6
Jayson Tatum,F,22023,1628369,22300389,"DEC 23, 2023",BOS @ LAC,W,30,9,16,0.563,5,10,0.5,7,9,0.778,0,4,4,2,1,0,2,0,30,19,1,BOS,LAC,BOS,142,19.5,FG Attempted,36,34,32,6
Jayson Tatum,F,22023,1628369,22300389,"DEC 23, 2023",BOS @ LAC,W,30,9,16,0.563,5,10,0.5,7,9,0.778,0,4,4,2,1,0,2,0,30,19,1,BOS,LAC,BOS,142,35.5,Pts+Rebs,36,34,32,6
Jayson Tatum,F,22023,1628369,22300389,"DEC 23, 2023",BOS @ LAC,W,30,9,16,0.563,5,10,0.5,7,9,0.778,0,4,4,2,1,0,2,0,30,19,1,BOS,LAC,BOS,142,31.5,Pts+Asts,36,34,32,6
Jayson Tatum,F,22023,1628369,22300389,"DEC 23, 2023",BOS @ LAC,W,30,9,16,0.563,5,10,0.5,7,9,0.778,0,4,4,2,1,0,2,0,30,19,1,BOS,LAC,BOS,142,13.0,Rebs+Asts,36,34,32,6
Jayson Tatum,F,22023,1628369,22300389,"DEC 23, 2023",BOS @ LAC,W,30,9,16,0.563,5,10,0.5,7,9,0.778,0,4,4,2,1,0,2,0,30,19,1,BOS,LAC,BOS,142,1.5,Blks+Stls,36,34,32,6
Jayson Tatum,F,22023,1628369,22300344,"DEC 17, 2023",BOS vs. ORL,W,31,8,21,0.381,4,6,0.667,3,4,0.75,3,5,8,3,0,1,1,3,23,9,1,BOS,BOS,ORL,114,26.5,Points,34,31,26,11
Jayson Tatum,F,22023,1628369,22300344,"DEC 17, 2023",BOS vs. ORL,W,31,8,21,0.381,4,6,0.667,3,4,0.75,3,5,8,3,0,1,1,3,23,9,1,BOS,BOS,ORL,114,8.5,Rebounds,34,31,26,11
Jayson Tatum,F,22023,1628369,22300344,"DEC 17, 2023",BOS vs. ORL,W,31,8,21,0.381,4,6,0.667,3,4,0.75,3,5,8,3,0,1,1,3,23,9,1,BOS,BOS,ORL,114,39.5,Pts+Rebs+Asts,34,31,26,11
Jayson Tatum,F,22023,1628369,22300344,"DEC 17, 2023",BOS vs. ORL,W,31,8,21,0.381,4,6,0.667,3,4,0.75,3,5,8,3,0,1,1,3,23,9,1,BOS,BOS,ORL,114,4.5,Assists,34,31,26,11
Jayson Tatum,F,22023,1628369,22300344,"DEC 17, 2023",BOS vs. ORL,W,31,8,21,0.381,4,6,0.667,3,4,0.75,3,5,8,3,0,1,1,3,23,9,1,BOS,BOS,ORL,114,45.5,Fantasy Score,34,31,26,11
Jayson Tatum,F,22023,1628369,22300344,"DEC 17, 2023",BOS vs. ORL,W,31,8,21,0.381,4,6,0.667,3,4,0.75,3,5,8,3,0,1,1,3,23,9,1,BOS,BOS,ORL,114,7.0,Defensive Rebounds,34,31,26,11
Jayson Tatum,F,22023,1628369,22300344,"DEC 17, 2023",BOS vs. ORL,W,31,8,21,0.381,4,6,0.667,3,4,0.75,3,5,8,3,0,1,1,3,23,9,1,BOS,BOS,ORL,114,9.0,3-PT Attempted,34,31,26,11
Jayson Tatum,F,22023,1628369,22300344,"DEC 17, 2023",BOS vs. ORL,W,31,8,21,0.381,4,6,0.667,3,4,0.75,3,5,8,3,0,1,1,3,23,9,1,BOS,BOS,ORL,114,5.5,Free Throws Made,34,31,26,11
Jayson Tatum,F,22023,1628369,22300344,"DEC 17, 2023",BOS vs. ORL,W,31,8,21,0.381,4,6,0.667,3,4,0.75,3,5,8,3,0,1,1,3,23,9,1,BOS,BOS,ORL,114,19.5,FG Attempted,34,31,26,11
Jayson Tatum,F,22023,1628369,22300344,"DEC 17, 2023",BOS vs. ORL,W,31,8,21,0.381,4,6,0.667,3,4,0.75,3,5,8,3,0,1,1,3,23,9,1,BOS,BOS,ORL,114,35.5,Pts+Rebs,34,31,26,11
Jayson Tatum,F,22023,1628369,22300344,"DEC 17, 2023",BOS vs. ORL,W,31,8,21,0.381,4,6,0.667,3,4,0.75,3,5,8,3,0,1,1,3,23,9,1,BOS,BOS,ORL,114,31.5,Pts+Asts,34,31,26,11
Jayson Tatum,F,22023,1628369,22300344,"DEC 17, 2023",BOS vs. ORL,W,31,8,21,0.381,4,6,0.667,3,4,0.75,3,5,8,3,0,1,1,3,23,9,1,BOS,BOS,ORL,114,13.0,Rebs+Asts,34,31,26,11
Jayson Tatum,F,22023,1628369,22300344,"DEC 17, 2023",BOS vs. ORL,W,31,8,21,0.381,4,6,0.667,3,4,0.75,3,5,8,3,0,1,1,3,23,9,1,BOS,BOS,ORL,114,1.5,Blks+Stls,34,31,26,11
Jayson Tatum,F,22023,1628369,22301227,"DEC 08, 2023",BOS vs. NYK,W,39,8,18,0.444,3,9,0.333,6,8,0.75,0,6,6,5,1,0,0,3,25,17,1,BOS,BOS,NYK,133,26.5,Points,36,31,30,11
Jayson Tatum,F,22023,1628369,22301227,"DEC 08, 2023",BOS vs. NYK,W,39,8,18,0.444,3,9,0.333,6,8,0.75,0,6,6,5,1,0,0,3,25,17,1,BOS,BOS,NYK,133,8.5,Rebounds,36,31,30,11
Jayson Tatum,F,22023,1628369,22301227,"DEC 08, 2023",BOS vs. NYK,W,39,8,18,0.444,3,9,0.333,6,8,0.75,0,6,6,5,1,0,0,3,25,17,1,BOS,BOS,NYK,133,39.5,Pts+Rebs+Asts,36,31,30,11
Jayson Tatum,F,22023,1628369,22301227,"DEC 08, 2023",BOS vs. NYK,W,39,8,18,0.444,3,9,0.333,6,8,0.75,0,6,6,5,1,0,0,3,25,17,1,BOS,BOS,NYK,133,4.5,Assists,36,31,30,11
Jayson Tatum,F,22023,1628369,22301227,"DEC 08, 2023",BOS vs. NYK,W,39,8,18,0.444,3,9,0.333,6,8,0.75,0,6,6,5,1,0,0,3,25,17,1,BOS,BOS,NYK,133,45.5,Fantasy Score,36,31,30,11
Jayson Tatum,F,22023,1628369,22301227,"DEC 08, 2023",BOS vs. NYK,W,39,8,18,0.444,3,9,0.333,6,8,0.75,0,6,6,5,1,0,0,3,25,17,1,BOS,BOS,NYK,133,7.0,Defensive Rebounds,36,31,30,11
Jayson Tatum,F,22023,1628369,22301227,"DEC 08, 2023",BOS vs. NYK,W,39,8,18,0.444,3,9,0.333,6,8,0.75,0,6,6,5,1,0,0,3,25,17,1,BOS,BOS,NYK,133,9.0,3-PT Attempted,36,31,30,11
Jayson Tatum,F,22023,1628369,22301227,"DEC 08, 2023",BOS vs. NYK,W,39,8,18,0.444,3,9,0.333,6,8,0.75,0,6,6,5,1,0,0,3,25,17,1,BOS,BOS,NYK,133,5.5,Free Throws Made,36,31,30,11
Jayson Tatum,F,22023,1628369,22301227,"DEC 08, 2023",BOS vs. NYK,W,39,8,18,0.444,3,9,0.333,6,8,0.75,0,6,6,5,1,0,0,3,25,17,1,BOS,BOS,NYK,133,19.5,FG Attempted,36,31,30,11
Jayson Tatum,F,22023,1628369,22301227,"DEC 08, 2023",BOS vs. NYK,W,39,8,18,0.444,3,9,0.333,6,8,0.75,0,6,6,5,1,0,0,3,25,17,1,BOS,BOS,NYK,133,35.5,Pts+Rebs,36,31,30,11
Jayson Tatum,F,22023,1628369,22301227,"DEC 08, 2023",BOS vs. NYK,W,39,8,18,0.444,3,9,0.333,6,8,0.75,0,6,6,5,1,0,0,3,25,17,1,BOS,BOS,NYK,133,31.5,Pts+Asts,36,31,30,11
Jayson Tatum,F,22023,1628369,22301227,"DEC 08, 2023",BOS vs. NYK,W,39,8,18,0.444,3,9,0.333,6,8,0.75,0,6,6,5,1,0,0,3,25,17,1,BOS,BOS,NYK,133,13.0,Rebs+Asts,36,31,30,11
Jayson Tatum,F,22023,1628369,22301227,"DEC 08, 2023",BOS vs. NYK,W,39,8,18,0.444,3,9,0.333,6,8,0.75,0,6,6,5,1,0,0,3,25,17,1,BOS,BOS,NYK,133,1.5,Blks+Stls,36,31,30,11
Jayson Tatum,F,22023,1628369,22301202,"DEC 04, 2023",BOS @ IND,L,37,13,26,0.5,2,8,0.25,4,7,0.571,1,11,12,6,1,0,2,2,32,-14,1,BOS,IND,BOS,112,26.5,Points,50,44,38,18
Jayson Tatum,F,22023,1628369,22301202,"DEC 04, 2023",BOS @ IND,L,37,13,26,0.5,2,8,0.25,4,7,0.571,1,11,12,6,1,0,2,2,32,-14,1,BOS,IND,BOS,112,8.5,Rebounds,50,44,38,18
Jayson Tatum,F,22023,1628369,22301202,"DEC 04, 2023",BOS @ IND,L,37,13,26,0.5,2,8,0.25,4,7,0.571,1,11,12,6,1,0,2,2,32,-14,1,BOS,IND,BOS,112,39.5,Pts+Rebs+Asts,50,44,38,18
Jayson Tatum,F,22023,1628369,22301202,"DEC 04, 2023",BOS @ IND,L,37,13,26,0.5,2,8,0.25,4,7,0.571,1,11,12,6,1,0,2,2,32,-14,1,BOS,IND,BOS,112,4.5,Assists,50,44,38,18
Jayson Tatum,F,22023,1628369,22301202,"DEC 04, 2023",BOS @ IND,L,37,13,26,0.5,2,8,0.25,4,7,0.571,1,11,12,6,1,0,2,2,32,-14,1,BOS,IND,BOS,112,45.5,Fantasy Score,50,44,38,18
Jayson Tatum,F,22023,1628369,22301202,"DEC 04, 2023",BOS @ IND,L,37,13,26,0.5,2,8,0.25,4,7,0.571,1,11,12,6,1,0,2,2,32,-14,1,BOS,IND,BOS,112,7.0,Defensive Rebounds,50,44,38,18
Jayson Tatum,F,22023,1628369,22301202,"DEC 04, 2023",BOS @ IND,L,37,13,26,0.5,2,8,0.25,4,7,0.571,1,11,12,6,1,0,2,2,32,-14,1,BOS,IND,BOS,112,9.0,3-PT Attempted,50,44,38,18
Jayson Tatum,F,22023,1628369,22301202,"DEC 04, 2023",BOS @ IND,L,37,13,26,0.5,2,8,0.25,4,7,0.571,1,11,12,6,1,0,2,2,32,-14,1,BOS,IND,BOS,112,5.5,Free Throws Made,50,44,38,18
Jayson Tatum,F,22023,1628369,22301202,"DEC 04, 2023",BOS @ IND,L,37,13,26,0.5,2,8,0.25,4,7,0.571,1,11,12,6,1,0,2,2,32,-14,1,BOS,IND,BOS,112,19.5,FG Attempted,50,44,38,18
Jayson Tatum,F,22023,1628369,22301202,"DEC 04, 2023",BOS @ IND,L,37,13,26,0.5,2,8,0.25,4,7,0.571,1,11,12,6,1,0,2,2,32,-14,1,BOS,IND,BOS,112,35.5,Pts+Rebs,50,44,38,18
Jayson Tatum,F,22023,1628369,22301202,"DEC 04, 2023",BOS @ IND,L,37,13,26,0.5,2,8,0.25,4,7,0.571,1,11,12,6,1,0,2,2,32,-14,1,BOS,IND,BOS,112,31.5,Pts+Asts,50,44,38,18
Jayson Tatum,F,22023,1628369,22301202,"DEC 04, 2023",BOS @ IND,L,37,13,26,0.5,2,8,0.25,4,7,0.571,1,11,12,6,1,0,2,2,32,-14,1,BOS,IND,BOS,112,13.0,Rebs+Asts,50,44,38,18
Jayson Tatum,F,22023,1628369,22301202,"DEC 04, 2023",BOS @ IND,L,37,13,26,0.5,2,8,0.25,4,7,0.571,1,11,12,6,1,0,2,2,32,-14,1,BOS,IND,BOS,112,1.5,Blks+Stls,50,44,38,18
Jayson Tatum,F,22023,1628369,22300275,"DEC 01, 2023",BOS vs. PHI,W,27,6,9,0.667,2,5,0.4,7,9,0.778,0,7,7,4,1,1,7,1,21,-7,1,BOS,BOS,PHI,125,26.5,Points,32,28,25,11
Jayson Tatum,F,22023,1628369,22300275,"DEC 01, 2023",BOS vs. PHI,W,27,6,9,0.667,2,5,0.4,7,9,0.778,0,7,7,4,1,1,7,1,21,-7,1,BOS,BOS,PHI,125,8.5,Rebounds,32,28,25,11
Jayson Tatum,F,22023,1628369,22300275,"DEC 01, 2023",BOS vs. PHI,W,27,6,9,0.667,2,5,0.4,7,9,0.778,0,7,7,4,1,1,7,1,21,-7,1,BOS,BOS,PHI,125,39.5,Pts+Rebs+Asts,32,28,25,11
Jayson Tatum,F,22023,1628369,22300275,"DEC 01, 2023",BOS vs. PHI,W,27,6,9,0.667,2,5,0.4,7,9,0.778,0,7,7,4,1,1,7,1,21,-7,1,BOS,BOS,PHI,125,4.5,Assists,32,28,25,11
Jayson Tatum,F,22023,1628369,22300275,"DEC 01, 2023",BOS vs. PHI,W,27,6,9,0.667,2,5,0.4,7,9,0.778,0,7,7,4,1,1,7,1,21,-7,1,BOS,BOS,PHI,125,45.5,Fantasy Score,32,28,25,11
Jayson Tatum,F,22023,1628369,22300275,"DEC 01, 2023",BOS vs. PHI,W,27,6,9,0.667,2,5,0.4,7,9,0.778,0,7,7,4,1,1,7,1,21,-7,1,BOS,BOS,PHI,125,7.0,Defensive Rebounds,32,28,25,11
Jayson Tatum,F,22023,1628369,22300275,"DEC 01, 2023",BOS vs. PHI,W,27,6,9,0.667,2,5,0.4,7,9,0.778,0,7,7,4,1,1,7,1,21,-7,1,BOS,BOS,PHI,125,9.0,3-PT Attempted,32,28,25,11
Jayson Tatum,F,22023,1628369,22300275,"DEC 01, 2023",BOS vs. PHI,W,27,6,9,0.667,2,5,0.4,7,9,0.778,0,7,7,4,1,1,7,1,21,-7,1,BOS,BOS,PHI,125,5.5,Free Throws Made,32,28,25,11
Jayson Tatum,F,22023,1628369,22300275,"DEC 01, 2023",BOS vs. PHI,W,27,6,9,0.667,2,5,0.4,7,9,0.778,0,7,7,4,1,1,7,1,21,-7,1,BOS,BOS,PHI,125,19.5,FG Attempted,32,28,25,11
Jayson Tatum,F,22023,1628369,22300275,"DEC 01, 2023",BOS vs. PHI,W,27,6,9,0.667,2,5,0.4,7,9,0.778,0,7,7,4,1,1,7,1,21,-7,1,BOS,BOS,PHI,125,35.5,Pts+Rebs,32,28,25,11
Jayson Tatum,F,22023,1628369,22300275,"DEC 01, 2023",BOS vs. PHI,W,27,6,9,0.667,2,5,0.4,7,9,0.778,0,7,7,4,1,1,7,1,21,-7,1,BOS,BOS,PHI,125,31.5,Pts+Asts,32,28,25,11
Jayson Tatum,F,22023,1628369,22300275,"DEC 01, 2023",BOS vs. PHI,W,27,6,9,0.667,2,5,0.4,7,9,0.778,0,7,7,4,1,1,7,1,21,-7,1,BOS,BOS,PHI,125,13.0,Rebs+Asts,32,28,25,11
Jayson Tatum,F,22023,1628369,22300275,"DEC 01, 2023",BOS vs. PHI,W,27,6,9,0.667,2,5,0.4,7,9,0.778,0,7,7,4,1,1,7,1,21,-7,1,BOS,BOS,PHI,125,1.5,Blks+Stls,32,28,25,11
Jayson Tatum,F,22023,1628369,22300053,"NOV 28, 2023",BOS vs. CHI,W,36,8,16,0.5,2,8,0.25,3,3,1.0,1,6,7,4,0,0,4,2,21,18,1,BOS,BOS,CHI,124,26.5,Points,32,28,25,11
Jayson Tatum,F,22023,1628369,22300053,"NOV 28, 2023",BOS vs. CHI,W,36,8,16,0.5,2,8,0.25,3,3,1.0,1,6,7,4,0,0,4,2,21,18,1,BOS,BOS,CHI,124,8.5,Rebounds,32,28,25,11
Jayson Tatum,F,22023,1628369,22300053,"NOV 28, 2023",BOS vs. CHI,W,36,8,16,0.5,2,8,0.25,3,3,1.0,1,6,7,4,0,0,4,2,21,18,1,BOS,BOS,CHI,124,39.5,Pts+Rebs+Asts,32,28,25,11
Jayson Tatum,F,22023,1628369,22300053,"NOV 28, 2023",BOS vs. CHI,W,36,8,16,0.5,2,8,0.25,3,3,1.0,1,6,7,4,0,0,4,2,21,18,1,BOS,BOS,CHI,124,4.5,Assists,32,28,25,11
Jayson Tatum,F,22023,1628369,22300053,"NOV 28, 2023",BOS vs. CHI,W,36,8,16,0.5,2,8,0.25,3,3,1.0,1,6,7,4,0,0,4,2,21,18,1,BOS,BOS,CHI,124,45.5,Fantasy Score,32,28,25,11
Jayson Tatum,F,22023,1628369,22300053,"NOV 28, 2023",BOS vs. CHI,W,36,8,16,0.5,2,8,0.25,3,3,1.0,1,6,7,4,0,0,4,2,21,18,1,BOS,BOS,CHI,124,7.0,Defensive Rebounds,32,28,25,11
Jayson Tatum,F,22023,1628369,22300053,"NOV 28, 2023",BOS vs. CHI,W,36,8,16,0.5,2,8,0.25,3,3,1.0,1,6,7,4,0,0,4,2,21,18,1,BOS,BOS,CHI,124,9.0,3-PT Attempted,32,28,25,11
Jayson Tatum,F,22023,1628369,22300053,"NOV 28, 2023",BOS vs. CHI,W,36,8,16,0.5,2,8,0.25,3,3,1.0,1,6,7,4,0,0,4,2,21,18,1,BOS,BOS,CHI,124,5.5,Free Throws Made,32,28,25,11
Jayson Tatum,F,22023,1628369,22300053,"NOV 28, 2023",BOS vs. CHI,W,36,8,16,0.5,2,8,0.25,3,3,1.0,1,6,7,4,0,0,4,2,21,18,1,BOS,BOS,CHI,124,19.5,FG Attempted,32,28,25,11
Jayson Tatum,F,22023,1628369,22300053,"NOV 28, 2023",BOS vs. CHI,W,36,8,16,0.5,2,8,0.25,3,3,1.0,1,6,7,4,0,0,4,2,21,18,1,BOS,BOS,CHI,124,35.5,Pts+Rebs,32,28,25,11
Jayson Tatum,F,22023,1628369,22300053,"NOV 28, 2023",BOS vs. CHI,W,36,8,16,0.5,2,8,0.25,3,3,1.0,1,6,7,4,0,0,4,2,21,18,1,BOS,BOS,CHI,124,31.5,Pts+Asts,32,28,25,11
Jayson Tatum,F,22023,1628369,22300053,"NOV 28, 2023",BOS vs. CHI,W,36,8,16,0.5,2,8,0.25,3,3,1.0,1,6,7,4,0,0,4,2,21,18,1,BOS,BOS,CHI,124,13.0,Rebs+Asts,32,28,25,11
Jayson Tatum,F,22023,1628369,22300053,"NOV 28, 2023",BOS vs. CHI,W,36,8,16,0.5,2,8,0.25,3,3,1.0,1,6,7,4,0,0,4,2,21,18,1,BOS,BOS,CHI,124,1.5,Blks+Stls,32,28,25,11
Jayson Tatum,F,22023,1628369,22300246,"NOV 26, 2023",BOS vs. ATL,W,39,11,25,0.44,5,13,0.385,7,10,0.7,1,8,9,4,2,0,6,2,34,3,1,BOS,BOS,ATL,113,26.5,Points,47,43,38,13
Jayson Tatum,F,22023,1628369,22300246,"NOV 26, 2023",BOS vs. ATL,W,39,11,25,0.44,5,13,0.385,7,10,0.7,1,8,9,4,2,0,6,2,34,3,1,BOS,BOS,ATL,113,8.5,Rebounds,47,43,38,13
Jayson Tatum,F,22023,1628369,22300246,"NOV 26, 2023",BOS vs. ATL,W,39,11,25,0.44,5,13,0.385,7,10,0.7,1,8,9,4,2,0,6,2,34,3,1,BOS,BOS,ATL,113,39.5,Pts+Rebs+Asts,47,43,38,13
Jayson Tatum,F,22023,1628369,22300246,"NOV 26, 2023",BOS vs. ATL,W,39,11,25,0.44,5,13,0.385,7,10,0.7,1,8,9,4,2,0,6,2,34,3,1,BOS,BOS,ATL,113,4.5,Assists,47,43,38,13
Jayson Tatum,F,22023,1628369,22300246,"NOV 26, 2023",BOS vs. ATL,W,39,11,25,0.44,5,13,0.385,7,10,0.7,1,8,9,4,2,0,6,2,34,3,1,BOS,BOS,ATL,113,45.5,Fantasy Score,47,43,38,13
Jayson Tatum,F,22023,1628369,22300246,"NOV 26, 2023",BOS vs. ATL,W,39,11,25,0.44,5,13,0.385,7,10,0.7,1,8,9,4,2,0,6,2,34,3,1,BOS,BOS,ATL,113,7.0,Defensive Rebounds,47,43,38,13
Jayson Tatum,F,22023,1628369,22300246,"NOV 26, 2023",BOS vs. ATL,W,39,11,25,0.44,5,13,0.385,7,10,0.7,1,8,9,4,2,0,6,2,34,3,1,BOS,BOS,ATL,113,9.0,3-PT Attempted,47,43,38,13
Jayson Tatum,F,22023,1628369,22300246,"NOV 26, 2023",BOS vs. ATL,W,39,11,25,0.44,5,13,0.385,7,10,0.7,1,8,9,4,2,0,6,2,34,3,1,BOS,BOS,ATL,113,5.5,Free Throws Made,47,43,38,13
Jayson Tatum,F,22023,1628369,22300246,"NOV 26, 2023",BOS vs. ATL,W,39,11,25,0.44,5,13,0.385,7,10,0.7,1,8,9,4,2,0,6,2,34,3,1,BOS,BOS,ATL,113,19.5,FG Attempted,47,43,38,13
Jayson Tatum,F,22023,1628369,22300246,"NOV 26, 2023",BOS vs. ATL,W,39,11,25,0.44,5,13,0.385,7,10,0.7,1,8,9,4,2,0,6,2,34,3,1,BOS,BOS,ATL,113,35.5,Pts+Rebs,47,43,38,13
Jayson Tatum,F,22023,1628369,22300246,"NOV 26, 2023",BOS vs. ATL,W,39,11,25,0.44,5,13,0.385,7,10,0.7,1,8,9,4,2,0,6,2,34,3,1,BOS,BOS,ATL,113,31.5,Pts+Asts,47,43,38,13
Jayson Tatum,F,22023,1628369,22300246,"NOV 26, 2023",BOS vs. ATL,W,39,11,25,0.44,5,13,0.385,7,10,0.7,1,8,9,4,2,0,6,2,34,3,1,BOS,BOS,ATL,113,13.0,Rebs+Asts,47,43,38,13
Jayson Tatum,F,22023,1628369,22300246,"NOV 26, 2023",BOS vs. ATL,W,39,11,25,0.44,5,13,0.385,7,10,0.7,1,8,9,4,2,0,6,2,34,3,1,BOS,BOS,ATL,113,1.5,Blks+Stls,47,43,38,13
Jayson Tatum,F,22023,1628369,22300043,"NOV 24, 2023",BOS @ ORL,L,39,7,16,0.438,0,3,0.0,12,13,0.923,0,5,5,3,2,0,2,3,26,-21,1,BOS,ORL,BOS,96,26.5,Points,34,31,29,8
Jayson Tatum,F,22023,1628369,22300043,"NOV 24, 2023",BOS @ ORL,L,39,7,16,0.438,0,3,0.0,12,13,0.923,0,5,5,3,2,0,2,3,26,-21,1,BOS,ORL,BOS,96,8.5,Rebounds,34,31,29,8
Jayson Tatum,F,22023,1628369,22300043,"NOV 24, 2023",BOS @ ORL,L,39,7,16,0.438,0,3,0.0,12,13,0.923,0,5,5,3,2,0,2,3,26,-21,1,BOS,ORL,BOS,96,39.5,Pts+Rebs+Asts,34,31,29,8
Jayson Tatum,F,22023,1628369,22300043,"NOV 24, 2023",BOS @ ORL,L,39,7,16,0.438,0,3,0.0,12,13,0.923,0,5,5,3,2,0,2,3,26,-21,1,BOS,ORL,BOS,96,4.5,Assists,34,31,29,8
Jayson Tatum,F,22023,1628369,22300043,"NOV 24, 2023",BOS @ ORL,L,39,7,16,0.438,0,3,0.0,12,13,0.923,0,5,5,3,2,0,2,3,26,-21,1,BOS,ORL,BOS,96,45.5,Fantasy Score,34,31,29,8
Jayson Tatum,F,22023,1628369,22300043,"NOV 24, 2023",BOS @ ORL,L,39,7,16,0.438,0,3,0.0,12,13,0.923,0,5,5,3,2,0,2,3,26,-21,1,BOS,ORL,BOS,96,7.0,Defensive Rebounds,34,31,29,8
Jayson Tatum,F,22023,1628369,22300043,"NOV 24, 2023",BOS @ ORL,L,39,7,16,0.438,0,3,0.0,12,13,0.923,0,5,5,3,2,0,2,3,26,-21,1,BOS,ORL,BOS,96,9.0,3-PT Attempted,34,31,29,8
Jayson Tatum,F,22023,1628369,22300043,"NOV 24, 2023",BOS @ ORL,L,39,7,16,0.438,0,3,0.0,12,13,0.923,0,5,5,3,2,0,2,3,26,-21,1,BOS,ORL,BOS,96,5.5,Free Throws Made,34,31,29,8
Jayson Tatum,F,22023,1628369,22300043,"NOV 24, 2023",BOS @ ORL,L,39,7,16,0.438,0,3,0.0,12,13,0.923,0,5,5,3,2,0,2,3,26,-21,1,BOS,ORL,BOS,96,19.5,FG Attempted,34,31,29,8
Jayson Tatum,F,22023,1628369,22300043,"NOV 24, 2023",BOS @ ORL,L,39,7,16,0.438,0,3,0.0,12,13,0.923,0,5,5,3,2,0,2,3,26,-21,1,BOS,ORL,BOS,96,35.5,Pts+Rebs,34,31,29,8
Jayson Tatum,F,22023,1628369,22300043,"NOV 24, 2023",BOS @ ORL,L,39,7,16,0.438,0,3,0.0,12,13,0.923,0,5,5,3,2,0,2,3,26,-21,1,BOS,ORL,BOS,96,31.5,Pts+Asts,34,31,29,8
Jayson Tatum,F,22023,1628369,22300043,"NOV 24, 2023",BOS @ ORL,L,39,7,16,0.438,0,3,0.0,12,13,0.923,0,5,5,3,2,0,2,3,26,-21,1,BOS,ORL,BOS,96,13.0,Rebs+Asts,34,31,29,8
Jayson Tatum,F,22023,1628369,22300043,"NOV 24, 2023",BOS @ ORL,L,39,7,16,0.438,0,3,0.0,12,13,0.923,0,5,5,3,2,0,2,3,26,-21,1,BOS,ORL,BOS,96,1.5,Blks+Stls,34,31,29,8
Jayson Tatum,F,22023,1628369,22300194,"NOV 15, 2023",BOS @ PHI,W,39,10,23,0.435,4,10,0.4,5,6,0.833,2,6,8,6,2,0,3,1,29,2,1,BOS,PHI,BOS,117,26.5,Points,43,37,35,14
Jayson Tatum,F,22023,1628369,22300194,"NOV 15, 2023",BOS @ PHI,W,39,10,23,0.435,4,10,0.4,5,6,0.833,2,6,8,6,2,0,3,1,29,2,1,BOS,PHI,BOS,117,8.5,Rebounds,43,37,35,14
Jayson Tatum,F,22023,1628369,22300194,"NOV 15, 2023",BOS @ PHI,W,39,10,23,0.435,4,10,0.4,5,6,0.833,2,6,8,6,2,0,3,1,29,2,1,BOS,PHI,BOS,117,39.5,Pts+Rebs+Asts,43,37,35,14
Jayson Tatum,F,22023,1628369,22300194,"NOV 15, 2023",BOS @ PHI,W,39,10,23,0.435,4,10,0.4,5,6,0.833,2,6,8,6,2,0,3,1,29,2,1,BOS,PHI,BOS,117,4.5,Assists,43,37,35,14
Jayson Tatum,F,22023,1628369,22300194,"NOV 15, 2023",BOS @ PHI,W,39,10,23,0.435,4,10,0.4,5,6,0.833,2,6,8,6,2,0,3,1,29,2,1,BOS,PHI,BOS,117,45.5,Fantasy Score,43,37,35,14
Jayson Tatum,F,22023,1628369,22300194,"NOV 15, 2023",BOS @ PHI,W,39,10,23,0.435,4,10,0.4,5,6,0.833,2,6,8,6,2,0,3,1,29,2,1,BOS,PHI,BOS,117,7.0,Defensive Rebounds,43,37,35,14
Jayson Tatum,F,22023,1628369,22300194,"NOV 15, 2023",BOS @ PHI,W,39,10,23,0.435,4,10,0.4,5,6,0.833,2,6,8,6,2,0,3,1,29,2,1,BOS,PHI,BOS,117,9.0,3-PT Attempted,43,37,35,14
Jayson Tatum,F,22023,1628369,22300194,"NOV 15, 2023",BOS @ PHI,W,39,10,23,0.435,4,10,0.4,5,6,0.833,2,6,8,6,2,0,3,1,29,2,1,BOS,PHI,BOS,117,5.5,Free Throws Made,43,37,35,14
Jayson Tatum,F,22023,1628369,22300194,"NOV 15, 2023",BOS @ PHI,W,39,10,23,0.435,4,10,0.4,5,6,0.833,2,6,8,6,2,0,3,1,29,2,1,BOS,PHI,BOS,117,19.5,FG Attempted,43,37,35,14
Jayson Tatum,F,22023,1628369,22300194,"NOV 15, 2023",BOS @ PHI,W,39,10,23,0.435,4,10,0.4,5,6,0.833,2,6,8,6,2,0,3,1,29,2,1,BOS,PHI,BOS,117,35.5,Pts+Rebs,43,37,35,14
Jayson Tatum,F,22023,1628369,22300194,"NOV 15, 2023",BOS @ PHI,W,39,10,23,0.435,4,10,0.4,5,6,0.833,2,6,8,6,2,0,3,1,29,2,1,BOS,PHI,BOS,117,31.5,Pts+Asts,43,37,35,14
Jayson Tatum,F,22023,1628369,22300194,"NOV 15, 2023",BOS @ PHI,W,39,10,23,0.435,4,10,0.4,5,6,0.833,2,6,8,6,2,0,3,1,29,2,1,BOS,PHI,BOS,117,13.0,Rebs+Asts,43,37,35,14
Jayson Tatum,F,22023,1628369,22300194,"NOV 15, 2023",BOS @ PHI,W,39,10,23,0.435,4,10,0.4,5,6,0.833,2,6,8,6,2,0,3,1,29,2,1,BOS,PHI,BOS,117,1.5,Blks+Stls,43,37,35,14
Jayson Tatum,F,22023,1628369,22300174,"NOV 11, 2023",BOS vs. TOR,W,34,10,18,0.556,3,9,0.333,4,6,0.667,0,5,5,4,0,1,1,2,27,42,1,BOS,BOS,TOR,117,26.5,Points,36,32,31,9
Jayson Tatum,F,22023,1628369,22300174,"NOV 11, 2023",BOS vs. TOR,W,34,10,18,0.556,3,9,0.333,4,6,0.667,0,5,5,4,0,1,1,2,27,42,1,BOS,BOS,TOR,117,8.5,Rebounds,36,32,31,9
Jayson Tatum,F,22023,1628369,22300174,"NOV 11, 2023",BOS vs. TOR,W,34,10,18,0.556,3,9,0.333,4,6,0.667,0,5,5,4,0,1,1,2,27,42,1,BOS,BOS,TOR,117,39.5,Pts+Rebs+Asts,36,32,31,9
Jayson Tatum,F,22023,1628369,22300174,"NOV 11, 2023",BOS vs. TOR,W,34,10,18,0.556,3,9,0.333,4,6,0.667,0,5,5,4,0,1,1,2,27,42,1,BOS,BOS,TOR,117,4.5,Assists,36,32,31,9
Jayson Tatum,F,22023,1628369,22300174,"NOV 11, 2023",BOS vs. TOR,W,34,10,18,0.556,3,9,0.333,4,6,0.667,0,5,5,4,0,1,1,2,27,42,1,BOS,BOS,TOR,117,45.5,Fantasy Score,36,32,31,9
Jayson Tatum,F,22023,1628369,22300174,"NOV 11, 2023",BOS vs. TOR,W,34,10,18,0.556,3,9,0.333,4,6,0.667,0,5,5,4,0,1,1,2,27,42,1,BOS,BOS,TOR,117,7.0,Defensive Rebounds,36,32,31,9
Jayson Tatum,F,22023,1628369,22300174,"NOV 11, 2023",BOS vs. TOR,W,34,10,18,0.556,3,9,0.333,4,6,0.667,0,5,5,4,0,1,1,2,27,42,1,BOS,BOS,TOR,117,9.0,3-PT Attempted,36,32,31,9
Jayson Tatum,F,22023,1628369,22300174,"NOV 11, 2023",BOS vs. TOR,W,34,10,18,0.556,3,9,0.333,4,6,0.667,0,5,5,4,0,1,1,2,27,42,1,BOS,BOS,TOR,117,5.5,Free Throws Made,36,32,31,9
Jayson Tatum,F,22023,1628369,22300174,"NOV 11, 2023",BOS vs. TOR,W,34,10,18,0.556,3,9,0.333,4,6,0.667,0,5,5,4,0,1,1,2,27,42,1,BOS,BOS,TOR,117,19.5,FG Attempted,36,32,31,9
Jayson Tatum,F,22023,1628369,22300174,"NOV 11, 2023",BOS vs. TOR,W,34,10,18,0.556,3,9,0.333,4,6,0.667,0,5,5,4,0,1,1,2,27,42,1,BOS,BOS,TOR,117,35.5,Pts+Rebs,36,32,31,9
Jayson Tatum,F,22023,1628369,22300174,"NOV 11, 2023",BOS vs. TOR,W,34,10,18,0.556,3,9,0.333,4,6,0.667,0,5,5,4,0,1,1,2,27,42,1,BOS,BOS,TOR,117,31.5,Pts+Asts,36,32,31,9
Jayson Tatum,F,22023,1628369,22300174,"NOV 11, 2023",BOS vs. TOR,W,34,10,18,0.556,3,9,0.333,4,6,0.667,0,5,5,4,0,1,1,2,27,42,1,BOS,BOS,TOR,117,13.0,Rebs+Asts,36,32,31,9
Jayson Tatum,F,22023,1628369,22300174,"NOV 11, 2023",BOS vs. TOR,W,34,10,18,0.556,3,9,0.333,4,6,0.667,0,5,5,4,0,1,1,2,27,42,1,BOS,BOS,TOR,117,1.5,Blks+Stls,36,32,31,9
Jayson Tatum,F,22023,1628369,22300010,"NOV 10, 2023",BOS vs. BKN,W,33,6,17,0.353,4,11,0.364,7,9,0.778,1,9,10,3,0,0,2,1,23,28,1,BOS,BOS,BKN,121,26.5,Points,36,33,26,13
Jayson Tatum,F,22023,1628369,22300010,"NOV 10, 2023",BOS vs. BKN,W,33,6,17,0.353,4,11,0.364,7,9,0.778,1,9,10,3,0,0,2,1,23,28,1,BOS,BOS,BKN,121,8.5,Rebounds,36,33,26,13
Jayson Tatum,F,22023,1628369,22300010,"NOV 10, 2023",BOS vs. BKN,W,33,6,17,0.353,4,11,0.364,7,9,0.778,1,9,10,3,0,0,2,1,23,28,1,BOS,BOS,BKN,121,39.5,Pts+Rebs+Asts,36,33,26,13
Jayson Tatum,F,22023,1628369,22300010,"NOV 10, 2023",BOS vs. BKN,W,33,6,17,0.353,4,11,0.364,7,9,0.778,1,9,10,3,0,0,2,1,23,28,1,BOS,BOS,BKN,121,4.5,Assists,36,33,26,13
Jayson Tatum,F,22023,1628369,22300010,"NOV 10, 2023",BOS vs. BKN,W,33,6,17,0.353,4,11,0.364,7,9,0.778,1,9,10,3,0,0,2,1,23,28,1,BOS,BOS,BKN,121,45.5,Fantasy Score,36,33,26,13
Jayson Tatum,F,22023,1628369,22300010,"NOV 10, 2023",BOS vs. BKN,W,33,6,17,0.353,4,11,0.364,7,9,0.778,1,9,10,3,0,0,2,1,23,28,1,BOS,BOS,BKN,121,7.0,Defensive Rebounds,36,33,26,13
Jayson Tatum,F,22023,1628369,22300010,"NOV 10, 2023",BOS vs. BKN,W,33,6,17,0.353,4,11,0.364,7,9,0.778,1,9,10,3,0,0,2,1,23,28,1,BOS,BOS,BKN,121,9.0,3-PT Attempted,36,33,26,13
Jayson Tatum,F,22023,1628369,22300010,"NOV 10, 2023",BOS vs. BKN,W,33,6,17,0.353,4,11,0.364,7,9,0.778,1,9,10,3,0,0,2,1,23,28,1,BOS,BOS,BKN,121,5.5,Free Throws Made,36,33,26,13
Jayson Tatum,F,22023,1628369,22300010,"NOV 10, 2023",BOS vs. BKN,W,33,6,17,0.353,4,11,0.364,7,9,0.778,1,9,10,3,0,0,2,1,23,28,1,BOS,BOS,BKN,121,19.5,FG Attempted,36,33,26,13
Jayson Tatum,F,22023,1628369,22300010,"NOV 10, 2023",BOS vs. BKN,W,33,6,17,0.353,4,11,0.364,7,9,0.778,1,9,10,3,0,0,2,1,23,28,1,BOS,BOS,BKN,121,35.5,Pts+Rebs,36,33,26,13
Jayson Tatum,F,22023,1628369,22300010,"NOV 10, 2023",BOS vs. BKN,W,33,6,17,0.353,4,11,0.364,7,9,0.778,1,9,10,3,0,0,2,1,23,28,1,BOS,BOS,BKN,121,31.5,Pts+Asts,36,33,26,13
Jayson Tatum,F,22023,1628369,22300010,"NOV 10, 2023",BOS vs. BKN,W,33,6,17,0.353,4,11,0.364,7,9,0.778,1,9,10,3,0,0,2,1,23,28,1,BOS,BOS,BKN,121,13.0,Rebs+Asts,36,33,26,13
Jayson Tatum,F,22023,1628369,22300010,"NOV 10, 2023",BOS vs. BKN,W,33,6,17,0.353,4,11,0.364,7,9,0.778,1,9,10,3,0,0,2,1,23,28,1,BOS,BOS,BKN,121,1.5,Blks+Stls,36,33,26,13
Jayson Tatum,F,22023,1628369,22300118,"NOV 01, 2023",BOS vs. IND,W,27,9,15,0.6,3,5,0.6,9,10,0.9,2,10,12,4,0,0,2,1,30,36,1,BOS,BOS,IND,155,26.5,Points,46,42,34,16
Jayson Tatum,F,22023,1628369,22300118,"NOV 01, 2023",BOS vs. IND,W,27,9,15,0.6,3,5,0.6,9,10,0.9,2,10,12,4,0,0,2,1,30,36,1,BOS,BOS,IND,155,8.5,Rebounds,46,42,34,16
Jayson Tatum,F,22023,1628369,22300118,"NOV 01, 2023",BOS vs. IND,W,27,9,15,0.6,3,5,0.6,9,10,0.9,2,10,12,4,0,0,2,1,30,36,1,BOS,BOS,IND,155,39.5,Pts+Rebs+Asts,46,42,34,16
Jayson Tatum,F,22023,1628369,22300118,"NOV 01, 2023",BOS vs. IND,W,27,9,15,0.6,3,5,0.6,9,10,0.9,2,10,12,4,0,0,2,1,30,36,1,BOS,BOS,IND,155,4.5,Assists,46,42,34,16
Jayson Tatum,F,22023,1628369,22300118,"NOV 01, 2023",BOS vs. IND,W,27,9,15,0.6,3,5,0.6,9,10,0.9,2,10,12,4,0,0,2,1,30,36,1,BOS,BOS,IND,155,45.5,Fantasy Score,46,42,34,16
Jayson Tatum,F,22023,1628369,22300118,"NOV 01, 2023",BOS vs. IND,W,27,9,15,0.6,3,5,0.6,9,10,0.9,2,10,12,4,0,0,2,1,30,36,1,BOS,BOS,IND,155,7.0,Defensive Rebounds,46,42,34,16
Jayson Tatum,F,22023,1628369,22300118,"NOV 01, 2023",BOS vs. IND,W,27,9,15,0.6,3,5,0.6,9,10,0.9,2,10,12,4,0,0,2,1,30,36,1,BOS,BOS,IND,155,9.0,3-PT Attempted,46,42,34,16
Jayson Tatum,F,22023,1628369,22300118,"NOV 01, 2023",BOS vs. IND,W,27,9,15,0.6,3,5,0.6,9,10,0.9,2,10,12,4,0,0,2,1,30,36,1,BOS,BOS,IND,155,5.5,Free Throws Made,46,42,34,16
Jayson Tatum,F,22023,1628369,22300118,"NOV 01, 2023",BOS vs. IND,W,27,9,15,0.6,3,5,0.6,9,10,0.9,2,10,12,4,0,0,2,1,30,36,1,BOS,BOS,IND,155,19.5,FG Attempted,46,42,34,16
Jayson Tatum,F,22023,1628369,22300118,"NOV 01, 2023",BOS vs. IND,W,27,9,15,0.6,3,5,0.6,9,10,0.9,2,10,12,4,0,0,2,1,30,36,1,BOS,BOS,IND,155,35.5,Pts+Rebs,46,42,34,16
Jayson Tatum,F,22023,1628369,22300118,"NOV 01, 2023",BOS vs. IND,W,27,9,15,0.6,3,5,0.6,9,10,0.9,2,10,12,4,0,0,2,1,30,36,1,BOS,BOS,IND,155,31.5,Pts+Asts,46,42,34,16
Jayson Tatum,F,22023,1628369,22300118,"NOV 01, 2023",BOS vs. IND,W,27,9,15,0.6,3,5,0.6,9,10,0.9,2,10,12,4,0,0,2,1,30,36,1,BOS,BOS,IND,155,13.0,Rebs+Asts,46,42,34,16
Jayson Tatum,F,22023,1628369,22300118,"NOV 01, 2023",BOS vs. IND,W,27,9,15,0.6,3,5,0.6,9,10,0.9,2,10,12,4,0,0,2,1,30,36,1,BOS,BOS,IND,155,1.5,Blks+Stls,46,42,34,16
Jayson Tatum,F,22023,1628369,22300103,"OCT 30, 2023",BOS @ WAS,W,28,14,21,0.667,4,9,0.444,1,1,1.0,0,6,6,3,0,0,2,2,33,27,1,BOS,WAS,BOS,126,26.5,Points,42,39,36,9
Jayson Tatum,F,22023,1628369,22300103,"OCT 30, 2023",BOS @ WAS,W,28,14,21,0.667,4,9,0.444,1,1,1.0,0,6,6,3,0,0,2,2,33,27,1,BOS,WAS,BOS,126,8.5,Rebounds,42,39,36,9
Jayson Tatum,F,22023,1628369,22300103,"OCT 30, 2023",BOS @ WAS,W,28,14,21,0.667,4,9,0.444,1,1,1.0,0,6,6,3,0,0,2,2,33,27,1,BOS,WAS,BOS,126,39.5,Pts+Rebs+Asts,42,39,36,9
Jayson Tatum,F,22023,1628369,22300103,"OCT 30, 2023",BOS @ WAS,W,28,14,21,0.667,4,9,0.444,1,1,1.0,0,6,6,3,0,0,2,2,33,27,1,BOS,WAS,BOS,126,4.5,Assists,42,39,36,9
Jayson Tatum,F,22023,1628369,22300103,"OCT 30, 2023",BOS @ WAS,W,28,14,21,0.667,4,9,0.444,1,1,1.0,0,6,6,3,0,0,2,2,33,27,1,BOS,WAS,BOS,126,45.5,Fantasy Score,42,39,36,9
Jayson Tatum,F,22023,1628369,22300103,"OCT 30, 2023",BOS @ WAS,W,28,14,21,0.667,4,9,0.444,1,1,1.0,0,6,6,3,0,0,2,2,33,27,1,BOS,WAS,BOS,126,7.0,Defensive Rebounds,42,39,36,9
Jayson Tatum,F,22023,1628369,22300103,"OCT 30, 2023",BOS @ WAS,W,28,14,21,0.667,4,9,0.444,1,1,1.0,0,6,6,3,0,0,2,2,33,27,1,BOS,WAS,BOS,126,9.0,3-PT Attempted,42,39,36,9
Jayson Tatum,F,22023,1628369,22300103,"OCT 30, 2023",BOS @ WAS,W,28,14,21,0.667,4,9,0.444,1,1,1.0,0,6,6,3,0,0,2,2,33,27,1,BOS,WAS,BOS,126,5.5,Free Throws Made,42,39,36,9
Jayson Tatum,F,22023,1628369,22300103,"OCT 30, 2023",BOS @ WAS,W,28,14,21,0.667,4,9,0.444,1,1,1.0,0,6,6,3,0,0,2,2,33,27,1,BOS,WAS,BOS,126,19.5,FG Attempted,42,39,36,9
Jayson Tatum,F,22023,1628369,22300103,"OCT 30, 2023",BOS @ WAS,W,28,14,21,0.667,4,9,0.444,1,1,1.0,0,6,6,3,0,0,2,2,33,27,1,BOS,WAS,BOS,126,35.5,Pts+Rebs,42,39,36,9
Jayson Tatum,F,22023,1628369,22300103,"OCT 30, 2023",BOS @ WAS,W,28,14,21,0.667,4,9,0.444,1,1,1.0,0,6,6,3,0,0,2,2,33,27,1,BOS,WAS,BOS,126,31.5,Pts+Asts,42,39,36,9
Jayson Tatum,F,22023,1628369,22300103,"OCT 30, 2023",BOS @ WAS,W,28,14,21,0.667,4,9,0.444,1,1,1.0,0,6,6,3,0,0,2,2,33,27,1,BOS,WAS,BOS,126,13.0,Rebs+Asts,42,39,36,9
Jayson Tatum,F,22023,1628369,22300103,"OCT 30, 2023",BOS @ WAS,W,28,14,21,0.667,4,9,0.444,1,1,1.0,0,6,6,3,0,0,2,2,33,27,1,BOS,WAS,BOS,126,1.5,Blks+Stls,42,39,36,9
Jayson Tatum,F,22023,1628369,22300729,"FEB 07, 2024",BOS vs. ATL,W,36,8,21,0.381,2,13,0.154,2,2,1.0,0,9,9,7,1,0,3,3,20,3,1,BOS,BOS,ATL,125,26.5,Points,36,29,27,16
Jayson Tatum,F,22023,1628369,22300729,"FEB 07, 2024",BOS vs. ATL,W,36,8,21,0.381,2,13,0.154,2,2,1.0,0,9,9,7,1,0,3,3,20,3,1,BOS,BOS,ATL,125,8.5,Rebounds,36,29,27,16
Jayson Tatum,F,22023,1628369,22300729,"FEB 07, 2024",BOS vs. ATL,W,36,8,21,0.381,2,13,0.154,2,2,1.0,0,9,9,7,1,0,3,3,20,3,1,BOS,BOS,ATL,125,39.5,Pts+Rebs+Asts,36,29,27,16
Jayson Tatum,F,22023,1628369,22300729,"FEB 07, 2024",BOS vs. ATL,W,36,8,21,0.381,2,13,0.154,2,2,1.0,0,9,9,7,1,0,3,3,20,3,1,BOS,BOS,ATL,125,4.5,Assists,36,29,27,16
Jayson Tatum,F,22023,1628369,22300729,"FEB 07, 2024",BOS vs. ATL,W,36,8,21,0.381,2,13,0.154,2,2,1.0,0,9,9,7,1,0,3,3,20,3,1,BOS,BOS,ATL,125,45.5,Fantasy Score,36,29,27,16
Jayson Tatum,F,22023,1628369,22300729,"FEB 07, 2024",BOS vs. ATL,W,36,8,21,0.381,2,13,0.154,2,2,1.0,0,9,9,7,1,0,3,3,20,3,1,BOS,BOS,ATL,125,7.0,Defensive Rebounds,36,29,27,16
Jayson Tatum,F,22023,1628369,22300729,"FEB 07, 2024",BOS vs. ATL,W,36,8,21,0.381,2,13,0.154,2,2,1.0,0,9,9,7,1,0,3,3,20,3,1,BOS,BOS,ATL,125,9.0,3-PT Attempted,36,29,27,16
Jayson Tatum,F,22023,1628369,22300729,"FEB 07, 2024",BOS vs. ATL,W,36,8,21,0.381,2,13,0.154,2,2,1.0,0,9,9,7,1,0,3,3,20,3,1,BOS,BOS,ATL,125,5.5,Free Throws Made,36,29,27,16
Jayson Tatum,F,22023,1628369,22300729,"FEB 07, 2024",BOS vs. ATL,W,36,8,21,0.381,2,13,0.154,2,2,1.0,0,9,9,7,1,0,3,3,20,3,1,BOS,BOS,ATL,125,19.5,FG Attempted,36,29,27,16
Jayson Tatum,F,22023,1628369,22300729,"FEB 07, 2024",BOS vs. ATL,W,36,8,21,0.381,2,13,0.154,2,2,1.0,0,9,9,7,1,0,3,3,20,3,1,BOS,BOS,ATL,125,35.5,Pts+Rebs,36,29,27,16
Jayson Tatum,F,22023,1628369,22300729,"FEB 07, 2024",BOS vs. ATL,W,36,8,21,0.381,2,13,0.154,2,2,1.0,0,9,9,7,1,0,3,3,20,3,1,BOS,BOS,ATL,125,31.5,Pts+Asts,36,29,27,16
Jayson Tatum,F,22023,1628369,22300729,"FEB 07, 2024",BOS vs. ATL,W,36,8,21,0.381,2,13,0.154,2,2,1.0,0,9,9,7,1,0,3,3,20,3,1,BOS,BOS,ATL,125,13.0,Rebs+Asts,36,29,27,16
Jayson Tatum,F,22023,1628369,22300729,"FEB 07, 2024",BOS vs. ATL,W,36,8,21,0.381,2,13,0.154,2,2,1.0,0,9,9,7,1,0,3,3,20,3,1,BOS,BOS,ATL,125,1.5,Blks+Stls,36,29,27,16
Jayson Tatum,F,22023,1628369,22300670,"JAN 30, 2024",BOS vs. IND,W,39,12,19,0.632,4,9,0.444,2,3,0.667,0,7,7,7,1,2,2,2,30,-4,1,BOS,BOS,IND,129,26.5,Points,44,37,37,14
Jayson Tatum,F,22023,1628369,22300670,"JAN 30, 2024",BOS vs. IND,W,39,12,19,0.632,4,9,0.444,2,3,0.667,0,7,7,7,1,2,2,2,30,-4,1,BOS,BOS,IND,129,8.5,Rebounds,44,37,37,14
Jayson Tatum,F,22023,1628369,22300670,"JAN 30, 2024",BOS vs. IND,W,39,12,19,0.632,4,9,0.444,2,3,0.667,0,7,7,7,1,2,2,2,30,-4,1,BOS,BOS,IND,129,39.5,Pts+Rebs+Asts,44,37,37,14
Jayson Tatum,F,22023,1628369,22300670,"JAN 30, 2024",BOS vs. IND,W,39,12,19,0.632,4,9,0.444,2,3,0.667,0,7,7,7,1,2,2,2,30,-4,1,BOS,BOS,IND,129,4.5,Assists,44,37,37,14
Jayson Tatum,F,22023,1628369,22300670,"JAN 30, 2024",BOS vs. IND,W,39,12,19,0.632,4,9,0.444,2,3,0.667,0,7,7,7,1,2,2,2,30,-4,1,BOS,BOS,IND,129,45.5,Fantasy Score,44,37,37,14
Jayson Tatum,F,22023,1628369,22300670,"JAN 30, 2024",BOS vs. IND,W,39,12,19,0.632,4,9,0.444,2,3,0.667,0,7,7,7,1,2,2,2,30,-4,1,BOS,BOS,IND,129,7.0,Defensive Rebounds,44,37,37,14
Jayson Tatum,F,22023,1628369,22300670,"JAN 30, 2024",BOS vs. IND,W,39,12,19,0.632,4,9,0.444,2,3,0.667,0,7,7,7,1,2,2,2,30,-4,1,BOS,BOS,IND,129,9.0,3-PT Attempted,44,37,37,14
Jayson Tatum,F,22023,1628369,22300670,"JAN 30, 2024",BOS vs. IND,W,39,12,19,0.632,4,9,0.444,2,3,0.667,0,7,7,7,1,2,2,2,30,-4,1,BOS,BOS,IND,129,5.5,Free Throws Made,44,37,37,14
Jayson Tatum,F,22023,1628369,22300670,"JAN 30, 2024",BOS vs. IND,W,39,12,19,0.632,4,9,0.444,2,3,0.667,0,7,7,7,1,2,2,2,30,-4,1,BOS,BOS,IND,129,19.5,FG Attempted,44,37,37,14
Jayson Tatum,F,22023,1628369,22300670,"JAN 30, 2024",BOS vs. IND,W,39,12,19,0.632,4,9,0.444,2,3,0.667,0,7,7,7,1,2,2,2,30,-4,1,BOS,BOS,IND,129,35.5,Pts+Rebs,44,37,37,14
Jayson Tatum,F,22023,1628369,22300670,"JAN 30, 2024",BOS vs. IND,W,39,12,19,0.632,4,9,0.444,2,3,0.667,0,7,7,7,1,2,2,2,30,-4,1,BOS,BOS,IND,129,31.5,Pts+Asts,44,37,37,14
Jayson Tatum,F,22023,1628369,22300670,"JAN 30, 2024",BOS vs. IND,W,39,12,19,0.632,4,9,0.444,2,3,0.667,0,7,7,7,1,2,2,2,30,-4,1,BOS,BOS,IND,129,13.0,Rebs+Asts,44,37,37,14
Jayson Tatum,F,22023,1628369,22300670,"JAN 30, 2024",BOS vs. IND,W,39,12,19,0.632,4,9,0.444,2,3,0.667,0,7,7,7,1,2,2,2,30,-4,1,BOS,BOS,IND,129,1.5,Blks+Stls,44,37,37,14
Jayson Tatum,F,22023,1628369,22300659,"JAN 29, 2024",BOS vs. NOP,W,38,10,18,0.556,2,8,0.25,6,7,0.857,0,10,10,8,3,1,7,1,28,9,1,BOS,BOS,NOP,118,26.5,Points,46,38,36,18
Jayson Tatum,F,22023,1628369,22300659,"JAN 29, 2024",BOS vs. NOP,W,38,10,18,0.556,2,8,0.25,6,7,0.857,0,10,10,8,3,1,7,1,28,9,1,BOS,BOS,NOP,118,8.5,Rebounds,46,38,36,18
Jayson Tatum,F,22023,1628369,22300659,"JAN 29, 2024",BOS vs. NOP,W,38,10,18,0.556,2,8,0.25,6,7,0.857,0,10,10,8,3,1,7,1,28,9,1,BOS,BOS,NOP,118,39.5,Pts+Rebs+Asts,46,38,36,18
Jayson Tatum,F,22023,1628369,22300659,"JAN 29, 2024",BOS vs. NOP,W,38,10,18,0.556,2,8,0.25,6,7,0.857,0,10,10,8,3,1,7,1,28,9,1,BOS,BOS,NOP,118,4.5,Assists,46,38,36,18
Jayson Tatum,F,22023,1628369,22300659,"JAN 29, 2024",BOS vs. NOP,W,38,10,18,0.556,2,8,0.25,6,7,0.857,0,10,10,8,3,1,7,1,28,9,1,BOS,BOS,NOP,118,45.5,Fantasy Score,46,38,36,18
Jayson Tatum,F,22023,1628369,22300659,"JAN 29, 2024",BOS vs. NOP,W,38,10,18,0.556,2,8,0.25,6,7,0.857,0,10,10,8,3,1,7,1,28,9,1,BOS,BOS,NOP,118,7.0,Defensive Rebounds,46,38,36,18
Jayson Tatum,F,22023,1628369,22300659,"JAN 29, 2024",BOS vs. NOP,W,38,10,18,0.556,2,8,0.25,6,7,0.857,0,10,10,8,3,1,7,1,28,9,1,BOS,BOS,NOP,118,9.0,3-PT Attempted,46,38,36,18
Jayson Tatum,F,22023,1628369,22300659,"JAN 29, 2024",BOS vs. NOP,W,38,10,18,0.556,2,8,0.25,6,7,0.857,0,10,10,8,3,1,7,1,28,9,1,BOS,BOS,NOP,118,5.5,Free Throws Made,46,38,36,18
Jayson Tatum,F,22023,1628369,22300659,"JAN 29, 2024",BOS vs. NOP,W,38,10,18,0.556,2,8,0.25,6,7,0.857,0,10,10,8,3,1,7,1,28,9,1,BOS,BOS,NOP,118,19.5,FG Attempted,46,38,36,18
Jayson Tatum,F,22023,1628369,22300659,"JAN 29, 2024",BOS vs. NOP,W,38,10,18,0.556,2,8,0.25,6,7,0.857,0,10,10,8,3,1,7,1,28,9,1,BOS,BOS,NOP,118,35.5,Pts+Rebs,46,38,36,18
Jayson Tatum,F,22023,1628369,22300659,"JAN 29, 2024",BOS vs. NOP,W,38,10,18,0.556,2,8,0.25,6,7,0.857,0,10,10,8,3,1,7,1,28,9,1,BOS,BOS,NOP,118,31.5,Pts+Asts,46,38,36,18
Jayson Tatum,F,22023,1628369,22300659,"JAN 29, 2024",BOS vs. NOP,W,38,10,18,0.556,2,8,0.25,6,7,0.857,0,10,10,8,3,1,7,1,28,9,1,BOS,BOS,NOP,118,13.0,Rebs+Asts,46,38,36,18
Jayson Tatum,F,22023,1628369,22300659,"JAN 29, 2024",BOS vs. NOP,W,38,10,18,0.556,2,8,0.25,6,7,0.857,0,10,10,8,3,1,7,1,28,9,1,BOS,BOS,NOP,118,1.5,Blks+Stls,46,38,36,18
Jayson Tatum,F,22023,1628369,22300603,"JAN 21, 2024",BOS @ HOU,W,35,4,17,0.235,1,6,0.167,9,12,0.75,1,6,7,3,1,0,2,0,18,-4,1,BOS,HOU,BOS,116,26.5,Points,28,25,21,10
Jayson Tatum,F,22023,1628369,22300603,"JAN 21, 2024",BOS @ HOU,W,35,4,17,0.235,1,6,0.167,9,12,0.75,1,6,7,3,1,0,2,0,18,-4,1,BOS,HOU,BOS,116,8.5,Rebounds,28,25,21,10
Jayson Tatum,F,22023,1628369,22300603,"JAN 21, 2024",BOS @ HOU,W,35,4,17,0.235,1,6,0.167,9,12,0.75,1,6,7,3,1,0,2,0,18,-4,1,BOS,HOU,BOS,116,39.5,Pts+Rebs+Asts,28,25,21,10
Jayson Tatum,F,22023,1628369,22300603,"JAN 21, 2024",BOS @ HOU,W,35,4,17,0.235,1,6,0.167,9,12,0.75,1,6,7,3,1,0,2,0,18,-4,1,BOS,HOU,BOS,116,4.5,Assists,28,25,21,10
Jayson Tatum,F,22023,1628369,22300603,"JAN 21, 2024",BOS @ HOU,W,35,4,17,0.235,1,6,0.167,9,12,0.75,1,6,7,3,1,0,2,0,18,-4,1,BOS,HOU,BOS,116,45.5,Fantasy Score,28,25,21,10
Jayson Tatum,F,22023,1628369,22300603,"JAN 21, 2024",BOS @ HOU,W,35,4,17,0.235,1,6,0.167,9,12,0.75,1,6,7,3,1,0,2,0,18,-4,1,BOS,HOU,BOS,116,7.0,Defensive Rebounds,28,25,21,10
Jayson Tatum,F,22023,1628369,22300603,"JAN 21, 2024",BOS @ HOU,W,35,4,17,0.235,1,6,0.167,9,12,0.75,1,6,7,3,1,0,2,0,18,-4,1,BOS,HOU,BOS,116,9.0,3-PT Attempted,28,25,21,10
Jayson Tatum,F,22023,1628369,22300603,"JAN 21, 2024",BOS @ HOU,W,35,4,17,0.235,1,6,0.167,9,12,0.75,1,6,7,3,1,0,2,0,18,-4,1,BOS,HOU,BOS,116,5.5,Free Throws Made,28,25,21,10
Jayson Tatum,F,22023,1628369,22300603,"JAN 21, 2024",BOS @ HOU,W,35,4,17,0.235,1,6,0.167,9,12,0.75,1,6,7,3,1,0,2,0,18,-4,1,BOS,HOU,BOS,116,19.5,FG Attempted,28,25,21,10
Jayson Tatum,F,22023,1628369,22300603,"JAN 21, 2024",BOS @ HOU,W,35,4,17,0.235,1,6,0.167,9,12,0.75,1,6,7,3,1,0,2,0,18,-4,1,BOS,HOU,BOS,116,35.5,Pts+Rebs,28,25,21,10
Jayson Tatum,F,22023,1628369,22300603,"JAN 21, 2024",BOS @ HOU,W,35,4,17,0.235,1,6,0.167,9,12,0.75,1,6,7,3,1,0,2,0,18,-4,1,BOS,HOU,BOS,116,31.5,Pts+Asts,28,25,21,10
Jayson Tatum,F,22023,1628369,22300603,"JAN 21, 2024",BOS @ HOU,W,35,4,17,0.235,1,6,0.167,9,12,0.75,1,6,7,3,1,0,2,0,18,-4,1,BOS,HOU,BOS,116,13.0,Rebs+Asts,28,25,21,10
Jayson Tatum,F,22023,1628369,22300603,"JAN 21, 2024",BOS @ HOU,W,35,4,17,0.235,1,6,0.167,9,12,0.75,1,6,7,3,1,0,2,0,18,-4,1,BOS,HOU,BOS,116,1.5,Blks+Stls,28,25,21,10
Jayson Tatum,F,22023,1628369,22300563,"JAN 15, 2024",BOS @ TOR,W,37,7,19,0.368,1,6,0.167,4,4,1.0,0,14,14,6,1,1,1,2,19,8,1,BOS,TOR,BOS,105,26.5,Points,39,33,25,20
Jayson Tatum,F,22023,1628369,22300563,"JAN 15, 2024",BOS @ TOR,W,37,7,19,0.368,1,6,0.167,4,4,1.0,0,14,14,6,1,1,1,2,19,8,1,BOS,TOR,BOS,105,8.5,Rebounds,39,33,25,20
Jayson Tatum,F,22023,1628369,22300563,"JAN 15, 2024",BOS @ TOR,W,37,7,19,0.368,1,6,0.167,4,4,1.0,0,14,14,6,1,1,1,2,19,8,1,BOS,TOR,BOS,105,39.5,Pts+Rebs+Asts,39,33,25,20
Jayson Tatum,F,22023,1628369,22300563,"JAN 15, 2024",BOS @ TOR,W,37,7,19,0.368,1,6,0.167,4,4,1.0,0,14,14,6,1,1,1,2,19,8,1,BOS,TOR,BOS,105,4.5,Assists,39,33,25,20
Jayson Tatum,F,22023,1628369,22300563,"JAN 15, 2024",BOS @ TOR,W,37,7,19,0.368,1,6,0.167,4,4,1.0,0,14,14,6,1,1,1,2,19,8,1,BOS,TOR,BOS,105,45.5,Fantasy Score,39,33,25,20
Jayson Tatum,F,22023,1628369,22300563,"JAN 15, 2024",BOS @ TOR,W,37,7,19,0.368,1,6,0.167,4,4,1.0,0,14,14,6,1,1,1,2,19,8,1,BOS,TOR,BOS,105,7.0,Defensive Rebounds,39,33,25,20
Jayson Tatum,F,22023,1628369,22300563,"JAN 15, 2024",BOS @ TOR,W,37,7,19,0.368,1,6,0.167,4,4,1.0,0,14,14,6,1,1,1,2,19,8,1,BOS,TOR,BOS,105,9.0,3-PT Attempted,39,33,25,20
Jayson Tatum,F,22023,1628369,22300563,"JAN 15, 2024",BOS @ TOR,W,37,7,19,0.368,1,6,0.167,4,4,1.0,0,14,14,6,1,1,1,2,19,8,1,BOS,TOR,BOS,105,5.5,Free Throws Made,39,33,25,20
Jayson Tatum,F,22023,1628369,22300563,"JAN 15, 2024",BOS @ TOR,W,37,7,19,0.368,1,6,0.167,4,4,1.0,0,14,14,6,1,1,1,2,19,8,1,BOS,TOR,BOS,105,19.5,FG Attempted,39,33,25,20
Jayson Tatum,F,22023,1628369,22300563,"JAN 15, 2024",BOS @ TOR,W,37,7,19,0.368,1,6,0.167,4,4,1.0,0,14,14,6,1,1,1,2,19,8,1,BOS,TOR,BOS,105,35.5,Pts+Rebs,39,33,25,20
Jayson Tatum,F,22023,1628369,22300563,"JAN 15, 2024",BOS @ TOR,W,37,7,19,0.368,1,6,0.167,4,4,1.0,0,14,14,6,1,1,1,2,19,8,1,BOS,TOR,BOS,105,31.5,Pts+Asts,39,33,25,20
Jayson Tatum,F,22023,1628369,22300563,"JAN 15, 2024",BOS @ TOR,W,37,7,19,0.368,1,6,0.167,4,4,1.0,0,14,14,6,1,1,1,2,19,8,1,BOS,TOR,BOS,105,13.0,Rebs+Asts,39,33,25,20
Jayson Tatum,F,22023,1628369,22300563,"JAN 15, 2024",BOS @ TOR,W,37,7,19,0.368,1,6,0.167,4,4,1.0,0,14,14,6,1,1,1,2,19,8,1,BOS,TOR,BOS,105,1.5,Blks+Stls,39,33,25,20
Jayson Tatum,F,22023,1628369,22300542,"JAN 13, 2024",BOS vs. HOU,W,30,9,17,0.529,4,7,0.571,5,7,0.714,1,7,8,5,1,1,2,2,27,9,1,BOS,BOS,HOU,145,26.5,Points,40,35,32,13
Jayson Tatum,F,22023,1628369,22300542,"JAN 13, 2024",BOS vs. HOU,W,30,9,17,0.529,4,7,0.571,5,7,0.714,1,7,8,5,1,1,2,2,27,9,1,BOS,BOS,HOU,145,8.5,Rebounds,40,35,32,13
Jayson Tatum,F,22023,1628369,22300542,"JAN 13, 2024",BOS vs. HOU,W,30,9,17,0.529,4,7,0.571,5,7,0.714,1,7,8,5,1,1,2,2,27,9,1,BOS,BOS,HOU,145,39.5,Pts+Rebs+Asts,40,35,32,13
Jayson Tatum,F,22023,1628369,22300542,"JAN 13, 2024",BOS vs. HOU,W,30,9,17,0.529,4,7,0.571,5,7,0.714,1,7,8,5,1,1,2,2,27,9,1,BOS,BOS,HOU,145,4.5,Assists,40,35,32,13
Jayson Tatum,F,22023,1628369,22300542,"JAN 13, 2024",BOS vs. HOU,W,30,9,17,0.529,4,7,0.571,5,7,0.714,1,7,8,5,1,1,2,2,27,9,1,BOS,BOS,HOU,145,45.5,Fantasy Score,40,35,32,13
Jayson Tatum,F,22023,1628369,22300542,"JAN 13, 2024",BOS vs. HOU,W,30,9,17,0.529,4,7,0.571,5,7,0.714,1,7,8,5,1,1,2,2,27,9,1,BOS,BOS,HOU,145,7.0,Defensive Rebounds,40,35,32,13
Jayson Tatum,F,22023,1628369,22300542,"JAN 13, 2024",BOS vs. HOU,W,30,9,17,0.529,4,7,0.571,5,7,0.714,1,7,8,5,1,1,2,2,27,9,1,BOS,BOS,HOU,145,9.0,3-PT Attempted,40,35,32,13
Jayson Tatum,F,22023,1628369,22300542,"JAN 13, 2024",BOS vs. HOU,W,30,9,17,0.529,4,7,0.571,5,7,0.714,1,7,8,5,1,1,2,2,27,9,1,BOS,BOS,HOU,145,5.5,Free Throws Made,40,35,32,13
Jayson Tatum,F,22023,1628369,22300542,"JAN 13, 2024",BOS vs. HOU,W,30,9,17,0.529,4,7,0.571,5,7,0.714,1,7,8,5,1,1,2,2,27,9,1,BOS,BOS,HOU,145,19.5,FG Attempted,40,35,32,13
Jayson Tatum,F,22023,1628369,22300542,"JAN 13, 2024",BOS vs. HOU,W,30,9,17,0.529,4,7,0.571,5,7,0.714,1,7,8,5,1,1,2,2,27,9,1,BOS,BOS,HOU,145,35.5,Pts+Rebs,40,35,32,13
Jayson Tatum,F,22023,1628369,22300542,"JAN 13, 2024",BOS vs. HOU,W,30,9,17,0.529,4,7,0.571,5,7,0.714,1,7,8,5,1,1,2,2,27,9,1,BOS,BOS,HOU,145,31.5,Pts+Asts,40,35,32,13
Jayson Tatum,F,22023,1628369,22300542,"JAN 13, 2024",BOS vs. HOU,W,30,9,17,0.529,4,7,0.571,5,7,0.714,1,7,8,5,1,1,2,2,27,9,1,BOS,BOS,HOU,145,13.0,Rebs+Asts,40,35,32,13
Jayson Tatum,F,22023,1628369,22300542,"JAN 13, 2024",BOS vs. HOU,W,30,9,17,0.529,4,7,0.571,5,7,0.714,1,7,8,5,1,1,2,2,27,9,1,BOS,BOS,HOU,145,1.5,Blks+Stls,40,35,32,13
Jayson Tatum,F,22023,1628369,22300517,"JAN 10, 2024",BOS vs. MIN,W,42,13,26,0.5,6,11,0.545,13,14,0.929,0,4,4,2,1,0,1,3,45,3,1,BOS,BOS,MIN,127,26.5,Points,51,49,47,6
Jayson Tatum,F,22023,1628369,22300517,"JAN 10, 2024",BOS vs. MIN,W,42,13,26,0.5,6,11,0.545,13,14,0.929,0,4,4,2,1,0,1,3,45,3,1,BOS,BOS,MIN,127,8.5,Rebounds,51,49,47,6
Jayson Tatum,F,22023,1628369,22300517,"JAN 10, 2024",BOS vs. MIN,W,42,13,26,0.5,6,11,0.545,13,14,0.929,0,4,4,2,1,0,1,3,45,3,1,BOS,BOS,MIN,127,39.5,Pts+Rebs+Asts,51,49,47,6
Jayson Tatum,F,22023,1628369,22300517,"JAN 10, 2024",BOS vs. MIN,W,42,13,26,0.5,6,11,0.545,13,14,0.929,0,4,4,2,1,0,1,3,45,3,1,BOS,BOS,MIN,127,4.5,Assists,51,49,47,6
Jayson Tatum,F,22023,1628369,22300517,"JAN 10, 2024",BOS vs. MIN,W,42,13,26,0.5,6,11,0.545,13,14,0.929,0,4,4,2,1,0,1,3,45,3,1,BOS,BOS,MIN,127,45.5,Fantasy Score,51,49,47,6
Jayson Tatum,F,22023,1628369,22300517,"JAN 10, 2024",BOS vs. MIN,W,42,13,26,0.5,6,11,0.545,13,14,0.929,0,4,4,2,1,0,1,3,45,3,1,BOS,BOS,MIN,127,7.0,Defensive Rebounds,51,49,47,6
Jayson Tatum,F,22023,1628369,22300517,"JAN 10, 2024",BOS vs. MIN,W,42,13,26,0.5,6,11,0.545,13,14,0.929,0,4,4,2,1,0,1,3,45,3,1,BOS,BOS,MIN,127,9.0,3-PT Attempted,51,49,47,6
Jayson Tatum,F,22023,1628369,22300517,"JAN 10, 2024",BOS vs. MIN,W,42,13,26,0.5,6,11,0.545,13,14,0.929,0,4,4,2,1,0,1,3,45,3,1,BOS,BOS,MIN,127,5.5,Free Throws Made,51,49,47,6
Jayson Tatum,F,22023,1628369,22300517,"JAN 10, 2024",BOS vs. MIN,W,42,13,26,0.5,6,11,0.545,13,14,0.929,0,4,4,2,1,0,1,3,45,3,1,BOS,BOS,MIN,127,19.5,FG Attempted,51,49,47,6
Jayson Tatum,F,22023,1628369,22300517,"JAN 10, 2024",BOS vs. MIN,W,42,13,26,0.5,6,11,0.545,13,14,0.929,0,4,4,2,1,0,1,3,45,3,1,BOS,BOS,MIN,127,35.5,Pts+Rebs,51,49,47,6
Jayson Tatum,F,22023,1628369,22300517,"JAN 10, 2024",BOS vs. MIN,W,42,13,26,0.5,6,11,0.545,13,14,0.929,0,4,4,2,1,0,1,3,45,3,1,BOS,BOS,MIN,127,31.5,Pts+Asts,51,49,47,6
Jayson Tatum,F,22023,1628369,22300517,"JAN 10, 2024",BOS vs. MIN,W,42,13,26,0.5,6,11,0.545,13,14,0.929,0,4,4,2,1,0,1,3,45,3,1,BOS,BOS,MIN,127,13.0,Rebs+Asts,51,49,47,6
Jayson Tatum,F,22023,1628369,22300517,"JAN 10, 2024",BOS vs. MIN,W,42,13,26,0.5,6,11,0.545,13,14,0.929,0,4,4,2,1,0,1,3,45,3,1,BOS,BOS,MIN,127,1.5,Blks+Stls,51,49,47,6
Jayson Tatum,F,22023,1628369,22300421,"DEC 28, 2023",BOS vs. DET,W,43,11,31,0.355,2,11,0.182,7,8,0.875,2,5,7,10,5,0,3,4,31,10,1,BOS,BOS,DET,128,26.5,Points,48,38,41,17
Jayson Tatum,F,22023,1628369,22300421,"DEC 28, 2023",BOS vs. DET,W,43,11,31,0.355,2,11,0.182,7,8,0.875,2,5,7,10,5,0,3,4,31,10,1,BOS,BOS,DET,128,8.5,Rebounds,48,38,41,17
Jayson Tatum,F,22023,1628369,22300421,"DEC 28, 2023",BOS vs. DET,W,43,11,31,0.355,2,11,0.182,7,8,0.875,2,5,7,10,5,0,3,4,31,10,1,BOS,BOS,DET,128,39.5,Pts+Rebs+Asts,48,38,41,17
Jayson Tatum,F,22023,1628369,22300421,"DEC 28, 2023",BOS vs. DET,W,43,11,31,0.355,2,11,0.182,7,8,0.875,2,5,7,10,5,0,3,4,31,10,1,BOS,BOS,DET,128,4.5,Assists,48,38,41,17
Jayson Tatum,F,22023,1628369,22300421,"DEC 28, 2023",BOS vs. DET,W,43,11,31,0.355,2,11,0.182,7,8,0.875,2,5,7,10,5,0,3,4,31,10,1,BOS,BOS,DET,128,45.5,Fantasy Score,48,38,41,17
Jayson Tatum,F,22023,1628369,22300421,"DEC 28, 2023",BOS vs. DET,W,43,11,31,0.355,2,11,0.182,7,8,0.875,2,5,7,10,5,0,3,4,31,10,1,BOS,BOS,DET,128,7.0,Defensive Rebounds,48,38,41,17
Jayson Tatum,F,22023,1628369,22300421,"DEC 28, 2023",BOS vs. DET,W,43,11,31,0.355,2,11,0.182,7,8,0.875,2,5,7,10,5,0,3,4,31,10,1,BOS,BOS,DET,128,9.0,3-PT Attempted,48,38,41,17
Jayson Tatum,F,22023,1628369,22300421,"DEC 28, 2023",BOS vs. DET,W,43,11,31,0.355,2,11,0.182,7,8,0.875,2,5,7,10,5,0,3,4,31,10,1,BOS,BOS,DET,128,5.5,Free Throws Made,48,38,41,17
Jayson Tatum,F,22023,1628369,22300421,"DEC 28, 2023",BOS vs. DET,W,43,11,31,0.355,2,11,0.182,7,8,0.875,2,5,7,10,5,0,3,4,31,10,1,BOS,BOS,DET,128,19.5,FG Attempted,48,38,41,17
Jayson Tatum,F,22023,1628369,22300421,"DEC 28, 2023",BOS vs. DET,W,43,11,31,0.355,2,11,0.182,7,8,0.875,2,5,7,10,5,0,3,4,31,10,1,BOS,BOS,DET,128,35.5,Pts+Rebs,48,38,41,17
Jayson Tatum,F,22023,1628369,22300421,"DEC 28, 2023",BOS vs. DET,W,43,11,31,0.355,2,11,0.182,7,8,0.875,2,5,7,10,5,0,3,4,31,10,1,BOS,BOS,DET,128,31.5,Pts+Asts,48,38,41,17
Jayson Tatum,F,22023,1628369,22300421,"DEC 28, 2023",BOS vs. DET,W,43,11,31,0.355,2,11,0.182,7,8,0.875,2,5,7,10,5,0,3,4,31,10,1,BOS,BOS,DET,128,13.0,Rebs+Asts,48,38,41,17
Jayson Tatum,F,22023,1628369,22300421,"DEC 28, 2023",BOS vs. DET,W,43,11,31,0.355,2,11,0.182,7,8,0.875,2,5,7,10,5,0,3,4,31,10,1,BOS,BOS,DET,128,1.5,Blks+Stls,48,38,41,17
Jayson Tatum,F,22023,1628369,22300362,"DEC 19, 2023",BOS @ GSW,L,41,5,17,0.294,2,9,0.222,3,3,1.0,3,5,8,7,2,0,0,0,15,-9,1,BOS,GSW,BOS,126,26.5,Points,30,23,22,15
Jayson Tatum,F,22023,1628369,22300362,"DEC 19, 2023",BOS @ GSW,L,41,5,17,0.294,2,9,0.222,3,3,1.0,3,5,8,7,2,0,0,0,15,-9,1,BOS,GSW,BOS,126,8.5,Rebounds,30,23,22,15
Jayson Tatum,F,22023,1628369,22300362,"DEC 19, 2023",BOS @ GSW,L,41,5,17,0.294,2,9,0.222,3,3,1.0,3,5,8,7,2,0,0,0,15,-9,1,BOS,GSW,BOS,126,39.5,Pts+Rebs+Asts,30,23,22,15
Jayson Tatum,F,22023,1628369,22300362,"DEC 19, 2023",BOS @ GSW,L,41,5,17,0.294,2,9,0.222,3,3,1.0,3,5,8,7,2,0,0,0,15,-9,1,BOS,GSW,BOS,126,4.5,Assists,30,23,22,15
Jayson Tatum,F,22023,1628369,22300362,"DEC 19, 2023",BOS @ GSW,L,41,5,17,0.294,2,9,0.222,3,3,1.0,3,5,8,7,2,0,0,0,15,-9,1,BOS,GSW,BOS,126,45.5,Fantasy Score,30,23,22,15
Jayson Tatum,F,22023,1628369,22300362,"DEC 19, 2023",BOS @ GSW,L,41,5,17,0.294,2,9,0.222,3,3,1.0,3,5,8,7,2,0,0,0,15,-9,1,BOS,GSW,BOS,126,7.0,Defensive Rebounds,30,23,22,15
Jayson Tatum,F,22023,1628369,22300362,"DEC 19, 2023",BOS @ GSW,L,41,5,17,0.294,2,9,0.222,3,3,1.0,3,5,8,7,2,0,0,0,15,-9,1,BOS,GSW,BOS,126,9.0,3-PT Attempted,30,23,22,15
Jayson Tatum,F,22023,1628369,22300362,"DEC 19, 2023",BOS @ GSW,L,41,5,17,0.294,2,9,0.222,3,3,1.0,3,5,8,7,2,0,0,0,15,-9,1,BOS,GSW,BOS,126,5.5,Free Throws Made,30,23,22,15
Jayson Tatum,F,22023,1628369,22300362,"DEC 19, 2023",BOS @ GSW,L,41,5,17,0.294,2,9,0.222,3,3,1.0,3,5,8,7,2,0,0,0,15,-9,1,BOS,GSW,BOS,126,19.5,FG Attempted,30,23,22,15
Jayson Tatum,F,22023,1628369,22300362,"DEC 19, 2023",BOS @ GSW,L,41,5,17,0.294,2,9,0.222,3,3,1.0,3,5,8,7,2,0,0,0,15,-9,1,BOS,GSW,BOS,126,35.5,Pts+Rebs,30,23,22,15
Jayson Tatum,F,22023,1628369,22300362,"DEC 19, 2023",BOS @ GSW,L,41,5,17,0.294,2,9,0.222,3,3,1.0,3,5,8,7,2,0,0,0,15,-9,1,BOS,GSW,BOS,126,31.5,Pts+Asts,30,23,22,15
Jayson Tatum,F,22023,1628369,22300362,"DEC 19, 2023",BOS @ GSW,L,41,5,17,0.294,2,9,0.222,3,3,1.0,3,5,8,7,2,0,0,0,15,-9,1,BOS,GSW,BOS,126,13.0,Rebs+Asts,30,23,22,15
Jayson Tatum,F,22023,1628369,22300362,"DEC 19, 2023",BOS @ GSW,L,41,5,17,0.294,2,9,0.222,3,3,1.0,3,5,8,7,2,0,0,0,15,-9,1,BOS,GSW,BOS,126,1.5,Blks+Stls,30,23,22,15
Jayson Tatum,F,22023,1628369,22300329,"DEC 15, 2023",BOS vs. ORL,W,39,11,22,0.5,2,9,0.222,6,9,0.667,0,6,6,4,0,0,2,3,30,14,1,BOS,BOS,ORL,128,26.5,Points,40,36,34,10
Jayson Tatum,F,22023,1628369,22300329,"DEC 15, 2023",BOS vs. ORL,W,39,11,22,0.5,2,9,0.222,6,9,0.667,0,6,6,4,0,0,2,3,30,14,1,BOS,BOS,ORL,128,8.5,Rebounds,40,36,34,10
Jayson Tatum,F,22023,1628369,22300329,"DEC 15, 2023",BOS vs. ORL,W,39,11,22,0.5,2,9,0.222,6,9,0.667,0,6,6,4,0,0,2,3,30,14,1,BOS,BOS,ORL,128,39.5,Pts+Rebs+Asts,40,36,34,10
Jayson Tatum,F,22023,1628369,22300329,"DEC 15, 2023",BOS vs. ORL,W,39,11,22,0.5,2,9,0.222,6,9,0.667,0,6,6,4,0,0,2,3,30,14,1,BOS,BOS,ORL,128,4.5,Assists,40,36,34,10
Jayson Tatum,F,22023,1628369,22300329,"DEC 15, 2023",BOS vs. ORL,W,39,11,22,0.5,2,9,0.222,6,9,0.667,0,6,6,4,0,0,2,3,30,14,1,BOS,BOS,ORL,128,45.5,Fantasy Score,40,36,34,10
Jayson Tatum,F,22023,1628369,22300329,"DEC 15, 2023",BOS vs. ORL,W,39,11,22,0.5,2,9,0.222,6,9,0.667,0,6,6,4,0,0,2,3,30,14,1,BOS,BOS,ORL,128,7.0,Defensive Rebounds,40,36,34,10
Jayson Tatum,F,22023,1628369,22300329,"DEC 15, 2023",BOS vs. ORL,W,39,11,22,0.5,2,9,0.222,6,9,0.667,0,6,6,4,0,0,2,3,30,14,1,BOS,BOS,ORL,128,9.0,3-PT Attempted,40,36,34,10
Jayson Tatum,F,22023,1628369,22300329,"DEC 15, 2023",BOS vs. ORL,W,39,11,22,0.5,2,9,0.222,6,9,0.667,0,6,6,4,0,0,2,3,30,14,1,BOS,BOS,ORL,128,5.5,Free Throws Made,40,36,34,10
Jayson Tatum,F,22023,1628369,22300329,"DEC 15, 2023",BOS vs. ORL,W,39,11,22,0.5,2,9,0.222,6,9,0.667,0,6,6,4,0,0,2,3,30,14,1,BOS,BOS,ORL,128,19.5,FG Attempted,40,36,34,10
Jayson Tatum,F,22023,1628369,22300329,"DEC 15, 2023",BOS vs. ORL,W,39,11,22,0.5,2,9,0.222,6,9,0.667,0,6,6,4,0,0,2,3,30,14,1,BOS,BOS,ORL,128,35.5,Pts+Rebs,40,36,34,10
Jayson Tatum,F,22023,1628369,22300329,"DEC 15, 2023",BOS vs. ORL,W,39,11,22,0.5,2,9,0.222,6,9,0.667,0,6,6,4,0,0,2,3,30,14,1,BOS,BOS,ORL,128,31.5,Pts+Asts,40,36,34,10
Jayson Tatum,F,22023,1628369,22300329,"DEC 15, 2023",BOS vs. ORL,W,39,11,22,0.5,2,9,0.222,6,9,0.667,0,6,6,4,0,0,2,3,30,14,1,BOS,BOS,ORL,128,13.0,Rebs+Asts,40,36,34,10
Jayson Tatum,F,22023,1628369,22300329,"DEC 15, 2023",BOS vs. ORL,W,39,11,22,0.5,2,9,0.222,6,9,0.667,0,6,6,4,0,0,2,3,30,14,1,BOS,BOS,ORL,128,1.5,Blks+Stls,40,36,34,10
Jayson Tatum,F,22023,1628369,22300217,"NOV 20, 2023",BOS @ CHA,L,44,15,28,0.536,7,15,0.467,8,10,0.8,0,13,13,6,0,2,3,1,45,-5,1,BOS,CHA,BOS,118,26.5,Points,64,58,51,19
Jayson Tatum,F,22023,1628369,22300217,"NOV 20, 2023",BOS @ CHA,L,44,15,28,0.536,7,15,0.467,8,10,0.8,0,13,13,6,0,2,3,1,45,-5,1,BOS,CHA,BOS,118,8.5,Rebounds,64,58,51,19
Jayson Tatum,F,22023,1628369,22300217,"NOV 20, 2023",BOS @ CHA,L,44,15,28,0.536,7,15,0.467,8,10,0.8,0,13,13,6,0,2,3,1,45,-5,1,BOS,CHA,BOS,118,39.5,Pts+Rebs+Asts,64,58,51,19
Jayson Tatum,F,22023,1628369,22300217,"NOV 20, 2023",BOS @ CHA,L,44,15,28,0.536,7,15,0.467,8,10,0.8,0,13,13,6,0,2,3,1,45,-5,1,BOS,CHA,BOS,118,4.5,Assists,64,58,51,19
Jayson Tatum,F,22023,1628369,22300217,"NOV 20, 2023",BOS @ CHA,L,44,15,28,0.536,7,15,0.467,8,10,0.8,0,13,13,6,0,2,3,1,45,-5,1,BOS,CHA,BOS,118,45.5,Fantasy Score,64,58,51,19
Jayson Tatum,F,22023,1628369,22300217,"NOV 20, 2023",BOS @ CHA,L,44,15,28,0.536,7,15,0.467,8,10,0.8,0,13,13,6,0,2,3,1,45,-5,1,BOS,CHA,BOS,118,7.0,Defensive Rebounds,64,58,51,19
Jayson Tatum,F,22023,1628369,22300217,"NOV 20, 2023",BOS @ CHA,L,44,15,28,0.536,7,15,0.467,8,10,0.8,0,13,13,6,0,2,3,1,45,-5,1,BOS,CHA,BOS,118,9.0,3-PT Attempted,64,58,51,19
Jayson Tatum,F,22023,1628369,22300217,"NOV 20, 2023",BOS @ CHA,L,44,15,28,0.536,7,15,0.467,8,10,0.8,0,13,13,6,0,2,3,1,45,-5,1,BOS,CHA,BOS,118,5.5,Free Throws Made,64,58,51,19
Jayson Tatum,F,22023,1628369,22300217,"NOV 20, 2023",BOS @ CHA,L,44,15,28,0.536,7,15,0.467,8,10,0.8,0,13,13,6,0,2,3,1,45,-5,1,BOS,CHA,BOS,118,19.5,FG Attempted,64,58,51,19
Jayson Tatum,F,22023,1628369,22300217,"NOV 20, 2023",BOS @ CHA,L,44,15,28,0.536,7,15,0.467,8,10,0.8,0,13,13,6,0,2,3,1,45,-5,1,BOS,CHA,BOS,118,35.5,Pts+Rebs,64,58,51,19
Jayson Tatum,F,22023,1628369,22300217,"NOV 20, 2023",BOS @ CHA,L,44,15,28,0.536,7,15,0.467,8,10,0.8,0,13,13,6,0,2,3,1,45,-5,1,BOS,CHA,BOS,118,31.5,Pts+Asts,64,58,51,19
Jayson Tatum,F,22023,1628369,22300217,"NOV 20, 2023",BOS @ CHA,L,44,15,28,0.536,7,15,0.467,8,10,0.8,0,13,13,6,0,2,3,1,45,-5,1,BOS,CHA,BOS,118,13.0,Rebs+Asts,64,58,51,19
Jayson Tatum,F,22023,1628369,22300217,"NOV 20, 2023",BOS @ CHA,L,44,15,28,0.536,7,15,0.467,8,10,0.8,0,13,13,6,0,2,3,1,45,-5,1,BOS,CHA,BOS,118,1.5,Blks+Stls,64,58,51,19
Jayson Tatum,F,22023,1628369,22300136,"NOV 04, 2023",BOS @ BKN,W,41,10,20,0.5,6,10,0.6,6,6,1.0,1,10,11,1,0,0,3,1,32,18,1,BOS,BKN,BOS,124,26.5,Points,44,43,33,12
Jayson Tatum,F,22023,1628369,22300136,"NOV 04, 2023",BOS @ BKN,W,41,10,20,0.5,6,10,0.6,6,6,1.0,1,10,11,1,0,0,3,1,32,18,1,BOS,BKN,BOS,124,8.5,Rebounds,44,43,33,12
Jayson Tatum,F,22023,1628369,22300136,"NOV 04, 2023",BOS @ BKN,W,41,10,20,0.5,6,10,0.6,6,6,1.0,1,10,11,1,0,0,3,1,32,18,1,BOS,BKN,BOS,124,39.5,Pts+Rebs+Asts,44,43,33,12
Jayson Tatum,F,22023,1628369,22300136,"NOV 04, 2023",BOS @ BKN,W,41,10,20,0.5,6,10,0.6,6,6,1.0,1,10,11,1,0,0,3,1,32,18,1,BOS,BKN,BOS,124,4.5,Assists,44,43,33,12
Jayson Tatum,F,22023,1628369,22300136,"NOV 04, 2023",BOS @ BKN,W,41,10,20,0.5,6,10,0.6,6,6,1.0,1,10,11,1,0,0,3,1,32,18,1,BOS,BKN,BOS,124,45.5,Fantasy Score,44,43,33,12
Jayson Tatum,F,22023,1628369,22300136,"NOV 04, 2023",BOS @ BKN,W,41,10,20,0.5,6,10,0.6,6,6,1.0,1,10,11,1,0,0,3,1,32,18,1,BOS,BKN,BOS,124,7.0,Defensive Rebounds,44,43,33,12
Jayson Tatum,F,22023,1628369,22300136,"NOV 04, 2023",BOS @ BKN,W,41,10,20,0.5,6,10,0.6,6,6,1.0,1,10,11,1,0,0,3,1,32,18,1,BOS,BKN,BOS,124,9.0,3-PT Attempted,44,43,33,12
Jayson Tatum,F,22023,1628369,22300136,"NOV 04, 2023",BOS @ BKN,W,41,10,20,0.5,6,10,0.6,6,6,1.0,1,10,11,1,0,0,3,1,32,18,1,BOS,BKN,BOS,124,5.5,Free Throws Made,44,43,33,12
Jayson Tatum,F,22023,1628369,22300136,"NOV 04, 2023",BOS @ BKN,W,41,10,20,0.5,6,10,0.6,6,6,1.0,1,10,11,1,0,0,3,1,32,18,1,BOS,BKN,BOS,124,19.5,FG Attempted,44,43,33,12
Jayson Tatum,F,22023,1628369,22300136,"NOV 04, 2023",BOS @ BKN,W,41,10,20,0.5,6,10,0.6,6,6,1.0,1,10,11,1,0,0,3,1,32,18,1,BOS,BKN,BOS,124,35.5,Pts+Rebs,44,43,33,12
Jayson Tatum,F,22023,1628369,22300136,"NOV 04, 2023",BOS @ BKN,W,41,10,20,0.5,6,10,0.6,6,6,1.0,1,10,11,1,0,0,3,1,32,18,1,BOS,BKN,BOS,124,31.5,Pts+Asts,44,43,33,12
Jayson Tatum,F,22023,1628369,22300136,"NOV 04, 2023",BOS @ BKN,W,41,10,20,0.5,6,10,0.6,6,6,1.0,1,10,11,1,0,0,3,1,32,18,1,BOS,BKN,BOS,124,13.0,Rebs+Asts,44,43,33,12
Jayson Tatum,F,22023,1628369,22300136,"NOV 04, 2023",BOS @ BKN,W,41,10,20,0.5,6,10,0.6,6,6,1.0,1,10,11,1,0,0,3,1,32,18,1,BOS,BKN,BOS,124,1.5,Blks+Stls,44,43,33,12
Jayson Tatum,F,22023,1628369,22300080,"OCT 27, 2023",BOS vs. MIA,W,41,9,22,0.409,3,10,0.3,1,3,0.333,0,8,8,5,1,0,2,4,22,13,1,BOS,BOS,MIA,119,26.5,Points,35,30,27,13
Jayson Tatum,F,22023,1628369,22300080,"OCT 27, 2023",BOS vs. MIA,W,41,9,22,0.409,3,10,0.3,1,3,0.333,0,8,8,5,1,0,2,4,22,13,1,BOS,BOS,MIA,119,8.5,Rebounds,35,30,27,13
Jayson Tatum,F,22023,1628369,22300080,"OCT 27, 2023",BOS vs. MIA,W,41,9,22,0.409,3,10,0.3,1,3,0.333,0,8,8,5,1,0,2,4,22,13,1,BOS,BOS,MIA,119,39.5,Pts+Rebs+Asts,35,30,27,13
Jayson Tatum,F,22023,1628369,22300080,"OCT 27, 2023",BOS vs. MIA,W,41,9,22,0.409,3,10,0.3,1,3,0.333,0,8,8,5,1,0,2,4,22,13,1,BOS,BOS,MIA,119,4.5,Assists,35,30,27,13
Jayson Tatum,F,22023,1628369,22300080,"OCT 27, 2023",BOS vs. MIA,W,41,9,22,0.409,3,10,0.3,1,3,0.333,0,8,8,5,1,0,2,4,22,13,1,BOS,BOS,MIA,119,45.5,Fantasy Score,35,30,27,13
Jayson Tatum,F,22023,1628369,22300080,"OCT 27, 2023",BOS vs. MIA,W,41,9,22,0.409,3,10,0.3,1,3,0.333,0,8,8,5,1,0,2,4,22,13,1,BOS,BOS,MIA,119,7.0,Defensive Rebounds,35,30,27,13
Jayson Tatum,F,22023,1628369,22300080,"OCT 27, 2023",BOS vs. MIA,W,41,9,22,0.409,3,10,0.3,1,3,0.333,0,8,8,5,1,0,2,4,22,13,1,BOS,BOS,MIA,119,9.0,3-PT Attempted,35,30,27,13
Jayson Tatum,F,22023,1628369,22300080,"OCT 27, 2023",BOS vs. MIA,W,41,9,22,0.409,3,10,0.3,1,3,0.333,0,8,8,5,1,0,2,4,22,13,1,BOS,BOS,MIA,119,5.5,Free Throws Made,35,30,27,13
Jayson Tatum,F,22023,1628369,22300080,"OCT 27, 2023",BOS vs. MIA,W,41,9,22,0.409,3,10,0.3,1,3,0.333,0,8,8,5,1,0,2,4,22,13,1,BOS,BOS,MIA,119,19.5,FG Attempted,35,30,27,13
Jayson Tatum,F,22023,1628369,22300080,"OCT 27, 2023",BOS vs. MIA,W,41,9,22,0.409,3,10,0.3,1,3,0.333,0,8,8,5,1,0,2,4,22,13,1,BOS,BOS,MIA,119,35.5,Pts+Rebs,35,30,27,13
Jayson Tatum,F,22023,1628369,22300080,"OCT 27, 2023",BOS vs. MIA,W,41,9,22,0.409,3,10,0.3,1,3,0.333,0,8,8,5,1,0,2,4,22,13,1,BOS,BOS,MIA,119,31.5,Pts+Asts,35,30,27,13
Jayson Tatum,F,22023,1628369,22300080,"OCT 27, 2023",BOS vs. MIA,W,41,9,22,0.409,3,10,0.3,1,3,0.333,0,8,8,5,1,0,2,4,22,13,1,BOS,BOS,MIA,119,13.0,Rebs+Asts,35,30,27,13
Jayson Tatum,F,22023,1628369,22300080,"OCT 27, 2023",BOS vs. MIA,W,41,9,22,0.409,3,10,0.3,1,3,0.333,0,8,8,5,1,0,2,4,22,13,1,BOS,BOS,MIA,119,1.5,Blks+Stls,35,30,27,13
Jayson Tatum,F,22023,1628369,22300743,"FEB 09, 2024",BOS vs. WAS,W,38,12,22,0.545,3,10,0.3,8,9,0.889,1,9,10,8,1,2,2,1,35,9,1,BOS,BOS,WAS,133,26.5,Points,53,45,43,18
Jayson Tatum,F,22023,1628369,22300743,"FEB 09, 2024",BOS vs. WAS,W,38,12,22,0.545,3,10,0.3,8,9,0.889,1,9,10,8,1,2,2,1,35,9,1,BOS,BOS,WAS,133,8.5,Rebounds,53,45,43,18
Jayson Tatum,F,22023,1628369,22300743,"FEB 09, 2024",BOS vs. WAS,W,38,12,22,0.545,3,10,0.3,8,9,0.889,1,9,10,8,1,2,2,1,35,9,1,BOS,BOS,WAS,133,39.5,Pts+Rebs+Asts,53,45,43,18
Jayson Tatum,F,22023,1628369,22300743,"FEB 09, 2024",BOS vs. WAS,W,38,12,22,0.545,3,10,0.3,8,9,0.889,1,9,10,8,1,2,2,1,35,9,1,BOS,BOS,WAS,133,4.5,Assists,53,45,43,18
Jayson Tatum,F,22023,1628369,22300743,"FEB 09, 2024",BOS vs. WAS,W,38,12,22,0.545,3,10,0.3,8,9,0.889,1,9,10,8,1,2,2,1,35,9,1,BOS,BOS,WAS,133,45.5,Fantasy Score,53,45,43,18
Jayson Tatum,F,22023,1628369,22300743,"FEB 09, 2024",BOS vs. WAS,W,38,12,22,0.545,3,10,0.3,8,9,0.889,1,9,10,8,1,2,2,1,35,9,1,BOS,BOS,WAS,133,7.0,Defensive Rebounds,53,45,43,18
Jayson Tatum,F,22023,1628369,22300743,"FEB 09, 2024",BOS vs. WAS,W,38,12,22,0.545,3,10,0.3,8,9,0.889,1,9,10,8,1,2,2,1,35,9,1,BOS,BOS,WAS,133,9.0,3-PT Attempted,53,45,43,18
Jayson Tatum,F,22023,1628369,22300743,"FEB 09, 2024",BOS vs. WAS,W,38,12,22,0.545,3,10,0.3,8,9,0.889,1,9,10,8,1,2,2,1,35,9,1,BOS,BOS,WAS,133,5.5,Free Throws Made,53,45,43,18
Jayson Tatum,F,22023,1628369,22300743,"FEB 09, 2024",BOS vs. WAS,W,38,12,22,0.545,3,10,0.3,8,9,0.889,1,9,10,8,1,2,2,1,35,9,1,BOS,BOS,WAS,133,19.5,FG Attempted,53,45,43,18
Jayson Tatum,F,22023,1628369,22300743,"FEB 09, 2024",BOS vs. WAS,W,38,12,22,0.545,3,10,0.3,8,9,0.889,1,9,10,8,1,2,2,1,35,9,1,BOS,BOS,WAS,133,35.5,Pts+Rebs,53,45,43,18
Jayson Tatum,F,22023,1628369,22300743,"FEB 09, 2024",BOS vs. WAS,W,38,12,22,0.545,3,10,0.3,8,9,0.889,1,9,10,8,1,2,2,1,35,9,1,BOS,BOS,WAS,133,31.5,Pts+Asts,53,45,43,18
Jayson Tatum,F,22023,1628369,22300743,"FEB 09, 2024",BOS vs. WAS,W,38,12,22,0.545,3,10,0.3,8,9,0.889,1,9,10,8,1,2,2,1,35,9,1,BOS,BOS,WAS,133,13.0,Rebs+Asts,53,45,43,18
Jayson Tatum,F,22023,1628369,22300743,"FEB 09, 2024",BOS vs. WAS,W,38,12,22,0.545,3,10,0.3,8,9,0.889,1,9,10,8,1,2,2,1,35,9,1,BOS,BOS,WAS,133,1.5,Blks+Stls,53,45,43,18
Jayson Tatum,F,22023,1628369,22300611,"JAN 22, 2024",BOS @ DAL,W,41,11,21,0.524,2,8,0.25,15,19,0.789,0,11,11,5,3,2,0,4,39,27,1,BOS,DAL,BOS,119,26.5,Points,55,50,44,16
Jayson Tatum,F,22023,1628369,22300611,"JAN 22, 2024",BOS @ DAL,W,41,11,21,0.524,2,8,0.25,15,19,0.789,0,11,11,5,3,2,0,4,39,27,1,BOS,DAL,BOS,119,8.5,Rebounds,55,50,44,16
Jayson Tatum,F,22023,1628369,22300611,"JAN 22, 2024",BOS @ DAL,W,41,11,21,0.524,2,8,0.25,15,19,0.789,0,11,11,5,3,2,0,4,39,27,1,BOS,DAL,BOS,119,39.5,Pts+Rebs+Asts,55,50,44,16
Jayson Tatum,F,22023,1628369,22300611,"JAN 22, 2024",BOS @ DAL,W,41,11,21,0.524,2,8,0.25,15,19,0.789,0,11,11,5,3,2,0,4,39,27,1,BOS,DAL,BOS,119,4.5,Assists,55,50,44,16
Jayson Tatum,F,22023,1628369,22300611,"JAN 22, 2024",BOS @ DAL,W,41,11,21,0.524,2,8,0.25,15,19,0.789,0,11,11,5,3,2,0,4,39,27,1,BOS,DAL,BOS,119,45.5,Fantasy Score,55,50,44,16
Jayson Tatum,F,22023,1628369,22300611,"JAN 22, 2024",BOS @ DAL,W,41,11,21,0.524,2,8,0.25,15,19,0.789,0,11,11,5,3,2,0,4,39,27,1,BOS,DAL,BOS,119,7.0,Defensive Rebounds,55,50,44,16
Jayson Tatum,F,22023,1628369,22300611,"JAN 22, 2024",BOS @ DAL,W,41,11,21,0.524,2,8,0.25,15,19,0.789,0,11,11,5,3,2,0,4,39,27,1,BOS,DAL,BOS,119,9.0,3-PT Attempted,55,50,44,16
Jayson Tatum,F,22023,1628369,22300611,"JAN 22, 2024",BOS @ DAL,W,41,11,21,0.524,2,8,0.25,15,19,0.789,0,11,11,5,3,2,0,4,39,27,1,BOS,DAL,BOS,119,5.5,Free Throws Made,55,50,44,16
Jayson Tatum,F,22023,1628369,22300611,"JAN 22, 2024",BOS @ DAL,W,41,11,21,0.524,2,8,0.25,15,19,0.789,0,11,11,5,3,2,0,4,39,27,1,BOS,DAL,BOS,119,19.5,FG Attempted,55,50,44,16
Jayson Tatum,F,22023,1628369,22300611,"JAN 22, 2024",BOS @ DAL,W,41,11,21,0.524,2,8,0.25,15,19,0.789,0,11,11,5,3,2,0,4,39,27,1,BOS,DAL,BOS,119,35.5,Pts+Rebs,55,50,44,16
Jayson Tatum,F,22023,1628369,22300611,"JAN 22, 2024",BOS @ DAL,W,41,11,21,0.524,2,8,0.25,15,19,0.789,0,11,11,5,3,2,0,4,39,27,1,BOS,DAL,BOS,119,31.5,Pts+Asts,55,50,44,16
Jayson Tatum,F,22023,1628369,22300611,"JAN 22, 2024",BOS @ DAL,W,41,11,21,0.524,2,8,0.25,15,19,0.789,0,11,11,5,3,2,0,4,39,27,1,BOS,DAL,BOS,119,13.0,Rebs+Asts,55,50,44,16
Jayson Tatum,F,22023,1628369,22300611,"JAN 22, 2024",BOS @ DAL,W,41,11,21,0.524,2,8,0.25,15,19,0.789,0,11,11,5,3,2,0,4,39,27,1,BOS,DAL,BOS,119,1.5,Blks+Stls,55,50,44,16
Jayson Tatum,F,22023,1628369,22300586,"JAN 19, 2024",BOS vs. DEN,L,39,9,24,0.375,1,8,0.125,3,3,1.0,2,6,8,5,1,0,0,1,22,6,1,BOS,BOS,DEN,100,26.5,Points,35,30,27,13
Jayson Tatum,F,22023,1628369,22300586,"JAN 19, 2024",BOS vs. DEN,L,39,9,24,0.375,1,8,0.125,3,3,1.0,2,6,8,5,1,0,0,1,22,6,1,BOS,BOS,DEN,100,8.5,Rebounds,35,30,27,13
Jayson Tatum,F,22023,1628369,22300586,"JAN 19, 2024",BOS vs. DEN,L,39,9,24,0.375,1,8,0.125,3,3,1.0,2,6,8,5,1,0,0,1,22,6,1,BOS,BOS,DEN,100,39.5,Pts+Rebs+Asts,35,30,27,13
Jayson Tatum,F,22023,1628369,22300586,"JAN 19, 2024",BOS vs. DEN,L,39,9,24,0.375,1,8,0.125,3,3,1.0,2,6,8,5,1,0,0,1,22,6,1,BOS,BOS,DEN,100,4.5,Assists,35,30,27,13
Jayson Tatum,F,22023,1628369,22300586,"JAN 19, 2024",BOS vs. DEN,L,39,9,24,0.375,1,8,0.125,3,3,1.0,2,6,8,5,1,0,0,1,22,6,1,BOS,BOS,DEN,100,45.5,Fantasy Score,35,30,27,13
Jayson Tatum,F,22023,1628369,22300586,"JAN 19, 2024",BOS vs. DEN,L,39,9,24,0.375,1,8,0.125,3,3,1.0,2,6,8,5,1,0,0,1,22,6,1,BOS,BOS,DEN,100,7.0,Defensive Rebounds,35,30,27,13
Jayson Tatum,F,22023,1628369,22300586,"JAN 19, 2024",BOS vs. DEN,L,39,9,24,0.375,1,8,0.125,3,3,1.0,2,6,8,5,1,0,0,1,22,6,1,BOS,BOS,DEN,100,9.0,3-PT Attempted,35,30,27,13
Jayson Tatum,F,22023,1628369,22300586,"JAN 19, 2024",BOS vs. DEN,L,39,9,24,0.375,1,8,0.125,3,3,1.0,2,6,8,5,1,0,0,1,22,6,1,BOS,BOS,DEN,100,5.5,Free Throws Made,35,30,27,13
Jayson Tatum,F,22023,1628369,22300586,"JAN 19, 2024",BOS vs. DEN,L,39,9,24,0.375,1,8,0.125,3,3,1.0,2,6,8,5,1,0,0,1,22,6,1,BOS,BOS,DEN,100,19.5,FG Attempted,35,30,27,13
Jayson Tatum,F,22023,1628369,22300586,"JAN 19, 2024",BOS vs. DEN,L,39,9,24,0.375,1,8,0.125,3,3,1.0,2,6,8,5,1,0,0,1,22,6,1,BOS,BOS,DEN,100,35.5,Pts+Rebs,35,30,27,13
Jayson Tatum,F,22023,1628369,22300586,"JAN 19, 2024",BOS vs. DEN,L,39,9,24,0.375,1,8,0.125,3,3,1.0,2,6,8,5,1,0,0,1,22,6,1,BOS,BOS,DEN,100,31.5,Pts+Asts,35,30,27,13
Jayson Tatum,F,22023,1628369,22300586,"JAN 19, 2024",BOS vs. DEN,L,39,9,24,0.375,1,8,0.125,3,3,1.0,2,6,8,5,1,0,0,1,22,6,1,BOS,BOS,DEN,100,13.0,Rebs+Asts,35,30,27,13
Jayson Tatum,F,22023,1628369,22300586,"JAN 19, 2024",BOS vs. DEN,L,39,9,24,0.375,1,8,0.125,3,3,1.0,2,6,8,5,1,0,0,1,22,6,1,BOS,BOS,DEN,100,1.5,Blks+Stls,35,30,27,13
Jayson Tatum,F,22023,1628369,22300462,"JAN 02, 2024",BOS @ OKC,L,38,10,21,0.476,2,5,0.4,8,10,0.8,5,8,13,8,1,0,4,3,30,0,1,BOS,OKC,BOS,123,26.5,Points,51,43,38,21
Jayson Tatum,F,22023,1628369,22300462,"JAN 02, 2024",BOS @ OKC,L,38,10,21,0.476,2,5,0.4,8,10,0.8,5,8,13,8,1,0,4,3,30,0,1,BOS,OKC,BOS,123,8.5,Rebounds,51,43,38,21
Jayson Tatum,F,22023,1628369,22300462,"JAN 02, 2024",BOS @ OKC,L,38,10,21,0.476,2,5,0.4,8,10,0.8,5,8,13,8,1,0,4,3,30,0,1,BOS,OKC,BOS,123,39.5,Pts+Rebs+Asts,51,43,38,21
Jayson Tatum,F,22023,1628369,22300462,"JAN 02, 2024",BOS @ OKC,L,38,10,21,0.476,2,5,0.4,8,10,0.8,5,8,13,8,1,0,4,3,30,0,1,BOS,OKC,BOS,123,4.5,Assists,51,43,38,21
Jayson Tatum,F,22023,1628369,22300462,"JAN 02, 2024",BOS @ OKC,L,38,10,21,0.476,2,5,0.4,8,10,0.8,5,8,13,8,1,0,4,3,30,0,1,BOS,OKC,BOS,123,45.5,Fantasy Score,51,43,38,21
Jayson Tatum,F,22023,1628369,22300462,"JAN 02, 2024",BOS @ OKC,L,38,10,21,0.476,2,5,0.4,8,10,0.8,5,8,13,8,1,0,4,3,30,0,1,BOS,OKC,BOS,123,7.0,Defensive Rebounds,51,43,38,21
Jayson Tatum,F,22023,1628369,22300462,"JAN 02, 2024",BOS @ OKC,L,38,10,21,0.476,2,5,0.4,8,10,0.8,5,8,13,8,1,0,4,3,30,0,1,BOS,OKC,BOS,123,9.0,3-PT Attempted,51,43,38,21
Jayson Tatum,F,22023,1628369,22300462,"JAN 02, 2024",BOS @ OKC,L,38,10,21,0.476,2,5,0.4,8,10,0.8,5,8,13,8,1,0,4,3,30,0,1,BOS,OKC,BOS,123,5.5,Free Throws Made,51,43,38,21
Jayson Tatum,F,22023,1628369,22300462,"JAN 02, 2024",BOS @ OKC,L,38,10,21,0.476,2,5,0.4,8,10,0.8,5,8,13,8,1,0,4,3,30,0,1,BOS,OKC,BOS,123,19.5,FG Attempted,51,43,38,21
Jayson Tatum,F,22023,1628369,22300462,"JAN 02, 2024",BOS @ OKC,L,38,10,21,0.476,2,5,0.4,8,10,0.8,5,8,13,8,1,0,4,3,30,0,1,BOS,OKC,BOS,123,35.5,Pts+Rebs,51,43,38,21
Jayson Tatum,F,22023,1628369,22300462,"JAN 02, 2024",BOS @ OKC,L,38,10,21,0.476,2,5,0.4,8,10,0.8,5,8,13,8,1,0,4,3,30,0,1,BOS,OKC,BOS,123,31.5,Pts+Asts,51,43,38,21
Jayson Tatum,F,22023,1628369,22300462,"JAN 02, 2024",BOS @ OKC,L,38,10,21,0.476,2,5,0.4,8,10,0.8,5,8,13,8,1,0,4,3,30,0,1,BOS,OKC,BOS,123,13.0,Rebs+Asts,51,43,38,21
Jayson Tatum,F,22023,1628369,22300462,"JAN 02, 2024",BOS @ OKC,L,38,10,21,0.476,2,5,0.4,8,10,0.8,5,8,13,8,1,0,4,3,30,0,1,BOS,OKC,BOS,123,1.5,Blks+Stls,51,43,38,21
Jayson Tatum,F,22023,1628369,22300403,"DEC 25, 2023",BOS @ LAL,W,41,6,15,0.4,1,6,0.167,12,13,0.923,0,8,8,7,0,1,1,0,25,10,1,BOS,LAL,BOS,126,26.5,Points,40,33,32,15
Jayson Tatum,F,22023,1628369,22300403,"DEC 25, 2023",BOS @ LAL,W,41,6,15,0.4,1,6,0.167,12,13,0.923,0,8,8,7,0,1,1,0,25,10,1,BOS,LAL,BOS,126,8.5,Rebounds,40,33,32,15
Jayson Tatum,F,22023,1628369,22300403,"DEC 25, 2023",BOS @ LAL,W,41,6,15,0.4,1,6,0.167,12,13,0.923,0,8,8,7,0,1,1,0,25,10,1,BOS,LAL,BOS,126,39.5,Pts+Rebs+Asts,40,33,32,15
Jayson Tatum,F,22023,1628369,22300403,"DEC 25, 2023",BOS @ LAL,W,41,6,15,0.4,1,6,0.167,12,13,0.923,0,8,8,7,0,1,1,0,25,10,1,BOS,LAL,BOS,126,4.5,Assists,40,33,32,15
Jayson Tatum,F,22023,1628369,22300403,"DEC 25, 2023",BOS @ LAL,W,41,6,15,0.4,1,6,0.167,12,13,0.923,0,8,8,7,0,1,1,0,25,10,1,BOS,LAL,BOS,126,45.5,Fantasy Score,40,33,32,15
Jayson Tatum,F,22023,1628369,22300403,"DEC 25, 2023",BOS @ LAL,W,41,6,15,0.4,1,6,0.167,12,13,0.923,0,8,8,7,0,1,1,0,25,10,1,BOS,LAL,BOS,126,7.0,Defensive Rebounds,40,33,32,15
Jayson Tatum,F,22023,1628369,22300403,"DEC 25, 2023",BOS @ LAL,W,41,6,15,0.4,1,6,0.167,12,13,0.923,0,8,8,7,0,1,1,0,25,10,1,BOS,LAL,BOS,126,9.0,3-PT Attempted,40,33,32,15
Jayson Tatum,F,22023,1628369,22300403,"DEC 25, 2023",BOS @ LAL,W,41,6,15,0.4,1,6,0.167,12,13,0.923,0,8,8,7,0,1,1,0,25,10,1,BOS,LAL,BOS,126,5.5,Free Throws Made,40,33,32,15
Jayson Tatum,F,22023,1628369,22300403,"DEC 25, 2023",BOS @ LAL,W,41,6,15,0.4,1,6,0.167,12,13,0.923,0,8,8,7,0,1,1,0,25,10,1,BOS,LAL,BOS,126,19.5,FG Attempted,40,33,32,15
Jayson Tatum,F,22023,1628369,22300403,"DEC 25, 2023",BOS @ LAL,W,41,6,15,0.4,1,6,0.167,12,13,0.923,0,8,8,7,0,1,1,0,25,10,1,BOS,LAL,BOS,126,35.5,Pts+Rebs,40,33,32,15
Jayson Tatum,F,22023,1628369,22300403,"DEC 25, 2023",BOS @ LAL,W,41,6,15,0.4,1,6,0.167,12,13,0.923,0,8,8,7,0,1,1,0,25,10,1,BOS,LAL,BOS,126,31.5,Pts+Asts,40,33,32,15
Jayson Tatum,F,22023,1628369,22300403,"DEC 25, 2023",BOS @ LAL,W,41,6,15,0.4,1,6,0.167,12,13,0.923,0,8,8,7,0,1,1,0,25,10,1,BOS,LAL,BOS,126,13.0,Rebs+Asts,40,33,32,15
Jayson Tatum,F,22023,1628369,22300403,"DEC 25, 2023",BOS @ LAL,W,41,6,15,0.4,1,6,0.167,12,13,0.923,0,8,8,7,0,1,1,0,25,10,1,BOS,LAL,BOS,126,1.5,Blks+Stls,40,33,32,15
Jayson Tatum,F,22023,1628369,22300319,"DEC 14, 2023",BOS vs. CLE,W,36,9,22,0.409,3,10,0.3,6,8,0.75,3,8,11,3,0,3,3,1,27,2,1,BOS,BOS,CLE,116,26.5,Points,41,38,30,14
Jayson Tatum,F,22023,1628369,22300319,"DEC 14, 2023",BOS vs. CLE,W,36,9,22,0.409,3,10,0.3,6,8,0.75,3,8,11,3,0,3,3,1,27,2,1,BOS,BOS,CLE,116,8.5,Rebounds,41,38,30,14
Jayson Tatum,F,22023,1628369,22300319,"DEC 14, 2023",BOS vs. CLE,W,36,9,22,0.409,3,10,0.3,6,8,0.75,3,8,11,3,0,3,3,1,27,2,1,BOS,BOS,CLE,116,39.5,Pts+Rebs+Asts,41,38,30,14
Jayson Tatum,F,22023,1628369,22300319,"DEC 14, 2023",BOS vs. CLE,W,36,9,22,0.409,3,10,0.3,6,8,0.75,3,8,11,3,0,3,3,1,27,2,1,BOS,BOS,CLE,116,4.5,Assists,41,38,30,14
Jayson Tatum,F,22023,1628369,22300319,"DEC 14, 2023",BOS vs. CLE,W,36,9,22,0.409,3,10,0.3,6,8,0.75,3,8,11,3,0,3,3,1,27,2,1,BOS,BOS,CLE,116,45.5,Fantasy Score,41,38,30,14
Jayson Tatum,F,22023,1628369,22300319,"DEC 14, 2023",BOS vs. CLE,W,36,9,22,0.409,3,10,0.3,6,8,0.75,3,8,11,3,0,3,3,1,27,2,1,BOS,BOS,CLE,116,7.0,Defensive Rebounds,41,38,30,14
Jayson Tatum,F,22023,1628369,22300319,"DEC 14, 2023",BOS vs. CLE,W,36,9,22,0.409,3,10,0.3,6,8,0.75,3,8,11,3,0,3,3,1,27,2,1,BOS,BOS,CLE,116,9.0,3-PT Attempted,41,38,30,14
Jayson Tatum,F,22023,1628369,22300319,"DEC 14, 2023",BOS vs. CLE,W,36,9,22,0.409,3,10,0.3,6,8,0.75,3,8,11,3,0,3,3,1,27,2,1,BOS,BOS,CLE,116,5.5,Free Throws Made,41,38,30,14
Jayson Tatum,F,22023,1628369,22300319,"DEC 14, 2023",BOS vs. CLE,W,36,9,22,0.409,3,10,0.3,6,8,0.75,3,8,11,3,0,3,3,1,27,2,1,BOS,BOS,CLE,116,19.5,FG Attempted,41,38,30,14
Jayson Tatum,F,22023,1628369,22300319,"DEC 14, 2023",BOS vs. CLE,W,36,9,22,0.409,3,10,0.3,6,8,0.75,3,8,11,3,0,3,3,1,27,2,1,BOS,BOS,CLE,116,35.5,Pts+Rebs,41,38,30,14
Jayson Tatum,F,22023,1628369,22300319,"DEC 14, 2023",BOS vs. CLE,W,36,9,22,0.409,3,10,0.3,6,8,0.75,3,8,11,3,0,3,3,1,27,2,1,BOS,BOS,CLE,116,31.5,Pts+Asts,41,38,30,14
Jayson Tatum,F,22023,1628369,22300319,"DEC 14, 2023",BOS vs. CLE,W,36,9,22,0.409,3,10,0.3,6,8,0.75,3,8,11,3,0,3,3,1,27,2,1,BOS,BOS,CLE,116,13.0,Rebs+Asts,41,38,30,14
Jayson Tatum,F,22023,1628369,22300319,"DEC 14, 2023",BOS vs. CLE,W,36,9,22,0.409,3,10,0.3,6,8,0.75,3,8,11,3,0,3,3,1,27,2,1,BOS,BOS,CLE,116,1.5,Blks+Stls,41,38,30,14
Jayson Tatum,F,22023,1628369,22300305,"DEC 12, 2023",BOS vs. CLE,W,41,7,19,0.368,2,9,0.222,9,9,1.0,0,10,10,5,0,2,4,3,25,9,1,BOS,BOS,CLE,120,26.5,Points,40,35,30,15
Jayson Tatum,F,22023,1628369,22300305,"DEC 12, 2023",BOS vs. CLE,W,41,7,19,0.368,2,9,0.222,9,9,1.0,0,10,10,5,0,2,4,3,25,9,1,BOS,BOS,CLE,120,8.5,Rebounds,40,35,30,15
Jayson Tatum,F,22023,1628369,22300305,"DEC 12, 2023",BOS vs. CLE,W,41,7,19,0.368,2,9,0.222,9,9,1.0,0,10,10,5,0,2,4,3,25,9,1,BOS,BOS,CLE,120,39.5,Pts+Rebs+Asts,40,35,30,15
Jayson Tatum,F,22023,1628369,22300305,"DEC 12, 2023",BOS vs. CLE,W,41,7,19,0.368,2,9,0.222,9,9,1.0,0,10,10,5,0,2,4,3,25,9,1,BOS,BOS,CLE,120,4.5,Assists,40,35,30,15
Jayson Tatum,F,22023,1628369,22300305,"DEC 12, 2023",BOS vs. CLE,W,41,7,19,0.368,2,9,0.222,9,9,1.0,0,10,10,5,0,2,4,3,25,9,1,BOS,BOS,CLE,120,45.5,Fantasy Score,40,35,30,15
Jayson Tatum,F,22023,1628369,22300305,"DEC 12, 2023",BOS vs. CLE,W,41,7,19,0.368,2,9,0.222,9,9,1.0,0,10,10,5,0,2,4,3,25,9,1,BOS,BOS,CLE,120,7.0,Defensive Rebounds,40,35,30,15
Jayson Tatum,F,22023,1628369,22300305,"DEC 12, 2023",BOS vs. CLE,W,41,7,19,0.368,2,9,0.222,9,9,1.0,0,10,10,5,0,2,4,3,25,9,1,BOS,BOS,CLE,120,9.0,3-PT Attempted,40,35,30,15
Jayson Tatum,F,22023,1628369,22300305,"DEC 12, 2023",BOS vs. CLE,W,41,7,19,0.368,2,9,0.222,9,9,1.0,0,10,10,5,0,2,4,3,25,9,1,BOS,BOS,CLE,120,5.5,Free Throws Made,40,35,30,15
Jayson Tatum,F,22023,1628369,22300305,"DEC 12, 2023",BOS vs. CLE,W,41,7,19,0.368,2,9,0.222,9,9,1.0,0,10,10,5,0,2,4,3,25,9,1,BOS,BOS,CLE,120,19.5,FG Attempted,40,35,30,15
Jayson Tatum,F,22023,1628369,22300305,"DEC 12, 2023",BOS vs. CLE,W,41,7,19,0.368,2,9,0.222,9,9,1.0,0,10,10,5,0,2,4,3,25,9,1,BOS,BOS,CLE,120,35.5,Pts+Rebs,40,35,30,15
Jayson Tatum,F,22023,1628369,22300305,"DEC 12, 2023",BOS vs. CLE,W,41,7,19,0.368,2,9,0.222,9,9,1.0,0,10,10,5,0,2,4,3,25,9,1,BOS,BOS,CLE,120,31.5,Pts+Asts,40,35,30,15
Jayson Tatum,F,22023,1628369,22300305,"DEC 12, 2023",BOS vs. CLE,W,41,7,19,0.368,2,9,0.222,9,9,1.0,0,10,10,5,0,2,4,3,25,9,1,BOS,BOS,CLE,120,13.0,Rebs+Asts,40,35,30,15
Jayson Tatum,F,22023,1628369,22300305,"DEC 12, 2023",BOS vs. CLE,W,41,7,19,0.368,2,9,0.222,9,9,1.0,0,10,10,5,0,2,4,3,25,9,1,BOS,BOS,CLE,120,1.5,Blks+Stls,40,35,30,15
Jayson Tatum,F,22023,1628369,22300228,"NOV 22, 2023",BOS vs. MIL,W,36,7,17,0.412,2,9,0.222,7,9,0.778,0,11,11,4,0,1,2,2,23,-2,1,BOS,BOS,MIL,119,26.5,Points,38,34,27,15
Jayson Tatum,F,22023,1628369,22300228,"NOV 22, 2023",BOS vs. MIL,W,36,7,17,0.412,2,9,0.222,7,9,0.778,0,11,11,4,0,1,2,2,23,-2,1,BOS,BOS,MIL,119,8.5,Rebounds,38,34,27,15
Jayson Tatum,F,22023,1628369,22300228,"NOV 22, 2023",BOS vs. MIL,W,36,7,17,0.412,2,9,0.222,7,9,0.778,0,11,11,4,0,1,2,2,23,-2,1,BOS,BOS,MIL,119,39.5,Pts+Rebs+Asts,38,34,27,15
Jayson Tatum,F,22023,1628369,22300228,"NOV 22, 2023",BOS vs. MIL,W,36,7,17,0.412,2,9,0.222,7,9,0.778,0,11,11,4,0,1,2,2,23,-2,1,BOS,BOS,MIL,119,4.5,Assists,38,34,27,15
Jayson Tatum,F,22023,1628369,22300228,"NOV 22, 2023",BOS vs. MIL,W,36,7,17,0.412,2,9,0.222,7,9,0.778,0,11,11,4,0,1,2,2,23,-2,1,BOS,BOS,MIL,119,45.5,Fantasy Score,38,34,27,15
Jayson Tatum,F,22023,1628369,22300228,"NOV 22, 2023",BOS vs. MIL,W,36,7,17,0.412,2,9,0.222,7,9,0.778,0,11,11,4,0,1,2,2,23,-2,1,BOS,BOS,MIL,119,7.0,Defensive Rebounds,38,34,27,15
Jayson Tatum,F,22023,1628369,22300228,"NOV 22, 2023",BOS vs. MIL,W,36,7,17,0.412,2,9,0.222,7,9,0.778,0,11,11,4,0,1,2,2,23,-2,1,BOS,BOS,MIL,119,9.0,3-PT Attempted,38,34,27,15
Jayson Tatum,F,22023,1628369,22300228,"NOV 22, 2023",BOS vs. MIL,W,36,7,17,0.412,2,9,0.222,7,9,0.778,0,11,11,4,0,1,2,2,23,-2,1,BOS,BOS,MIL,119,5.5,Free Throws Made,38,34,27,15
Jayson Tatum,F,22023,1628369,22300228,"NOV 22, 2023",BOS vs. MIL,W,36,7,17,0.412,2,9,0.222,7,9,0.778,0,11,11,4,0,1,2,2,23,-2,1,BOS,BOS,MIL,119,19.5,FG Attempted,38,34,27,15
Jayson Tatum,F,22023,1628369,22300228,"NOV 22, 2023",BOS vs. MIL,W,36,7,17,0.412,2,9,0.222,7,9,0.778,0,11,11,4,0,1,2,2,23,-2,1,BOS,BOS,MIL,119,35.5,Pts+Rebs,38,34,27,15
Jayson Tatum,F,22023,1628369,22300228,"NOV 22, 2023",BOS vs. MIL,W,36,7,17,0.412,2,9,0.222,7,9,0.778,0,11,11,4,0,1,2,2,23,-2,1,BOS,BOS,MIL,119,31.5,Pts+Asts,38,34,27,15
Jayson Tatum,F,22023,1628369,22300228,"NOV 22, 2023",BOS vs. MIL,W,36,7,17,0.412,2,9,0.222,7,9,0.778,0,11,11,4,0,1,2,2,23,-2,1,BOS,BOS,MIL,119,13.0,Rebs+Asts,38,34,27,15
Jayson Tatum,F,22023,1628369,22300228,"NOV 22, 2023",BOS vs. MIL,W,36,7,17,0.412,2,9,0.222,7,9,0.778,0,11,11,4,0,1,2,2,23,-2,1,BOS,BOS,MIL,119,1.5,Blks+Stls,38,34,27,15
Jayson Tatum,F,22023,1628369,22300213,"NOV 19, 2023",BOS @ MEM,W,35,7,13,0.538,1,1,1.0,5,6,0.833,2,7,9,5,1,1,8,4,20,-1,1,BOS,MEM,BOS,102,26.5,Points,34,29,25,14
Jayson Tatum,F,22023,1628369,22300213,"NOV 19, 2023",BOS @ MEM,W,35,7,13,0.538,1,1,1.0,5,6,0.833,2,7,9,5,1,1,8,4,20,-1,1,BOS,MEM,BOS,102,8.5,Rebounds,34,29,25,14
Jayson Tatum,F,22023,1628369,22300213,"NOV 19, 2023",BOS @ MEM,W,35,7,13,0.538,1,1,1.0,5,6,0.833,2,7,9,5,1,1,8,4,20,-1,1,BOS,MEM,BOS,102,39.5,Pts+Rebs+Asts,34,29,25,14
Jayson Tatum,F,22023,1628369,22300213,"NOV 19, 2023",BOS @ MEM,W,35,7,13,0.538,1,1,1.0,5,6,0.833,2,7,9,5,1,1,8,4,20,-1,1,BOS,MEM,BOS,102,4.5,Assists,34,29,25,14
Jayson Tatum,F,22023,1628369,22300213,"NOV 19, 2023",BOS @ MEM,W,35,7,13,0.538,1,1,1.0,5,6,0.833,2,7,9,5,1,1,8,4,20,-1,1,BOS,MEM,BOS,102,45.5,Fantasy Score,34,29,25,14
Jayson Tatum,F,22023,1628369,22300213,"NOV 19, 2023",BOS @ MEM,W,35,7,13,0.538,1,1,1.0,5,6,0.833,2,7,9,5,1,1,8,4,20,-1,1,BOS,MEM,BOS,102,7.0,Defensive Rebounds,34,29,25,14
Jayson Tatum,F,22023,1628369,22300213,"NOV 19, 2023",BOS @ MEM,W,35,7,13,0.538,1,1,1.0,5,6,0.833,2,7,9,5,1,1,8,4,20,-1,1,BOS,MEM,BOS,102,9.0,3-PT Attempted,34,29,25,14
Jayson Tatum,F,22023,1628369,22300213,"NOV 19, 2023",BOS @ MEM,W,35,7,13,0.538,1,1,1.0,5,6,0.833,2,7,9,5,1,1,8,4,20,-1,1,BOS,MEM,BOS,102,5.5,Free Throws Made,34,29,25,14
Jayson Tatum,F,22023,1628369,22300213,"NOV 19, 2023",BOS @ MEM,W,35,7,13,0.538,1,1,1.0,5,6,0.833,2,7,9,5,1,1,8,4,20,-1,1,BOS,MEM,BOS,102,19.5,FG Attempted,34,29,25,14
Jayson Tatum,F,22023,1628369,22300213,"NOV 19, 2023",BOS @ MEM,W,35,7,13,0.538,1,1,1.0,5,6,0.833,2,7,9,5,1,1,8,4,20,-1,1,BOS,MEM,BOS,102,35.5,Pts+Rebs,34,29,25,14
Jayson Tatum,F,22023,1628369,22300213,"NOV 19, 2023",BOS @ MEM,W,35,7,13,0.538,1,1,1.0,5,6,0.833,2,7,9,5,1,1,8,4,20,-1,1,BOS,MEM,BOS,102,31.5,Pts+Asts,34,29,25,14
Jayson Tatum,F,22023,1628369,22300213,"NOV 19, 2023",BOS @ MEM,W,35,7,13,0.538,1,1,1.0,5,6,0.833,2,7,9,5,1,1,8,4,20,-1,1,BOS,MEM,BOS,102,13.0,Rebs+Asts,34,29,25,14
Jayson Tatum,F,22023,1628369,22300213,"NOV 19, 2023",BOS @ MEM,W,35,7,13,0.538,1,1,1.0,5,6,0.833,2,7,9,5,1,1,8,4,20,-1,1,BOS,MEM,BOS,102,1.5,Blks+Stls,34,29,25,14
Jayson Tatum,F,22023,1628369,22300031,"NOV 17, 2023",BOS @ TOR,W,37,8,22,0.364,1,11,0.091,0,0,0.0,1,6,7,2,1,0,3,3,17,-4,1,BOS,TOR,BOS,108,26.5,Points,26,24,19,9
Jayson Tatum,F,22023,1628369,22300031,"NOV 17, 2023",BOS @ TOR,W,37,8,22,0.364,1,11,0.091,0,0,0.0,1,6,7,2,1,0,3,3,17,-4,1,BOS,TOR,BOS,108,8.5,Rebounds,26,24,19,9
Jayson Tatum,F,22023,1628369,22300031,"NOV 17, 2023",BOS @ TOR,W,37,8,22,0.364,1,11,0.091,0,0,0.0,1,6,7,2,1,0,3,3,17,-4,1,BOS,TOR,BOS,108,39.5,Pts+Rebs+Asts,26,24,19,9
Jayson Tatum,F,22023,1628369,22300031,"NOV 17, 2023",BOS @ TOR,W,37,8,22,0.364,1,11,0.091,0,0,0.0,1,6,7,2,1,0,3,3,17,-4,1,BOS,TOR,BOS,108,4.5,Assists,26,24,19,9
Jayson Tatum,F,22023,1628369,22300031,"NOV 17, 2023",BOS @ TOR,W,37,8,22,0.364,1,11,0.091,0,0,0.0,1,6,7,2,1,0,3,3,17,-4,1,BOS,TOR,BOS,108,45.5,Fantasy Score,26,24,19,9
Jayson Tatum,F,22023,1628369,22300031,"NOV 17, 2023",BOS @ TOR,W,37,8,22,0.364,1,11,0.091,0,0,0.0,1,6,7,2,1,0,3,3,17,-4,1,BOS,TOR,BOS,108,7.0,Defensive Rebounds,26,24,19,9
Jayson Tatum,F,22023,1628369,22300031,"NOV 17, 2023",BOS @ TOR,W,37,8,22,0.364,1,11,0.091,0,0,0.0,1,6,7,2,1,0,3,3,17,-4,1,BOS,TOR,BOS,108,9.0,3-PT Attempted,26,24,19,9
Jayson Tatum,F,22023,1628369,22300031,"NOV 17, 2023",BOS @ TOR,W,37,8,22,0.364,1,11,0.091,0,0,0.0,1,6,7,2,1,0,3,3,17,-4,1,BOS,TOR,BOS,108,5.5,Free Throws Made,26,24,19,9
Jayson Tatum,F,22023,1628369,22300031,"NOV 17, 2023",BOS @ TOR,W,37,8,22,0.364,1,11,0.091,0,0,0.0,1,6,7,2,1,0,3,3,17,-4,1,BOS,TOR,BOS,108,19.5,FG Attempted,26,24,19,9
Jayson Tatum,F,22023,1628369,22300031,"NOV 17, 2023",BOS @ TOR,W,37,8,22,0.364,1,11,0.091,0,0,0.0,1,6,7,2,1,0,3,3,17,-4,1,BOS,TOR,BOS,108,35.5,Pts+Rebs,26,24,19,9
Jayson Tatum,F,22023,1628369,22300031,"NOV 17, 2023",BOS @ TOR,W,37,8,22,0.364,1,11,0.091,0,0,0.0,1,6,7,2,1,0,3,3,17,-4,1,BOS,TOR,BOS,108,31.5,Pts+Asts,26,24,19,9
Jayson Tatum,F,22023,1628369,22300031,"NOV 17, 2023",BOS @ TOR,W,37,8,22,0.364,1,11,0.091,0,0,0.0,1,6,7,2,1,0,3,3,17,-4,1,BOS,TOR,BOS,108,13.0,Rebs+Asts,26,24,19,9
Jayson Tatum,F,22023,1628369,22300031,"NOV 17, 2023",BOS @ TOR,W,37,8,22,0.364,1,11,0.091,0,0,0.0,1,6,7,2,1,0,3,3,17,-4,1,BOS,TOR,BOS,108,1.5,Blks+Stls,26,24,19,9
Jayson Tatum,F,22023,1628369,22300188,"NOV 13, 2023",BOS vs. NYK,W,39,13,23,0.565,5,12,0.417,4,5,0.8,1,5,6,7,1,0,3,5,35,12,1,BOS,BOS,NYK,114,26.5,Points,48,41,42,13
Jayson Tatum,F,22023,1628369,22300188,"NOV 13, 2023",BOS vs. NYK,W,39,13,23,0.565,5,12,0.417,4,5,0.8,1,5,6,7,1,0,3,5,35,12,1,BOS,BOS,NYK,114,8.5,Rebounds,48,41,42,13
Jayson Tatum,F,22023,1628369,22300188,"NOV 13, 2023",BOS vs. NYK,W,39,13,23,0.565,5,12,0.417,4,5,0.8,1,5,6,7,1,0,3,5,35,12,1,BOS,BOS,NYK,114,39.5,Pts+Rebs+Asts,48,41,42,13
Jayson Tatum,F,22023,1628369,22300188,"NOV 13, 2023",BOS vs. NYK,W,39,13,23,0.565,5,12,0.417,4,5,0.8,1,5,6,7,1,0,3,5,35,12,1,BOS,BOS,NYK,114,4.5,Assists,48,41,42,13
Jayson Tatum,F,22023,1628369,22300188,"NOV 13, 2023",BOS vs. NYK,W,39,13,23,0.565,5,12,0.417,4,5,0.8,1,5,6,7,1,0,3,5,35,12,1,BOS,BOS,NYK,114,45.5,Fantasy Score,48,41,42,13
Jayson Tatum,F,22023,1628369,22300188,"NOV 13, 2023",BOS vs. NYK,W,39,13,23,0.565,5,12,0.417,4,5,0.8,1,5,6,7,1,0,3,5,35,12,1,BOS,BOS,NYK,114,7.0,Defensive Rebounds,48,41,42,13
Jayson Tatum,F,22023,1628369,22300188,"NOV 13, 2023",BOS vs. NYK,W,39,13,23,0.565,5,12,0.417,4,5,0.8,1,5,6,7,1,0,3,5,35,12,1,BOS,BOS,NYK,114,9.0,3-PT Attempted,48,41,42,13
Jayson Tatum,F,22023,1628369,22300188,"NOV 13, 2023",BOS vs. NYK,W,39,13,23,0.565,5,12,0.417,4,5,0.8,1,5,6,7,1,0,3,5,35,12,1,BOS,BOS,NYK,114,5.5,Free Throws Made,48,41,42,13
Jayson Tatum,F,22023,1628369,22300188,"NOV 13, 2023",BOS vs. NYK,W,39,13,23,0.565,5,12,0.417,4,5,0.8,1,5,6,7,1,0,3,5,35,12,1,BOS,BOS,NYK,114,19.5,FG Attempted,48,41,42,13
Jayson Tatum,F,22023,1628369,22300188,"NOV 13, 2023",BOS vs. NYK,W,39,13,23,0.565,5,12,0.417,4,5,0.8,1,5,6,7,1,0,3,5,35,12,1,BOS,BOS,NYK,114,35.5,Pts+Rebs,48,41,42,13
Jayson Tatum,F,22023,1628369,22300188,"NOV 13, 2023",BOS vs. NYK,W,39,13,23,0.565,5,12,0.417,4,5,0.8,1,5,6,7,1,0,3,5,35,12,1,BOS,BOS,NYK,114,31.5,Pts+Asts,48,41,42,13
Jayson Tatum,F,22023,1628369,22300188,"NOV 13, 2023",BOS vs. NYK,W,39,13,23,0.565,5,12,0.417,4,5,0.8,1,5,6,7,1,0,3,5,35,12,1,BOS,BOS,NYK,114,13.0,Rebs+Asts,48,41,42,13
Jayson Tatum,F,22023,1628369,22300188,"NOV 13, 2023",BOS vs. NYK,W,39,13,23,0.565,5,12,0.417,4,5,0.8,1,5,6,7,1,0,3,5,35,12,1,BOS,BOS,NYK,114,1.5,Blks+Stls,48,41,42,13
Jayson Tatum,F,22023,1628369,22300159,"NOV 08, 2023",BOS @ PHI,L,37,6,14,0.429,2,6,0.333,2,3,0.667,1,14,15,6,3,0,2,2,16,-1,1,BOS,PHI,BOS,103,26.5,Points,37,31,22,21
Jayson Tatum,F,22023,1628369,22300159,"NOV 08, 2023",BOS @ PHI,L,37,6,14,0.429,2,6,0.333,2,3,0.667,1,14,15,6,3,0,2,2,16,-1,1,BOS,PHI,BOS,103,8.5,Rebounds,37,31,22,21
Jayson Tatum,F,22023,1628369,22300159,"NOV 08, 2023",BOS @ PHI,L,37,6,14,0.429,2,6,0.333,2,3,0.667,1,14,15,6,3,0,2,2,16,-1,1,BOS,PHI,BOS,103,39.5,Pts+Rebs+Asts,37,31,22,21
Jayson Tatum,F,22023,1628369,22300159,"NOV 08, 2023",BOS @ PHI,L,37,6,14,0.429,2,6,0.333,2,3,0.667,1,14,15,6,3,0,2,2,16,-1,1,BOS,PHI,BOS,103,4.5,Assists,37,31,22,21
Jayson Tatum,F,22023,1628369,22300159,"NOV 08, 2023",BOS @ PHI,L,37,6,14,0.429,2,6,0.333,2,3,0.667,1,14,15,6,3,0,2,2,16,-1,1,BOS,PHI,BOS,103,45.5,Fantasy Score,37,31,22,21
Jayson Tatum,F,22023,1628369,22300159,"NOV 08, 2023",BOS @ PHI,L,37,6,14,0.429,2,6,0.333,2,3,0.667,1,14,15,6,3,0,2,2,16,-1,1,BOS,PHI,BOS,103,7.0,Defensive Rebounds,37,31,22,21
Jayson Tatum,F,22023,1628369,22300159,"NOV 08, 2023",BOS @ PHI,L,37,6,14,0.429,2,6,0.333,2,3,0.667,1,14,15,6,3,0,2,2,16,-1,1,BOS,PHI,BOS,103,9.0,3-PT Attempted,37,31,22,21
Jayson Tatum,F,22023,1628369,22300159,"NOV 08, 2023",BOS @ PHI,L,37,6,14,0.429,2,6,0.333,2,3,0.667,1,14,15,6,3,0,2,2,16,-1,1,BOS,PHI,BOS,103,5.5,Free Throws Made,37,31,22,21
Jayson Tatum,F,22023,1628369,22300159,"NOV 08, 2023",BOS @ PHI,L,37,6,14,0.429,2,6,0.333,2,3,0.667,1,14,15,6,3,0,2,2,16,-1,1,BOS,PHI,BOS,103,19.5,FG Attempted,37,31,22,21
Jayson Tatum,F,22023,1628369,22300159,"NOV 08, 2023",BOS @ PHI,L,37,6,14,0.429,2,6,0.333,2,3,0.667,1,14,15,6,3,0,2,2,16,-1,1,BOS,PHI,BOS,103,35.5,Pts+Rebs,37,31,22,21
Jayson Tatum,F,22023,1628369,22300159,"NOV 08, 2023",BOS @ PHI,L,37,6,14,0.429,2,6,0.333,2,3,0.667,1,14,15,6,3,0,2,2,16,-1,1,BOS,PHI,BOS,103,31.5,Pts+Asts,37,31,22,21
Jayson Tatum,F,22023,1628369,22300159,"NOV 08, 2023",BOS @ PHI,L,37,6,14,0.429,2,6,0.333,2,3,0.667,1,14,15,6,3,0,2,2,16,-1,1,BOS,PHI,BOS,103,13.0,Rebs+Asts,37,31,22,21
Jayson Tatum,F,22023,1628369,22300159,"NOV 08, 2023",BOS @ PHI,L,37,6,14,0.429,2,6,0.333,2,3,0.667,1,14,15,6,3,0,2,2,16,-1,1,BOS,PHI,BOS,103,1.5,Blks+Stls,37,31,22,21
Jayson Tatum,F,22023,1628369,22300154,"NOV 06, 2023",BOS @ MIN,L,43,12,22,0.545,2,8,0.25,6,8,0.75,0,5,5,2,5,0,6,2,32,3,1,BOS,MIN,BOS,109,26.5,Points,39,37,34,7
Jayson Tatum,F,22023,1628369,22300154,"NOV 06, 2023",BOS @ MIN,L,43,12,22,0.545,2,8,0.25,6,8,0.75,0,5,5,2,5,0,6,2,32,3,1,BOS,MIN,BOS,109,8.5,Rebounds,39,37,34,7
Jayson Tatum,F,22023,1628369,22300154,"NOV 06, 2023",BOS @ MIN,L,43,12,22,0.545,2,8,0.25,6,8,0.75,0,5,5,2,5,0,6,2,32,3,1,BOS,MIN,BOS,109,39.5,Pts+Rebs+Asts,39,37,34,7
Jayson Tatum,F,22023,1628369,22300154,"NOV 06, 2023",BOS @ MIN,L,43,12,22,0.545,2,8,0.25,6,8,0.75,0,5,5,2,5,0,6,2,32,3,1,BOS,MIN,BOS,109,4.5,Assists,39,37,34,7
Jayson Tatum,F,22023,1628369,22300154,"NOV 06, 2023",BOS @ MIN,L,43,12,22,0.545,2,8,0.25,6,8,0.75,0,5,5,2,5,0,6,2,32,3,1,BOS,MIN,BOS,109,45.5,Fantasy Score,39,37,34,7
Jayson Tatum,F,22023,1628369,22300154,"NOV 06, 2023",BOS @ MIN,L,43,12,22,0.545,2,8,0.25,6,8,0.75,0,5,5,2,5,0,6,2,32,3,1,BOS,MIN,BOS,109,7.0,Defensive Rebounds,39,37,34,7
Jayson Tatum,F,22023,1628369,22300154,"NOV 06, 2023",BOS @ MIN,L,43,12,22,0.545,2,8,0.25,6,8,0.75,0,5,5,2,5,0,6,2,32,3,1,BOS,MIN,BOS,109,9.0,3-PT Attempted,39,37,34,7
Jayson Tatum,F,22023,1628369,22300154,"NOV 06, 2023",BOS @ MIN,L,43,12,22,0.545,2,8,0.25,6,8,0.75,0,5,5,2,5,0,6,2,32,3,1,BOS,MIN,BOS,109,5.5,Free Throws Made,39,37,34,7
Jayson Tatum,F,22023,1628369,22300154,"NOV 06, 2023",BOS @ MIN,L,43,12,22,0.545,2,8,0.25,6,8,0.75,0,5,5,2,5,0,6,2,32,3,1,BOS,MIN,BOS,109,19.5,FG Attempted,39,37,34,7
Jayson Tatum,F,22023,1628369,22300154,"NOV 06, 2023",BOS @ MIN,L,43,12,22,0.545,2,8,0.25,6,8,0.75,0,5,5,2,5,0,6,2,32,3,1,BOS,MIN,BOS,109,35.5,Pts+Rebs,39,37,34,7
Jayson Tatum,F,22023,1628369,22300154,"NOV 06, 2023",BOS @ MIN,L,43,12,22,0.545,2,8,0.25,6,8,0.75,0,5,5,2,5,0,6,2,32,3,1,BOS,MIN,BOS,109,31.5,Pts+Asts,39,37,34,7
Jayson Tatum,F,22023,1628369,22300154,"NOV 06, 2023",BOS @ MIN,L,43,12,22,0.545,2,8,0.25,6,8,0.75,0,5,5,2,5,0,6,2,32,3,1,BOS,MIN,BOS,109,13.0,Rebs+Asts,39,37,34,7
Jayson Tatum,F,22023,1628369,22300154,"NOV 06, 2023",BOS @ MIN,L,43,12,22,0.545,2,8,0.25,6,8,0.75,0,5,5,2,5,0,6,2,32,3,1,BOS,MIN,BOS,109,1.5,Blks+Stls,39,37,34,7
Jayson Tatum,F,22023,1628369,22300065,"OCT 25, 2023",BOS @ NYK,W,39,13,22,0.591,3,8,0.375,5,6,0.833,0,11,11,4,2,1,4,3,34,0,1,BOS,NYK,BOS,108,26.5,Points,49,45,38,15
Jayson Tatum,F,22023,1628369,22300065,"OCT 25, 2023",BOS @ NYK,W,39,13,22,0.591,3,8,0.375,5,6,0.833,0,11,11,4,2,1,4,3,34,0,1,BOS,NYK,BOS,108,8.5,Rebounds,49,45,38,15
Jayson Tatum,F,22023,1628369,22300065,"OCT 25, 2023",BOS @ NYK,W,39,13,22,0.591,3,8,0.375,5,6,0.833,0,11,11,4,2,1,4,3,34,0,1,BOS,NYK,BOS,108,39.5,Pts+Rebs+Asts,49,45,38,15
Jayson Tatum,F,22023,1628369,22300065,"OCT 25, 2023",BOS @ NYK,W,39,13,22,0.591,3,8,0.375,5,6,0.833,0,11,11,4,2,1,4,3,34,0,1,BOS,NYK,BOS,108,4.5,Assists,49,45,38,15
Jayson Tatum,F,22023,1628369,22300065,"OCT 25, 2023",BOS @ NYK,W,39,13,22,0.591,3,8,0.375,5,6,0.833,0,11,11,4,2,1,4,3,34,0,1,BOS,NYK,BOS,108,45.5,Fantasy Score,49,45,38,15
Jayson Tatum,F,22023,1628369,22300065,"OCT 25, 2023",BOS @ NYK,W,39,13,22,0.591,3,8,0.375,5,6,0.833,0,11,11,4,2,1,4,3,34,0,1,BOS,NYK,BOS,108,7.0,Defensive Rebounds,49,45,38,15
Jayson Tatum,F,22023,1628369,22300065,"OCT 25, 2023",BOS @ NYK,W,39,13,22,0.591,3,8,0.375,5,6,0.833,0,11,11,4,2,1,4,3,34,0,1,BOS,NYK,BOS,108,9.0,3-PT Attempted,49,45,38,15
Jayson Tatum,F,22023,1628369,22300065,"OCT 25, 2023",BOS @ NYK,W,39,13,22,0.591,3,8,0.375,5,6,0.833,0,11,11,4,2,1,4,3,34,0,1,BOS,NYK,BOS,108,5.5,Free Throws Made,49,45,38,15
Jayson Tatum,F,22023,1628369,22300065,"OCT 25, 2023",BOS @ NYK,W,39,13,22,0.591,3,8,0.375,5,6,0.833,0,11,11,4,2,1,4,3,34,0,1,BOS,NYK,BOS,108,19.5,FG Attempted,49,45,38,15
Jayson Tatum,F,22023,1628369,22300065,"OCT 25, 2023",BOS @ NYK,W,39,13,22,0.591,3,8,0.375,5,6,0.833,0,11,11,4,2,1,4,3,34,0,1,BOS,NYK,BOS,108,35.5,Pts+Rebs,49,45,38,15
Jayson Tatum,F,22023,1628369,22300065,"OCT 25, 2023",BOS @ NYK,W,39,13,22,0.591,3,8,0.375,5,6,0.833,0,11,11,4,2,1,4,3,34,0,1,BOS,NYK,BOS,108,31.5,Pts+Asts,49,45,38,15
Jayson Tatum,F,22023,1628369,22300065,"OCT 25, 2023",BOS @ NYK,W,39,13,22,0.591,3,8,0.375,5,6,0.833,0,11,11,4,2,1,4,3,34,0,1,BOS,NYK,BOS,108,13.0,Rebs+Asts,49,45,38,15
Jayson Tatum,F,22023,1628369,22300065,"OCT 25, 2023",BOS @ NYK,W,39,13,22,0.591,3,8,0.375,5,6,0.833,0,11,11,4,2,1,4,3,34,0,1,BOS,NYK,BOS,108,1.5,Blks+Stls,49,45,38,15
Jalen Brunson,G,22023,1628973,22300755,"FEB 10, 2024",NYK vs. IND,L,37,14,25,0.56,1,5,0.2,10,10,1.0,0,3,3,4,1,0,2,2,39,-7,1,NYK,NYK,IND,111,,,46,42,43,7
Jalen Brunson,G,22023,1628973,22300722,"FEB 06, 2024",NYK vs. MEM,W,31,11,21,0.524,1,4,0.25,4,5,0.8,0,3,3,8,3,0,2,1,27,-3,1,NYK,NYK,MEM,121,,,38,30,35,11
Jalen Brunson,G,22023,1628973,22300701,"FEB 03, 2024",NYK vs. LAL,L,45,15,31,0.484,1,6,0.167,5,6,0.833,2,4,6,10,0,0,3,1,36,-5,1,NYK,NYK,LAL,105,,,52,42,46,16
Jalen Brunson,G,22023,1628973,22300685,"FEB 01, 2024",NYK vs. IND,W,37,15,30,0.5,1,6,0.167,9,11,0.818,1,4,5,1,0,0,2,3,40,4,1,NYK,NYK,IND,109,,,46,45,41,6
Jalen Brunson,G,22023,1628973,22300671,"JAN 30, 2024",NYK vs. UTA,W,38,10,23,0.435,2,6,0.333,7,8,0.875,0,3,3,9,0,1,0,2,29,19,1,NYK,NYK,UTA,118,,,41,32,38,12
Jalen Brunson,G,22023,1628973,22300657,"JAN 29, 2024",NYK @ CHA,W,34,13,24,0.542,2,6,0.333,4,5,0.8,0,4,4,7,1,0,2,1,32,20,1,NYK,CHA,NYK,113,,,43,36,39,11
Jalen Brunson,G,22023,1628973,22300643,"JAN 27, 2024",NYK vs. MIA,W,38,12,22,0.545,4,8,0.5,4,5,0.8,0,5,5,8,1,1,0,2,32,24,1,NYK,NYK,MIA,125,,,45,37,40,13
Jalen Brunson,G,22023,1628973,22300631,"JAN 25, 2024",NYK vs. DEN,W,27,7,10,0.7,1,2,0.5,6,6,1.0,0,1,1,4,0,0,2,0,21,24,1,NYK,NYK,DEN,122,,,26,22,25,5
Jalen Brunson,G,22023,1628973,22300615,"JAN 23, 2024",NYK @ BKN,W,36,11,22,0.5,2,7,0.286,6,7,0.857,0,3,3,4,0,0,2,2,30,7,1,NYK,BKN,NYK,108,,,37,33,34,7
Jalen Brunson,G,22023,1628973,22300596,"JAN 20, 2024",NYK vs. TOR,W,35,13,23,0.565,5,11,0.455,7,7,1.0,1,4,5,9,1,0,3,3,38,22,1,NYK,NYK,TOR,126,,,52,43,47,14
Jalen Brunson,G,22023,1628973,22300579,"JAN 18, 2024",NYK vs. WAS,W,40,14,27,0.519,2,4,0.5,11,13,0.846,1,7,8,8,2,1,6,2,41,10,1,NYK,NYK,WAS,113,,,57,49,49,16
Jalen Brunson,G,22023,1628973,22300573,"JAN 17, 2024",NYK vs. HOU,W,37,11,21,0.524,4,9,0.444,4,7,0.571,0,3,3,7,0,0,2,2,30,12,1,NYK,NYK,HOU,109,,,40,33,37,10
Jalen Brunson,G,22023,1628973,22300530,"JAN 11, 2024",NYK @ DAL,L,39,10,22,0.455,2,6,0.333,8,9,0.889,0,2,2,8,1,0,4,3,30,8,1,NYK,DAL,NYK,124,,,40,32,38,10
Jalen Brunson,G,22023,1628973,22300514,"JAN 09, 2024",NYK vs. POR,W,26,3,11,0.273,1,7,0.143,5,6,0.833,1,2,3,7,0,0,0,0,12,29,1,NYK,NYK,POR,112,,,22,15,19,10
Jalen Brunson,G,22023,1628973,22300494,"JAN 06, 2024",NYK @ WAS,W,35,10,18,0.556,4,8,0.5,9,9,1.0,0,3,3,8,0,0,2,2,33,20,1,NYK,WAS,NYK,121,,,44,36,41,11
Jalen Brunson,G,22023,1628973,22300483,"JAN 05, 2024",NYK @ PHI,W,32,11,20,0.55,4,9,0.444,3,3,1.0,0,3,3,2,1,1,0,1,29,14,1,NYK,PHI,NYK,128,,,34,32,31,5
Jalen Brunson,G,22023,1628973,22300468,"JAN 03, 2024",NYK vs. CHI,W,38,13,22,0.591,4,9,0.444,1,1,1.0,0,3,3,13,0,0,4,3,31,31,1,NYK,NYK,CHI,116,,,47,34,44,16
Jalen Brunson,G,22023,1628973,22300451,"JAN 01, 2024",NYK vs. MIN,W,41,5,23,0.217,1,9,0.111,5,5,1.0,0,4,4,14,1,0,2,4,16,16,1,NYK,NYK,MIN,112,,,34,20,30,18
Jalen Brunson,G,22023,1628973,22300441,"DEC 30, 2023",NYK @ IND,L,41,9,22,0.409,4,8,0.5,6,9,0.667,0,1,1,6,0,1,4,3,28,-17,1,NYK,IND,NYK,124,,,35,29,34,7
Jalen Brunson,G,22023,1628973,22300388,"DEC 23, 2023",NYK vs. MIL,L,37,15,26,0.577,3,5,0.6,3,3,1.0,0,3,3,7,0,1,3,2,36,-16,1,NYK,NYK,MIL,109,,,46,39,43,10
Jalen Brunson,G,22023,1628973,22300368,"DEC 20, 2023",NYK @ BKN,W,32,6,15,0.4,1,3,0.333,3,4,0.75,1,6,7,8,1,0,3,0,16,18,1,NYK,BKN,NYK,119,,,31,23,24,15
Jalen Brunson,G,22023,1628973,22300343,"DEC 16, 2023",NYK @ LAC,L,34,7,17,0.412,2,5,0.4,6,6,1.0,2,5,7,6,0,0,2,2,22,-25,1,NYK,LAC,NYK,120,,,35,29,28,13
Jalen Brunson,G,22023,1628973,22300333,"DEC 15, 2023",NYK @ PHX,W,35,17,23,0.739,9,9,1.0,7,9,0.778,1,5,6,9,5,0,2,0,50,7,1,NYK,PHX,NYK,139,,,65,56,59,15
Jalen Brunson,G,22023,1628973,22301201,"DEC 05, 2023",NYK @ MIL,L,34,10,22,0.455,0,5,0.0,4,7,0.571,0,3,3,6,1,0,3,1,24,-14,1,NYK,MIL,NYK,122,,,33,27,30,9
Jalen Brunson,G,22023,1628973,22300221,"NOV 20, 2023",NYK @ MIN,L,36,7,15,0.467,3,6,0.5,8,8,1.0,0,4,4,6,0,0,1,2,25,-16,1,NYK,MIN,NYK,100,,,35,29,31,10
Jalen Brunson,G,22023,1628973,22300028,"NOV 17, 2023",NYK @ WAS,W,34,10,23,0.435,6,10,0.6,6,6,1.0,3,4,7,7,0,0,0,2,32,18,1,NYK,WAS,NYK,120,,,46,39,39,14
Jalen Brunson,G,22023,1628973,22300177,"NOV 12, 2023",NYK vs. CHA,W,27,7,12,0.583,2,4,0.5,4,4,1.0,0,1,1,1,1,0,1,2,20,13,1,NYK,NYK,CHA,129,,,22,21,21,2
Jalen Brunson,G,22023,1628973,22300161,"NOV 08, 2023",NYK vs. SAS,W,33,8,19,0.421,5,8,0.625,4,4,1.0,0,2,2,6,0,0,0,2,25,27,1,NYK,NYK,SAS,126,,,33,27,31,8
Jalen Brunson,G,22023,1628973,22300112,"OCT 31, 2023",NYK @ CLE,W,34,7,16,0.438,1,3,0.333,4,5,0.8,0,5,5,2,2,0,5,1,19,21,1,NYK,CLE,NYK,109,,,26,24,21,7
Jalen Brunson,G,22023,1628973,22300429,"DEC 29, 2023",NYK @ ORL,L,34,4,15,0.267,0,4,0.0,12,12,1.0,0,7,7,8,0,1,3,2,20,-10,1,NYK,ORL,NYK,106,,,35,27,28,15
Jalen Brunson,G,22023,1628973,22300419,"DEC 27, 2023",NYK @ OKC,L,37,9,19,0.474,1,5,0.2,5,5,1.0,2,2,4,7,2,1,5,4,24,-9,1,NYK,OKC,NYK,116,,,35,28,31,11
Jalen Brunson,G,22023,1628973,22300401,"DEC 25, 2023",NYK vs. MIL,W,37,15,28,0.536,1,3,0.333,7,9,0.778,1,3,4,6,1,0,0,0,38,6,1,NYK,NYK,MIL,129,,,48,42,44,10
Jalen Brunson,G,22023,1628973,22300359,"DEC 18, 2023",NYK @ LAL,W,37,10,21,0.476,3,6,0.5,6,6,1.0,1,3,4,3,1,1,4,0,29,1,1,NYK,LAL,NYK,114,,,36,33,32,7
Jalen Brunson,G,22023,1628973,22300318,"DEC 13, 2023",NYK @ UTA,L,39,6,19,0.316,0,6,0.0,11,16,0.688,2,5,7,8,2,0,3,4,23,9,1,NYK,UTA,NYK,113,,,38,30,31,15
Jalen Brunson,G,22023,1628973,22300297,"DEC 11, 2023",NYK vs. TOR,W,38,7,12,0.583,3,5,0.6,4,6,0.667,0,2,2,9,1,0,7,5,21,1,1,NYK,NYK,TOR,136,,,32,23,30,11
Jalen Brunson,G,22023,1628973,22301227,"DEC 08, 2023",NYK @ BOS,L,34,8,17,0.471,0,5,0.0,7,9,0.778,0,1,1,4,1,0,1,3,23,-21,1,NYK,BOS,NYK,123,,,28,24,27,5
Jalen Brunson,G,22023,1628973,22300276,"DEC 01, 2023",NYK @ TOR,W,37,9,21,0.429,3,8,0.375,1,1,1.0,0,5,5,8,1,0,2,2,22,15,1,NYK,TOR,NYK,119,,,35,27,30,13
Jalen Brunson,G,22023,1628973,22300268,"NOV 30, 2023",NYK vs. DET,W,40,13,24,0.542,7,12,0.583,9,10,0.9,2,4,6,8,1,0,1,3,42,11,1,NYK,NYK,DET,118,,,56,48,50,14
Jalen Brunson,G,22023,1628973,22300057,"NOV 28, 2023",NYK vs. CHA,W,34,5,9,0.556,2,5,0.4,0,1,0.0,1,2,3,7,3,0,2,3,12,20,1,NYK,NYK,CHA,115,,,22,15,19,10
Jalen Brunson,G,22023,1628973,22300247,"NOV 26, 2023",NYK vs. PHX,L,38,15,25,0.6,5,10,0.5,0,2,0.0,0,6,6,8,3,1,2,5,35,5,1,NYK,NYK,PHX,113,,,49,41,43,14
Jalen Brunson,G,22023,1628973,22300045,"NOV 24, 2023",NYK vs. MIA,W,34,10,16,0.625,1,4,0.25,3,5,0.6,0,3,3,3,0,0,2,1,24,-6,1,NYK,NYK,MIA,100,,,30,27,27,6
Jalen Brunson,G,22023,1628973,22300202,"NOV 18, 2023",NYK @ CHA,W,39,12,21,0.571,4,8,0.5,4,4,1.0,0,4,4,7,0,0,2,2,32,15,1,NYK,CHA,NYK,122,,,43,36,39,11
Jalen Brunson,G,22023,1628973,22300151,"NOV 06, 2023",NYK vs. LAC,W,35,2,12,0.167,1,3,0.333,2,2,1.0,2,1,3,6,3,0,4,1,7,-1,1,NYK,NYK,LAC,111,,,16,10,13,9
Jalen Brunson,G,22023,1628973,22300090,"OCT 28, 2023",NYK @ NOP,L,31,4,14,0.286,1,5,0.2,5,6,0.833,1,3,4,5,0,0,1,2,14,-9,1,NYK,NOP,NYK,87,,,23,18,19,9
Jalen Brunson,G,22023,1628973,22300079,"OCT 27, 2023",NYK @ ATL,W,33,11,21,0.524,8,12,0.667,1,2,0.5,0,3,3,5,0,0,2,1,31,13,1,NYK,ATL,NYK,126,,,39,34,36,8
Jalen Brunson,G,22023,1628973,22300065,"OCT 25, 2023",NYK vs. BOS,L,33,6,21,0.286,3,8,0.375,0,1,0.0,1,2,3,6,3,0,2,3,15,-9,1,NYK,NYK,BOS,104,,,24,18,21,9
Jalen Brunson,G,22023,1628973,22300193,"NOV 15, 2023",NYK @ ATL,W,41,8,19,0.421,6,10,0.6,2,2,1.0,0,0,0,8,0,0,3,2,24,8,1,NYK,ATL,NYK,116,,,32,24,32,8
Jalen Brunson,G,22023,1628973,22300188,"NOV 13, 2023",NYK @ BOS,L,39,10,21,0.476,3,7,0.429,3,5,0.6,0,3,3,4,1,0,2,0,26,-20,1,NYK,BOS,NYK,98,,,33,29,30,7
Jalen Brunson,G,22023,1628973,22300002,"NOV 03, 2023",NYK @ MIL,L,42,17,30,0.567,2,8,0.25,9,11,0.818,2,3,5,4,1,0,4,3,45,2,1,NYK,MIL,NYK,105,,,54,50,49,9
Jalen Brunson,G,22023,1628973,22300120,"NOV 01, 2023",NYK vs. CLE,L,39,8,23,0.348,0,2,0.0,8,9,0.889,1,3,4,4,0,0,1,4,24,-6,1,NYK,NYK,CLE,89,,,32,28,28,8
Nikola Jokic,C,22023,203999,22300746,"FEB 09, 2024",DEN @ SAC,L,30,9,17,0.529,1,1,1.0,4,5,0.8,2,6,8,7,3,0,1,2,23,-7,1,DEN,SAC,DEN,106,,,38,31,30,15
Nikola Jokic,C,22023,203999,22300740,"FEB 08, 2024",DEN @ LAL,W,36,9,20,0.45,2,6,0.333,4,4,1.0,3,10,13,9,0,3,6,2,24,10,1,DEN,LAL,DEN,114,,,46,37,33,22
Nikola Jokic,C,22023,203999,22300712,"FEB 04, 2024",DEN vs. POR,W,34,12,20,0.6,1,3,0.333,4,5,0.8,1,7,8,7,2,0,2,1,29,-5,1,DEN,DEN,POR,112,,,44,37,36,15
Nikola Jokic,C,22023,203999,22300697,"FEB 02, 2024",DEN vs. POR,W,38,11,16,0.688,1,1,1.0,4,4,1.0,7,15,22,12,1,2,4,3,27,20,1,DEN,DEN,POR,120,,,61,49,39,34
Nikola Jokic,C,22023,203999,22300667,"JAN 29, 2024",DEN vs. MIL,W,40,10,25,0.4,1,6,0.167,4,5,0.8,1,15,16,12,3,2,3,1,25,9,1,DEN,DEN,MIL,113,,,53,41,37,28
Nikola Jokic,C,22023,203999,22300644,"JAN 27, 2024",DEN vs. PHI,W,37,8,16,0.5,0,1,0.0,10,16,0.625,5,11,16,7,2,0,3,3,26,2,1,DEN,DEN,PHI,111,,,49,42,33,23
Nikola Jokic,C,22023,203999,22300631,"JAN 25, 2024",DEN @ NYK,L,27,13,18,0.722,2,3,0.667,3,3,1.0,4,7,11,3,0,0,7,1,31,-23,1,DEN,NYK,DEN,84,,,45,42,34,14
Nikola Jokic,C,22023,203999,22300614,"JAN 23, 2024",DEN @ IND,W,37,13,19,0.684,3,4,0.75,2,2,1.0,2,11,13,10,0,1,1,3,31,9,1,DEN,IND,DEN,114,,,54,44,41,23
Nikola Jokic,C,22023,203999,22300602,"JAN 21, 2024",DEN @ WAS,W,36,15,20,0.75,0,0,0.0,12,14,0.857,4,8,12,8,2,2,0,2,42,20,1,DEN,WAS,DEN,113,,,62,54,50,20
Nikola Jokic,C,22023,203999,22300586,"JAN 19, 2024",DEN @ BOS,W,38,14,22,0.636,2,4,0.5,4,4,1.0,2,10,12,9,0,0,4,1,34,1,1,DEN,BOS,DEN,102,,,55,46,43,21
Nikola Jokic,C,22023,203999,22300566,"JAN 16, 2024",DEN @ PHI,L,38,11,20,0.55,0,2,0.0,3,4,0.75,11,8,19,3,1,1,4,3,25,1,1,DEN,PHI,DEN,121,,,47,44,28,22
Nikola Jokic,C,22023,203999,22300550,"JAN 14, 2024",DEN vs. IND,W,33,12,13,0.923,0,0,0.0,1,2,0.5,3,9,12,9,2,1,7,3,25,10,1,DEN,DEN,IND,117,,,46,37,34,21
Nikola Jokic,C,22023,203999,22300539,"JAN 12, 2024",DEN vs. NOP,W,32,11,17,0.647,1,2,0.5,4,4,1.0,3,7,10,14,0,1,2,4,27,12,1,DEN,DEN,NOP,125,,,51,37,41,24
Nikola Jokic,C,22023,203999,22300524,"JAN 10, 2024",DEN @ UTA,L,30,8,9,0.889,1,1,1.0,10,12,0.833,1,10,11,6,1,0,6,3,27,-21,1,DEN,UTA,DEN,111,,,44,38,33,17
Nikola Jokic,C,22023,203999,22300502,"JAN 07, 2024",DEN vs. DET,W,25,2,3,0.667,0,0,0.0,0,0,0.0,0,7,7,16,0,5,2,4,4,16,1,DEN,DEN,DET,131,,,27,11,20,23
Nikola Jokic,C,22023,203999,22300488,"JAN 05, 2024",DEN vs. ORL,L,37,13,19,0.684,0,1,0.0,3,4,0.75,0,4,4,8,3,0,2,3,29,-4,1,DEN,DEN,ORL,120,,,41,33,37,12
Nikola Jokic,C,22023,203999,22300478,"JAN 04, 2024",DEN @ GSW,W,38,13,16,0.813,2,2,1.0,6,7,0.857,2,7,9,10,2,1,4,2,34,4,1,DEN,GSW,DEN,130,,,53,43,44,19
Nikola Jokic,C,22023,203999,22300455,"JAN 01, 2024",DEN vs. CHA,W,28,6,7,0.857,0,0,0.0,1,1,1.0,0,11,11,6,1,1,3,2,13,27,1,DEN,DEN,CHA,111,,,30,24,19,17
Nikola Jokic,C,22023,203999,22300435,"DEC 29, 2023",DEN vs. OKC,L,32,9,10,0.9,1,1,1.0,0,0,0.0,2,8,10,7,1,1,7,2,19,-19,1,DEN,DEN,OKC,93,,,36,29,26,17
Nikola Jokic,C,22023,203999,22300425,"DEC 28, 2023",DEN vs. MEM,W,30,11,11,1.0,1,1,1.0,3,3,1.0,0,14,14,10,0,2,3,1,26,25,1,DEN,DEN,MEM,142,,,50,40,36,24
Nikola Jokic,C,22023,203999,22300402,"DEC 25, 2023",DEN vs. GSW,W,39,4,12,0.333,0,2,0.0,18,18,1.0,4,10,14,8,0,0,3,2,26,21,1,DEN,DEN,GSW,120,,,48,40,34,22
Nikola Jokic,C,22023,203999,22300390,"DEC 23, 2023",DEN @ CHA,W,36,8,14,0.571,0,2,0.0,2,2,1.0,2,8,10,9,1,1,3,6,18,12,1,DEN,CHA,DEN,102,,,37,28,27,19
Nikola Jokic,C,22023,203999,22300383,"DEC 22, 2023",DEN @ BKN,W,34,12,17,0.706,2,2,1.0,5,5,1.0,2,9,11,7,3,2,0,4,31,29,1,DEN,BKN,DEN,122,,,49,42,38,18
Nikola Jokic,C,22023,203999,22300369,"DEC 20, 2023",DEN @ TOR,W,38,13,23,0.565,3,5,0.6,2,3,0.667,5,10,15,6,0,2,2,2,31,15,1,DEN,TOR,DEN,113,,,52,46,37,21
Nikola Jokic,C,22023,203999,22300356,"DEC 18, 2023",DEN vs. DAL,W,28,3,8,0.375,0,1,0.0,2,2,1.0,1,8,9,7,2,0,2,2,8,16,1,DEN,DEN,DAL,130,,,24,17,15,16
Nikola Jokic,C,22023,203999,22300340,"DEC 16, 2023",DEN vs. OKC,L,37,8,15,0.533,1,2,0.5,7,8,0.875,4,2,6,12,2,0,3,3,24,-9,1,DEN,DEN,OKC,117,,,42,30,36,18
Nikola Jokic,C,22023,203999,22300322,"DEC 14, 2023",DEN vs. BKN,W,30,8,12,0.667,0,2,0.0,10,12,0.833,1,13,14,10,1,0,1,2,26,21,1,DEN,DEN,BKN,124,,,50,40,36,24
Nikola Jokic,C,22023,203999,22300307,"DEC 12, 2023",DEN @ CHI,W,16,2,5,0.4,0,0,0.0,0,0,0.0,3,6,9,6,0,0,0,1,4,5,1,DEN,CHI,DEN,114,,,19,13,10,15
Nikola Jokic,C,22023,203999,22300296,"DEC 11, 2023",DEN @ ATL,W,36,9,13,0.692,1,1,1.0,6,7,0.857,2,6,8,9,3,2,1,3,25,8,1,DEN,ATL,DEN,129,,,42,33,34,17
Nikola Jokic,C,22023,203999,22301224,"DEC 08, 2023",DEN vs. HOU,L,34,9,26,0.346,1,2,0.5,4,7,0.571,7,9,16,5,0,2,3,5,23,3,1,DEN,DEN,HOU,106,,,44,39,28,21
Nikola Jokic,C,22023,203999,22301215,"DEC 06, 2023",DEN @ LAC,L,37,9,32,0.281,2,7,0.286,2,2,1.0,5,10,15,10,1,0,4,2,22,1,1,DEN,LAC,DEN,102,,,47,37,32,25
Nikola Jokic,C,22023,203999,22300290,"DEC 02, 2023",DEN @ SAC,L,38,13,23,0.565,1,4,0.25,9,12,0.75,2,11,13,14,2,1,0,3,36,11,1,DEN,SAC,DEN,117,,,63,49,50,27
Nikola Jokic,C,22023,203999,22300279,"DEC 01, 2023",DEN @ PHX,W,35,9,18,0.5,0,3,0.0,3,6,0.5,1,4,5,16,1,2,3,4,21,6,1,DEN,PHX,DEN,119,,,42,26,37,21
Nikola Jokic,C,22023,203999,22300263,"NOV 29, 2023",DEN vs. HOU,W,33,12,19,0.632,1,2,0.5,7,8,0.875,6,4,10,15,1,0,0,2,32,29,1,DEN,DEN,HOU,134,,,57,42,47,25
Nikola Jokic,C,22023,203999,22300252,"NOV 26, 2023",DEN vs. SAS,W,34,17,29,0.586,0,0,0.0,5,5,1.0,5,6,11,9,1,0,5,3,39,14,1,DEN,DEN,SAS,132,,,59,50,48,20
Nikola Jokic,C,22023,203999,22300048,"NOV 24, 2023",DEN @ HOU,L,42,14,31,0.452,3,8,0.375,7,11,0.636,6,13,19,8,3,0,3,3,38,-12,1,DEN,HOU,DEN,86,,,65,57,46,27
Nikola Jokic,C,22023,203999,22300226,"NOV 22, 2023",DEN @ ORL,L,36,12,18,0.667,1,2,0.5,5,5,1.0,5,8,13,12,3,2,1,4,30,4,1,DEN,ORL,DEN,119,,,55,43,42,25
Nikola Jokic,C,22023,203999,22300218,"NOV 20, 2023",DEN @ DET,W,15,4,8,0.5,1,4,0.25,0,0,0.0,0,5,5,5,0,1,1,1,9,-4,1,DEN,DET,DEN,107,,,19,14,14,10
Nikola Jokic,C,22023,203999,22300210,"NOV 19, 2023",DEN @ CLE,L,28,8,13,0.615,0,0,0.0,2,5,0.4,1,9,10,7,1,1,3,5,18,-16,1,DEN,CLE,DEN,109,,,35,28,25,17
Nikola Jokic,C,22023,203999,22300034,"NOV 17, 2023",DEN @ NOP,L,36,10,20,0.5,1,8,0.125,5,5,1.0,2,14,16,18,1,1,4,2,26,5,1,DEN,NOP,DEN,110,,,60,42,44,34
Nikola Jokic,C,22023,203999,22300024,"NOV 14, 2023",DEN vs. LAC,W,36,8,23,0.348,2,7,0.286,14,14,1.0,3,13,16,9,1,0,4,2,32,3,1,DEN,DEN,LAC,111,,,57,48,41,25
Nikola Jokic,C,22023,203999,22300182,"NOV 12, 2023",DEN @ HOU,L,38,13,26,0.5,2,6,0.333,8,8,1.0,6,15,21,11,0,1,3,3,36,12,1,DEN,HOU,DEN,104,,,68,57,47,32
Nikola Jokic,C,22023,203999,22300169,"NOV 08, 2023",DEN vs. GSW,W,37,14,25,0.56,1,8,0.125,6,10,0.6,3,10,13,5,3,1,3,3,35,3,1,DEN,DEN,GSW,108,,,53,48,40,18
Nikola Jokic,C,22023,203999,22300156,"NOV 06, 2023",DEN vs. NOP,W,36,15,24,0.625,2,6,0.333,3,5,0.6,3,11,14,12,1,1,2,1,35,16,1,DEN,DEN,NOP,134,,,61,49,47,26
Nikola Jokic,C,22023,203999,22300139,"NOV 04, 2023",DEN vs. CHI,W,33,9,16,0.563,1,3,0.333,9,9,1.0,4,12,16,9,3,0,1,3,28,33,1,DEN,DEN,CHI,123,,,53,44,37,25
Nikola Jokic,C,22023,203999,22300006,"NOV 03, 2023",DEN vs. DAL,W,36,14,16,0.875,2,2,1.0,3,5,0.6,7,7,14,9,1,1,4,3,33,17,1,DEN,DEN,DAL,125,,,56,47,42,23
Nikola Jokic,C,22023,203999,22300123,"NOV 01, 2023",DEN @ MIN,L,30,11,23,0.478,1,6,0.167,2,2,1.0,2,8,10,3,0,0,5,0,25,-19,1,DEN,MIN,DEN,89,,,38,35,28,13
Nikola Jokic,C,22023,203999,22300110,"OCT 30, 2023",DEN vs. UTA,W,35,12,16,0.75,1,3,0.333,2,5,0.4,1,9,10,11,0,2,1,3,27,13,1,DEN,DEN,UTA,110,,,48,37,38,21
Nikola Jokic,C,22023,203999,22300095,"OCT 29, 2023",DEN @ OKC,W,30,12,16,0.75,1,2,0.5,3,3,1.0,2,12,14,5,0,0,4,3,28,21,1,DEN,OKC,DEN,128,,,47,42,33,19
Nikola Jokic,C,22023,203999,22300078,"OCT 27, 2023",DEN @ MEM,W,35,8,14,0.571,1,4,0.25,5,6,0.833,3,9,12,7,1,1,9,1,22,6,1,DEN,MEM,DEN,108,,,41,34,29,19
Nikola Jokic,C,22023,203999,22300061,"OCT 24, 2023",DEN vs. LAL,W,36,12,22,0.545,3,5,0.6,2,4,0.5,3,10,13,11,1,1,2,2,29,15,1,DEN,DEN,LAL,119,,,53,42,40,24
Tyrese Maxey,G,22023,1630178,22300727,"FEB 07, 2024",PHI vs. GSW,L,30,5,14,0.357,2,7,0.286,0,0,0.0,0,2,2,3,1,1,3,2,12,-27,1,PHI,PHI,GSW,104,,,17,14,15,5
Tyrese Maxey,G,22023,1630178,22300715,"FEB 05, 2024",PHI vs. DAL,L,33,6,16,0.375,1,5,0.2,2,3,0.667,0,2,2,7,0,0,3,4,15,-23,1,PHI,PHI,DAL,102,,,24,17,22,9
Tyrese Maxey,G,22023,1630178,22300698,"FEB 03, 2024",PHI vs. BKN,L,31,8,23,0.348,3,8,0.375,4,6,0.667,1,2,3,5,3,0,1,2,23,-15,1,PHI,PHI,BKN,121,,,31,26,28,8
Tyrese Maxey,G,22023,1630178,22300686,"FEB 01, 2024",PHI @ UTA,W,41,17,27,0.63,7,9,0.778,10,11,0.909,0,2,2,1,0,1,0,4,51,-2,1,PHI,UTA,PHI,127,,,54,53,52,3
Tyrese Maxey,G,22023,1630178,22300532,"JAN 12, 2024",PHI vs. SAC,W,40,6,17,0.353,3,6,0.5,6,6,1.0,0,3,3,4,3,2,3,3,21,17,1,PHI,PHI,SAC,112,,,28,24,25,7
Tyrese Maxey,G,22023,1630178,22300521,"JAN 10, 2024",PHI @ ATL,L,43,12,29,0.414,4,11,0.364,7,9,0.778,1,7,8,9,4,0,3,6,35,2,1,PHI,ATL,PHI,132,,,52,43,44,17
Tyrese Maxey,G,22023,1630178,22300495,"JAN 06, 2024",PHI vs. UTA,L,42,9,24,0.375,1,8,0.125,6,6,1.0,1,0,1,9,3,1,3,0,25,-14,1,PHI,PHI,UTA,109,,,35,26,34,10
Tyrese Maxey,G,22023,1630178,22300483,"JAN 05, 2024",PHI vs. NYK,L,36,9,20,0.45,1,7,0.143,8,10,0.8,1,3,4,9,2,1,1,1,27,-28,1,PHI,PHI,NYK,92,,,40,31,36,13
Tyrese Maxey,G,22023,1630178,22300459,"JAN 02, 2024",PHI vs. CHI,W,29,6,12,0.5,4,7,0.571,5,6,0.833,0,1,1,5,0,0,1,2,21,24,1,PHI,PHI,CHI,110,,,27,22,26,6
Tyrese Maxey,G,22023,1630178,22300442,"DEC 30, 2023",PHI @ CHI,L,35,8,22,0.364,2,8,0.25,2,5,0.4,0,0,0,7,1,0,2,4,20,-12,1,PHI,CHI,PHI,92,,,27,20,27,7
Tyrese Maxey,G,22023,1630178,22300434,"DEC 29, 2023",PHI @ HOU,W,41,13,26,0.5,2,9,0.222,14,15,0.933,1,3,4,4,0,1,1,1,42,0,1,PHI,HOU,PHI,131,,,50,46,46,8
Tyrese Maxey,G,22023,1630178,22300415,"DEC 27, 2023",PHI @ ORL,W,34,9,18,0.5,3,6,0.5,2,3,0.667,1,5,6,2,0,1,1,2,23,17,1,PHI,ORL,PHI,112,,,31,29,25,8
Tyrese Maxey,G,22023,1630178,22300404,"DEC 25, 2023",PHI @ MIA,L,44,4,20,0.2,1,8,0.125,3,6,0.5,0,3,3,5,1,1,0,4,12,3,1,PHI,MIA,PHI,113,,,20,15,17,8
Tyrese Maxey,G,22023,1630178,22300367,"DEC 20, 2023",PHI vs. MIN,W,37,12,24,0.5,5,12,0.417,6,6,1.0,0,1,1,5,0,0,5,4,35,1,1,PHI,PHI,MIN,127,,,41,36,40,6
Tyrese Maxey,G,22023,1630178,22300335,"DEC 16, 2023",PHI @ CHA,W,33,8,13,0.615,5,8,0.625,0,0,0.0,0,2,2,7,2,1,0,1,21,43,1,PHI,CHA,PHI,135,,,30,23,28,9
Tyrese Maxey,G,22023,1630178,22300327,"DEC 15, 2023",PHI vs. DET,W,27,7,16,0.438,1,6,0.167,4,5,0.8,0,1,1,4,2,0,1,1,19,37,1,PHI,PHI,DET,124,,,24,20,23,5
Tyrese Maxey,G,22023,1630178,22300310,"DEC 13, 2023",PHI @ DET,W,33,2,13,0.154,0,6,0.0,5,6,0.833,1,3,4,9,0,0,1,1,9,22,1,PHI,DET,PHI,129,,,22,13,18,13
Tyrese Maxey,G,22023,1630178,22300295,"DEC 11, 2023",PHI vs. WAS,W,25,8,13,0.615,5,9,0.556,3,3,1.0,0,1,1,6,0,0,2,1,24,26,1,PHI,PHI,WAS,146,,,31,25,30,7
Tyrese Maxey,G,22023,1630178,22301218,"DEC 08, 2023",PHI vs. ATL,W,39,8,18,0.444,4,8,0.5,10,12,0.833,0,2,2,7,1,1,0,3,30,-1,1,PHI,PHI,ATL,125,,,39,32,37,9
Tyrese Maxey,G,22023,1630178,22300262,"NOV 29, 2023",PHI @ NOP,L,38,13,25,0.52,3,10,0.3,4,4,1.0,0,1,1,3,2,0,4,2,33,-11,1,PHI,NOP,PHI,114,,,37,34,36,4
Tyrese Maxey,G,22023,1630178,22300255,"NOV 27, 2023",PHI vs. LAL,W,36,9,20,0.45,5,12,0.417,8,9,0.889,0,3,3,8,1,0,0,2,31,25,1,PHI,PHI,LAL,138,,,42,34,39,11
Tyrese Maxey,G,22023,1630178,22300232,"NOV 22, 2023",PHI @ MIN,L,34,7,19,0.368,0,5,0.0,2,4,0.5,2,3,5,8,0,1,3,0,16,-18,1,PHI,MIN,PHI,99,,,29,21,24,13
Tyrese Maxey,G,22023,1630178,22300208,"NOV 19, 2023",PHI @ BKN,W,36,8,20,0.4,6,11,0.545,3,3,1.0,1,1,2,10,0,0,1,0,25,21,1,PHI,BKN,PHI,121,,,37,27,35,12
Tyrese Maxey,G,22023,1630178,22300148,"NOV 06, 2023",PHI vs. WAS,W,32,9,16,0.563,3,9,0.333,1,1,1.0,0,1,1,11,1,1,0,2,22,9,1,PHI,PHI,WAS,146,,,34,23,33,12
Tyrese Maxey,G,22023,1630178,22300132,"NOV 04, 2023",PHI vs. PHX,W,36,9,18,0.5,2,6,0.333,2,2,1.0,2,3,5,10,0,1,3,0,22,25,1,PHI,PHI,PHX,112,,,37,27,32,15
Tyrese Maxey,G,22023,1630178,22300128,"NOV 02, 2023",PHI vs. TOR,W,40,7,16,0.438,0,3,0.0,4,4,1.0,0,1,1,4,2,0,1,1,18,6,1,PHI,PHI,TOR,114,,,23,19,22,5
Tyrese Maxey,G,22023,1630178,22300098,"OCT 29, 2023",PHI vs. POR,W,35,6,14,0.429,4,8,0.5,10,10,1.0,1,9,10,4,0,0,2,1,26,19,1,PHI,PHI,POR,126,,,40,36,30,14
Tyrese Maxey,G,22023,1630178,22300627,"JAN 25, 2024",PHI @ IND,L,29,7,17,0.412,1,8,0.125,7,7,1.0,0,1,1,2,0,1,1,2,22,-29,1,PHI,IND,PHI,122,,,25,23,24,3
Tyrese Maxey,G,22023,1630178,22300608,"JAN 22, 2024",PHI vs. SAS,W,42,7,15,0.467,2,5,0.4,2,2,1.0,1,3,4,8,0,0,2,1,18,12,1,PHI,PHI,SAS,133,,,30,22,26,12
Tyrese Maxey,G,22023,1630178,22300593,"JAN 20, 2024",PHI @ CHA,W,42,7,22,0.318,1,9,0.111,1,2,0.5,0,3,3,8,2,0,0,2,16,18,1,PHI,CHA,PHI,97,,,27,19,24,11
Tyrese Maxey,G,22023,1630178,22300585,"JAN 19, 2024",PHI @ ORL,W,34,10,20,0.5,4,10,0.4,8,9,0.889,2,1,3,5,3,1,2,1,32,17,1,PHI,ORL,PHI,124,,,40,35,37,8
Tyrese Maxey,G,22023,1630178,22300566,"JAN 16, 2024",PHI vs. DEN,W,43,9,20,0.45,4,9,0.444,3,7,0.429,1,4,5,9,2,0,1,2,25,9,1,PHI,PHI,DEN,126,,,39,30,34,14
Tyrese Maxey,G,22023,1630178,22300555,"JAN 15, 2024",PHI vs. HOU,W,35,8,18,0.444,6,10,0.6,5,5,1.0,0,1,1,7,0,0,2,4,27,19,1,PHI,PHI,HOU,124,,,35,28,34,8
Tyrese Maxey,G,22023,1630178,22300351,"DEC 18, 2023",PHI vs. CHI,L,39,9,23,0.391,5,11,0.455,6,6,1.0,2,3,5,8,1,0,3,3,29,11,1,PHI,PHI,CHI,104,,,42,34,37,13
Tyrese Maxey,G,22023,1630178,22301208,"DEC 06, 2023",PHI @ WAS,W,38,10,20,0.5,2,6,0.333,4,4,1.0,0,1,1,7,1,0,0,2,26,12,1,PHI,WAS,PHI,131,,,34,27,33,8
Tyrese Maxey,G,22023,1630178,22300239,"NOV 25, 2023",PHI @ OKC,W,41,8,17,0.471,3,9,0.333,9,11,0.818,1,7,8,3,0,1,1,5,28,6,1,PHI,OKC,PHI,127,,,39,36,31,11
Tyrese Maxey,G,22023,1630178,22300040,"NOV 21, 2023",PHI vs. CLE,L,47,11,28,0.393,3,12,0.25,5,7,0.714,0,4,4,6,1,0,1,2,30,-8,1,PHI,PHI,CLE,119,,,40,34,36,10
Tyrese Maxey,G,22023,1630178,22300180,"NOV 12, 2023",PHI vs. IND,W,39,20,32,0.625,7,11,0.636,3,3,1.0,3,4,7,5,0,3,2,2,50,17,1,PHI,PHI,IND,137,,,62,57,55,12
Tyrese Maxey,G,22023,1630178,22300008,"NOV 10, 2023",PHI @ DET,W,39,9,19,0.474,2,7,0.286,9,9,1.0,0,6,6,11,3,1,0,3,29,17,1,PHI,DET,PHI,114,,,46,35,40,17
Tyrese Maxey,G,22023,1630178,22300159,"NOV 08, 2023",PHI vs. BOS,W,39,11,27,0.407,3,11,0.273,0,1,0.0,1,8,9,5,1,2,1,4,25,-3,1,PHI,PHI,BOS,106,,,39,34,30,14
Tyrese Maxey,G,22023,1630178,22300029,"NOV 17, 2023",PHI @ ATL,W,40,5,13,0.385,3,6,0.5,6,6,1.0,0,4,4,8,2,0,2,1,19,1,1,PHI,ATL,PHI,126,,,31,23,27,12
Tyrese Maxey,G,22023,1630178,22300194,"NOV 15, 2023",PHI vs. BOS,L,39,6,15,0.4,3,7,0.429,5,5,1.0,0,3,3,4,0,0,2,3,20,9,1,PHI,PHI,BOS,107,,,27,23,24,7
Tyrese Maxey,G,22023,1630178,22300019,"NOV 14, 2023",PHI vs. IND,L,38,9,23,0.391,2,5,0.4,7,7,1.0,0,4,4,5,0,1,4,2,27,-6,1,PHI,PHI,IND,126,,,36,31,32,9
Tyrese Maxey,G,22023,1630178,22300092,"OCT 28, 2023",PHI @ TOR,W,41,12,20,0.6,7,9,0.778,3,3,1.0,1,5,6,7,0,1,1,1,34,10,1,PHI,TOR,PHI,114,,,47,40,41,13
Tyrese Maxey,G,22023,1630178,22300075,"OCT 26, 2023",PHI @ MIL,L,40,10,22,0.455,3,8,0.375,8,10,0.8,0,4,4,8,2,0,0,3,31,0,1,PHI,MIL,PHI,117,,,43,35,39,12
Tyrese Maxey,G,22023,1630178,22300753,"FEB 10, 2024",PHI @ WAS,W,36,11,25,0.44,3,7,0.429,3,4,0.75,0,9,9,7,0,0,2,1,28,-10,1,PHI,WAS,PHI,119,,,44,37,35,16
Tyrese Maxey,G,22023,1630178,22300382,"DEC 22, 2023",PHI vs. TOR,W,41,13,22,0.591,4,10,0.4,3,3,1.0,0,4,4,10,0,0,3,3,33,17,1,PHI,PHI,TOR,121,,,47,37,43,14
Anthony Edwards,G,22023,1630162,22300738,"FEB 08, 2024",MIN @ MIL,W,36,9,20,0.45,4,11,0.364,4,6,0.667,0,3,3,9,1,0,0,3,26,16,1,MIN,MIL,MIN,129,,,38,29,35,12
Anthony Edwards,G,22023,1630162,22300723,"FEB 06, 2024",MIN @ CHI,L,44,12,26,0.462,5,9,0.556,9,11,0.818,0,12,12,5,2,1,5,5,38,-4,1,MIN,CHI,MIN,123,,,55,50,43,17
Anthony Edwards,G,22023,1630162,22300709,"FEB 04, 2024",MIN vs. HOU,W,34,11,22,0.5,4,8,0.5,6,8,0.75,1,5,6,1,1,1,4,3,32,27,1,MIN,MIN,HOU,111,,,39,38,33,7
Anthony Edwards,G,22023,1630162,22300694,"FEB 02, 2024",MIN vs. ORL,L,35,9,18,0.5,2,8,0.25,2,3,0.667,0,1,1,5,1,0,3,1,22,6,1,MIN,MIN,ORL,106,,,28,23,27,6
Anthony Edwards,G,22023,1630162,22300680,"JAN 31, 2024",MIN vs. DAL,W,30,3,5,0.6,1,2,0.5,2,2,1.0,0,5,5,5,0,0,2,1,9,18,1,MIN,MIN,DAL,121,,,19,14,14,10
Anthony Edwards,G,22023,1630162,22300664,"JAN 29, 2024",MIN @ OKC,W,40,10,20,0.5,3,5,0.6,4,4,1.0,0,4,4,4,1,0,4,4,27,-1,1,MIN,OKC,MIN,107,,,35,31,31,8
Anthony Edwards,G,22023,1630162,22300649,"JAN 27, 2024",MIN @ SAS,L,38,12,18,0.667,6,8,0.75,2,4,0.5,1,5,6,12,1,0,4,0,32,7,1,MIN,SAS,MIN,112,,,50,38,44,18
Anthony Edwards,G,22023,1630162,22300629,"JAN 25, 2024",MIN @ BKN,W,36,8,23,0.348,3,7,0.429,5,6,0.833,0,1,1,3,1,0,3,3,24,-5,1,MIN,BKN,MIN,96,,,28,25,27,4
Anthony Edwards,G,22023,1630162,22300620,"JAN 24, 2024",MIN @ WAS,W,34,11,28,0.393,3,10,0.3,13,14,0.929,1,2,3,5,1,0,4,4,38,6,1,MIN,WAS,MIN,118,,,46,41,43,8
Anthony Edwards,G,22023,1630162,22300610,"JAN 22, 2024",MIN vs. CHA,L,37,3,11,0.273,1,5,0.2,2,2,1.0,0,5,5,11,0,0,1,1,9,7,1,MIN,MIN,CHA,125,,,25,14,20,16
Anthony Edwards,G,22023,1630162,22300599,"JAN 20, 2024",MIN vs. OKC,L,38,6,10,0.6,1,3,0.333,6,10,0.6,0,5,5,5,0,0,5,2,19,-13,1,MIN,MIN,OKC,97,,,29,24,24,10
Anthony Edwards,G,22023,1630162,22300582,"JAN 18, 2024",MIN vs. MEM,W,34,11,19,0.579,1,6,0.167,5,6,0.833,0,5,5,5,1,0,3,2,28,10,1,MIN,MIN,MEM,118,,,38,33,33,10
Anthony Edwards,G,22023,1630162,22300569,"JAN 17, 2024",MIN @ DET,W,33,10,24,0.417,3,8,0.375,4,4,1.0,0,5,5,8,0,0,3,3,27,5,1,MIN,DET,MIN,124,,,40,32,35,13
Anthony Edwards,G,22023,1630162,22300553,"JAN 14, 2024",MIN vs. LAC,W,38,10,16,0.625,2,4,0.5,11,12,0.917,1,8,9,6,2,0,5,1,33,13,1,MIN,MIN,LAC,109,,,48,42,39,15
Anthony Edwards,G,22023,1630162,22300538,"JAN 12, 2024",MIN vs. POR,W,27,4,9,0.444,0,3,0.0,1,2,0.5,0,3,3,6,1,1,0,2,9,41,1,MIN,MIN,POR,116,,,18,12,15,9
Anthony Edwards,G,22023,1630162,22300517,"JAN 10, 2024",MIN @ BOS,L,46,11,25,0.44,3,6,0.5,4,4,1.0,0,6,6,3,0,0,5,1,29,-1,1,MIN,BOS,MIN,120,,,38,35,32,9
Anthony Edwards,G,22023,1630162,22300513,"JAN 09, 2024",MIN @ ORL,W,26,2,7,0.286,0,2,0.0,2,3,0.667,1,3,4,3,0,0,5,3,6,1,1,MIN,ORL,MIN,113,,,13,10,9,7
Anthony Edwards,G,22023,1630162,22300501,"JAN 07, 2024",MIN @ DAL,L,37,14,27,0.519,3,6,0.5,5,7,0.714,5,5,10,3,3,1,2,3,36,-5,1,MIN,DAL,MIN,108,,,49,46,39,13
Anthony Edwards,G,22023,1630162,22300485,"JAN 05, 2024",MIN @ HOU,W,33,8,17,0.471,2,5,0.4,6,6,1.0,0,3,3,5,2,0,5,2,24,14,1,MIN,HOU,MIN,122,,,32,27,29,8
Anthony Edwards,G,22023,1630162,22300471,"JAN 03, 2024",MIN vs. NOP,L,37,11,22,0.5,4,7,0.571,9,10,0.9,2,2,4,5,1,1,6,1,35,-15,1,MIN,MIN,NOP,106,,,44,39,40,9
Anthony Edwards,G,22023,1630162,22300451,"JAN 01, 2024",MIN @ NYK,L,38,11,21,0.524,4,9,0.444,9,10,0.9,0,4,4,2,0,2,4,1,35,2,1,MIN,NYK,MIN,106,,,41,39,37,6
Anthony Edwards,G,22023,1630162,22300443,"DEC 30, 2023",MIN vs. LAL,W,38,10,23,0.435,2,8,0.25,9,11,0.818,0,3,3,3,0,3,3,3,31,8,1,MIN,MIN,LAL,108,,,37,34,34,6
Anthony Edwards,G,22023,1630162,22300423,"DEC 28, 2023",MIN vs. DAL,W,38,12,23,0.522,6,11,0.545,14,18,0.778,0,3,3,4,3,1,6,2,44,11,1,MIN,MIN,DAL,118,,,51,47,48,7
Anthony Edwards,G,22023,1630162,22300411,"DEC 26, 2023",MIN @ OKC,L,34,7,16,0.438,2,5,0.4,9,13,0.692,1,6,7,6,1,0,4,3,25,-16,1,MIN,OKC,MIN,106,,,38,32,31,13
Anthony Edwards,G,22023,1630162,22300400,"DEC 23, 2023",MIN @ SAC,W,39,13,27,0.481,3,12,0.25,5,5,1.0,0,5,5,10,1,1,5,1,34,8,1,MIN,SAC,MIN,110,,,49,39,44,15
Anthony Edwards,G,22023,1630162,22300380,"DEC 21, 2023",MIN vs. LAL,W,38,9,19,0.474,2,6,0.333,7,8,0.875,0,7,7,5,3,1,5,0,27,2,1,MIN,MIN,LAL,118,,,39,34,32,12
Anthony Edwards,G,22023,1630162,22300367,"DEC 20, 2023",MIN @ PHI,L,36,9,20,0.45,2,6,0.333,7,8,0.875,1,6,7,5,0,0,1,2,27,-10,1,MIN,PHI,MIN,113,,,39,34,32,12
Anthony Edwards,G,22023,1630162,22300353,"DEC 18, 2023",MIN @ MIA,W,40,13,25,0.52,2,9,0.222,4,4,1.0,0,8,8,5,3,2,1,1,32,6,1,MIN,MIA,MIN,112,,,45,40,37,13
Anthony Edwards,G,22023,1630162,22300338,"DEC 16, 2023",MIN vs. IND,W,34,14,23,0.609,7,10,0.7,2,2,1.0,0,2,2,4,3,0,4,3,37,17,1,MIN,MIN,IND,127,,,43,39,41,6
Anthony Edwards,G,22023,1630162,22300321,"DEC 14, 2023",MIN @ DAL,W,35,3,19,0.158,0,3,0.0,3,6,0.5,1,1,2,11,2,0,5,2,9,20,1,MIN,DAL,MIN,119,,,22,11,20,13
Anthony Edwards,G,22023,1630162,22301221,"DEC 08, 2023",MIN @ MEM,W,4,0,1,0.0,0,0,0.0,0,0,0.0,0,0,0,1,0,0,0,0,0,-3,1,MIN,MEM,MIN,127,,,1,0,1,1
Anthony Edwards,G,22023,1630162,22301210,"DEC 06, 2023",MIN vs. SAS,W,37,4,17,0.235,2,5,0.4,7,8,0.875,1,6,7,6,1,1,3,2,17,14,1,MIN,MIN,SAS,102,,,30,24,23,13
Anthony Edwards,G,22023,1630162,22300058,"NOV 28, 2023",MIN vs. OKC,W,28,7,16,0.438,3,6,0.5,4,6,0.667,0,5,5,1,0,1,2,2,21,0,1,MIN,MIN,OKC,106,,,27,26,22,6
Anthony Edwards,G,22023,1630162,22300249,"NOV 26, 2023",MIN @ MEM,W,34,8,14,0.571,1,4,0.25,7,7,1.0,0,5,5,7,0,1,2,3,24,23,1,MIN,MEM,MIN,119,,,36,29,31,12
Anthony Edwards,G,22023,1630162,22300050,"NOV 24, 2023",MIN vs. SAC,L,40,8,21,0.381,2,9,0.222,17,18,0.944,0,7,7,5,2,2,4,2,35,5,1,MIN,MIN,SAC,111,,,47,42,40,12
Anthony Edwards,G,22023,1630162,22300232,"NOV 22, 2023",MIN vs. PHI,W,36,11,22,0.5,5,9,0.556,4,4,1.0,2,4,6,6,2,0,2,2,31,19,1,MIN,MIN,PHI,112,,,43,37,37,12
Anthony Edwards,G,22023,1630162,22300221,"NOV 20, 2023",MIN vs. NYK,W,39,9,21,0.429,1,6,0.167,4,4,1.0,2,8,10,5,2,0,3,1,23,9,1,MIN,MIN,NYK,117,,,38,33,28,15
Anthony Edwards,G,22023,1630162,22300203,"NOV 18, 2023",MIN @ NOP,W,30,9,19,0.474,5,10,0.5,0,0,0.0,0,3,3,4,0,0,3,6,23,13,1,MIN,NOP,MIN,121,,,30,26,27,7
Anthony Edwards,G,22023,1630162,22300197,"NOV 15, 2023",MIN @ PHX,L,31,4,16,0.25,1,3,0.333,4,4,1.0,1,3,4,4,1,1,1,0,13,-29,1,MIN,PHX,MIN,115,,,21,17,17,8
Anthony Edwards,G,22023,1630162,22300025,"NOV 14, 2023",MIN @ GSW,W,36,7,16,0.438,3,6,0.5,3,5,0.6,0,4,4,4,3,0,5,1,20,-9,1,MIN,GSW,MIN,104,,,28,24,24,8
Anthony Edwards,G,22023,1630162,22300186,"NOV 12, 2023",MIN @ GSW,W,38,11,27,0.407,1,9,0.111,10,10,1.0,1,5,6,7,2,0,4,0,33,15,1,MIN,GSW,MIN,116,,,46,39,40,13
Anthony Edwards,G,22023,1630162,22300013,"NOV 10, 2023",MIN @ SAS,W,37,9,21,0.429,2,8,0.25,8,11,0.727,2,5,7,5,2,1,4,1,28,3,1,MIN,SAS,MIN,117,,,40,35,33,12
Anthony Edwards,G,22023,1630162,22300166,"NOV 08, 2023",MIN vs. NOP,W,33,10,22,0.455,2,8,0.25,4,5,0.8,0,3,3,8,3,2,3,1,26,35,1,MIN,MIN,NOP,122,,,37,29,34,11
Anthony Edwards,G,22023,1630162,22300154,"NOV 06, 2023",MIN vs. BOS,W,38,15,25,0.6,2,8,0.25,6,7,0.857,0,9,9,7,1,0,3,5,38,18,1,MIN,MIN,BOS,114,,,54,47,45,16
Anthony Edwards,G,22023,1630162,22300138,"NOV 04, 2023",MIN vs. UTA,W,36,13,19,0.684,2,4,0.5,3,5,0.6,0,8,8,6,1,0,6,0,31,27,1,MIN,MIN,UTA,123,,,45,39,37,14
Anthony Edwards,G,22023,1630162,22300123,"NOV 01, 2023",MIN vs. DEN,W,32,8,16,0.5,1,4,0.25,7,8,0.875,0,2,2,1,2,0,4,1,24,11,1,MIN,MIN,DEN,110,,,27,26,25,3
Anthony Edwards,G,22023,1630162,22300104,"OCT 30, 2023",MIN @ ATL,L,38,13,21,0.619,5,8,0.625,0,1,0.0,0,5,5,7,1,0,5,4,31,-9,1,MIN,ATL,MIN,113,,,43,36,38,12
Anthony Edwards,G,22023,1630162,22300093,"OCT 28, 2023",MIN vs. MIA,W,33,7,15,0.467,3,5,0.6,2,2,1.0,0,2,2,7,0,0,2,3,19,21,1,MIN,MIN,MIA,106,,,28,21,26,9
Anthony Edwards,G,22023,1630162,22300069,"OCT 25, 2023",MIN @ TOR,L,38,8,27,0.296,4,7,0.571,6,6,1.0,5,9,14,1,0,0,2,1,26,0,1,MIN,TOR,MIN,94,,,41,40,27,15
Kyrie Irving,G,22023,202681,22300487,"JAN 05, 2024",DAL vs. POR,W,29,10,18,0.556,3,7,0.429,1,1,1.0,0,9,9,5,2,2,1,0,24,27,1,DAL,DAL,POR,132,,,38,33,29,14
Kyrie Irving,G,22023,202681,22300577,"JAN 17, 2024",DAL @ LAL,L,32,4,16,0.25,1,5,0.2,3,3,1.0,0,5,5,6,0,0,2,2,12,-14,1,DAL,LAL,DAL,105,,,23,17,18,11
Kyrie Irving,G,22023,202681,22300556,"JAN 15, 2024",DAL vs. NOP,W,41,13,28,0.464,3,9,0.333,13,15,0.867,0,7,7,7,0,1,3,1,42,7,1,DAL,DAL,NOP,125,,,56,49,49,14
Kyrie Irving,G,22023,202681,22300547,"JAN 13, 2024",DAL vs. NOP,L,40,12,27,0.444,5,14,0.357,4,4,1.0,0,5,5,6,1,0,1,2,33,-8,1,DAL,DAL,NOP,108,,,44,38,39,11
Kyrie Irving,G,22023,202681,22300530,"JAN 11, 2024",DAL vs. NYK,W,40,15,26,0.577,6,10,0.6,8,9,0.889,0,4,4,10,2,0,5,3,44,9,1,DAL,DAL,NYK,128,,,58,48,54,14
Kyrie Irving,G,22023,202681,22300515,"JAN 09, 2024",DAL vs. MEM,L,40,11,25,0.44,2,7,0.286,9,10,0.9,4,4,8,4,4,1,3,3,33,-2,1,DAL,DAL,MEM,103,,,45,41,37,12
Kyrie Irving,G,22023,202681,22300501,"JAN 07, 2024",DAL vs. MIN,W,39,14,27,0.519,6,8,0.75,1,1,1.0,5,3,8,5,3,2,3,2,35,6,1,DAL,DAL,MIN,115,,,48,43,40,13
Kyrie Irving,G,22023,202681,22300472,"JAN 03, 2024",DAL vs. POR,W,29,10,19,0.526,4,8,0.5,5,6,0.833,1,8,9,5,2,0,1,0,29,20,1,DAL,DAL,POR,126,,,43,38,34,14
Kyrie Irving,G,22023,202681,22301226,"DEC 08, 2023",DAL @ POR,W,13,4,6,0.667,0,0,0.0,3,3,1.0,0,2,2,2,1,0,0,1,11,-10,1,DAL,POR,DAL,125,,,15,13,13,4
Kyrie Irving,G,22023,202681,22301213,"DEC 06, 2023",DAL vs. UTA,W,27,11,16,0.688,4,7,0.571,0,0,0.0,0,3,3,4,3,0,1,2,26,26,1,DAL,DAL,UTA,147,,,33,29,30,7
Kyrie Irving,G,22023,202681,22300277,"DEC 01, 2023",DAL vs. MEM,L,36,3,15,0.2,0,5,0.0,4,5,0.8,0,5,5,5,0,0,1,2,10,-6,1,DAL,DAL,MEM,94,,,20,15,15,10
Kyrie Irving,G,22023,202681,22300059,"NOV 28, 2023",DAL vs. HOU,W,36,8,22,0.364,2,7,0.286,9,9,1.0,1,1,2,5,1,1,0,1,27,-9,1,DAL,DAL,HOU,121,,,34,29,32,7
Kyrie Irving,G,22023,202681,22300244,"NOV 25, 2023",DAL @ LAC,L,32,11,22,0.5,3,7,0.429,1,1,1.0,0,6,6,3,1,0,1,3,26,1,1,DAL,LAC,DAL,88,,,35,32,29,9
Kyrie Irving,G,22023,202681,22300238,"NOV 22, 2023",DAL @ LAL,W,35,11,22,0.5,4,8,0.5,2,2,1.0,1,5,6,2,2,0,2,0,28,14,1,DAL,LAL,DAL,104,,,36,34,30,8
Kyrie Irving,G,22023,202681,22300205,"NOV 18, 2023",DAL @ MIL,L,34,16,29,0.552,3,10,0.3,4,4,1.0,1,3,4,6,1,0,2,4,39,13,1,DAL,MIL,DAL,125,,,49,43,45,10
Kyrie Irving,G,22023,202681,22300022,"NOV 14, 2023",DAL @ NOP,L,26,6,13,0.462,3,7,0.429,2,4,0.5,1,1,2,6,0,0,1,1,17,-14,1,DAL,NOP,DAL,110,,,25,19,23,8
Kyrie Irving,G,22023,202681,22300183,"NOV 12, 2023",DAL @ NOP,W,29,13,20,0.65,7,10,0.7,2,2,1.0,1,5,6,7,0,1,1,1,35,9,1,DAL,NOP,DAL,136,,,48,41,42,13
Kyrie Irving,G,22023,202681,22300014,"NOV 10, 2023",DAL vs. LAC,W,28,8,19,0.421,5,9,0.556,6,6,1.0,3,3,6,3,2,0,2,1,27,12,1,DAL,DAL,LAC,144,,,36,33,30,9
Kyrie Irving,G,22023,202681,22300006,"NOV 03, 2023",DAL @ DEN,L,35,9,15,0.6,1,5,0.2,3,4,0.75,0,1,1,7,4,2,3,1,22,-12,1,DAL,DEN,DAL,114,,,30,23,29,8
Kyrie Irving,G,22023,202681,22300084,"OCT 27, 2023",DAL vs. BKN,W,34,6,17,0.353,1,4,0.25,4,4,1.0,1,6,7,6,0,0,0,2,17,-7,1,DAL,DAL,BKN,125,,,30,24,23,13
Kyrie Irving,G,22023,202681,22300073,"OCT 25, 2023",DAL @ SAS,W,36,10,24,0.417,1,8,0.125,1,1,1.0,0,2,2,6,1,0,2,3,22,1,1,DAL,SAS,DAL,126,,,30,24,28,8
Kyrie Irving,G,22023,202681,22300748,"FEB 10, 2024",DAL vs. OKC,W,33,11,19,0.579,2,7,0.286,1,2,0.5,1,5,6,8,1,0,1,2,25,32,1,DAL,DAL,OKC,146,,,39,31,33,14
Kyrie Irving,G,22023,202681,22300736,"FEB 08, 2024",DAL @ NYK,W,36,7,17,0.412,2,6,0.333,0,0,0.0,0,5,5,6,0,0,2,3,16,12,1,DAL,NYK,DAL,121,,,27,21,22,11
Kyrie Irving,G,22023,202681,22300720,"FEB 06, 2024",DAL @ BKN,W,40,15,24,0.625,6,10,0.6,0,0,0.0,0,2,2,5,2,0,3,1,36,15,1,DAL,BKN,DAL,119,,,43,38,41,7
Kyrie Irving,G,22023,202681,22300715,"FEB 05, 2024",DAL @ PHI,W,35,10,17,0.588,2,3,0.667,1,1,1.0,1,4,5,8,2,1,1,4,23,15,1,DAL,PHI,DAL,118,,,36,28,31,13
Kyrie Irving,G,22023,202681,22300611,"JAN 22, 2024",DAL vs. BOS,L,36,9,20,0.45,3,7,0.429,2,2,1.0,0,6,6,3,2,0,1,3,23,0,1,DAL,DAL,BOS,110,,,32,29,26,9
Kyrie Irving,G,22023,202681,22300457,"JAN 01, 2024",DAL @ UTA,L,32,6,14,0.429,2,3,0.667,0,1,0.0,1,8,9,4,0,1,1,3,14,-15,1,DAL,UTA,DAL,86,,,27,23,18,13
Kyrie Irving,G,22023,202681,22300212,"NOV 19, 2023",DAL vs. SAC,L,33,8,17,0.471,2,6,0.333,5,5,1.0,0,2,2,1,0,0,1,2,23,-19,1,DAL,DAL,SAC,113,,,26,25,24,3
Kyrie Irving,G,22023,202681,22300168,"NOV 08, 2023",DAL vs. TOR,L,36,8,19,0.421,3,7,0.429,3,3,1.0,0,4,4,5,0,0,1,2,22,4,1,DAL,DAL,TOR,116,,,31,26,27,9
Kyrie Irving,G,22023,202681,22300147,"NOV 06, 2023",DAL @ ORL,W,37,8,20,0.4,2,6,0.333,3,5,0.6,1,5,6,10,3,0,3,2,21,18,1,DAL,ORL,DAL,117,,,37,27,31,16
Kyrie Irving,G,22023,202681,22300143,"NOV 05, 2023",DAL vs. CHA,W,34,6,14,0.429,2,6,0.333,4,4,1.0,0,3,3,10,1,1,2,3,18,8,1,DAL,DAL,CHA,124,,,31,21,28,13
Damian Lillard,G,22023,203081,22300745,"FEB 09, 2024",MIL vs. CHA,W,29,9,18,0.5,2,8,0.25,6,6,1.0,0,4,4,8,3,0,0,1,26,33,1,MIL,MIL,CHA,120,,,38,30,34,12
Damian Lillard,G,22023,203081,22300711,"FEB 04, 2024",MIL @ UTA,L,38,5,18,0.278,1,8,0.125,1,2,0.5,0,0,0,6,1,2,3,5,12,-21,1,MIL,UTA,MIL,108,,,18,12,18,6
Damian Lillard,G,22023,203081,22300702,"FEB 03, 2024",MIL @ DAL,W,38,10,11,0.909,5,5,1.0,5,6,0.833,0,3,3,8,0,1,6,3,30,16,1,MIL,DAL,MIL,129,,,41,33,38,11
Damian Lillard,G,22023,203081,22300683,"JAN 31, 2024",MIL @ POR,L,40,9,23,0.391,3,13,0.231,4,4,1.0,2,4,6,7,1,0,4,2,25,6,1,MIL,POR,MIL,116,,,38,31,32,13
Damian Lillard,G,22023,203081,22300667,"JAN 29, 2024",MIL @ DEN,L,35,5,13,0.385,2,4,0.5,6,6,1.0,2,1,3,5,0,1,4,2,18,1,1,MIL,DEN,MIL,107,,,26,21,23,8
Damian Lillard,G,22023,203081,22300648,"JAN 27, 2024",MIL vs. NOP,W,29,7,14,0.5,3,7,0.429,9,10,0.9,0,6,6,9,2,0,0,1,26,23,1,MIL,MIL,NOP,141,,,41,32,35,15
Damian Lillard,G,22023,203081,22300639,"JAN 26, 2024",MIL vs. CLE,L,38,7,24,0.292,2,10,0.2,6,6,1.0,1,3,4,3,1,0,4,0,22,-7,1,MIL,MIL,CLE,100,,,29,26,25,7
Damian Lillard,G,22023,203081,22300624,"JAN 24, 2024",MIL vs. CLE,W,35,8,21,0.381,2,9,0.222,10,11,0.909,0,1,1,4,2,0,2,1,28,8,1,MIL,MIL,CLE,126,,,33,29,32,5
Damian Lillard,G,22023,203081,22300606,"JAN 22, 2024",MIL @ DET,W,37,4,15,0.267,2,10,0.2,7,8,0.875,0,5,5,8,1,0,2,0,17,20,1,MIL,DET,MIL,122,,,30,22,25,13
Damian Lillard,G,22023,203081,22300592,"JAN 20, 2024",MIL @ DET,W,37,12,22,0.545,5,11,0.455,16,16,1.0,0,6,6,11,1,0,1,3,45,18,1,MIL,DET,MIL,141,,,62,51,56,17
Damian Lillard,G,22023,203081,22300552,"JAN 14, 2024",MIL vs. SAC,W,41,9,23,0.391,5,13,0.385,6,6,1.0,0,4,4,8,0,0,4,0,29,-6,1,MIL,MIL,SAC,143,,,41,33,37,12
Damian Lillard,G,22023,203081,22300545,"JAN 13, 2024",MIL vs. GSW,W,38,9,19,0.474,2,5,0.4,7,7,1.0,0,6,6,7,2,0,1,1,27,21,1,MIL,MIL,GSW,129,,,40,33,34,13
Damian Lillard,G,22023,203081,22300528,"JAN 11, 2024",MIL vs. BOS,W,27,6,12,0.5,3,8,0.375,6,6,1.0,0,4,4,4,0,0,0,1,21,25,1,MIL,MIL,BOS,135,,,29,25,25,8
Damian Lillard,G,22023,203081,22300496,"JAN 06, 2024",MIL @ HOU,L,38,5,16,0.313,1,8,0.125,7,10,0.7,0,2,2,8,2,0,1,1,18,-11,1,MIL,HOU,MIL,108,,,28,20,26,10
Damian Lillard,G,22023,203081,22300477,"JAN 04, 2024",MIL @ SAS,W,39,10,19,0.526,1,6,0.167,4,4,1.0,1,3,4,10,1,0,0,3,25,11,1,MIL,SAS,MIL,125,,,39,29,35,14
Damian Lillard,G,22023,203081,22300466,"JAN 03, 2024",MIL @ IND,L,36,6,18,0.333,2,8,0.25,9,10,0.9,1,1,2,5,3,0,2,3,23,-22,1,MIL,IND,MIL,130,,,30,25,28,7
Damian Lillard,G,22023,203081,22300454,"JAN 01, 2024",MIL vs. IND,L,38,3,16,0.188,1,9,0.111,6,6,1.0,1,6,7,5,0,0,1,3,13,4,1,MIL,MIL,IND,113,,,25,20,18,12
Damian Lillard,G,22023,203081,22300433,"DEC 29, 2023",MIL @ CLE,W,34,9,16,0.563,2,6,0.333,11,11,1.0,0,2,2,4,0,0,2,3,31,14,1,MIL,CLE,MIL,119,,,37,33,35,6
Damian Lillard,G,22023,203081,22300417,"DEC 27, 2023",MIL @ BKN,W,29,4,10,0.4,3,9,0.333,1,1,1.0,0,3,3,4,0,0,4,0,12,2,1,MIL,BKN,MIL,144,,,19,15,16,7
Damian Lillard,G,22023,203081,22300401,"DEC 25, 2023",MIL @ NYK,L,38,10,21,0.476,4,13,0.308,8,9,0.889,0,1,1,8,1,0,4,2,32,-6,1,MIL,NYK,MIL,122,,,41,33,40,9
Damian Lillard,G,22023,203081,22300388,"DEC 23, 2023",MIL @ NYK,W,34,6,16,0.375,3,7,0.429,4,5,0.8,3,6,9,7,1,0,3,3,19,3,1,MIL,NYK,MIL,130,,,35,28,26,16
Damian Lillard,G,22023,203081,22300378,"DEC 21, 2023",MIL vs. ORL,W,35,5,17,0.294,4,8,0.5,10,10,1.0,0,5,5,8,0,0,3,1,24,9,1,MIL,MIL,ORL,118,,,37,29,32,13
Damian Lillard,G,22023,203081,22300361,"DEC 19, 2023",MIL vs. SAS,W,35,14,22,0.636,7,12,0.583,5,5,1.0,0,3,3,4,3,0,1,0,40,26,1,MIL,MIL,SAS,132,,,47,43,44,7
Damian Lillard,G,22023,203081,22300346,"DEC 17, 2023",MIL vs. HOU,W,37,11,19,0.579,5,8,0.625,12,13,0.923,0,5,5,11,3,0,3,2,39,10,1,MIL,MIL,HOU,128,,,55,44,50,16
Damian Lillard,G,22023,203081,22300334,"DEC 16, 2023",MIL vs. DET,W,30,11,22,0.5,6,14,0.429,5,5,1.0,0,4,4,5,0,1,2,3,33,26,1,MIL,MIL,DET,146,,,42,37,38,9
Damian Lillard,G,22023,203081,22300315,"DEC 13, 2023",MIL vs. IND,W,36,6,14,0.429,2,8,0.25,7,9,0.778,0,4,4,6,1,0,4,2,21,15,1,MIL,MIL,IND,140,,,31,25,27,10
Damian Lillard,G,22023,203081,22300300,"DEC 11, 2023",MIL vs. CHI,W,41,3,17,0.176,2,9,0.222,6,7,0.857,0,4,4,9,0,1,2,2,14,0,1,MIL,MIL,CHI,133,,,27,18,23,13
Damian Lillard,G,22023,203081,22301229,"DEC 07, 2023",MIL vs. IND,L,42,7,20,0.35,4,9,0.444,6,6,1.0,0,7,7,7,1,1,3,2,24,6,1,MIL,MIL,IND,119,,,38,31,31,14
Damian Lillard,G,22023,203081,22301201,"DEC 05, 2023",MIL vs. NYK,W,34,8,13,0.615,5,7,0.714,7,8,0.875,1,2,3,7,1,1,3,4,28,17,1,MIL,MIL,NYK,146,,,38,31,35,10
Damian Lillard,G,22023,203081,22300286,"DEC 02, 2023",MIL vs. ATL,W,38,10,16,0.625,3,6,0.5,2,2,1.0,1,5,6,9,1,0,4,3,25,14,1,MIL,MIL,ATL,132,,,40,31,34,15
Damian Lillard,G,22023,203081,22300269,"NOV 30, 2023",MIL @ CHI,L,43,7,16,0.438,1,6,0.167,3,4,0.75,1,4,5,13,2,1,7,1,18,9,1,MIL,CHI,MIL,113,,,36,23,31,18
Damian Lillard,G,22023,203081,22300056,"NOV 28, 2023",MIL @ MIA,W,37,9,18,0.5,4,9,0.444,10,10,1.0,2,2,4,9,0,0,1,1,32,13,1,MIL,MIA,MIL,131,,,45,36,41,13
Damian Lillard,G,22023,203081,22300245,"NOV 26, 2023",MIL vs. POR,W,37,7,21,0.333,4,12,0.333,13,14,0.929,1,4,5,4,2,0,3,2,31,15,1,MIL,MIL,POR,108,,,40,36,35,9
Damian Lillard,G,22023,203081,22300049,"NOV 24, 2023",MIL vs. WAS,W,37,11,18,0.611,2,5,0.4,7,8,0.875,1,5,6,10,0,0,1,1,31,1,1,MIL,MIL,WAS,131,,,47,37,41,16
Damian Lillard,G,22023,203081,22300228,"NOV 22, 2023",MIL @ BOS,L,38,11,24,0.458,3,10,0.3,2,2,1.0,0,5,5,5,2,0,3,2,27,9,1,MIL,BOS,MIL,116,,,37,32,32,10
Damian Lillard,G,22023,203081,22300219,"NOV 20, 2023",MIL @ WAS,W,33,5,14,0.357,3,6,0.5,9,11,0.818,1,4,5,7,0,0,1,1,22,6,1,MIL,WAS,MIL,142,,,34,27,29,12
Damian Lillard,G,22023,203081,22300205,"NOV 18, 2023",MIL vs. DAL,W,38,7,18,0.389,4,11,0.364,9,10,0.9,0,3,3,12,1,0,1,2,27,-6,1,MIL,MIL,DAL,132,,,42,30,39,15
Damian Lillard,G,22023,203081,22300027,"NOV 17, 2023",MIL @ CHA,W,31,9,18,0.5,5,10,0.5,4,4,1.0,0,5,5,5,1,0,2,2,27,10,1,MIL,CHA,MIL,130,,,37,32,32,10
Damian Lillard,G,22023,203081,22300190,"NOV 13, 2023",MIL vs. CHI,W,32,3,17,0.176,1,9,0.111,5,5,1.0,2,1,3,5,0,0,5,0,12,-6,1,MIL,MIL,CHI,118,,,20,15,17,8
Damian Lillard,G,22023,203081,22300165,"NOV 08, 2023",MIL vs. DET,W,34,10,25,0.4,2,12,0.167,12,13,0.923,0,2,2,3,3,0,1,1,34,5,1,MIL,MIL,DET,120,,,39,36,37,5
Damian Lillard,G,22023,203081,22300149,"NOV 06, 2023",MIL @ BKN,W,34,5,15,0.333,2,8,0.25,9,10,0.9,2,4,6,7,1,0,1,1,21,-14,1,MIL,BKN,MIL,129,,,34,27,28,13
Damian Lillard,G,22023,203081,22300002,"NOV 03, 2023",MIL vs. NYK,W,36,7,15,0.467,4,7,0.571,12,12,1.0,0,4,4,4,1,1,4,0,30,2,1,MIL,MIL,NYK,110,,,38,34,34,8
Damian Lillard,G,22023,203081,22300116,"NOV 01, 2023",MIL @ TOR,L,31,4,9,0.444,1,4,0.25,6,7,0.857,0,2,2,6,0,0,2,1,15,-26,1,MIL,TOR,MIL,111,,,23,17,21,8
Damian Lillard,G,22023,203081,22300107,"OCT 30, 2023",MIL vs. MIA,W,35,7,14,0.5,2,7,0.286,9,11,0.818,1,4,5,4,1,0,4,2,25,2,1,MIL,MIL,MIA,122,,,34,30,29,9
Damian Lillard,G,22023,203081,22300097,"OCT 29, 2023",MIL vs. ATL,L,29,2,12,0.167,2,8,0.25,0,0,0.0,1,3,4,5,2,0,6,2,6,-29,1,MIL,MIL,ATL,110,,,15,10,11,9
Damian Lillard,G,22023,203081,22300075,"OCT 26, 2023",MIL vs. PHI,W,37,9,20,0.45,4,12,0.333,17,17,1.0,0,8,8,4,0,0,0,2,39,12,1,MIL,MIL,PHI,118,,,51,47,43,12
Damian Lillard,G,22023,203081,22300572,"JAN 17, 2024",MIL @ CLE,L,25,7,20,0.35,1,5,0.2,2,3,0.667,1,1,2,5,2,0,1,1,17,-26,1,MIL,CLE,MIL,95,,,24,19,22,7
Damian Lillard,G,22023,203081,22300195,"NOV 15, 2023",MIL @ TOR,W,31,9,18,0.5,4,10,0.4,15,16,0.938,0,4,4,13,2,0,4,1,37,25,1,MIL,TOR,MIL,128,,,54,41,50,17
Ja Morant,G,22023,1629630,22300491,"JAN 05, 2024",MEM @ LAL,W,35,7,17,0.412,3,7,0.429,4,5,0.8,2,5,7,7,1,1,2,3,21,15,1,MEM,LAL,MEM,127,,,35,28,28,14
Ja Morant,G,22023,1629630,22300470,"JAN 03, 2024",MEM vs. TOR,L,35,10,18,0.556,3,6,0.5,5,6,0.833,1,7,8,9,1,0,2,1,28,-7,1,MEM,MEM,TOR,111,,,45,36,37,17
Ja Morant,G,22023,1629630,22300460,"JAN 02, 2024",MEM vs. SAS,W,35,7,15,0.467,3,9,0.333,9,12,0.75,0,5,5,10,1,0,4,3,26,-1,1,MEM,MEM,SAS,106,,,41,31,36,15
Ja Morant,G,22023,1629630,22300449,"DEC 31, 2023",MEM vs. SAC,L,31,4,12,0.333,2,4,0.5,7,8,0.875,0,3,3,3,0,0,0,3,17,-9,1,MEM,MEM,SAC,92,,,23,20,20,6
Ja Morant,G,22023,1629630,22300438,"DEC 29, 2023",MEM @ LAC,L,37,7,19,0.368,0,7,0.0,5,6,0.833,0,6,6,10,0,0,3,4,19,-19,1,MEM,LAC,MEM,106,,,35,25,29,16
Ja Morant,G,22023,1629630,22300410,"DEC 26, 2023",MEM @ NOP,W,40,12,24,0.5,1,7,0.143,6,8,0.75,0,4,4,7,1,2,6,2,31,3,1,MEM,NOP,MEM,116,,,42,35,38,11
Ja Morant,G,22023,1629630,22300393,"DEC 23, 2023",MEM @ ATL,W,36,14,25,0.56,1,3,0.333,1,1,1.0,0,6,6,11,1,1,3,1,30,2,1,MEM,ATL,MEM,125,,,47,36,41,17
Ja Morant,G,22023,1629630,22300377,"DEC 21, 2023",MEM vs. IND,W,34,7,16,0.438,1,3,0.333,5,6,0.833,0,5,5,8,0,0,2,0,20,15,1,MEM,MEM,IND,116,,,33,25,28,13
Ja Morant,G,22023,1629630,22300360,"DEC 19, 2023",MEM @ NOP,W,35,12,24,0.5,0,5,0.0,10,12,0.833,3,3,6,8,2,1,5,2,34,12,1,MEM,NOP,MEM,115,,,48,40,42,14
LeBron James,F,22023,2544,22300605,"JAN 21, 2024",LAL vs. POR,W,31,8,16,0.5,3,8,0.375,9,10,0.9,0,5,5,5,0,0,3,2,28,28,1,LAL,LAL,POR,134,,,38,33,33,10
LeBron James,F,22023,2544,22300331,"DEC 15, 2023",LAL @ SAS,L,36,7,17,0.412,2,6,0.333,7,10,0.7,2,5,7,14,2,0,2,1,23,-28,1,LAL,SAS,LAL,115,,,44,30,37,21
LeBron James,F,22023,2544,22300271,"NOV 30, 2023",LAL @ OKC,L,35,7,12,0.583,4,8,0.5,3,4,0.75,2,10,12,6,1,1,5,1,21,-18,1,LAL,OKC,LAL,110,,,39,33,27,18
LeBron James,F,22023,2544,22300163,"NOV 08, 2023",LAL @ HOU,L,27,7,13,0.538,0,2,0.0,4,5,0.8,1,5,6,2,0,0,3,1,18,-24,1,LAL,HOU,LAL,94,,,26,24,20,8
LeBron James,F,22023,2544,22300134,"NOV 04, 2023",LAL @ ORL,L,35,8,15,0.533,2,5,0.4,6,7,0.857,1,8,9,5,3,0,3,1,24,12,1,LAL,ORL,LAL,101,,,38,33,29,14
LeBron James,F,22023,2544,22300740,"FEB 08, 2024",LAL vs. DEN,L,35,9,20,0.45,2,6,0.333,5,5,1.0,1,8,9,7,1,1,2,0,25,-6,1,LAL,LAL,DEN,106,,,41,34,32,16
LeBron James,F,22023,2544,22300713,"FEB 05, 2024",LAL @ CHA,W,40,12,22,0.545,0,5,0.0,2,3,0.667,0,4,4,7,1,1,4,2,26,2,1,LAL,CHA,LAL,124,,,37,30,33,11
LeBron James,F,22023,2544,22300701,"FEB 03, 2024",LAL @ NYK,W,40,10,19,0.526,2,5,0.4,2,2,1.0,1,4,5,5,2,1,1,1,24,11,1,LAL,NYK,LAL,113,,,34,29,29,10
LeBron James,F,22023,2544,22300669,"JAN 30, 2024",LAL @ ATL,L,36,7,17,0.412,2,6,0.333,4,9,0.444,2,7,9,8,1,1,3,1,20,-6,1,LAL,ATL,LAL,122,,,37,29,28,17
LeBron James,F,22023,2544,22300662,"JAN 29, 2024",LAL @ HOU,L,37,9,15,0.6,2,5,0.4,3,8,0.375,0,6,6,10,1,1,1,4,23,-11,1,LAL,HOU,LAL,119,,,39,29,33,16
LeBron James,F,22023,2544,22300650,"JAN 27, 2024",LAL @ GSW,W,48,14,25,0.56,2,4,0.5,6,6,1.0,1,19,20,12,0,0,3,2,36,-6,1,LAL,GSW,LAL,145,,,68,56,48,32
LeBron James,F,22023,2544,22300633,"JAN 25, 2024",LAL vs. CHI,W,36,10,19,0.526,3,4,0.75,2,2,1.0,0,4,4,12,2,0,5,2,25,14,1,LAL,LAL,CHI,141,,,41,29,37,16
LeBron James,F,22023,2544,22300591,"JAN 19, 2024",LAL vs. BKN,L,34,9,22,0.409,2,5,0.4,4,5,0.8,5,6,11,5,0,0,4,1,24,-13,1,LAL,LAL,BKN,112,,,40,35,29,16
LeBron James,F,22023,2544,22300577,"JAN 17, 2024",LAL vs. DAL,W,33,10,19,0.526,3,7,0.429,2,2,1.0,1,7,8,8,1,0,3,1,25,20,1,LAL,LAL,DAL,127,,,41,33,33,16
LeBron James,F,22023,2544,22300565,"JAN 15, 2024",LAL vs. OKC,W,39,12,20,0.6,1,2,0.5,0,1,0.0,0,7,7,6,0,0,5,1,25,2,1,LAL,LAL,OKC,112,,,38,32,31,13
LeBron James,F,22023,2544,22300531,"JAN 11, 2024",LAL vs. PHX,L,24,3,11,0.273,0,4,0.0,4,7,0.571,0,5,5,9,1,0,4,1,10,-25,1,LAL,LAL,PHX,109,,,24,15,19,14
LeBron James,F,22023,2544,22300516,"JAN 09, 2024",LAL vs. TOR,W,35,8,17,0.471,2,5,0.4,4,6,0.667,0,5,5,12,1,1,3,0,22,0,1,LAL,LAL,TOR,132,,,39,27,34,17
LeBron James,F,22023,2544,22300505,"JAN 07, 2024",LAL vs. LAC,W,38,11,19,0.579,1,3,0.333,2,3,0.667,1,7,8,7,1,0,4,2,25,5,1,LAL,LAL,LAC,106,,,40,33,32,15
LeBron James,F,22023,2544,22300491,"JAN 05, 2024",LAL vs. MEM,L,39,11,24,0.458,4,9,0.444,6,10,0.6,2,3,5,7,5,0,4,0,32,-8,1,LAL,LAL,MEM,113,,,44,37,39,12
LeBron James,F,22023,2544,22300475,"JAN 03, 2024",LAL vs. MIA,L,38,6,18,0.333,0,6,0.0,0,0,0.0,0,6,6,9,0,0,2,2,12,-20,1,LAL,LAL,MIA,96,,,27,18,21,15
LeBron James,F,22023,2544,22300446,"DEC 31, 2023",LAL @ NOP,L,37,12,24,0.5,3,7,0.429,7,8,0.875,0,5,5,8,0,1,4,2,34,-11,1,LAL,NOP,LAL,109,,,47,39,42,13
LeBron James,F,22023,2544,22300428,"DEC 28, 2023",LAL vs. CHA,W,25,7,13,0.538,2,5,0.4,1,1,1.0,0,4,4,11,0,0,3,0,17,1,1,LAL,LAL,CHA,133,,,32,21,28,15
LeBron James,F,22023,2544,22300370,"DEC 20, 2023",LAL @ CHI,L,37,10,18,0.556,1,3,0.333,4,4,1.0,2,8,10,9,1,2,5,0,25,-11,1,LAL,CHI,LAL,108,,,44,35,34,19
LeBron James,F,22023,2544,22300306,"DEC 12, 2023",LAL @ DAL,L,40,14,27,0.519,3,8,0.375,2,3,0.667,2,6,8,9,3,1,4,1,33,-4,1,LAL,DAL,LAL,125,,,50,41,42,17
LeBron James,F,22023,2544,22301230,"DEC 07, 2023",LAL vs. NOP,W,23,9,12,0.75,4,4,1.0,8,8,1.0,0,5,5,8,0,0,0,1,30,36,1,LAL,LAL,NOP,133,,,43,35,38,13
LeBron James,F,22023,2544,22301203,"DEC 05, 2023",LAL vs. PHX,W,40,12,25,0.48,2,4,0.5,5,6,0.833,3,5,8,11,5,0,2,3,31,12,1,LAL,LAL,PHX,106,,,50,39,42,19
LeBron James,F,22023,2544,22300291,"DEC 02, 2023",LAL vs. HOU,W,35,7,17,0.412,0,4,0.0,2,5,0.4,0,4,4,7,1,1,5,0,16,16,1,LAL,LAL,HOU,107,,,27,20,23,11
LeBron James,F,22023,2544,22300258,"NOV 29, 2023",LAL @ DET,W,29,9,19,0.474,2,6,0.333,5,5,1.0,2,6,8,3,0,0,1,0,25,26,1,LAL,DET,LAL,133,,,36,33,28,11
LeBron James,F,22023,2544,22300255,"NOV 27, 2023",LAL @ PHI,L,30,8,12,0.667,1,1,1.0,1,2,0.5,0,0,0,5,1,1,1,0,18,-30,1,LAL,PHI,LAL,94,,,23,18,23,5
LeBron James,F,22023,2544,22300242,"NOV 25, 2023",LAL @ CLE,W,36,8,23,0.348,1,9,0.111,5,7,0.714,1,5,6,6,2,2,4,1,22,2,1,LAL,CLE,LAL,121,,,34,28,28,12
LeBron James,F,22023,2544,22300238,"NOV 22, 2023",LAL vs. DAL,L,36,9,19,0.474,4,9,0.444,4,7,0.571,2,7,9,7,0,0,3,0,26,7,1,LAL,LAL,DAL,101,,,42,35,33,16
LeBron James,F,22023,2544,22300042,"NOV 21, 2023",LAL vs. UTA,W,24,6,10,0.6,3,5,0.6,2,2,1.0,1,6,7,9,0,0,2,0,17,14,1,LAL,LAL,UTA,131,,,33,24,26,16
LeBron James,F,22023,2544,22300036,"NOV 17, 2023",LAL @ POR,W,35,13,22,0.591,5,9,0.556,4,6,0.667,0,5,5,9,2,0,3,3,35,19,1,LAL,POR,LAL,107,,,49,40,44,14
LeBron James,F,22023,2544,22300198,"NOV 15, 2023",LAL vs. SAC,L,35,9,15,0.6,3,7,0.429,7,8,0.875,2,8,10,12,4,1,6,1,28,0,1,LAL,LAL,SAC,110,,,50,38,40,22
LeBron James,F,22023,2544,22300026,"NOV 14, 2023",LAL vs. MEM,W,23,6,11,0.545,3,6,0.5,1,2,0.5,0,9,9,6,1,0,4,1,16,15,1,LAL,LAL,MEM,134,,,31,25,22,15
LeBron James,F,22023,2544,22300150,"NOV 06, 2023",LAL @ MIA,L,37,13,23,0.565,0,4,0.0,4,4,1.0,0,4,4,3,1,3,5,4,30,6,1,LAL,MIA,LAL,107,,,37,34,33,7
LeBron James,F,22023,2544,22300127,"NOV 01, 2023",LAL vs. LAC,W,42,13,19,0.684,4,8,0.5,5,10,0.5,0,12,12,7,1,2,4,3,35,6,1,LAL,LAL,LAC,130,,,54,47,42,19
LeBron James,F,22023,2544,22300061,"OCT 24, 2023",LAL @ DEN,L,29,10,16,0.625,1,4,0.25,0,1,0.0,1,7,8,5,1,0,0,1,21,7,1,LAL,DEN,LAL,107,,,34,29,26,13
LeBron James,F,22023,2544,22300747,"FEB 09, 2024",LAL vs. NOP,W,38,6,13,0.462,2,2,1.0,7,8,0.875,1,3,4,14,1,1,2,2,21,15,1,LAL,LAL,NOP,139,,,39,25,35,18
LeBron James,F,22023,2544,22300443,"DEC 30, 2023",LAL @ MIN,L,39,10,21,0.476,1,4,0.25,5,7,0.714,0,3,3,6,3,1,1,2,26,-5,1,LAL,MIN,LAL,106,,,35,29,32,9
LeBron James,F,22023,2544,22300403,"DEC 25, 2023",LAL vs. BOS,L,37,5,14,0.357,1,2,0.5,5,6,0.833,0,9,9,8,0,0,3,1,16,-11,1,LAL,LAL,BOS,115,,,33,25,24,17
LeBron James,F,22023,2544,22300397,"DEC 23, 2023",LAL @ OKC,W,37,13,20,0.65,5,5,1.0,9,9,1.0,2,5,7,7,2,2,3,0,40,10,1,LAL,OKC,LAL,129,,,54,47,47,14
LeBron James,F,22023,2544,22300359,"DEC 18, 2023",LAL vs. NYK,L,39,10,23,0.435,2,8,0.25,3,4,0.75,1,10,11,11,1,0,2,1,25,-13,1,LAL,LAL,NYK,109,,,47,36,36,22
LeBron James,F,22023,2544,22300216,"NOV 19, 2023",LAL vs. HOU,W,40,14,19,0.737,2,5,0.4,7,9,0.778,1,5,6,8,3,0,2,0,37,2,1,LAL,LAL,HOU,105,,,51,43,45,14
LeBron James,F,22023,2544,22300015,"NOV 10, 2023",LAL @ PHX,W,36,11,17,0.647,3,4,0.75,7,11,0.636,1,10,11,6,1,1,4,1,32,2,1,LAL,PHX,LAL,122,,,49,43,38,17
LeBron James,F,22023,2544,22300111,"OCT 30, 2023",LAL vs. ORL,W,33,7,17,0.412,2,6,0.333,3,4,0.75,0,3,3,4,3,1,5,0,19,5,1,LAL,LAL,ORL,106,,,26,22,23,7
LeBron James,F,22023,2544,22300100,"OCT 29, 2023",LAL @ SAC,L,39,11,19,0.579,3,8,0.375,2,6,0.333,0,15,15,8,0,0,8,2,27,-5,1,LAL,SAC,LAL,127,,,50,42,35,23
LeBron James,F,22023,2544,22300076,"OCT 26, 2023",LAL vs. PHX,W,35,7,14,0.5,1,5,0.2,6,8,0.75,1,7,8,9,2,2,5,1,21,22,1,LAL,LAL,PHX,100,,,38,29,30,17
Anthony Davis,C,22023,203076,22300605,"JAN 21, 2024",LAL vs. POR,W,26,4,7,0.571,0,1,0.0,6,6,1.0,3,11,14,3,0,0,0,0,14,3,1,LAL,LAL,POR,134,,,31,28,17,17
Anthony Davis,C,22023,203076,22300271,"NOV 30, 2023",LAL @ OKC,L,36,11,18,0.611,0,1,0.0,9,10,0.9,1,13,14,2,2,0,0,1,31,-12,1,LAL,OKC,LAL,110,,,47,45,33,16
Anthony Davis,C,22023,203076,22300134,"NOV 04, 2023",LAL @ ORL,L,32,10,15,0.667,0,0,0.0,8,8,1.0,6,7,13,3,0,7,4,5,28,-24,1,LAL,ORL,LAL,101,,,44,41,31,16
Anthony Davis,C,22023,203076,22300740,"FEB 08, 2024",LAL vs. DEN,L,38,14,27,0.519,0,3,0.0,4,6,0.667,1,8,9,3,3,4,1,0,32,-11,1,LAL,LAL,DEN,106,,,44,41,35,12
Anthony Davis,C,22023,203076,22300713,"FEB 05, 2024",LAL @ CHA,W,37,12,16,0.75,0,2,0.0,2,2,1.0,3,12,15,11,0,3,2,1,26,16,1,LAL,CHA,LAL,124,,,52,41,37,26
Anthony Davis,C,22023,203076,22300701,"FEB 03, 2024",LAL @ NYK,W,36,4,12,0.333,0,1,0.0,4,4,1.0,2,16,18,5,1,4,0,2,12,6,1,LAL,NYK,LAL,113,,,35,30,17,23
Anthony Davis,C,22023,203076,22300662,"JAN 29, 2024",LAL @ HOU,L,29,10,20,0.5,3,3,1.0,0,1,0.0,2,5,7,2,2,1,3,2,23,-10,1,LAL,HOU,LAL,119,,,32,30,25,9
Anthony Davis,C,22023,203076,22300650,"JAN 27, 2024",LAL @ GSW,W,45,11,24,0.458,0,4,0.0,7,9,0.778,3,10,13,3,0,4,2,4,29,-2,1,LAL,GSW,LAL,145,,,45,42,32,16
Anthony Davis,C,22023,203076,22300633,"JAN 25, 2024",LAL vs. CHI,W,36,10,18,0.556,0,1,0.0,2,5,0.4,5,6,11,6,0,1,0,1,22,13,1,LAL,LAL,CHI,141,,,39,33,28,17
Anthony Davis,C,22023,203076,22300618,"JAN 23, 2024",LAL @ LAC,L,36,12,20,0.6,0,1,0.0,2,2,1.0,4,8,12,2,0,0,1,2,26,-9,1,LAL,LAC,LAL,116,,,40,38,28,14
Anthony Davis,C,22023,203076,22300591,"JAN 19, 2024",LAL vs. BKN,L,35,9,13,0.692,0,1,0.0,8,11,0.727,4,8,12,6,3,2,1,1,26,-12,1,LAL,LAL,BKN,112,,,44,38,32,18
Anthony Davis,C,22023,203076,22300577,"JAN 17, 2024",LAL vs. DAL,W,33,12,17,0.706,0,0,0.0,4,5,0.8,5,7,12,9,1,1,1,2,28,21,1,LAL,LAL,DAL,127,,,49,40,37,21
Anthony Davis,C,22023,203076,22300565,"JAN 15, 2024",LAL vs. OKC,W,38,9,17,0.529,0,1,0.0,9,10,0.9,3,12,15,5,2,1,2,3,27,8,1,LAL,LAL,OKC,112,,,47,42,32,20
Anthony Davis,C,22023,203076,22300549,"JAN 13, 2024",LAL @ UTA,L,39,5,21,0.238,0,1,0.0,5,6,0.833,2,13,15,11,1,4,6,1,15,-12,1,LAL,UTA,LAL,125,,,41,30,26,26
Anthony Davis,C,22023,203076,22300531,"JAN 11, 2024",LAL vs. PHX,L,32,6,11,0.545,0,2,0.0,1,1,1.0,0,5,5,1,1,2,3,4,13,-24,1,LAL,LAL,PHX,109,,,19,18,14,6
Anthony Davis,C,22023,203076,22300516,"JAN 09, 2024",LAL vs. TOR,W,40,13,17,0.765,2,2,1.0,13,14,0.929,1,10,11,6,0,1,3,4,41,0,1,LAL,LAL,TOR,132,,,58,52,47,17
Anthony Davis,C,22023,203076,22300505,"JAN 07, 2024",LAL vs. LAC,W,39,10,15,0.667,0,1,0.0,2,4,0.5,1,9,10,1,3,1,3,1,22,-4,1,LAL,LAL,LAC,106,,,33,32,23,11
Anthony Davis,C,22023,203076,22300491,"JAN 05, 2024",LAL vs. MEM,L,41,13,22,0.591,0,3,0.0,5,7,0.714,3,3,6,4,0,2,4,4,31,-10,1,LAL,LAL,MEM,113,,,41,37,35,10
Anthony Davis,C,22023,203076,22300475,"JAN 03, 2024",LAL vs. MIA,L,43,10,17,0.588,0,1,0.0,9,10,0.9,3,14,17,6,3,5,5,2,29,-13,1,LAL,LAL,MIA,96,,,52,46,35,23
Anthony Davis,C,22023,203076,22300446,"DEC 31, 2023",LAL @ NOP,L,35,7,15,0.467,0,2,0.0,6,8,0.75,2,8,10,3,0,5,3,4,20,-17,1,LAL,NOP,LAL,109,,,33,30,23,13
Anthony Davis,C,22023,203076,22300428,"DEC 28, 2023",LAL vs. CHA,W,26,11,19,0.579,0,1,0.0,4,4,1.0,2,6,8,2,2,4,2,4,26,6,1,LAL,LAL,CHA,133,,,36,34,28,10
Anthony Davis,C,22023,203076,22300370,"DEC 20, 2023",LAL @ CHI,L,38,7,15,0.467,0,2,0.0,5,8,0.625,2,12,14,3,2,2,1,1,19,-3,1,LAL,CHI,LAL,108,,,36,33,22,17
Anthony Davis,C,22023,203076,22300316,"DEC 13, 2023",LAL @ SAS,W,38,13,23,0.565,2,3,0.667,9,12,0.75,1,9,10,1,4,0,2,3,37,5,1,LAL,SAS,LAL,122,,,48,47,38,11
Anthony Davis,C,22023,203076,22300306,"DEC 12, 2023",LAL @ DAL,L,37,15,21,0.714,1,2,0.5,6,10,0.6,5,6,11,0,0,2,2,2,37,0,1,LAL,DAL,LAL,125,,,48,48,37,11
Anthony Davis,C,22023,203076,22301230,"DEC 07, 2023",LAL vs. NOP,W,31,5,10,0.5,0,2,0.0,6,8,0.75,5,10,15,5,2,2,2,1,16,35,1,LAL,LAL,NOP,133,,,36,31,21,20
Anthony Davis,C,22023,203076,22301203,"DEC 05, 2023",LAL vs. PHX,W,39,10,26,0.385,0,0,0.0,7,8,0.875,9,6,15,1,0,2,0,1,27,-1,1,LAL,LAL,PHX,106,,,43,42,28,16
Anthony Davis,C,22023,203076,22300291,"DEC 02, 2023",LAL vs. HOU,W,37,10,22,0.455,0,0,0.0,7,9,0.778,6,8,14,3,0,5,1,2,27,12,1,LAL,LAL,HOU,107,,,44,41,30,17
Anthony Davis,C,22023,203076,22300258,"NOV 29, 2023",LAL @ DET,W,29,9,15,0.6,0,0,0.0,10,13,0.769,4,12,16,4,1,3,0,1,28,29,1,LAL,DET,LAL,133,,,48,44,32,20
Anthony Davis,C,22023,203076,22300255,"NOV 27, 2023",LAL @ PHI,L,32,7,14,0.5,0,0,0.0,3,5,0.6,3,8,11,2,1,1,2,4,17,-13,1,LAL,PHI,LAL,94,,,30,28,19,13
Anthony Davis,C,22023,203076,22300242,"NOV 25, 2023",LAL @ CLE,W,38,13,20,0.65,0,0,0.0,6,7,0.857,5,8,13,3,2,3,5,3,32,3,1,LAL,CLE,LAL,121,,,48,45,35,16
Anthony Davis,C,22023,203076,22300238,"NOV 22, 2023",LAL vs. DAL,L,36,4,10,0.4,0,0,0.0,2,2,1.0,2,11,13,4,1,1,3,3,10,0,1,LAL,LAL,DAL,101,,,27,23,14,17
Anthony Davis,C,22023,203076,22300042,"NOV 21, 2023",LAL vs. UTA,W,29,11,14,0.786,0,0,0.0,4,5,0.8,5,11,16,4,2,0,2,1,26,34,1,LAL,LAL,UTA,131,,,46,42,30,20
Anthony Davis,C,22023,203076,22300036,"NOV 17, 2023",LAL @ POR,W,35,8,19,0.421,0,1,0.0,0,1,0.0,4,10,14,2,3,5,6,5,16,1,1,LAL,POR,LAL,107,,,32,30,18,16
Anthony Davis,C,22023,203076,22300198,"NOV 15, 2023",LAL vs. SAC,L,35,3,9,0.333,0,1,0.0,3,3,1.0,0,9,9,0,0,4,5,4,9,-13,1,LAL,LAL,SAC,110,,,18,18,9,9
Anthony Davis,C,22023,203076,22300026,"NOV 14, 2023",LAL vs. MEM,W,27,7,11,0.636,0,0,0.0,5,6,0.833,4,7,11,5,0,6,2,1,19,21,1,LAL,LAL,MEM,134,,,35,30,24,16
Anthony Davis,C,22023,203076,22300187,"NOV 12, 2023",LAL vs. POR,W,41,10,20,0.5,0,1,0.0,10,12,0.833,2,11,13,6,0,3,1,0,30,17,1,LAL,LAL,POR,116,,,49,43,36,19
Anthony Davis,C,22023,203076,22300150,"NOV 06, 2023",LAL @ MIA,L,25,4,7,0.571,0,0,0.0,1,1,1.0,0,6,6,4,0,1,1,2,9,-9,1,LAL,MIA,LAL,107,,,19,15,13,10
Anthony Davis,C,22023,203076,22300127,"NOV 01, 2023",LAL vs. LAC,W,48,10,18,0.556,0,0,0.0,7,9,0.778,4,6,10,3,1,4,0,3,27,11,1,LAL,LAL,LAC,130,,,40,37,30,13
Anthony Davis,C,22023,203076,22300061,"OCT 24, 2023",LAL @ DEN,L,34,6,17,0.353,1,2,0.5,4,4,1.0,1,7,8,4,0,2,2,3,17,-17,1,LAL,DEN,LAL,107,,,29,25,21,12
Anthony Davis,C,22023,203076,22300747,"FEB 09, 2024",LAL vs. NOP,W,29,7,11,0.636,0,1,0.0,6,7,0.857,0,6,6,6,1,1,3,4,20,0,1,LAL,LAL,NOP,139,,,32,26,26,12
Anthony Davis,C,22023,203076,22300443,"DEC 30, 2023",LAL @ MIN,L,39,12,17,0.706,1,2,0.5,8,10,0.8,4,13,17,8,4,2,2,3,33,-6,1,LAL,MIN,LAL,106,,,58,50,41,25
Anthony Davis,C,22023,203076,22300403,"DEC 25, 2023",LAL vs. BOS,L,39,15,26,0.577,2,4,0.5,8,10,0.8,5,8,13,4,0,1,2,2,40,-6,1,LAL,LAL,BOS,115,,,57,53,44,17
Anthony Davis,C,22023,203076,22300397,"DEC 23, 2023",LAL @ OKC,W,42,11,21,0.524,1,1,1.0,3,6,0.5,3,8,11,7,1,2,3,2,26,3,1,LAL,OKC,LAL,129,,,44,37,33,18
Anthony Davis,C,22023,203076,22300380,"DEC 21, 2023",LAL @ MIN,L,39,11,20,0.55,1,1,1.0,8,9,0.889,1,7,8,4,0,3,1,2,31,3,1,LAL,MIN,LAL,111,,,43,39,35,12
Anthony Davis,C,22023,203076,22300359,"DEC 18, 2023",LAL vs. NYK,L,35,14,22,0.636,1,1,1.0,3,3,1.0,2,12,14,2,1,2,2,2,32,-6,1,LAL,LAL,NYK,109,,,48,46,34,16
Anthony Davis,C,22023,203076,22300216,"NOV 19, 2023",LAL vs. HOU,W,33,11,15,0.733,0,0,0.0,5,7,0.714,4,6,10,3,2,1,4,6,27,-8,1,LAL,LAL,HOU,105,,,40,37,30,13
Anthony Davis,C,22023,203076,22300015,"NOV 10, 2023",LAL @ PHX,W,36,5,14,0.357,0,0,0.0,8,8,1.0,4,7,11,4,0,1,1,3,18,-5,1,LAL,PHX,LAL,122,,,33,29,22,15
Anthony Davis,C,22023,203076,22300111,"OCT 30, 2023",LAL vs. ORL,W,38,12,18,0.667,0,1,0.0,2,3,0.667,2,17,19,5,1,3,1,3,26,-2,1,LAL,LAL,ORL,106,,,50,45,31,24
Anthony Davis,C,22023,203076,22300100,"OCT 29, 2023",LAL @ SAC,L,42,11,22,0.5,1,2,0.5,7,8,0.875,6,10,16,2,2,3,0,5,30,-10,1,LAL,SAC,LAL,127,,,48,46,32,18
Anthony Davis,C,22023,203076,22300076,"OCT 26, 2023",LAL vs. PHX,W,39,10,17,0.588,1,2,0.5,9,10,0.9,3,9,12,2,3,3,2,2,30,7,1,LAL,LAL,PHX,100,,,44,42,32,14
Desmond Bane,G,22023,1630217,22300503,"JAN 07, 2024",MEM @ PHX,W,37,8,14,0.571,2,7,0.286,5,5,1.0,2,3,5,5,1,1,3,3,23,-13,1,MEM,PHX,MEM,121,,,33,28,28,10
Desmond Bane,G,22023,1630217,22300491,"JAN 05, 2024",MEM @ LAL,W,37,8,14,0.571,5,8,0.625,3,4,0.75,0,5,5,13,1,0,3,2,24,11,1,MEM,LAL,MEM,127,,,42,29,37,18
Desmond Bane,G,22023,1630217,22300470,"JAN 03, 2024",MEM vs. TOR,L,38,9,18,0.5,2,6,0.333,2,2,1.0,2,2,4,8,0,0,0,4,22,5,1,MEM,MEM,TOR,111,,,34,26,30,12
Desmond Bane,G,22023,1630217,22300460,"JAN 02, 2024",MEM vs. SAS,W,34,11,17,0.647,2,6,0.333,0,0,0.0,0,3,3,2,0,0,3,1,24,3,1,MEM,MEM,SAS,106,,,29,27,26,5
Desmond Bane,G,22023,1630217,22300449,"DEC 31, 2023",MEM vs. SAC,L,35,6,14,0.429,3,7,0.429,2,3,0.667,0,7,7,6,0,0,2,2,17,-18,1,MEM,MEM,SAC,92,,,30,24,23,13
Desmond Bane,G,22023,1630217,22300438,"DEC 29, 2023",MEM @ LAC,L,37,7,11,0.636,2,5,0.4,2,2,1.0,0,7,7,5,2,0,2,3,18,-6,1,MEM,LAC,MEM,106,,,30,25,23,12
Desmond Bane,G,22023,1630217,22300410,"DEC 26, 2023",MEM @ NOP,W,40,9,22,0.409,5,14,0.357,4,5,0.8,1,4,5,7,0,1,1,5,27,3,1,MEM,NOP,MEM,116,,,39,32,34,12
Desmond Bane,G,22023,1630217,22300393,"DEC 23, 2023",MEM @ ATL,W,36,13,25,0.52,5,14,0.357,6,6,1.0,0,6,6,6,1,1,2,0,37,-5,1,MEM,ATL,MEM,125,,,49,43,43,12
Desmond Bane,G,22023,1630217,22300377,"DEC 21, 2023",MEM vs. IND,W,36,11,26,0.423,5,12,0.417,4,5,0.8,0,6,6,7,1,0,2,1,31,-7,1,MEM,MEM,IND,116,,,44,37,38,13
Desmond Bane,G,22023,1630217,22300360,"DEC 19, 2023",MEM @ NOP,W,35,8,19,0.421,3,9,0.333,2,2,1.0,1,0,1,4,0,0,4,1,21,5,1,MEM,NOP,MEM,115,,,26,22,25,5
Desmond Bane,G,22023,1630217,22300355,"DEC 18, 2023",MEM @ OKC,L,28,6,14,0.429,4,9,0.444,1,2,0.5,0,1,1,5,0,1,5,1,17,-18,1,MEM,OKC,MEM,97,,,23,18,22,6
Desmond Bane,G,22023,1630217,22300332,"DEC 15, 2023",MEM vs. HOU,L,40,11,25,0.44,4,12,0.333,2,3,0.667,6,7,13,3,2,0,4,4,28,1,1,MEM,MEM,HOU,96,,,44,41,31,16
Desmond Bane,G,22023,1630217,22300299,"DEC 11, 2023",MEM vs. DAL,L,39,11,20,0.55,3,9,0.333,3,3,1.0,1,2,3,8,1,0,5,4,28,1,1,MEM,MEM,DAL,113,,,39,31,36,11
Desmond Bane,G,22023,1630217,22301221,"DEC 08, 2023",MEM vs. MIN,L,37,6,13,0.462,4,6,0.667,0,0,0.0,0,2,2,1,0,1,4,5,16,-23,1,MEM,MEM,MIN,95,,,19,18,17,3
Desmond Bane,G,22023,1630217,22301206,"DEC 06, 2023",MEM @ DET,W,36,19,31,0.613,4,8,0.5,7,7,1.0,1,5,6,8,1,2,3,2,49,-1,1,MEM,DET,MEM,104,,,63,55,57,14
Desmond Bane,G,22023,1630217,22300288,"DEC 02, 2023",MEM @ PHX,L,30,10,17,0.588,3,6,0.5,4,5,0.8,1,2,3,5,2,1,2,5,27,-3,1,MEM,PHX,MEM,101,,,35,30,32,8
Desmond Bane,G,22023,1630217,22300277,"DEC 01, 2023",MEM @ DAL,W,34,11,20,0.55,4,6,0.667,4,6,0.667,2,2,4,5,1,2,4,2,30,13,1,MEM,DAL,MEM,89,,,39,34,35,9
Desmond Bane,G,22023,1630217,22300261,"NOV 29, 2023",MEM vs. UTA,W,36,7,17,0.412,3,11,0.273,0,0,0.0,1,6,7,9,3,0,3,2,17,6,1,MEM,MEM,UTA,105,,,33,24,26,16
Desmond Bane,G,22023,1630217,22300249,"NOV 26, 2023",MEM vs. MIN,L,34,5,16,0.313,3,9,0.333,0,0,0.0,1,1,2,4,0,0,5,3,13,-17,1,MEM,MEM,MIN,91,,,19,15,17,6
Desmond Bane,G,22023,1630217,22300044,"NOV 24, 2023",MEM vs. PHX,L,34,3,12,0.25,0,5,0.0,0,0,0.0,0,5,5,10,1,0,3,3,6,-10,1,MEM,MEM,PHX,89,,,21,11,16,15
Desmond Bane,G,22023,1630217,22300231,"NOV 22, 2023",MEM @ HOU,L,26,6,12,0.5,2,6,0.333,9,10,0.9,1,6,7,4,1,0,2,4,23,-15,1,MEM,HOU,MEM,91,,,34,30,27,11
Desmond Bane,G,22023,1630217,22300213,"NOV 19, 2023",MEM vs. BOS,L,37,11,27,0.407,7,14,0.5,1,1,1.0,2,0,2,8,1,0,2,2,30,1,1,MEM,MEM,BOS,100,,,40,32,38,10
Desmond Bane,G,22023,1630217,22300206,"NOV 18, 2023",MEM @ SAS,W,34,8,15,0.533,3,6,0.5,7,7,1.0,3,2,5,4,1,0,2,5,26,4,1,MEM,SAS,MEM,120,,,35,31,30,9
Desmond Bane,G,22023,1630217,22300026,"NOV 14, 2023",MEM @ LAL,L,27,5,10,0.5,2,6,0.333,3,3,1.0,0,1,1,5,0,0,2,1,15,-24,1,MEM,LAL,MEM,107,,,21,16,20,6
Desmond Bane,G,22023,1630217,22300179,"NOV 12, 2023",MEM @ LAC,W,35,10,24,0.417,3,11,0.273,4,6,0.667,1,3,4,6,0,1,4,4,27,11,1,MEM,LAC,MEM,105,,,37,31,33,10
Desmond Bane,G,22023,1630217,22300012,"NOV 10, 2023",MEM vs. UTA,L,38,14,28,0.5,7,13,0.538,2,3,0.667,0,4,4,8,1,2,3,3,37,1,1,MEM,MEM,UTA,121,,,49,41,45,12
Desmond Bane,G,22023,1630217,22300164,"NOV 08, 2023",MEM vs. MIA,L,36,4,16,0.25,2,8,0.25,5,6,0.833,0,5,5,3,1,2,1,3,15,-18,1,MEM,MEM,MIA,102,,,23,20,18,8
Desmond Bane,G,22023,1630217,22300144,"NOV 05, 2023",MEM @ POR,W,34,13,27,0.481,3,9,0.333,1,1,1.0,0,8,8,5,1,0,3,5,30,8,1,MEM,POR,MEM,112,,,43,38,35,13
Desmond Bane,G,22023,1630217,22300537,"JAN 12, 2024",MEM vs. LAC,L,23,3,11,0.273,3,6,0.5,6,7,0.857,0,1,1,3,1,0,0,3,15,-6,1,MEM,MEM,LAC,119,,,19,16,18,4
Desmond Bane,G,22023,1630217,22300515,"JAN 09, 2024",MEM @ DAL,W,39,11,27,0.407,2,9,0.222,8,9,0.889,2,7,9,4,0,0,2,3,32,17,1,MEM,DAL,MEM,120,,,45,41,36,13
Desmond Bane,G,22023,1630217,22300425,"DEC 28, 2023",MEM @ DEN,L,25,9,13,0.692,3,5,0.6,2,2,1.0,0,1,1,2,1,0,2,3,23,-27,1,MEM,DEN,MEM,105,,,26,24,25,3
Desmond Bane,G,22023,1630217,22300007,"NOV 03, 2023",MEM @ POR,L,45,13,26,0.5,3,9,0.333,4,5,0.8,1,7,8,7,4,3,3,5,33,11,1,MEM,POR,MEM,113,,,48,41,40,15
Desmond Bane,G,22023,1630217,22300125,"NOV 01, 2023",MEM @ UTA,L,27,7,19,0.368,4,12,0.333,3,3,1.0,1,2,3,0,1,0,2,1,21,-25,1,MEM,UTA,MEM,109,,,24,24,21,3
Desmond Bane,G,22023,1630217,22300106,"OCT 30, 2023",MEM vs. DAL,L,37,12,17,0.706,3,7,0.429,3,4,0.75,2,4,6,3,3,0,2,3,30,0,1,MEM,MEM,DAL,110,,,39,36,33,9
Desmond Bane,G,22023,1630217,22300089,"OCT 28, 2023",MEM @ WAS,L,34,10,20,0.5,4,10,0.4,2,2,1.0,1,1,2,5,1,1,5,4,26,-11,1,MEM,WAS,MEM,106,,,33,28,31,7
Desmond Bane,G,22023,1630217,22300078,"OCT 27, 2023",MEM vs. DEN,L,32,4,17,0.235,1,10,0.1,6,6,1.0,1,2,3,3,2,0,2,3,15,-8,1,MEM,MEM,DEN,104,,,21,18,18,6
Desmond Bane,G,22023,1630217,22300071,"OCT 25, 2023",MEM vs. NOP,L,36,11,22,0.5,5,10,0.5,4,5,0.8,0,5,5,5,2,1,2,1,31,6,1,MEM,MEM,NOP,104,,,41,36,36,10
Julius Randle,F,22023,203944,22300643,"JAN 27, 2024",NYK vs. MIA,W,32,6,14,0.429,3,4,0.75,4,4,1.0,3,6,9,3,0,0,4,2,19,3,1,NYK,NYK,MIA,125,,,31,28,22,12
Julius Randle,F,22023,203944,22300631,"JAN 25, 2024",NYK vs. DEN,W,30,7,15,0.467,1,5,0.2,2,2,1.0,3,4,7,8,1,0,2,2,17,25,1,NYK,NYK,DEN,122,,,32,24,25,15
Julius Randle,F,22023,203944,22300615,"JAN 23, 2024",NYK @ BKN,W,37,10,19,0.526,2,2,1.0,8,8,1.0,2,7,9,7,0,0,4,3,30,-3,1,NYK,BKN,NYK,108,,,46,39,37,16
Julius Randle,F,22023,203944,22300596,"JAN 20, 2024",NYK vs. TOR,W,32,7,13,0.538,3,7,0.429,1,2,0.5,7,9,16,10,0,0,7,3,18,16,1,NYK,NYK,TOR,126,,,44,34,28,26
Julius Randle,F,22023,203944,22300579,"JAN 18, 2024",NYK vs. WAS,W,39,8,17,0.471,3,8,0.375,2,4,0.5,1,7,8,5,0,0,5,2,21,1,1,NYK,NYK,WAS,113,,,34,29,26,13
Julius Randle,F,22023,203944,22300573,"JAN 17, 2024",NYK vs. HOU,W,34,11,19,0.579,4,8,0.5,5,6,0.833,2,6,8,4,0,1,4,4,31,15,1,NYK,NYK,HOU,109,,,43,39,35,12
Julius Randle,F,22023,203944,22300557,"JAN 15, 2024",NYK vs. ORL,L,38,5,18,0.278,2,9,0.222,3,5,0.6,1,5,6,5,0,0,0,3,15,2,1,NYK,NYK,ORL,94,,,26,21,20,11
Julius Randle,F,22023,203944,22300544,"JAN 13, 2024",NYK @ MEM,W,36,9,21,0.429,1,6,0.167,5,6,0.833,5,6,11,5,0,1,6,2,24,10,1,NYK,MEM,NYK,106,,,40,35,29,16
Julius Randle,F,22023,203944,22300530,"JAN 11, 2024",NYK @ DAL,L,37,12,23,0.522,2,7,0.286,6,7,0.857,1,5,6,5,2,0,4,3,32,-1,1,NYK,DAL,NYK,124,,,43,38,37,11
Julius Randle,F,22023,203944,22300514,"JAN 09, 2024",NYK vs. POR,W,32,7,17,0.412,2,4,0.5,4,4,1.0,0,7,7,8,0,1,2,1,20,31,1,NYK,NYK,POR,112,,,35,27,28,15
Julius Randle,F,22023,203944,22300494,"JAN 06, 2024",NYK @ WAS,W,38,13,23,0.565,3,8,0.375,10,13,0.769,3,4,7,5,1,0,2,2,39,24,1,NYK,WAS,NYK,121,,,51,46,44,12
Julius Randle,F,22023,203944,22300483,"JAN 05, 2024",NYK @ PHI,W,30,1,11,0.091,0,3,0.0,6,6,1.0,0,7,7,5,1,1,4,3,8,13,1,NYK,PHI,NYK,128,,,20,15,13,12
Julius Randle,F,22023,203944,22300468,"JAN 03, 2024",NYK vs. CHI,W,39,13,23,0.565,3,7,0.429,6,7,0.857,0,6,6,4,2,1,3,3,35,13,1,NYK,NYK,CHI,116,,,45,41,39,10
Julius Randle,F,22023,203944,22300451,"JAN 01, 2024",NYK vs. MIN,W,36,14,24,0.583,2,6,0.333,9,13,0.692,3,6,9,0,0,0,6,5,39,2,1,NYK,NYK,MIN,112,,,48,48,39,9
Julius Randle,F,22023,203944,22300441,"DEC 30, 2023",NYK @ IND,L,39,9,22,0.409,1,5,0.2,9,13,0.692,6,6,12,4,0,0,5,1,28,-6,1,NYK,IND,NYK,124,,,44,40,32,16
Julius Randle,F,22023,203944,22300388,"DEC 23, 2023",NYK vs. MIL,L,34,8,17,0.471,0,2,0.0,10,10,1.0,1,7,8,1,1,0,3,3,26,-3,1,NYK,NYK,MIL,109,,,35,34,27,9
Julius Randle,F,22023,203944,22300368,"DEC 20, 2023",NYK @ BKN,W,34,9,20,0.45,0,4,0.0,8,9,0.889,2,5,7,4,0,0,1,3,26,27,1,NYK,BKN,NYK,119,,,37,33,30,11
Julius Randle,F,22023,203944,22300343,"DEC 16, 2023",NYK @ LAC,L,31,8,17,0.471,0,3,0.0,6,6,1.0,2,2,4,3,0,0,3,3,22,-20,1,NYK,LAC,NYK,120,,,29,26,25,7
Julius Randle,F,22023,203944,22300333,"DEC 15, 2023",NYK @ PHX,W,35,10,16,0.625,1,3,0.333,2,2,1.0,1,7,8,6,0,1,5,4,23,4,1,NYK,PHX,NYK,139,,,37,31,29,14
Julius Randle,F,22023,203944,22301201,"DEC 05, 2023",NYK @ MIL,L,37,14,19,0.737,2,2,1.0,11,12,0.917,3,3,6,5,0,0,4,3,41,-21,1,NYK,MIL,NYK,122,,,52,47,46,11
Julius Randle,F,22023,203944,22300221,"NOV 20, 2023",NYK @ MIN,L,34,6,16,0.375,1,6,0.167,8,12,0.667,3,11,14,1,0,0,2,2,21,-12,1,NYK,MIN,NYK,100,,,36,35,22,15
Julius Randle,F,22023,203944,22300028,"NOV 17, 2023",NYK @ WAS,W,35,9,18,0.5,1,5,0.2,3,6,0.5,1,6,7,8,1,2,6,3,22,15,1,NYK,WAS,NYK,120,,,37,29,30,15
Julius Randle,F,22023,203944,22300177,"NOV 12, 2023",NYK vs. CHA,W,27,8,16,0.5,1,4,0.25,6,8,0.75,1,4,5,5,3,0,3,1,23,8,1,NYK,NYK,CHA,129,,,33,28,28,10
Julius Randle,F,22023,203944,22300161,"NOV 08, 2023",NYK vs. SAS,W,31,8,19,0.421,2,6,0.333,5,8,0.625,4,12,16,5,1,0,2,1,23,31,1,NYK,NYK,SAS,126,,,44,39,28,21
Julius Randle,F,22023,203944,22300112,"OCT 31, 2023",NYK @ CLE,W,31,5,14,0.357,2,5,0.4,7,10,0.7,3,7,10,2,1,0,1,1,19,18,1,NYK,CLE,NYK,109,,,31,29,21,12
Julius Randle,F,22023,203944,22300429,"DEC 29, 2023",NYK @ ORL,L,36,16,25,0.64,0,4,0.0,6,8,0.75,3,9,12,6,0,1,5,5,38,0,1,NYK,ORL,NYK,106,,,56,50,44,18
Julius Randle,F,22023,203944,22300419,"DEC 27, 2023",NYK @ OKC,L,36,7,15,0.467,1,4,0.25,10,13,0.769,1,8,9,2,0,0,3,3,25,-12,1,NYK,OKC,NYK,116,,,36,34,27,11
Julius Randle,F,22023,203944,22300401,"DEC 25, 2023",NYK vs. MIL,W,41,8,17,0.471,2,5,0.4,6,6,1.0,1,8,9,2,1,0,4,3,24,6,1,NYK,NYK,MIL,129,,,35,33,26,11
Julius Randle,F,22023,203944,22300359,"DEC 18, 2023",NYK @ LAL,W,43,12,22,0.545,1,4,0.25,2,2,1.0,1,13,14,3,0,0,2,3,27,17,1,NYK,LAL,NYK,114,,,44,41,30,17
Julius Randle,F,22023,203944,22300318,"DEC 13, 2023",NYK @ UTA,L,39,14,23,0.609,2,6,0.333,2,2,1.0,3,9,12,6,1,1,2,4,32,13,1,NYK,UTA,NYK,113,,,50,44,38,18
Julius Randle,F,22023,203944,22300297,"DEC 11, 2023",NYK vs. TOR,W,35,14,21,0.667,1,3,0.333,5,7,0.714,3,5,8,5,0,0,3,1,34,-1,1,NYK,NYK,TOR,136,,,47,42,39,13
Julius Randle,F,22023,203944,22301227,"DEC 08, 2023",NYK @ BOS,L,34,7,15,0.467,3,4,0.75,3,4,0.75,1,4,5,3,1,1,6,2,20,-18,1,NYK,BOS,NYK,123,,,28,25,23,8
Julius Randle,F,22023,203944,22300276,"DEC 01, 2023",NYK @ TOR,W,35,8,15,0.533,1,4,0.25,3,3,1.0,2,8,10,9,0,0,2,3,20,15,1,NYK,TOR,NYK,119,,,39,30,29,19
Julius Randle,F,22023,203944,22300268,"NOV 30, 2023",NYK vs. DET,W,38,12,21,0.571,2,5,0.4,3,6,0.5,2,8,10,8,0,1,3,3,29,11,1,NYK,NYK,DET,118,,,47,39,37,18
Julius Randle,F,22023,203944,22300057,"NOV 28, 2023",NYK vs. CHA,W,34,8,15,0.533,2,7,0.286,7,8,0.875,4,16,20,5,2,0,4,2,25,27,1,NYK,NYK,CHA,115,,,50,45,30,25
Julius Randle,F,22023,203944,22300247,"NOV 26, 2023",NYK vs. PHX,L,36,10,21,0.476,1,4,0.25,7,8,0.875,3,2,5,2,0,0,2,2,28,-9,1,NYK,NYK,PHX,113,,,35,33,30,7
Julius Randle,F,22023,203944,22300045,"NOV 24, 2023",NYK vs. MIA,W,35,5,12,0.417,1,4,0.25,2,2,1.0,0,8,8,7,0,0,6,0,13,-8,1,NYK,NYK,MIA,100,,,28,21,20,15
Julius Randle,F,22023,203944,22300202,"NOV 18, 2023",NYK @ CHA,W,38,8,17,0.471,2,5,0.4,3,7,0.429,0,6,6,8,0,0,4,4,21,9,1,NYK,CHA,NYK,122,,,35,27,29,14
Julius Randle,F,22023,203944,22300151,"NOV 06, 2023",NYK vs. LAC,W,37,9,21,0.429,3,8,0.375,6,6,1.0,2,8,10,3,0,0,6,3,27,2,1,NYK,NYK,LAC,111,,,40,37,30,13
Julius Randle,F,22023,203944,22300090,"OCT 28, 2023",NYK @ NOP,L,34,4,15,0.267,0,5,0.0,2,2,1.0,0,12,12,4,0,0,8,4,10,-11,1,NYK,NOP,NYK,87,,,26,22,14,16
Julius Randle,F,22023,203944,22300079,"OCT 27, 2023",NYK @ ATL,W,34,4,10,0.4,3,7,0.429,6,8,0.75,2,10,12,9,0,0,3,3,17,7,1,NYK,ATL,NYK,126,,,38,29,26,21
Julius Randle,F,22023,203944,22300065,"OCT 25, 2023",NYK vs. BOS,L,34,5,22,0.227,3,8,0.375,1,5,0.2,4,7,11,7,2,0,0,3,14,-13,1,NYK,NYK,BOS,104,,,32,25,21,18
Julius Randle,F,22023,203944,22300193,"NOV 15, 2023",NYK @ ATL,W,39,12,24,0.5,3,5,0.6,2,2,1.0,2,8,10,8,1,0,1,4,29,12,1,NYK,ATL,NYK,116,,,47,39,37,18
Julius Randle,F,22023,203944,22300188,"NOV 13, 2023",NYK @ BOS,L,38,7,19,0.368,2,8,0.25,9,11,0.818,3,6,9,5,0,0,3,4,25,-10,1,NYK,BOS,NYK,98,,,39,34,30,14
Julius Randle,F,22023,203944,22300002,"NOV 03, 2023",NYK @ MIL,L,39,5,20,0.25,1,9,0.111,5,9,0.556,4,8,12,5,2,0,1,4,16,-5,1,NYK,MIL,NYK,105,,,33,28,21,17
Julius Randle,F,22023,203944,22300120,"NOV 01, 2023",NYK vs. CLE,L,35,3,15,0.2,0,6,0.0,0,0,0.0,0,6,6,4,1,0,3,2,6,-4,1,NYK,NYK,CLE,89,,,16,12,10,10
Kawhi Leonard,F,22023,202695,22300099,"OCT 29, 2023",LAC vs. SAS,W,28,6,13,0.462,3,7,0.429,6,7,0.857,0,3,3,4,2,0,3,2,21,24,1,LAC,LAC,SAS,123,,,28,24,25,7
Kawhi Leonard,F,22023,202695,22300085,"OCT 27, 2023",LAC @ UTA,L,37,10,22,0.455,4,10,0.4,1,3,0.333,3,6,9,5,2,0,1,1,25,9,1,LAC,UTA,LAC,118,,,39,34,30,14
Kawhi Leonard,F,22023,202695,22300074,"OCT 25, 2023",LAC vs. POR,W,29,9,17,0.529,5,5,1.0,0,0,0.0,1,4,5,6,1,1,4,2,23,25,1,LAC,LAC,POR,123,,,34,28,29,11
Kawhi Leonard,F,22023,202695,22300731,"FEB 07, 2024",LAC vs. NOP,L,33,4,10,0.4,1,3,0.333,6,8,0.75,1,5,6,4,2,1,3,0,15,-11,1,LAC,LAC,NOP,106,,,25,21,19,10
Kawhi Leonard,F,22023,202695,22300688,"FEB 02, 2024",LAC @ DET,W,32,12,17,0.706,6,8,0.75,3,3,1.0,0,4,4,3,0,1,0,2,33,18,1,LAC,DET,LAC,136,,,40,37,36,7
Kawhi Leonard,F,22023,202695,22300676,"JAN 31, 2024",LAC @ WAS,W,30,14,25,0.56,1,4,0.25,2,2,1.0,4,5,9,4,4,1,0,1,31,23,1,LAC,WAS,LAC,125,,,44,40,35,13
Kawhi Leonard,F,22023,202695,22300658,"JAN 29, 2024",LAC @ CLE,L,37,13,25,0.52,2,7,0.286,2,2,1.0,3,5,8,3,2,0,1,2,30,-9,1,LAC,CLE,LAC,108,,,41,38,33,11
Kawhi Leonard,F,22023,202695,22300646,"JAN 27, 2024",LAC @ BOS,W,29,10,15,0.667,3,5,0.6,3,3,1.0,1,6,7,2,2,2,2,1,26,27,1,LAC,BOS,LAC,115,,,35,33,28,9
Kawhi Leonard,F,22023,202695,22300637,"JAN 26, 2024",LAC @ TOR,W,31,7,13,0.538,2,4,0.5,0,0,0.0,1,6,7,3,1,2,1,0,16,11,1,LAC,TOR,LAC,127,,,26,23,19,10
Kawhi Leonard,F,22023,202695,22300537,"JAN 12, 2024",LAC @ MEM,W,29,10,16,0.625,2,5,0.4,0,0,0.0,0,7,7,4,2,2,1,3,22,11,1,LAC,MEM,LAC,128,,,33,29,26,11
Kawhi Leonard,F,22023,202695,22300511,"JAN 08, 2024",LAC vs. PHX,W,32,8,15,0.533,1,3,0.333,0,0,0.0,0,3,3,2,5,1,3,1,17,11,1,LAC,LAC,PHX,138,,,22,20,19,5
Kawhi Leonard,F,22023,202695,22300486,"JAN 05, 2024",LAC @ NOP,W,30,7,15,0.467,2,4,0.5,3,4,0.75,2,7,9,2,1,1,2,1,19,6,1,LAC,NOP,LAC,111,,,30,28,21,11
Kawhi Leonard,F,22023,202695,22300458,"JAN 01, 2024",LAC vs. MIA,W,34,10,19,0.526,2,5,0.4,2,3,0.667,1,5,6,5,4,1,2,0,24,24,1,LAC,LAC,MIA,121,,,35,30,29,11
Kawhi Leonard,F,22023,202695,22300350,"DEC 18, 2023",LAC @ IND,W,27,12,18,0.667,2,5,0.4,2,2,1.0,1,1,2,1,1,0,3,2,28,27,1,LAC,IND,LAC,151,,,31,30,29,3
Kawhi Leonard,F,22023,202695,22300343,"DEC 16, 2023",LAC vs. NYK,W,30,12,16,0.75,5,6,0.833,7,7,1.0,1,6,7,4,2,0,0,1,36,15,1,LAC,LAC,NYK,144,,,47,43,40,11
Kawhi Leonard,F,22023,202695,22300618,"JAN 23, 2024",LAC vs. LAL,W,38,11,16,0.688,0,1,0.0,3,3,1.0,2,9,11,10,2,1,2,0,25,15,1,LAC,LAC,LAL,127,,,46,36,35,21
Kawhi Leonard,F,22023,202695,22300325,"DEC 14, 2023",LAC vs. GSW,W,39,9,16,0.563,2,4,0.5,7,9,0.778,3,5,8,2,1,1,2,2,27,-1,1,LAC,LAC,GSW,121,,,37,35,29,10
Kawhi Leonard,F,22023,202695,22300309,"DEC 12, 2023",LAC vs. SAC,W,31,11,14,0.786,2,3,0.667,7,7,1.0,0,4,4,3,1,1,1,0,31,21,1,LAC,LAC,SAC,117,,,38,35,34,7
Kawhi Leonard,F,22023,202695,22300304,"DEC 11, 2023",LAC vs. POR,W,39,11,19,0.579,3,8,0.375,9,9,1.0,0,6,6,5,3,0,1,2,34,13,1,LAC,LAC,POR,132,,,45,40,39,11
Kawhi Leonard,F,22023,202695,22301225,"DEC 08, 2023",LAC @ UTA,W,38,14,23,0.609,6,8,0.75,7,7,1.0,3,2,5,5,0,1,2,1,41,18,1,LAC,UTA,LAC,117,,,51,46,46,10
Kawhi Leonard,F,22023,202695,22301215,"DEC 06, 2023",LAC vs. DEN,W,38,8,16,0.5,1,3,0.333,0,0,0.0,1,3,4,5,1,1,2,2,17,-8,1,LAC,LAC,DEN,111,,,26,21,22,9
Kawhi Leonard,F,22023,202695,22300280,"DEC 02, 2023",LAC vs. GSW,W,39,9,16,0.563,2,5,0.4,0,0,0.0,0,8,8,7,1,0,3,2,20,8,1,LAC,LAC,GSW,113,,,35,28,27,15
Kawhi Leonard,F,22023,202695,22300273,"NOV 30, 2023",LAC @ GSW,L,35,9,17,0.529,2,2,1.0,3,4,0.75,1,6,7,0,2,0,0,2,23,2,1,LAC,GSW,LAC,114,,,30,30,23,7
Kawhi Leonard,F,22023,202695,22300264,"NOV 29, 2023",LAC @ SAC,W,37,14,18,0.778,2,3,0.667,4,6,0.667,0,9,9,3,1,2,0,2,34,20,1,LAC,SAC,LAC,131,,,46,43,37,12
Kawhi Leonard,F,22023,202695,22300244,"NOV 25, 2023",LAC vs. DAL,W,29,2,12,0.167,0,5,0.0,4,4,1.0,0,6,6,3,0,2,2,1,8,24,1,LAC,LAC,DAL,107,,,17,14,11,9
Kawhi Leonard,F,22023,202695,22300014,"NOV 10, 2023",LAC @ DAL,L,29,8,15,0.533,2,4,0.5,8,8,1.0,1,2,3,4,0,0,2,2,26,-8,1,LAC,DAL,LAC,126,,,33,29,30,7
Kawhi Leonard,F,22023,202695,22300151,"NOV 06, 2023",LAC @ NYK,L,32,8,16,0.5,2,6,0.333,0,0,0.0,2,3,5,3,0,0,0,2,18,-12,1,LAC,NYK,LAC,97,,,26,23,21,8
Kawhi Leonard,F,22023,202695,22300127,"NOV 01, 2023",LAC @ LAL,L,41,15,28,0.536,5,11,0.455,3,6,0.5,1,5,6,5,2,0,2,2,38,4,1,LAC,LAL,LAC,125,,,49,44,43,11
Kawhi Leonard,F,22023,202695,22300114,"OCT 31, 2023",LAC vs. ORL,W,33,3,11,0.273,0,3,0.0,2,2,1.0,2,6,8,3,2,0,1,1,8,18,1,LAC,LAC,ORL,118,,,19,16,11,11
Kawhi Leonard,F,22023,202695,22300749,"FEB 10, 2024",LAC vs. DET,W,35,7,18,0.389,3,7,0.429,7,7,1.0,0,4,4,5,2,0,3,2,24,2,1,LAC,LAC,DET,112,,,33,28,29,9
Kawhi Leonard,F,22023,202695,22300716,"FEB 05, 2024",LAC @ ATL,W,37,13,20,0.65,5,8,0.625,5,5,1.0,1,1,2,5,1,1,1,2,36,8,1,LAC,ATL,LAC,149,,,43,38,41,7
Kawhi Leonard,F,22023,202695,22300708,"FEB 04, 2024",LAC @ MIA,W,35,8,16,0.5,3,6,0.5,6,6,1.0,3,8,11,4,2,2,3,2,25,-6,1,LAC,MIA,LAC,103,,,40,36,29,15
Kawhi Leonard,F,22023,202695,22300600,"JAN 21, 2024",LAC vs. BKN,W,37,6,15,0.4,2,3,0.667,7,8,0.875,1,3,4,4,0,1,2,2,21,15,1,LAC,LAC,BKN,125,,,29,25,25,8
Kawhi Leonard,F,22023,202695,22300568,"JAN 16, 2024",LAC vs. OKC,W,37,6,10,0.6,3,4,0.75,1,2,0.5,1,5,6,6,0,1,3,0,16,19,1,LAC,LAC,OKC,128,,,28,22,22,12
Kawhi Leonard,F,22023,202695,22300553,"JAN 14, 2024",LAC @ MIN,L,37,9,19,0.474,2,3,0.667,6,6,1.0,0,9,9,4,2,0,1,4,26,-13,1,LAC,MIN,LAC,105,,,39,35,30,13
Kawhi Leonard,F,22023,202695,22300526,"JAN 10, 2024",LAC vs. TOR,W,38,10,18,0.556,2,4,0.5,7,7,1.0,2,1,3,7,1,2,0,3,29,-5,1,LAC,LAC,TOR,126,,,39,32,36,10
Kawhi Leonard,F,22023,202695,22300505,"JAN 07, 2024",LAC @ LAL,L,35,6,17,0.353,2,7,0.286,1,2,0.5,0,8,8,2,3,2,3,4,15,4,1,LAC,LAL,LAC,103,,,25,23,17,10
Kawhi Leonard,F,22023,202695,22300473,"JAN 03, 2024",LAC @ PHX,W,40,9,16,0.563,4,6,0.667,8,8,1.0,2,6,8,3,2,2,2,1,30,11,1,LAC,PHX,LAC,131,,,41,38,33,11
Kawhi Leonard,F,22023,202695,22300372,"DEC 20, 2023",LAC @ DAL,W,37,12,22,0.545,1,6,0.167,5,5,1.0,3,7,10,5,1,1,0,0,30,7,1,LAC,DAL,LAC,120,,,45,40,35,15
Kawhi Leonard,F,22023,202695,22300235,"NOV 22, 2023",LAC @ SAS,W,36,10,17,0.588,2,6,0.333,4,4,1.0,0,4,4,4,2,0,1,3,26,-2,1,LAC,SAS,LAC,109,,,34,30,30,8
Kawhi Leonard,F,22023,202695,22300223,"NOV 20, 2023",LAC @ SAS,W,28,8,17,0.471,2,6,0.333,3,3,1.0,2,2,4,3,1,1,0,0,21,17,1,LAC,SAS,LAC,124,,,28,25,24,7
Kawhi Leonard,F,22023,202695,22300179,"NOV 12, 2023",LAC vs. MEM,L,37,6,16,0.375,1,4,0.25,1,2,0.5,1,4,5,3,1,2,0,3,14,-18,1,LAC,LAC,MEM,101,,,22,19,17,8
Kawhi Leonard,F,22023,202695,22300257,"NOV 27, 2023",LAC vs. DEN,L,39,10,26,0.385,2,5,0.4,9,9,1.0,1,7,8,3,1,2,2,0,31,-5,1,LAC,LAC,DEN,104,,,42,39,34,11
Kawhi Leonard,F,22023,202695,22300052,"NOV 24, 2023",LAC vs. NOP,L,34,8,17,0.471,1,7,0.143,3,4,0.75,1,7,8,3,1,1,1,0,20,-15,1,LAC,LAC,NOP,106,,,31,28,23,11
Kawhi Leonard,F,22023,202695,22300037,"NOV 17, 2023",LAC vs. HOU,W,37,8,16,0.5,3,6,0.5,7,8,0.875,1,7,8,2,5,1,3,3,26,18,1,LAC,LAC,HOU,106,,,36,34,28,10
Kawhi Leonard,F,22023,202695,22300024,"NOV 14, 2023",LAC @ DEN,L,38,5,14,0.357,2,3,0.667,3,4,0.75,0,2,2,2,5,0,3,1,15,0,1,LAC,DEN,LAC,108,,,19,17,17,4
Kawhi Leonard,F,22023,202695,22300160,"NOV 08, 2023",LAC @ BKN,L,36,7,16,0.438,1,6,0.167,2,2,1.0,0,6,6,2,2,1,1,1,17,3,1,LAC,BKN,LAC,93,,,25,23,19,8
LaMelo Ball,G,22023,1630163,22300177,"NOV 12, 2023",CHA @ NYK,L,33,13,20,0.65,4,8,0.5,2,2,1.0,3,4,7,6,1,1,2,2,32,-32,1,CHA,NYK,CHA,107,,,45,39,38,13
LaMelo Ball,G,22023,1630163,22300635,"JAN 26, 2024",CHA vs. HOU,L,23,6,16,0.375,2,9,0.222,1,2,0.5,0,2,2,8,2,0,3,4,15,-25,1,CHA,CHA,HOU,104,,,25,17,23,10
LaMelo Ball,G,22023,1630163,22300619,"JAN 24, 2024",CHA @ DET,L,32,6,21,0.286,1,8,0.125,4,4,1.0,1,3,4,7,1,0,4,6,17,-24,1,CHA,DET,CHA,106,,,28,21,24,11
LaMelo Ball,G,22023,1630163,22300610,"JAN 22, 2024",CHA @ MIN,W,35,7,18,0.389,1,6,0.167,3,4,0.75,2,4,6,13,3,0,1,1,18,10,1,CHA,MIN,CHA,126,,,37,24,31,19
LaMelo Ball,G,22023,1630163,22300584,"JAN 19, 2024",CHA vs. SAS,W,32,10,13,0.769,4,6,0.667,4,5,0.8,1,0,1,8,3,0,4,4,28,13,1,CHA,CHA,SAS,124,,,37,29,36,9
LaMelo Ball,G,22023,1630163,22300575,"JAN 17, 2024",CHA @ NOP,L,31,8,19,0.421,4,12,0.333,9,10,0.9,0,5,5,7,2,0,4,5,29,-12,1,CHA,NOP,CHA,108,,,41,34,36,12
LaMelo Ball,G,22023,1630163,22300551,"JAN 14, 2024",CHA @ MIA,L,30,9,24,0.375,3,13,0.231,0,0,0.0,2,8,10,5,3,0,2,3,21,8,1,CHA,MIA,CHA,85,,,36,31,26,15
LaMelo Ball,G,22023,1630163,22300541,"JAN 12, 2024",CHA @ SAS,L,27,5,14,0.357,3,9,0.333,15,16,0.938,0,3,3,5,5,0,6,4,28,-16,1,CHA,SAS,CHA,99,,,36,31,33,8
LaMelo Ball,G,22023,1630163,22300248,"NOV 26, 2023",CHA @ ORL,L,15,3,6,0.5,1,3,0.333,0,0,0.0,0,1,1,2,0,0,1,0,7,-2,1,CHA,ORL,CHA,117,,,10,8,9,3
LaMelo Ball,G,22023,1630163,22300225,"NOV 22, 2023",CHA vs. WAS,W,40,13,31,0.419,6,16,0.375,2,3,0.667,2,6,8,13,1,0,4,2,34,4,1,CHA,CHA,WAS,117,,,55,42,47,21
LaMelo Ball,G,22023,1630163,22300217,"NOV 20, 2023",CHA vs. BOS,W,41,15,27,0.556,5,11,0.455,1,1,1.0,2,7,9,8,2,1,5,5,36,3,1,CHA,CHA,BOS,121,,,53,45,44,17
LaMelo Ball,G,22023,1630163,22300202,"NOV 18, 2023",CHA vs. NYK,L,36,12,22,0.545,8,13,0.615,2,2,1.0,0,5,5,9,1,0,3,3,34,-16,1,CHA,CHA,NYK,108,,,48,39,43,14
LaMelo Ball,G,22023,1630163,22300027,"NOV 17, 2023",CHA vs. MIL,L,35,12,28,0.429,2,9,0.222,11,12,0.917,0,5,5,5,1,0,6,2,37,-18,1,CHA,CHA,MIL,99,,,47,42,42,10
LaMelo Ball,G,22023,1630163,22300017,"NOV 14, 2023",CHA vs. MIA,L,39,9,26,0.346,4,10,0.4,6,6,1.0,2,4,6,11,3,0,8,5,28,2,1,CHA,CHA,MIA,105,,,45,34,39,17
LaMelo Ball,G,22023,1630163,22300009,"NOV 10, 2023",CHA @ WAS,W,38,9,19,0.474,4,8,0.5,3,4,0.75,3,3,6,6,2,0,2,5,25,0,1,CHA,WAS,CHA,124,,,37,31,31,12
LaMelo Ball,G,22023,1630163,22300157,"NOV 08, 2023",CHA vs. WAS,L,36,13,22,0.591,3,9,0.333,5,7,0.714,3,1,4,7,1,0,6,3,34,-3,1,CHA,CHA,WAS,116,,,45,38,41,11
LaMelo Ball,G,22023,1630163,22300143,"NOV 05, 2023",CHA @ DAL,L,39,11,23,0.478,5,10,0.5,3,3,1.0,2,8,10,13,1,1,3,6,30,1,1,CHA,DAL,CHA,118,,,53,40,43,23
LaMelo Ball,G,22023,1630163,22300133,"NOV 04, 2023",CHA @ IND,W,31,4,15,0.267,2,7,0.286,1,1,1.0,1,1,2,11,2,0,6,5,11,-15,1,CHA,IND,CHA,125,,,24,13,22,13
LaMelo Ball,G,22023,1630163,22300122,"NOV 01, 2023",CHA @ HOU,L,33,7,15,0.467,2,6,0.333,3,4,0.75,1,0,1,5,1,0,3,4,19,-14,1,CHA,HOU,CHA,119,,,25,20,24,6
LaMelo Ball,G,22023,1630163,22300101,"OCT 30, 2023",CHA vs. BKN,L,22,3,12,0.25,0,6,0.0,2,2,1.0,0,3,3,8,2,0,3,6,8,-3,1,CHA,CHA,BKN,121,,,19,11,16,11
LaMelo Ball,G,22023,1630163,22300077,"OCT 27, 2023",CHA vs. DET,L,33,4,17,0.235,2,7,0.286,10,12,0.833,3,6,9,9,2,1,4,1,20,-7,1,CHA,CHA,DET,99,,,38,29,29,18
LaMelo Ball,G,22023,1630163,22300063,"OCT 25, 2023",CHA vs. ATL,W,31,4,15,0.267,4,11,0.364,3,4,0.75,1,5,6,10,1,0,3,3,15,7,1,CHA,CHA,ATL,116,,,31,21,25,16
Lauri Markkanen,F,22023,1628374,22300711,"FEB 04, 2024",UTA vs. MIL,W,36,8,15,0.533,5,10,0.5,0,0,0.0,1,2,3,2,1,0,2,4,21,20,1,UTA,UTA,MIL,123,,,26,24,23,5
Lauri Markkanen,F,22023,1628374,22300686,"FEB 01, 2024",UTA vs. PHI,L,33,10,15,0.667,4,9,0.444,4,4,1.0,2,8,10,3,1,0,0,2,28,1,1,UTA,UTA,PHI,124,,,41,38,31,13
Lauri Markkanen,F,22023,1628374,22300671,"JAN 30, 2024",UTA @ NYK,L,34,5,14,0.357,2,8,0.25,2,2,1.0,2,3,5,1,1,0,0,1,14,-10,1,UTA,NYK,UTA,103,,,20,19,15,6
Lauri Markkanen,F,22023,1628374,22300660,"JAN 29, 2024",UTA @ BKN,L,27,4,12,0.333,1,4,0.25,4,4,1.0,4,5,9,2,0,0,3,2,13,-19,1,UTA,BKN,UTA,114,,,24,22,15,11
Lauri Markkanen,F,22023,1628374,22300647,"JAN 27, 2024",UTA @ CHA,W,36,12,18,0.667,7,12,0.583,2,2,1.0,3,9,12,3,1,0,2,5,33,19,1,UTA,CHA,UTA,134,,,48,45,36,15
Lauri Markkanen,F,22023,1628374,22300628,"JAN 25, 2024",UTA @ WAS,W,33,11,20,0.55,6,12,0.5,1,2,0.5,1,6,7,5,3,0,3,3,29,11,1,UTA,WAS,UTA,123,,,41,36,34,12
Lauri Markkanen,F,22023,1628374,22300616,"JAN 23, 2024",UTA @ NOP,L,27,4,15,0.267,1,5,0.2,2,2,1.0,2,2,4,1,0,0,1,0,11,-14,1,UTA,NOP,UTA,124,,,16,15,12,5
Lauri Markkanen,F,22023,1628374,22300598,"JAN 20, 2024",UTA @ HOU,L,39,8,18,0.444,3,11,0.273,3,4,0.75,3,6,9,1,0,0,3,2,22,8,1,UTA,HOU,UTA,126,,,32,31,23,10
Lauri Markkanen,F,22023,1628374,22300581,"JAN 18, 2024",UTA vs. OKC,L,36,7,13,0.538,2,4,0.5,10,11,0.909,1,9,10,4,1,0,1,0,26,0,1,UTA,UTA,OKC,129,,,40,36,30,14
Lauri Markkanen,F,22023,1628374,22300564,"JAN 15, 2024",UTA vs. IND,W,28,10,15,0.667,2,4,0.5,10,10,1.0,2,8,10,3,0,0,1,1,32,25,1,UTA,UTA,IND,132,,,45,42,35,13
Lauri Markkanen,F,22023,1628374,22300549,"JAN 13, 2024",UTA vs. LAL,W,33,8,16,0.5,3,6,0.5,10,11,0.909,2,7,9,5,2,1,0,0,29,16,1,UTA,UTA,LAL,132,,,43,38,34,14
Lauri Markkanen,F,22023,1628374,22300540,"JAN 12, 2024",UTA vs. TOR,W,29,7,11,0.636,4,6,0.667,4,5,0.8,3,6,9,2,1,0,3,2,22,19,1,UTA,UTA,TOR,145,,,33,31,24,11
Lauri Markkanen,F,22023,1628374,22300524,"JAN 10, 2024",UTA vs. DEN,W,32,6,13,0.462,2,5,0.4,12,12,1.0,2,10,12,2,0,1,0,2,26,17,1,UTA,UTA,DEN,124,,,40,38,28,14
Lauri Markkanen,F,22023,1628374,22300510,"JAN 08, 2024",UTA @ MIL,W,32,5,15,0.333,4,10,0.4,7,8,0.875,4,10,14,2,1,2,0,1,21,8,1,UTA,MIL,UTA,132,,,37,35,23,16
Lauri Markkanen,F,22023,1628374,22300495,"JAN 06, 2024",UTA @ PHI,W,35,12,19,0.632,5,9,0.556,4,5,0.8,4,9,13,1,0,1,1,2,33,8,1,UTA,PHI,UTA,120,,,47,46,34,14
Lauri Markkanen,F,22023,1628374,22300479,"JAN 05, 2024",UTA @ BOS,L,23,7,16,0.438,2,7,0.286,1,2,0.5,4,1,5,5,0,0,0,1,17,-14,1,UTA,BOS,UTA,97,,,27,22,22,10
Lauri Markkanen,F,22023,1628374,22300474,"JAN 03, 2024",UTA vs. DET,W,38,10,18,0.556,4,8,0.5,7,8,0.875,2,5,7,0,0,1,1,1,31,12,1,UTA,UTA,DET,154,,,38,38,31,7
Lauri Markkanen,F,22023,1628374,22300457,"JAN 01, 2024",UTA vs. DAL,W,25,6,12,0.5,4,8,0.5,1,1,1.0,2,2,4,1,1,1,1,0,17,8,1,UTA,UTA,DAL,127,,,22,21,18,5
Lauri Markkanen,F,22023,1628374,22300439,"DEC 30, 2023",UTA vs. MIA,W,26,4,13,0.308,1,8,0.125,3,4,0.75,2,3,5,1,2,0,0,4,12,1,1,UTA,UTA,MIA,117,,,18,17,13,6
Lauri Markkanen,F,22023,1628374,22300424,"DEC 28, 2023",UTA @ NOP,L,35,7,19,0.368,3,12,0.25,7,7,1.0,6,4,10,5,1,0,2,0,24,2,1,UTA,NOP,UTA,105,,,39,34,29,15
Lauri Markkanen,F,22023,1628374,22300412,"DEC 26, 2023",UTA @ SAS,W,31,12,17,0.706,5,9,0.556,2,2,1.0,3,9,12,2,1,0,1,3,31,20,1,UTA,SAS,UTA,130,,,45,43,33,14
Lauri Markkanen,F,22023,1628374,22300395,"DEC 23, 2023",UTA @ TOR,W,39,12,21,0.571,4,10,0.4,2,2,1.0,2,7,9,5,3,0,1,2,30,9,1,UTA,TOR,UTA,126,,,44,39,35,14
Lauri Markkanen,F,22023,1628374,22300364,"DEC 20, 2023",UTA @ CLE,L,36,8,18,0.444,3,9,0.333,7,8,0.875,2,8,10,1,0,0,0,3,26,-7,1,UTA,CLE,UTA,116,,,37,36,27,11
Lauri Markkanen,F,22023,1628374,22300357,"DEC 18, 2023",UTA vs. BKN,W,29,6,14,0.429,1,5,0.2,7,7,1.0,1,9,10,4,0,1,2,1,20,15,1,UTA,UTA,BKN,125,,,34,30,24,14
Lauri Markkanen,F,22023,1628374,22300342,"DEC 16, 2023",UTA @ SAC,L,28,7,13,0.538,2,5,0.4,2,2,1.0,1,5,6,3,0,0,2,2,18,-2,1,UTA,SAC,UTA,104,,,27,24,21,9
Lauri Markkanen,F,22023,1628374,22300318,"DEC 13, 2023",UTA vs. NYK,W,25,7,13,0.538,4,8,0.5,5,7,0.714,0,7,7,0,0,0,0,2,23,-14,1,UTA,UTA,NYK,117,,,30,30,23,7
Lauri Markkanen,F,22023,1628374,22300237,"NOV 22, 2023",UTA @ POR,L,34,9,18,0.5,1,6,0.167,5,6,0.833,3,5,8,0,3,0,2,2,24,-1,1,UTA,POR,UTA,105,,,32,32,24,8
Lauri Markkanen,F,22023,1628374,22300042,"NOV 21, 2023",UTA @ LAL,L,23,4,10,0.4,2,7,0.286,0,0,0.0,1,7,8,0,1,0,0,2,10,-9,1,UTA,LAL,UTA,99,,,18,18,10,8
Lauri Markkanen,F,22023,1628374,22300214,"NOV 19, 2023",UTA vs. PHX,L,50,15,27,0.556,2,10,0.2,6,9,0.667,7,10,17,0,2,2,1,3,38,2,1,UTA,UTA,PHX,137,,,55,55,38,17
Lauri Markkanen,F,22023,1628374,22300035,"NOV 17, 2023",UTA vs. PHX,L,40,5,12,0.417,1,4,0.25,10,12,0.833,0,2,2,0,1,2,0,1,21,1,1,UTA,UTA,PHX,128,,,23,23,21,2
Lauri Markkanen,F,22023,1628374,22300023,"NOV 14, 2023",UTA vs. POR,W,31,8,18,0.444,2,9,0.222,3,4,0.75,1,8,9,0,1,1,0,1,21,9,1,UTA,UTA,POR,115,,,30,30,21,9
Lauri Markkanen,F,22023,1628374,22300012,"NOV 10, 2023",UTA @ MEM,W,37,8,13,0.615,4,9,0.444,6,6,1.0,0,7,7,1,2,2,3,3,26,-1,1,UTA,MEM,UTA,127,,,34,33,27,8
Lauri Markkanen,F,22023,1628374,22300158,"NOV 08, 2023",UTA @ IND,L,35,8,16,0.5,3,5,0.6,5,6,0.833,5,4,9,0,1,1,1,1,24,-12,1,UTA,IND,UTA,118,,,33,33,24,9
Lauri Markkanen,F,22023,1628374,22300152,"NOV 06, 2023",UTA @ CHI,L,34,8,15,0.533,5,12,0.417,8,8,1.0,1,4,5,3,0,1,1,2,29,-12,1,UTA,CHI,UTA,113,,,37,34,32,8
Lauri Markkanen,F,22023,1628374,22300138,"NOV 04, 2023",UTA @ MIN,L,35,7,20,0.35,4,11,0.364,4,5,0.8,4,4,8,1,0,1,2,4,22,-16,1,UTA,MIN,UTA,95,,,31,30,23,9
Lauri Markkanen,F,22023,1628374,22300130,"NOV 02, 2023",UTA vs. ORL,L,33,9,17,0.529,4,10,0.4,0,2,0.0,1,6,7,1,2,0,3,4,22,2,1,UTA,UTA,ORL,113,,,30,29,23,8
Lauri Markkanen,F,22023,1628374,22300125,"NOV 01, 2023",UTA vs. MEM,W,28,6,11,0.545,4,6,0.667,3,3,1.0,1,10,11,1,1,0,0,5,19,10,1,UTA,UTA,MEM,133,,,31,30,20,12
Lauri Markkanen,F,22023,1628374,22300110,"OCT 30, 2023",UTA @ DEN,L,38,10,24,0.417,5,13,0.385,2,2,1.0,5,9,14,5,0,1,2,2,27,3,1,UTA,DEN,UTA,102,,,46,41,32,19
Lauri Markkanen,F,22023,1628374,22300094,"OCT 28, 2023",UTA @ PHX,L,28,7,13,0.538,5,7,0.714,0,0,0.0,0,3,3,0,1,2,1,1,19,-21,1,UTA,PHX,UTA,104,,,22,22,19,3
Lauri Markkanen,F,22023,1628374,22300085,"OCT 27, 2023",UTA vs. LAC,W,35,12,23,0.522,5,13,0.385,6,6,1.0,5,7,12,3,0,0,3,2,35,11,1,UTA,UTA,LAC,120,,,50,47,38,15
Lauri Markkanen,F,22023,1628374,22300072,"OCT 25, 2023",UTA vs. SAC,L,32,6,15,0.4,2,6,0.333,5,6,0.833,2,8,10,1,2,0,1,1,19,-7,1,UTA,UTA,SAC,114,,,30,29,20,11
Lauri Markkanen,F,22023,1628374,22300739,"FEB 08, 2024",UTA @ PHX,L,34,8,15,0.533,2,6,0.333,4,4,1.0,0,5,5,1,0,0,4,1,22,-8,1,UTA,PHX,UTA,115,,,28,27,23,6
Lauri Markkanen,F,22023,1628374,22300724,"FEB 06, 2024",UTA vs. OKC,W,36,12,18,0.667,5,7,0.714,4,4,1.0,3,8,11,2,1,0,2,3,33,15,1,UTA,UTA,OKC,124,,,46,44,35,13
Tyrese Haliburton,G,22023,1630169,22300507,"JAN 08, 2024",IND vs. BOS,W,13,3,5,0.6,1,3,0.333,0,0,0.0,0,2,2,6,0,0,2,1,7,-4,1,IND,IND,BOS,133,,,15,9,13,8
Tyrese Haliburton,G,22023,1630169,22300480,"JAN 05, 2024",IND vs. ATL,W,25,4,6,0.667,2,4,0.5,0,0,0.0,1,7,8,18,2,1,2,1,10,24,1,IND,IND,ATL,148,,,36,18,28,26
Tyrese Haliburton,G,22023,1630169,22300466,"JAN 03, 2024",IND vs. MIL,W,34,10,20,0.5,5,11,0.455,6,6,1.0,0,2,2,12,1,3,0,1,31,21,1,IND,IND,MIL,142,,,45,33,43,14
Tyrese Haliburton,G,22023,1630169,22300377,"DEC 21, 2023",IND @ MEM,L,38,7,19,0.368,2,12,0.167,1,2,0.5,0,4,4,14,0,0,4,2,17,1,1,IND,MEM,IND,103,,,35,21,31,18
Tyrese Haliburton,G,22023,1630169,22300365,"DEC 20, 2023",IND vs. CHA,W,28,6,14,0.429,3,9,0.333,4,4,1.0,1,2,3,13,1,1,4,0,19,32,1,IND,IND,CHA,142,,,35,22,32,16
Tyrese Haliburton,G,22023,1630169,22300350,"DEC 18, 2023",IND vs. LAC,L,31,3,12,0.25,1,5,0.2,1,2,0.5,0,2,2,11,0,0,4,1,8,-37,1,IND,IND,LAC,127,,,21,10,19,13
Tyrese Haliburton,G,22023,1630169,22300328,"DEC 15, 2023",IND @ WAS,L,28,7,17,0.412,2,6,0.333,3,3,1.0,1,1,2,11,0,0,4,2,19,-18,1,IND,WAS,IND,123,,,32,21,30,13
Tyrese Haliburton,G,22023,1630169,22300315,"DEC 13, 2023",IND @ MIL,L,31,8,16,0.5,1,4,0.25,5,7,0.714,1,4,5,7,0,0,3,0,22,-14,1,IND,MIL,IND,126,,,34,27,29,12
Tyrese Haliburton,G,22023,1630169,22300293,"DEC 11, 2023",IND @ DET,W,33,5,12,0.417,3,6,0.5,1,1,1.0,0,5,5,16,1,2,7,2,14,8,1,IND,DET,IND,131,,,35,19,30,21
Tyrese Haliburton,G,22023,1630169,22301229,"DEC 07, 2023",IND @ MIL,W,37,11,19,0.579,3,9,0.333,2,2,1.0,3,4,7,15,0,1,0,1,27,0,1,IND,MIL,IND,128,,,49,34,42,22
Tyrese Haliburton,G,22023,1630169,22301202,"DEC 04, 2023",IND vs. BOS,W,40,10,18,0.556,5,11,0.455,1,1,1.0,3,7,10,13,1,0,0,2,26,15,1,IND,IND,BOS,122,,,49,36,39,23
Tyrese Haliburton,G,22023,1630169,22300267,"NOV 30, 2023",IND @ MIA,L,40,15,28,0.536,6,16,0.375,8,12,0.667,0,2,2,10,3,1,2,0,44,-6,1,IND,MIA,IND,132,,,56,46,54,12
Tyrese Haliburton,G,22023,1630169,22300254,"NOV 27, 2023",IND vs. POR,L,36,11,17,0.647,3,6,0.5,8,9,0.889,0,2,2,9,0,0,3,1,33,-3,1,IND,IND,POR,110,,,44,35,42,11
Tyrese Haliburton,G,22023,1630169,22300047,"NOV 24, 2023",IND vs. DET,W,32,9,23,0.391,5,13,0.385,3,3,1.0,0,2,2,10,0,0,1,0,26,9,1,IND,IND,DET,136,,,38,28,36,12
Tyrese Haliburton,G,22023,1630169,22300230,"NOV 22, 2023",IND vs. TOR,L,34,12,22,0.545,5,10,0.5,4,5,0.8,1,2,3,16,0,1,3,3,33,3,1,IND,IND,TOR,131,,,52,36,49,19
Tyrese Haliburton,G,22023,1630169,22300039,"NOV 21, 2023",IND @ ATL,W,39,11,18,0.611,9,15,0.6,6,7,0.857,1,4,5,16,3,1,6,0,37,16,1,IND,ATL,IND,157,,,58,42,53,21
Tyrese Haliburton,G,22023,1630169,22300209,"NOV 19, 2023",IND vs. ORL,L,25,4,14,0.286,1,3,0.333,3,3,1.0,0,2,2,3,0,1,4,2,12,-30,1,IND,IND,ORL,116,,,17,14,15,5
Tyrese Haliburton,G,22023,1630169,22300019,"NOV 14, 2023",IND @ PHI,W,38,11,18,0.611,7,12,0.583,4,5,0.8,1,6,7,15,2,1,0,1,33,19,1,IND,PHI,IND,132,,,55,40,48,22
Tyrese Haliburton,G,22023,1630169,22300180,"NOV 12, 2023",IND @ PHI,L,37,9,14,0.643,3,6,0.5,4,4,1.0,0,1,1,17,2,1,0,0,25,4,1,IND,PHI,IND,126,,,43,26,42,18
Tyrese Haliburton,G,22023,1630169,22300171,"NOV 09, 2023",IND vs. MIL,W,38,10,17,0.588,5,9,0.556,4,4,1.0,1,5,6,10,0,1,2,1,29,14,1,IND,IND,MIL,126,,,45,35,39,16
Tyrese Haliburton,G,22023,1630169,22300158,"NOV 08, 2023",IND vs. UTA,W,31,6,12,0.5,1,6,0.167,3,3,1.0,1,5,6,13,1,0,2,0,16,-1,1,IND,IND,UTA,134,,,35,22,29,19
Tyrese Haliburton,G,22023,1630169,22300146,"NOV 06, 2023",IND vs. SAS,W,27,9,19,0.474,3,7,0.429,2,2,1.0,0,2,2,8,1,1,2,1,23,27,1,IND,IND,SAS,152,,,33,25,31,10
Tyrese Haliburton,G,22023,1630169,22300133,"NOV 04, 2023",IND vs. CHA,L,37,14,21,0.667,8,12,0.667,7,7,1.0,0,2,2,12,0,1,3,2,43,8,1,IND,IND,CHA,124,,,57,45,55,14
Tyrese Haliburton,G,22023,1630169,22300001,"NOV 03, 2023",IND vs. CLE,W,34,5,14,0.357,0,5,0.0,8,9,0.889,0,2,2,13,2,0,4,2,18,3,1,IND,IND,CLE,121,,,33,20,31,15
Tyrese Haliburton,G,22023,1630169,22300102,"OCT 30, 2023",IND vs. CHI,L,36,6,16,0.375,1,8,0.125,6,7,0.857,1,4,5,13,2,0,4,1,19,2,1,IND,IND,CHI,105,,,37,24,32,18
Tyrese Haliburton,G,22023,1630169,22300091,"OCT 28, 2023",IND @ CLE,W,32,7,16,0.438,4,7,0.571,3,3,1.0,1,7,8,13,0,0,1,2,21,-1,1,IND,CLE,IND,125,,,42,29,34,21
Tyrese Haliburton,G,22023,1630169,22300064,"OCT 25, 2023",IND vs. WAS,W,27,9,16,0.563,2,6,0.333,0,0,0.0,0,3,3,11,1,2,3,1,20,6,1,IND,IND,WAS,143,,,34,23,31,14
Tyrese Haliburton,G,22023,1630169,22300707,"FEB 04, 2024",IND @ CHA,W,20,6,8,0.75,3,5,0.6,2,3,0.667,0,1,1,4,1,2,1,0,17,13,1,IND,CHA,IND,115,,,22,18,21,5
Tyrese Haliburton,G,22023,1630169,22300493,"JAN 06, 2024",IND vs. BOS,L,35,5,17,0.294,2,9,0.222,5,5,1.0,1,5,6,7,5,0,4,1,17,-14,1,IND,IND,BOS,101,,,30,23,24,13
Tyrese Haliburton,G,22023,1630169,22300755,"FEB 10, 2024",IND @ NYK,W,30,7,14,0.5,4,9,0.444,4,5,0.8,0,3,3,12,0,1,1,0,22,11,1,IND,NYK,IND,125,,,37,25,34,15
Tyrese Haliburton,G,22023,1630169,22300733,"FEB 08, 2024",IND vs. GSW,L,26,2,7,0.286,1,4,0.25,0,0,0.0,0,1,1,11,1,1,3,1,5,-9,1,IND,IND,GSW,109,,,17,6,16,12
Tyrese Haliburton,G,22023,1630169,22300719,"FEB 06, 2024",IND vs. HOU,W,29,8,15,0.533,2,6,0.333,0,1,0.0,0,2,2,7,1,2,2,1,18,-1,1,IND,IND,HOU,132,,,27,20,25,9
Tyrese Haliburton,G,22023,1630169,22300691,"FEB 02, 2024",IND vs. SAC,L,22,6,10,0.6,1,3,0.333,1,1,1.0,1,2,3,1,1,0,5,1,14,-15,1,IND,IND,SAC,122,,,18,17,15,4
Tyrese Haliburton,G,22023,1630169,22300685,"FEB 01, 2024",IND @ NYK,L,22,6,10,0.6,2,6,0.333,1,1,1.0,0,4,4,5,0,2,1,1,15,5,1,IND,NYK,IND,105,,,24,19,20,9
Tyrese Haliburton,G,22023,1630169,22300670,"JAN 30, 2024",IND @ BOS,L,22,5,16,0.313,1,5,0.2,2,2,1.0,3,0,3,10,1,0,1,1,13,-4,1,IND,BOS,IND,124,,,26,16,23,13
Tyrese Haliburton,G,22023,1630169,22300590,"JAN 19, 2024",IND @ POR,L,35,6,14,0.429,2,7,0.286,7,9,0.778,0,2,2,17,0,0,0,1,21,16,1,IND,POR,IND,115,,,40,23,38,19
Tyrese Haliburton,G,22023,1630169,22300454,"JAN 01, 2024",IND @ MIL,W,37,11,22,0.5,1,7,0.143,3,3,1.0,1,8,9,11,1,1,2,0,26,-5,1,IND,MIL,IND,122,,,46,35,37,20
Tyrese Haliburton,G,22023,1630169,22300441,"DEC 30, 2023",IND vs. NYK,W,36,8,17,0.471,2,10,0.2,4,4,1.0,1,4,5,23,2,1,2,0,22,19,1,IND,IND,NYK,140,,,50,27,45,28
Tyrese Haliburton,G,22023,1630169,22300422,"DEC 28, 2023",IND @ CHI,W,37,7,17,0.412,6,13,0.462,1,2,0.5,0,3,3,20,2,1,0,2,21,32,1,IND,CHI,IND,120,,,44,24,41,23
Tyrese Haliburton,G,22023,1630169,22300409,"DEC 26, 2023",IND @ HOU,W,38,13,21,0.619,7,13,0.538,0,1,0.0,1,5,6,10,1,0,3,0,33,15,1,IND,HOU,IND,123,,,49,39,43,16
Tyrese Haliburton,G,22023,1630169,22300391,"DEC 23, 2023",IND vs. ORL,L,40,12,22,0.545,3,5,0.6,2,3,0.667,0,2,2,15,3,0,3,2,29,8,1,IND,IND,ORL,110,,,46,31,44,17
Terry Rozier,G,22023,1626179,22300730,"FEB 07, 2024",MIA vs. SAS,W,28,5,15,0.333,2,7,0.286,1,1,1.0,1,1,2,5,0,0,1,3,13,16,1,MIA,MIA,SAS,116,16.5,Points,20,15,18,7
Terry Rozier,G,22023,1626179,22300730,"FEB 07, 2024",MIA vs. SAS,W,28,5,15,0.333,2,7,0.286,1,1,1.0,1,1,2,5,0,0,1,3,13,16,1,MIA,MIA,SAS,116,4.0,Rebounds,20,15,18,7
Terry Rozier,G,22023,1626179,22300730,"FEB 07, 2024",MIA vs. SAS,W,28,5,15,0.333,2,7,0.286,1,1,1.0,1,1,2,5,0,0,1,3,13,16,1,MIA,MIA,SAS,116,26.5,Pts+Rebs+Asts,20,15,18,7
Terry Rozier,G,22023,1626179,22300730,"FEB 07, 2024",MIA vs. SAS,W,28,5,15,0.333,2,7,0.286,1,1,1.0,1,1,2,5,0,0,1,3,13,16,1,MIA,MIA,SAS,116,6.0,Assists,20,15,18,7
Terry Rozier,G,22023,1626179,22300730,"FEB 07, 2024",MIA vs. SAS,W,28,5,15,0.333,2,7,0.286,1,1,1.0,1,1,2,5,0,0,1,3,13,16,1,MIA,MIA,SAS,116,31.0,Fantasy Score,20,15,18,7
Terry Rozier,G,22023,1626179,22300730,"FEB 07, 2024",MIA vs. SAS,W,28,5,15,0.333,2,7,0.286,1,1,1.0,1,1,2,5,0,0,1,3,13,16,1,MIA,MIA,SAS,116,20.5,Pts+Rebs,20,15,18,7
Terry Rozier,G,22023,1626179,22300730,"FEB 07, 2024",MIA vs. SAS,W,28,5,15,0.333,2,7,0.286,1,1,1.0,1,1,2,5,0,0,1,3,13,16,1,MIA,MIA,SAS,116,22.5,Pts+Asts,20,15,18,7
Terry Rozier,G,22023,1626179,22300730,"FEB 07, 2024",MIA vs. SAS,W,28,5,15,0.333,2,7,0.286,1,1,1.0,1,1,2,5,0,0,1,3,13,16,1,MIA,MIA,SAS,116,10.0,Rebs+Asts,20,15,18,7
Terry Rozier,G,22023,1626179,22300721,"FEB 06, 2024",MIA vs. ORL,W,31,7,12,0.583,2,4,0.5,2,3,0.667,1,5,6,7,1,0,1,1,18,21,1,MIA,MIA,ORL,121,16.5,Points,31,24,25,13
Terry Rozier,G,22023,1626179,22300721,"FEB 06, 2024",MIA vs. ORL,W,31,7,12,0.583,2,4,0.5,2,3,0.667,1,5,6,7,1,0,1,1,18,21,1,MIA,MIA,ORL,121,4.0,Rebounds,31,24,25,13
Terry Rozier,G,22023,1626179,22300721,"FEB 06, 2024",MIA vs. ORL,W,31,7,12,0.583,2,4,0.5,2,3,0.667,1,5,6,7,1,0,1,1,18,21,1,MIA,MIA,ORL,121,26.5,Pts+Rebs+Asts,31,24,25,13
Terry Rozier,G,22023,1626179,22300721,"FEB 06, 2024",MIA vs. ORL,W,31,7,12,0.583,2,4,0.5,2,3,0.667,1,5,6,7,1,0,1,1,18,21,1,MIA,MIA,ORL,121,6.0,Assists,31,24,25,13
Terry Rozier,G,22023,1626179,22300721,"FEB 06, 2024",MIA vs. ORL,W,31,7,12,0.583,2,4,0.5,2,3,0.667,1,5,6,7,1,0,1,1,18,21,1,MIA,MIA,ORL,121,31.0,Fantasy Score,31,24,25,13
Terry Rozier,G,22023,1626179,22300721,"FEB 06, 2024",MIA vs. ORL,W,31,7,12,0.583,2,4,0.5,2,3,0.667,1,5,6,7,1,0,1,1,18,21,1,MIA,MIA,ORL,121,20.5,Pts+Rebs,31,24,25,13
Terry Rozier,G,22023,1626179,22300721,"FEB 06, 2024",MIA vs. ORL,W,31,7,12,0.583,2,4,0.5,2,3,0.667,1,5,6,7,1,0,1,1,18,21,1,MIA,MIA,ORL,121,22.5,Pts+Asts,31,24,25,13
Terry Rozier,G,22023,1626179,22300721,"FEB 06, 2024",MIA vs. ORL,W,31,7,12,0.583,2,4,0.5,2,3,0.667,1,5,6,7,1,0,1,1,18,21,1,MIA,MIA,ORL,121,10.0,Rebs+Asts,31,24,25,13
Terry Rozier,G,22023,1626179,22300708,"FEB 04, 2024",MIA vs. LAC,L,38,7,17,0.412,0,5,0.0,3,3,1.0,1,6,7,5,2,0,2,4,17,-4,1,MIA,MIA,LAC,95,16.5,Points,29,24,22,12
Terry Rozier,G,22023,1626179,22300708,"FEB 04, 2024",MIA vs. LAC,L,38,7,17,0.412,0,5,0.0,3,3,1.0,1,6,7,5,2,0,2,4,17,-4,1,MIA,MIA,LAC,95,4.0,Rebounds,29,24,22,12
Terry Rozier,G,22023,1626179,22300708,"FEB 04, 2024",MIA vs. LAC,L,38,7,17,0.412,0,5,0.0,3,3,1.0,1,6,7,5,2,0,2,4,17,-4,1,MIA,MIA,LAC,95,26.5,Pts+Rebs+Asts,29,24,22,12
Terry Rozier,G,22023,1626179,22300708,"FEB 04, 2024",MIA vs. LAC,L,38,7,17,0.412,0,5,0.0,3,3,1.0,1,6,7,5,2,0,2,4,17,-4,1,MIA,MIA,LAC,95,6.0,Assists,29,24,22,12
Terry Rozier,G,22023,1626179,22300708,"FEB 04, 2024",MIA vs. LAC,L,38,7,17,0.412,0,5,0.0,3,3,1.0,1,6,7,5,2,0,2,4,17,-4,1,MIA,MIA,LAC,95,31.0,Fantasy Score,29,24,22,12
Terry Rozier,G,22023,1626179,22300708,"FEB 04, 2024",MIA vs. LAC,L,38,7,17,0.412,0,5,0.0,3,3,1.0,1,6,7,5,2,0,2,4,17,-4,1,MIA,MIA,LAC,95,20.5,Pts+Rebs,29,24,22,12
Terry Rozier,G,22023,1626179,22300708,"FEB 04, 2024",MIA vs. LAC,L,38,7,17,0.412,0,5,0.0,3,3,1.0,1,6,7,5,2,0,2,4,17,-4,1,MIA,MIA,LAC,95,22.5,Pts+Asts,29,24,22,12
Terry Rozier,G,22023,1626179,22300708,"FEB 04, 2024",MIA vs. LAC,L,38,7,17,0.412,0,5,0.0,3,3,1.0,1,6,7,5,2,0,2,4,17,-4,1,MIA,MIA,LAC,95,10.0,Rebs+Asts,29,24,22,12
Terry Rozier,G,22023,1626179,22300689,"FEB 02, 2024",MIA @ WAS,W,30,2,13,0.154,0,6,0.0,11,11,1.0,2,6,8,5,0,0,0,3,15,15,1,MIA,WAS,MIA,110,16.5,Points,28,23,20,13
Terry Rozier,G,22023,1626179,22300689,"FEB 02, 2024",MIA @ WAS,W,30,2,13,0.154,0,6,0.0,11,11,1.0,2,6,8,5,0,0,0,3,15,15,1,MIA,WAS,MIA,110,4.0,Rebounds,28,23,20,13
Terry Rozier,G,22023,1626179,22300689,"FEB 02, 2024",MIA @ WAS,W,30,2,13,0.154,0,6,0.0,11,11,1.0,2,6,8,5,0,0,0,3,15,15,1,MIA,WAS,MIA,110,26.5,Pts+Rebs+Asts,28,23,20,13
Terry Rozier,G,22023,1626179,22300689,"FEB 02, 2024",MIA @ WAS,W,30,2,13,0.154,0,6,0.0,11,11,1.0,2,6,8,5,0,0,0,3,15,15,1,MIA,WAS,MIA,110,6.0,Assists,28,23,20,13
Terry Rozier,G,22023,1626179,22300689,"FEB 02, 2024",MIA @ WAS,W,30,2,13,0.154,0,6,0.0,11,11,1.0,2,6,8,5,0,0,0,3,15,15,1,MIA,WAS,MIA,110,31.0,Fantasy Score,28,23,20,13
Terry Rozier,G,22023,1626179,22300689,"FEB 02, 2024",MIA @ WAS,W,30,2,13,0.154,0,6,0.0,11,11,1.0,2,6,8,5,0,0,0,3,15,15,1,MIA,WAS,MIA,110,20.5,Pts+Rebs,28,23,20,13
Terry Rozier,G,22023,1626179,22300689,"FEB 02, 2024",MIA @ WAS,W,30,2,13,0.154,0,6,0.0,11,11,1.0,2,6,8,5,0,0,0,3,15,15,1,MIA,WAS,MIA,110,22.5,Pts+Asts,28,23,20,13
Terry Rozier,G,22023,1626179,22300689,"FEB 02, 2024",MIA @ WAS,W,30,2,13,0.154,0,6,0.0,11,11,1.0,2,6,8,5,0,0,0,3,15,15,1,MIA,WAS,MIA,110,10.0,Rebs+Asts,28,23,20,13
Terry Rozier,G,22023,1626179,22300678,"JAN 31, 2024",MIA vs. SAC,W,30,1,8,0.125,1,4,0.25,0,0,0.0,1,4,5,10,2,1,1,1,3,1,1,MIA,MIA,SAC,115,16.5,Points,18,8,13,15
Terry Rozier,G,22023,1626179,22300678,"JAN 31, 2024",MIA vs. SAC,W,30,1,8,0.125,1,4,0.25,0,0,0.0,1,4,5,10,2,1,1,1,3,1,1,MIA,MIA,SAC,115,4.0,Rebounds,18,8,13,15
Terry Rozier,G,22023,1626179,22300678,"JAN 31, 2024",MIA vs. SAC,W,30,1,8,0.125,1,4,0.25,0,0,0.0,1,4,5,10,2,1,1,1,3,1,1,MIA,MIA,SAC,115,26.5,Pts+Rebs+Asts,18,8,13,15
Terry Rozier,G,22023,1626179,22300678,"JAN 31, 2024",MIA vs. SAC,W,30,1,8,0.125,1,4,0.25,0,0,0.0,1,4,5,10,2,1,1,1,3,1,1,MIA,MIA,SAC,115,6.0,Assists,18,8,13,15
Terry Rozier,G,22023,1626179,22300678,"JAN 31, 2024",MIA vs. SAC,W,30,1,8,0.125,1,4,0.25,0,0,0.0,1,4,5,10,2,1,1,1,3,1,1,MIA,MIA,SAC,115,31.0,Fantasy Score,18,8,13,15
Terry Rozier,G,22023,1626179,22300678,"JAN 31, 2024",MIA vs. SAC,W,30,1,8,0.125,1,4,0.25,0,0,0.0,1,4,5,10,2,1,1,1,3,1,1,MIA,MIA,SAC,115,20.5,Pts+Rebs,18,8,13,15
Terry Rozier,G,22023,1626179,22300678,"JAN 31, 2024",MIA vs. SAC,W,30,1,8,0.125,1,4,0.25,0,0,0.0,1,4,5,10,2,1,1,1,3,1,1,MIA,MIA,SAC,115,22.5,Pts+Asts,18,8,13,15
Terry Rozier,G,22023,1626179,22300678,"JAN 31, 2024",MIA vs. SAC,W,30,1,8,0.125,1,4,0.25,0,0,0.0,1,4,5,10,2,1,1,1,3,1,1,MIA,MIA,SAC,115,10.0,Rebs+Asts,18,8,13,15
Terry Rozier,G,22023,1626179,22300661,"JAN 29, 2024",MIA vs. PHX,L,27,8,14,0.571,4,6,0.667,1,1,1.0,0,2,2,3,0,1,1,2,21,-21,1,MIA,MIA,PHX,105,16.5,Points,26,23,24,5
Terry Rozier,G,22023,1626179,22300661,"JAN 29, 2024",MIA vs. PHX,L,27,8,14,0.571,4,6,0.667,1,1,1.0,0,2,2,3,0,1,1,2,21,-21,1,MIA,MIA,PHX,105,4.0,Rebounds,26,23,24,5
Terry Rozier,G,22023,1626179,22300661,"JAN 29, 2024",MIA vs. PHX,L,27,8,14,0.571,4,6,0.667,1,1,1.0,0,2,2,3,0,1,1,2,21,-21,1,MIA,MIA,PHX,105,26.5,Pts+Rebs+Asts,26,23,24,5
Terry Rozier,G,22023,1626179,22300661,"JAN 29, 2024",MIA vs. PHX,L,27,8,14,0.571,4,6,0.667,1,1,1.0,0,2,2,3,0,1,1,2,21,-21,1,MIA,MIA,PHX,105,6.0,Assists,26,23,24,5
Terry Rozier,G,22023,1626179,22300661,"JAN 29, 2024",MIA vs. PHX,L,27,8,14,0.571,4,6,0.667,1,1,1.0,0,2,2,3,0,1,1,2,21,-21,1,MIA,MIA,PHX,105,31.0,Fantasy Score,26,23,24,5
Terry Rozier,G,22023,1626179,22300661,"JAN 29, 2024",MIA vs. PHX,L,27,8,14,0.571,4,6,0.667,1,1,1.0,0,2,2,3,0,1,1,2,21,-21,1,MIA,MIA,PHX,105,20.5,Pts+Rebs,26,23,24,5
Terry Rozier,G,22023,1626179,22300661,"JAN 29, 2024",MIA vs. PHX,L,27,8,14,0.571,4,6,0.667,1,1,1.0,0,2,2,3,0,1,1,2,21,-21,1,MIA,MIA,PHX,105,22.5,Pts+Asts,26,23,24,5
Terry Rozier,G,22023,1626179,22300661,"JAN 29, 2024",MIA vs. PHX,L,27,8,14,0.571,4,6,0.667,1,1,1.0,0,2,2,3,0,1,1,2,21,-21,1,MIA,MIA,PHX,105,10.0,Rebs+Asts,26,23,24,5
Terry Rozier,G,22023,1626179,22300643,"JAN 27, 2024",MIA @ NYK,L,32,4,12,0.333,0,2,0.0,2,2,1.0,0,5,5,7,0,0,2,1,10,-14,1,MIA,NYK,MIA,109,16.5,Points,22,15,17,12
Terry Rozier,G,22023,1626179,22300643,"JAN 27, 2024",MIA @ NYK,L,32,4,12,0.333,0,2,0.0,2,2,1.0,0,5,5,7,0,0,2,1,10,-14,1,MIA,NYK,MIA,109,4.0,Rebounds,22,15,17,12
Terry Rozier,G,22023,1626179,22300643,"JAN 27, 2024",MIA @ NYK,L,32,4,12,0.333,0,2,0.0,2,2,1.0,0,5,5,7,0,0,2,1,10,-14,1,MIA,NYK,MIA,109,26.5,Pts+Rebs+Asts,22,15,17,12
Terry Rozier,G,22023,1626179,22300643,"JAN 27, 2024",MIA @ NYK,L,32,4,12,0.333,0,2,0.0,2,2,1.0,0,5,5,7,0,0,2,1,10,-14,1,MIA,NYK,MIA,109,6.0,Assists,22,15,17,12
Terry Rozier,G,22023,1626179,22300643,"JAN 27, 2024",MIA @ NYK,L,32,4,12,0.333,0,2,0.0,2,2,1.0,0,5,5,7,0,0,2,1,10,-14,1,MIA,NYK,MIA,109,31.0,Fantasy Score,22,15,17,12
Terry Rozier,G,22023,1626179,22300643,"JAN 27, 2024",MIA @ NYK,L,32,4,12,0.333,0,2,0.0,2,2,1.0,0,5,5,7,0,0,2,1,10,-14,1,MIA,NYK,MIA,109,20.5,Pts+Rebs,22,15,17,12
Terry Rozier,G,22023,1626179,22300643,"JAN 27, 2024",MIA @ NYK,L,32,4,12,0.333,0,2,0.0,2,2,1.0,0,5,5,7,0,0,2,1,10,-14,1,MIA,NYK,MIA,109,22.5,Pts+Asts,22,15,17,12
Terry Rozier,G,22023,1626179,22300643,"JAN 27, 2024",MIA @ NYK,L,32,4,12,0.333,0,2,0.0,2,2,1.0,0,5,5,7,0,0,2,1,10,-14,1,MIA,NYK,MIA,109,10.0,Rebs+Asts,22,15,17,12
Terry Rozier,G,22023,1626179,22300630,"JAN 25, 2024",MIA vs. BOS,L,29,3,10,0.3,1,4,0.25,0,0,0.0,0,2,2,3,1,0,0,2,7,-28,1,MIA,MIA,BOS,110,16.5,Points,12,9,10,5
Terry Rozier,G,22023,1626179,22300630,"JAN 25, 2024",MIA vs. BOS,L,29,3,10,0.3,1,4,0.25,0,0,0.0,0,2,2,3,1,0,0,2,7,-28,1,MIA,MIA,BOS,110,4.0,Rebounds,12,9,10,5
Terry Rozier,G,22023,1626179,22300630,"JAN 25, 2024",MIA vs. BOS,L,29,3,10,0.3,1,4,0.25,0,0,0.0,0,2,2,3,1,0,0,2,7,-28,1,MIA,MIA,BOS,110,26.5,Pts+Rebs+Asts,12,9,10,5
Terry Rozier,G,22023,1626179,22300630,"JAN 25, 2024",MIA vs. BOS,L,29,3,10,0.3,1,4,0.25,0,0,0.0,0,2,2,3,1,0,0,2,7,-28,1,MIA,MIA,BOS,110,6.0,Assists,12,9,10,5
Terry Rozier,G,22023,1626179,22300630,"JAN 25, 2024",MIA vs. BOS,L,29,3,10,0.3,1,4,0.25,0,0,0.0,0,2,2,3,1,0,0,2,7,-28,1,MIA,MIA,BOS,110,31.0,Fantasy Score,12,9,10,5
Terry Rozier,G,22023,1626179,22300630,"JAN 25, 2024",MIA vs. BOS,L,29,3,10,0.3,1,4,0.25,0,0,0.0,0,2,2,3,1,0,0,2,7,-28,1,MIA,MIA,BOS,110,20.5,Pts+Rebs,12,9,10,5
Terry Rozier,G,22023,1626179,22300630,"JAN 25, 2024",MIA vs. BOS,L,29,3,10,0.3,1,4,0.25,0,0,0.0,0,2,2,3,1,0,0,2,7,-28,1,MIA,MIA,BOS,110,22.5,Pts+Asts,12,9,10,5
Terry Rozier,G,22023,1626179,22300630,"JAN 25, 2024",MIA vs. BOS,L,29,3,10,0.3,1,4,0.25,0,0,0.0,0,2,2,3,1,0,0,2,7,-28,1,MIA,MIA,BOS,110,10.0,Rebs+Asts,12,9,10,5
Terry Rozier,G,22023,1626179,22300621,"JAN 24, 2024",MIA vs. MEM,L,29,3,11,0.273,1,5,0.2,2,2,1.0,2,2,4,5,2,0,3,2,9,-13,1,MIA,MIA,MEM,96,16.5,Points,18,13,14,9
Terry Rozier,G,22023,1626179,22300621,"JAN 24, 2024",MIA vs. MEM,L,29,3,11,0.273,1,5,0.2,2,2,1.0,2,2,4,5,2,0,3,2,9,-13,1,MIA,MIA,MEM,96,4.0,Rebounds,18,13,14,9
Terry Rozier,G,22023,1626179,22300621,"JAN 24, 2024",MIA vs. MEM,L,29,3,11,0.273,1,5,0.2,2,2,1.0,2,2,4,5,2,0,3,2,9,-13,1,MIA,MIA,MEM,96,26.5,Pts+Rebs+Asts,18,13,14,9
Terry Rozier,G,22023,1626179,22300621,"JAN 24, 2024",MIA vs. MEM,L,29,3,11,0.273,1,5,0.2,2,2,1.0,2,2,4,5,2,0,3,2,9,-13,1,MIA,MIA,MEM,96,6.0,Assists,18,13,14,9
Terry Rozier,G,22023,1626179,22300621,"JAN 24, 2024",MIA vs. MEM,L,29,3,11,0.273,1,5,0.2,2,2,1.0,2,2,4,5,2,0,3,2,9,-13,1,MIA,MIA,MEM,96,31.0,Fantasy Score,18,13,14,9
Terry Rozier,G,22023,1626179,22300621,"JAN 24, 2024",MIA vs. MEM,L,29,3,11,0.273,1,5,0.2,2,2,1.0,2,2,4,5,2,0,3,2,9,-13,1,MIA,MIA,MEM,96,20.5,Pts+Rebs,18,13,14,9
Terry Rozier,G,22023,1626179,22300621,"JAN 24, 2024",MIA vs. MEM,L,29,3,11,0.273,1,5,0.2,2,2,1.0,2,2,4,5,2,0,3,2,9,-13,1,MIA,MIA,MEM,96,22.5,Pts+Asts,18,13,14,9
Terry Rozier,G,22023,1626179,22300621,"JAN 24, 2024",MIA vs. MEM,L,29,3,11,0.273,1,5,0.2,2,2,1.0,2,2,4,5,2,0,3,2,9,-13,1,MIA,MIA,MEM,96,10.0,Rebs+Asts,18,13,14,9
Terry Rozier,G,22023,1626179,22300335,"DEC 16, 2023",CHA vs. PHI,L,20,3,10,0.3,0,5,0.0,0,0,0.0,1,1,2,2,0,0,2,2,6,-38,1,CHA,CHA,PHI,80,16.5,Points,10,8,8,4
Terry Rozier,G,22023,1626179,22300335,"DEC 16, 2023",CHA vs. PHI,L,20,3,10,0.3,0,5,0.0,0,0,0.0,1,1,2,2,0,0,2,2,6,-38,1,CHA,CHA,PHI,80,4.0,Rebounds,10,8,8,4
Terry Rozier,G,22023,1626179,22300335,"DEC 16, 2023",CHA vs. PHI,L,20,3,10,0.3,0,5,0.0,0,0,0.0,1,1,2,2,0,0,2,2,6,-38,1,CHA,CHA,PHI,80,26.5,Pts+Rebs+Asts,10,8,8,4
Terry Rozier,G,22023,1626179,22300335,"DEC 16, 2023",CHA vs. PHI,L,20,3,10,0.3,0,5,0.0,0,0,0.0,1,1,2,2,0,0,2,2,6,-38,1,CHA,CHA,PHI,80,6.0,Assists,10,8,8,4
Terry Rozier,G,22023,1626179,22300335,"DEC 16, 2023",CHA vs. PHI,L,20,3,10,0.3,0,5,0.0,0,0,0.0,1,1,2,2,0,0,2,2,6,-38,1,CHA,CHA,PHI,80,31.0,Fantasy Score,10,8,8,4
Terry Rozier,G,22023,1626179,22300335,"DEC 16, 2023",CHA vs. PHI,L,20,3,10,0.3,0,5,0.0,0,0,0.0,1,1,2,2,0,0,2,2,6,-38,1,CHA,CHA,PHI,80,20.5,Pts+Rebs,10,8,8,4
Terry Rozier,G,22023,1626179,22300335,"DEC 16, 2023",CHA vs. PHI,L,20,3,10,0.3,0,5,0.0,0,0,0.0,1,1,2,2,0,0,2,2,6,-38,1,CHA,CHA,PHI,80,22.5,Pts+Asts,10,8,8,4
Terry Rozier,G,22023,1626179,22300335,"DEC 16, 2023",CHA vs. PHI,L,20,3,10,0.3,0,5,0.0,0,0,0.0,1,1,2,2,0,0,2,2,6,-38,1,CHA,CHA,PHI,80,10.0,Rebs+Asts,10,8,8,4
Terry Rozier,G,22023,1626179,22300610,"JAN 22, 2024",CHA @ MIN,W,35,5,12,0.417,0,6,0.0,1,2,0.5,0,2,2,4,0,0,4,1,11,-13,1,CHA,MIN,CHA,126,16.5,Points,17,13,15,6
Terry Rozier,G,22023,1626179,22300610,"JAN 22, 2024",CHA @ MIN,W,35,5,12,0.417,0,6,0.0,1,2,0.5,0,2,2,4,0,0,4,1,11,-13,1,CHA,MIN,CHA,126,4.0,Rebounds,17,13,15,6
Terry Rozier,G,22023,1626179,22300610,"JAN 22, 2024",CHA @ MIN,W,35,5,12,0.417,0,6,0.0,1,2,0.5,0,2,2,4,0,0,4,1,11,-13,1,CHA,MIN,CHA,126,26.5,Pts+Rebs+Asts,17,13,15,6
Terry Rozier,G,22023,1626179,22300610,"JAN 22, 2024",CHA @ MIN,W,35,5,12,0.417,0,6,0.0,1,2,0.5,0,2,2,4,0,0,4,1,11,-13,1,CHA,MIN,CHA,126,6.0,Assists,17,13,15,6
Terry Rozier,G,22023,1626179,22300610,"JAN 22, 2024",CHA @ MIN,W,35,5,12,0.417,0,6,0.0,1,2,0.5,0,2,2,4,0,0,4,1,11,-13,1,CHA,MIN,CHA,126,31.0,Fantasy Score,17,13,15,6
Terry Rozier,G,22023,1626179,22300610,"JAN 22, 2024",CHA @ MIN,W,35,5,12,0.417,0,6,0.0,1,2,0.5,0,2,2,4,0,0,4,1,11,-13,1,CHA,MIN,CHA,126,20.5,Pts+Rebs,17,13,15,6
Terry Rozier,G,22023,1626179,22300610,"JAN 22, 2024",CHA @ MIN,W,35,5,12,0.417,0,6,0.0,1,2,0.5,0,2,2,4,0,0,4,1,11,-13,1,CHA,MIN,CHA,126,22.5,Pts+Asts,17,13,15,6
Terry Rozier,G,22023,1626179,22300610,"JAN 22, 2024",CHA @ MIN,W,35,5,12,0.417,0,6,0.0,1,2,0.5,0,2,2,4,0,0,4,1,11,-13,1,CHA,MIN,CHA,126,10.0,Rebs+Asts,17,13,15,6
Terry Rozier,G,22023,1626179,22300584,"JAN 19, 2024",CHA vs. SAS,W,34,7,18,0.389,1,7,0.143,2,2,1.0,1,5,6,8,1,0,3,0,17,-2,1,CHA,CHA,SAS,124,16.5,Points,31,23,25,14
Terry Rozier,G,22023,1626179,22300584,"JAN 19, 2024",CHA vs. SAS,W,34,7,18,0.389,1,7,0.143,2,2,1.0,1,5,6,8,1,0,3,0,17,-2,1,CHA,CHA,SAS,124,4.0,Rebounds,31,23,25,14
Terry Rozier,G,22023,1626179,22300584,"JAN 19, 2024",CHA vs. SAS,W,34,7,18,0.389,1,7,0.143,2,2,1.0,1,5,6,8,1,0,3,0,17,-2,1,CHA,CHA,SAS,124,26.5,Pts+Rebs+Asts,31,23,25,14
Terry Rozier,G,22023,1626179,22300584,"JAN 19, 2024",CHA vs. SAS,W,34,7,18,0.389,1,7,0.143,2,2,1.0,1,5,6,8,1,0,3,0,17,-2,1,CHA,CHA,SAS,124,6.0,Assists,31,23,25,14
Terry Rozier,G,22023,1626179,22300584,"JAN 19, 2024",CHA vs. SAS,W,34,7,18,0.389,1,7,0.143,2,2,1.0,1,5,6,8,1,0,3,0,17,-2,1,CHA,CHA,SAS,124,31.0,Fantasy Score,31,23,25,14
Terry Rozier,G,22023,1626179,22300584,"JAN 19, 2024",CHA vs. SAS,W,34,7,18,0.389,1,7,0.143,2,2,1.0,1,5,6,8,1,0,3,0,17,-2,1,CHA,CHA,SAS,124,20.5,Pts+Rebs,31,23,25,14
Terry Rozier,G,22023,1626179,22300584,"JAN 19, 2024",CHA vs. SAS,W,34,7,18,0.389,1,7,0.143,2,2,1.0,1,5,6,8,1,0,3,0,17,-2,1,CHA,CHA,SAS,124,22.5,Pts+Asts,31,23,25,14
Terry Rozier,G,22023,1626179,22300584,"JAN 19, 2024",CHA vs. SAS,W,34,7,18,0.389,1,7,0.143,2,2,1.0,1,5,6,8,1,0,3,0,17,-2,1,CHA,CHA,SAS,124,10.0,Rebs+Asts,31,23,25,14
Terry Rozier,G,22023,1626179,22300575,"JAN 17, 2024",CHA @ NOP,L,32,9,15,0.6,7,11,0.636,0,0,0.0,1,1,2,4,1,1,1,1,25,-9,1,CHA,NOP,CHA,108,16.5,Points,31,27,29,6
Terry Rozier,G,22023,1626179,22300575,"JAN 17, 2024",CHA @ NOP,L,32,9,15,0.6,7,11,0.636,0,0,0.0,1,1,2,4,1,1,1,1,25,-9,1,CHA,NOP,CHA,108,4.0,Rebounds,31,27,29,6
Terry Rozier,G,22023,1626179,22300575,"JAN 17, 2024",CHA @ NOP,L,32,9,15,0.6,7,11,0.636,0,0,0.0,1,1,2,4,1,1,1,1,25,-9,1,CHA,NOP,CHA,108,26.5,Pts+Rebs+Asts,31,27,29,6
Terry Rozier,G,22023,1626179,22300575,"JAN 17, 2024",CHA @ NOP,L,32,9,15,0.6,7,11,0.636,0,0,0.0,1,1,2,4,1,1,1,1,25,-9,1,CHA,NOP,CHA,108,6.0,Assists,31,27,29,6
Terry Rozier,G,22023,1626179,22300575,"JAN 17, 2024",CHA @ NOP,L,32,9,15,0.6,7,11,0.636,0,0,0.0,1,1,2,4,1,1,1,1,25,-9,1,CHA,NOP,CHA,108,31.0,Fantasy Score,31,27,29,6
Terry Rozier,G,22023,1626179,22300575,"JAN 17, 2024",CHA @ NOP,L,32,9,15,0.6,7,11,0.636,0,0,0.0,1,1,2,4,1,1,1,1,25,-9,1,CHA,NOP,CHA,108,20.5,Pts+Rebs,31,27,29,6
Terry Rozier,G,22023,1626179,22300575,"JAN 17, 2024",CHA @ NOP,L,32,9,15,0.6,7,11,0.636,0,0,0.0,1,1,2,4,1,1,1,1,25,-9,1,CHA,NOP,CHA,108,22.5,Pts+Asts,31,27,29,6
Terry Rozier,G,22023,1626179,22300575,"JAN 17, 2024",CHA @ NOP,L,32,9,15,0.6,7,11,0.636,0,0,0.0,1,1,2,4,1,1,1,1,25,-9,1,CHA,NOP,CHA,108,10.0,Rebs+Asts,31,27,29,6
Terry Rozier,G,22023,1626179,22300551,"JAN 14, 2024",CHA @ MIA,L,35,8,23,0.348,4,11,0.364,6,6,1.0,2,3,5,7,0,0,1,2,26,-18,1,CHA,MIA,CHA,85,16.5,Points,38,31,33,12
Terry Rozier,G,22023,1626179,22300551,"JAN 14, 2024",CHA @ MIA,L,35,8,23,0.348,4,11,0.364,6,6,1.0,2,3,5,7,0,0,1,2,26,-18,1,CHA,MIA,CHA,85,4.0,Rebounds,38,31,33,12
Terry Rozier,G,22023,1626179,22300551,"JAN 14, 2024",CHA @ MIA,L,35,8,23,0.348,4,11,0.364,6,6,1.0,2,3,5,7,0,0,1,2,26,-18,1,CHA,MIA,CHA,85,26.5,Pts+Rebs+Asts,38,31,33,12
Terry Rozier,G,22023,1626179,22300551,"JAN 14, 2024",CHA @ MIA,L,35,8,23,0.348,4,11,0.364,6,6,1.0,2,3,5,7,0,0,1,2,26,-18,1,CHA,MIA,CHA,85,6.0,Assists,38,31,33,12
Terry Rozier,G,22023,1626179,22300551,"JAN 14, 2024",CHA @ MIA,L,35,8,23,0.348,4,11,0.364,6,6,1.0,2,3,5,7,0,0,1,2,26,-18,1,CHA,MIA,CHA,85,31.0,Fantasy Score,38,31,33,12
Terry Rozier,G,22023,1626179,22300551,"JAN 14, 2024",CHA @ MIA,L,35,8,23,0.348,4,11,0.364,6,6,1.0,2,3,5,7,0,0,1,2,26,-18,1,CHA,MIA,CHA,85,20.5,Pts+Rebs,38,31,33,12
Terry Rozier,G,22023,1626179,22300551,"JAN 14, 2024",CHA @ MIA,L,35,8,23,0.348,4,11,0.364,6,6,1.0,2,3,5,7,0,0,1,2,26,-18,1,CHA,MIA,CHA,85,22.5,Pts+Asts,38,31,33,12
Terry Rozier,G,22023,1626179,22300551,"JAN 14, 2024",CHA @ MIA,L,35,8,23,0.348,4,11,0.364,6,6,1.0,2,3,5,7,0,0,1,2,26,-18,1,CHA,MIA,CHA,85,10.0,Rebs+Asts,38,31,33,12
Terry Rozier,G,22023,1626179,22300541,"JAN 12, 2024",CHA @ SAS,L,28,6,14,0.429,3,9,0.333,1,2,0.5,0,2,2,2,2,1,1,2,16,-32,1,CHA,SAS,CHA,99,16.5,Points,20,18,18,4
Terry Rozier,G,22023,1626179,22300541,"JAN 12, 2024",CHA @ SAS,L,28,6,14,0.429,3,9,0.333,1,2,0.5,0,2,2,2,2,1,1,2,16,-32,1,CHA,SAS,CHA,99,4.0,Rebounds,20,18,18,4
Terry Rozier,G,22023,1626179,22300541,"JAN 12, 2024",CHA @ SAS,L,28,6,14,0.429,3,9,0.333,1,2,0.5,0,2,2,2,2,1,1,2,16,-32,1,CHA,SAS,CHA,99,26.5,Pts+Rebs+Asts,20,18,18,4
Terry Rozier,G,22023,1626179,22300541,"JAN 12, 2024",CHA @ SAS,L,28,6,14,0.429,3,9,0.333,1,2,0.5,0,2,2,2,2,1,1,2,16,-32,1,CHA,SAS,CHA,99,6.0,Assists,20,18,18,4
Terry Rozier,G,22023,1626179,22300541,"JAN 12, 2024",CHA @ SAS,L,28,6,14,0.429,3,9,0.333,1,2,0.5,0,2,2,2,2,1,1,2,16,-32,1,CHA,SAS,CHA,99,31.0,Fantasy Score,20,18,18,4
Terry Rozier,G,22023,1626179,22300541,"JAN 12, 2024",CHA @ SAS,L,28,6,14,0.429,3,9,0.333,1,2,0.5,0,2,2,2,2,1,1,2,16,-32,1,CHA,SAS,CHA,99,20.5,Pts+Rebs,20,18,18,4
Terry Rozier,G,22023,1626179,22300541,"JAN 12, 2024",CHA @ SAS,L,28,6,14,0.429,3,9,0.333,1,2,0.5,0,2,2,2,2,1,1,2,16,-32,1,CHA,SAS,CHA,99,22.5,Pts+Asts,20,18,18,4
Terry Rozier,G,22023,1626179,22300541,"JAN 12, 2024",CHA @ SAS,L,28,6,14,0.429,3,9,0.333,1,2,0.5,0,2,2,2,2,1,1,2,16,-32,1,CHA,SAS,CHA,99,10.0,Rebs+Asts,20,18,18,4
Terry Rozier,G,22023,1626179,22300248,"NOV 26, 2023",CHA @ ORL,L,37,9,15,0.6,2,4,0.5,2,4,0.5,0,1,1,9,1,1,5,4,22,-10,1,CHA,ORL,CHA,117,16.5,Points,32,23,31,10
Terry Rozier,G,22023,1626179,22300248,"NOV 26, 2023",CHA @ ORL,L,37,9,15,0.6,2,4,0.5,2,4,0.5,0,1,1,9,1,1,5,4,22,-10,1,CHA,ORL,CHA,117,4.0,Rebounds,32,23,31,10
Terry Rozier,G,22023,1626179,22300248,"NOV 26, 2023",CHA @ ORL,L,37,9,15,0.6,2,4,0.5,2,4,0.5,0,1,1,9,1,1,5,4,22,-10,1,CHA,ORL,CHA,117,26.5,Pts+Rebs+Asts,32,23,31,10
Terry Rozier,G,22023,1626179,22300248,"NOV 26, 2023",CHA @ ORL,L,37,9,15,0.6,2,4,0.5,2,4,0.5,0,1,1,9,1,1,5,4,22,-10,1,CHA,ORL,CHA,117,6.0,Assists,32,23,31,10
Terry Rozier,G,22023,1626179,22300248,"NOV 26, 2023",CHA @ ORL,L,37,9,15,0.6,2,4,0.5,2,4,0.5,0,1,1,9,1,1,5,4,22,-10,1,CHA,ORL,CHA,117,31.0,Fantasy Score,32,23,31,10
Terry Rozier,G,22023,1626179,22300248,"NOV 26, 2023",CHA @ ORL,L,37,9,15,0.6,2,4,0.5,2,4,0.5,0,1,1,9,1,1,5,4,22,-10,1,CHA,ORL,CHA,117,20.5,Pts+Rebs,32,23,31,10
Terry Rozier,G,22023,1626179,22300248,"NOV 26, 2023",CHA @ ORL,L,37,9,15,0.6,2,4,0.5,2,4,0.5,0,1,1,9,1,1,5,4,22,-10,1,CHA,ORL,CHA,117,22.5,Pts+Asts,32,23,31,10
Terry Rozier,G,22023,1626179,22300248,"NOV 26, 2023",CHA @ ORL,L,37,9,15,0.6,2,4,0.5,2,4,0.5,0,1,1,9,1,1,5,4,22,-10,1,CHA,ORL,CHA,117,10.0,Rebs+Asts,32,23,31,10
Terry Rozier,G,22023,1626179,22300133,"NOV 04, 2023",CHA @ IND,W,31,7,14,0.5,3,5,0.6,5,5,1.0,0,6,6,3,0,1,0,0,22,0,1,CHA,IND,CHA,125,16.5,Points,31,28,25,9
Terry Rozier,G,22023,1626179,22300133,"NOV 04, 2023",CHA @ IND,W,31,7,14,0.5,3,5,0.6,5,5,1.0,0,6,6,3,0,1,0,0,22,0,1,CHA,IND,CHA,125,4.0,Rebounds,31,28,25,9
Terry Rozier,G,22023,1626179,22300133,"NOV 04, 2023",CHA @ IND,W,31,7,14,0.5,3,5,0.6,5,5,1.0,0,6,6,3,0,1,0,0,22,0,1,CHA,IND,CHA,125,26.5,Pts+Rebs+Asts,31,28,25,9
Terry Rozier,G,22023,1626179,22300133,"NOV 04, 2023",CHA @ IND,W,31,7,14,0.5,3,5,0.6,5,5,1.0,0,6,6,3,0,1,0,0,22,0,1,CHA,IND,CHA,125,6.0,Assists,31,28,25,9
Terry Rozier,G,22023,1626179,22300133,"NOV 04, 2023",CHA @ IND,W,31,7,14,0.5,3,5,0.6,5,5,1.0,0,6,6,3,0,1,0,0,22,0,1,CHA,IND,CHA,125,31.0,Fantasy Score,31,28,25,9
Terry Rozier,G,22023,1626179,22300133,"NOV 04, 2023",CHA @ IND,W,31,7,14,0.5,3,5,0.6,5,5,1.0,0,6,6,3,0,1,0,0,22,0,1,CHA,IND,CHA,125,20.5,Pts+Rebs,31,28,25,9
Terry Rozier,G,22023,1626179,22300133,"NOV 04, 2023",CHA @ IND,W,31,7,14,0.5,3,5,0.6,5,5,1.0,0,6,6,3,0,1,0,0,22,0,1,CHA,IND,CHA,125,22.5,Pts+Asts,31,28,25,9
Terry Rozier,G,22023,1626179,22300133,"NOV 04, 2023",CHA @ IND,W,31,7,14,0.5,3,5,0.6,5,5,1.0,0,6,6,3,0,1,0,0,22,0,1,CHA,IND,CHA,125,10.0,Rebs+Asts,31,28,25,9
Terry Rozier,G,22023,1626179,22300122,"NOV 01, 2023",CHA @ HOU,L,38,10,21,0.476,1,6,0.167,0,0,0.0,2,1,3,6,1,0,4,0,21,-1,1,CHA,HOU,CHA,119,16.5,Points,30,24,27,9
Terry Rozier,G,22023,1626179,22300122,"NOV 01, 2023",CHA @ HOU,L,38,10,21,0.476,1,6,0.167,0,0,0.0,2,1,3,6,1,0,4,0,21,-1,1,CHA,HOU,CHA,119,4.0,Rebounds,30,24,27,9
Terry Rozier,G,22023,1626179,22300122,"NOV 01, 2023",CHA @ HOU,L,38,10,21,0.476,1,6,0.167,0,0,0.0,2,1,3,6,1,0,4,0,21,-1,1,CHA,HOU,CHA,119,26.5,Pts+Rebs+Asts,30,24,27,9
Terry Rozier,G,22023,1626179,22300122,"NOV 01, 2023",CHA @ HOU,L,38,10,21,0.476,1,6,0.167,0,0,0.0,2,1,3,6,1,0,4,0,21,-1,1,CHA,HOU,CHA,119,6.0,Assists,30,24,27,9
Terry Rozier,G,22023,1626179,22300122,"NOV 01, 2023",CHA @ HOU,L,38,10,21,0.476,1,6,0.167,0,0,0.0,2,1,3,6,1,0,4,0,21,-1,1,CHA,HOU,CHA,119,31.0,Fantasy Score,30,24,27,9
Terry Rozier,G,22023,1626179,22300122,"NOV 01, 2023",CHA @ HOU,L,38,10,21,0.476,1,6,0.167,0,0,0.0,2,1,3,6,1,0,4,0,21,-1,1,CHA,HOU,CHA,119,20.5,Pts+Rebs,30,24,27,9
Terry Rozier,G,22023,1626179,22300122,"NOV 01, 2023",CHA @ HOU,L,38,10,21,0.476,1,6,0.167,0,0,0.0,2,1,3,6,1,0,4,0,21,-1,1,CHA,HOU,CHA,119,22.5,Pts+Asts,30,24,27,9
Terry Rozier,G,22023,1626179,22300122,"NOV 01, 2023",CHA @ HOU,L,38,10,21,0.476,1,6,0.167,0,0,0.0,2,1,3,6,1,0,4,0,21,-1,1,CHA,HOU,CHA,119,10.0,Rebs+Asts,30,24,27,9
Terry Rozier,G,22023,1626179,22300101,"OCT 30, 2023",CHA vs. BKN,L,41,10,19,0.526,2,6,0.333,1,1,1.0,0,3,3,9,1,1,2,2,23,-13,1,CHA,CHA,BKN,121,16.5,Points,35,26,32,12
Terry Rozier,G,22023,1626179,22300101,"OCT 30, 2023",CHA vs. BKN,L,41,10,19,0.526,2,6,0.333,1,1,1.0,0,3,3,9,1,1,2,2,23,-13,1,CHA,CHA,BKN,121,4.0,Rebounds,35,26,32,12
Terry Rozier,G,22023,1626179,22300101,"OCT 30, 2023",CHA vs. BKN,L,41,10,19,0.526,2,6,0.333,1,1,1.0,0,3,3,9,1,1,2,2,23,-13,1,CHA,CHA,BKN,121,26.5,Pts+Rebs+Asts,35,26,32,12
Terry Rozier,G,22023,1626179,22300101,"OCT 30, 2023",CHA vs. BKN,L,41,10,19,0.526,2,6,0.333,1,1,1.0,0,3,3,9,1,1,2,2,23,-13,1,CHA,CHA,BKN,121,6.0,Assists,35,26,32,12
Terry Rozier,G,22023,1626179,22300101,"OCT 30, 2023",CHA vs. BKN,L,41,10,19,0.526,2,6,0.333,1,1,1.0,0,3,3,9,1,1,2,2,23,-13,1,CHA,CHA,BKN,121,31.0,Fantasy Score,35,26,32,12
Terry Rozier,G,22023,1626179,22300101,"OCT 30, 2023",CHA vs. BKN,L,41,10,19,0.526,2,6,0.333,1,1,1.0,0,3,3,9,1,1,2,2,23,-13,1,CHA,CHA,BKN,121,20.5,Pts+Rebs,35,26,32,12
Terry Rozier,G,22023,1626179,22300101,"OCT 30, 2023",CHA vs. BKN,L,41,10,19,0.526,2,6,0.333,1,1,1.0,0,3,3,9,1,1,2,2,23,-13,1,CHA,CHA,BKN,121,22.5,Pts+Asts,35,26,32,12
Terry Rozier,G,22023,1626179,22300101,"OCT 30, 2023",CHA vs. BKN,L,41,10,19,0.526,2,6,0.333,1,1,1.0,0,3,3,9,1,1,2,2,23,-13,1,CHA,CHA,BKN,121,10.0,Rebs+Asts,35,26,32,12
Terry Rozier,G,22023,1626179,22300077,"OCT 27, 2023",CHA vs. DET,L,35,8,20,0.4,0,7,0.0,4,4,1.0,1,2,3,1,1,0,2,0,20,-11,1,CHA,CHA,DET,99,16.5,Points,24,23,21,4
Terry Rozier,G,22023,1626179,22300077,"OCT 27, 2023",CHA vs. DET,L,35,8,20,0.4,0,7,0.0,4,4,1.0,1,2,3,1,1,0,2,0,20,-11,1,CHA,CHA,DET,99,4.0,Rebounds,24,23,21,4
Terry Rozier,G,22023,1626179,22300077,"OCT 27, 2023",CHA vs. DET,L,35,8,20,0.4,0,7,0.0,4,4,1.0,1,2,3,1,1,0,2,0,20,-11,1,CHA,CHA,DET,99,26.5,Pts+Rebs+Asts,24,23,21,4
Terry Rozier,G,22023,1626179,22300077,"OCT 27, 2023",CHA vs. DET,L,35,8,20,0.4,0,7,0.0,4,4,1.0,1,2,3,1,1,0,2,0,20,-11,1,CHA,CHA,DET,99,6.0,Assists,24,23,21,4
Terry Rozier,G,22023,1626179,22300077,"OCT 27, 2023",CHA vs. DET,L,35,8,20,0.4,0,7,0.0,4,4,1.0,1,2,3,1,1,0,2,0,20,-11,1,CHA,CHA,DET,99,31.0,Fantasy Score,24,23,21,4
Terry Rozier,G,22023,1626179,22300077,"OCT 27, 2023",CHA vs. DET,L,35,8,20,0.4,0,7,0.0,4,4,1.0,1,2,3,1,1,0,2,0,20,-11,1,CHA,CHA,DET,99,20.5,Pts+Rebs,24,23,21,4
Terry Rozier,G,22023,1626179,22300077,"OCT 27, 2023",CHA vs. DET,L,35,8,20,0.4,0,7,0.0,4,4,1.0,1,2,3,1,1,0,2,0,20,-11,1,CHA,CHA,DET,99,22.5,Pts+Asts,24,23,21,4
Terry Rozier,G,22023,1626179,22300077,"OCT 27, 2023",CHA vs. DET,L,35,8,20,0.4,0,7,0.0,4,4,1.0,1,2,3,1,1,0,2,0,20,-11,1,CHA,CHA,DET,99,10.0,Rebs+Asts,24,23,21,4
Terry Rozier,G,22023,1626179,22300063,"OCT 25, 2023",CHA vs. ATL,W,34,7,16,0.438,2,7,0.286,8,12,0.667,1,4,5,6,0,0,3,2,24,14,1,CHA,CHA,ATL,116,16.5,Points,35,29,30,11
Terry Rozier,G,22023,1626179,22300063,"OCT 25, 2023",CHA vs. ATL,W,34,7,16,0.438,2,7,0.286,8,12,0.667,1,4,5,6,0,0,3,2,24,14,1,CHA,CHA,ATL,116,4.0,Rebounds,35,29,30,11
Terry Rozier,G,22023,1626179,22300063,"OCT 25, 2023",CHA vs. ATL,W,34,7,16,0.438,2,7,0.286,8,12,0.667,1,4,5,6,0,0,3,2,24,14,1,CHA,CHA,ATL,116,26.5,Pts+Rebs+Asts,35,29,30,11
Terry Rozier,G,22023,1626179,22300063,"OCT 25, 2023",CHA vs. ATL,W,34,7,16,0.438,2,7,0.286,8,12,0.667,1,4,5,6,0,0,3,2,24,14,1,CHA,CHA,ATL,116,6.0,Assists,35,29,30,11
Terry Rozier,G,22023,1626179,22300063,"OCT 25, 2023",CHA vs. ATL,W,34,7,16,0.438,2,7,0.286,8,12,0.667,1,4,5,6,0,0,3,2,24,14,1,CHA,CHA,ATL,116,31.0,Fantasy Score,35,29,30,11
Terry Rozier,G,22023,1626179,22300063,"OCT 25, 2023",CHA vs. ATL,W,34,7,16,0.438,2,7,0.286,8,12,0.667,1,4,5,6,0,0,3,2,24,14,1,CHA,CHA,ATL,116,20.5,Pts+Rebs,35,29,30,11
Terry Rozier,G,22023,1626179,22300063,"OCT 25, 2023",CHA vs. ATL,W,34,7,16,0.438,2,7,0.286,8,12,0.667,1,4,5,6,0,0,3,2,24,14,1,CHA,CHA,ATL,116,22.5,Pts+Asts,35,29,30,11
Terry Rozier,G,22023,1626179,22300063,"OCT 25, 2023",CHA vs. ATL,W,34,7,16,0.438,2,7,0.286,8,12,0.667,1,4,5,6,0,0,3,2,24,14,1,CHA,CHA,ATL,116,10.0,Rebs+Asts,35,29,30,11
Terry Rozier,G,22023,1626179,22300518,"JAN 10, 2024",CHA vs. SAC,L,32,6,14,0.429,3,6,0.5,7,8,0.875,0,4,4,2,1,1,0,1,22,-31,1,CHA,CHA,SAC,96,16.5,Points,28,26,24,6
Terry Rozier,G,22023,1626179,22300518,"JAN 10, 2024",CHA vs. SAC,L,32,6,14,0.429,3,6,0.5,7,8,0.875,0,4,4,2,1,1,0,1,22,-31,1,CHA,CHA,SAC,96,4.0,Rebounds,28,26,24,6
Terry Rozier,G,22023,1626179,22300518,"JAN 10, 2024",CHA vs. SAC,L,32,6,14,0.429,3,6,0.5,7,8,0.875,0,4,4,2,1,1,0,1,22,-31,1,CHA,CHA,SAC,96,26.5,Pts+Rebs+Asts,28,26,24,6
Terry Rozier,G,22023,1626179,22300518,"JAN 10, 2024",CHA vs. SAC,L,32,6,14,0.429,3,6,0.5,7,8,0.875,0,4,4,2,1,1,0,1,22,-31,1,CHA,CHA,SAC,96,6.0,Assists,28,26,24,6
Terry Rozier,G,22023,1626179,22300518,"JAN 10, 2024",CHA vs. SAC,L,32,6,14,0.429,3,6,0.5,7,8,0.875,0,4,4,2,1,1,0,1,22,-31,1,CHA,CHA,SAC,96,31.0,Fantasy Score,28,26,24,6
Terry Rozier,G,22023,1626179,22300518,"JAN 10, 2024",CHA vs. SAC,L,32,6,14,0.429,3,6,0.5,7,8,0.875,0,4,4,2,1,1,0,1,22,-31,1,CHA,CHA,SAC,96,20.5,Pts+Rebs,28,26,24,6
Terry Rozier,G,22023,1626179,22300518,"JAN 10, 2024",CHA vs. SAC,L,32,6,14,0.429,3,6,0.5,7,8,0.875,0,4,4,2,1,1,0,1,22,-31,1,CHA,CHA,SAC,96,22.5,Pts+Asts,28,26,24,6
Terry Rozier,G,22023,1626179,22300518,"JAN 10, 2024",CHA vs. SAC,L,32,6,14,0.429,3,6,0.5,7,8,0.875,0,4,4,2,1,1,0,1,22,-31,1,CHA,CHA,SAC,96,10.0,Rebs+Asts,28,26,24,6
Terry Rozier,G,22023,1626179,22300365,"DEC 20, 2023",CHA @ IND,L,35,10,26,0.385,2,10,0.2,3,3,1.0,2,7,9,7,1,0,1,0,25,-21,1,CHA,IND,CHA,109,16.5,Points,41,34,32,16
Terry Rozier,G,22023,1626179,22300365,"DEC 20, 2023",CHA @ IND,L,35,10,26,0.385,2,10,0.2,3,3,1.0,2,7,9,7,1,0,1,0,25,-21,1,CHA,IND,CHA,109,4.0,Rebounds,41,34,32,16
Terry Rozier,G,22023,1626179,22300365,"DEC 20, 2023",CHA @ IND,L,35,10,26,0.385,2,10,0.2,3,3,1.0,2,7,9,7,1,0,1,0,25,-21,1,CHA,IND,CHA,109,26.5,Pts+Rebs+Asts,41,34,32,16
Terry Rozier,G,22023,1626179,22300365,"DEC 20, 2023",CHA @ IND,L,35,10,26,0.385,2,10,0.2,3,3,1.0,2,7,9,7,1,0,1,0,25,-21,1,CHA,IND,CHA,109,6.0,Assists,41,34,32,16
Terry Rozier,G,22023,1626179,22300365,"DEC 20, 2023",CHA @ IND,L,35,10,26,0.385,2,10,0.2,3,3,1.0,2,7,9,7,1,0,1,0,25,-21,1,CHA,IND,CHA,109,31.0,Fantasy Score,41,34,32,16
Terry Rozier,G,22023,1626179,22300365,"DEC 20, 2023",CHA @ IND,L,35,10,26,0.385,2,10,0.2,3,3,1.0,2,7,9,7,1,0,1,0,25,-21,1,CHA,IND,CHA,109,20.5,Pts+Rebs,41,34,32,16
Terry Rozier,G,22023,1626179,22300365,"DEC 20, 2023",CHA @ IND,L,35,10,26,0.385,2,10,0.2,3,3,1.0,2,7,9,7,1,0,1,0,25,-21,1,CHA,IND,CHA,109,22.5,Pts+Asts,41,34,32,16
Terry Rozier,G,22023,1626179,22300365,"DEC 20, 2023",CHA @ IND,L,35,10,26,0.385,2,10,0.2,3,3,1.0,2,7,9,7,1,0,1,0,25,-21,1,CHA,IND,CHA,109,10.0,Rebs+Asts,41,34,32,16
Terry Rozier,G,22023,1626179,22300354,"DEC 18, 2023",CHA @ TOR,L,32,9,20,0.45,2,8,0.25,2,2,1.0,1,2,3,7,3,1,3,4,22,-3,1,CHA,TOR,CHA,99,16.5,Points,32,25,29,10
Terry Rozier,G,22023,1626179,22300354,"DEC 18, 2023",CHA @ TOR,L,32,9,20,0.45,2,8,0.25,2,2,1.0,1,2,3,7,3,1,3,4,22,-3,1,CHA,TOR,CHA,99,4.0,Rebounds,32,25,29,10
Terry Rozier,G,22023,1626179,22300354,"DEC 18, 2023",CHA @ TOR,L,32,9,20,0.45,2,8,0.25,2,2,1.0,1,2,3,7,3,1,3,4,22,-3,1,CHA,TOR,CHA,99,26.5,Pts+Rebs+Asts,32,25,29,10
Terry Rozier,G,22023,1626179,22300354,"DEC 18, 2023",CHA @ TOR,L,32,9,20,0.45,2,8,0.25,2,2,1.0,1,2,3,7,3,1,3,4,22,-3,1,CHA,TOR,CHA,99,6.0,Assists,32,25,29,10
Terry Rozier,G,22023,1626179,22300354,"DEC 18, 2023",CHA @ TOR,L,32,9,20,0.45,2,8,0.25,2,2,1.0,1,2,3,7,3,1,3,4,22,-3,1,CHA,TOR,CHA,99,31.0,Fantasy Score,32,25,29,10
Terry Rozier,G,22023,1626179,22300354,"DEC 18, 2023",CHA @ TOR,L,32,9,20,0.45,2,8,0.25,2,2,1.0,1,2,3,7,3,1,3,4,22,-3,1,CHA,TOR,CHA,99,20.5,Pts+Rebs,32,25,29,10
Terry Rozier,G,22023,1626179,22300354,"DEC 18, 2023",CHA @ TOR,L,32,9,20,0.45,2,8,0.25,2,2,1.0,1,2,3,7,3,1,3,4,22,-3,1,CHA,TOR,CHA,99,22.5,Pts+Asts,32,25,29,10
Terry Rozier,G,22023,1626179,22300354,"DEC 18, 2023",CHA @ TOR,L,32,9,20,0.45,2,8,0.25,2,2,1.0,1,2,3,7,3,1,3,4,22,-3,1,CHA,TOR,CHA,99,10.0,Rebs+Asts,32,25,29,10
Terry Rozier,G,22023,1626179,22300057,"NOV 28, 2023",CHA @ NYK,L,33,5,16,0.313,0,3,0.0,1,1,1.0,0,2,2,5,1,0,3,0,11,-10,1,CHA,NYK,CHA,91,16.5,Points,18,13,16,7
Terry Rozier,G,22023,1626179,22300057,"NOV 28, 2023",CHA @ NYK,L,33,5,16,0.313,0,3,0.0,1,1,1.0,0,2,2,5,1,0,3,0,11,-10,1,CHA,NYK,CHA,91,4.0,Rebounds,18,13,16,7
Terry Rozier,G,22023,1626179,22300057,"NOV 28, 2023",CHA @ NYK,L,33,5,16,0.313,0,3,0.0,1,1,1.0,0,2,2,5,1,0,3,0,11,-10,1,CHA,NYK,CHA,91,26.5,Pts+Rebs+Asts,18,13,16,7
Terry Rozier,G,22023,1626179,22300057,"NOV 28, 2023",CHA @ NYK,L,33,5,16,0.313,0,3,0.0,1,1,1.0,0,2,2,5,1,0,3,0,11,-10,1,CHA,NYK,CHA,91,6.0,Assists,18,13,16,7
Terry Rozier,G,22023,1626179,22300057,"NOV 28, 2023",CHA @ NYK,L,33,5,16,0.313,0,3,0.0,1,1,1.0,0,2,2,5,1,0,3,0,11,-10,1,CHA,NYK,CHA,91,31.0,Fantasy Score,18,13,16,7
Terry Rozier,G,22023,1626179,22300057,"NOV 28, 2023",CHA @ NYK,L,33,5,16,0.313,0,3,0.0,1,1,1.0,0,2,2,5,1,0,3,0,11,-10,1,CHA,NYK,CHA,91,20.5,Pts+Rebs,18,13,16,7
Terry Rozier,G,22023,1626179,22300057,"NOV 28, 2023",CHA @ NYK,L,33,5,16,0.313,0,3,0.0,1,1,1.0,0,2,2,5,1,0,3,0,11,-10,1,CHA,NYK,CHA,91,22.5,Pts+Asts,18,13,16,7
Terry Rozier,G,22023,1626179,22300057,"NOV 28, 2023",CHA @ NYK,L,33,5,16,0.313,0,3,0.0,1,1,1.0,0,2,2,5,1,0,3,0,11,-10,1,CHA,NYK,CHA,91,10.0,Rebs+Asts,18,13,16,7
Terry Rozier,G,22023,1626179,22300506,"JAN 08, 2024",CHA vs. CHI,L,44,10,18,0.556,7,13,0.538,12,12,1.0,0,3,3,8,0,0,0,2,39,-9,1,CHA,CHA,CHI,109,16.5,Points,50,42,47,11
Terry Rozier,G,22023,1626179,22300506,"JAN 08, 2024",CHA vs. CHI,L,44,10,18,0.556,7,13,0.538,12,12,1.0,0,3,3,8,0,0,0,2,39,-9,1,CHA,CHA,CHI,109,4.0,Rebounds,50,42,47,11
Terry Rozier,G,22023,1626179,22300506,"JAN 08, 2024",CHA vs. CHI,L,44,10,18,0.556,7,13,0.538,12,12,1.0,0,3,3,8,0,0,0,2,39,-9,1,CHA,CHA,CHI,109,26.5,Pts+Rebs+Asts,50,42,47,11
Terry Rozier,G,22023,1626179,22300506,"JAN 08, 2024",CHA vs. CHI,L,44,10,18,0.556,7,13,0.538,12,12,1.0,0,3,3,8,0,0,0,2,39,-9,1,CHA,CHA,CHI,109,6.0,Assists,50,42,47,11
Terry Rozier,G,22023,1626179,22300506,"JAN 08, 2024",CHA vs. CHI,L,44,10,18,0.556,7,13,0.538,12,12,1.0,0,3,3,8,0,0,0,2,39,-9,1,CHA,CHA,CHI,109,31.0,Fantasy Score,50,42,47,11
Terry Rozier,G,22023,1626179,22300506,"JAN 08, 2024",CHA vs. CHI,L,44,10,18,0.556,7,13,0.538,12,12,1.0,0,3,3,8,0,0,0,2,39,-9,1,CHA,CHA,CHI,109,20.5,Pts+Rebs,50,42,47,11
Terry Rozier,G,22023,1626179,22300506,"JAN 08, 2024",CHA vs. CHI,L,44,10,18,0.556,7,13,0.538,12,12,1.0,0,3,3,8,0,0,0,2,39,-9,1,CHA,CHA,CHI,109,22.5,Pts+Asts,50,42,47,11
Terry Rozier,G,22023,1626179,22300506,"JAN 08, 2024",CHA vs. CHI,L,44,10,18,0.556,7,13,0.538,12,12,1.0,0,3,3,8,0,0,0,2,39,-9,1,CHA,CHA,CHI,109,10.0,Rebs+Asts,50,42,47,11
Terry Rozier,G,22023,1626179,22300428,"DEC 28, 2023",CHA @ LAL,L,32,5,14,0.357,1,3,0.333,7,9,0.778,0,6,6,8,1,0,4,0,18,-32,1,CHA,LAL,CHA,110,16.5,Points,32,24,26,14
Terry Rozier,G,22023,1626179,22300428,"DEC 28, 2023",CHA @ LAL,L,32,5,14,0.357,1,3,0.333,7,9,0.778,0,6,6,8,1,0,4,0,18,-32,1,CHA,LAL,CHA,110,4.0,Rebounds,32,24,26,14
Terry Rozier,G,22023,1626179,22300428,"DEC 28, 2023",CHA @ LAL,L,32,5,14,0.357,1,3,0.333,7,9,0.778,0,6,6,8,1,0,4,0,18,-32,1,CHA,LAL,CHA,110,26.5,Pts+Rebs+Asts,32,24,26,14
Terry Rozier,G,22023,1626179,22300428,"DEC 28, 2023",CHA @ LAL,L,32,5,14,0.357,1,3,0.333,7,9,0.778,0,6,6,8,1,0,4,0,18,-32,1,CHA,LAL,CHA,110,6.0,Assists,32,24,26,14
Terry Rozier,G,22023,1626179,22300428,"DEC 28, 2023",CHA @ LAL,L,32,5,14,0.357,1,3,0.333,7,9,0.778,0,6,6,8,1,0,4,0,18,-32,1,CHA,LAL,CHA,110,31.0,Fantasy Score,32,24,26,14
Terry Rozier,G,22023,1626179,22300428,"DEC 28, 2023",CHA @ LAL,L,32,5,14,0.357,1,3,0.333,7,9,0.778,0,6,6,8,1,0,4,0,18,-32,1,CHA,LAL,CHA,110,20.5,Pts+Rebs,32,24,26,14
Terry Rozier,G,22023,1626179,22300428,"DEC 28, 2023",CHA @ LAL,L,32,5,14,0.357,1,3,0.333,7,9,0.778,0,6,6,8,1,0,4,0,18,-32,1,CHA,LAL,CHA,110,22.5,Pts+Asts,32,24,26,14
Terry Rozier,G,22023,1626179,22300428,"DEC 28, 2023",CHA @ LAL,L,32,5,14,0.357,1,3,0.333,7,9,0.778,0,6,6,8,1,0,4,0,18,-32,1,CHA,LAL,CHA,110,10.0,Rebs+Asts,32,24,26,14
Terry Rozier,G,22023,1626179,22300593,"JAN 20, 2024",CHA vs. PHI,L,36,9,18,0.5,0,5,0.0,1,5,0.2,0,9,9,6,1,0,3,2,19,-10,1,CHA,CHA,PHI,89,16.5,Points,34,28,25,15
Terry Rozier,G,22023,1626179,22300593,"JAN 20, 2024",CHA vs. PHI,L,36,9,18,0.5,0,5,0.0,1,5,0.2,0,9,9,6,1,0,3,2,19,-10,1,CHA,CHA,PHI,89,4.0,Rebounds,34,28,25,15
Terry Rozier,G,22023,1626179,22300593,"JAN 20, 2024",CHA vs. PHI,L,36,9,18,0.5,0,5,0.0,1,5,0.2,0,9,9,6,1,0,3,2,19,-10,1,CHA,CHA,PHI,89,26.5,Pts+Rebs+Asts,34,28,25,15
Terry Rozier,G,22023,1626179,22300593,"JAN 20, 2024",CHA vs. PHI,L,36,9,18,0.5,0,5,0.0,1,5,0.2,0,9,9,6,1,0,3,2,19,-10,1,CHA,CHA,PHI,89,6.0,Assists,34,28,25,15
Terry Rozier,G,22023,1626179,22300593,"JAN 20, 2024",CHA vs. PHI,L,36,9,18,0.5,0,5,0.0,1,5,0.2,0,9,9,6,1,0,3,2,19,-10,1,CHA,CHA,PHI,89,31.0,Fantasy Score,34,28,25,15
Terry Rozier,G,22023,1626179,22300593,"JAN 20, 2024",CHA vs. PHI,L,36,9,18,0.5,0,5,0.0,1,5,0.2,0,9,9,6,1,0,3,2,19,-10,1,CHA,CHA,PHI,89,20.5,Pts+Rebs,34,28,25,15
Terry Rozier,G,22023,1626179,22300593,"JAN 20, 2024",CHA vs. PHI,L,36,9,18,0.5,0,5,0.0,1,5,0.2,0,9,9,6,1,0,3,2,19,-10,1,CHA,CHA,PHI,89,22.5,Pts+Asts,34,28,25,15
Terry Rozier,G,22023,1626179,22300593,"JAN 20, 2024",CHA vs. PHI,L,36,9,18,0.5,0,5,0.0,1,5,0.2,0,9,9,6,1,0,3,2,19,-10,1,CHA,CHA,PHI,89,10.0,Rebs+Asts,34,28,25,15
Terry Rozier,G,22023,1626179,22300484,"JAN 05, 2024",CHA @ CHI,L,36,5,17,0.294,1,7,0.143,4,4,1.0,1,3,4,7,1,0,3,2,15,-10,1,CHA,CHI,CHA,87,16.5,Points,26,19,22,11
Terry Rozier,G,22023,1626179,22300484,"JAN 05, 2024",CHA @ CHI,L,36,5,17,0.294,1,7,0.143,4,4,1.0,1,3,4,7,1,0,3,2,15,-10,1,CHA,CHI,CHA,87,4.0,Rebounds,26,19,22,11
Terry Rozier,G,22023,1626179,22300484,"JAN 05, 2024",CHA @ CHI,L,36,5,17,0.294,1,7,0.143,4,4,1.0,1,3,4,7,1,0,3,2,15,-10,1,CHA,CHI,CHA,87,26.5,Pts+Rebs+Asts,26,19,22,11
Terry Rozier,G,22023,1626179,22300484,"JAN 05, 2024",CHA @ CHI,L,36,5,17,0.294,1,7,0.143,4,4,1.0,1,3,4,7,1,0,3,2,15,-10,1,CHA,CHI,CHA,87,6.0,Assists,26,19,22,11
Terry Rozier,G,22023,1626179,22300484,"JAN 05, 2024",CHA @ CHI,L,36,5,17,0.294,1,7,0.143,4,4,1.0,1,3,4,7,1,0,3,2,15,-10,1,CHA,CHI,CHA,87,31.0,Fantasy Score,26,19,22,11
Terry Rozier,G,22023,1626179,22300484,"JAN 05, 2024",CHA @ CHI,L,36,5,17,0.294,1,7,0.143,4,4,1.0,1,3,4,7,1,0,3,2,15,-10,1,CHA,CHI,CHA,87,20.5,Pts+Rebs,26,19,22,11
Terry Rozier,G,22023,1626179,22300484,"JAN 05, 2024",CHA @ CHI,L,36,5,17,0.294,1,7,0.143,4,4,1.0,1,3,4,7,1,0,3,2,15,-10,1,CHA,CHI,CHA,87,22.5,Pts+Asts,26,19,22,11
Terry Rozier,G,22023,1626179,22300484,"JAN 05, 2024",CHA @ CHI,L,36,5,17,0.294,1,7,0.143,4,4,1.0,1,3,4,7,1,0,3,2,15,-10,1,CHA,CHI,CHA,87,10.0,Rebs+Asts,26,19,22,11
Terry Rozier,G,22023,1626179,22300464,"JAN 02, 2024",CHA @ SAC,W,36,13,24,0.542,3,11,0.273,5,6,0.833,0,3,3,6,1,2,2,3,34,-1,1,CHA,SAC,CHA,111,16.5,Points,43,37,40,9
Terry Rozier,G,22023,1626179,22300464,"JAN 02, 2024",CHA @ SAC,W,36,13,24,0.542,3,11,0.273,5,6,0.833,0,3,3,6,1,2,2,3,34,-1,1,CHA,SAC,CHA,111,4.0,Rebounds,43,37,40,9
Terry Rozier,G,22023,1626179,22300464,"JAN 02, 2024",CHA @ SAC,W,36,13,24,0.542,3,11,0.273,5,6,0.833,0,3,3,6,1,2,2,3,34,-1,1,CHA,SAC,CHA,111,26.5,Pts+Rebs+Asts,43,37,40,9
Terry Rozier,G,22023,1626179,22300464,"JAN 02, 2024",CHA @ SAC,W,36,13,24,0.542,3,11,0.273,5,6,0.833,0,3,3,6,1,2,2,3,34,-1,1,CHA,SAC,CHA,111,6.0,Assists,43,37,40,9
Terry Rozier,G,22023,1626179,22300464,"JAN 02, 2024",CHA @ SAC,W,36,13,24,0.542,3,11,0.273,5,6,0.833,0,3,3,6,1,2,2,3,34,-1,1,CHA,SAC,CHA,111,31.0,Fantasy Score,43,37,40,9
Terry Rozier,G,22023,1626179,22300464,"JAN 02, 2024",CHA @ SAC,W,36,13,24,0.542,3,11,0.273,5,6,0.833,0,3,3,6,1,2,2,3,34,-1,1,CHA,SAC,CHA,111,20.5,Pts+Rebs,43,37,40,9
Terry Rozier,G,22023,1626179,22300464,"JAN 02, 2024",CHA @ SAC,W,36,13,24,0.542,3,11,0.273,5,6,0.833,0,3,3,6,1,2,2,3,34,-1,1,CHA,SAC,CHA,111,22.5,Pts+Asts,43,37,40,9
Terry Rozier,G,22023,1626179,22300464,"JAN 02, 2024",CHA @ SAC,W,36,13,24,0.542,3,11,0.273,5,6,0.833,0,3,3,6,1,2,2,3,34,-1,1,CHA,SAC,CHA,111,10.0,Rebs+Asts,43,37,40,9
Terry Rozier,G,22023,1626179,22300436,"DEC 29, 2023",CHA @ PHX,L,39,14,22,0.636,8,12,0.667,6,6,1.0,1,3,4,8,1,0,0,0,42,-1,1,CHA,PHX,CHA,119,16.5,Points,54,46,50,12
Terry Rozier,G,22023,1626179,22300436,"DEC 29, 2023",CHA @ PHX,L,39,14,22,0.636,8,12,0.667,6,6,1.0,1,3,4,8,1,0,0,0,42,-1,1,CHA,PHX,CHA,119,4.0,Rebounds,54,46,50,12
Terry Rozier,G,22023,1626179,22300436,"DEC 29, 2023",CHA @ PHX,L,39,14,22,0.636,8,12,0.667,6,6,1.0,1,3,4,8,1,0,0,0,42,-1,1,CHA,PHX,CHA,119,26.5,Pts+Rebs+Asts,54,46,50,12
Terry Rozier,G,22023,1626179,22300436,"DEC 29, 2023",CHA @ PHX,L,39,14,22,0.636,8,12,0.667,6,6,1.0,1,3,4,8,1,0,0,0,42,-1,1,CHA,PHX,CHA,119,6.0,Assists,54,46,50,12
Terry Rozier,G,22023,1626179,22300436,"DEC 29, 2023",CHA @ PHX,L,39,14,22,0.636,8,12,0.667,6,6,1.0,1,3,4,8,1,0,0,0,42,-1,1,CHA,PHX,CHA,119,31.0,Fantasy Score,54,46,50,12
Terry Rozier,G,22023,1626179,22300436,"DEC 29, 2023",CHA @ PHX,L,39,14,22,0.636,8,12,0.667,6,6,1.0,1,3,4,8,1,0,0,0,42,-1,1,CHA,PHX,CHA,119,20.5,Pts+Rebs,54,46,50,12
Terry Rozier,G,22023,1626179,22300436,"DEC 29, 2023",CHA @ PHX,L,39,14,22,0.636,8,12,0.667,6,6,1.0,1,3,4,8,1,0,0,0,42,-1,1,CHA,PHX,CHA,119,22.5,Pts+Asts,54,46,50,12
Terry Rozier,G,22023,1626179,22300436,"DEC 29, 2023",CHA @ PHX,L,39,14,22,0.636,8,12,0.667,6,6,1.0,1,3,4,8,1,0,0,0,42,-1,1,CHA,PHX,CHA,119,10.0,Rebs+Asts,54,46,50,12
Terry Rozier,G,22023,1626179,22300414,"DEC 26, 2023",CHA @ LAC,L,39,8,23,0.348,1,8,0.125,1,3,0.333,0,4,4,7,1,0,4,2,18,0,1,CHA,LAC,CHA,104,16.5,Points,29,22,25,11
Terry Rozier,G,22023,1626179,22300414,"DEC 26, 2023",CHA @ LAC,L,39,8,23,0.348,1,8,0.125,1,3,0.333,0,4,4,7,1,0,4,2,18,0,1,CHA,LAC,CHA,104,4.0,Rebounds,29,22,25,11
Terry Rozier,G,22023,1626179,22300414,"DEC 26, 2023",CHA @ LAC,L,39,8,23,0.348,1,8,0.125,1,3,0.333,0,4,4,7,1,0,4,2,18,0,1,CHA,LAC,CHA,104,26.5,Pts+Rebs+Asts,29,22,25,11
Terry Rozier,G,22023,1626179,22300414,"DEC 26, 2023",CHA @ LAC,L,39,8,23,0.348,1,8,0.125,1,3,0.333,0,4,4,7,1,0,4,2,18,0,1,CHA,LAC,CHA,104,6.0,Assists,29,22,25,11
Terry Rozier,G,22023,1626179,22300414,"DEC 26, 2023",CHA @ LAC,L,39,8,23,0.348,1,8,0.125,1,3,0.333,0,4,4,7,1,0,4,2,18,0,1,CHA,LAC,CHA,104,31.0,Fantasy Score,29,22,25,11
Terry Rozier,G,22023,1626179,22300414,"DEC 26, 2023",CHA @ LAC,L,39,8,23,0.348,1,8,0.125,1,3,0.333,0,4,4,7,1,0,4,2,18,0,1,CHA,LAC,CHA,104,20.5,Pts+Rebs,29,22,25,11
Terry Rozier,G,22023,1626179,22300414,"DEC 26, 2023",CHA @ LAC,L,39,8,23,0.348,1,8,0.125,1,3,0.333,0,4,4,7,1,0,4,2,18,0,1,CHA,LAC,CHA,104,22.5,Pts+Asts,29,22,25,11
Terry Rozier,G,22023,1626179,22300414,"DEC 26, 2023",CHA @ LAC,L,39,8,23,0.348,1,8,0.125,1,3,0.333,0,4,4,7,1,0,4,2,18,0,1,CHA,LAC,CHA,104,10.0,Rebs+Asts,29,22,25,11
Terry Rozier,G,22023,1626179,22300326,"DEC 15, 2023",CHA vs. NOP,L,39,11,25,0.44,4,11,0.364,4,4,1.0,0,4,4,6,3,0,2,0,30,-10,1,CHA,CHA,NOP,105,16.5,Points,40,34,36,10
Terry Rozier,G,22023,1626179,22300326,"DEC 15, 2023",CHA vs. NOP,L,39,11,25,0.44,4,11,0.364,4,4,1.0,0,4,4,6,3,0,2,0,30,-10,1,CHA,CHA,NOP,105,4.0,Rebounds,40,34,36,10
Terry Rozier,G,22023,1626179,22300326,"DEC 15, 2023",CHA vs. NOP,L,39,11,25,0.44,4,11,0.364,4,4,1.0,0,4,4,6,3,0,2,0,30,-10,1,CHA,CHA,NOP,105,26.5,Pts+Rebs+Asts,40,34,36,10
Terry Rozier,G,22023,1626179,22300326,"DEC 15, 2023",CHA vs. NOP,L,39,11,25,0.44,4,11,0.364,4,4,1.0,0,4,4,6,3,0,2,0,30,-10,1,CHA,CHA,NOP,105,6.0,Assists,40,34,36,10
Terry Rozier,G,22023,1626179,22300326,"DEC 15, 2023",CHA vs. NOP,L,39,11,25,0.44,4,11,0.364,4,4,1.0,0,4,4,6,3,0,2,0,30,-10,1,CHA,CHA,NOP,105,31.0,Fantasy Score,40,34,36,10
Terry Rozier,G,22023,1626179,22300326,"DEC 15, 2023",CHA vs. NOP,L,39,11,25,0.44,4,11,0.364,4,4,1.0,0,4,4,6,3,0,2,0,30,-10,1,CHA,CHA,NOP,105,20.5,Pts+Rebs,40,34,36,10
Terry Rozier,G,22023,1626179,22300326,"DEC 15, 2023",CHA vs. NOP,L,39,11,25,0.44,4,11,0.364,4,4,1.0,0,4,4,6,3,0,2,0,30,-10,1,CHA,CHA,NOP,105,22.5,Pts+Asts,40,34,36,10
Terry Rozier,G,22023,1626179,22300326,"DEC 15, 2023",CHA vs. NOP,L,39,11,25,0.44,4,11,0.364,4,4,1.0,0,4,4,6,3,0,2,0,30,-10,1,CHA,CHA,NOP,105,10.0,Rebs+Asts,40,34,36,10
Terry Rozier,G,22023,1626179,22300312,"DEC 13, 2023",CHA @ MIA,L,37,10,14,0.714,5,6,0.833,3,3,1.0,0,3,3,7,4,1,1,2,28,-15,1,CHA,MIA,CHA,104,16.5,Points,38,31,35,10
Terry Rozier,G,22023,1626179,22300312,"DEC 13, 2023",CHA @ MIA,L,37,10,14,0.714,5,6,0.833,3,3,1.0,0,3,3,7,4,1,1,2,28,-15,1,CHA,MIA,CHA,104,4.0,Rebounds,38,31,35,10
Terry Rozier,G,22023,1626179,22300312,"DEC 13, 2023",CHA @ MIA,L,37,10,14,0.714,5,6,0.833,3,3,1.0,0,3,3,7,4,1,1,2,28,-15,1,CHA,MIA,CHA,104,26.5,Pts+Rebs+Asts,38,31,35,10
Terry Rozier,G,22023,1626179,22300312,"DEC 13, 2023",CHA @ MIA,L,37,10,14,0.714,5,6,0.833,3,3,1.0,0,3,3,7,4,1,1,2,28,-15,1,CHA,MIA,CHA,104,6.0,Assists,38,31,35,10
Terry Rozier,G,22023,1626179,22300312,"DEC 13, 2023",CHA @ MIA,L,37,10,14,0.714,5,6,0.833,3,3,1.0,0,3,3,7,4,1,1,2,28,-15,1,CHA,MIA,CHA,104,31.0,Fantasy Score,38,31,35,10
Terry Rozier,G,22023,1626179,22300312,"DEC 13, 2023",CHA @ MIA,L,37,10,14,0.714,5,6,0.833,3,3,1.0,0,3,3,7,4,1,1,2,28,-15,1,CHA,MIA,CHA,104,20.5,Pts+Rebs,38,31,35,10
Terry Rozier,G,22023,1626179,22300312,"DEC 13, 2023",CHA @ MIA,L,37,10,14,0.714,5,6,0.833,3,3,1.0,0,3,3,7,4,1,1,2,28,-15,1,CHA,MIA,CHA,104,22.5,Pts+Asts,38,31,35,10
Terry Rozier,G,22023,1626179,22300312,"DEC 13, 2023",CHA @ MIA,L,37,10,14,0.714,5,6,0.833,3,3,1.0,0,3,3,7,4,1,1,2,28,-15,1,CHA,MIA,CHA,104,10.0,Rebs+Asts,38,31,35,10
Terry Rozier,G,22023,1626179,22300292,"DEC 11, 2023",CHA vs. MIA,L,39,10,17,0.588,8,13,0.615,6,7,0.857,1,1,2,13,0,0,3,4,34,4,1,CHA,CHA,MIA,114,16.5,Points,49,36,47,15
Terry Rozier,G,22023,1626179,22300292,"DEC 11, 2023",CHA vs. MIA,L,39,10,17,0.588,8,13,0.615,6,7,0.857,1,1,2,13,0,0,3,4,34,4,1,CHA,CHA,MIA,114,4.0,Rebounds,49,36,47,15
Terry Rozier,G,22023,1626179,22300292,"DEC 11, 2023",CHA vs. MIA,L,39,10,17,0.588,8,13,0.615,6,7,0.857,1,1,2,13,0,0,3,4,34,4,1,CHA,CHA,MIA,114,26.5,Pts+Rebs+Asts,49,36,47,15
Terry Rozier,G,22023,1626179,22300292,"DEC 11, 2023",CHA vs. MIA,L,39,10,17,0.588,8,13,0.615,6,7,0.857,1,1,2,13,0,0,3,4,34,4,1,CHA,CHA,MIA,114,6.0,Assists,49,36,47,15
Terry Rozier,G,22023,1626179,22300292,"DEC 11, 2023",CHA vs. MIA,L,39,10,17,0.588,8,13,0.615,6,7,0.857,1,1,2,13,0,0,3,4,34,4,1,CHA,CHA,MIA,114,31.0,Fantasy Score,49,36,47,15
Terry Rozier,G,22023,1626179,22300292,"DEC 11, 2023",CHA vs. MIA,L,39,10,17,0.588,8,13,0.615,6,7,0.857,1,1,2,13,0,0,3,4,34,4,1,CHA,CHA,MIA,114,20.5,Pts+Rebs,49,36,47,15
Terry Rozier,G,22023,1626179,22300292,"DEC 11, 2023",CHA vs. MIA,L,39,10,17,0.588,8,13,0.615,6,7,0.857,1,1,2,13,0,0,3,4,34,4,1,CHA,CHA,MIA,114,22.5,Pts+Asts,49,36,47,15
Terry Rozier,G,22023,1626179,22300292,"DEC 11, 2023",CHA vs. MIA,L,39,10,17,0.588,8,13,0.615,6,7,0.857,1,1,2,13,0,0,3,4,34,4,1,CHA,CHA,MIA,114,10.0,Rebs+Asts,49,36,47,15
Terry Rozier,G,22023,1626179,22301216,"DEC 08, 2023",CHA vs. TOR,W,40,7,15,0.467,2,5,0.4,5,5,1.0,0,2,2,13,0,0,2,5,21,5,1,CHA,CHA,TOR,119,16.5,Points,36,23,34,15
Terry Rozier,G,22023,1626179,22301216,"DEC 08, 2023",CHA vs. TOR,W,40,7,15,0.467,2,5,0.4,5,5,1.0,0,2,2,13,0,0,2,5,21,5,1,CHA,CHA,TOR,119,4.0,Rebounds,36,23,34,15
Terry Rozier,G,22023,1626179,22301216,"DEC 08, 2023",CHA vs. TOR,W,40,7,15,0.467,2,5,0.4,5,5,1.0,0,2,2,13,0,0,2,5,21,5,1,CHA,CHA,TOR,119,26.5,Pts+Rebs+Asts,36,23,34,15
Terry Rozier,G,22023,1626179,22301216,"DEC 08, 2023",CHA vs. TOR,W,40,7,15,0.467,2,5,0.4,5,5,1.0,0,2,2,13,0,0,2,5,21,5,1,CHA,CHA,TOR,119,6.0,Assists,36,23,34,15
Terry Rozier,G,22023,1626179,22301216,"DEC 08, 2023",CHA vs. TOR,W,40,7,15,0.467,2,5,0.4,5,5,1.0,0,2,2,13,0,0,2,5,21,5,1,CHA,CHA,TOR,119,31.0,Fantasy Score,36,23,34,15
Terry Rozier,G,22023,1626179,22301216,"DEC 08, 2023",CHA vs. TOR,W,40,7,15,0.467,2,5,0.4,5,5,1.0,0,2,2,13,0,0,2,5,21,5,1,CHA,CHA,TOR,119,20.5,Pts+Rebs,36,23,34,15
Terry Rozier,G,22023,1626179,22301216,"DEC 08, 2023",CHA vs. TOR,W,40,7,15,0.467,2,5,0.4,5,5,1.0,0,2,2,13,0,0,2,5,21,5,1,CHA,CHA,TOR,119,22.5,Pts+Asts,36,23,34,15
Terry Rozier,G,22023,1626179,22301216,"DEC 08, 2023",CHA vs. TOR,W,40,7,15,0.467,2,5,0.4,5,5,1.0,0,2,2,13,0,0,2,5,21,5,1,CHA,CHA,TOR,119,10.0,Rebs+Asts,36,23,34,15
Terry Rozier,G,22023,1626179,22301211,"DEC 06, 2023",CHA @ CHI,L,40,10,24,0.417,1,11,0.091,4,4,1.0,1,4,5,7,1,2,2,4,25,-11,1,CHA,CHI,CHA,100,16.5,Points,37,30,32,12
Terry Rozier,G,22023,1626179,22301211,"DEC 06, 2023",CHA @ CHI,L,40,10,24,0.417,1,11,0.091,4,4,1.0,1,4,5,7,1,2,2,4,25,-11,1,CHA,CHI,CHA,100,4.0,Rebounds,37,30,32,12
Terry Rozier,G,22023,1626179,22301211,"DEC 06, 2023",CHA @ CHI,L,40,10,24,0.417,1,11,0.091,4,4,1.0,1,4,5,7,1,2,2,4,25,-11,1,CHA,CHI,CHA,100,26.5,Pts+Rebs+Asts,37,30,32,12
Terry Rozier,G,22023,1626179,22301211,"DEC 06, 2023",CHA @ CHI,L,40,10,24,0.417,1,11,0.091,4,4,1.0,1,4,5,7,1,2,2,4,25,-11,1,CHA,CHI,CHA,100,6.0,Assists,37,30,32,12
Terry Rozier,G,22023,1626179,22301211,"DEC 06, 2023",CHA @ CHI,L,40,10,24,0.417,1,11,0.091,4,4,1.0,1,4,5,7,1,2,2,4,25,-11,1,CHA,CHI,CHA,100,31.0,Fantasy Score,37,30,32,12
Terry Rozier,G,22023,1626179,22301211,"DEC 06, 2023",CHA @ CHI,L,40,10,24,0.417,1,11,0.091,4,4,1.0,1,4,5,7,1,2,2,4,25,-11,1,CHA,CHI,CHA,100,20.5,Pts+Rebs,37,30,32,12
Terry Rozier,G,22023,1626179,22301211,"DEC 06, 2023",CHA @ CHI,L,40,10,24,0.417,1,11,0.091,4,4,1.0,1,4,5,7,1,2,2,4,25,-11,1,CHA,CHI,CHA,100,22.5,Pts+Asts,37,30,32,12
Terry Rozier,G,22023,1626179,22301211,"DEC 06, 2023",CHA @ CHI,L,40,10,24,0.417,1,11,0.091,4,4,1.0,1,4,5,7,1,2,2,4,25,-11,1,CHA,CHI,CHA,100,10.0,Rebs+Asts,37,30,32,12
Terry Rozier,G,22023,1626179,22300281,"DEC 02, 2023",CHA vs. MIN,L,35,8,20,0.4,3,7,0.429,4,5,0.8,1,5,6,7,2,0,1,4,23,-6,1,CHA,CHA,MIN,117,16.5,Points,36,29,30,13
Terry Rozier,G,22023,1626179,22300281,"DEC 02, 2023",CHA vs. MIN,L,35,8,20,0.4,3,7,0.429,4,5,0.8,1,5,6,7,2,0,1,4,23,-6,1,CHA,CHA,MIN,117,4.0,Rebounds,36,29,30,13
Terry Rozier,G,22023,1626179,22300281,"DEC 02, 2023",CHA vs. MIN,L,35,8,20,0.4,3,7,0.429,4,5,0.8,1,5,6,7,2,0,1,4,23,-6,1,CHA,CHA,MIN,117,26.5,Pts+Rebs+Asts,36,29,30,13
Terry Rozier,G,22023,1626179,22300281,"DEC 02, 2023",CHA vs. MIN,L,35,8,20,0.4,3,7,0.429,4,5,0.8,1,5,6,7,2,0,1,4,23,-6,1,CHA,CHA,MIN,117,6.0,Assists,36,29,30,13
Terry Rozier,G,22023,1626179,22300281,"DEC 02, 2023",CHA vs. MIN,L,35,8,20,0.4,3,7,0.429,4,5,0.8,1,5,6,7,2,0,1,4,23,-6,1,CHA,CHA,MIN,117,31.0,Fantasy Score,36,29,30,13
Terry Rozier,G,22023,1626179,22300281,"DEC 02, 2023",CHA vs. MIN,L,35,8,20,0.4,3,7,0.429,4,5,0.8,1,5,6,7,2,0,1,4,23,-6,1,CHA,CHA,MIN,117,20.5,Pts+Rebs,36,29,30,13
Terry Rozier,G,22023,1626179,22300281,"DEC 02, 2023",CHA vs. MIN,L,35,8,20,0.4,3,7,0.429,4,5,0.8,1,5,6,7,2,0,1,4,23,-6,1,CHA,CHA,MIN,117,22.5,Pts+Asts,36,29,30,13
Terry Rozier,G,22023,1626179,22300281,"DEC 02, 2023",CHA vs. MIN,L,35,8,20,0.4,3,7,0.429,4,5,0.8,1,5,6,7,2,0,1,4,23,-6,1,CHA,CHA,MIN,117,10.0,Rebs+Asts,36,29,30,13
Terry Rozier,G,22023,1626179,22300266,"NOV 30, 2023",CHA @ BKN,W,40,13,25,0.52,7,9,0.778,4,4,1.0,0,4,4,13,2,0,3,1,37,2,1,CHA,BKN,CHA,129,16.5,Points,54,41,50,17
Terry Rozier,G,22023,1626179,22300266,"NOV 30, 2023",CHA @ BKN,W,40,13,25,0.52,7,9,0.778,4,4,1.0,0,4,4,13,2,0,3,1,37,2,1,CHA,BKN,CHA,129,4.0,Rebounds,54,41,50,17
Terry Rozier,G,22023,1626179,22300266,"NOV 30, 2023",CHA @ BKN,W,40,13,25,0.52,7,9,0.778,4,4,1.0,0,4,4,13,2,0,3,1,37,2,1,CHA,BKN,CHA,129,26.5,Pts+Rebs+Asts,54,41,50,17
Terry Rozier,G,22023,1626179,22300266,"NOV 30, 2023",CHA @ BKN,W,40,13,25,0.52,7,9,0.778,4,4,1.0,0,4,4,13,2,0,3,1,37,2,1,CHA,BKN,CHA,129,6.0,Assists,54,41,50,17
Terry Rozier,G,22023,1626179,22300266,"NOV 30, 2023",CHA @ BKN,W,40,13,25,0.52,7,9,0.778,4,4,1.0,0,4,4,13,2,0,3,1,37,2,1,CHA,BKN,CHA,129,31.0,Fantasy Score,54,41,50,17
Terry Rozier,G,22023,1626179,22300266,"NOV 30, 2023",CHA @ BKN,W,40,13,25,0.52,7,9,0.778,4,4,1.0,0,4,4,13,2,0,3,1,37,2,1,CHA,BKN,CHA,129,20.5,Pts+Rebs,54,41,50,17
Terry Rozier,G,22023,1626179,22300266,"NOV 30, 2023",CHA @ BKN,W,40,13,25,0.52,7,9,0.778,4,4,1.0,0,4,4,13,2,0,3,1,37,2,1,CHA,BKN,CHA,129,22.5,Pts+Asts,54,41,50,17
Terry Rozier,G,22023,1626179,22300266,"NOV 30, 2023",CHA @ BKN,W,40,13,25,0.52,7,9,0.778,4,4,1.0,0,4,4,13,2,0,3,1,37,2,1,CHA,BKN,CHA,129,10.0,Rebs+Asts,54,41,50,17
Terry Rozier,G,22023,1626179,22300730,"FEB 07, 2024",MIA vs. SAS,W,28,5,15,0.333,2,7,0.286,1,1,1.0,1,1,2,5,0,0,1,3,13,16,1,MIA,MIA,SAS,116,16.5,Points,20,15,18,7
Terry Rozier,G,22023,1626179,22300730,"FEB 07, 2024",MIA vs. SAS,W,28,5,15,0.333,2,7,0.286,1,1,1.0,1,1,2,5,0,0,1,3,13,16,1,MIA,MIA,SAS,116,4.0,Rebounds,20,15,18,7
Terry Rozier,G,22023,1626179,22300730,"FEB 07, 2024",MIA vs. SAS,W,28,5,15,0.333,2,7,0.286,1,1,1.0,1,1,2,5,0,0,1,3,13,16,1,MIA,MIA,SAS,116,26.5,Pts+Rebs+Asts,20,15,18,7
Terry Rozier,G,22023,1626179,22300730,"FEB 07, 2024",MIA vs. SAS,W,28,5,15,0.333,2,7,0.286,1,1,1.0,1,1,2,5,0,0,1,3,13,16,1,MIA,MIA,SAS,116,6.0,Assists,20,15,18,7
Terry Rozier,G,22023,1626179,22300730,"FEB 07, 2024",MIA vs. SAS,W,28,5,15,0.333,2,7,0.286,1,1,1.0,1,1,2,5,0,0,1,3,13,16,1,MIA,MIA,SAS,116,31.0,Fantasy Score,20,15,18,7
Terry Rozier,G,22023,1626179,22300730,"FEB 07, 2024",MIA vs. SAS,W,28,5,15,0.333,2,7,0.286,1,1,1.0,1,1,2,5,0,0,1,3,13,16,1,MIA,MIA,SAS,116,20.5,Pts+Rebs,20,15,18,7
Terry Rozier,G,22023,1626179,22300730,"FEB 07, 2024",MIA vs. SAS,W,28,5,15,0.333,2,7,0.286,1,1,1.0,1,1,2,5,0,0,1,3,13,16,1,MIA,MIA,SAS,116,22.5,Pts+Asts,20,15,18,7
Terry Rozier,G,22023,1626179,22300730,"FEB 07, 2024",MIA vs. SAS,W,28,5,15,0.333,2,7,0.286,1,1,1.0,1,1,2,5,0,0,1,3,13,16,1,MIA,MIA,SAS,116,10.0,Rebs+Asts,20,15,18,7
Terry Rozier,G,22023,1626179,22300721,"FEB 06, 2024",MIA vs. ORL,W,31,7,12,0.583,2,4,0.5,2,3,0.667,1,5,6,7,1,0,1,1,18,21,1,MIA,MIA,ORL,121,16.5,Points,31,24,25,13
Terry Rozier,G,22023,1626179,22300721,"FEB 06, 2024",MIA vs. ORL,W,31,7,12,0.583,2,4,0.5,2,3,0.667,1,5,6,7,1,0,1,1,18,21,1,MIA,MIA,ORL,121,4.0,Rebounds,31,24,25,13
Terry Rozier,G,22023,1626179,22300721,"FEB 06, 2024",MIA vs. ORL,W,31,7,12,0.583,2,4,0.5,2,3,0.667,1,5,6,7,1,0,1,1,18,21,1,MIA,MIA,ORL,121,26.5,Pts+Rebs+Asts,31,24,25,13
Terry Rozier,G,22023,1626179,22300721,"FEB 06, 2024",MIA vs. ORL,W,31,7,12,0.583,2,4,0.5,2,3,0.667,1,5,6,7,1,0,1,1,18,21,1,MIA,MIA,ORL,121,6.0,Assists,31,24,25,13
Terry Rozier,G,22023,1626179,22300721,"FEB 06, 2024",MIA vs. ORL,W,31,7,12,0.583,2,4,0.5,2,3,0.667,1,5,6,7,1,0,1,1,18,21,1,MIA,MIA,ORL,121,31.0,Fantasy Score,31,24,25,13
Terry Rozier,G,22023,1626179,22300721,"FEB 06, 2024",MIA vs. ORL,W,31,7,12,0.583,2,4,0.5,2,3,0.667,1,5,6,7,1,0,1,1,18,21,1,MIA,MIA,ORL,121,20.5,Pts+Rebs,31,24,25,13
Terry Rozier,G,22023,1626179,22300721,"FEB 06, 2024",MIA vs. ORL,W,31,7,12,0.583,2,4,0.5,2,3,0.667,1,5,6,7,1,0,1,1,18,21,1,MIA,MIA,ORL,121,22.5,Pts+Asts,31,24,25,13
Terry Rozier,G,22023,1626179,22300721,"FEB 06, 2024",MIA vs. ORL,W,31,7,12,0.583,2,4,0.5,2,3,0.667,1,5,6,7,1,0,1,1,18,21,1,MIA,MIA,ORL,121,10.0,Rebs+Asts,31,24,25,13
Terry Rozier,G,22023,1626179,22300708,"FEB 04, 2024",MIA vs. LAC,L,38,7,17,0.412,0,5,0.0,3,3,1.0,1,6,7,5,2,0,2,4,17,-4,1,MIA,MIA,LAC,95,16.5,Points,29,24,22,12
Terry Rozier,G,22023,1626179,22300708,"FEB 04, 2024",MIA vs. LAC,L,38,7,17,0.412,0,5,0.0,3,3,1.0,1,6,7,5,2,0,2,4,17,-4,1,MIA,MIA,LAC,95,4.0,Rebounds,29,24,22,12
Terry Rozier,G,22023,1626179,22300708,"FEB 04, 2024",MIA vs. LAC,L,38,7,17,0.412,0,5,0.0,3,3,1.0,1,6,7,5,2,0,2,4,17,-4,1,MIA,MIA,LAC,95,26.5,Pts+Rebs+Asts,29,24,22,12
Terry Rozier,G,22023,1626179,22300708,"FEB 04, 2024",MIA vs. LAC,L,38,7,17,0.412,0,5,0.0,3,3,1.0,1,6,7,5,2,0,2,4,17,-4,1,MIA,MIA,LAC,95,6.0,Assists,29,24,22,12
Terry Rozier,G,22023,1626179,22300708,"FEB 04, 2024",MIA vs. LAC,L,38,7,17,0.412,0,5,0.0,3,3,1.0,1,6,7,5,2,0,2,4,17,-4,1,MIA,MIA,LAC,95,31.0,Fantasy Score,29,24,22,12
Terry Rozier,G,22023,1626179,22300708,"FEB 04, 2024",MIA vs. LAC,L,38,7,17,0.412,0,5,0.0,3,3,1.0,1,6,7,5,2,0,2,4,17,-4,1,MIA,MIA,LAC,95,20.5,Pts+Rebs,29,24,22,12
Terry Rozier,G,22023,1626179,22300708,"FEB 04, 2024",MIA vs. LAC,L,38,7,17,0.412,0,5,0.0,3,3,1.0,1,6,7,5,2,0,2,4,17,-4,1,MIA,MIA,LAC,95,22.5,Pts+Asts,29,24,22,12
Terry Rozier,G,22023,1626179,22300708,"FEB 04, 2024",MIA vs. LAC,L,38,7,17,0.412,0,5,0.0,3,3,1.0,1,6,7,5,2,0,2,4,17,-4,1,MIA,MIA,LAC,95,10.0,Rebs+Asts,29,24,22,12
Terry Rozier,G,22023,1626179,22300689,"FEB 02, 2024",MIA @ WAS,W,30,2,13,0.154,0,6,0.0,11,11,1.0,2,6,8,5,0,0,0,3,15,15,1,MIA,WAS,MIA,110,16.5,Points,28,23,20,13
Terry Rozier,G,22023,1626179,22300689,"FEB 02, 2024",MIA @ WAS,W,30,2,13,0.154,0,6,0.0,11,11,1.0,2,6,8,5,0,0,0,3,15,15,1,MIA,WAS,MIA,110,4.0,Rebounds,28,23,20,13
Terry Rozier,G,22023,1626179,22300689,"FEB 02, 2024",MIA @ WAS,W,30,2,13,0.154,0,6,0.0,11,11,1.0,2,6,8,5,0,0,0,3,15,15,1,MIA,WAS,MIA,110,26.5,Pts+Rebs+Asts,28,23,20,13
Terry Rozier,G,22023,1626179,22300689,"FEB 02, 2024",MIA @ WAS,W,30,2,13,0.154,0,6,0.0,11,11,1.0,2,6,8,5,0,0,0,3,15,15,1,MIA,WAS,MIA,110,6.0,Assists,28,23,20,13
Terry Rozier,G,22023,1626179,22300689,"FEB 02, 2024",MIA @ WAS,W,30,2,13,0.154,0,6,0.0,11,11,1.0,2,6,8,5,0,0,0,3,15,15,1,MIA,WAS,MIA,110,31.0,Fantasy Score,28,23,20,13
Terry Rozier,G,22023,1626179,22300689,"FEB 02, 2024",MIA @ WAS,W,30,2,13,0.154,0,6,0.0,11,11,1.0,2,6,8,5,0,0,0,3,15,15,1,MIA,WAS,MIA,110,20.5,Pts+Rebs,28,23,20,13
Terry Rozier,G,22023,1626179,22300689,"FEB 02, 2024",MIA @ WAS,W,30,2,13,0.154,0,6,0.0,11,11,1.0,2,6,8,5,0,0,0,3,15,15,1,MIA,WAS,MIA,110,22.5,Pts+Asts,28,23,20,13
Terry Rozier,G,22023,1626179,22300689,"FEB 02, 2024",MIA @ WAS,W,30,2,13,0.154,0,6,0.0,11,11,1.0,2,6,8,5,0,0,0,3,15,15,1,MIA,WAS,MIA,110,10.0,Rebs+Asts,28,23,20,13
Terry Rozier,G,22023,1626179,22300678,"JAN 31, 2024",MIA vs. SAC,W,30,1,8,0.125,1,4,0.25,0,0,0.0,1,4,5,10,2,1,1,1,3,1,1,MIA,MIA,SAC,115,16.5,Points,18,8,13,15
Terry Rozier,G,22023,1626179,22300678,"JAN 31, 2024",MIA vs. SAC,W,30,1,8,0.125,1,4,0.25,0,0,0.0,1,4,5,10,2,1,1,1,3,1,1,MIA,MIA,SAC,115,4.0,Rebounds,18,8,13,15
Terry Rozier,G,22023,1626179,22300678,"JAN 31, 2024",MIA vs. SAC,W,30,1,8,0.125,1,4,0.25,0,0,0.0,1,4,5,10,2,1,1,1,3,1,1,MIA,MIA,SAC,115,26.5,Pts+Rebs+Asts,18,8,13,15
Terry Rozier,G,22023,1626179,22300678,"JAN 31, 2024",MIA vs. SAC,W,30,1,8,0.125,1,4,0.25,0,0,0.0,1,4,5,10,2,1,1,1,3,1,1,MIA,MIA,SAC,115,6.0,Assists,18,8,13,15
Terry Rozier,G,22023,1626179,22300678,"JAN 31, 2024",MIA vs. SAC,W,30,1,8,0.125,1,4,0.25,0,0,0.0,1,4,5,10,2,1,1,1,3,1,1,MIA,MIA,SAC,115,31.0,Fantasy Score,18,8,13,15
Terry Rozier,G,22023,1626179,22300678,"JAN 31, 2024",MIA vs. SAC,W,30,1,8,0.125,1,4,0.25,0,0,0.0,1,4,5,10,2,1,1,1,3,1,1,MIA,MIA,SAC,115,20.5,Pts+Rebs,18,8,13,15
Terry Rozier,G,22023,1626179,22300678,"JAN 31, 2024",MIA vs. SAC,W,30,1,8,0.125,1,4,0.25,0,0,0.0,1,4,5,10,2,1,1,1,3,1,1,MIA,MIA,SAC,115,22.5,Pts+Asts,18,8,13,15
Terry Rozier,G,22023,1626179,22300678,"JAN 31, 2024",MIA vs. SAC,W,30,1,8,0.125,1,4,0.25,0,0,0.0,1,4,5,10,2,1,1,1,3,1,1,MIA,MIA,SAC,115,10.0,Rebs+Asts,18,8,13,15
Terry Rozier,G,22023,1626179,22300661,"JAN 29, 2024",MIA vs. PHX,L,27,8,14,0.571,4,6,0.667,1,1,1.0,0,2,2,3,0,1,1,2,21,-21,1,MIA,MIA,PHX,105,16.5,Points,26,23,24,5
Terry Rozier,G,22023,1626179,22300661,"JAN 29, 2024",MIA vs. PHX,L,27,8,14,0.571,4,6,0.667,1,1,1.0,0,2,2,3,0,1,1,2,21,-21,1,MIA,MIA,PHX,105,4.0,Rebounds,26,23,24,5
Terry Rozier,G,22023,1626179,22300661,"JAN 29, 2024",MIA vs. PHX,L,27,8,14,0.571,4,6,0.667,1,1,1.0,0,2,2,3,0,1,1,2,21,-21,1,MIA,MIA,PHX,105,26.5,Pts+Rebs+Asts,26,23,24,5
Terry Rozier,G,22023,1626179,22300661,"JAN 29, 2024",MIA vs. PHX,L,27,8,14,0.571,4,6,0.667,1,1,1.0,0,2,2,3,0,1,1,2,21,-21,1,MIA,MIA,PHX,105,6.0,Assists,26,23,24,5
Terry Rozier,G,22023,1626179,22300661,"JAN 29, 2024",MIA vs. PHX,L,27,8,14,0.571,4,6,0.667,1,1,1.0,0,2,2,3,0,1,1,2,21,-21,1,MIA,MIA,PHX,105,31.0,Fantasy Score,26,23,24,5
Terry Rozier,G,22023,1626179,22300661,"JAN 29, 2024",MIA vs. PHX,L,27,8,14,0.571,4,6,0.667,1,1,1.0,0,2,2,3,0,1,1,2,21,-21,1,MIA,MIA,PHX,105,20.5,Pts+Rebs,26,23,24,5
Terry Rozier,G,22023,1626179,22300661,"JAN 29, 2024",MIA vs. PHX,L,27,8,14,0.571,4,6,0.667,1,1,1.0,0,2,2,3,0,1,1,2,21,-21,1,MIA,MIA,PHX,105,22.5,Pts+Asts,26,23,24,5
Terry Rozier,G,22023,1626179,22300661,"JAN 29, 2024",MIA vs. PHX,L,27,8,14,0.571,4,6,0.667,1,1,1.0,0,2,2,3,0,1,1,2,21,-21,1,MIA,MIA,PHX,105,10.0,Rebs+Asts,26,23,24,5
Terry Rozier,G,22023,1626179,22300643,"JAN 27, 2024",MIA @ NYK,L,32,4,12,0.333,0,2,0.0,2,2,1.0,0,5,5,7,0,0,2,1,10,-14,1,MIA,NYK,MIA,109,16.5,Points,22,15,17,12
Terry Rozier,G,22023,1626179,22300643,"JAN 27, 2024",MIA @ NYK,L,32,4,12,0.333,0,2,0.0,2,2,1.0,0,5,5,7,0,0,2,1,10,-14,1,MIA,NYK,MIA,109,4.0,Rebounds,22,15,17,12
Terry Rozier,G,22023,1626179,22300643,"JAN 27, 2024",MIA @ NYK,L,32,4,12,0.333,0,2,0.0,2,2,1.0,0,5,5,7,0,0,2,1,10,-14,1,MIA,NYK,MIA,109,26.5,Pts+Rebs+Asts,22,15,17,12
Terry Rozier,G,22023,1626179,22300643,"JAN 27, 2024",MIA @ NYK,L,32,4,12,0.333,0,2,0.0,2,2,1.0,0,5,5,7,0,0,2,1,10,-14,1,MIA,NYK,MIA,109,6.0,Assists,22,15,17,12
Terry Rozier,G,22023,1626179,22300643,"JAN 27, 2024",MIA @ NYK,L,32,4,12,0.333,0,2,0.0,2,2,1.0,0,5,5,7,0,0,2,1,10,-14,1,MIA,NYK,MIA,109,31.0,Fantasy Score,22,15,17,12
Terry Rozier,G,22023,1626179,22300643,"JAN 27, 2024",MIA @ NYK,L,32,4,12,0.333,0,2,0.0,2,2,1.0,0,5,5,7,0,0,2,1,10,-14,1,MIA,NYK,MIA,109,20.5,Pts+Rebs,22,15,17,12
Terry Rozier,G,22023,1626179,22300643,"JAN 27, 2024",MIA @ NYK,L,32,4,12,0.333,0,2,0.0,2,2,1.0,0,5,5,7,0,0,2,1,10,-14,1,MIA,NYK,MIA,109,22.5,Pts+Asts,22,15,17,12
Terry Rozier,G,22023,1626179,22300643,"JAN 27, 2024",MIA @ NYK,L,32,4,12,0.333,0,2,0.0,2,2,1.0,0,5,5,7,0,0,2,1,10,-14,1,MIA,NYK,MIA,109,10.0,Rebs+Asts,22,15,17,12
Terry Rozier,G,22023,1626179,22300630,"JAN 25, 2024",MIA vs. BOS,L,29,3,10,0.3,1,4,0.25,0,0,0.0,0,2,2,3,1,0,0,2,7,-28,1,MIA,MIA,BOS,110,16.5,Points,12,9,10,5
Terry Rozier,G,22023,1626179,22300630,"JAN 25, 2024",MIA vs. BOS,L,29,3,10,0.3,1,4,0.25,0,0,0.0,0,2,2,3,1,0,0,2,7,-28,1,MIA,MIA,BOS,110,4.0,Rebounds,12,9,10,5
Terry Rozier,G,22023,1626179,22300630,"JAN 25, 2024",MIA vs. BOS,L,29,3,10,0.3,1,4,0.25,0,0,0.0,0,2,2,3,1,0,0,2,7,-28,1,MIA,MIA,BOS,110,26.5,Pts+Rebs+Asts,12,9,10,5
Terry Rozier,G,22023,1626179,22300630,"JAN 25, 2024",MIA vs. BOS,L,29,3,10,0.3,1,4,0.25,0,0,0.0,0,2,2,3,1,0,0,2,7,-28,1,MIA,MIA,BOS,110,6.0,Assists,12,9,10,5
Terry Rozier,G,22023,1626179,22300630,"JAN 25, 2024",MIA vs. BOS,L,29,3,10,0.3,1,4,0.25,0,0,0.0,0,2,2,3,1,0,0,2,7,-28,1,MIA,MIA,BOS,110,31.0,Fantasy Score,12,9,10,5
Terry Rozier,G,22023,1626179,22300630,"JAN 25, 2024",MIA vs. BOS,L,29,3,10,0.3,1,4,0.25,0,0,0.0,0,2,2,3,1,0,0,2,7,-28,1,MIA,MIA,BOS,110,20.5,Pts+Rebs,12,9,10,5
Terry Rozier,G,22023,1626179,22300630,"JAN 25, 2024",MIA vs. BOS,L,29,3,10,0.3,1,4,0.25,0,0,0.0,0,2,2,3,1,0,0,2,7,-28,1,MIA,MIA,BOS,110,22.5,Pts+Asts,12,9,10,5
Terry Rozier,G,22023,1626179,22300630,"JAN 25, 2024",MIA vs. BOS,L,29,3,10,0.3,1,4,0.25,0,0,0.0,0,2,2,3,1,0,0,2,7,-28,1,MIA,MIA,BOS,110,10.0,Rebs+Asts,12,9,10,5
Terry Rozier,G,22023,1626179,22300621,"JAN 24, 2024",MIA vs. MEM,L,29,3,11,0.273,1,5,0.2,2,2,1.0,2,2,4,5,2,0,3,2,9,-13,1,MIA,MIA,MEM,96,16.5,Points,18,13,14,9
Terry Rozier,G,22023,1626179,22300621,"JAN 24, 2024",MIA vs. MEM,L,29,3,11,0.273,1,5,0.2,2,2,1.0,2,2,4,5,2,0,3,2,9,-13,1,MIA,MIA,MEM,96,4.0,Rebounds,18,13,14,9
Terry Rozier,G,22023,1626179,22300621,"JAN 24, 2024",MIA vs. MEM,L,29,3,11,0.273,1,5,0.2,2,2,1.0,2,2,4,5,2,0,3,2,9,-13,1,MIA,MIA,MEM,96,26.5,Pts+Rebs+Asts,18,13,14,9
Terry Rozier,G,22023,1626179,22300621,"JAN 24, 2024",MIA vs. MEM,L,29,3,11,0.273,1,5,0.2,2,2,1.0,2,2,4,5,2,0,3,2,9,-13,1,MIA,MIA,MEM,96,6.0,Assists,18,13,14,9
Terry Rozier,G,22023,1626179,22300621,"JAN 24, 2024",MIA vs. MEM,L,29,3,11,0.273,1,5,0.2,2,2,1.0,2,2,4,5,2,0,3,2,9,-13,1,MIA,MIA,MEM,96,31.0,Fantasy Score,18,13,14,9
Terry Rozier,G,22023,1626179,22300621,"JAN 24, 2024",MIA vs. MEM,L,29,3,11,0.273,1,5,0.2,2,2,1.0,2,2,4,5,2,0,3,2,9,-13,1,MIA,MIA,MEM,96,20.5,Pts+Rebs,18,13,14,9
Terry Rozier,G,22023,1626179,22300621,"JAN 24, 2024",MIA vs. MEM,L,29,3,11,0.273,1,5,0.2,2,2,1.0,2,2,4,5,2,0,3,2,9,-13,1,MIA,MIA,MEM,96,22.5,Pts+Asts,18,13,14,9
Terry Rozier,G,22023,1626179,22300621,"JAN 24, 2024",MIA vs. MEM,L,29,3,11,0.273,1,5,0.2,2,2,1.0,2,2,4,5,2,0,3,2,9,-13,1,MIA,MIA,MEM,96,10.0,Rebs+Asts,18,13,14,9
Terry Rozier,G,22023,1626179,22300335,"DEC 16, 2023",CHA vs. PHI,L,20,3,10,0.3,0,5,0.0,0,0,0.0,1,1,2,2,0,0,2,2,6,-38,1,CHA,CHA,PHI,80,16.5,Points,10,8,8,4
Terry Rozier,G,22023,1626179,22300335,"DEC 16, 2023",CHA vs. PHI,L,20,3,10,0.3,0,5,0.0,0,0,0.0,1,1,2,2,0,0,2,2,6,-38,1,CHA,CHA,PHI,80,4.0,Rebounds,10,8,8,4
Terry Rozier,G,22023,1626179,22300335,"DEC 16, 2023",CHA vs. PHI,L,20,3,10,0.3,0,5,0.0,0,0,0.0,1,1,2,2,0,0,2,2,6,-38,1,CHA,CHA,PHI,80,26.5,Pts+Rebs+Asts,10,8,8,4
Terry Rozier,G,22023,1626179,22300335,"DEC 16, 2023",CHA vs. PHI,L,20,3,10,0.3,0,5,0.0,0,0,0.0,1,1,2,2,0,0,2,2,6,-38,1,CHA,CHA,PHI,80,6.0,Assists,10,8,8,4
Terry Rozier,G,22023,1626179,22300335,"DEC 16, 2023",CHA vs. PHI,L,20,3,10,0.3,0,5,0.0,0,0,0.0,1,1,2,2,0,0,2,2,6,-38,1,CHA,CHA,PHI,80,31.0,Fantasy Score,10,8,8,4
Terry Rozier,G,22023,1626179,22300335,"DEC 16, 2023",CHA vs. PHI,L,20,3,10,0.3,0,5,0.0,0,0,0.0,1,1,2,2,0,0,2,2,6,-38,1,CHA,CHA,PHI,80,20.5,Pts+Rebs,10,8,8,4
Terry Rozier,G,22023,1626179,22300335,"DEC 16, 2023",CHA vs. PHI,L,20,3,10,0.3,0,5,0.0,0,0,0.0,1,1,2,2,0,0,2,2,6,-38,1,CHA,CHA,PHI,80,22.5,Pts+Asts,10,8,8,4
Terry Rozier,G,22023,1626179,22300335,"DEC 16, 2023",CHA vs. PHI,L,20,3,10,0.3,0,5,0.0,0,0,0.0,1,1,2,2,0,0,2,2,6,-38,1,CHA,CHA,PHI,80,10.0,Rebs+Asts,10,8,8,4
Terry Rozier,G,22023,1626179,22300610,"JAN 22, 2024",CHA @ MIN,W,35,5,12,0.417,0,6,0.0,1,2,0.5,0,2,2,4,0,0,4,1,11,-13,1,CHA,MIN,CHA,126,16.5,Points,17,13,15,6
Terry Rozier,G,22023,1626179,22300610,"JAN 22, 2024",CHA @ MIN,W,35,5,12,0.417,0,6,0.0,1,2,0.5,0,2,2,4,0,0,4,1,11,-13,1,CHA,MIN,CHA,126,4.0,Rebounds,17,13,15,6
Terry Rozier,G,22023,1626179,22300610,"JAN 22, 2024",CHA @ MIN,W,35,5,12,0.417,0,6,0.0,1,2,0.5,0,2,2,4,0,0,4,1,11,-13,1,CHA,MIN,CHA,126,26.5,Pts+Rebs+Asts,17,13,15,6
Terry Rozier,G,22023,1626179,22300610,"JAN 22, 2024",CHA @ MIN,W,35,5,12,0.417,0,6,0.0,1,2,0.5,0,2,2,4,0,0,4,1,11,-13,1,CHA,MIN,CHA,126,6.0,Assists,17,13,15,6
Terry Rozier,G,22023,1626179,22300610,"JAN 22, 2024",CHA @ MIN,W,35,5,12,0.417,0,6,0.0,1,2,0.5,0,2,2,4,0,0,4,1,11,-13,1,CHA,MIN,CHA,126,31.0,Fantasy Score,17,13,15,6
Terry Rozier,G,22023,1626179,22300610,"JAN 22, 2024",CHA @ MIN,W,35,5,12,0.417,0,6,0.0,1,2,0.5,0,2,2,4,0,0,4,1,11,-13,1,CHA,MIN,CHA,126,20.5,Pts+Rebs,17,13,15,6
Terry Rozier,G,22023,1626179,22300610,"JAN 22, 2024",CHA @ MIN,W,35,5,12,0.417,0,6,0.0,1,2,0.5,0,2,2,4,0,0,4,1,11,-13,1,CHA,MIN,CHA,126,22.5,Pts+Asts,17,13,15,6
Terry Rozier,G,22023,1626179,22300610,"JAN 22, 2024",CHA @ MIN,W,35,5,12,0.417,0,6,0.0,1,2,0.5,0,2,2,4,0,0,4,1,11,-13,1,CHA,MIN,CHA,126,10.0,Rebs+Asts,17,13,15,6
Terry Rozier,G,22023,1626179,22300584,"JAN 19, 2024",CHA vs. SAS,W,34,7,18,0.389,1,7,0.143,2,2,1.0,1,5,6,8,1,0,3,0,17,-2,1,CHA,CHA,SAS,124,16.5,Points,31,23,25,14
Terry Rozier,G,22023,1626179,22300584,"JAN 19, 2024",CHA vs. SAS,W,34,7,18,0.389,1,7,0.143,2,2,1.0,1,5,6,8,1,0,3,0,17,-2,1,CHA,CHA,SAS,124,4.0,Rebounds,31,23,25,14
Terry Rozier,G,22023,1626179,22300584,"JAN 19, 2024",CHA vs. SAS,W,34,7,18,0.389,1,7,0.143,2,2,1.0,1,5,6,8,1,0,3,0,17,-2,1,CHA,CHA,SAS,124,26.5,Pts+Rebs+Asts,31,23,25,14
Terry Rozier,G,22023,1626179,22300584,"JAN 19, 2024",CHA vs. SAS,W,34,7,18,0.389,1,7,0.143,2,2,1.0,1,5,6,8,1,0,3,0,17,-2,1,CHA,CHA,SAS,124,6.0,Assists,31,23,25,14
Terry Rozier,G,22023,1626179,22300584,"JAN 19, 2024",CHA vs. SAS,W,34,7,18,0.389,1,7,0.143,2,2,1.0,1,5,6,8,1,0,3,0,17,-2,1,CHA,CHA,SAS,124,31.0,Fantasy Score,31,23,25,14
Terry Rozier,G,22023,1626179,22300584,"JAN 19, 2024",CHA vs. SAS,W,34,7,18,0.389,1,7,0.143,2,2,1.0,1,5,6,8,1,0,3,0,17,-2,1,CHA,CHA,SAS,124,20.5,Pts+Rebs,31,23,25,14
Terry Rozier,G,22023,1626179,22300584,"JAN 19, 2024",CHA vs. SAS,W,34,7,18,0.389,1,7,0.143,2,2,1.0,1,5,6,8,1,0,3,0,17,-2,1,CHA,CHA,SAS,124,22.5,Pts+Asts,31,23,25,14
Terry Rozier,G,22023,1626179,22300584,"JAN 19, 2024",CHA vs. SAS,W,34,7,18,0.389,1,7,0.143,2,2,1.0,1,5,6,8,1,0,3,0,17,-2,1,CHA,CHA,SAS,124,10.0,Rebs+Asts,31,23,25,14
Terry Rozier,G,22023,1626179,22300575,"JAN 17, 2024",CHA @ NOP,L,32,9,15,0.6,7,11,0.636,0,0,0.0,1,1,2,4,1,1,1,1,25,-9,1,CHA,NOP,CHA,108,16.5,Points,31,27,29,6
Terry Rozier,G,22023,1626179,22300575,"JAN 17, 2024",CHA @ NOP,L,32,9,15,0.6,7,11,0.636,0,0,0.0,1,1,2,4,1,1,1,1,25,-9,1,CHA,NOP,CHA,108,4.0,Rebounds,31,27,29,6
Terry Rozier,G,22023,1626179,22300575,"JAN 17, 2024",CHA @ NOP,L,32,9,15,0.6,7,11,0.636,0,0,0.0,1,1,2,4,1,1,1,1,25,-9,1,CHA,NOP,CHA,108,26.5,Pts+Rebs+Asts,31,27,29,6
Terry Rozier,G,22023,1626179,22300575,"JAN 17, 2024",CHA @ NOP,L,32,9,15,0.6,7,11,0.636,0,0,0.0,1,1,2,4,1,1,1,1,25,-9,1,CHA,NOP,CHA,108,6.0,Assists,31,27,29,6
Terry Rozier,G,22023,1626179,22300575,"JAN 17, 2024",CHA @ NOP,L,32,9,15,0.6,7,11,0.636,0,0,0.0,1,1,2,4,1,1,1,1,25,-9,1,CHA,NOP,CHA,108,31.0,Fantasy Score,31,27,29,6
Terry Rozier,G,22023,1626179,22300575,"JAN 17, 2024",CHA @ NOP,L,32,9,15,0.6,7,11,0.636,0,0,0.0,1,1,2,4,1,1,1,1,25,-9,1,CHA,NOP,CHA,108,20.5,Pts+Rebs,31,27,29,6
Terry Rozier,G,22023,1626179,22300575,"JAN 17, 2024",CHA @ NOP,L,32,9,15,0.6,7,11,0.636,0,0,0.0,1,1,2,4,1,1,1,1,25,-9,1,CHA,NOP,CHA,108,22.5,Pts+Asts,31,27,29,6
Terry Rozier,G,22023,1626179,22300575,"JAN 17, 2024",CHA @ NOP,L,32,9,15,0.6,7,11,0.636,0,0,0.0,1,1,2,4,1,1,1,1,25,-9,1,CHA,NOP,CHA,108,10.0,Rebs+Asts,31,27,29,6
Terry Rozier,G,22023,1626179,22300551,"JAN 14, 2024",CHA @ MIA,L,35,8,23,0.348,4,11,0.364,6,6,1.0,2,3,5,7,0,0,1,2,26,-18,1,CHA,MIA,CHA,85,16.5,Points,38,31,33,12
Terry Rozier,G,22023,1626179,22300551,"JAN 14, 2024",CHA @ MIA,L,35,8,23,0.348,4,11,0.364,6,6,1.0,2,3,5,7,0,0,1,2,26,-18,1,CHA,MIA,CHA,85,4.0,Rebounds,38,31,33,12
Terry Rozier,G,22023,1626179,22300551,"JAN 14, 2024",CHA @ MIA,L,35,8,23,0.348,4,11,0.364,6,6,1.0,2,3,5,7,0,0,1,2,26,-18,1,CHA,MIA,CHA,85,26.5,Pts+Rebs+Asts,38,31,33,12
Terry Rozier,G,22023,1626179,22300551,"JAN 14, 2024",CHA @ MIA,L,35,8,23,0.348,4,11,0.364,6,6,1.0,2,3,5,7,0,0,1,2,26,-18,1,CHA,MIA,CHA,85,6.0,Assists,38,31,33,12
Terry Rozier,G,22023,1626179,22300551,"JAN 14, 2024",CHA @ MIA,L,35,8,23,0.348,4,11,0.364,6,6,1.0,2,3,5,7,0,0,1,2,26,-18,1,CHA,MIA,CHA,85,31.0,Fantasy Score,38,31,33,12
Terry Rozier,G,22023,1626179,22300551,"JAN 14, 2024",CHA @ MIA,L,35,8,23,0.348,4,11,0.364,6,6,1.0,2,3,5,7,0,0,1,2,26,-18,1,CHA,MIA,CHA,85,20.5,Pts+Rebs,38,31,33,12
Terry Rozier,G,22023,1626179,22300551,"JAN 14, 2024",CHA @ MIA,L,35,8,23,0.348,4,11,0.364,6,6,1.0,2,3,5,7,0,0,1,2,26,-18,1,CHA,MIA,CHA,85,22.5,Pts+Asts,38,31,33,12
Terry Rozier,G,22023,1626179,22300551,"JAN 14, 2024",CHA @ MIA,L,35,8,23,0.348,4,11,0.364,6,6,1.0,2,3,5,7,0,0,1,2,26,-18,1,CHA,MIA,CHA,85,10.0,Rebs+Asts,38,31,33,12
Terry Rozier,G,22023,1626179,22300541,"JAN 12, 2024",CHA @ SAS,L,28,6,14,0.429,3,9,0.333,1,2,0.5,0,2,2,2,2,1,1,2,16,-32,1,CHA,SAS,CHA,99,16.5,Points,20,18,18,4
Terry Rozier,G,22023,1626179,22300541,"JAN 12, 2024",CHA @ SAS,L,28,6,14,0.429,3,9,0.333,1,2,0.5,0,2,2,2,2,1,1,2,16,-32,1,CHA,SAS,CHA,99,4.0,Rebounds,20,18,18,4
Terry Rozier,G,22023,1626179,22300541,"JAN 12, 2024",CHA @ SAS,L,28,6,14,0.429,3,9,0.333,1,2,0.5,0,2,2,2,2,1,1,2,16,-32,1,CHA,SAS,CHA,99,26.5,Pts+Rebs+Asts,20,18,18,4
Terry Rozier,G,22023,1626179,22300541,"JAN 12, 2024",CHA @ SAS,L,28,6,14,0.429,3,9,0.333,1,2,0.5,0,2,2,2,2,1,1,2,16,-32,1,CHA,SAS,CHA,99,6.0,Assists,20,18,18,4
Terry Rozier,G,22023,1626179,22300541,"JAN 12, 2024",CHA @ SAS,L,28,6,14,0.429,3,9,0.333,1,2,0.5,0,2,2,2,2,1,1,2,16,-32,1,CHA,SAS,CHA,99,31.0,Fantasy Score,20,18,18,4
Terry Rozier,G,22023,1626179,22300541,"JAN 12, 2024",CHA @ SAS,L,28,6,14,0.429,3,9,0.333,1,2,0.5,0,2,2,2,2,1,1,2,16,-32,1,CHA,SAS,CHA,99,20.5,Pts+Rebs,20,18,18,4
Terry Rozier,G,22023,1626179,22300541,"JAN 12, 2024",CHA @ SAS,L,28,6,14,0.429,3,9,0.333,1,2,0.5,0,2,2,2,2,1,1,2,16,-32,1,CHA,SAS,CHA,99,22.5,Pts+Asts,20,18,18,4
Terry Rozier,G,22023,1626179,22300541,"JAN 12, 2024",CHA @ SAS,L,28,6,14,0.429,3,9,0.333,1,2,0.5,0,2,2,2,2,1,1,2,16,-32,1,CHA,SAS,CHA,99,10.0,Rebs+Asts,20,18,18,4
Terry Rozier,G,22023,1626179,22300248,"NOV 26, 2023",CHA @ ORL,L,37,9,15,0.6,2,4,0.5,2,4,0.5,0,1,1,9,1,1,5,4,22,-10,1,CHA,ORL,CHA,117,16.5,Points,32,23,31,10
Terry Rozier,G,22023,1626179,22300248,"NOV 26, 2023",CHA @ ORL,L,37,9,15,0.6,2,4,0.5,2,4,0.5,0,1,1,9,1,1,5,4,22,-10,1,CHA,ORL,CHA,117,4.0,Rebounds,32,23,31,10
Terry Rozier,G,22023,1626179,22300248,"NOV 26, 2023",CHA @ ORL,L,37,9,15,0.6,2,4,0.5,2,4,0.5,0,1,1,9,1,1,5,4,22,-10,1,CHA,ORL,CHA,117,26.5,Pts+Rebs+Asts,32,23,31,10
Terry Rozier,G,22023,1626179,22300248,"NOV 26, 2023",CHA @ ORL,L,37,9,15,0.6,2,4,0.5,2,4,0.5,0,1,1,9,1,1,5,4,22,-10,1,CHA,ORL,CHA,117,6.0,Assists,32,23,31,10
Terry Rozier,G,22023,1626179,22300248,"NOV 26, 2023",CHA @ ORL,L,37,9,15,0.6,2,4,0.5,2,4,0.5,0,1,1,9,1,1,5,4,22,-10,1,CHA,ORL,CHA,117,31.0,Fantasy Score,32,23,31,10
Terry Rozier,G,22023,1626179,22300248,"NOV 26, 2023",CHA @ ORL,L,37,9,15,0.6,2,4,0.5,2,4,0.5,0,1,1,9,1,1,5,4,22,-10,1,CHA,ORL,CHA,117,20.5,Pts+Rebs,32,23,31,10
Terry Rozier,G,22023,1626179,22300248,"NOV 26, 2023",CHA @ ORL,L,37,9,15,0.6,2,4,0.5,2,4,0.5,0,1,1,9,1,1,5,4,22,-10,1,CHA,ORL,CHA,117,22.5,Pts+Asts,32,23,31,10
Terry Rozier,G,22023,1626179,22300248,"NOV 26, 2023",CHA @ ORL,L,37,9,15,0.6,2,4,0.5,2,4,0.5,0,1,1,9,1,1,5,4,22,-10,1,CHA,ORL,CHA,117,10.0,Rebs+Asts,32,23,31,10
Terry Rozier,G,22023,1626179,22300133,"NOV 04, 2023",CHA @ IND,W,31,7,14,0.5,3,5,0.6,5,5,1.0,0,6,6,3,0,1,0,0,22,0,1,CHA,IND,CHA,125,16.5,Points,31,28,25,9
Terry Rozier,G,22023,1626179,22300133,"NOV 04, 2023",CHA @ IND,W,31,7,14,0.5,3,5,0.6,5,5,1.0,0,6,6,3,0,1,0,0,22,0,1,CHA,IND,CHA,125,4.0,Rebounds,31,28,25,9
Terry Rozier,G,22023,1626179,22300133,"NOV 04, 2023",CHA @ IND,W,31,7,14,0.5,3,5,0.6,5,5,1.0,0,6,6,3,0,1,0,0,22,0,1,CHA,IND,CHA,125,26.5,Pts+Rebs+Asts,31,28,25,9
Terry Rozier,G,22023,1626179,22300133,"NOV 04, 2023",CHA @ IND,W,31,7,14,0.5,3,5,0.6,5,5,1.0,0,6,6,3,0,1,0,0,22,0,1,CHA,IND,CHA,125,6.0,Assists,31,28,25,9
Terry Rozier,G,22023,1626179,22300133,"NOV 04, 2023",CHA @ IND,W,31,7,14,0.5,3,5,0.6,5,5,1.0,0,6,6,3,0,1,0,0,22,0,1,CHA,IND,CHA,125,31.0,Fantasy Score,31,28,25,9
Terry Rozier,G,22023,1626179,22300133,"NOV 04, 2023",CHA @ IND,W,31,7,14,0.5,3,5,0.6,5,5,1.0,0,6,6,3,0,1,0,0,22,0,1,CHA,IND,CHA,125,20.5,Pts+Rebs,31,28,25,9
Terry Rozier,G,22023,1626179,22300133,"NOV 04, 2023",CHA @ IND,W,31,7,14,0.5,3,5,0.6,5,5,1.0,0,6,6,3,0,1,0,0,22,0,1,CHA,IND,CHA,125,22.5,Pts+Asts,31,28,25,9
Terry Rozier,G,22023,1626179,22300133,"NOV 04, 2023",CHA @ IND,W,31,7,14,0.5,3,5,0.6,5,5,1.0,0,6,6,3,0,1,0,0,22,0,1,CHA,IND,CHA,125,10.0,Rebs+Asts,31,28,25,9
Terry Rozier,G,22023,1626179,22300122,"NOV 01, 2023",CHA @ HOU,L,38,10,21,0.476,1,6,0.167,0,0,0.0,2,1,3,6,1,0,4,0,21,-1,1,CHA,HOU,CHA,119,16.5,Points,30,24,27,9
Terry Rozier,G,22023,1626179,22300122,"NOV 01, 2023",CHA @ HOU,L,38,10,21,0.476,1,6,0.167,0,0,0.0,2,1,3,6,1,0,4,0,21,-1,1,CHA,HOU,CHA,119,4.0,Rebounds,30,24,27,9
Terry Rozier,G,22023,1626179,22300122,"NOV 01, 2023",CHA @ HOU,L,38,10,21,0.476,1,6,0.167,0,0,0.0,2,1,3,6,1,0,4,0,21,-1,1,CHA,HOU,CHA,119,26.5,Pts+Rebs+Asts,30,24,27,9
Terry Rozier,G,22023,1626179,22300122,"NOV 01, 2023",CHA @ HOU,L,38,10,21,0.476,1,6,0.167,0,0,0.0,2,1,3,6,1,0,4,0,21,-1,1,CHA,HOU,CHA,119,6.0,Assists,30,24,27,9
Terry Rozier,G,22023,1626179,22300122,"NOV 01, 2023",CHA @ HOU,L,38,10,21,0.476,1,6,0.167,0,0,0.0,2,1,3,6,1,0,4,0,21,-1,1,CHA,HOU,CHA,119,31.0,Fantasy Score,30,24,27,9
Terry Rozier,G,22023,1626179,22300122,"NOV 01, 2023",CHA @ HOU,L,38,10,21,0.476,1,6,0.167,0,0,0.0,2,1,3,6,1,0,4,0,21,-1,1,CHA,HOU,CHA,119,20.5,Pts+Rebs,30,24,27,9
Terry Rozier,G,22023,1626179,22300122,"NOV 01, 2023",CHA @ HOU,L,38,10,21,0.476,1,6,0.167,0,0,0.0,2,1,3,6,1,0,4,0,21,-1,1,CHA,HOU,CHA,119,22.5,Pts+Asts,30,24,27,9
Terry Rozier,G,22023,1626179,22300122,"NOV 01, 2023",CHA @ HOU,L,38,10,21,0.476,1,6,0.167,0,0,0.0,2,1,3,6,1,0,4,0,21,-1,1,CHA,HOU,CHA,119,10.0,Rebs+Asts,30,24,27,9
Terry Rozier,G,22023,1626179,22300101,"OCT 30, 2023",CHA vs. BKN,L,41,10,19,0.526,2,6,0.333,1,1,1.0,0,3,3,9,1,1,2,2,23,-13,1,CHA,CHA,BKN,121,16.5,Points,35,26,32,12
Terry Rozier,G,22023,1626179,22300101,"OCT 30, 2023",CHA vs. BKN,L,41,10,19,0.526,2,6,0.333,1,1,1.0,0,3,3,9,1,1,2,2,23,-13,1,CHA,CHA,BKN,121,4.0,Rebounds,35,26,32,12
Terry Rozier,G,22023,1626179,22300101,"OCT 30, 2023",CHA vs. BKN,L,41,10,19,0.526,2,6,0.333,1,1,1.0,0,3,3,9,1,1,2,2,23,-13,1,CHA,CHA,BKN,121,26.5,Pts+Rebs+Asts,35,26,32,12
Terry Rozier,G,22023,1626179,22300101,"OCT 30, 2023",CHA vs. BKN,L,41,10,19,0.526,2,6,0.333,1,1,1.0,0,3,3,9,1,1,2,2,23,-13,1,CHA,CHA,BKN,121,6.0,Assists,35,26,32,12
Terry Rozier,G,22023,1626179,22300101,"OCT 30, 2023",CHA vs. BKN,L,41,10,19,0.526,2,6,0.333,1,1,1.0,0,3,3,9,1,1,2,2,23,-13,1,CHA,CHA,BKN,121,31.0,Fantasy Score,35,26,32,12
Terry Rozier,G,22023,1626179,22300101,"OCT 30, 2023",CHA vs. BKN,L,41,10,19,0.526,2,6,0.333,1,1,1.0,0,3,3,9,1,1,2,2,23,-13,1,CHA,CHA,BKN,121,20.5,Pts+Rebs,35,26,32,12
Terry Rozier,G,22023,1626179,22300101,"OCT 30, 2023",CHA vs. BKN,L,41,10,19,0.526,2,6,0.333,1,1,1.0,0,3,3,9,1,1,2,2,23,-13,1,CHA,CHA,BKN,121,22.5,Pts+Asts,35,26,32,12
Terry Rozier,G,22023,1626179,22300101,"OCT 30, 2023",CHA vs. BKN,L,41,10,19,0.526,2,6,0.333,1,1,1.0,0,3,3,9,1,1,2,2,23,-13,1,CHA,CHA,BKN,121,10.0,Rebs+Asts,35,26,32,12
Terry Rozier,G,22023,1626179,22300077,"OCT 27, 2023",CHA vs. DET,L,35,8,20,0.4,0,7,0.0,4,4,1.0,1,2,3,1,1,0,2,0,20,-11,1,CHA,CHA,DET,99,16.5,Points,24,23,21,4
Terry Rozier,G,22023,1626179,22300077,"OCT 27, 2023",CHA vs. DET,L,35,8,20,0.4,0,7,0.0,4,4,1.0,1,2,3,1,1,0,2,0,20,-11,1,CHA,CHA,DET,99,4.0,Rebounds,24,23,21,4
Terry Rozier,G,22023,1626179,22300077,"OCT 27, 2023",CHA vs. DET,L,35,8,20,0.4,0,7,0.0,4,4,1.0,1,2,3,1,1,0,2,0,20,-11,1,CHA,CHA,DET,99,26.5,Pts+Rebs+Asts,24,23,21,4
Terry Rozier,G,22023,1626179,22300077,"OCT 27, 2023",CHA vs. DET,L,35,8,20,0.4,0,7,0.0,4,4,1.0,1,2,3,1,1,0,2,0,20,-11,1,CHA,CHA,DET,99,6.0,Assists,24,23,21,4
Terry Rozier,G,22023,1626179,22300077,"OCT 27, 2023",CHA vs. DET,L,35,8,20,0.4,0,7,0.0,4,4,1.0,1,2,3,1,1,0,2,0,20,-11,1,CHA,CHA,DET,99,31.0,Fantasy Score,24,23,21,4
Terry Rozier,G,22023,1626179,22300077,"OCT 27, 2023",CHA vs. DET,L,35,8,20,0.4,0,7,0.0,4,4,1.0,1,2,3,1,1,0,2,0,20,-11,1,CHA,CHA,DET,99,20.5,Pts+Rebs,24,23,21,4
Terry Rozier,G,22023,1626179,22300077,"OCT 27, 2023",CHA vs. DET,L,35,8,20,0.4,0,7,0.0,4,4,1.0,1,2,3,1,1,0,2,0,20,-11,1,CHA,CHA,DET,99,22.5,Pts+Asts,24,23,21,4
Terry Rozier,G,22023,1626179,22300077,"OCT 27, 2023",CHA vs. DET,L,35,8,20,0.4,0,7,0.0,4,4,1.0,1,2,3,1,1,0,2,0,20,-11,1,CHA,CHA,DET,99,10.0,Rebs+Asts,24,23,21,4
Terry Rozier,G,22023,1626179,22300063,"OCT 25, 2023",CHA vs. ATL,W,34,7,16,0.438,2,7,0.286,8,12,0.667,1,4,5,6,0,0,3,2,24,14,1,CHA,CHA,ATL,116,16.5,Points,35,29,30,11
Terry Rozier,G,22023,1626179,22300063,"OCT 25, 2023",CHA vs. ATL,W,34,7,16,0.438,2,7,0.286,8,12,0.667,1,4,5,6,0,0,3,2,24,14,1,CHA,CHA,ATL,116,4.0,Rebounds,35,29,30,11
Terry Rozier,G,22023,1626179,22300063,"OCT 25, 2023",CHA vs. ATL,W,34,7,16,0.438,2,7,0.286,8,12,0.667,1,4,5,6,0,0,3,2,24,14,1,CHA,CHA,ATL,116,26.5,Pts+Rebs+Asts,35,29,30,11
Terry Rozier,G,22023,1626179,22300063,"OCT 25, 2023",CHA vs. ATL,W,34,7,16,0.438,2,7,0.286,8,12,0.667,1,4,5,6,0,0,3,2,24,14,1,CHA,CHA,ATL,116,6.0,Assists,35,29,30,11
Terry Rozier,G,22023,1626179,22300063,"OCT 25, 2023",CHA vs. ATL,W,34,7,16,0.438,2,7,0.286,8,12,0.667,1,4,5,6,0,0,3,2,24,14,1,CHA,CHA,ATL,116,31.0,Fantasy Score,35,29,30,11
Terry Rozier,G,22023,1626179,22300063,"OCT 25, 2023",CHA vs. ATL,W,34,7,16,0.438,2,7,0.286,8,12,0.667,1,4,5,6,0,0,3,2,24,14,1,CHA,CHA,ATL,116,20.5,Pts+Rebs,35,29,30,11
Terry Rozier,G,22023,1626179,22300063,"OCT 25, 2023",CHA vs. ATL,W,34,7,16,0.438,2,7,0.286,8,12,0.667,1,4,5,6,0,0,3,2,24,14,1,CHA,CHA,ATL,116,22.5,Pts+Asts,35,29,30,11
Terry Rozier,G,22023,1626179,22300063,"OCT 25, 2023",CHA vs. ATL,W,34,7,16,0.438,2,7,0.286,8,12,0.667,1,4,5,6,0,0,3,2,24,14,1,CHA,CHA,ATL,116,10.0,Rebs+Asts,35,29,30,11
Terry Rozier,G,22023,1626179,22300518,"JAN 10, 2024",CHA vs. SAC,L,32,6,14,0.429,3,6,0.5,7,8,0.875,0,4,4,2,1,1,0,1,22,-31,1,CHA,CHA,SAC,96,16.5,Points,28,26,24,6
Terry Rozier,G,22023,1626179,22300518,"JAN 10, 2024",CHA vs. SAC,L,32,6,14,0.429,3,6,0.5,7,8,0.875,0,4,4,2,1,1,0,1,22,-31,1,CHA,CHA,SAC,96,4.0,Rebounds,28,26,24,6
Terry Rozier,G,22023,1626179,22300518,"JAN 10, 2024",CHA vs. SAC,L,32,6,14,0.429,3,6,0.5,7,8,0.875,0,4,4,2,1,1,0,1,22,-31,1,CHA,CHA,SAC,96,26.5,Pts+Rebs+Asts,28,26,24,6
Terry Rozier,G,22023,1626179,22300518,"JAN 10, 2024",CHA vs. SAC,L,32,6,14,0.429,3,6,0.5,7,8,0.875,0,4,4,2,1,1,0,1,22,-31,1,CHA,CHA,SAC,96,6.0,Assists,28,26,24,6
Terry Rozier,G,22023,1626179,22300518,"JAN 10, 2024",CHA vs. SAC,L,32,6,14,0.429,3,6,0.5,7,8,0.875,0,4,4,2,1,1,0,1,22,-31,1,CHA,CHA,SAC,96,31.0,Fantasy Score,28,26,24,6
Terry Rozier,G,22023,1626179,22300518,"JAN 10, 2024",CHA vs. SAC,L,32,6,14,0.429,3,6,0.5,7,8,0.875,0,4,4,2,1,1,0,1,22,-31,1,CHA,CHA,SAC,96,20.5,Pts+Rebs,28,26,24,6
Terry Rozier,G,22023,1626179,22300518,"JAN 10, 2024",CHA vs. SAC,L,32,6,14,0.429,3,6,0.5,7,8,0.875,0,4,4,2,1,1,0,1,22,-31,1,CHA,CHA,SAC,96,22.5,Pts+Asts,28,26,24,6
Terry Rozier,G,22023,1626179,22300518,"JAN 10, 2024",CHA vs. SAC,L,32,6,14,0.429,3,6,0.5,7,8,0.875,0,4,4,2,1,1,0,1,22,-31,1,CHA,CHA,SAC,96,10.0,Rebs+Asts,28,26,24,6
Terry Rozier,G,22023,1626179,22300365,"DEC 20, 2023",CHA @ IND,L,35,10,26,0.385,2,10,0.2,3,3,1.0,2,7,9,7,1,0,1,0,25,-21,1,CHA,IND,CHA,109,16.5,Points,41,34,32,16
Terry Rozier,G,22023,1626179,22300365,"DEC 20, 2023",CHA @ IND,L,35,10,26,0.385,2,10,0.2,3,3,1.0,2,7,9,7,1,0,1,0,25,-21,1,CHA,IND,CHA,109,4.0,Rebounds,41,34,32,16
Terry Rozier,G,22023,1626179,22300365,"DEC 20, 2023",CHA @ IND,L,35,10,26,0.385,2,10,0.2,3,3,1.0,2,7,9,7,1,0,1,0,25,-21,1,CHA,IND,CHA,109,26.5,Pts+Rebs+Asts,41,34,32,16
Terry Rozier,G,22023,1626179,22300365,"DEC 20, 2023",CHA @ IND,L,35,10,26,0.385,2,10,0.2,3,3,1.0,2,7,9,7,1,0,1,0,25,-21,1,CHA,IND,CHA,109,6.0,Assists,41,34,32,16
Terry Rozier,G,22023,1626179,22300365,"DEC 20, 2023",CHA @ IND,L,35,10,26,0.385,2,10,0.2,3,3,1.0,2,7,9,7,1,0,1,0,25,-21,1,CHA,IND,CHA,109,31.0,Fantasy Score,41,34,32,16
Terry Rozier,G,22023,1626179,22300365,"DEC 20, 2023",CHA @ IND,L,35,10,26,0.385,2,10,0.2,3,3,1.0,2,7,9,7,1,0,1,0,25,-21,1,CHA,IND,CHA,109,20.5,Pts+Rebs,41,34,32,16
Terry Rozier,G,22023,1626179,22300365,"DEC 20, 2023",CHA @ IND,L,35,10,26,0.385,2,10,0.2,3,3,1.0,2,7,9,7,1,0,1,0,25,-21,1,CHA,IND,CHA,109,22.5,Pts+Asts,41,34,32,16
Terry Rozier,G,22023,1626179,22300365,"DEC 20, 2023",CHA @ IND,L,35,10,26,0.385,2,10,0.2,3,3,1.0,2,7,9,7,1,0,1,0,25,-21,1,CHA,IND,CHA,109,10.0,Rebs+Asts,41,34,32,16
Terry Rozier,G,22023,1626179,22300354,"DEC 18, 2023",CHA @ TOR,L,32,9,20,0.45,2,8,0.25,2,2,1.0,1,2,3,7,3,1,3,4,22,-3,1,CHA,TOR,CHA,99,16.5,Points,32,25,29,10
Terry Rozier,G,22023,1626179,22300354,"DEC 18, 2023",CHA @ TOR,L,32,9,20,0.45,2,8,0.25,2,2,1.0,1,2,3,7,3,1,3,4,22,-3,1,CHA,TOR,CHA,99,4.0,Rebounds,32,25,29,10
Terry Rozier,G,22023,1626179,22300354,"DEC 18, 2023",CHA @ TOR,L,32,9,20,0.45,2,8,0.25,2,2,1.0,1,2,3,7,3,1,3,4,22,-3,1,CHA,TOR,CHA,99,26.5,Pts+Rebs+Asts,32,25,29,10
Terry Rozier,G,22023,1626179,22300354,"DEC 18, 2023",CHA @ TOR,L,32,9,20,0.45,2,8,0.25,2,2,1.0,1,2,3,7,3,1,3,4,22,-3,1,CHA,TOR,CHA,99,6.0,Assists,32,25,29,10
Terry Rozier,G,22023,1626179,22300354,"DEC 18, 2023",CHA @ TOR,L,32,9,20,0.45,2,8,0.25,2,2,1.0,1,2,3,7,3,1,3,4,22,-3,1,CHA,TOR,CHA,99,31.0,Fantasy Score,32,25,29,10
Terry Rozier,G,22023,1626179,22300354,"DEC 18, 2023",CHA @ TOR,L,32,9,20,0.45,2,8,0.25,2,2,1.0,1,2,3,7,3,1,3,4,22,-3,1,CHA,TOR,CHA,99,20.5,Pts+Rebs,32,25,29,10
Terry Rozier,G,22023,1626179,22300354,"DEC 18, 2023",CHA @ TOR,L,32,9,20,0.45,2,8,0.25,2,2,1.0,1,2,3,7,3,1,3,4,22,-3,1,CHA,TOR,CHA,99,22.5,Pts+Asts,32,25,29,10
Terry Rozier,G,22023,1626179,22300354,"DEC 18, 2023",CHA @ TOR,L,32,9,20,0.45,2,8,0.25,2,2,1.0,1,2,3,7,3,1,3,4,22,-3,1,CHA,TOR,CHA,99,10.0,Rebs+Asts,32,25,29,10
Terry Rozier,G,22023,1626179,22300057,"NOV 28, 2023",CHA @ NYK,L,33,5,16,0.313,0,3,0.0,1,1,1.0,0,2,2,5,1,0,3,0,11,-10,1,CHA,NYK,CHA,91,16.5,Points,18,13,16,7
Terry Rozier,G,22023,1626179,22300057,"NOV 28, 2023",CHA @ NYK,L,33,5,16,0.313,0,3,0.0,1,1,1.0,0,2,2,5,1,0,3,0,11,-10,1,CHA,NYK,CHA,91,4.0,Rebounds,18,13,16,7
Terry Rozier,G,22023,1626179,22300057,"NOV 28, 2023",CHA @ NYK,L,33,5,16,0.313,0,3,0.0,1,1,1.0,0,2,2,5,1,0,3,0,11,-10,1,CHA,NYK,CHA,91,26.5,Pts+Rebs+Asts,18,13,16,7
Terry Rozier,G,22023,1626179,22300057,"NOV 28, 2023",CHA @ NYK,L,33,5,16,0.313,0,3,0.0,1,1,1.0,0,2,2,5,1,0,3,0,11,-10,1,CHA,NYK,CHA,91,6.0,Assists,18,13,16,7
Terry Rozier,G,22023,1626179,22300057,"NOV 28, 2023",CHA @ NYK,L,33,5,16,0.313,0,3,0.0,1,1,1.0,0,2,2,5,1,0,3,0,11,-10,1,CHA,NYK,CHA,91,31.0,Fantasy Score,18,13,16,7
Terry Rozier,G,22023,1626179,22300057,"NOV 28, 2023",CHA @ NYK,L,33,5,16,0.313,0,3,0.0,1,1,1.0,0,2,2,5,1,0,3,0,11,-10,1,CHA,NYK,CHA,91,20.5,Pts+Rebs,18,13,16,7
Terry Rozier,G,22023,1626179,22300057,"NOV 28, 2023",CHA @ NYK,L,33,5,16,0.313,0,3,0.0,1,1,1.0,0,2,2,5,1,0,3,0,11,-10,1,CHA,NYK,CHA,91,22.5,Pts+Asts,18,13,16,7
Terry Rozier,G,22023,1626179,22300057,"NOV 28, 2023",CHA @ NYK,L,33,5,16,0.313,0,3,0.0,1,1,1.0,0,2,2,5,1,0,3,0,11,-10,1,CHA,NYK,CHA,91,10.0,Rebs+Asts,18,13,16,7
Terry Rozier,G,22023,1626179,22300506,"JAN 08, 2024",CHA vs. CHI,L,44,10,18,0.556,7,13,0.538,12,12,1.0,0,3,3,8,0,0,0,2,39,-9,1,CHA,CHA,CHI,109,16.5,Points,50,42,47,11
Terry Rozier,G,22023,1626179,22300506,"JAN 08, 2024",CHA vs. CHI,L,44,10,18,0.556,7,13,0.538,12,12,1.0,0,3,3,8,0,0,0,2,39,-9,1,CHA,CHA,CHI,109,4.0,Rebounds,50,42,47,11
Terry Rozier,G,22023,1626179,22300506,"JAN 08, 2024",CHA vs. CHI,L,44,10,18,0.556,7,13,0.538,12,12,1.0,0,3,3,8,0,0,0,2,39,-9,1,CHA,CHA,CHI,109,26.5,Pts+Rebs+Asts,50,42,47,11
Terry Rozier,G,22023,1626179,22300506,"JAN 08, 2024",CHA vs. CHI,L,44,10,18,0.556,7,13,0.538,12,12,1.0,0,3,3,8,0,0,0,2,39,-9,1,CHA,CHA,CHI,109,6.0,Assists,50,42,47,11
Terry Rozier,G,22023,1626179,22300506,"JAN 08, 2024",CHA vs. CHI,L,44,10,18,0.556,7,13,0.538,12,12,1.0,0,3,3,8,0,0,0,2,39,-9,1,CHA,CHA,CHI,109,31.0,Fantasy Score,50,42,47,11
Terry Rozier,G,22023,1626179,22300506,"JAN 08, 2024",CHA vs. CHI,L,44,10,18,0.556,7,13,0.538,12,12,1.0,0,3,3,8,0,0,0,2,39,-9,1,CHA,CHA,CHI,109,20.5,Pts+Rebs,50,42,47,11
Terry Rozier,G,22023,1626179,22300506,"JAN 08, 2024",CHA vs. CHI,L,44,10,18,0.556,7,13,0.538,12,12,1.0,0,3,3,8,0,0,0,2,39,-9,1,CHA,CHA,CHI,109,22.5,Pts+Asts,50,42,47,11
Terry Rozier,G,22023,1626179,22300506,"JAN 08, 2024",CHA vs. CHI,L,44,10,18,0.556,7,13,0.538,12,12,1.0,0,3,3,8,0,0,0,2,39,-9,1,CHA,CHA,CHI,109,10.0,Rebs+Asts,50,42,47,11
Terry Rozier,G,22023,1626179,22300428,"DEC 28, 2023",CHA @ LAL,L,32,5,14,0.357,1,3,0.333,7,9,0.778,0,6,6,8,1,0,4,0,18,-32,1,CHA,LAL,CHA,110,16.5,Points,32,24,26,14
Terry Rozier,G,22023,1626179,22300428,"DEC 28, 2023",CHA @ LAL,L,32,5,14,0.357,1,3,0.333,7,9,0.778,0,6,6,8,1,0,4,0,18,-32,1,CHA,LAL,CHA,110,4.0,Rebounds,32,24,26,14
Terry Rozier,G,22023,1626179,22300428,"DEC 28, 2023",CHA @ LAL,L,32,5,14,0.357,1,3,0.333,7,9,0.778,0,6,6,8,1,0,4,0,18,-32,1,CHA,LAL,CHA,110,26.5,Pts+Rebs+Asts,32,24,26,14
Terry Rozier,G,22023,1626179,22300428,"DEC 28, 2023",CHA @ LAL,L,32,5,14,0.357,1,3,0.333,7,9,0.778,0,6,6,8,1,0,4,0,18,-32,1,CHA,LAL,CHA,110,6.0,Assists,32,24,26,14
Terry Rozier,G,22023,1626179,22300428,"DEC 28, 2023",CHA @ LAL,L,32,5,14,0.357,1,3,0.333,7,9,0.778,0,6,6,8,1,0,4,0,18,-32,1,CHA,LAL,CHA,110,31.0,Fantasy Score,32,24,26,14
Terry Rozier,G,22023,1626179,22300428,"DEC 28, 2023",CHA @ LAL,L,32,5,14,0.357,1,3,0.333,7,9,0.778,0,6,6,8,1,0,4,0,18,-32,1,CHA,LAL,CHA,110,20.5,Pts+Rebs,32,24,26,14
Terry Rozier,G,22023,1626179,22300428,"DEC 28, 2023",CHA @ LAL,L,32,5,14,0.357,1,3,0.333,7,9,0.778,0,6,6,8,1,0,4,0,18,-32,1,CHA,LAL,CHA,110,22.5,Pts+Asts,32,24,26,14
Terry Rozier,G,22023,1626179,22300428,"DEC 28, 2023",CHA @ LAL,L,32,5,14,0.357,1,3,0.333,7,9,0.778,0,6,6,8,1,0,4,0,18,-32,1,CHA,LAL,CHA,110,10.0,Rebs+Asts,32,24,26,14
Terry Rozier,G,22023,1626179,22300593,"JAN 20, 2024",CHA vs. PHI,L,36,9,18,0.5,0,5,0.0,1,5,0.2,0,9,9,6,1,0,3,2,19,-10,1,CHA,CHA,PHI,89,16.5,Points,34,28,25,15
Terry Rozier,G,22023,1626179,22300593,"JAN 20, 2024",CHA vs. PHI,L,36,9,18,0.5,0,5,0.0,1,5,0.2,0,9,9,6,1,0,3,2,19,-10,1,CHA,CHA,PHI,89,4.0,Rebounds,34,28,25,15
Terry Rozier,G,22023,1626179,22300593,"JAN 20, 2024",CHA vs. PHI,L,36,9,18,0.5,0,5,0.0,1,5,0.2,0,9,9,6,1,0,3,2,19,-10,1,CHA,CHA,PHI,89,26.5,Pts+Rebs+Asts,34,28,25,15
Terry Rozier,G,22023,1626179,22300593,"JAN 20, 2024",CHA vs. PHI,L,36,9,18,0.5,0,5,0.0,1,5,0.2,0,9,9,6,1,0,3,2,19,-10,1,CHA,CHA,PHI,89,6.0,Assists,34,28,25,15
Terry Rozier,G,22023,1626179,22300593,"JAN 20, 2024",CHA vs. PHI,L,36,9,18,0.5,0,5,0.0,1,5,0.2,0,9,9,6,1,0,3,2,19,-10,1,CHA,CHA,PHI,89,31.0,Fantasy Score,34,28,25,15
Terry Rozier,G,22023,1626179,22300593,"JAN 20, 2024",CHA vs. PHI,L,36,9,18,0.5,0,5,0.0,1,5,0.2,0,9,9,6,1,0,3,2,19,-10,1,CHA,CHA,PHI,89,20.5,Pts+Rebs,34,28,25,15
Terry Rozier,G,22023,1626179,22300593,"JAN 20, 2024",CHA vs. PHI,L,36,9,18,0.5,0,5,0.0,1,5,0.2,0,9,9,6,1,0,3,2,19,-10,1,CHA,CHA,PHI,89,22.5,Pts+Asts,34,28,25,15
Terry Rozier,G,22023,1626179,22300593,"JAN 20, 2024",CHA vs. PHI,L,36,9,18,0.5,0,5,0.0,1,5,0.2,0,9,9,6,1,0,3,2,19,-10,1,CHA,CHA,PHI,89,10.0,Rebs+Asts,34,28,25,15
Terry Rozier,G,22023,1626179,22300484,"JAN 05, 2024",CHA @ CHI,L,36,5,17,0.294,1,7,0.143,4,4,1.0,1,3,4,7,1,0,3,2,15,-10,1,CHA,CHI,CHA,87,16.5,Points,26,19,22,11
Terry Rozier,G,22023,1626179,22300484,"JAN 05, 2024",CHA @ CHI,L,36,5,17,0.294,1,7,0.143,4,4,1.0,1,3,4,7,1,0,3,2,15,-10,1,CHA,CHI,CHA,87,4.0,Rebounds,26,19,22,11
Terry Rozier,G,22023,1626179,22300484,"JAN 05, 2024",CHA @ CHI,L,36,5,17,0.294,1,7,0.143,4,4,1.0,1,3,4,7,1,0,3,2,15,-10,1,CHA,CHI,CHA,87,26.5,Pts+Rebs+Asts,26,19,22,11
Terry Rozier,G,22023,1626179,22300484,"JAN 05, 2024",CHA @ CHI,L,36,5,17,0.294,1,7,0.143,4,4,1.0,1,3,4,7,1,0,3,2,15,-10,1,CHA,CHI,CHA,87,6.0,Assists,26,19,22,11
Terry Rozier,G,22023,1626179,22300484,"JAN 05, 2024",CHA @ CHI,L,36,5,17,0.294,1,7,0.143,4,4,1.0,1,3,4,7,1,0,3,2,15,-10,1,CHA,CHI,CHA,87,31.0,Fantasy Score,26,19,22,11
Terry Rozier,G,22023,1626179,22300484,"JAN 05, 2024",CHA @ CHI,L,36,5,17,0.294,1,7,0.143,4,4,1.0,1,3,4,7,1,0,3,2,15,-10,1,CHA,CHI,CHA,87,20.5,Pts+Rebs,26,19,22,11
Terry Rozier,G,22023,1626179,22300484,"JAN 05, 2024",CHA @ CHI,L,36,5,17,0.294,1,7,0.143,4,4,1.0,1,3,4,7,1,0,3,2,15,-10,1,CHA,CHI,CHA,87,22.5,Pts+Asts,26,19,22,11
Terry Rozier,G,22023,1626179,22300484,"JAN 05, 2024",CHA @ CHI,L,36,5,17,0.294,1,7,0.143,4,4,1.0,1,3,4,7,1,0,3,2,15,-10,1,CHA,CHI,CHA,87,10.0,Rebs+Asts,26,19,22,11
Terry Rozier,G,22023,1626179,22300464,"JAN 02, 2024",CHA @ SAC,W,36,13,24,0.542,3,11,0.273,5,6,0.833,0,3,3,6,1,2,2,3,34,-1,1,CHA,SAC,CHA,111,16.5,Points,43,37,40,9
Terry Rozier,G,22023,1626179,22300464,"JAN 02, 2024",CHA @ SAC,W,36,13,24,0.542,3,11,0.273,5,6,0.833,0,3,3,6,1,2,2,3,34,-1,1,CHA,SAC,CHA,111,4.0,Rebounds,43,37,40,9
Terry Rozier,G,22023,1626179,22300464,"JAN 02, 2024",CHA @ SAC,W,36,13,24,0.542,3,11,0.273,5,6,0.833,0,3,3,6,1,2,2,3,34,-1,1,CHA,SAC,CHA,111,26.5,Pts+Rebs+Asts,43,37,40,9
Terry Rozier,G,22023,1626179,22300464,"JAN 02, 2024",CHA @ SAC,W,36,13,24,0.542,3,11,0.273,5,6,0.833,0,3,3,6,1,2,2,3,34,-1,1,CHA,SAC,CHA,111,6.0,Assists,43,37,40,9
Terry Rozier,G,22023,1626179,22300464,"JAN 02, 2024",CHA @ SAC,W,36,13,24,0.542,3,11,0.273,5,6,0.833,0,3,3,6,1,2,2,3,34,-1,1,CHA,SAC,CHA,111,31.0,Fantasy Score,43,37,40,9
Terry Rozier,G,22023,1626179,22300464,"JAN 02, 2024",CHA @ SAC,W,36,13,24,0.542,3,11,0.273,5,6,0.833,0,3,3,6,1,2,2,3,34,-1,1,CHA,SAC,CHA,111,20.5,Pts+Rebs,43,37,40,9
Terry Rozier,G,22023,1626179,22300464,"JAN 02, 2024",CHA @ SAC,W,36,13,24,0.542,3,11,0.273,5,6,0.833,0,3,3,6,1,2,2,3,34,-1,1,CHA,SAC,CHA,111,22.5,Pts+Asts,43,37,40,9
Terry Rozier,G,22023,1626179,22300464,"JAN 02, 2024",CHA @ SAC,W,36,13,24,0.542,3,11,0.273,5,6,0.833,0,3,3,6,1,2,2,3,34,-1,1,CHA,SAC,CHA,111,10.0,Rebs+Asts,43,37,40,9
Terry Rozier,G,22023,1626179,22300436,"DEC 29, 2023",CHA @ PHX,L,39,14,22,0.636,8,12,0.667,6,6,1.0,1,3,4,8,1,0,0,0,42,-1,1,CHA,PHX,CHA,119,16.5,Points,54,46,50,12
Terry Rozier,G,22023,1626179,22300436,"DEC 29, 2023",CHA @ PHX,L,39,14,22,0.636,8,12,0.667,6,6,1.0,1,3,4,8,1,0,0,0,42,-1,1,CHA,PHX,CHA,119,4.0,Rebounds,54,46,50,12
Terry Rozier,G,22023,1626179,22300436,"DEC 29, 2023",CHA @ PHX,L,39,14,22,0.636,8,12,0.667,6,6,1.0,1,3,4,8,1,0,0,0,42,-1,1,CHA,PHX,CHA,119,26.5,Pts+Rebs+Asts,54,46,50,12
Terry Rozier,G,22023,1626179,22300436,"DEC 29, 2023",CHA @ PHX,L,39,14,22,0.636,8,12,0.667,6,6,1.0,1,3,4,8,1,0,0,0,42,-1,1,CHA,PHX,CHA,119,6.0,Assists,54,46,50,12
Terry Rozier,G,22023,1626179,22300436,"DEC 29, 2023",CHA @ PHX,L,39,14,22,0.636,8,12,0.667,6,6,1.0,1,3,4,8,1,0,0,0,42,-1,1,CHA,PHX,CHA,119,31.0,Fantasy Score,54,46,50,12
Terry Rozier,G,22023,1626179,22300436,"DEC 29, 2023",CHA @ PHX,L,39,14,22,0.636,8,12,0.667,6,6,1.0,1,3,4,8,1,0,0,0,42,-1,1,CHA,PHX,CHA,119,20.5,Pts+Rebs,54,46,50,12
Terry Rozier,G,22023,1626179,22300436,"DEC 29, 2023",CHA @ PHX,L,39,14,22,0.636,8,12,0.667,6,6,1.0,1,3,4,8,1,0,0,0,42,-1,1,CHA,PHX,CHA,119,22.5,Pts+Asts,54,46,50,12
Terry Rozier,G,22023,1626179,22300436,"DEC 29, 2023",CHA @ PHX,L,39,14,22,0.636,8,12,0.667,6,6,1.0,1,3,4,8,1,0,0,0,42,-1,1,CHA,PHX,CHA,119,10.0,Rebs+Asts,54,46,50,12
Terry Rozier,G,22023,1626179,22300414,"DEC 26, 2023",CHA @ LAC,L,39,8,23,0.348,1,8,0.125,1,3,0.333,0,4,4,7,1,0,4,2,18,0,1,CHA,LAC,CHA,104,16.5,Points,29,22,25,11
Terry Rozier,G,22023,1626179,22300414,"DEC 26, 2023",CHA @ LAC,L,39,8,23,0.348,1,8,0.125,1,3,0.333,0,4,4,7,1,0,4,2,18,0,1,CHA,LAC,CHA,104,4.0,Rebounds,29,22,25,11
Terry Rozier,G,22023,1626179,22300414,"DEC 26, 2023",CHA @ LAC,L,39,8,23,0.348,1,8,0.125,1,3,0.333,0,4,4,7,1,0,4,2,18,0,1,CHA,LAC,CHA,104,26.5,Pts+Rebs+Asts,29,22,25,11
Terry Rozier,G,22023,1626179,22300414,"DEC 26, 2023",CHA @ LAC,L,39,8,23,0.348,1,8,0.125,1,3,0.333,0,4,4,7,1,0,4,2,18,0,1,CHA,LAC,CHA,104,6.0,Assists,29,22,25,11
Terry Rozier,G,22023,1626179,22300414,"DEC 26, 2023",CHA @ LAC,L,39,8,23,0.348,1,8,0.125,1,3,0.333,0,4,4,7,1,0,4,2,18,0,1,CHA,LAC,CHA,104,31.0,Fantasy Score,29,22,25,11
Terry Rozier,G,22023,1626179,22300414,"DEC 26, 2023",CHA @ LAC,L,39,8,23,0.348,1,8,0.125,1,3,0.333,0,4,4,7,1,0,4,2,18,0,1,CHA,LAC,CHA,104,20.5,Pts+Rebs,29,22,25,11
Terry Rozier,G,22023,1626179,22300414,"DEC 26, 2023",CHA @ LAC,L,39,8,23,0.348,1,8,0.125,1,3,0.333,0,4,4,7,1,0,4,2,18,0,1,CHA,LAC,CHA,104,22.5,Pts+Asts,29,22,25,11
Terry Rozier,G,22023,1626179,22300414,"DEC 26, 2023",CHA @ LAC,L,39,8,23,0.348,1,8,0.125,1,3,0.333,0,4,4,7,1,0,4,2,18,0,1,CHA,LAC,CHA,104,10.0,Rebs+Asts,29,22,25,11
Terry Rozier,G,22023,1626179,22300326,"DEC 15, 2023",CHA vs. NOP,L,39,11,25,0.44,4,11,0.364,4,4,1.0,0,4,4,6,3,0,2,0,30,-10,1,CHA,CHA,NOP,105,16.5,Points,40,34,36,10
Terry Rozier,G,22023,1626179,22300326,"DEC 15, 2023",CHA vs. NOP,L,39,11,25,0.44,4,11,0.364,4,4,1.0,0,4,4,6,3,0,2,0,30,-10,1,CHA,CHA,NOP,105,4.0,Rebounds,40,34,36,10
Terry Rozier,G,22023,1626179,22300326,"DEC 15, 2023",CHA vs. NOP,L,39,11,25,0.44,4,11,0.364,4,4,1.0,0,4,4,6,3,0,2,0,30,-10,1,CHA,CHA,NOP,105,26.5,Pts+Rebs+Asts,40,34,36,10
Terry Rozier,G,22023,1626179,22300326,"DEC 15, 2023",CHA vs. NOP,L,39,11,25,0.44,4,11,0.364,4,4,1.0,0,4,4,6,3,0,2,0,30,-10,1,CHA,CHA,NOP,105,6.0,Assists,40,34,36,10
Terry Rozier,G,22023,1626179,22300326,"DEC 15, 2023",CHA vs. NOP,L,39,11,25,0.44,4,11,0.364,4,4,1.0,0,4,4,6,3,0,2,0,30,-10,1,CHA,CHA,NOP,105,31.0,Fantasy Score,40,34,36,10
Terry Rozier,G,22023,1626179,22300326,"DEC 15, 2023",CHA vs. NOP,L,39,11,25,0.44,4,11,0.364,4,4,1.0,0,4,4,6,3,0,2,0,30,-10,1,CHA,CHA,NOP,105,20.5,Pts+Rebs,40,34,36,10
Terry Rozier,G,22023,1626179,22300326,"DEC 15, 2023",CHA vs. NOP,L,39,11,25,0.44,4,11,0.364,4,4,1.0,0,4,4,6,3,0,2,0,30,-10,1,CHA,CHA,NOP,105,22.5,Pts+Asts,40,34,36,10
Terry Rozier,G,22023,1626179,22300326,"DEC 15, 2023",CHA vs. NOP,L,39,11,25,0.44,4,11,0.364,4,4,1.0,0,4,4,6,3,0,2,0,30,-10,1,CHA,CHA,NOP,105,10.0,Rebs+Asts,40,34,36,10
Terry Rozier,G,22023,1626179,22300312,"DEC 13, 2023",CHA @ MIA,L,37,10,14,0.714,5,6,0.833,3,3,1.0,0,3,3,7,4,1,1,2,28,-15,1,CHA,MIA,CHA,104,16.5,Points,38,31,35,10
Terry Rozier,G,22023,1626179,22300312,"DEC 13, 2023",CHA @ MIA,L,37,10,14,0.714,5,6,0.833,3,3,1.0,0,3,3,7,4,1,1,2,28,-15,1,CHA,MIA,CHA,104,4.0,Rebounds,38,31,35,10
Terry Rozier,G,22023,1626179,22300312,"DEC 13, 2023",CHA @ MIA,L,37,10,14,0.714,5,6,0.833,3,3,1.0,0,3,3,7,4,1,1,2,28,-15,1,CHA,MIA,CHA,104,26.5,Pts+Rebs+Asts,38,31,35,10
Terry Rozier,G,22023,1626179,22300312,"DEC 13, 2023",CHA @ MIA,L,37,10,14,0.714,5,6,0.833,3,3,1.0,0,3,3,7,4,1,1,2,28,-15,1,CHA,MIA,CHA,104,6.0,Assists,38,31,35,10
Terry Rozier,G,22023,1626179,22300312,"DEC 13, 2023",CHA @ MIA,L,37,10,14,0.714,5,6,0.833,3,3,1.0,0,3,3,7,4,1,1,2,28,-15,1,CHA,MIA,CHA,104,31.0,Fantasy Score,38,31,35,10
Terry Rozier,G,22023,1626179,22300312,"DEC 13, 2023",CHA @ MIA,L,37,10,14,0.714,5,6,0.833,3,3,1.0,0,3,3,7,4,1,1,2,28,-15,1,CHA,MIA,CHA,104,20.5,Pts+Rebs,38,31,35,10
Terry Rozier,G,22023,1626179,22300312,"DEC 13, 2023",CHA @ MIA,L,37,10,14,0.714,5,6,0.833,3,3,1.0,0,3,3,7,4,1,1,2,28,-15,1,CHA,MIA,CHA,104,22.5,Pts+Asts,38,31,35,10
Terry Rozier,G,22023,1626179,22300312,"DEC 13, 2023",CHA @ MIA,L,37,10,14,0.714,5,6,0.833,3,3,1.0,0,3,3,7,4,1,1,2,28,-15,1,CHA,MIA,CHA,104,10.0,Rebs+Asts,38,31,35,10
Terry Rozier,G,22023,1626179,22300292,"DEC 11, 2023",CHA vs. MIA,L,39,10,17,0.588,8,13,0.615,6,7,0.857,1,1,2,13,0,0,3,4,34,4,1,CHA,CHA,MIA,114,16.5,Points,49,36,47,15
Terry Rozier,G,22023,1626179,22300292,"DEC 11, 2023",CHA vs. MIA,L,39,10,17,0.588,8,13,0.615,6,7,0.857,1,1,2,13,0,0,3,4,34,4,1,CHA,CHA,MIA,114,4.0,Rebounds,49,36,47,15
Terry Rozier,G,22023,1626179,22300292,"DEC 11, 2023",CHA vs. MIA,L,39,10,17,0.588,8,13,0.615,6,7,0.857,1,1,2,13,0,0,3,4,34,4,1,CHA,CHA,MIA,114,26.5,Pts+Rebs+Asts,49,36,47,15
Terry Rozier,G,22023,1626179,22300292,"DEC 11, 2023",CHA vs. MIA,L,39,10,17,0.588,8,13,0.615,6,7,0.857,1,1,2,13,0,0,3,4,34,4,1,CHA,CHA,MIA,114,6.0,Assists,49,36,47,15
Terry Rozier,G,22023,1626179,22300292,"DEC 11, 2023",CHA vs. MIA,L,39,10,17,0.588,8,13,0.615,6,7,0.857,1,1,2,13,0,0,3,4,34,4,1,CHA,CHA,MIA,114,31.0,Fantasy Score,49,36,47,15
Terry Rozier,G,22023,1626179,22300292,"DEC 11, 2023",CHA vs. MIA,L,39,10,17,0.588,8,13,0.615,6,7,0.857,1,1,2,13,0,0,3,4,34,4,1,CHA,CHA,MIA,114,20.5,Pts+Rebs,49,36,47,15
Terry Rozier,G,22023,1626179,22300292,"DEC 11, 2023",CHA vs. MIA,L,39,10,17,0.588,8,13,0.615,6,7,0.857,1,1,2,13,0,0,3,4,34,4,1,CHA,CHA,MIA,114,22.5,Pts+Asts,49,36,47,15
Terry Rozier,G,22023,1626179,22300292,"DEC 11, 2023",CHA vs. MIA,L,39,10,17,0.588,8,13,0.615,6,7,0.857,1,1,2,13,0,0,3,4,34,4,1,CHA,CHA,MIA,114,10.0,Rebs+Asts,49,36,47,15
Terry Rozier,G,22023,1626179,22301216,"DEC 08, 2023",CHA vs. TOR,W,40,7,15,0.467,2,5,0.4,5,5,1.0,0,2,2,13,0,0,2,5,21,5,1,CHA,CHA,TOR,119,16.5,Points,36,23,34,15
Terry Rozier,G,22023,1626179,22301216,"DEC 08, 2023",CHA vs. TOR,W,40,7,15,0.467,2,5,0.4,5,5,1.0,0,2,2,13,0,0,2,5,21,5,1,CHA,CHA,TOR,119,4.0,Rebounds,36,23,34,15
Terry Rozier,G,22023,1626179,22301216,"DEC 08, 2023",CHA vs. TOR,W,40,7,15,0.467,2,5,0.4,5,5,1.0,0,2,2,13,0,0,2,5,21,5,1,CHA,CHA,TOR,119,26.5,Pts+Rebs+Asts,36,23,34,15
Terry Rozier,G,22023,1626179,22301216,"DEC 08, 2023",CHA vs. TOR,W,40,7,15,0.467,2,5,0.4,5,5,1.0,0,2,2,13,0,0,2,5,21,5,1,CHA,CHA,TOR,119,6.0,Assists,36,23,34,15
Terry Rozier,G,22023,1626179,22301216,"DEC 08, 2023",CHA vs. TOR,W,40,7,15,0.467,2,5,0.4,5,5,1.0,0,2,2,13,0,0,2,5,21,5,1,CHA,CHA,TOR,119,31.0,Fantasy Score,36,23,34,15
Terry Rozier,G,22023,1626179,22301216,"DEC 08, 2023",CHA vs. TOR,W,40,7,15,0.467,2,5,0.4,5,5,1.0,0,2,2,13,0,0,2,5,21,5,1,CHA,CHA,TOR,119,20.5,Pts+Rebs,36,23,34,15
Terry Rozier,G,22023,1626179,22301216,"DEC 08, 2023",CHA vs. TOR,W,40,7,15,0.467,2,5,0.4,5,5,1.0,0,2,2,13,0,0,2,5,21,5,1,CHA,CHA,TOR,119,22.5,Pts+Asts,36,23,34,15
Terry Rozier,G,22023,1626179,22301216,"DEC 08, 2023",CHA vs. TOR,W,40,7,15,0.467,2,5,0.4,5,5,1.0,0,2,2,13,0,0,2,5,21,5,1,CHA,CHA,TOR,119,10.0,Rebs+Asts,36,23,34,15
Terry Rozier,G,22023,1626179,22301211,"DEC 06, 2023",CHA @ CHI,L,40,10,24,0.417,1,11,0.091,4,4,1.0,1,4,5,7,1,2,2,4,25,-11,1,CHA,CHI,CHA,100,16.5,Points,37,30,32,12
Terry Rozier,G,22023,1626179,22301211,"DEC 06, 2023",CHA @ CHI,L,40,10,24,0.417,1,11,0.091,4,4,1.0,1,4,5,7,1,2,2,4,25,-11,1,CHA,CHI,CHA,100,4.0,Rebounds,37,30,32,12
Terry Rozier,G,22023,1626179,22301211,"DEC 06, 2023",CHA @ CHI,L,40,10,24,0.417,1,11,0.091,4,4,1.0,1,4,5,7,1,2,2,4,25,-11,1,CHA,CHI,CHA,100,26.5,Pts+Rebs+Asts,37,30,32,12
Terry Rozier,G,22023,1626179,22301211,"DEC 06, 2023",CHA @ CHI,L,40,10,24,0.417,1,11,0.091,4,4,1.0,1,4,5,7,1,2,2,4,25,-11,1,CHA,CHI,CHA,100,6.0,Assists,37,30,32,12
Terry Rozier,G,22023,1626179,22301211,"DEC 06, 2023",CHA @ CHI,L,40,10,24,0.417,1,11,0.091,4,4,1.0,1,4,5,7,1,2,2,4,25,-11,1,CHA,CHI,CHA,100,31.0,Fantasy Score,37,30,32,12
Terry Rozier,G,22023,1626179,22301211,"DEC 06, 2023",CHA @ CHI,L,40,10,24,0.417,1,11,0.091,4,4,1.0,1,4,5,7,1,2,2,4,25,-11,1,CHA,CHI,CHA,100,20.5,Pts+Rebs,37,30,32,12
Terry Rozier,G,22023,1626179,22301211,"DEC 06, 2023",CHA @ CHI,L,40,10,24,0.417,1,11,0.091,4,4,1.0,1,4,5,7,1,2,2,4,25,-11,1,CHA,CHI,CHA,100,22.5,Pts+Asts,37,30,32,12
Terry Rozier,G,22023,1626179,22301211,"DEC 06, 2023",CHA @ CHI,L,40,10,24,0.417,1,11,0.091,4,4,1.0,1,4,5,7,1,2,2,4,25,-11,1,CHA,CHI,CHA,100,10.0,Rebs+Asts,37,30,32,12
Terry Rozier,G,22023,1626179,22300281,"DEC 02, 2023",CHA vs. MIN,L,35,8,20,0.4,3,7,0.429,4,5,0.8,1,5,6,7,2,0,1,4,23,-6,1,CHA,CHA,MIN,117,16.5,Points,36,29,30,13
Terry Rozier,G,22023,1626179,22300281,"DEC 02, 2023",CHA vs. MIN,L,35,8,20,0.4,3,7,0.429,4,5,0.8,1,5,6,7,2,0,1,4,23,-6,1,CHA,CHA,MIN,117,4.0,Rebounds,36,29,30,13
Terry Rozier,G,22023,1626179,22300281,"DEC 02, 2023",CHA vs. MIN,L,35,8,20,0.4,3,7,0.429,4,5,0.8,1,5,6,7,2,0,1,4,23,-6,1,CHA,CHA,MIN,117,26.5,Pts+Rebs+Asts,36,29,30,13
Terry Rozier,G,22023,1626179,22300281,"DEC 02, 2023",CHA vs. MIN,L,35,8,20,0.4,3,7,0.429,4,5,0.8,1,5,6,7,2,0,1,4,23,-6,1,CHA,CHA,MIN,117,6.0,Assists,36,29,30,13
Terry Rozier,G,22023,1626179,22300281,"DEC 02, 2023",CHA vs. MIN,L,35,8,20,0.4,3,7,0.429,4,5,0.8,1,5,6,7,2,0,1,4,23,-6,1,CHA,CHA,MIN,117,31.0,Fantasy Score,36,29,30,13
Terry Rozier,G,22023,1626179,22300281,"DEC 02, 2023",CHA vs. MIN,L,35,8,20,0.4,3,7,0.429,4,5,0.8,1,5,6,7,2,0,1,4,23,-6,1,CHA,CHA,MIN,117,20.5,Pts+Rebs,36,29,30,13
Terry Rozier,G,22023,1626179,22300281,"DEC 02, 2023",CHA vs. MIN,L,35,8,20,0.4,3,7,0.429,4,5,0.8,1,5,6,7,2,0,1,4,23,-6,1,CHA,CHA,MIN,117,22.5,Pts+Asts,36,29,30,13
Terry Rozier,G,22023,1626179,22300281,"DEC 02, 2023",CHA vs. MIN,L,35,8,20,0.4,3,7,0.429,4,5,0.8,1,5,6,7,2,0,1,4,23,-6,1,CHA,CHA,MIN,117,10.0,Rebs+Asts,36,29,30,13
Terry Rozier,G,22023,1626179,22300266,"NOV 30, 2023",CHA @ BKN,W,40,13,25,0.52,7,9,0.778,4,4,1.0,0,4,4,13,2,0,3,1,37,2,1,CHA,BKN,CHA,129,16.5,Points,54,41,50,17
Terry Rozier,G,22023,1626179,22300266,"NOV 30, 2023",CHA @ BKN,W,40,13,25,0.52,7,9,0.778,4,4,1.0,0,4,4,13,2,0,3,1,37,2,1,CHA,BKN,CHA,129,4.0,Rebounds,54,41,50,17
Terry Rozier,G,22023,1626179,22300266,"NOV 30, 2023",CHA @ BKN,W,40,13,25,0.52,7,9,0.778,4,4,1.0,0,4,4,13,2,0,3,1,37,2,1,CHA,BKN,CHA,129,26.5,Pts+Rebs+Asts,54,41,50,17
Terry Rozier,G,22023,1626179,22300266,"NOV 30, 2023",CHA @ BKN,W,40,13,25,0.52,7,9,0.778,4,4,1.0,0,4,4,13,2,0,3,1,37,2,1,CHA,BKN,CHA,129,6.0,Assists,54,41,50,17
Terry Rozier,G,22023,1626179,22300266,"NOV 30, 2023",CHA @ BKN,W,40,13,25,0.52,7,9,0.778,4,4,1.0,0,4,4,13,2,0,3,1,37,2,1,CHA,BKN,CHA,129,31.0,Fantasy Score,54,41,50,17
Terry Rozier,G,22023,1626179,22300266,"NOV 30, 2023",CHA @ BKN,W,40,13,25,0.52,7,9,0.778,4,4,1.0,0,4,4,13,2,0,3,1,37,2,1,CHA,BKN,CHA,129,20.5,Pts+Rebs,54,41,50,17
Terry Rozier,G,22023,1626179,22300266,"NOV 30, 2023",CHA @ BKN,W,40,13,25,0.52,7,9,0.778,4,4,1.0,0,4,4,13,2,0,3,1,37,2,1,CHA,BKN,CHA,129,22.5,Pts+Asts,54,41,50,17
Terry Rozier,G,22023,1626179,22300266,"NOV 30, 2023",CHA @ BKN,W,40,13,25,0.52,7,9,0.778,4,4,1.0,0,4,4,13,2,0,3,1,37,2,1,CHA,BKN,CHA,129,10.0,Rebs+Asts,54,41,50,17
Paul George,G,22023,202331,22300099,"OCT 29, 2023",LAC vs. SAS,W,28,8,17,0.471,2,7,0.286,1,1,1.0,1,3,4,5,5,0,1,1,19,24,1,LAC,LAC,SAS,123,,,28,23,24,9
Paul George,G,22023,202331,22300085,"OCT 27, 2023",LAC @ UTA,L,38,9,17,0.529,3,9,0.333,15,15,1.0,1,3,4,1,0,0,2,1,36,3,1,LAC,UTA,LAC,118,,,41,40,37,5
Paul George,G,22023,202331,22300074,"OCT 25, 2023",LAC vs. POR,W,32,11,17,0.647,4,7,0.571,1,1,1.0,0,3,3,6,3,0,4,2,27,23,1,LAC,LAC,POR,123,,,36,30,33,9
Paul George,G,22023,202331,22300731,"FEB 07, 2024",LAC vs. NOP,L,28,3,15,0.2,0,8,0.0,1,1,1.0,0,1,1,4,2,0,3,2,7,-4,1,LAC,LAC,NOP,106,,,12,8,11,5
Paul George,G,22023,202331,22300688,"FEB 02, 2024",LAC @ DET,W,27,8,16,0.5,2,5,0.4,0,0,0.0,0,4,4,7,3,1,0,3,18,13,1,LAC,DET,LAC,136,,,29,22,25,11
Paul George,G,22023,202331,22300658,"JAN 29, 2024",LAC @ CLE,L,27,3,11,0.273,0,5,0.0,7,8,0.875,1,4,5,3,2,1,2,6,13,4,1,LAC,CLE,LAC,108,,,21,18,16,8
Paul George,G,22023,202331,22300646,"JAN 27, 2024",LAC @ BOS,W,22,5,11,0.455,3,6,0.5,4,4,1.0,1,5,6,1,2,0,1,2,17,23,1,LAC,BOS,LAC,115,,,24,23,18,7
Paul George,G,22023,202331,22300637,"JAN 26, 2024",LAC @ TOR,W,28,6,15,0.4,3,9,0.333,6,7,0.857,0,2,2,1,1,2,2,0,21,13,1,LAC,TOR,LAC,127,,,24,23,22,3
Paul George,G,22023,202331,22300537,"JAN 12, 2024",LAC @ MEM,W,35,12,18,0.667,7,10,0.7,6,6,1.0,0,3,3,1,2,0,4,3,37,18,1,LAC,MEM,LAC,128,,,41,40,38,4
Paul George,G,22023,202331,22300511,"JAN 08, 2024",LAC vs. PHX,W,31,10,19,0.526,4,9,0.444,1,2,0.5,1,6,7,0,1,0,1,2,25,21,1,LAC,LAC,PHX,138,,,32,32,25,7
Paul George,G,22023,202331,22300486,"JAN 05, 2024",LAC @ NOP,W,30,9,15,0.6,6,10,0.6,0,0,0.0,0,7,7,1,0,1,2,2,24,22,1,LAC,NOP,LAC,111,,,32,31,25,8
Paul George,G,22023,202331,22300458,"JAN 01, 2024",LAC vs. MIA,W,34,7,14,0.5,3,8,0.375,6,6,1.0,0,3,3,2,1,0,3,4,23,14,1,LAC,LAC,MIA,121,,,28,26,25,5
Paul George,G,22023,202331,22300389,"DEC 23, 2023",LAC vs. BOS,L,30,9,17,0.529,3,7,0.429,0,0,0.0,1,2,3,2,1,2,1,1,21,-27,1,LAC,LAC,BOS,108,,,26,24,23,5
Paul George,G,22023,202331,22300379,"DEC 21, 2023",LAC @ OKC,L,29,7,14,0.5,5,8,0.625,3,3,1.0,0,4,4,4,1,1,1,4,22,-13,1,LAC,OKC,LAC,115,,,30,26,26,8
Paul George,G,22023,202331,22300350,"DEC 18, 2023",LAC @ IND,W,31,9,21,0.429,5,11,0.455,4,4,1.0,0,3,3,4,1,1,1,3,27,22,1,LAC,IND,LAC,151,,,34,30,31,7
Paul George,G,22023,202331,22300343,"DEC 16, 2023",LAC vs. NYK,W,31,11,18,0.611,3,6,0.5,0,0,0.0,0,4,4,7,2,0,2,4,25,26,1,LAC,LAC,NYK,144,,,36,29,32,11
Paul George,G,22023,202331,22300618,"JAN 23, 2024",LAC vs. LAL,W,30,8,12,0.667,1,2,0.5,0,0,0.0,1,4,5,3,0,1,4,2,17,7,1,LAC,LAC,LAL,127,,,25,22,20,8
Paul George,G,22023,202331,22300438,"DEC 29, 2023",LAC vs. MEM,W,36,8,21,0.381,2,8,0.25,5,6,0.833,1,6,7,3,1,0,4,6,23,2,1,LAC,LAC,MEM,117,,,33,30,26,10
Paul George,G,22023,202331,22300414,"DEC 26, 2023",LAC vs. CHA,W,37,10,25,0.4,5,11,0.455,0,0,0.0,2,2,4,4,0,0,3,4,25,9,1,LAC,LAC,CHA,113,,,33,29,29,8
Paul George,G,22023,202331,22300309,"DEC 12, 2023",LAC vs. SAC,W,16,3,7,0.429,2,5,0.4,1,1,1.0,0,6,6,1,2,0,3,0,9,14,1,LAC,LAC,SAC,117,,,16,15,10,7
Paul George,G,22023,202331,22300304,"DEC 11, 2023",LAC vs. POR,W,41,7,17,0.412,2,8,0.25,4,4,1.0,3,5,8,8,1,1,1,4,20,3,1,LAC,LAC,POR,132,,,36,28,28,16
Paul George,G,22023,202331,22301225,"DEC 08, 2023",LAC @ UTA,W,37,8,13,0.615,2,5,0.4,2,3,0.667,0,3,3,2,6,1,1,2,20,14,1,LAC,UTA,LAC,117,,,25,23,22,5
Paul George,G,22023,202331,22301215,"DEC 06, 2023",LAC vs. DEN,W,38,8,20,0.4,5,9,0.556,4,4,1.0,1,7,8,1,0,1,2,1,25,11,1,LAC,LAC,DEN,111,,,34,33,26,9
Paul George,G,22023,202331,22300280,"DEC 02, 2023",LAC vs. GSW,W,38,8,17,0.471,4,8,0.5,5,5,1.0,0,6,6,6,1,0,1,5,25,5,1,LAC,LAC,GSW,113,,,37,31,31,12
Paul George,G,22023,202331,22300273,"NOV 30, 2023",LAC @ GSW,L,37,6,18,0.333,3,10,0.3,0,0,0.0,0,1,1,10,0,0,1,5,15,-6,1,LAC,GSW,LAC,114,,,26,16,25,11
Paul George,G,22023,202331,22300264,"NOV 29, 2023",LAC @ SAC,W,40,7,18,0.389,4,9,0.444,1,2,0.5,0,3,3,7,0,0,1,1,19,14,1,LAC,SAC,LAC,131,,,29,22,26,10
Paul George,G,22023,202331,22300244,"NOV 25, 2023",LAC vs. DAL,W,36,9,19,0.474,2,5,0.4,5,5,1.0,1,8,9,4,0,0,1,4,25,19,1,LAC,LAC,DAL,107,,,38,34,29,13
Paul George,G,22023,202331,22300014,"NOV 10, 2023",LAC @ DAL,L,23,3,12,0.25,1,7,0.143,1,1,1.0,0,3,3,2,1,0,2,3,8,-14,1,LAC,DAL,LAC,126,,,13,11,10,5
Paul George,G,22023,202331,22300151,"NOV 06, 2023",LAC @ NYK,L,34,2,11,0.182,1,6,0.167,5,5,1.0,0,7,7,3,3,0,4,2,10,-7,1,LAC,NYK,LAC,97,,,20,17,13,10
Paul George,G,22023,202331,22300127,"NOV 01, 2023",LAC @ LAL,L,37,11,16,0.688,6,9,0.667,7,8,0.875,0,6,6,1,2,0,3,6,35,22,1,LAC,LAL,LAC,125,,,42,41,36,7
Paul George,G,22023,202331,22300114,"OCT 31, 2023",LAC vs. ORL,W,33,8,17,0.471,6,9,0.667,5,6,0.833,1,6,7,7,2,0,3,2,27,15,1,LAC,LAC,ORL,118,,,41,34,34,14
Paul George,G,22023,202331,22300749,"FEB 10, 2024",LAC vs. DET,W,36,14,24,0.583,4,13,0.308,1,1,1.0,0,5,5,3,3,0,1,3,33,2,1,LAC,LAC,DET,112,,,41,38,36,8
Paul George,G,22023,202331,22300716,"FEB 05, 2024",LAC @ ATL,W,32,7,13,0.538,3,5,0.6,1,2,0.5,0,3,3,5,2,0,1,3,18,12,1,LAC,ATL,LAC,149,,,26,21,23,8
Paul George,G,22023,202331,22300708,"FEB 04, 2024",LAC @ MIA,W,33,3,13,0.231,3,10,0.3,6,6,1.0,0,7,7,4,1,1,4,2,15,7,1,LAC,MIA,LAC,103,,,26,22,19,11
Paul George,G,22023,202331,22300600,"JAN 21, 2024",LAC vs. BKN,W,36,5,17,0.294,2,7,0.286,0,0,0.0,1,6,7,1,1,0,1,3,12,17,1,LAC,LAC,BKN,125,,,20,19,13,8
Paul George,G,22023,202331,22300568,"JAN 16, 2024",LAC vs. OKC,W,34,15,24,0.625,6,12,0.5,2,4,0.5,0,7,7,5,3,0,0,2,38,13,1,LAC,LAC,OKC,128,,,50,45,43,12
Paul George,G,22023,202331,22300553,"JAN 14, 2024",LAC @ MIN,L,42,5,19,0.263,4,13,0.308,2,2,1.0,0,4,4,3,0,0,1,2,16,-6,1,LAC,MIN,LAC,105,,,23,20,19,7
Paul George,G,22023,202331,22300526,"JAN 10, 2024",LAC vs. TOR,W,38,12,22,0.545,5,9,0.556,0,0,0.0,0,7,7,6,2,1,0,4,29,15,1,LAC,LAC,TOR,126,,,42,36,35,13
Paul George,G,22023,202331,22300505,"JAN 07, 2024",LAC @ LAL,L,38,8,18,0.444,4,11,0.364,2,2,1.0,0,4,4,3,5,1,3,4,22,3,1,LAC,LAL,LAC,103,,,29,26,25,7
Paul George,G,22023,202331,22300473,"JAN 03, 2024",LAC @ PHX,W,37,8,14,0.571,5,10,0.5,12,14,0.857,2,5,7,3,2,0,1,3,33,12,1,LAC,PHX,LAC,131,,,43,40,36,10
Paul George,G,22023,202331,22300235,"NOV 22, 2023",LAC @ SAS,W,36,8,23,0.348,4,12,0.333,4,4,1.0,1,7,8,3,2,0,2,3,24,7,1,LAC,SAS,LAC,109,,,35,32,27,11
Paul George,G,22023,202331,22300223,"NOV 20, 2023",LAC @ SAS,W,32,11,16,0.688,4,8,0.5,2,2,1.0,0,5,5,6,1,0,2,1,28,23,1,LAC,SAS,LAC,124,,,39,33,34,11
Paul George,G,22023,202331,22300179,"NOV 12, 2023",LAC vs. MEM,L,37,8,16,0.5,3,7,0.429,7,9,0.778,1,6,7,7,2,0,7,5,26,2,1,LAC,LAC,MEM,101,,,40,33,33,14
Paul George,G,22023,202331,22300257,"NOV 27, 2023",LAC vs. DEN,L,37,2,13,0.154,0,4,0.0,2,2,1.0,3,5,8,4,1,1,3,5,6,-11,1,LAC,LAC,DEN,104,,,18,14,10,12
Paul George,G,22023,202331,22300052,"NOV 24, 2023",LAC vs. NOP,L,39,14,30,0.467,4,12,0.333,2,3,0.667,1,7,8,2,0,0,2,3,34,-9,1,LAC,LAC,NOP,106,,,44,42,36,10
Paul George,G,22023,202331,22300037,"NOV 17, 2023",LAC vs. HOU,W,40,8,22,0.364,4,10,0.4,3,3,1.0,1,7,8,3,2,1,3,2,23,9,1,LAC,LAC,HOU,106,,,34,31,26,11
Paul George,G,22023,202331,22300024,"NOV 14, 2023",LAC @ DEN,L,40,13,26,0.5,4,11,0.364,5,5,1.0,0,7,7,3,3,0,1,4,35,-5,1,LAC,DEN,LAC,108,,,45,42,38,10
Paul George,G,22023,202331,22300160,"NOV 08, 2023",LAC @ BKN,L,39,7,20,0.35,2,10,0.2,8,8,1.0,1,6,7,1,3,1,3,2,24,-7,1,LAC,BKN,LAC,93,,,32,31,25,8
Paolo Banchero,F,22023,1631094,22300752,"FEB 10, 2024",ORL vs. CHI,W,43,5,13,0.385,2,6,0.333,7,8,0.875,1,6,7,8,1,1,3,1,19,1,1,ORL,ORL,CHI,114,,,34,26,27,15
Paolo Banchero,F,22023,1631094,22300734,"FEB 08, 2024",ORL vs. SAS,W,31,7,12,0.583,1,3,0.333,1,4,0.25,0,5,5,6,2,0,1,0,16,16,1,ORL,ORL,SAS,127,,,27,21,22,11
Paolo Banchero,F,22023,1631094,22300721,"FEB 06, 2024",ORL @ MIA,L,34,7,16,0.438,1,4,0.25,8,12,0.667,1,8,9,7,2,0,2,2,23,-23,1,ORL,MIA,ORL,95,,,39,32,30,16
Paolo Banchero,F,22023,1631094,22300704,"FEB 04, 2024",ORL @ DET,W,35,6,16,0.375,2,5,0.4,6,6,1.0,1,5,6,7,1,0,1,2,20,8,1,ORL,DET,ORL,111,,,33,26,27,13
Paolo Banchero,F,22023,1631094,22300694,"FEB 02, 2024",ORL @ MIN,W,35,10,20,0.5,1,1,1.0,2,2,1.0,0,1,1,6,1,0,3,2,23,-1,1,ORL,MIN,ORL,108,,,30,24,29,7
Paolo Banchero,F,22023,1631094,22300681,"JAN 31, 2024",ORL @ SAS,W,36,9,18,0.5,2,4,0.5,5,7,0.714,2,7,9,7,2,0,1,1,25,13,1,ORL,SAS,ORL,108,,,41,34,32,16
Paolo Banchero,F,22023,1631094,22300666,"JAN 29, 2024",ORL @ DAL,L,39,13,25,0.52,4,8,0.5,6,11,0.545,3,6,9,7,2,0,3,3,36,3,1,ORL,DAL,ORL,129,,,52,45,43,16
Paolo Banchero,F,22023,1631094,22300655,"JAN 28, 2024",ORL vs. PHX,W,36,9,18,0.5,2,5,0.4,6,9,0.667,1,3,4,7,0,0,2,1,26,11,1,ORL,ORL,PHX,113,,,37,30,33,11
Paolo Banchero,F,22023,1631094,22300638,"JAN 26, 2024",ORL @ MEM,L,34,8,20,0.4,2,9,0.222,9,11,0.818,0,5,5,6,2,1,3,3,27,0,1,ORL,MEM,ORL,106,,,38,32,33,11
Paolo Banchero,F,22023,1631094,22300607,"JAN 22, 2024",ORL vs. CLE,L,29,6,14,0.429,1,4,0.25,5,9,0.556,0,3,3,6,0,0,2,2,18,-22,1,ORL,ORL,CLE,99,,,27,21,24,9
Paolo Banchero,F,22023,1631094,22300601,"JAN 21, 2024",ORL vs. MIA,W,31,7,14,0.5,3,5,0.6,3,5,0.6,0,10,10,2,0,0,2,2,20,17,1,ORL,ORL,MIA,105,,,32,30,22,12
Paolo Banchero,F,22023,1631094,22300585,"JAN 19, 2024",ORL vs. PHI,L,32,5,12,0.417,0,1,0.0,4,4,1.0,1,7,8,6,0,1,3,0,14,-12,1,ORL,ORL,PHI,109,,,28,22,20,14
Paolo Banchero,F,22023,1631094,22300570,"JAN 17, 2024",ORL @ ATL,L,38,8,25,0.32,1,5,0.2,9,11,0.818,0,4,4,4,2,1,1,1,26,-10,1,ORL,ATL,ORL,104,,,34,30,30,8
Paolo Banchero,F,22023,1631094,22300557,"JAN 15, 2024",ORL @ NYK,W,33,9,19,0.474,0,2,0.0,2,5,0.4,1,5,6,3,0,0,2,1,20,-12,1,ORL,NYK,ORL,98,,,29,26,23,9
Paolo Banchero,F,22023,1631094,22300546,"JAN 13, 2024",ORL @ OKC,L,36,8,19,0.421,0,4,0.0,4,7,0.571,2,7,9,8,0,2,2,4,20,-7,1,ORL,OKC,ORL,100,,,37,29,28,17
Paolo Banchero,F,22023,1631094,22300535,"JAN 12, 2024",ORL @ MIA,L,36,10,26,0.385,1,7,0.143,4,6,0.667,3,5,8,6,0,0,4,2,25,10,1,ORL,MIA,ORL,96,,,39,33,31,14
Paolo Banchero,F,22023,1631094,22300513,"JAN 09, 2024",ORL vs. MIN,L,35,8,22,0.364,1,4,0.25,1,4,0.25,0,2,2,3,3,1,4,4,18,-30,1,ORL,ORL,MIN,92,,,23,20,21,5
Paolo Banchero,F,22023,1631094,22300499,"JAN 07, 2024",ORL vs. ATL,W,45,13,29,0.448,4,7,0.571,5,7,0.714,1,9,10,4,3,1,2,2,35,18,1,ORL,ORL,ATL,117,,,49,45,39,14
Paolo Banchero,F,22023,1631094,22300488,"JAN 05, 2024",ORL @ DEN,W,41,8,21,0.381,1,4,0.25,15,19,0.789,1,9,10,11,3,0,5,2,32,2,1,ORL,DEN,ORL,122,,,53,42,43,21
Paolo Banchero,F,22023,1631094,22300463,"JAN 02, 2024",ORL @ GSW,L,34,8,20,0.4,3,8,0.375,8,11,0.727,4,8,12,6,2,1,5,4,27,-8,1,ORL,GSW,ORL,115,,,45,39,33,18
Paolo Banchero,F,22023,1631094,22300450,"DEC 31, 2023",ORL @ PHX,L,37,12,23,0.522,2,6,0.333,2,2,1.0,0,9,9,7,0,1,3,1,28,-6,1,ORL,PHX,ORL,107,,,44,37,35,16
Paolo Banchero,F,22023,1631094,22300429,"DEC 29, 2023",ORL vs. NYK,W,36,9,19,0.474,2,6,0.333,9,12,0.75,1,9,10,4,1,1,2,3,29,4,1,ORL,ORL,NYK,117,,,43,39,33,14
Paolo Banchero,F,22023,1631094,22300415,"DEC 27, 2023",ORL vs. PHI,L,38,6,21,0.286,1,8,0.125,6,7,0.857,0,9,9,4,1,1,1,0,19,-18,1,ORL,ORL,PHI,92,,,32,28,23,13
Paolo Banchero,F,22023,1631094,22300407,"DEC 26, 2023",ORL @ WAS,W,38,10,22,0.455,0,1,0.0,4,8,0.5,1,2,3,8,1,1,3,1,24,0,1,ORL,WAS,ORL,127,,,35,27,32,11
Paolo Banchero,F,22023,1631094,22300391,"DEC 23, 2023",ORL @ IND,W,36,11,20,0.55,0,0,0.0,12,16,0.75,1,6,7,4,1,0,3,1,34,-2,1,ORL,IND,ORL,117,,,45,41,38,11
Paolo Banchero,F,22023,1631094,22300378,"DEC 21, 2023",ORL @ MIL,L,34,6,17,0.353,3,5,0.6,8,10,0.8,0,7,7,4,0,1,2,4,23,-10,1,ORL,MIL,ORL,114,,,34,30,27,11
Paolo Banchero,F,22023,1631094,22300366,"DEC 20, 2023",ORL vs. MIA,L,34,2,12,0.167,0,3,0.0,6,8,0.75,0,8,8,8,1,0,3,1,10,-22,1,ORL,ORL,MIA,106,,,26,18,18,16
Paolo Banchero,F,22023,1631094,22300344,"DEC 17, 2023",ORL @ BOS,L,36,14,30,0.467,4,10,0.4,4,6,0.667,2,8,10,1,2,0,4,0,36,-11,1,ORL,BOS,ORL,97,,,47,46,37,11
Paolo Banchero,F,22023,1631094,22300329,"DEC 15, 2023",ORL @ BOS,L,32,5,17,0.294,1,4,0.25,3,6,0.5,1,3,4,5,0,1,5,1,14,-13,1,ORL,BOS,ORL,111,,,23,18,19,9
Paolo Banchero,F,22023,1631094,22300294,"DEC 11, 2023",ORL vs. CLE,W,36,9,21,0.429,0,3,0.0,2,3,0.667,4,6,10,4,1,0,8,0,20,6,1,ORL,ORL,CLE,104,,,34,30,24,14
Paolo Banchero,F,22023,1631094,22301217,"DEC 08, 2023",ORL vs. DET,W,30,9,17,0.529,0,3,0.0,6,7,0.857,0,4,4,2,2,0,0,3,24,25,1,ORL,ORL,DET,123,,,30,28,26,6
Paolo Banchero,F,22023,1631094,22301205,"DEC 06, 2023",ORL @ CLE,L,38,16,26,0.615,1,5,0.2,9,12,0.75,1,5,6,1,0,2,3,3,42,2,1,ORL,CLE,ORL,111,,,49,48,43,7
Paolo Banchero,F,22023,1631094,22300282,"DEC 02, 2023",ORL @ BKN,L,34,6,15,0.4,0,2,0.0,7,9,0.778,1,9,10,8,1,0,1,3,19,-16,1,ORL,BKN,ORL,101,,,37,29,27,18
Paolo Banchero,F,22023,1631094,22300274,"DEC 01, 2023",ORL vs. WAS,W,38,11,20,0.55,3,4,0.75,3,3,1.0,3,10,13,7,0,0,2,2,28,1,1,ORL,ORL,WAS,130,,,48,41,35,20
Paolo Banchero,F,22023,1631094,22300259,"NOV 29, 2023",ORL vs. WAS,W,27,2,8,0.25,0,0,0.0,2,3,0.667,1,3,4,4,0,0,4,2,6,8,1,ORL,ORL,WAS,139,,,14,10,10,8
Paolo Banchero,F,22023,1631094,22300248,"NOV 26, 2023",ORL vs. CHA,W,37,9,18,0.5,2,5,0.4,3,6,0.5,0,7,7,8,2,0,2,2,23,8,1,ORL,ORL,CHA,130,,,38,30,31,15
Paolo Banchero,F,22023,1631094,22300043,"NOV 24, 2023",ORL vs. BOS,W,35,10,16,0.625,2,6,0.333,1,2,0.5,1,6,7,5,0,0,3,4,23,7,1,ORL,ORL,BOS,113,,,35,30,28,12
Paolo Banchero,F,22023,1631094,22300226,"NOV 22, 2023",ORL vs. DEN,W,35,8,14,0.571,4,5,0.8,3,5,0.6,1,2,3,4,1,3,3,1,23,-4,1,ORL,ORL,DEN,124,,,30,26,27,7
Paolo Banchero,F,22023,1631094,22300038,"NOV 21, 2023",ORL vs. TOR,W,32,10,20,0.5,2,3,0.667,3,3,1.0,1,4,5,3,0,1,3,2,25,14,1,ORL,ORL,TOR,126,,,33,30,28,8
Paolo Banchero,F,22023,1631094,22300209,"NOV 19, 2023",ORL @ IND,W,27,9,14,0.643,0,0,0.0,6,7,0.857,1,2,3,0,1,2,1,1,24,28,1,ORL,IND,ORL,128,,,27,27,24,3
Paolo Banchero,F,22023,1631094,22300033,"NOV 17, 2023",ORL @ CHI,W,32,6,14,0.429,0,1,0.0,1,4,0.25,3,5,8,4,0,1,7,3,13,0,1,ORL,CHI,ORL,103,,,25,21,17,12
Paolo Banchero,F,22023,1631094,22300196,"NOV 15, 2023",ORL @ CHI,W,33,4,12,0.333,2,4,0.5,7,10,0.7,1,8,9,3,1,0,1,0,17,-8,1,ORL,CHI,ORL,96,,,29,26,20,12
Paolo Banchero,F,22023,1631094,22300020,"NOV 14, 2023",ORL @ BKN,L,35,6,15,0.4,4,7,0.571,3,6,0.5,0,6,6,3,2,1,2,0,19,-16,1,ORL,BKN,ORL,104,,,28,25,22,9
Paolo Banchero,F,22023,1631094,22300173,"NOV 11, 2023",ORL vs. MIL,W,38,10,22,0.455,2,5,0.4,4,5,0.8,3,9,12,5,1,0,3,2,26,10,1,ORL,ORL,MIL,112,,,43,38,31,17
Paolo Banchero,F,22023,1631094,22300172,"NOV 09, 2023",ORL vs. ATL,L,34,7,14,0.5,1,3,0.333,2,4,0.5,4,4,8,4,1,0,5,4,17,-5,1,ORL,ORL,ATL,119,,,29,25,21,12
Paolo Banchero,F,22023,1631094,22300147,"NOV 06, 2023",ORL vs. DAL,L,37,8,18,0.444,0,1,0.0,6,6,1.0,1,4,5,6,0,0,6,5,22,-15,1,ORL,ORL,DAL,102,,,33,27,28,11
Paolo Banchero,F,22023,1631094,22300134,"NOV 04, 2023",ORL vs. LAL,W,34,9,15,0.6,2,4,0.5,5,7,0.714,1,6,7,10,1,1,4,2,25,23,1,ORL,ORL,LAL,120,,,42,32,35,17
Paolo Banchero,F,22023,1631094,22300130,"NOV 02, 2023",ORL @ UTA,W,36,9,13,0.692,1,2,0.5,11,15,0.733,2,7,9,5,3,2,6,4,30,-5,1,ORL,UTA,ORL,115,,,44,39,35,14
Paolo Banchero,F,22023,1631094,22300114,"OCT 31, 2023",ORL @ LAC,L,32,5,13,0.385,1,3,0.333,4,8,0.5,0,4,4,4,4,0,3,3,15,-15,1,ORL,LAC,ORL,102,,,23,19,19,8
Paolo Banchero,F,22023,1631094,22300111,"OCT 30, 2023",ORL @ LAL,L,30,4,14,0.286,1,5,0.2,0,2,0.0,1,4,5,5,0,0,2,3,9,-12,1,ORL,LAL,ORL,103,,,19,14,14,10
Paolo Banchero,F,22023,1631094,22300086,"OCT 27, 2023",ORL @ POR,W,35,5,12,0.417,0,0,0.0,4,9,0.444,2,5,7,4,2,0,3,1,14,2,1,ORL,POR,ORL,102,,,25,21,18,11
Paolo Banchero,F,22023,1631094,22300066,"OCT 25, 2023",ORL vs. HOU,W,28,3,6,0.5,0,1,0.0,6,7,0.857,0,5,5,5,1,0,1,2,12,11,1,ORL,ORL,HOU,116,,,22,17,17,10
Paolo Banchero,F,22023,1631094,22300476,"JAN 03, 2024",ORL @ SAC,L,45,13,25,0.52,6,9,0.667,11,14,0.786,1,3,4,5,0,0,8,4,43,-2,1,ORL,SAC,ORL,135,,,52,47,48,9
Anfernee Simons,G,22023,1629014,22300712,"FEB 04, 2024",POR @ DEN,L,39,8,18,0.444,4,8,0.5,6,6,1.0,0,6,6,9,1,0,4,0,26,-1,1,POR,DEN,POR,103,,,41,32,35,15
Anfernee Simons,G,22023,1629014,22300697,"FEB 02, 2024",POR @ DEN,L,37,11,23,0.478,4,10,0.4,3,4,0.75,1,3,4,4,2,0,2,2,29,-20,1,POR,DEN,POR,108,,,37,33,33,8
Anfernee Simons,G,22023,1629014,22300683,"JAN 31, 2024",POR vs. MIL,W,38,10,19,0.526,4,9,0.444,0,0,0.0,0,3,3,5,0,0,3,0,24,-11,1,POR,POR,MIL,119,,,32,27,29,8
Anfernee Simons,G,22023,1629014,22300668,"JAN 29, 2024",POR vs. PHI,W,28,6,12,0.5,1,7,0.143,2,2,1.0,1,0,1,6,0,1,1,3,15,26,1,POR,POR,PHI,128,,,22,16,21,7
Anfernee Simons,G,22023,1629014,22300656,"JAN 28, 2024",POR vs. CHI,L,35,4,15,0.267,2,7,0.286,1,1,1.0,2,5,7,8,0,0,1,5,11,-8,1,POR,POR,CHI,96,,,26,18,19,15
Anfernee Simons,G,22023,1629014,22300641,"JAN 26, 2024",POR @ SAS,L,41,14,27,0.519,7,15,0.467,5,5,1.0,0,2,2,10,1,0,5,3,40,-5,1,POR,SAS,POR,98,,,52,42,50,12
Anfernee Simons,G,22023,1629014,22300623,"JAN 24, 2024",POR @ HOU,W,41,13,20,0.65,4,9,0.444,3,3,1.0,2,4,6,5,0,0,3,3,33,15,1,POR,HOU,POR,137,,,44,39,38,11
Anfernee Simons,G,22023,1629014,22300617,"JAN 23, 2024",POR @ OKC,L,33,5,12,0.417,4,9,0.444,3,4,0.75,0,3,3,5,0,1,4,3,17,-15,1,POR,OKC,POR,109,,,25,20,22,8
Anfernee Simons,G,22023,1629014,22300605,"JAN 21, 2024",POR @ LAL,L,30,8,15,0.533,3,7,0.429,0,0,0.0,0,2,2,3,0,0,4,4,19,-24,1,POR,LAL,POR,108,,,24,21,22,5
Anfernee Simons,G,22023,1629014,22300399,"DEC 23, 2023",POR @ GSW,L,34,7,17,0.412,7,13,0.538,4,4,1.0,0,2,2,2,1,0,1,0,25,-8,1,POR,GSW,POR,106,,,29,27,27,4
Anfernee Simons,G,22023,1629014,22300381,"DEC 21, 2023",POR vs. WAS,L,38,15,28,0.536,7,14,0.5,4,5,0.8,1,3,4,7,0,0,3,2,41,-2,1,POR,POR,WAS,117,,,52,45,48,11
Anfernee Simons,G,22023,1629014,22300363,"DEC 19, 2023",POR vs. PHX,W,38,9,23,0.391,2,7,0.286,3,5,0.6,0,3,3,7,1,0,1,2,23,4,1,POR,POR,PHX,109,,,33,26,30,10
Anfernee Simons,G,22023,1629014,22300348,"DEC 17, 2023",POR vs. GSW,L,36,9,20,0.45,0,5,0.0,6,6,1.0,0,3,3,7,1,0,4,3,24,-1,1,POR,POR,GSW,114,,,34,27,31,10
Anfernee Simons,G,22023,1629014,22300341,"DEC 16, 2023",POR vs. DAL,L,35,13,22,0.591,2,8,0.25,5,5,1.0,2,6,8,6,2,0,3,2,33,4,1,POR,POR,DAL,120,,,47,41,39,14
Anfernee Simons,G,22023,1629014,22300323,"DEC 14, 2023",POR vs. UTA,L,22,3,8,0.375,2,6,0.333,1,2,0.5,0,1,1,6,1,0,2,1,9,-24,1,POR,POR,UTA,114,,,16,10,15,7
Anfernee Simons,G,22023,1629014,22300074,"OCT 25, 2023",POR @ LAC,L,27,6,14,0.429,2,6,0.333,4,4,1.0,1,1,2,4,2,0,0,2,18,-27,1,POR,LAC,POR,111,,,24,20,22,6
Anfernee Simons,G,22023,1629014,22300578,"JAN 17, 2024",POR vs. BKN,W,39,8,20,0.4,1,7,0.143,3,4,0.75,0,4,4,4,0,0,0,2,20,11,1,POR,POR,BKN,103,,,28,24,24,8
Anfernee Simons,G,22023,1629014,22300538,"JAN 12, 2024",POR @ MIN,L,29,0,10,0.0,0,2,0.0,5,5,1.0,0,2,2,3,0,1,3,0,5,-34,1,POR,MIN,POR,91,,,10,7,8,5
Anfernee Simons,G,22023,1629014,22300514,"JAN 09, 2024",POR @ NYK,L,27,4,14,0.286,2,7,0.286,2,2,1.0,0,4,4,3,0,0,3,2,12,-26,1,POR,NYK,POR,80,,,19,16,15,7
Anfernee Simons,G,22023,1629014,22300498,"JAN 07, 2024",POR @ BKN,W,45,13,25,0.52,5,10,0.5,7,8,0.875,0,4,4,11,0,0,2,2,38,7,1,POR,BKN,POR,134,,,53,42,49,15
Anfernee Simons,G,22023,1629014,22300487,"JAN 05, 2024",POR @ DAL,L,23,1,8,0.125,1,4,0.25,3,3,1.0,0,5,5,4,0,0,2,1,6,-14,1,POR,DAL,POR,103,,,15,11,10,9
Anfernee Simons,G,22023,1629014,22300472,"JAN 03, 2024",POR @ DAL,L,27,5,16,0.313,1,7,0.143,4,4,1.0,1,4,5,3,0,0,2,1,15,-31,1,POR,DAL,POR,97,,,23,20,18,8
Anfernee Simons,G,22023,1629014,22300413,"DEC 26, 2023",POR vs. SAC,W,35,12,25,0.48,5,12,0.417,0,0,0.0,0,4,4,3,1,0,2,2,29,4,1,POR,POR,SAC,130,,,36,33,32,7
Anfernee Simons,G,22023,1629014,22301214,"DEC 06, 2023",POR @ GSW,L,37,10,27,0.37,6,13,0.462,2,2,1.0,1,0,1,4,0,0,1,3,28,2,1,POR,GSW,POR,106,,,33,29,32,5
Anfernee Simons,G,22023,1629014,22300304,"DEC 11, 2023",POR @ LAC,L,38,10,23,0.435,5,11,0.455,13,13,1.0,0,1,1,4,0,1,3,1,38,-9,1,POR,LAC,POR,127,,,43,39,42,5
Anfernee Simons,G,22023,1629014,22300741,"FEB 08, 2024",POR vs. DET,L,25,9,19,0.474,4,12,0.333,7,7,1.0,0,2,2,5,0,0,2,2,29,22,1,POR,POR,DET,118,,,36,31,34,7
Anfernee Simons,G,22023,1629014,22300554,"JAN 14, 2024",POR vs. PHX,L,41,8,18,0.444,6,12,0.5,6,7,0.857,0,5,5,5,0,0,3,2,28,-11,1,POR,POR,PHX,116,,,38,33,33,10
Anfernee Simons,G,22023,1629014,22300529,"JAN 11, 2024",POR @ OKC,L,20,4,13,0.308,4,8,0.5,2,4,0.5,1,2,3,2,0,0,3,2,14,-36,1,POR,OKC,POR,77,,,19,17,16,5
Anfernee Simons,G,22023,1629014,22301226,"DEC 08, 2023",POR vs. DAL,L,36,10,21,0.476,4,10,0.4,6,6,1.0,2,3,5,8,1,0,6,4,30,-10,1,POR,POR,DAL,112,,,43,35,38,13
Karl-Anthony Towns,F,22023,1626157,22300738,"FEB 08, 2024",MIN @ MIL,W,30,7,15,0.467,4,6,0.667,1,2,0.5,2,3,5,1,0,0,1,4,19,21,1,MIN,MIL,MIN,129,,,25,24,20,6
Karl-Anthony Towns,F,22023,1626157,22300723,"FEB 06, 2024",MIN @ CHI,L,39,11,22,0.5,7,16,0.438,4,5,0.8,1,4,5,3,1,2,2,4,33,1,1,MIN,CHI,MIN,123,,,41,38,36,8
Karl-Anthony Towns,F,22023,1626157,22300709,"FEB 04, 2024",MIN vs. HOU,W,27,4,12,0.333,1,3,0.333,5,5,1.0,2,8,10,0,0,2,2,4,14,26,1,MIN,MIN,HOU,111,,,24,24,14,10
Karl-Anthony Towns,F,22023,1626157,22300694,"FEB 02, 2024",MIN vs. ORL,L,35,7,17,0.412,2,7,0.286,3,3,1.0,0,3,3,1,0,2,6,1,19,-8,1,MIN,MIN,ORL,106,,,23,22,20,4
Karl-Anthony Towns,F,22023,1626157,22300680,"JAN 31, 2024",MIN vs. DAL,W,31,11,15,0.733,4,6,0.667,3,5,0.6,2,7,9,4,1,0,3,2,29,14,1,MIN,MIN,DAL,121,,,42,38,33,13
Karl-Anthony Towns,F,22023,1626157,22300664,"JAN 29, 2024",MIN @ OKC,W,39,6,15,0.4,2,4,0.5,7,8,0.875,1,9,10,6,1,1,2,2,21,8,1,MIN,OKC,MIN,107,,,37,31,27,16
Karl-Anthony Towns,F,22023,1626157,22300649,"JAN 27, 2024",MIN @ SAS,L,32,9,16,0.563,1,4,0.25,0,1,0.0,0,5,5,4,1,2,3,3,19,-14,1,MIN,SAS,MIN,112,,,28,24,23,9
Karl-Anthony Towns,F,22023,1626157,22300629,"JAN 25, 2024",MIN @ BKN,W,37,12,15,0.8,2,3,0.667,1,2,0.5,1,9,10,3,0,0,6,3,27,-6,1,MIN,BKN,MIN,96,,,40,37,30,13
Karl-Anthony Towns,F,22023,1626157,22300620,"JAN 24, 2024",MIN @ WAS,W,35,11,24,0.458,2,10,0.2,3,3,1.0,0,6,6,3,0,1,1,4,27,26,1,MIN,WAS,MIN,118,,,36,33,30,9
Karl-Anthony Towns,F,22023,1626157,22300610,"JAN 22, 2024",MIN vs. CHA,L,38,21,35,0.6,10,15,0.667,10,14,0.714,3,5,8,2,0,0,7,2,62,0,1,MIN,MIN,CHA,125,,,72,70,64,10
Karl-Anthony Towns,F,22023,1626157,22300599,"JAN 20, 2024",MIN vs. OKC,L,36,4,10,0.4,1,4,0.25,10,10,1.0,1,10,11,2,0,1,3,6,19,-19,1,MIN,MIN,OKC,97,,,32,30,21,13
Karl-Anthony Towns,F,22023,1626157,22300582,"JAN 18, 2024",MIN vs. MEM,W,29,5,12,0.417,2,5,0.4,2,3,0.667,0,7,7,2,0,1,1,2,14,-1,1,MIN,MIN,MEM,118,,,23,21,16,9
Karl-Anthony Towns,F,22023,1626157,22300569,"JAN 17, 2024",MIN @ DET,W,31,10,17,0.588,5,5,1.0,2,2,1.0,2,4,6,4,0,0,1,2,27,7,1,MIN,DET,MIN,124,,,37,33,31,10
Karl-Anthony Towns,F,22023,1626157,22300553,"JAN 14, 2024",MIN vs. LAC,W,37,7,12,0.583,2,4,0.5,1,2,0.5,0,6,6,5,0,0,4,4,17,12,1,MIN,MIN,LAC,109,,,28,23,22,11
Karl-Anthony Towns,F,22023,1626157,22300538,"JAN 12, 2024",MIN vs. POR,W,28,7,8,0.875,3,3,1.0,6,7,0.857,1,7,8,1,2,0,0,2,23,38,1,MIN,MIN,POR,116,,,32,31,24,9
Karl-Anthony Towns,F,22023,1626157,22300517,"JAN 10, 2024",MIN @ BOS,L,44,8,17,0.471,2,7,0.286,7,7,1.0,1,12,13,6,2,0,1,6,25,-5,1,MIN,BOS,MIN,120,,,44,38,31,19
Karl-Anthony Towns,F,22023,1626157,22300513,"JAN 09, 2024",MIN @ ORL,W,34,11,19,0.579,5,5,1.0,1,1,1.0,1,5,6,5,3,0,2,2,28,28,1,MIN,ORL,MIN,113,,,39,34,33,11
Karl-Anthony Towns,F,22023,1626157,22300501,"JAN 07, 2024",MIN @ DAL,L,27,8,16,0.5,3,9,0.333,5,6,0.833,0,7,7,1,0,2,3,5,24,-6,1,MIN,DAL,MIN,108,,,32,31,25,8
Karl-Anthony Towns,F,22023,1626157,22300485,"JAN 05, 2024",MIN @ HOU,W,31,8,17,0.471,1,4,0.25,5,5,1.0,2,6,8,6,0,1,4,2,22,11,1,MIN,HOU,MIN,122,,,36,30,28,14
Karl-Anthony Towns,F,22023,1626157,22300471,"JAN 03, 2024",MIN vs. NOP,L,36,8,19,0.421,0,4,0.0,6,7,0.857,2,4,6,2,0,0,1,2,22,-18,1,MIN,MIN,NOP,106,,,30,28,24,8
Karl-Anthony Towns,F,22023,1626157,22300451,"JAN 01, 2024",MIN @ NYK,L,32,10,18,0.556,3,5,0.6,6,6,1.0,1,5,6,3,0,0,3,5,29,4,1,MIN,NYK,MIN,106,,,38,35,32,9
Karl-Anthony Towns,F,22023,1626157,22300443,"DEC 30, 2023",MIN vs. LAL,W,29,3,7,0.429,1,4,0.25,2,2,1.0,2,7,9,2,0,0,5,5,9,-23,1,MIN,MIN,LAL,108,,,20,18,11,11
Karl-Anthony Towns,F,22023,1626157,22300423,"DEC 28, 2023",MIN vs. DAL,W,27,3,12,0.25,2,6,0.333,2,4,0.5,2,6,8,3,0,0,5,5,10,14,1,MIN,MIN,DAL,118,,,21,18,13,11
Karl-Anthony Towns,F,22023,1626157,22300411,"DEC 26, 2023",MIN @ OKC,L,29,5,10,0.5,0,2,0.0,6,6,1.0,2,4,6,1,0,0,5,2,16,-11,1,MIN,OKC,MIN,106,,,23,22,17,7
Karl-Anthony Towns,F,22023,1626157,22300380,"DEC 21, 2023",MIN vs. LAL,W,33,7,17,0.412,2,6,0.333,5,6,0.833,0,6,6,4,1,0,0,3,21,12,1,MIN,MIN,LAL,118,,,31,27,25,10
Karl-Anthony Towns,F,22023,1626157,22300367,"DEC 20, 2023",MIN @ PHI,L,38,9,14,0.643,1,2,0.5,4,5,0.8,3,10,13,2,0,0,4,4,23,8,1,MIN,PHI,MIN,113,,,38,36,25,15
Karl-Anthony Towns,F,22023,1626157,22300353,"DEC 18, 2023",MIN @ MIA,W,32,7,14,0.5,1,4,0.25,3,3,1.0,4,4,8,2,1,0,1,3,18,-3,1,MIN,MIA,MIN,112,,,28,26,20,10
Karl-Anthony Towns,F,22023,1626157,22300338,"DEC 16, 2023",MIN vs. IND,W,35,15,25,0.6,2,3,0.667,8,8,1.0,5,7,12,4,3,2,3,2,40,18,1,MIN,MIN,IND,127,,,56,52,44,16
Karl-Anthony Towns,F,22023,1626157,22300321,"DEC 14, 2023",MIN @ DAL,W,31,8,14,0.571,1,3,0.333,4,5,0.8,5,12,17,2,0,0,3,1,21,11,1,MIN,DAL,MIN,119,,,40,38,23,19
Karl-Anthony Towns,F,22023,1626157,22300301,"DEC 11, 2023",MIN @ NOP,L,33,5,11,0.455,1,3,0.333,6,7,0.857,3,9,12,1,0,0,1,6,17,-12,1,MIN,NOP,MIN,107,,,30,29,18,13
Karl-Anthony Towns,F,22023,1626157,22301221,"DEC 08, 2023",MIN @ MEM,W,29,7,14,0.5,2,4,0.5,8,9,0.889,2,5,7,5,1,0,1,4,24,17,1,MIN,MEM,MIN,127,,,36,31,29,12
Karl-Anthony Towns,F,22023,1626157,22301210,"DEC 06, 2023",MIN vs. SAS,W,32,5,6,0.833,2,3,0.667,2,3,0.667,1,9,10,2,0,1,6,2,14,-14,1,MIN,MIN,SAS,102,,,26,24,16,12
Karl-Anthony Towns,F,22023,1626157,22300281,"DEC 02, 2023",MIN @ CHA,W,32,12,23,0.522,4,8,0.5,0,0,0.0,3,4,7,5,0,0,3,3,28,12,1,MIN,CHA,MIN,123,,,40,35,33,12
Karl-Anthony Towns,F,22023,1626157,22300270,"NOV 30, 2023",MIN vs. UTA,W,37,12,22,0.545,4,7,0.571,4,5,0.8,4,7,11,4,2,1,4,3,32,9,1,MIN,MIN,UTA,101,,,47,43,36,15
Karl-Anthony Towns,F,22023,1626157,22300058,"NOV 28, 2023",MIN vs. OKC,W,32,2,8,0.25,1,3,0.333,8,8,1.0,0,10,10,3,0,0,6,4,13,12,1,MIN,MIN,OKC,106,,,26,23,16,13
Karl-Anthony Towns,F,22023,1626157,22300249,"NOV 26, 2023",MIN @ MEM,W,26,7,11,0.636,1,3,0.333,3,3,1.0,0,8,8,2,1,1,4,5,18,7,1,MIN,MEM,MIN,119,,,28,26,20,10
Karl-Anthony Towns,F,22023,1626157,22300050,"NOV 24, 2023",MIN vs. SAC,L,38,9,15,0.6,4,5,0.8,5,5,1.0,1,10,11,4,0,0,4,3,27,-8,1,MIN,MIN,SAC,111,,,42,38,31,15
Karl-Anthony Towns,F,22023,1626157,22300232,"NOV 22, 2023",MIN vs. PHI,W,36,9,19,0.474,1,2,0.5,4,5,0.8,0,11,11,3,2,2,4,5,23,18,1,MIN,MIN,PHI,112,,,37,34,26,14
Karl-Anthony Towns,F,22023,1626157,22300221,"NOV 20, 2023",MIN vs. NYK,W,36,6,10,0.6,2,3,0.667,6,7,0.857,0,5,5,4,3,2,3,6,20,14,1,MIN,MIN,NYK,117,,,29,25,24,9
Karl-Anthony Towns,F,22023,1626157,22300203,"NOV 18, 2023",MIN @ NOP,W,33,10,11,0.909,2,2,1.0,7,8,0.875,2,4,6,9,0,2,0,5,29,9,1,MIN,NOP,MIN,121,,,44,35,38,15
Karl-Anthony Towns,F,22023,1626157,22300197,"NOV 15, 2023",MIN @ PHX,L,31,10,17,0.588,0,4,0.0,5,5,1.0,1,6,7,2,0,0,1,3,25,-14,1,MIN,PHX,MIN,115,,,34,32,27,9
Karl-Anthony Towns,F,22023,1626157,22300025,"NOV 14, 2023",MIN @ GSW,W,42,12,26,0.462,5,12,0.417,4,4,1.0,1,10,11,2,2,0,5,1,33,8,1,MIN,GSW,MIN,104,,,46,44,35,13
Karl-Anthony Towns,F,22023,1626157,22300186,"NOV 12, 2023",MIN @ GSW,W,37,8,14,0.571,2,3,0.667,3,3,1.0,2,12,14,3,2,1,1,1,21,11,1,MIN,GSW,MIN,116,,,38,35,24,17
Karl-Anthony Towns,F,22023,1626157,22300013,"NOV 10, 2023",MIN @ SAS,W,34,11,21,0.524,3,7,0.429,4,4,1.0,1,11,12,2,0,0,3,1,29,1,1,MIN,SAS,MIN,117,,,43,41,31,14
Karl-Anthony Towns,F,22023,1626157,22300166,"NOV 08, 2023",MIN vs. NOP,W,28,9,12,0.75,4,5,0.8,1,2,0.5,0,3,3,0,0,1,3,6,23,12,1,MIN,MIN,NOP,122,,,26,26,23,3
Karl-Anthony Towns,F,22023,1626157,22300154,"NOV 06, 2023",MIN vs. BOS,W,28,3,10,0.3,1,7,0.143,0,0,0.0,0,10,10,3,0,0,7,6,7,-5,1,MIN,MIN,BOS,114,,,20,17,10,13
Karl-Anthony Towns,F,22023,1626157,22300138,"NOV 04, 2023",MIN vs. UTA,W,32,7,14,0.5,2,6,0.333,9,10,0.9,0,7,7,1,2,0,2,4,25,24,1,MIN,MIN,UTA,123,,,33,32,26,8
Karl-Anthony Towns,F,22023,1626157,22300123,"NOV 01, 2023",MIN vs. DEN,W,31,7,19,0.368,1,4,0.25,6,6,1.0,2,6,8,4,2,0,1,2,21,22,1,MIN,MIN,DEN,110,,,33,29,25,12
Karl-Anthony Towns,F,22023,1626157,22300104,"OCT 30, 2023",MIN @ ATL,L,36,7,17,0.412,1,3,0.333,1,1,1.0,2,8,10,3,1,0,0,2,16,-8,1,MIN,ATL,MIN,113,,,29,26,19,13
Karl-Anthony Towns,F,22023,1626157,22300093,"OCT 28, 2023",MIN vs. MIA,W,31,5,12,0.417,1,4,0.25,1,2,0.5,0,10,10,2,1,0,1,3,12,6,1,MIN,MIN,MIA,106,,,24,22,14,12
Karl-Anthony Towns,F,22023,1626157,22300069,"OCT 25, 2023",MIN @ TOR,L,36,8,25,0.32,2,10,0.2,1,1,1.0,2,8,10,3,0,4,4,2,19,-1,1,MIN,TOR,MIN,94,,,32,29,22,13
Cade Cunningham,G,22023,1630595,22300453,"JAN 01, 2024",DET @ HOU,L,30,3,16,0.188,0,5,0.0,0,1,0.0,0,1,1,10,0,0,4,2,6,-21,1,DET,HOU,DET,113,,,17,7,16,11
Cade Cunningham,G,22023,1630595,22300394,"DEC 23, 2023",DET @ BKN,L,33,9,20,0.45,1,5,0.2,3,4,0.75,0,3,3,6,0,0,2,4,22,-5,1,DET,BKN,DET,115,,,31,25,28,9
Cade Cunningham,G,22023,1630595,22300374,"DEC 21, 2023",DET vs. UTA,L,39,10,22,0.455,2,6,0.333,6,7,0.857,1,5,6,10,2,1,6,2,28,1,1,DET,DET,UTA,111,,,44,34,38,16
Cade Cunningham,G,22023,1630595,22300352,"DEC 18, 2023",DET @ ATL,L,44,16,24,0.667,3,5,0.6,8,9,0.889,1,4,5,7,3,1,3,1,43,-2,1,DET,ATL,DET,124,,,55,48,50,12
Cade Cunningham,G,22023,1630595,22300334,"DEC 16, 2023",DET @ MIL,L,31,10,17,0.588,0,2,0.0,5,6,0.833,0,1,1,6,1,0,2,3,25,-13,1,DET,MIL,DET,114,,,32,26,31,7
Cade Cunningham,G,22023,1630595,22301217,"DEC 08, 2023",DET @ ORL,L,32,8,15,0.533,2,6,0.333,3,4,0.75,1,2,3,6,1,0,3,1,21,-20,1,DET,ORL,DET,91,,,30,24,27,9
Cade Cunningham,G,22023,1630595,22300283,"DEC 02, 2023",DET vs. CLE,L,37,8,20,0.4,3,6,0.5,4,4,1.0,0,8,8,11,2,0,1,3,23,13,1,DET,DET,CLE,101,,,42,31,34,19
Cade Cunningham,G,22023,1630595,22300268,"NOV 30, 2023",DET @ NYK,L,37,12,20,0.6,4,9,0.444,3,4,0.75,0,2,2,8,2,0,7,2,31,1,1,DET,NYK,DET,112,,,41,33,39,10
Cade Cunningham,G,22023,1630595,22300258,"NOV 29, 2023",DET vs. LAL,L,23,6,15,0.4,2,4,0.5,1,1,1.0,0,4,4,5,1,0,2,1,15,-33,1,DET,DET,LAL,107,,,24,19,20,9
Cade Cunningham,G,22023,1630595,22300047,"NOV 24, 2023",DET @ IND,L,38,10,26,0.385,2,4,0.5,9,9,1.0,0,3,3,5,0,0,4,0,31,-12,1,DET,IND,DET,113,,,39,34,36,8
Cade Cunningham,G,22023,1630595,22300218,"NOV 20, 2023",DET vs. DEN,L,38,7,17,0.412,2,4,0.5,11,11,1.0,0,2,2,9,3,1,5,2,27,7,1,DET,DET,DEN,103,,,38,29,36,11
Cade Cunningham,G,22023,1630595,22300211,"NOV 19, 2023",DET @ TOR,L,27,7,17,0.412,3,5,0.6,1,3,0.333,2,3,5,4,0,0,3,2,18,-22,1,DET,TOR,DET,113,,,27,23,22,9
Cade Cunningham,G,22023,1630595,22300030,"NOV 17, 2023",DET @ CLE,L,34,9,21,0.429,2,7,0.286,0,0,0.0,1,4,5,8,0,0,4,4,20,5,1,DET,CLE,DET,100,,,33,25,28,13
Cade Cunningham,G,22023,1630595,22300018,"NOV 14, 2023",DET vs. ATL,L,38,4,14,0.286,1,3,0.333,0,0,0.0,1,2,3,12,3,0,6,3,9,-11,1,DET,DET,ATL,120,,,24,12,21,15
Cade Cunningham,G,22023,1630595,22300181,"NOV 12, 2023",DET @ CHI,L,38,4,15,0.267,0,5,0.0,2,2,1.0,0,3,3,5,0,1,1,4,10,-24,1,DET,CHI,DET,108,,,18,13,15,8
Cade Cunningham,G,22023,1630595,22300008,"NOV 10, 2023",DET vs. PHI,L,36,8,18,0.444,1,5,0.2,4,4,1.0,1,3,4,7,0,0,4,5,21,-5,1,DET,DET,PHI,106,,,32,25,28,11
Cade Cunningham,G,22023,1630595,22300165,"NOV 08, 2023",DET @ MIL,L,39,11,27,0.407,2,8,0.25,9,10,0.9,2,6,8,8,0,0,5,2,33,-8,1,DET,MIL,DET,118,,,49,41,41,16
Cade Cunningham,G,22023,1630595,22300145,"NOV 06, 2023",DET vs. GSW,L,40,7,18,0.389,1,6,0.167,6,7,0.857,0,4,4,5,2,0,5,2,21,-9,1,DET,DET,GSW,109,,,30,25,26,9
Cade Cunningham,G,22023,1630595,22300140,"NOV 05, 2023",DET vs. PHX,L,39,12,24,0.5,0,6,0.0,2,3,0.667,1,2,3,6,0,1,6,2,26,-21,1,DET,DET,PHX,106,,,35,29,32,9
Cade Cunningham,G,22023,1630595,22300129,"NOV 02, 2023",DET @ NOP,L,34,8,22,0.364,2,7,0.286,4,5,0.8,0,2,2,11,1,0,6,4,22,3,1,DET,NOP,DET,116,,,35,24,33,13
Cade Cunningham,G,22023,1630595,22300115,"NOV 01, 2023",DET vs. POR,L,37,11,27,0.407,5,9,0.556,3,3,1.0,0,5,5,4,1,0,6,3,30,-7,1,DET,DET,POR,101,,,39,35,34,9
Cade Cunningham,G,22023,1630595,22300109,"OCT 30, 2023",DET @ OKC,L,35,5,15,0.333,3,7,0.429,4,5,0.8,0,2,2,5,0,0,7,1,17,-14,1,DET,OKC,DET,112,,,24,19,22,7
Cade Cunningham,G,22023,1630595,22300088,"OCT 28, 2023",DET vs. CHI,W,40,9,19,0.474,1,4,0.25,6,7,0.857,0,4,4,10,0,0,6,3,25,10,1,DET,DET,CHI,118,,,39,29,35,14
Cade Cunningham,G,22023,1630595,22300077,"OCT 27, 2023",DET @ CHA,W,24,4,13,0.308,2,5,0.4,2,2,1.0,1,1,2,6,1,0,5,6,12,7,1,DET,CHA,DET,111,,,20,14,18,8
Cade Cunningham,G,22023,1630595,22300068,"OCT 25, 2023",DET @ MIA,L,36,13,27,0.481,4,9,0.444,0,0,0.0,0,3,3,9,1,1,3,5,30,-2,1,DET,MIA,DET,102,,,42,33,39,12
Cade Cunningham,G,22023,1630595,22300704,"FEB 04, 2024",DET vs. ORL,L,32,6,14,0.429,1,3,0.333,5,7,0.714,0,5,5,7,2,0,1,2,18,-8,1,DET,DET,ORL,99,,,30,23,25,12
Cade Cunningham,G,22023,1630595,22300688,"FEB 02, 2024",DET vs. LAC,L,33,7,17,0.412,1,3,0.333,1,1,1.0,0,3,3,11,1,0,4,4,16,-11,1,DET,DET,LAC,125,,,30,19,27,14
Cade Cunningham,G,22023,1630595,22300675,"JAN 31, 2024",DET @ CLE,L,31,8,16,0.5,2,4,0.5,1,2,0.5,0,2,2,7,2,1,0,4,19,-22,1,DET,CLE,DET,121,,,28,21,26,9
Cade Cunningham,G,22023,1630595,22300642,"JAN 27, 2024",DET vs. WAS,L,35,7,17,0.412,2,3,0.667,4,6,0.667,0,4,4,12,0,0,7,3,20,-6,1,DET,DET,WAS,104,,,36,24,32,16
Cade Cunningham,G,22023,1630595,22300502,"JAN 07, 2024",DET @ DEN,L,11,1,6,0.167,1,2,0.5,0,0,0.0,0,3,3,3,0,0,0,2,3,-2,1,DET,DEN,DET,114,,,9,6,6,6
Cade Cunningham,G,22023,1630595,22300490,"JAN 05, 2024",DET @ GSW,L,35,13,22,0.591,1,7,0.143,3,3,1.0,0,5,5,3,0,1,2,2,30,-7,1,DET,GSW,DET,109,,,38,35,33,8
Cade Cunningham,G,22023,1630595,22300474,"JAN 03, 2024",DET @ UTA,L,40,12,21,0.571,3,7,0.429,4,5,0.8,0,5,5,13,1,0,6,5,31,-13,1,DET,UTA,DET,148,,,49,36,44,18
Cade Cunningham,G,22023,1630595,22300440,"DEC 30, 2023",DET vs. TOR,W,38,9,20,0.45,2,4,0.5,10,10,1.0,0,3,3,12,1,0,0,4,30,1,1,DET,DET,TOR,129,,,45,33,42,15
Cade Cunningham,G,22023,1630595,22300421,"DEC 28, 2023",DET @ BOS,L,43,12,22,0.545,4,6,0.667,3,4,0.75,1,5,6,9,3,2,6,3,31,4,1,DET,BOS,DET,122,,,46,37,40,15
Cade Cunningham,G,22023,1630595,22300406,"DEC 26, 2023",DET vs. BKN,L,37,15,21,0.714,3,4,0.75,8,10,0.8,1,8,9,5,1,1,3,4,41,5,1,DET,DET,BKN,112,,,55,50,46,14
Cade Cunningham,G,22023,1630595,22300327,"DEC 15, 2023",DET @ PHI,L,24,2,9,0.222,0,2,0.0,0,0,0.0,0,3,3,2,1,1,3,3,4,-32,1,DET,PHI,DET,92,,,9,7,6,5
Cade Cunningham,G,22023,1630595,22300310,"DEC 13, 2023",DET vs. PHI,L,30,5,17,0.294,1,8,0.125,10,12,0.833,1,5,6,7,0,0,1,3,21,-23,1,DET,DET,PHI,111,,,34,27,28,13
Cade Cunningham,G,22023,1630595,22300293,"DEC 11, 2023",DET vs. IND,L,38,11,21,0.524,1,6,0.167,0,0,0.0,0,6,6,7,1,0,3,3,23,-8,1,DET,DET,IND,123,,,36,29,30,13
Cade Cunningham,G,22023,1630595,22301206,"DEC 06, 2023",DET vs. MEM,L,34,6,14,0.429,1,5,0.2,3,3,1.0,0,4,4,10,2,1,5,2,16,-1,1,DET,DET,MEM,102,,,30,20,26,14
Cade Cunningham,G,22023,1630595,22300749,"FEB 10, 2024",DET @ LAC,L,35,9,18,0.5,1,3,0.333,3,3,1.0,0,6,6,10,0,1,2,2,22,2,1,DET,LAC,DET,106,,,38,28,32,16
Cade Cunningham,G,22023,1630595,22300253,"NOV 27, 2023",DET vs. WAS,L,32,10,22,0.455,2,7,0.286,4,4,1.0,1,4,5,7,1,0,1,2,26,-12,1,DET,DET,WAS,107,,,38,31,33,12
Cade Cunningham,G,22023,1630595,22300741,"FEB 08, 2024",DET @ POR,W,39,8,17,0.471,1,5,0.2,6,6,1.0,0,2,2,5,0,0,2,0,23,7,1,DET,POR,DET,128,,,30,25,28,7
Jaylen Brown,F,22023,1627759,22300684,"FEB 01, 2024",BOS vs. LAL,L,27,4,12,0.333,0,3,0.0,0,0,0.0,3,5,8,7,1,0,3,5,8,-20,1,BOS,BOS,LAL,105,20.0,Points,23,16,15,15
Jaylen Brown,F,22023,1627759,22300684,"FEB 01, 2024",BOS vs. LAL,L,27,4,12,0.333,0,3,0.0,0,0,0.0,3,5,8,7,1,0,3,5,8,-20,1,BOS,BOS,LAL,105,6.0,Rebounds,23,16,15,15
Jaylen Brown,F,22023,1627759,22300684,"FEB 01, 2024",BOS vs. LAL,L,27,4,12,0.333,0,3,0.0,0,0,0.0,3,5,8,7,1,0,3,5,8,-20,1,BOS,BOS,LAL,105,29.5,Pts+Rebs+Asts,23,16,15,15
Jaylen Brown,F,22023,1627759,22300684,"FEB 01, 2024",BOS vs. LAL,L,27,4,12,0.333,0,3,0.0,0,0,0.0,3,5,8,7,1,0,3,5,8,-20,1,BOS,BOS,LAL,105,34.5,Fantasy Score,23,16,15,15
Jaylen Brown,F,22023,1627759,22300684,"FEB 01, 2024",BOS vs. LAL,L,27,4,12,0.333,0,3,0.0,0,0,0.0,3,5,8,7,1,0,3,5,8,-20,1,BOS,BOS,LAL,105,2.5,Free Throws Made,23,16,15,15
Jaylen Brown,F,22023,1627759,22300684,"FEB 01, 2024",BOS vs. LAL,L,27,4,12,0.333,0,3,0.0,0,0,0.0,3,5,8,7,1,0,3,5,8,-20,1,BOS,BOS,LAL,105,25.5,Pts+Rebs,23,16,15,15
Jaylen Brown,F,22023,1627759,22300684,"FEB 01, 2024",BOS vs. LAL,L,27,4,12,0.333,0,3,0.0,0,0,0.0,3,5,8,7,1,0,3,5,8,-20,1,BOS,BOS,LAL,105,23.5,Pts+Asts,23,16,15,15
Jaylen Brown,F,22023,1627759,22300684,"FEB 01, 2024",BOS vs. LAL,L,27,4,12,0.333,0,3,0.0,0,0,0.0,3,5,8,7,1,0,3,5,8,-20,1,BOS,BOS,LAL,105,9.5,Rebs+Asts,23,16,15,15
Jaylen Brown,F,22023,1627759,22300684,"FEB 01, 2024",BOS vs. LAL,L,27,4,12,0.333,0,3,0.0,0,0,0.0,3,5,8,7,1,0,3,5,8,-20,1,BOS,BOS,LAL,105,1.5,Blks+Stls,23,16,15,15
Jaylen Brown,F,22023,1627759,22300646,"JAN 27, 2024",BOS vs. LAC,L,24,3,13,0.231,0,2,0.0,2,2,1.0,5,1,6,2,0,1,1,3,8,-18,1,BOS,BOS,LAC,96,20.0,Points,16,14,10,8
Jaylen Brown,F,22023,1627759,22300646,"JAN 27, 2024",BOS vs. LAC,L,24,3,13,0.231,0,2,0.0,2,2,1.0,5,1,6,2,0,1,1,3,8,-18,1,BOS,BOS,LAC,96,6.0,Rebounds,16,14,10,8
Jaylen Brown,F,22023,1627759,22300646,"JAN 27, 2024",BOS vs. LAC,L,24,3,13,0.231,0,2,0.0,2,2,1.0,5,1,6,2,0,1,1,3,8,-18,1,BOS,BOS,LAC,96,29.5,Pts+Rebs+Asts,16,14,10,8
Jaylen Brown,F,22023,1627759,22300646,"JAN 27, 2024",BOS vs. LAC,L,24,3,13,0.231,0,2,0.0,2,2,1.0,5,1,6,2,0,1,1,3,8,-18,1,BOS,BOS,LAC,96,34.5,Fantasy Score,16,14,10,8
Jaylen Brown,F,22023,1627759,22300646,"JAN 27, 2024",BOS vs. LAC,L,24,3,13,0.231,0,2,0.0,2,2,1.0,5,1,6,2,0,1,1,3,8,-18,1,BOS,BOS,LAC,96,2.5,Free Throws Made,16,14,10,8
Jaylen Brown,F,22023,1627759,22300646,"JAN 27, 2024",BOS vs. LAC,L,24,3,13,0.231,0,2,0.0,2,2,1.0,5,1,6,2,0,1,1,3,8,-18,1,BOS,BOS,LAC,96,25.5,Pts+Rebs,16,14,10,8
Jaylen Brown,F,22023,1627759,22300646,"JAN 27, 2024",BOS vs. LAC,L,24,3,13,0.231,0,2,0.0,2,2,1.0,5,1,6,2,0,1,1,3,8,-18,1,BOS,BOS,LAC,96,23.5,Pts+Asts,16,14,10,8
Jaylen Brown,F,22023,1627759,22300646,"JAN 27, 2024",BOS vs. LAC,L,24,3,13,0.231,0,2,0.0,2,2,1.0,5,1,6,2,0,1,1,3,8,-18,1,BOS,BOS,LAC,96,9.5,Rebs+Asts,16,14,10,8
Jaylen Brown,F,22023,1627759,22300646,"JAN 27, 2024",BOS vs. LAC,L,24,3,13,0.231,0,2,0.0,2,2,1.0,5,1,6,2,0,1,1,3,8,-18,1,BOS,BOS,LAC,96,1.5,Blks+Stls,16,14,10,8
Jaylen Brown,F,22023,1627759,22300630,"JAN 25, 2024",BOS @ MIA,W,27,7,11,0.636,4,8,0.5,0,0,0.0,1,3,4,5,3,0,3,1,18,22,1,BOS,MIA,BOS,143,20.0,Points,27,22,23,9
Jaylen Brown,F,22023,1627759,22300630,"JAN 25, 2024",BOS @ MIA,W,27,7,11,0.636,4,8,0.5,0,0,0.0,1,3,4,5,3,0,3,1,18,22,1,BOS,MIA,BOS,143,6.0,Rebounds,27,22,23,9
Jaylen Brown,F,22023,1627759,22300630,"JAN 25, 2024",BOS @ MIA,W,27,7,11,0.636,4,8,0.5,0,0,0.0,1,3,4,5,3,0,3,1,18,22,1,BOS,MIA,BOS,143,29.5,Pts+Rebs+Asts,27,22,23,9
Jaylen Brown,F,22023,1627759,22300630,"JAN 25, 2024",BOS @ MIA,W,27,7,11,0.636,4,8,0.5,0,0,0.0,1,3,4,5,3,0,3,1,18,22,1,BOS,MIA,BOS,143,34.5,Fantasy Score,27,22,23,9
Jaylen Brown,F,22023,1627759,22300630,"JAN 25, 2024",BOS @ MIA,W,27,7,11,0.636,4,8,0.5,0,0,0.0,1,3,4,5,3,0,3,1,18,22,1,BOS,MIA,BOS,143,2.5,Free Throws Made,27,22,23,9
Jaylen Brown,F,22023,1627759,22300630,"JAN 25, 2024",BOS @ MIA,W,27,7,11,0.636,4,8,0.5,0,0,0.0,1,3,4,5,3,0,3,1,18,22,1,BOS,MIA,BOS,143,25.5,Pts+Rebs,27,22,23,9
Jaylen Brown,F,22023,1627759,22300630,"JAN 25, 2024",BOS @ MIA,W,27,7,11,0.636,4,8,0.5,0,0,0.0,1,3,4,5,3,0,3,1,18,22,1,BOS,MIA,BOS,143,23.5,Pts+Asts,27,22,23,9
Jaylen Brown,F,22023,1627759,22300630,"JAN 25, 2024",BOS @ MIA,W,27,7,11,0.636,4,8,0.5,0,0,0.0,1,3,4,5,3,0,3,1,18,22,1,BOS,MIA,BOS,143,9.5,Rebs+Asts,27,22,23,9
Jaylen Brown,F,22023,1627759,22300630,"JAN 25, 2024",BOS @ MIA,W,27,7,11,0.636,4,8,0.5,0,0,0.0,1,3,4,5,3,0,3,1,18,22,1,BOS,MIA,BOS,143,1.5,Blks+Stls,27,22,23,9
Jaylen Brown,F,22023,1627759,22300571,"JAN 17, 2024",BOS vs. SAS,W,31,8,16,0.5,3,6,0.5,2,2,1.0,1,6,7,5,1,1,3,2,21,12,1,BOS,BOS,SAS,117,20.0,Points,33,28,26,12
Jaylen Brown,F,22023,1627759,22300571,"JAN 17, 2024",BOS vs. SAS,W,31,8,16,0.5,3,6,0.5,2,2,1.0,1,6,7,5,1,1,3,2,21,12,1,BOS,BOS,SAS,117,6.0,Rebounds,33,28,26,12
Jaylen Brown,F,22023,1627759,22300571,"JAN 17, 2024",BOS vs. SAS,W,31,8,16,0.5,3,6,0.5,2,2,1.0,1,6,7,5,1,1,3,2,21,12,1,BOS,BOS,SAS,117,29.5,Pts+Rebs+Asts,33,28,26,12
Jaylen Brown,F,22023,1627759,22300571,"JAN 17, 2024",BOS vs. SAS,W,31,8,16,0.5,3,6,0.5,2,2,1.0,1,6,7,5,1,1,3,2,21,12,1,BOS,BOS,SAS,117,34.5,Fantasy Score,33,28,26,12
Jaylen Brown,F,22023,1627759,22300571,"JAN 17, 2024",BOS vs. SAS,W,31,8,16,0.5,3,6,0.5,2,2,1.0,1,6,7,5,1,1,3,2,21,12,1,BOS,BOS,SAS,117,2.5,Free Throws Made,33,28,26,12
Jaylen Brown,F,22023,1627759,22300571,"JAN 17, 2024",BOS vs. SAS,W,31,8,16,0.5,3,6,0.5,2,2,1.0,1,6,7,5,1,1,3,2,21,12,1,BOS,BOS,SAS,117,25.5,Pts+Rebs,33,28,26,12
Jaylen Brown,F,22023,1627759,22300571,"JAN 17, 2024",BOS vs. SAS,W,31,8,16,0.5,3,6,0.5,2,2,1.0,1,6,7,5,1,1,3,2,21,12,1,BOS,BOS,SAS,117,23.5,Pts+Asts,33,28,26,12
Jaylen Brown,F,22023,1627759,22300571,"JAN 17, 2024",BOS vs. SAS,W,31,8,16,0.5,3,6,0.5,2,2,1.0,1,6,7,5,1,1,3,2,21,12,1,BOS,BOS,SAS,117,9.5,Rebs+Asts,33,28,26,12
Jaylen Brown,F,22023,1627759,22300571,"JAN 17, 2024",BOS vs. SAS,W,31,8,16,0.5,3,6,0.5,2,2,1.0,1,6,7,5,1,1,3,2,21,12,1,BOS,BOS,SAS,117,1.5,Blks+Stls,33,28,26,12
Jaylen Brown,F,22023,1627759,22300528,"JAN 11, 2024",BOS @ MIL,L,18,5,14,0.357,0,1,0.0,0,0,0.0,1,3,4,3,0,0,0,1,10,-17,1,BOS,MIL,BOS,102,20.0,Points,17,14,13,7
Jaylen Brown,F,22023,1627759,22300528,"JAN 11, 2024",BOS @ MIL,L,18,5,14,0.357,0,1,0.0,0,0,0.0,1,3,4,3,0,0,0,1,10,-17,1,BOS,MIL,BOS,102,6.0,Rebounds,17,14,13,7
Jaylen Brown,F,22023,1627759,22300528,"JAN 11, 2024",BOS @ MIL,L,18,5,14,0.357,0,1,0.0,0,0,0.0,1,3,4,3,0,0,0,1,10,-17,1,BOS,MIL,BOS,102,29.5,Pts+Rebs+Asts,17,14,13,7
Jaylen Brown,F,22023,1627759,22300528,"JAN 11, 2024",BOS @ MIL,L,18,5,14,0.357,0,1,0.0,0,0,0.0,1,3,4,3,0,0,0,1,10,-17,1,BOS,MIL,BOS,102,34.5,Fantasy Score,17,14,13,7
Jaylen Brown,F,22023,1627759,22300528,"JAN 11, 2024",BOS @ MIL,L,18,5,14,0.357,0,1,0.0,0,0,0.0,1,3,4,3,0,0,0,1,10,-17,1,BOS,MIL,BOS,102,2.5,Free Throws Made,17,14,13,7
Jaylen Brown,F,22023,1627759,22300528,"JAN 11, 2024",BOS @ MIL,L,18,5,14,0.357,0,1,0.0,0,0,0.0,1,3,4,3,0,0,0,1,10,-17,1,BOS,MIL,BOS,102,25.5,Pts+Rebs,17,14,13,7
Jaylen Brown,F,22023,1627759,22300528,"JAN 11, 2024",BOS @ MIL,L,18,5,14,0.357,0,1,0.0,0,0,0.0,1,3,4,3,0,0,0,1,10,-17,1,BOS,MIL,BOS,102,23.5,Pts+Asts,17,14,13,7
Jaylen Brown,F,22023,1627759,22300528,"JAN 11, 2024",BOS @ MIL,L,18,5,14,0.357,0,1,0.0,0,0,0.0,1,3,4,3,0,0,0,1,10,-17,1,BOS,MIL,BOS,102,9.5,Rebs+Asts,17,14,13,7
Jaylen Brown,F,22023,1627759,22300528,"JAN 11, 2024",BOS @ MIL,L,18,5,14,0.357,0,1,0.0,0,0,0.0,1,3,4,3,0,0,0,1,10,-17,1,BOS,MIL,BOS,102,1.5,Blks+Stls,17,14,13,7
Jaylen Brown,F,22023,1627759,22300507,"JAN 08, 2024",BOS @ IND,L,38,17,26,0.654,3,4,0.75,3,5,0.6,1,4,5,2,0,0,5,2,40,-1,1,BOS,IND,BOS,131,20.0,Points,47,45,42,7
Jaylen Brown,F,22023,1627759,22300507,"JAN 08, 2024",BOS @ IND,L,38,17,26,0.654,3,4,0.75,3,5,0.6,1,4,5,2,0,0,5,2,40,-1,1,BOS,IND,BOS,131,6.0,Rebounds,47,45,42,7
Jaylen Brown,F,22023,1627759,22300507,"JAN 08, 2024",BOS @ IND,L,38,17,26,0.654,3,4,0.75,3,5,0.6,1,4,5,2,0,0,5,2,40,-1,1,BOS,IND,BOS,131,29.5,Pts+Rebs+Asts,47,45,42,7
Jaylen Brown,F,22023,1627759,22300507,"JAN 08, 2024",BOS @ IND,L,38,17,26,0.654,3,4,0.75,3,5,0.6,1,4,5,2,0,0,5,2,40,-1,1,BOS,IND,BOS,131,34.5,Fantasy Score,47,45,42,7
Jaylen Brown,F,22023,1627759,22300507,"JAN 08, 2024",BOS @ IND,L,38,17,26,0.654,3,4,0.75,3,5,0.6,1,4,5,2,0,0,5,2,40,-1,1,BOS,IND,BOS,131,2.5,Free Throws Made,47,45,42,7
Jaylen Brown,F,22023,1627759,22300507,"JAN 08, 2024",BOS @ IND,L,38,17,26,0.654,3,4,0.75,3,5,0.6,1,4,5,2,0,0,5,2,40,-1,1,BOS,IND,BOS,131,25.5,Pts+Rebs,47,45,42,7
Jaylen Brown,F,22023,1627759,22300507,"JAN 08, 2024",BOS @ IND,L,38,17,26,0.654,3,4,0.75,3,5,0.6,1,4,5,2,0,0,5,2,40,-1,1,BOS,IND,BOS,131,23.5,Pts+Asts,47,45,42,7
Jaylen Brown,F,22023,1627759,22300507,"JAN 08, 2024",BOS @ IND,L,38,17,26,0.654,3,4,0.75,3,5,0.6,1,4,5,2,0,0,5,2,40,-1,1,BOS,IND,BOS,131,9.5,Rebs+Asts,47,45,42,7
Jaylen Brown,F,22023,1627759,22300507,"JAN 08, 2024",BOS @ IND,L,38,17,26,0.654,3,4,0.75,3,5,0.6,1,4,5,2,0,0,5,2,40,-1,1,BOS,IND,BOS,131,1.5,Blks+Stls,47,45,42,7
Jaylen Brown,F,22023,1627759,22300493,"JAN 06, 2024",BOS @ IND,W,36,13,20,0.65,1,4,0.25,4,8,0.5,1,3,4,1,0,1,3,0,31,7,1,BOS,IND,BOS,118,20.0,Points,36,35,32,5
Jaylen Brown,F,22023,1627759,22300493,"JAN 06, 2024",BOS @ IND,W,36,13,20,0.65,1,4,0.25,4,8,0.5,1,3,4,1,0,1,3,0,31,7,1,BOS,IND,BOS,118,6.0,Rebounds,36,35,32,5
Jaylen Brown,F,22023,1627759,22300493,"JAN 06, 2024",BOS @ IND,W,36,13,20,0.65,1,4,0.25,4,8,0.5,1,3,4,1,0,1,3,0,31,7,1,BOS,IND,BOS,118,29.5,Pts+Rebs+Asts,36,35,32,5
Jaylen Brown,F,22023,1627759,22300493,"JAN 06, 2024",BOS @ IND,W,36,13,20,0.65,1,4,0.25,4,8,0.5,1,3,4,1,0,1,3,0,31,7,1,BOS,IND,BOS,118,34.5,Fantasy Score,36,35,32,5
Jaylen Brown,F,22023,1627759,22300493,"JAN 06, 2024",BOS @ IND,W,36,13,20,0.65,1,4,0.25,4,8,0.5,1,3,4,1,0,1,3,0,31,7,1,BOS,IND,BOS,118,2.5,Free Throws Made,36,35,32,5
Jaylen Brown,F,22023,1627759,22300493,"JAN 06, 2024",BOS @ IND,W,36,13,20,0.65,1,4,0.25,4,8,0.5,1,3,4,1,0,1,3,0,31,7,1,BOS,IND,BOS,118,25.5,Pts+Rebs,36,35,32,5
Jaylen Brown,F,22023,1627759,22300493,"JAN 06, 2024",BOS @ IND,W,36,13,20,0.65,1,4,0.25,4,8,0.5,1,3,4,1,0,1,3,0,31,7,1,BOS,IND,BOS,118,23.5,Pts+Asts,36,35,32,5
Jaylen Brown,F,22023,1627759,22300493,"JAN 06, 2024",BOS @ IND,W,36,13,20,0.65,1,4,0.25,4,8,0.5,1,3,4,1,0,1,3,0,31,7,1,BOS,IND,BOS,118,9.5,Rebs+Asts,36,35,32,5
Jaylen Brown,F,22023,1627759,22300493,"JAN 06, 2024",BOS @ IND,W,36,13,20,0.65,1,4,0.25,4,8,0.5,1,3,4,1,0,1,3,0,31,7,1,BOS,IND,BOS,118,1.5,Blks+Stls,36,35,32,5
Jaylen Brown,F,22023,1627759,22300479,"JAN 05, 2024",BOS vs. UTA,W,27,5,12,0.417,2,4,0.5,1,2,0.5,0,3,3,5,1,1,3,2,13,18,1,BOS,BOS,UTA,126,20.0,Points,21,16,18,8
Jaylen Brown,F,22023,1627759,22300479,"JAN 05, 2024",BOS vs. UTA,W,27,5,12,0.417,2,4,0.5,1,2,0.5,0,3,3,5,1,1,3,2,13,18,1,BOS,BOS,UTA,126,6.0,Rebounds,21,16,18,8
Jaylen Brown,F,22023,1627759,22300479,"JAN 05, 2024",BOS vs. UTA,W,27,5,12,0.417,2,4,0.5,1,2,0.5,0,3,3,5,1,1,3,2,13,18,1,BOS,BOS,UTA,126,29.5,Pts+Rebs+Asts,21,16,18,8
Jaylen Brown,F,22023,1627759,22300479,"JAN 05, 2024",BOS vs. UTA,W,27,5,12,0.417,2,4,0.5,1,2,0.5,0,3,3,5,1,1,3,2,13,18,1,BOS,BOS,UTA,126,34.5,Fantasy Score,21,16,18,8
Jaylen Brown,F,22023,1627759,22300479,"JAN 05, 2024",BOS vs. UTA,W,27,5,12,0.417,2,4,0.5,1,2,0.5,0,3,3,5,1,1,3,2,13,18,1,BOS,BOS,UTA,126,2.5,Free Throws Made,21,16,18,8
Jaylen Brown,F,22023,1627759,22300479,"JAN 05, 2024",BOS vs. UTA,W,27,5,12,0.417,2,4,0.5,1,2,0.5,0,3,3,5,1,1,3,2,13,18,1,BOS,BOS,UTA,126,25.5,Pts+Rebs,21,16,18,8
Jaylen Brown,F,22023,1627759,22300479,"JAN 05, 2024",BOS vs. UTA,W,27,5,12,0.417,2,4,0.5,1,2,0.5,0,3,3,5,1,1,3,2,13,18,1,BOS,BOS,UTA,126,23.5,Pts+Asts,21,16,18,8
Jaylen Brown,F,22023,1627759,22300479,"JAN 05, 2024",BOS vs. UTA,W,27,5,12,0.417,2,4,0.5,1,2,0.5,0,3,3,5,1,1,3,2,13,18,1,BOS,BOS,UTA,126,9.5,Rebs+Asts,21,16,18,8
Jaylen Brown,F,22023,1627759,22300479,"JAN 05, 2024",BOS vs. UTA,W,27,5,12,0.417,2,4,0.5,1,2,0.5,0,3,3,5,1,1,3,2,13,18,1,BOS,BOS,UTA,126,1.5,Blks+Stls,21,16,18,8
Jaylen Brown,F,22023,1627759,22300448,"DEC 31, 2023",BOS @ SAS,W,26,9,13,0.692,2,2,1.0,4,6,0.667,1,5,6,3,2,0,2,0,24,26,1,BOS,SAS,BOS,134,20.0,Points,33,30,27,9
Jaylen Brown,F,22023,1627759,22300448,"DEC 31, 2023",BOS @ SAS,W,26,9,13,0.692,2,2,1.0,4,6,0.667,1,5,6,3,2,0,2,0,24,26,1,BOS,SAS,BOS,134,6.0,Rebounds,33,30,27,9
Jaylen Brown,F,22023,1627759,22300448,"DEC 31, 2023",BOS @ SAS,W,26,9,13,0.692,2,2,1.0,4,6,0.667,1,5,6,3,2,0,2,0,24,26,1,BOS,SAS,BOS,134,29.5,Pts+Rebs+Asts,33,30,27,9
Jaylen Brown,F,22023,1627759,22300448,"DEC 31, 2023",BOS @ SAS,W,26,9,13,0.692,2,2,1.0,4,6,0.667,1,5,6,3,2,0,2,0,24,26,1,BOS,SAS,BOS,134,34.5,Fantasy Score,33,30,27,9
Jaylen Brown,F,22023,1627759,22300448,"DEC 31, 2023",BOS @ SAS,W,26,9,13,0.692,2,2,1.0,4,6,0.667,1,5,6,3,2,0,2,0,24,26,1,BOS,SAS,BOS,134,2.5,Free Throws Made,33,30,27,9
Jaylen Brown,F,22023,1627759,22300448,"DEC 31, 2023",BOS @ SAS,W,26,9,13,0.692,2,2,1.0,4,6,0.667,1,5,6,3,2,0,2,0,24,26,1,BOS,SAS,BOS,134,25.5,Pts+Rebs,33,30,27,9
Jaylen Brown,F,22023,1627759,22300448,"DEC 31, 2023",BOS @ SAS,W,26,9,13,0.692,2,2,1.0,4,6,0.667,1,5,6,3,2,0,2,0,24,26,1,BOS,SAS,BOS,134,23.5,Pts+Asts,33,30,27,9
Jaylen Brown,F,22023,1627759,22300448,"DEC 31, 2023",BOS @ SAS,W,26,9,13,0.692,2,2,1.0,4,6,0.667,1,5,6,3,2,0,2,0,24,26,1,BOS,SAS,BOS,134,9.5,Rebs+Asts,33,30,27,9
Jaylen Brown,F,22023,1627759,22300448,"DEC 31, 2023",BOS @ SAS,W,26,9,13,0.692,2,2,1.0,4,6,0.667,1,5,6,3,2,0,2,0,24,26,1,BOS,SAS,BOS,134,1.5,Blks+Stls,33,30,27,9
Jaylen Brown,F,22023,1627759,22300432,"DEC 29, 2023",BOS vs. TOR,W,41,11,16,0.688,5,6,0.833,4,5,0.8,1,9,10,6,0,0,7,4,31,12,1,BOS,BOS,TOR,120,20.0,Points,47,41,37,16
Jaylen Brown,F,22023,1627759,22300432,"DEC 29, 2023",BOS vs. TOR,W,41,11,16,0.688,5,6,0.833,4,5,0.8,1,9,10,6,0,0,7,4,31,12,1,BOS,BOS,TOR,120,6.0,Rebounds,47,41,37,16
Jaylen Brown,F,22023,1627759,22300432,"DEC 29, 2023",BOS vs. TOR,W,41,11,16,0.688,5,6,0.833,4,5,0.8,1,9,10,6,0,0,7,4,31,12,1,BOS,BOS,TOR,120,29.5,Pts+Rebs+Asts,47,41,37,16
Jaylen Brown,F,22023,1627759,22300432,"DEC 29, 2023",BOS vs. TOR,W,41,11,16,0.688,5,6,0.833,4,5,0.8,1,9,10,6,0,0,7,4,31,12,1,BOS,BOS,TOR,120,34.5,Fantasy Score,47,41,37,16
Jaylen Brown,F,22023,1627759,22300432,"DEC 29, 2023",BOS vs. TOR,W,41,11,16,0.688,5,6,0.833,4,5,0.8,1,9,10,6,0,0,7,4,31,12,1,BOS,BOS,TOR,120,2.5,Free Throws Made,47,41,37,16
Jaylen Brown,F,22023,1627759,22300432,"DEC 29, 2023",BOS vs. TOR,W,41,11,16,0.688,5,6,0.833,4,5,0.8,1,9,10,6,0,0,7,4,31,12,1,BOS,BOS,TOR,120,25.5,Pts+Rebs,47,41,37,16
Jaylen Brown,F,22023,1627759,22300432,"DEC 29, 2023",BOS vs. TOR,W,41,11,16,0.688,5,6,0.833,4,5,0.8,1,9,10,6,0,0,7,4,31,12,1,BOS,BOS,TOR,120,23.5,Pts+Asts,47,41,37,16
Jaylen Brown,F,22023,1627759,22300432,"DEC 29, 2023",BOS vs. TOR,W,41,11,16,0.688,5,6,0.833,4,5,0.8,1,9,10,6,0,0,7,4,31,12,1,BOS,BOS,TOR,120,9.5,Rebs+Asts,47,41,37,16
Jaylen Brown,F,22023,1627759,22300432,"DEC 29, 2023",BOS vs. TOR,W,41,11,16,0.688,5,6,0.833,4,5,0.8,1,9,10,6,0,0,7,4,31,12,1,BOS,BOS,TOR,120,1.5,Blks+Stls,47,41,37,16
Jaylen Brown,F,22023,1627759,22300389,"DEC 23, 2023",BOS @ LAC,W,29,9,17,0.529,3,6,0.5,3,4,0.75,3,3,6,2,1,0,3,2,24,29,1,BOS,LAC,BOS,142,20.0,Points,32,30,26,8
Jaylen Brown,F,22023,1627759,22300389,"DEC 23, 2023",BOS @ LAC,W,29,9,17,0.529,3,6,0.5,3,4,0.75,3,3,6,2,1,0,3,2,24,29,1,BOS,LAC,BOS,142,6.0,Rebounds,32,30,26,8
Jaylen Brown,F,22023,1627759,22300389,"DEC 23, 2023",BOS @ LAC,W,29,9,17,0.529,3,6,0.5,3,4,0.75,3,3,6,2,1,0,3,2,24,29,1,BOS,LAC,BOS,142,29.5,Pts+Rebs+Asts,32,30,26,8
Jaylen Brown,F,22023,1627759,22300389,"DEC 23, 2023",BOS @ LAC,W,29,9,17,0.529,3,6,0.5,3,4,0.75,3,3,6,2,1,0,3,2,24,29,1,BOS,LAC,BOS,142,34.5,Fantasy Score,32,30,26,8
Jaylen Brown,F,22023,1627759,22300389,"DEC 23, 2023",BOS @ LAC,W,29,9,17,0.529,3,6,0.5,3,4,0.75,3,3,6,2,1,0,3,2,24,29,1,BOS,LAC,BOS,142,2.5,Free Throws Made,32,30,26,8
Jaylen Brown,F,22023,1627759,22300389,"DEC 23, 2023",BOS @ LAC,W,29,9,17,0.529,3,6,0.5,3,4,0.75,3,3,6,2,1,0,3,2,24,29,1,BOS,LAC,BOS,142,25.5,Pts+Rebs,32,30,26,8
Jaylen Brown,F,22023,1627759,22300389,"DEC 23, 2023",BOS @ LAC,W,29,9,17,0.529,3,6,0.5,3,4,0.75,3,3,6,2,1,0,3,2,24,29,1,BOS,LAC,BOS,142,23.5,Pts+Asts,32,30,26,8
Jaylen Brown,F,22023,1627759,22300389,"DEC 23, 2023",BOS @ LAC,W,29,9,17,0.529,3,6,0.5,3,4,0.75,3,3,6,2,1,0,3,2,24,29,1,BOS,LAC,BOS,142,9.5,Rebs+Asts,32,30,26,8
Jaylen Brown,F,22023,1627759,22300389,"DEC 23, 2023",BOS @ LAC,W,29,9,17,0.529,3,6,0.5,3,4,0.75,3,3,6,2,1,0,3,2,24,29,1,BOS,LAC,BOS,142,1.5,Blks+Stls,32,30,26,8
Jaylen Brown,F,22023,1627759,22300344,"DEC 17, 2023",BOS vs. ORL,W,34,12,20,0.6,5,8,0.625,2,2,1.0,1,4,5,6,1,1,2,4,31,11,1,BOS,BOS,ORL,114,20.0,Points,42,36,37,11
Jaylen Brown,F,22023,1627759,22300344,"DEC 17, 2023",BOS vs. ORL,W,34,12,20,0.6,5,8,0.625,2,2,1.0,1,4,5,6,1,1,2,4,31,11,1,BOS,BOS,ORL,114,6.0,Rebounds,42,36,37,11
Jaylen Brown,F,22023,1627759,22300344,"DEC 17, 2023",BOS vs. ORL,W,34,12,20,0.6,5,8,0.625,2,2,1.0,1,4,5,6,1,1,2,4,31,11,1,BOS,BOS,ORL,114,29.5,Pts+Rebs+Asts,42,36,37,11
Jaylen Brown,F,22023,1627759,22300344,"DEC 17, 2023",BOS vs. ORL,W,34,12,20,0.6,5,8,0.625,2,2,1.0,1,4,5,6,1,1,2,4,31,11,1,BOS,BOS,ORL,114,34.5,Fantasy Score,42,36,37,11
Jaylen Brown,F,22023,1627759,22300344,"DEC 17, 2023",BOS vs. ORL,W,34,12,20,0.6,5,8,0.625,2,2,1.0,1,4,5,6,1,1,2,4,31,11,1,BOS,BOS,ORL,114,2.5,Free Throws Made,42,36,37,11
Jaylen Brown,F,22023,1627759,22300344,"DEC 17, 2023",BOS vs. ORL,W,34,12,20,0.6,5,8,0.625,2,2,1.0,1,4,5,6,1,1,2,4,31,11,1,BOS,BOS,ORL,114,25.5,Pts+Rebs,42,36,37,11
Jaylen Brown,F,22023,1627759,22300344,"DEC 17, 2023",BOS vs. ORL,W,34,12,20,0.6,5,8,0.625,2,2,1.0,1,4,5,6,1,1,2,4,31,11,1,BOS,BOS,ORL,114,23.5,Pts+Asts,42,36,37,11
Jaylen Brown,F,22023,1627759,22300344,"DEC 17, 2023",BOS vs. ORL,W,34,12,20,0.6,5,8,0.625,2,2,1.0,1,4,5,6,1,1,2,4,31,11,1,BOS,BOS,ORL,114,9.5,Rebs+Asts,42,36,37,11
Jaylen Brown,F,22023,1627759,22300344,"DEC 17, 2023",BOS vs. ORL,W,34,12,20,0.6,5,8,0.625,2,2,1.0,1,4,5,6,1,1,2,4,31,11,1,BOS,BOS,ORL,114,1.5,Blks+Stls,42,36,37,11
Jaylen Brown,F,22023,1627759,22301227,"DEC 08, 2023",BOS vs. NYK,W,27,7,13,0.538,2,5,0.4,1,1,1.0,0,0,0,4,1,1,2,5,17,17,1,BOS,BOS,NYK,133,20.0,Points,21,17,21,4
Jaylen Brown,F,22023,1627759,22301227,"DEC 08, 2023",BOS vs. NYK,W,27,7,13,0.538,2,5,0.4,1,1,1.0,0,0,0,4,1,1,2,5,17,17,1,BOS,BOS,NYK,133,6.0,Rebounds,21,17,21,4
Jaylen Brown,F,22023,1627759,22301227,"DEC 08, 2023",BOS vs. NYK,W,27,7,13,0.538,2,5,0.4,1,1,1.0,0,0,0,4,1,1,2,5,17,17,1,BOS,BOS,NYK,133,29.5,Pts+Rebs+Asts,21,17,21,4
Jaylen Brown,F,22023,1627759,22301227,"DEC 08, 2023",BOS vs. NYK,W,27,7,13,0.538,2,5,0.4,1,1,1.0,0,0,0,4,1,1,2,5,17,17,1,BOS,BOS,NYK,133,34.5,Fantasy Score,21,17,21,4
Jaylen Brown,F,22023,1627759,22301227,"DEC 08, 2023",BOS vs. NYK,W,27,7,13,0.538,2,5,0.4,1,1,1.0,0,0,0,4,1,1,2,5,17,17,1,BOS,BOS,NYK,133,2.5,Free Throws Made,21,17,21,4
Jaylen Brown,F,22023,1627759,22301227,"DEC 08, 2023",BOS vs. NYK,W,27,7,13,0.538,2,5,0.4,1,1,1.0,0,0,0,4,1,1,2,5,17,17,1,BOS,BOS,NYK,133,25.5,Pts+Rebs,21,17,21,4
Jaylen Brown,F,22023,1627759,22301227,"DEC 08, 2023",BOS vs. NYK,W,27,7,13,0.538,2,5,0.4,1,1,1.0,0,0,0,4,1,1,2,5,17,17,1,BOS,BOS,NYK,133,23.5,Pts+Asts,21,17,21,4
Jaylen Brown,F,22023,1627759,22301227,"DEC 08, 2023",BOS vs. NYK,W,27,7,13,0.538,2,5,0.4,1,1,1.0,0,0,0,4,1,1,2,5,17,17,1,BOS,BOS,NYK,133,9.5,Rebs+Asts,21,17,21,4
Jaylen Brown,F,22023,1627759,22301227,"DEC 08, 2023",BOS vs. NYK,W,27,7,13,0.538,2,5,0.4,1,1,1.0,0,0,0,4,1,1,2,5,17,17,1,BOS,BOS,NYK,133,1.5,Blks+Stls,21,17,21,4
Jaylen Brown,F,22023,1627759,22301202,"DEC 04, 2023",BOS @ IND,L,31,14,23,0.609,2,7,0.286,0,1,0.0,2,7,9,0,1,2,3,6,30,-10,1,BOS,IND,BOS,112,20.0,Points,39,39,30,9
Jaylen Brown,F,22023,1627759,22301202,"DEC 04, 2023",BOS @ IND,L,31,14,23,0.609,2,7,0.286,0,1,0.0,2,7,9,0,1,2,3,6,30,-10,1,BOS,IND,BOS,112,6.0,Rebounds,39,39,30,9
Jaylen Brown,F,22023,1627759,22301202,"DEC 04, 2023",BOS @ IND,L,31,14,23,0.609,2,7,0.286,0,1,0.0,2,7,9,0,1,2,3,6,30,-10,1,BOS,IND,BOS,112,29.5,Pts+Rebs+Asts,39,39,30,9
Jaylen Brown,F,22023,1627759,22301202,"DEC 04, 2023",BOS @ IND,L,31,14,23,0.609,2,7,0.286,0,1,0.0,2,7,9,0,1,2,3,6,30,-10,1,BOS,IND,BOS,112,34.5,Fantasy Score,39,39,30,9
Jaylen Brown,F,22023,1627759,22301202,"DEC 04, 2023",BOS @ IND,L,31,14,23,0.609,2,7,0.286,0,1,0.0,2,7,9,0,1,2,3,6,30,-10,1,BOS,IND,BOS,112,2.5,Free Throws Made,39,39,30,9
Jaylen Brown,F,22023,1627759,22301202,"DEC 04, 2023",BOS @ IND,L,31,14,23,0.609,2,7,0.286,0,1,0.0,2,7,9,0,1,2,3,6,30,-10,1,BOS,IND,BOS,112,25.5,Pts+Rebs,39,39,30,9
Jaylen Brown,F,22023,1627759,22301202,"DEC 04, 2023",BOS @ IND,L,31,14,23,0.609,2,7,0.286,0,1,0.0,2,7,9,0,1,2,3,6,30,-10,1,BOS,IND,BOS,112,23.5,Pts+Asts,39,39,30,9
Jaylen Brown,F,22023,1627759,22301202,"DEC 04, 2023",BOS @ IND,L,31,14,23,0.609,2,7,0.286,0,1,0.0,2,7,9,0,1,2,3,6,30,-10,1,BOS,IND,BOS,112,9.5,Rebs+Asts,39,39,30,9
Jaylen Brown,F,22023,1627759,22301202,"DEC 04, 2023",BOS @ IND,L,31,14,23,0.609,2,7,0.286,0,1,0.0,2,7,9,0,1,2,3,6,30,-10,1,BOS,IND,BOS,112,1.5,Blks+Stls,39,39,30,9
Jaylen Brown,F,22023,1627759,22300275,"DEC 01, 2023",BOS vs. PHI,W,35,8,20,0.4,1,4,0.25,3,4,0.75,1,3,4,0,4,2,3,3,20,10,1,BOS,BOS,PHI,125,20.0,Points,24,24,20,4
Jaylen Brown,F,22023,1627759,22300275,"DEC 01, 2023",BOS vs. PHI,W,35,8,20,0.4,1,4,0.25,3,4,0.75,1,3,4,0,4,2,3,3,20,10,1,BOS,BOS,PHI,125,6.0,Rebounds,24,24,20,4
Jaylen Brown,F,22023,1627759,22300275,"DEC 01, 2023",BOS vs. PHI,W,35,8,20,0.4,1,4,0.25,3,4,0.75,1,3,4,0,4,2,3,3,20,10,1,BOS,BOS,PHI,125,29.5,Pts+Rebs+Asts,24,24,20,4
Jaylen Brown,F,22023,1627759,22300275,"DEC 01, 2023",BOS vs. PHI,W,35,8,20,0.4,1,4,0.25,3,4,0.75,1,3,4,0,4,2,3,3,20,10,1,BOS,BOS,PHI,125,34.5,Fantasy Score,24,24,20,4
Jaylen Brown,F,22023,1627759,22300275,"DEC 01, 2023",BOS vs. PHI,W,35,8,20,0.4,1,4,0.25,3,4,0.75,1,3,4,0,4,2,3,3,20,10,1,BOS,BOS,PHI,125,2.5,Free Throws Made,24,24,20,4
Jaylen Brown,F,22023,1627759,22300275,"DEC 01, 2023",BOS vs. PHI,W,35,8,20,0.4,1,4,0.25,3,4,0.75,1,3,4,0,4,2,3,3,20,10,1,BOS,BOS,PHI,125,25.5,Pts+Rebs,24,24,20,4
Jaylen Brown,F,22023,1627759,22300275,"DEC 01, 2023",BOS vs. PHI,W,35,8,20,0.4,1,4,0.25,3,4,0.75,1,3,4,0,4,2,3,3,20,10,1,BOS,BOS,PHI,125,23.5,Pts+Asts,24,24,20,4
Jaylen Brown,F,22023,1627759,22300275,"DEC 01, 2023",BOS vs. PHI,W,35,8,20,0.4,1,4,0.25,3,4,0.75,1,3,4,0,4,2,3,3,20,10,1,BOS,BOS,PHI,125,9.5,Rebs+Asts,24,24,20,4
Jaylen Brown,F,22023,1627759,22300275,"DEC 01, 2023",BOS vs. PHI,W,35,8,20,0.4,1,4,0.25,3,4,0.75,1,3,4,0,4,2,3,3,20,10,1,BOS,BOS,PHI,125,1.5,Blks+Stls,24,24,20,4
Jaylen Brown,F,22023,1627759,22300053,"NOV 28, 2023",BOS vs. CHI,W,35,12,23,0.522,3,8,0.375,3,5,0.6,2,6,8,6,0,1,3,1,30,22,1,BOS,BOS,CHI,124,20.0,Points,44,38,36,14
Jaylen Brown,F,22023,1627759,22300053,"NOV 28, 2023",BOS vs. CHI,W,35,12,23,0.522,3,8,0.375,3,5,0.6,2,6,8,6,0,1,3,1,30,22,1,BOS,BOS,CHI,124,6.0,Rebounds,44,38,36,14
Jaylen Brown,F,22023,1627759,22300053,"NOV 28, 2023",BOS vs. CHI,W,35,12,23,0.522,3,8,0.375,3,5,0.6,2,6,8,6,0,1,3,1,30,22,1,BOS,BOS,CHI,124,29.5,Pts+Rebs+Asts,44,38,36,14
Jaylen Brown,F,22023,1627759,22300053,"NOV 28, 2023",BOS vs. CHI,W,35,12,23,0.522,3,8,0.375,3,5,0.6,2,6,8,6,0,1,3,1,30,22,1,BOS,BOS,CHI,124,34.5,Fantasy Score,44,38,36,14
Jaylen Brown,F,22023,1627759,22300053,"NOV 28, 2023",BOS vs. CHI,W,35,12,23,0.522,3,8,0.375,3,5,0.6,2,6,8,6,0,1,3,1,30,22,1,BOS,BOS,CHI,124,2.5,Free Throws Made,44,38,36,14
Jaylen Brown,F,22023,1627759,22300053,"NOV 28, 2023",BOS vs. CHI,W,35,12,23,0.522,3,8,0.375,3,5,0.6,2,6,8,6,0,1,3,1,30,22,1,BOS,BOS,CHI,124,25.5,Pts+Rebs,44,38,36,14
Jaylen Brown,F,22023,1627759,22300053,"NOV 28, 2023",BOS vs. CHI,W,35,12,23,0.522,3,8,0.375,3,5,0.6,2,6,8,6,0,1,3,1,30,22,1,BOS,BOS,CHI,124,23.5,Pts+Asts,44,38,36,14
Jaylen Brown,F,22023,1627759,22300053,"NOV 28, 2023",BOS vs. CHI,W,35,12,23,0.522,3,8,0.375,3,5,0.6,2,6,8,6,0,1,3,1,30,22,1,BOS,BOS,CHI,124,9.5,Rebs+Asts,44,38,36,14
Jaylen Brown,F,22023,1627759,22300053,"NOV 28, 2023",BOS vs. CHI,W,35,12,23,0.522,3,8,0.375,3,5,0.6,2,6,8,6,0,1,3,1,30,22,1,BOS,BOS,CHI,124,1.5,Blks+Stls,44,38,36,14
Jaylen Brown,F,22023,1627759,22300246,"NOV 26, 2023",BOS vs. ATL,W,36,9,19,0.474,2,7,0.286,1,2,0.5,1,6,7,3,1,0,2,4,21,5,1,BOS,BOS,ATL,113,20.0,Points,31,28,24,10
Jaylen Brown,F,22023,1627759,22300246,"NOV 26, 2023",BOS vs. ATL,W,36,9,19,0.474,2,7,0.286,1,2,0.5,1,6,7,3,1,0,2,4,21,5,1,BOS,BOS,ATL,113,6.0,Rebounds,31,28,24,10
Jaylen Brown,F,22023,1627759,22300246,"NOV 26, 2023",BOS vs. ATL,W,36,9,19,0.474,2,7,0.286,1,2,0.5,1,6,7,3,1,0,2,4,21,5,1,BOS,BOS,ATL,113,29.5,Pts+Rebs+Asts,31,28,24,10
Jaylen Brown,F,22023,1627759,22300246,"NOV 26, 2023",BOS vs. ATL,W,36,9,19,0.474,2,7,0.286,1,2,0.5,1,6,7,3,1,0,2,4,21,5,1,BOS,BOS,ATL,113,34.5,Fantasy Score,31,28,24,10
Jaylen Brown,F,22023,1627759,22300246,"NOV 26, 2023",BOS vs. ATL,W,36,9,19,0.474,2,7,0.286,1,2,0.5,1,6,7,3,1,0,2,4,21,5,1,BOS,BOS,ATL,113,2.5,Free Throws Made,31,28,24,10
Jaylen Brown,F,22023,1627759,22300246,"NOV 26, 2023",BOS vs. ATL,W,36,9,19,0.474,2,7,0.286,1,2,0.5,1,6,7,3,1,0,2,4,21,5,1,BOS,BOS,ATL,113,25.5,Pts+Rebs,31,28,24,10
Jaylen Brown,F,22023,1627759,22300246,"NOV 26, 2023",BOS vs. ATL,W,36,9,19,0.474,2,7,0.286,1,2,0.5,1,6,7,3,1,0,2,4,21,5,1,BOS,BOS,ATL,113,23.5,Pts+Asts,31,28,24,10
Jaylen Brown,F,22023,1627759,22300246,"NOV 26, 2023",BOS vs. ATL,W,36,9,19,0.474,2,7,0.286,1,2,0.5,1,6,7,3,1,0,2,4,21,5,1,BOS,BOS,ATL,113,9.5,Rebs+Asts,31,28,24,10
Jaylen Brown,F,22023,1627759,22300246,"NOV 26, 2023",BOS vs. ATL,W,36,9,19,0.474,2,7,0.286,1,2,0.5,1,6,7,3,1,0,2,4,21,5,1,BOS,BOS,ATL,113,1.5,Blks+Stls,31,28,24,10
Jaylen Brown,F,22023,1627759,22300043,"NOV 24, 2023",BOS @ ORL,L,39,6,22,0.273,2,8,0.25,4,7,0.571,0,3,3,2,3,1,3,3,18,1,1,BOS,ORL,BOS,96,20.0,Points,23,21,20,5
Jaylen Brown,F,22023,1627759,22300043,"NOV 24, 2023",BOS @ ORL,L,39,6,22,0.273,2,8,0.25,4,7,0.571,0,3,3,2,3,1,3,3,18,1,1,BOS,ORL,BOS,96,6.0,Rebounds,23,21,20,5
Jaylen Brown,F,22023,1627759,22300043,"NOV 24, 2023",BOS @ ORL,L,39,6,22,0.273,2,8,0.25,4,7,0.571,0,3,3,2,3,1,3,3,18,1,1,BOS,ORL,BOS,96,29.5,Pts+Rebs+Asts,23,21,20,5
Jaylen Brown,F,22023,1627759,22300043,"NOV 24, 2023",BOS @ ORL,L,39,6,22,0.273,2,8,0.25,4,7,0.571,0,3,3,2,3,1,3,3,18,1,1,BOS,ORL,BOS,96,34.5,Fantasy Score,23,21,20,5
Jaylen Brown,F,22023,1627759,22300043,"NOV 24, 2023",BOS @ ORL,L,39,6,22,0.273,2,8,0.25,4,7,0.571,0,3,3,2,3,1,3,3,18,1,1,BOS,ORL,BOS,96,2.5,Free Throws Made,23,21,20,5
Jaylen Brown,F,22023,1627759,22300043,"NOV 24, 2023",BOS @ ORL,L,39,6,22,0.273,2,8,0.25,4,7,0.571,0,3,3,2,3,1,3,3,18,1,1,BOS,ORL,BOS,96,25.5,Pts+Rebs,23,21,20,5
Jaylen Brown,F,22023,1627759,22300043,"NOV 24, 2023",BOS @ ORL,L,39,6,22,0.273,2,8,0.25,4,7,0.571,0,3,3,2,3,1,3,3,18,1,1,BOS,ORL,BOS,96,23.5,Pts+Asts,23,21,20,5
Jaylen Brown,F,22023,1627759,22300043,"NOV 24, 2023",BOS @ ORL,L,39,6,22,0.273,2,8,0.25,4,7,0.571,0,3,3,2,3,1,3,3,18,1,1,BOS,ORL,BOS,96,9.5,Rebs+Asts,23,21,20,5
Jaylen Brown,F,22023,1627759,22300043,"NOV 24, 2023",BOS @ ORL,L,39,6,22,0.273,2,8,0.25,4,7,0.571,0,3,3,2,3,1,3,3,18,1,1,BOS,ORL,BOS,96,1.5,Blks+Stls,23,21,20,5
Jaylen Brown,F,22023,1627759,22300174,"NOV 11, 2023",BOS vs. TOR,W,32,12,20,0.6,3,8,0.375,2,3,0.667,1,4,5,2,0,0,2,1,29,9,1,BOS,BOS,TOR,117,20.0,Points,36,34,31,7
Jaylen Brown,F,22023,1627759,22300174,"NOV 11, 2023",BOS vs. TOR,W,32,12,20,0.6,3,8,0.375,2,3,0.667,1,4,5,2,0,0,2,1,29,9,1,BOS,BOS,TOR,117,6.0,Rebounds,36,34,31,7
Jaylen Brown,F,22023,1627759,22300174,"NOV 11, 2023",BOS vs. TOR,W,32,12,20,0.6,3,8,0.375,2,3,0.667,1,4,5,2,0,0,2,1,29,9,1,BOS,BOS,TOR,117,29.5,Pts+Rebs+Asts,36,34,31,7
Jaylen Brown,F,22023,1627759,22300174,"NOV 11, 2023",BOS vs. TOR,W,32,12,20,0.6,3,8,0.375,2,3,0.667,1,4,5,2,0,0,2,1,29,9,1,BOS,BOS,TOR,117,34.5,Fantasy Score,36,34,31,7
Jaylen Brown,F,22023,1627759,22300174,"NOV 11, 2023",BOS vs. TOR,W,32,12,20,0.6,3,8,0.375,2,3,0.667,1,4,5,2,0,0,2,1,29,9,1,BOS,BOS,TOR,117,2.5,Free Throws Made,36,34,31,7
Jaylen Brown,F,22023,1627759,22300174,"NOV 11, 2023",BOS vs. TOR,W,32,12,20,0.6,3,8,0.375,2,3,0.667,1,4,5,2,0,0,2,1,29,9,1,BOS,BOS,TOR,117,25.5,Pts+Rebs,36,34,31,7
Jaylen Brown,F,22023,1627759,22300174,"NOV 11, 2023",BOS vs. TOR,W,32,12,20,0.6,3,8,0.375,2,3,0.667,1,4,5,2,0,0,2,1,29,9,1,BOS,BOS,TOR,117,23.5,Pts+Asts,36,34,31,7
Jaylen Brown,F,22023,1627759,22300174,"NOV 11, 2023",BOS vs. TOR,W,32,12,20,0.6,3,8,0.375,2,3,0.667,1,4,5,2,0,0,2,1,29,9,1,BOS,BOS,TOR,117,9.5,Rebs+Asts,36,34,31,7
Jaylen Brown,F,22023,1627759,22300174,"NOV 11, 2023",BOS vs. TOR,W,32,12,20,0.6,3,8,0.375,2,3,0.667,1,4,5,2,0,0,2,1,29,9,1,BOS,BOS,TOR,117,1.5,Blks+Stls,36,34,31,7
Jaylen Brown,F,22023,1627759,22300010,"NOV 10, 2023",BOS vs. BKN,W,29,10,19,0.526,5,9,0.556,3,5,0.6,0,3,3,5,1,0,3,0,28,6,1,BOS,BOS,BKN,121,20.0,Points,36,31,33,8
Jaylen Brown,F,22023,1627759,22300010,"NOV 10, 2023",BOS vs. BKN,W,29,10,19,0.526,5,9,0.556,3,5,0.6,0,3,3,5,1,0,3,0,28,6,1,BOS,BOS,BKN,121,6.0,Rebounds,36,31,33,8
Jaylen Brown,F,22023,1627759,22300010,"NOV 10, 2023",BOS vs. BKN,W,29,10,19,0.526,5,9,0.556,3,5,0.6,0,3,3,5,1,0,3,0,28,6,1,BOS,BOS,BKN,121,29.5,Pts+Rebs+Asts,36,31,33,8
Jaylen Brown,F,22023,1627759,22300010,"NOV 10, 2023",BOS vs. BKN,W,29,10,19,0.526,5,9,0.556,3,5,0.6,0,3,3,5,1,0,3,0,28,6,1,BOS,BOS,BKN,121,34.5,Fantasy Score,36,31,33,8
Jaylen Brown,F,22023,1627759,22300010,"NOV 10, 2023",BOS vs. BKN,W,29,10,19,0.526,5,9,0.556,3,5,0.6,0,3,3,5,1,0,3,0,28,6,1,BOS,BOS,BKN,121,2.5,Free Throws Made,36,31,33,8
Jaylen Brown,F,22023,1627759,22300010,"NOV 10, 2023",BOS vs. BKN,W,29,10,19,0.526,5,9,0.556,3,5,0.6,0,3,3,5,1,0,3,0,28,6,1,BOS,BOS,BKN,121,25.5,Pts+Rebs,36,31,33,8
Jaylen Brown,F,22023,1627759,22300010,"NOV 10, 2023",BOS vs. BKN,W,29,10,19,0.526,5,9,0.556,3,5,0.6,0,3,3,5,1,0,3,0,28,6,1,BOS,BOS,BKN,121,23.5,Pts+Asts,36,31,33,8
Jaylen Brown,F,22023,1627759,22300010,"NOV 10, 2023",BOS vs. BKN,W,29,10,19,0.526,5,9,0.556,3,5,0.6,0,3,3,5,1,0,3,0,28,6,1,BOS,BOS,BKN,121,9.5,Rebs+Asts,36,31,33,8
Jaylen Brown,F,22023,1627759,22300010,"NOV 10, 2023",BOS vs. BKN,W,29,10,19,0.526,5,9,0.556,3,5,0.6,0,3,3,5,1,0,3,0,28,6,1,BOS,BOS,BKN,121,1.5,Blks+Stls,36,31,33,8
Jaylen Brown,F,22023,1627759,22300118,"NOV 01, 2023",BOS vs. IND,W,25,7,15,0.467,0,1,0.0,2,2,1.0,1,6,7,1,0,0,2,3,16,22,1,BOS,BOS,IND,155,20.0,Points,24,23,17,8
Jaylen Brown,F,22023,1627759,22300118,"NOV 01, 2023",BOS vs. IND,W,25,7,15,0.467,0,1,0.0,2,2,1.0,1,6,7,1,0,0,2,3,16,22,1,BOS,BOS,IND,155,6.0,Rebounds,24,23,17,8
Jaylen Brown,F,22023,1627759,22300118,"NOV 01, 2023",BOS vs. IND,W,25,7,15,0.467,0,1,0.0,2,2,1.0,1,6,7,1,0,0,2,3,16,22,1,BOS,BOS,IND,155,29.5,Pts+Rebs+Asts,24,23,17,8
Jaylen Brown,F,22023,1627759,22300118,"NOV 01, 2023",BOS vs. IND,W,25,7,15,0.467,0,1,0.0,2,2,1.0,1,6,7,1,0,0,2,3,16,22,1,BOS,BOS,IND,155,34.5,Fantasy Score,24,23,17,8
Jaylen Brown,F,22023,1627759,22300118,"NOV 01, 2023",BOS vs. IND,W,25,7,15,0.467,0,1,0.0,2,2,1.0,1,6,7,1,0,0,2,3,16,22,1,BOS,BOS,IND,155,2.5,Free Throws Made,24,23,17,8
Jaylen Brown,F,22023,1627759,22300118,"NOV 01, 2023",BOS vs. IND,W,25,7,15,0.467,0,1,0.0,2,2,1.0,1,6,7,1,0,0,2,3,16,22,1,BOS,BOS,IND,155,25.5,Pts+Rebs,24,23,17,8
Jaylen Brown,F,22023,1627759,22300118,"NOV 01, 2023",BOS vs. IND,W,25,7,15,0.467,0,1,0.0,2,2,1.0,1,6,7,1,0,0,2,3,16,22,1,BOS,BOS,IND,155,23.5,Pts+Asts,24,23,17,8
Jaylen Brown,F,22023,1627759,22300118,"NOV 01, 2023",BOS vs. IND,W,25,7,15,0.467,0,1,0.0,2,2,1.0,1,6,7,1,0,0,2,3,16,22,1,BOS,BOS,IND,155,9.5,Rebs+Asts,24,23,17,8
Jaylen Brown,F,22023,1627759,22300118,"NOV 01, 2023",BOS vs. IND,W,25,7,15,0.467,0,1,0.0,2,2,1.0,1,6,7,1,0,0,2,3,16,22,1,BOS,BOS,IND,155,1.5,Blks+Stls,24,23,17,8
Jaylen Brown,F,22023,1627759,22300103,"OCT 30, 2023",BOS @ WAS,W,32,13,24,0.542,8,13,0.615,2,4,0.5,0,6,6,2,3,1,0,3,36,32,1,BOS,WAS,BOS,126,20.0,Points,44,42,38,8
Jaylen Brown,F,22023,1627759,22300103,"OCT 30, 2023",BOS @ WAS,W,32,13,24,0.542,8,13,0.615,2,4,0.5,0,6,6,2,3,1,0,3,36,32,1,BOS,WAS,BOS,126,6.0,Rebounds,44,42,38,8
Jaylen Brown,F,22023,1627759,22300103,"OCT 30, 2023",BOS @ WAS,W,32,13,24,0.542,8,13,0.615,2,4,0.5,0,6,6,2,3,1,0,3,36,32,1,BOS,WAS,BOS,126,29.5,Pts+Rebs+Asts,44,42,38,8
Jaylen Brown,F,22023,1627759,22300103,"OCT 30, 2023",BOS @ WAS,W,32,13,24,0.542,8,13,0.615,2,4,0.5,0,6,6,2,3,1,0,3,36,32,1,BOS,WAS,BOS,126,34.5,Fantasy Score,44,42,38,8
Jaylen Brown,F,22023,1627759,22300103,"OCT 30, 2023",BOS @ WAS,W,32,13,24,0.542,8,13,0.615,2,4,0.5,0,6,6,2,3,1,0,3,36,32,1,BOS,WAS,BOS,126,2.5,Free Throws Made,44,42,38,8
Jaylen Brown,F,22023,1627759,22300103,"OCT 30, 2023",BOS @ WAS,W,32,13,24,0.542,8,13,0.615,2,4,0.5,0,6,6,2,3,1,0,3,36,32,1,BOS,WAS,BOS,126,25.5,Pts+Rebs,44,42,38,8
Jaylen Brown,F,22023,1627759,22300103,"OCT 30, 2023",BOS @ WAS,W,32,13,24,0.542,8,13,0.615,2,4,0.5,0,6,6,2,3,1,0,3,36,32,1,BOS,WAS,BOS,126,23.5,Pts+Asts,44,42,38,8
Jaylen Brown,F,22023,1627759,22300103,"OCT 30, 2023",BOS @ WAS,W,32,13,24,0.542,8,13,0.615,2,4,0.5,0,6,6,2,3,1,0,3,36,32,1,BOS,WAS,BOS,126,9.5,Rebs+Asts,44,42,38,8
Jaylen Brown,F,22023,1627759,22300103,"OCT 30, 2023",BOS @ WAS,W,32,13,24,0.542,8,13,0.615,2,4,0.5,0,6,6,2,3,1,0,3,36,32,1,BOS,WAS,BOS,126,1.5,Blks+Stls,44,42,38,8
Jaylen Brown,F,22023,1627759,22300729,"FEB 07, 2024",BOS vs. ATL,W,34,7,11,0.636,0,2,0.0,1,1,1.0,0,6,6,6,1,0,2,4,15,-3,1,BOS,BOS,ATL,125,20.0,Points,27,21,21,12
Jaylen Brown,F,22023,1627759,22300729,"FEB 07, 2024",BOS vs. ATL,W,34,7,11,0.636,0,2,0.0,1,1,1.0,0,6,6,6,1,0,2,4,15,-3,1,BOS,BOS,ATL,125,6.0,Rebounds,27,21,21,12
Jaylen Brown,F,22023,1627759,22300729,"FEB 07, 2024",BOS vs. ATL,W,34,7,11,0.636,0,2,0.0,1,1,1.0,0,6,6,6,1,0,2,4,15,-3,1,BOS,BOS,ATL,125,29.5,Pts+Rebs+Asts,27,21,21,12
Jaylen Brown,F,22023,1627759,22300729,"FEB 07, 2024",BOS vs. ATL,W,34,7,11,0.636,0,2,0.0,1,1,1.0,0,6,6,6,1,0,2,4,15,-3,1,BOS,BOS,ATL,125,34.5,Fantasy Score,27,21,21,12
Jaylen Brown,F,22023,1627759,22300729,"FEB 07, 2024",BOS vs. ATL,W,34,7,11,0.636,0,2,0.0,1,1,1.0,0,6,6,6,1,0,2,4,15,-3,1,BOS,BOS,ATL,125,2.5,Free Throws Made,27,21,21,12
Jaylen Brown,F,22023,1627759,22300729,"FEB 07, 2024",BOS vs. ATL,W,34,7,11,0.636,0,2,0.0,1,1,1.0,0,6,6,6,1,0,2,4,15,-3,1,BOS,BOS,ATL,125,25.5,Pts+Rebs,27,21,21,12
Jaylen Brown,F,22023,1627759,22300729,"FEB 07, 2024",BOS vs. ATL,W,34,7,11,0.636,0,2,0.0,1,1,1.0,0,6,6,6,1,0,2,4,15,-3,1,BOS,BOS,ATL,125,23.5,Pts+Asts,27,21,21,12
Jaylen Brown,F,22023,1627759,22300729,"FEB 07, 2024",BOS vs. ATL,W,34,7,11,0.636,0,2,0.0,1,1,1.0,0,6,6,6,1,0,2,4,15,-3,1,BOS,BOS,ATL,125,9.5,Rebs+Asts,27,21,21,12
Jaylen Brown,F,22023,1627759,22300729,"FEB 07, 2024",BOS vs. ATL,W,34,7,11,0.636,0,2,0.0,1,1,1.0,0,6,6,6,1,0,2,4,15,-3,1,BOS,BOS,ATL,125,1.5,Blks+Stls,27,21,21,12
Jaylen Brown,F,22023,1627759,22300670,"JAN 30, 2024",BOS vs. IND,W,36,9,15,0.6,0,3,0.0,7,8,0.875,2,4,6,2,2,0,0,0,25,-6,1,BOS,BOS,IND,129,20.0,Points,33,31,27,8
Jaylen Brown,F,22023,1627759,22300670,"JAN 30, 2024",BOS vs. IND,W,36,9,15,0.6,0,3,0.0,7,8,0.875,2,4,6,2,2,0,0,0,25,-6,1,BOS,BOS,IND,129,6.0,Rebounds,33,31,27,8
Jaylen Brown,F,22023,1627759,22300670,"JAN 30, 2024",BOS vs. IND,W,36,9,15,0.6,0,3,0.0,7,8,0.875,2,4,6,2,2,0,0,0,25,-6,1,BOS,BOS,IND,129,29.5,Pts+Rebs+Asts,33,31,27,8
Jaylen Brown,F,22023,1627759,22300670,"JAN 30, 2024",BOS vs. IND,W,36,9,15,0.6,0,3,0.0,7,8,0.875,2,4,6,2,2,0,0,0,25,-6,1,BOS,BOS,IND,129,34.5,Fantasy Score,33,31,27,8
Jaylen Brown,F,22023,1627759,22300670,"JAN 30, 2024",BOS vs. IND,W,36,9,15,0.6,0,3,0.0,7,8,0.875,2,4,6,2,2,0,0,0,25,-6,1,BOS,BOS,IND,129,2.5,Free Throws Made,33,31,27,8
Jaylen Brown,F,22023,1627759,22300670,"JAN 30, 2024",BOS vs. IND,W,36,9,15,0.6,0,3,0.0,7,8,0.875,2,4,6,2,2,0,0,0,25,-6,1,BOS,BOS,IND,129,25.5,Pts+Rebs,33,31,27,8
Jaylen Brown,F,22023,1627759,22300670,"JAN 30, 2024",BOS vs. IND,W,36,9,15,0.6,0,3,0.0,7,8,0.875,2,4,6,2,2,0,0,0,25,-6,1,BOS,BOS,IND,129,23.5,Pts+Asts,33,31,27,8
Jaylen Brown,F,22023,1627759,22300670,"JAN 30, 2024",BOS vs. IND,W,36,9,15,0.6,0,3,0.0,7,8,0.875,2,4,6,2,2,0,0,0,25,-6,1,BOS,BOS,IND,129,9.5,Rebs+Asts,33,31,27,8
Jaylen Brown,F,22023,1627759,22300670,"JAN 30, 2024",BOS vs. IND,W,36,9,15,0.6,0,3,0.0,7,8,0.875,2,4,6,2,2,0,0,0,25,-6,1,BOS,BOS,IND,129,1.5,Blks+Stls,33,31,27,8
Jaylen Brown,F,22023,1627759,22300659,"JAN 29, 2024",BOS vs. NOP,W,37,8,15,0.533,1,5,0.2,5,7,0.714,2,9,11,7,0,1,0,3,22,6,1,BOS,BOS,NOP,118,20.0,Points,40,33,29,18
Jaylen Brown,F,22023,1627759,22300659,"JAN 29, 2024",BOS vs. NOP,W,37,8,15,0.533,1,5,0.2,5,7,0.714,2,9,11,7,0,1,0,3,22,6,1,BOS,BOS,NOP,118,6.0,Rebounds,40,33,29,18
Jaylen Brown,F,22023,1627759,22300659,"JAN 29, 2024",BOS vs. NOP,W,37,8,15,0.533,1,5,0.2,5,7,0.714,2,9,11,7,0,1,0,3,22,6,1,BOS,BOS,NOP,118,29.5,Pts+Rebs+Asts,40,33,29,18
Jaylen Brown,F,22023,1627759,22300659,"JAN 29, 2024",BOS vs. NOP,W,37,8,15,0.533,1,5,0.2,5,7,0.714,2,9,11,7,0,1,0,3,22,6,1,BOS,BOS,NOP,118,34.5,Fantasy Score,40,33,29,18
Jaylen Brown,F,22023,1627759,22300659,"JAN 29, 2024",BOS vs. NOP,W,37,8,15,0.533,1,5,0.2,5,7,0.714,2,9,11,7,0,1,0,3,22,6,1,BOS,BOS,NOP,118,2.5,Free Throws Made,40,33,29,18
Jaylen Brown,F,22023,1627759,22300659,"JAN 29, 2024",BOS vs. NOP,W,37,8,15,0.533,1,5,0.2,5,7,0.714,2,9,11,7,0,1,0,3,22,6,1,BOS,BOS,NOP,118,25.5,Pts+Rebs,40,33,29,18
Jaylen Brown,F,22023,1627759,22300659,"JAN 29, 2024",BOS vs. NOP,W,37,8,15,0.533,1,5,0.2,5,7,0.714,2,9,11,7,0,1,0,3,22,6,1,BOS,BOS,NOP,118,23.5,Pts+Asts,40,33,29,18
Jaylen Brown,F,22023,1627759,22300659,"JAN 29, 2024",BOS vs. NOP,W,37,8,15,0.533,1,5,0.2,5,7,0.714,2,9,11,7,0,1,0,3,22,6,1,BOS,BOS,NOP,118,9.5,Rebs+Asts,40,33,29,18
Jaylen Brown,F,22023,1627759,22300659,"JAN 29, 2024",BOS vs. NOP,W,37,8,15,0.533,1,5,0.2,5,7,0.714,2,9,11,7,0,1,0,3,22,6,1,BOS,BOS,NOP,118,1.5,Blks+Stls,40,33,29,18
Jaylen Brown,F,22023,1627759,22300603,"JAN 21, 2024",BOS @ HOU,W,31,6,14,0.429,1,3,0.333,0,2,0.0,0,11,11,10,3,0,3,0,13,4,1,BOS,HOU,BOS,116,20.0,Points,34,24,23,21
Jaylen Brown,F,22023,1627759,22300603,"JAN 21, 2024",BOS @ HOU,W,31,6,14,0.429,1,3,0.333,0,2,0.0,0,11,11,10,3,0,3,0,13,4,1,BOS,HOU,BOS,116,6.0,Rebounds,34,24,23,21
Jaylen Brown,F,22023,1627759,22300603,"JAN 21, 2024",BOS @ HOU,W,31,6,14,0.429,1,3,0.333,0,2,0.0,0,11,11,10,3,0,3,0,13,4,1,BOS,HOU,BOS,116,29.5,Pts+Rebs+Asts,34,24,23,21
Jaylen Brown,F,22023,1627759,22300603,"JAN 21, 2024",BOS @ HOU,W,31,6,14,0.429,1,3,0.333,0,2,0.0,0,11,11,10,3,0,3,0,13,4,1,BOS,HOU,BOS,116,34.5,Fantasy Score,34,24,23,21
Jaylen Brown,F,22023,1627759,22300603,"JAN 21, 2024",BOS @ HOU,W,31,6,14,0.429,1,3,0.333,0,2,0.0,0,11,11,10,3,0,3,0,13,4,1,BOS,HOU,BOS,116,2.5,Free Throws Made,34,24,23,21
Jaylen Brown,F,22023,1627759,22300603,"JAN 21, 2024",BOS @ HOU,W,31,6,14,0.429,1,3,0.333,0,2,0.0,0,11,11,10,3,0,3,0,13,4,1,BOS,HOU,BOS,116,25.5,Pts+Rebs,34,24,23,21
Jaylen Brown,F,22023,1627759,22300603,"JAN 21, 2024",BOS @ HOU,W,31,6,14,0.429,1,3,0.333,0,2,0.0,0,11,11,10,3,0,3,0,13,4,1,BOS,HOU,BOS,116,23.5,Pts+Asts,34,24,23,21
Jaylen Brown,F,22023,1627759,22300603,"JAN 21, 2024",BOS @ HOU,W,31,6,14,0.429,1,3,0.333,0,2,0.0,0,11,11,10,3,0,3,0,13,4,1,BOS,HOU,BOS,116,9.5,Rebs+Asts,34,24,23,21
Jaylen Brown,F,22023,1627759,22300603,"JAN 21, 2024",BOS @ HOU,W,31,6,14,0.429,1,3,0.333,0,2,0.0,0,11,11,10,3,0,3,0,13,4,1,BOS,HOU,BOS,116,1.5,Blks+Stls,34,24,23,21
Jaylen Brown,F,22023,1627759,22300542,"JAN 13, 2024",BOS vs. HOU,W,28,11,15,0.733,4,6,0.667,6,10,0.6,1,5,6,2,2,2,3,5,32,19,1,BOS,BOS,HOU,145,20.0,Points,40,38,34,8
Jaylen Brown,F,22023,1627759,22300542,"JAN 13, 2024",BOS vs. HOU,W,28,11,15,0.733,4,6,0.667,6,10,0.6,1,5,6,2,2,2,3,5,32,19,1,BOS,BOS,HOU,145,6.0,Rebounds,40,38,34,8
Jaylen Brown,F,22023,1627759,22300542,"JAN 13, 2024",BOS vs. HOU,W,28,11,15,0.733,4,6,0.667,6,10,0.6,1,5,6,2,2,2,3,5,32,19,1,BOS,BOS,HOU,145,29.5,Pts+Rebs+Asts,40,38,34,8
Jaylen Brown,F,22023,1627759,22300542,"JAN 13, 2024",BOS vs. HOU,W,28,11,15,0.733,4,6,0.667,6,10,0.6,1,5,6,2,2,2,3,5,32,19,1,BOS,BOS,HOU,145,34.5,Fantasy Score,40,38,34,8
Jaylen Brown,F,22023,1627759,22300542,"JAN 13, 2024",BOS vs. HOU,W,28,11,15,0.733,4,6,0.667,6,10,0.6,1,5,6,2,2,2,3,5,32,19,1,BOS,BOS,HOU,145,2.5,Free Throws Made,40,38,34,8
Jaylen Brown,F,22023,1627759,22300542,"JAN 13, 2024",BOS vs. HOU,W,28,11,15,0.733,4,6,0.667,6,10,0.6,1,5,6,2,2,2,3,5,32,19,1,BOS,BOS,HOU,145,25.5,Pts+Rebs,40,38,34,8
Jaylen Brown,F,22023,1627759,22300542,"JAN 13, 2024",BOS vs. HOU,W,28,11,15,0.733,4,6,0.667,6,10,0.6,1,5,6,2,2,2,3,5,32,19,1,BOS,BOS,HOU,145,23.5,Pts+Asts,40,38,34,8
Jaylen Brown,F,22023,1627759,22300542,"JAN 13, 2024",BOS vs. HOU,W,28,11,15,0.733,4,6,0.667,6,10,0.6,1,5,6,2,2,2,3,5,32,19,1,BOS,BOS,HOU,145,9.5,Rebs+Asts,40,38,34,8
Jaylen Brown,F,22023,1627759,22300542,"JAN 13, 2024",BOS vs. HOU,W,28,11,15,0.733,4,6,0.667,6,10,0.6,1,5,6,2,2,2,3,5,32,19,1,BOS,BOS,HOU,145,1.5,Blks+Stls,40,38,34,8
Jaylen Brown,F,22023,1627759,22300517,"JAN 10, 2024",BOS vs. MIN,W,43,9,16,0.563,4,7,0.571,13,13,1.0,1,10,11,3,2,1,2,1,35,10,1,BOS,BOS,MIN,127,20.0,Points,49,46,38,14
Jaylen Brown,F,22023,1627759,22300517,"JAN 10, 2024",BOS vs. MIN,W,43,9,16,0.563,4,7,0.571,13,13,1.0,1,10,11,3,2,1,2,1,35,10,1,BOS,BOS,MIN,127,6.0,Rebounds,49,46,38,14
Jaylen Brown,F,22023,1627759,22300517,"JAN 10, 2024",BOS vs. MIN,W,43,9,16,0.563,4,7,0.571,13,13,1.0,1,10,11,3,2,1,2,1,35,10,1,BOS,BOS,MIN,127,29.5,Pts+Rebs+Asts,49,46,38,14
Jaylen Brown,F,22023,1627759,22300517,"JAN 10, 2024",BOS vs. MIN,W,43,9,16,0.563,4,7,0.571,13,13,1.0,1,10,11,3,2,1,2,1,35,10,1,BOS,BOS,MIN,127,34.5,Fantasy Score,49,46,38,14
Jaylen Brown,F,22023,1627759,22300517,"JAN 10, 2024",BOS vs. MIN,W,43,9,16,0.563,4,7,0.571,13,13,1.0,1,10,11,3,2,1,2,1,35,10,1,BOS,BOS,MIN,127,2.5,Free Throws Made,49,46,38,14
Jaylen Brown,F,22023,1627759,22300517,"JAN 10, 2024",BOS vs. MIN,W,43,9,16,0.563,4,7,0.571,13,13,1.0,1,10,11,3,2,1,2,1,35,10,1,BOS,BOS,MIN,127,25.5,Pts+Rebs,49,46,38,14
Jaylen Brown,F,22023,1627759,22300517,"JAN 10, 2024",BOS vs. MIN,W,43,9,16,0.563,4,7,0.571,13,13,1.0,1,10,11,3,2,1,2,1,35,10,1,BOS,BOS,MIN,127,23.5,Pts+Asts,49,46,38,14
Jaylen Brown,F,22023,1627759,22300517,"JAN 10, 2024",BOS vs. MIN,W,43,9,16,0.563,4,7,0.571,13,13,1.0,1,10,11,3,2,1,2,1,35,10,1,BOS,BOS,MIN,127,9.5,Rebs+Asts,49,46,38,14
Jaylen Brown,F,22023,1627759,22300517,"JAN 10, 2024",BOS vs. MIN,W,43,9,16,0.563,4,7,0.571,13,13,1.0,1,10,11,3,2,1,2,1,35,10,1,BOS,BOS,MIN,127,1.5,Blks+Stls,49,46,38,14
Jaylen Brown,F,22023,1627759,22300373,"DEC 20, 2023",BOS @ SAC,W,29,11,21,0.524,0,3,0.0,6,7,0.857,1,4,5,6,0,0,0,2,28,22,1,BOS,SAC,BOS,144,20.0,Points,39,33,34,11
Jaylen Brown,F,22023,1627759,22300373,"DEC 20, 2023",BOS @ SAC,W,29,11,21,0.524,0,3,0.0,6,7,0.857,1,4,5,6,0,0,0,2,28,22,1,BOS,SAC,BOS,144,6.0,Rebounds,39,33,34,11
Jaylen Brown,F,22023,1627759,22300373,"DEC 20, 2023",BOS @ SAC,W,29,11,21,0.524,0,3,0.0,6,7,0.857,1,4,5,6,0,0,0,2,28,22,1,BOS,SAC,BOS,144,29.5,Pts+Rebs+Asts,39,33,34,11
Jaylen Brown,F,22023,1627759,22300373,"DEC 20, 2023",BOS @ SAC,W,29,11,21,0.524,0,3,0.0,6,7,0.857,1,4,5,6,0,0,0,2,28,22,1,BOS,SAC,BOS,144,34.5,Fantasy Score,39,33,34,11
Jaylen Brown,F,22023,1627759,22300373,"DEC 20, 2023",BOS @ SAC,W,29,11,21,0.524,0,3,0.0,6,7,0.857,1,4,5,6,0,0,0,2,28,22,1,BOS,SAC,BOS,144,2.5,Free Throws Made,39,33,34,11
Jaylen Brown,F,22023,1627759,22300373,"DEC 20, 2023",BOS @ SAC,W,29,11,21,0.524,0,3,0.0,6,7,0.857,1,4,5,6,0,0,0,2,28,22,1,BOS,SAC,BOS,144,25.5,Pts+Rebs,39,33,34,11
Jaylen Brown,F,22023,1627759,22300373,"DEC 20, 2023",BOS @ SAC,W,29,11,21,0.524,0,3,0.0,6,7,0.857,1,4,5,6,0,0,0,2,28,22,1,BOS,SAC,BOS,144,23.5,Pts+Asts,39,33,34,11
Jaylen Brown,F,22023,1627759,22300373,"DEC 20, 2023",BOS @ SAC,W,29,11,21,0.524,0,3,0.0,6,7,0.857,1,4,5,6,0,0,0,2,28,22,1,BOS,SAC,BOS,144,9.5,Rebs+Asts,39,33,34,11
Jaylen Brown,F,22023,1627759,22300373,"DEC 20, 2023",BOS @ SAC,W,29,11,21,0.524,0,3,0.0,6,7,0.857,1,4,5,6,0,0,0,2,28,22,1,BOS,SAC,BOS,144,1.5,Blks+Stls,39,33,34,11
Jaylen Brown,F,22023,1627759,22300362,"DEC 19, 2023",BOS @ GSW,L,41,10,22,0.455,1,4,0.25,7,8,0.875,3,5,8,7,0,1,4,2,28,-3,1,BOS,GSW,BOS,126,20.0,Points,43,36,35,15
Jaylen Brown,F,22023,1627759,22300362,"DEC 19, 2023",BOS @ GSW,L,41,10,22,0.455,1,4,0.25,7,8,0.875,3,5,8,7,0,1,4,2,28,-3,1,BOS,GSW,BOS,126,6.0,Rebounds,43,36,35,15
Jaylen Brown,F,22023,1627759,22300362,"DEC 19, 2023",BOS @ GSW,L,41,10,22,0.455,1,4,0.25,7,8,0.875,3,5,8,7,0,1,4,2,28,-3,1,BOS,GSW,BOS,126,29.5,Pts+Rebs+Asts,43,36,35,15
Jaylen Brown,F,22023,1627759,22300362,"DEC 19, 2023",BOS @ GSW,L,41,10,22,0.455,1,4,0.25,7,8,0.875,3,5,8,7,0,1,4,2,28,-3,1,BOS,GSW,BOS,126,34.5,Fantasy Score,43,36,35,15
Jaylen Brown,F,22023,1627759,22300362,"DEC 19, 2023",BOS @ GSW,L,41,10,22,0.455,1,4,0.25,7,8,0.875,3,5,8,7,0,1,4,2,28,-3,1,BOS,GSW,BOS,126,2.5,Free Throws Made,43,36,35,15
Jaylen Brown,F,22023,1627759,22300362,"DEC 19, 2023",BOS @ GSW,L,41,10,22,0.455,1,4,0.25,7,8,0.875,3,5,8,7,0,1,4,2,28,-3,1,BOS,GSW,BOS,126,25.5,Pts+Rebs,43,36,35,15
Jaylen Brown,F,22023,1627759,22300362,"DEC 19, 2023",BOS @ GSW,L,41,10,22,0.455,1,4,0.25,7,8,0.875,3,5,8,7,0,1,4,2,28,-3,1,BOS,GSW,BOS,126,23.5,Pts+Asts,43,36,35,15
Jaylen Brown,F,22023,1627759,22300362,"DEC 19, 2023",BOS @ GSW,L,41,10,22,0.455,1,4,0.25,7,8,0.875,3,5,8,7,0,1,4,2,28,-3,1,BOS,GSW,BOS,126,9.5,Rebs+Asts,43,36,35,15
Jaylen Brown,F,22023,1627759,22300362,"DEC 19, 2023",BOS @ GSW,L,41,10,22,0.455,1,4,0.25,7,8,0.875,3,5,8,7,0,1,4,2,28,-3,1,BOS,GSW,BOS,126,1.5,Blks+Stls,43,36,35,15
Jaylen Brown,F,22023,1627759,22300329,"DEC 15, 2023",BOS vs. ORL,W,30,8,15,0.533,0,5,0.0,2,3,0.667,0,3,3,4,0,1,2,0,18,20,1,BOS,BOS,ORL,128,20.0,Points,25,21,22,7
Jaylen Brown,F,22023,1627759,22300329,"DEC 15, 2023",BOS vs. ORL,W,30,8,15,0.533,0,5,0.0,2,3,0.667,0,3,3,4,0,1,2,0,18,20,1,BOS,BOS,ORL,128,6.0,Rebounds,25,21,22,7
Jaylen Brown,F,22023,1627759,22300329,"DEC 15, 2023",BOS vs. ORL,W,30,8,15,0.533,0,5,0.0,2,3,0.667,0,3,3,4,0,1,2,0,18,20,1,BOS,BOS,ORL,128,29.5,Pts+Rebs+Asts,25,21,22,7
Jaylen Brown,F,22023,1627759,22300329,"DEC 15, 2023",BOS vs. ORL,W,30,8,15,0.533,0,5,0.0,2,3,0.667,0,3,3,4,0,1,2,0,18,20,1,BOS,BOS,ORL,128,34.5,Fantasy Score,25,21,22,7
Jaylen Brown,F,22023,1627759,22300329,"DEC 15, 2023",BOS vs. ORL,W,30,8,15,0.533,0,5,0.0,2,3,0.667,0,3,3,4,0,1,2,0,18,20,1,BOS,BOS,ORL,128,2.5,Free Throws Made,25,21,22,7
Jaylen Brown,F,22023,1627759,22300329,"DEC 15, 2023",BOS vs. ORL,W,30,8,15,0.533,0,5,0.0,2,3,0.667,0,3,3,4,0,1,2,0,18,20,1,BOS,BOS,ORL,128,25.5,Pts+Rebs,25,21,22,7
Jaylen Brown,F,22023,1627759,22300329,"DEC 15, 2023",BOS vs. ORL,W,30,8,15,0.533,0,5,0.0,2,3,0.667,0,3,3,4,0,1,2,0,18,20,1,BOS,BOS,ORL,128,23.5,Pts+Asts,25,21,22,7
Jaylen Brown,F,22023,1627759,22300329,"DEC 15, 2023",BOS vs. ORL,W,30,8,15,0.533,0,5,0.0,2,3,0.667,0,3,3,4,0,1,2,0,18,20,1,BOS,BOS,ORL,128,9.5,Rebs+Asts,25,21,22,7
Jaylen Brown,F,22023,1627759,22300329,"DEC 15, 2023",BOS vs. ORL,W,30,8,15,0.533,0,5,0.0,2,3,0.667,0,3,3,4,0,1,2,0,18,20,1,BOS,BOS,ORL,128,1.5,Blks+Stls,25,21,22,7
Jaylen Brown,F,22023,1627759,22300217,"NOV 20, 2023",BOS @ CHA,L,34,5,17,0.294,0,5,0.0,3,4,0.75,1,3,4,3,0,0,2,5,13,-23,1,BOS,CHA,BOS,118,20.0,Points,20,17,16,7
Jaylen Brown,F,22023,1627759,22300217,"NOV 20, 2023",BOS @ CHA,L,34,5,17,0.294,0,5,0.0,3,4,0.75,1,3,4,3,0,0,2,5,13,-23,1,BOS,CHA,BOS,118,6.0,Rebounds,20,17,16,7
Jaylen Brown,F,22023,1627759,22300217,"NOV 20, 2023",BOS @ CHA,L,34,5,17,0.294,0,5,0.0,3,4,0.75,1,3,4,3,0,0,2,5,13,-23,1,BOS,CHA,BOS,118,29.5,Pts+Rebs+Asts,20,17,16,7
Jaylen Brown,F,22023,1627759,22300217,"NOV 20, 2023",BOS @ CHA,L,34,5,17,0.294,0,5,0.0,3,4,0.75,1,3,4,3,0,0,2,5,13,-23,1,BOS,CHA,BOS,118,34.5,Fantasy Score,20,17,16,7
Jaylen Brown,F,22023,1627759,22300217,"NOV 20, 2023",BOS @ CHA,L,34,5,17,0.294,0,5,0.0,3,4,0.75,1,3,4,3,0,0,2,5,13,-23,1,BOS,CHA,BOS,118,2.5,Free Throws Made,20,17,16,7
Jaylen Brown,F,22023,1627759,22300217,"NOV 20, 2023",BOS @ CHA,L,34,5,17,0.294,0,5,0.0,3,4,0.75,1,3,4,3,0,0,2,5,13,-23,1,BOS,CHA,BOS,118,25.5,Pts+Rebs,20,17,16,7
Jaylen Brown,F,22023,1627759,22300217,"NOV 20, 2023",BOS @ CHA,L,34,5,17,0.294,0,5,0.0,3,4,0.75,1,3,4,3,0,0,2,5,13,-23,1,BOS,CHA,BOS,118,23.5,Pts+Asts,20,17,16,7
Jaylen Brown,F,22023,1627759,22300217,"NOV 20, 2023",BOS @ CHA,L,34,5,17,0.294,0,5,0.0,3,4,0.75,1,3,4,3,0,0,2,5,13,-23,1,BOS,CHA,BOS,118,9.5,Rebs+Asts,20,17,16,7
Jaylen Brown,F,22023,1627759,22300217,"NOV 20, 2023",BOS @ CHA,L,34,5,17,0.294,0,5,0.0,3,4,0.75,1,3,4,3,0,0,2,5,13,-23,1,BOS,CHA,BOS,118,1.5,Blks+Stls,20,17,16,7
Jaylen Brown,F,22023,1627759,22300136,"NOV 04, 2023",BOS @ BKN,W,35,7,22,0.318,2,11,0.182,7,8,0.875,0,5,5,4,0,1,2,4,23,6,1,BOS,BKN,BOS,124,20.0,Points,32,28,27,9
Jaylen Brown,F,22023,1627759,22300136,"NOV 04, 2023",BOS @ BKN,W,35,7,22,0.318,2,11,0.182,7,8,0.875,0,5,5,4,0,1,2,4,23,6,1,BOS,BKN,BOS,124,6.0,Rebounds,32,28,27,9
Jaylen Brown,F,22023,1627759,22300136,"NOV 04, 2023",BOS @ BKN,W,35,7,22,0.318,2,11,0.182,7,8,0.875,0,5,5,4,0,1,2,4,23,6,1,BOS,BKN,BOS,124,29.5,Pts+Rebs+Asts,32,28,27,9
Jaylen Brown,F,22023,1627759,22300136,"NOV 04, 2023",BOS @ BKN,W,35,7,22,0.318,2,11,0.182,7,8,0.875,0,5,5,4,0,1,2,4,23,6,1,BOS,BKN,BOS,124,34.5,Fantasy Score,32,28,27,9
Jaylen Brown,F,22023,1627759,22300136,"NOV 04, 2023",BOS @ BKN,W,35,7,22,0.318,2,11,0.182,7,8,0.875,0,5,5,4,0,1,2,4,23,6,1,BOS,BKN,BOS,124,2.5,Free Throws Made,32,28,27,9
Jaylen Brown,F,22023,1627759,22300136,"NOV 04, 2023",BOS @ BKN,W,35,7,22,0.318,2,11,0.182,7,8,0.875,0,5,5,4,0,1,2,4,23,6,1,BOS,BKN,BOS,124,25.5,Pts+Rebs,32,28,27,9
Jaylen Brown,F,22023,1627759,22300136,"NOV 04, 2023",BOS @ BKN,W,35,7,22,0.318,2,11,0.182,7,8,0.875,0,5,5,4,0,1,2,4,23,6,1,BOS,BKN,BOS,124,23.5,Pts+Asts,32,28,27,9
Jaylen Brown,F,22023,1627759,22300136,"NOV 04, 2023",BOS @ BKN,W,35,7,22,0.318,2,11,0.182,7,8,0.875,0,5,5,4,0,1,2,4,23,6,1,BOS,BKN,BOS,124,9.5,Rebs+Asts,32,28,27,9
Jaylen Brown,F,22023,1627759,22300136,"NOV 04, 2023",BOS @ BKN,W,35,7,22,0.318,2,11,0.182,7,8,0.875,0,5,5,4,0,1,2,4,23,6,1,BOS,BKN,BOS,124,1.5,Blks+Stls,32,28,27,9
Jaylen Brown,F,22023,1627759,22300080,"OCT 27, 2023",BOS vs. MIA,W,34,11,22,0.5,3,7,0.429,2,4,0.5,2,4,6,1,2,0,4,1,27,3,1,BOS,BOS,MIA,119,20.0,Points,34,33,28,7
Jaylen Brown,F,22023,1627759,22300080,"OCT 27, 2023",BOS vs. MIA,W,34,11,22,0.5,3,7,0.429,2,4,0.5,2,4,6,1,2,0,4,1,27,3,1,BOS,BOS,MIA,119,6.0,Rebounds,34,33,28,7
Jaylen Brown,F,22023,1627759,22300080,"OCT 27, 2023",BOS vs. MIA,W,34,11,22,0.5,3,7,0.429,2,4,0.5,2,4,6,1,2,0,4,1,27,3,1,BOS,BOS,MIA,119,29.5,Pts+Rebs+Asts,34,33,28,7
Jaylen Brown,F,22023,1627759,22300080,"OCT 27, 2023",BOS vs. MIA,W,34,11,22,0.5,3,7,0.429,2,4,0.5,2,4,6,1,2,0,4,1,27,3,1,BOS,BOS,MIA,119,34.5,Fantasy Score,34,33,28,7
Jaylen Brown,F,22023,1627759,22300080,"OCT 27, 2023",BOS vs. MIA,W,34,11,22,0.5,3,7,0.429,2,4,0.5,2,4,6,1,2,0,4,1,27,3,1,BOS,BOS,MIA,119,2.5,Free Throws Made,34,33,28,7
Jaylen Brown,F,22023,1627759,22300080,"OCT 27, 2023",BOS vs. MIA,W,34,11,22,0.5,3,7,0.429,2,4,0.5,2,4,6,1,2,0,4,1,27,3,1,BOS,BOS,MIA,119,25.5,Pts+Rebs,34,33,28,7
Jaylen Brown,F,22023,1627759,22300080,"OCT 27, 2023",BOS vs. MIA,W,34,11,22,0.5,3,7,0.429,2,4,0.5,2,4,6,1,2,0,4,1,27,3,1,BOS,BOS,MIA,119,23.5,Pts+Asts,34,33,28,7
Jaylen Brown,F,22023,1627759,22300080,"OCT 27, 2023",BOS vs. MIA,W,34,11,22,0.5,3,7,0.429,2,4,0.5,2,4,6,1,2,0,4,1,27,3,1,BOS,BOS,MIA,119,9.5,Rebs+Asts,34,33,28,7
Jaylen Brown,F,22023,1627759,22300080,"OCT 27, 2023",BOS vs. MIA,W,34,11,22,0.5,3,7,0.429,2,4,0.5,2,4,6,1,2,0,4,1,27,3,1,BOS,BOS,MIA,119,1.5,Blks+Stls,34,33,28,7
Jaylen Brown,F,22023,1627759,22300743,"FEB 09, 2024",BOS vs. WAS,W,35,9,15,0.6,0,1,0.0,0,0,0.0,1,6,7,3,1,0,3,3,18,-15,1,BOS,BOS,WAS,133,20.0,Points,28,25,21,10
Jaylen Brown,F,22023,1627759,22300743,"FEB 09, 2024",BOS vs. WAS,W,35,9,15,0.6,0,1,0.0,0,0,0.0,1,6,7,3,1,0,3,3,18,-15,1,BOS,BOS,WAS,133,6.0,Rebounds,28,25,21,10
Jaylen Brown,F,22023,1627759,22300743,"FEB 09, 2024",BOS vs. WAS,W,35,9,15,0.6,0,1,0.0,0,0,0.0,1,6,7,3,1,0,3,3,18,-15,1,BOS,BOS,WAS,133,29.5,Pts+Rebs+Asts,28,25,21,10
Jaylen Brown,F,22023,1627759,22300743,"FEB 09, 2024",BOS vs. WAS,W,35,9,15,0.6,0,1,0.0,0,0,0.0,1,6,7,3,1,0,3,3,18,-15,1,BOS,BOS,WAS,133,34.5,Fantasy Score,28,25,21,10
Jaylen Brown,F,22023,1627759,22300743,"FEB 09, 2024",BOS vs. WAS,W,35,9,15,0.6,0,1,0.0,0,0,0.0,1,6,7,3,1,0,3,3,18,-15,1,BOS,BOS,WAS,133,2.5,Free Throws Made,28,25,21,10
Jaylen Brown,F,22023,1627759,22300743,"FEB 09, 2024",BOS vs. WAS,W,35,9,15,0.6,0,1,0.0,0,0,0.0,1,6,7,3,1,0,3,3,18,-15,1,BOS,BOS,WAS,133,25.5,Pts+Rebs,28,25,21,10
Jaylen Brown,F,22023,1627759,22300743,"FEB 09, 2024",BOS vs. WAS,W,35,9,15,0.6,0,1,0.0,0,0,0.0,1,6,7,3,1,0,3,3,18,-15,1,BOS,BOS,WAS,133,23.5,Pts+Asts,28,25,21,10
Jaylen Brown,F,22023,1627759,22300743,"FEB 09, 2024",BOS vs. WAS,W,35,9,15,0.6,0,1,0.0,0,0,0.0,1,6,7,3,1,0,3,3,18,-15,1,BOS,BOS,WAS,133,9.5,Rebs+Asts,28,25,21,10
Jaylen Brown,F,22023,1627759,22300743,"FEB 09, 2024",BOS vs. WAS,W,35,9,15,0.6,0,1,0.0,0,0,0.0,1,6,7,3,1,0,3,3,18,-15,1,BOS,BOS,WAS,133,1.5,Blks+Stls,28,25,21,10
Jaylen Brown,F,22023,1627759,22300611,"JAN 22, 2024",BOS @ DAL,W,37,13,22,0.591,2,7,0.286,6,9,0.667,1,2,3,4,0,2,0,5,34,-6,1,BOS,DAL,BOS,119,20.0,Points,41,37,38,7
Jaylen Brown,F,22023,1627759,22300611,"JAN 22, 2024",BOS @ DAL,W,37,13,22,0.591,2,7,0.286,6,9,0.667,1,2,3,4,0,2,0,5,34,-6,1,BOS,DAL,BOS,119,6.0,Rebounds,41,37,38,7
Jaylen Brown,F,22023,1627759,22300611,"JAN 22, 2024",BOS @ DAL,W,37,13,22,0.591,2,7,0.286,6,9,0.667,1,2,3,4,0,2,0,5,34,-6,1,BOS,DAL,BOS,119,29.5,Pts+Rebs+Asts,41,37,38,7
Jaylen Brown,F,22023,1627759,22300611,"JAN 22, 2024",BOS @ DAL,W,37,13,22,0.591,2,7,0.286,6,9,0.667,1,2,3,4,0,2,0,5,34,-6,1,BOS,DAL,BOS,119,34.5,Fantasy Score,41,37,38,7
Jaylen Brown,F,22023,1627759,22300611,"JAN 22, 2024",BOS @ DAL,W,37,13,22,0.591,2,7,0.286,6,9,0.667,1,2,3,4,0,2,0,5,34,-6,1,BOS,DAL,BOS,119,2.5,Free Throws Made,41,37,38,7
Jaylen Brown,F,22023,1627759,22300611,"JAN 22, 2024",BOS @ DAL,W,37,13,22,0.591,2,7,0.286,6,9,0.667,1,2,3,4,0,2,0,5,34,-6,1,BOS,DAL,BOS,119,25.5,Pts+Rebs,41,37,38,7
Jaylen Brown,F,22023,1627759,22300611,"JAN 22, 2024",BOS @ DAL,W,37,13,22,0.591,2,7,0.286,6,9,0.667,1,2,3,4,0,2,0,5,34,-6,1,BOS,DAL,BOS,119,23.5,Pts+Asts,41,37,38,7
Jaylen Brown,F,22023,1627759,22300611,"JAN 22, 2024",BOS @ DAL,W,37,13,22,0.591,2,7,0.286,6,9,0.667,1,2,3,4,0,2,0,5,34,-6,1,BOS,DAL,BOS,119,9.5,Rebs+Asts,41,37,38,7
Jaylen Brown,F,22023,1627759,22300611,"JAN 22, 2024",BOS @ DAL,W,37,13,22,0.591,2,7,0.286,6,9,0.667,1,2,3,4,0,2,0,5,34,-6,1,BOS,DAL,BOS,119,1.5,Blks+Stls,41,37,38,7
Jaylen Brown,F,22023,1627759,22300586,"JAN 19, 2024",BOS vs. DEN,L,36,6,19,0.316,1,9,0.111,0,2,0.0,0,2,2,1,2,0,0,3,13,-2,1,BOS,BOS,DEN,100,20.0,Points,16,15,14,3
Jaylen Brown,F,22023,1627759,22300586,"JAN 19, 2024",BOS vs. DEN,L,36,6,19,0.316,1,9,0.111,0,2,0.0,0,2,2,1,2,0,0,3,13,-2,1,BOS,BOS,DEN,100,6.0,Rebounds,16,15,14,3
Jaylen Brown,F,22023,1627759,22300586,"JAN 19, 2024",BOS vs. DEN,L,36,6,19,0.316,1,9,0.111,0,2,0.0,0,2,2,1,2,0,0,3,13,-2,1,BOS,BOS,DEN,100,29.5,Pts+Rebs+Asts,16,15,14,3
Jaylen Brown,F,22023,1627759,22300586,"JAN 19, 2024",BOS vs. DEN,L,36,6,19,0.316,1,9,0.111,0,2,0.0,0,2,2,1,2,0,0,3,13,-2,1,BOS,BOS,DEN,100,34.5,Fantasy Score,16,15,14,3
Jaylen Brown,F,22023,1627759,22300586,"JAN 19, 2024",BOS vs. DEN,L,36,6,19,0.316,1,9,0.111,0,2,0.0,0,2,2,1,2,0,0,3,13,-2,1,BOS,BOS,DEN,100,2.5,Free Throws Made,16,15,14,3
Jaylen Brown,F,22023,1627759,22300586,"JAN 19, 2024",BOS vs. DEN,L,36,6,19,0.316,1,9,0.111,0,2,0.0,0,2,2,1,2,0,0,3,13,-2,1,BOS,BOS,DEN,100,25.5,Pts+Rebs,16,15,14,3
Jaylen Brown,F,22023,1627759,22300586,"JAN 19, 2024",BOS vs. DEN,L,36,6,19,0.316,1,9,0.111,0,2,0.0,0,2,2,1,2,0,0,3,13,-2,1,BOS,BOS,DEN,100,23.5,Pts+Asts,16,15,14,3
Jaylen Brown,F,22023,1627759,22300586,"JAN 19, 2024",BOS vs. DEN,L,36,6,19,0.316,1,9,0.111,0,2,0.0,0,2,2,1,2,0,0,3,13,-2,1,BOS,BOS,DEN,100,9.5,Rebs+Asts,16,15,14,3
Jaylen Brown,F,22023,1627759,22300586,"JAN 19, 2024",BOS vs. DEN,L,36,6,19,0.316,1,9,0.111,0,2,0.0,0,2,2,1,2,0,0,3,13,-2,1,BOS,BOS,DEN,100,1.5,Blks+Stls,16,15,14,3
Jaylen Brown,F,22023,1627759,22300462,"JAN 02, 2024",BOS @ OKC,L,38,4,18,0.222,0,8,0.0,7,8,0.875,2,4,6,3,0,0,4,5,15,-1,1,BOS,OKC,BOS,123,20.0,Points,24,21,18,9
Jaylen Brown,F,22023,1627759,22300462,"JAN 02, 2024",BOS @ OKC,L,38,4,18,0.222,0,8,0.0,7,8,0.875,2,4,6,3,0,0,4,5,15,-1,1,BOS,OKC,BOS,123,6.0,Rebounds,24,21,18,9
Jaylen Brown,F,22023,1627759,22300462,"JAN 02, 2024",BOS @ OKC,L,38,4,18,0.222,0,8,0.0,7,8,0.875,2,4,6,3,0,0,4,5,15,-1,1,BOS,OKC,BOS,123,29.5,Pts+Rebs+Asts,24,21,18,9
Jaylen Brown,F,22023,1627759,22300462,"JAN 02, 2024",BOS @ OKC,L,38,4,18,0.222,0,8,0.0,7,8,0.875,2,4,6,3,0,0,4,5,15,-1,1,BOS,OKC,BOS,123,34.5,Fantasy Score,24,21,18,9
Jaylen Brown,F,22023,1627759,22300462,"JAN 02, 2024",BOS @ OKC,L,38,4,18,0.222,0,8,0.0,7,8,0.875,2,4,6,3,0,0,4,5,15,-1,1,BOS,OKC,BOS,123,2.5,Free Throws Made,24,21,18,9
Jaylen Brown,F,22023,1627759,22300462,"JAN 02, 2024",BOS @ OKC,L,38,4,18,0.222,0,8,0.0,7,8,0.875,2,4,6,3,0,0,4,5,15,-1,1,BOS,OKC,BOS,123,25.5,Pts+Rebs,24,21,18,9
Jaylen Brown,F,22023,1627759,22300462,"JAN 02, 2024",BOS @ OKC,L,38,4,18,0.222,0,8,0.0,7,8,0.875,2,4,6,3,0,0,4,5,15,-1,1,BOS,OKC,BOS,123,23.5,Pts+Asts,24,21,18,9
Jaylen Brown,F,22023,1627759,22300462,"JAN 02, 2024",BOS @ OKC,L,38,4,18,0.222,0,8,0.0,7,8,0.875,2,4,6,3,0,0,4,5,15,-1,1,BOS,OKC,BOS,123,9.5,Rebs+Asts,24,21,18,9
Jaylen Brown,F,22023,1627759,22300462,"JAN 02, 2024",BOS @ OKC,L,38,4,18,0.222,0,8,0.0,7,8,0.875,2,4,6,3,0,0,4,5,15,-1,1,BOS,OKC,BOS,123,1.5,Blks+Stls,24,21,18,9
Jaylen Brown,F,22023,1627759,22300403,"DEC 25, 2023",BOS @ LAL,W,33,7,17,0.412,1,5,0.2,4,7,0.571,3,2,5,2,3,0,2,3,19,9,1,BOS,LAL,BOS,126,20.0,Points,26,24,21,7
Jaylen Brown,F,22023,1627759,22300403,"DEC 25, 2023",BOS @ LAL,W,33,7,17,0.412,1,5,0.2,4,7,0.571,3,2,5,2,3,0,2,3,19,9,1,BOS,LAL,BOS,126,6.0,Rebounds,26,24,21,7
Jaylen Brown,F,22023,1627759,22300403,"DEC 25, 2023",BOS @ LAL,W,33,7,17,0.412,1,5,0.2,4,7,0.571,3,2,5,2,3,0,2,3,19,9,1,BOS,LAL,BOS,126,29.5,Pts+Rebs+Asts,26,24,21,7
Jaylen Brown,F,22023,1627759,22300403,"DEC 25, 2023",BOS @ LAL,W,33,7,17,0.412,1,5,0.2,4,7,0.571,3,2,5,2,3,0,2,3,19,9,1,BOS,LAL,BOS,126,34.5,Fantasy Score,26,24,21,7
Jaylen Brown,F,22023,1627759,22300403,"DEC 25, 2023",BOS @ LAL,W,33,7,17,0.412,1,5,0.2,4,7,0.571,3,2,5,2,3,0,2,3,19,9,1,BOS,LAL,BOS,126,2.5,Free Throws Made,26,24,21,7
Jaylen Brown,F,22023,1627759,22300403,"DEC 25, 2023",BOS @ LAL,W,33,7,17,0.412,1,5,0.2,4,7,0.571,3,2,5,2,3,0,2,3,19,9,1,BOS,LAL,BOS,126,25.5,Pts+Rebs,26,24,21,7
Jaylen Brown,F,22023,1627759,22300403,"DEC 25, 2023",BOS @ LAL,W,33,7,17,0.412,1,5,0.2,4,7,0.571,3,2,5,2,3,0,2,3,19,9,1,BOS,LAL,BOS,126,23.5,Pts+Asts,26,24,21,7
Jaylen Brown,F,22023,1627759,22300403,"DEC 25, 2023",BOS @ LAL,W,33,7,17,0.412,1,5,0.2,4,7,0.571,3,2,5,2,3,0,2,3,19,9,1,BOS,LAL,BOS,126,9.5,Rebs+Asts,26,24,21,7
Jaylen Brown,F,22023,1627759,22300403,"DEC 25, 2023",BOS @ LAL,W,33,7,17,0.412,1,5,0.2,4,7,0.571,3,2,5,2,3,0,2,3,19,9,1,BOS,LAL,BOS,126,1.5,Blks+Stls,26,24,21,7
Jaylen Brown,F,22023,1627759,22300319,"DEC 14, 2023",BOS vs. CLE,W,36,10,20,0.5,2,5,0.4,0,0,0.0,2,3,5,5,2,0,2,3,22,4,1,BOS,BOS,CLE,116,20.0,Points,32,27,27,10
Jaylen Brown,F,22023,1627759,22300319,"DEC 14, 2023",BOS vs. CLE,W,36,10,20,0.5,2,5,0.4,0,0,0.0,2,3,5,5,2,0,2,3,22,4,1,BOS,BOS,CLE,116,6.0,Rebounds,32,27,27,10
Jaylen Brown,F,22023,1627759,22300319,"DEC 14, 2023",BOS vs. CLE,W,36,10,20,0.5,2,5,0.4,0,0,0.0,2,3,5,5,2,0,2,3,22,4,1,BOS,BOS,CLE,116,29.5,Pts+Rebs+Asts,32,27,27,10
Jaylen Brown,F,22023,1627759,22300319,"DEC 14, 2023",BOS vs. CLE,W,36,10,20,0.5,2,5,0.4,0,0,0.0,2,3,5,5,2,0,2,3,22,4,1,BOS,BOS,CLE,116,34.5,Fantasy Score,32,27,27,10
Jaylen Brown,F,22023,1627759,22300319,"DEC 14, 2023",BOS vs. CLE,W,36,10,20,0.5,2,5,0.4,0,0,0.0,2,3,5,5,2,0,2,3,22,4,1,BOS,BOS,CLE,116,2.5,Free Throws Made,32,27,27,10
Jaylen Brown,F,22023,1627759,22300319,"DEC 14, 2023",BOS vs. CLE,W,36,10,20,0.5,2,5,0.4,0,0,0.0,2,3,5,5,2,0,2,3,22,4,1,BOS,BOS,CLE,116,25.5,Pts+Rebs,32,27,27,10
Jaylen Brown,F,22023,1627759,22300319,"DEC 14, 2023",BOS vs. CLE,W,36,10,20,0.5,2,5,0.4,0,0,0.0,2,3,5,5,2,0,2,3,22,4,1,BOS,BOS,CLE,116,23.5,Pts+Asts,32,27,27,10
Jaylen Brown,F,22023,1627759,22300319,"DEC 14, 2023",BOS vs. CLE,W,36,10,20,0.5,2,5,0.4,0,0,0.0,2,3,5,5,2,0,2,3,22,4,1,BOS,BOS,CLE,116,9.5,Rebs+Asts,32,27,27,10
Jaylen Brown,F,22023,1627759,22300319,"DEC 14, 2023",BOS vs. CLE,W,36,10,20,0.5,2,5,0.4,0,0,0.0,2,3,5,5,2,0,2,3,22,4,1,BOS,BOS,CLE,116,1.5,Blks+Stls,32,27,27,10
Jaylen Brown,F,22023,1627759,22300305,"DEC 12, 2023",BOS vs. CLE,W,35,10,17,0.588,1,5,0.2,4,4,1.0,1,1,2,4,1,1,3,1,25,-6,1,BOS,BOS,CLE,120,20.0,Points,31,27,29,6
Jaylen Brown,F,22023,1627759,22300305,"DEC 12, 2023",BOS vs. CLE,W,35,10,17,0.588,1,5,0.2,4,4,1.0,1,1,2,4,1,1,3,1,25,-6,1,BOS,BOS,CLE,120,6.0,Rebounds,31,27,29,6
Jaylen Brown,F,22023,1627759,22300305,"DEC 12, 2023",BOS vs. CLE,W,35,10,17,0.588,1,5,0.2,4,4,1.0,1,1,2,4,1,1,3,1,25,-6,1,BOS,BOS,CLE,120,29.5,Pts+Rebs+Asts,31,27,29,6
Jaylen Brown,F,22023,1627759,22300305,"DEC 12, 2023",BOS vs. CLE,W,35,10,17,0.588,1,5,0.2,4,4,1.0,1,1,2,4,1,1,3,1,25,-6,1,BOS,BOS,CLE,120,34.5,Fantasy Score,31,27,29,6
Jaylen Brown,F,22023,1627759,22300305,"DEC 12, 2023",BOS vs. CLE,W,35,10,17,0.588,1,5,0.2,4,4,1.0,1,1,2,4,1,1,3,1,25,-6,1,BOS,BOS,CLE,120,2.5,Free Throws Made,31,27,29,6
Jaylen Brown,F,22023,1627759,22300305,"DEC 12, 2023",BOS vs. CLE,W,35,10,17,0.588,1,5,0.2,4,4,1.0,1,1,2,4,1,1,3,1,25,-6,1,BOS,BOS,CLE,120,25.5,Pts+Rebs,31,27,29,6
Jaylen Brown,F,22023,1627759,22300305,"DEC 12, 2023",BOS vs. CLE,W,35,10,17,0.588,1,5,0.2,4,4,1.0,1,1,2,4,1,1,3,1,25,-6,1,BOS,BOS,CLE,120,23.5,Pts+Asts,31,27,29,6
Jaylen Brown,F,22023,1627759,22300305,"DEC 12, 2023",BOS vs. CLE,W,35,10,17,0.588,1,5,0.2,4,4,1.0,1,1,2,4,1,1,3,1,25,-6,1,BOS,BOS,CLE,120,9.5,Rebs+Asts,31,27,29,6
Jaylen Brown,F,22023,1627759,22300305,"DEC 12, 2023",BOS vs. CLE,W,35,10,17,0.588,1,5,0.2,4,4,1.0,1,1,2,4,1,1,3,1,25,-6,1,BOS,BOS,CLE,120,1.5,Blks+Stls,31,27,29,6
Jaylen Brown,F,22023,1627759,22300228,"NOV 22, 2023",BOS vs. MIL,W,35,10,16,0.625,3,5,0.6,3,3,1.0,0,2,2,8,1,0,1,1,26,-3,1,BOS,BOS,MIL,119,20.0,Points,36,28,34,10
Jaylen Brown,F,22023,1627759,22300228,"NOV 22, 2023",BOS vs. MIL,W,35,10,16,0.625,3,5,0.6,3,3,1.0,0,2,2,8,1,0,1,1,26,-3,1,BOS,BOS,MIL,119,6.0,Rebounds,36,28,34,10
Jaylen Brown,F,22023,1627759,22300228,"NOV 22, 2023",BOS vs. MIL,W,35,10,16,0.625,3,5,0.6,3,3,1.0,0,2,2,8,1,0,1,1,26,-3,1,BOS,BOS,MIL,119,29.5,Pts+Rebs+Asts,36,28,34,10
Jaylen Brown,F,22023,1627759,22300228,"NOV 22, 2023",BOS vs. MIL,W,35,10,16,0.625,3,5,0.6,3,3,1.0,0,2,2,8,1,0,1,1,26,-3,1,BOS,BOS,MIL,119,34.5,Fantasy Score,36,28,34,10
Jaylen Brown,F,22023,1627759,22300228,"NOV 22, 2023",BOS vs. MIL,W,35,10,16,0.625,3,5,0.6,3,3,1.0,0,2,2,8,1,0,1,1,26,-3,1,BOS,BOS,MIL,119,2.5,Free Throws Made,36,28,34,10
Jaylen Brown,F,22023,1627759,22300228,"NOV 22, 2023",BOS vs. MIL,W,35,10,16,0.625,3,5,0.6,3,3,1.0,0,2,2,8,1,0,1,1,26,-3,1,BOS,BOS,MIL,119,25.5,Pts+Rebs,36,28,34,10
Jaylen Brown,F,22023,1627759,22300228,"NOV 22, 2023",BOS vs. MIL,W,35,10,16,0.625,3,5,0.6,3,3,1.0,0,2,2,8,1,0,1,1,26,-3,1,BOS,BOS,MIL,119,23.5,Pts+Asts,36,28,34,10
Jaylen Brown,F,22023,1627759,22300228,"NOV 22, 2023",BOS vs. MIL,W,35,10,16,0.625,3,5,0.6,3,3,1.0,0,2,2,8,1,0,1,1,26,-3,1,BOS,BOS,MIL,119,9.5,Rebs+Asts,36,28,34,10
Jaylen Brown,F,22023,1627759,22300228,"NOV 22, 2023",BOS vs. MIL,W,35,10,16,0.625,3,5,0.6,3,3,1.0,0,2,2,8,1,0,1,1,26,-3,1,BOS,BOS,MIL,119,1.5,Blks+Stls,36,28,34,10
Jaylen Brown,F,22023,1627759,22300213,"NOV 19, 2023",BOS @ MEM,W,34,5,16,0.313,1,7,0.143,1,2,0.5,0,6,6,3,2,2,2,4,12,1,1,BOS,MEM,BOS,102,20.0,Points,21,18,15,9
Jaylen Brown,F,22023,1627759,22300213,"NOV 19, 2023",BOS @ MEM,W,34,5,16,0.313,1,7,0.143,1,2,0.5,0,6,6,3,2,2,2,4,12,1,1,BOS,MEM,BOS,102,6.0,Rebounds,21,18,15,9
Jaylen Brown,F,22023,1627759,22300213,"NOV 19, 2023",BOS @ MEM,W,34,5,16,0.313,1,7,0.143,1,2,0.5,0,6,6,3,2,2,2,4,12,1,1,BOS,MEM,BOS,102,29.5,Pts+Rebs+Asts,21,18,15,9
Jaylen Brown,F,22023,1627759,22300213,"NOV 19, 2023",BOS @ MEM,W,34,5,16,0.313,1,7,0.143,1,2,0.5,0,6,6,3,2,2,2,4,12,1,1,BOS,MEM,BOS,102,34.5,Fantasy Score,21,18,15,9
Jaylen Brown,F,22023,1627759,22300213,"NOV 19, 2023",BOS @ MEM,W,34,5,16,0.313,1,7,0.143,1,2,0.5,0,6,6,3,2,2,2,4,12,1,1,BOS,MEM,BOS,102,2.5,Free Throws Made,21,18,15,9
Jaylen Brown,F,22023,1627759,22300213,"NOV 19, 2023",BOS @ MEM,W,34,5,16,0.313,1,7,0.143,1,2,0.5,0,6,6,3,2,2,2,4,12,1,1,BOS,MEM,BOS,102,25.5,Pts+Rebs,21,18,15,9
Jaylen Brown,F,22023,1627759,22300213,"NOV 19, 2023",BOS @ MEM,W,34,5,16,0.313,1,7,0.143,1,2,0.5,0,6,6,3,2,2,2,4,12,1,1,BOS,MEM,BOS,102,23.5,Pts+Asts,21,18,15,9
Jaylen Brown,F,22023,1627759,22300213,"NOV 19, 2023",BOS @ MEM,W,34,5,16,0.313,1,7,0.143,1,2,0.5,0,6,6,3,2,2,2,4,12,1,1,BOS,MEM,BOS,102,9.5,Rebs+Asts,21,18,15,9
Jaylen Brown,F,22023,1627759,22300213,"NOV 19, 2023",BOS @ MEM,W,34,5,16,0.313,1,7,0.143,1,2,0.5,0,6,6,3,2,2,2,4,12,1,1,BOS,MEM,BOS,102,1.5,Blks+Stls,21,18,15,9
Jaylen Brown,F,22023,1627759,22300031,"NOV 17, 2023",BOS @ TOR,W,36,9,14,0.643,3,5,0.6,2,3,0.667,0,3,3,4,1,1,3,2,23,4,1,BOS,TOR,BOS,108,20.0,Points,30,26,27,7
Jaylen Brown,F,22023,1627759,22300031,"NOV 17, 2023",BOS @ TOR,W,36,9,14,0.643,3,5,0.6,2,3,0.667,0,3,3,4,1,1,3,2,23,4,1,BOS,TOR,BOS,108,6.0,Rebounds,30,26,27,7
Jaylen Brown,F,22023,1627759,22300031,"NOV 17, 2023",BOS @ TOR,W,36,9,14,0.643,3,5,0.6,2,3,0.667,0,3,3,4,1,1,3,2,23,4,1,BOS,TOR,BOS,108,29.5,Pts+Rebs+Asts,30,26,27,7
Jaylen Brown,F,22023,1627759,22300031,"NOV 17, 2023",BOS @ TOR,W,36,9,14,0.643,3,5,0.6,2,3,0.667,0,3,3,4,1,1,3,2,23,4,1,BOS,TOR,BOS,108,34.5,Fantasy Score,30,26,27,7
Jaylen Brown,F,22023,1627759,22300031,"NOV 17, 2023",BOS @ TOR,W,36,9,14,0.643,3,5,0.6,2,3,0.667,0,3,3,4,1,1,3,2,23,4,1,BOS,TOR,BOS,108,2.5,Free Throws Made,30,26,27,7
Jaylen Brown,F,22023,1627759,22300031,"NOV 17, 2023",BOS @ TOR,W,36,9,14,0.643,3,5,0.6,2,3,0.667,0,3,3,4,1,1,3,2,23,4,1,BOS,TOR,BOS,108,25.5,Pts+Rebs,30,26,27,7
Jaylen Brown,F,22023,1627759,22300031,"NOV 17, 2023",BOS @ TOR,W,36,9,14,0.643,3,5,0.6,2,3,0.667,0,3,3,4,1,1,3,2,23,4,1,BOS,TOR,BOS,108,23.5,Pts+Asts,30,26,27,7
Jaylen Brown,F,22023,1627759,22300031,"NOV 17, 2023",BOS @ TOR,W,36,9,14,0.643,3,5,0.6,2,3,0.667,0,3,3,4,1,1,3,2,23,4,1,BOS,TOR,BOS,108,9.5,Rebs+Asts,30,26,27,7
Jaylen Brown,F,22023,1627759,22300031,"NOV 17, 2023",BOS @ TOR,W,36,9,14,0.643,3,5,0.6,2,3,0.667,0,3,3,4,1,1,3,2,23,4,1,BOS,TOR,BOS,108,1.5,Blks+Stls,30,26,27,7
Jaylen Brown,F,22023,1627759,22300188,"NOV 13, 2023",BOS vs. NYK,W,36,7,18,0.389,2,9,0.222,6,6,1.0,1,4,5,6,1,1,3,3,22,17,1,BOS,BOS,NYK,114,20.0,Points,33,27,28,11
Jaylen Brown,F,22023,1627759,22300188,"NOV 13, 2023",BOS vs. NYK,W,36,7,18,0.389,2,9,0.222,6,6,1.0,1,4,5,6,1,1,3,3,22,17,1,BOS,BOS,NYK,114,6.0,Rebounds,33,27,28,11
Jaylen Brown,F,22023,1627759,22300188,"NOV 13, 2023",BOS vs. NYK,W,36,7,18,0.389,2,9,0.222,6,6,1.0,1,4,5,6,1,1,3,3,22,17,1,BOS,BOS,NYK,114,29.5,Pts+Rebs+Asts,33,27,28,11
Jaylen Brown,F,22023,1627759,22300188,"NOV 13, 2023",BOS vs. NYK,W,36,7,18,0.389,2,9,0.222,6,6,1.0,1,4,5,6,1,1,3,3,22,17,1,BOS,BOS,NYK,114,34.5,Fantasy Score,33,27,28,11
Jaylen Brown,F,22023,1627759,22300188,"NOV 13, 2023",BOS vs. NYK,W,36,7,18,0.389,2,9,0.222,6,6,1.0,1,4,5,6,1,1,3,3,22,17,1,BOS,BOS,NYK,114,2.5,Free Throws Made,33,27,28,11
Jaylen Brown,F,22023,1627759,22300188,"NOV 13, 2023",BOS vs. NYK,W,36,7,18,0.389,2,9,0.222,6,6,1.0,1,4,5,6,1,1,3,3,22,17,1,BOS,BOS,NYK,114,25.5,Pts+Rebs,33,27,28,11
Jaylen Brown,F,22023,1627759,22300188,"NOV 13, 2023",BOS vs. NYK,W,36,7,18,0.389,2,9,0.222,6,6,1.0,1,4,5,6,1,1,3,3,22,17,1,BOS,BOS,NYK,114,23.5,Pts+Asts,33,27,28,11
Jaylen Brown,F,22023,1627759,22300188,"NOV 13, 2023",BOS vs. NYK,W,36,7,18,0.389,2,9,0.222,6,6,1.0,1,4,5,6,1,1,3,3,22,17,1,BOS,BOS,NYK,114,9.5,Rebs+Asts,33,27,28,11
Jaylen Brown,F,22023,1627759,22300188,"NOV 13, 2023",BOS vs. NYK,W,36,7,18,0.389,2,9,0.222,6,6,1.0,1,4,5,6,1,1,3,3,22,17,1,BOS,BOS,NYK,114,1.5,Blks+Stls,33,27,28,11
Jaylen Brown,F,22023,1627759,22300159,"NOV 08, 2023",BOS @ PHI,L,36,4,13,0.308,2,7,0.286,1,2,0.5,0,2,2,2,1,1,4,2,11,-3,1,BOS,PHI,BOS,103,20.0,Points,15,13,13,4
Jaylen Brown,F,22023,1627759,22300159,"NOV 08, 2023",BOS @ PHI,L,36,4,13,0.308,2,7,0.286,1,2,0.5,0,2,2,2,1,1,4,2,11,-3,1,BOS,PHI,BOS,103,6.0,Rebounds,15,13,13,4
Jaylen Brown,F,22023,1627759,22300159,"NOV 08, 2023",BOS @ PHI,L,36,4,13,0.308,2,7,0.286,1,2,0.5,0,2,2,2,1,1,4,2,11,-3,1,BOS,PHI,BOS,103,29.5,Pts+Rebs+Asts,15,13,13,4
Jaylen Brown,F,22023,1627759,22300159,"NOV 08, 2023",BOS @ PHI,L,36,4,13,0.308,2,7,0.286,1,2,0.5,0,2,2,2,1,1,4,2,11,-3,1,BOS,PHI,BOS,103,34.5,Fantasy Score,15,13,13,4
Jaylen Brown,F,22023,1627759,22300159,"NOV 08, 2023",BOS @ PHI,L,36,4,13,0.308,2,7,0.286,1,2,0.5,0,2,2,2,1,1,4,2,11,-3,1,BOS,PHI,BOS,103,2.5,Free Throws Made,15,13,13,4
Jaylen Brown,F,22023,1627759,22300159,"NOV 08, 2023",BOS @ PHI,L,36,4,13,0.308,2,7,0.286,1,2,0.5,0,2,2,2,1,1,4,2,11,-3,1,BOS,PHI,BOS,103,25.5,Pts+Rebs,15,13,13,4
Jaylen Brown,F,22023,1627759,22300159,"NOV 08, 2023",BOS @ PHI,L,36,4,13,0.308,2,7,0.286,1,2,0.5,0,2,2,2,1,1,4,2,11,-3,1,BOS,PHI,BOS,103,23.5,Pts+Asts,15,13,13,4
Jaylen Brown,F,22023,1627759,22300159,"NOV 08, 2023",BOS @ PHI,L,36,4,13,0.308,2,7,0.286,1,2,0.5,0,2,2,2,1,1,4,2,11,-3,1,BOS,PHI,BOS,103,9.5,Rebs+Asts,15,13,13,4
Jaylen Brown,F,22023,1627759,22300159,"NOV 08, 2023",BOS @ PHI,L,36,4,13,0.308,2,7,0.286,1,2,0.5,0,2,2,2,1,1,4,2,11,-3,1,BOS,PHI,BOS,103,1.5,Blks+Stls,15,13,13,4
Jaylen Brown,F,22023,1627759,22300154,"NOV 06, 2023",BOS @ MIN,L,39,10,21,0.476,3,8,0.375,3,4,0.75,0,7,7,4,1,0,3,5,26,-16,1,BOS,MIN,BOS,109,20.0,Points,37,33,30,11
Jaylen Brown,F,22023,1627759,22300154,"NOV 06, 2023",BOS @ MIN,L,39,10,21,0.476,3,8,0.375,3,4,0.75,0,7,7,4,1,0,3,5,26,-16,1,BOS,MIN,BOS,109,6.0,Rebounds,37,33,30,11
Jaylen Brown,F,22023,1627759,22300154,"NOV 06, 2023",BOS @ MIN,L,39,10,21,0.476,3,8,0.375,3,4,0.75,0,7,7,4,1,0,3,5,26,-16,1,BOS,MIN,BOS,109,29.5,Pts+Rebs+Asts,37,33,30,11
Jaylen Brown,F,22023,1627759,22300154,"NOV 06, 2023",BOS @ MIN,L,39,10,21,0.476,3,8,0.375,3,4,0.75,0,7,7,4,1,0,3,5,26,-16,1,BOS,MIN,BOS,109,34.5,Fantasy Score,37,33,30,11
Jaylen Brown,F,22023,1627759,22300154,"NOV 06, 2023",BOS @ MIN,L,39,10,21,0.476,3,8,0.375,3,4,0.75,0,7,7,4,1,0,3,5,26,-16,1,BOS,MIN,BOS,109,2.5,Free Throws Made,37,33,30,11
Jaylen Brown,F,22023,1627759,22300154,"NOV 06, 2023",BOS @ MIN,L,39,10,21,0.476,3,8,0.375,3,4,0.75,0,7,7,4,1,0,3,5,26,-16,1,BOS,MIN,BOS,109,25.5,Pts+Rebs,37,33,30,11
Jaylen Brown,F,22023,1627759,22300154,"NOV 06, 2023",BOS @ MIN,L,39,10,21,0.476,3,8,0.375,3,4,0.75,0,7,7,4,1,0,3,5,26,-16,1,BOS,MIN,BOS,109,23.5,Pts+Asts,37,33,30,11
Jaylen Brown,F,22023,1627759,22300154,"NOV 06, 2023",BOS @ MIN,L,39,10,21,0.476,3,8,0.375,3,4,0.75,0,7,7,4,1,0,3,5,26,-16,1,BOS,MIN,BOS,109,9.5,Rebs+Asts,37,33,30,11
Jaylen Brown,F,22023,1627759,22300154,"NOV 06, 2023",BOS @ MIN,L,39,10,21,0.476,3,8,0.375,3,4,0.75,0,7,7,4,1,0,3,5,26,-16,1,BOS,MIN,BOS,109,1.5,Blks+Stls,37,33,30,11
Jaylen Brown,F,22023,1627759,22300065,"OCT 25, 2023",BOS @ NYK,W,38,4,11,0.364,0,4,0.0,3,4,0.75,0,6,6,5,1,0,2,5,11,8,1,BOS,NYK,BOS,108,20.0,Points,22,17,16,11
Jaylen Brown,F,22023,1627759,22300065,"OCT 25, 2023",BOS @ NYK,W,38,4,11,0.364,0,4,0.0,3,4,0.75,0,6,6,5,1,0,2,5,11,8,1,BOS,NYK,BOS,108,6.0,Rebounds,22,17,16,11
Jaylen Brown,F,22023,1627759,22300065,"OCT 25, 2023",BOS @ NYK,W,38,4,11,0.364,0,4,0.0,3,4,0.75,0,6,6,5,1,0,2,5,11,8,1,BOS,NYK,BOS,108,29.5,Pts+Rebs+Asts,22,17,16,11
Jaylen Brown,F,22023,1627759,22300065,"OCT 25, 2023",BOS @ NYK,W,38,4,11,0.364,0,4,0.0,3,4,0.75,0,6,6,5,1,0,2,5,11,8,1,BOS,NYK,BOS,108,34.5,Fantasy Score,22,17,16,11
Jaylen Brown,F,22023,1627759,22300065,"OCT 25, 2023",BOS @ NYK,W,38,4,11,0.364,0,4,0.0,3,4,0.75,0,6,6,5,1,0,2,5,11,8,1,BOS,NYK,BOS,108,2.5,Free Throws Made,22,17,16,11
Jaylen Brown,F,22023,1627759,22300065,"OCT 25, 2023",BOS @ NYK,W,38,4,11,0.364,0,4,0.0,3,4,0.75,0,6,6,5,1,0,2,5,11,8,1,BOS,NYK,BOS,108,25.5,Pts+Rebs,22,17,16,11
Jaylen Brown,F,22023,1627759,22300065,"OCT 25, 2023",BOS @ NYK,W,38,4,11,0.364,0,4,0.0,3,4,0.75,0,6,6,5,1,0,2,5,11,8,1,BOS,NYK,BOS,108,23.5,Pts+Asts,22,17,16,11
Jaylen Brown,F,22023,1627759,22300065,"OCT 25, 2023",BOS @ NYK,W,38,4,11,0.364,0,4,0.0,3,4,0.75,0,6,6,5,1,0,2,5,11,8,1,BOS,NYK,BOS,108,9.5,Rebs+Asts,22,17,16,11
Jaylen Brown,F,22023,1627759,22300065,"OCT 25, 2023",BOS @ NYK,W,38,4,11,0.364,0,4,0.0,3,4,0.75,0,6,6,5,1,0,2,5,11,8,1,BOS,NYK,BOS,108,1.5,Blks+Stls,22,17,16,11
Pascal Siakam,F,22023,1627783,22300432,"DEC 29, 2023",TOR @ BOS,L,41,10,18,0.556,2,5,0.4,5,8,0.625,0,5,5,5,2,0,1,1,27,8,1,TOR,BOS,TOR,118,,,37,32,32,10
Pascal Siakam,F,22023,1627783,22300416,"DEC 27, 2023",TOR @ WAS,W,32,9,15,0.6,0,2,0.0,4,5,0.8,1,5,6,11,1,0,4,3,22,16,1,TOR,WAS,TOR,132,,,39,28,33,17
Pascal Siakam,F,22023,1627783,22300395,"DEC 23, 2023",TOR vs. UTA,L,36,7,20,0.35,0,2,0.0,5,6,0.833,3,6,9,6,1,0,1,4,19,0,1,TOR,TOR,UTA,119,,,34,28,25,15
Pascal Siakam,F,22023,1627783,22300382,"DEC 22, 2023",TOR @ PHI,L,36,10,16,0.625,0,4,0.0,11,12,0.917,1,4,5,5,0,1,2,1,31,-4,1,TOR,PHI,TOR,111,,,41,36,36,10
Pascal Siakam,F,22023,1627783,22300369,"DEC 20, 2023",TOR vs. DEN,L,36,7,16,0.438,1,5,0.2,3,5,0.6,1,4,5,1,0,0,1,2,18,-17,1,TOR,TOR,DEN,104,,,24,23,19,6
Pascal Siakam,F,22023,1627783,22300354,"DEC 18, 2023",TOR vs. CHA,W,36,11,16,0.688,0,1,0.0,5,6,0.833,4,4,8,8,1,0,2,1,27,2,1,TOR,TOR,CHA,114,,,43,35,35,16
Pascal Siakam,F,22023,1627783,22300330,"DEC 15, 2023",TOR vs. ATL,L,34,5,11,0.455,2,3,0.667,3,4,0.75,0,5,5,4,2,0,1,1,15,-9,1,TOR,TOR,ATL,104,,,24,20,19,9
Pascal Siakam,F,22023,1627783,22300313,"DEC 13, 2023",TOR vs. ATL,W,36,12,19,0.632,5,6,0.833,4,7,0.571,1,6,7,7,0,0,2,0,33,15,1,TOR,TOR,ATL,135,,,47,40,40,14
Pascal Siakam,F,22023,1627783,22300297,"DEC 11, 2023",TOR @ NYK,L,37,8,15,0.533,1,2,0.5,3,7,0.429,2,2,4,4,4,0,1,5,20,6,1,TOR,NYK,TOR,130,,,28,24,24,8
Pascal Siakam,F,22023,1627783,22301216,"DEC 08, 2023",TOR @ CHA,L,33,11,15,0.733,0,1,0.0,3,4,0.75,1,4,5,4,1,0,1,2,25,-9,1,TOR,CHA,TOR,116,,,34,30,29,9
Pascal Siakam,F,22023,1627783,22301207,"DEC 06, 2023",TOR vs. MIA,L,36,9,13,0.692,1,1,1.0,11,11,1.0,1,3,4,6,0,1,2,1,30,-9,1,TOR,TOR,MIA,103,,,40,34,36,10
Pascal Siakam,F,22023,1627783,22300276,"DEC 01, 2023",TOR vs. NYK,L,34,7,16,0.438,0,4,0.0,7,8,0.875,3,5,8,3,0,0,3,3,21,-14,1,TOR,TOR,NYK,106,,,32,29,24,11
Pascal Siakam,F,22023,1627783,22300260,"NOV 29, 2023",TOR vs. PHX,W,36,9,21,0.429,1,5,0.2,3,3,1.0,3,6,9,3,1,0,3,4,22,9,1,TOR,TOR,PHX,112,,,34,31,25,12
Pascal Siakam,F,22023,1627783,22300054,"NOV 28, 2023",TOR @ BKN,L,35,6,18,0.333,0,4,0.0,5,7,0.714,2,8,10,2,1,0,2,2,17,-14,1,TOR,BKN,TOR,103,,,29,27,19,12
Pascal Siakam,F,22023,1627783,22300251,"NOV 26, 2023",TOR @ CLE,L,38,7,17,0.412,0,4,0.0,4,6,0.667,4,4,8,6,1,1,4,0,18,6,1,TOR,CLE,TOR,102,,,32,26,24,14
Pascal Siakam,F,22023,1627783,22300046,"NOV 24, 2023",TOR vs. CHI,W,37,6,12,0.5,1,6,0.167,5,6,0.833,0,3,3,8,1,0,3,2,18,14,1,TOR,TOR,CHI,121,,,29,21,26,11
Pascal Siakam,F,22023,1627783,22300038,"NOV 21, 2023",TOR @ ORL,L,30,5,10,0.5,0,2,0.0,6,8,0.75,0,2,2,8,1,0,2,1,16,-7,1,TOR,ORL,TOR,107,,,26,18,24,10
Pascal Siakam,F,22023,1627783,22300211,"NOV 19, 2023",TOR vs. DET,W,29,10,18,0.556,1,2,0.5,2,3,0.667,3,4,7,6,1,0,0,1,23,23,1,TOR,TOR,DET,142,,,36,30,29,13
Pascal Siakam,F,22023,1627783,22300031,"NOV 17, 2023",TOR vs. BOS,L,29,11,16,0.688,0,1,0.0,1,1,1.0,1,5,6,5,0,0,3,5,23,17,1,TOR,TOR,BOS,105,,,34,29,28,11
Pascal Siakam,F,22023,1627783,22300195,"NOV 15, 2023",TOR vs. MIL,L,29,4,9,0.444,0,2,0.0,3,5,0.6,2,5,7,5,0,1,4,1,11,-21,1,TOR,TOR,MIL,112,,,23,18,16,12
Pascal Siakam,F,22023,1627783,22300189,"NOV 13, 2023",TOR vs. WAS,W,38,15,23,0.652,0,3,0.0,9,14,0.643,2,9,11,7,3,0,6,1,39,18,1,TOR,TOR,WAS,111,,,57,50,46,18
Pascal Siakam,F,22023,1627783,22300174,"NOV 11, 2023",TOR @ BOS,L,28,6,17,0.353,0,4,0.0,5,6,0.833,2,5,7,3,3,0,3,0,17,-9,1,TOR,BOS,TOR,94,,,27,24,20,10
Pascal Siakam,F,22023,1627783,22300092,"OCT 28, 2023",TOR vs. PHI,L,36,3,8,0.375,2,5,0.4,3,4,0.75,1,6,7,4,0,1,2,4,11,-5,1,TOR,TOR,PHI,107,,,22,18,15,11
Pascal Siakam,F,22023,1627783,22300082,"OCT 27, 2023",TOR @ CHI,L,41,7,15,0.467,1,5,0.2,3,5,0.6,1,7,8,2,0,0,3,4,18,-2,1,TOR,CHI,TOR,103,,,28,26,20,10
Pascal Siakam,F,22023,1627783,22300069,"OCT 25, 2023",TOR vs. MIN,W,34,5,17,0.294,3,5,0.6,2,2,1.0,0,7,7,6,1,0,2,2,15,7,1,TOR,TOR,MIN,97,,,28,22,21,13
Pascal Siakam,F,22023,1627783,22300230,"NOV 22, 2023",TOR @ IND,W,38,13,24,0.542,1,3,0.333,9,11,0.818,3,7,10,5,0,1,2,2,36,-5,1,TOR,IND,TOR,132,,,51,46,41,15
Pascal Siakam,F,22023,1627783,22300168,"NOV 08, 2023",TOR @ DAL,W,37,15,25,0.6,0,5,0.0,1,4,0.25,4,8,12,5,0,0,3,2,31,7,1,TOR,DAL,TOR,127,,,48,43,36,17
Pascal Siakam,F,22023,1627783,22300141,"NOV 05, 2023",TOR @ SAS,W,36,2,12,0.167,1,4,0.25,3,3,1.0,0,6,6,5,1,0,3,3,8,7,1,TOR,SAS,TOR,123,,,19,14,13,11
Pascal Siakam,F,22023,1627783,22300128,"NOV 02, 2023",TOR @ PHI,L,33,5,11,0.455,0,3,0.0,0,0,0.0,1,2,3,6,0,0,2,5,10,-14,1,TOR,PHI,TOR,99,,,19,13,16,9
Pascal Siakam,F,22023,1627783,22300116,"NOV 01, 2023",TOR vs. MIL,W,33,9,13,0.692,5,8,0.625,3,3,1.0,0,6,6,7,0,0,3,3,26,22,1,TOR,TOR,MIL,130,,,39,32,33,13
Pascal Siakam,F,22023,1627783,22300105,"OCT 30, 2023",TOR vs. POR,L,35,9,21,0.429,0,6,0.0,2,3,0.667,1,5,6,3,1,0,0,1,20,-2,1,TOR,TOR,POR,91,,,29,26,23,9
Pascal Siakam,F,22023,1627783,22300563,"JAN 15, 2024",TOR vs. BOS,L,37,5,15,0.333,0,6,0.0,7,8,0.875,2,3,5,4,1,0,0,1,17,-5,1,TOR,TOR,BOS,94,,,26,22,21,9
Pascal Siakam,F,22023,1627783,22300540,"JAN 12, 2024",TOR @ UTA,L,30,8,14,0.571,5,6,0.833,6,8,0.75,0,4,4,2,0,0,2,1,27,-23,1,TOR,UTA,TOR,104,,,33,31,29,6
Pascal Siakam,F,22023,1627783,22300516,"JAN 09, 2024",TOR @ LAL,L,32,10,17,0.588,3,5,0.6,2,3,0.667,0,4,4,3,0,1,1,2,25,-4,1,TOR,LAL,TOR,131,,,32,29,28,7
Pascal Siakam,F,22023,1627783,22300504,"JAN 07, 2024",TOR @ GSW,W,30,7,11,0.636,2,3,0.667,0,0,0.0,1,5,6,6,0,2,1,0,16,5,1,TOR,GSW,TOR,131,,,28,22,22,12
Pascal Siakam,F,22023,1627783,22300492,"JAN 05, 2024",TOR @ SAC,L,37,6,11,0.545,0,0,0.0,6,7,0.857,1,3,4,9,2,1,2,3,18,5,1,TOR,SAC,TOR,120,,,31,22,27,13
Pascal Siakam,F,22023,1627783,22300470,"JAN 03, 2024",TOR @ MEM,W,30,9,14,0.643,1,2,0.5,5,6,0.833,1,6,7,0,1,0,3,5,24,-1,1,TOR,MEM,TOR,116,,,31,31,24,7
Pascal Siakam,F,22023,1627783,22300452,"JAN 01, 2024",TOR vs. CLE,W,40,13,20,0.65,5,8,0.625,5,6,0.833,0,5,5,2,1,0,1,3,36,1,1,TOR,TOR,CLE,124,,,43,41,38,7
Pascal Siakam,F,22023,1627783,22300440,"DEC 30, 2023",TOR @ DET,L,40,14,24,0.583,2,2,1.0,5,8,0.625,1,4,5,4,0,0,2,5,35,-5,1,TOR,DET,TOR,127,,,44,40,39,9
Pascal Siakam,F,22023,1627783,22300707,"FEB 04, 2024",IND @ CHA,W,35,11,20,0.55,1,4,0.25,2,3,0.667,3,5,8,9,1,1,0,3,25,30,1,IND,CHA,IND,115,,,42,33,34,17
Pascal Siakam,F,22023,1627783,22300627,"JAN 25, 2024",IND vs. PHI,W,30,9,13,0.692,1,2,0.5,7,10,0.7,3,10,13,10,0,0,2,3,26,30,1,IND,IND,PHI,134,,,49,39,36,23
Pascal Siakam,F,22023,1627783,22300755,"FEB 10, 2024",IND @ NYK,W,31,8,13,0.615,2,6,0.333,1,4,0.25,0,6,6,3,1,0,1,0,19,7,1,IND,NYK,IND,125,,,28,25,22,9
Pascal Siakam,F,22023,1627783,22300733,"FEB 08, 2024",IND vs. GSW,L,30,6,11,0.545,2,4,0.5,2,4,0.5,2,6,8,2,1,1,2,2,16,-16,1,IND,IND,GSW,109,,,26,24,18,10
Pascal Siakam,F,22023,1627783,22300719,"FEB 06, 2024",IND vs. HOU,W,35,11,16,0.688,4,6,0.667,3,4,0.75,1,3,4,4,1,0,2,1,29,1,1,IND,IND,HOU,132,,,37,33,33,8
Pascal Siakam,F,22023,1627783,22300691,"FEB 02, 2024",IND vs. SAC,L,35,10,15,0.667,1,3,0.333,1,3,0.333,3,3,6,2,2,0,5,3,22,-5,1,IND,IND,SAC,122,,,30,28,24,8
Pascal Siakam,F,22023,1627783,22300685,"FEB 01, 2024",IND @ NYK,L,35,8,19,0.421,1,3,0.333,1,2,0.5,4,3,7,5,0,1,5,5,18,-10,1,IND,NYK,IND,105,,,30,25,23,12
Pascal Siakam,F,22023,1627783,22300670,"JAN 30, 2024",IND @ BOS,L,32,9,16,0.563,1,1,1.0,4,4,1.0,4,2,6,2,0,0,0,4,23,9,1,IND,BOS,IND,124,,,31,29,25,8
Pascal Siakam,F,22023,1627783,22300590,"JAN 19, 2024",IND @ POR,L,34,9,14,0.643,1,3,0.333,2,6,0.333,0,6,6,3,1,0,1,5,21,17,1,IND,POR,IND,115,,,30,27,24,9
Pascal Siakam,F,22023,1627783,22300652,"JAN 28, 2024",IND vs. MEM,W,35,8,13,0.615,0,2,0.0,3,3,1.0,0,6,6,6,2,0,1,3,19,8,1,IND,IND,MEM,116,,,31,25,25,12
Pascal Siakam,F,22023,1627783,22300636,"JAN 26, 2024",IND vs. PHX,W,33,14,22,0.636,2,3,0.667,1,3,0.333,4,3,7,4,2,0,2,1,31,9,1,IND,IND,PHX,133,,,42,38,35,11
Pascal Siakam,F,22023,1627783,22300614,"JAN 23, 2024",IND vs. DEN,L,33,7,16,0.438,0,0,0.0,2,2,1.0,2,8,10,4,0,0,1,1,16,-5,1,IND,IND,DEN,109,,,30,26,20,14
Pascal Siakam,F,22023,1627783,22300604,"JAN 21, 2024",IND @ PHX,L,30,6,14,0.429,1,3,0.333,2,2,1.0,2,2,4,7,0,0,3,6,15,-9,1,IND,PHX,IND,110,,,26,19,22,11
Pascal Siakam,F,22023,1627783,22300432,"DEC 29, 2023",TOR @ BOS,L,41,10,18,0.556,2,5,0.4,5,8,0.625,0,5,5,5,2,0,1,1,27,8,1,TOR,BOS,TOR,118,,,37,32,32,10
Pascal Siakam,F,22023,1627783,22300416,"DEC 27, 2023",TOR @ WAS,W,32,9,15,0.6,0,2,0.0,4,5,0.8,1,5,6,11,1,0,4,3,22,16,1,TOR,WAS,TOR,132,,,39,28,33,17
Pascal Siakam,F,22023,1627783,22300395,"DEC 23, 2023",TOR vs. UTA,L,36,7,20,0.35,0,2,0.0,5,6,0.833,3,6,9,6,1,0,1,4,19,0,1,TOR,TOR,UTA,119,,,34,28,25,15
Pascal Siakam,F,22023,1627783,22300382,"DEC 22, 2023",TOR @ PHI,L,36,10,16,0.625,0,4,0.0,11,12,0.917,1,4,5,5,0,1,2,1,31,-4,1,TOR,PHI,TOR,111,,,41,36,36,10
Pascal Siakam,F,22023,1627783,22300369,"DEC 20, 2023",TOR vs. DEN,L,36,7,16,0.438,1,5,0.2,3,5,0.6,1,4,5,1,0,0,1,2,18,-17,1,TOR,TOR,DEN,104,,,24,23,19,6
Pascal Siakam,F,22023,1627783,22300354,"DEC 18, 2023",TOR vs. CHA,W,36,11,16,0.688,0,1,0.0,5,6,0.833,4,4,8,8,1,0,2,1,27,2,1,TOR,TOR,CHA,114,,,43,35,35,16
Pascal Siakam,F,22023,1627783,22300330,"DEC 15, 2023",TOR vs. ATL,L,34,5,11,0.455,2,3,0.667,3,4,0.75,0,5,5,4,2,0,1,1,15,-9,1,TOR,TOR,ATL,104,,,24,20,19,9
Pascal Siakam,F,22023,1627783,22300313,"DEC 13, 2023",TOR vs. ATL,W,36,12,19,0.632,5,6,0.833,4,7,0.571,1,6,7,7,0,0,2,0,33,15,1,TOR,TOR,ATL,135,,,47,40,40,14
Pascal Siakam,F,22023,1627783,22300297,"DEC 11, 2023",TOR @ NYK,L,37,8,15,0.533,1,2,0.5,3,7,0.429,2,2,4,4,4,0,1,5,20,6,1,TOR,NYK,TOR,130,,,28,24,24,8
Pascal Siakam,F,22023,1627783,22301216,"DEC 08, 2023",TOR @ CHA,L,33,11,15,0.733,0,1,0.0,3,4,0.75,1,4,5,4,1,0,1,2,25,-9,1,TOR,CHA,TOR,116,,,34,30,29,9
Pascal Siakam,F,22023,1627783,22301207,"DEC 06, 2023",TOR vs. MIA,L,36,9,13,0.692,1,1,1.0,11,11,1.0,1,3,4,6,0,1,2,1,30,-9,1,TOR,TOR,MIA,103,,,40,34,36,10
Pascal Siakam,F,22023,1627783,22300276,"DEC 01, 2023",TOR vs. NYK,L,34,7,16,0.438,0,4,0.0,7,8,0.875,3,5,8,3,0,0,3,3,21,-14,1,TOR,TOR,NYK,106,,,32,29,24,11
Pascal Siakam,F,22023,1627783,22300260,"NOV 29, 2023",TOR vs. PHX,W,36,9,21,0.429,1,5,0.2,3,3,1.0,3,6,9,3,1,0,3,4,22,9,1,TOR,TOR,PHX,112,,,34,31,25,12
Pascal Siakam,F,22023,1627783,22300054,"NOV 28, 2023",TOR @ BKN,L,35,6,18,0.333,0,4,0.0,5,7,0.714,2,8,10,2,1,0,2,2,17,-14,1,TOR,BKN,TOR,103,,,29,27,19,12
Pascal Siakam,F,22023,1627783,22300251,"NOV 26, 2023",TOR @ CLE,L,38,7,17,0.412,0,4,0.0,4,6,0.667,4,4,8,6,1,1,4,0,18,6,1,TOR,CLE,TOR,102,,,32,26,24,14
Pascal Siakam,F,22023,1627783,22300046,"NOV 24, 2023",TOR vs. CHI,W,37,6,12,0.5,1,6,0.167,5,6,0.833,0,3,3,8,1,0,3,2,18,14,1,TOR,TOR,CHI,121,,,29,21,26,11
Pascal Siakam,F,22023,1627783,22300038,"NOV 21, 2023",TOR @ ORL,L,30,5,10,0.5,0,2,0.0,6,8,0.75,0,2,2,8,1,0,2,1,16,-7,1,TOR,ORL,TOR,107,,,26,18,24,10
Pascal Siakam,F,22023,1627783,22300211,"NOV 19, 2023",TOR vs. DET,W,29,10,18,0.556,1,2,0.5,2,3,0.667,3,4,7,6,1,0,0,1,23,23,1,TOR,TOR,DET,142,,,36,30,29,13
Pascal Siakam,F,22023,1627783,22300031,"NOV 17, 2023",TOR vs. BOS,L,29,11,16,0.688,0,1,0.0,1,1,1.0,1,5,6,5,0,0,3,5,23,17,1,TOR,TOR,BOS,105,,,34,29,28,11
Pascal Siakam,F,22023,1627783,22300195,"NOV 15, 2023",TOR vs. MIL,L,29,4,9,0.444,0,2,0.0,3,5,0.6,2,5,7,5,0,1,4,1,11,-21,1,TOR,TOR,MIL,112,,,23,18,16,12
Pascal Siakam,F,22023,1627783,22300189,"NOV 13, 2023",TOR vs. WAS,W,38,15,23,0.652,0,3,0.0,9,14,0.643,2,9,11,7,3,0,6,1,39,18,1,TOR,TOR,WAS,111,,,57,50,46,18
Pascal Siakam,F,22023,1627783,22300174,"NOV 11, 2023",TOR @ BOS,L,28,6,17,0.353,0,4,0.0,5,6,0.833,2,5,7,3,3,0,3,0,17,-9,1,TOR,BOS,TOR,94,,,27,24,20,10
Pascal Siakam,F,22023,1627783,22300092,"OCT 28, 2023",TOR vs. PHI,L,36,3,8,0.375,2,5,0.4,3,4,0.75,1,6,7,4,0,1,2,4,11,-5,1,TOR,TOR,PHI,107,,,22,18,15,11
Pascal Siakam,F,22023,1627783,22300082,"OCT 27, 2023",TOR @ CHI,L,41,7,15,0.467,1,5,0.2,3,5,0.6,1,7,8,2,0,0,3,4,18,-2,1,TOR,CHI,TOR,103,,,28,26,20,10
Pascal Siakam,F,22023,1627783,22300069,"OCT 25, 2023",TOR vs. MIN,W,34,5,17,0.294,3,5,0.6,2,2,1.0,0,7,7,6,1,0,2,2,15,7,1,TOR,TOR,MIN,97,,,28,22,21,13
Pascal Siakam,F,22023,1627783,22300230,"NOV 22, 2023",TOR @ IND,W,38,13,24,0.542,1,3,0.333,9,11,0.818,3,7,10,5,0,1,2,2,36,-5,1,TOR,IND,TOR,132,,,51,46,41,15
Pascal Siakam,F,22023,1627783,22300168,"NOV 08, 2023",TOR @ DAL,W,37,15,25,0.6,0,5,0.0,1,4,0.25,4,8,12,5,0,0,3,2,31,7,1,TOR,DAL,TOR,127,,,48,43,36,17
Pascal Siakam,F,22023,1627783,22300141,"NOV 05, 2023",TOR @ SAS,W,36,2,12,0.167,1,4,0.25,3,3,1.0,0,6,6,5,1,0,3,3,8,7,1,TOR,SAS,TOR,123,,,19,14,13,11
Pascal Siakam,F,22023,1627783,22300128,"NOV 02, 2023",TOR @ PHI,L,33,5,11,0.455,0,3,0.0,0,0,0.0,1,2,3,6,0,0,2,5,10,-14,1,TOR,PHI,TOR,99,,,19,13,16,9
Pascal Siakam,F,22023,1627783,22300116,"NOV 01, 2023",TOR vs. MIL,W,33,9,13,0.692,5,8,0.625,3,3,1.0,0,6,6,7,0,0,3,3,26,22,1,TOR,TOR,MIL,130,,,39,32,33,13
Pascal Siakam,F,22023,1627783,22300105,"OCT 30, 2023",TOR vs. POR,L,35,9,21,0.429,0,6,0.0,2,3,0.667,1,5,6,3,1,0,0,1,20,-2,1,TOR,TOR,POR,91,,,29,26,23,9
Pascal Siakam,F,22023,1627783,22300563,"JAN 15, 2024",TOR vs. BOS,L,37,5,15,0.333,0,6,0.0,7,8,0.875,2,3,5,4,1,0,0,1,17,-5,1,TOR,TOR,BOS,94,,,26,22,21,9
Pascal Siakam,F,22023,1627783,22300540,"JAN 12, 2024",TOR @ UTA,L,30,8,14,0.571,5,6,0.833,6,8,0.75,0,4,4,2,0,0,2,1,27,-23,1,TOR,UTA,TOR,104,,,33,31,29,6
Pascal Siakam,F,22023,1627783,22300516,"JAN 09, 2024",TOR @ LAL,L,32,10,17,0.588,3,5,0.6,2,3,0.667,0,4,4,3,0,1,1,2,25,-4,1,TOR,LAL,TOR,131,,,32,29,28,7
Pascal Siakam,F,22023,1627783,22300504,"JAN 07, 2024",TOR @ GSW,W,30,7,11,0.636,2,3,0.667,0,0,0.0,1,5,6,6,0,2,1,0,16,5,1,TOR,GSW,TOR,131,,,28,22,22,12
Pascal Siakam,F,22023,1627783,22300492,"JAN 05, 2024",TOR @ SAC,L,37,6,11,0.545,0,0,0.0,6,7,0.857,1,3,4,9,2,1,2,3,18,5,1,TOR,SAC,TOR,120,,,31,22,27,13
Pascal Siakam,F,22023,1627783,22300470,"JAN 03, 2024",TOR @ MEM,W,30,9,14,0.643,1,2,0.5,5,6,0.833,1,6,7,0,1,0,3,5,24,-1,1,TOR,MEM,TOR,116,,,31,31,24,7
Pascal Siakam,F,22023,1627783,22300452,"JAN 01, 2024",TOR vs. CLE,W,40,13,20,0.65,5,8,0.625,5,6,0.833,0,5,5,2,1,0,1,3,36,1,1,TOR,TOR,CLE,124,,,43,41,38,7
Pascal Siakam,F,22023,1627783,22300440,"DEC 30, 2023",TOR @ DET,L,40,14,24,0.583,2,2,1.0,5,8,0.625,1,4,5,4,0,0,2,5,35,-5,1,TOR,DET,TOR,127,,,44,40,39,9
Pascal Siakam,F,22023,1627783,22300707,"FEB 04, 2024",IND @ CHA,W,35,11,20,0.55,1,4,0.25,2,3,0.667,3,5,8,9,1,1,0,3,25,30,1,IND,CHA,IND,115,,,42,33,34,17
Pascal Siakam,F,22023,1627783,22300627,"JAN 25, 2024",IND vs. PHI,W,30,9,13,0.692,1,2,0.5,7,10,0.7,3,10,13,10,0,0,2,3,26,30,1,IND,IND,PHI,134,,,49,39,36,23
Pascal Siakam,F,22023,1627783,22300755,"FEB 10, 2024",IND @ NYK,W,31,8,13,0.615,2,6,0.333,1,4,0.25,0,6,6,3,1,0,1,0,19,7,1,IND,NYK,IND,125,,,28,25,22,9
Pascal Siakam,F,22023,1627783,22300733,"FEB 08, 2024",IND vs. GSW,L,30,6,11,0.545,2,4,0.5,2,4,0.5,2,6,8,2,1,1,2,2,16,-16,1,IND,IND,GSW,109,,,26,24,18,10
Pascal Siakam,F,22023,1627783,22300719,"FEB 06, 2024",IND vs. HOU,W,35,11,16,0.688,4,6,0.667,3,4,0.75,1,3,4,4,1,0,2,1,29,1,1,IND,IND,HOU,132,,,37,33,33,8
Pascal Siakam,F,22023,1627783,22300691,"FEB 02, 2024",IND vs. SAC,L,35,10,15,0.667,1,3,0.333,1,3,0.333,3,3,6,2,2,0,5,3,22,-5,1,IND,IND,SAC,122,,,30,28,24,8
Pascal Siakam,F,22023,1627783,22300685,"FEB 01, 2024",IND @ NYK,L,35,8,19,0.421,1,3,0.333,1,2,0.5,4,3,7,5,0,1,5,5,18,-10,1,IND,NYK,IND,105,,,30,25,23,12
Pascal Siakam,F,22023,1627783,22300670,"JAN 30, 2024",IND @ BOS,L,32,9,16,0.563,1,1,1.0,4,4,1.0,4,2,6,2,0,0,0,4,23,9,1,IND,BOS,IND,124,,,31,29,25,8
Pascal Siakam,F,22023,1627783,22300590,"JAN 19, 2024",IND @ POR,L,34,9,14,0.643,1,3,0.333,2,6,0.333,0,6,6,3,1,0,1,5,21,17,1,IND,POR,IND,115,,,30,27,24,9
Pascal Siakam,F,22023,1627783,22300652,"JAN 28, 2024",IND vs. MEM,W,35,8,13,0.615,0,2,0.0,3,3,1.0,0,6,6,6,2,0,1,3,19,8,1,IND,IND,MEM,116,,,31,25,25,12
Pascal Siakam,F,22023,1627783,22300636,"JAN 26, 2024",IND vs. PHX,W,33,14,22,0.636,2,3,0.667,1,3,0.333,4,3,7,4,2,0,2,1,31,9,1,IND,IND,PHX,133,,,42,38,35,11
Pascal Siakam,F,22023,1627783,22300614,"JAN 23, 2024",IND vs. DEN,L,33,7,16,0.438,0,0,0.0,2,2,1.0,2,8,10,4,0,0,1,1,16,-5,1,IND,IND,DEN,109,,,30,26,20,14
Pascal Siakam,F,22023,1627783,22300604,"JAN 21, 2024",IND @ PHX,L,30,6,14,0.429,1,3,0.333,2,2,1.0,2,2,4,7,0,0,3,6,15,-9,1,IND,PHX,IND,110,,,26,19,22,11
DeMar DeRozan,F,22023,201942,22300139,"NOV 04, 2023",CHI @ DEN,L,34,7,16,0.438,0,1,0.0,3,4,0.75,0,3,3,6,0,0,0,4,17,-18,1,CHI,DEN,CHI,101,,,26,20,23,9
DeMar DeRozan,F,22023,201942,22300737,"FEB 08, 2024",CHI @ MEM,W,38,11,17,0.647,3,3,1.0,5,5,1.0,1,7,8,1,0,0,2,3,30,3,1,CHI,MEM,CHI,118,,,39,38,31,9
DeMar DeRozan,F,22023,201942,22300723,"FEB 06, 2024",CHI vs. MIN,W,43,8,19,0.421,0,1,0.0,17,18,0.944,2,1,3,5,4,0,1,2,33,12,1,CHI,CHI,MIN,129,,,41,36,38,8
DeMar DeRozan,F,22023,201942,22300700,"FEB 03, 2024",CHI vs. SAC,L,39,5,14,0.357,0,2,0.0,14,15,0.933,1,6,7,6,4,0,3,2,24,4,1,CHI,CHI,SAC,115,,,37,31,30,13
DeMar DeRozan,F,22023,201942,22300674,"JAN 31, 2024",CHI @ CHA,W,38,4,10,0.4,1,2,0.5,6,8,0.75,0,4,4,3,0,1,2,2,15,3,1,CHI,CHA,CHI,117,,,22,19,18,7
DeMar DeRozan,F,22023,201942,22300672,"JAN 30, 2024",CHI vs. TOR,L,42,8,17,0.471,0,5,0.0,9,12,0.75,1,1,2,5,3,4,5,1,25,-14,1,CHI,CHI,TOR,107,,,32,27,30,7
DeMar DeRozan,F,22023,201942,22300656,"JAN 28, 2024",CHI @ POR,W,40,8,14,0.571,1,2,0.5,3,3,1.0,0,7,7,6,1,0,0,2,20,11,1,CHI,POR,CHI,104,,,33,27,26,13
DeMar DeRozan,F,22023,201942,22300633,"JAN 25, 2024",CHI @ LAL,L,41,10,14,0.714,1,1,1.0,11,12,0.917,0,2,2,10,2,0,3,2,32,-7,1,CHI,LAL,CHI,132,,,44,34,42,12
DeMar DeRozan,F,22023,201942,22300612,"JAN 22, 2024",CHI @ PHX,L,40,8,17,0.471,1,3,0.333,4,6,0.667,1,4,5,3,1,0,2,3,21,-10,1,CHI,PHX,CHI,113,,,29,26,24,8
DeMar DeRozan,F,22023,201942,22300597,"JAN 20, 2024",CHI vs. MEM,W,37,7,20,0.35,1,4,0.25,3,4,0.75,1,3,4,8,1,1,1,0,18,23,1,CHI,CHI,MEM,125,,,30,22,26,12
DeMar DeRozan,F,22023,201942,22300580,"JAN 18, 2024",CHI @ TOR,W,38,9,20,0.45,0,4,0.0,6,7,0.857,1,6,7,6,1,0,2,2,24,6,1,CHI,TOR,CHI,116,,,37,31,30,13
DeMar DeRozan,F,22023,201942,22300561,"JAN 15, 2024",CHI @ CLE,L,38,3,8,0.375,0,1,0.0,0,0,0.0,0,6,6,3,2,1,2,3,6,-17,1,CHI,CLE,CHI,91,,,15,12,9,9
DeMar DeRozan,F,22023,201942,22300548,"JAN 13, 2024",CHI @ SAS,W,34,8,19,0.421,2,5,0.4,2,2,1.0,0,4,4,4,0,0,0,1,20,6,1,CHI,SAS,CHI,122,,,28,24,24,8
DeMar DeRozan,F,22023,201942,22300506,"JAN 08, 2024",CHI @ CHA,W,44,7,16,0.438,1,3,0.333,3,4,0.75,0,7,7,7,3,1,3,0,18,14,1,CHI,CHA,CHI,119,,,32,25,25,14
DeMar DeRozan,F,22023,201942,22300484,"JAN 05, 2024",CHI vs. CHA,W,38,6,10,0.6,0,2,0.0,5,5,1.0,0,1,1,6,3,0,3,4,17,18,1,CHI,CHI,CHA,104,,,24,18,23,7
DeMar DeRozan,F,22023,201942,22300468,"JAN 03, 2024",CHI @ NYK,L,39,10,13,0.769,3,4,0.75,5,5,1.0,0,3,3,4,1,1,0,1,28,-25,1,CHI,NYK,CHI,100,,,35,31,32,7
DeMar DeRozan,F,22023,201942,22300459,"JAN 02, 2024",CHI @ PHI,L,30,5,10,0.5,0,3,0.0,6,7,0.857,0,4,4,3,0,0,1,4,16,-24,1,CHI,PHI,CHI,97,,,23,20,19,7
DeMar DeRozan,F,22023,201942,22300442,"DEC 30, 2023",CHI vs. PHI,W,37,9,17,0.529,0,2,0.0,6,7,0.857,0,6,6,5,0,0,2,0,24,19,1,CHI,CHI,PHI,105,,,35,30,29,11
DeMar DeRozan,F,22023,201942,22300422,"DEC 28, 2023",CHI vs. IND,L,37,7,19,0.368,0,3,0.0,7,8,0.875,0,5,5,5,2,0,1,1,21,-18,1,CHI,CHI,IND,104,,,31,26,26,10
DeMar DeRozan,F,22023,201942,22300408,"DEC 26, 2023",CHI vs. ATL,W,40,8,17,0.471,2,3,0.667,7,7,1.0,0,2,2,6,1,0,1,3,25,8,1,CHI,CHI,ATL,118,,,33,27,31,8
DeMar DeRozan,F,22023,201942,22300396,"DEC 23, 2023",CHI vs. CLE,L,40,6,14,0.429,1,3,0.333,8,9,0.889,0,5,5,8,3,0,2,4,21,-8,1,CHI,CHI,CLE,95,,,34,26,29,13
DeMar DeRozan,F,22023,201942,22300376,"DEC 21, 2023",CHI vs. SAS,W,36,9,15,0.6,1,3,0.333,2,2,1.0,0,4,4,5,0,1,0,1,21,10,1,CHI,CHI,SAS,114,,,30,25,26,9
DeMar DeRozan,F,22023,201942,22300370,"DEC 20, 2023",CHI vs. LAL,W,36,12,16,0.75,0,2,0.0,3,3,1.0,0,7,7,9,1,1,3,3,27,17,1,CHI,CHI,LAL,124,,,43,34,36,16
DeMar DeRozan,F,22023,201942,22300351,"DEC 18, 2023",CHI @ PHI,W,37,5,15,0.333,0,0,0.0,5,6,0.833,0,4,4,5,4,1,2,1,15,-5,1,CHI,PHI,CHI,108,,,24,19,20,9
DeMar DeRozan,F,22023,201942,22300337,"DEC 16, 2023",CHI @ MIA,L,42,9,13,0.692,1,2,0.5,8,9,0.889,1,2,3,5,2,3,3,1,27,5,1,CHI,MIA,CHI,116,,,35,30,32,8
DeMar DeRozan,F,22023,201942,22300320,"DEC 14, 2023",CHI @ MIA,W,41,6,14,0.429,1,3,0.333,10,11,0.909,2,3,5,4,0,0,3,2,23,14,1,CHI,MIA,CHI,124,,,32,28,27,9
DeMar DeRozan,F,22023,201942,22300307,"DEC 12, 2023",CHI vs. DEN,L,37,3,13,0.231,1,4,0.25,7,7,1.0,0,4,4,5,1,2,0,5,14,-7,1,CHI,CHI,DEN,106,,,23,18,19,9
DeMar DeRozan,F,22023,201942,22300300,"DEC 11, 2023",CHI @ MIL,L,42,14,30,0.467,3,6,0.5,10,12,0.833,0,2,2,11,0,0,2,5,41,6,1,CHI,MIL,CHI,129,,,54,43,52,13
DeMar DeRozan,F,22023,201942,22301223,"DEC 08, 2023",CHI @ SAS,W,39,7,24,0.292,0,2,0.0,6,10,0.6,1,5,6,10,3,0,2,2,20,13,1,CHI,SAS,CHI,121,,,36,26,30,16
DeMar DeRozan,F,22023,201942,22301211,"DEC 06, 2023",CHI vs. CHA,W,37,8,20,0.4,1,3,0.333,12,14,0.857,0,6,6,3,0,1,2,1,29,17,1,CHI,CHI,CHA,111,,,38,35,32,9
DeMar DeRozan,F,22023,201942,22300285,"DEC 02, 2023",CHI vs. NOP,W,40,10,18,0.556,2,4,0.5,2,2,1.0,0,5,5,10,0,0,2,3,24,2,1,CHI,CHI,NOP,124,,,39,29,34,15
DeMar DeRozan,F,22023,201942,22300053,"NOV 28, 2023",CHI @ BOS,L,26,7,14,0.5,1,3,0.333,4,4,1.0,0,2,2,6,0,0,2,2,19,-20,1,CHI,BOS,CHI,97,,,27,21,25,8
DeMar DeRozan,F,22023,201942,22300250,"NOV 26, 2023",CHI @ BKN,L,38,11,22,0.5,2,4,0.5,3,5,0.6,2,4,6,6,1,0,1,2,27,5,1,CHI,BKN,CHI,109,,,39,33,33,12
DeMar DeRozan,F,22023,201942,22300046,"NOV 24, 2023",CHI @ TOR,L,39,7,16,0.438,0,1,0.0,5,9,0.556,0,3,3,4,1,1,2,3,19,-31,1,CHI,TOR,CHI,108,,,26,22,23,7
DeMar DeRozan,F,22023,201942,22300234,"NOV 22, 2023",CHI @ OKC,L,37,6,17,0.353,0,2,0.0,13,13,1.0,1,1,2,6,2,1,1,3,25,-16,1,CHI,OKC,CHI,102,,,33,27,31,8
DeMar DeRozan,F,22023,201942,22300220,"NOV 20, 2023",CHI vs. MIA,L,34,6,10,0.6,2,4,0.5,1,1,1.0,0,4,4,5,0,1,0,1,15,-15,1,CHI,CHI,MIA,100,,,24,19,20,9
DeMar DeRozan,F,22023,201942,22300204,"NOV 18, 2023",CHI vs. MIA,W,40,6,12,0.5,2,4,0.5,9,13,0.692,1,3,4,4,1,0,3,1,23,-11,1,CHI,CHI,MIA,102,,,31,27,27,8
DeMar DeRozan,F,22023,201942,22300033,"NOV 17, 2023",CHI vs. ORL,L,36,10,20,0.5,1,1,1.0,2,4,0.5,0,4,4,3,1,0,3,1,23,-6,1,CHI,CHI,ORL,97,,,30,27,26,7
DeMar DeRozan,F,22023,201942,22300190,"NOV 13, 2023",CHI @ MIL,L,37,3,14,0.214,0,3,0.0,5,5,1.0,2,2,4,7,0,1,1,3,11,-2,1,CHI,MIL,CHI,109,,,22,15,18,11
DeMar DeRozan,F,22023,201942,22300181,"NOV 12, 2023",CHI vs. DET,W,37,11,19,0.579,2,3,0.667,5,5,1.0,1,0,1,1,0,4,0,1,29,12,1,CHI,CHI,DET,119,,,31,30,30,2
DeMar DeRozan,F,22023,201942,22300162,"NOV 08, 2023",CHI vs. PHX,L,40,6,20,0.3,1,4,0.25,9,11,0.818,0,2,2,7,1,2,2,2,22,-3,1,CHI,CHI,PHX,115,,,31,24,29,9
DeMar DeRozan,F,22023,201942,22300152,"NOV 06, 2023",CHI vs. UTA,W,30,8,13,0.615,1,1,1.0,4,5,0.8,3,2,5,4,4,0,1,3,21,2,1,CHI,CHI,UTA,130,,,30,26,25,9
DeMar DeRozan,F,22023,201942,22300004,"NOV 03, 2023",CHI vs. BKN,L,33,9,20,0.45,2,4,0.5,4,4,1.0,1,0,1,4,0,0,0,0,24,-16,1,CHI,CHI,BKN,107,,,29,25,28,5
DeMar DeRozan,F,22023,201942,22300124,"NOV 01, 2023",CHI @ DAL,L,33,5,13,0.385,0,1,0.0,6,6,1.0,1,2,3,7,1,0,2,3,16,-17,1,CHI,DAL,CHI,105,,,26,19,23,10
DeMar DeRozan,F,22023,201942,22300102,"OCT 30, 2023",CHI @ IND,W,35,6,19,0.316,0,1,0.0,8,8,1.0,1,2,3,4,0,1,0,2,20,15,1,CHI,IND,CHI,112,,,27,23,24,7
DeMar DeRozan,F,22023,201942,22300088,"OCT 28, 2023",CHI @ DET,L,32,7,13,0.538,0,1,0.0,6,7,0.857,1,1,2,4,1,2,1,3,20,-11,1,CHI,DET,CHI,102,,,26,22,24,6
DeMar DeRozan,F,22023,201942,22300082,"OCT 27, 2023",CHI vs. TOR,W,41,11,22,0.5,1,3,0.333,10,14,0.714,1,3,4,3,4,1,2,2,33,0,1,CHI,CHI,TOR,104,,,40,37,36,7
DeMar DeRozan,F,22023,201942,22300070,"OCT 25, 2023",CHI vs. OKC,L,33,9,20,0.45,1,3,0.333,1,3,0.333,2,3,5,2,1,1,0,1,20,-29,1,CHI,CHI,OKC,104,,,27,25,22,7
DeMar DeRozan,F,22023,201942,22300752,"FEB 10, 2024",CHI @ ORL,L,44,11,24,0.458,1,4,0.25,5,6,0.833,1,3,4,4,0,0,1,3,28,-2,1,CHI,ORL,CHI,108,,,36,32,32,8
DeMar DeRozan,F,22023,201942,22300536,"JAN 12, 2024",CHI vs. GSW,L,41,15,21,0.714,2,5,0.4,7,8,0.875,1,6,7,5,0,0,1,5,39,4,1,CHI,CHI,GSW,131,,,51,46,44,12
DeMar DeRozan,F,22023,201942,22300523,"JAN 10, 2024",CHI vs. HOU,W,43,5,19,0.263,3,6,0.5,6,6,1.0,0,4,4,4,0,0,1,2,19,-9,1,CHI,CHI,HOU,124,,,27,23,23,8
Kyle Kuzma,F,22023,1628398,22300753,"FEB 10, 2024",WAS vs. PHI,L,37,9,17,0.529,2,6,0.333,1,2,0.5,0,3,3,5,0,4,4,5,21,-7,1,WAS,WAS,PHI,113,,,29,24,26,8
Kyle Kuzma,F,22023,1628398,22300743,"FEB 09, 2024",WAS @ BOS,L,37,6,14,0.429,3,8,0.375,2,2,1.0,1,3,4,5,0,0,0,5,17,4,1,WAS,BOS,WAS,129,,,26,21,22,9
Kyle Kuzma,F,22023,1628398,22300728,"FEB 07, 2024",WAS vs. CLE,L,32,11,24,0.458,5,13,0.385,1,1,1.0,0,4,4,2,2,1,3,2,28,1,1,WAS,WAS,CLE,106,,,34,32,30,6
Kyle Kuzma,F,22023,1628398,22300689,"FEB 02, 2024",WAS vs. MIA,L,36,5,16,0.313,1,5,0.2,2,2,1.0,0,4,4,1,0,0,0,5,13,-7,1,WAS,WAS,MIA,102,,,18,17,14,5
Kyle Kuzma,F,22023,1628398,22300676,"JAN 31, 2024",WAS vs. LAC,L,29,11,22,0.5,2,4,0.5,3,3,1.0,0,2,2,0,0,1,2,2,27,-11,1,WAS,WAS,LAC,107,,,29,29,27,2
Kyle Kuzma,F,22023,1628398,22300665,"JAN 29, 2024",WAS @ SAS,W,32,7,18,0.389,0,4,0.0,4,4,1.0,2,9,11,5,0,2,2,2,18,3,1,WAS,SAS,WAS,118,,,34,29,23,16
Kyle Kuzma,F,22023,1628398,22300642,"JAN 27, 2024",WAS @ DET,W,32,13,27,0.481,3,13,0.231,1,2,0.5,0,6,6,4,1,1,1,1,30,4,1,WAS,DET,WAS,118,,,40,36,34,10
Kyle Kuzma,F,22023,1628398,22300628,"JAN 25, 2024",WAS vs. UTA,L,34,12,24,0.5,1,8,0.125,1,1,1.0,2,4,6,5,0,0,5,0,26,-8,1,WAS,WAS,UTA,108,,,37,32,31,11
Kyle Kuzma,F,22023,1628398,22300620,"JAN 24, 2024",WAS vs. MIN,L,35,5,11,0.455,3,8,0.375,4,4,1.0,0,14,14,8,0,1,5,4,17,-13,1,WAS,WAS,MIN,107,,,39,31,25,22
Kyle Kuzma,F,22023,1628398,22300602,"JAN 21, 2024",WAS vs. DEN,L,33,7,13,0.538,2,4,0.5,1,2,0.5,0,6,6,7,0,2,3,5,17,-11,1,WAS,WAS,DEN,104,,,30,23,24,13
Kyle Kuzma,F,22023,1628398,22300594,"JAN 20, 2024",WAS vs. SAS,L,29,5,14,0.357,0,4,0.0,1,1,1.0,3,9,12,6,1,0,2,0,11,-22,1,WAS,WAS,SAS,127,,,29,23,17,18
Kyle Kuzma,F,22023,1628398,22300579,"JAN 18, 2024",WAS @ NYK,L,38,7,16,0.438,1,5,0.2,0,0,0.0,0,6,6,5,2,1,3,2,15,-2,1,WAS,NYK,WAS,109,,,26,21,20,11
Kyle Kuzma,F,22023,1628398,22300558,"JAN 15, 2024",WAS vs. DET,L,33,7,21,0.333,3,9,0.333,4,4,1.0,0,8,8,4,3,2,0,2,21,-17,1,WAS,WAS,DET,117,,,33,29,25,12
Kyle Kuzma,F,22023,1628398,22300543,"JAN 13, 2024",WAS @ ATL,W,27,10,20,0.5,3,5,0.6,6,7,0.857,3,3,6,4,0,1,2,0,29,21,1,WAS,ATL,WAS,125,,,39,35,33,10
Kyle Kuzma,F,22023,1628398,22300520,"JAN 10, 2024",WAS @ IND,L,34,4,15,0.267,0,4,0.0,3,3,1.0,3,8,11,5,2,0,4,0,11,-8,1,WAS,IND,WAS,104,,,27,22,16,16
Kyle Kuzma,F,22023,1628398,22300508,"JAN 08, 2024",WAS vs. OKC,L,37,10,24,0.417,0,5,0.0,2,2,1.0,4,11,15,5,0,0,2,1,22,1,1,WAS,WAS,OKC,128,,,42,37,27,20
Kyle Kuzma,F,22023,1628398,22300494,"JAN 06, 2024",WAS vs. NYK,L,32,10,21,0.476,4,10,0.4,3,4,0.75,0,2,2,2,0,1,3,3,27,-8,1,WAS,WAS,NYK,105,,,31,29,29,4
Kyle Kuzma,F,22023,1628398,22300482,"JAN 05, 2024",WAS @ CLE,L,25,4,14,0.286,1,4,0.25,0,0,0.0,1,1,2,2,1,0,7,2,9,-20,1,WAS,CLE,WAS,90,,,13,11,11,4
Kyle Kuzma,F,22023,1628398,22300465,"JAN 03, 2024",WAS @ CLE,L,23,7,12,0.583,2,6,0.333,0,0,0.0,0,2,2,3,1,0,1,1,16,-22,1,WAS,CLE,WAS,101,,,21,18,19,5
Kyle Kuzma,F,22023,1628398,22300445,"DEC 31, 2023",WAS vs. ATL,L,34,15,31,0.484,7,18,0.389,1,1,1.0,2,6,8,5,0,0,2,4,38,0,1,WAS,WAS,ATL,126,,,51,46,43,13
Kyle Kuzma,F,22023,1628398,22300430,"DEC 29, 2023",WAS vs. BKN,W,31,11,22,0.5,4,10,0.4,0,0,0.0,1,7,8,2,0,1,2,1,26,-9,1,WAS,WAS,BKN,110,,,36,34,28,10
Kyle Kuzma,F,22023,1628398,22300416,"DEC 27, 2023",WAS vs. TOR,L,30,6,13,0.462,1,5,0.2,1,2,0.5,2,2,4,7,0,0,5,3,14,-21,1,WAS,WAS,TOR,102,,,25,18,21,11
Kyle Kuzma,F,22023,1628398,22300407,"DEC 26, 2023",WAS vs. ORL,L,36,6,18,0.333,2,8,0.25,3,3,1.0,1,3,4,6,0,1,6,5,17,8,1,WAS,WAS,ORL,119,,,27,21,23,10
Kyle Kuzma,F,22023,1628398,22300386,"DEC 22, 2023",WAS @ GSW,L,25,3,11,0.273,1,5,0.2,0,1,0.0,0,9,9,3,0,0,3,2,7,-5,1,WAS,GSW,WAS,118,,,19,16,10,12
Kyle Kuzma,F,22023,1628398,22300381,"DEC 21, 2023",WAS @ POR,W,37,11,22,0.5,3,7,0.429,7,10,0.7,2,6,8,6,1,0,3,0,32,4,1,WAS,POR,WAS,118,,,46,40,38,14
Kyle Kuzma,F,22023,1628398,22300358,"DEC 18, 2023",WAS @ SAC,L,29,8,16,0.5,3,7,0.429,8,8,1.0,0,8,8,1,0,1,3,1,27,-23,1,WAS,SAC,WAS,131,,,36,35,28,9
Kyle Kuzma,F,22023,1628398,22300347,"DEC 17, 2023",WAS @ PHX,L,34,7,22,0.318,3,13,0.231,0,2,0.0,1,6,7,2,0,2,2,6,17,0,1,WAS,PHX,WAS,108,,,26,24,19,9
Kyle Kuzma,F,22023,1628398,22300328,"DEC 15, 2023",WAS vs. IND,W,30,11,23,0.478,4,9,0.444,5,8,0.625,0,5,5,4,1,0,3,3,31,12,1,WAS,WAS,IND,137,,,40,36,35,9
Kyle Kuzma,F,22023,1628398,22300311,"DEC 13, 2023",WAS vs. NOP,L,30,10,19,0.526,4,8,0.5,3,4,0.75,0,7,7,4,1,1,2,1,27,-6,1,WAS,WAS,NOP,122,,,38,34,31,11
Kyle Kuzma,F,22023,1628398,22300295,"DEC 11, 2023",WAS @ PHI,L,27,9,17,0.529,1,2,0.5,2,4,0.5,2,7,9,1,0,0,2,0,21,-28,1,WAS,PHI,WAS,99,,,31,30,22,10
Kyle Kuzma,F,22023,1628398,22301219,"DEC 08, 2023",WAS @ BKN,L,30,8,17,0.471,1,4,0.25,0,1,0.0,1,2,3,2,0,0,3,2,17,-23,1,WAS,BKN,WAS,97,,,22,20,19,5
Kyle Kuzma,F,22023,1628398,22301208,"DEC 06, 2023",WAS vs. PHI,L,34,7,16,0.438,2,5,0.4,0,0,0.0,0,3,3,7,0,1,1,3,16,-12,1,WAS,WAS,PHI,126,,,26,19,23,10
Kyle Kuzma,F,22023,1628398,22300274,"DEC 01, 2023",WAS @ ORL,L,37,10,18,0.556,2,6,0.333,5,6,0.833,1,5,6,1,1,2,6,6,27,-7,1,WAS,ORL,WAS,125,,,34,33,28,7
Kyle Kuzma,F,22023,1628398,22300259,"NOV 29, 2023",WAS @ ORL,L,35,9,20,0.45,1,4,0.25,4,5,0.8,0,3,3,6,0,0,4,1,23,-11,1,WAS,ORL,WAS,120,,,32,26,29,9
Kyle Kuzma,F,22023,1628398,22300253,"NOV 27, 2023",WAS @ DET,W,35,10,23,0.435,2,7,0.286,10,11,0.909,0,12,12,8,0,0,1,0,32,18,1,WAS,DET,WAS,126,,,52,44,40,20
Kyle Kuzma,F,22023,1628398,22300241,"NOV 25, 2023",WAS vs. ATL,L,25,4,10,0.4,2,5,0.4,2,2,1.0,2,5,7,8,0,0,5,1,12,-25,1,WAS,WAS,ATL,108,,,27,19,20,15
Kyle Kuzma,F,22023,1628398,22300049,"NOV 24, 2023",WAS @ MIL,L,31,9,22,0.409,3,8,0.375,1,1,1.0,1,3,4,4,0,2,1,3,22,-1,1,WAS,MIL,WAS,128,,,30,26,26,8
Kyle Kuzma,F,22023,1628398,22300225,"NOV 22, 2023",WAS @ CHA,L,35,12,22,0.545,3,6,0.5,1,1,1.0,0,9,9,10,1,2,2,4,28,13,1,WAS,CHA,WAS,114,,,47,37,38,19
Kyle Kuzma,F,22023,1628398,22300219,"NOV 20, 2023",WAS vs. MIL,L,31,10,15,0.667,2,5,0.4,0,0,0.0,0,3,3,13,2,1,2,2,22,3,1,WAS,WAS,MIL,129,,,38,25,35,16
Kyle Kuzma,F,22023,1628398,22300028,"NOV 17, 2023",WAS vs. NYK,L,32,8,21,0.381,3,8,0.375,0,0,0.0,0,4,4,5,0,0,2,3,19,-20,1,WAS,WAS,NYK,99,,,28,23,24,9
Kyle Kuzma,F,22023,1628398,22300192,"NOV 15, 2023",WAS vs. DAL,L,30,6,18,0.333,2,6,0.333,8,10,0.8,2,4,6,3,0,0,2,1,22,-24,1,WAS,WAS,DAL,117,,,31,28,25,9
Kyle Kuzma,F,22023,1628398,22300189,"NOV 13, 2023",WAS @ TOR,L,38,14,25,0.56,4,7,0.571,2,3,0.667,1,2,3,3,0,0,6,5,34,1,1,WAS,TOR,WAS,107,,,40,37,37,6
Kyle Kuzma,F,22023,1628398,22300178,"NOV 12, 2023",WAS @ BKN,L,31,4,16,0.25,0,5,0.0,7,10,0.7,0,4,4,3,1,2,1,2,15,-29,1,WAS,BKN,WAS,94,,,22,19,18,7
Kyle Kuzma,F,22023,1628398,22300009,"NOV 10, 2023",WAS vs. CHA,L,29,7,17,0.412,2,5,0.4,1,1,1.0,1,5,6,1,0,0,3,1,17,-19,1,WAS,WAS,CHA,117,,,24,23,18,7
Kyle Kuzma,F,22023,1628398,22300157,"NOV 08, 2023",WAS @ CHA,W,31,13,24,0.542,4,11,0.364,3,3,1.0,3,6,9,4,0,0,2,1,33,8,1,WAS,CHA,WAS,132,,,46,42,37,13
Kyle Kuzma,F,22023,1628398,22300148,"NOV 06, 2023",WAS @ PHI,L,30,12,20,0.6,4,5,0.8,0,1,0.0,2,4,6,4,0,1,2,2,28,-3,1,WAS,PHI,WAS,128,,,38,34,32,10
Kyle Kuzma,F,22023,1628398,22300003,"NOV 03, 2023",WAS @ MIA,L,31,8,19,0.421,4,9,0.444,2,2,1.0,1,3,4,3,0,0,5,3,22,-20,1,WAS,MIA,WAS,114,,,29,26,25,7
Kyle Kuzma,F,22023,1628398,22300117,"NOV 01, 2023",WAS @ ATL,L,25,11,21,0.524,1,6,0.167,2,3,0.667,0,9,9,6,0,0,1,1,25,-16,1,WAS,ATL,WAS,121,,,40,34,31,15
Kyle Kuzma,F,22023,1628398,22300103,"OCT 30, 2023",WAS vs. BOS,L,26,9,15,0.6,3,6,0.5,0,0,0.0,0,5,5,4,0,0,2,0,21,-24,1,WAS,WAS,BOS,107,,,30,26,25,9
Kyle Kuzma,F,22023,1628398,22300089,"OCT 28, 2023",WAS vs. MEM,W,36,9,23,0.391,1,10,0.1,2,3,0.667,3,10,13,2,1,0,0,2,21,-1,1,WAS,WAS,MEM,113,,,36,34,23,15
Kyle Kuzma,F,22023,1628398,22300064,"OCT 25, 2023",WAS @ IND,L,25,9,18,0.5,1,4,0.25,6,6,1.0,1,1,2,0,0,2,0,0,25,-10,1,WAS,IND,WAS,120,,,27,27,25,2
Zion Williamson,F,22023,1629627,22300747,"FEB 09, 2024",NOP @ LAL,L,32,12,19,0.632,0,0,0.0,6,7,0.857,3,6,9,5,1,1,2,2,30,-17,1,NOP,LAL,NOP,122,,,44,39,35,14
Zion Williamson,F,22023,1629627,22300731,"FEB 07, 2024",NOP @ LAC,W,35,7,16,0.438,0,0,0.0,7,10,0.7,1,2,3,10,1,2,2,3,21,-6,1,NOP,LAC,NOP,117,,,34,24,31,13
Zion Williamson,F,22023,1629627,22300718,"FEB 05, 2024",NOP vs. TOR,W,22,5,8,0.625,0,0,0.0,6,6,1.0,1,2,3,5,0,1,1,0,16,16,1,NOP,NOP,TOR,138,,,24,19,21,8
Zion Williamson,F,22023,1629627,22300696,"FEB 02, 2024",NOP @ SAS,W,36,12,21,0.571,0,0,0.0,9,13,0.692,3,5,8,4,1,1,1,2,33,15,1,NOP,SAS,NOP,114,,,45,41,37,12
Zion Williamson,F,22023,1629627,22300648,"JAN 27, 2024",NOP @ MIL,L,29,8,14,0.571,0,0,0.0,7,7,1.0,1,1,2,2,1,0,5,0,23,-20,1,NOP,MIL,NOP,117,,,27,25,25,4
Zion Williamson,F,22023,1629627,22300616,"JAN 23, 2024",NOP vs. UTA,W,27,8,12,0.667,0,0,0.0,1,2,0.5,1,2,3,11,0,0,2,2,17,6,1,NOP,NOP,UTA,153,,,31,20,28,14
Zion Williamson,F,22023,1629627,22300588,"JAN 19, 2024",NOP vs. PHX,L,33,11,17,0.647,1,1,1.0,1,3,0.333,1,2,3,1,0,1,2,2,24,-23,1,NOP,NOP,PHX,109,,,28,27,25,4
Zion Williamson,F,22023,1629627,22300575,"JAN 17, 2024",NOP vs. CHA,W,27,5,11,0.455,0,0,0.0,3,4,0.75,2,3,5,9,3,0,2,1,13,6,1,NOP,NOP,CHA,132,,,27,18,22,14
Zion Williamson,F,22023,1629627,22300539,"JAN 12, 2024",NOP @ DEN,L,35,13,22,0.591,0,0,0.0,4,6,0.667,2,4,6,5,0,1,1,1,30,-7,1,NOP,DEN,NOP,113,,,41,36,35,11
Zion Williamson,F,22023,1629627,22300486,"JAN 05, 2024",NOP vs. LAC,L,19,3,9,0.333,0,0,0.0,6,8,0.75,2,4,6,1,1,1,1,3,12,-17,1,NOP,NOP,LAC,95,,,19,18,13,7
Zion Williamson,F,22023,1629627,22300471,"JAN 03, 2024",NOP @ MIN,W,29,11,15,0.733,0,0,0.0,5,6,0.833,1,3,4,6,1,1,2,3,27,20,1,NOP,MIN,NOP,117,,,37,31,33,10
Zion Williamson,F,22023,1629627,22300461,"JAN 02, 2024",NOP vs. BKN,W,26,5,9,0.556,0,0,0.0,0,0,0.0,1,2,3,5,0,1,4,3,10,16,1,NOP,NOP,BKN,112,,,18,13,15,8
Zion Williamson,F,22023,1629627,22300446,"DEC 31, 2023",NOP vs. LAL,W,32,8,12,0.667,0,0,0.0,10,12,0.833,2,2,4,6,0,0,4,5,26,12,1,NOP,NOP,LAL,129,,,36,30,32,10
Zion Williamson,F,22023,1629627,22300424,"DEC 28, 2023",NOP vs. UTA,W,30,10,14,0.714,0,0,0.0,1,3,0.333,1,9,10,8,0,1,0,2,21,7,1,NOP,NOP,UTA,112,,,39,31,29,18
Zion Williamson,F,22023,1629627,22300410,"DEC 26, 2023",NOP vs. MEM,L,36,7,17,0.412,0,0,0.0,9,12,0.75,2,9,11,1,1,0,6,5,23,4,1,NOP,NOP,MEM,115,,,35,34,24,12
Zion Williamson,F,22023,1629627,22300392,"DEC 23, 2023",NOP vs. HOU,L,34,11,16,0.688,1,2,0.5,5,10,0.5,2,6,8,4,2,1,3,1,28,2,1,NOP,NOP,HOU,104,,,40,36,32,12
Zion Williamson,F,22023,1629627,22300360,"DEC 19, 2023",NOP vs. MEM,L,25,5,12,0.417,0,0,0.0,3,4,0.75,0,3,3,4,0,0,2,4,13,-13,1,NOP,NOP,MEM,113,,,20,16,17,7
Zion Williamson,F,22023,1629627,22300345,"DEC 17, 2023",NOP @ SAS,W,26,7,12,0.583,0,1,0.0,1,4,0.25,5,3,8,3,2,1,1,2,15,5,1,NOP,SAS,NOP,146,,,26,23,18,11
Zion Williamson,F,22023,1629627,22300326,"DEC 15, 2023",NOP @ CHA,W,30,9,16,0.563,0,0,0.0,3,4,0.75,3,8,11,4,0,0,1,4,21,-1,1,NOP,CHA,NOP,112,,,36,32,25,15
Zion Williamson,F,22023,1629627,22300301,"DEC 11, 2023",NOP vs. MIN,W,33,13,17,0.765,0,0,0.0,10,12,0.833,2,3,5,2,1,1,1,1,36,26,1,NOP,NOP,MIN,121,,,43,41,38,7
Zion Williamson,F,22023,1629627,22301230,"DEC 07, 2023",NOP @ LAL,L,26,6,8,0.75,0,0,0.0,1,6,0.167,1,1,2,3,0,0,3,3,13,-33,1,NOP,LAL,NOP,89,,,18,15,16,5
Zion Williamson,F,22023,1629627,22301204,"DEC 04, 2023",NOP @ SAC,W,28,5,8,0.625,0,2,0.0,0,0,0.0,1,5,6,6,3,0,4,3,10,4,1,NOP,SAC,NOP,127,,,22,16,16,12
Zion Williamson,F,22023,1629627,22300285,"DEC 02, 2023",NOP @ CHI,L,30,10,15,0.667,0,0,0.0,7,9,0.778,2,3,5,3,1,0,5,3,27,-12,1,NOP,CHI,NOP,118,,,35,32,30,8
Zion Williamson,F,22023,1629627,22300262,"NOV 29, 2023",NOP vs. PHI,W,33,11,12,0.917,0,0,0.0,11,12,0.917,1,7,8,6,3,0,2,1,33,16,1,NOP,NOP,PHI,124,,,47,41,39,14
Zion Williamson,F,22023,1629627,22300256,"NOV 27, 2023",NOP @ UTA,L,34,9,16,0.563,1,1,1.0,7,9,0.778,1,3,4,7,1,0,0,2,26,3,1,NOP,UTA,NOP,112,,,37,30,33,11
Zion Williamson,F,22023,1629627,22300052,"NOV 24, 2023",NOP @ LAC,W,34,13,25,0.52,0,1,0.0,6,9,0.667,2,4,6,5,2,0,5,2,32,-1,1,NOP,LAC,NOP,116,,,43,38,37,11
Zion Williamson,F,22023,1629627,22300233,"NOV 22, 2023",NOP vs. SAC,W,35,10,16,0.625,0,0,0.0,5,7,0.714,1,4,5,6,0,0,2,3,25,-1,1,NOP,NOP,SAC,117,,,36,30,31,11
Zion Williamson,F,22023,1629627,22300222,"NOV 20, 2023",NOP vs. SAC,W,30,12,16,0.75,0,0,0.0,2,2,1.0,0,3,3,5,3,1,1,2,26,32,1,NOP,NOP,SAC,129,,,34,29,31,8
Zion Williamson,F,22023,1629627,22300659,"JAN 29, 2024",NOP @ BOS,L,31,11,18,0.611,0,1,0.0,4,5,0.8,0,4,4,3,2,0,3,0,26,-7,1,NOP,BOS,NOP,112,,,33,30,29,7
Zion Williamson,F,22023,1629627,22300556,"JAN 15, 2024",NOP @ DAL,L,32,12,17,0.706,0,0,0.0,6,11,0.545,0,1,1,3,1,0,3,2,30,6,1,NOP,DAL,NOP,120,,,34,31,33,4
Zion Williamson,F,22023,1629627,22300525,"JAN 10, 2024",NOP @ GSW,W,30,8,12,0.667,0,0,0.0,3,5,0.6,1,4,5,7,1,0,4,2,19,23,1,NOP,GSW,NOP,141,,,31,24,26,12
Zion Williamson,F,22023,1629627,22300278,"DEC 01, 2023",NOP vs. SAS,W,26,4,9,0.444,0,0,0.0,4,5,0.8,1,3,4,7,0,1,1,2,12,12,1,NOP,NOP,SAS,121,,,23,16,19,11
Zion Williamson,F,22023,1629627,22300034,"NOV 17, 2023",NOP vs. DEN,W,33,10,17,0.588,1,1,1.0,5,11,0.455,0,4,4,6,0,2,4,3,26,21,1,NOP,NOP,DEN,115,,,36,30,32,10
Zion Williamson,F,22023,1629627,22300022,"NOV 14, 2023",NOP vs. DAL,W,27,8,15,0.533,0,0,0.0,3,7,0.429,3,4,7,5,2,0,2,3,19,11,1,NOP,NOP,DAL,131,,,31,26,24,12
Zion Williamson,F,22023,1629627,22300183,"NOV 12, 2023",NOP vs. DAL,L,27,7,11,0.636,0,0,0.0,4,8,0.5,1,1,2,4,1,0,6,3,18,-21,1,NOP,NOP,DAL,124,,,24,20,22,6
Zion Williamson,F,22023,1629627,22300011,"NOV 10, 2023",NOP @ HOU,L,34,8,16,0.5,0,0,0.0,8,11,0.727,2,6,8,1,0,1,5,5,24,2,1,NOP,HOU,NOP,101,,,33,32,25,9
Zion Williamson,F,22023,1629627,22300156,"NOV 06, 2023",NOP @ DEN,L,37,10,22,0.455,0,0,0.0,0,1,0.0,3,7,10,9,2,0,0,2,20,-11,1,NOP,DEN,NOP,116,,,39,30,29,19
Zion Williamson,F,22023,1629627,22300135,"NOV 04, 2023",NOP vs. ATL,L,32,9,16,0.563,0,0,0.0,7,10,0.7,2,3,5,3,0,0,0,2,25,-4,1,NOP,NOP,ATL,105,,,33,30,28,8
Zion Williamson,F,22023,1629627,22300121,"NOV 01, 2023",NOP @ OKC,W,33,7,20,0.35,0,0,0.0,6,9,0.667,7,3,10,8,0,0,4,4,20,-7,1,NOP,OKC,NOP,110,,,38,30,28,18
Zion Williamson,F,22023,1629627,22300108,"OCT 30, 2023",NOP vs. GSW,L,30,7,15,0.467,0,1,0.0,5,9,0.556,3,2,5,3,2,0,5,5,19,-17,1,NOP,NOP,GSW,102,,,27,24,22,8
Zion Williamson,F,22023,1629627,22300090,"OCT 28, 2023",NOP vs. NYK,W,28,12,17,0.706,0,0,0.0,0,2,0.0,1,4,5,2,1,0,0,0,24,11,1,NOP,NOP,NYK,96,,,31,29,26,7
Zion Williamson,F,22023,1629627,22300071,"OCT 25, 2023",NOP @ MEM,W,32,9,17,0.529,0,0,0.0,5,7,0.714,4,3,7,3,0,0,3,1,23,-8,1,NOP,MEM,NOP,111,,,33,30,26,10
Mikal Bridges,F,22023,1628969,22300750,"FEB 10, 2024",BKN vs. SAS,W,33,4,11,0.364,3,6,0.5,3,3,1.0,0,6,6,3,1,1,1,0,14,17,1,BKN,BKN,SAS,123,,,23,20,17,9
Mikal Bridges,F,22023,1628969,22300735,"FEB 08, 2024",BKN vs. CLE,L,35,10,23,0.435,5,13,0.385,1,2,0.5,1,2,3,5,0,0,3,1,26,-28,1,BKN,BKN,CLE,95,,,34,29,31,8
Mikal Bridges,F,22023,1628969,22300720,"FEB 06, 2024",BKN vs. DAL,L,39,11,21,0.524,5,11,0.455,1,1,1.0,0,1,1,4,2,0,1,0,28,-18,1,BKN,BKN,DAL,107,,,33,29,32,5
Mikal Bridges,F,22023,1628969,22300717,"FEB 05, 2024",BKN vs. GSW,L,43,5,15,0.333,1,7,0.143,2,2,1.0,2,4,6,4,1,1,3,0,13,-6,1,BKN,BKN,GSW,98,,,23,19,17,10
Mikal Bridges,F,22023,1628969,22300698,"FEB 03, 2024",BKN @ PHI,W,32,7,16,0.438,5,12,0.417,4,5,0.8,1,2,3,4,0,0,1,1,23,25,1,BKN,PHI,BKN,136,,,30,26,27,7
Mikal Bridges,F,22023,1628969,22300677,"JAN 31, 2024",BKN vs. PHX,L,40,7,16,0.438,6,12,0.5,1,3,0.333,1,2,3,2,1,0,2,2,21,-4,1,BKN,BKN,PHX,120,,,26,24,23,5
Mikal Bridges,F,22023,1628969,22300660,"JAN 29, 2024",BKN vs. UTA,W,37,12,24,0.5,6,14,0.429,3,3,1.0,1,2,3,4,1,0,1,3,33,33,1,BKN,BKN,UTA,147,,,40,36,37,7
Mikal Bridges,F,22023,1628969,22300645,"JAN 27, 2024",BKN vs. HOU,W,41,6,14,0.429,3,8,0.375,4,6,0.667,0,5,5,1,3,1,3,3,19,-5,1,BKN,BKN,HOU,106,,,25,24,20,6
Mikal Bridges,F,22023,1628969,22300629,"JAN 25, 2024",BKN vs. MIN,L,35,8,18,0.444,2,8,0.25,3,5,0.6,0,1,1,3,2,0,3,1,21,2,1,BKN,BKN,MIN,94,,,25,22,24,4
Mikal Bridges,F,22023,1628969,22300615,"JAN 23, 2024",BKN vs. NYK,L,37,14,26,0.538,7,13,0.538,1,2,0.5,0,5,5,5,1,0,0,2,36,0,1,BKN,BKN,NYK,103,,,46,41,41,10
Mikal Bridges,F,22023,1628969,22300600,"JAN 21, 2024",BKN @ LAC,L,38,9,17,0.529,4,7,0.571,4,4,1.0,1,5,6,5,1,1,3,1,26,-12,1,BKN,LAC,BKN,114,,,37,32,31,11
Mikal Bridges,F,22023,1628969,22300591,"JAN 19, 2024",BKN @ LAL,W,35,6,11,0.545,4,8,0.5,1,2,0.5,0,1,1,5,2,0,2,1,17,14,1,BKN,LAL,BKN,130,,,23,18,22,6
Mikal Bridges,F,22023,1628969,22300578,"JAN 17, 2024",BKN @ POR,L,34,7,18,0.389,3,9,0.333,4,6,0.667,0,4,4,4,0,1,1,4,21,-3,1,BKN,POR,BKN,103,,,29,25,25,8
Mikal Bridges,F,22023,1628969,22300562,"JAN 15, 2024",BKN vs. MIA,L,44,10,23,0.435,2,10,0.2,4,4,1.0,2,7,9,6,2,2,1,1,26,-1,1,BKN,BKN,MIA,95,,,41,35,32,15
Mikal Bridges,F,22023,1628969,22300527,"JAN 11, 2024",BKN @ CLE,L,39,6,18,0.333,2,6,0.333,12,13,0.923,0,6,6,1,1,0,4,3,26,-6,1,BKN,CLE,BKN,102,,,33,32,27,7
Mikal Bridges,F,22023,1628969,22300498,"JAN 07, 2024",BKN vs. POR,L,44,15,26,0.577,4,8,0.5,8,8,1.0,0,4,4,3,0,0,3,0,42,-2,1,BKN,BKN,POR,127,,,49,46,45,7
Mikal Bridges,F,22023,1628969,22300481,"JAN 05, 2024",BKN vs. OKC,W,39,5,13,0.385,0,5,0.0,7,8,0.875,1,7,8,3,0,1,4,4,17,5,1,BKN,BKN,OKC,124,,,28,25,20,11
Mikal Bridges,F,22023,1628969,22300469,"JAN 03, 2024",BKN @ HOU,L,36,5,18,0.278,3,12,0.25,2,3,0.667,0,4,4,3,1,1,1,1,15,-19,1,BKN,HOU,BKN,101,,,22,19,18,7
Mikal Bridges,F,22023,1628969,22300461,"JAN 02, 2024",BKN @ NOP,L,29,4,11,0.364,2,5,0.4,3,3,1.0,2,1,3,2,0,0,4,0,13,-24,1,BKN,NOP,BKN,85,,,18,16,15,5
Mikal Bridges,F,22023,1628969,22300447,"DEC 31, 2023",BKN @ OKC,L,37,8,20,0.4,3,10,0.3,3,3,1.0,0,7,7,7,1,0,0,1,22,-8,1,BKN,OKC,BKN,108,,,36,29,29,14
Mikal Bridges,F,22023,1628969,22300430,"DEC 29, 2023",BKN @ WAS,L,36,6,14,0.429,2,6,0.333,5,7,0.714,0,5,5,1,1,1,2,2,19,11,1,BKN,WAS,BKN,104,,,25,24,20,6
Mikal Bridges,F,22023,1628969,22300417,"DEC 27, 2023",BKN vs. MIL,L,12,3,4,0.75,0,1,0.0,0,0,0.0,0,3,3,1,1,0,1,0,6,-1,1,BKN,BKN,MIL,122,,,10,9,7,4
Mikal Bridges,F,22023,1628969,22300406,"DEC 26, 2023",BKN @ DET,W,40,6,14,0.429,0,1,0.0,9,15,0.6,0,4,4,3,0,0,3,2,21,0,1,BKN,DET,BKN,118,,,28,25,24,7
Mikal Bridges,F,22023,1628969,22300394,"DEC 23, 2023",BKN vs. DET,W,33,9,17,0.529,1,4,0.25,10,10,1.0,2,4,6,7,1,1,1,2,29,8,1,BKN,BKN,DET,126,,,42,35,36,13
Mikal Bridges,F,22023,1628969,22300383,"DEC 22, 2023",BKN vs. DEN,L,29,7,16,0.438,0,3,0.0,0,1,0.0,2,1,3,6,0,0,3,2,14,-13,1,BKN,BKN,DEN,117,,,23,17,20,9
Mikal Bridges,F,22023,1628969,22300368,"DEC 20, 2023",BKN vs. NYK,L,33,4,21,0.19,1,8,0.125,6,6,1.0,2,3,5,2,2,0,2,0,15,-17,1,BKN,BKN,NYK,102,,,22,20,17,7
Mikal Bridges,F,22023,1628969,22300357,"DEC 18, 2023",BKN @ UTA,L,35,4,16,0.25,3,8,0.375,2,5,0.4,0,1,1,5,0,0,2,3,13,-19,1,BKN,UTA,BKN,108,,,19,14,18,6
Mikal Bridges,F,22023,1628969,22300339,"DEC 16, 2023",BKN @ GSW,L,40,6,17,0.353,3,4,0.75,3,3,1.0,1,5,6,2,1,0,2,1,18,-2,1,BKN,GSW,BKN,120,,,26,24,20,8
Mikal Bridges,F,22023,1628969,22300322,"DEC 14, 2023",BKN @ DEN,L,25,3,8,0.375,2,6,0.333,1,2,0.5,0,0,0,1,1,0,4,0,9,-13,1,BKN,DEN,BKN,101,,,10,9,10,1
Mikal Bridges,F,22023,1628969,22300317,"DEC 13, 2023",BKN @ PHX,W,39,7,19,0.368,3,9,0.333,4,5,0.8,0,3,3,2,1,0,0,3,21,0,1,BKN,PHX,BKN,116,,,26,24,23,5
Mikal Bridges,F,22023,1628969,22300303,"DEC 11, 2023",BKN @ SAC,L,37,6,13,0.462,3,5,0.6,7,7,1.0,2,3,5,5,0,0,5,1,22,-13,1,BKN,SAC,BKN,118,,,32,27,27,10
Mikal Bridges,F,22023,1628969,22301219,"DEC 08, 2023",BKN vs. WAS,W,30,9,15,0.6,2,3,0.667,1,1,1.0,1,3,4,3,0,2,2,0,21,24,1,BKN,BKN,WAS,124,,,28,25,24,7
Mikal Bridges,F,22023,1628969,22301209,"DEC 06, 2023",BKN @ ATL,W,35,12,19,0.632,3,4,0.75,5,5,1.0,0,5,5,6,0,1,1,2,32,1,1,BKN,ATL,BKN,114,,,43,37,38,11
Mikal Bridges,F,22023,1628969,22300282,"DEC 02, 2023",BKN vs. ORL,W,35,12,20,0.6,3,6,0.5,15,18,0.833,1,4,5,3,1,3,3,3,42,26,1,BKN,BKN,ORL,129,,,50,47,45,8
Mikal Bridges,F,22023,1628969,22300266,"NOV 30, 2023",BKN vs. CHA,L,38,9,22,0.409,2,5,0.4,2,3,0.667,0,9,9,4,2,0,2,1,22,7,1,BKN,BKN,CHA,128,,,35,31,26,13
Mikal Bridges,F,22023,1628969,22300054,"NOV 28, 2023",BKN vs. TOR,W,38,9,17,0.529,1,3,0.333,3,3,1.0,1,9,10,5,0,0,5,3,22,15,1,BKN,BKN,TOR,115,,,37,32,27,15
Mikal Bridges,F,22023,1628969,22300250,"NOV 26, 2023",BKN vs. CHI,W,36,5,7,0.714,4,6,0.667,1,2,0.5,0,2,2,6,0,0,2,0,15,-7,1,BKN,BKN,CHI,118,,,23,17,21,8
Mikal Bridges,F,22023,1628969,22300240,"NOV 25, 2023",BKN vs. MIA,W,33,8,19,0.421,3,6,0.5,5,5,1.0,1,5,6,3,2,1,3,2,24,16,1,BKN,BKN,MIA,112,,,33,30,27,9
Mikal Bridges,F,22023,1628969,22300227,"NOV 22, 2023",BKN @ ATL,L,44,16,31,0.516,2,6,0.333,11,12,0.917,3,7,10,4,2,0,1,2,45,-12,1,BKN,ATL,BKN,145,,,59,55,49,14
Mikal Bridges,F,22023,1628969,22300208,"NOV 19, 2023",BKN vs. PHI,L,29,8,12,0.667,2,2,1.0,0,0,0.0,0,1,1,3,0,0,2,0,18,-14,1,BKN,BKN,PHI,99,,,22,19,21,4
Mikal Bridges,F,22023,1628969,22300200,"NOV 16, 2023",BKN @ MIA,L,35,6,15,0.4,2,6,0.333,9,10,0.9,1,6,7,5,0,0,3,2,23,5,1,BKN,MIA,BKN,115,,,35,30,28,12
Mikal Bridges,F,22023,1628969,22300020,"NOV 14, 2023",BKN vs. ORL,W,32,9,17,0.529,3,5,0.6,0,1,0.0,1,4,5,4,4,0,6,2,21,12,1,BKN,BKN,ORL,124,,,30,26,25,9
Mikal Bridges,F,22023,1628969,22300178,"NOV 12, 2023",BKN vs. WAS,W,34,11,29,0.379,2,14,0.143,3,5,0.6,4,9,13,2,1,0,4,0,27,17,1,BKN,BKN,WAS,102,,,42,40,29,15
Mikal Bridges,F,22023,1628969,22300010,"NOV 10, 2023",BKN @ BOS,L,28,4,11,0.364,1,6,0.167,3,3,1.0,0,5,5,1,0,0,2,2,12,-14,1,BKN,BOS,BKN,107,,,18,17,13,6
Mikal Bridges,F,22023,1628969,22300160,"NOV 08, 2023",BKN vs. LAC,W,34,4,11,0.364,1,4,0.25,1,2,0.5,1,7,8,7,2,2,3,1,10,1,1,BKN,BKN,LAC,100,,,25,18,17,15
Mikal Bridges,F,22023,1628969,22300149,"NOV 06, 2023",BKN vs. MIL,L,39,12,21,0.571,1,5,0.2,6,7,0.857,1,4,5,4,1,1,1,2,31,7,1,BKN,BKN,MIL,125,,,40,36,35,9
Mikal Bridges,F,22023,1628969,22300136,"NOV 04, 2023",BKN vs. BOS,L,38,7,20,0.35,4,11,0.364,1,1,1.0,2,4,6,4,1,1,0,4,19,-9,1,BKN,BKN,BOS,114,,,29,25,23,10
Mikal Bridges,F,22023,1628969,22300004,"NOV 03, 2023",BKN @ CHI,W,33,8,17,0.471,3,8,0.375,1,2,0.5,0,2,2,3,0,0,0,0,20,-5,1,BKN,CHI,BKN,109,,,25,22,23,5
Mikal Bridges,F,22023,1628969,22300119,"NOV 01, 2023",BKN @ MIA,W,31,7,16,0.438,2,7,0.286,5,5,1.0,2,5,7,5,1,0,2,1,21,-14,1,BKN,MIA,BKN,109,,,33,28,26,12
Mikal Bridges,F,22023,1628969,22300101,"OCT 30, 2023",BKN @ CHA,W,38,10,13,0.769,1,3,0.333,3,3,1.0,1,6,7,4,1,1,5,3,24,10,1,BKN,CHA,BKN,133,,,35,31,28,11
Mikal Bridges,F,22023,1628969,22300084,"OCT 27, 2023",BKN @ DAL,L,35,6,17,0.353,3,7,0.429,3,3,1.0,1,3,4,3,0,0,1,2,18,-12,1,BKN,DAL,BKN,120,,,25,22,21,7
Mikal Bridges,F,22023,1628969,22300067,"OCT 25, 2023",BKN vs. CLE,L,35,6,12,0.5,0,2,0.0,8,9,0.889,2,4,6,4,3,0,3,4,20,-3,1,BKN,BKN,CLE,113,,,30,26,24,10
Jaren Jackson Jr.,F,22023,1628991,22300751,"FEB 10, 2024",MEM @ CHA,L,34,12,23,0.522,5,9,0.556,0,0,0.0,1,2,3,3,1,2,5,4,29,2,1,MEM,CHA,MEM,105,,,35,32,32,6
Jaren Jackson Jr.,F,22023,1628991,22300737,"FEB 08, 2024",MEM vs. CHI,L,32,11,22,0.5,4,10,0.4,2,5,0.4,1,1,2,4,0,1,4,6,28,-8,1,MEM,MEM,CHI,95,,,34,30,32,6
Jaren Jackson Jr.,F,22023,1628991,22300693,"FEB 02, 2024",MEM vs. GSW,L,31,8,21,0.381,2,9,0.222,9,11,0.818,0,5,5,2,2,2,2,2,27,-7,1,MEM,MEM,GSW,98,,,34,32,29,7
Jaren Jackson Jr.,F,22023,1628991,22300687,"FEB 01, 2024",MEM vs. CLE,L,34,10,23,0.435,2,6,0.333,3,4,0.75,0,5,5,5,1,3,5,4,25,-11,1,MEM,MEM,CLE,86,,,35,30,30,10
Jaren Jackson Jr.,F,22023,1628991,22300663,"JAN 29, 2024",MEM vs. SAC,L,32,6,18,0.333,0,4,0.0,10,12,0.833,0,3,3,2,0,0,3,5,22,-5,1,MEM,MEM,SAC,72,,,27,25,24,5
Jaren Jackson Jr.,F,22023,1628991,22300652,"JAN 28, 2024",MEM @ IND,L,32,7,17,0.412,0,3,0.0,11,12,0.917,0,5,5,4,2,1,4,5,25,10,1,MEM,IND,MEM,106,,,34,30,29,9
Jaren Jackson Jr.,F,22023,1628991,22300638,"JAN 26, 2024",MEM vs. ORL,W,35,13,30,0.433,1,5,0.2,3,4,0.75,3,5,8,2,1,1,3,3,30,5,1,MEM,MEM,ORL,107,,,40,38,32,10
Jaren Jackson Jr.,F,22023,1628991,22300609,"JAN 22, 2024",MEM @ TOR,W,32,12,22,0.545,2,5,0.4,1,3,0.333,3,1,4,5,6,1,4,4,27,0,1,MEM,TOR,MEM,108,,,36,31,32,9
Jaren Jackson Jr.,F,22023,1628991,22300597,"JAN 20, 2024",MEM @ CHI,L,33,8,18,0.444,1,7,0.143,9,9,1.0,1,5,6,5,1,0,2,3,26,-5,1,MEM,CHI,MEM,93,,,37,32,31,11
Jaren Jackson Jr.,F,22023,1628991,22300582,"JAN 18, 2024",MEM @ MIN,L,27,15,23,0.652,3,6,0.5,3,5,0.6,1,2,3,1,0,1,3,5,36,-10,1,MEM,MIN,MEM,103,,,40,39,37,4
Jaren Jackson Jr.,F,22023,1628991,22300560,"JAN 15, 2024",MEM vs. GSW,W,33,4,20,0.2,3,14,0.214,7,8,0.875,0,5,5,5,4,1,1,1,18,-9,1,MEM,MEM,GSW,116,,,28,23,23,10
Jaren Jackson Jr.,F,22023,1628991,22300503,"JAN 07, 2024",MEM @ PHX,W,32,11,20,0.55,3,8,0.375,3,4,0.75,1,9,10,6,0,1,2,5,28,25,1,MEM,PHX,MEM,121,,,44,38,34,16
Jaren Jackson Jr.,F,22023,1628991,22300491,"JAN 05, 2024",MEM @ LAL,W,30,11,14,0.786,5,6,0.833,4,4,1.0,0,9,9,1,0,3,3,5,31,1,1,MEM,LAL,MEM,127,,,41,40,32,10
Jaren Jackson Jr.,F,22023,1628991,22300470,"JAN 03, 2024",MEM vs. TOR,L,37,7,18,0.389,4,8,0.5,6,6,1.0,1,3,4,0,1,4,3,1,24,5,1,MEM,MEM,TOR,111,,,28,28,24,4
Jaren Jackson Jr.,F,22023,1628991,22300460,"JAN 02, 2024",MEM vs. SAS,W,32,3,14,0.214,1,4,0.25,3,4,0.75,1,6,7,1,3,4,1,4,10,2,1,MEM,MEM,SAS,106,,,18,17,11,8
Jaren Jackson Jr.,F,22023,1628991,22300449,"DEC 31, 2023",MEM vs. SAC,L,29,6,14,0.429,1,4,0.25,5,6,0.833,0,3,3,1,1,0,0,3,18,-13,1,MEM,MEM,SAC,92,,,22,21,19,4
Jaren Jackson Jr.,F,22023,1628991,22300438,"DEC 29, 2023",MEM @ LAC,L,37,8,17,0.471,4,6,0.667,2,2,1.0,0,2,2,4,2,2,1,5,22,-11,1,MEM,LAC,MEM,106,,,28,24,26,6
Jaren Jackson Jr.,F,22023,1628991,22300410,"DEC 26, 2023",MEM @ NOP,W,39,5,11,0.455,0,3,0.0,9,10,0.9,1,9,10,1,1,1,3,5,19,6,1,MEM,NOP,MEM,116,,,30,29,20,11
Jaren Jackson Jr.,F,22023,1628991,22300393,"DEC 23, 2023",MEM @ ATL,W,24,8,10,0.8,1,2,0.5,3,4,0.75,2,0,2,0,0,0,2,5,20,0,1,MEM,ATL,MEM,125,,,22,22,20,2
Jaren Jackson Jr.,F,22023,1628991,22300377,"DEC 21, 2023",MEM vs. IND,W,33,8,10,0.8,2,4,0.5,3,3,1.0,2,6,8,1,1,0,7,4,21,-8,1,MEM,MEM,IND,116,,,30,29,22,9
Jaren Jackson Jr.,F,22023,1628991,22300360,"DEC 19, 2023",MEM @ NOP,W,30,6,10,0.6,1,3,0.333,11,15,0.733,1,5,6,0,0,3,2,4,24,-2,1,MEM,NOP,MEM,115,,,30,30,24,6
Jaren Jackson Jr.,F,22023,1628991,22300355,"DEC 18, 2023",MEM @ OKC,L,25,3,7,0.429,1,4,0.25,4,5,0.8,0,5,5,1,1,0,2,3,11,-15,1,MEM,OKC,MEM,97,,,17,16,12,6
Jaren Jackson Jr.,F,22023,1628991,22300332,"DEC 15, 2023",MEM vs. HOU,L,33,8,23,0.348,0,7,0.0,6,7,0.857,1,2,3,2,0,4,1,5,22,-5,1,MEM,MEM,HOU,96,,,27,25,24,5
Jaren Jackson Jr.,F,22023,1628991,22300314,"DEC 13, 2023",MEM @ HOU,L,40,15,24,0.625,3,8,0.375,11,13,0.846,1,6,7,2,4,1,3,4,44,-1,1,MEM,HOU,MEM,104,,,53,51,46,9
Jaren Jackson Jr.,F,22023,1628991,22300299,"DEC 11, 2023",MEM vs. DAL,L,42,15,29,0.517,6,10,0.6,5,5,1.0,0,4,4,2,2,2,2,3,41,-2,1,MEM,MEM,DAL,113,,,47,45,43,6
Jaren Jackson Jr.,F,22023,1628991,22301221,"DEC 08, 2023",MEM vs. MIN,L,29,7,14,0.5,3,4,0.75,4,4,1.0,1,1,2,1,1,1,2,5,21,-19,1,MEM,MEM,MIN,95,,,24,23,22,3
Jaren Jackson Jr.,F,22023,1628991,22301206,"DEC 06, 2023",MEM @ DET,W,35,10,20,0.5,2,6,0.333,2,3,0.667,0,4,4,0,0,3,0,3,24,15,1,MEM,DET,MEM,104,,,28,28,24,4
Jaren Jackson Jr.,F,22023,1628991,22300288,"DEC 02, 2023",MEM @ PHX,L,35,13,21,0.619,2,5,0.4,9,10,0.9,1,8,9,2,1,1,4,4,37,-7,1,MEM,PHX,MEM,101,,,48,46,39,11
Jaren Jackson Jr.,F,22023,1628991,22300277,"DEC 01, 2023",MEM @ DAL,W,14,2,8,0.25,0,3,0.0,0,0,0.0,1,3,4,2,0,2,1,5,4,0,1,MEM,DAL,MEM,89,,,10,8,6,6
Jaren Jackson Jr.,F,22023,1628991,22300261,"NOV 29, 2023",MEM vs. UTA,W,35,8,19,0.421,0,3,0.0,4,4,1.0,3,3,6,1,1,6,1,2,20,14,1,MEM,MEM,UTA,105,,,27,26,21,7
Jaren Jackson Jr.,F,22023,1628991,22300249,"NOV 26, 2023",MEM vs. MIN,L,37,4,14,0.286,2,6,0.333,8,10,0.8,0,4,4,3,1,3,2,3,18,-9,1,MEM,MEM,MIN,91,,,25,22,21,7
Jaren Jackson Jr.,F,22023,1628991,22300044,"NOV 24, 2023",MEM vs. PHX,L,29,5,13,0.385,1,4,0.25,2,4,0.5,4,3,7,2,1,0,3,5,13,-12,1,MEM,MEM,PHX,89,,,22,20,15,9
Jaren Jackson Jr.,F,22023,1628991,22300231,"NOV 22, 2023",MEM @ HOU,L,37,7,21,0.333,0,4,0.0,9,12,0.75,1,6,7,0,1,1,2,4,23,-20,1,MEM,HOU,MEM,91,,,30,30,23,7
Jaren Jackson Jr.,F,22023,1628991,22300213,"NOV 19, 2023",MEM vs. BOS,L,34,5,12,0.417,1,3,0.333,6,7,0.857,2,6,8,1,1,1,2,5,17,-1,1,MEM,MEM,BOS,100,,,26,25,18,9
Jaren Jackson Jr.,F,22023,1628991,22300206,"NOV 18, 2023",MEM @ SAS,W,27,7,20,0.35,2,8,0.25,11,12,0.917,3,2,5,0,1,1,2,3,27,10,1,MEM,SAS,MEM,120,,,32,32,27,5
Jaren Jackson Jr.,F,22023,1628991,22300026,"NOV 14, 2023",MEM @ LAL,L,22,3,16,0.188,2,6,0.333,0,0,0.0,2,0,2,2,0,1,1,2,8,-16,1,MEM,LAL,MEM,107,,,12,10,10,4
Jaren Jackson Jr.,F,22023,1628991,22300179,"NOV 12, 2023",MEM @ LAC,W,29,3,15,0.2,0,3,0.0,6,6,1.0,0,4,4,1,1,1,3,4,12,-3,1,MEM,LAC,MEM,105,,,17,16,13,5
Jaren Jackson Jr.,F,22023,1628991,22300012,"NOV 10, 2023",MEM vs. UTA,L,23,7,13,0.538,0,2,0.0,0,0,0.0,2,2,4,2,0,0,2,2,14,-11,1,MEM,MEM,UTA,121,,,20,18,16,6
Jaren Jackson Jr.,F,22023,1628991,22300164,"NOV 08, 2023",MEM vs. MIA,L,33,9,18,0.5,2,8,0.25,8,10,0.8,2,2,4,2,0,1,1,5,28,-5,1,MEM,MEM,MIA,102,,,34,32,30,6
Jaren Jackson Jr.,F,22023,1628991,22300144,"NOV 05, 2023",MEM @ POR,W,37,11,18,0.611,1,4,0.25,4,6,0.667,3,4,7,2,1,1,2,1,27,11,1,MEM,POR,MEM,112,,,36,34,29,9
Jaren Jackson Jr.,F,22023,1628991,22300537,"JAN 12, 2024",MEM vs. LAC,L,30,6,20,0.3,1,8,0.125,8,10,0.8,2,4,6,1,1,1,1,1,21,-14,1,MEM,MEM,LAC,119,,,28,27,22,7
Jaren Jackson Jr.,F,22023,1628991,22300425,"DEC 28, 2023",MEM @ DEN,L,28,5,15,0.333,1,3,0.333,3,4,0.75,1,3,4,2,2,0,0,1,14,-11,1,MEM,DEN,MEM,105,,,20,18,16,6
Jaren Jackson Jr.,F,22023,1628991,22300007,"NOV 03, 2023",MEM @ POR,L,38,11,17,0.647,5,8,0.625,3,6,0.5,2,8,10,3,1,3,4,1,30,3,1,MEM,POR,MEM,113,,,43,40,33,13
Jaren Jackson Jr.,F,22023,1628991,22300125,"NOV 01, 2023",MEM @ UTA,L,26,5,17,0.294,1,8,0.125,8,8,1.0,3,5,8,2,0,1,2,3,19,-25,1,MEM,UTA,MEM,109,,,29,27,21,10
Jaren Jackson Jr.,F,22023,1628991,22300106,"OCT 30, 2023",MEM vs. DAL,L,34,10,20,0.5,3,6,0.5,7,9,0.778,2,7,9,4,0,2,1,3,30,-25,1,MEM,MEM,DAL,110,,,43,39,34,13
Jaren Jackson Jr.,F,22023,1628991,22300089,"OCT 28, 2023",MEM @ WAS,L,31,4,12,0.333,2,4,0.5,6,6,1.0,0,5,5,2,1,1,1,4,16,5,1,MEM,WAS,MEM,106,,,23,21,18,7
Jaren Jackson Jr.,F,22023,1628991,22300078,"OCT 27, 2023",MEM vs. DEN,L,28,9,13,0.692,2,2,1.0,1,2,0.5,2,7,9,2,0,3,0,5,21,-1,1,MEM,MEM,DEN,104,,,32,30,23,11
Jaren Jackson Jr.,F,22023,1628991,22300071,"OCT 25, 2023",MEM vs. NOP,L,36,2,9,0.222,0,5,0.0,4,4,1.0,1,4,5,3,0,5,3,5,8,-1,1,MEM,MEM,NOP,104,,,16,13,11,8
Jaren Jackson Jr.,F,22023,1628991,22300621,"JAN 24, 2024",MEM @ MIA,W,35,5,21,0.238,1,7,0.143,4,5,0.8,0,6,6,3,1,1,5,1,15,11,1,MEM,MIA,MEM,90,,,24,21,18,9
Alperen Sengun,C,22023,1630578,22300744,"FEB 09, 2024",HOU @ TOR,L,21,3,7,0.429,0,0,0.0,1,2,0.5,3,4,7,1,0,0,2,3,7,-21,1,HOU,TOR,HOU,104,,,15,14,8,8
Alperen Sengun,C,22023,1630578,22300719,"FEB 06, 2024",HOU @ IND,L,36,7,15,0.467,0,1,0.0,6,8,0.75,5,5,10,6,1,0,1,2,20,8,1,HOU,IND,HOU,129,,,36,30,26,16
Alperen Sengun,C,22023,1630578,22300709,"FEB 04, 2024",HOU @ MIN,L,30,7,14,0.5,1,1,1.0,0,2,0.0,4,6,10,1,1,1,3,4,15,-14,1,HOU,MIN,HOU,90,,,26,25,16,11
Alperen Sengun,C,22023,1630578,22300692,"FEB 02, 2024",HOU vs. TOR,W,29,10,14,0.714,1,2,0.5,3,3,1.0,1,12,13,8,0,0,2,4,24,23,1,HOU,HOU,TOR,135,,,45,37,32,21
Alperen Sengun,C,22023,1630578,22300679,"JAN 31, 2024",HOU vs. NOP,L,34,4,11,0.364,0,1,0.0,2,2,1.0,2,8,10,5,2,0,2,3,10,-5,1,HOU,HOU,NOP,99,,,25,20,15,15
Alperen Sengun,C,22023,1630578,22300662,"JAN 29, 2024",HOU vs. LAL,W,39,14,23,0.609,1,4,0.25,2,4,0.5,3,9,12,7,2,1,4,4,31,15,1,HOU,HOU,LAL,135,,,50,43,38,19
Alperen Sengun,C,22023,1630578,22300645,"JAN 27, 2024",HOU @ BKN,L,28,6,13,0.462,0,1,0.0,3,4,0.75,5,6,11,2,0,0,3,2,15,-7,1,HOU,BKN,HOU,104,,,28,26,17,13
Alperen Sengun,C,22023,1630578,22300635,"JAN 26, 2024",HOU @ CHA,W,25,5,7,0.714,0,0,0.0,1,2,0.5,2,4,6,7,0,1,2,2,11,18,1,HOU,CHA,HOU,138,,,24,17,18,13
Alperen Sengun,C,22023,1630578,22300623,"JAN 24, 2024",HOU vs. POR,L,40,11,17,0.647,1,2,0.5,7,8,0.875,4,6,10,8,1,0,2,5,30,-9,1,HOU,HOU,POR,131,,,48,40,38,18
Alperen Sengun,C,22023,1630578,22300603,"JAN 21, 2024",HOU vs. BOS,L,36,10,18,0.556,0,2,0.0,4,4,1.0,2,10,12,10,1,0,6,2,24,-12,1,HOU,HOU,BOS,107,,,46,36,34,22
Alperen Sengun,C,22023,1630578,22300598,"JAN 20, 2024",HOU vs. UTA,W,42,15,26,0.577,1,1,1.0,6,10,0.6,8,6,14,6,1,1,1,4,37,-8,1,HOU,HOU,UTA,127,,,57,51,43,20
Alperen Sengun,C,22023,1630578,22300573,"JAN 17, 2024",HOU @ NYK,L,40,7,16,0.438,0,1,0.0,4,7,0.571,3,7,10,5,1,4,3,3,18,-16,1,HOU,NYK,HOU,94,,,33,28,23,15
Alperen Sengun,C,22023,1630578,22300555,"JAN 15, 2024",HOU @ PHI,L,30,7,15,0.467,1,1,1.0,4,6,0.667,5,4,9,6,1,2,5,1,19,-4,1,HOU,PHI,HOU,115,,,34,28,25,15
Alperen Sengun,C,22023,1630578,22300542,"JAN 13, 2024",HOU @ BOS,L,24,8,17,0.471,0,2,0.0,3,3,1.0,2,8,10,3,4,0,3,3,19,-14,1,HOU,BOS,HOU,113,,,32,29,22,13
Alperen Sengun,C,22023,1630578,22300409,"DEC 26, 2023",HOU vs. IND,L,37,11,20,0.55,0,0,0.0,8,9,0.889,7,9,16,5,4,0,4,2,30,-8,1,HOU,HOU,IND,117,,,51,46,35,21
Alperen Sengun,C,22023,1630578,22300392,"DEC 23, 2023",HOU @ NOP,W,38,11,21,0.524,1,1,1.0,14,17,0.824,4,7,11,6,1,1,2,4,37,-2,1,HOU,NOP,HOU,106,,,54,48,43,17
Alperen Sengun,C,22023,1630578,22300385,"DEC 22, 2023",HOU vs. DAL,W,25,8,12,0.667,1,1,1.0,5,5,1.0,2,13,15,3,0,0,0,2,22,30,1,HOU,HOU,DAL,122,,,40,37,25,18
Alperen Sengun,C,22023,1630578,22300371,"DEC 20, 2023",HOU vs. ATL,L,27,7,12,0.583,0,0,0.0,0,0,0.0,2,7,9,5,0,1,0,2,14,-10,1,HOU,HOU,ATL,127,,,28,23,19,14
Alperen Sengun,C,22023,1630578,22300349,"DEC 18, 2023",HOU @ CLE,L,31,11,20,0.55,1,3,0.333,1,2,0.5,4,4,8,6,1,0,4,5,24,-3,1,HOU,CLE,HOU,130,,,38,32,30,14
Alperen Sengun,C,22023,1630578,22300346,"DEC 17, 2023",HOU @ MIL,L,31,8,15,0.533,0,3,0.0,4,6,0.667,2,6,8,5,1,1,0,4,20,-7,1,HOU,MIL,HOU,119,,,33,28,25,13
Alperen Sengun,C,22023,1630578,22300332,"DEC 15, 2023",HOU @ MEM,W,32,4,12,0.333,0,0,0.0,7,7,1.0,4,3,7,1,2,3,4,3,15,1,1,HOU,MEM,HOU,103,,,23,22,16,8
Alperen Sengun,C,22023,1630578,22300314,"DEC 13, 2023",HOU vs. MEM,W,24,2,8,0.25,0,1,0.0,5,6,0.833,1,9,10,2,0,0,2,4,9,-10,1,HOU,HOU,MEM,117,,,21,19,11,12
Alperen Sengun,C,22023,1630578,22300298,"DEC 11, 2023",HOU vs. SAS,W,30,6,12,0.5,1,1,1.0,2,4,0.5,2,7,9,4,2,1,6,3,15,10,1,HOU,HOU,SAS,93,,,28,24,19,13
Alperen Sengun,C,22023,1630578,22301224,"DEC 08, 2023",HOU @ DEN,W,34,7,14,0.5,0,1,0.0,3,5,0.6,2,8,10,7,0,1,1,3,17,11,1,HOU,DEN,HOU,114,,,34,27,24,17
Alperen Sengun,C,22023,1630578,22301212,"DEC 06, 2023",HOU vs. OKC,W,35,8,13,0.615,0,2,0.0,5,11,0.455,1,5,6,7,1,2,4,4,21,12,1,HOU,HOU,OKC,110,,,34,27,28,13
Alperen Sengun,C,22023,1630578,22300291,"DEC 02, 2023",HOU @ LAL,L,34,8,25,0.32,3,8,0.375,2,2,1.0,3,10,13,5,2,2,0,2,21,-6,1,HOU,LAL,HOU,97,,,39,34,26,18
Alperen Sengun,C,22023,1630578,22300263,"NOV 29, 2023",HOU @ DEN,L,28,10,18,0.556,2,6,0.333,0,0,0.0,2,5,7,4,1,0,1,3,22,-19,1,HOU,DEN,HOU,124,,,33,29,26,11
Alperen Sengun,C,22023,1630578,22300059,"NOV 28, 2023",HOU @ DAL,L,35,10,19,0.526,0,2,0.0,11,14,0.786,4,5,9,6,0,1,3,2,31,-8,1,HOU,DAL,HOU,115,,,46,40,37,15
Alperen Sengun,C,22023,1630578,22300048,"NOV 24, 2023",HOU vs. DEN,W,43,8,19,0.421,0,4,0.0,5,6,0.833,1,14,15,8,2,1,5,4,21,12,1,HOU,HOU,DEN,105,,,44,36,29,23
Alperen Sengun,C,22023,1630578,22300231,"NOV 22, 2023",HOU vs. MEM,W,32,4,9,0.444,1,1,1.0,2,3,0.667,1,6,7,3,0,3,2,5,11,21,1,HOU,HOU,MEM,111,,,21,18,14,10
Alperen Sengun,C,22023,1630578,22300224,"NOV 20, 2023",HOU @ GSW,L,37,13,23,0.565,2,3,0.667,2,5,0.4,7,6,13,5,1,1,3,4,30,6,1,HOU,GSW,HOU,116,,,48,43,35,18
Alperen Sengun,C,22023,1630578,22300216,"NOV 19, 2023",HOU @ LAL,L,31,11,16,0.688,1,2,0.5,0,0,0.0,2,8,10,5,0,1,4,4,23,21,1,HOU,LAL,HOU,104,,,38,33,28,15
Alperen Sengun,C,22023,1630578,22300037,"NOV 17, 2023",HOU @ LAC,L,34,8,18,0.444,2,5,0.4,5,7,0.714,2,6,8,4,1,0,6,4,23,-17,1,HOU,LAC,HOU,100,,,35,31,27,12
Alperen Sengun,C,22023,1630578,22300182,"NOV 12, 2023",HOU vs. DEN,W,35,9,18,0.5,0,2,0.0,5,6,0.833,4,4,8,5,1,2,3,2,23,-8,1,HOU,HOU,DEN,107,,,36,31,28,13
Alperen Sengun,C,22023,1630578,22300011,"NOV 10, 2023",HOU vs. NOP,W,34,11,15,0.733,0,2,0.0,2,5,0.4,4,4,8,3,2,1,4,3,24,-2,1,HOU,HOU,NOP,104,,,35,32,27,11
Alperen Sengun,C,22023,1630578,22300163,"NOV 08, 2023",HOU vs. LAL,W,25,8,10,0.8,0,0,0.0,3,4,0.75,0,7,7,4,0,0,1,1,19,18,1,HOU,HOU,LAL,128,,,30,26,23,11
Alperen Sengun,C,22023,1630578,22300153,"NOV 06, 2023",HOU vs. SAC,W,26,7,13,0.538,0,2,0.0,3,4,0.75,2,6,8,12,1,0,1,3,17,30,1,HOU,HOU,SAC,122,,,37,25,29,20
Alperen Sengun,C,22023,1630578,22300137,"NOV 04, 2023",HOU vs. SAC,W,34,7,13,0.538,1,3,0.333,0,0,0.0,0,9,9,6,2,0,2,2,15,27,1,HOU,HOU,SAC,107,,,30,24,21,15
Alperen Sengun,C,22023,1630578,22300122,"NOV 01, 2023",HOU vs. CHA,W,27,9,12,0.75,1,1,1.0,0,1,0.0,1,6,7,4,1,0,1,1,19,9,1,HOU,HOU,CHA,128,,,30,26,23,11
Alperen Sengun,C,22023,1630578,22300096,"OCT 29, 2023",HOU vs. GSW,L,33,7,15,0.467,1,2,0.5,4,4,1.0,4,1,5,7,0,0,0,3,19,-10,1,HOU,HOU,GSW,95,,,31,24,26,12
Alperen Sengun,C,22023,1630578,22300083,"OCT 27, 2023",HOU @ SAS,L,41,11,18,0.611,1,3,0.333,2,6,0.333,6,8,14,7,2,1,6,6,25,-4,1,HOU,SAS,HOU,122,,,46,39,32,21
Alperen Sengun,C,22023,1630578,22300066,"OCT 25, 2023",HOU @ ORL,L,28,6,11,0.545,0,1,0.0,2,4,0.5,2,6,8,6,0,0,1,4,14,-4,1,HOU,ORL,HOU,86,,,28,22,20,14
Alperen Sengun,C,22023,1630578,22300534,"JAN 12, 2024",HOU @ DET,W,37,12,19,0.632,0,1,0.0,5,7,0.714,0,6,6,1,1,0,4,3,29,10,1,HOU,DET,HOU,112,,,36,35,30,7
Alperen Sengun,C,22023,1630578,22300485,"JAN 05, 2024",HOU vs. MIN,L,33,8,17,0.471,0,1,0.0,3,3,1.0,1,4,5,1,0,0,2,3,19,-16,1,HOU,HOU,MIN,95,,,25,24,20,6
Alperen Sengun,C,22023,1630578,22300469,"JAN 03, 2024",HOU vs. BKN,W,34,11,17,0.647,0,2,0.0,8,10,0.8,4,4,8,4,3,1,2,1,30,17,1,HOU,HOU,BKN,112,,,42,38,34,12
Alperen Sengun,C,22023,1630578,22300453,"JAN 01, 2024",HOU vs. DET,W,27,9,13,0.692,0,2,0.0,8,9,0.889,1,3,4,9,3,0,2,3,26,20,1,HOU,HOU,DET,136,,,39,30,35,13
Alperen Sengun,C,22023,1630578,22300418,"DEC 27, 2023",HOU vs. PHX,L,29,9,18,0.5,1,4,0.25,5,6,0.833,1,4,5,1,2,0,0,3,24,-11,1,HOU,HOU,PHX,113,,,30,29,25,6
Alperen Sengun,C,22023,1630578,22300434,"DEC 29, 2023",HOU vs. PHI,L,34,12,16,0.75,1,2,0.5,3,4,0.75,3,4,7,8,1,1,5,6,28,12,1,HOU,HOU,PHI,127,,,43,35,36,15
Alperen Sengun,C,22023,1630578,22300523,"JAN 10, 2024",HOU @ CHI,L,41,11,19,0.579,0,3,0.0,3,8,0.375,2,7,9,5,2,0,2,5,25,-8,1,HOU,CHI,HOU,119,,,39,34,30,14
Alperen Sengun,C,22023,1630578,22300509,"JAN 08, 2024",HOU @ MIA,L,33,9,15,0.6,1,2,0.5,3,4,0.75,3,7,10,2,3,0,3,6,22,-10,1,HOU,MIA,HOU,113,,,34,32,24,12
Alperen Sengun,C,22023,1630578,22300496,"JAN 06, 2024",HOU vs. MIL,W,31,7,21,0.333,0,1,0.0,7,10,0.7,1,10,11,4,0,0,3,5,21,0,1,HOU,HOU,MIL,112,,,36,32,25,15
Brandon Ingram,F,22023,1627742,22300758,"FEB 10, 2024",NOP @ POR,W,36,8,21,0.381,0,2,0.0,1,4,0.25,2,2,4,9,1,1,5,3,17,4,1,NOP,POR,NOP,93,,,30,21,26,13
Brandon Ingram,F,22023,1627742,22300747,"FEB 09, 2024",NOP @ LAL,L,35,7,17,0.412,0,2,0.0,8,8,1.0,1,6,7,7,0,3,2,3,22,0,1,NOP,LAL,NOP,122,,,36,29,29,14
Brandon Ingram,F,22023,1627742,22300731,"FEB 07, 2024",NOP @ LAC,W,36,7,14,0.5,0,4,0.0,1,2,0.5,1,7,8,6,1,1,2,0,15,14,1,NOP,LAC,NOP,117,,,29,23,21,14
Brandon Ingram,F,22023,1627742,22300718,"FEB 05, 2024",NOP vs. TOR,W,30,16,21,0.762,8,11,0.727,1,1,1.0,1,5,6,9,0,1,0,1,41,37,1,NOP,NOP,TOR,138,,,56,47,50,15
Brandon Ingram,F,22023,1627742,22300696,"FEB 02, 2024",NOP @ SAS,W,36,7,15,0.467,1,2,0.5,4,4,1.0,2,2,4,6,2,1,2,4,19,-6,1,NOP,SAS,NOP,114,,,29,23,25,10
Brandon Ingram,F,22023,1627742,22300679,"JAN 31, 2024",NOP @ HOU,W,36,9,19,0.474,0,3,0.0,6,7,0.857,4,6,10,4,0,2,6,4,24,4,1,NOP,HOU,NOP,110,,,38,34,28,14
Brandon Ingram,F,22023,1627742,22300648,"JAN 27, 2024",NOP @ MIL,L,28,9,18,0.5,2,2,1.0,6,8,0.75,0,6,6,1,0,0,1,0,26,-22,1,NOP,MIL,NOP,117,,,33,32,27,7
Brandon Ingram,F,22023,1627742,22300640,"JAN 26, 2024",NOP vs. OKC,L,34,5,9,0.556,0,0,0.0,2,5,0.4,0,4,4,9,0,2,5,3,12,-15,1,NOP,NOP,OKC,83,,,25,16,21,13
Brandon Ingram,F,22023,1627742,22300616,"JAN 23, 2024",NOP vs. UTA,W,31,8,18,0.444,0,2,0.0,2,2,1.0,1,4,5,6,0,0,1,1,18,20,1,NOP,NOP,UTA,153,,,29,23,24,11
Brandon Ingram,F,22023,1627742,22300588,"JAN 19, 2024",NOP vs. PHX,L,33,5,11,0.455,1,5,0.2,6,9,0.667,0,7,7,11,0,0,2,2,17,-10,1,NOP,NOP,PHX,109,,,35,24,28,18
Brandon Ingram,F,22023,1627742,22300575,"JAN 17, 2024",NOP vs. CHA,W,34,8,19,0.421,7,11,0.636,5,5,1.0,1,9,10,10,3,0,2,3,28,20,1,NOP,NOP,CHA,132,,,48,38,38,20
Brandon Ingram,F,22023,1627742,22300539,"JAN 12, 2024",NOP @ DEN,L,34,4,11,0.364,0,1,0.0,1,2,0.5,0,4,4,6,0,0,2,2,9,-14,1,NOP,DEN,NOP,113,,,19,13,15,10
Brandon Ingram,F,22023,1627742,22300486,"JAN 05, 2024",NOP vs. LAC,L,30,3,9,0.333,0,1,0.0,6,7,0.857,0,1,1,4,0,0,2,2,12,-12,1,NOP,NOP,LAC,95,,,17,13,16,5
Brandon Ingram,F,22023,1627742,22300471,"JAN 03, 2024",NOP @ MIN,W,32,7,11,0.636,1,3,0.333,4,5,0.8,0,4,4,7,2,0,3,3,19,13,1,NOP,MIN,NOP,117,,,30,23,26,11
Brandon Ingram,F,22023,1627742,22300461,"JAN 02, 2024",NOP vs. BKN,W,25,5,9,0.556,2,2,1.0,0,0,0.0,1,4,5,5,0,1,1,2,12,20,1,NOP,NOP,BKN,112,,,22,17,17,10
Brandon Ingram,F,22023,1627742,22300446,"DEC 31, 2023",NOP vs. LAL,W,38,10,18,0.556,4,7,0.571,2,5,0.4,1,4,5,8,3,2,3,3,26,17,1,NOP,NOP,LAL,129,,,39,31,34,13
Brandon Ingram,F,22023,1627742,22300424,"DEC 28, 2023",NOP vs. UTA,W,36,9,18,0.5,1,2,0.5,7,7,1.0,1,2,3,5,1,2,1,3,26,4,1,NOP,NOP,UTA,112,,,34,29,31,8
Brandon Ingram,F,22023,1627742,22300410,"DEC 26, 2023",NOP vs. MEM,L,42,9,20,0.45,2,4,0.5,4,4,1.0,2,4,6,7,3,4,3,3,24,-7,1,NOP,NOP,MEM,115,,,37,30,31,13
Brandon Ingram,F,22023,1627742,22300392,"DEC 23, 2023",NOP vs. HOU,L,36,6,12,0.5,0,2,0.0,7,9,0.778,1,2,3,5,0,2,0,2,19,2,1,NOP,NOP,HOU,104,,,27,22,24,8
Brandon Ingram,F,22023,1627742,22300375,"DEC 21, 2023",NOP @ CLE,W,28,6,12,0.5,1,3,0.333,4,4,1.0,1,6,7,6,0,0,3,2,17,12,1,NOP,CLE,NOP,123,,,30,24,23,13
Brandon Ingram,F,22023,1627742,22300360,"DEC 19, 2023",NOP vs. MEM,L,37,11,18,0.611,1,1,1.0,11,12,0.917,1,3,4,6,2,0,2,4,34,0,1,NOP,NOP,MEM,113,,,44,38,40,10
Brandon Ingram,F,22023,1627742,22300345,"DEC 17, 2023",NOP @ SAS,W,27,10,17,0.588,5,7,0.714,1,1,1.0,0,3,3,4,1,1,1,1,26,23,1,NOP,SAS,NOP,146,,,33,29,30,7
Brandon Ingram,F,22023,1627742,22300326,"DEC 15, 2023",NOP @ CHA,W,32,3,8,0.375,0,1,0.0,2,2,1.0,0,3,3,7,0,0,9,3,8,5,1,NOP,CHA,NOP,112,,,18,11,15,10
Brandon Ingram,F,22023,1627742,22300311,"DEC 13, 2023",NOP @ WAS,W,31,14,23,0.609,1,4,0.25,11,12,0.917,1,1,2,3,0,1,1,2,40,12,1,NOP,WAS,NOP,142,,,45,42,43,5
Brandon Ingram,F,22023,1627742,22300301,"DEC 11, 2023",NOP vs. MIN,W,29,5,13,0.385,2,5,0.4,8,9,0.889,0,3,3,5,0,0,4,2,20,13,1,NOP,NOP,MIN,121,,,28,23,25,8
Brandon Ingram,F,22023,1627742,22301230,"DEC 07, 2023",NOP @ LAL,L,31,4,13,0.308,0,3,0.0,1,2,0.5,1,2,3,7,0,0,3,3,9,-33,1,NOP,LAL,NOP,89,,,19,12,16,10
Brandon Ingram,F,22023,1627742,22301204,"DEC 04, 2023",NOP @ SAC,W,40,10,20,0.5,3,6,0.5,7,9,0.778,2,6,8,6,1,0,2,2,30,3,1,NOP,SAC,NOP,127,,,44,38,36,14
Brandon Ingram,F,22023,1627742,22300285,"DEC 02, 2023",NOP @ CHI,L,36,10,15,0.667,0,0,0.0,3,6,0.5,0,6,6,6,3,0,2,1,23,1,1,NOP,CHI,NOP,118,,,35,29,29,12
Brandon Ingram,F,22023,1627742,22300262,"NOV 29, 2023",NOP vs. PHI,W,35,4,7,0.571,2,4,0.5,5,5,1.0,0,4,4,6,1,1,1,1,15,10,1,NOP,NOP,PHI,124,,,25,19,21,10
Brandon Ingram,F,22023,1627742,22300256,"NOV 27, 2023",NOP @ UTA,L,35,11,22,0.5,0,2,0.0,3,4,0.75,0,4,4,5,0,0,2,3,25,4,1,NOP,UTA,NOP,112,,,34,29,30,9
Brandon Ingram,F,22023,1627742,22300243,"NOV 25, 2023",NOP @ UTA,L,37,10,22,0.455,1,4,0.25,5,8,0.625,1,5,6,8,1,0,1,4,26,3,1,NOP,UTA,NOP,100,,,40,32,34,14
Brandon Ingram,F,22023,1627742,22300052,"NOV 24, 2023",NOP @ LAC,W,35,12,21,0.571,2,5,0.4,4,6,0.667,0,4,4,5,0,0,3,3,30,13,1,NOP,LAC,NOP,116,,,39,34,35,9
Brandon Ingram,F,22023,1627742,22300233,"NOV 22, 2023",NOP vs. SAC,W,30,9,18,0.5,1,4,0.25,4,4,1.0,0,4,4,3,1,0,2,5,23,0,1,NOP,NOP,SAC,117,,,30,27,26,7
Brandon Ingram,F,22023,1627742,22300222,"NOV 20, 2023",NOP vs. SAC,W,26,11,18,0.611,5,5,1.0,4,4,1.0,0,4,4,3,0,0,1,0,31,33,1,NOP,NOP,SAC,129,,,38,35,34,7
Brandon Ingram,F,22023,1627742,22300659,"JAN 29, 2024",NOP @ BOS,L,36,12,24,0.5,2,8,0.25,2,3,0.667,1,6,7,6,1,1,2,2,28,2,1,NOP,BOS,NOP,112,,,41,35,34,13
Brandon Ingram,F,22023,1627742,22300556,"JAN 15, 2024",NOP @ DAL,L,32,3,14,0.214,0,4,0.0,6,8,0.75,0,5,5,5,1,0,1,3,12,-19,1,NOP,DAL,NOP,120,,,22,17,17,10
Brandon Ingram,F,22023,1627742,22300525,"JAN 10, 2024",NOP @ GSW,W,23,5,12,0.417,1,3,0.333,2,2,1.0,1,4,5,1,1,0,2,4,13,7,1,NOP,GSW,NOP,141,,,19,18,14,6
Brandon Ingram,F,22023,1627742,22300500,"JAN 07, 2024",NOP @ SAC,W,30,6,12,0.5,1,3,0.333,2,2,1.0,0,4,4,8,1,1,1,0,15,34,1,NOP,SAC,NOP,133,,,27,19,23,12
Brandon Ingram,F,22023,1627742,22300278,"DEC 01, 2023",NOP vs. SAS,W,34,3,14,0.214,0,4,0.0,8,8,1.0,0,5,5,7,1,0,4,3,14,10,1,NOP,NOP,SAS,121,,,26,19,21,12
Brandon Ingram,F,22023,1627742,22300203,"NOV 18, 2023",NOP vs. MIN,L,34,11,24,0.458,1,6,0.167,7,9,0.778,2,5,7,4,1,0,4,0,30,3,1,NOP,NOP,MIN,120,,,41,37,34,11
Brandon Ingram,F,22023,1627742,22300034,"NOV 17, 2023",NOP vs. DEN,W,38,9,19,0.474,2,4,0.5,1,1,1.0,1,2,3,8,1,0,2,3,21,-5,1,NOP,NOP,DEN,115,,,32,24,29,11
Brandon Ingram,F,22023,1627742,22300022,"NOV 14, 2023",NOP vs. DAL,W,36,11,20,0.55,1,5,0.2,2,2,1.0,1,8,9,7,2,0,2,0,25,17,1,NOP,NOP,DAL,131,,,41,34,32,16
Brandon Ingram,F,22023,1627742,22300183,"NOV 12, 2023",NOP vs. DAL,L,31,9,17,0.529,1,3,0.333,1,4,0.25,0,5,5,5,0,0,1,2,20,-10,1,NOP,NOP,DAL,124,,,30,25,25,10
Brandon Ingram,F,22023,1627742,22300011,"NOV 10, 2023",NOP @ HOU,L,39,11,24,0.458,3,11,0.273,6,9,0.667,0,6,6,5,0,1,4,2,31,1,1,NOP,HOU,NOP,101,,,42,37,36,11
Brandon Ingram,F,22023,1627742,22300166,"NOV 08, 2023",NOP @ MIN,L,32,11,25,0.44,1,6,0.167,1,1,1.0,0,3,3,6,0,0,2,1,24,-24,1,NOP,MIN,NOP,101,,,33,27,30,9
Brandon Ingram,F,22023,1627742,22300156,"NOV 06, 2023",NOP @ DEN,L,36,10,22,0.455,0,4,0.0,2,2,1.0,1,1,2,5,0,0,5,1,22,-29,1,NOP,DEN,NOP,116,,,29,24,27,7
Brandon Ingram,F,22023,1627742,22300135,"NOV 04, 2023",NOP vs. ATL,L,32,6,10,0.6,1,3,0.333,3,3,1.0,1,6,7,3,0,1,1,1,16,-10,1,NOP,NOP,ATL,105,,,26,23,19,10
Brandon Ingram,F,22023,1627742,22300090,"OCT 28, 2023",NOP vs. NYK,W,32,11,17,0.647,1,3,0.333,3,4,0.75,2,5,7,3,1,0,5,4,26,5,1,NOP,NOP,NYK,96,,,36,33,29,10
Brandon Ingram,F,22023,1627742,22300071,"OCT 25, 2023",NOP @ MEM,W,36,7,18,0.389,0,3,0.0,5,6,0.833,0,7,7,6,2,0,5,3,19,-2,1,NOP,MEM,NOP,111,,,32,26,25,13
Dejounte Murray,G,22023,1627749,22300754,"FEB 10, 2024",ATL vs. HOU,W,40,9,19,0.474,4,9,0.444,12,15,0.8,0,6,6,7,2,1,1,0,34,8,1,ATL,ATL,HOU,122,,,47,40,41,13
Dejounte Murray,G,22023,1627749,22300716,"FEB 05, 2024",ATL vs. LAC,L,34,7,18,0.389,3,7,0.429,4,5,0.8,1,4,5,7,0,0,2,1,21,-7,1,ATL,ATL,LAC,144,,,33,26,28,12
Dejounte Murray,G,22023,1627749,22300690,"FEB 02, 2024",ATL vs. PHX,W,39,7,17,0.412,1,8,0.125,7,8,0.875,0,8,8,5,1,0,1,2,22,10,1,ATL,ATL,PHX,129,,,35,30,27,13
Dejounte Murray,G,22023,1627749,22300669,"JAN 30, 2024",ATL vs. LAL,W,33,11,19,0.579,0,4,0.0,2,2,1.0,0,4,4,9,2,0,3,1,24,19,1,ATL,ATL,LAL,138,,,37,28,33,13
Dejounte Murray,G,22023,1627749,22300634,"JAN 26, 2024",ATL vs. DAL,L,37,9,18,0.5,3,7,0.429,1,2,0.5,1,4,5,7,0,0,3,3,22,-21,1,ATL,ATL,DAL,143,,,34,27,29,12
Dejounte Murray,G,22023,1627749,22300626,"JAN 24, 2024",ATL @ GSW,L,33,7,19,0.368,2,7,0.286,7,8,0.875,3,4,7,7,1,0,2,2,23,-13,1,ATL,GSW,ATL,112,,,37,30,30,14
Dejounte Murray,G,22023,1627749,22300613,"JAN 22, 2024",ATL @ SAC,L,40,11,23,0.478,6,10,0.6,7,8,0.875,0,10,10,6,0,1,4,1,35,-4,1,ATL,SAC,ATL,107,,,51,45,41,16
Dejounte Murray,G,22023,1627749,22300595,"JAN 20, 2024",ATL vs. CLE,L,35,10,19,0.526,2,7,0.286,2,2,1.0,0,9,9,5,1,0,2,2,24,-20,1,ATL,ATL,CLE,95,,,38,33,29,14
Dejounte Murray,G,22023,1627749,22300587,"JAN 19, 2024",ATL @ MIA,W,40,9,22,0.409,3,7,0.429,1,1,1.0,0,3,3,11,2,0,2,2,22,3,1,ATL,MIA,ATL,109,,,36,25,33,14
Dejounte Murray,G,22023,1627749,22300570,"JAN 17, 2024",ATL vs. ORL,W,36,11,18,0.611,1,4,0.25,3,3,1.0,1,4,5,5,2,0,5,1,26,-2,1,ATL,ATL,ORL,106,,,36,31,31,10
Dejounte Murray,G,22023,1627749,22300559,"JAN 15, 2024",ATL vs. SAS,W,33,6,15,0.4,1,6,0.167,0,0,0.0,0,13,13,0,0,1,2,3,13,0,1,ATL,ATL,SAS,109,,,26,26,13,13
Dejounte Murray,G,22023,1627749,22300543,"JAN 13, 2024",ATL vs. WAS,L,31,4,15,0.267,1,6,0.167,4,4,1.0,0,5,5,3,0,0,2,1,13,-22,1,ATL,ATL,WAS,99,,,21,18,16,8
Dejounte Murray,G,22023,1627749,22300533,"JAN 12, 2024",ATL vs. IND,L,32,13,18,0.722,3,6,0.5,0,0,0.0,0,4,4,4,3,0,3,2,29,-1,1,ATL,ATL,IND,108,,,37,33,33,8
Dejounte Murray,G,22023,1627749,22300521,"JAN 10, 2024",ATL vs. PHI,W,38,8,18,0.444,5,7,0.714,4,4,1.0,0,5,5,5,1,0,1,2,25,1,1,ATL,ATL,PHI,139,,,35,30,30,10
Dejounte Murray,G,22023,1627749,22300499,"JAN 07, 2024",ATL @ ORL,L,40,9,20,0.45,0,2,0.0,6,10,0.6,0,6,6,2,0,0,3,2,24,-14,1,ATL,ORL,ATL,110,,,32,30,26,8
Dejounte Murray,G,22023,1627749,22300480,"JAN 05, 2024",ATL @ IND,L,34,13,19,0.684,2,3,0.667,2,2,1.0,0,1,1,2,0,0,1,0,30,-20,1,ATL,IND,ATL,116,,,33,31,32,3
Dejounte Murray,G,22023,1627749,22300467,"JAN 03, 2024",ATL vs. OKC,W,35,8,18,0.444,2,5,0.4,4,4,1.0,2,4,6,6,0,0,3,2,22,4,1,ATL,ATL,OKC,141,,,34,28,28,12
Dejounte Murray,G,22023,1627749,22300445,"DEC 31, 2023",ATL @ WAS,W,34,13,21,0.619,3,6,0.5,3,5,0.6,1,5,6,3,0,0,1,1,32,0,1,ATL,WAS,ATL,130,,,41,38,35,9
Dejounte Murray,G,22023,1627749,22300431,"DEC 29, 2023",ATL vs. SAC,L,37,7,20,0.35,4,8,0.5,0,0,0.0,1,5,6,3,1,0,3,3,18,5,1,ATL,ATL,SAC,110,,,27,24,21,9
Dejounte Murray,G,22023,1627749,22300408,"DEC 26, 2023",ATL @ CHI,L,34,6,15,0.4,2,9,0.222,3,4,0.75,0,6,6,4,2,1,3,4,17,0,1,ATL,CHI,ATL,113,,,27,23,21,10
Dejounte Murray,G,22023,1627749,22300393,"DEC 23, 2023",ATL vs. MEM,L,35,10,15,0.667,4,6,0.667,2,2,1.0,1,3,4,4,2,0,3,4,26,-4,1,ATL,ATL,MEM,119,,,34,30,30,8
Dejounte Murray,G,22023,1627749,22300384,"DEC 22, 2023",ATL @ MIA,L,34,10,20,0.5,3,9,0.333,1,3,0.333,1,7,8,6,3,0,2,0,24,-3,1,ATL,MIA,ATL,113,,,38,32,30,14
Dejounte Murray,G,22023,1627749,22300371,"DEC 20, 2023",ATL @ HOU,W,35,7,15,0.467,3,8,0.375,4,5,0.8,2,1,3,5,0,1,3,2,21,-8,1,ATL,HOU,ATL,134,,,29,24,26,8
Dejounte Murray,G,22023,1627749,22300352,"DEC 18, 2023",ATL vs. DET,W,33,8,13,0.615,3,5,0.6,1,2,0.5,0,3,3,3,1,1,1,2,20,2,1,ATL,ATL,DET,130,,,26,23,23,6
Dejounte Murray,G,22023,1627749,22300336,"DEC 16, 2023",ATL @ CLE,L,37,8,19,0.421,0,5,0.0,5,6,0.833,0,3,3,6,1,1,0,2,21,-3,1,ATL,CLE,ATL,119,,,30,24,27,9
Dejounte Murray,G,22023,1627749,22300330,"DEC 15, 2023",ATL @ TOR,W,33,8,18,0.444,1,6,0.167,0,0,0.0,1,6,7,9,1,0,1,3,17,18,1,ATL,TOR,ATL,125,,,33,24,26,16
Dejounte Murray,G,22023,1627749,22300313,"DEC 13, 2023",ATL @ TOR,L,34,8,17,0.471,4,9,0.444,0,1,0.0,0,3,3,5,0,2,0,2,20,-17,1,ATL,TOR,ATL,128,,,28,23,25,8
Dejounte Murray,G,22023,1627749,22300296,"DEC 11, 2023",ATL vs. DEN,L,38,8,22,0.364,3,8,0.375,2,2,1.0,4,2,6,3,1,0,2,2,21,-6,1,ATL,ATL,DEN,122,,,30,27,24,9
Dejounte Murray,G,22023,1627749,22301218,"DEC 08, 2023",ATL @ PHI,L,36,7,17,0.412,2,5,0.4,4,4,1.0,1,3,4,9,1,0,4,1,20,-7,1,ATL,PHI,ATL,114,,,33,24,29,13
Dejounte Murray,G,22023,1627749,22301209,"DEC 06, 2023",ATL vs. BKN,L,32,6,16,0.375,1,5,0.2,0,0,0.0,0,10,10,9,1,0,0,3,13,2,1,ATL,ATL,BKN,113,,,32,23,22,19
Dejounte Murray,G,22023,1627749,22300286,"DEC 02, 2023",ATL @ MIL,L,34,12,19,0.632,4,6,0.667,2,2,1.0,0,2,2,3,2,0,2,0,30,-7,1,ATL,MIL,ATL,121,,,35,32,33,5
Dejounte Murray,G,22023,1627749,22300272,"NOV 30, 2023",ATL @ SAS,W,35,10,21,0.476,2,4,0.5,2,2,1.0,0,3,3,2,5,0,0,1,24,-1,1,ATL,SAS,ATL,137,,,29,27,26,5
Dejounte Murray,G,22023,1627749,22300055,"NOV 28, 2023",ATL @ CLE,L,31,5,14,0.357,3,7,0.429,0,0,0.0,1,2,3,1,2,1,3,0,13,-21,1,ATL,CLE,ATL,105,,,17,16,14,4
Dejounte Murray,G,22023,1627749,22300246,"NOV 26, 2023",ATL @ BOS,L,34,2,13,0.154,0,6,0.0,2,2,1.0,2,2,4,3,0,0,3,1,6,-7,1,ATL,BOS,ATL,103,,,13,10,9,7
Dejounte Murray,G,22023,1627749,22300241,"NOV 25, 2023",ATL @ WAS,W,27,4,14,0.286,1,6,0.167,2,2,1.0,0,5,5,10,4,0,0,0,11,19,1,ATL,WAS,ATL,136,,,26,16,21,15
Dejounte Murray,G,22023,1627749,22300227,"NOV 22, 2023",ATL vs. BKN,W,39,6,21,0.286,3,8,0.375,5,5,1.0,3,3,6,8,2,0,1,4,20,0,1,ATL,ATL,BKN,147,,,34,26,28,14
Dejounte Murray,G,22023,1627749,22300039,"NOV 21, 2023",ATL vs. IND,L,34,11,19,0.579,4,6,0.667,2,2,1.0,1,2,3,5,2,0,5,3,28,-7,1,ATL,ATL,IND,152,,,36,31,33,8
Dejounte Murray,G,22023,1627749,22300029,"NOV 17, 2023",ATL vs. PHI,L,35,5,16,0.313,3,7,0.429,0,0,0.0,0,1,1,3,1,0,3,2,13,-18,1,ATL,ATL,PHI,116,,,17,14,16,4
Dejounte Murray,G,22023,1627749,22300193,"NOV 15, 2023",ATL vs. NYK,L,32,6,12,0.5,0,3,0.0,1,3,0.333,0,5,5,2,1,0,1,1,13,-16,1,ATL,ATL,NYK,114,,,20,18,15,7
Dejounte Murray,G,22023,1627749,22300018,"NOV 14, 2023",ATL @ DET,W,37,11,21,0.524,1,4,0.25,9,9,1.0,0,5,5,10,3,0,2,2,32,9,1,ATL,DET,ATL,126,,,47,37,42,15
Dejounte Murray,G,22023,1627749,22300175,"NOV 11, 2023",ATL vs. MIA,L,36,9,16,0.563,5,9,0.556,0,1,0.0,0,5,5,5,3,1,3,1,23,-9,1,ATL,ATL,MIA,109,,,33,28,28,10
Dejounte Murray,G,22023,1627749,22300172,"NOV 09, 2023",ATL @ ORL,W,33,6,15,0.4,3,7,0.429,1,2,0.5,0,3,3,2,2,0,4,2,16,5,1,ATL,ORL,ATL,120,,,21,19,18,5
Dejounte Murray,G,22023,1627749,22300155,"NOV 06, 2023",ATL @ OKC,L,33,7,16,0.438,6,9,0.667,9,10,0.9,2,2,4,6,1,0,3,4,29,-3,1,ATL,OKC,ATL,117,,,39,33,35,10
Dejounte Murray,G,22023,1627749,22300135,"NOV 04, 2023",ATL @ NOP,W,37,8,20,0.4,2,9,0.222,2,2,1.0,2,6,8,7,0,0,3,1,20,13,1,ATL,NOP,ATL,123,,,35,28,27,15
Dejounte Murray,G,22023,1627749,22300117,"NOV 01, 2023",ATL vs. WAS,W,34,10,15,0.667,3,5,0.6,1,2,0.5,0,4,4,8,1,1,4,2,24,15,1,ATL,ATL,WAS,130,,,36,28,32,12
Dejounte Murray,G,22023,1627749,22300104,"OCT 30, 2023",ATL vs. MIN,W,39,17,24,0.708,3,5,0.6,4,4,1.0,0,7,7,5,2,0,3,1,41,25,1,ATL,ATL,MIN,127,,,53,48,46,12
Dejounte Murray,G,22023,1627749,22300097,"OCT 29, 2023",ATL @ MIL,W,30,6,12,0.5,1,5,0.2,2,2,1.0,0,1,1,5,2,1,3,0,15,26,1,ATL,MIL,ATL,127,,,21,16,20,6
Dejounte Murray,G,22023,1627749,22300079,"OCT 27, 2023",ATL vs. NYK,L,35,8,17,0.471,0,3,0.0,2,3,0.667,2,5,7,6,1,1,1,1,18,-6,1,ATL,ATL,NYK,120,,,31,25,24,13
Dejounte Murray,G,22023,1627749,22300063,"OCT 25, 2023",ATL @ CHA,L,33,3,14,0.214,0,3,0.0,5,6,0.833,0,2,2,6,0,0,1,0,11,-15,1,ATL,CHA,ATL,110,,,19,13,17,8
Dejounte Murray,G,22023,1627749,22300699,"FEB 03, 2024",ATL vs. GSW,W,41,9,24,0.375,0,6,0.0,1,1,1.0,0,5,5,7,1,0,2,5,19,4,1,ATL,ATL,GSW,141,,,31,24,26,12
Jimmy Butler,F,22023,202710,22300730,"FEB 07, 2024",MIA vs. SAS,W,34,5,12,0.417,1,3,0.333,6,6,1.0,1,10,11,11,3,1,0,0,17,17,1,MIA,MIA,SAS,116,,,39,28,28,22
Jimmy Butler,F,22023,202710,22300721,"FEB 06, 2024",MIA vs. ORL,W,34,6,9,0.667,2,4,0.5,9,12,0.75,0,8,8,8,3,0,5,0,23,11,1,MIA,MIA,ORL,121,,,39,31,31,16
Jimmy Butler,F,22023,202710,22300708,"FEB 04, 2024",MIA vs. LAC,L,36,8,19,0.421,2,5,0.4,3,3,1.0,3,1,4,3,2,0,1,1,21,1,1,MIA,MIA,LAC,95,,,28,25,24,7
Jimmy Butler,F,22023,202710,22300689,"FEB 02, 2024",MIA @ WAS,W,36,7,10,0.7,1,1,1.0,9,13,0.692,4,5,9,3,1,0,2,0,24,8,1,MIA,WAS,MIA,110,,,36,33,27,12
Jimmy Butler,F,22023,202710,22300678,"JAN 31, 2024",MIA vs. SAC,W,35,10,14,0.714,2,3,0.667,9,12,0.75,1,6,7,6,1,0,1,2,31,-1,1,MIA,MIA,SAC,115,,,44,38,37,13
Jimmy Butler,F,22023,202710,22300661,"JAN 29, 2024",MIA vs. PHX,L,37,7,12,0.583,2,2,1.0,10,10,1.0,5,3,8,4,1,0,0,1,26,-17,1,MIA,MIA,PHX,105,,,38,34,30,12
Jimmy Butler,F,22023,202710,22300643,"JAN 27, 2024",MIA @ NYK,L,36,11,20,0.55,1,3,0.333,5,6,0.833,4,4,8,4,3,0,0,2,28,-7,1,MIA,NYK,MIA,109,,,40,36,32,12
Jimmy Butler,F,22023,202710,22300630,"JAN 25, 2024",MIA vs. BOS,L,29,7,11,0.636,2,3,0.667,1,1,1.0,1,2,3,4,2,0,1,1,17,-24,1,MIA,MIA,BOS,110,,,24,20,21,7
Jimmy Butler,F,22023,202710,22300621,"JAN 24, 2024",MIA vs. MEM,L,35,4,10,0.4,1,2,0.5,6,8,0.75,3,1,4,3,2,0,4,1,15,-4,1,MIA,MIA,MEM,96,,,22,19,18,7
Jimmy Butler,F,22023,202710,22300601,"JAN 21, 2024",MIA @ ORL,L,29,5,10,0.5,3,5,0.6,2,2,1.0,0,4,4,2,0,0,0,1,15,-10,1,MIA,ORL,MIA,87,,,21,19,17,6
Jimmy Butler,F,22023,202710,22300587,"JAN 19, 2024",MIA vs. ATL,L,36,8,10,0.8,0,0,0.0,9,10,0.9,4,1,5,6,2,0,4,2,25,0,1,MIA,MIA,ATL,108,,,36,30,31,11
Jimmy Butler,F,22023,202710,22300574,"JAN 17, 2024",MIA @ TOR,L,31,6,11,0.545,0,0,0.0,4,5,0.8,2,3,5,5,2,0,1,0,16,-8,1,MIA,TOR,MIA,97,,,26,21,21,10
Jimmy Butler,F,22023,202710,22300562,"JAN 15, 2024",MIA @ BKN,W,40,8,12,0.667,0,0,0.0,15,16,0.938,2,3,5,4,2,0,1,2,31,6,1,MIA,BKN,MIA,96,,,40,36,35,9
Jimmy Butler,F,22023,202710,22300439,"DEC 30, 2023",MIA @ UTA,L,23,2,3,0.667,0,0,0.0,4,4,1.0,0,2,2,1,0,1,2,2,8,4,1,MIA,UTA,MIA,109,,,11,10,9,3
Jimmy Butler,F,22023,202710,22300353,"DEC 18, 2023",MIA vs. MIN,L,34,5,12,0.417,1,3,0.333,4,6,0.667,2,3,5,5,0,0,1,1,15,5,1,MIA,MIA,MIN,108,,,25,20,20,10
Jimmy Butler,F,22023,202710,22300267,"NOV 30, 2023",MIA vs. IND,W,38,9,19,0.474,0,1,0.0,18,20,0.9,4,7,11,3,0,0,3,1,36,-3,1,MIA,MIA,IND,142,,,50,47,39,14
Jimmy Butler,F,22023,202710,22300045,"NOV 24, 2023",MIA @ NYK,L,37,7,14,0.5,3,5,0.6,6,6,1.0,0,2,2,3,1,0,2,1,23,7,1,MIA,NYK,MIA,98,,,28,25,26,5
Jimmy Butler,F,22023,202710,22300220,"NOV 20, 2023",MIA @ CHI,W,29,4,11,0.364,0,2,0.0,8,9,0.889,0,3,3,6,1,0,1,2,16,17,1,MIA,CHI,MIA,118,,,25,19,22,9
Jimmy Butler,F,22023,202710,22300204,"NOV 18, 2023",MIA @ CHI,L,33,8,16,0.5,2,6,0.333,7,7,1.0,0,3,3,2,1,0,2,2,25,7,1,MIA,CHI,MIA,97,,,30,28,27,5
Jimmy Butler,F,22023,202710,22300200,"NOV 16, 2023",MIA vs. BKN,W,35,12,19,0.632,2,5,0.4,10,11,0.909,2,3,5,3,1,3,4,0,36,9,1,MIA,MIA,BKN,122,,,44,41,39,8
Jimmy Butler,F,22023,202710,22300017,"NOV 14, 2023",MIA @ CHA,W,34,10,14,0.714,1,1,1.0,11,14,0.786,3,1,4,5,2,0,3,1,32,2,1,MIA,CHA,MIA,111,,,41,36,37,9
Jimmy Butler,F,22023,202710,22300184,"NOV 12, 2023",MIA @ SAS,W,37,5,14,0.357,1,3,0.333,8,9,0.889,2,4,6,4,0,1,2,1,19,14,1,MIA,SAS,MIA,118,,,29,25,23,10
Jimmy Butler,F,22023,202710,22300164,"NOV 08, 2023",MIA @ MEM,W,35,5,13,0.385,2,4,0.5,3,3,1.0,1,2,3,2,2,0,1,1,15,12,1,MIA,MEM,MIA,108,,,20,18,17,5
Jimmy Butler,F,22023,202710,22300150,"NOV 06, 2023",MIA vs. LAL,W,37,9,15,0.6,3,4,0.75,7,7,1.0,2,2,4,6,2,0,3,0,28,-1,1,MIA,MIA,LAL,108,,,38,32,34,10
Jimmy Butler,F,22023,202710,22300003,"NOV 03, 2023",MIA vs. WAS,W,31,7,11,0.636,1,2,0.5,5,6,0.833,0,7,7,2,3,0,2,1,20,6,1,MIA,MIA,WAS,121,,,29,27,22,9
Jimmy Butler,F,22023,202710,22300119,"NOV 01, 2023",MIA vs. BKN,L,34,7,16,0.438,0,2,0.0,6,8,0.75,4,3,7,3,1,0,1,1,20,-3,1,MIA,MIA,BKN,105,,,30,27,23,10
Jimmy Butler,F,22023,202710,22300080,"OCT 27, 2023",MIA @ BOS,L,34,3,11,0.273,0,0,0.0,8,9,0.889,2,3,5,3,1,1,1,1,14,0,1,MIA,BOS,MIA,111,,,22,19,17,8
Jimmy Butler,F,22023,202710,22300068,"OCT 25, 2023",MIA vs. DET,W,34,6,18,0.333,0,0,0.0,7,9,0.778,8,5,13,4,2,0,0,0,19,-3,1,MIA,MIA,DET,103,,,36,32,23,17
Jimmy Butler,F,22023,202710,22300337,"DEC 16, 2023",MIA vs. CHI,W,35,9,18,0.5,0,2,0.0,10,11,0.909,1,3,4,2,2,0,2,3,28,12,1,MIA,MIA,CHI,118,,,34,32,30,6
Jimmy Butler,F,22023,202710,22300320,"DEC 14, 2023",MIA vs. CHI,L,36,6,15,0.4,0,1,0.0,8,10,0.8,2,4,6,7,0,0,1,0,20,-10,1,MIA,MIA,CHI,116,,,33,26,27,13
Jimmy Butler,F,22023,202710,22300312,"DEC 13, 2023",MIA vs. CHA,W,29,4,8,0.5,0,0,0.0,7,7,1.0,2,5,7,10,1,0,4,1,15,19,1,MIA,MIA,CHA,115,,,32,22,25,17
Jimmy Butler,F,22023,202710,22300292,"DEC 11, 2023",MIA @ CHA,W,36,7,12,0.583,1,1,1.0,8,9,0.889,2,2,4,8,1,1,3,4,23,13,1,MIA,CHA,MIA,116,,,35,27,31,12
Jimmy Butler,F,22023,202710,22300229,"NOV 22, 2023",MIA @ CLE,W,28,3,12,0.25,1,5,0.2,3,4,0.75,1,3,4,9,2,2,1,0,10,23,1,MIA,CLE,MIA,129,,,23,14,19,13
Jimmy Butler,F,22023,202710,22300107,"OCT 30, 2023",MIA @ MIL,L,29,4,11,0.364,1,2,0.5,4,4,1.0,2,2,4,4,0,1,1,0,13,-13,1,MIA,MIL,MIA,114,,,21,17,17,8
Jimmy Butler,F,22023,202710,22301220,"DEC 08, 2023",MIA vs. CLE,L,36,5,15,0.333,0,2,0.0,6,7,0.857,3,2,5,2,1,0,2,1,16,-5,1,MIA,MIA,CLE,99,,,23,21,18,7
Jimmy Butler,F,22023,202710,22301207,"DEC 06, 2023",MIA @ TOR,W,35,7,16,0.438,1,1,1.0,4,5,0.8,0,2,2,8,1,0,0,2,19,5,1,MIA,TOR,MIA,112,,,29,21,27,10
Jimmy Butler,F,22023,202710,22300284,"DEC 02, 2023",MIA vs. IND,L,37,12,23,0.522,0,1,0.0,9,9,1.0,2,3,5,5,0,0,1,1,33,-17,1,MIA,MIA,IND,129,,,43,38,38,10
Jerami Grant,F,22023,203924,22300758,"FEB 10, 2024",POR vs. NOP,L,41,7,17,0.412,2,5,0.4,8,12,0.667,2,3,5,4,0,0,4,2,24,-7,1,POR,POR,NOP,75,,,33,29,28,9
Jerami Grant,F,22023,203924,22300683,"JAN 31, 2024",POR vs. MIL,W,38,7,14,0.5,0,1,0.0,4,4,1.0,0,3,3,4,2,0,0,3,18,2,1,POR,POR,MIL,119,,,25,21,22,7
Jerami Grant,F,22023,203924,22300668,"JAN 29, 2024",POR vs. PHI,W,31,7,13,0.538,1,2,0.5,12,13,0.923,3,2,5,3,0,1,3,4,27,29,1,POR,POR,PHI,128,,,35,32,30,8
Jerami Grant,F,22023,203924,22300656,"JAN 28, 2024",POR vs. CHI,L,37,5,12,0.417,1,6,0.167,13,16,0.813,0,7,7,2,0,1,2,2,24,-2,1,POR,POR,CHI,96,,,33,31,26,9
Jerami Grant,F,22023,203924,22300641,"JAN 26, 2024",POR @ SAS,L,10,2,6,0.333,0,1,0.0,0,0,0.0,0,1,1,2,0,0,1,1,4,7,1,POR,SAS,POR,98,,,7,5,6,3
Jerami Grant,F,22023,203924,22300623,"JAN 24, 2024",POR @ HOU,W,43,5,12,0.417,2,5,0.4,9,11,0.818,0,5,5,9,0,2,1,0,21,15,1,POR,HOU,POR,137,,,35,26,30,14
Jerami Grant,F,22023,203924,22300617,"JAN 23, 2024",POR @ OKC,L,30,6,10,0.6,4,5,0.8,2,4,0.5,0,5,5,1,1,1,1,0,18,-8,1,POR,OKC,POR,109,,,24,23,19,6
Jerami Grant,F,22023,203924,22300605,"JAN 21, 2024",POR @ LAL,L,33,6,15,0.4,0,3,0.0,5,5,1.0,1,2,3,3,1,1,1,3,17,-14,1,POR,LAL,POR,108,,,23,20,20,6
Jerami Grant,F,22023,203924,22300590,"JAN 19, 2024",POR vs. IND,W,43,14,28,0.5,1,4,0.25,8,11,0.727,1,3,4,3,1,2,1,2,37,2,1,POR,POR,IND,118,,,44,41,40,7
Jerami Grant,F,22023,203924,22300399,"DEC 23, 2023",POR @ GSW,L,32,5,12,0.417,1,4,0.25,6,8,0.75,1,1,2,3,0,0,2,3,17,-20,1,POR,GSW,POR,106,,,22,19,20,5
Jerami Grant,F,22023,203924,22300381,"DEC 21, 2023",POR vs. WAS,L,32,6,14,0.429,4,7,0.571,4,7,0.571,1,1,2,4,1,0,2,4,20,-15,1,POR,POR,WAS,117,,,26,22,24,6
Jerami Grant,F,22023,203924,22300363,"DEC 19, 2023",POR vs. PHX,W,36,8,15,0.533,3,4,0.75,3,3,1.0,0,1,1,4,0,2,2,2,22,-10,1,POR,POR,PHX,109,,,27,23,26,5
Jerami Grant,F,22023,203924,22300348,"DEC 17, 2023",POR vs. GSW,L,41,11,19,0.579,3,9,0.333,5,5,1.0,1,6,7,6,1,0,3,4,30,-13,1,POR,POR,GSW,114,,,43,37,36,13
Jerami Grant,F,22023,203924,22300341,"DEC 16, 2023",POR vs. DAL,L,38,12,20,0.6,1,4,0.25,2,3,0.667,1,4,5,1,0,0,0,2,27,-8,1,POR,POR,DAL,120,,,33,32,28,6
Jerami Grant,F,22023,203924,22300289,"DEC 02, 2023",POR @ UTA,L,26,1,9,0.111,0,5,0.0,7,7,1.0,0,3,3,0,0,1,3,2,9,-12,1,POR,UTA,POR,113,,,12,12,9,3
Jerami Grant,F,22023,203924,22300265,"NOV 30, 2023",POR @ CLE,W,28,4,12,0.333,3,6,0.5,2,2,1.0,0,2,2,3,2,1,3,4,13,6,1,POR,CLE,POR,103,,,18,15,16,5
Jerami Grant,F,22023,203924,22300254,"NOV 27, 2023",POR @ IND,W,38,12,18,0.667,3,3,1.0,7,7,1.0,1,6,7,3,0,3,1,1,34,3,1,POR,IND,POR,114,,,44,41,37,10
Jerami Grant,F,22023,203924,22300245,"NOV 26, 2023",POR @ MIL,L,39,7,18,0.389,3,6,0.5,5,6,0.833,1,1,2,2,4,0,4,3,22,-8,1,POR,MIL,POR,102,,,26,24,24,4
Jerami Grant,F,22023,203924,22300041,"NOV 21, 2023",POR @ PHX,L,36,8,19,0.421,5,8,0.625,5,6,0.833,1,3,4,6,1,1,1,1,26,-7,1,POR,PHX,POR,107,,,36,30,32,10
Jerami Grant,F,22023,203924,22300215,"NOV 19, 2023",POR vs. OKC,L,27,4,12,0.333,1,5,0.2,5,6,0.833,0,0,0,1,1,0,2,1,14,-25,1,POR,POR,OKC,89,,,15,14,15,1
Jerami Grant,F,22023,203924,22300036,"NOV 17, 2023",POR vs. LAL,L,40,8,20,0.4,4,9,0.444,4,4,1.0,0,4,4,3,1,0,1,0,24,-14,1,POR,POR,LAL,95,,,31,28,27,7
Jerami Grant,F,22023,203924,22300199,"NOV 15, 2023",POR vs. CLE,L,32,7,17,0.412,1,6,0.167,2,2,1.0,0,3,3,2,2,0,3,2,17,4,1,POR,POR,CLE,93,,,22,20,19,5
Jerami Grant,F,22023,203924,22300023,"NOV 14, 2023",POR @ UTA,L,27,10,17,0.588,3,6,0.5,3,4,0.75,0,2,2,1,0,1,2,3,26,-11,1,POR,UTA,POR,99,,,29,28,27,3
Jerami Grant,F,22023,203924,22300187,"NOV 12, 2023",POR @ LAL,L,41,8,17,0.471,3,6,0.5,4,5,0.8,0,5,5,1,0,1,2,3,23,-15,1,POR,LAL,POR,104,,,29,28,24,6
Jerami Grant,F,22023,203924,22300170,"NOV 08, 2023",POR @ SAC,L,46,12,25,0.48,5,8,0.625,9,12,0.75,1,8,9,5,0,3,4,2,38,7,1,POR,SAC,POR,118,,,52,47,43,14
Jerami Grant,F,22023,203924,22300144,"NOV 05, 2023",POR vs. MEM,L,38,10,22,0.455,4,13,0.308,3,4,0.75,2,1,3,3,0,0,2,3,27,-22,1,POR,POR,MEM,100,,,33,30,30,6
Jerami Grant,F,22023,203924,22300007,"NOV 03, 2023",POR vs. MEM,W,44,9,23,0.391,3,7,0.429,5,9,0.556,2,6,8,3,0,1,3,0,26,9,1,POR,POR,MEM,115,,,37,34,29,11
Jerami Grant,F,22023,203924,22300115,"NOV 01, 2023",POR @ DET,W,38,7,16,0.438,2,4,0.5,8,10,0.8,0,1,1,0,1,0,4,4,24,15,1,POR,DET,POR,110,,,25,25,24,1
Jerami Grant,F,22023,203924,22300105,"OCT 30, 2023",POR @ TOR,W,37,8,18,0.444,2,8,0.25,4,4,1.0,1,5,6,0,1,1,2,2,22,8,1,POR,TOR,POR,99,,,28,28,22,6
Jerami Grant,F,22023,203924,22300098,"OCT 29, 2023",POR @ PHI,L,28,5,16,0.313,1,4,0.25,6,7,0.857,2,3,5,1,0,2,2,2,17,-29,1,POR,PHI,POR,98,,,23,22,18,6
Jerami Grant,F,22023,203924,22300086,"OCT 27, 2023",POR vs. ORL,L,36,4,14,0.286,1,5,0.2,6,7,0.857,0,4,4,3,2,0,3,5,15,2,1,POR,POR,ORL,97,,,22,19,18,7
Jerami Grant,F,22023,203924,22300074,"OCT 25, 2023",POR @ LAC,L,30,5,12,0.417,0,4,0.0,3,4,0.75,2,1,3,1,0,1,3,1,13,-22,1,POR,LAC,POR,111,,,17,16,14,4
Jerami Grant,F,22023,203924,22300578,"JAN 17, 2024",POR vs. BKN,W,36,14,26,0.538,2,4,0.5,0,0,0.0,4,4,8,1,0,0,2,1,30,12,1,POR,POR,BKN,103,,,39,38,31,9
Jerami Grant,F,22023,203924,22300538,"JAN 12, 2024",POR @ MIN,L,31,4,15,0.267,2,7,0.286,3,3,1.0,0,0,0,1,2,0,0,3,13,-36,1,POR,MIN,POR,91,,,14,13,14,1
Jerami Grant,F,22023,203924,22300514,"JAN 09, 2024",POR @ NYK,L,28,8,16,0.5,1,4,0.25,4,6,0.667,0,2,2,0,0,0,1,2,21,-31,1,POR,NYK,POR,80,,,23,23,21,2
Jerami Grant,F,22023,203924,22300498,"JAN 07, 2024",POR @ BKN,W,42,11,24,0.458,3,7,0.429,2,2,1.0,0,2,2,1,1,1,0,2,27,0,1,POR,BKN,POR,134,,,30,29,28,3
Jerami Grant,F,22023,203924,22300487,"JAN 05, 2024",POR @ DAL,L,23,6,11,0.545,2,3,0.667,4,5,0.8,0,1,1,3,3,1,1,1,18,-24,1,POR,DAL,POR,103,,,22,19,21,4
Jerami Grant,F,22023,203924,22300472,"JAN 03, 2024",POR @ DAL,L,20,4,9,0.444,1,3,0.333,1,3,0.333,0,1,1,2,0,0,3,3,10,-13,1,POR,DAL,POR,97,,,13,11,12,3
Jerami Grant,F,22023,203924,22300456,"JAN 01, 2024",POR @ PHX,L,25,6,12,0.5,1,3,0.333,2,3,0.667,0,1,1,3,1,1,3,1,15,-13,1,POR,PHX,POR,84,,,19,16,18,4
Jerami Grant,F,22023,203924,22300437,"DEC 29, 2023",POR vs. SAS,W,39,9,17,0.529,4,5,0.8,5,6,0.833,0,6,6,4,0,0,4,2,27,6,1,POR,POR,SAS,132,,,37,33,31,10
Jerami Grant,F,22023,203924,22300427,"DEC 28, 2023",POR vs. SAS,L,41,9,21,0.429,1,5,0.2,10,13,0.769,3,7,10,5,0,0,4,4,29,-7,1,POR,POR,SAS,98,,,44,39,34,15
Jerami Grant,F,22023,203924,22300413,"DEC 26, 2023",POR vs. SAC,W,28,5,10,0.5,1,3,0.333,2,3,0.667,0,2,2,2,0,1,0,1,13,-3,1,POR,POR,SAC,130,,,17,15,15,4
Jerami Grant,F,22023,203924,22300237,"NOV 22, 2023",POR vs. UTA,W,32,10,13,0.769,5,6,0.833,5,6,0.833,0,2,2,4,1,1,2,3,30,25,1,POR,POR,UTA,121,,,36,32,34,6
Jerami Grant,F,22023,203924,22300741,"FEB 08, 2024",POR vs. DET,L,45,14,29,0.483,3,6,0.5,18,20,0.9,2,6,8,6,0,0,4,5,49,-5,1,POR,POR,DET,118,,,63,57,55,14
Jerami Grant,F,22023,203924,22300529,"JAN 11, 2024",POR @ OKC,L,25,4,10,0.4,1,3,0.333,0,0,0.0,0,2,2,2,1,1,0,2,9,-40,1,POR,OKC,POR,77,,,13,11,11,4
Jamal Murray,G,22023,1627750,22300746,"FEB 09, 2024",DEN @ SAC,L,26,4,10,0.4,2,5,0.4,2,3,0.667,0,1,1,3,1,0,6,1,12,-21,1,DEN,SAC,DEN,106,,,16,13,15,4
Jamal Murray,G,22023,1627750,22300740,"FEB 08, 2024",DEN @ LAL,W,36,12,25,0.48,5,9,0.556,0,0,0.0,0,7,7,11,2,0,3,2,29,17,1,DEN,LAL,DEN,114,,,47,36,40,18
Jamal Murray,G,22023,1627750,22300712,"FEB 04, 2024",DEN vs. POR,W,34,8,16,0.5,4,6,0.667,1,2,0.5,2,3,5,10,1,2,1,2,21,16,1,DEN,DEN,POR,112,,,36,26,31,15
Jamal Murray,G,22023,1627750,22300697,"FEB 02, 2024",DEN vs. POR,W,33,5,21,0.238,3,15,0.2,0,0,0.0,4,5,9,10,0,2,2,1,13,9,1,DEN,DEN,POR,120,,,32,22,23,19
Jamal Murray,G,22023,1627750,22300682,"JAN 31, 2024",DEN @ OKC,L,39,6,14,0.429,2,3,0.667,2,2,1.0,1,2,3,4,0,2,0,3,16,1,1,DEN,OKC,DEN,100,,,23,19,20,7
Jamal Murray,G,22023,1627750,22300667,"JAN 29, 2024",DEN vs. MIL,W,36,13,22,0.591,0,2,0.0,9,10,0.9,1,1,2,5,2,0,2,1,35,-3,1,DEN,DEN,MIL,113,,,42,37,40,7
Jamal Murray,G,22023,1627750,22300644,"JAN 27, 2024",DEN vs. PHI,W,37,8,15,0.533,6,10,0.6,1,4,0.25,0,3,3,7,1,1,2,1,23,13,1,DEN,DEN,PHI,111,,,33,26,30,10
Jamal Murray,G,22023,1627750,22300631,"JAN 25, 2024",DEN @ NYK,L,30,3,11,0.273,1,3,0.333,2,3,0.667,0,2,2,7,0,0,3,1,9,-29,1,DEN,NYK,DEN,84,,,18,11,16,9
Jamal Murray,G,22023,1627750,22300614,"JAN 23, 2024",DEN @ IND,W,37,11,24,0.458,3,9,0.333,6,6,1.0,2,6,8,7,0,0,3,1,31,17,1,DEN,IND,DEN,114,,,46,39,38,15
Jamal Murray,G,22023,1627750,22300602,"JAN 21, 2024",DEN @ WAS,W,39,7,23,0.304,3,8,0.375,2,2,1.0,1,4,5,7,0,0,1,2,19,4,1,DEN,WAS,DEN,113,,,31,24,26,12
Jamal Murray,G,22023,1627750,22300586,"JAN 19, 2024",DEN @ BOS,W,37,15,21,0.714,3,7,0.429,2,3,0.667,0,8,8,5,0,0,1,3,35,-7,1,DEN,BOS,DEN,102,,,48,43,40,13
Jamal Murray,G,22023,1627750,22300566,"JAN 16, 2024",DEN @ PHI,L,38,7,16,0.438,1,3,0.333,2,2,1.0,1,2,3,10,0,1,2,0,17,-5,1,DEN,PHI,DEN,121,,,30,20,27,13
Jamal Murray,G,22023,1627750,22300550,"JAN 14, 2024",DEN vs. IND,W,36,11,18,0.611,1,4,0.25,2,4,0.5,0,1,1,8,1,0,5,3,25,-5,1,DEN,DEN,IND,117,,,34,26,33,9
Jamal Murray,G,22023,1627750,22300539,"JAN 12, 2024",DEN vs. NOP,W,34,8,15,0.533,3,5,0.6,1,1,1.0,0,2,2,9,0,0,2,3,20,18,1,DEN,DEN,NOP,125,,,31,22,29,11
Jamal Murray,G,22023,1627750,22300524,"JAN 10, 2024",DEN @ UTA,L,31,6,15,0.4,1,5,0.2,4,4,1.0,0,1,1,6,1,2,4,3,17,-27,1,DEN,UTA,DEN,111,,,24,18,23,7
Jamal Murray,G,22023,1627750,22300502,"JAN 07, 2024",DEN vs. DET,W,30,14,24,0.583,3,8,0.375,6,7,0.857,2,3,5,4,1,1,1,4,37,11,1,DEN,DEN,DET,131,,,46,42,41,9
Jamal Murray,G,22023,1627750,22300488,"JAN 05, 2024",DEN vs. ORL,L,33,9,23,0.391,0,6,0.0,2,2,1.0,1,6,7,9,1,0,3,3,20,-5,1,DEN,DEN,ORL,120,,,36,27,29,16
Jamal Murray,G,22023,1627750,22300478,"JAN 04, 2024",DEN @ GSW,W,32,8,16,0.5,1,6,0.167,8,9,0.889,0,2,2,6,2,0,0,4,25,9,1,DEN,GSW,DEN,130,,,33,27,31,8
Jamal Murray,G,22023,1627750,22300455,"JAN 01, 2024",DEN vs. CHA,W,27,7,16,0.438,5,9,0.556,6,7,0.857,0,3,3,7,2,1,2,1,25,26,1,DEN,DEN,CHA,111,,,35,28,32,10
Jamal Murray,G,22023,1627750,22300435,"DEC 29, 2023",DEN vs. OKC,L,36,4,15,0.267,1,6,0.167,0,1,0.0,0,3,3,11,1,1,2,1,9,-20,1,DEN,DEN,OKC,93,,,23,12,20,14
Jamal Murray,G,22023,1627750,22300425,"DEC 28, 2023",DEN vs. MEM,W,26,9,12,0.75,4,6,0.667,1,1,1.0,2,1,3,9,2,0,1,0,23,19,1,DEN,DEN,MEM,142,,,35,26,32,12
Jamal Murray,G,22023,1627750,22300402,"DEC 25, 2023",DEN vs. GSW,W,33,10,18,0.556,3,5,0.6,5,5,1.0,1,4,5,3,2,0,2,4,28,20,1,DEN,DEN,GSW,120,,,36,33,31,8
Jamal Murray,G,22023,1627750,22300390,"DEC 23, 2023",DEN @ CHA,W,33,8,19,0.421,2,6,0.333,2,2,1.0,2,10,12,5,3,0,1,1,20,7,1,DEN,CHA,DEN,102,,,37,32,25,17
Jamal Murray,G,22023,1627750,22300383,"DEC 22, 2023",DEN @ BKN,W,34,11,19,0.579,4,6,0.667,6,8,0.75,1,4,5,9,0,2,1,0,32,18,1,DEN,BKN,DEN,122,,,46,37,41,14
Jamal Murray,G,22023,1627750,22300369,"DEC 20, 2023",DEN @ TOR,W,32,9,22,0.409,2,7,0.286,0,0,0.0,1,4,5,6,1,2,2,2,20,12,1,DEN,TOR,DEN,113,,,31,25,26,11
Jamal Murray,G,22023,1627750,22300356,"DEC 18, 2023",DEN vs. DAL,W,25,8,14,0.571,4,4,1.0,2,2,1.0,0,4,4,2,1,1,2,1,22,18,1,DEN,DEN,DAL,130,,,28,26,24,6
Jamal Murray,G,22023,1627750,22300340,"DEC 16, 2023",DEN vs. OKC,L,28,5,13,0.385,0,6,0.0,5,5,1.0,1,1,2,5,0,0,1,4,15,-3,1,DEN,DEN,OKC,117,,,22,17,20,7
Jamal Murray,G,22023,1627750,22300322,"DEC 14, 2023",DEN vs. BKN,W,22,7,15,0.467,2,4,0.5,0,0,0.0,0,1,1,2,3,1,0,2,16,9,1,DEN,DEN,BKN,124,,,19,17,18,3
Jamal Murray,G,22023,1627750,22300296,"DEC 11, 2023",DEN @ ATL,W,29,12,15,0.8,4,5,0.8,1,1,1.0,1,8,9,4,1,2,6,1,29,14,1,DEN,ATL,DEN,129,,,42,38,33,13
Jamal Murray,G,22023,1627750,22301224,"DEC 08, 2023",DEN vs. HOU,L,32,6,17,0.353,4,8,0.5,5,5,1.0,0,5,5,3,0,0,1,2,21,4,1,DEN,DEN,HOU,106,,,29,26,24,8
Jamal Murray,G,22023,1627750,22301215,"DEC 06, 2023",DEN @ LAC,L,29,10,18,0.556,2,7,0.286,1,1,1.0,0,0,0,6,1,1,1,4,23,2,1,DEN,LAC,DEN,102,,,29,23,29,6
Jamal Murray,G,22023,1627750,22300263,"NOV 29, 2023",DEN vs. HOU,W,22,4,14,0.286,3,8,0.375,5,5,1.0,0,6,6,6,0,0,0,2,16,14,1,DEN,DEN,HOU,134,,,28,22,22,12
Jamal Murray,G,22023,1627750,22300139,"NOV 04, 2023",DEN vs. CHI,W,10,1,3,0.333,0,0,0.0,0,0,0.0,0,2,2,0,0,0,0,0,2,-2,1,DEN,DEN,CHI,123,,,4,4,2,2
Jamal Murray,G,22023,1627750,22300006,"NOV 03, 2023",DEN vs. DAL,W,39,5,15,0.333,2,6,0.333,6,6,1.0,0,2,2,13,1,0,2,4,18,2,1,DEN,DEN,DAL,125,,,33,20,31,15
Jamal Murray,G,22023,1627750,22300123,"NOV 01, 2023",DEN @ MIN,L,32,5,16,0.313,1,4,0.25,3,5,0.6,2,4,6,6,1,1,3,3,14,-17,1,DEN,MIN,DEN,89,,,26,20,20,12
Jamal Murray,G,22023,1627750,22300110,"OCT 30, 2023",DEN vs. UTA,W,37,7,19,0.368,3,7,0.429,1,2,0.5,0,3,3,14,0,2,3,0,18,-5,1,DEN,DEN,UTA,110,,,35,21,32,17
Jamal Murray,G,22023,1627750,22300095,"OCT 29, 2023",DEN @ OKC,W,30,9,14,0.643,1,1,1.0,0,0,0.0,1,1,2,8,0,0,4,1,19,22,1,DEN,OKC,DEN,128,,,29,21,27,10
Jamal Murray,G,22023,1627750,22300078,"OCT 27, 2023",DEN @ MEM,W,34,7,17,0.412,4,9,0.444,4,4,1.0,0,1,1,5,0,1,3,2,22,8,1,DEN,MEM,DEN,108,,,28,23,27,6
Jamal Murray,G,22023,1627750,22300061,"OCT 24, 2023",DEN vs. LAL,W,34,8,13,0.615,3,5,0.6,2,2,1.0,0,2,2,6,0,1,1,3,21,3,1,DEN,DEN,LAL,119,,,29,23,27,8
Tyler Herro,G,22023,1629639,22300730,"FEB 07, 2024",MIA vs. SAS,W,29,10,15,0.667,4,7,0.571,0,0,0.0,1,5,6,7,0,0,1,1,24,16,1,MIA,MIA,SAS,116,19.5,Points,37,30,31,13
Tyler Herro,G,22023,1629639,22300730,"FEB 07, 2024",MIA vs. SAS,W,29,10,15,0.667,4,7,0.571,0,0,0.0,1,5,6,7,0,0,1,1,24,16,1,MIA,MIA,SAS,116,5.0,Rebounds,37,30,31,13
Tyler Herro,G,22023,1629639,22300730,"FEB 07, 2024",MIA vs. SAS,W,29,10,15,0.667,4,7,0.571,0,0,0.0,1,5,6,7,0,0,1,1,24,16,1,MIA,MIA,SAS,116,29.5,Pts+Rebs+Asts,37,30,31,13
Tyler Herro,G,22023,1629639,22300730,"FEB 07, 2024",MIA vs. SAS,W,29,10,15,0.667,4,7,0.571,0,0,0.0,1,5,6,7,0,0,1,1,24,16,1,MIA,MIA,SAS,116,4.5,Assists,37,30,31,13
Tyler Herro,G,22023,1629639,22300730,"FEB 07, 2024",MIA vs. SAS,W,29,10,15,0.667,4,7,0.571,0,0,0.0,1,5,6,7,0,0,1,1,24,16,1,MIA,MIA,SAS,116,32.0,Fantasy Score,37,30,31,13
Tyler Herro,G,22023,1629639,22300730,"FEB 07, 2024",MIA vs. SAS,W,29,10,15,0.667,4,7,0.571,0,0,0.0,1,5,6,7,0,0,1,1,24,16,1,MIA,MIA,SAS,116,24.5,Pts+Rebs,37,30,31,13
Tyler Herro,G,22023,1629639,22300730,"FEB 07, 2024",MIA vs. SAS,W,29,10,15,0.667,4,7,0.571,0,0,0.0,1,5,6,7,0,0,1,1,24,16,1,MIA,MIA,SAS,116,24.5,Pts+Asts,37,30,31,13
Tyler Herro,G,22023,1629639,22300730,"FEB 07, 2024",MIA vs. SAS,W,29,10,15,0.667,4,7,0.571,0,0,0.0,1,5,6,7,0,0,1,1,24,16,1,MIA,MIA,SAS,116,0.5,Steals,37,30,31,13
Tyler Herro,G,22023,1629639,22300730,"FEB 07, 2024",MIA vs. SAS,W,29,10,15,0.667,4,7,0.571,0,0,0.0,1,5,6,7,0,0,1,1,24,16,1,MIA,MIA,SAS,116,9.5,Rebs+Asts,37,30,31,13
Tyler Herro,G,22023,1629639,22300721,"FEB 06, 2024",MIA vs. ORL,W,26,6,13,0.462,2,5,0.4,0,0,0.0,0,3,3,4,0,0,1,0,14,22,1,MIA,MIA,ORL,121,19.5,Points,21,17,18,7
Tyler Herro,G,22023,1629639,22300721,"FEB 06, 2024",MIA vs. ORL,W,26,6,13,0.462,2,5,0.4,0,0,0.0,0,3,3,4,0,0,1,0,14,22,1,MIA,MIA,ORL,121,5.0,Rebounds,21,17,18,7
Tyler Herro,G,22023,1629639,22300721,"FEB 06, 2024",MIA vs. ORL,W,26,6,13,0.462,2,5,0.4,0,0,0.0,0,3,3,4,0,0,1,0,14,22,1,MIA,MIA,ORL,121,29.5,Pts+Rebs+Asts,21,17,18,7
Tyler Herro,G,22023,1629639,22300721,"FEB 06, 2024",MIA vs. ORL,W,26,6,13,0.462,2,5,0.4,0,0,0.0,0,3,3,4,0,0,1,0,14,22,1,MIA,MIA,ORL,121,4.5,Assists,21,17,18,7
Tyler Herro,G,22023,1629639,22300721,"FEB 06, 2024",MIA vs. ORL,W,26,6,13,0.462,2,5,0.4,0,0,0.0,0,3,3,4,0,0,1,0,14,22,1,MIA,MIA,ORL,121,32.0,Fantasy Score,21,17,18,7
Tyler Herro,G,22023,1629639,22300721,"FEB 06, 2024",MIA vs. ORL,W,26,6,13,0.462,2,5,0.4,0,0,0.0,0,3,3,4,0,0,1,0,14,22,1,MIA,MIA,ORL,121,24.5,Pts+Rebs,21,17,18,7
Tyler Herro,G,22023,1629639,22300721,"FEB 06, 2024",MIA vs. ORL,W,26,6,13,0.462,2,5,0.4,0,0,0.0,0,3,3,4,0,0,1,0,14,22,1,MIA,MIA,ORL,121,24.5,Pts+Asts,21,17,18,7
Tyler Herro,G,22023,1629639,22300721,"FEB 06, 2024",MIA vs. ORL,W,26,6,13,0.462,2,5,0.4,0,0,0.0,0,3,3,4,0,0,1,0,14,22,1,MIA,MIA,ORL,121,0.5,Steals,21,17,18,7
Tyler Herro,G,22023,1629639,22300721,"FEB 06, 2024",MIA vs. ORL,W,26,6,13,0.462,2,5,0.4,0,0,0.0,0,3,3,4,0,0,1,0,14,22,1,MIA,MIA,ORL,121,9.5,Rebs+Asts,21,17,18,7
Tyler Herro,G,22023,1629639,22300689,"FEB 02, 2024",MIA @ WAS,W,32,6,19,0.316,3,8,0.375,0,0,0.0,0,4,4,5,0,0,2,2,15,-3,1,MIA,WAS,MIA,110,19.5,Points,24,19,20,9
Tyler Herro,G,22023,1629639,22300689,"FEB 02, 2024",MIA @ WAS,W,32,6,19,0.316,3,8,0.375,0,0,0.0,0,4,4,5,0,0,2,2,15,-3,1,MIA,WAS,MIA,110,5.0,Rebounds,24,19,20,9
Tyler Herro,G,22023,1629639,22300689,"FEB 02, 2024",MIA @ WAS,W,32,6,19,0.316,3,8,0.375,0,0,0.0,0,4,4,5,0,0,2,2,15,-3,1,MIA,WAS,MIA,110,29.5,Pts+Rebs+Asts,24,19,20,9
Tyler Herro,G,22023,1629639,22300689,"FEB 02, 2024",MIA @ WAS,W,32,6,19,0.316,3,8,0.375,0,0,0.0,0,4,4,5,0,0,2,2,15,-3,1,MIA,WAS,MIA,110,4.5,Assists,24,19,20,9
Tyler Herro,G,22023,1629639,22300689,"FEB 02, 2024",MIA @ WAS,W,32,6,19,0.316,3,8,0.375,0,0,0.0,0,4,4,5,0,0,2,2,15,-3,1,MIA,WAS,MIA,110,32.0,Fantasy Score,24,19,20,9
Tyler Herro,G,22023,1629639,22300689,"FEB 02, 2024",MIA @ WAS,W,32,6,19,0.316,3,8,0.375,0,0,0.0,0,4,4,5,0,0,2,2,15,-3,1,MIA,WAS,MIA,110,24.5,Pts+Rebs,24,19,20,9
Tyler Herro,G,22023,1629639,22300689,"FEB 02, 2024",MIA @ WAS,W,32,6,19,0.316,3,8,0.375,0,0,0.0,0,4,4,5,0,0,2,2,15,-3,1,MIA,WAS,MIA,110,24.5,Pts+Asts,24,19,20,9
Tyler Herro,G,22023,1629639,22300689,"FEB 02, 2024",MIA @ WAS,W,32,6,19,0.316,3,8,0.375,0,0,0.0,0,4,4,5,0,0,2,2,15,-3,1,MIA,WAS,MIA,110,0.5,Steals,24,19,20,9
Tyler Herro,G,22023,1629639,22300689,"FEB 02, 2024",MIA @ WAS,W,32,6,19,0.316,3,8,0.375,0,0,0.0,0,4,4,5,0,0,2,2,15,-3,1,MIA,WAS,MIA,110,9.5,Rebs+Asts,24,19,20,9
Tyler Herro,G,22023,1629639,22300678,"JAN 31, 2024",MIA vs. SAC,W,31,4,9,0.444,2,4,0.5,4,6,0.667,1,7,8,8,0,0,2,1,14,-1,1,MIA,MIA,SAC,115,19.5,Points,30,22,22,16
Tyler Herro,G,22023,1629639,22300678,"JAN 31, 2024",MIA vs. SAC,W,31,4,9,0.444,2,4,0.5,4,6,0.667,1,7,8,8,0,0,2,1,14,-1,1,MIA,MIA,SAC,115,5.0,Rebounds,30,22,22,16
Tyler Herro,G,22023,1629639,22300678,"JAN 31, 2024",MIA vs. SAC,W,31,4,9,0.444,2,4,0.5,4,6,0.667,1,7,8,8,0,0,2,1,14,-1,1,MIA,MIA,SAC,115,29.5,Pts+Rebs+Asts,30,22,22,16
Tyler Herro,G,22023,1629639,22300678,"JAN 31, 2024",MIA vs. SAC,W,31,4,9,0.444,2,4,0.5,4,6,0.667,1,7,8,8,0,0,2,1,14,-1,1,MIA,MIA,SAC,115,4.5,Assists,30,22,22,16
Tyler Herro,G,22023,1629639,22300678,"JAN 31, 2024",MIA vs. SAC,W,31,4,9,0.444,2,4,0.5,4,6,0.667,1,7,8,8,0,0,2,1,14,-1,1,MIA,MIA,SAC,115,32.0,Fantasy Score,30,22,22,16
Tyler Herro,G,22023,1629639,22300678,"JAN 31, 2024",MIA vs. SAC,W,31,4,9,0.444,2,4,0.5,4,6,0.667,1,7,8,8,0,0,2,1,14,-1,1,MIA,MIA,SAC,115,24.5,Pts+Rebs,30,22,22,16
Tyler Herro,G,22023,1629639,22300678,"JAN 31, 2024",MIA vs. SAC,W,31,4,9,0.444,2,4,0.5,4,6,0.667,1,7,8,8,0,0,2,1,14,-1,1,MIA,MIA,SAC,115,24.5,Pts+Asts,30,22,22,16
Tyler Herro,G,22023,1629639,22300678,"JAN 31, 2024",MIA vs. SAC,W,31,4,9,0.444,2,4,0.5,4,6,0.667,1,7,8,8,0,0,2,1,14,-1,1,MIA,MIA,SAC,115,0.5,Steals,30,22,22,16
Tyler Herro,G,22023,1629639,22300678,"JAN 31, 2024",MIA vs. SAC,W,31,4,9,0.444,2,4,0.5,4,6,0.667,1,7,8,8,0,0,2,1,14,-1,1,MIA,MIA,SAC,115,9.5,Rebs+Asts,30,22,22,16
Tyler Herro,G,22023,1629639,22300661,"JAN 29, 2024",MIA vs. PHX,L,34,5,18,0.278,5,12,0.417,2,2,1.0,0,6,6,4,0,0,0,1,17,6,1,MIA,MIA,PHX,105,19.5,Points,27,23,21,10
Tyler Herro,G,22023,1629639,22300661,"JAN 29, 2024",MIA vs. PHX,L,34,5,18,0.278,5,12,0.417,2,2,1.0,0,6,6,4,0,0,0,1,17,6,1,MIA,MIA,PHX,105,5.0,Rebounds,27,23,21,10
Tyler Herro,G,22023,1629639,22300661,"JAN 29, 2024",MIA vs. PHX,L,34,5,18,0.278,5,12,0.417,2,2,1.0,0,6,6,4,0,0,0,1,17,6,1,MIA,MIA,PHX,105,29.5,Pts+Rebs+Asts,27,23,21,10
Tyler Herro,G,22023,1629639,22300661,"JAN 29, 2024",MIA vs. PHX,L,34,5,18,0.278,5,12,0.417,2,2,1.0,0,6,6,4,0,0,0,1,17,6,1,MIA,MIA,PHX,105,4.5,Assists,27,23,21,10
Tyler Herro,G,22023,1629639,22300661,"JAN 29, 2024",MIA vs. PHX,L,34,5,18,0.278,5,12,0.417,2,2,1.0,0,6,6,4,0,0,0,1,17,6,1,MIA,MIA,PHX,105,32.0,Fantasy Score,27,23,21,10
Tyler Herro,G,22023,1629639,22300661,"JAN 29, 2024",MIA vs. PHX,L,34,5,18,0.278,5,12,0.417,2,2,1.0,0,6,6,4,0,0,0,1,17,6,1,MIA,MIA,PHX,105,24.5,Pts+Rebs,27,23,21,10
Tyler Herro,G,22023,1629639,22300661,"JAN 29, 2024",MIA vs. PHX,L,34,5,18,0.278,5,12,0.417,2,2,1.0,0,6,6,4,0,0,0,1,17,6,1,MIA,MIA,PHX,105,24.5,Pts+Asts,27,23,21,10
Tyler Herro,G,22023,1629639,22300661,"JAN 29, 2024",MIA vs. PHX,L,34,5,18,0.278,5,12,0.417,2,2,1.0,0,6,6,4,0,0,0,1,17,6,1,MIA,MIA,PHX,105,0.5,Steals,27,23,21,10
Tyler Herro,G,22023,1629639,22300661,"JAN 29, 2024",MIA vs. PHX,L,34,5,18,0.278,5,12,0.417,2,2,1.0,0,6,6,4,0,0,0,1,17,6,1,MIA,MIA,PHX,105,9.5,Rebs+Asts,27,23,21,10
Tyler Herro,G,22023,1629639,22300643,"JAN 27, 2024",MIA @ NYK,L,35,7,18,0.389,4,11,0.364,0,0,0.0,0,1,1,3,0,0,1,2,18,-17,1,MIA,NYK,MIA,109,19.5,Points,22,19,21,4
Tyler Herro,G,22023,1629639,22300643,"JAN 27, 2024",MIA @ NYK,L,35,7,18,0.389,4,11,0.364,0,0,0.0,0,1,1,3,0,0,1,2,18,-17,1,MIA,NYK,MIA,109,5.0,Rebounds,22,19,21,4
Tyler Herro,G,22023,1629639,22300643,"JAN 27, 2024",MIA @ NYK,L,35,7,18,0.389,4,11,0.364,0,0,0.0,0,1,1,3,0,0,1,2,18,-17,1,MIA,NYK,MIA,109,29.5,Pts+Rebs+Asts,22,19,21,4
Tyler Herro,G,22023,1629639,22300643,"JAN 27, 2024",MIA @ NYK,L,35,7,18,0.389,4,11,0.364,0,0,0.0,0,1,1,3,0,0,1,2,18,-17,1,MIA,NYK,MIA,109,4.5,Assists,22,19,21,4
Tyler Herro,G,22023,1629639,22300643,"JAN 27, 2024",MIA @ NYK,L,35,7,18,0.389,4,11,0.364,0,0,0.0,0,1,1,3,0,0,1,2,18,-17,1,MIA,NYK,MIA,109,32.0,Fantasy Score,22,19,21,4
Tyler Herro,G,22023,1629639,22300643,"JAN 27, 2024",MIA @ NYK,L,35,7,18,0.389,4,11,0.364,0,0,0.0,0,1,1,3,0,0,1,2,18,-17,1,MIA,NYK,MIA,109,24.5,Pts+Rebs,22,19,21,4
Tyler Herro,G,22023,1629639,22300643,"JAN 27, 2024",MIA @ NYK,L,35,7,18,0.389,4,11,0.364,0,0,0.0,0,1,1,3,0,0,1,2,18,-17,1,MIA,NYK,MIA,109,24.5,Pts+Asts,22,19,21,4
Tyler Herro,G,22023,1629639,22300643,"JAN 27, 2024",MIA @ NYK,L,35,7,18,0.389,4,11,0.364,0,0,0.0,0,1,1,3,0,0,1,2,18,-17,1,MIA,NYK,MIA,109,0.5,Steals,22,19,21,4
Tyler Herro,G,22023,1629639,22300643,"JAN 27, 2024",MIA @ NYK,L,35,7,18,0.389,4,11,0.364,0,0,0.0,0,1,1,3,0,0,1,2,18,-17,1,MIA,NYK,MIA,109,9.5,Rebs+Asts,22,19,21,4
Tyler Herro,G,22023,1629639,22300630,"JAN 25, 2024",MIA vs. BOS,L,29,7,14,0.5,5,10,0.5,0,0,0.0,0,3,3,6,1,0,1,0,19,-24,1,MIA,MIA,BOS,110,19.5,Points,28,22,25,9
Tyler Herro,G,22023,1629639,22300630,"JAN 25, 2024",MIA vs. BOS,L,29,7,14,0.5,5,10,0.5,0,0,0.0,0,3,3,6,1,0,1,0,19,-24,1,MIA,MIA,BOS,110,5.0,Rebounds,28,22,25,9
Tyler Herro,G,22023,1629639,22300630,"JAN 25, 2024",MIA vs. BOS,L,29,7,14,0.5,5,10,0.5,0,0,0.0,0,3,3,6,1,0,1,0,19,-24,1,MIA,MIA,BOS,110,29.5,Pts+Rebs+Asts,28,22,25,9
Tyler Herro,G,22023,1629639,22300630,"JAN 25, 2024",MIA vs. BOS,L,29,7,14,0.5,5,10,0.5,0,0,0.0,0,3,3,6,1,0,1,0,19,-24,1,MIA,MIA,BOS,110,4.5,Assists,28,22,25,9
Tyler Herro,G,22023,1629639,22300630,"JAN 25, 2024",MIA vs. BOS,L,29,7,14,0.5,5,10,0.5,0,0,0.0,0,3,3,6,1,0,1,0,19,-24,1,MIA,MIA,BOS,110,32.0,Fantasy Score,28,22,25,9
Tyler Herro,G,22023,1629639,22300630,"JAN 25, 2024",MIA vs. BOS,L,29,7,14,0.5,5,10,0.5,0,0,0.0,0,3,3,6,1,0,1,0,19,-24,1,MIA,MIA,BOS,110,24.5,Pts+Rebs,28,22,25,9
Tyler Herro,G,22023,1629639,22300630,"JAN 25, 2024",MIA vs. BOS,L,29,7,14,0.5,5,10,0.5,0,0,0.0,0,3,3,6,1,0,1,0,19,-24,1,MIA,MIA,BOS,110,24.5,Pts+Asts,28,22,25,9
Tyler Herro,G,22023,1629639,22300630,"JAN 25, 2024",MIA vs. BOS,L,29,7,14,0.5,5,10,0.5,0,0,0.0,0,3,3,6,1,0,1,0,19,-24,1,MIA,MIA,BOS,110,0.5,Steals,28,22,25,9
Tyler Herro,G,22023,1629639,22300630,"JAN 25, 2024",MIA vs. BOS,L,29,7,14,0.5,5,10,0.5,0,0,0.0,0,3,3,6,1,0,1,0,19,-24,1,MIA,MIA,BOS,110,9.5,Rebs+Asts,28,22,25,9
Tyler Herro,G,22023,1629639,22300621,"JAN 24, 2024",MIA vs. MEM,L,38,8,15,0.533,2,6,0.333,0,0,0.0,0,6,6,3,0,0,4,1,18,-9,1,MIA,MIA,MEM,96,19.5,Points,27,24,21,9
Tyler Herro,G,22023,1629639,22300621,"JAN 24, 2024",MIA vs. MEM,L,38,8,15,0.533,2,6,0.333,0,0,0.0,0,6,6,3,0,0,4,1,18,-9,1,MIA,MIA,MEM,96,5.0,Rebounds,27,24,21,9
Tyler Herro,G,22023,1629639,22300621,"JAN 24, 2024",MIA vs. MEM,L,38,8,15,0.533,2,6,0.333,0,0,0.0,0,6,6,3,0,0,4,1,18,-9,1,MIA,MIA,MEM,96,29.5,Pts+Rebs+Asts,27,24,21,9
Tyler Herro,G,22023,1629639,22300621,"JAN 24, 2024",MIA vs. MEM,L,38,8,15,0.533,2,6,0.333,0,0,0.0,0,6,6,3,0,0,4,1,18,-9,1,MIA,MIA,MEM,96,4.5,Assists,27,24,21,9
Tyler Herro,G,22023,1629639,22300621,"JAN 24, 2024",MIA vs. MEM,L,38,8,15,0.533,2,6,0.333,0,0,0.0,0,6,6,3,0,0,4,1,18,-9,1,MIA,MIA,MEM,96,32.0,Fantasy Score,27,24,21,9
Tyler Herro,G,22023,1629639,22300621,"JAN 24, 2024",MIA vs. MEM,L,38,8,15,0.533,2,6,0.333,0,0,0.0,0,6,6,3,0,0,4,1,18,-9,1,MIA,MIA,MEM,96,24.5,Pts+Rebs,27,24,21,9
Tyler Herro,G,22023,1629639,22300621,"JAN 24, 2024",MIA vs. MEM,L,38,8,15,0.533,2,6,0.333,0,0,0.0,0,6,6,3,0,0,4,1,18,-9,1,MIA,MIA,MEM,96,24.5,Pts+Asts,27,24,21,9
Tyler Herro,G,22023,1629639,22300621,"JAN 24, 2024",MIA vs. MEM,L,38,8,15,0.533,2,6,0.333,0,0,0.0,0,6,6,3,0,0,4,1,18,-9,1,MIA,MIA,MEM,96,0.5,Steals,27,24,21,9
Tyler Herro,G,22023,1629639,22300621,"JAN 24, 2024",MIA vs. MEM,L,38,8,15,0.533,2,6,0.333,0,0,0.0,0,6,6,3,0,0,4,1,18,-9,1,MIA,MIA,MEM,96,9.5,Rebs+Asts,27,24,21,9
Tyler Herro,G,22023,1629639,22300601,"JAN 21, 2024",MIA @ ORL,L,33,4,14,0.286,4,11,0.364,0,0,0.0,1,0,1,2,1,0,2,1,12,-16,1,MIA,ORL,MIA,87,19.5,Points,15,13,14,3
Tyler Herro,G,22023,1629639,22300601,"JAN 21, 2024",MIA @ ORL,L,33,4,14,0.286,4,11,0.364,0,0,0.0,1,0,1,2,1,0,2,1,12,-16,1,MIA,ORL,MIA,87,5.0,Rebounds,15,13,14,3
Tyler Herro,G,22023,1629639,22300601,"JAN 21, 2024",MIA @ ORL,L,33,4,14,0.286,4,11,0.364,0,0,0.0,1,0,1,2,1,0,2,1,12,-16,1,MIA,ORL,MIA,87,29.5,Pts+Rebs+Asts,15,13,14,3
Tyler Herro,G,22023,1629639,22300601,"JAN 21, 2024",MIA @ ORL,L,33,4,14,0.286,4,11,0.364,0,0,0.0,1,0,1,2,1,0,2,1,12,-16,1,MIA,ORL,MIA,87,4.5,Assists,15,13,14,3
Tyler Herro,G,22023,1629639,22300601,"JAN 21, 2024",MIA @ ORL,L,33,4,14,0.286,4,11,0.364,0,0,0.0,1,0,1,2,1,0,2,1,12,-16,1,MIA,ORL,MIA,87,32.0,Fantasy Score,15,13,14,3
Tyler Herro,G,22023,1629639,22300601,"JAN 21, 2024",MIA @ ORL,L,33,4,14,0.286,4,11,0.364,0,0,0.0,1,0,1,2,1,0,2,1,12,-16,1,MIA,ORL,MIA,87,24.5,Pts+Rebs,15,13,14,3
Tyler Herro,G,22023,1629639,22300601,"JAN 21, 2024",MIA @ ORL,L,33,4,14,0.286,4,11,0.364,0,0,0.0,1,0,1,2,1,0,2,1,12,-16,1,MIA,ORL,MIA,87,24.5,Pts+Asts,15,13,14,3
Tyler Herro,G,22023,1629639,22300601,"JAN 21, 2024",MIA @ ORL,L,33,4,14,0.286,4,11,0.364,0,0,0.0,1,0,1,2,1,0,2,1,12,-16,1,MIA,ORL,MIA,87,0.5,Steals,15,13,14,3
Tyler Herro,G,22023,1629639,22300601,"JAN 21, 2024",MIA @ ORL,L,33,4,14,0.286,4,11,0.364,0,0,0.0,1,0,1,2,1,0,2,1,12,-16,1,MIA,ORL,MIA,87,9.5,Rebs+Asts,15,13,14,3
Tyler Herro,G,22023,1629639,22300587,"JAN 19, 2024",MIA vs. ATL,L,35,10,19,0.526,4,9,0.444,1,1,1.0,0,6,6,2,1,0,2,4,25,0,1,MIA,MIA,ATL,108,19.5,Points,33,31,27,8
Tyler Herro,G,22023,1629639,22300587,"JAN 19, 2024",MIA vs. ATL,L,35,10,19,0.526,4,9,0.444,1,1,1.0,0,6,6,2,1,0,2,4,25,0,1,MIA,MIA,ATL,108,5.0,Rebounds,33,31,27,8
Tyler Herro,G,22023,1629639,22300587,"JAN 19, 2024",MIA vs. ATL,L,35,10,19,0.526,4,9,0.444,1,1,1.0,0,6,6,2,1,0,2,4,25,0,1,MIA,MIA,ATL,108,29.5,Pts+Rebs+Asts,33,31,27,8
Tyler Herro,G,22023,1629639,22300587,"JAN 19, 2024",MIA vs. ATL,L,35,10,19,0.526,4,9,0.444,1,1,1.0,0,6,6,2,1,0,2,4,25,0,1,MIA,MIA,ATL,108,4.5,Assists,33,31,27,8
Tyler Herro,G,22023,1629639,22300587,"JAN 19, 2024",MIA vs. ATL,L,35,10,19,0.526,4,9,0.444,1,1,1.0,0,6,6,2,1,0,2,4,25,0,1,MIA,MIA,ATL,108,32.0,Fantasy Score,33,31,27,8
Tyler Herro,G,22023,1629639,22300587,"JAN 19, 2024",MIA vs. ATL,L,35,10,19,0.526,4,9,0.444,1,1,1.0,0,6,6,2,1,0,2,4,25,0,1,MIA,MIA,ATL,108,24.5,Pts+Rebs,33,31,27,8
Tyler Herro,G,22023,1629639,22300587,"JAN 19, 2024",MIA vs. ATL,L,35,10,19,0.526,4,9,0.444,1,1,1.0,0,6,6,2,1,0,2,4,25,0,1,MIA,MIA,ATL,108,24.5,Pts+Asts,33,31,27,8
Tyler Herro,G,22023,1629639,22300587,"JAN 19, 2024",MIA vs. ATL,L,35,10,19,0.526,4,9,0.444,1,1,1.0,0,6,6,2,1,0,2,4,25,0,1,MIA,MIA,ATL,108,0.5,Steals,33,31,27,8
Tyler Herro,G,22023,1629639,22300587,"JAN 19, 2024",MIA vs. ATL,L,35,10,19,0.526,4,9,0.444,1,1,1.0,0,6,6,2,1,0,2,4,25,0,1,MIA,MIA,ATL,108,9.5,Rebs+Asts,33,31,27,8
Tyler Herro,G,22023,1629639,22300574,"JAN 17, 2024",MIA @ TOR,L,32,7,20,0.35,2,9,0.222,0,0,0.0,1,6,7,3,0,0,3,2,16,-8,1,MIA,TOR,MIA,97,19.5,Points,26,23,19,10
Tyler Herro,G,22023,1629639,22300574,"JAN 17, 2024",MIA @ TOR,L,32,7,20,0.35,2,9,0.222,0,0,0.0,1,6,7,3,0,0,3,2,16,-8,1,MIA,TOR,MIA,97,5.0,Rebounds,26,23,19,10
Tyler Herro,G,22023,1629639,22300574,"JAN 17, 2024",MIA @ TOR,L,32,7,20,0.35,2,9,0.222,0,0,0.0,1,6,7,3,0,0,3,2,16,-8,1,MIA,TOR,MIA,97,29.5,Pts+Rebs+Asts,26,23,19,10
Tyler Herro,G,22023,1629639,22300574,"JAN 17, 2024",MIA @ TOR,L,32,7,20,0.35,2,9,0.222,0,0,0.0,1,6,7,3,0,0,3,2,16,-8,1,MIA,TOR,MIA,97,4.5,Assists,26,23,19,10
Tyler Herro,G,22023,1629639,22300574,"JAN 17, 2024",MIA @ TOR,L,32,7,20,0.35,2,9,0.222,0,0,0.0,1,6,7,3,0,0,3,2,16,-8,1,MIA,TOR,MIA,97,32.0,Fantasy Score,26,23,19,10
Tyler Herro,G,22023,1629639,22300574,"JAN 17, 2024",MIA @ TOR,L,32,7,20,0.35,2,9,0.222,0,0,0.0,1,6,7,3,0,0,3,2,16,-8,1,MIA,TOR,MIA,97,24.5,Pts+Rebs,26,23,19,10
Tyler Herro,G,22023,1629639,22300574,"JAN 17, 2024",MIA @ TOR,L,32,7,20,0.35,2,9,0.222,0,0,0.0,1,6,7,3,0,0,3,2,16,-8,1,MIA,TOR,MIA,97,24.5,Pts+Asts,26,23,19,10
Tyler Herro,G,22023,1629639,22300574,"JAN 17, 2024",MIA @ TOR,L,32,7,20,0.35,2,9,0.222,0,0,0.0,1,6,7,3,0,0,3,2,16,-8,1,MIA,TOR,MIA,97,0.5,Steals,26,23,19,10
Tyler Herro,G,22023,1629639,22300574,"JAN 17, 2024",MIA @ TOR,L,32,7,20,0.35,2,9,0.222,0,0,0.0,1,6,7,3,0,0,3,2,16,-8,1,MIA,TOR,MIA,97,9.5,Rebs+Asts,26,23,19,10
Tyler Herro,G,22023,1629639,22300562,"JAN 15, 2024",MIA @ BKN,W,38,11,22,0.5,4,11,0.364,3,4,0.75,1,10,11,2,0,0,4,3,29,16,1,MIA,BKN,MIA,96,19.5,Points,42,40,31,13
Tyler Herro,G,22023,1629639,22300562,"JAN 15, 2024",MIA @ BKN,W,38,11,22,0.5,4,11,0.364,3,4,0.75,1,10,11,2,0,0,4,3,29,16,1,MIA,BKN,MIA,96,5.0,Rebounds,42,40,31,13
Tyler Herro,G,22023,1629639,22300562,"JAN 15, 2024",MIA @ BKN,W,38,11,22,0.5,4,11,0.364,3,4,0.75,1,10,11,2,0,0,4,3,29,16,1,MIA,BKN,MIA,96,29.5,Pts+Rebs+Asts,42,40,31,13
Tyler Herro,G,22023,1629639,22300562,"JAN 15, 2024",MIA @ BKN,W,38,11,22,0.5,4,11,0.364,3,4,0.75,1,10,11,2,0,0,4,3,29,16,1,MIA,BKN,MIA,96,4.5,Assists,42,40,31,13
Tyler Herro,G,22023,1629639,22300562,"JAN 15, 2024",MIA @ BKN,W,38,11,22,0.5,4,11,0.364,3,4,0.75,1,10,11,2,0,0,4,3,29,16,1,MIA,BKN,MIA,96,32.0,Fantasy Score,42,40,31,13
Tyler Herro,G,22023,1629639,22300562,"JAN 15, 2024",MIA @ BKN,W,38,11,22,0.5,4,11,0.364,3,4,0.75,1,10,11,2,0,0,4,3,29,16,1,MIA,BKN,MIA,96,24.5,Pts+Rebs,42,40,31,13
Tyler Herro,G,22023,1629639,22300562,"JAN 15, 2024",MIA @ BKN,W,38,11,22,0.5,4,11,0.364,3,4,0.75,1,10,11,2,0,0,4,3,29,16,1,MIA,BKN,MIA,96,24.5,Pts+Asts,42,40,31,13
Tyler Herro,G,22023,1629639,22300562,"JAN 15, 2024",MIA @ BKN,W,38,11,22,0.5,4,11,0.364,3,4,0.75,1,10,11,2,0,0,4,3,29,16,1,MIA,BKN,MIA,96,0.5,Steals,42,40,31,13
Tyler Herro,G,22023,1629639,22300562,"JAN 15, 2024",MIA @ BKN,W,38,11,22,0.5,4,11,0.364,3,4,0.75,1,10,11,2,0,0,4,3,29,16,1,MIA,BKN,MIA,96,9.5,Rebs+Asts,42,40,31,13
Tyler Herro,G,22023,1629639,22300551,"JAN 14, 2024",MIA vs. CHA,W,28,7,15,0.467,4,9,0.444,3,4,0.75,1,6,7,4,1,0,3,1,21,12,1,MIA,MIA,CHA,104,19.5,Points,32,28,25,11
Tyler Herro,G,22023,1629639,22300551,"JAN 14, 2024",MIA vs. CHA,W,28,7,15,0.467,4,9,0.444,3,4,0.75,1,6,7,4,1,0,3,1,21,12,1,MIA,MIA,CHA,104,5.0,Rebounds,32,28,25,11
Tyler Herro,G,22023,1629639,22300551,"JAN 14, 2024",MIA vs. CHA,W,28,7,15,0.467,4,9,0.444,3,4,0.75,1,6,7,4,1,0,3,1,21,12,1,MIA,MIA,CHA,104,29.5,Pts+Rebs+Asts,32,28,25,11
Tyler Herro,G,22023,1629639,22300551,"JAN 14, 2024",MIA vs. CHA,W,28,7,15,0.467,4,9,0.444,3,4,0.75,1,6,7,4,1,0,3,1,21,12,1,MIA,MIA,CHA,104,4.5,Assists,32,28,25,11
Tyler Herro,G,22023,1629639,22300551,"JAN 14, 2024",MIA vs. CHA,W,28,7,15,0.467,4,9,0.444,3,4,0.75,1,6,7,4,1,0,3,1,21,12,1,MIA,MIA,CHA,104,32.0,Fantasy Score,32,28,25,11
Tyler Herro,G,22023,1629639,22300551,"JAN 14, 2024",MIA vs. CHA,W,28,7,15,0.467,4,9,0.444,3,4,0.75,1,6,7,4,1,0,3,1,21,12,1,MIA,MIA,CHA,104,24.5,Pts+Rebs,32,28,25,11
Tyler Herro,G,22023,1629639,22300551,"JAN 14, 2024",MIA vs. CHA,W,28,7,15,0.467,4,9,0.444,3,4,0.75,1,6,7,4,1,0,3,1,21,12,1,MIA,MIA,CHA,104,24.5,Pts+Asts,32,28,25,11
Tyler Herro,G,22023,1629639,22300551,"JAN 14, 2024",MIA vs. CHA,W,28,7,15,0.467,4,9,0.444,3,4,0.75,1,6,7,4,1,0,3,1,21,12,1,MIA,MIA,CHA,104,0.5,Steals,32,28,25,11
Tyler Herro,G,22023,1629639,22300551,"JAN 14, 2024",MIA vs. CHA,W,28,7,15,0.467,4,9,0.444,3,4,0.75,1,6,7,4,1,0,3,1,21,12,1,MIA,MIA,CHA,104,9.5,Rebs+Asts,32,28,25,11
Tyler Herro,G,22023,1629639,22300522,"JAN 10, 2024",MIA vs. OKC,L,36,7,21,0.333,1,5,0.2,2,4,0.5,0,5,5,6,3,0,1,1,17,9,1,MIA,MIA,OKC,120,19.5,Points,28,22,23,11
Tyler Herro,G,22023,1629639,22300522,"JAN 10, 2024",MIA vs. OKC,L,36,7,21,0.333,1,5,0.2,2,4,0.5,0,5,5,6,3,0,1,1,17,9,1,MIA,MIA,OKC,120,5.0,Rebounds,28,22,23,11
Tyler Herro,G,22023,1629639,22300522,"JAN 10, 2024",MIA vs. OKC,L,36,7,21,0.333,1,5,0.2,2,4,0.5,0,5,5,6,3,0,1,1,17,9,1,MIA,MIA,OKC,120,29.5,Pts+Rebs+Asts,28,22,23,11
Tyler Herro,G,22023,1629639,22300522,"JAN 10, 2024",MIA vs. OKC,L,36,7,21,0.333,1,5,0.2,2,4,0.5,0,5,5,6,3,0,1,1,17,9,1,MIA,MIA,OKC,120,4.5,Assists,28,22,23,11
Tyler Herro,G,22023,1629639,22300522,"JAN 10, 2024",MIA vs. OKC,L,36,7,21,0.333,1,5,0.2,2,4,0.5,0,5,5,6,3,0,1,1,17,9,1,MIA,MIA,OKC,120,32.0,Fantasy Score,28,22,23,11
Tyler Herro,G,22023,1629639,22300522,"JAN 10, 2024",MIA vs. OKC,L,36,7,21,0.333,1,5,0.2,2,4,0.5,0,5,5,6,3,0,1,1,17,9,1,MIA,MIA,OKC,120,24.5,Pts+Rebs,28,22,23,11
Tyler Herro,G,22023,1629639,22300522,"JAN 10, 2024",MIA vs. OKC,L,36,7,21,0.333,1,5,0.2,2,4,0.5,0,5,5,6,3,0,1,1,17,9,1,MIA,MIA,OKC,120,24.5,Pts+Asts,28,22,23,11
Tyler Herro,G,22023,1629639,22300522,"JAN 10, 2024",MIA vs. OKC,L,36,7,21,0.333,1,5,0.2,2,4,0.5,0,5,5,6,3,0,1,1,17,9,1,MIA,MIA,OKC,120,0.5,Steals,28,22,23,11
Tyler Herro,G,22023,1629639,22300522,"JAN 10, 2024",MIA vs. OKC,L,36,7,21,0.333,1,5,0.2,2,4,0.5,0,5,5,6,3,0,1,1,17,9,1,MIA,MIA,OKC,120,9.5,Rebs+Asts,28,22,23,11
Tyler Herro,G,22023,1629639,22300509,"JAN 08, 2024",MIA vs. HOU,W,34,10,20,0.5,5,10,0.5,3,3,1.0,2,1,3,3,0,0,1,2,28,1,1,MIA,MIA,HOU,120,19.5,Points,34,31,31,6
Tyler Herro,G,22023,1629639,22300509,"JAN 08, 2024",MIA vs. HOU,W,34,10,20,0.5,5,10,0.5,3,3,1.0,2,1,3,3,0,0,1,2,28,1,1,MIA,MIA,HOU,120,5.0,Rebounds,34,31,31,6
Tyler Herro,G,22023,1629639,22300509,"JAN 08, 2024",MIA vs. HOU,W,34,10,20,0.5,5,10,0.5,3,3,1.0,2,1,3,3,0,0,1,2,28,1,1,MIA,MIA,HOU,120,29.5,Pts+Rebs+Asts,34,31,31,6
Tyler Herro,G,22023,1629639,22300509,"JAN 08, 2024",MIA vs. HOU,W,34,10,20,0.5,5,10,0.5,3,3,1.0,2,1,3,3,0,0,1,2,28,1,1,MIA,MIA,HOU,120,4.5,Assists,34,31,31,6
Tyler Herro,G,22023,1629639,22300509,"JAN 08, 2024",MIA vs. HOU,W,34,10,20,0.5,5,10,0.5,3,3,1.0,2,1,3,3,0,0,1,2,28,1,1,MIA,MIA,HOU,120,32.0,Fantasy Score,34,31,31,6
Tyler Herro,G,22023,1629639,22300509,"JAN 08, 2024",MIA vs. HOU,W,34,10,20,0.5,5,10,0.5,3,3,1.0,2,1,3,3,0,0,1,2,28,1,1,MIA,MIA,HOU,120,24.5,Pts+Rebs,34,31,31,6
Tyler Herro,G,22023,1629639,22300509,"JAN 08, 2024",MIA vs. HOU,W,34,10,20,0.5,5,10,0.5,3,3,1.0,2,1,3,3,0,0,1,2,28,1,1,MIA,MIA,HOU,120,24.5,Pts+Asts,34,31,31,6
Tyler Herro,G,22023,1629639,22300509,"JAN 08, 2024",MIA vs. HOU,W,34,10,20,0.5,5,10,0.5,3,3,1.0,2,1,3,3,0,0,1,2,28,1,1,MIA,MIA,HOU,120,0.5,Steals,34,31,31,6
Tyler Herro,G,22023,1629639,22300509,"JAN 08, 2024",MIA vs. HOU,W,34,10,20,0.5,5,10,0.5,3,3,1.0,2,1,3,3,0,0,1,2,28,1,1,MIA,MIA,HOU,120,9.5,Rebs+Asts,34,31,31,6
Tyler Herro,G,22023,1629639,22300489,"JAN 05, 2024",MIA @ PHX,L,35,4,17,0.235,1,7,0.143,0,0,0.0,0,4,4,6,0,0,1,2,9,-25,1,MIA,PHX,MIA,97,19.5,Points,19,13,15,10
Tyler Herro,G,22023,1629639,22300489,"JAN 05, 2024",MIA @ PHX,L,35,4,17,0.235,1,7,0.143,0,0,0.0,0,4,4,6,0,0,1,2,9,-25,1,MIA,PHX,MIA,97,5.0,Rebounds,19,13,15,10
Tyler Herro,G,22023,1629639,22300489,"JAN 05, 2024",MIA @ PHX,L,35,4,17,0.235,1,7,0.143,0,0,0.0,0,4,4,6,0,0,1,2,9,-25,1,MIA,PHX,MIA,97,29.5,Pts+Rebs+Asts,19,13,15,10
Tyler Herro,G,22023,1629639,22300489,"JAN 05, 2024",MIA @ PHX,L,35,4,17,0.235,1,7,0.143,0,0,0.0,0,4,4,6,0,0,1,2,9,-25,1,MIA,PHX,MIA,97,4.5,Assists,19,13,15,10
Tyler Herro,G,22023,1629639,22300489,"JAN 05, 2024",MIA @ PHX,L,35,4,17,0.235,1,7,0.143,0,0,0.0,0,4,4,6,0,0,1,2,9,-25,1,MIA,PHX,MIA,97,32.0,Fantasy Score,19,13,15,10
Tyler Herro,G,22023,1629639,22300489,"JAN 05, 2024",MIA @ PHX,L,35,4,17,0.235,1,7,0.143,0,0,0.0,0,4,4,6,0,0,1,2,9,-25,1,MIA,PHX,MIA,97,24.5,Pts+Rebs,19,13,15,10
Tyler Herro,G,22023,1629639,22300489,"JAN 05, 2024",MIA @ PHX,L,35,4,17,0.235,1,7,0.143,0,0,0.0,0,4,4,6,0,0,1,2,9,-25,1,MIA,PHX,MIA,97,24.5,Pts+Asts,19,13,15,10
Tyler Herro,G,22023,1629639,22300489,"JAN 05, 2024",MIA @ PHX,L,35,4,17,0.235,1,7,0.143,0,0,0.0,0,4,4,6,0,0,1,2,9,-25,1,MIA,PHX,MIA,97,0.5,Steals,19,13,15,10
Tyler Herro,G,22023,1629639,22300489,"JAN 05, 2024",MIA @ PHX,L,35,4,17,0.235,1,7,0.143,0,0,0.0,0,4,4,6,0,0,1,2,9,-25,1,MIA,PHX,MIA,97,9.5,Rebs+Asts,19,13,15,10
Tyler Herro,G,22023,1629639,22300475,"JAN 03, 2024",MIA @ LAL,W,28,7,19,0.368,4,8,0.5,3,3,1.0,0,6,6,4,3,0,2,3,21,5,1,MIA,LAL,MIA,110,19.5,Points,31,27,25,10
Tyler Herro,G,22023,1629639,22300475,"JAN 03, 2024",MIA @ LAL,W,28,7,19,0.368,4,8,0.5,3,3,1.0,0,6,6,4,3,0,2,3,21,5,1,MIA,LAL,MIA,110,5.0,Rebounds,31,27,25,10
Tyler Herro,G,22023,1629639,22300475,"JAN 03, 2024",MIA @ LAL,W,28,7,19,0.368,4,8,0.5,3,3,1.0,0,6,6,4,3,0,2,3,21,5,1,MIA,LAL,MIA,110,29.5,Pts+Rebs+Asts,31,27,25,10
Tyler Herro,G,22023,1629639,22300475,"JAN 03, 2024",MIA @ LAL,W,28,7,19,0.368,4,8,0.5,3,3,1.0,0,6,6,4,3,0,2,3,21,5,1,MIA,LAL,MIA,110,4.5,Assists,31,27,25,10
Tyler Herro,G,22023,1629639,22300475,"JAN 03, 2024",MIA @ LAL,W,28,7,19,0.368,4,8,0.5,3,3,1.0,0,6,6,4,3,0,2,3,21,5,1,MIA,LAL,MIA,110,32.0,Fantasy Score,31,27,25,10
Tyler Herro,G,22023,1629639,22300475,"JAN 03, 2024",MIA @ LAL,W,28,7,19,0.368,4,8,0.5,3,3,1.0,0,6,6,4,3,0,2,3,21,5,1,MIA,LAL,MIA,110,24.5,Pts+Rebs,31,27,25,10
Tyler Herro,G,22023,1629639,22300475,"JAN 03, 2024",MIA @ LAL,W,28,7,19,0.368,4,8,0.5,3,3,1.0,0,6,6,4,3,0,2,3,21,5,1,MIA,LAL,MIA,110,24.5,Pts+Asts,31,27,25,10
Tyler Herro,G,22023,1629639,22300475,"JAN 03, 2024",MIA @ LAL,W,28,7,19,0.368,4,8,0.5,3,3,1.0,0,6,6,4,3,0,2,3,21,5,1,MIA,LAL,MIA,110,0.5,Steals,31,27,25,10
Tyler Herro,G,22023,1629639,22300475,"JAN 03, 2024",MIA @ LAL,W,28,7,19,0.368,4,8,0.5,3,3,1.0,0,6,6,4,3,0,2,3,21,5,1,MIA,LAL,MIA,110,9.5,Rebs+Asts,31,27,25,10
Tyler Herro,G,22023,1629639,22300458,"JAN 01, 2024",MIA @ LAC,L,35,4,13,0.308,4,8,0.5,0,0,0.0,0,6,6,6,2,0,3,1,12,-29,1,MIA,LAC,MIA,104,19.5,Points,24,18,18,12
Tyler Herro,G,22023,1629639,22300458,"JAN 01, 2024",MIA @ LAC,L,35,4,13,0.308,4,8,0.5,0,0,0.0,0,6,6,6,2,0,3,1,12,-29,1,MIA,LAC,MIA,104,5.0,Rebounds,24,18,18,12
Tyler Herro,G,22023,1629639,22300458,"JAN 01, 2024",MIA @ LAC,L,35,4,13,0.308,4,8,0.5,0,0,0.0,0,6,6,6,2,0,3,1,12,-29,1,MIA,LAC,MIA,104,29.5,Pts+Rebs+Asts,24,18,18,12
Tyler Herro,G,22023,1629639,22300458,"JAN 01, 2024",MIA @ LAC,L,35,4,13,0.308,4,8,0.5,0,0,0.0,0,6,6,6,2,0,3,1,12,-29,1,MIA,LAC,MIA,104,4.5,Assists,24,18,18,12
Tyler Herro,G,22023,1629639,22300458,"JAN 01, 2024",MIA @ LAC,L,35,4,13,0.308,4,8,0.5,0,0,0.0,0,6,6,6,2,0,3,1,12,-29,1,MIA,LAC,MIA,104,32.0,Fantasy Score,24,18,18,12
Tyler Herro,G,22023,1629639,22300458,"JAN 01, 2024",MIA @ LAC,L,35,4,13,0.308,4,8,0.5,0,0,0.0,0,6,6,6,2,0,3,1,12,-29,1,MIA,LAC,MIA,104,24.5,Pts+Rebs,24,18,18,12
Tyler Herro,G,22023,1629639,22300458,"JAN 01, 2024",MIA @ LAC,L,35,4,13,0.308,4,8,0.5,0,0,0.0,0,6,6,6,2,0,3,1,12,-29,1,MIA,LAC,MIA,104,24.5,Pts+Asts,24,18,18,12
Tyler Herro,G,22023,1629639,22300458,"JAN 01, 2024",MIA @ LAC,L,35,4,13,0.308,4,8,0.5,0,0,0.0,0,6,6,6,2,0,3,1,12,-29,1,MIA,LAC,MIA,104,0.5,Steals,24,18,18,12
Tyler Herro,G,22023,1629639,22300458,"JAN 01, 2024",MIA @ LAC,L,35,4,13,0.308,4,8,0.5,0,0,0.0,0,6,6,6,2,0,3,1,12,-29,1,MIA,LAC,MIA,104,9.5,Rebs+Asts,24,18,18,12
Tyler Herro,G,22023,1629639,22300439,"DEC 30, 2023",MIA @ UTA,L,39,9,22,0.409,2,7,0.286,5,5,1.0,2,4,6,6,1,1,1,2,25,-1,1,MIA,UTA,MIA,109,19.5,Points,37,31,31,12
Tyler Herro,G,22023,1629639,22300439,"DEC 30, 2023",MIA @ UTA,L,39,9,22,0.409,2,7,0.286,5,5,1.0,2,4,6,6,1,1,1,2,25,-1,1,MIA,UTA,MIA,109,5.0,Rebounds,37,31,31,12
Tyler Herro,G,22023,1629639,22300439,"DEC 30, 2023",MIA @ UTA,L,39,9,22,0.409,2,7,0.286,5,5,1.0,2,4,6,6,1,1,1,2,25,-1,1,MIA,UTA,MIA,109,29.5,Pts+Rebs+Asts,37,31,31,12
Tyler Herro,G,22023,1629639,22300439,"DEC 30, 2023",MIA @ UTA,L,39,9,22,0.409,2,7,0.286,5,5,1.0,2,4,6,6,1,1,1,2,25,-1,1,MIA,UTA,MIA,109,4.5,Assists,37,31,31,12
Tyler Herro,G,22023,1629639,22300439,"DEC 30, 2023",MIA @ UTA,L,39,9,22,0.409,2,7,0.286,5,5,1.0,2,4,6,6,1,1,1,2,25,-1,1,MIA,UTA,MIA,109,32.0,Fantasy Score,37,31,31,12
Tyler Herro,G,22023,1629639,22300439,"DEC 30, 2023",MIA @ UTA,L,39,9,22,0.409,2,7,0.286,5,5,1.0,2,4,6,6,1,1,1,2,25,-1,1,MIA,UTA,MIA,109,24.5,Pts+Rebs,37,31,31,12
Tyler Herro,G,22023,1629639,22300439,"DEC 30, 2023",MIA @ UTA,L,39,9,22,0.409,2,7,0.286,5,5,1.0,2,4,6,6,1,1,1,2,25,-1,1,MIA,UTA,MIA,109,24.5,Pts+Asts,37,31,31,12
Tyler Herro,G,22023,1629639,22300439,"DEC 30, 2023",MIA @ UTA,L,39,9,22,0.409,2,7,0.286,5,5,1.0,2,4,6,6,1,1,1,2,25,-1,1,MIA,UTA,MIA,109,0.5,Steals,37,31,31,12
Tyler Herro,G,22023,1629639,22300439,"DEC 30, 2023",MIA @ UTA,L,39,9,22,0.409,2,7,0.286,5,5,1.0,2,4,6,6,1,1,1,2,25,-1,1,MIA,UTA,MIA,109,9.5,Rebs+Asts,37,31,31,12
Tyler Herro,G,22023,1629639,22300426,"DEC 28, 2023",MIA @ GSW,W,31,10,18,0.556,3,7,0.429,3,4,0.75,0,7,7,2,1,0,2,0,26,11,1,MIA,GSW,MIA,114,19.5,Points,35,33,28,9
Tyler Herro,G,22023,1629639,22300426,"DEC 28, 2023",MIA @ GSW,W,31,10,18,0.556,3,7,0.429,3,4,0.75,0,7,7,2,1,0,2,0,26,11,1,MIA,GSW,MIA,114,5.0,Rebounds,35,33,28,9
Tyler Herro,G,22023,1629639,22300426,"DEC 28, 2023",MIA @ GSW,W,31,10,18,0.556,3,7,0.429,3,4,0.75,0,7,7,2,1,0,2,0,26,11,1,MIA,GSW,MIA,114,29.5,Pts+Rebs+Asts,35,33,28,9
Tyler Herro,G,22023,1629639,22300426,"DEC 28, 2023",MIA @ GSW,W,31,10,18,0.556,3,7,0.429,3,4,0.75,0,7,7,2,1,0,2,0,26,11,1,MIA,GSW,MIA,114,4.5,Assists,35,33,28,9
Tyler Herro,G,22023,1629639,22300426,"DEC 28, 2023",MIA @ GSW,W,31,10,18,0.556,3,7,0.429,3,4,0.75,0,7,7,2,1,0,2,0,26,11,1,MIA,GSW,MIA,114,32.0,Fantasy Score,35,33,28,9
Tyler Herro,G,22023,1629639,22300426,"DEC 28, 2023",MIA @ GSW,W,31,10,18,0.556,3,7,0.429,3,4,0.75,0,7,7,2,1,0,2,0,26,11,1,MIA,GSW,MIA,114,24.5,Pts+Rebs,35,33,28,9
Tyler Herro,G,22023,1629639,22300426,"DEC 28, 2023",MIA @ GSW,W,31,10,18,0.556,3,7,0.429,3,4,0.75,0,7,7,2,1,0,2,0,26,11,1,MIA,GSW,MIA,114,24.5,Pts+Asts,35,33,28,9
Tyler Herro,G,22023,1629639,22300426,"DEC 28, 2023",MIA @ GSW,W,31,10,18,0.556,3,7,0.429,3,4,0.75,0,7,7,2,1,0,2,0,26,11,1,MIA,GSW,MIA,114,0.5,Steals,35,33,28,9
Tyler Herro,G,22023,1629639,22300426,"DEC 28, 2023",MIA @ GSW,W,31,10,18,0.556,3,7,0.429,3,4,0.75,0,7,7,2,1,0,2,0,26,11,1,MIA,GSW,MIA,114,9.5,Rebs+Asts,35,33,28,9
Tyler Herro,G,22023,1629639,22300404,"DEC 25, 2023",MIA vs. PHI,W,38,8,25,0.32,4,11,0.364,2,3,0.667,2,4,6,5,1,1,4,1,22,-5,1,MIA,MIA,PHI,119,19.5,Points,33,28,27,11
Tyler Herro,G,22023,1629639,22300404,"DEC 25, 2023",MIA vs. PHI,W,38,8,25,0.32,4,11,0.364,2,3,0.667,2,4,6,5,1,1,4,1,22,-5,1,MIA,MIA,PHI,119,5.0,Rebounds,33,28,27,11
Tyler Herro,G,22023,1629639,22300404,"DEC 25, 2023",MIA vs. PHI,W,38,8,25,0.32,4,11,0.364,2,3,0.667,2,4,6,5,1,1,4,1,22,-5,1,MIA,MIA,PHI,119,29.5,Pts+Rebs+Asts,33,28,27,11
Tyler Herro,G,22023,1629639,22300404,"DEC 25, 2023",MIA vs. PHI,W,38,8,25,0.32,4,11,0.364,2,3,0.667,2,4,6,5,1,1,4,1,22,-5,1,MIA,MIA,PHI,119,4.5,Assists,33,28,27,11
Tyler Herro,G,22023,1629639,22300404,"DEC 25, 2023",MIA vs. PHI,W,38,8,25,0.32,4,11,0.364,2,3,0.667,2,4,6,5,1,1,4,1,22,-5,1,MIA,MIA,PHI,119,32.0,Fantasy Score,33,28,27,11
Tyler Herro,G,22023,1629639,22300404,"DEC 25, 2023",MIA vs. PHI,W,38,8,25,0.32,4,11,0.364,2,3,0.667,2,4,6,5,1,1,4,1,22,-5,1,MIA,MIA,PHI,119,24.5,Pts+Rebs,33,28,27,11
Tyler Herro,G,22023,1629639,22300404,"DEC 25, 2023",MIA vs. PHI,W,38,8,25,0.32,4,11,0.364,2,3,0.667,2,4,6,5,1,1,4,1,22,-5,1,MIA,MIA,PHI,119,24.5,Pts+Asts,33,28,27,11
Tyler Herro,G,22023,1629639,22300404,"DEC 25, 2023",MIA vs. PHI,W,38,8,25,0.32,4,11,0.364,2,3,0.667,2,4,6,5,1,1,4,1,22,-5,1,MIA,MIA,PHI,119,0.5,Steals,33,28,27,11
Tyler Herro,G,22023,1629639,22300404,"DEC 25, 2023",MIA vs. PHI,W,38,8,25,0.32,4,11,0.364,2,3,0.667,2,4,6,5,1,1,4,1,22,-5,1,MIA,MIA,PHI,119,9.5,Rebs+Asts,33,28,27,11
Tyler Herro,G,22023,1629639,22300384,"DEC 22, 2023",MIA vs. ATL,W,34,11,21,0.524,7,13,0.538,1,2,0.5,0,7,7,2,1,0,4,1,30,7,1,MIA,MIA,ATL,122,19.5,Points,39,37,32,9
Tyler Herro,G,22023,1629639,22300384,"DEC 22, 2023",MIA vs. ATL,W,34,11,21,0.524,7,13,0.538,1,2,0.5,0,7,7,2,1,0,4,1,30,7,1,MIA,MIA,ATL,122,5.0,Rebounds,39,37,32,9
Tyler Herro,G,22023,1629639,22300384,"DEC 22, 2023",MIA vs. ATL,W,34,11,21,0.524,7,13,0.538,1,2,0.5,0,7,7,2,1,0,4,1,30,7,1,MIA,MIA,ATL,122,29.5,Pts+Rebs+Asts,39,37,32,9
Tyler Herro,G,22023,1629639,22300384,"DEC 22, 2023",MIA vs. ATL,W,34,11,21,0.524,7,13,0.538,1,2,0.5,0,7,7,2,1,0,4,1,30,7,1,MIA,MIA,ATL,122,4.5,Assists,39,37,32,9
Tyler Herro,G,22023,1629639,22300384,"DEC 22, 2023",MIA vs. ATL,W,34,11,21,0.524,7,13,0.538,1,2,0.5,0,7,7,2,1,0,4,1,30,7,1,MIA,MIA,ATL,122,32.0,Fantasy Score,39,37,32,9
Tyler Herro,G,22023,1629639,22300384,"DEC 22, 2023",MIA vs. ATL,W,34,11,21,0.524,7,13,0.538,1,2,0.5,0,7,7,2,1,0,4,1,30,7,1,MIA,MIA,ATL,122,24.5,Pts+Rebs,39,37,32,9
Tyler Herro,G,22023,1629639,22300384,"DEC 22, 2023",MIA vs. ATL,W,34,11,21,0.524,7,13,0.538,1,2,0.5,0,7,7,2,1,0,4,1,30,7,1,MIA,MIA,ATL,122,24.5,Pts+Asts,39,37,32,9
Tyler Herro,G,22023,1629639,22300384,"DEC 22, 2023",MIA vs. ATL,W,34,11,21,0.524,7,13,0.538,1,2,0.5,0,7,7,2,1,0,4,1,30,7,1,MIA,MIA,ATL,122,0.5,Steals,39,37,32,9
Tyler Herro,G,22023,1629639,22300384,"DEC 22, 2023",MIA vs. ATL,W,34,11,21,0.524,7,13,0.538,1,2,0.5,0,7,7,2,1,0,4,1,30,7,1,MIA,MIA,ATL,122,9.5,Rebs+Asts,39,37,32,9
Tyler Herro,G,22023,1629639,22300366,"DEC 20, 2023",MIA @ ORL,W,36,10,17,0.588,4,5,0.8,4,4,1.0,1,7,8,7,0,0,4,1,28,10,1,MIA,ORL,MIA,115,19.5,Points,43,36,35,15
Tyler Herro,G,22023,1629639,22300366,"DEC 20, 2023",MIA @ ORL,W,36,10,17,0.588,4,5,0.8,4,4,1.0,1,7,8,7,0,0,4,1,28,10,1,MIA,ORL,MIA,115,5.0,Rebounds,43,36,35,15
Tyler Herro,G,22023,1629639,22300366,"DEC 20, 2023",MIA @ ORL,W,36,10,17,0.588,4,5,0.8,4,4,1.0,1,7,8,7,0,0,4,1,28,10,1,MIA,ORL,MIA,115,29.5,Pts+Rebs+Asts,43,36,35,15
Tyler Herro,G,22023,1629639,22300366,"DEC 20, 2023",MIA @ ORL,W,36,10,17,0.588,4,5,0.8,4,4,1.0,1,7,8,7,0,0,4,1,28,10,1,MIA,ORL,MIA,115,4.5,Assists,43,36,35,15
Tyler Herro,G,22023,1629639,22300366,"DEC 20, 2023",MIA @ ORL,W,36,10,17,0.588,4,5,0.8,4,4,1.0,1,7,8,7,0,0,4,1,28,10,1,MIA,ORL,MIA,115,32.0,Fantasy Score,43,36,35,15
Tyler Herro,G,22023,1629639,22300366,"DEC 20, 2023",MIA @ ORL,W,36,10,17,0.588,4,5,0.8,4,4,1.0,1,7,8,7,0,0,4,1,28,10,1,MIA,ORL,MIA,115,24.5,Pts+Rebs,43,36,35,15
Tyler Herro,G,22023,1629639,22300366,"DEC 20, 2023",MIA @ ORL,W,36,10,17,0.588,4,5,0.8,4,4,1.0,1,7,8,7,0,0,4,1,28,10,1,MIA,ORL,MIA,115,24.5,Pts+Asts,43,36,35,15
Tyler Herro,G,22023,1629639,22300366,"DEC 20, 2023",MIA @ ORL,W,36,10,17,0.588,4,5,0.8,4,4,1.0,1,7,8,7,0,0,4,1,28,10,1,MIA,ORL,MIA,115,0.5,Steals,43,36,35,15
Tyler Herro,G,22023,1629639,22300366,"DEC 20, 2023",MIA @ ORL,W,36,10,17,0.588,4,5,0.8,4,4,1.0,1,7,8,7,0,0,4,1,28,10,1,MIA,ORL,MIA,115,9.5,Rebs+Asts,43,36,35,15
Tyler Herro,G,22023,1629639,22300353,"DEC 18, 2023",MIA vs. MIN,L,33,10,18,0.556,1,6,0.167,4,4,1.0,1,2,3,2,2,0,2,1,25,-1,1,MIA,MIA,MIN,108,19.5,Points,30,28,27,5
Tyler Herro,G,22023,1629639,22300353,"DEC 18, 2023",MIA vs. MIN,L,33,10,18,0.556,1,6,0.167,4,4,1.0,1,2,3,2,2,0,2,1,25,-1,1,MIA,MIA,MIN,108,5.0,Rebounds,30,28,27,5
Tyler Herro,G,22023,1629639,22300353,"DEC 18, 2023",MIA vs. MIN,L,33,10,18,0.556,1,6,0.167,4,4,1.0,1,2,3,2,2,0,2,1,25,-1,1,MIA,MIA,MIN,108,29.5,Pts+Rebs+Asts,30,28,27,5
Tyler Herro,G,22023,1629639,22300353,"DEC 18, 2023",MIA vs. MIN,L,33,10,18,0.556,1,6,0.167,4,4,1.0,1,2,3,2,2,0,2,1,25,-1,1,MIA,MIA,MIN,108,4.5,Assists,30,28,27,5
Tyler Herro,G,22023,1629639,22300353,"DEC 18, 2023",MIA vs. MIN,L,33,10,18,0.556,1,6,0.167,4,4,1.0,1,2,3,2,2,0,2,1,25,-1,1,MIA,MIA,MIN,108,32.0,Fantasy Score,30,28,27,5
Tyler Herro,G,22023,1629639,22300353,"DEC 18, 2023",MIA vs. MIN,L,33,10,18,0.556,1,6,0.167,4,4,1.0,1,2,3,2,2,0,2,1,25,-1,1,MIA,MIA,MIN,108,24.5,Pts+Rebs,30,28,27,5
Tyler Herro,G,22023,1629639,22300353,"DEC 18, 2023",MIA vs. MIN,L,33,10,18,0.556,1,6,0.167,4,4,1.0,1,2,3,2,2,0,2,1,25,-1,1,MIA,MIA,MIN,108,24.5,Pts+Asts,30,28,27,5
Tyler Herro,G,22023,1629639,22300353,"DEC 18, 2023",MIA vs. MIN,L,33,10,18,0.556,1,6,0.167,4,4,1.0,1,2,3,2,2,0,2,1,25,-1,1,MIA,MIA,MIN,108,0.5,Steals,30,28,27,5
Tyler Herro,G,22023,1629639,22300353,"DEC 18, 2023",MIA vs. MIN,L,33,10,18,0.556,1,6,0.167,4,4,1.0,1,2,3,2,2,0,2,1,25,-1,1,MIA,MIA,MIN,108,9.5,Rebs+Asts,30,28,27,5
Tyler Herro,G,22023,1629639,22300164,"NOV 08, 2023",MIA @ MEM,W,8,2,4,0.5,0,0,0.0,2,3,0.667,0,1,1,2,1,0,0,2,6,6,1,MIA,MEM,MIA,108,19.5,Points,9,7,8,3
Tyler Herro,G,22023,1629639,22300164,"NOV 08, 2023",MIA @ MEM,W,8,2,4,0.5,0,0,0.0,2,3,0.667,0,1,1,2,1,0,0,2,6,6,1,MIA,MEM,MIA,108,5.0,Rebounds,9,7,8,3
Tyler Herro,G,22023,1629639,22300164,"NOV 08, 2023",MIA @ MEM,W,8,2,4,0.5,0,0,0.0,2,3,0.667,0,1,1,2,1,0,0,2,6,6,1,MIA,MEM,MIA,108,29.5,Pts+Rebs+Asts,9,7,8,3
Tyler Herro,G,22023,1629639,22300164,"NOV 08, 2023",MIA @ MEM,W,8,2,4,0.5,0,0,0.0,2,3,0.667,0,1,1,2,1,0,0,2,6,6,1,MIA,MEM,MIA,108,4.5,Assists,9,7,8,3
Tyler Herro,G,22023,1629639,22300164,"NOV 08, 2023",MIA @ MEM,W,8,2,4,0.5,0,0,0.0,2,3,0.667,0,1,1,2,1,0,0,2,6,6,1,MIA,MEM,MIA,108,32.0,Fantasy Score,9,7,8,3
Tyler Herro,G,22023,1629639,22300164,"NOV 08, 2023",MIA @ MEM,W,8,2,4,0.5,0,0,0.0,2,3,0.667,0,1,1,2,1,0,0,2,6,6,1,MIA,MEM,MIA,108,24.5,Pts+Rebs,9,7,8,3
Tyler Herro,G,22023,1629639,22300164,"NOV 08, 2023",MIA @ MEM,W,8,2,4,0.5,0,0,0.0,2,3,0.667,0,1,1,2,1,0,0,2,6,6,1,MIA,MEM,MIA,108,24.5,Pts+Asts,9,7,8,3
Tyler Herro,G,22023,1629639,22300164,"NOV 08, 2023",MIA @ MEM,W,8,2,4,0.5,0,0,0.0,2,3,0.667,0,1,1,2,1,0,0,2,6,6,1,MIA,MEM,MIA,108,0.5,Steals,9,7,8,3
Tyler Herro,G,22023,1629639,22300164,"NOV 08, 2023",MIA @ MEM,W,8,2,4,0.5,0,0,0.0,2,3,0.667,0,1,1,2,1,0,0,2,6,6,1,MIA,MEM,MIA,108,9.5,Rebs+Asts,9,7,8,3
Tyler Herro,G,22023,1629639,22300150,"NOV 06, 2023",MIA vs. LAL,W,34,8,20,0.4,2,10,0.2,4,4,1.0,1,4,5,5,3,0,6,1,22,-9,1,MIA,MIA,LAL,108,19.5,Points,32,27,27,10
Tyler Herro,G,22023,1629639,22300150,"NOV 06, 2023",MIA vs. LAL,W,34,8,20,0.4,2,10,0.2,4,4,1.0,1,4,5,5,3,0,6,1,22,-9,1,MIA,MIA,LAL,108,5.0,Rebounds,32,27,27,10
Tyler Herro,G,22023,1629639,22300150,"NOV 06, 2023",MIA vs. LAL,W,34,8,20,0.4,2,10,0.2,4,4,1.0,1,4,5,5,3,0,6,1,22,-9,1,MIA,MIA,LAL,108,29.5,Pts+Rebs+Asts,32,27,27,10
Tyler Herro,G,22023,1629639,22300150,"NOV 06, 2023",MIA vs. LAL,W,34,8,20,0.4,2,10,0.2,4,4,1.0,1,4,5,5,3,0,6,1,22,-9,1,MIA,MIA,LAL,108,4.5,Assists,32,27,27,10
Tyler Herro,G,22023,1629639,22300150,"NOV 06, 2023",MIA vs. LAL,W,34,8,20,0.4,2,10,0.2,4,4,1.0,1,4,5,5,3,0,6,1,22,-9,1,MIA,MIA,LAL,108,32.0,Fantasy Score,32,27,27,10
Tyler Herro,G,22023,1629639,22300150,"NOV 06, 2023",MIA vs. LAL,W,34,8,20,0.4,2,10,0.2,4,4,1.0,1,4,5,5,3,0,6,1,22,-9,1,MIA,MIA,LAL,108,24.5,Pts+Rebs,32,27,27,10
Tyler Herro,G,22023,1629639,22300150,"NOV 06, 2023",MIA vs. LAL,W,34,8,20,0.4,2,10,0.2,4,4,1.0,1,4,5,5,3,0,6,1,22,-9,1,MIA,MIA,LAL,108,24.5,Pts+Asts,32,27,27,10
Tyler Herro,G,22023,1629639,22300150,"NOV 06, 2023",MIA vs. LAL,W,34,8,20,0.4,2,10,0.2,4,4,1.0,1,4,5,5,3,0,6,1,22,-9,1,MIA,MIA,LAL,108,0.5,Steals,32,27,27,10
Tyler Herro,G,22023,1629639,22300150,"NOV 06, 2023",MIA vs. LAL,W,34,8,20,0.4,2,10,0.2,4,4,1.0,1,4,5,5,3,0,6,1,22,-9,1,MIA,MIA,LAL,108,9.5,Rebs+Asts,32,27,27,10
Tyler Herro,G,22023,1629639,22300003,"NOV 03, 2023",MIA vs. WAS,W,37,9,17,0.529,4,7,0.571,2,2,1.0,0,10,10,9,2,0,3,3,24,7,1,MIA,MIA,WAS,121,19.5,Points,43,34,33,19
Tyler Herro,G,22023,1629639,22300003,"NOV 03, 2023",MIA vs. WAS,W,37,9,17,0.529,4,7,0.571,2,2,1.0,0,10,10,9,2,0,3,3,24,7,1,MIA,MIA,WAS,121,5.0,Rebounds,43,34,33,19
Tyler Herro,G,22023,1629639,22300003,"NOV 03, 2023",MIA vs. WAS,W,37,9,17,0.529,4,7,0.571,2,2,1.0,0,10,10,9,2,0,3,3,24,7,1,MIA,MIA,WAS,121,29.5,Pts+Rebs+Asts,43,34,33,19
Tyler Herro,G,22023,1629639,22300003,"NOV 03, 2023",MIA vs. WAS,W,37,9,17,0.529,4,7,0.571,2,2,1.0,0,10,10,9,2,0,3,3,24,7,1,MIA,MIA,WAS,121,4.5,Assists,43,34,33,19
Tyler Herro,G,22023,1629639,22300003,"NOV 03, 2023",MIA vs. WAS,W,37,9,17,0.529,4,7,0.571,2,2,1.0,0,10,10,9,2,0,3,3,24,7,1,MIA,MIA,WAS,121,32.0,Fantasy Score,43,34,33,19
Tyler Herro,G,22023,1629639,22300003,"NOV 03, 2023",MIA vs. WAS,W,37,9,17,0.529,4,7,0.571,2,2,1.0,0,10,10,9,2,0,3,3,24,7,1,MIA,MIA,WAS,121,24.5,Pts+Rebs,43,34,33,19
Tyler Herro,G,22023,1629639,22300003,"NOV 03, 2023",MIA vs. WAS,W,37,9,17,0.529,4,7,0.571,2,2,1.0,0,10,10,9,2,0,3,3,24,7,1,MIA,MIA,WAS,121,24.5,Pts+Asts,43,34,33,19
Tyler Herro,G,22023,1629639,22300003,"NOV 03, 2023",MIA vs. WAS,W,37,9,17,0.529,4,7,0.571,2,2,1.0,0,10,10,9,2,0,3,3,24,7,1,MIA,MIA,WAS,121,0.5,Steals,43,34,33,19
Tyler Herro,G,22023,1629639,22300003,"NOV 03, 2023",MIA vs. WAS,W,37,9,17,0.529,4,7,0.571,2,2,1.0,0,10,10,9,2,0,3,3,24,7,1,MIA,MIA,WAS,121,9.5,Rebs+Asts,43,34,33,19
Tyler Herro,G,22023,1629639,22300119,"NOV 01, 2023",MIA vs. BKN,L,36,12,23,0.522,6,10,0.6,0,1,0.0,0,3,3,5,0,0,3,2,30,-1,1,MIA,MIA,BKN,105,19.5,Points,38,33,35,8
Tyler Herro,G,22023,1629639,22300119,"NOV 01, 2023",MIA vs. BKN,L,36,12,23,0.522,6,10,0.6,0,1,0.0,0,3,3,5,0,0,3,2,30,-1,1,MIA,MIA,BKN,105,5.0,Rebounds,38,33,35,8
Tyler Herro,G,22023,1629639,22300119,"NOV 01, 2023",MIA vs. BKN,L,36,12,23,0.522,6,10,0.6,0,1,0.0,0,3,3,5,0,0,3,2,30,-1,1,MIA,MIA,BKN,105,29.5,Pts+Rebs+Asts,38,33,35,8
Tyler Herro,G,22023,1629639,22300119,"NOV 01, 2023",MIA vs. BKN,L,36,12,23,0.522,6,10,0.6,0,1,0.0,0,3,3,5,0,0,3,2,30,-1,1,MIA,MIA,BKN,105,4.5,Assists,38,33,35,8
Tyler Herro,G,22023,1629639,22300119,"NOV 01, 2023",MIA vs. BKN,L,36,12,23,0.522,6,10,0.6,0,1,0.0,0,3,3,5,0,0,3,2,30,-1,1,MIA,MIA,BKN,105,32.0,Fantasy Score,38,33,35,8
Tyler Herro,G,22023,1629639,22300119,"NOV 01, 2023",MIA vs. BKN,L,36,12,23,0.522,6,10,0.6,0,1,0.0,0,3,3,5,0,0,3,2,30,-1,1,MIA,MIA,BKN,105,24.5,Pts+Rebs,38,33,35,8
Tyler Herro,G,22023,1629639,22300119,"NOV 01, 2023",MIA vs. BKN,L,36,12,23,0.522,6,10,0.6,0,1,0.0,0,3,3,5,0,0,3,2,30,-1,1,MIA,MIA,BKN,105,24.5,Pts+Asts,38,33,35,8
Tyler Herro,G,22023,1629639,22300119,"NOV 01, 2023",MIA vs. BKN,L,36,12,23,0.522,6,10,0.6,0,1,0.0,0,3,3,5,0,0,3,2,30,-1,1,MIA,MIA,BKN,105,0.5,Steals,38,33,35,8
Tyler Herro,G,22023,1629639,22300119,"NOV 01, 2023",MIA vs. BKN,L,36,12,23,0.522,6,10,0.6,0,1,0.0,0,3,3,5,0,0,3,2,30,-1,1,MIA,MIA,BKN,105,9.5,Rebs+Asts,38,33,35,8
Tyler Herro,G,22023,1629639,22300093,"OCT 28, 2023",MIA @ MIN,L,40,8,23,0.348,4,10,0.4,2,2,1.0,0,5,5,4,0,0,0,1,22,-16,1,MIA,MIN,MIA,90,19.5,Points,31,27,26,9
Tyler Herro,G,22023,1629639,22300093,"OCT 28, 2023",MIA @ MIN,L,40,8,23,0.348,4,10,0.4,2,2,1.0,0,5,5,4,0,0,0,1,22,-16,1,MIA,MIN,MIA,90,5.0,Rebounds,31,27,26,9
Tyler Herro,G,22023,1629639,22300093,"OCT 28, 2023",MIA @ MIN,L,40,8,23,0.348,4,10,0.4,2,2,1.0,0,5,5,4,0,0,0,1,22,-16,1,MIA,MIN,MIA,90,29.5,Pts+Rebs+Asts,31,27,26,9
Tyler Herro,G,22023,1629639,22300093,"OCT 28, 2023",MIA @ MIN,L,40,8,23,0.348,4,10,0.4,2,2,1.0,0,5,5,4,0,0,0,1,22,-16,1,MIA,MIN,MIA,90,4.5,Assists,31,27,26,9
Tyler Herro,G,22023,1629639,22300093,"OCT 28, 2023",MIA @ MIN,L,40,8,23,0.348,4,10,0.4,2,2,1.0,0,5,5,4,0,0,0,1,22,-16,1,MIA,MIN,MIA,90,32.0,Fantasy Score,31,27,26,9
Tyler Herro,G,22023,1629639,22300093,"OCT 28, 2023",MIA @ MIN,L,40,8,23,0.348,4,10,0.4,2,2,1.0,0,5,5,4,0,0,0,1,22,-16,1,MIA,MIN,MIA,90,24.5,Pts+Rebs,31,27,26,9
Tyler Herro,G,22023,1629639,22300093,"OCT 28, 2023",MIA @ MIN,L,40,8,23,0.348,4,10,0.4,2,2,1.0,0,5,5,4,0,0,0,1,22,-16,1,MIA,MIN,MIA,90,24.5,Pts+Asts,31,27,26,9
Tyler Herro,G,22023,1629639,22300093,"OCT 28, 2023",MIA @ MIN,L,40,8,23,0.348,4,10,0.4,2,2,1.0,0,5,5,4,0,0,0,1,22,-16,1,MIA,MIN,MIA,90,0.5,Steals,31,27,26,9
Tyler Herro,G,22023,1629639,22300093,"OCT 28, 2023",MIA @ MIN,L,40,8,23,0.348,4,10,0.4,2,2,1.0,0,5,5,4,0,0,0,1,22,-16,1,MIA,MIN,MIA,90,9.5,Rebs+Asts,31,27,26,9
Tyler Herro,G,22023,1629639,22300080,"OCT 27, 2023",MIA @ BOS,L,40,10,20,0.5,5,12,0.417,3,3,1.0,1,5,6,6,1,0,3,2,28,-1,1,MIA,BOS,MIA,111,19.5,Points,40,34,34,12
Tyler Herro,G,22023,1629639,22300080,"OCT 27, 2023",MIA @ BOS,L,40,10,20,0.5,5,12,0.417,3,3,1.0,1,5,6,6,1,0,3,2,28,-1,1,MIA,BOS,MIA,111,5.0,Rebounds,40,34,34,12
Tyler Herro,G,22023,1629639,22300080,"OCT 27, 2023",MIA @ BOS,L,40,10,20,0.5,5,12,0.417,3,3,1.0,1,5,6,6,1,0,3,2,28,-1,1,MIA,BOS,MIA,111,29.5,Pts+Rebs+Asts,40,34,34,12
Tyler Herro,G,22023,1629639,22300080,"OCT 27, 2023",MIA @ BOS,L,40,10,20,0.5,5,12,0.417,3,3,1.0,1,5,6,6,1,0,3,2,28,-1,1,MIA,BOS,MIA,111,4.5,Assists,40,34,34,12
Tyler Herro,G,22023,1629639,22300080,"OCT 27, 2023",MIA @ BOS,L,40,10,20,0.5,5,12,0.417,3,3,1.0,1,5,6,6,1,0,3,2,28,-1,1,MIA,BOS,MIA,111,32.0,Fantasy Score,40,34,34,12
Tyler Herro,G,22023,1629639,22300080,"OCT 27, 2023",MIA @ BOS,L,40,10,20,0.5,5,12,0.417,3,3,1.0,1,5,6,6,1,0,3,2,28,-1,1,MIA,BOS,MIA,111,24.5,Pts+Rebs,40,34,34,12
Tyler Herro,G,22023,1629639,22300080,"OCT 27, 2023",MIA @ BOS,L,40,10,20,0.5,5,12,0.417,3,3,1.0,1,5,6,6,1,0,3,2,28,-1,1,MIA,BOS,MIA,111,24.5,Pts+Asts,40,34,34,12
Tyler Herro,G,22023,1629639,22300080,"OCT 27, 2023",MIA @ BOS,L,40,10,20,0.5,5,12,0.417,3,3,1.0,1,5,6,6,1,0,3,2,28,-1,1,MIA,BOS,MIA,111,0.5,Steals,40,34,34,12
Tyler Herro,G,22023,1629639,22300080,"OCT 27, 2023",MIA @ BOS,L,40,10,20,0.5,5,12,0.417,3,3,1.0,1,5,6,6,1,0,3,2,28,-1,1,MIA,BOS,MIA,111,9.5,Rebs+Asts,40,34,34,12
Tyler Herro,G,22023,1629639,22300068,"OCT 25, 2023",MIA vs. DET,W,35,7,24,0.292,2,7,0.286,0,0,0.0,0,2,2,3,3,0,2,1,16,6,1,MIA,MIA,DET,103,19.5,Points,21,18,19,5
Tyler Herro,G,22023,1629639,22300068,"OCT 25, 2023",MIA vs. DET,W,35,7,24,0.292,2,7,0.286,0,0,0.0,0,2,2,3,3,0,2,1,16,6,1,MIA,MIA,DET,103,5.0,Rebounds,21,18,19,5
Tyler Herro,G,22023,1629639,22300068,"OCT 25, 2023",MIA vs. DET,W,35,7,24,0.292,2,7,0.286,0,0,0.0,0,2,2,3,3,0,2,1,16,6,1,MIA,MIA,DET,103,29.5,Pts+Rebs+Asts,21,18,19,5
Tyler Herro,G,22023,1629639,22300068,"OCT 25, 2023",MIA vs. DET,W,35,7,24,0.292,2,7,0.286,0,0,0.0,0,2,2,3,3,0,2,1,16,6,1,MIA,MIA,DET,103,4.5,Assists,21,18,19,5
Tyler Herro,G,22023,1629639,22300068,"OCT 25, 2023",MIA vs. DET,W,35,7,24,0.292,2,7,0.286,0,0,0.0,0,2,2,3,3,0,2,1,16,6,1,MIA,MIA,DET,103,32.0,Fantasy Score,21,18,19,5
Tyler Herro,G,22023,1629639,22300068,"OCT 25, 2023",MIA vs. DET,W,35,7,24,0.292,2,7,0.286,0,0,0.0,0,2,2,3,3,0,2,1,16,6,1,MIA,MIA,DET,103,24.5,Pts+Rebs,21,18,19,5
Tyler Herro,G,22023,1629639,22300068,"OCT 25, 2023",MIA vs. DET,W,35,7,24,0.292,2,7,0.286,0,0,0.0,0,2,2,3,3,0,2,1,16,6,1,MIA,MIA,DET,103,24.5,Pts+Asts,21,18,19,5
Tyler Herro,G,22023,1629639,22300068,"OCT 25, 2023",MIA vs. DET,W,35,7,24,0.292,2,7,0.286,0,0,0.0,0,2,2,3,3,0,2,1,16,6,1,MIA,MIA,DET,103,0.5,Steals,21,18,19,5
Tyler Herro,G,22023,1629639,22300068,"OCT 25, 2023",MIA vs. DET,W,35,7,24,0.292,2,7,0.286,0,0,0.0,0,2,2,3,3,0,2,1,16,6,1,MIA,MIA,DET,103,9.5,Rebs+Asts,21,18,19,5
Tyler Herro,G,22023,1629639,22300107,"OCT 30, 2023",MIA @ MIL,L,42,12,21,0.571,2,5,0.4,9,10,0.9,1,7,8,3,1,0,3,1,35,-3,1,MIA,MIL,MIA,114,19.5,Points,46,43,38,11
Tyler Herro,G,22023,1629639,22300107,"OCT 30, 2023",MIA @ MIL,L,42,12,21,0.571,2,5,0.4,9,10,0.9,1,7,8,3,1,0,3,1,35,-3,1,MIA,MIL,MIA,114,5.0,Rebounds,46,43,38,11
Tyler Herro,G,22023,1629639,22300107,"OCT 30, 2023",MIA @ MIL,L,42,12,21,0.571,2,5,0.4,9,10,0.9,1,7,8,3,1,0,3,1,35,-3,1,MIA,MIL,MIA,114,29.5,Pts+Rebs+Asts,46,43,38,11
Tyler Herro,G,22023,1629639,22300107,"OCT 30, 2023",MIA @ MIL,L,42,12,21,0.571,2,5,0.4,9,10,0.9,1,7,8,3,1,0,3,1,35,-3,1,MIA,MIL,MIA,114,4.5,Assists,46,43,38,11
Tyler Herro,G,22023,1629639,22300107,"OCT 30, 2023",MIA @ MIL,L,42,12,21,0.571,2,5,0.4,9,10,0.9,1,7,8,3,1,0,3,1,35,-3,1,MIA,MIL,MIA,114,32.0,Fantasy Score,46,43,38,11
Tyler Herro,G,22023,1629639,22300107,"OCT 30, 2023",MIA @ MIL,L,42,12,21,0.571,2,5,0.4,9,10,0.9,1,7,8,3,1,0,3,1,35,-3,1,MIA,MIL,MIA,114,24.5,Pts+Rebs,46,43,38,11
Tyler Herro,G,22023,1629639,22300107,"OCT 30, 2023",MIA @ MIL,L,42,12,21,0.571,2,5,0.4,9,10,0.9,1,7,8,3,1,0,3,1,35,-3,1,MIA,MIL,MIA,114,24.5,Pts+Asts,46,43,38,11
Tyler Herro,G,22023,1629639,22300107,"OCT 30, 2023",MIA @ MIL,L,42,12,21,0.571,2,5,0.4,9,10,0.9,1,7,8,3,1,0,3,1,35,-3,1,MIA,MIL,MIA,114,0.5,Steals,46,43,38,11
Tyler Herro,G,22023,1629639,22300107,"OCT 30, 2023",MIA @ MIL,L,42,12,21,0.571,2,5,0.4,9,10,0.9,1,7,8,3,1,0,3,1,35,-3,1,MIA,MIL,MIA,114,9.5,Rebs+Asts,46,43,38,11
Cam Thomas,G,22023,1630560,22300750,"FEB 10, 2024",BKN vs. SAS,W,36,9,19,0.474,5,10,0.5,2,2,1.0,1,1,2,4,2,0,2,2,25,22,1,BKN,BKN,SAS,123,,,31,27,29,6
Cam Thomas,G,22023,1630560,22300735,"FEB 08, 2024",BKN vs. CLE,L,30,6,18,0.333,2,4,0.5,3,3,1.0,1,3,4,1,0,0,1,1,17,-24,1,BKN,BKN,CLE,95,,,22,21,18,5
Cam Thomas,G,22023,1630560,22300720,"FEB 06, 2024",BKN vs. DAL,L,37,6,16,0.375,1,3,0.333,3,4,0.75,0,8,8,8,1,0,2,2,16,-19,1,BKN,BKN,DAL,107,,,32,24,24,16
Cam Thomas,G,22023,1630560,22300717,"FEB 05, 2024",BKN vs. GSW,L,36,4,21,0.19,0,6,0.0,10,11,0.909,1,4,5,3,2,0,1,6,18,-14,1,BKN,BKN,GSW,98,,,26,23,21,8
Cam Thomas,G,22023,1630560,22300698,"FEB 03, 2024",BKN @ PHI,W,36,14,26,0.538,5,11,0.455,7,8,0.875,1,2,3,5,1,0,3,3,40,23,1,BKN,PHI,BKN,136,,,48,43,45,8
Cam Thomas,G,22023,1630560,22300677,"JAN 31, 2024",BKN vs. PHX,L,33,11,19,0.579,1,4,0.25,2,2,1.0,2,0,2,4,2,0,2,2,25,-11,1,BKN,BKN,PHX,120,,,31,27,29,6
Cam Thomas,G,22023,1630560,22300660,"JAN 29, 2024",BKN vs. UTA,W,31,8,16,0.5,4,5,0.8,5,5,1.0,1,6,7,0,1,1,2,3,25,25,1,BKN,BKN,UTA,147,,,32,32,25,7
Cam Thomas,G,22023,1630560,22300645,"JAN 27, 2024",BKN vs. HOU,W,41,11,19,0.579,3,6,0.5,12,15,0.8,0,3,3,3,1,0,5,4,37,12,1,BKN,BKN,HOU,106,,,43,40,40,6
Cam Thomas,G,22023,1630560,22300629,"JAN 25, 2024",BKN vs. MIN,L,28,7,15,0.467,1,4,0.25,10,10,1.0,0,6,6,3,2,0,5,0,25,6,1,BKN,BKN,MIN,94,,,34,31,28,9
Cam Thomas,G,22023,1630560,22300615,"JAN 23, 2024",BKN vs. NYK,L,22,6,11,0.545,0,3,0.0,2,2,1.0,0,1,1,2,0,1,1,3,14,-3,1,BKN,BKN,NYK,103,,,17,15,16,3
Cam Thomas,G,22023,1630560,22300600,"JAN 21, 2024",BKN @ LAC,L,27,8,17,0.471,1,5,0.2,3,4,0.75,0,2,2,6,0,0,4,2,20,-19,1,BKN,LAC,BKN,114,,,28,22,26,8
Cam Thomas,G,22023,1630560,22300591,"JAN 19, 2024",BKN @ LAL,W,32,13,18,0.722,4,7,0.571,3,4,0.75,0,3,3,4,1,0,1,2,33,12,1,BKN,LAL,BKN,130,,,40,36,37,7
Cam Thomas,G,22023,1630560,22300578,"JAN 17, 2024",BKN @ POR,L,22,2,7,0.286,2,4,0.5,2,2,1.0,0,0,0,4,0,0,1,0,8,-1,1,BKN,POR,BKN,103,,,12,8,12,4
Cam Thomas,G,22023,1630560,22300562,"JAN 15, 2024",BKN vs. MIA,L,32,7,20,0.35,2,10,0.2,7,7,1.0,0,2,2,3,0,0,2,2,23,9,1,BKN,BKN,MIA,95,,,28,25,26,5
Cam Thomas,G,22023,1630560,22300527,"JAN 11, 2024",BKN @ CLE,L,35,9,21,0.429,1,5,0.2,7,11,0.636,0,6,6,2,0,1,0,3,26,2,1,BKN,CLE,BKN,102,,,34,32,28,8
Cam Thomas,G,22023,1630560,22300498,"JAN 07, 2024",BKN vs. POR,L,18,4,9,0.444,1,3,0.333,0,0,0.0,0,3,3,0,0,0,1,0,9,-5,1,BKN,BKN,POR,127,,,12,12,9,3
Cam Thomas,G,22023,1630560,22300481,"JAN 05, 2024",BKN vs. OKC,W,24,6,14,0.429,3,5,0.6,4,5,0.8,0,2,2,0,1,0,1,0,19,6,1,BKN,BKN,OKC,124,,,21,21,19,2
Cam Thomas,G,22023,1630560,22300469,"JAN 03, 2024",BKN @ HOU,L,17,0,7,0.0,0,2,0.0,4,4,1.0,0,0,0,5,1,0,1,1,4,-10,1,BKN,HOU,BKN,101,,,9,4,9,5
Cam Thomas,G,22023,1630560,22300461,"JAN 02, 2024",BKN @ NOP,L,20,0,11,0.0,0,4,0.0,0,0,0.0,1,1,2,0,1,0,1,0,0,-14,1,BKN,NOP,BKN,85,,,2,2,0,2
Cam Thomas,G,22023,1630560,22300447,"DEC 31, 2023",BKN @ OKC,L,26,7,18,0.389,3,8,0.375,3,7,0.429,1,0,1,1,1,0,1,2,20,-9,1,BKN,OKC,BKN,108,,,22,21,21,2
Cam Thomas,G,22023,1630560,22300430,"DEC 29, 2023",BKN @ WAS,L,24,6,15,0.4,0,1,0.0,3,6,0.5,0,1,1,3,0,0,1,0,15,-14,1,BKN,WAS,BKN,104,,,19,16,18,4
Cam Thomas,G,22023,1630560,22300417,"DEC 27, 2023",BKN vs. MIL,L,12,4,9,0.444,0,2,0.0,0,0,0.0,0,0,0,0,1,0,0,1,8,-1,1,BKN,BKN,MIL,122,,,8,8,8,0
Cam Thomas,G,22023,1630560,22300406,"DEC 26, 2023",BKN @ DET,W,23,7,13,0.538,0,1,0.0,3,4,0.75,0,1,1,1,0,0,2,4,17,-4,1,BKN,DET,BKN,118,,,19,18,18,2
Cam Thomas,G,22023,1630560,22300394,"DEC 23, 2023",BKN vs. DET,W,28,7,16,0.438,1,3,0.333,5,5,1.0,0,2,2,3,1,0,2,3,20,2,1,BKN,BKN,DET,126,,,25,22,23,5
Cam Thomas,G,22023,1630560,22300383,"DEC 22, 2023",BKN vs. DEN,L,34,8,21,0.381,1,6,0.167,6,6,1.0,0,0,0,2,0,0,2,5,23,-5,1,BKN,BKN,DEN,117,,,25,23,25,2
Cam Thomas,G,22023,1630560,22300368,"DEC 20, 2023",BKN vs. NYK,L,32,8,18,0.444,4,7,0.571,0,1,0.0,1,1,2,5,0,0,1,2,20,-25,1,BKN,BKN,NYK,102,,,27,22,25,7
Cam Thomas,G,22023,1630560,22300357,"DEC 18, 2023",BKN @ UTA,L,37,12,23,0.522,5,7,0.714,3,3,1.0,2,2,4,3,1,1,3,1,32,-17,1,BKN,UTA,BKN,108,,,39,36,35,7
Cam Thomas,G,22023,1630560,22300339,"DEC 16, 2023",BKN @ GSW,L,37,15,24,0.625,5,13,0.385,6,6,1.0,0,5,5,2,1,0,5,5,41,-3,1,BKN,GSW,BKN,120,,,48,46,43,7
Cam Thomas,G,22023,1630560,22300322,"DEC 14, 2023",BKN @ DEN,L,27,5,13,0.385,0,2,0.0,3,6,0.5,0,3,3,0,0,0,0,3,13,-25,1,BKN,DEN,BKN,101,,,16,16,13,3
Cam Thomas,G,22023,1630560,22300317,"DEC 13, 2023",BKN @ PHX,W,28,6,17,0.353,4,8,0.5,8,8,1.0,1,1,2,4,1,1,2,0,24,-5,1,BKN,PHX,BKN,116,,,30,26,28,6
Cam Thomas,G,22023,1630560,22300303,"DEC 11, 2023",BKN @ SAC,L,31,8,21,0.381,2,6,0.333,2,2,1.0,0,0,0,2,0,0,2,2,20,-15,1,BKN,SAC,BKN,118,,,22,20,22,2
Cam Thomas,G,22023,1630560,22301219,"DEC 08, 2023",BKN vs. WAS,W,29,7,19,0.368,2,4,0.5,1,2,0.5,0,2,2,4,1,1,2,3,17,14,1,BKN,BKN,WAS,124,,,23,19,21,6
Cam Thomas,G,22023,1630560,22301209,"DEC 06, 2023",BKN @ ATL,W,27,3,10,0.3,0,2,0.0,0,0,0.0,0,1,1,1,0,0,5,2,6,-5,1,BKN,ATL,BKN,114,,,8,7,7,2
Cam Thomas,G,22023,1630560,22300282,"DEC 02, 2023",BKN vs. ORL,W,38,7,23,0.304,4,9,0.444,2,2,1.0,0,7,7,5,0,0,2,3,20,11,1,BKN,BKN,ORL,129,,,32,27,25,12
Cam Thomas,G,22023,1630560,22300266,"NOV 30, 2023",BKN vs. CHA,L,25,11,21,0.524,2,5,0.4,2,3,0.667,0,2,2,1,0,1,1,1,26,0,1,BKN,BKN,CHA,128,,,29,28,27,3
Cam Thomas,G,22023,1630560,22300160,"NOV 08, 2023",BKN vs. LAC,W,20,6,14,0.429,0,2,0.0,2,2,1.0,0,2,2,0,0,1,2,1,14,1,1,BKN,BKN,LAC,100,,,16,16,14,2
Cam Thomas,G,22023,1630560,22300149,"NOV 06, 2023",BKN vs. MIL,L,41,17,33,0.515,6,16,0.375,5,6,0.833,1,3,4,3,1,0,1,3,45,3,1,BKN,BKN,MIL,125,,,52,49,48,7
Cam Thomas,G,22023,1630560,22300136,"NOV 04, 2023",BKN vs. BOS,L,37,11,24,0.458,2,6,0.333,3,3,1.0,0,5,5,3,1,1,0,2,27,-9,1,BKN,BKN,BOS,114,,,35,32,30,8
Cam Thomas,G,22023,1630560,22300004,"NOV 03, 2023",BKN @ CHI,W,31,6,18,0.333,3,9,0.333,2,2,1.0,1,4,5,4,0,1,0,1,17,-5,1,BKN,CHI,BKN,109,,,26,22,21,9
Cam Thomas,G,22023,1630560,22300119,"NOV 01, 2023",BKN @ MIA,W,34,4,19,0.211,2,7,0.286,3,4,0.75,0,2,2,1,3,1,4,2,13,-9,1,BKN,MIA,BKN,109,,,16,15,14,3
Cam Thomas,G,22023,1630560,22300101,"OCT 30, 2023",BKN @ CHA,W,38,10,17,0.588,1,4,0.25,12,14,0.857,0,2,2,2,0,0,2,4,33,8,1,BKN,CHA,BKN,133,,,37,35,35,4
Cam Thomas,G,22023,1630560,22300084,"OCT 27, 2023",BKN @ DAL,L,33,12,19,0.632,1,4,0.25,5,5,1.0,0,7,7,2,1,1,0,2,30,3,1,BKN,DAL,BKN,120,,,39,37,32,9
Cam Thomas,G,22023,1630560,22300067,"OCT 25, 2023",BKN vs. CLE,L,25,13,21,0.619,2,5,0.4,8,11,0.727,0,3,3,2,1,0,1,0,36,5,1,BKN,BKN,CLE,113,,,41,39,38,5
Miles Bridges,F,22023,1628970,22300745,"FEB 09, 2024",CHA @ MIL,L,31,2,16,0.125,2,6,0.333,5,6,0.833,1,4,5,3,0,0,1,1,11,-39,1,CHA,MIL,CHA,80,,,19,16,14,8
Miles Bridges,F,22023,1628970,22300335,"DEC 16, 2023",CHA vs. PHI,L,31,3,14,0.214,1,7,0.143,2,2,1.0,0,10,10,0,0,0,1,1,9,-56,1,CHA,CHA,PHI,80,,,19,19,9,10
Miles Bridges,F,22023,1628970,22300635,"JAN 26, 2024",CHA vs. HOU,L,36,7,11,0.636,2,4,0.5,5,5,1.0,1,6,7,3,1,0,4,1,21,-29,1,CHA,CHA,HOU,104,,,31,28,24,10
Miles Bridges,F,22023,1628970,22300619,"JAN 24, 2024",CHA @ DET,L,41,7,21,0.333,3,9,0.333,3,4,0.75,0,10,10,2,2,0,3,1,20,3,1,CHA,DET,CHA,106,,,32,30,22,12
Miles Bridges,F,22023,1628970,22300610,"JAN 22, 2024",CHA @ MIN,W,40,10,23,0.435,3,10,0.3,5,5,1.0,1,4,5,2,1,0,1,2,28,-13,1,CHA,MIN,CHA,126,,,35,33,30,7
Miles Bridges,F,22023,1628970,22300584,"JAN 19, 2024",CHA vs. SAS,W,39,10,15,0.667,2,2,1.0,1,1,1.0,0,6,6,3,0,1,2,3,23,-4,1,CHA,CHA,SAS,124,,,32,29,26,9
Miles Bridges,F,22023,1628970,22300575,"JAN 17, 2024",CHA @ NOP,L,35,8,20,0.4,3,7,0.429,0,0,0.0,0,4,4,3,0,0,2,1,19,-12,1,CHA,NOP,CHA,108,,,26,23,22,7
Miles Bridges,F,22023,1628970,22300551,"JAN 14, 2024",CHA @ MIA,L,38,8,17,0.471,1,7,0.143,3,3,1.0,1,6,7,1,1,0,3,0,20,-16,1,CHA,MIA,CHA,85,,,28,27,21,8
Miles Bridges,F,22023,1628970,22300541,"JAN 12, 2024",CHA @ SAS,L,33,4,13,0.308,1,4,0.25,5,5,1.0,1,8,9,0,1,0,1,1,14,-32,1,CHA,SAS,CHA,99,,,23,23,14,9
Miles Bridges,F,22023,1628970,22300248,"NOV 26, 2023",CHA @ ORL,L,37,9,17,0.529,1,4,0.25,4,6,0.667,3,7,10,2,1,1,3,2,23,-6,1,CHA,ORL,CHA,117,,,35,33,25,12
Miles Bridges,F,22023,1628970,22300225,"NOV 22, 2023",CHA vs. WAS,W,37,11,18,0.611,3,7,0.429,8,10,0.8,2,8,10,0,2,0,3,2,33,-1,1,CHA,CHA,WAS,117,,,43,43,33,10
Miles Bridges,F,22023,1628970,22300217,"NOV 20, 2023",CHA vs. BOS,W,45,3,13,0.231,2,7,0.286,6,6,1.0,0,15,15,5,1,0,1,1,14,-6,1,CHA,CHA,BOS,121,,,34,29,19,20
Miles Bridges,F,22023,1628970,22300202,"NOV 18, 2023",CHA vs. NYK,L,32,8,12,0.667,1,1,1.0,2,3,0.667,0,4,4,3,1,1,1,2,19,2,1,CHA,CHA,NYK,108,,,26,23,22,7
Miles Bridges,F,22023,1628970,22300027,"NOV 17, 2023",CHA vs. MIL,L,33,6,13,0.462,2,5,0.4,3,3,1.0,0,5,5,4,2,0,2,1,17,-10,1,CHA,CHA,MIL,99,,,26,22,21,9
Miles Bridges,F,22023,1628970,22300751,"FEB 10, 2024",CHA vs. MEM,W,39,11,13,0.846,2,2,1.0,1,2,0.5,1,5,6,5,2,1,3,0,25,7,1,CHA,CHA,MEM,115,,,36,31,30,11
Miles Bridges,F,22023,1628970,22300726,"FEB 07, 2024",CHA vs. TOR,L,38,17,27,0.63,6,11,0.545,5,7,0.714,5,3,8,7,0,0,1,4,45,-6,1,CHA,CHA,TOR,117,,,60,53,52,15
Miles Bridges,F,22023,1628970,22300713,"FEB 05, 2024",CHA vs. LAL,L,40,16,26,0.615,5,10,0.5,4,4,1.0,0,0,0,4,0,0,1,1,41,-4,1,CHA,CHA,LAL,118,,,45,41,45,4
Miles Bridges,F,22023,1628970,22300707,"FEB 04, 2024",CHA vs. IND,L,38,8,23,0.348,1,5,0.2,2,2,1.0,1,5,6,3,0,1,2,2,19,-24,1,CHA,CHA,IND,99,,,28,25,22,9
Miles Bridges,F,22023,1628970,22300695,"FEB 02, 2024",CHA @ OKC,L,32,3,16,0.188,1,3,0.333,2,2,1.0,0,5,5,4,0,0,2,2,9,-36,1,CHA,OKC,CHA,106,,,18,14,13,9
Miles Bridges,F,22023,1628970,22300674,"JAN 31, 2024",CHA vs. CHI,L,41,11,20,0.55,6,13,0.462,2,2,1.0,2,13,15,5,1,3,0,1,30,3,1,CHA,CHA,CHI,110,,,50,45,35,20
Miles Bridges,F,22023,1628970,22300657,"JAN 29, 2024",CHA vs. NYK,L,39,10,20,0.5,1,6,0.167,0,2,0.0,1,9,10,5,3,1,3,2,21,-22,1,CHA,CHA,NYK,92,,,36,31,26,15
Miles Bridges,F,22023,1628970,22300647,"JAN 27, 2024",CHA vs. UTA,L,41,8,19,0.421,3,8,0.375,2,2,1.0,1,8,9,6,2,2,1,2,21,-14,1,CHA,CHA,UTA,122,,,36,30,27,15
Miles Bridges,F,22023,1628970,22300518,"JAN 10, 2024",CHA vs. SAC,L,34,10,21,0.476,4,8,0.5,0,0,0.0,1,6,7,6,1,0,3,1,24,-7,1,CHA,CHA,SAC,96,,,37,31,30,13
Miles Bridges,F,22023,1628970,22300365,"DEC 20, 2023",CHA @ IND,L,37,8,17,0.471,0,2,0.0,3,4,0.75,1,3,4,3,3,0,0,2,19,-15,1,CHA,IND,CHA,109,,,26,23,22,7
Miles Bridges,F,22023,1628970,22300057,"NOV 28, 2023",CHA @ NYK,L,32,5,12,0.417,2,3,0.667,1,2,0.5,0,4,4,2,2,1,2,2,13,-22,1,CHA,NYK,CHA,91,,,19,17,15,6
Miles Bridges,F,22023,1628970,22300506,"JAN 08, 2024",CHA vs. CHI,L,40,9,18,0.5,4,8,0.5,2,3,0.667,2,6,8,5,1,2,5,3,24,-2,1,CHA,CHA,CHI,109,,,37,32,29,13
Miles Bridges,F,22023,1628970,22300455,"JAN 01, 2024",CHA @ DEN,L,36,10,14,0.714,3,5,0.6,3,5,0.6,0,9,9,5,1,0,2,1,26,-23,1,CHA,DEN,CHA,91,,,40,35,31,14
Miles Bridges,F,22023,1628970,22300428,"DEC 28, 2023",CHA @ LAL,L,33,7,20,0.35,4,10,0.4,2,2,1.0,1,4,5,5,0,1,3,3,20,-33,1,CHA,LAL,CHA,110,,,30,25,25,10
Miles Bridges,F,22023,1628970,22300593,"JAN 20, 2024",CHA vs. PHI,L,40,9,22,0.409,5,10,0.5,2,2,1.0,0,11,11,3,0,1,2,2,25,8,1,CHA,CHA,PHI,89,,,39,36,28,14
Miles Bridges,F,22023,1628970,22300484,"JAN 05, 2024",CHA @ CHI,L,42,12,18,0.667,3,7,0.429,1,2,0.5,0,5,5,2,0,0,2,1,28,-9,1,CHA,CHI,CHA,87,,,35,33,30,7
Miles Bridges,F,22023,1628970,22300464,"JAN 02, 2024",CHA @ SAC,W,40,9,18,0.5,3,6,0.5,6,6,1.0,0,5,5,3,1,2,3,0,27,9,1,CHA,SAC,CHA,111,,,35,32,30,8
Miles Bridges,F,22023,1628970,22300436,"DEC 29, 2023",CHA @ PHX,L,37,4,16,0.25,1,7,0.143,2,2,1.0,0,7,7,6,1,0,3,2,11,0,1,CHA,PHX,CHA,119,,,24,18,17,13
Miles Bridges,F,22023,1628970,22300414,"DEC 26, 2023",CHA @ LAC,L,38,9,23,0.391,3,10,0.3,0,0,0.0,1,10,11,5,0,2,2,5,21,4,1,CHA,LAC,CHA,104,,,37,32,26,16
Miles Bridges,F,22023,1628970,22300390,"DEC 23, 2023",CHA vs. DEN,L,38,8,23,0.348,2,12,0.167,4,4,1.0,2,5,7,2,2,3,1,2,22,-5,1,CHA,CHA,DEN,95,,,31,29,24,9
Miles Bridges,F,22023,1628970,22300326,"DEC 15, 2023",CHA vs. NOP,L,39,10,24,0.417,2,8,0.25,5,6,0.833,2,8,10,2,1,0,3,5,27,-11,1,CHA,CHA,NOP,105,,,39,37,29,12
Miles Bridges,F,22023,1628970,22300312,"DEC 13, 2023",CHA @ MIA,L,34,9,19,0.474,1,8,0.125,0,0,0.0,1,4,5,4,2,0,4,2,19,3,1,CHA,MIA,CHA,104,,,28,24,23,9
Miles Bridges,F,22023,1628970,22300292,"DEC 11, 2023",CHA vs. MIA,L,34,7,14,0.5,2,6,0.333,2,2,1.0,1,3,4,1,0,0,2,3,18,3,1,CHA,CHA,MIA,114,,,23,22,19,5
Miles Bridges,F,22023,1628970,22301216,"DEC 08, 2023",CHA vs. TOR,W,38,8,15,0.533,3,6,0.5,3,3,1.0,0,8,8,3,2,0,1,0,22,2,1,CHA,CHA,TOR,119,,,33,30,25,11
Miles Bridges,F,22023,1628970,22301211,"DEC 06, 2023",CHA @ CHI,L,40,7,15,0.467,2,8,0.25,0,0,0.0,2,6,8,2,3,0,1,3,16,-6,1,CHA,CHI,CHA,100,,,26,24,18,10
Miles Bridges,F,22023,1628970,22300281,"DEC 02, 2023",CHA vs. MIN,L,36,8,18,0.444,2,5,0.4,4,4,1.0,1,2,3,4,1,0,1,5,22,-7,1,CHA,CHA,MIN,117,,,29,25,26,7
Miles Bridges,F,22023,1628970,22300266,"NOV 30, 2023",CHA @ BKN,W,38,9,15,0.6,3,4,0.75,2,2,1.0,1,4,5,2,0,0,0,2,23,4,1,CHA,BKN,CHA,129,,,30,28,25,7
RJ Barrett,F,22023,1629628,22300756,"FEB 10, 2024",TOR vs. CLE,L,33,5,14,0.357,0,2,0.0,4,7,0.571,2,5,7,1,1,0,2,0,14,-12,1,TOR,TOR,CLE,95,,,22,21,15,8
RJ Barrett,F,22023,1629628,22300388,"DEC 23, 2023",NYK vs. MIL,L,29,5,17,0.294,2,5,0.4,1,2,0.5,1,6,7,1,0,1,1,1,13,-8,1,NYK,NYK,MIL,109,,,21,20,14,8
RJ Barrett,F,22023,1629628,22300368,"DEC 20, 2023",NYK @ BKN,W,27,5,11,0.455,0,1,0.0,4,4,1.0,0,5,5,2,1,1,2,2,14,13,1,NYK,BKN,NYK,119,,,21,19,16,7
RJ Barrett,F,22023,1629628,22300343,"DEC 16, 2023",NYK @ LAC,L,28,7,15,0.467,2,7,0.286,2,2,1.0,1,4,5,0,0,1,1,1,18,-30,1,NYK,LAC,NYK,120,,,23,23,18,5
RJ Barrett,F,22023,1629628,22300333,"DEC 15, 2023",NYK @ PHX,W,29,6,10,0.6,1,2,0.5,8,8,1.0,1,1,2,3,0,1,1,2,21,0,1,NYK,PHX,NYK,139,,,26,23,24,5
RJ Barrett,F,22023,1629628,22301201,"DEC 05, 2023",NYK @ MIL,L,31,7,18,0.389,1,4,0.25,8,8,1.0,3,5,8,1,0,0,2,0,23,-6,1,NYK,MIL,NYK,122,,,32,31,24,9
RJ Barrett,F,22023,1629628,22300221,"NOV 20, 2023",NYK @ MIN,L,22,4,13,0.308,3,4,0.75,3,4,0.75,2,5,7,1,1,0,4,5,14,-14,1,NYK,MIN,NYK,100,,,22,21,15,8
RJ Barrett,F,22023,1629628,22300177,"NOV 12, 2023",NYK vs. CHA,W,31,9,16,0.563,4,6,0.667,2,3,0.667,0,4,4,2,1,1,1,1,24,26,1,NYK,NYK,CHA,129,,,30,28,26,6
RJ Barrett,F,22023,1629628,22300161,"NOV 08, 2023",NYK vs. SAS,W,32,8,17,0.471,5,9,0.556,3,3,1.0,0,2,2,6,1,0,0,2,24,26,1,NYK,NYK,SAS,126,,,32,26,30,8
RJ Barrett,F,22023,1629628,22300112,"OCT 31, 2023",NYK @ CLE,W,25,5,13,0.385,3,5,0.6,3,4,0.75,1,2,3,0,0,0,1,2,16,14,1,NYK,CLE,NYK,109,,,19,19,16,3
RJ Barrett,F,22023,1629628,22300744,"FEB 09, 2024",TOR vs. HOU,W,36,8,12,0.667,1,3,0.333,4,5,0.8,1,4,5,7,1,0,2,2,21,8,1,TOR,TOR,HOU,100,,,33,26,28,12
RJ Barrett,F,22023,1629628,22300726,"FEB 07, 2024",TOR @ CHA,W,33,9,15,0.6,4,6,0.667,1,1,1.0,0,6,6,5,0,1,1,4,23,0,1,TOR,CHA,TOR,123,,,34,29,28,11
RJ Barrett,F,22023,1629628,22300710,"FEB 04, 2024",TOR @ OKC,L,43,9,16,0.563,2,5,0.4,3,4,0.75,1,6,7,4,1,1,4,3,23,-13,1,TOR,OKC,TOR,127,,,34,30,27,11
RJ Barrett,F,22023,1629628,22300637,"JAN 26, 2024",TOR vs. LAC,L,36,9,19,0.474,0,2,0.0,4,8,0.5,2,4,6,4,1,0,3,1,22,-27,1,TOR,TOR,LAC,107,,,32,28,26,10
RJ Barrett,F,22023,1629628,22300609,"JAN 22, 2024",TOR vs. MEM,L,37,12,18,0.667,0,2,0.0,5,6,0.833,1,8,9,1,0,1,2,3,29,-9,1,TOR,TOR,MEM,100,,,39,38,30,10
RJ Barrett,F,22023,1629628,22300596,"JAN 20, 2024",TOR @ NYK,L,29,8,15,0.533,1,3,0.333,3,9,0.333,2,6,8,4,1,0,0,2,20,-14,1,TOR,NYK,TOR,94,,,32,28,24,12
RJ Barrett,F,22023,1629628,22300580,"JAN 18, 2024",TOR vs. CHI,L,35,6,16,0.375,1,6,0.167,4,5,0.8,0,4,4,6,1,0,1,2,17,-5,1,TOR,TOR,CHI,100,,,27,21,23,10
RJ Barrett,F,22023,1629628,22300574,"JAN 17, 2024",TOR vs. MIA,W,36,9,14,0.643,1,3,0.333,7,13,0.538,3,5,8,3,0,0,0,1,26,20,1,TOR,TOR,MIA,115,,,37,34,29,11
RJ Barrett,F,22023,1629628,22300563,"JAN 15, 2024",TOR vs. BOS,L,36,11,19,0.579,0,4,0.0,2,3,0.667,0,9,9,4,0,0,0,4,24,-4,1,TOR,TOR,BOS,94,,,37,33,28,13
RJ Barrett,F,22023,1629628,22300540,"JAN 12, 2024",TOR @ UTA,L,30,2,9,0.222,0,2,0.0,0,0,0.0,0,7,7,2,1,3,2,4,4,-16,1,TOR,UTA,TOR,104,,,13,11,6,9
RJ Barrett,F,22023,1629628,22300526,"JAN 10, 2024",TOR @ LAC,L,37,10,16,0.625,4,6,0.667,0,0,0.0,1,4,5,4,0,0,4,4,24,0,1,TOR,LAC,TOR,111,,,33,29,28,9
RJ Barrett,F,22023,1629628,22300516,"JAN 09, 2024",TOR @ LAL,L,35,10,13,0.769,1,3,0.333,2,3,0.667,1,9,10,5,2,0,3,4,23,10,1,TOR,LAL,TOR,131,,,38,33,28,15
RJ Barrett,F,22023,1629628,22300504,"JAN 07, 2024",TOR @ GSW,W,36,13,20,0.65,5,8,0.625,6,8,0.75,0,6,6,6,1,0,0,3,37,26,1,TOR,GSW,TOR,131,,,49,43,43,12
RJ Barrett,F,22023,1629628,22300492,"JAN 05, 2024",TOR @ SAC,L,27,4,8,0.5,2,4,0.5,4,4,1.0,1,3,4,2,0,1,0,2,14,-19,1,TOR,SAC,TOR,120,,,20,18,16,6
RJ Barrett,F,22023,1629628,22300470,"JAN 03, 2024",TOR @ MEM,W,33,5,12,0.417,2,5,0.4,2,3,0.667,0,7,7,3,1,0,3,3,14,-2,1,TOR,MEM,TOR,116,,,24,21,17,10
RJ Barrett,F,22023,1629628,22300452,"JAN 01, 2024",TOR vs. CLE,W,29,6,12,0.5,1,2,0.5,6,8,0.75,3,6,9,1,0,0,5,5,19,-7,1,TOR,TOR,CLE,124,,,29,28,20,10
RJ Barrett,F,22023,1629628,22300429,"DEC 29, 2023",NYK @ ORL,L,37,7,17,0.412,1,5,0.2,4,5,0.8,2,4,6,2,1,0,2,4,19,-22,1,NYK,ORL,NYK,106,,,27,25,21,8
RJ Barrett,F,22023,1629628,22300419,"DEC 27, 2023",NYK @ OKC,L,30,5,14,0.357,1,7,0.143,3,6,0.5,0,4,4,4,0,0,5,5,14,-9,1,NYK,OKC,NYK,116,,,22,18,18,8
RJ Barrett,F,22023,1629628,22300401,"DEC 25, 2023",NYK vs. MIL,W,28,8,14,0.571,2,5,0.4,3,4,0.75,1,5,6,1,1,0,3,3,21,-6,1,NYK,NYK,MIL,129,,,28,27,22,7
RJ Barrett,F,22023,1629628,22300359,"DEC 18, 2023",NYK @ LAL,W,30,3,10,0.3,0,2,0.0,6,6,1.0,1,4,5,4,0,1,1,2,12,-7,1,NYK,LAL,NYK,114,,,21,17,16,9
RJ Barrett,F,22023,1629628,22300318,"DEC 13, 2023",NYK @ UTA,L,24,3,16,0.188,0,7,0.0,3,4,0.75,1,5,6,2,0,0,0,2,9,-4,1,NYK,UTA,NYK,113,,,17,15,11,8
RJ Barrett,F,22023,1629628,22300297,"DEC 11, 2023",NYK vs. TOR,W,32,11,21,0.524,3,8,0.375,2,4,0.5,0,3,3,2,1,1,1,1,27,1,1,NYK,NYK,TOR,136,,,32,30,29,5
RJ Barrett,F,22023,1629628,22301227,"DEC 08, 2023",NYK @ BOS,L,31,9,16,0.563,2,5,0.4,3,4,0.75,1,2,3,3,1,0,0,0,23,-12,1,NYK,BOS,NYK,123,,,29,26,26,6
RJ Barrett,F,22023,1629628,22300276,"DEC 01, 2023",NYK @ TOR,W,27,6,18,0.333,1,6,0.167,2,3,0.667,1,3,4,6,0,0,2,1,15,-5,1,NYK,TOR,NYK,119,,,25,19,21,10
RJ Barrett,F,22023,1629628,22300268,"NOV 30, 2023",NYK vs. DET,W,24,5,12,0.417,1,6,0.167,4,6,0.667,0,1,1,2,0,0,2,2,15,-5,1,NYK,NYK,DET,118,,,18,16,17,3
RJ Barrett,F,22023,1629628,22300057,"NOV 28, 2023",NYK vs. CHA,W,28,3,13,0.231,1,4,0.25,9,9,1.0,0,3,3,2,1,0,1,1,16,0,1,NYK,NYK,CHA,115,,,21,19,18,5
RJ Barrett,F,22023,1629628,22300247,"NOV 26, 2023",NYK vs. PHX,L,31,3,11,0.273,0,2,0.0,3,4,0.75,0,2,2,1,0,1,0,3,9,-5,1,NYK,NYK,PHX,113,,,12,11,10,3
RJ Barrett,F,22023,1629628,22300045,"NOV 24, 2023",NYK vs. MIA,W,34,7,14,0.5,1,5,0.2,3,3,1.0,0,7,7,1,0,0,3,2,18,9,1,NYK,NYK,MIA,100,,,26,25,19,8
RJ Barrett,F,22023,1629628,22300202,"NOV 18, 2023",NYK @ CHA,W,26,5,15,0.333,1,5,0.2,4,5,0.8,0,3,3,3,1,0,1,0,15,16,1,NYK,CHA,NYK,122,,,21,18,18,6
RJ Barrett,F,22023,1629628,22300151,"NOV 06, 2023",NYK vs. LAC,W,31,9,16,0.563,2,4,0.5,6,6,1.0,1,5,6,4,0,0,5,1,26,13,1,NYK,NYK,LAC,111,,,36,32,30,10
RJ Barrett,F,22023,1629628,22300090,"OCT 28, 2023",NYK @ NOP,L,30,7,16,0.438,1,6,0.167,3,4,0.75,0,3,3,2,0,1,3,0,18,-15,1,NYK,NOP,NYK,87,,,23,21,20,5
RJ Barrett,F,22023,1629628,22300079,"OCT 27, 2023",NYK @ ATL,W,34,9,15,0.6,3,5,0.6,5,6,0.833,1,2,3,6,1,0,3,2,26,6,1,NYK,ATL,NYK,126,,,35,29,32,9
RJ Barrett,F,22023,1629628,22300065,"OCT 25, 2023",NYK vs. BOS,L,36,8,20,0.4,2,5,0.4,6,7,0.857,1,2,3,2,1,0,2,0,24,6,1,NYK,NYK,BOS,104,,,29,27,26,5
RJ Barrett,F,22023,1629628,22300756,"FEB 10, 2024",TOR vs. CLE,L,33,5,14,0.357,0,2,0.0,4,7,0.571,2,5,7,1,1,0,2,0,14,-12,1,TOR,TOR,CLE,95,,,22,21,15,8
RJ Barrett,F,22023,1629628,22300388,"DEC 23, 2023",NYK vs. MIL,L,29,5,17,0.294,2,5,0.4,1,2,0.5,1,6,7,1,0,1,1,1,13,-8,1,NYK,NYK,MIL,109,,,21,20,14,8
RJ Barrett,F,22023,1629628,22300368,"DEC 20, 2023",NYK @ BKN,W,27,5,11,0.455,0,1,0.0,4,4,1.0,0,5,5,2,1,1,2,2,14,13,1,NYK,BKN,NYK,119,,,21,19,16,7
RJ Barrett,F,22023,1629628,22300343,"DEC 16, 2023",NYK @ LAC,L,28,7,15,0.467,2,7,0.286,2,2,1.0,1,4,5,0,0,1,1,1,18,-30,1,NYK,LAC,NYK,120,,,23,23,18,5
RJ Barrett,F,22023,1629628,22300333,"DEC 15, 2023",NYK @ PHX,W,29,6,10,0.6,1,2,0.5,8,8,1.0,1,1,2,3,0,1,1,2,21,0,1,NYK,PHX,NYK,139,,,26,23,24,5
RJ Barrett,F,22023,1629628,22301201,"DEC 05, 2023",NYK @ MIL,L,31,7,18,0.389,1,4,0.25,8,8,1.0,3,5,8,1,0,0,2,0,23,-6,1,NYK,MIL,NYK,122,,,32,31,24,9
RJ Barrett,F,22023,1629628,22300221,"NOV 20, 2023",NYK @ MIN,L,22,4,13,0.308,3,4,0.75,3,4,0.75,2,5,7,1,1,0,4,5,14,-14,1,NYK,MIN,NYK,100,,,22,21,15,8
RJ Barrett,F,22023,1629628,22300177,"NOV 12, 2023",NYK vs. CHA,W,31,9,16,0.563,4,6,0.667,2,3,0.667,0,4,4,2,1,1,1,1,24,26,1,NYK,NYK,CHA,129,,,30,28,26,6
RJ Barrett,F,22023,1629628,22300161,"NOV 08, 2023",NYK vs. SAS,W,32,8,17,0.471,5,9,0.556,3,3,1.0,0,2,2,6,1,0,0,2,24,26,1,NYK,NYK,SAS,126,,,32,26,30,8
RJ Barrett,F,22023,1629628,22300112,"OCT 31, 2023",NYK @ CLE,W,25,5,13,0.385,3,5,0.6,3,4,0.75,1,2,3,0,0,0,1,2,16,14,1,NYK,CLE,NYK,109,,,19,19,16,3
RJ Barrett,F,22023,1629628,22300744,"FEB 09, 2024",TOR vs. HOU,W,36,8,12,0.667,1,3,0.333,4,5,0.8,1,4,5,7,1,0,2,2,21,8,1,TOR,TOR,HOU,100,,,33,26,28,12
RJ Barrett,F,22023,1629628,22300726,"FEB 07, 2024",TOR @ CHA,W,33,9,15,0.6,4,6,0.667,1,1,1.0,0,6,6,5,0,1,1,4,23,0,1,TOR,CHA,TOR,123,,,34,29,28,11
RJ Barrett,F,22023,1629628,22300710,"FEB 04, 2024",TOR @ OKC,L,43,9,16,0.563,2,5,0.4,3,4,0.75,1,6,7,4,1,1,4,3,23,-13,1,TOR,OKC,TOR,127,,,34,30,27,11
RJ Barrett,F,22023,1629628,22300637,"JAN 26, 2024",TOR vs. LAC,L,36,9,19,0.474,0,2,0.0,4,8,0.5,2,4,6,4,1,0,3,1,22,-27,1,TOR,TOR,LAC,107,,,32,28,26,10
RJ Barrett,F,22023,1629628,22300609,"JAN 22, 2024",TOR vs. MEM,L,37,12,18,0.667,0,2,0.0,5,6,0.833,1,8,9,1,0,1,2,3,29,-9,1,TOR,TOR,MEM,100,,,39,38,30,10
RJ Barrett,F,22023,1629628,22300596,"JAN 20, 2024",TOR @ NYK,L,29,8,15,0.533,1,3,0.333,3,9,0.333,2,6,8,4,1,0,0,2,20,-14,1,TOR,NYK,TOR,94,,,32,28,24,12
RJ Barrett,F,22023,1629628,22300580,"JAN 18, 2024",TOR vs. CHI,L,35,6,16,0.375,1,6,0.167,4,5,0.8,0,4,4,6,1,0,1,2,17,-5,1,TOR,TOR,CHI,100,,,27,21,23,10
RJ Barrett,F,22023,1629628,22300574,"JAN 17, 2024",TOR vs. MIA,W,36,9,14,0.643,1,3,0.333,7,13,0.538,3,5,8,3,0,0,0,1,26,20,1,TOR,TOR,MIA,115,,,37,34,29,11
RJ Barrett,F,22023,1629628,22300563,"JAN 15, 2024",TOR vs. BOS,L,36,11,19,0.579,0,4,0.0,2,3,0.667,0,9,9,4,0,0,0,4,24,-4,1,TOR,TOR,BOS,94,,,37,33,28,13
RJ Barrett,F,22023,1629628,22300540,"JAN 12, 2024",TOR @ UTA,L,30,2,9,0.222,0,2,0.0,0,0,0.0,0,7,7,2,1,3,2,4,4,-16,1,TOR,UTA,TOR,104,,,13,11,6,9
RJ Barrett,F,22023,1629628,22300526,"JAN 10, 2024",TOR @ LAC,L,37,10,16,0.625,4,6,0.667,0,0,0.0,1,4,5,4,0,0,4,4,24,0,1,TOR,LAC,TOR,111,,,33,29,28,9
RJ Barrett,F,22023,1629628,22300516,"JAN 09, 2024",TOR @ LAL,L,35,10,13,0.769,1,3,0.333,2,3,0.667,1,9,10,5,2,0,3,4,23,10,1,TOR,LAL,TOR,131,,,38,33,28,15
RJ Barrett,F,22023,1629628,22300504,"JAN 07, 2024",TOR @ GSW,W,36,13,20,0.65,5,8,0.625,6,8,0.75,0,6,6,6,1,0,0,3,37,26,1,TOR,GSW,TOR,131,,,49,43,43,12
RJ Barrett,F,22023,1629628,22300492,"JAN 05, 2024",TOR @ SAC,L,27,4,8,0.5,2,4,0.5,4,4,1.0,1,3,4,2,0,1,0,2,14,-19,1,TOR,SAC,TOR,120,,,20,18,16,6
RJ Barrett,F,22023,1629628,22300470,"JAN 03, 2024",TOR @ MEM,W,33,5,12,0.417,2,5,0.4,2,3,0.667,0,7,7,3,1,0,3,3,14,-2,1,TOR,MEM,TOR,116,,,24,21,17,10
RJ Barrett,F,22023,1629628,22300452,"JAN 01, 2024",TOR vs. CLE,W,29,6,12,0.5,1,2,0.5,6,8,0.75,3,6,9,1,0,0,5,5,19,-7,1,TOR,TOR,CLE,124,,,29,28,20,10
RJ Barrett,F,22023,1629628,22300429,"DEC 29, 2023",NYK @ ORL,L,37,7,17,0.412,1,5,0.2,4,5,0.8,2,4,6,2,1,0,2,4,19,-22,1,NYK,ORL,NYK,106,,,27,25,21,8
RJ Barrett,F,22023,1629628,22300419,"DEC 27, 2023",NYK @ OKC,L,30,5,14,0.357,1,7,0.143,3,6,0.5,0,4,4,4,0,0,5,5,14,-9,1,NYK,OKC,NYK,116,,,22,18,18,8
RJ Barrett,F,22023,1629628,22300401,"DEC 25, 2023",NYK vs. MIL,W,28,8,14,0.571,2,5,0.4,3,4,0.75,1,5,6,1,1,0,3,3,21,-6,1,NYK,NYK,MIL,129,,,28,27,22,7
RJ Barrett,F,22023,1629628,22300359,"DEC 18, 2023",NYK @ LAL,W,30,3,10,0.3,0,2,0.0,6,6,1.0,1,4,5,4,0,1,1,2,12,-7,1,NYK,LAL,NYK,114,,,21,17,16,9
RJ Barrett,F,22023,1629628,22300318,"DEC 13, 2023",NYK @ UTA,L,24,3,16,0.188,0,7,0.0,3,4,0.75,1,5,6,2,0,0,0,2,9,-4,1,NYK,UTA,NYK,113,,,17,15,11,8
RJ Barrett,F,22023,1629628,22300297,"DEC 11, 2023",NYK vs. TOR,W,32,11,21,0.524,3,8,0.375,2,4,0.5,0,3,3,2,1,1,1,1,27,1,1,NYK,NYK,TOR,136,,,32,30,29,5
RJ Barrett,F,22023,1629628,22301227,"DEC 08, 2023",NYK @ BOS,L,31,9,16,0.563,2,5,0.4,3,4,0.75,1,2,3,3,1,0,0,0,23,-12,1,NYK,BOS,NYK,123,,,29,26,26,6
RJ Barrett,F,22023,1629628,22300276,"DEC 01, 2023",NYK @ TOR,W,27,6,18,0.333,1,6,0.167,2,3,0.667,1,3,4,6,0,0,2,1,15,-5,1,NYK,TOR,NYK,119,,,25,19,21,10
RJ Barrett,F,22023,1629628,22300268,"NOV 30, 2023",NYK vs. DET,W,24,5,12,0.417,1,6,0.167,4,6,0.667,0,1,1,2,0,0,2,2,15,-5,1,NYK,NYK,DET,118,,,18,16,17,3
RJ Barrett,F,22023,1629628,22300057,"NOV 28, 2023",NYK vs. CHA,W,28,3,13,0.231,1,4,0.25,9,9,1.0,0,3,3,2,1,0,1,1,16,0,1,NYK,NYK,CHA,115,,,21,19,18,5
RJ Barrett,F,22023,1629628,22300247,"NOV 26, 2023",NYK vs. PHX,L,31,3,11,0.273,0,2,0.0,3,4,0.75,0,2,2,1,0,1,0,3,9,-5,1,NYK,NYK,PHX,113,,,12,11,10,3
RJ Barrett,F,22023,1629628,22300045,"NOV 24, 2023",NYK vs. MIA,W,34,7,14,0.5,1,5,0.2,3,3,1.0,0,7,7,1,0,0,3,2,18,9,1,NYK,NYK,MIA,100,,,26,25,19,8
RJ Barrett,F,22023,1629628,22300202,"NOV 18, 2023",NYK @ CHA,W,26,5,15,0.333,1,5,0.2,4,5,0.8,0,3,3,3,1,0,1,0,15,16,1,NYK,CHA,NYK,122,,,21,18,18,6
RJ Barrett,F,22023,1629628,22300151,"NOV 06, 2023",NYK vs. LAC,W,31,9,16,0.563,2,4,0.5,6,6,1.0,1,5,6,4,0,0,5,1,26,13,1,NYK,NYK,LAC,111,,,36,32,30,10
RJ Barrett,F,22023,1629628,22300090,"OCT 28, 2023",NYK @ NOP,L,30,7,16,0.438,1,6,0.167,3,4,0.75,0,3,3,2,0,1,3,0,18,-15,1,NYK,NOP,NYK,87,,,23,21,20,5
RJ Barrett,F,22023,1629628,22300079,"OCT 27, 2023",NYK @ ATL,W,34,9,15,0.6,3,5,0.6,5,6,0.833,1,2,3,6,1,0,3,2,26,6,1,NYK,ATL,NYK,126,,,35,29,32,9
RJ Barrett,F,22023,1629628,22300065,"OCT 25, 2023",NYK vs. BOS,L,36,8,20,0.4,2,5,0.4,6,7,0.857,1,2,3,2,1,0,2,0,24,6,1,NYK,NYK,BOS,104,,,29,27,26,5
Bam Adebayo,C,22023,1628389,22300730,"FEB 07, 2024",MIA vs. SAS,W,29,10,14,0.714,0,0,0.0,0,2,0.0,0,5,5,2,1,0,1,4,20,17,1,MIA,MIA,SAS,116,19.5,Points,27,25,22,7
Bam Adebayo,C,22023,1628389,22300730,"FEB 07, 2024",MIA vs. SAS,W,29,10,14,0.714,0,0,0.0,0,2,0.0,0,5,5,2,1,0,1,4,20,17,1,MIA,MIA,SAS,116,10.5,Rebounds,27,25,22,7
Bam Adebayo,C,22023,1628389,22300730,"FEB 07, 2024",MIA vs. SAS,W,29,10,14,0.714,0,0,0.0,0,2,0.0,0,5,5,2,1,0,1,4,20,17,1,MIA,MIA,SAS,116,33.5,Pts+Rebs+Asts,27,25,22,7
Bam Adebayo,C,22023,1628389,22300730,"FEB 07, 2024",MIA vs. SAS,W,29,10,14,0.714,0,0,0.0,0,2,0.0,0,5,5,2,1,0,1,4,20,17,1,MIA,MIA,SAS,116,40.0,Fantasy Score,27,25,22,7
Bam Adebayo,C,22023,1628389,22300730,"FEB 07, 2024",MIA vs. SAS,W,29,10,14,0.714,0,0,0.0,0,2,0.0,0,5,5,2,1,0,1,4,20,17,1,MIA,MIA,SAS,116,29.5,Pts+Rebs,27,25,22,7
Bam Adebayo,C,22023,1628389,22300730,"FEB 07, 2024",MIA vs. SAS,W,29,10,14,0.714,0,0,0.0,0,2,0.0,0,5,5,2,1,0,1,4,20,17,1,MIA,MIA,SAS,116,23.5,Pts+Asts,27,25,22,7
Bam Adebayo,C,22023,1628389,22300730,"FEB 07, 2024",MIA vs. SAS,W,29,10,14,0.714,0,0,0.0,0,2,0.0,0,5,5,2,1,0,1,4,20,17,1,MIA,MIA,SAS,116,14.5,Rebs+Asts,27,25,22,7
Bam Adebayo,C,22023,1628389,22300721,"FEB 06, 2024",MIA vs. ORL,W,30,7,9,0.778,0,0,0.0,0,0,0.0,2,6,8,3,0,1,3,3,14,32,1,MIA,MIA,ORL,121,19.5,Points,25,22,17,11
Bam Adebayo,C,22023,1628389,22300721,"FEB 06, 2024",MIA vs. ORL,W,30,7,9,0.778,0,0,0.0,0,0,0.0,2,6,8,3,0,1,3,3,14,32,1,MIA,MIA,ORL,121,10.5,Rebounds,25,22,17,11
Bam Adebayo,C,22023,1628389,22300721,"FEB 06, 2024",MIA vs. ORL,W,30,7,9,0.778,0,0,0.0,0,0,0.0,2,6,8,3,0,1,3,3,14,32,1,MIA,MIA,ORL,121,33.5,Pts+Rebs+Asts,25,22,17,11
Bam Adebayo,C,22023,1628389,22300721,"FEB 06, 2024",MIA vs. ORL,W,30,7,9,0.778,0,0,0.0,0,0,0.0,2,6,8,3,0,1,3,3,14,32,1,MIA,MIA,ORL,121,40.0,Fantasy Score,25,22,17,11
Bam Adebayo,C,22023,1628389,22300721,"FEB 06, 2024",MIA vs. ORL,W,30,7,9,0.778,0,0,0.0,0,0,0.0,2,6,8,3,0,1,3,3,14,32,1,MIA,MIA,ORL,121,29.5,Pts+Rebs,25,22,17,11
Bam Adebayo,C,22023,1628389,22300721,"FEB 06, 2024",MIA vs. ORL,W,30,7,9,0.778,0,0,0.0,0,0,0.0,2,6,8,3,0,1,3,3,14,32,1,MIA,MIA,ORL,121,23.5,Pts+Asts,25,22,17,11
Bam Adebayo,C,22023,1628389,22300721,"FEB 06, 2024",MIA vs. ORL,W,30,7,9,0.778,0,0,0.0,0,0,0.0,2,6,8,3,0,1,3,3,14,32,1,MIA,MIA,ORL,121,14.5,Rebs+Asts,25,22,17,11
Bam Adebayo,C,22023,1628389,22300708,"FEB 04, 2024",MIA vs. LAC,L,35,5,13,0.385,0,0,0.0,4,4,1.0,4,9,13,3,3,0,2,1,14,-8,1,MIA,MIA,LAC,95,19.5,Points,30,27,17,16
Bam Adebayo,C,22023,1628389,22300708,"FEB 04, 2024",MIA vs. LAC,L,35,5,13,0.385,0,0,0.0,4,4,1.0,4,9,13,3,3,0,2,1,14,-8,1,MIA,MIA,LAC,95,10.5,Rebounds,30,27,17,16
Bam Adebayo,C,22023,1628389,22300708,"FEB 04, 2024",MIA vs. LAC,L,35,5,13,0.385,0,0,0.0,4,4,1.0,4,9,13,3,3,0,2,1,14,-8,1,MIA,MIA,LAC,95,33.5,Pts+Rebs+Asts,30,27,17,16
Bam Adebayo,C,22023,1628389,22300708,"FEB 04, 2024",MIA vs. LAC,L,35,5,13,0.385,0,0,0.0,4,4,1.0,4,9,13,3,3,0,2,1,14,-8,1,MIA,MIA,LAC,95,40.0,Fantasy Score,30,27,17,16
Bam Adebayo,C,22023,1628389,22300708,"FEB 04, 2024",MIA vs. LAC,L,35,5,13,0.385,0,0,0.0,4,4,1.0,4,9,13,3,3,0,2,1,14,-8,1,MIA,MIA,LAC,95,29.5,Pts+Rebs,30,27,17,16
Bam Adebayo,C,22023,1628389,22300708,"FEB 04, 2024",MIA vs. LAC,L,35,5,13,0.385,0,0,0.0,4,4,1.0,4,9,13,3,3,0,2,1,14,-8,1,MIA,MIA,LAC,95,23.5,Pts+Asts,30,27,17,16
Bam Adebayo,C,22023,1628389,22300708,"FEB 04, 2024",MIA vs. LAC,L,35,5,13,0.385,0,0,0.0,4,4,1.0,4,9,13,3,3,0,2,1,14,-8,1,MIA,MIA,LAC,95,14.5,Rebs+Asts,30,27,17,16
Bam Adebayo,C,22023,1628389,22300689,"FEB 02, 2024",MIA @ WAS,W,33,8,14,0.571,0,0,0.0,4,7,0.571,2,12,14,1,0,1,4,3,20,-8,1,MIA,WAS,MIA,110,19.5,Points,35,34,21,15
Bam Adebayo,C,22023,1628389,22300689,"FEB 02, 2024",MIA @ WAS,W,33,8,14,0.571,0,0,0.0,4,7,0.571,2,12,14,1,0,1,4,3,20,-8,1,MIA,WAS,MIA,110,10.5,Rebounds,35,34,21,15
Bam Adebayo,C,22023,1628389,22300689,"FEB 02, 2024",MIA @ WAS,W,33,8,14,0.571,0,0,0.0,4,7,0.571,2,12,14,1,0,1,4,3,20,-8,1,MIA,WAS,MIA,110,33.5,Pts+Rebs+Asts,35,34,21,15
Bam Adebayo,C,22023,1628389,22300689,"FEB 02, 2024",MIA @ WAS,W,33,8,14,0.571,0,0,0.0,4,7,0.571,2,12,14,1,0,1,4,3,20,-8,1,MIA,WAS,MIA,110,40.0,Fantasy Score,35,34,21,15
Bam Adebayo,C,22023,1628389,22300689,"FEB 02, 2024",MIA @ WAS,W,33,8,14,0.571,0,0,0.0,4,7,0.571,2,12,14,1,0,1,4,3,20,-8,1,MIA,WAS,MIA,110,29.5,Pts+Rebs,35,34,21,15
Bam Adebayo,C,22023,1628389,22300689,"FEB 02, 2024",MIA @ WAS,W,33,8,14,0.571,0,0,0.0,4,7,0.571,2,12,14,1,0,1,4,3,20,-8,1,MIA,WAS,MIA,110,23.5,Pts+Asts,35,34,21,15
Bam Adebayo,C,22023,1628389,22300689,"FEB 02, 2024",MIA @ WAS,W,33,8,14,0.571,0,0,0.0,4,7,0.571,2,12,14,1,0,1,4,3,20,-8,1,MIA,WAS,MIA,110,14.5,Rebs+Asts,35,34,21,15
Bam Adebayo,C,22023,1628389,22300678,"JAN 31, 2024",MIA vs. SAC,W,32,8,14,0.571,0,0,0.0,0,0,0.0,2,9,11,4,0,0,0,4,16,2,1,MIA,MIA,SAC,115,19.5,Points,31,27,20,15
Bam Adebayo,C,22023,1628389,22300678,"JAN 31, 2024",MIA vs. SAC,W,32,8,14,0.571,0,0,0.0,0,0,0.0,2,9,11,4,0,0,0,4,16,2,1,MIA,MIA,SAC,115,10.5,Rebounds,31,27,20,15
Bam Adebayo,C,22023,1628389,22300678,"JAN 31, 2024",MIA vs. SAC,W,32,8,14,0.571,0,0,0.0,0,0,0.0,2,9,11,4,0,0,0,4,16,2,1,MIA,MIA,SAC,115,33.5,Pts+Rebs+Asts,31,27,20,15
Bam Adebayo,C,22023,1628389,22300678,"JAN 31, 2024",MIA vs. SAC,W,32,8,14,0.571,0,0,0.0,0,0,0.0,2,9,11,4,0,0,0,4,16,2,1,MIA,MIA,SAC,115,40.0,Fantasy Score,31,27,20,15
Bam Adebayo,C,22023,1628389,22300678,"JAN 31, 2024",MIA vs. SAC,W,32,8,14,0.571,0,0,0.0,0,0,0.0,2,9,11,4,0,0,0,4,16,2,1,MIA,MIA,SAC,115,29.5,Pts+Rebs,31,27,20,15
Bam Adebayo,C,22023,1628389,22300678,"JAN 31, 2024",MIA vs. SAC,W,32,8,14,0.571,0,0,0.0,0,0,0.0,2,9,11,4,0,0,0,4,16,2,1,MIA,MIA,SAC,115,23.5,Pts+Asts,31,27,20,15
Bam Adebayo,C,22023,1628389,22300678,"JAN 31, 2024",MIA vs. SAC,W,32,8,14,0.571,0,0,0.0,0,0,0.0,2,9,11,4,0,0,0,4,16,2,1,MIA,MIA,SAC,115,14.5,Rebs+Asts,31,27,20,15
Bam Adebayo,C,22023,1628389,22300661,"JAN 29, 2024",MIA vs. PHX,L,35,3,9,0.333,0,0,0.0,2,2,1.0,0,11,11,5,1,3,4,2,8,3,1,MIA,MIA,PHX,105,19.5,Points,24,19,13,16
Bam Adebayo,C,22023,1628389,22300661,"JAN 29, 2024",MIA vs. PHX,L,35,3,9,0.333,0,0,0.0,2,2,1.0,0,11,11,5,1,3,4,2,8,3,1,MIA,MIA,PHX,105,10.5,Rebounds,24,19,13,16
Bam Adebayo,C,22023,1628389,22300661,"JAN 29, 2024",MIA vs. PHX,L,35,3,9,0.333,0,0,0.0,2,2,1.0,0,11,11,5,1,3,4,2,8,3,1,MIA,MIA,PHX,105,33.5,Pts+Rebs+Asts,24,19,13,16
Bam Adebayo,C,22023,1628389,22300661,"JAN 29, 2024",MIA vs. PHX,L,35,3,9,0.333,0,0,0.0,2,2,1.0,0,11,11,5,1,3,4,2,8,3,1,MIA,MIA,PHX,105,40.0,Fantasy Score,24,19,13,16
Bam Adebayo,C,22023,1628389,22300661,"JAN 29, 2024",MIA vs. PHX,L,35,3,9,0.333,0,0,0.0,2,2,1.0,0,11,11,5,1,3,4,2,8,3,1,MIA,MIA,PHX,105,29.5,Pts+Rebs,24,19,13,16
Bam Adebayo,C,22023,1628389,22300661,"JAN 29, 2024",MIA vs. PHX,L,35,3,9,0.333,0,0,0.0,2,2,1.0,0,11,11,5,1,3,4,2,8,3,1,MIA,MIA,PHX,105,23.5,Pts+Asts,24,19,13,16
Bam Adebayo,C,22023,1628389,22300661,"JAN 29, 2024",MIA vs. PHX,L,35,3,9,0.333,0,0,0.0,2,2,1.0,0,11,11,5,1,3,4,2,8,3,1,MIA,MIA,PHX,105,14.5,Rebs+Asts,24,19,13,16
Bam Adebayo,C,22023,1628389,22300643,"JAN 27, 2024",MIA @ NYK,L,33,6,10,0.6,0,0,0.0,0,0,0.0,3,10,13,1,0,0,2,1,12,-20,1,MIA,NYK,MIA,109,19.5,Points,26,25,13,14
Bam Adebayo,C,22023,1628389,22300643,"JAN 27, 2024",MIA @ NYK,L,33,6,10,0.6,0,0,0.0,0,0,0.0,3,10,13,1,0,0,2,1,12,-20,1,MIA,NYK,MIA,109,10.5,Rebounds,26,25,13,14
Bam Adebayo,C,22023,1628389,22300643,"JAN 27, 2024",MIA @ NYK,L,33,6,10,0.6,0,0,0.0,0,0,0.0,3,10,13,1,0,0,2,1,12,-20,1,MIA,NYK,MIA,109,33.5,Pts+Rebs+Asts,26,25,13,14
Bam Adebayo,C,22023,1628389,22300643,"JAN 27, 2024",MIA @ NYK,L,33,6,10,0.6,0,0,0.0,0,0,0.0,3,10,13,1,0,0,2,1,12,-20,1,MIA,NYK,MIA,109,40.0,Fantasy Score,26,25,13,14
Bam Adebayo,C,22023,1628389,22300643,"JAN 27, 2024",MIA @ NYK,L,33,6,10,0.6,0,0,0.0,0,0,0.0,3,10,13,1,0,0,2,1,12,-20,1,MIA,NYK,MIA,109,29.5,Pts+Rebs,26,25,13,14
Bam Adebayo,C,22023,1628389,22300643,"JAN 27, 2024",MIA @ NYK,L,33,6,10,0.6,0,0,0.0,0,0,0.0,3,10,13,1,0,0,2,1,12,-20,1,MIA,NYK,MIA,109,23.5,Pts+Asts,26,25,13,14
Bam Adebayo,C,22023,1628389,22300643,"JAN 27, 2024",MIA @ NYK,L,33,6,10,0.6,0,0,0.0,0,0,0.0,3,10,13,1,0,0,2,1,12,-20,1,MIA,NYK,MIA,109,14.5,Rebs+Asts,26,25,13,14
Bam Adebayo,C,22023,1628389,22300630,"JAN 25, 2024",MIA vs. BOS,L,29,8,14,0.571,0,0,0.0,3,4,0.75,1,4,5,2,1,1,0,0,19,-28,1,MIA,MIA,BOS,110,19.5,Points,26,24,21,7
Bam Adebayo,C,22023,1628389,22300630,"JAN 25, 2024",MIA vs. BOS,L,29,8,14,0.571,0,0,0.0,3,4,0.75,1,4,5,2,1,1,0,0,19,-28,1,MIA,MIA,BOS,110,10.5,Rebounds,26,24,21,7
Bam Adebayo,C,22023,1628389,22300630,"JAN 25, 2024",MIA vs. BOS,L,29,8,14,0.571,0,0,0.0,3,4,0.75,1,4,5,2,1,1,0,0,19,-28,1,MIA,MIA,BOS,110,33.5,Pts+Rebs+Asts,26,24,21,7
Bam Adebayo,C,22023,1628389,22300630,"JAN 25, 2024",MIA vs. BOS,L,29,8,14,0.571,0,0,0.0,3,4,0.75,1,4,5,2,1,1,0,0,19,-28,1,MIA,MIA,BOS,110,40.0,Fantasy Score,26,24,21,7
Bam Adebayo,C,22023,1628389,22300630,"JAN 25, 2024",MIA vs. BOS,L,29,8,14,0.571,0,0,0.0,3,4,0.75,1,4,5,2,1,1,0,0,19,-28,1,MIA,MIA,BOS,110,29.5,Pts+Rebs,26,24,21,7
Bam Adebayo,C,22023,1628389,22300630,"JAN 25, 2024",MIA vs. BOS,L,29,8,14,0.571,0,0,0.0,3,4,0.75,1,4,5,2,1,1,0,0,19,-28,1,MIA,MIA,BOS,110,23.5,Pts+Asts,26,24,21,7
Bam Adebayo,C,22023,1628389,22300630,"JAN 25, 2024",MIA vs. BOS,L,29,8,14,0.571,0,0,0.0,3,4,0.75,1,4,5,2,1,1,0,0,19,-28,1,MIA,MIA,BOS,110,14.5,Rebs+Asts,26,24,21,7
Bam Adebayo,C,22023,1628389,22300621,"JAN 24, 2024",MIA vs. MEM,L,40,4,13,0.308,0,1,0.0,7,11,0.636,3,12,15,6,1,6,0,3,15,3,1,MIA,MIA,MEM,96,19.5,Points,36,30,21,21
Bam Adebayo,C,22023,1628389,22300621,"JAN 24, 2024",MIA vs. MEM,L,40,4,13,0.308,0,1,0.0,7,11,0.636,3,12,15,6,1,6,0,3,15,3,1,MIA,MIA,MEM,96,10.5,Rebounds,36,30,21,21
Bam Adebayo,C,22023,1628389,22300621,"JAN 24, 2024",MIA vs. MEM,L,40,4,13,0.308,0,1,0.0,7,11,0.636,3,12,15,6,1,6,0,3,15,3,1,MIA,MIA,MEM,96,33.5,Pts+Rebs+Asts,36,30,21,21
Bam Adebayo,C,22023,1628389,22300621,"JAN 24, 2024",MIA vs. MEM,L,40,4,13,0.308,0,1,0.0,7,11,0.636,3,12,15,6,1,6,0,3,15,3,1,MIA,MIA,MEM,96,40.0,Fantasy Score,36,30,21,21
Bam Adebayo,C,22023,1628389,22300621,"JAN 24, 2024",MIA vs. MEM,L,40,4,13,0.308,0,1,0.0,7,11,0.636,3,12,15,6,1,6,0,3,15,3,1,MIA,MIA,MEM,96,29.5,Pts+Rebs,36,30,21,21
Bam Adebayo,C,22023,1628389,22300621,"JAN 24, 2024",MIA vs. MEM,L,40,4,13,0.308,0,1,0.0,7,11,0.636,3,12,15,6,1,6,0,3,15,3,1,MIA,MIA,MEM,96,23.5,Pts+Asts,36,30,21,21
Bam Adebayo,C,22023,1628389,22300621,"JAN 24, 2024",MIA vs. MEM,L,40,4,13,0.308,0,1,0.0,7,11,0.636,3,12,15,6,1,6,0,3,15,3,1,MIA,MIA,MEM,96,14.5,Rebs+Asts,36,30,21,21
Bam Adebayo,C,22023,1628389,22300601,"JAN 21, 2024",MIA @ ORL,L,34,8,17,0.471,0,1,0.0,6,6,1.0,6,5,11,7,2,0,5,3,22,-15,1,MIA,ORL,MIA,87,19.5,Points,40,33,29,18
Bam Adebayo,C,22023,1628389,22300601,"JAN 21, 2024",MIA @ ORL,L,34,8,17,0.471,0,1,0.0,6,6,1.0,6,5,11,7,2,0,5,3,22,-15,1,MIA,ORL,MIA,87,10.5,Rebounds,40,33,29,18
Bam Adebayo,C,22023,1628389,22300601,"JAN 21, 2024",MIA @ ORL,L,34,8,17,0.471,0,1,0.0,6,6,1.0,6,5,11,7,2,0,5,3,22,-15,1,MIA,ORL,MIA,87,33.5,Pts+Rebs+Asts,40,33,29,18
Bam Adebayo,C,22023,1628389,22300601,"JAN 21, 2024",MIA @ ORL,L,34,8,17,0.471,0,1,0.0,6,6,1.0,6,5,11,7,2,0,5,3,22,-15,1,MIA,ORL,MIA,87,40.0,Fantasy Score,40,33,29,18
Bam Adebayo,C,22023,1628389,22300601,"JAN 21, 2024",MIA @ ORL,L,34,8,17,0.471,0,1,0.0,6,6,1.0,6,5,11,7,2,0,5,3,22,-15,1,MIA,ORL,MIA,87,29.5,Pts+Rebs,40,33,29,18
Bam Adebayo,C,22023,1628389,22300601,"JAN 21, 2024",MIA @ ORL,L,34,8,17,0.471,0,1,0.0,6,6,1.0,6,5,11,7,2,0,5,3,22,-15,1,MIA,ORL,MIA,87,23.5,Pts+Asts,40,33,29,18
Bam Adebayo,C,22023,1628389,22300601,"JAN 21, 2024",MIA @ ORL,L,34,8,17,0.471,0,1,0.0,6,6,1.0,6,5,11,7,2,0,5,3,22,-15,1,MIA,ORL,MIA,87,14.5,Rebs+Asts,40,33,29,18
Bam Adebayo,C,22023,1628389,22300587,"JAN 19, 2024",MIA vs. ATL,L,39,7,15,0.467,0,0,0.0,7,8,0.875,2,7,9,6,1,0,3,4,21,8,1,MIA,MIA,ATL,108,19.5,Points,36,30,27,15
Bam Adebayo,C,22023,1628389,22300587,"JAN 19, 2024",MIA vs. ATL,L,39,7,15,0.467,0,0,0.0,7,8,0.875,2,7,9,6,1,0,3,4,21,8,1,MIA,MIA,ATL,108,10.5,Rebounds,36,30,27,15
Bam Adebayo,C,22023,1628389,22300587,"JAN 19, 2024",MIA vs. ATL,L,39,7,15,0.467,0,0,0.0,7,8,0.875,2,7,9,6,1,0,3,4,21,8,1,MIA,MIA,ATL,108,33.5,Pts+Rebs+Asts,36,30,27,15
Bam Adebayo,C,22023,1628389,22300587,"JAN 19, 2024",MIA vs. ATL,L,39,7,15,0.467,0,0,0.0,7,8,0.875,2,7,9,6,1,0,3,4,21,8,1,MIA,MIA,ATL,108,40.0,Fantasy Score,36,30,27,15
Bam Adebayo,C,22023,1628389,22300587,"JAN 19, 2024",MIA vs. ATL,L,39,7,15,0.467,0,0,0.0,7,8,0.875,2,7,9,6,1,0,3,4,21,8,1,MIA,MIA,ATL,108,29.5,Pts+Rebs,36,30,27,15
Bam Adebayo,C,22023,1628389,22300587,"JAN 19, 2024",MIA vs. ATL,L,39,7,15,0.467,0,0,0.0,7,8,0.875,2,7,9,6,1,0,3,4,21,8,1,MIA,MIA,ATL,108,23.5,Pts+Asts,36,30,27,15
Bam Adebayo,C,22023,1628389,22300587,"JAN 19, 2024",MIA vs. ATL,L,39,7,15,0.467,0,0,0.0,7,8,0.875,2,7,9,6,1,0,3,4,21,8,1,MIA,MIA,ATL,108,14.5,Rebs+Asts,36,30,27,15
Bam Adebayo,C,22023,1628389,22300574,"JAN 17, 2024",MIA @ TOR,L,36,7,13,0.538,0,0,0.0,2,3,0.667,1,4,5,4,1,0,2,3,16,-23,1,MIA,TOR,MIA,97,19.5,Points,25,21,20,9
Bam Adebayo,C,22023,1628389,22300574,"JAN 17, 2024",MIA @ TOR,L,36,7,13,0.538,0,0,0.0,2,3,0.667,1,4,5,4,1,0,2,3,16,-23,1,MIA,TOR,MIA,97,10.5,Rebounds,25,21,20,9
Bam Adebayo,C,22023,1628389,22300574,"JAN 17, 2024",MIA @ TOR,L,36,7,13,0.538,0,0,0.0,2,3,0.667,1,4,5,4,1,0,2,3,16,-23,1,MIA,TOR,MIA,97,33.5,Pts+Rebs+Asts,25,21,20,9
Bam Adebayo,C,22023,1628389,22300574,"JAN 17, 2024",MIA @ TOR,L,36,7,13,0.538,0,0,0.0,2,3,0.667,1,4,5,4,1,0,2,3,16,-23,1,MIA,TOR,MIA,97,40.0,Fantasy Score,25,21,20,9
Bam Adebayo,C,22023,1628389,22300574,"JAN 17, 2024",MIA @ TOR,L,36,7,13,0.538,0,0,0.0,2,3,0.667,1,4,5,4,1,0,2,3,16,-23,1,MIA,TOR,MIA,97,29.5,Pts+Rebs,25,21,20,9
Bam Adebayo,C,22023,1628389,22300574,"JAN 17, 2024",MIA @ TOR,L,36,7,13,0.538,0,0,0.0,2,3,0.667,1,4,5,4,1,0,2,3,16,-23,1,MIA,TOR,MIA,97,23.5,Pts+Asts,25,21,20,9
Bam Adebayo,C,22023,1628389,22300574,"JAN 17, 2024",MIA @ TOR,L,36,7,13,0.538,0,0,0.0,2,3,0.667,1,4,5,4,1,0,2,3,16,-23,1,MIA,TOR,MIA,97,14.5,Rebs+Asts,25,21,20,9
Bam Adebayo,C,22023,1628389,22300562,"JAN 15, 2024",MIA @ BKN,W,44,5,17,0.294,0,1,0.0,1,2,0.5,2,18,20,4,1,1,2,2,11,-3,1,MIA,BKN,MIA,96,19.5,Points,35,31,15,24
Bam Adebayo,C,22023,1628389,22300562,"JAN 15, 2024",MIA @ BKN,W,44,5,17,0.294,0,1,0.0,1,2,0.5,2,18,20,4,1,1,2,2,11,-3,1,MIA,BKN,MIA,96,10.5,Rebounds,35,31,15,24
Bam Adebayo,C,22023,1628389,22300562,"JAN 15, 2024",MIA @ BKN,W,44,5,17,0.294,0,1,0.0,1,2,0.5,2,18,20,4,1,1,2,2,11,-3,1,MIA,BKN,MIA,96,33.5,Pts+Rebs+Asts,35,31,15,24
Bam Adebayo,C,22023,1628389,22300562,"JAN 15, 2024",MIA @ BKN,W,44,5,17,0.294,0,1,0.0,1,2,0.5,2,18,20,4,1,1,2,2,11,-3,1,MIA,BKN,MIA,96,40.0,Fantasy Score,35,31,15,24
Bam Adebayo,C,22023,1628389,22300562,"JAN 15, 2024",MIA @ BKN,W,44,5,17,0.294,0,1,0.0,1,2,0.5,2,18,20,4,1,1,2,2,11,-3,1,MIA,BKN,MIA,96,29.5,Pts+Rebs,35,31,15,24
Bam Adebayo,C,22023,1628389,22300562,"JAN 15, 2024",MIA @ BKN,W,44,5,17,0.294,0,1,0.0,1,2,0.5,2,18,20,4,1,1,2,2,11,-3,1,MIA,BKN,MIA,96,23.5,Pts+Asts,35,31,15,24
Bam Adebayo,C,22023,1628389,22300562,"JAN 15, 2024",MIA @ BKN,W,44,5,17,0.294,0,1,0.0,1,2,0.5,2,18,20,4,1,1,2,2,11,-3,1,MIA,BKN,MIA,96,14.5,Rebs+Asts,35,31,15,24
Bam Adebayo,C,22023,1628389,22300551,"JAN 14, 2024",MIA vs. CHA,W,35,9,17,0.529,0,1,0.0,6,8,0.75,0,10,10,7,0,1,2,3,24,5,1,MIA,MIA,CHA,104,19.5,Points,41,34,31,17
Bam Adebayo,C,22023,1628389,22300551,"JAN 14, 2024",MIA vs. CHA,W,35,9,17,0.529,0,1,0.0,6,8,0.75,0,10,10,7,0,1,2,3,24,5,1,MIA,MIA,CHA,104,10.5,Rebounds,41,34,31,17
Bam Adebayo,C,22023,1628389,22300551,"JAN 14, 2024",MIA vs. CHA,W,35,9,17,0.529,0,1,0.0,6,8,0.75,0,10,10,7,0,1,2,3,24,5,1,MIA,MIA,CHA,104,33.5,Pts+Rebs+Asts,41,34,31,17
Bam Adebayo,C,22023,1628389,22300551,"JAN 14, 2024",MIA vs. CHA,W,35,9,17,0.529,0,1,0.0,6,8,0.75,0,10,10,7,0,1,2,3,24,5,1,MIA,MIA,CHA,104,40.0,Fantasy Score,41,34,31,17
Bam Adebayo,C,22023,1628389,22300551,"JAN 14, 2024",MIA vs. CHA,W,35,9,17,0.529,0,1,0.0,6,8,0.75,0,10,10,7,0,1,2,3,24,5,1,MIA,MIA,CHA,104,29.5,Pts+Rebs,41,34,31,17
Bam Adebayo,C,22023,1628389,22300551,"JAN 14, 2024",MIA vs. CHA,W,35,9,17,0.529,0,1,0.0,6,8,0.75,0,10,10,7,0,1,2,3,24,5,1,MIA,MIA,CHA,104,23.5,Pts+Asts,41,34,31,17
Bam Adebayo,C,22023,1628389,22300551,"JAN 14, 2024",MIA vs. CHA,W,35,9,17,0.529,0,1,0.0,6,8,0.75,0,10,10,7,0,1,2,3,24,5,1,MIA,MIA,CHA,104,14.5,Rebs+Asts,41,34,31,17
Bam Adebayo,C,22023,1628389,22300535,"JAN 12, 2024",MIA vs. ORL,W,39,8,17,0.471,0,0,0.0,5,6,0.833,4,7,11,7,0,1,4,3,21,17,1,MIA,MIA,ORL,99,19.5,Points,39,32,28,18
Bam Adebayo,C,22023,1628389,22300535,"JAN 12, 2024",MIA vs. ORL,W,39,8,17,0.471,0,0,0.0,5,6,0.833,4,7,11,7,0,1,4,3,21,17,1,MIA,MIA,ORL,99,10.5,Rebounds,39,32,28,18
Bam Adebayo,C,22023,1628389,22300535,"JAN 12, 2024",MIA vs. ORL,W,39,8,17,0.471,0,0,0.0,5,6,0.833,4,7,11,7,0,1,4,3,21,17,1,MIA,MIA,ORL,99,33.5,Pts+Rebs+Asts,39,32,28,18
Bam Adebayo,C,22023,1628389,22300535,"JAN 12, 2024",MIA vs. ORL,W,39,8,17,0.471,0,0,0.0,5,6,0.833,4,7,11,7,0,1,4,3,21,17,1,MIA,MIA,ORL,99,40.0,Fantasy Score,39,32,28,18
Bam Adebayo,C,22023,1628389,22300535,"JAN 12, 2024",MIA vs. ORL,W,39,8,17,0.471,0,0,0.0,5,6,0.833,4,7,11,7,0,1,4,3,21,17,1,MIA,MIA,ORL,99,29.5,Pts+Rebs,39,32,28,18
Bam Adebayo,C,22023,1628389,22300535,"JAN 12, 2024",MIA vs. ORL,W,39,8,17,0.471,0,0,0.0,5,6,0.833,4,7,11,7,0,1,4,3,21,17,1,MIA,MIA,ORL,99,23.5,Pts+Asts,39,32,28,18
Bam Adebayo,C,22023,1628389,22300535,"JAN 12, 2024",MIA vs. ORL,W,39,8,17,0.471,0,0,0.0,5,6,0.833,4,7,11,7,0,1,4,3,21,17,1,MIA,MIA,ORL,99,14.5,Rebs+Asts,39,32,28,18
Bam Adebayo,C,22023,1628389,22300522,"JAN 10, 2024",MIA vs. OKC,L,37,9,16,0.563,0,0,0.0,7,7,1.0,5,6,11,6,0,2,1,1,25,-6,1,MIA,MIA,OKC,120,19.5,Points,42,36,31,17
Bam Adebayo,C,22023,1628389,22300522,"JAN 10, 2024",MIA vs. OKC,L,37,9,16,0.563,0,0,0.0,7,7,1.0,5,6,11,6,0,2,1,1,25,-6,1,MIA,MIA,OKC,120,10.5,Rebounds,42,36,31,17
Bam Adebayo,C,22023,1628389,22300522,"JAN 10, 2024",MIA vs. OKC,L,37,9,16,0.563,0,0,0.0,7,7,1.0,5,6,11,6,0,2,1,1,25,-6,1,MIA,MIA,OKC,120,33.5,Pts+Rebs+Asts,42,36,31,17
Bam Adebayo,C,22023,1628389,22300522,"JAN 10, 2024",MIA vs. OKC,L,37,9,16,0.563,0,0,0.0,7,7,1.0,5,6,11,6,0,2,1,1,25,-6,1,MIA,MIA,OKC,120,40.0,Fantasy Score,42,36,31,17
Bam Adebayo,C,22023,1628389,22300522,"JAN 10, 2024",MIA vs. OKC,L,37,9,16,0.563,0,0,0.0,7,7,1.0,5,6,11,6,0,2,1,1,25,-6,1,MIA,MIA,OKC,120,29.5,Pts+Rebs,42,36,31,17
Bam Adebayo,C,22023,1628389,22300522,"JAN 10, 2024",MIA vs. OKC,L,37,9,16,0.563,0,0,0.0,7,7,1.0,5,6,11,6,0,2,1,1,25,-6,1,MIA,MIA,OKC,120,23.5,Pts+Asts,42,36,31,17
Bam Adebayo,C,22023,1628389,22300522,"JAN 10, 2024",MIA vs. OKC,L,37,9,16,0.563,0,0,0.0,7,7,1.0,5,6,11,6,0,2,1,1,25,-6,1,MIA,MIA,OKC,120,14.5,Rebs+Asts,42,36,31,17
Bam Adebayo,C,22023,1628389,22300509,"JAN 08, 2024",MIA vs. HOU,W,32,9,12,0.75,0,0,0.0,4,7,0.571,1,11,12,3,1,0,3,4,22,12,1,MIA,MIA,HOU,120,19.5,Points,37,34,25,15
Bam Adebayo,C,22023,1628389,22300509,"JAN 08, 2024",MIA vs. HOU,W,32,9,12,0.75,0,0,0.0,4,7,0.571,1,11,12,3,1,0,3,4,22,12,1,MIA,MIA,HOU,120,10.5,Rebounds,37,34,25,15
Bam Adebayo,C,22023,1628389,22300509,"JAN 08, 2024",MIA vs. HOU,W,32,9,12,0.75,0,0,0.0,4,7,0.571,1,11,12,3,1,0,3,4,22,12,1,MIA,MIA,HOU,120,33.5,Pts+Rebs+Asts,37,34,25,15
Bam Adebayo,C,22023,1628389,22300509,"JAN 08, 2024",MIA vs. HOU,W,32,9,12,0.75,0,0,0.0,4,7,0.571,1,11,12,3,1,0,3,4,22,12,1,MIA,MIA,HOU,120,40.0,Fantasy Score,37,34,25,15
Bam Adebayo,C,22023,1628389,22300509,"JAN 08, 2024",MIA vs. HOU,W,32,9,12,0.75,0,0,0.0,4,7,0.571,1,11,12,3,1,0,3,4,22,12,1,MIA,MIA,HOU,120,29.5,Pts+Rebs,37,34,25,15
Bam Adebayo,C,22023,1628389,22300509,"JAN 08, 2024",MIA vs. HOU,W,32,9,12,0.75,0,0,0.0,4,7,0.571,1,11,12,3,1,0,3,4,22,12,1,MIA,MIA,HOU,120,23.5,Pts+Asts,37,34,25,15
Bam Adebayo,C,22023,1628389,22300509,"JAN 08, 2024",MIA vs. HOU,W,32,9,12,0.75,0,0,0.0,4,7,0.571,1,11,12,3,1,0,3,4,22,12,1,MIA,MIA,HOU,120,14.5,Rebs+Asts,37,34,25,15
Bam Adebayo,C,22023,1628389,22300489,"JAN 05, 2024",MIA @ PHX,L,36,11,19,0.579,0,0,0.0,6,7,0.857,2,8,10,1,0,1,1,2,28,-16,1,MIA,PHX,MIA,97,19.5,Points,39,38,29,11
Bam Adebayo,C,22023,1628389,22300489,"JAN 05, 2024",MIA @ PHX,L,36,11,19,0.579,0,0,0.0,6,7,0.857,2,8,10,1,0,1,1,2,28,-16,1,MIA,PHX,MIA,97,10.5,Rebounds,39,38,29,11
Bam Adebayo,C,22023,1628389,22300489,"JAN 05, 2024",MIA @ PHX,L,36,11,19,0.579,0,0,0.0,6,7,0.857,2,8,10,1,0,1,1,2,28,-16,1,MIA,PHX,MIA,97,33.5,Pts+Rebs+Asts,39,38,29,11
Bam Adebayo,C,22023,1628389,22300489,"JAN 05, 2024",MIA @ PHX,L,36,11,19,0.579,0,0,0.0,6,7,0.857,2,8,10,1,0,1,1,2,28,-16,1,MIA,PHX,MIA,97,40.0,Fantasy Score,39,38,29,11
Bam Adebayo,C,22023,1628389,22300489,"JAN 05, 2024",MIA @ PHX,L,36,11,19,0.579,0,0,0.0,6,7,0.857,2,8,10,1,0,1,1,2,28,-16,1,MIA,PHX,MIA,97,29.5,Pts+Rebs,39,38,29,11
Bam Adebayo,C,22023,1628389,22300489,"JAN 05, 2024",MIA @ PHX,L,36,11,19,0.579,0,0,0.0,6,7,0.857,2,8,10,1,0,1,1,2,28,-16,1,MIA,PHX,MIA,97,23.5,Pts+Asts,39,38,29,11
Bam Adebayo,C,22023,1628389,22300489,"JAN 05, 2024",MIA @ PHX,L,36,11,19,0.579,0,0,0.0,6,7,0.857,2,8,10,1,0,1,1,2,28,-16,1,MIA,PHX,MIA,97,14.5,Rebs+Asts,39,38,29,11
Bam Adebayo,C,22023,1628389,22300475,"JAN 03, 2024",MIA @ LAL,W,38,5,14,0.357,0,1,0.0,5,6,0.833,3,4,7,5,3,0,2,4,15,12,1,MIA,LAL,MIA,110,19.5,Points,27,22,20,12
Bam Adebayo,C,22023,1628389,22300475,"JAN 03, 2024",MIA @ LAL,W,38,5,14,0.357,0,1,0.0,5,6,0.833,3,4,7,5,3,0,2,4,15,12,1,MIA,LAL,MIA,110,10.5,Rebounds,27,22,20,12
Bam Adebayo,C,22023,1628389,22300475,"JAN 03, 2024",MIA @ LAL,W,38,5,14,0.357,0,1,0.0,5,6,0.833,3,4,7,5,3,0,2,4,15,12,1,MIA,LAL,MIA,110,33.5,Pts+Rebs+Asts,27,22,20,12
Bam Adebayo,C,22023,1628389,22300475,"JAN 03, 2024",MIA @ LAL,W,38,5,14,0.357,0,1,0.0,5,6,0.833,3,4,7,5,3,0,2,4,15,12,1,MIA,LAL,MIA,110,40.0,Fantasy Score,27,22,20,12
Bam Adebayo,C,22023,1628389,22300475,"JAN 03, 2024",MIA @ LAL,W,38,5,14,0.357,0,1,0.0,5,6,0.833,3,4,7,5,3,0,2,4,15,12,1,MIA,LAL,MIA,110,29.5,Pts+Rebs,27,22,20,12
Bam Adebayo,C,22023,1628389,22300475,"JAN 03, 2024",MIA @ LAL,W,38,5,14,0.357,0,1,0.0,5,6,0.833,3,4,7,5,3,0,2,4,15,12,1,MIA,LAL,MIA,110,23.5,Pts+Asts,27,22,20,12
Bam Adebayo,C,22023,1628389,22300475,"JAN 03, 2024",MIA @ LAL,W,38,5,14,0.357,0,1,0.0,5,6,0.833,3,4,7,5,3,0,2,4,15,12,1,MIA,LAL,MIA,110,14.5,Rebs+Asts,27,22,20,12
Bam Adebayo,C,22023,1628389,22300458,"JAN 01, 2024",MIA @ LAC,L,36,6,17,0.353,0,2,0.0,9,13,0.692,3,12,15,4,0,0,3,3,21,-12,1,MIA,LAC,MIA,104,19.5,Points,40,36,25,19
Bam Adebayo,C,22023,1628389,22300458,"JAN 01, 2024",MIA @ LAC,L,36,6,17,0.353,0,2,0.0,9,13,0.692,3,12,15,4,0,0,3,3,21,-12,1,MIA,LAC,MIA,104,10.5,Rebounds,40,36,25,19
Bam Adebayo,C,22023,1628389,22300458,"JAN 01, 2024",MIA @ LAC,L,36,6,17,0.353,0,2,0.0,9,13,0.692,3,12,15,4,0,0,3,3,21,-12,1,MIA,LAC,MIA,104,33.5,Pts+Rebs+Asts,40,36,25,19
Bam Adebayo,C,22023,1628389,22300458,"JAN 01, 2024",MIA @ LAC,L,36,6,17,0.353,0,2,0.0,9,13,0.692,3,12,15,4,0,0,3,3,21,-12,1,MIA,LAC,MIA,104,40.0,Fantasy Score,40,36,25,19
Bam Adebayo,C,22023,1628389,22300458,"JAN 01, 2024",MIA @ LAC,L,36,6,17,0.353,0,2,0.0,9,13,0.692,3,12,15,4,0,0,3,3,21,-12,1,MIA,LAC,MIA,104,29.5,Pts+Rebs,40,36,25,19
Bam Adebayo,C,22023,1628389,22300458,"JAN 01, 2024",MIA @ LAC,L,36,6,17,0.353,0,2,0.0,9,13,0.692,3,12,15,4,0,0,3,3,21,-12,1,MIA,LAC,MIA,104,23.5,Pts+Asts,40,36,25,19
Bam Adebayo,C,22023,1628389,22300458,"JAN 01, 2024",MIA @ LAC,L,36,6,17,0.353,0,2,0.0,9,13,0.692,3,12,15,4,0,0,3,3,21,-12,1,MIA,LAC,MIA,104,14.5,Rebs+Asts,40,36,25,19
Bam Adebayo,C,22023,1628389,22300439,"DEC 30, 2023",MIA @ UTA,L,37,7,13,0.538,0,0,0.0,14,20,0.7,3,13,16,3,3,3,4,1,28,-3,1,MIA,UTA,MIA,109,19.5,Points,47,44,31,19
Bam Adebayo,C,22023,1628389,22300439,"DEC 30, 2023",MIA @ UTA,L,37,7,13,0.538,0,0,0.0,14,20,0.7,3,13,16,3,3,3,4,1,28,-3,1,MIA,UTA,MIA,109,10.5,Rebounds,47,44,31,19
Bam Adebayo,C,22023,1628389,22300439,"DEC 30, 2023",MIA @ UTA,L,37,7,13,0.538,0,0,0.0,14,20,0.7,3,13,16,3,3,3,4,1,28,-3,1,MIA,UTA,MIA,109,33.5,Pts+Rebs+Asts,47,44,31,19
Bam Adebayo,C,22023,1628389,22300439,"DEC 30, 2023",MIA @ UTA,L,37,7,13,0.538,0,0,0.0,14,20,0.7,3,13,16,3,3,3,4,1,28,-3,1,MIA,UTA,MIA,109,40.0,Fantasy Score,47,44,31,19
Bam Adebayo,C,22023,1628389,22300439,"DEC 30, 2023",MIA @ UTA,L,37,7,13,0.538,0,0,0.0,14,20,0.7,3,13,16,3,3,3,4,1,28,-3,1,MIA,UTA,MIA,109,29.5,Pts+Rebs,47,44,31,19
Bam Adebayo,C,22023,1628389,22300439,"DEC 30, 2023",MIA @ UTA,L,37,7,13,0.538,0,0,0.0,14,20,0.7,3,13,16,3,3,3,4,1,28,-3,1,MIA,UTA,MIA,109,23.5,Pts+Asts,47,44,31,19
Bam Adebayo,C,22023,1628389,22300439,"DEC 30, 2023",MIA @ UTA,L,37,7,13,0.538,0,0,0.0,14,20,0.7,3,13,16,3,3,3,4,1,28,-3,1,MIA,UTA,MIA,109,14.5,Rebs+Asts,47,44,31,19
Bam Adebayo,C,22023,1628389,22300426,"DEC 28, 2023",MIA @ GSW,W,36,7,13,0.538,0,0,0.0,3,4,0.75,2,9,11,4,0,0,0,2,17,8,1,MIA,GSW,MIA,114,19.5,Points,32,28,21,15
Bam Adebayo,C,22023,1628389,22300426,"DEC 28, 2023",MIA @ GSW,W,36,7,13,0.538,0,0,0.0,3,4,0.75,2,9,11,4,0,0,0,2,17,8,1,MIA,GSW,MIA,114,10.5,Rebounds,32,28,21,15
Bam Adebayo,C,22023,1628389,22300426,"DEC 28, 2023",MIA @ GSW,W,36,7,13,0.538,0,0,0.0,3,4,0.75,2,9,11,4,0,0,0,2,17,8,1,MIA,GSW,MIA,114,33.5,Pts+Rebs+Asts,32,28,21,15
Bam Adebayo,C,22023,1628389,22300426,"DEC 28, 2023",MIA @ GSW,W,36,7,13,0.538,0,0,0.0,3,4,0.75,2,9,11,4,0,0,0,2,17,8,1,MIA,GSW,MIA,114,40.0,Fantasy Score,32,28,21,15
Bam Adebayo,C,22023,1628389,22300426,"DEC 28, 2023",MIA @ GSW,W,36,7,13,0.538,0,0,0.0,3,4,0.75,2,9,11,4,0,0,0,2,17,8,1,MIA,GSW,MIA,114,29.5,Pts+Rebs,32,28,21,15
Bam Adebayo,C,22023,1628389,22300426,"DEC 28, 2023",MIA @ GSW,W,36,7,13,0.538,0,0,0.0,3,4,0.75,2,9,11,4,0,0,0,2,17,8,1,MIA,GSW,MIA,114,23.5,Pts+Asts,32,28,21,15
Bam Adebayo,C,22023,1628389,22300426,"DEC 28, 2023",MIA @ GSW,W,36,7,13,0.538,0,0,0.0,3,4,0.75,2,9,11,4,0,0,0,2,17,8,1,MIA,GSW,MIA,114,14.5,Rebs+Asts,32,28,21,15
Bam Adebayo,C,22023,1628389,22300404,"DEC 25, 2023",MIA vs. PHI,W,36,9,15,0.6,0,0,0.0,8,12,0.667,3,12,15,5,0,3,4,1,26,0,1,MIA,MIA,PHI,119,19.5,Points,46,41,31,20
Bam Adebayo,C,22023,1628389,22300404,"DEC 25, 2023",MIA vs. PHI,W,36,9,15,0.6,0,0,0.0,8,12,0.667,3,12,15,5,0,3,4,1,26,0,1,MIA,MIA,PHI,119,10.5,Rebounds,46,41,31,20
Bam Adebayo,C,22023,1628389,22300404,"DEC 25, 2023",MIA vs. PHI,W,36,9,15,0.6,0,0,0.0,8,12,0.667,3,12,15,5,0,3,4,1,26,0,1,MIA,MIA,PHI,119,33.5,Pts+Rebs+Asts,46,41,31,20
Bam Adebayo,C,22023,1628389,22300404,"DEC 25, 2023",MIA vs. PHI,W,36,9,15,0.6,0,0,0.0,8,12,0.667,3,12,15,5,0,3,4,1,26,0,1,MIA,MIA,PHI,119,40.0,Fantasy Score,46,41,31,20
Bam Adebayo,C,22023,1628389,22300404,"DEC 25, 2023",MIA vs. PHI,W,36,9,15,0.6,0,0,0.0,8,12,0.667,3,12,15,5,0,3,4,1,26,0,1,MIA,MIA,PHI,119,29.5,Pts+Rebs,46,41,31,20
Bam Adebayo,C,22023,1628389,22300404,"DEC 25, 2023",MIA vs. PHI,W,36,9,15,0.6,0,0,0.0,8,12,0.667,3,12,15,5,0,3,4,1,26,0,1,MIA,MIA,PHI,119,23.5,Pts+Asts,46,41,31,20
Bam Adebayo,C,22023,1628389,22300404,"DEC 25, 2023",MIA vs. PHI,W,36,9,15,0.6,0,0,0.0,8,12,0.667,3,12,15,5,0,3,4,1,26,0,1,MIA,MIA,PHI,119,14.5,Rebs+Asts,46,41,31,20
Bam Adebayo,C,22023,1628389,22300384,"DEC 22, 2023",MIA vs. ATL,W,38,5,14,0.357,0,1,0.0,8,10,0.8,2,9,11,6,2,0,6,2,18,10,1,MIA,MIA,ATL,122,19.5,Points,35,29,24,17
Bam Adebayo,C,22023,1628389,22300384,"DEC 22, 2023",MIA vs. ATL,W,38,5,14,0.357,0,1,0.0,8,10,0.8,2,9,11,6,2,0,6,2,18,10,1,MIA,MIA,ATL,122,10.5,Rebounds,35,29,24,17
Bam Adebayo,C,22023,1628389,22300384,"DEC 22, 2023",MIA vs. ATL,W,38,5,14,0.357,0,1,0.0,8,10,0.8,2,9,11,6,2,0,6,2,18,10,1,MIA,MIA,ATL,122,33.5,Pts+Rebs+Asts,35,29,24,17
Bam Adebayo,C,22023,1628389,22300384,"DEC 22, 2023",MIA vs. ATL,W,38,5,14,0.357,0,1,0.0,8,10,0.8,2,9,11,6,2,0,6,2,18,10,1,MIA,MIA,ATL,122,40.0,Fantasy Score,35,29,24,17
Bam Adebayo,C,22023,1628389,22300384,"DEC 22, 2023",MIA vs. ATL,W,38,5,14,0.357,0,1,0.0,8,10,0.8,2,9,11,6,2,0,6,2,18,10,1,MIA,MIA,ATL,122,29.5,Pts+Rebs,35,29,24,17
Bam Adebayo,C,22023,1628389,22300384,"DEC 22, 2023",MIA vs. ATL,W,38,5,14,0.357,0,1,0.0,8,10,0.8,2,9,11,6,2,0,6,2,18,10,1,MIA,MIA,ATL,122,23.5,Pts+Asts,35,29,24,17
Bam Adebayo,C,22023,1628389,22300384,"DEC 22, 2023",MIA vs. ATL,W,38,5,14,0.357,0,1,0.0,8,10,0.8,2,9,11,6,2,0,6,2,18,10,1,MIA,MIA,ATL,122,14.5,Rebs+Asts,35,29,24,17
Bam Adebayo,C,22023,1628389,22300366,"DEC 20, 2023",MIA @ ORL,W,30,7,15,0.467,0,0,0.0,4,5,0.8,0,7,7,2,1,0,1,4,18,-6,1,MIA,ORL,MIA,115,19.5,Points,27,25,20,9
Bam Adebayo,C,22023,1628389,22300366,"DEC 20, 2023",MIA @ ORL,W,30,7,15,0.467,0,0,0.0,4,5,0.8,0,7,7,2,1,0,1,4,18,-6,1,MIA,ORL,MIA,115,10.5,Rebounds,27,25,20,9
Bam Adebayo,C,22023,1628389,22300366,"DEC 20, 2023",MIA @ ORL,W,30,7,15,0.467,0,0,0.0,4,5,0.8,0,7,7,2,1,0,1,4,18,-6,1,MIA,ORL,MIA,115,33.5,Pts+Rebs+Asts,27,25,20,9
Bam Adebayo,C,22023,1628389,22300366,"DEC 20, 2023",MIA @ ORL,W,30,7,15,0.467,0,0,0.0,4,5,0.8,0,7,7,2,1,0,1,4,18,-6,1,MIA,ORL,MIA,115,40.0,Fantasy Score,27,25,20,9
Bam Adebayo,C,22023,1628389,22300366,"DEC 20, 2023",MIA @ ORL,W,30,7,15,0.467,0,0,0.0,4,5,0.8,0,7,7,2,1,0,1,4,18,-6,1,MIA,ORL,MIA,115,29.5,Pts+Rebs,27,25,20,9
Bam Adebayo,C,22023,1628389,22300366,"DEC 20, 2023",MIA @ ORL,W,30,7,15,0.467,0,0,0.0,4,5,0.8,0,7,7,2,1,0,1,4,18,-6,1,MIA,ORL,MIA,115,23.5,Pts+Asts,27,25,20,9
Bam Adebayo,C,22023,1628389,22300366,"DEC 20, 2023",MIA @ ORL,W,30,7,15,0.467,0,0,0.0,4,5,0.8,0,7,7,2,1,0,1,4,18,-6,1,MIA,ORL,MIA,115,14.5,Rebs+Asts,27,25,20,9
Bam Adebayo,C,22023,1628389,22300353,"DEC 18, 2023",MIA vs. MIN,L,36,10,22,0.455,0,0,0.0,2,3,0.667,3,3,6,6,1,1,4,3,22,-3,1,MIA,MIA,MIN,108,19.5,Points,34,28,28,12
Bam Adebayo,C,22023,1628389,22300353,"DEC 18, 2023",MIA vs. MIN,L,36,10,22,0.455,0,0,0.0,2,3,0.667,3,3,6,6,1,1,4,3,22,-3,1,MIA,MIA,MIN,108,10.5,Rebounds,34,28,28,12
Bam Adebayo,C,22023,1628389,22300353,"DEC 18, 2023",MIA vs. MIN,L,36,10,22,0.455,0,0,0.0,2,3,0.667,3,3,6,6,1,1,4,3,22,-3,1,MIA,MIA,MIN,108,33.5,Pts+Rebs+Asts,34,28,28,12
Bam Adebayo,C,22023,1628389,22300353,"DEC 18, 2023",MIA vs. MIN,L,36,10,22,0.455,0,0,0.0,2,3,0.667,3,3,6,6,1,1,4,3,22,-3,1,MIA,MIA,MIN,108,40.0,Fantasy Score,34,28,28,12
Bam Adebayo,C,22023,1628389,22300353,"DEC 18, 2023",MIA vs. MIN,L,36,10,22,0.455,0,0,0.0,2,3,0.667,3,3,6,6,1,1,4,3,22,-3,1,MIA,MIA,MIN,108,29.5,Pts+Rebs,34,28,28,12
Bam Adebayo,C,22023,1628389,22300353,"DEC 18, 2023",MIA vs. MIN,L,36,10,22,0.455,0,0,0.0,2,3,0.667,3,3,6,6,1,1,4,3,22,-3,1,MIA,MIA,MIN,108,23.5,Pts+Asts,34,28,28,12
Bam Adebayo,C,22023,1628389,22300353,"DEC 18, 2023",MIA vs. MIN,L,36,10,22,0.455,0,0,0.0,2,3,0.667,3,3,6,6,1,1,4,3,22,-3,1,MIA,MIA,MIN,108,14.5,Rebs+Asts,34,28,28,12
Bam Adebayo,C,22023,1628389,22300267,"NOV 30, 2023",MIA vs. IND,W,12,3,9,0.333,0,0,0.0,1,2,0.5,0,4,4,2,0,0,0,1,7,-2,1,MIA,MIA,IND,142,19.5,Points,13,11,9,6
Bam Adebayo,C,22023,1628389,22300267,"NOV 30, 2023",MIA vs. IND,W,12,3,9,0.333,0,0,0.0,1,2,0.5,0,4,4,2,0,0,0,1,7,-2,1,MIA,MIA,IND,142,10.5,Rebounds,13,11,9,6
Bam Adebayo,C,22023,1628389,22300267,"NOV 30, 2023",MIA vs. IND,W,12,3,9,0.333,0,0,0.0,1,2,0.5,0,4,4,2,0,0,0,1,7,-2,1,MIA,MIA,IND,142,33.5,Pts+Rebs+Asts,13,11,9,6
Bam Adebayo,C,22023,1628389,22300267,"NOV 30, 2023",MIA vs. IND,W,12,3,9,0.333,0,0,0.0,1,2,0.5,0,4,4,2,0,0,0,1,7,-2,1,MIA,MIA,IND,142,40.0,Fantasy Score,13,11,9,6
Bam Adebayo,C,22023,1628389,22300267,"NOV 30, 2023",MIA vs. IND,W,12,3,9,0.333,0,0,0.0,1,2,0.5,0,4,4,2,0,0,0,1,7,-2,1,MIA,MIA,IND,142,29.5,Pts+Rebs,13,11,9,6
Bam Adebayo,C,22023,1628389,22300267,"NOV 30, 2023",MIA vs. IND,W,12,3,9,0.333,0,0,0.0,1,2,0.5,0,4,4,2,0,0,0,1,7,-2,1,MIA,MIA,IND,142,23.5,Pts+Asts,13,11,9,6
Bam Adebayo,C,22023,1628389,22300267,"NOV 30, 2023",MIA vs. IND,W,12,3,9,0.333,0,0,0.0,1,2,0.5,0,4,4,2,0,0,0,1,7,-2,1,MIA,MIA,IND,142,14.5,Rebs+Asts,13,11,9,6
Bam Adebayo,C,22023,1628389,22300056,"NOV 28, 2023",MIA vs. MIL,L,42,13,27,0.481,0,0,0.0,5,7,0.714,2,8,10,5,0,2,2,3,31,-16,1,MIA,MIA,MIL,124,19.5,Points,46,41,36,15
Bam Adebayo,C,22023,1628389,22300056,"NOV 28, 2023",MIA vs. MIL,L,42,13,27,0.481,0,0,0.0,5,7,0.714,2,8,10,5,0,2,2,3,31,-16,1,MIA,MIA,MIL,124,10.5,Rebounds,46,41,36,15
Bam Adebayo,C,22023,1628389,22300056,"NOV 28, 2023",MIA vs. MIL,L,42,13,27,0.481,0,0,0.0,5,7,0.714,2,8,10,5,0,2,2,3,31,-16,1,MIA,MIA,MIL,124,33.5,Pts+Rebs+Asts,46,41,36,15
Bam Adebayo,C,22023,1628389,22300056,"NOV 28, 2023",MIA vs. MIL,L,42,13,27,0.481,0,0,0.0,5,7,0.714,2,8,10,5,0,2,2,3,31,-16,1,MIA,MIA,MIL,124,40.0,Fantasy Score,46,41,36,15
Bam Adebayo,C,22023,1628389,22300056,"NOV 28, 2023",MIA vs. MIL,L,42,13,27,0.481,0,0,0.0,5,7,0.714,2,8,10,5,0,2,2,3,31,-16,1,MIA,MIA,MIL,124,29.5,Pts+Rebs,46,41,36,15
Bam Adebayo,C,22023,1628389,22300056,"NOV 28, 2023",MIA vs. MIL,L,42,13,27,0.481,0,0,0.0,5,7,0.714,2,8,10,5,0,2,2,3,31,-16,1,MIA,MIA,MIL,124,23.5,Pts+Asts,46,41,36,15
Bam Adebayo,C,22023,1628389,22300056,"NOV 28, 2023",MIA vs. MIL,L,42,13,27,0.481,0,0,0.0,5,7,0.714,2,8,10,5,0,2,2,3,31,-16,1,MIA,MIA,MIL,124,14.5,Rebs+Asts,46,41,36,15
Bam Adebayo,C,22023,1628389,22300045,"NOV 24, 2023",MIA @ NYK,L,35,8,16,0.5,0,1,0.0,5,6,0.833,2,10,12,2,2,0,2,4,21,0,1,MIA,NYK,MIA,98,19.5,Points,35,33,23,14
Bam Adebayo,C,22023,1628389,22300045,"NOV 24, 2023",MIA @ NYK,L,35,8,16,0.5,0,1,0.0,5,6,0.833,2,10,12,2,2,0,2,4,21,0,1,MIA,NYK,MIA,98,10.5,Rebounds,35,33,23,14
Bam Adebayo,C,22023,1628389,22300045,"NOV 24, 2023",MIA @ NYK,L,35,8,16,0.5,0,1,0.0,5,6,0.833,2,10,12,2,2,0,2,4,21,0,1,MIA,NYK,MIA,98,33.5,Pts+Rebs+Asts,35,33,23,14
Bam Adebayo,C,22023,1628389,22300045,"NOV 24, 2023",MIA @ NYK,L,35,8,16,0.5,0,1,0.0,5,6,0.833,2,10,12,2,2,0,2,4,21,0,1,MIA,NYK,MIA,98,40.0,Fantasy Score,35,33,23,14
Bam Adebayo,C,22023,1628389,22300045,"NOV 24, 2023",MIA @ NYK,L,35,8,16,0.5,0,1,0.0,5,6,0.833,2,10,12,2,2,0,2,4,21,0,1,MIA,NYK,MIA,98,29.5,Pts+Rebs,35,33,23,14
Bam Adebayo,C,22023,1628389,22300045,"NOV 24, 2023",MIA @ NYK,L,35,8,16,0.5,0,1,0.0,5,6,0.833,2,10,12,2,2,0,2,4,21,0,1,MIA,NYK,MIA,98,23.5,Pts+Asts,35,33,23,14
Bam Adebayo,C,22023,1628389,22300045,"NOV 24, 2023",MIA @ NYK,L,35,8,16,0.5,0,1,0.0,5,6,0.833,2,10,12,2,2,0,2,4,21,0,1,MIA,NYK,MIA,98,14.5,Rebs+Asts,35,33,23,14
Bam Adebayo,C,22023,1628389,22300220,"NOV 20, 2023",MIA @ CHI,W,30,8,14,0.571,0,0,0.0,7,9,0.778,3,8,11,6,1,0,1,3,23,7,1,MIA,CHI,MIA,118,19.5,Points,40,34,29,17
Bam Adebayo,C,22023,1628389,22300220,"NOV 20, 2023",MIA @ CHI,W,30,8,14,0.571,0,0,0.0,7,9,0.778,3,8,11,6,1,0,1,3,23,7,1,MIA,CHI,MIA,118,10.5,Rebounds,40,34,29,17
Bam Adebayo,C,22023,1628389,22300220,"NOV 20, 2023",MIA @ CHI,W,30,8,14,0.571,0,0,0.0,7,9,0.778,3,8,11,6,1,0,1,3,23,7,1,MIA,CHI,MIA,118,33.5,Pts+Rebs+Asts,40,34,29,17
Bam Adebayo,C,22023,1628389,22300220,"NOV 20, 2023",MIA @ CHI,W,30,8,14,0.571,0,0,0.0,7,9,0.778,3,8,11,6,1,0,1,3,23,7,1,MIA,CHI,MIA,118,40.0,Fantasy Score,40,34,29,17
Bam Adebayo,C,22023,1628389,22300220,"NOV 20, 2023",MIA @ CHI,W,30,8,14,0.571,0,0,0.0,7,9,0.778,3,8,11,6,1,0,1,3,23,7,1,MIA,CHI,MIA,118,29.5,Pts+Rebs,40,34,29,17
Bam Adebayo,C,22023,1628389,22300220,"NOV 20, 2023",MIA @ CHI,W,30,8,14,0.571,0,0,0.0,7,9,0.778,3,8,11,6,1,0,1,3,23,7,1,MIA,CHI,MIA,118,23.5,Pts+Asts,40,34,29,17
Bam Adebayo,C,22023,1628389,22300220,"NOV 20, 2023",MIA @ CHI,W,30,8,14,0.571,0,0,0.0,7,9,0.778,3,8,11,6,1,0,1,3,23,7,1,MIA,CHI,MIA,118,14.5,Rebs+Asts,40,34,29,17
Bam Adebayo,C,22023,1628389,22300204,"NOV 18, 2023",MIA @ CHI,L,36,8,12,0.667,0,0,0.0,8,8,1.0,1,9,10,5,0,0,3,3,24,-1,1,MIA,CHI,MIA,97,19.5,Points,39,34,29,15
Bam Adebayo,C,22023,1628389,22300204,"NOV 18, 2023",MIA @ CHI,L,36,8,12,0.667,0,0,0.0,8,8,1.0,1,9,10,5,0,0,3,3,24,-1,1,MIA,CHI,MIA,97,10.5,Rebounds,39,34,29,15
Bam Adebayo,C,22023,1628389,22300204,"NOV 18, 2023",MIA @ CHI,L,36,8,12,0.667,0,0,0.0,8,8,1.0,1,9,10,5,0,0,3,3,24,-1,1,MIA,CHI,MIA,97,33.5,Pts+Rebs+Asts,39,34,29,15
Bam Adebayo,C,22023,1628389,22300204,"NOV 18, 2023",MIA @ CHI,L,36,8,12,0.667,0,0,0.0,8,8,1.0,1,9,10,5,0,0,3,3,24,-1,1,MIA,CHI,MIA,97,40.0,Fantasy Score,39,34,29,15
Bam Adebayo,C,22023,1628389,22300204,"NOV 18, 2023",MIA @ CHI,L,36,8,12,0.667,0,0,0.0,8,8,1.0,1,9,10,5,0,0,3,3,24,-1,1,MIA,CHI,MIA,97,29.5,Pts+Rebs,39,34,29,15
Bam Adebayo,C,22023,1628389,22300204,"NOV 18, 2023",MIA @ CHI,L,36,8,12,0.667,0,0,0.0,8,8,1.0,1,9,10,5,0,0,3,3,24,-1,1,MIA,CHI,MIA,97,23.5,Pts+Asts,39,34,29,15
Bam Adebayo,C,22023,1628389,22300204,"NOV 18, 2023",MIA @ CHI,L,36,8,12,0.667,0,0,0.0,8,8,1.0,1,9,10,5,0,0,3,3,24,-1,1,MIA,CHI,MIA,97,14.5,Rebs+Asts,39,34,29,15
Bam Adebayo,C,22023,1628389,22300200,"NOV 16, 2023",MIA vs. BKN,W,34,8,15,0.533,0,0,0.0,4,4,1.0,2,5,7,4,2,0,2,2,20,-6,1,MIA,MIA,BKN,122,19.5,Points,31,27,24,11
Bam Adebayo,C,22023,1628389,22300200,"NOV 16, 2023",MIA vs. BKN,W,34,8,15,0.533,0,0,0.0,4,4,1.0,2,5,7,4,2,0,2,2,20,-6,1,MIA,MIA,BKN,122,10.5,Rebounds,31,27,24,11
Bam Adebayo,C,22023,1628389,22300200,"NOV 16, 2023",MIA vs. BKN,W,34,8,15,0.533,0,0,0.0,4,4,1.0,2,5,7,4,2,0,2,2,20,-6,1,MIA,MIA,BKN,122,33.5,Pts+Rebs+Asts,31,27,24,11
Bam Adebayo,C,22023,1628389,22300200,"NOV 16, 2023",MIA vs. BKN,W,34,8,15,0.533,0,0,0.0,4,4,1.0,2,5,7,4,2,0,2,2,20,-6,1,MIA,MIA,BKN,122,40.0,Fantasy Score,31,27,24,11
Bam Adebayo,C,22023,1628389,22300200,"NOV 16, 2023",MIA vs. BKN,W,34,8,15,0.533,0,0,0.0,4,4,1.0,2,5,7,4,2,0,2,2,20,-6,1,MIA,MIA,BKN,122,29.5,Pts+Rebs,31,27,24,11
Bam Adebayo,C,22023,1628389,22300200,"NOV 16, 2023",MIA vs. BKN,W,34,8,15,0.533,0,0,0.0,4,4,1.0,2,5,7,4,2,0,2,2,20,-6,1,MIA,MIA,BKN,122,23.5,Pts+Asts,31,27,24,11
Bam Adebayo,C,22023,1628389,22300200,"NOV 16, 2023",MIA vs. BKN,W,34,8,15,0.533,0,0,0.0,4,4,1.0,2,5,7,4,2,0,2,2,20,-6,1,MIA,MIA,BKN,122,14.5,Rebs+Asts,31,27,24,11
Bam Adebayo,C,22023,1628389,22300017,"NOV 14, 2023",MIA @ CHA,W,36,8,16,0.5,0,0,0.0,5,6,0.833,0,11,11,4,3,1,1,3,21,1,1,MIA,CHA,MIA,111,19.5,Points,36,32,25,15
Bam Adebayo,C,22023,1628389,22300017,"NOV 14, 2023",MIA @ CHA,W,36,8,16,0.5,0,0,0.0,5,6,0.833,0,11,11,4,3,1,1,3,21,1,1,MIA,CHA,MIA,111,10.5,Rebounds,36,32,25,15
Bam Adebayo,C,22023,1628389,22300017,"NOV 14, 2023",MIA @ CHA,W,36,8,16,0.5,0,0,0.0,5,6,0.833,0,11,11,4,3,1,1,3,21,1,1,MIA,CHA,MIA,111,33.5,Pts+Rebs+Asts,36,32,25,15
Bam Adebayo,C,22023,1628389,22300017,"NOV 14, 2023",MIA @ CHA,W,36,8,16,0.5,0,0,0.0,5,6,0.833,0,11,11,4,3,1,1,3,21,1,1,MIA,CHA,MIA,111,40.0,Fantasy Score,36,32,25,15
Bam Adebayo,C,22023,1628389,22300017,"NOV 14, 2023",MIA @ CHA,W,36,8,16,0.5,0,0,0.0,5,6,0.833,0,11,11,4,3,1,1,3,21,1,1,MIA,CHA,MIA,111,29.5,Pts+Rebs,36,32,25,15
Bam Adebayo,C,22023,1628389,22300017,"NOV 14, 2023",MIA @ CHA,W,36,8,16,0.5,0,0,0.0,5,6,0.833,0,11,11,4,3,1,1,3,21,1,1,MIA,CHA,MIA,111,23.5,Pts+Asts,36,32,25,15
Bam Adebayo,C,22023,1628389,22300017,"NOV 14, 2023",MIA @ CHA,W,36,8,16,0.5,0,0,0.0,5,6,0.833,0,11,11,4,3,1,1,3,21,1,1,MIA,CHA,MIA,111,14.5,Rebs+Asts,36,32,25,15
Bam Adebayo,C,22023,1628389,22300184,"NOV 12, 2023",MIA @ SAS,W,34,10,20,0.5,0,0,0.0,4,5,0.8,4,7,11,6,3,0,0,0,24,-10,1,MIA,SAS,MIA,118,19.5,Points,41,35,30,17
Bam Adebayo,C,22023,1628389,22300184,"NOV 12, 2023",MIA @ SAS,W,34,10,20,0.5,0,0,0.0,4,5,0.8,4,7,11,6,3,0,0,0,24,-10,1,MIA,SAS,MIA,118,10.5,Rebounds,41,35,30,17
Bam Adebayo,C,22023,1628389,22300184,"NOV 12, 2023",MIA @ SAS,W,34,10,20,0.5,0,0,0.0,4,5,0.8,4,7,11,6,3,0,0,0,24,-10,1,MIA,SAS,MIA,118,33.5,Pts+Rebs+Asts,41,35,30,17
Bam Adebayo,C,22023,1628389,22300184,"NOV 12, 2023",MIA @ SAS,W,34,10,20,0.5,0,0,0.0,4,5,0.8,4,7,11,6,3,0,0,0,24,-10,1,MIA,SAS,MIA,118,40.0,Fantasy Score,41,35,30,17
Bam Adebayo,C,22023,1628389,22300184,"NOV 12, 2023",MIA @ SAS,W,34,10,20,0.5,0,0,0.0,4,5,0.8,4,7,11,6,3,0,0,0,24,-10,1,MIA,SAS,MIA,118,29.5,Pts+Rebs,41,35,30,17
Bam Adebayo,C,22023,1628389,22300184,"NOV 12, 2023",MIA @ SAS,W,34,10,20,0.5,0,0,0.0,4,5,0.8,4,7,11,6,3,0,0,0,24,-10,1,MIA,SAS,MIA,118,23.5,Pts+Asts,41,35,30,17
Bam Adebayo,C,22023,1628389,22300184,"NOV 12, 2023",MIA @ SAS,W,34,10,20,0.5,0,0,0.0,4,5,0.8,4,7,11,6,3,0,0,0,24,-10,1,MIA,SAS,MIA,118,14.5,Rebs+Asts,41,35,30,17
Bam Adebayo,C,22023,1628389,22300175,"NOV 11, 2023",MIA @ ATL,W,39,9,12,0.75,0,0,0.0,8,8,1.0,4,13,17,4,2,2,3,2,26,-5,1,MIA,ATL,MIA,117,19.5,Points,47,43,30,21
Bam Adebayo,C,22023,1628389,22300175,"NOV 11, 2023",MIA @ ATL,W,39,9,12,0.75,0,0,0.0,8,8,1.0,4,13,17,4,2,2,3,2,26,-5,1,MIA,ATL,MIA,117,10.5,Rebounds,47,43,30,21
Bam Adebayo,C,22023,1628389,22300175,"NOV 11, 2023",MIA @ ATL,W,39,9,12,0.75,0,0,0.0,8,8,1.0,4,13,17,4,2,2,3,2,26,-5,1,MIA,ATL,MIA,117,33.5,Pts+Rebs+Asts,47,43,30,21
Bam Adebayo,C,22023,1628389,22300175,"NOV 11, 2023",MIA @ ATL,W,39,9,12,0.75,0,0,0.0,8,8,1.0,4,13,17,4,2,2,3,2,26,-5,1,MIA,ATL,MIA,117,40.0,Fantasy Score,47,43,30,21
Bam Adebayo,C,22023,1628389,22300175,"NOV 11, 2023",MIA @ ATL,W,39,9,12,0.75,0,0,0.0,8,8,1.0,4,13,17,4,2,2,3,2,26,-5,1,MIA,ATL,MIA,117,29.5,Pts+Rebs,47,43,30,21
Bam Adebayo,C,22023,1628389,22300175,"NOV 11, 2023",MIA @ ATL,W,39,9,12,0.75,0,0,0.0,8,8,1.0,4,13,17,4,2,2,3,2,26,-5,1,MIA,ATL,MIA,117,23.5,Pts+Asts,47,43,30,21
Bam Adebayo,C,22023,1628389,22300175,"NOV 11, 2023",MIA @ ATL,W,39,9,12,0.75,0,0,0.0,8,8,1.0,4,13,17,4,2,2,3,2,26,-5,1,MIA,ATL,MIA,117,14.5,Rebs+Asts,47,43,30,21
Bam Adebayo,C,22023,1628389,22300164,"NOV 08, 2023",MIA @ MEM,W,36,8,15,0.533,0,0,0.0,14,16,0.875,0,11,11,1,1,3,4,5,30,15,1,MIA,MEM,MIA,108,19.5,Points,42,41,31,12
Bam Adebayo,C,22023,1628389,22300164,"NOV 08, 2023",MIA @ MEM,W,36,8,15,0.533,0,0,0.0,14,16,0.875,0,11,11,1,1,3,4,5,30,15,1,MIA,MEM,MIA,108,10.5,Rebounds,42,41,31,12
Bam Adebayo,C,22023,1628389,22300164,"NOV 08, 2023",MIA @ MEM,W,36,8,15,0.533,0,0,0.0,14,16,0.875,0,11,11,1,1,3,4,5,30,15,1,MIA,MEM,MIA,108,33.5,Pts+Rebs+Asts,42,41,31,12
Bam Adebayo,C,22023,1628389,22300164,"NOV 08, 2023",MIA @ MEM,W,36,8,15,0.533,0,0,0.0,14,16,0.875,0,11,11,1,1,3,4,5,30,15,1,MIA,MEM,MIA,108,40.0,Fantasy Score,42,41,31,12
Bam Adebayo,C,22023,1628389,22300164,"NOV 08, 2023",MIA @ MEM,W,36,8,15,0.533,0,0,0.0,14,16,0.875,0,11,11,1,1,3,4,5,30,15,1,MIA,MEM,MIA,108,29.5,Pts+Rebs,42,41,31,12
Bam Adebayo,C,22023,1628389,22300164,"NOV 08, 2023",MIA @ MEM,W,36,8,15,0.533,0,0,0.0,14,16,0.875,0,11,11,1,1,3,4,5,30,15,1,MIA,MEM,MIA,108,23.5,Pts+Asts,42,41,31,12
Bam Adebayo,C,22023,1628389,22300164,"NOV 08, 2023",MIA @ MEM,W,36,8,15,0.533,0,0,0.0,14,16,0.875,0,11,11,1,1,3,4,5,30,15,1,MIA,MEM,MIA,108,14.5,Rebs+Asts,42,41,31,12
Bam Adebayo,C,22023,1628389,22300150,"NOV 06, 2023",MIA vs. LAL,W,38,9,20,0.45,1,1,1.0,3,5,0.6,5,14,19,10,2,2,4,2,22,5,1,MIA,MIA,LAL,108,19.5,Points,51,41,32,29
Bam Adebayo,C,22023,1628389,22300150,"NOV 06, 2023",MIA vs. LAL,W,38,9,20,0.45,1,1,1.0,3,5,0.6,5,14,19,10,2,2,4,2,22,5,1,MIA,MIA,LAL,108,10.5,Rebounds,51,41,32,29
Bam Adebayo,C,22023,1628389,22300150,"NOV 06, 2023",MIA vs. LAL,W,38,9,20,0.45,1,1,1.0,3,5,0.6,5,14,19,10,2,2,4,2,22,5,1,MIA,MIA,LAL,108,33.5,Pts+Rebs+Asts,51,41,32,29
Bam Adebayo,C,22023,1628389,22300150,"NOV 06, 2023",MIA vs. LAL,W,38,9,20,0.45,1,1,1.0,3,5,0.6,5,14,19,10,2,2,4,2,22,5,1,MIA,MIA,LAL,108,40.0,Fantasy Score,51,41,32,29
Bam Adebayo,C,22023,1628389,22300150,"NOV 06, 2023",MIA vs. LAL,W,38,9,20,0.45,1,1,1.0,3,5,0.6,5,14,19,10,2,2,4,2,22,5,1,MIA,MIA,LAL,108,29.5,Pts+Rebs,51,41,32,29
Bam Adebayo,C,22023,1628389,22300150,"NOV 06, 2023",MIA vs. LAL,W,38,9,20,0.45,1,1,1.0,3,5,0.6,5,14,19,10,2,2,4,2,22,5,1,MIA,MIA,LAL,108,23.5,Pts+Asts,51,41,32,29
Bam Adebayo,C,22023,1628389,22300150,"NOV 06, 2023",MIA vs. LAL,W,38,9,20,0.45,1,1,1.0,3,5,0.6,5,14,19,10,2,2,4,2,22,5,1,MIA,MIA,LAL,108,14.5,Rebs+Asts,51,41,32,29
Bam Adebayo,C,22023,1628389,22300003,"NOV 03, 2023",MIA vs. WAS,W,30,8,15,0.533,0,0,0.0,2,2,1.0,0,4,4,3,0,0,4,3,18,6,1,MIA,MIA,WAS,121,19.5,Points,25,22,21,7
Bam Adebayo,C,22023,1628389,22300003,"NOV 03, 2023",MIA vs. WAS,W,30,8,15,0.533,0,0,0.0,2,2,1.0,0,4,4,3,0,0,4,3,18,6,1,MIA,MIA,WAS,121,10.5,Rebounds,25,22,21,7
Bam Adebayo,C,22023,1628389,22300003,"NOV 03, 2023",MIA vs. WAS,W,30,8,15,0.533,0,0,0.0,2,2,1.0,0,4,4,3,0,0,4,3,18,6,1,MIA,MIA,WAS,121,33.5,Pts+Rebs+Asts,25,22,21,7
Bam Adebayo,C,22023,1628389,22300003,"NOV 03, 2023",MIA vs. WAS,W,30,8,15,0.533,0,0,0.0,2,2,1.0,0,4,4,3,0,0,4,3,18,6,1,MIA,MIA,WAS,121,40.0,Fantasy Score,25,22,21,7
Bam Adebayo,C,22023,1628389,22300003,"NOV 03, 2023",MIA vs. WAS,W,30,8,15,0.533,0,0,0.0,2,2,1.0,0,4,4,3,0,0,4,3,18,6,1,MIA,MIA,WAS,121,29.5,Pts+Rebs,25,22,21,7
Bam Adebayo,C,22023,1628389,22300003,"NOV 03, 2023",MIA vs. WAS,W,30,8,15,0.533,0,0,0.0,2,2,1.0,0,4,4,3,0,0,4,3,18,6,1,MIA,MIA,WAS,121,23.5,Pts+Asts,25,22,21,7
Bam Adebayo,C,22023,1628389,22300003,"NOV 03, 2023",MIA vs. WAS,W,30,8,15,0.533,0,0,0.0,2,2,1.0,0,4,4,3,0,0,4,3,18,6,1,MIA,MIA,WAS,121,14.5,Rebs+Asts,25,22,21,7
Bam Adebayo,C,22023,1628389,22300119,"NOV 01, 2023",MIA vs. BKN,L,33,8,12,0.667,0,0,0.0,5,5,1.0,4,10,14,3,2,2,4,0,21,5,1,MIA,MIA,BKN,105,19.5,Points,38,35,24,17
Bam Adebayo,C,22023,1628389,22300119,"NOV 01, 2023",MIA vs. BKN,L,33,8,12,0.667,0,0,0.0,5,5,1.0,4,10,14,3,2,2,4,0,21,5,1,MIA,MIA,BKN,105,10.5,Rebounds,38,35,24,17
Bam Adebayo,C,22023,1628389,22300119,"NOV 01, 2023",MIA vs. BKN,L,33,8,12,0.667,0,0,0.0,5,5,1.0,4,10,14,3,2,2,4,0,21,5,1,MIA,MIA,BKN,105,33.5,Pts+Rebs+Asts,38,35,24,17
Bam Adebayo,C,22023,1628389,22300119,"NOV 01, 2023",MIA vs. BKN,L,33,8,12,0.667,0,0,0.0,5,5,1.0,4,10,14,3,2,2,4,0,21,5,1,MIA,MIA,BKN,105,40.0,Fantasy Score,38,35,24,17
Bam Adebayo,C,22023,1628389,22300119,"NOV 01, 2023",MIA vs. BKN,L,33,8,12,0.667,0,0,0.0,5,5,1.0,4,10,14,3,2,2,4,0,21,5,1,MIA,MIA,BKN,105,29.5,Pts+Rebs,38,35,24,17
Bam Adebayo,C,22023,1628389,22300119,"NOV 01, 2023",MIA vs. BKN,L,33,8,12,0.667,0,0,0.0,5,5,1.0,4,10,14,3,2,2,4,0,21,5,1,MIA,MIA,BKN,105,23.5,Pts+Asts,38,35,24,17
Bam Adebayo,C,22023,1628389,22300119,"NOV 01, 2023",MIA vs. BKN,L,33,8,12,0.667,0,0,0.0,5,5,1.0,4,10,14,3,2,2,4,0,21,5,1,MIA,MIA,BKN,105,14.5,Rebs+Asts,38,35,24,17
Bam Adebayo,C,22023,1628389,22300093,"OCT 28, 2023",MIA @ MIN,L,33,7,14,0.5,0,1,0.0,5,10,0.5,1,2,3,2,0,0,4,4,19,-10,1,MIA,MIN,MIA,90,19.5,Points,24,22,21,5
Bam Adebayo,C,22023,1628389,22300093,"OCT 28, 2023",MIA @ MIN,L,33,7,14,0.5,0,1,0.0,5,10,0.5,1,2,3,2,0,0,4,4,19,-10,1,MIA,MIN,MIA,90,10.5,Rebounds,24,22,21,5
Bam Adebayo,C,22023,1628389,22300093,"OCT 28, 2023",MIA @ MIN,L,33,7,14,0.5,0,1,0.0,5,10,0.5,1,2,3,2,0,0,4,4,19,-10,1,MIA,MIN,MIA,90,33.5,Pts+Rebs+Asts,24,22,21,5
Bam Adebayo,C,22023,1628389,22300093,"OCT 28, 2023",MIA @ MIN,L,33,7,14,0.5,0,1,0.0,5,10,0.5,1,2,3,2,0,0,4,4,19,-10,1,MIA,MIN,MIA,90,40.0,Fantasy Score,24,22,21,5
Bam Adebayo,C,22023,1628389,22300093,"OCT 28, 2023",MIA @ MIN,L,33,7,14,0.5,0,1,0.0,5,10,0.5,1,2,3,2,0,0,4,4,19,-10,1,MIA,MIN,MIA,90,29.5,Pts+Rebs,24,22,21,5
Bam Adebayo,C,22023,1628389,22300093,"OCT 28, 2023",MIA @ MIN,L,33,7,14,0.5,0,1,0.0,5,10,0.5,1,2,3,2,0,0,4,4,19,-10,1,MIA,MIN,MIA,90,23.5,Pts+Asts,24,22,21,5
Bam Adebayo,C,22023,1628389,22300093,"OCT 28, 2023",MIA @ MIN,L,33,7,14,0.5,0,1,0.0,5,10,0.5,1,2,3,2,0,0,4,4,19,-10,1,MIA,MIN,MIA,90,14.5,Rebs+Asts,24,22,21,5
Bam Adebayo,C,22023,1628389,22300080,"OCT 27, 2023",MIA @ BOS,L,35,10,23,0.435,0,0,0.0,7,9,0.778,3,4,7,2,1,2,3,1,27,0,1,MIA,BOS,MIA,111,19.5,Points,36,34,29,9
Bam Adebayo,C,22023,1628389,22300080,"OCT 27, 2023",MIA @ BOS,L,35,10,23,0.435,0,0,0.0,7,9,0.778,3,4,7,2,1,2,3,1,27,0,1,MIA,BOS,MIA,111,10.5,Rebounds,36,34,29,9
Bam Adebayo,C,22023,1628389,22300080,"OCT 27, 2023",MIA @ BOS,L,35,10,23,0.435,0,0,0.0,7,9,0.778,3,4,7,2,1,2,3,1,27,0,1,MIA,BOS,MIA,111,33.5,Pts+Rebs+Asts,36,34,29,9
Bam Adebayo,C,22023,1628389,22300080,"OCT 27, 2023",MIA @ BOS,L,35,10,23,0.435,0,0,0.0,7,9,0.778,3,4,7,2,1,2,3,1,27,0,1,MIA,BOS,MIA,111,40.0,Fantasy Score,36,34,29,9
Bam Adebayo,C,22023,1628389,22300080,"OCT 27, 2023",MIA @ BOS,L,35,10,23,0.435,0,0,0.0,7,9,0.778,3,4,7,2,1,2,3,1,27,0,1,MIA,BOS,MIA,111,29.5,Pts+Rebs,36,34,29,9
Bam Adebayo,C,22023,1628389,22300080,"OCT 27, 2023",MIA @ BOS,L,35,10,23,0.435,0,0,0.0,7,9,0.778,3,4,7,2,1,2,3,1,27,0,1,MIA,BOS,MIA,111,23.5,Pts+Asts,36,34,29,9
Bam Adebayo,C,22023,1628389,22300080,"OCT 27, 2023",MIA @ BOS,L,35,10,23,0.435,0,0,0.0,7,9,0.778,3,4,7,2,1,2,3,1,27,0,1,MIA,BOS,MIA,111,14.5,Rebs+Asts,36,34,29,9
Bam Adebayo,C,22023,1628389,22300068,"OCT 25, 2023",MIA vs. DET,W,32,7,13,0.538,0,0,0.0,8,10,0.8,2,6,8,3,0,2,2,3,22,-4,1,MIA,MIA,DET,103,19.5,Points,33,30,25,11
Bam Adebayo,C,22023,1628389,22300068,"OCT 25, 2023",MIA vs. DET,W,32,7,13,0.538,0,0,0.0,8,10,0.8,2,6,8,3,0,2,2,3,22,-4,1,MIA,MIA,DET,103,10.5,Rebounds,33,30,25,11
Bam Adebayo,C,22023,1628389,22300068,"OCT 25, 2023",MIA vs. DET,W,32,7,13,0.538,0,0,0.0,8,10,0.8,2,6,8,3,0,2,2,3,22,-4,1,MIA,MIA,DET,103,33.5,Pts+Rebs+Asts,33,30,25,11
Bam Adebayo,C,22023,1628389,22300068,"OCT 25, 2023",MIA vs. DET,W,32,7,13,0.538,0,0,0.0,8,10,0.8,2,6,8,3,0,2,2,3,22,-4,1,MIA,MIA,DET,103,40.0,Fantasy Score,33,30,25,11
Bam Adebayo,C,22023,1628389,22300068,"OCT 25, 2023",MIA vs. DET,W,32,7,13,0.538,0,0,0.0,8,10,0.8,2,6,8,3,0,2,2,3,22,-4,1,MIA,MIA,DET,103,29.5,Pts+Rebs,33,30,25,11
Bam Adebayo,C,22023,1628389,22300068,"OCT 25, 2023",MIA vs. DET,W,32,7,13,0.538,0,0,0.0,8,10,0.8,2,6,8,3,0,2,2,3,22,-4,1,MIA,MIA,DET,103,23.5,Pts+Asts,33,30,25,11
Bam Adebayo,C,22023,1628389,22300068,"OCT 25, 2023",MIA vs. DET,W,32,7,13,0.538,0,0,0.0,8,10,0.8,2,6,8,3,0,2,2,3,22,-4,1,MIA,MIA,DET,103,14.5,Rebs+Asts,33,30,25,11
Darius Garland,G,22023,1629636,22300756,"FEB 10, 2024",CLE @ TOR,W,29,4,11,0.364,1,5,0.2,2,2,1.0,1,2,3,8,1,0,2,0,11,14,1,CLE,TOR,CLE,119,,,22,14,19,11
Darius Garland,G,22023,1629636,22300735,"FEB 08, 2024",CLE @ BKN,W,29,6,10,0.6,0,3,0.0,2,2,1.0,0,0,0,7,1,0,2,2,14,23,1,CLE,BKN,CLE,118,,,21,14,21,7
Darius Garland,G,22023,1629636,22300728,"FEB 07, 2024",CLE @ WAS,W,28,4,12,0.333,1,5,0.2,4,4,1.0,0,0,0,4,0,0,3,0,13,9,1,CLE,WAS,CLE,114,,,17,13,17,4
Darius Garland,G,22023,1629636,22300714,"FEB 05, 2024",CLE vs. SAC,W,28,4,7,0.571,2,4,0.5,1,1,1.0,1,1,2,5,0,0,2,1,11,4,1,CLE,CLE,SAC,136,,,18,13,16,7
Darius Garland,G,22023,1629636,22300703,"FEB 03, 2024",CLE @ SAS,W,23,1,3,0.333,0,2,0.0,2,2,1.0,0,3,3,4,1,0,3,2,4,-1,1,CLE,SAS,CLE,117,,,11,7,8,7
Darius Garland,G,22023,1629636,22300687,"FEB 01, 2024",CLE @ MEM,W,24,4,10,0.4,1,3,0.333,0,0,0.0,0,2,2,7,1,0,3,0,9,2,1,CLE,MEM,CLE,108,,,18,11,16,9
Darius Garland,G,22023,1629636,22300675,"JAN 31, 2024",CLE vs. DET,W,20,7,12,0.583,2,6,0.333,3,3,1.0,0,0,0,3,2,0,1,1,19,-16,1,CLE,CLE,DET,128,,,22,19,22,3
Darius Garland,G,22023,1629636,22300319,"DEC 14, 2023",CLE @ BOS,L,36,8,19,0.421,3,7,0.429,0,0,0.0,1,1,2,3,2,0,5,2,19,-11,1,CLE,BOS,CLE,107,,,24,21,22,5
Darius Garland,G,22023,1629636,22300305,"DEC 12, 2023",CLE @ BOS,L,38,11,23,0.478,4,8,0.5,0,0,0.0,0,2,2,7,1,0,2,1,26,-3,1,CLE,BOS,CLE,113,,,35,28,33,9
Darius Garland,G,22023,1629636,22300294,"DEC 11, 2023",CLE @ ORL,L,39,11,23,0.478,3,9,0.333,11,12,0.917,1,5,6,5,2,0,3,0,36,6,1,CLE,ORL,CLE,94,,,47,42,41,11
Darius Garland,G,22023,1629636,22301220,"DEC 08, 2023",CLE @ MIA,W,26,6,11,0.545,1,4,0.25,5,7,0.714,0,2,2,6,4,0,2,4,18,20,1,CLE,MIA,CLE,111,,,26,20,24,8
Darius Garland,G,22023,1629636,22301205,"DEC 06, 2023",CLE vs. ORL,W,40,10,18,0.556,1,4,0.25,5,5,1.0,2,1,3,9,0,0,0,1,26,8,1,CLE,CLE,ORL,121,,,38,29,35,12
Darius Garland,G,22023,1629636,22300283,"DEC 02, 2023",CLE @ DET,W,34,9,23,0.391,2,7,0.286,2,3,0.667,0,2,2,5,3,1,2,1,22,13,1,CLE,DET,CLE,110,,,29,24,27,7
Darius Garland,G,22023,1629636,22300265,"NOV 30, 2023",CLE vs. POR,L,37,6,18,0.333,2,8,0.25,1,1,1.0,1,3,4,7,1,0,8,0,15,2,1,CLE,CLE,POR,95,,,26,19,22,11
Darius Garland,G,22023,1629636,22300055,"NOV 28, 2023",CLE vs. ATL,W,38,7,15,0.467,2,5,0.4,3,4,0.75,1,1,2,8,2,0,2,1,19,22,1,CLE,CLE,ATL,128,,,29,21,27,10
Darius Garland,G,22023,1629636,22300251,"NOV 26, 2023",CLE vs. TOR,W,41,10,16,0.625,3,6,0.5,1,1,1.0,0,2,2,8,0,0,5,2,24,12,1,CLE,CLE,TOR,105,,,34,26,32,10
Darius Garland,G,22023,1629636,22300242,"NOV 25, 2023",CLE vs. LAL,L,14,2,6,0.333,0,1,0.0,2,2,1.0,0,1,1,3,1,0,2,1,6,-3,1,CLE,CLE,LAL,115,,,10,7,9,4
Darius Garland,G,22023,1629636,22300229,"NOV 22, 2023",CLE vs. MIA,L,27,6,11,0.545,1,2,0.5,1,2,0.5,0,1,1,3,1,0,3,3,14,-24,1,CLE,CLE,MIA,96,,,18,15,17,4
Darius Garland,G,22023,1629636,22300040,"NOV 21, 2023",CLE @ PHI,W,43,10,25,0.4,2,6,0.333,10,11,0.909,1,4,5,8,3,0,4,1,32,4,1,CLE,PHI,CLE,122,,,45,37,40,13
Darius Garland,G,22023,1629636,22300210,"NOV 19, 2023",CLE vs. DEN,W,33,10,16,0.625,2,4,0.5,4,5,0.8,0,3,3,6,1,1,4,0,26,18,1,CLE,CLE,DEN,121,,,35,29,32,9
Darius Garland,G,22023,1629636,22300030,"NOV 17, 2023",CLE vs. DET,W,34,10,19,0.526,2,5,0.4,6,8,0.75,1,2,3,3,0,0,5,1,28,-6,1,CLE,CLE,DET,108,,,34,31,31,6
Darius Garland,G,22023,1629636,22300191,"NOV 13, 2023",CLE @ SAC,L,34,5,14,0.357,3,8,0.375,3,4,0.75,0,3,3,6,0,0,1,1,16,-14,1,CLE,SAC,CLE,120,,,25,19,22,9
Darius Garland,G,22023,1629636,22300176,"NOV 11, 2023",CLE @ GSW,W,36,6,13,0.462,3,5,0.6,4,6,0.667,2,4,6,4,5,0,4,2,19,5,1,CLE,GSW,CLE,118,,,29,25,23,10
Darius Garland,G,22023,1629636,22300167,"NOV 08, 2023",CLE @ OKC,L,36,7,11,0.636,1,3,0.333,0,1,0.0,1,2,3,9,2,1,8,4,15,-1,1,CLE,OKC,CLE,120,,,27,18,24,12
Darius Garland,G,22023,1629636,22300142,"NOV 05, 2023",CLE vs. GSW,W,30,6,17,0.353,0,5,0.0,12,13,0.923,0,3,3,7,0,0,6,3,24,15,1,CLE,CLE,GSW,115,,,34,27,31,10
Darius Garland,G,22023,1629636,22300001,"NOV 03, 2023",CLE @ IND,L,32,5,11,0.455,0,2,0.0,4,4,1.0,0,0,0,6,2,1,4,1,14,-10,1,CLE,IND,CLE,116,,,20,14,20,6
Darius Garland,G,22023,1629636,22300067,"OCT 25, 2023",CLE @ BKN,W,32,6,12,0.5,1,5,0.2,2,2,1.0,1,1,2,5,2,0,6,2,15,6,1,CLE,BKN,CLE,114,,,22,17,20,7
Victor Wembanyama,F,22023,1641705,22300750,"FEB 10, 2024",SAS @ BKN,L,29,7,16,0.438,3,6,0.5,4,4,1.0,0,4,4,3,0,1,4,2,21,-20,1,SAS,BKN,SAS,103,,,28,25,24,7
Victor Wembanyama,F,22023,1641705,22300681,"JAN 31, 2024",SAS vs. ORL,L,30,7,15,0.467,2,5,0.4,5,5,1.0,0,8,8,3,2,5,3,3,21,-8,1,SAS,SAS,ORL,98,,,32,29,24,11
Victor Wembanyama,F,22023,1641705,22300665,"JAN 29, 2024",SAS vs. WAS,L,31,9,19,0.474,0,4,0.0,4,4,1.0,3,8,11,4,1,3,4,1,22,-12,1,SAS,SAS,WAS,113,,,37,33,26,15
Victor Wembanyama,F,22023,1641705,22300649,"JAN 27, 2024",SAS vs. MIN,W,30,9,17,0.529,3,6,0.5,2,5,0.4,0,10,10,6,2,2,6,3,23,19,1,SAS,SAS,MIN,113,,,39,33,29,16
Victor Wembanyama,F,22023,1641705,22300571,"JAN 17, 2024",SAS @ BOS,L,27,10,19,0.526,2,6,0.333,5,6,0.833,2,3,5,1,0,1,5,2,27,-14,1,SAS,BOS,SAS,95,,,33,32,28,6
Victor Wembanyama,F,22023,1641705,22300559,"JAN 15, 2024",SAS @ ATL,L,27,12,18,0.667,1,5,0.2,1,1,1.0,2,11,13,2,2,5,3,2,26,-2,1,SAS,ATL,SAS,99,,,41,39,28,15
Victor Wembanyama,F,22023,1641705,22300541,"JAN 12, 2024",SAS vs. CHA,W,20,9,14,0.643,2,3,0.667,6,6,1.0,3,8,11,1,0,2,3,2,26,22,1,SAS,SAS,CHA,127,,,38,37,27,12
Victor Wembanyama,F,22023,1641705,22300519,"JAN 10, 2024",SAS @ DET,W,21,6,16,0.375,0,4,0.0,4,5,0.8,3,9,12,10,0,0,0,1,16,15,1,SAS,DET,SAS,129,,,38,28,26,22
Victor Wembanyama,F,22023,1641705,22300497,"JAN 07, 2024",SAS @ CLE,L,25,6,13,0.462,2,5,0.4,10,11,0.909,0,10,10,3,1,5,3,3,24,17,1,SAS,CLE,SAS,115,,,37,34,27,13
Victor Wembanyama,F,22023,1641705,22300477,"JAN 04, 2024",SAS vs. MIL,L,26,10,18,0.556,2,8,0.25,5,6,0.833,3,6,9,1,1,5,5,5,27,-11,1,SAS,SAS,MIL,121,,,37,36,28,10
Victor Wembanyama,F,22023,1641705,22300460,"JAN 02, 2024",SAS @ MEM,L,26,8,16,0.5,2,5,0.4,2,4,0.5,0,7,7,1,0,4,1,0,20,-12,1,SAS,MEM,SAS,98,,,28,27,21,8
Victor Wembanyama,F,22023,1641705,22300448,"DEC 31, 2023",SAS vs. BOS,L,24,8,16,0.5,3,8,0.375,2,2,1.0,2,5,7,3,0,1,3,0,21,-23,1,SAS,SAS,BOS,101,,,31,28,24,10
Victor Wembanyama,F,22023,1641705,22300235,"NOV 22, 2023",SAS vs. LAC,L,33,7,13,0.538,1,2,0.5,7,7,1.0,2,13,15,3,1,3,2,2,22,-3,1,SAS,SAS,LAC,102,,,40,37,25,18
Victor Wembanyama,F,22023,1641705,22300206,"NOV 18, 2023",SAS vs. MEM,L,31,6,17,0.353,2,6,0.333,5,6,0.833,4,9,13,4,1,8,2,5,19,-6,1,SAS,SAS,MEM,108,,,36,32,23,17
Victor Wembanyama,F,22023,1641705,22300021,"NOV 14, 2023",SAS @ OKC,L,28,4,15,0.267,0,3,0.0,0,0,0.0,3,11,14,2,0,2,5,2,8,-31,1,SAS,OKC,SAS,87,,,24,22,10,16
Victor Wembanyama,F,22023,1641705,22300161,"NOV 08, 2023",SAS @ NYK,L,30,4,14,0.286,0,4,0.0,6,6,1.0,4,5,9,2,0,1,3,2,14,-25,1,SAS,NYK,SAS,105,,,25,23,16,11
Victor Wembanyama,F,22023,1641705,22300146,"NOV 06, 2023",SAS @ IND,L,21,3,12,0.25,2,5,0.4,5,6,0.833,1,9,10,0,1,2,2,1,13,-9,1,SAS,IND,SAS,111,,,23,23,13,10
Victor Wembanyama,F,22023,1641705,22300099,"OCT 29, 2023",SAS @ LAC,L,26,4,10,0.4,0,2,0.0,3,6,0.5,1,4,5,2,1,1,5,1,11,-14,1,SAS,LAC,SAS,83,,,18,16,13,7
Victor Wembanyama,F,22023,1641705,22300272,"NOV 30, 2023",SAS vs. ATL,L,29,9,16,0.563,1,5,0.2,2,2,1.0,2,10,12,2,2,4,2,1,21,0,1,SAS,SAS,ATL,135,,,35,33,23,14
Victor Wembanyama,F,22023,1641705,22300252,"NOV 26, 2023",SAS @ DEN,L,25,7,17,0.412,2,5,0.4,6,7,0.857,4,7,11,2,6,4,3,4,22,-10,1,SAS,DEN,SAS,120,,,35,33,24,13
Victor Wembanyama,F,22023,1641705,22300051,"NOV 24, 2023",SAS @ GSW,L,35,8,18,0.444,1,6,0.167,5,5,1.0,2,7,9,4,1,2,6,2,22,2,1,SAS,GSW,SAS,112,,,35,31,26,13
Victor Wembanyama,F,22023,1641705,22300223,"NOV 20, 2023",SAS vs. LAC,L,27,4,12,0.333,0,4,0.0,1,1,1.0,0,3,3,4,0,2,1,1,9,-17,1,SAS,SAS,LAC,99,,,16,12,13,7
Victor Wembanyama,F,22023,1641705,22300032,"NOV 17, 2023",SAS vs. SAC,L,30,12,26,0.462,2,8,0.25,1,1,1.0,1,8,9,0,2,0,4,3,27,-31,1,SAS,SAS,SAC,120,,,36,36,27,9
Victor Wembanyama,F,22023,1641705,22300184,"NOV 12, 2023",SAS vs. MIA,L,34,8,22,0.364,2,9,0.222,0,0,0.0,1,10,11,7,1,1,7,3,18,5,1,SAS,SAS,MIA,113,,,36,29,25,18
Victor Wembanyama,F,22023,1641705,22300013,"NOV 10, 2023",SAS vs. MIN,L,35,12,21,0.571,3,7,0.429,2,4,0.5,1,8,9,4,1,4,3,5,29,3,1,SAS,SAS,MIN,110,,,42,38,33,13
Victor Wembanyama,F,22023,1641705,22300141,"NOV 05, 2023",SAS vs. TOR,L,38,7,16,0.438,2,7,0.286,4,5,0.8,2,7,9,4,1,5,2,1,20,-16,1,SAS,SAS,TOR,116,,,33,29,24,13
Victor Wembanyama,F,22023,1641705,22300131,"NOV 02, 2023",SAS @ PHX,W,34,15,26,0.577,3,6,0.5,5,6,0.833,2,8,10,2,1,2,2,3,38,21,1,SAS,PHX,SAS,132,,,50,48,40,12
Victor Wembanyama,F,22023,1641705,22300113,"OCT 31, 2023",SAS @ PHX,W,28,6,12,0.5,2,6,0.333,4,5,0.8,3,5,8,1,0,4,5,3,18,-3,1,SAS,PHX,SAS,115,,,27,26,19,9
Victor Wembanyama,F,22023,1641705,22300083,"OCT 27, 2023",SAS vs. HOU,W,31,7,19,0.368,0,6,0.0,7,8,0.875,5,7,12,1,3,3,4,2,21,9,1,SAS,SAS,HOU,126,,,34,33,22,13
Victor Wembanyama,F,22023,1641705,22300073,"OCT 25, 2023",SAS vs. DAL,L,23,6,9,0.667,3,5,0.6,0,1,0.0,0,5,5,2,2,1,5,5,15,0,1,SAS,SAS,DAL,119,,,22,20,17,7
Victor Wembanyama,F,22023,1641705,22300734,"FEB 08, 2024",SAS @ ORL,L,23,6,12,0.5,2,4,0.5,1,1,1.0,0,1,1,2,1,3,5,1,15,-11,1,SAS,ORL,SAS,111,,,18,16,17,3
Victor Wembanyama,F,22023,1641705,22300730,"FEB 07, 2024",SAS @ MIA,L,28,7,13,0.538,3,5,0.6,1,3,0.333,0,13,13,3,1,1,3,1,18,-12,1,SAS,MIA,SAS,104,,,34,31,21,16
Victor Wembanyama,F,22023,1641705,22300703,"FEB 03, 2024",SAS vs. CLE,L,27,5,16,0.313,2,4,0.5,7,8,0.875,4,10,14,3,2,2,3,0,19,10,1,SAS,SAS,CLE,101,,,36,33,22,17
Victor Wembanyama,F,22023,1641705,22300696,"FEB 02, 2024",SAS vs. NOP,L,28,7,14,0.5,0,3,0.0,2,2,1.0,5,9,14,7,2,3,6,2,16,-9,1,SAS,SAS,NOP,113,,,37,30,23,21
Victor Wembanyama,F,22023,1641705,22300622,"JAN 24, 2024",SAS vs. OKC,L,28,9,18,0.5,0,3,0.0,6,8,0.75,6,6,12,4,1,4,3,2,24,-11,1,SAS,SAS,OKC,114,,,40,36,28,16
Victor Wembanyama,F,22023,1641705,22300594,"JAN 20, 2024",SAS @ WAS,W,28,10,21,0.476,2,5,0.4,2,4,0.5,1,7,8,4,0,6,6,3,24,4,1,SAS,WAS,SAS,131,,,36,32,28,12
Victor Wembanyama,F,22023,1641705,22300427,"DEC 28, 2023",SAS @ POR,W,24,9,14,0.643,2,4,0.5,10,10,1.0,0,6,6,6,0,7,1,0,30,18,1,SAS,POR,SAS,118,,,42,36,36,12
Victor Wembanyama,F,22023,1641705,22300412,"DEC 26, 2023",SAS vs. UTA,L,24,6,15,0.4,1,4,0.25,2,3,0.667,2,5,7,4,1,5,4,1,15,-9,1,SAS,SAS,UTA,118,,,26,22,19,11
Victor Wembanyama,F,22023,1641705,22300376,"DEC 21, 2023",SAS @ CHI,L,22,3,8,0.375,0,1,0.0,1,3,0.333,0,5,5,5,2,3,2,0,7,-7,1,SAS,CHI,SAS,95,,,17,12,12,10
Victor Wembanyama,F,22023,1641705,22300345,"DEC 17, 2023",SAS vs. NOP,L,31,6,13,0.462,2,6,0.333,3,4,0.75,1,12,13,4,1,4,3,2,17,-14,1,SAS,SAS,NOP,110,,,34,30,21,17
Victor Wembanyama,F,22023,1641705,22300331,"DEC 15, 2023",SAS vs. LAL,W,31,5,13,0.385,1,2,0.5,2,3,0.667,3,12,15,5,2,2,2,3,13,19,1,SAS,SAS,LAL,129,,,33,28,18,20
Victor Wembanyama,F,22023,1641705,22300316,"DEC 13, 2023",SAS vs. LAL,L,32,11,21,0.524,4,5,0.8,4,7,0.571,4,9,13,2,3,6,5,6,30,-5,1,SAS,SAS,LAL,119,,,45,43,32,15
Victor Wembanyama,F,22023,1641705,22300298,"DEC 11, 2023",SAS @ HOU,L,33,7,15,0.467,1,6,0.167,0,1,0.0,2,16,18,3,0,5,5,3,15,-12,1,SAS,HOU,SAS,82,,,36,33,18,21
Victor Wembanyama,F,22023,1641705,22301223,"DEC 08, 2023",SAS vs. CHI,L,32,8,20,0.4,0,4,0.0,5,6,0.833,7,13,20,4,1,4,1,2,21,-22,1,SAS,SAS,CHI,112,,,45,41,25,24
Victor Wembanyama,F,22023,1641705,22301210,"DEC 06, 2023",SAS @ MIN,L,32,4,13,0.308,0,2,0.0,4,6,0.667,3,7,10,1,1,1,2,1,12,4,1,SAS,MIN,SAS,94,,,23,22,13,11
Victor Wembanyama,F,22023,1641705,22300641,"JAN 26, 2024",SAS vs. POR,W,29,7,18,0.389,3,7,0.429,6,6,1.0,3,9,12,4,2,2,7,1,23,23,1,SAS,SAS,POR,116,,,39,35,27,16
Victor Wembanyama,F,22023,1641705,22300608,"JAN 22, 2024",SAS @ PHI,L,28,10,19,0.526,2,5,0.4,11,12,0.917,3,4,7,2,0,2,1,5,33,0,1,SAS,PHI,SAS,123,,,42,40,35,9
Franz Wagner,F,22023,1630532,22300752,"FEB 10, 2024",ORL vs. CHI,W,44,12,22,0.545,5,12,0.417,7,10,0.7,1,2,3,5,0,0,1,3,36,3,1,ORL,ORL,CHI,114,,,44,39,41,8
Franz Wagner,F,22023,1630532,22300734,"FEB 08, 2024",ORL vs. SAS,W,28,13,17,0.765,3,4,0.75,5,5,1.0,1,6,7,7,0,2,1,0,34,19,1,ORL,ORL,SAS,127,,,48,41,41,14
Franz Wagner,F,22023,1630532,22300721,"FEB 06, 2024",ORL @ MIA,L,35,5,15,0.333,1,7,0.143,2,2,1.0,1,6,7,3,2,0,7,1,13,-20,1,ORL,MIA,ORL,95,,,23,20,16,10
Franz Wagner,F,22023,1630532,22300704,"FEB 04, 2024",ORL @ DET,W,36,17,25,0.68,4,7,0.571,0,0,0.0,1,2,3,2,1,0,0,2,38,16,1,ORL,DET,ORL,111,,,43,41,40,5
Franz Wagner,F,22023,1630532,22300694,"FEB 02, 2024",ORL @ MIN,W,35,7,17,0.412,0,5,0.0,5,6,0.833,2,2,4,5,2,1,1,3,19,12,1,ORL,MIN,ORL,108,,,28,23,24,9
Franz Wagner,F,22023,1630532,22300681,"JAN 31, 2024",ORL @ SAS,W,33,9,16,0.563,2,4,0.5,0,0,0.0,1,7,8,5,1,0,6,4,20,5,1,ORL,SAS,ORL,108,,,33,28,25,13
Franz Wagner,F,22023,1630532,22300666,"JAN 29, 2024",ORL @ DAL,L,32,8,16,0.5,3,6,0.5,2,3,0.667,3,2,5,6,1,0,0,5,21,3,1,ORL,DAL,ORL,129,,,32,26,27,11
Franz Wagner,F,22023,1630532,22300655,"JAN 28, 2024",ORL vs. PHX,W,31,3,11,0.273,2,7,0.286,3,3,1.0,2,6,8,7,1,0,2,2,11,18,1,ORL,ORL,PHX,113,,,26,19,18,15
Franz Wagner,F,22023,1630532,22300638,"JAN 26, 2024",ORL @ MEM,L,38,6,15,0.4,4,8,0.5,2,3,0.667,1,4,5,4,1,1,5,1,18,2,1,ORL,MEM,ORL,106,,,27,23,22,9
Franz Wagner,F,22023,1630532,22300607,"JAN 22, 2024",ORL vs. CLE,L,24,6,11,0.545,2,5,0.4,3,3,1.0,1,2,3,2,0,0,3,2,17,-23,1,ORL,ORL,CLE,99,,,22,20,19,5
Franz Wagner,F,22023,1630532,22300601,"JAN 21, 2024",ORL vs. MIA,W,28,6,13,0.462,2,5,0.4,5,5,1.0,1,1,2,5,0,0,0,2,19,18,1,ORL,ORL,MIA,105,,,26,21,24,7
Franz Wagner,F,22023,1630532,22300463,"JAN 02, 2024",ORL @ GSW,L,37,10,19,0.526,1,5,0.2,4,4,1.0,2,4,6,3,2,0,4,4,25,-1,1,ORL,GSW,ORL,115,,,34,31,28,9
Franz Wagner,F,22023,1630532,22300450,"DEC 31, 2023",ORL @ PHX,L,39,11,25,0.44,2,8,0.25,3,3,1.0,1,6,7,6,0,1,2,4,27,-8,1,ORL,PHX,ORL,107,,,40,34,33,13
Franz Wagner,F,22023,1630532,22300429,"DEC 29, 2023",ORL vs. NYK,W,39,11,19,0.579,3,5,0.6,7,7,1.0,2,7,9,2,4,1,4,1,32,15,1,ORL,ORL,NYK,117,,,43,41,34,11
Franz Wagner,F,22023,1630532,22300415,"DEC 27, 2023",ORL vs. PHI,L,36,8,16,0.5,1,5,0.2,7,8,0.875,0,5,5,3,1,0,4,4,24,-22,1,ORL,ORL,PHI,92,,,32,29,27,8
Franz Wagner,F,22023,1630532,22300407,"DEC 26, 2023",ORL @ WAS,W,38,10,17,0.588,2,4,0.5,6,8,0.75,0,8,8,9,1,1,2,3,28,26,1,ORL,WAS,ORL,127,,,45,36,37,17
Franz Wagner,F,22023,1630532,22300391,"DEC 23, 2023",ORL @ IND,W,36,8,14,0.571,0,2,0.0,8,8,1.0,1,5,6,0,1,0,1,4,24,0,1,ORL,IND,ORL,117,,,30,30,24,6
Franz Wagner,F,22023,1630532,22300378,"DEC 21, 2023",ORL @ MIL,L,39,13,23,0.565,1,6,0.167,2,4,0.5,1,5,6,6,1,0,2,4,29,-7,1,ORL,MIL,ORL,114,,,41,35,35,12
Franz Wagner,F,22023,1630532,22300366,"DEC 20, 2023",ORL vs. MIA,L,32,5,14,0.357,0,4,0.0,5,6,0.833,0,6,6,5,2,1,0,1,15,-13,1,ORL,ORL,MIA,106,,,26,21,20,11
Franz Wagner,F,22023,1630532,22300344,"DEC 17, 2023",ORL @ BOS,L,37,3,14,0.214,0,4,0.0,2,2,1.0,2,6,8,6,0,0,0,2,8,-12,1,ORL,BOS,ORL,97,,,22,16,14,14
Franz Wagner,F,22023,1630532,22300329,"DEC 15, 2023",ORL @ BOS,L,34,6,14,0.429,1,4,0.25,4,4,1.0,0,5,5,5,3,0,6,4,17,-9,1,ORL,BOS,ORL,111,,,27,22,22,10
Franz Wagner,F,22023,1630532,22300294,"DEC 11, 2023",ORL vs. CLE,W,33,7,18,0.389,0,5,0.0,5,7,0.714,1,7,8,4,0,0,1,4,19,11,1,ORL,ORL,CLE,104,,,31,27,23,12
Franz Wagner,F,22023,1630532,22301217,"DEC 08, 2023",ORL vs. DET,W,31,12,20,0.6,2,4,0.5,1,1,1.0,0,2,2,3,0,0,0,0,27,19,1,ORL,ORL,DET,123,,,32,29,30,5
Franz Wagner,F,22023,1630532,22301205,"DEC 06, 2023",ORL @ CLE,L,41,3,16,0.188,0,5,0.0,8,10,0.8,2,4,6,9,3,0,2,1,14,-2,1,ORL,CLE,ORL,111,,,29,20,23,15
Franz Wagner,F,22023,1630532,22300282,"DEC 02, 2023",ORL @ BKN,L,34,6,16,0.375,2,3,0.667,6,6,1.0,1,6,7,5,0,1,1,5,20,-17,1,ORL,BKN,ORL,101,,,32,27,25,12
Franz Wagner,F,22023,1630532,22300274,"DEC 01, 2023",ORL vs. WAS,W,34,9,17,0.529,1,3,0.333,12,14,0.857,1,6,7,8,0,0,0,0,31,0,1,ORL,ORL,WAS,130,,,46,38,39,15
Franz Wagner,F,22023,1630532,22300259,"NOV 29, 2023",ORL vs. WAS,W,31,11,14,0.786,4,6,0.667,5,6,0.833,3,3,6,3,0,1,2,1,31,9,1,ORL,ORL,WAS,139,,,40,37,34,9
Franz Wagner,F,22023,1630532,22300248,"NOV 26, 2023",ORL vs. CHA,W,35,11,15,0.733,2,3,0.667,6,9,0.667,1,6,7,2,2,0,3,3,30,10,1,ORL,ORL,CHA,130,,,39,37,32,9
Franz Wagner,F,22023,1630532,22300043,"NOV 24, 2023",ORL vs. BOS,W,35,8,17,0.471,1,6,0.167,0,0,0.0,0,8,8,6,0,1,3,2,17,10,1,ORL,ORL,BOS,113,,,31,25,23,14
Franz Wagner,F,22023,1630532,22300226,"NOV 22, 2023",ORL vs. DEN,W,31,11,18,0.611,1,4,0.25,4,4,1.0,1,2,3,4,1,2,1,1,27,-4,1,ORL,ORL,DEN,124,,,34,30,31,7
Franz Wagner,F,22023,1630532,22300038,"NOV 21, 2023",ORL vs. TOR,W,31,8,18,0.444,1,4,0.25,0,1,0.0,2,2,4,2,3,0,0,2,17,17,1,ORL,ORL,TOR,126,,,23,21,19,6
Franz Wagner,F,22023,1630532,22300209,"NOV 19, 2023",ORL @ IND,W,22,6,14,0.429,0,2,0.0,7,7,1.0,1,6,7,1,2,0,0,2,19,26,1,ORL,IND,ORL,128,,,27,26,20,8
Franz Wagner,F,22023,1630532,22300033,"NOV 17, 2023",ORL @ CHI,W,35,9,18,0.5,2,8,0.25,1,2,0.5,0,4,4,2,2,0,2,2,21,-6,1,ORL,CHI,ORL,103,,,27,25,23,6
Franz Wagner,F,22023,1630532,22300196,"NOV 15, 2023",ORL @ CHI,W,31,5,16,0.313,0,4,0.0,3,3,1.0,0,2,2,3,0,0,1,0,13,1,1,ORL,CHI,ORL,96,,,18,15,16,5
Franz Wagner,F,22023,1630532,22300020,"NOV 14, 2023",ORL @ BKN,L,36,8,16,0.5,3,8,0.375,2,3,0.667,3,5,8,5,0,0,0,2,21,-8,1,ORL,BKN,ORL,104,,,34,29,26,13
Franz Wagner,F,22023,1630532,22300173,"NOV 11, 2023",ORL vs. MIL,W,38,8,16,0.5,2,6,0.333,6,7,0.857,0,6,6,3,1,0,3,2,24,3,1,ORL,ORL,MIL,112,,,33,30,27,9
Franz Wagner,F,22023,1630532,22300172,"NOV 09, 2023",ORL vs. ATL,L,29,5,12,0.417,0,1,0.0,2,2,1.0,2,5,7,3,0,0,4,2,12,-16,1,ORL,ORL,ATL,119,,,22,19,15,10
Franz Wagner,F,22023,1630532,22300147,"NOV 06, 2023",ORL vs. DAL,L,33,5,13,0.385,1,4,0.25,1,2,0.5,0,5,5,4,1,0,1,3,12,-13,1,ORL,ORL,DAL,102,,,21,17,16,9
Franz Wagner,F,22023,1630532,22300134,"NOV 04, 2023",ORL vs. LAL,W,33,12,28,0.429,1,3,0.333,1,2,0.5,2,3,5,2,1,1,1,1,26,-8,1,ORL,ORL,LAL,120,,,33,31,28,7
Franz Wagner,F,22023,1630532,22300130,"NOV 02, 2023",ORL @ UTA,W,38,9,22,0.409,2,6,0.333,1,2,0.5,1,3,4,5,4,0,2,4,21,8,1,ORL,UTA,ORL,115,,,30,25,26,9
Franz Wagner,F,22023,1630532,22300114,"OCT 31, 2023",ORL @ LAC,L,32,6,13,0.462,2,7,0.286,0,0,0.0,1,7,8,3,0,1,3,4,14,5,1,ORL,LAC,ORL,102,,,25,22,17,11
Franz Wagner,F,22023,1630532,22300111,"OCT 30, 2023",ORL @ LAL,L,37,5,17,0.294,2,7,0.286,4,4,1.0,2,6,8,4,2,0,2,4,16,-2,1,ORL,LAL,ORL,103,,,28,24,20,12
Franz Wagner,F,22023,1630532,22300086,"OCT 27, 2023",ORL @ POR,W,35,6,16,0.375,3,9,0.333,8,9,0.889,0,5,5,3,1,1,3,2,23,11,1,ORL,POR,ORL,102,,,31,28,26,8
Franz Wagner,F,22023,1630532,22300066,"OCT 25, 2023",ORL vs. HOU,W,27,5,12,0.417,3,7,0.429,6,6,1.0,3,1,4,2,1,0,3,1,19,10,1,ORL,ORL,HOU,116,,,25,23,21,6
Franz Wagner,F,22023,1630532,22300476,"JAN 03, 2024",ORL @ SAC,L,5,2,4,0.5,1,1,1.0,1,1,1.0,0,2,2,1,0,0,0,0,6,-1,1,ORL,SAC,ORL,135,,,9,8,7,3
Bojan Bogdanovic,F,22023,202711,22300755,"FEB 10, 2024",NYK vs. IND,L,33,3,10,0.3,2,6,0.333,3,4,0.75,0,3,3,1,1,0,0,2,11,-10,1,NYK,NYK,IND,111,,,15,14,12,4
Bojan Bogdanovic,F,22023,202711,22300453,"JAN 01, 2024",DET @ HOU,L,27,4,11,0.364,3,6,0.5,3,4,0.75,1,1,2,2,0,0,4,0,14,-21,1,DET,HOU,DET,113,,,18,16,16,4
Bojan Bogdanovic,F,22023,202711,22300394,"DEC 23, 2023",DET @ BKN,L,39,5,13,0.385,2,7,0.286,7,9,0.778,2,6,8,4,2,0,4,4,19,0,1,DET,BKN,DET,115,,,31,27,23,12
Bojan Bogdanovic,F,22023,202711,22300374,"DEC 21, 2023",DET vs. UTA,L,35,3,12,0.25,2,7,0.286,0,0,0.0,0,1,1,1,0,1,1,4,8,-1,1,DET,DET,UTA,111,,,10,9,9,2
Bojan Bogdanovic,F,22023,202711,22300352,"DEC 18, 2023",DET @ ATL,L,39,9,17,0.529,5,9,0.556,2,3,0.667,1,1,2,2,0,0,2,3,25,4,1,DET,ATL,DET,124,,,29,27,27,4
Bojan Bogdanovic,F,22023,202711,22300334,"DEC 16, 2023",DET @ MIL,L,31,8,15,0.533,2,6,0.333,6,6,1.0,1,1,2,2,0,0,2,3,24,-16,1,DET,MIL,DET,114,,,28,26,26,4
Bojan Bogdanovic,F,22023,202711,22301217,"DEC 08, 2023",DET @ ORL,L,29,4,10,0.4,1,3,0.333,0,1,0.0,0,3,3,1,1,0,2,1,9,-18,1,DET,ORL,DET,91,,,13,12,10,4
Bojan Bogdanovic,F,22023,202711,22300283,"DEC 02, 2023",DET vs. CLE,L,27,7,15,0.467,3,10,0.3,5,6,0.833,1,1,2,2,1,0,1,1,22,-8,1,DET,DET,CLE,101,,,26,24,24,4
Bojan Bogdanovic,F,22023,202711,22300704,"FEB 04, 2024",DET vs. ORL,L,33,3,12,0.25,1,7,0.143,4,4,1.0,0,5,5,2,0,1,2,1,11,-11,1,DET,DET,ORL,99,,,18,16,13,7
Bojan Bogdanovic,F,22023,202711,22300688,"FEB 02, 2024",DET vs. LAC,L,30,9,13,0.692,6,9,0.667,2,2,1.0,0,1,1,3,0,0,4,2,26,-8,1,DET,DET,LAC,125,,,30,27,29,4
Bojan Bogdanovic,F,22023,202711,22300675,"JAN 31, 2024",DET @ CLE,L,30,5,12,0.417,4,8,0.5,3,4,0.75,0,2,2,0,1,0,4,1,17,-26,1,DET,CLE,DET,121,,,19,19,17,2
Bojan Bogdanovic,F,22023,202711,22300654,"JAN 28, 2024",DET vs. OKC,W,32,6,15,0.4,1,5,0.2,4,4,1.0,0,1,1,2,0,0,1,0,17,4,1,DET,DET,OKC,120,,,20,18,19,3
Bojan Bogdanovic,F,22023,202711,22300642,"JAN 27, 2024",DET vs. WAS,L,36,10,19,0.526,4,10,0.4,6,7,0.857,0,3,3,3,1,0,2,1,30,12,1,DET,DET,WAS,104,,,36,33,33,6
Bojan Bogdanovic,F,22023,202711,22300619,"JAN 24, 2024",DET vs. CHA,W,33,12,23,0.522,5,10,0.5,5,6,0.833,0,4,4,4,0,0,2,1,34,0,1,DET,DET,CHA,113,,,42,38,38,8
Bojan Bogdanovic,F,22023,202711,22300606,"JAN 22, 2024",DET vs. MIL,L,23,6,12,0.5,2,4,0.5,1,2,0.5,0,1,1,1,0,1,0,3,15,-13,1,DET,DET,MIL,113,,,17,16,16,2
Bojan Bogdanovic,F,22023,202711,22300592,"JAN 20, 2024",DET vs. MIL,L,32,5,15,0.333,3,7,0.429,6,8,0.75,0,1,1,2,0,0,1,5,19,-29,1,DET,DET,MIL,135,,,22,20,21,3
Bojan Bogdanovic,F,22023,202711,22300569,"JAN 17, 2024",DET vs. MIN,L,32,7,13,0.538,3,7,0.429,3,4,0.75,0,5,5,3,0,1,1,2,20,-4,1,DET,DET,MIN,117,,,28,25,23,8
Bojan Bogdanovic,F,22023,202711,22300519,"JAN 10, 2024",DET vs. SAS,L,33,8,13,0.615,3,5,0.6,0,0,0.0,0,2,2,2,1,0,4,1,19,-16,1,DET,DET,SAS,108,,,23,21,21,4
Bojan Bogdanovic,F,22023,202711,22300512,"JAN 09, 2024",DET vs. SAC,L,33,10,14,0.714,4,7,0.571,2,3,0.667,1,4,5,2,3,0,3,1,26,-19,1,DET,DET,SAC,110,,,33,31,28,7
Bojan Bogdanovic,F,22023,202711,22300502,"JAN 07, 2024",DET @ DEN,L,27,6,12,0.5,2,4,0.5,0,0,0.0,0,1,1,1,3,0,3,2,14,-4,1,DET,DEN,DET,114,,,16,15,15,2
Bojan Bogdanovic,F,22023,202711,22300490,"JAN 05, 2024",DET @ GSW,L,36,5,19,0.263,2,8,0.25,0,0,0.0,2,3,5,3,2,0,1,0,12,-7,1,DET,GSW,DET,109,,,20,17,15,8
Bojan Bogdanovic,F,22023,202711,22300474,"JAN 03, 2024",DET @ UTA,L,43,13,26,0.5,8,15,0.533,2,2,1.0,1,6,7,5,1,0,1,6,36,-5,1,DET,UTA,DET,148,,,48,43,41,12
Bojan Bogdanovic,F,22023,202711,22300440,"DEC 30, 2023",DET vs. TOR,W,37,7,14,0.5,2,6,0.333,3,5,0.6,0,7,7,3,0,0,4,2,19,-4,1,DET,DET,TOR,129,,,29,26,22,10
Bojan Bogdanovic,F,22023,202711,22300421,"DEC 28, 2023",DET @ BOS,L,44,8,21,0.381,1,7,0.143,0,0,0.0,2,10,12,6,0,0,2,3,17,-6,1,DET,BOS,DET,122,,,35,29,23,18
Bojan Bogdanovic,F,22023,202711,22300406,"DEC 26, 2023",DET vs. BKN,L,39,9,19,0.474,3,9,0.333,2,3,0.667,0,3,3,2,0,0,4,6,23,-3,1,DET,DET,BKN,112,,,28,26,25,5
Bojan Bogdanovic,F,22023,202711,22300327,"DEC 15, 2023",DET @ PHI,L,26,6,12,0.5,2,5,0.4,3,4,0.75,1,2,3,2,0,0,3,1,17,-28,1,DET,PHI,DET,92,,,22,20,19,5
Bojan Bogdanovic,F,22023,202711,22300310,"DEC 13, 2023",DET vs. PHI,L,33,11,19,0.579,5,9,0.556,6,8,0.75,0,1,1,2,1,0,1,1,33,-10,1,DET,DET,PHI,111,,,36,34,35,3
Bojan Bogdanovic,F,22023,202711,22300293,"DEC 11, 2023",DET vs. IND,L,34,5,14,0.357,3,9,0.333,4,7,0.571,0,1,1,2,3,0,2,2,17,-12,1,DET,DET,IND,123,,,20,18,19,3
Bojan Bogdanovic,F,22023,202711,22301206,"DEC 06, 2023",DET vs. MEM,L,32,8,15,0.533,4,8,0.5,2,2,1.0,0,4,4,7,3,0,2,0,22,-1,1,DET,DET,MEM,102,,,33,26,29,11
Scottie Barnes,F-G,22023,1630567,22300432,"DEC 29, 2023",TOR @ BOS,L,38,10,24,0.417,7,15,0.467,3,4,0.75,3,7,10,5,1,3,2,2,30,-3,1,TOR,BOS,TOR,118,,,45,40,35,15
Scottie Barnes,F-G,22023,1630567,22300416,"DEC 27, 2023",TOR @ WAS,W,33,8,16,0.5,4,8,0.5,0,0,0.0,5,7,12,8,3,2,2,0,20,10,1,TOR,WAS,TOR,132,,,40,32,28,20
Scottie Barnes,F-G,22023,1630567,22300395,"DEC 23, 2023",TOR vs. UTA,L,38,12,23,0.522,4,8,0.5,4,4,1.0,3,11,14,7,0,1,4,4,32,-6,1,TOR,TOR,UTA,119,,,53,46,39,21
Scottie Barnes,F-G,22023,1630567,22300382,"DEC 22, 2023",TOR @ PHI,L,35,3,11,0.273,2,7,0.286,4,4,1.0,1,6,7,7,1,4,3,0,12,-1,1,TOR,PHI,TOR,111,,,26,19,19,14
Scottie Barnes,F-G,22023,1630567,22300369,"DEC 20, 2023",TOR vs. DEN,L,33,13,22,0.591,1,5,0.2,3,4,0.75,1,9,10,5,0,1,2,0,30,-4,1,TOR,TOR,DEN,104,,,45,40,35,15
Scottie Barnes,F-G,22023,1630567,22300354,"DEC 18, 2023",TOR vs. CHA,W,39,7,14,0.5,1,2,0.5,7,7,1.0,5,12,17,7,0,3,5,3,22,22,1,TOR,TOR,CHA,114,,,46,39,29,24
Scottie Barnes,F-G,22023,1630567,22300330,"DEC 15, 2023",TOR vs. ATL,L,34,9,15,0.6,1,5,0.2,4,8,0.5,1,3,4,8,1,2,3,2,23,-19,1,TOR,TOR,ATL,104,,,35,27,31,12
Scottie Barnes,F-G,22023,1630567,22300313,"DEC 13, 2023",TOR vs. ATL,W,34,11,14,0.786,3,4,0.75,2,3,0.667,1,9,10,6,0,1,3,3,27,7,1,TOR,TOR,ATL,135,,,43,37,33,16
Scottie Barnes,F-G,22023,1630567,22300297,"DEC 11, 2023",TOR @ NYK,L,38,7,13,0.538,3,8,0.375,3,3,1.0,4,2,6,5,2,0,1,1,20,-10,1,TOR,NYK,TOR,130,,,31,26,25,11
Scottie Barnes,F-G,22023,1630567,22301216,"DEC 08, 2023",TOR @ CHA,L,36,12,18,0.667,3,6,0.5,4,8,0.5,4,6,10,10,2,1,5,1,31,1,1,TOR,CHA,TOR,116,,,51,41,41,20
Scottie Barnes,F-G,22023,1630567,22301207,"DEC 06, 2023",TOR vs. MIA,L,34,5,17,0.294,2,7,0.286,0,0,0.0,3,8,11,5,0,1,3,2,12,-25,1,TOR,TOR,MIA,103,,,28,23,17,16
Scottie Barnes,F-G,22023,1630567,22300276,"DEC 01, 2023",TOR vs. NYK,L,37,13,19,0.684,3,7,0.429,0,1,0.0,3,6,9,4,5,1,2,2,29,-7,1,TOR,TOR,NYK,106,,,42,38,33,13
Scottie Barnes,F-G,22023,1630567,22300260,"NOV 29, 2023",TOR vs. PHX,W,38,7,15,0.467,1,3,0.333,8,8,1.0,2,5,7,4,0,3,0,4,23,14,1,TOR,TOR,PHX,112,,,34,30,27,11
Scottie Barnes,F-G,22023,1630567,22300054,"NOV 28, 2023",TOR @ BKN,L,36,5,19,0.263,3,7,0.429,4,5,0.8,4,7,11,6,3,0,1,4,17,-22,1,TOR,BKN,TOR,103,,,34,28,23,17
Scottie Barnes,F-G,22023,1630567,22300251,"NOV 26, 2023",TOR @ CLE,L,33,5,14,0.357,1,4,0.25,4,5,0.8,1,7,8,3,1,1,2,1,15,-20,1,TOR,CLE,TOR,102,,,26,23,18,11
Scottie Barnes,F-G,22023,1630567,22300046,"NOV 24, 2023",TOR vs. CHI,W,33,5,11,0.455,2,5,0.4,1,2,0.5,5,5,10,6,1,2,1,1,13,19,1,TOR,TOR,CHI,121,,,29,23,19,16
Scottie Barnes,F-G,22023,1630567,22300038,"NOV 21, 2023",TOR @ ORL,L,30,5,11,0.455,1,4,0.25,3,4,0.75,0,8,8,4,3,0,5,1,14,-22,1,TOR,ORL,TOR,107,,,26,22,18,12
Scottie Barnes,F-G,22023,1630567,22300211,"NOV 19, 2023",TOR vs. DET,W,25,7,11,0.636,3,4,0.75,0,0,0.0,2,5,7,9,0,0,3,1,17,37,1,TOR,TOR,DET,142,,,33,24,26,16
Scottie Barnes,F-G,22023,1630567,22300031,"NOV 17, 2023",TOR vs. BOS,L,32,5,13,0.385,2,6,0.333,2,3,0.667,0,3,3,6,0,1,1,2,14,-3,1,TOR,TOR,BOS,105,,,23,17,20,9
Scottie Barnes,F-G,22023,1630567,22300195,"NOV 15, 2023",TOR vs. MIL,L,31,11,19,0.579,3,3,1.0,4,5,0.8,5,4,9,7,1,0,3,2,29,-24,1,TOR,TOR,MIL,112,,,45,38,36,16
Scottie Barnes,F-G,22023,1630567,22300189,"NOV 13, 2023",TOR vs. WAS,W,38,8,17,0.471,0,2,0.0,3,4,0.75,3,6,9,4,5,0,1,3,19,-3,1,TOR,TOR,WAS,111,,,32,28,23,13
Scottie Barnes,F-G,22023,1630567,22300174,"NOV 11, 2023",TOR @ BOS,L,29,4,15,0.267,2,9,0.222,0,0,0.0,1,4,5,4,1,1,1,1,10,-28,1,TOR,BOS,TOR,94,,,19,15,14,9
Scottie Barnes,F-G,22023,1630567,22300092,"OCT 28, 2023",TOR vs. PHI,L,37,11,16,0.688,2,5,0.4,0,0,0.0,1,7,8,5,0,2,1,3,24,-6,1,TOR,TOR,PHI,107,,,37,32,29,13
Scottie Barnes,F-G,22023,1630567,22300082,"OCT 27, 2023",TOR @ CHI,L,39,9,14,0.643,1,2,0.5,3,4,0.75,1,9,10,10,0,2,7,5,22,15,1,TOR,CHI,TOR,103,,,42,32,32,20
Scottie Barnes,F-G,22023,1630567,22300069,"OCT 25, 2023",TOR vs. MIN,W,37,6,16,0.375,1,4,0.25,4,6,0.667,1,7,8,5,2,5,4,1,17,2,1,TOR,TOR,MIN,97,,,30,25,22,13
Scottie Barnes,F-G,22023,1630567,22300756,"FEB 10, 2024",TOR vs. CLE,L,35,9,15,0.6,1,3,0.333,5,6,0.833,2,8,10,10,1,1,1,3,24,1,1,TOR,TOR,CLE,95,,,44,34,34,20
Scottie Barnes,F-G,22023,1630567,22300230,"NOV 22, 2023",TOR @ IND,W,39,7,17,0.412,2,6,0.333,4,5,0.8,3,9,12,4,4,0,3,0,20,-10,1,TOR,IND,TOR,132,,,36,32,24,16
Scottie Barnes,F-G,22023,1630567,22300168,"NOV 08, 2023",TOR @ DAL,W,39,4,15,0.267,0,4,0.0,6,8,0.75,6,8,14,7,4,2,0,2,14,9,1,TOR,DAL,TOR,127,,,35,28,21,21
Scottie Barnes,F-G,22023,1630567,22300141,"NOV 05, 2023",TOR @ SAS,W,42,9,20,0.45,5,10,0.5,7,11,0.636,4,7,11,6,3,3,3,1,30,14,1,TOR,SAS,TOR,123,,,47,41,36,17
Scottie Barnes,F-G,22023,1630567,22300128,"NOV 02, 2023",TOR @ PHI,L,35,9,16,0.563,2,7,0.286,4,4,1.0,2,6,8,8,0,0,1,4,24,-11,1,TOR,PHI,TOR,99,,,40,32,32,16
Scottie Barnes,F-G,22023,1630567,22300116,"NOV 01, 2023",TOR vs. MIL,W,29,8,16,0.5,4,6,0.667,1,1,1.0,5,7,12,5,1,2,3,1,21,14,1,TOR,TOR,MIL,130,,,38,33,26,17
Scottie Barnes,F-G,22023,1630567,22300105,"OCT 30, 2023",TOR vs. POR,L,37,8,19,0.421,1,4,0.25,3,3,1.0,4,8,12,2,2,1,4,3,20,1,1,TOR,TOR,POR,91,,,34,32,22,14
Scottie Barnes,F-G,22023,1630567,22300744,"FEB 09, 2024",TOR vs. HOU,W,35,4,16,0.25,0,3,0.0,5,5,1.0,6,4,10,8,2,2,1,2,13,-2,1,TOR,TOR,HOU,100,,,31,23,21,18
Scottie Barnes,F-G,22023,1630567,22300726,"FEB 07, 2024",TOR @ CHA,W,36,6,14,0.429,1,5,0.2,5,6,0.833,0,4,4,5,0,1,2,2,18,4,1,TOR,CHA,TOR,123,,,27,22,23,9
Scottie Barnes,F-G,22023,1630567,22300718,"FEB 05, 2024",TOR @ NOP,L,25,5,12,0.417,2,5,0.4,5,6,0.833,2,3,5,4,0,2,1,1,17,-22,1,TOR,NOP,TOR,100,,,26,22,21,9
Scottie Barnes,F-G,22023,1630567,22300710,"FEB 04, 2024",TOR @ OKC,L,48,8,15,0.533,3,5,0.6,0,1,0.0,3,4,7,9,0,1,3,3,19,4,1,TOR,OKC,TOR,127,,,35,26,28,16
Scottie Barnes,F-G,22023,1630567,22300692,"FEB 02, 2024",TOR @ HOU,L,33,10,17,0.588,1,2,0.5,7,8,0.875,3,4,7,4,1,0,1,1,28,-10,1,TOR,HOU,TOR,106,,,39,35,32,11
Scottie Barnes,F-G,22023,1630567,22300672,"JAN 30, 2024",TOR @ CHI,W,37,4,14,0.286,0,3,0.0,5,6,0.833,1,3,4,7,1,0,5,1,13,10,1,TOR,CHI,TOR,118,,,24,17,20,11
Scottie Barnes,F-G,22023,1630567,22300653,"JAN 28, 2024",TOR @ ATL,L,38,8,14,0.571,0,0,0.0,8,8,1.0,1,3,4,8,0,2,5,2,24,-11,1,TOR,ATL,TOR,113,,,36,28,32,12
Scottie Barnes,F-G,22023,1630567,22300637,"JAN 26, 2024",TOR vs. LAC,L,35,9,21,0.429,1,5,0.2,4,5,0.8,1,4,5,4,1,0,1,1,23,-13,1,TOR,TOR,LAC,107,,,32,28,27,9
Scottie Barnes,F-G,22023,1630567,22300609,"JAN 22, 2024",TOR vs. MEM,L,41,6,14,0.429,1,3,0.333,9,9,1.0,5,7,12,8,0,6,5,2,22,2,1,TOR,TOR,MEM,100,,,42,34,30,20
Scottie Barnes,F-G,22023,1630567,22300596,"JAN 20, 2024",TOR @ NYK,L,33,4,14,0.286,0,3,0.0,1,3,0.333,2,4,6,7,0,2,3,2,9,-15,1,TOR,NYK,TOR,94,,,22,15,16,13
Scottie Barnes,F-G,22023,1630567,22300580,"JAN 18, 2024",TOR vs. CHI,L,37,11,18,0.611,2,6,0.333,7,9,0.778,1,6,7,6,3,3,6,1,31,-3,1,TOR,TOR,CHI,100,,,44,38,37,13
Scottie Barnes,F-G,22023,1630567,22300574,"JAN 17, 2024",TOR vs. MIA,W,34,9,16,0.563,1,6,0.167,1,1,1.0,2,3,5,8,2,1,5,2,20,5,1,TOR,TOR,MIA,115,,,33,25,28,13
Scottie Barnes,F-G,22023,1630567,22300563,"JAN 15, 2024",TOR vs. BOS,L,41,5,12,0.417,0,2,0.0,0,0,0.0,2,11,13,2,2,0,4,2,10,-1,1,TOR,TOR,BOS,94,,,25,23,12,15
Scottie Barnes,F-G,22023,1630567,22300540,"JAN 12, 2024",TOR @ UTA,L,28,6,13,0.462,2,4,0.5,5,11,0.455,1,2,3,3,0,3,3,3,19,-21,1,TOR,UTA,TOR,104,,,25,22,22,6
Scottie Barnes,F-G,22023,1630567,22300526,"JAN 10, 2024",TOR @ LAC,L,34,5,10,0.5,1,5,0.2,1,3,0.333,0,7,7,6,0,2,2,1,12,-9,1,TOR,LAC,TOR,111,,,25,19,18,13
Scottie Barnes,F-G,22023,1630567,22300516,"JAN 09, 2024",TOR @ LAL,L,40,11,20,0.55,3,7,0.429,1,2,0.5,1,2,3,6,0,2,2,6,26,0,1,TOR,LAL,TOR,131,,,35,29,32,9
Scottie Barnes,F-G,22023,1630567,22300504,"JAN 07, 2024",TOR @ GSW,W,24,3,11,0.273,0,4,0.0,0,0,0.0,1,1,2,3,1,1,2,1,6,3,1,TOR,GSW,TOR,131,,,11,8,9,5
Scottie Barnes,F-G,22023,1630567,22300492,"JAN 05, 2024",TOR @ SAC,L,35,8,15,0.533,4,8,0.5,0,0,0.0,0,4,4,6,1,2,5,2,20,-23,1,TOR,SAC,TOR,120,,,30,24,26,10
Scottie Barnes,F-G,22023,1630567,22300470,"JAN 03, 2024",TOR @ MEM,W,40,7,14,0.5,2,5,0.4,4,4,1.0,0,2,2,8,1,0,1,2,20,2,1,TOR,MEM,TOR,116,,,30,22,28,10
Scottie Barnes,F-G,22023,1630567,22300452,"JAN 01, 2024",TOR vs. CLE,W,36,7,17,0.412,1,5,0.2,5,7,0.714,1,5,6,5,1,1,0,3,20,-5,1,TOR,TOR,CLE,124,,,31,26,25,11
Scottie Barnes,F-G,22023,1630567,22300440,"DEC 30, 2023",TOR @ DET,L,36,8,20,0.4,1,5,0.2,5,5,1.0,2,7,9,2,2,1,1,4,22,1,1,TOR,DET,TOR,127,,,33,31,24,11
Domantas Sabonis,C,22023,1627734,22300746,"FEB 09, 2024",SAC vs. DEN,W,31,7,9,0.778,1,1,1.0,2,2,1.0,1,16,17,10,1,0,3,3,17,18,1,SAC,SAC,DEN,135,19.5,Points,44,34,27,27
Domantas Sabonis,C,22023,1627734,22300746,"FEB 09, 2024",SAC vs. DEN,W,31,7,9,0.778,1,1,1.0,2,2,1.0,1,16,17,10,1,0,3,3,17,18,1,SAC,SAC,DEN,135,13.5,Rebounds,44,34,27,27
Domantas Sabonis,C,22023,1627734,22300746,"FEB 09, 2024",SAC vs. DEN,W,31,7,9,0.778,1,1,1.0,2,2,1.0,1,16,17,10,1,0,3,3,17,18,1,SAC,SAC,DEN,135,42.5,Pts+Rebs+Asts,44,34,27,27
Domantas Sabonis,C,22023,1627734,22300746,"FEB 09, 2024",SAC vs. DEN,W,31,7,9,0.778,1,1,1.0,2,2,1.0,1,16,17,10,1,0,3,3,17,18,1,SAC,SAC,DEN,135,8.5,Assists,44,34,27,27
Domantas Sabonis,C,22023,1627734,22300746,"FEB 09, 2024",SAC vs. DEN,W,31,7,9,0.778,1,1,1.0,2,2,1.0,1,16,17,10,1,0,3,3,17,18,1,SAC,SAC,DEN,135,49.5,Fantasy Score,44,34,27,27
Domantas Sabonis,C,22023,1627734,22300746,"FEB 09, 2024",SAC vs. DEN,W,31,7,9,0.778,1,1,1.0,2,2,1.0,1,16,17,10,1,0,3,3,17,18,1,SAC,SAC,DEN,135,10.0,Defensive Rebounds,44,34,27,27
Domantas Sabonis,C,22023,1627734,22300746,"FEB 09, 2024",SAC vs. DEN,W,31,7,9,0.778,1,1,1.0,2,2,1.0,1,16,17,10,1,0,3,3,17,18,1,SAC,SAC,DEN,135,3.5,Free Throws Made,44,34,27,27
Domantas Sabonis,C,22023,1627734,22300746,"FEB 09, 2024",SAC vs. DEN,W,31,7,9,0.778,1,1,1.0,2,2,1.0,1,16,17,10,1,0,3,3,17,18,1,SAC,SAC,DEN,135,13.0,FG Attempted,44,34,27,27
Domantas Sabonis,C,22023,1627734,22300746,"FEB 09, 2024",SAC vs. DEN,W,31,7,9,0.778,1,1,1.0,2,2,1.0,1,16,17,10,1,0,3,3,17,18,1,SAC,SAC,DEN,135,34.5,Pts+Rebs,44,34,27,27
Domantas Sabonis,C,22023,1627734,22300746,"FEB 09, 2024",SAC vs. DEN,W,31,7,9,0.778,1,1,1.0,2,2,1.0,1,16,17,10,1,0,3,3,17,18,1,SAC,SAC,DEN,135,1.0,Dunks,44,34,27,27
Domantas Sabonis,C,22023,1627734,22300746,"FEB 09, 2024",SAC vs. DEN,W,31,7,9,0.778,1,1,1.0,2,2,1.0,1,16,17,10,1,0,3,3,17,18,1,SAC,SAC,DEN,135,28.5,Pts+Asts,44,34,27,27
Domantas Sabonis,C,22023,1627734,22300746,"FEB 09, 2024",SAC vs. DEN,W,31,7,9,0.778,1,1,1.0,2,2,1.0,1,16,17,10,1,0,3,3,17,18,1,SAC,SAC,DEN,135,22.5,Rebs+Asts,44,34,27,27
Domantas Sabonis,C,22023,1627734,22300732,"FEB 07, 2024",SAC vs. DET,L,41,11,17,0.647,1,3,0.333,7,10,0.7,2,10,12,7,1,0,0,3,30,-17,1,SAC,SAC,DET,120,19.5,Points,49,42,37,19
Domantas Sabonis,C,22023,1627734,22300732,"FEB 07, 2024",SAC vs. DET,L,41,11,17,0.647,1,3,0.333,7,10,0.7,2,10,12,7,1,0,0,3,30,-17,1,SAC,SAC,DET,120,13.5,Rebounds,49,42,37,19
Domantas Sabonis,C,22023,1627734,22300732,"FEB 07, 2024",SAC vs. DET,L,41,11,17,0.647,1,3,0.333,7,10,0.7,2,10,12,7,1,0,0,3,30,-17,1,SAC,SAC,DET,120,42.5,Pts+Rebs+Asts,49,42,37,19
Domantas Sabonis,C,22023,1627734,22300732,"FEB 07, 2024",SAC vs. DET,L,41,11,17,0.647,1,3,0.333,7,10,0.7,2,10,12,7,1,0,0,3,30,-17,1,SAC,SAC,DET,120,8.5,Assists,49,42,37,19
Domantas Sabonis,C,22023,1627734,22300732,"FEB 07, 2024",SAC vs. DET,L,41,11,17,0.647,1,3,0.333,7,10,0.7,2,10,12,7,1,0,0,3,30,-17,1,SAC,SAC,DET,120,49.5,Fantasy Score,49,42,37,19
Domantas Sabonis,C,22023,1627734,22300732,"FEB 07, 2024",SAC vs. DET,L,41,11,17,0.647,1,3,0.333,7,10,0.7,2,10,12,7,1,0,0,3,30,-17,1,SAC,SAC,DET,120,10.0,Defensive Rebounds,49,42,37,19
Domantas Sabonis,C,22023,1627734,22300732,"FEB 07, 2024",SAC vs. DET,L,41,11,17,0.647,1,3,0.333,7,10,0.7,2,10,12,7,1,0,0,3,30,-17,1,SAC,SAC,DET,120,3.5,Free Throws Made,49,42,37,19
Domantas Sabonis,C,22023,1627734,22300732,"FEB 07, 2024",SAC vs. DET,L,41,11,17,0.647,1,3,0.333,7,10,0.7,2,10,12,7,1,0,0,3,30,-17,1,SAC,SAC,DET,120,13.0,FG Attempted,49,42,37,19
Domantas Sabonis,C,22023,1627734,22300732,"FEB 07, 2024",SAC vs. DET,L,41,11,17,0.647,1,3,0.333,7,10,0.7,2,10,12,7,1,0,0,3,30,-17,1,SAC,SAC,DET,120,34.5,Pts+Rebs,49,42,37,19
Domantas Sabonis,C,22023,1627734,22300732,"FEB 07, 2024",SAC vs. DET,L,41,11,17,0.647,1,3,0.333,7,10,0.7,2,10,12,7,1,0,0,3,30,-17,1,SAC,SAC,DET,120,1.0,Dunks,49,42,37,19
Domantas Sabonis,C,22023,1627734,22300732,"FEB 07, 2024",SAC vs. DET,L,41,11,17,0.647,1,3,0.333,7,10,0.7,2,10,12,7,1,0,0,3,30,-17,1,SAC,SAC,DET,120,28.5,Pts+Asts,49,42,37,19
Domantas Sabonis,C,22023,1627734,22300732,"FEB 07, 2024",SAC vs. DET,L,41,11,17,0.647,1,3,0.333,7,10,0.7,2,10,12,7,1,0,0,3,30,-17,1,SAC,SAC,DET,120,22.5,Rebs+Asts,49,42,37,19
Domantas Sabonis,C,22023,1627734,22300714,"FEB 05, 2024",SAC @ CLE,L,34,6,9,0.667,0,0,0.0,0,0,0.0,4,15,19,15,0,0,5,1,12,-25,1,SAC,CLE,SAC,110,19.5,Points,46,31,27,34
Domantas Sabonis,C,22023,1627734,22300714,"FEB 05, 2024",SAC @ CLE,L,34,6,9,0.667,0,0,0.0,0,0,0.0,4,15,19,15,0,0,5,1,12,-25,1,SAC,CLE,SAC,110,13.5,Rebounds,46,31,27,34
Domantas Sabonis,C,22023,1627734,22300714,"FEB 05, 2024",SAC @ CLE,L,34,6,9,0.667,0,0,0.0,0,0,0.0,4,15,19,15,0,0,5,1,12,-25,1,SAC,CLE,SAC,110,42.5,Pts+Rebs+Asts,46,31,27,34
Domantas Sabonis,C,22023,1627734,22300714,"FEB 05, 2024",SAC @ CLE,L,34,6,9,0.667,0,0,0.0,0,0,0.0,4,15,19,15,0,0,5,1,12,-25,1,SAC,CLE,SAC,110,8.5,Assists,46,31,27,34
Domantas Sabonis,C,22023,1627734,22300714,"FEB 05, 2024",SAC @ CLE,L,34,6,9,0.667,0,0,0.0,0,0,0.0,4,15,19,15,0,0,5,1,12,-25,1,SAC,CLE,SAC,110,49.5,Fantasy Score,46,31,27,34
Domantas Sabonis,C,22023,1627734,22300714,"FEB 05, 2024",SAC @ CLE,L,34,6,9,0.667,0,0,0.0,0,0,0.0,4,15,19,15,0,0,5,1,12,-25,1,SAC,CLE,SAC,110,10.0,Defensive Rebounds,46,31,27,34
Domantas Sabonis,C,22023,1627734,22300714,"FEB 05, 2024",SAC @ CLE,L,34,6,9,0.667,0,0,0.0,0,0,0.0,4,15,19,15,0,0,5,1,12,-25,1,SAC,CLE,SAC,110,3.5,Free Throws Made,46,31,27,34
Domantas Sabonis,C,22023,1627734,22300714,"FEB 05, 2024",SAC @ CLE,L,34,6,9,0.667,0,0,0.0,0,0,0.0,4,15,19,15,0,0,5,1,12,-25,1,SAC,CLE,SAC,110,13.0,FG Attempted,46,31,27,34
Domantas Sabonis,C,22023,1627734,22300714,"FEB 05, 2024",SAC @ CLE,L,34,6,9,0.667,0,0,0.0,0,0,0.0,4,15,19,15,0,0,5,1,12,-25,1,SAC,CLE,SAC,110,34.5,Pts+Rebs,46,31,27,34
Domantas Sabonis,C,22023,1627734,22300714,"FEB 05, 2024",SAC @ CLE,L,34,6,9,0.667,0,0,0.0,0,0,0.0,4,15,19,15,0,0,5,1,12,-25,1,SAC,CLE,SAC,110,1.0,Dunks,46,31,27,34
Domantas Sabonis,C,22023,1627734,22300714,"FEB 05, 2024",SAC @ CLE,L,34,6,9,0.667,0,0,0.0,0,0,0.0,4,15,19,15,0,0,5,1,12,-25,1,SAC,CLE,SAC,110,28.5,Pts+Asts,46,31,27,34
Domantas Sabonis,C,22023,1627734,22300714,"FEB 05, 2024",SAC @ CLE,L,34,6,9,0.667,0,0,0.0,0,0,0.0,4,15,19,15,0,0,5,1,12,-25,1,SAC,CLE,SAC,110,22.5,Rebs+Asts,46,31,27,34
Domantas Sabonis,C,22023,1627734,22300700,"FEB 03, 2024",SAC @ CHI,W,39,6,8,0.75,0,1,0.0,1,1,1.0,0,14,14,10,1,0,6,1,13,10,1,SAC,CHI,SAC,123,19.5,Points,37,27,23,24
Domantas Sabonis,C,22023,1627734,22300700,"FEB 03, 2024",SAC @ CHI,W,39,6,8,0.75,0,1,0.0,1,1,1.0,0,14,14,10,1,0,6,1,13,10,1,SAC,CHI,SAC,123,13.5,Rebounds,37,27,23,24
Domantas Sabonis,C,22023,1627734,22300700,"FEB 03, 2024",SAC @ CHI,W,39,6,8,0.75,0,1,0.0,1,1,1.0,0,14,14,10,1,0,6,1,13,10,1,SAC,CHI,SAC,123,42.5,Pts+Rebs+Asts,37,27,23,24
Domantas Sabonis,C,22023,1627734,22300700,"FEB 03, 2024",SAC @ CHI,W,39,6,8,0.75,0,1,0.0,1,1,1.0,0,14,14,10,1,0,6,1,13,10,1,SAC,CHI,SAC,123,8.5,Assists,37,27,23,24
Domantas Sabonis,C,22023,1627734,22300700,"FEB 03, 2024",SAC @ CHI,W,39,6,8,0.75,0,1,0.0,1,1,1.0,0,14,14,10,1,0,6,1,13,10,1,SAC,CHI,SAC,123,49.5,Fantasy Score,37,27,23,24
Domantas Sabonis,C,22023,1627734,22300700,"FEB 03, 2024",SAC @ CHI,W,39,6,8,0.75,0,1,0.0,1,1,1.0,0,14,14,10,1,0,6,1,13,10,1,SAC,CHI,SAC,123,10.0,Defensive Rebounds,37,27,23,24
Domantas Sabonis,C,22023,1627734,22300700,"FEB 03, 2024",SAC @ CHI,W,39,6,8,0.75,0,1,0.0,1,1,1.0,0,14,14,10,1,0,6,1,13,10,1,SAC,CHI,SAC,123,3.5,Free Throws Made,37,27,23,24
Domantas Sabonis,C,22023,1627734,22300700,"FEB 03, 2024",SAC @ CHI,W,39,6,8,0.75,0,1,0.0,1,1,1.0,0,14,14,10,1,0,6,1,13,10,1,SAC,CHI,SAC,123,13.0,FG Attempted,37,27,23,24
Domantas Sabonis,C,22023,1627734,22300700,"FEB 03, 2024",SAC @ CHI,W,39,6,8,0.75,0,1,0.0,1,1,1.0,0,14,14,10,1,0,6,1,13,10,1,SAC,CHI,SAC,123,34.5,Pts+Rebs,37,27,23,24
Domantas Sabonis,C,22023,1627734,22300700,"FEB 03, 2024",SAC @ CHI,W,39,6,8,0.75,0,1,0.0,1,1,1.0,0,14,14,10,1,0,6,1,13,10,1,SAC,CHI,SAC,123,1.0,Dunks,37,27,23,24
Domantas Sabonis,C,22023,1627734,22300700,"FEB 03, 2024",SAC @ CHI,W,39,6,8,0.75,0,1,0.0,1,1,1.0,0,14,14,10,1,0,6,1,13,10,1,SAC,CHI,SAC,123,28.5,Pts+Asts,37,27,23,24
Domantas Sabonis,C,22023,1627734,22300700,"FEB 03, 2024",SAC @ CHI,W,39,6,8,0.75,0,1,0.0,1,1,1.0,0,14,14,10,1,0,6,1,13,10,1,SAC,CHI,SAC,123,22.5,Rebs+Asts,37,27,23,24
Domantas Sabonis,C,22023,1627734,22300691,"FEB 02, 2024",SAC @ IND,W,35,9,14,0.643,0,1,0.0,8,9,0.889,3,8,11,7,2,1,4,3,26,7,1,SAC,IND,SAC,133,19.5,Points,44,37,33,18
Domantas Sabonis,C,22023,1627734,22300691,"FEB 02, 2024",SAC @ IND,W,35,9,14,0.643,0,1,0.0,8,9,0.889,3,8,11,7,2,1,4,3,26,7,1,SAC,IND,SAC,133,13.5,Rebounds,44,37,33,18
Domantas Sabonis,C,22023,1627734,22300691,"FEB 02, 2024",SAC @ IND,W,35,9,14,0.643,0,1,0.0,8,9,0.889,3,8,11,7,2,1,4,3,26,7,1,SAC,IND,SAC,133,42.5,Pts+Rebs+Asts,44,37,33,18
Domantas Sabonis,C,22023,1627734,22300691,"FEB 02, 2024",SAC @ IND,W,35,9,14,0.643,0,1,0.0,8,9,0.889,3,8,11,7,2,1,4,3,26,7,1,SAC,IND,SAC,133,8.5,Assists,44,37,33,18
Domantas Sabonis,C,22023,1627734,22300691,"FEB 02, 2024",SAC @ IND,W,35,9,14,0.643,0,1,0.0,8,9,0.889,3,8,11,7,2,1,4,3,26,7,1,SAC,IND,SAC,133,49.5,Fantasy Score,44,37,33,18
Domantas Sabonis,C,22023,1627734,22300691,"FEB 02, 2024",SAC @ IND,W,35,9,14,0.643,0,1,0.0,8,9,0.889,3,8,11,7,2,1,4,3,26,7,1,SAC,IND,SAC,133,10.0,Defensive Rebounds,44,37,33,18
Domantas Sabonis,C,22023,1627734,22300691,"FEB 02, 2024",SAC @ IND,W,35,9,14,0.643,0,1,0.0,8,9,0.889,3,8,11,7,2,1,4,3,26,7,1,SAC,IND,SAC,133,3.5,Free Throws Made,44,37,33,18
Domantas Sabonis,C,22023,1627734,22300691,"FEB 02, 2024",SAC @ IND,W,35,9,14,0.643,0,1,0.0,8,9,0.889,3,8,11,7,2,1,4,3,26,7,1,SAC,IND,SAC,133,13.0,FG Attempted,44,37,33,18
Domantas Sabonis,C,22023,1627734,22300691,"FEB 02, 2024",SAC @ IND,W,35,9,14,0.643,0,1,0.0,8,9,0.889,3,8,11,7,2,1,4,3,26,7,1,SAC,IND,SAC,133,34.5,Pts+Rebs,44,37,33,18
Domantas Sabonis,C,22023,1627734,22300691,"FEB 02, 2024",SAC @ IND,W,35,9,14,0.643,0,1,0.0,8,9,0.889,3,8,11,7,2,1,4,3,26,7,1,SAC,IND,SAC,133,1.0,Dunks,44,37,33,18
Domantas Sabonis,C,22023,1627734,22300691,"FEB 02, 2024",SAC @ IND,W,35,9,14,0.643,0,1,0.0,8,9,0.889,3,8,11,7,2,1,4,3,26,7,1,SAC,IND,SAC,133,28.5,Pts+Asts,44,37,33,18
Domantas Sabonis,C,22023,1627734,22300691,"FEB 02, 2024",SAC @ IND,W,35,9,14,0.643,0,1,0.0,8,9,0.889,3,8,11,7,2,1,4,3,26,7,1,SAC,IND,SAC,133,22.5,Rebs+Asts,44,37,33,18
Domantas Sabonis,C,22023,1627734,22300678,"JAN 31, 2024",SAC @ MIA,L,38,7,14,0.5,1,1,1.0,4,6,0.667,4,13,17,13,1,1,1,0,19,0,1,SAC,MIA,SAC,106,19.5,Points,49,36,32,30
Domantas Sabonis,C,22023,1627734,22300678,"JAN 31, 2024",SAC @ MIA,L,38,7,14,0.5,1,1,1.0,4,6,0.667,4,13,17,13,1,1,1,0,19,0,1,SAC,MIA,SAC,106,13.5,Rebounds,49,36,32,30
Domantas Sabonis,C,22023,1627734,22300678,"JAN 31, 2024",SAC @ MIA,L,38,7,14,0.5,1,1,1.0,4,6,0.667,4,13,17,13,1,1,1,0,19,0,1,SAC,MIA,SAC,106,42.5,Pts+Rebs+Asts,49,36,32,30
Domantas Sabonis,C,22023,1627734,22300678,"JAN 31, 2024",SAC @ MIA,L,38,7,14,0.5,1,1,1.0,4,6,0.667,4,13,17,13,1,1,1,0,19,0,1,SAC,MIA,SAC,106,8.5,Assists,49,36,32,30
Domantas Sabonis,C,22023,1627734,22300678,"JAN 31, 2024",SAC @ MIA,L,38,7,14,0.5,1,1,1.0,4,6,0.667,4,13,17,13,1,1,1,0,19,0,1,SAC,MIA,SAC,106,49.5,Fantasy Score,49,36,32,30
Domantas Sabonis,C,22023,1627734,22300678,"JAN 31, 2024",SAC @ MIA,L,38,7,14,0.5,1,1,1.0,4,6,0.667,4,13,17,13,1,1,1,0,19,0,1,SAC,MIA,SAC,106,10.0,Defensive Rebounds,49,36,32,30
Domantas Sabonis,C,22023,1627734,22300678,"JAN 31, 2024",SAC @ MIA,L,38,7,14,0.5,1,1,1.0,4,6,0.667,4,13,17,13,1,1,1,0,19,0,1,SAC,MIA,SAC,106,3.5,Free Throws Made,49,36,32,30
Domantas Sabonis,C,22023,1627734,22300678,"JAN 31, 2024",SAC @ MIA,L,38,7,14,0.5,1,1,1.0,4,6,0.667,4,13,17,13,1,1,1,0,19,0,1,SAC,MIA,SAC,106,13.0,FG Attempted,49,36,32,30
Domantas Sabonis,C,22023,1627734,22300678,"JAN 31, 2024",SAC @ MIA,L,38,7,14,0.5,1,1,1.0,4,6,0.667,4,13,17,13,1,1,1,0,19,0,1,SAC,MIA,SAC,106,34.5,Pts+Rebs,49,36,32,30
Domantas Sabonis,C,22023,1627734,22300678,"JAN 31, 2024",SAC @ MIA,L,38,7,14,0.5,1,1,1.0,4,6,0.667,4,13,17,13,1,1,1,0,19,0,1,SAC,MIA,SAC,106,1.0,Dunks,49,36,32,30
Domantas Sabonis,C,22023,1627734,22300678,"JAN 31, 2024",SAC @ MIA,L,38,7,14,0.5,1,1,1.0,4,6,0.667,4,13,17,13,1,1,1,0,19,0,1,SAC,MIA,SAC,106,28.5,Pts+Asts,49,36,32,30
Domantas Sabonis,C,22023,1627734,22300678,"JAN 31, 2024",SAC @ MIA,L,38,7,14,0.5,1,1,1.0,4,6,0.667,4,13,17,13,1,1,1,0,19,0,1,SAC,MIA,SAC,106,22.5,Rebs+Asts,49,36,32,30
Domantas Sabonis,C,22023,1627734,22300663,"JAN 29, 2024",SAC @ MEM,W,38,10,11,0.909,0,0,0.0,0,0,0.0,6,20,26,5,0,0,3,3,20,10,1,SAC,MEM,SAC,103,19.5,Points,51,46,25,31
Domantas Sabonis,C,22023,1627734,22300663,"JAN 29, 2024",SAC @ MEM,W,38,10,11,0.909,0,0,0.0,0,0,0.0,6,20,26,5,0,0,3,3,20,10,1,SAC,MEM,SAC,103,13.5,Rebounds,51,46,25,31
Domantas Sabonis,C,22023,1627734,22300663,"JAN 29, 2024",SAC @ MEM,W,38,10,11,0.909,0,0,0.0,0,0,0.0,6,20,26,5,0,0,3,3,20,10,1,SAC,MEM,SAC,103,42.5,Pts+Rebs+Asts,51,46,25,31
Domantas Sabonis,C,22023,1627734,22300663,"JAN 29, 2024",SAC @ MEM,W,38,10,11,0.909,0,0,0.0,0,0,0.0,6,20,26,5,0,0,3,3,20,10,1,SAC,MEM,SAC,103,8.5,Assists,51,46,25,31
Domantas Sabonis,C,22023,1627734,22300663,"JAN 29, 2024",SAC @ MEM,W,38,10,11,0.909,0,0,0.0,0,0,0.0,6,20,26,5,0,0,3,3,20,10,1,SAC,MEM,SAC,103,49.5,Fantasy Score,51,46,25,31
Domantas Sabonis,C,22023,1627734,22300663,"JAN 29, 2024",SAC @ MEM,W,38,10,11,0.909,0,0,0.0,0,0,0.0,6,20,26,5,0,0,3,3,20,10,1,SAC,MEM,SAC,103,10.0,Defensive Rebounds,51,46,25,31
Domantas Sabonis,C,22023,1627734,22300663,"JAN 29, 2024",SAC @ MEM,W,38,10,11,0.909,0,0,0.0,0,0,0.0,6,20,26,5,0,0,3,3,20,10,1,SAC,MEM,SAC,103,3.5,Free Throws Made,51,46,25,31
Domantas Sabonis,C,22023,1627734,22300663,"JAN 29, 2024",SAC @ MEM,W,38,10,11,0.909,0,0,0.0,0,0,0.0,6,20,26,5,0,0,3,3,20,10,1,SAC,MEM,SAC,103,13.0,FG Attempted,51,46,25,31
Domantas Sabonis,C,22023,1627734,22300663,"JAN 29, 2024",SAC @ MEM,W,38,10,11,0.909,0,0,0.0,0,0,0.0,6,20,26,5,0,0,3,3,20,10,1,SAC,MEM,SAC,103,34.5,Pts+Rebs,51,46,25,31
Domantas Sabonis,C,22023,1627734,22300663,"JAN 29, 2024",SAC @ MEM,W,38,10,11,0.909,0,0,0.0,0,0,0.0,6,20,26,5,0,0,3,3,20,10,1,SAC,MEM,SAC,103,1.0,Dunks,51,46,25,31
Domantas Sabonis,C,22023,1627734,22300663,"JAN 29, 2024",SAC @ MEM,W,38,10,11,0.909,0,0,0.0,0,0,0.0,6,20,26,5,0,0,3,3,20,10,1,SAC,MEM,SAC,103,28.5,Pts+Asts,51,46,25,31
Domantas Sabonis,C,22023,1627734,22300663,"JAN 29, 2024",SAC @ MEM,W,38,10,11,0.909,0,0,0.0,0,0,0.0,6,20,26,5,0,0,3,3,20,10,1,SAC,MEM,SAC,103,22.5,Rebs+Asts,51,46,25,31
Domantas Sabonis,C,22023,1627734,22300651,"JAN 27, 2024",SAC @ DAL,W,36,7,10,0.7,1,1,1.0,2,2,1.0,3,8,11,4,0,0,6,6,17,-2,1,SAC,DAL,SAC,120,19.5,Points,32,28,21,15
Domantas Sabonis,C,22023,1627734,22300651,"JAN 27, 2024",SAC @ DAL,W,36,7,10,0.7,1,1,1.0,2,2,1.0,3,8,11,4,0,0,6,6,17,-2,1,SAC,DAL,SAC,120,13.5,Rebounds,32,28,21,15
Domantas Sabonis,C,22023,1627734,22300651,"JAN 27, 2024",SAC @ DAL,W,36,7,10,0.7,1,1,1.0,2,2,1.0,3,8,11,4,0,0,6,6,17,-2,1,SAC,DAL,SAC,120,42.5,Pts+Rebs+Asts,32,28,21,15
Domantas Sabonis,C,22023,1627734,22300651,"JAN 27, 2024",SAC @ DAL,W,36,7,10,0.7,1,1,1.0,2,2,1.0,3,8,11,4,0,0,6,6,17,-2,1,SAC,DAL,SAC,120,8.5,Assists,32,28,21,15
Domantas Sabonis,C,22023,1627734,22300651,"JAN 27, 2024",SAC @ DAL,W,36,7,10,0.7,1,1,1.0,2,2,1.0,3,8,11,4,0,0,6,6,17,-2,1,SAC,DAL,SAC,120,49.5,Fantasy Score,32,28,21,15
Domantas Sabonis,C,22023,1627734,22300651,"JAN 27, 2024",SAC @ DAL,W,36,7,10,0.7,1,1,1.0,2,2,1.0,3,8,11,4,0,0,6,6,17,-2,1,SAC,DAL,SAC,120,10.0,Defensive Rebounds,32,28,21,15
Domantas Sabonis,C,22023,1627734,22300651,"JAN 27, 2024",SAC @ DAL,W,36,7,10,0.7,1,1,1.0,2,2,1.0,3,8,11,4,0,0,6,6,17,-2,1,SAC,DAL,SAC,120,3.5,Free Throws Made,32,28,21,15
Domantas Sabonis,C,22023,1627734,22300651,"JAN 27, 2024",SAC @ DAL,W,36,7,10,0.7,1,1,1.0,2,2,1.0,3,8,11,4,0,0,6,6,17,-2,1,SAC,DAL,SAC,120,13.0,FG Attempted,32,28,21,15
Domantas Sabonis,C,22023,1627734,22300651,"JAN 27, 2024",SAC @ DAL,W,36,7,10,0.7,1,1,1.0,2,2,1.0,3,8,11,4,0,0,6,6,17,-2,1,SAC,DAL,SAC,120,34.5,Pts+Rebs,32,28,21,15
Domantas Sabonis,C,22023,1627734,22300651,"JAN 27, 2024",SAC @ DAL,W,36,7,10,0.7,1,1,1.0,2,2,1.0,3,8,11,4,0,0,6,6,17,-2,1,SAC,DAL,SAC,120,1.0,Dunks,32,28,21,15
Domantas Sabonis,C,22023,1627734,22300651,"JAN 27, 2024",SAC @ DAL,W,36,7,10,0.7,1,1,1.0,2,2,1.0,3,8,11,4,0,0,6,6,17,-2,1,SAC,DAL,SAC,120,28.5,Pts+Asts,32,28,21,15
Domantas Sabonis,C,22023,1627734,22300651,"JAN 27, 2024",SAC @ DAL,W,36,7,10,0.7,1,1,1.0,2,2,1.0,3,8,11,4,0,0,6,6,17,-2,1,SAC,DAL,SAC,120,22.5,Rebs+Asts,32,28,21,15
Domantas Sabonis,C,22023,1627734,22300632,"JAN 25, 2024",SAC @ GSW,W,35,8,11,0.727,2,2,1.0,0,0,0.0,1,7,8,13,0,1,3,5,18,8,1,SAC,GSW,SAC,134,19.5,Points,39,26,31,21
Domantas Sabonis,C,22023,1627734,22300632,"JAN 25, 2024",SAC @ GSW,W,35,8,11,0.727,2,2,1.0,0,0,0.0,1,7,8,13,0,1,3,5,18,8,1,SAC,GSW,SAC,134,13.5,Rebounds,39,26,31,21
Domantas Sabonis,C,22023,1627734,22300632,"JAN 25, 2024",SAC @ GSW,W,35,8,11,0.727,2,2,1.0,0,0,0.0,1,7,8,13,0,1,3,5,18,8,1,SAC,GSW,SAC,134,42.5,Pts+Rebs+Asts,39,26,31,21
Domantas Sabonis,C,22023,1627734,22300632,"JAN 25, 2024",SAC @ GSW,W,35,8,11,0.727,2,2,1.0,0,0,0.0,1,7,8,13,0,1,3,5,18,8,1,SAC,GSW,SAC,134,8.5,Assists,39,26,31,21
Domantas Sabonis,C,22023,1627734,22300632,"JAN 25, 2024",SAC @ GSW,W,35,8,11,0.727,2,2,1.0,0,0,0.0,1,7,8,13,0,1,3,5,18,8,1,SAC,GSW,SAC,134,49.5,Fantasy Score,39,26,31,21
Domantas Sabonis,C,22023,1627734,22300632,"JAN 25, 2024",SAC @ GSW,W,35,8,11,0.727,2,2,1.0,0,0,0.0,1,7,8,13,0,1,3,5,18,8,1,SAC,GSW,SAC,134,10.0,Defensive Rebounds,39,26,31,21
Domantas Sabonis,C,22023,1627734,22300632,"JAN 25, 2024",SAC @ GSW,W,35,8,11,0.727,2,2,1.0,0,0,0.0,1,7,8,13,0,1,3,5,18,8,1,SAC,GSW,SAC,134,3.5,Free Throws Made,39,26,31,21
Domantas Sabonis,C,22023,1627734,22300632,"JAN 25, 2024",SAC @ GSW,W,35,8,11,0.727,2,2,1.0,0,0,0.0,1,7,8,13,0,1,3,5,18,8,1,SAC,GSW,SAC,134,13.0,FG Attempted,39,26,31,21
Domantas Sabonis,C,22023,1627734,22300632,"JAN 25, 2024",SAC @ GSW,W,35,8,11,0.727,2,2,1.0,0,0,0.0,1,7,8,13,0,1,3,5,18,8,1,SAC,GSW,SAC,134,34.5,Pts+Rebs,39,26,31,21
Domantas Sabonis,C,22023,1627734,22300632,"JAN 25, 2024",SAC @ GSW,W,35,8,11,0.727,2,2,1.0,0,0,0.0,1,7,8,13,0,1,3,5,18,8,1,SAC,GSW,SAC,134,1.0,Dunks,39,26,31,21
Domantas Sabonis,C,22023,1627734,22300632,"JAN 25, 2024",SAC @ GSW,W,35,8,11,0.727,2,2,1.0,0,0,0.0,1,7,8,13,0,1,3,5,18,8,1,SAC,GSW,SAC,134,28.5,Pts+Asts,39,26,31,21
Domantas Sabonis,C,22023,1627734,22300632,"JAN 25, 2024",SAC @ GSW,W,35,8,11,0.727,2,2,1.0,0,0,0.0,1,7,8,13,0,1,3,5,18,8,1,SAC,GSW,SAC,134,22.5,Rebs+Asts,39,26,31,21
Domantas Sabonis,C,22023,1627734,22300613,"JAN 22, 2024",SAC vs. ATL,W,38,4,10,0.4,0,1,0.0,6,6,1.0,2,19,21,6,2,0,4,4,14,11,1,SAC,SAC,ATL,122,19.5,Points,41,35,20,27
Domantas Sabonis,C,22023,1627734,22300613,"JAN 22, 2024",SAC vs. ATL,W,38,4,10,0.4,0,1,0.0,6,6,1.0,2,19,21,6,2,0,4,4,14,11,1,SAC,SAC,ATL,122,13.5,Rebounds,41,35,20,27
Domantas Sabonis,C,22023,1627734,22300613,"JAN 22, 2024",SAC vs. ATL,W,38,4,10,0.4,0,1,0.0,6,6,1.0,2,19,21,6,2,0,4,4,14,11,1,SAC,SAC,ATL,122,42.5,Pts+Rebs+Asts,41,35,20,27
Domantas Sabonis,C,22023,1627734,22300613,"JAN 22, 2024",SAC vs. ATL,W,38,4,10,0.4,0,1,0.0,6,6,1.0,2,19,21,6,2,0,4,4,14,11,1,SAC,SAC,ATL,122,8.5,Assists,41,35,20,27
Domantas Sabonis,C,22023,1627734,22300613,"JAN 22, 2024",SAC vs. ATL,W,38,4,10,0.4,0,1,0.0,6,6,1.0,2,19,21,6,2,0,4,4,14,11,1,SAC,SAC,ATL,122,49.5,Fantasy Score,41,35,20,27
Domantas Sabonis,C,22023,1627734,22300613,"JAN 22, 2024",SAC vs. ATL,W,38,4,10,0.4,0,1,0.0,6,6,1.0,2,19,21,6,2,0,4,4,14,11,1,SAC,SAC,ATL,122,10.0,Defensive Rebounds,41,35,20,27
Domantas Sabonis,C,22023,1627734,22300613,"JAN 22, 2024",SAC vs. ATL,W,38,4,10,0.4,0,1,0.0,6,6,1.0,2,19,21,6,2,0,4,4,14,11,1,SAC,SAC,ATL,122,3.5,Free Throws Made,41,35,20,27
Domantas Sabonis,C,22023,1627734,22300613,"JAN 22, 2024",SAC vs. ATL,W,38,4,10,0.4,0,1,0.0,6,6,1.0,2,19,21,6,2,0,4,4,14,11,1,SAC,SAC,ATL,122,13.0,FG Attempted,41,35,20,27
Domantas Sabonis,C,22023,1627734,22300613,"JAN 22, 2024",SAC vs. ATL,W,38,4,10,0.4,0,1,0.0,6,6,1.0,2,19,21,6,2,0,4,4,14,11,1,SAC,SAC,ATL,122,34.5,Pts+Rebs,41,35,20,27
Domantas Sabonis,C,22023,1627734,22300613,"JAN 22, 2024",SAC vs. ATL,W,38,4,10,0.4,0,1,0.0,6,6,1.0,2,19,21,6,2,0,4,4,14,11,1,SAC,SAC,ATL,122,1.0,Dunks,41,35,20,27
Domantas Sabonis,C,22023,1627734,22300613,"JAN 22, 2024",SAC vs. ATL,W,38,4,10,0.4,0,1,0.0,6,6,1.0,2,19,21,6,2,0,4,4,14,11,1,SAC,SAC,ATL,122,28.5,Pts+Asts,41,35,20,27
Domantas Sabonis,C,22023,1627734,22300613,"JAN 22, 2024",SAC vs. ATL,W,38,4,10,0.4,0,1,0.0,6,6,1.0,2,19,21,6,2,0,4,4,14,11,1,SAC,SAC,ATL,122,22.5,Rebs+Asts,41,35,20,27
Domantas Sabonis,C,22023,1627734,22300583,"JAN 18, 2024",SAC vs. IND,L,38,8,13,0.615,0,1,0.0,5,8,0.625,0,11,11,10,0,1,3,5,21,-4,1,SAC,SAC,IND,121,19.5,Points,42,32,31,21
Domantas Sabonis,C,22023,1627734,22300583,"JAN 18, 2024",SAC vs. IND,L,38,8,13,0.615,0,1,0.0,5,8,0.625,0,11,11,10,0,1,3,5,21,-4,1,SAC,SAC,IND,121,13.5,Rebounds,42,32,31,21
Domantas Sabonis,C,22023,1627734,22300583,"JAN 18, 2024",SAC vs. IND,L,38,8,13,0.615,0,1,0.0,5,8,0.625,0,11,11,10,0,1,3,5,21,-4,1,SAC,SAC,IND,121,42.5,Pts+Rebs+Asts,42,32,31,21
Domantas Sabonis,C,22023,1627734,22300583,"JAN 18, 2024",SAC vs. IND,L,38,8,13,0.615,0,1,0.0,5,8,0.625,0,11,11,10,0,1,3,5,21,-4,1,SAC,SAC,IND,121,8.5,Assists,42,32,31,21
Domantas Sabonis,C,22023,1627734,22300583,"JAN 18, 2024",SAC vs. IND,L,38,8,13,0.615,0,1,0.0,5,8,0.625,0,11,11,10,0,1,3,5,21,-4,1,SAC,SAC,IND,121,49.5,Fantasy Score,42,32,31,21
Domantas Sabonis,C,22023,1627734,22300583,"JAN 18, 2024",SAC vs. IND,L,38,8,13,0.615,0,1,0.0,5,8,0.625,0,11,11,10,0,1,3,5,21,-4,1,SAC,SAC,IND,121,10.0,Defensive Rebounds,42,32,31,21
Domantas Sabonis,C,22023,1627734,22300583,"JAN 18, 2024",SAC vs. IND,L,38,8,13,0.615,0,1,0.0,5,8,0.625,0,11,11,10,0,1,3,5,21,-4,1,SAC,SAC,IND,121,3.5,Free Throws Made,42,32,31,21
Domantas Sabonis,C,22023,1627734,22300583,"JAN 18, 2024",SAC vs. IND,L,38,8,13,0.615,0,1,0.0,5,8,0.625,0,11,11,10,0,1,3,5,21,-4,1,SAC,SAC,IND,121,13.0,FG Attempted,42,32,31,21
Domantas Sabonis,C,22023,1627734,22300583,"JAN 18, 2024",SAC vs. IND,L,38,8,13,0.615,0,1,0.0,5,8,0.625,0,11,11,10,0,1,3,5,21,-4,1,SAC,SAC,IND,121,34.5,Pts+Rebs,42,32,31,21
Domantas Sabonis,C,22023,1627734,22300583,"JAN 18, 2024",SAC vs. IND,L,38,8,13,0.615,0,1,0.0,5,8,0.625,0,11,11,10,0,1,3,5,21,-4,1,SAC,SAC,IND,121,1.0,Dunks,42,32,31,21
Domantas Sabonis,C,22023,1627734,22300583,"JAN 18, 2024",SAC vs. IND,L,38,8,13,0.615,0,1,0.0,5,8,0.625,0,11,11,10,0,1,3,5,21,-4,1,SAC,SAC,IND,121,28.5,Pts+Asts,42,32,31,21
Domantas Sabonis,C,22023,1627734,22300583,"JAN 18, 2024",SAC vs. IND,L,38,8,13,0.615,0,1,0.0,5,8,0.625,0,11,11,10,0,1,3,5,21,-4,1,SAC,SAC,IND,121,22.5,Rebs+Asts,42,32,31,21
Domantas Sabonis,C,22023,1627734,22300567,"JAN 16, 2024",SAC @ PHX,L,39,9,11,0.818,1,1,1.0,2,4,0.5,2,10,12,11,0,1,2,2,21,-2,1,SAC,PHX,SAC,117,19.5,Points,44,33,32,23
Domantas Sabonis,C,22023,1627734,22300567,"JAN 16, 2024",SAC @ PHX,L,39,9,11,0.818,1,1,1.0,2,4,0.5,2,10,12,11,0,1,2,2,21,-2,1,SAC,PHX,SAC,117,13.5,Rebounds,44,33,32,23
Domantas Sabonis,C,22023,1627734,22300567,"JAN 16, 2024",SAC @ PHX,L,39,9,11,0.818,1,1,1.0,2,4,0.5,2,10,12,11,0,1,2,2,21,-2,1,SAC,PHX,SAC,117,42.5,Pts+Rebs+Asts,44,33,32,23
Domantas Sabonis,C,22023,1627734,22300567,"JAN 16, 2024",SAC @ PHX,L,39,9,11,0.818,1,1,1.0,2,4,0.5,2,10,12,11,0,1,2,2,21,-2,1,SAC,PHX,SAC,117,8.5,Assists,44,33,32,23
Domantas Sabonis,C,22023,1627734,22300567,"JAN 16, 2024",SAC @ PHX,L,39,9,11,0.818,1,1,1.0,2,4,0.5,2,10,12,11,0,1,2,2,21,-2,1,SAC,PHX,SAC,117,49.5,Fantasy Score,44,33,32,23
Domantas Sabonis,C,22023,1627734,22300567,"JAN 16, 2024",SAC @ PHX,L,39,9,11,0.818,1,1,1.0,2,4,0.5,2,10,12,11,0,1,2,2,21,-2,1,SAC,PHX,SAC,117,10.0,Defensive Rebounds,44,33,32,23
Domantas Sabonis,C,22023,1627734,22300567,"JAN 16, 2024",SAC @ PHX,L,39,9,11,0.818,1,1,1.0,2,4,0.5,2,10,12,11,0,1,2,2,21,-2,1,SAC,PHX,SAC,117,3.5,Free Throws Made,44,33,32,23
Domantas Sabonis,C,22023,1627734,22300567,"JAN 16, 2024",SAC @ PHX,L,39,9,11,0.818,1,1,1.0,2,4,0.5,2,10,12,11,0,1,2,2,21,-2,1,SAC,PHX,SAC,117,13.0,FG Attempted,44,33,32,23
Domantas Sabonis,C,22023,1627734,22300567,"JAN 16, 2024",SAC @ PHX,L,39,9,11,0.818,1,1,1.0,2,4,0.5,2,10,12,11,0,1,2,2,21,-2,1,SAC,PHX,SAC,117,34.5,Pts+Rebs,44,33,32,23
Domantas Sabonis,C,22023,1627734,22300567,"JAN 16, 2024",SAC @ PHX,L,39,9,11,0.818,1,1,1.0,2,4,0.5,2,10,12,11,0,1,2,2,21,-2,1,SAC,PHX,SAC,117,1.0,Dunks,44,33,32,23
Domantas Sabonis,C,22023,1627734,22300567,"JAN 16, 2024",SAC @ PHX,L,39,9,11,0.818,1,1,1.0,2,4,0.5,2,10,12,11,0,1,2,2,21,-2,1,SAC,PHX,SAC,117,28.5,Pts+Asts,44,33,32,23
Domantas Sabonis,C,22023,1627734,22300567,"JAN 16, 2024",SAC @ PHX,L,39,9,11,0.818,1,1,1.0,2,4,0.5,2,10,12,11,0,1,2,2,21,-2,1,SAC,PHX,SAC,117,22.5,Rebs+Asts,44,33,32,23
Domantas Sabonis,C,22023,1627734,22300552,"JAN 14, 2024",SAC @ MIL,L,45,9,10,0.9,1,1,1.0,2,2,1.0,3,10,13,15,1,1,3,3,21,7,1,SAC,MIL,SAC,142,19.5,Points,49,34,36,28
Domantas Sabonis,C,22023,1627734,22300552,"JAN 14, 2024",SAC @ MIL,L,45,9,10,0.9,1,1,1.0,2,2,1.0,3,10,13,15,1,1,3,3,21,7,1,SAC,MIL,SAC,142,13.5,Rebounds,49,34,36,28
Domantas Sabonis,C,22023,1627734,22300552,"JAN 14, 2024",SAC @ MIL,L,45,9,10,0.9,1,1,1.0,2,2,1.0,3,10,13,15,1,1,3,3,21,7,1,SAC,MIL,SAC,142,42.5,Pts+Rebs+Asts,49,34,36,28
Domantas Sabonis,C,22023,1627734,22300552,"JAN 14, 2024",SAC @ MIL,L,45,9,10,0.9,1,1,1.0,2,2,1.0,3,10,13,15,1,1,3,3,21,7,1,SAC,MIL,SAC,142,8.5,Assists,49,34,36,28
Domantas Sabonis,C,22023,1627734,22300552,"JAN 14, 2024",SAC @ MIL,L,45,9,10,0.9,1,1,1.0,2,2,1.0,3,10,13,15,1,1,3,3,21,7,1,SAC,MIL,SAC,142,49.5,Fantasy Score,49,34,36,28
Domantas Sabonis,C,22023,1627734,22300552,"JAN 14, 2024",SAC @ MIL,L,45,9,10,0.9,1,1,1.0,2,2,1.0,3,10,13,15,1,1,3,3,21,7,1,SAC,MIL,SAC,142,10.0,Defensive Rebounds,49,34,36,28
Domantas Sabonis,C,22023,1627734,22300552,"JAN 14, 2024",SAC @ MIL,L,45,9,10,0.9,1,1,1.0,2,2,1.0,3,10,13,15,1,1,3,3,21,7,1,SAC,MIL,SAC,142,3.5,Free Throws Made,49,34,36,28
Domantas Sabonis,C,22023,1627734,22300552,"JAN 14, 2024",SAC @ MIL,L,45,9,10,0.9,1,1,1.0,2,2,1.0,3,10,13,15,1,1,3,3,21,7,1,SAC,MIL,SAC,142,13.0,FG Attempted,49,34,36,28
Domantas Sabonis,C,22023,1627734,22300552,"JAN 14, 2024",SAC @ MIL,L,45,9,10,0.9,1,1,1.0,2,2,1.0,3,10,13,15,1,1,3,3,21,7,1,SAC,MIL,SAC,142,34.5,Pts+Rebs,49,34,36,28
Domantas Sabonis,C,22023,1627734,22300552,"JAN 14, 2024",SAC @ MIL,L,45,9,10,0.9,1,1,1.0,2,2,1.0,3,10,13,15,1,1,3,3,21,7,1,SAC,MIL,SAC,142,1.0,Dunks,49,34,36,28
Domantas Sabonis,C,22023,1627734,22300552,"JAN 14, 2024",SAC @ MIL,L,45,9,10,0.9,1,1,1.0,2,2,1.0,3,10,13,15,1,1,3,3,21,7,1,SAC,MIL,SAC,142,28.5,Pts+Asts,49,34,36,28
Domantas Sabonis,C,22023,1627734,22300552,"JAN 14, 2024",SAC @ MIL,L,45,9,10,0.9,1,1,1.0,2,2,1.0,3,10,13,15,1,1,3,3,21,7,1,SAC,MIL,SAC,142,22.5,Rebs+Asts,49,34,36,28
Domantas Sabonis,C,22023,1627734,22300532,"JAN 12, 2024",SAC @ PHI,L,33,6,10,0.6,0,0,0.0,2,2,1.0,5,7,12,5,0,0,4,3,14,-20,1,SAC,PHI,SAC,90,19.5,Points,31,26,19,17
Domantas Sabonis,C,22023,1627734,22300532,"JAN 12, 2024",SAC @ PHI,L,33,6,10,0.6,0,0,0.0,2,2,1.0,5,7,12,5,0,0,4,3,14,-20,1,SAC,PHI,SAC,90,13.5,Rebounds,31,26,19,17
Domantas Sabonis,C,22023,1627734,22300532,"JAN 12, 2024",SAC @ PHI,L,33,6,10,0.6,0,0,0.0,2,2,1.0,5,7,12,5,0,0,4,3,14,-20,1,SAC,PHI,SAC,90,42.5,Pts+Rebs+Asts,31,26,19,17
Domantas Sabonis,C,22023,1627734,22300532,"JAN 12, 2024",SAC @ PHI,L,33,6,10,0.6,0,0,0.0,2,2,1.0,5,7,12,5,0,0,4,3,14,-20,1,SAC,PHI,SAC,90,8.5,Assists,31,26,19,17
Domantas Sabonis,C,22023,1627734,22300532,"JAN 12, 2024",SAC @ PHI,L,33,6,10,0.6,0,0,0.0,2,2,1.0,5,7,12,5,0,0,4,3,14,-20,1,SAC,PHI,SAC,90,49.5,Fantasy Score,31,26,19,17
Domantas Sabonis,C,22023,1627734,22300532,"JAN 12, 2024",SAC @ PHI,L,33,6,10,0.6,0,0,0.0,2,2,1.0,5,7,12,5,0,0,4,3,14,-20,1,SAC,PHI,SAC,90,10.0,Defensive Rebounds,31,26,19,17
Domantas Sabonis,C,22023,1627734,22300532,"JAN 12, 2024",SAC @ PHI,L,33,6,10,0.6,0,0,0.0,2,2,1.0,5,7,12,5,0,0,4,3,14,-20,1,SAC,PHI,SAC,90,3.5,Free Throws Made,31,26,19,17
Domantas Sabonis,C,22023,1627734,22300532,"JAN 12, 2024",SAC @ PHI,L,33,6,10,0.6,0,0,0.0,2,2,1.0,5,7,12,5,0,0,4,3,14,-20,1,SAC,PHI,SAC,90,13.0,FG Attempted,31,26,19,17
Domantas Sabonis,C,22023,1627734,22300532,"JAN 12, 2024",SAC @ PHI,L,33,6,10,0.6,0,0,0.0,2,2,1.0,5,7,12,5,0,0,4,3,14,-20,1,SAC,PHI,SAC,90,34.5,Pts+Rebs,31,26,19,17
Domantas Sabonis,C,22023,1627734,22300532,"JAN 12, 2024",SAC @ PHI,L,33,6,10,0.6,0,0,0.0,2,2,1.0,5,7,12,5,0,0,4,3,14,-20,1,SAC,PHI,SAC,90,1.0,Dunks,31,26,19,17
Domantas Sabonis,C,22023,1627734,22300532,"JAN 12, 2024",SAC @ PHI,L,33,6,10,0.6,0,0,0.0,2,2,1.0,5,7,12,5,0,0,4,3,14,-20,1,SAC,PHI,SAC,90,28.5,Pts+Asts,31,26,19,17
Domantas Sabonis,C,22023,1627734,22300532,"JAN 12, 2024",SAC @ PHI,L,33,6,10,0.6,0,0,0.0,2,2,1.0,5,7,12,5,0,0,4,3,14,-20,1,SAC,PHI,SAC,90,22.5,Rebs+Asts,31,26,19,17
Domantas Sabonis,C,22023,1627734,22300518,"JAN 10, 2024",SAC @ CHA,W,28,9,13,0.692,1,2,0.5,5,6,0.833,1,9,10,7,0,1,2,2,24,-4,1,SAC,CHA,SAC,121,19.5,Points,41,34,31,17
Domantas Sabonis,C,22023,1627734,22300518,"JAN 10, 2024",SAC @ CHA,W,28,9,13,0.692,1,2,0.5,5,6,0.833,1,9,10,7,0,1,2,2,24,-4,1,SAC,CHA,SAC,121,13.5,Rebounds,41,34,31,17
Domantas Sabonis,C,22023,1627734,22300518,"JAN 10, 2024",SAC @ CHA,W,28,9,13,0.692,1,2,0.5,5,6,0.833,1,9,10,7,0,1,2,2,24,-4,1,SAC,CHA,SAC,121,42.5,Pts+Rebs+Asts,41,34,31,17
Domantas Sabonis,C,22023,1627734,22300518,"JAN 10, 2024",SAC @ CHA,W,28,9,13,0.692,1,2,0.5,5,6,0.833,1,9,10,7,0,1,2,2,24,-4,1,SAC,CHA,SAC,121,8.5,Assists,41,34,31,17
Domantas Sabonis,C,22023,1627734,22300518,"JAN 10, 2024",SAC @ CHA,W,28,9,13,0.692,1,2,0.5,5,6,0.833,1,9,10,7,0,1,2,2,24,-4,1,SAC,CHA,SAC,121,49.5,Fantasy Score,41,34,31,17
Domantas Sabonis,C,22023,1627734,22300518,"JAN 10, 2024",SAC @ CHA,W,28,9,13,0.692,1,2,0.5,5,6,0.833,1,9,10,7,0,1,2,2,24,-4,1,SAC,CHA,SAC,121,10.0,Defensive Rebounds,41,34,31,17
Domantas Sabonis,C,22023,1627734,22300518,"JAN 10, 2024",SAC @ CHA,W,28,9,13,0.692,1,2,0.5,5,6,0.833,1,9,10,7,0,1,2,2,24,-4,1,SAC,CHA,SAC,121,3.5,Free Throws Made,41,34,31,17
Domantas Sabonis,C,22023,1627734,22300518,"JAN 10, 2024",SAC @ CHA,W,28,9,13,0.692,1,2,0.5,5,6,0.833,1,9,10,7,0,1,2,2,24,-4,1,SAC,CHA,SAC,121,13.0,FG Attempted,41,34,31,17
Domantas Sabonis,C,22023,1627734,22300518,"JAN 10, 2024",SAC @ CHA,W,28,9,13,0.692,1,2,0.5,5,6,0.833,1,9,10,7,0,1,2,2,24,-4,1,SAC,CHA,SAC,121,34.5,Pts+Rebs,41,34,31,17
Domantas Sabonis,C,22023,1627734,22300518,"JAN 10, 2024",SAC @ CHA,W,28,9,13,0.692,1,2,0.5,5,6,0.833,1,9,10,7,0,1,2,2,24,-4,1,SAC,CHA,SAC,121,1.0,Dunks,41,34,31,17
Domantas Sabonis,C,22023,1627734,22300518,"JAN 10, 2024",SAC @ CHA,W,28,9,13,0.692,1,2,0.5,5,6,0.833,1,9,10,7,0,1,2,2,24,-4,1,SAC,CHA,SAC,121,28.5,Pts+Asts,41,34,31,17
Domantas Sabonis,C,22023,1627734,22300518,"JAN 10, 2024",SAC @ CHA,W,28,9,13,0.692,1,2,0.5,5,6,0.833,1,9,10,7,0,1,2,2,24,-4,1,SAC,CHA,SAC,121,22.5,Rebs+Asts,41,34,31,17
Domantas Sabonis,C,22023,1627734,22300512,"JAN 09, 2024",SAC @ DET,W,38,16,21,0.762,1,1,1.0,4,4,1.0,5,5,10,13,3,0,5,3,37,28,1,SAC,DET,SAC,131,19.5,Points,60,47,50,23
Domantas Sabonis,C,22023,1627734,22300512,"JAN 09, 2024",SAC @ DET,W,38,16,21,0.762,1,1,1.0,4,4,1.0,5,5,10,13,3,0,5,3,37,28,1,SAC,DET,SAC,131,13.5,Rebounds,60,47,50,23
Domantas Sabonis,C,22023,1627734,22300512,"JAN 09, 2024",SAC @ DET,W,38,16,21,0.762,1,1,1.0,4,4,1.0,5,5,10,13,3,0,5,3,37,28,1,SAC,DET,SAC,131,42.5,Pts+Rebs+Asts,60,47,50,23
Domantas Sabonis,C,22023,1627734,22300512,"JAN 09, 2024",SAC @ DET,W,38,16,21,0.762,1,1,1.0,4,4,1.0,5,5,10,13,3,0,5,3,37,28,1,SAC,DET,SAC,131,8.5,Assists,60,47,50,23
Domantas Sabonis,C,22023,1627734,22300512,"JAN 09, 2024",SAC @ DET,W,38,16,21,0.762,1,1,1.0,4,4,1.0,5,5,10,13,3,0,5,3,37,28,1,SAC,DET,SAC,131,49.5,Fantasy Score,60,47,50,23
Domantas Sabonis,C,22023,1627734,22300512,"JAN 09, 2024",SAC @ DET,W,38,16,21,0.762,1,1,1.0,4,4,1.0,5,5,10,13,3,0,5,3,37,28,1,SAC,DET,SAC,131,10.0,Defensive Rebounds,60,47,50,23
Domantas Sabonis,C,22023,1627734,22300512,"JAN 09, 2024",SAC @ DET,W,38,16,21,0.762,1,1,1.0,4,4,1.0,5,5,10,13,3,0,5,3,37,28,1,SAC,DET,SAC,131,3.5,Free Throws Made,60,47,50,23
Domantas Sabonis,C,22023,1627734,22300512,"JAN 09, 2024",SAC @ DET,W,38,16,21,0.762,1,1,1.0,4,4,1.0,5,5,10,13,3,0,5,3,37,28,1,SAC,DET,SAC,131,13.0,FG Attempted,60,47,50,23
Domantas Sabonis,C,22023,1627734,22300512,"JAN 09, 2024",SAC @ DET,W,38,16,21,0.762,1,1,1.0,4,4,1.0,5,5,10,13,3,0,5,3,37,28,1,SAC,DET,SAC,131,34.5,Pts+Rebs,60,47,50,23
Domantas Sabonis,C,22023,1627734,22300512,"JAN 09, 2024",SAC @ DET,W,38,16,21,0.762,1,1,1.0,4,4,1.0,5,5,10,13,3,0,5,3,37,28,1,SAC,DET,SAC,131,1.0,Dunks,60,47,50,23
Domantas Sabonis,C,22023,1627734,22300512,"JAN 09, 2024",SAC @ DET,W,38,16,21,0.762,1,1,1.0,4,4,1.0,5,5,10,13,3,0,5,3,37,28,1,SAC,DET,SAC,131,28.5,Pts+Asts,60,47,50,23
Domantas Sabonis,C,22023,1627734,22300512,"JAN 09, 2024",SAC @ DET,W,38,16,21,0.762,1,1,1.0,4,4,1.0,5,5,10,13,3,0,5,3,37,28,1,SAC,DET,SAC,131,22.5,Rebs+Asts,60,47,50,23
Domantas Sabonis,C,22023,1627734,22300500,"JAN 07, 2024",SAC vs. NOP,L,29,8,12,0.667,1,2,0.5,0,1,0.0,0,10,10,6,1,0,3,2,17,-32,1,SAC,SAC,NOP,100,19.5,Points,33,27,23,16
Domantas Sabonis,C,22023,1627734,22300500,"JAN 07, 2024",SAC vs. NOP,L,29,8,12,0.667,1,2,0.5,0,1,0.0,0,10,10,6,1,0,3,2,17,-32,1,SAC,SAC,NOP,100,13.5,Rebounds,33,27,23,16
Domantas Sabonis,C,22023,1627734,22300500,"JAN 07, 2024",SAC vs. NOP,L,29,8,12,0.667,1,2,0.5,0,1,0.0,0,10,10,6,1,0,3,2,17,-32,1,SAC,SAC,NOP,100,42.5,Pts+Rebs+Asts,33,27,23,16
Domantas Sabonis,C,22023,1627734,22300500,"JAN 07, 2024",SAC vs. NOP,L,29,8,12,0.667,1,2,0.5,0,1,0.0,0,10,10,6,1,0,3,2,17,-32,1,SAC,SAC,NOP,100,8.5,Assists,33,27,23,16
Domantas Sabonis,C,22023,1627734,22300500,"JAN 07, 2024",SAC vs. NOP,L,29,8,12,0.667,1,2,0.5,0,1,0.0,0,10,10,6,1,0,3,2,17,-32,1,SAC,SAC,NOP,100,49.5,Fantasy Score,33,27,23,16
Domantas Sabonis,C,22023,1627734,22300500,"JAN 07, 2024",SAC vs. NOP,L,29,8,12,0.667,1,2,0.5,0,1,0.0,0,10,10,6,1,0,3,2,17,-32,1,SAC,SAC,NOP,100,10.0,Defensive Rebounds,33,27,23,16
Domantas Sabonis,C,22023,1627734,22300500,"JAN 07, 2024",SAC vs. NOP,L,29,8,12,0.667,1,2,0.5,0,1,0.0,0,10,10,6,1,0,3,2,17,-32,1,SAC,SAC,NOP,100,3.5,Free Throws Made,33,27,23,16
Domantas Sabonis,C,22023,1627734,22300500,"JAN 07, 2024",SAC vs. NOP,L,29,8,12,0.667,1,2,0.5,0,1,0.0,0,10,10,6,1,0,3,2,17,-32,1,SAC,SAC,NOP,100,13.0,FG Attempted,33,27,23,16
Domantas Sabonis,C,22023,1627734,22300500,"JAN 07, 2024",SAC vs. NOP,L,29,8,12,0.667,1,2,0.5,0,1,0.0,0,10,10,6,1,0,3,2,17,-32,1,SAC,SAC,NOP,100,34.5,Pts+Rebs,33,27,23,16
Domantas Sabonis,C,22023,1627734,22300500,"JAN 07, 2024",SAC vs. NOP,L,29,8,12,0.667,1,2,0.5,0,1,0.0,0,10,10,6,1,0,3,2,17,-32,1,SAC,SAC,NOP,100,1.0,Dunks,33,27,23,16
Domantas Sabonis,C,22023,1627734,22300500,"JAN 07, 2024",SAC vs. NOP,L,29,8,12,0.667,1,2,0.5,0,1,0.0,0,10,10,6,1,0,3,2,17,-32,1,SAC,SAC,NOP,100,28.5,Pts+Asts,33,27,23,16
Domantas Sabonis,C,22023,1627734,22300500,"JAN 07, 2024",SAC vs. NOP,L,29,8,12,0.667,1,2,0.5,0,1,0.0,0,10,10,6,1,0,3,2,17,-32,1,SAC,SAC,NOP,100,22.5,Rebs+Asts,33,27,23,16
Domantas Sabonis,C,22023,1627734,22300492,"JAN 05, 2024",SAC vs. TOR,W,39,11,16,0.688,0,0,0.0,2,3,0.667,4,11,15,11,0,0,6,6,24,12,1,SAC,SAC,TOR,135,19.5,Points,50,39,35,26
Domantas Sabonis,C,22023,1627734,22300492,"JAN 05, 2024",SAC vs. TOR,W,39,11,16,0.688,0,0,0.0,2,3,0.667,4,11,15,11,0,0,6,6,24,12,1,SAC,SAC,TOR,135,13.5,Rebounds,50,39,35,26
Domantas Sabonis,C,22023,1627734,22300492,"JAN 05, 2024",SAC vs. TOR,W,39,11,16,0.688,0,0,0.0,2,3,0.667,4,11,15,11,0,0,6,6,24,12,1,SAC,SAC,TOR,135,42.5,Pts+Rebs+Asts,50,39,35,26
Domantas Sabonis,C,22023,1627734,22300492,"JAN 05, 2024",SAC vs. TOR,W,39,11,16,0.688,0,0,0.0,2,3,0.667,4,11,15,11,0,0,6,6,24,12,1,SAC,SAC,TOR,135,8.5,Assists,50,39,35,26
Domantas Sabonis,C,22023,1627734,22300492,"JAN 05, 2024",SAC vs. TOR,W,39,11,16,0.688,0,0,0.0,2,3,0.667,4,11,15,11,0,0,6,6,24,12,1,SAC,SAC,TOR,135,49.5,Fantasy Score,50,39,35,26
Domantas Sabonis,C,22023,1627734,22300492,"JAN 05, 2024",SAC vs. TOR,W,39,11,16,0.688,0,0,0.0,2,3,0.667,4,11,15,11,0,0,6,6,24,12,1,SAC,SAC,TOR,135,10.0,Defensive Rebounds,50,39,35,26
Domantas Sabonis,C,22023,1627734,22300492,"JAN 05, 2024",SAC vs. TOR,W,39,11,16,0.688,0,0,0.0,2,3,0.667,4,11,15,11,0,0,6,6,24,12,1,SAC,SAC,TOR,135,3.5,Free Throws Made,50,39,35,26
Domantas Sabonis,C,22023,1627734,22300492,"JAN 05, 2024",SAC vs. TOR,W,39,11,16,0.688,0,0,0.0,2,3,0.667,4,11,15,11,0,0,6,6,24,12,1,SAC,SAC,TOR,135,13.0,FG Attempted,50,39,35,26
Domantas Sabonis,C,22023,1627734,22300492,"JAN 05, 2024",SAC vs. TOR,W,39,11,16,0.688,0,0,0.0,2,3,0.667,4,11,15,11,0,0,6,6,24,12,1,SAC,SAC,TOR,135,34.5,Pts+Rebs,50,39,35,26
Domantas Sabonis,C,22023,1627734,22300492,"JAN 05, 2024",SAC vs. TOR,W,39,11,16,0.688,0,0,0.0,2,3,0.667,4,11,15,11,0,0,6,6,24,12,1,SAC,SAC,TOR,135,1.0,Dunks,50,39,35,26
Domantas Sabonis,C,22023,1627734,22300492,"JAN 05, 2024",SAC vs. TOR,W,39,11,16,0.688,0,0,0.0,2,3,0.667,4,11,15,11,0,0,6,6,24,12,1,SAC,SAC,TOR,135,28.5,Pts+Asts,50,39,35,26
Domantas Sabonis,C,22023,1627734,22300492,"JAN 05, 2024",SAC vs. TOR,W,39,11,16,0.688,0,0,0.0,2,3,0.667,4,11,15,11,0,0,6,6,24,12,1,SAC,SAC,TOR,135,22.5,Rebs+Asts,50,39,35,26
Domantas Sabonis,C,22023,1627734,22300476,"JAN 03, 2024",SAC vs. ORL,W,45,8,14,0.571,0,0,0.0,6,9,0.667,6,17,23,12,2,1,6,2,22,10,1,SAC,SAC,ORL,138,19.5,Points,57,45,34,35
Domantas Sabonis,C,22023,1627734,22300476,"JAN 03, 2024",SAC vs. ORL,W,45,8,14,0.571,0,0,0.0,6,9,0.667,6,17,23,12,2,1,6,2,22,10,1,SAC,SAC,ORL,138,13.5,Rebounds,57,45,34,35
Domantas Sabonis,C,22023,1627734,22300476,"JAN 03, 2024",SAC vs. ORL,W,45,8,14,0.571,0,0,0.0,6,9,0.667,6,17,23,12,2,1,6,2,22,10,1,SAC,SAC,ORL,138,42.5,Pts+Rebs+Asts,57,45,34,35
Domantas Sabonis,C,22023,1627734,22300476,"JAN 03, 2024",SAC vs. ORL,W,45,8,14,0.571,0,0,0.0,6,9,0.667,6,17,23,12,2,1,6,2,22,10,1,SAC,SAC,ORL,138,8.5,Assists,57,45,34,35
Domantas Sabonis,C,22023,1627734,22300476,"JAN 03, 2024",SAC vs. ORL,W,45,8,14,0.571,0,0,0.0,6,9,0.667,6,17,23,12,2,1,6,2,22,10,1,SAC,SAC,ORL,138,49.5,Fantasy Score,57,45,34,35
Domantas Sabonis,C,22023,1627734,22300476,"JAN 03, 2024",SAC vs. ORL,W,45,8,14,0.571,0,0,0.0,6,9,0.667,6,17,23,12,2,1,6,2,22,10,1,SAC,SAC,ORL,138,10.0,Defensive Rebounds,57,45,34,35
Domantas Sabonis,C,22023,1627734,22300476,"JAN 03, 2024",SAC vs. ORL,W,45,8,14,0.571,0,0,0.0,6,9,0.667,6,17,23,12,2,1,6,2,22,10,1,SAC,SAC,ORL,138,3.5,Free Throws Made,57,45,34,35
Domantas Sabonis,C,22023,1627734,22300476,"JAN 03, 2024",SAC vs. ORL,W,45,8,14,0.571,0,0,0.0,6,9,0.667,6,17,23,12,2,1,6,2,22,10,1,SAC,SAC,ORL,138,13.0,FG Attempted,57,45,34,35
Domantas Sabonis,C,22023,1627734,22300476,"JAN 03, 2024",SAC vs. ORL,W,45,8,14,0.571,0,0,0.0,6,9,0.667,6,17,23,12,2,1,6,2,22,10,1,SAC,SAC,ORL,138,34.5,Pts+Rebs,57,45,34,35
Domantas Sabonis,C,22023,1627734,22300476,"JAN 03, 2024",SAC vs. ORL,W,45,8,14,0.571,0,0,0.0,6,9,0.667,6,17,23,12,2,1,6,2,22,10,1,SAC,SAC,ORL,138,1.0,Dunks,57,45,34,35
Domantas Sabonis,C,22023,1627734,22300476,"JAN 03, 2024",SAC vs. ORL,W,45,8,14,0.571,0,0,0.0,6,9,0.667,6,17,23,12,2,1,6,2,22,10,1,SAC,SAC,ORL,138,28.5,Pts+Asts,57,45,34,35
Domantas Sabonis,C,22023,1627734,22300476,"JAN 03, 2024",SAC vs. ORL,W,45,8,14,0.571,0,0,0.0,6,9,0.667,6,17,23,12,2,1,6,2,22,10,1,SAC,SAC,ORL,138,22.5,Rebs+Asts,57,45,34,35
Domantas Sabonis,C,22023,1627734,22300464,"JAN 02, 2024",SAC vs. CHA,L,35,11,21,0.524,1,1,1.0,0,1,0.0,9,10,19,4,1,0,11,5,23,-3,1,SAC,SAC,CHA,104,19.5,Points,46,42,27,23
Domantas Sabonis,C,22023,1627734,22300464,"JAN 02, 2024",SAC vs. CHA,L,35,11,21,0.524,1,1,1.0,0,1,0.0,9,10,19,4,1,0,11,5,23,-3,1,SAC,SAC,CHA,104,13.5,Rebounds,46,42,27,23
Domantas Sabonis,C,22023,1627734,22300464,"JAN 02, 2024",SAC vs. CHA,L,35,11,21,0.524,1,1,1.0,0,1,0.0,9,10,19,4,1,0,11,5,23,-3,1,SAC,SAC,CHA,104,42.5,Pts+Rebs+Asts,46,42,27,23
Domantas Sabonis,C,22023,1627734,22300464,"JAN 02, 2024",SAC vs. CHA,L,35,11,21,0.524,1,1,1.0,0,1,0.0,9,10,19,4,1,0,11,5,23,-3,1,SAC,SAC,CHA,104,8.5,Assists,46,42,27,23
Domantas Sabonis,C,22023,1627734,22300464,"JAN 02, 2024",SAC vs. CHA,L,35,11,21,0.524,1,1,1.0,0,1,0.0,9,10,19,4,1,0,11,5,23,-3,1,SAC,SAC,CHA,104,49.5,Fantasy Score,46,42,27,23
Domantas Sabonis,C,22023,1627734,22300464,"JAN 02, 2024",SAC vs. CHA,L,35,11,21,0.524,1,1,1.0,0,1,0.0,9,10,19,4,1,0,11,5,23,-3,1,SAC,SAC,CHA,104,10.0,Defensive Rebounds,46,42,27,23
Domantas Sabonis,C,22023,1627734,22300464,"JAN 02, 2024",SAC vs. CHA,L,35,11,21,0.524,1,1,1.0,0,1,0.0,9,10,19,4,1,0,11,5,23,-3,1,SAC,SAC,CHA,104,3.5,Free Throws Made,46,42,27,23
Domantas Sabonis,C,22023,1627734,22300464,"JAN 02, 2024",SAC vs. CHA,L,35,11,21,0.524,1,1,1.0,0,1,0.0,9,10,19,4,1,0,11,5,23,-3,1,SAC,SAC,CHA,104,13.0,FG Attempted,46,42,27,23
Domantas Sabonis,C,22023,1627734,22300464,"JAN 02, 2024",SAC vs. CHA,L,35,11,21,0.524,1,1,1.0,0,1,0.0,9,10,19,4,1,0,11,5,23,-3,1,SAC,SAC,CHA,104,34.5,Pts+Rebs,46,42,27,23
Domantas Sabonis,C,22023,1627734,22300464,"JAN 02, 2024",SAC vs. CHA,L,35,11,21,0.524,1,1,1.0,0,1,0.0,9,10,19,4,1,0,11,5,23,-3,1,SAC,SAC,CHA,104,1.0,Dunks,46,42,27,23
Domantas Sabonis,C,22023,1627734,22300464,"JAN 02, 2024",SAC vs. CHA,L,35,11,21,0.524,1,1,1.0,0,1,0.0,9,10,19,4,1,0,11,5,23,-3,1,SAC,SAC,CHA,104,28.5,Pts+Asts,46,42,27,23
Domantas Sabonis,C,22023,1627734,22300464,"JAN 02, 2024",SAC vs. CHA,L,35,11,21,0.524,1,1,1.0,0,1,0.0,9,10,19,4,1,0,11,5,23,-3,1,SAC,SAC,CHA,104,22.5,Rebs+Asts,46,42,27,23
Domantas Sabonis,C,22023,1627734,22300449,"DEC 31, 2023",SAC @ MEM,W,32,5,11,0.455,0,1,0.0,3,5,0.6,2,19,21,12,1,0,3,4,13,17,1,SAC,MEM,SAC,123,19.5,Points,46,34,25,33
Domantas Sabonis,C,22023,1627734,22300449,"DEC 31, 2023",SAC @ MEM,W,32,5,11,0.455,0,1,0.0,3,5,0.6,2,19,21,12,1,0,3,4,13,17,1,SAC,MEM,SAC,123,13.5,Rebounds,46,34,25,33
Domantas Sabonis,C,22023,1627734,22300449,"DEC 31, 2023",SAC @ MEM,W,32,5,11,0.455,0,1,0.0,3,5,0.6,2,19,21,12,1,0,3,4,13,17,1,SAC,MEM,SAC,123,42.5,Pts+Rebs+Asts,46,34,25,33
Domantas Sabonis,C,22023,1627734,22300449,"DEC 31, 2023",SAC @ MEM,W,32,5,11,0.455,0,1,0.0,3,5,0.6,2,19,21,12,1,0,3,4,13,17,1,SAC,MEM,SAC,123,8.5,Assists,46,34,25,33
Domantas Sabonis,C,22023,1627734,22300449,"DEC 31, 2023",SAC @ MEM,W,32,5,11,0.455,0,1,0.0,3,5,0.6,2,19,21,12,1,0,3,4,13,17,1,SAC,MEM,SAC,123,49.5,Fantasy Score,46,34,25,33
Domantas Sabonis,C,22023,1627734,22300449,"DEC 31, 2023",SAC @ MEM,W,32,5,11,0.455,0,1,0.0,3,5,0.6,2,19,21,12,1,0,3,4,13,17,1,SAC,MEM,SAC,123,10.0,Defensive Rebounds,46,34,25,33
Domantas Sabonis,C,22023,1627734,22300449,"DEC 31, 2023",SAC @ MEM,W,32,5,11,0.455,0,1,0.0,3,5,0.6,2,19,21,12,1,0,3,4,13,17,1,SAC,MEM,SAC,123,3.5,Free Throws Made,46,34,25,33
Domantas Sabonis,C,22023,1627734,22300449,"DEC 31, 2023",SAC @ MEM,W,32,5,11,0.455,0,1,0.0,3,5,0.6,2,19,21,12,1,0,3,4,13,17,1,SAC,MEM,SAC,123,13.0,FG Attempted,46,34,25,33
Domantas Sabonis,C,22023,1627734,22300449,"DEC 31, 2023",SAC @ MEM,W,32,5,11,0.455,0,1,0.0,3,5,0.6,2,19,21,12,1,0,3,4,13,17,1,SAC,MEM,SAC,123,34.5,Pts+Rebs,46,34,25,33
Domantas Sabonis,C,22023,1627734,22300449,"DEC 31, 2023",SAC @ MEM,W,32,5,11,0.455,0,1,0.0,3,5,0.6,2,19,21,12,1,0,3,4,13,17,1,SAC,MEM,SAC,123,1.0,Dunks,46,34,25,33
Domantas Sabonis,C,22023,1627734,22300449,"DEC 31, 2023",SAC @ MEM,W,32,5,11,0.455,0,1,0.0,3,5,0.6,2,19,21,12,1,0,3,4,13,17,1,SAC,MEM,SAC,123,28.5,Pts+Asts,46,34,25,33
Domantas Sabonis,C,22023,1627734,22300449,"DEC 31, 2023",SAC @ MEM,W,32,5,11,0.455,0,1,0.0,3,5,0.6,2,19,21,12,1,0,3,4,13,17,1,SAC,MEM,SAC,123,22.5,Rebs+Asts,46,34,25,33
Domantas Sabonis,C,22023,1627734,22300431,"DEC 29, 2023",SAC @ ATL,W,35,12,17,0.706,0,0,0.0,1,4,0.25,2,8,10,7,0,0,1,2,25,-4,1,SAC,ATL,SAC,117,19.5,Points,42,35,32,17
Domantas Sabonis,C,22023,1627734,22300431,"DEC 29, 2023",SAC @ ATL,W,35,12,17,0.706,0,0,0.0,1,4,0.25,2,8,10,7,0,0,1,2,25,-4,1,SAC,ATL,SAC,117,13.5,Rebounds,42,35,32,17
Domantas Sabonis,C,22023,1627734,22300431,"DEC 29, 2023",SAC @ ATL,W,35,12,17,0.706,0,0,0.0,1,4,0.25,2,8,10,7,0,0,1,2,25,-4,1,SAC,ATL,SAC,117,42.5,Pts+Rebs+Asts,42,35,32,17
Domantas Sabonis,C,22023,1627734,22300431,"DEC 29, 2023",SAC @ ATL,W,35,12,17,0.706,0,0,0.0,1,4,0.25,2,8,10,7,0,0,1,2,25,-4,1,SAC,ATL,SAC,117,8.5,Assists,42,35,32,17
Domantas Sabonis,C,22023,1627734,22300431,"DEC 29, 2023",SAC @ ATL,W,35,12,17,0.706,0,0,0.0,1,4,0.25,2,8,10,7,0,0,1,2,25,-4,1,SAC,ATL,SAC,117,49.5,Fantasy Score,42,35,32,17
Domantas Sabonis,C,22023,1627734,22300431,"DEC 29, 2023",SAC @ ATL,W,35,12,17,0.706,0,0,0.0,1,4,0.25,2,8,10,7,0,0,1,2,25,-4,1,SAC,ATL,SAC,117,10.0,Defensive Rebounds,42,35,32,17
Domantas Sabonis,C,22023,1627734,22300431,"DEC 29, 2023",SAC @ ATL,W,35,12,17,0.706,0,0,0.0,1,4,0.25,2,8,10,7,0,0,1,2,25,-4,1,SAC,ATL,SAC,117,3.5,Free Throws Made,42,35,32,17
Domantas Sabonis,C,22023,1627734,22300431,"DEC 29, 2023",SAC @ ATL,W,35,12,17,0.706,0,0,0.0,1,4,0.25,2,8,10,7,0,0,1,2,25,-4,1,SAC,ATL,SAC,117,13.0,FG Attempted,42,35,32,17
Domantas Sabonis,C,22023,1627734,22300431,"DEC 29, 2023",SAC @ ATL,W,35,12,17,0.706,0,0,0.0,1,4,0.25,2,8,10,7,0,0,1,2,25,-4,1,SAC,ATL,SAC,117,34.5,Pts+Rebs,42,35,32,17
Domantas Sabonis,C,22023,1627734,22300431,"DEC 29, 2023",SAC @ ATL,W,35,12,17,0.706,0,0,0.0,1,4,0.25,2,8,10,7,0,0,1,2,25,-4,1,SAC,ATL,SAC,117,1.0,Dunks,42,35,32,17
Domantas Sabonis,C,22023,1627734,22300431,"DEC 29, 2023",SAC @ ATL,W,35,12,17,0.706,0,0,0.0,1,4,0.25,2,8,10,7,0,0,1,2,25,-4,1,SAC,ATL,SAC,117,28.5,Pts+Asts,42,35,32,17
Domantas Sabonis,C,22023,1627734,22300431,"DEC 29, 2023",SAC @ ATL,W,35,12,17,0.706,0,0,0.0,1,4,0.25,2,8,10,7,0,0,1,2,25,-4,1,SAC,ATL,SAC,117,22.5,Rebs+Asts,42,35,32,17
Domantas Sabonis,C,22023,1627734,22300413,"DEC 26, 2023",SAC @ POR,L,36,14,19,0.737,0,0,0.0,6,7,0.857,3,9,12,5,0,0,2,4,34,-9,1,SAC,POR,SAC,113,19.5,Points,51,46,39,17
Domantas Sabonis,C,22023,1627734,22300413,"DEC 26, 2023",SAC @ POR,L,36,14,19,0.737,0,0,0.0,6,7,0.857,3,9,12,5,0,0,2,4,34,-9,1,SAC,POR,SAC,113,13.5,Rebounds,51,46,39,17
Domantas Sabonis,C,22023,1627734,22300413,"DEC 26, 2023",SAC @ POR,L,36,14,19,0.737,0,0,0.0,6,7,0.857,3,9,12,5,0,0,2,4,34,-9,1,SAC,POR,SAC,113,42.5,Pts+Rebs+Asts,51,46,39,17
Domantas Sabonis,C,22023,1627734,22300413,"DEC 26, 2023",SAC @ POR,L,36,14,19,0.737,0,0,0.0,6,7,0.857,3,9,12,5,0,0,2,4,34,-9,1,SAC,POR,SAC,113,8.5,Assists,51,46,39,17
Domantas Sabonis,C,22023,1627734,22300413,"DEC 26, 2023",SAC @ POR,L,36,14,19,0.737,0,0,0.0,6,7,0.857,3,9,12,5,0,0,2,4,34,-9,1,SAC,POR,SAC,113,49.5,Fantasy Score,51,46,39,17
Domantas Sabonis,C,22023,1627734,22300413,"DEC 26, 2023",SAC @ POR,L,36,14,19,0.737,0,0,0.0,6,7,0.857,3,9,12,5,0,0,2,4,34,-9,1,SAC,POR,SAC,113,10.0,Defensive Rebounds,51,46,39,17
Domantas Sabonis,C,22023,1627734,22300413,"DEC 26, 2023",SAC @ POR,L,36,14,19,0.737,0,0,0.0,6,7,0.857,3,9,12,5,0,0,2,4,34,-9,1,SAC,POR,SAC,113,3.5,Free Throws Made,51,46,39,17
Domantas Sabonis,C,22023,1627734,22300413,"DEC 26, 2023",SAC @ POR,L,36,14,19,0.737,0,0,0.0,6,7,0.857,3,9,12,5,0,0,2,4,34,-9,1,SAC,POR,SAC,113,13.0,FG Attempted,51,46,39,17
Domantas Sabonis,C,22023,1627734,22300413,"DEC 26, 2023",SAC @ POR,L,36,14,19,0.737,0,0,0.0,6,7,0.857,3,9,12,5,0,0,2,4,34,-9,1,SAC,POR,SAC,113,34.5,Pts+Rebs,51,46,39,17
Domantas Sabonis,C,22023,1627734,22300413,"DEC 26, 2023",SAC @ POR,L,36,14,19,0.737,0,0,0.0,6,7,0.857,3,9,12,5,0,0,2,4,34,-9,1,SAC,POR,SAC,113,1.0,Dunks,51,46,39,17
Domantas Sabonis,C,22023,1627734,22300413,"DEC 26, 2023",SAC @ POR,L,36,14,19,0.737,0,0,0.0,6,7,0.857,3,9,12,5,0,0,2,4,34,-9,1,SAC,POR,SAC,113,28.5,Pts+Asts,51,46,39,17
Domantas Sabonis,C,22023,1627734,22300413,"DEC 26, 2023",SAC @ POR,L,36,14,19,0.737,0,0,0.0,6,7,0.857,3,9,12,5,0,0,2,4,34,-9,1,SAC,POR,SAC,113,22.5,Rebs+Asts,51,46,39,17
Domantas Sabonis,C,22023,1627734,22300400,"DEC 23, 2023",SAC vs. MIN,L,39,7,12,0.583,0,1,0.0,3,5,0.6,1,9,10,10,1,0,3,3,17,-17,1,SAC,SAC,MIN,98,19.5,Points,37,27,27,20
Domantas Sabonis,C,22023,1627734,22300400,"DEC 23, 2023",SAC vs. MIN,L,39,7,12,0.583,0,1,0.0,3,5,0.6,1,9,10,10,1,0,3,3,17,-17,1,SAC,SAC,MIN,98,13.5,Rebounds,37,27,27,20
Domantas Sabonis,C,22023,1627734,22300400,"DEC 23, 2023",SAC vs. MIN,L,39,7,12,0.583,0,1,0.0,3,5,0.6,1,9,10,10,1,0,3,3,17,-17,1,SAC,SAC,MIN,98,42.5,Pts+Rebs+Asts,37,27,27,20
Domantas Sabonis,C,22023,1627734,22300400,"DEC 23, 2023",SAC vs. MIN,L,39,7,12,0.583,0,1,0.0,3,5,0.6,1,9,10,10,1,0,3,3,17,-17,1,SAC,SAC,MIN,98,8.5,Assists,37,27,27,20
Domantas Sabonis,C,22023,1627734,22300400,"DEC 23, 2023",SAC vs. MIN,L,39,7,12,0.583,0,1,0.0,3,5,0.6,1,9,10,10,1,0,3,3,17,-17,1,SAC,SAC,MIN,98,49.5,Fantasy Score,37,27,27,20
Domantas Sabonis,C,22023,1627734,22300400,"DEC 23, 2023",SAC vs. MIN,L,39,7,12,0.583,0,1,0.0,3,5,0.6,1,9,10,10,1,0,3,3,17,-17,1,SAC,SAC,MIN,98,10.0,Defensive Rebounds,37,27,27,20
Domantas Sabonis,C,22023,1627734,22300400,"DEC 23, 2023",SAC vs. MIN,L,39,7,12,0.583,0,1,0.0,3,5,0.6,1,9,10,10,1,0,3,3,17,-17,1,SAC,SAC,MIN,98,3.5,Free Throws Made,37,27,27,20
Domantas Sabonis,C,22023,1627734,22300400,"DEC 23, 2023",SAC vs. MIN,L,39,7,12,0.583,0,1,0.0,3,5,0.6,1,9,10,10,1,0,3,3,17,-17,1,SAC,SAC,MIN,98,13.0,FG Attempted,37,27,27,20
Domantas Sabonis,C,22023,1627734,22300400,"DEC 23, 2023",SAC vs. MIN,L,39,7,12,0.583,0,1,0.0,3,5,0.6,1,9,10,10,1,0,3,3,17,-17,1,SAC,SAC,MIN,98,34.5,Pts+Rebs,37,27,27,20
Domantas Sabonis,C,22023,1627734,22300400,"DEC 23, 2023",SAC vs. MIN,L,39,7,12,0.583,0,1,0.0,3,5,0.6,1,9,10,10,1,0,3,3,17,-17,1,SAC,SAC,MIN,98,1.0,Dunks,37,27,27,20
Domantas Sabonis,C,22023,1627734,22300400,"DEC 23, 2023",SAC vs. MIN,L,39,7,12,0.583,0,1,0.0,3,5,0.6,1,9,10,10,1,0,3,3,17,-17,1,SAC,SAC,MIN,98,28.5,Pts+Asts,37,27,27,20
Domantas Sabonis,C,22023,1627734,22300400,"DEC 23, 2023",SAC vs. MIN,L,39,7,12,0.583,0,1,0.0,3,5,0.6,1,9,10,10,1,0,3,3,17,-17,1,SAC,SAC,MIN,98,22.5,Rebs+Asts,37,27,27,20
Domantas Sabonis,C,22023,1627734,22300387,"DEC 22, 2023",SAC vs. PHX,W,35,12,15,0.8,0,2,0.0,4,5,0.8,1,10,11,12,0,0,3,3,28,27,1,SAC,SAC,PHX,120,19.5,Points,51,39,40,23
Domantas Sabonis,C,22023,1627734,22300387,"DEC 22, 2023",SAC vs. PHX,W,35,12,15,0.8,0,2,0.0,4,5,0.8,1,10,11,12,0,0,3,3,28,27,1,SAC,SAC,PHX,120,13.5,Rebounds,51,39,40,23
Domantas Sabonis,C,22023,1627734,22300387,"DEC 22, 2023",SAC vs. PHX,W,35,12,15,0.8,0,2,0.0,4,5,0.8,1,10,11,12,0,0,3,3,28,27,1,SAC,SAC,PHX,120,42.5,Pts+Rebs+Asts,51,39,40,23
Domantas Sabonis,C,22023,1627734,22300387,"DEC 22, 2023",SAC vs. PHX,W,35,12,15,0.8,0,2,0.0,4,5,0.8,1,10,11,12,0,0,3,3,28,27,1,SAC,SAC,PHX,120,8.5,Assists,51,39,40,23
Domantas Sabonis,C,22023,1627734,22300387,"DEC 22, 2023",SAC vs. PHX,W,35,12,15,0.8,0,2,0.0,4,5,0.8,1,10,11,12,0,0,3,3,28,27,1,SAC,SAC,PHX,120,49.5,Fantasy Score,51,39,40,23
Domantas Sabonis,C,22023,1627734,22300387,"DEC 22, 2023",SAC vs. PHX,W,35,12,15,0.8,0,2,0.0,4,5,0.8,1,10,11,12,0,0,3,3,28,27,1,SAC,SAC,PHX,120,10.0,Defensive Rebounds,51,39,40,23
Domantas Sabonis,C,22023,1627734,22300387,"DEC 22, 2023",SAC vs. PHX,W,35,12,15,0.8,0,2,0.0,4,5,0.8,1,10,11,12,0,0,3,3,28,27,1,SAC,SAC,PHX,120,3.5,Free Throws Made,51,39,40,23
Domantas Sabonis,C,22023,1627734,22300387,"DEC 22, 2023",SAC vs. PHX,W,35,12,15,0.8,0,2,0.0,4,5,0.8,1,10,11,12,0,0,3,3,28,27,1,SAC,SAC,PHX,120,13.0,FG Attempted,51,39,40,23
Domantas Sabonis,C,22023,1627734,22300387,"DEC 22, 2023",SAC vs. PHX,W,35,12,15,0.8,0,2,0.0,4,5,0.8,1,10,11,12,0,0,3,3,28,27,1,SAC,SAC,PHX,120,34.5,Pts+Rebs,51,39,40,23
Domantas Sabonis,C,22023,1627734,22300387,"DEC 22, 2023",SAC vs. PHX,W,35,12,15,0.8,0,2,0.0,4,5,0.8,1,10,11,12,0,0,3,3,28,27,1,SAC,SAC,PHX,120,1.0,Dunks,51,39,40,23
Domantas Sabonis,C,22023,1627734,22300387,"DEC 22, 2023",SAC vs. PHX,W,35,12,15,0.8,0,2,0.0,4,5,0.8,1,10,11,12,0,0,3,3,28,27,1,SAC,SAC,PHX,120,28.5,Pts+Asts,51,39,40,23
Domantas Sabonis,C,22023,1627734,22300387,"DEC 22, 2023",SAC vs. PHX,W,35,12,15,0.8,0,2,0.0,4,5,0.8,1,10,11,12,0,0,3,3,28,27,1,SAC,SAC,PHX,120,22.5,Rebs+Asts,51,39,40,23
Domantas Sabonis,C,22023,1627734,22300373,"DEC 20, 2023",SAC vs. BOS,L,26,6,14,0.429,0,1,0.0,1,4,0.25,5,5,10,8,0,1,1,2,13,-25,1,SAC,SAC,BOS,119,19.5,Points,31,23,21,18
Domantas Sabonis,C,22023,1627734,22300373,"DEC 20, 2023",SAC vs. BOS,L,26,6,14,0.429,0,1,0.0,1,4,0.25,5,5,10,8,0,1,1,2,13,-25,1,SAC,SAC,BOS,119,13.5,Rebounds,31,23,21,18
Domantas Sabonis,C,22023,1627734,22300373,"DEC 20, 2023",SAC vs. BOS,L,26,6,14,0.429,0,1,0.0,1,4,0.25,5,5,10,8,0,1,1,2,13,-25,1,SAC,SAC,BOS,119,42.5,Pts+Rebs+Asts,31,23,21,18
Domantas Sabonis,C,22023,1627734,22300373,"DEC 20, 2023",SAC vs. BOS,L,26,6,14,0.429,0,1,0.0,1,4,0.25,5,5,10,8,0,1,1,2,13,-25,1,SAC,SAC,BOS,119,8.5,Assists,31,23,21,18
Domantas Sabonis,C,22023,1627734,22300373,"DEC 20, 2023",SAC vs. BOS,L,26,6,14,0.429,0,1,0.0,1,4,0.25,5,5,10,8,0,1,1,2,13,-25,1,SAC,SAC,BOS,119,49.5,Fantasy Score,31,23,21,18
Domantas Sabonis,C,22023,1627734,22300373,"DEC 20, 2023",SAC vs. BOS,L,26,6,14,0.429,0,1,0.0,1,4,0.25,5,5,10,8,0,1,1,2,13,-25,1,SAC,SAC,BOS,119,10.0,Defensive Rebounds,31,23,21,18
Domantas Sabonis,C,22023,1627734,22300373,"DEC 20, 2023",SAC vs. BOS,L,26,6,14,0.429,0,1,0.0,1,4,0.25,5,5,10,8,0,1,1,2,13,-25,1,SAC,SAC,BOS,119,3.5,Free Throws Made,31,23,21,18
Domantas Sabonis,C,22023,1627734,22300373,"DEC 20, 2023",SAC vs. BOS,L,26,6,14,0.429,0,1,0.0,1,4,0.25,5,5,10,8,0,1,1,2,13,-25,1,SAC,SAC,BOS,119,13.0,FG Attempted,31,23,21,18
Domantas Sabonis,C,22023,1627734,22300373,"DEC 20, 2023",SAC vs. BOS,L,26,6,14,0.429,0,1,0.0,1,4,0.25,5,5,10,8,0,1,1,2,13,-25,1,SAC,SAC,BOS,119,34.5,Pts+Rebs,31,23,21,18
Domantas Sabonis,C,22023,1627734,22300373,"DEC 20, 2023",SAC vs. BOS,L,26,6,14,0.429,0,1,0.0,1,4,0.25,5,5,10,8,0,1,1,2,13,-25,1,SAC,SAC,BOS,119,1.0,Dunks,31,23,21,18
Domantas Sabonis,C,22023,1627734,22300373,"DEC 20, 2023",SAC vs. BOS,L,26,6,14,0.429,0,1,0.0,1,4,0.25,5,5,10,8,0,1,1,2,13,-25,1,SAC,SAC,BOS,119,28.5,Pts+Asts,31,23,21,18
Domantas Sabonis,C,22023,1627734,22300373,"DEC 20, 2023",SAC vs. BOS,L,26,6,14,0.429,0,1,0.0,1,4,0.25,5,5,10,8,0,1,1,2,13,-25,1,SAC,SAC,BOS,119,22.5,Rebs+Asts,31,23,21,18
Domantas Sabonis,C,22023,1627734,22300358,"DEC 18, 2023",SAC vs. WAS,W,32,11,16,0.688,1,1,1.0,5,6,0.833,3,10,13,12,0,1,2,1,28,25,1,SAC,SAC,WAS,141,19.5,Points,53,41,40,25
Domantas Sabonis,C,22023,1627734,22300358,"DEC 18, 2023",SAC vs. WAS,W,32,11,16,0.688,1,1,1.0,5,6,0.833,3,10,13,12,0,1,2,1,28,25,1,SAC,SAC,WAS,141,13.5,Rebounds,53,41,40,25
Domantas Sabonis,C,22023,1627734,22300358,"DEC 18, 2023",SAC vs. WAS,W,32,11,16,0.688,1,1,1.0,5,6,0.833,3,10,13,12,0,1,2,1,28,25,1,SAC,SAC,WAS,141,42.5,Pts+Rebs+Asts,53,41,40,25
Domantas Sabonis,C,22023,1627734,22300358,"DEC 18, 2023",SAC vs. WAS,W,32,11,16,0.688,1,1,1.0,5,6,0.833,3,10,13,12,0,1,2,1,28,25,1,SAC,SAC,WAS,141,8.5,Assists,53,41,40,25
Domantas Sabonis,C,22023,1627734,22300358,"DEC 18, 2023",SAC vs. WAS,W,32,11,16,0.688,1,1,1.0,5,6,0.833,3,10,13,12,0,1,2,1,28,25,1,SAC,SAC,WAS,141,49.5,Fantasy Score,53,41,40,25
Domantas Sabonis,C,22023,1627734,22300358,"DEC 18, 2023",SAC vs. WAS,W,32,11,16,0.688,1,1,1.0,5,6,0.833,3,10,13,12,0,1,2,1,28,25,1,SAC,SAC,WAS,141,10.0,Defensive Rebounds,53,41,40,25
Domantas Sabonis,C,22023,1627734,22300358,"DEC 18, 2023",SAC vs. WAS,W,32,11,16,0.688,1,1,1.0,5,6,0.833,3,10,13,12,0,1,2,1,28,25,1,SAC,SAC,WAS,141,3.5,Free Throws Made,53,41,40,25
Domantas Sabonis,C,22023,1627734,22300358,"DEC 18, 2023",SAC vs. WAS,W,32,11,16,0.688,1,1,1.0,5,6,0.833,3,10,13,12,0,1,2,1,28,25,1,SAC,SAC,WAS,141,13.0,FG Attempted,53,41,40,25
Domantas Sabonis,C,22023,1627734,22300358,"DEC 18, 2023",SAC vs. WAS,W,32,11,16,0.688,1,1,1.0,5,6,0.833,3,10,13,12,0,1,2,1,28,25,1,SAC,SAC,WAS,141,34.5,Pts+Rebs,53,41,40,25
Domantas Sabonis,C,22023,1627734,22300358,"DEC 18, 2023",SAC vs. WAS,W,32,11,16,0.688,1,1,1.0,5,6,0.833,3,10,13,12,0,1,2,1,28,25,1,SAC,SAC,WAS,141,1.0,Dunks,53,41,40,25
Domantas Sabonis,C,22023,1627734,22300358,"DEC 18, 2023",SAC vs. WAS,W,32,11,16,0.688,1,1,1.0,5,6,0.833,3,10,13,12,0,1,2,1,28,25,1,SAC,SAC,WAS,141,28.5,Pts+Asts,53,41,40,25
Domantas Sabonis,C,22023,1627734,22300358,"DEC 18, 2023",SAC vs. WAS,W,32,11,16,0.688,1,1,1.0,5,6,0.833,3,10,13,12,0,1,2,1,28,25,1,SAC,SAC,WAS,141,22.5,Rebs+Asts,53,41,40,25
Domantas Sabonis,C,22023,1627734,22300342,"DEC 16, 2023",SAC vs. UTA,W,35,9,10,0.9,0,1,0.0,2,4,0.5,2,8,10,8,2,0,6,1,20,34,1,SAC,SAC,UTA,125,19.5,Points,38,30,28,18
Domantas Sabonis,C,22023,1627734,22300342,"DEC 16, 2023",SAC vs. UTA,W,35,9,10,0.9,0,1,0.0,2,4,0.5,2,8,10,8,2,0,6,1,20,34,1,SAC,SAC,UTA,125,13.5,Rebounds,38,30,28,18
Domantas Sabonis,C,22023,1627734,22300342,"DEC 16, 2023",SAC vs. UTA,W,35,9,10,0.9,0,1,0.0,2,4,0.5,2,8,10,8,2,0,6,1,20,34,1,SAC,SAC,UTA,125,42.5,Pts+Rebs+Asts,38,30,28,18
Domantas Sabonis,C,22023,1627734,22300342,"DEC 16, 2023",SAC vs. UTA,W,35,9,10,0.9,0,1,0.0,2,4,0.5,2,8,10,8,2,0,6,1,20,34,1,SAC,SAC,UTA,125,8.5,Assists,38,30,28,18
Domantas Sabonis,C,22023,1627734,22300342,"DEC 16, 2023",SAC vs. UTA,W,35,9,10,0.9,0,1,0.0,2,4,0.5,2,8,10,8,2,0,6,1,20,34,1,SAC,SAC,UTA,125,49.5,Fantasy Score,38,30,28,18
Domantas Sabonis,C,22023,1627734,22300342,"DEC 16, 2023",SAC vs. UTA,W,35,9,10,0.9,0,1,0.0,2,4,0.5,2,8,10,8,2,0,6,1,20,34,1,SAC,SAC,UTA,125,10.0,Defensive Rebounds,38,30,28,18
Domantas Sabonis,C,22023,1627734,22300342,"DEC 16, 2023",SAC vs. UTA,W,35,9,10,0.9,0,1,0.0,2,4,0.5,2,8,10,8,2,0,6,1,20,34,1,SAC,SAC,UTA,125,3.5,Free Throws Made,38,30,28,18
Domantas Sabonis,C,22023,1627734,22300342,"DEC 16, 2023",SAC vs. UTA,W,35,9,10,0.9,0,1,0.0,2,4,0.5,2,8,10,8,2,0,6,1,20,34,1,SAC,SAC,UTA,125,13.0,FG Attempted,38,30,28,18
Domantas Sabonis,C,22023,1627734,22300342,"DEC 16, 2023",SAC vs. UTA,W,35,9,10,0.9,0,1,0.0,2,4,0.5,2,8,10,8,2,0,6,1,20,34,1,SAC,SAC,UTA,125,34.5,Pts+Rebs,38,30,28,18
Domantas Sabonis,C,22023,1627734,22300342,"DEC 16, 2023",SAC vs. UTA,W,35,9,10,0.9,0,1,0.0,2,4,0.5,2,8,10,8,2,0,6,1,20,34,1,SAC,SAC,UTA,125,1.0,Dunks,38,30,28,18
Domantas Sabonis,C,22023,1627734,22300342,"DEC 16, 2023",SAC vs. UTA,W,35,9,10,0.9,0,1,0.0,2,4,0.5,2,8,10,8,2,0,6,1,20,34,1,SAC,SAC,UTA,125,28.5,Pts+Asts,38,30,28,18
Domantas Sabonis,C,22023,1627734,22300342,"DEC 16, 2023",SAC vs. UTA,W,35,9,10,0.9,0,1,0.0,2,4,0.5,2,8,10,8,2,0,6,1,20,34,1,SAC,SAC,UTA,125,22.5,Rebs+Asts,38,30,28,18
Domantas Sabonis,C,22023,1627734,22300324,"DEC 14, 2023",SAC vs. OKC,W,40,8,14,0.571,1,2,0.5,1,2,0.5,2,14,16,7,0,0,2,2,18,-1,1,SAC,SAC,OKC,128,19.5,Points,41,34,25,23
Domantas Sabonis,C,22023,1627734,22300324,"DEC 14, 2023",SAC vs. OKC,W,40,8,14,0.571,1,2,0.5,1,2,0.5,2,14,16,7,0,0,2,2,18,-1,1,SAC,SAC,OKC,128,13.5,Rebounds,41,34,25,23
Domantas Sabonis,C,22023,1627734,22300324,"DEC 14, 2023",SAC vs. OKC,W,40,8,14,0.571,1,2,0.5,1,2,0.5,2,14,16,7,0,0,2,2,18,-1,1,SAC,SAC,OKC,128,42.5,Pts+Rebs+Asts,41,34,25,23
Domantas Sabonis,C,22023,1627734,22300324,"DEC 14, 2023",SAC vs. OKC,W,40,8,14,0.571,1,2,0.5,1,2,0.5,2,14,16,7,0,0,2,2,18,-1,1,SAC,SAC,OKC,128,8.5,Assists,41,34,25,23
Domantas Sabonis,C,22023,1627734,22300324,"DEC 14, 2023",SAC vs. OKC,W,40,8,14,0.571,1,2,0.5,1,2,0.5,2,14,16,7,0,0,2,2,18,-1,1,SAC,SAC,OKC,128,49.5,Fantasy Score,41,34,25,23
Domantas Sabonis,C,22023,1627734,22300324,"DEC 14, 2023",SAC vs. OKC,W,40,8,14,0.571,1,2,0.5,1,2,0.5,2,14,16,7,0,0,2,2,18,-1,1,SAC,SAC,OKC,128,10.0,Defensive Rebounds,41,34,25,23
Domantas Sabonis,C,22023,1627734,22300324,"DEC 14, 2023",SAC vs. OKC,W,40,8,14,0.571,1,2,0.5,1,2,0.5,2,14,16,7,0,0,2,2,18,-1,1,SAC,SAC,OKC,128,3.5,Free Throws Made,41,34,25,23
Domantas Sabonis,C,22023,1627734,22300324,"DEC 14, 2023",SAC vs. OKC,W,40,8,14,0.571,1,2,0.5,1,2,0.5,2,14,16,7,0,0,2,2,18,-1,1,SAC,SAC,OKC,128,13.0,FG Attempted,41,34,25,23
Domantas Sabonis,C,22023,1627734,22300324,"DEC 14, 2023",SAC vs. OKC,W,40,8,14,0.571,1,2,0.5,1,2,0.5,2,14,16,7,0,0,2,2,18,-1,1,SAC,SAC,OKC,128,34.5,Pts+Rebs,41,34,25,23
Domantas Sabonis,C,22023,1627734,22300324,"DEC 14, 2023",SAC vs. OKC,W,40,8,14,0.571,1,2,0.5,1,2,0.5,2,14,16,7,0,0,2,2,18,-1,1,SAC,SAC,OKC,128,1.0,Dunks,41,34,25,23
Domantas Sabonis,C,22023,1627734,22300324,"DEC 14, 2023",SAC vs. OKC,W,40,8,14,0.571,1,2,0.5,1,2,0.5,2,14,16,7,0,0,2,2,18,-1,1,SAC,SAC,OKC,128,28.5,Pts+Asts,41,34,25,23
Domantas Sabonis,C,22023,1627734,22300324,"DEC 14, 2023",SAC vs. OKC,W,40,8,14,0.571,1,2,0.5,1,2,0.5,2,14,16,7,0,0,2,2,18,-1,1,SAC,SAC,OKC,128,22.5,Rebs+Asts,41,34,25,23
Domantas Sabonis,C,22023,1627734,22300309,"DEC 12, 2023",SAC @ LAC,L,26,5,11,0.455,0,2,0.0,5,8,0.625,5,5,10,3,2,0,2,3,15,-23,1,SAC,LAC,SAC,99,19.5,Points,28,25,18,13
Domantas Sabonis,C,22023,1627734,22300309,"DEC 12, 2023",SAC @ LAC,L,26,5,11,0.455,0,2,0.0,5,8,0.625,5,5,10,3,2,0,2,3,15,-23,1,SAC,LAC,SAC,99,13.5,Rebounds,28,25,18,13
Domantas Sabonis,C,22023,1627734,22300309,"DEC 12, 2023",SAC @ LAC,L,26,5,11,0.455,0,2,0.0,5,8,0.625,5,5,10,3,2,0,2,3,15,-23,1,SAC,LAC,SAC,99,42.5,Pts+Rebs+Asts,28,25,18,13
Domantas Sabonis,C,22023,1627734,22300309,"DEC 12, 2023",SAC @ LAC,L,26,5,11,0.455,0,2,0.0,5,8,0.625,5,5,10,3,2,0,2,3,15,-23,1,SAC,LAC,SAC,99,8.5,Assists,28,25,18,13
Domantas Sabonis,C,22023,1627734,22300309,"DEC 12, 2023",SAC @ LAC,L,26,5,11,0.455,0,2,0.0,5,8,0.625,5,5,10,3,2,0,2,3,15,-23,1,SAC,LAC,SAC,99,49.5,Fantasy Score,28,25,18,13
Domantas Sabonis,C,22023,1627734,22300309,"DEC 12, 2023",SAC @ LAC,L,26,5,11,0.455,0,2,0.0,5,8,0.625,5,5,10,3,2,0,2,3,15,-23,1,SAC,LAC,SAC,99,10.0,Defensive Rebounds,28,25,18,13
Domantas Sabonis,C,22023,1627734,22300309,"DEC 12, 2023",SAC @ LAC,L,26,5,11,0.455,0,2,0.0,5,8,0.625,5,5,10,3,2,0,2,3,15,-23,1,SAC,LAC,SAC,99,3.5,Free Throws Made,28,25,18,13
Domantas Sabonis,C,22023,1627734,22300309,"DEC 12, 2023",SAC @ LAC,L,26,5,11,0.455,0,2,0.0,5,8,0.625,5,5,10,3,2,0,2,3,15,-23,1,SAC,LAC,SAC,99,13.0,FG Attempted,28,25,18,13
Domantas Sabonis,C,22023,1627734,22300309,"DEC 12, 2023",SAC @ LAC,L,26,5,11,0.455,0,2,0.0,5,8,0.625,5,5,10,3,2,0,2,3,15,-23,1,SAC,LAC,SAC,99,34.5,Pts+Rebs,28,25,18,13
Domantas Sabonis,C,22023,1627734,22300309,"DEC 12, 2023",SAC @ LAC,L,26,5,11,0.455,0,2,0.0,5,8,0.625,5,5,10,3,2,0,2,3,15,-23,1,SAC,LAC,SAC,99,1.0,Dunks,28,25,18,13
Domantas Sabonis,C,22023,1627734,22300309,"DEC 12, 2023",SAC @ LAC,L,26,5,11,0.455,0,2,0.0,5,8,0.625,5,5,10,3,2,0,2,3,15,-23,1,SAC,LAC,SAC,99,28.5,Pts+Asts,28,25,18,13
Domantas Sabonis,C,22023,1627734,22300309,"DEC 12, 2023",SAC @ LAC,L,26,5,11,0.455,0,2,0.0,5,8,0.625,5,5,10,3,2,0,2,3,15,-23,1,SAC,LAC,SAC,99,22.5,Rebs+Asts,28,25,18,13
Domantas Sabonis,C,22023,1627734,22300303,"DEC 11, 2023",SAC vs. BKN,W,34,6,14,0.429,1,1,1.0,2,4,0.5,4,12,16,9,2,0,4,2,15,11,1,SAC,SAC,BKN,131,19.5,Points,40,31,24,25
Domantas Sabonis,C,22023,1627734,22300303,"DEC 11, 2023",SAC vs. BKN,W,34,6,14,0.429,1,1,1.0,2,4,0.5,4,12,16,9,2,0,4,2,15,11,1,SAC,SAC,BKN,131,13.5,Rebounds,40,31,24,25
Domantas Sabonis,C,22023,1627734,22300303,"DEC 11, 2023",SAC vs. BKN,W,34,6,14,0.429,1,1,1.0,2,4,0.5,4,12,16,9,2,0,4,2,15,11,1,SAC,SAC,BKN,131,42.5,Pts+Rebs+Asts,40,31,24,25
Domantas Sabonis,C,22023,1627734,22300303,"DEC 11, 2023",SAC vs. BKN,W,34,6,14,0.429,1,1,1.0,2,4,0.5,4,12,16,9,2,0,4,2,15,11,1,SAC,SAC,BKN,131,8.5,Assists,40,31,24,25
Domantas Sabonis,C,22023,1627734,22300303,"DEC 11, 2023",SAC vs. BKN,W,34,6,14,0.429,1,1,1.0,2,4,0.5,4,12,16,9,2,0,4,2,15,11,1,SAC,SAC,BKN,131,49.5,Fantasy Score,40,31,24,25
Domantas Sabonis,C,22023,1627734,22300303,"DEC 11, 2023",SAC vs. BKN,W,34,6,14,0.429,1,1,1.0,2,4,0.5,4,12,16,9,2,0,4,2,15,11,1,SAC,SAC,BKN,131,10.0,Defensive Rebounds,40,31,24,25
Domantas Sabonis,C,22023,1627734,22300303,"DEC 11, 2023",SAC vs. BKN,W,34,6,14,0.429,1,1,1.0,2,4,0.5,4,12,16,9,2,0,4,2,15,11,1,SAC,SAC,BKN,131,3.5,Free Throws Made,40,31,24,25
Domantas Sabonis,C,22023,1627734,22300303,"DEC 11, 2023",SAC vs. BKN,W,34,6,14,0.429,1,1,1.0,2,4,0.5,4,12,16,9,2,0,4,2,15,11,1,SAC,SAC,BKN,131,13.0,FG Attempted,40,31,24,25
Domantas Sabonis,C,22023,1627734,22300303,"DEC 11, 2023",SAC vs. BKN,W,34,6,14,0.429,1,1,1.0,2,4,0.5,4,12,16,9,2,0,4,2,15,11,1,SAC,SAC,BKN,131,34.5,Pts+Rebs,40,31,24,25
Domantas Sabonis,C,22023,1627734,22300303,"DEC 11, 2023",SAC vs. BKN,W,34,6,14,0.429,1,1,1.0,2,4,0.5,4,12,16,9,2,0,4,2,15,11,1,SAC,SAC,BKN,131,1.0,Dunks,40,31,24,25
Domantas Sabonis,C,22023,1627734,22300303,"DEC 11, 2023",SAC vs. BKN,W,34,6,14,0.429,1,1,1.0,2,4,0.5,4,12,16,9,2,0,4,2,15,11,1,SAC,SAC,BKN,131,28.5,Pts+Asts,40,31,24,25
Domantas Sabonis,C,22023,1627734,22300303,"DEC 11, 2023",SAC vs. BKN,W,34,6,14,0.429,1,1,1.0,2,4,0.5,4,12,16,9,2,0,4,2,15,11,1,SAC,SAC,BKN,131,22.5,Rebs+Asts,40,31,24,25
Domantas Sabonis,C,22023,1627734,22301228,"DEC 08, 2023",SAC @ PHX,W,38,6,11,0.545,0,0,0.0,3,4,0.75,4,13,17,5,0,0,4,4,15,3,1,SAC,PHX,SAC,114,19.5,Points,37,32,20,22
Domantas Sabonis,C,22023,1627734,22301228,"DEC 08, 2023",SAC @ PHX,W,38,6,11,0.545,0,0,0.0,3,4,0.75,4,13,17,5,0,0,4,4,15,3,1,SAC,PHX,SAC,114,13.5,Rebounds,37,32,20,22
Domantas Sabonis,C,22023,1627734,22301228,"DEC 08, 2023",SAC @ PHX,W,38,6,11,0.545,0,0,0.0,3,4,0.75,4,13,17,5,0,0,4,4,15,3,1,SAC,PHX,SAC,114,42.5,Pts+Rebs+Asts,37,32,20,22
Domantas Sabonis,C,22023,1627734,22301228,"DEC 08, 2023",SAC @ PHX,W,38,6,11,0.545,0,0,0.0,3,4,0.75,4,13,17,5,0,0,4,4,15,3,1,SAC,PHX,SAC,114,8.5,Assists,37,32,20,22
Domantas Sabonis,C,22023,1627734,22301228,"DEC 08, 2023",SAC @ PHX,W,38,6,11,0.545,0,0,0.0,3,4,0.75,4,13,17,5,0,0,4,4,15,3,1,SAC,PHX,SAC,114,49.5,Fantasy Score,37,32,20,22
Domantas Sabonis,C,22023,1627734,22301228,"DEC 08, 2023",SAC @ PHX,W,38,6,11,0.545,0,0,0.0,3,4,0.75,4,13,17,5,0,0,4,4,15,3,1,SAC,PHX,SAC,114,10.0,Defensive Rebounds,37,32,20,22
Domantas Sabonis,C,22023,1627734,22301228,"DEC 08, 2023",SAC @ PHX,W,38,6,11,0.545,0,0,0.0,3,4,0.75,4,13,17,5,0,0,4,4,15,3,1,SAC,PHX,SAC,114,3.5,Free Throws Made,37,32,20,22
Domantas Sabonis,C,22023,1627734,22301228,"DEC 08, 2023",SAC @ PHX,W,38,6,11,0.545,0,0,0.0,3,4,0.75,4,13,17,5,0,0,4,4,15,3,1,SAC,PHX,SAC,114,13.0,FG Attempted,37,32,20,22
Domantas Sabonis,C,22023,1627734,22301228,"DEC 08, 2023",SAC @ PHX,W,38,6,11,0.545,0,0,0.0,3,4,0.75,4,13,17,5,0,0,4,4,15,3,1,SAC,PHX,SAC,114,34.5,Pts+Rebs,37,32,20,22
Domantas Sabonis,C,22023,1627734,22301228,"DEC 08, 2023",SAC @ PHX,W,38,6,11,0.545,0,0,0.0,3,4,0.75,4,13,17,5,0,0,4,4,15,3,1,SAC,PHX,SAC,114,1.0,Dunks,37,32,20,22
Domantas Sabonis,C,22023,1627734,22301228,"DEC 08, 2023",SAC @ PHX,W,38,6,11,0.545,0,0,0.0,3,4,0.75,4,13,17,5,0,0,4,4,15,3,1,SAC,PHX,SAC,114,28.5,Pts+Asts,37,32,20,22
Domantas Sabonis,C,22023,1627734,22301228,"DEC 08, 2023",SAC @ PHX,W,38,6,11,0.545,0,0,0.0,3,4,0.75,4,13,17,5,0,0,4,4,15,3,1,SAC,PHX,SAC,114,22.5,Rebs+Asts,37,32,20,22
Domantas Sabonis,C,22023,1627734,22301204,"DEC 04, 2023",SAC vs. NOP,L,36,8,12,0.667,0,1,0.0,10,10,1.0,5,8,13,10,2,1,1,2,26,5,1,SAC,SAC,NOP,117,19.5,Points,49,39,36,23
Domantas Sabonis,C,22023,1627734,22301204,"DEC 04, 2023",SAC vs. NOP,L,36,8,12,0.667,0,1,0.0,10,10,1.0,5,8,13,10,2,1,1,2,26,5,1,SAC,SAC,NOP,117,13.5,Rebounds,49,39,36,23
Domantas Sabonis,C,22023,1627734,22301204,"DEC 04, 2023",SAC vs. NOP,L,36,8,12,0.667,0,1,0.0,10,10,1.0,5,8,13,10,2,1,1,2,26,5,1,SAC,SAC,NOP,117,42.5,Pts+Rebs+Asts,49,39,36,23
Domantas Sabonis,C,22023,1627734,22301204,"DEC 04, 2023",SAC vs. NOP,L,36,8,12,0.667,0,1,0.0,10,10,1.0,5,8,13,10,2,1,1,2,26,5,1,SAC,SAC,NOP,117,8.5,Assists,49,39,36,23
Domantas Sabonis,C,22023,1627734,22301204,"DEC 04, 2023",SAC vs. NOP,L,36,8,12,0.667,0,1,0.0,10,10,1.0,5,8,13,10,2,1,1,2,26,5,1,SAC,SAC,NOP,117,49.5,Fantasy Score,49,39,36,23
Domantas Sabonis,C,22023,1627734,22301204,"DEC 04, 2023",SAC vs. NOP,L,36,8,12,0.667,0,1,0.0,10,10,1.0,5,8,13,10,2,1,1,2,26,5,1,SAC,SAC,NOP,117,10.0,Defensive Rebounds,49,39,36,23
Domantas Sabonis,C,22023,1627734,22301204,"DEC 04, 2023",SAC vs. NOP,L,36,8,12,0.667,0,1,0.0,10,10,1.0,5,8,13,10,2,1,1,2,26,5,1,SAC,SAC,NOP,117,3.5,Free Throws Made,49,39,36,23
Domantas Sabonis,C,22023,1627734,22301204,"DEC 04, 2023",SAC vs. NOP,L,36,8,12,0.667,0,1,0.0,10,10,1.0,5,8,13,10,2,1,1,2,26,5,1,SAC,SAC,NOP,117,13.0,FG Attempted,49,39,36,23
Domantas Sabonis,C,22023,1627734,22301204,"DEC 04, 2023",SAC vs. NOP,L,36,8,12,0.667,0,1,0.0,10,10,1.0,5,8,13,10,2,1,1,2,26,5,1,SAC,SAC,NOP,117,34.5,Pts+Rebs,49,39,36,23
Domantas Sabonis,C,22023,1627734,22301204,"DEC 04, 2023",SAC vs. NOP,L,36,8,12,0.667,0,1,0.0,10,10,1.0,5,8,13,10,2,1,1,2,26,5,1,SAC,SAC,NOP,117,1.0,Dunks,49,39,36,23
Domantas Sabonis,C,22023,1627734,22301204,"DEC 04, 2023",SAC vs. NOP,L,36,8,12,0.667,0,1,0.0,10,10,1.0,5,8,13,10,2,1,1,2,26,5,1,SAC,SAC,NOP,117,28.5,Pts+Asts,49,39,36,23
Domantas Sabonis,C,22023,1627734,22301204,"DEC 04, 2023",SAC vs. NOP,L,36,8,12,0.667,0,1,0.0,10,10,1.0,5,8,13,10,2,1,1,2,26,5,1,SAC,SAC,NOP,117,22.5,Rebs+Asts,49,39,36,23
Domantas Sabonis,C,22023,1627734,22300290,"DEC 02, 2023",SAC vs. DEN,W,36,7,18,0.389,1,3,0.333,2,3,0.667,2,13,15,7,1,0,2,5,17,-8,1,SAC,SAC,DEN,123,19.5,Points,39,32,24,22
Domantas Sabonis,C,22023,1627734,22300290,"DEC 02, 2023",SAC vs. DEN,W,36,7,18,0.389,1,3,0.333,2,3,0.667,2,13,15,7,1,0,2,5,17,-8,1,SAC,SAC,DEN,123,13.5,Rebounds,39,32,24,22
Domantas Sabonis,C,22023,1627734,22300290,"DEC 02, 2023",SAC vs. DEN,W,36,7,18,0.389,1,3,0.333,2,3,0.667,2,13,15,7,1,0,2,5,17,-8,1,SAC,SAC,DEN,123,42.5,Pts+Rebs+Asts,39,32,24,22
Domantas Sabonis,C,22023,1627734,22300290,"DEC 02, 2023",SAC vs. DEN,W,36,7,18,0.389,1,3,0.333,2,3,0.667,2,13,15,7,1,0,2,5,17,-8,1,SAC,SAC,DEN,123,8.5,Assists,39,32,24,22
Domantas Sabonis,C,22023,1627734,22300290,"DEC 02, 2023",SAC vs. DEN,W,36,7,18,0.389,1,3,0.333,2,3,0.667,2,13,15,7,1,0,2,5,17,-8,1,SAC,SAC,DEN,123,49.5,Fantasy Score,39,32,24,22
Domantas Sabonis,C,22023,1627734,22300290,"DEC 02, 2023",SAC vs. DEN,W,36,7,18,0.389,1,3,0.333,2,3,0.667,2,13,15,7,1,0,2,5,17,-8,1,SAC,SAC,DEN,123,10.0,Defensive Rebounds,39,32,24,22
Domantas Sabonis,C,22023,1627734,22300290,"DEC 02, 2023",SAC vs. DEN,W,36,7,18,0.389,1,3,0.333,2,3,0.667,2,13,15,7,1,0,2,5,17,-8,1,SAC,SAC,DEN,123,3.5,Free Throws Made,39,32,24,22
Domantas Sabonis,C,22023,1627734,22300290,"DEC 02, 2023",SAC vs. DEN,W,36,7,18,0.389,1,3,0.333,2,3,0.667,2,13,15,7,1,0,2,5,17,-8,1,SAC,SAC,DEN,123,13.0,FG Attempted,39,32,24,22
Domantas Sabonis,C,22023,1627734,22300290,"DEC 02, 2023",SAC vs. DEN,W,36,7,18,0.389,1,3,0.333,2,3,0.667,2,13,15,7,1,0,2,5,17,-8,1,SAC,SAC,DEN,123,34.5,Pts+Rebs,39,32,24,22
Domantas Sabonis,C,22023,1627734,22300290,"DEC 02, 2023",SAC vs. DEN,W,36,7,18,0.389,1,3,0.333,2,3,0.667,2,13,15,7,1,0,2,5,17,-8,1,SAC,SAC,DEN,123,1.0,Dunks,39,32,24,22
Domantas Sabonis,C,22023,1627734,22300290,"DEC 02, 2023",SAC vs. DEN,W,36,7,18,0.389,1,3,0.333,2,3,0.667,2,13,15,7,1,0,2,5,17,-8,1,SAC,SAC,DEN,123,28.5,Pts+Asts,39,32,24,22
Domantas Sabonis,C,22023,1627734,22300290,"DEC 02, 2023",SAC vs. DEN,W,36,7,18,0.389,1,3,0.333,2,3,0.667,2,13,15,7,1,0,2,5,17,-8,1,SAC,SAC,DEN,123,22.5,Rebs+Asts,39,32,24,22
Domantas Sabonis,C,22023,1627734,22300264,"NOV 29, 2023",SAC vs. LAC,L,31,3,12,0.25,2,3,0.667,3,4,0.75,1,4,5,3,0,0,1,3,11,-19,1,SAC,SAC,LAC,117,19.5,Points,19,16,14,8
Domantas Sabonis,C,22023,1627734,22300264,"NOV 29, 2023",SAC vs. LAC,L,31,3,12,0.25,2,3,0.667,3,4,0.75,1,4,5,3,0,0,1,3,11,-19,1,SAC,SAC,LAC,117,13.5,Rebounds,19,16,14,8
Domantas Sabonis,C,22023,1627734,22300264,"NOV 29, 2023",SAC vs. LAC,L,31,3,12,0.25,2,3,0.667,3,4,0.75,1,4,5,3,0,0,1,3,11,-19,1,SAC,SAC,LAC,117,42.5,Pts+Rebs+Asts,19,16,14,8
Domantas Sabonis,C,22023,1627734,22300264,"NOV 29, 2023",SAC vs. LAC,L,31,3,12,0.25,2,3,0.667,3,4,0.75,1,4,5,3,0,0,1,3,11,-19,1,SAC,SAC,LAC,117,8.5,Assists,19,16,14,8
Domantas Sabonis,C,22023,1627734,22300264,"NOV 29, 2023",SAC vs. LAC,L,31,3,12,0.25,2,3,0.667,3,4,0.75,1,4,5,3,0,0,1,3,11,-19,1,SAC,SAC,LAC,117,49.5,Fantasy Score,19,16,14,8
Domantas Sabonis,C,22023,1627734,22300264,"NOV 29, 2023",SAC vs. LAC,L,31,3,12,0.25,2,3,0.667,3,4,0.75,1,4,5,3,0,0,1,3,11,-19,1,SAC,SAC,LAC,117,10.0,Defensive Rebounds,19,16,14,8
Domantas Sabonis,C,22023,1627734,22300264,"NOV 29, 2023",SAC vs. LAC,L,31,3,12,0.25,2,3,0.667,3,4,0.75,1,4,5,3,0,0,1,3,11,-19,1,SAC,SAC,LAC,117,3.5,Free Throws Made,19,16,14,8
Domantas Sabonis,C,22023,1627734,22300264,"NOV 29, 2023",SAC vs. LAC,L,31,3,12,0.25,2,3,0.667,3,4,0.75,1,4,5,3,0,0,1,3,11,-19,1,SAC,SAC,LAC,117,13.0,FG Attempted,19,16,14,8
Domantas Sabonis,C,22023,1627734,22300264,"NOV 29, 2023",SAC vs. LAC,L,31,3,12,0.25,2,3,0.667,3,4,0.75,1,4,5,3,0,0,1,3,11,-19,1,SAC,SAC,LAC,117,34.5,Pts+Rebs,19,16,14,8
Domantas Sabonis,C,22023,1627734,22300264,"NOV 29, 2023",SAC vs. LAC,L,31,3,12,0.25,2,3,0.667,3,4,0.75,1,4,5,3,0,0,1,3,11,-19,1,SAC,SAC,LAC,117,1.0,Dunks,19,16,14,8
Domantas Sabonis,C,22023,1627734,22300264,"NOV 29, 2023",SAC vs. LAC,L,31,3,12,0.25,2,3,0.667,3,4,0.75,1,4,5,3,0,0,1,3,11,-19,1,SAC,SAC,LAC,117,28.5,Pts+Asts,19,16,14,8
Domantas Sabonis,C,22023,1627734,22300264,"NOV 29, 2023",SAC vs. LAC,L,31,3,12,0.25,2,3,0.667,3,4,0.75,1,4,5,3,0,0,1,3,11,-19,1,SAC,SAC,LAC,117,22.5,Rebs+Asts,19,16,14,8
Domantas Sabonis,C,22023,1627734,22300060,"NOV 28, 2023",SAC vs. GSW,W,37,2,7,0.286,0,1,0.0,5,6,0.833,2,6,8,10,1,0,1,3,9,-3,1,SAC,SAC,GSW,124,19.5,Points,27,17,19,18
Domantas Sabonis,C,22023,1627734,22300060,"NOV 28, 2023",SAC vs. GSW,W,37,2,7,0.286,0,1,0.0,5,6,0.833,2,6,8,10,1,0,1,3,9,-3,1,SAC,SAC,GSW,124,13.5,Rebounds,27,17,19,18
Domantas Sabonis,C,22023,1627734,22300060,"NOV 28, 2023",SAC vs. GSW,W,37,2,7,0.286,0,1,0.0,5,6,0.833,2,6,8,10,1,0,1,3,9,-3,1,SAC,SAC,GSW,124,42.5,Pts+Rebs+Asts,27,17,19,18
Domantas Sabonis,C,22023,1627734,22300060,"NOV 28, 2023",SAC vs. GSW,W,37,2,7,0.286,0,1,0.0,5,6,0.833,2,6,8,10,1,0,1,3,9,-3,1,SAC,SAC,GSW,124,8.5,Assists,27,17,19,18
Domantas Sabonis,C,22023,1627734,22300060,"NOV 28, 2023",SAC vs. GSW,W,37,2,7,0.286,0,1,0.0,5,6,0.833,2,6,8,10,1,0,1,3,9,-3,1,SAC,SAC,GSW,124,49.5,Fantasy Score,27,17,19,18
Domantas Sabonis,C,22023,1627734,22300060,"NOV 28, 2023",SAC vs. GSW,W,37,2,7,0.286,0,1,0.0,5,6,0.833,2,6,8,10,1,0,1,3,9,-3,1,SAC,SAC,GSW,124,10.0,Defensive Rebounds,27,17,19,18
Domantas Sabonis,C,22023,1627734,22300060,"NOV 28, 2023",SAC vs. GSW,W,37,2,7,0.286,0,1,0.0,5,6,0.833,2,6,8,10,1,0,1,3,9,-3,1,SAC,SAC,GSW,124,3.5,Free Throws Made,27,17,19,18
Domantas Sabonis,C,22023,1627734,22300060,"NOV 28, 2023",SAC vs. GSW,W,37,2,7,0.286,0,1,0.0,5,6,0.833,2,6,8,10,1,0,1,3,9,-3,1,SAC,SAC,GSW,124,13.0,FG Attempted,27,17,19,18
Domantas Sabonis,C,22023,1627734,22300060,"NOV 28, 2023",SAC vs. GSW,W,37,2,7,0.286,0,1,0.0,5,6,0.833,2,6,8,10,1,0,1,3,9,-3,1,SAC,SAC,GSW,124,34.5,Pts+Rebs,27,17,19,18
Domantas Sabonis,C,22023,1627734,22300060,"NOV 28, 2023",SAC vs. GSW,W,37,2,7,0.286,0,1,0.0,5,6,0.833,2,6,8,10,1,0,1,3,9,-3,1,SAC,SAC,GSW,124,1.0,Dunks,27,17,19,18
Domantas Sabonis,C,22023,1627734,22300060,"NOV 28, 2023",SAC vs. GSW,W,37,2,7,0.286,0,1,0.0,5,6,0.833,2,6,8,10,1,0,1,3,9,-3,1,SAC,SAC,GSW,124,28.5,Pts+Asts,27,17,19,18
Domantas Sabonis,C,22023,1627734,22300060,"NOV 28, 2023",SAC vs. GSW,W,37,2,7,0.286,0,1,0.0,5,6,0.833,2,6,8,10,1,0,1,3,9,-3,1,SAC,SAC,GSW,124,22.5,Rebs+Asts,27,17,19,18
Domantas Sabonis,C,22023,1627734,22300050,"NOV 24, 2023",SAC @ MIN,W,39,7,15,0.467,1,1,1.0,0,1,0.0,5,6,11,5,2,3,2,6,15,-7,1,SAC,MIN,SAC,124,19.5,Points,31,26,20,16
Domantas Sabonis,C,22023,1627734,22300050,"NOV 24, 2023",SAC @ MIN,W,39,7,15,0.467,1,1,1.0,0,1,0.0,5,6,11,5,2,3,2,6,15,-7,1,SAC,MIN,SAC,124,13.5,Rebounds,31,26,20,16
Domantas Sabonis,C,22023,1627734,22300050,"NOV 24, 2023",SAC @ MIN,W,39,7,15,0.467,1,1,1.0,0,1,0.0,5,6,11,5,2,3,2,6,15,-7,1,SAC,MIN,SAC,124,42.5,Pts+Rebs+Asts,31,26,20,16
Domantas Sabonis,C,22023,1627734,22300050,"NOV 24, 2023",SAC @ MIN,W,39,7,15,0.467,1,1,1.0,0,1,0.0,5,6,11,5,2,3,2,6,15,-7,1,SAC,MIN,SAC,124,8.5,Assists,31,26,20,16
Domantas Sabonis,C,22023,1627734,22300050,"NOV 24, 2023",SAC @ MIN,W,39,7,15,0.467,1,1,1.0,0,1,0.0,5,6,11,5,2,3,2,6,15,-7,1,SAC,MIN,SAC,124,49.5,Fantasy Score,31,26,20,16
Domantas Sabonis,C,22023,1627734,22300050,"NOV 24, 2023",SAC @ MIN,W,39,7,15,0.467,1,1,1.0,0,1,0.0,5,6,11,5,2,3,2,6,15,-7,1,SAC,MIN,SAC,124,10.0,Defensive Rebounds,31,26,20,16
Domantas Sabonis,C,22023,1627734,22300050,"NOV 24, 2023",SAC @ MIN,W,39,7,15,0.467,1,1,1.0,0,1,0.0,5,6,11,5,2,3,2,6,15,-7,1,SAC,MIN,SAC,124,3.5,Free Throws Made,31,26,20,16
Domantas Sabonis,C,22023,1627734,22300050,"NOV 24, 2023",SAC @ MIN,W,39,7,15,0.467,1,1,1.0,0,1,0.0,5,6,11,5,2,3,2,6,15,-7,1,SAC,MIN,SAC,124,13.0,FG Attempted,31,26,20,16
Domantas Sabonis,C,22023,1627734,22300050,"NOV 24, 2023",SAC @ MIN,W,39,7,15,0.467,1,1,1.0,0,1,0.0,5,6,11,5,2,3,2,6,15,-7,1,SAC,MIN,SAC,124,34.5,Pts+Rebs,31,26,20,16
Domantas Sabonis,C,22023,1627734,22300050,"NOV 24, 2023",SAC @ MIN,W,39,7,15,0.467,1,1,1.0,0,1,0.0,5,6,11,5,2,3,2,6,15,-7,1,SAC,MIN,SAC,124,1.0,Dunks,31,26,20,16
Domantas Sabonis,C,22023,1627734,22300050,"NOV 24, 2023",SAC @ MIN,W,39,7,15,0.467,1,1,1.0,0,1,0.0,5,6,11,5,2,3,2,6,15,-7,1,SAC,MIN,SAC,124,28.5,Pts+Asts,31,26,20,16
Domantas Sabonis,C,22023,1627734,22300050,"NOV 24, 2023",SAC @ MIN,W,39,7,15,0.467,1,1,1.0,0,1,0.0,5,6,11,5,2,3,2,6,15,-7,1,SAC,MIN,SAC,124,22.5,Rebs+Asts,31,26,20,16
Domantas Sabonis,C,22023,1627734,22300233,"NOV 22, 2023",SAC @ NOP,L,36,8,11,0.727,0,0,0.0,7,10,0.7,2,7,9,6,0,1,3,3,23,12,1,SAC,NOP,SAC,112,19.5,Points,38,32,29,15
Domantas Sabonis,C,22023,1627734,22300233,"NOV 22, 2023",SAC @ NOP,L,36,8,11,0.727,0,0,0.0,7,10,0.7,2,7,9,6,0,1,3,3,23,12,1,SAC,NOP,SAC,112,13.5,Rebounds,38,32,29,15
Domantas Sabonis,C,22023,1627734,22300233,"NOV 22, 2023",SAC @ NOP,L,36,8,11,0.727,0,0,0.0,7,10,0.7,2,7,9,6,0,1,3,3,23,12,1,SAC,NOP,SAC,112,42.5,Pts+Rebs+Asts,38,32,29,15
Domantas Sabonis,C,22023,1627734,22300233,"NOV 22, 2023",SAC @ NOP,L,36,8,11,0.727,0,0,0.0,7,10,0.7,2,7,9,6,0,1,3,3,23,12,1,SAC,NOP,SAC,112,8.5,Assists,38,32,29,15
Domantas Sabonis,C,22023,1627734,22300233,"NOV 22, 2023",SAC @ NOP,L,36,8,11,0.727,0,0,0.0,7,10,0.7,2,7,9,6,0,1,3,3,23,12,1,SAC,NOP,SAC,112,49.5,Fantasy Score,38,32,29,15
Domantas Sabonis,C,22023,1627734,22300233,"NOV 22, 2023",SAC @ NOP,L,36,8,11,0.727,0,0,0.0,7,10,0.7,2,7,9,6,0,1,3,3,23,12,1,SAC,NOP,SAC,112,10.0,Defensive Rebounds,38,32,29,15
Domantas Sabonis,C,22023,1627734,22300233,"NOV 22, 2023",SAC @ NOP,L,36,8,11,0.727,0,0,0.0,7,10,0.7,2,7,9,6,0,1,3,3,23,12,1,SAC,NOP,SAC,112,3.5,Free Throws Made,38,32,29,15
Domantas Sabonis,C,22023,1627734,22300233,"NOV 22, 2023",SAC @ NOP,L,36,8,11,0.727,0,0,0.0,7,10,0.7,2,7,9,6,0,1,3,3,23,12,1,SAC,NOP,SAC,112,13.0,FG Attempted,38,32,29,15
Domantas Sabonis,C,22023,1627734,22300233,"NOV 22, 2023",SAC @ NOP,L,36,8,11,0.727,0,0,0.0,7,10,0.7,2,7,9,6,0,1,3,3,23,12,1,SAC,NOP,SAC,112,34.5,Pts+Rebs,38,32,29,15
Domantas Sabonis,C,22023,1627734,22300233,"NOV 22, 2023",SAC @ NOP,L,36,8,11,0.727,0,0,0.0,7,10,0.7,2,7,9,6,0,1,3,3,23,12,1,SAC,NOP,SAC,112,1.0,Dunks,38,32,29,15
Domantas Sabonis,C,22023,1627734,22300233,"NOV 22, 2023",SAC @ NOP,L,36,8,11,0.727,0,0,0.0,7,10,0.7,2,7,9,6,0,1,3,3,23,12,1,SAC,NOP,SAC,112,28.5,Pts+Asts,38,32,29,15
Domantas Sabonis,C,22023,1627734,22300233,"NOV 22, 2023",SAC @ NOP,L,36,8,11,0.727,0,0,0.0,7,10,0.7,2,7,9,6,0,1,3,3,23,12,1,SAC,NOP,SAC,112,22.5,Rebs+Asts,38,32,29,15
Domantas Sabonis,C,22023,1627734,22300222,"NOV 20, 2023",SAC @ NOP,L,31,4,8,0.5,0,0,0.0,2,3,0.667,5,5,10,8,0,0,5,4,10,-36,1,SAC,NOP,SAC,93,19.5,Points,28,20,18,18
Domantas Sabonis,C,22023,1627734,22300222,"NOV 20, 2023",SAC @ NOP,L,31,4,8,0.5,0,0,0.0,2,3,0.667,5,5,10,8,0,0,5,4,10,-36,1,SAC,NOP,SAC,93,13.5,Rebounds,28,20,18,18
Domantas Sabonis,C,22023,1627734,22300222,"NOV 20, 2023",SAC @ NOP,L,31,4,8,0.5,0,0,0.0,2,3,0.667,5,5,10,8,0,0,5,4,10,-36,1,SAC,NOP,SAC,93,42.5,Pts+Rebs+Asts,28,20,18,18
Domantas Sabonis,C,22023,1627734,22300222,"NOV 20, 2023",SAC @ NOP,L,31,4,8,0.5,0,0,0.0,2,3,0.667,5,5,10,8,0,0,5,4,10,-36,1,SAC,NOP,SAC,93,8.5,Assists,28,20,18,18
Domantas Sabonis,C,22023,1627734,22300222,"NOV 20, 2023",SAC @ NOP,L,31,4,8,0.5,0,0,0.0,2,3,0.667,5,5,10,8,0,0,5,4,10,-36,1,SAC,NOP,SAC,93,49.5,Fantasy Score,28,20,18,18
Domantas Sabonis,C,22023,1627734,22300222,"NOV 20, 2023",SAC @ NOP,L,31,4,8,0.5,0,0,0.0,2,3,0.667,5,5,10,8,0,0,5,4,10,-36,1,SAC,NOP,SAC,93,10.0,Defensive Rebounds,28,20,18,18
Domantas Sabonis,C,22023,1627734,22300222,"NOV 20, 2023",SAC @ NOP,L,31,4,8,0.5,0,0,0.0,2,3,0.667,5,5,10,8,0,0,5,4,10,-36,1,SAC,NOP,SAC,93,3.5,Free Throws Made,28,20,18,18
Domantas Sabonis,C,22023,1627734,22300222,"NOV 20, 2023",SAC @ NOP,L,31,4,8,0.5,0,0,0.0,2,3,0.667,5,5,10,8,0,0,5,4,10,-36,1,SAC,NOP,SAC,93,13.0,FG Attempted,28,20,18,18
Domantas Sabonis,C,22023,1627734,22300222,"NOV 20, 2023",SAC @ NOP,L,31,4,8,0.5,0,0,0.0,2,3,0.667,5,5,10,8,0,0,5,4,10,-36,1,SAC,NOP,SAC,93,34.5,Pts+Rebs,28,20,18,18
Domantas Sabonis,C,22023,1627734,22300222,"NOV 20, 2023",SAC @ NOP,L,31,4,8,0.5,0,0,0.0,2,3,0.667,5,5,10,8,0,0,5,4,10,-36,1,SAC,NOP,SAC,93,1.0,Dunks,28,20,18,18
Domantas Sabonis,C,22023,1627734,22300222,"NOV 20, 2023",SAC @ NOP,L,31,4,8,0.5,0,0,0.0,2,3,0.667,5,5,10,8,0,0,5,4,10,-36,1,SAC,NOP,SAC,93,28.5,Pts+Asts,28,20,18,18
Domantas Sabonis,C,22023,1627734,22300222,"NOV 20, 2023",SAC @ NOP,L,31,4,8,0.5,0,0,0.0,2,3,0.667,5,5,10,8,0,0,5,4,10,-36,1,SAC,NOP,SAC,93,22.5,Rebs+Asts,28,20,18,18
Domantas Sabonis,C,22023,1627734,22300212,"NOV 19, 2023",SAC @ DAL,W,35,13,15,0.867,0,2,0.0,6,10,0.6,3,10,13,6,0,0,1,2,32,16,1,SAC,DAL,SAC,129,19.5,Points,51,45,38,19
Domantas Sabonis,C,22023,1627734,22300212,"NOV 19, 2023",SAC @ DAL,W,35,13,15,0.867,0,2,0.0,6,10,0.6,3,10,13,6,0,0,1,2,32,16,1,SAC,DAL,SAC,129,13.5,Rebounds,51,45,38,19
Domantas Sabonis,C,22023,1627734,22300212,"NOV 19, 2023",SAC @ DAL,W,35,13,15,0.867,0,2,0.0,6,10,0.6,3,10,13,6,0,0,1,2,32,16,1,SAC,DAL,SAC,129,42.5,Pts+Rebs+Asts,51,45,38,19
Domantas Sabonis,C,22023,1627734,22300212,"NOV 19, 2023",SAC @ DAL,W,35,13,15,0.867,0,2,0.0,6,10,0.6,3,10,13,6,0,0,1,2,32,16,1,SAC,DAL,SAC,129,8.5,Assists,51,45,38,19
Domantas Sabonis,C,22023,1627734,22300212,"NOV 19, 2023",SAC @ DAL,W,35,13,15,0.867,0,2,0.0,6,10,0.6,3,10,13,6,0,0,1,2,32,16,1,SAC,DAL,SAC,129,49.5,Fantasy Score,51,45,38,19
Domantas Sabonis,C,22023,1627734,22300212,"NOV 19, 2023",SAC @ DAL,W,35,13,15,0.867,0,2,0.0,6,10,0.6,3,10,13,6,0,0,1,2,32,16,1,SAC,DAL,SAC,129,10.0,Defensive Rebounds,51,45,38,19
Domantas Sabonis,C,22023,1627734,22300212,"NOV 19, 2023",SAC @ DAL,W,35,13,15,0.867,0,2,0.0,6,10,0.6,3,10,13,6,0,0,1,2,32,16,1,SAC,DAL,SAC,129,3.5,Free Throws Made,51,45,38,19
Domantas Sabonis,C,22023,1627734,22300212,"NOV 19, 2023",SAC @ DAL,W,35,13,15,0.867,0,2,0.0,6,10,0.6,3,10,13,6,0,0,1,2,32,16,1,SAC,DAL,SAC,129,13.0,FG Attempted,51,45,38,19
Domantas Sabonis,C,22023,1627734,22300212,"NOV 19, 2023",SAC @ DAL,W,35,13,15,0.867,0,2,0.0,6,10,0.6,3,10,13,6,0,0,1,2,32,16,1,SAC,DAL,SAC,129,34.5,Pts+Rebs,51,45,38,19
Domantas Sabonis,C,22023,1627734,22300212,"NOV 19, 2023",SAC @ DAL,W,35,13,15,0.867,0,2,0.0,6,10,0.6,3,10,13,6,0,0,1,2,32,16,1,SAC,DAL,SAC,129,1.0,Dunks,51,45,38,19
Domantas Sabonis,C,22023,1627734,22300212,"NOV 19, 2023",SAC @ DAL,W,35,13,15,0.867,0,2,0.0,6,10,0.6,3,10,13,6,0,0,1,2,32,16,1,SAC,DAL,SAC,129,28.5,Pts+Asts,51,45,38,19
Domantas Sabonis,C,22023,1627734,22300212,"NOV 19, 2023",SAC @ DAL,W,35,13,15,0.867,0,2,0.0,6,10,0.6,3,10,13,6,0,0,1,2,32,16,1,SAC,DAL,SAC,129,22.5,Rebs+Asts,51,45,38,19
Domantas Sabonis,C,22023,1627734,22300032,"NOV 17, 2023",SAC @ SAS,W,35,9,13,0.692,2,3,0.667,7,8,0.875,2,12,14,7,0,1,4,5,27,6,1,SAC,SAS,SAC,129,19.5,Points,48,41,34,21
Domantas Sabonis,C,22023,1627734,22300032,"NOV 17, 2023",SAC @ SAS,W,35,9,13,0.692,2,3,0.667,7,8,0.875,2,12,14,7,0,1,4,5,27,6,1,SAC,SAS,SAC,129,13.5,Rebounds,48,41,34,21
Domantas Sabonis,C,22023,1627734,22300032,"NOV 17, 2023",SAC @ SAS,W,35,9,13,0.692,2,3,0.667,7,8,0.875,2,12,14,7,0,1,4,5,27,6,1,SAC,SAS,SAC,129,42.5,Pts+Rebs+Asts,48,41,34,21
Domantas Sabonis,C,22023,1627734,22300032,"NOV 17, 2023",SAC @ SAS,W,35,9,13,0.692,2,3,0.667,7,8,0.875,2,12,14,7,0,1,4,5,27,6,1,SAC,SAS,SAC,129,8.5,Assists,48,41,34,21
Domantas Sabonis,C,22023,1627734,22300032,"NOV 17, 2023",SAC @ SAS,W,35,9,13,0.692,2,3,0.667,7,8,0.875,2,12,14,7,0,1,4,5,27,6,1,SAC,SAS,SAC,129,49.5,Fantasy Score,48,41,34,21
Domantas Sabonis,C,22023,1627734,22300032,"NOV 17, 2023",SAC @ SAS,W,35,9,13,0.692,2,3,0.667,7,8,0.875,2,12,14,7,0,1,4,5,27,6,1,SAC,SAS,SAC,129,10.0,Defensive Rebounds,48,41,34,21
Domantas Sabonis,C,22023,1627734,22300032,"NOV 17, 2023",SAC @ SAS,W,35,9,13,0.692,2,3,0.667,7,8,0.875,2,12,14,7,0,1,4,5,27,6,1,SAC,SAS,SAC,129,3.5,Free Throws Made,48,41,34,21
Domantas Sabonis,C,22023,1627734,22300032,"NOV 17, 2023",SAC @ SAS,W,35,9,13,0.692,2,3,0.667,7,8,0.875,2,12,14,7,0,1,4,5,27,6,1,SAC,SAS,SAC,129,13.0,FG Attempted,48,41,34,21
Domantas Sabonis,C,22023,1627734,22300032,"NOV 17, 2023",SAC @ SAS,W,35,9,13,0.692,2,3,0.667,7,8,0.875,2,12,14,7,0,1,4,5,27,6,1,SAC,SAS,SAC,129,34.5,Pts+Rebs,48,41,34,21
Domantas Sabonis,C,22023,1627734,22300032,"NOV 17, 2023",SAC @ SAS,W,35,9,13,0.692,2,3,0.667,7,8,0.875,2,12,14,7,0,1,4,5,27,6,1,SAC,SAS,SAC,129,1.0,Dunks,48,41,34,21
Domantas Sabonis,C,22023,1627734,22300032,"NOV 17, 2023",SAC @ SAS,W,35,9,13,0.692,2,3,0.667,7,8,0.875,2,12,14,7,0,1,4,5,27,6,1,SAC,SAS,SAC,129,28.5,Pts+Asts,48,41,34,21
Domantas Sabonis,C,22023,1627734,22300032,"NOV 17, 2023",SAC @ SAS,W,35,9,13,0.692,2,3,0.667,7,8,0.875,2,12,14,7,0,1,4,5,27,6,1,SAC,SAS,SAC,129,22.5,Rebs+Asts,48,41,34,21
Domantas Sabonis,C,22023,1627734,22300198,"NOV 15, 2023",SAC @ LAL,W,39,13,19,0.684,1,1,1.0,2,2,1.0,5,11,16,7,3,1,4,3,29,20,1,SAC,LAL,SAC,125,19.5,Points,52,45,36,23
Domantas Sabonis,C,22023,1627734,22300198,"NOV 15, 2023",SAC @ LAL,W,39,13,19,0.684,1,1,1.0,2,2,1.0,5,11,16,7,3,1,4,3,29,20,1,SAC,LAL,SAC,125,13.5,Rebounds,52,45,36,23
Domantas Sabonis,C,22023,1627734,22300198,"NOV 15, 2023",SAC @ LAL,W,39,13,19,0.684,1,1,1.0,2,2,1.0,5,11,16,7,3,1,4,3,29,20,1,SAC,LAL,SAC,125,42.5,Pts+Rebs+Asts,52,45,36,23
Domantas Sabonis,C,22023,1627734,22300198,"NOV 15, 2023",SAC @ LAL,W,39,13,19,0.684,1,1,1.0,2,2,1.0,5,11,16,7,3,1,4,3,29,20,1,SAC,LAL,SAC,125,8.5,Assists,52,45,36,23
Domantas Sabonis,C,22023,1627734,22300198,"NOV 15, 2023",SAC @ LAL,W,39,13,19,0.684,1,1,1.0,2,2,1.0,5,11,16,7,3,1,4,3,29,20,1,SAC,LAL,SAC,125,49.5,Fantasy Score,52,45,36,23
Domantas Sabonis,C,22023,1627734,22300198,"NOV 15, 2023",SAC @ LAL,W,39,13,19,0.684,1,1,1.0,2,2,1.0,5,11,16,7,3,1,4,3,29,20,1,SAC,LAL,SAC,125,10.0,Defensive Rebounds,52,45,36,23
Domantas Sabonis,C,22023,1627734,22300198,"NOV 15, 2023",SAC @ LAL,W,39,13,19,0.684,1,1,1.0,2,2,1.0,5,11,16,7,3,1,4,3,29,20,1,SAC,LAL,SAC,125,3.5,Free Throws Made,52,45,36,23
Domantas Sabonis,C,22023,1627734,22300198,"NOV 15, 2023",SAC @ LAL,W,39,13,19,0.684,1,1,1.0,2,2,1.0,5,11,16,7,3,1,4,3,29,20,1,SAC,LAL,SAC,125,13.0,FG Attempted,52,45,36,23
Domantas Sabonis,C,22023,1627734,22300198,"NOV 15, 2023",SAC @ LAL,W,39,13,19,0.684,1,1,1.0,2,2,1.0,5,11,16,7,3,1,4,3,29,20,1,SAC,LAL,SAC,125,34.5,Pts+Rebs,52,45,36,23
Domantas Sabonis,C,22023,1627734,22300198,"NOV 15, 2023",SAC @ LAL,W,39,13,19,0.684,1,1,1.0,2,2,1.0,5,11,16,7,3,1,4,3,29,20,1,SAC,LAL,SAC,125,1.0,Dunks,52,45,36,23
Domantas Sabonis,C,22023,1627734,22300198,"NOV 15, 2023",SAC @ LAL,W,39,13,19,0.684,1,1,1.0,2,2,1.0,5,11,16,7,3,1,4,3,29,20,1,SAC,LAL,SAC,125,28.5,Pts+Asts,52,45,36,23
Domantas Sabonis,C,22023,1627734,22300198,"NOV 15, 2023",SAC @ LAL,W,39,13,19,0.684,1,1,1.0,2,2,1.0,5,11,16,7,3,1,4,3,29,20,1,SAC,LAL,SAC,125,22.5,Rebs+Asts,52,45,36,23
Domantas Sabonis,C,22023,1627734,22300191,"NOV 13, 2023",SAC vs. CLE,W,35,8,10,0.8,1,2,0.5,6,11,0.545,0,9,9,10,0,2,3,4,23,6,1,SAC,SAC,CLE,132,19.5,Points,42,32,33,19
Domantas Sabonis,C,22023,1627734,22300191,"NOV 13, 2023",SAC vs. CLE,W,35,8,10,0.8,1,2,0.5,6,11,0.545,0,9,9,10,0,2,3,4,23,6,1,SAC,SAC,CLE,132,13.5,Rebounds,42,32,33,19
Domantas Sabonis,C,22023,1627734,22300191,"NOV 13, 2023",SAC vs. CLE,W,35,8,10,0.8,1,2,0.5,6,11,0.545,0,9,9,10,0,2,3,4,23,6,1,SAC,SAC,CLE,132,42.5,Pts+Rebs+Asts,42,32,33,19
Domantas Sabonis,C,22023,1627734,22300191,"NOV 13, 2023",SAC vs. CLE,W,35,8,10,0.8,1,2,0.5,6,11,0.545,0,9,9,10,0,2,3,4,23,6,1,SAC,SAC,CLE,132,8.5,Assists,42,32,33,19
Domantas Sabonis,C,22023,1627734,22300191,"NOV 13, 2023",SAC vs. CLE,W,35,8,10,0.8,1,2,0.5,6,11,0.545,0,9,9,10,0,2,3,4,23,6,1,SAC,SAC,CLE,132,49.5,Fantasy Score,42,32,33,19
Domantas Sabonis,C,22023,1627734,22300191,"NOV 13, 2023",SAC vs. CLE,W,35,8,10,0.8,1,2,0.5,6,11,0.545,0,9,9,10,0,2,3,4,23,6,1,SAC,SAC,CLE,132,10.0,Defensive Rebounds,42,32,33,19
Domantas Sabonis,C,22023,1627734,22300191,"NOV 13, 2023",SAC vs. CLE,W,35,8,10,0.8,1,2,0.5,6,11,0.545,0,9,9,10,0,2,3,4,23,6,1,SAC,SAC,CLE,132,3.5,Free Throws Made,42,32,33,19
Domantas Sabonis,C,22023,1627734,22300191,"NOV 13, 2023",SAC vs. CLE,W,35,8,10,0.8,1,2,0.5,6,11,0.545,0,9,9,10,0,2,3,4,23,6,1,SAC,SAC,CLE,132,13.0,FG Attempted,42,32,33,19
Domantas Sabonis,C,22023,1627734,22300191,"NOV 13, 2023",SAC vs. CLE,W,35,8,10,0.8,1,2,0.5,6,11,0.545,0,9,9,10,0,2,3,4,23,6,1,SAC,SAC,CLE,132,34.5,Pts+Rebs,42,32,33,19
Domantas Sabonis,C,22023,1627734,22300191,"NOV 13, 2023",SAC vs. CLE,W,35,8,10,0.8,1,2,0.5,6,11,0.545,0,9,9,10,0,2,3,4,23,6,1,SAC,SAC,CLE,132,1.0,Dunks,42,32,33,19
Domantas Sabonis,C,22023,1627734,22300191,"NOV 13, 2023",SAC vs. CLE,W,35,8,10,0.8,1,2,0.5,6,11,0.545,0,9,9,10,0,2,3,4,23,6,1,SAC,SAC,CLE,132,28.5,Pts+Asts,42,32,33,19
Domantas Sabonis,C,22023,1627734,22300191,"NOV 13, 2023",SAC vs. CLE,W,35,8,10,0.8,1,2,0.5,6,11,0.545,0,9,9,10,0,2,3,4,23,6,1,SAC,SAC,CLE,132,22.5,Rebs+Asts,42,32,33,19
Domantas Sabonis,C,22023,1627734,22300016,"NOV 10, 2023",SAC vs. OKC,W,38,7,15,0.467,0,0,0.0,3,6,0.5,6,7,13,13,1,2,5,5,17,11,1,SAC,SAC,OKC,105,19.5,Points,43,30,30,26
Domantas Sabonis,C,22023,1627734,22300016,"NOV 10, 2023",SAC vs. OKC,W,38,7,15,0.467,0,0,0.0,3,6,0.5,6,7,13,13,1,2,5,5,17,11,1,SAC,SAC,OKC,105,13.5,Rebounds,43,30,30,26
Domantas Sabonis,C,22023,1627734,22300016,"NOV 10, 2023",SAC vs. OKC,W,38,7,15,0.467,0,0,0.0,3,6,0.5,6,7,13,13,1,2,5,5,17,11,1,SAC,SAC,OKC,105,42.5,Pts+Rebs+Asts,43,30,30,26
Domantas Sabonis,C,22023,1627734,22300016,"NOV 10, 2023",SAC vs. OKC,W,38,7,15,0.467,0,0,0.0,3,6,0.5,6,7,13,13,1,2,5,5,17,11,1,SAC,SAC,OKC,105,8.5,Assists,43,30,30,26
Domantas Sabonis,C,22023,1627734,22300016,"NOV 10, 2023",SAC vs. OKC,W,38,7,15,0.467,0,0,0.0,3,6,0.5,6,7,13,13,1,2,5,5,17,11,1,SAC,SAC,OKC,105,49.5,Fantasy Score,43,30,30,26
Domantas Sabonis,C,22023,1627734,22300016,"NOV 10, 2023",SAC vs. OKC,W,38,7,15,0.467,0,0,0.0,3,6,0.5,6,7,13,13,1,2,5,5,17,11,1,SAC,SAC,OKC,105,10.0,Defensive Rebounds,43,30,30,26
Domantas Sabonis,C,22023,1627734,22300016,"NOV 10, 2023",SAC vs. OKC,W,38,7,15,0.467,0,0,0.0,3,6,0.5,6,7,13,13,1,2,5,5,17,11,1,SAC,SAC,OKC,105,3.5,Free Throws Made,43,30,30,26
Domantas Sabonis,C,22023,1627734,22300016,"NOV 10, 2023",SAC vs. OKC,W,38,7,15,0.467,0,0,0.0,3,6,0.5,6,7,13,13,1,2,5,5,17,11,1,SAC,SAC,OKC,105,13.0,FG Attempted,43,30,30,26
Domantas Sabonis,C,22023,1627734,22300016,"NOV 10, 2023",SAC vs. OKC,W,38,7,15,0.467,0,0,0.0,3,6,0.5,6,7,13,13,1,2,5,5,17,11,1,SAC,SAC,OKC,105,34.5,Pts+Rebs,43,30,30,26
Domantas Sabonis,C,22023,1627734,22300016,"NOV 10, 2023",SAC vs. OKC,W,38,7,15,0.467,0,0,0.0,3,6,0.5,6,7,13,13,1,2,5,5,17,11,1,SAC,SAC,OKC,105,1.0,Dunks,43,30,30,26
Domantas Sabonis,C,22023,1627734,22300016,"NOV 10, 2023",SAC vs. OKC,W,38,7,15,0.467,0,0,0.0,3,6,0.5,6,7,13,13,1,2,5,5,17,11,1,SAC,SAC,OKC,105,28.5,Pts+Asts,43,30,30,26
Domantas Sabonis,C,22023,1627734,22300016,"NOV 10, 2023",SAC vs. OKC,W,38,7,15,0.467,0,0,0.0,3,6,0.5,6,7,13,13,1,2,5,5,17,11,1,SAC,SAC,OKC,105,22.5,Rebs+Asts,43,30,30,26
Domantas Sabonis,C,22023,1627734,22300170,"NOV 08, 2023",SAC vs. POR,W,40,11,14,0.786,0,0,0.0,5,7,0.714,7,4,11,9,1,1,6,4,27,-5,1,SAC,SAC,POR,121,19.5,Points,47,38,36,20
Domantas Sabonis,C,22023,1627734,22300170,"NOV 08, 2023",SAC vs. POR,W,40,11,14,0.786,0,0,0.0,5,7,0.714,7,4,11,9,1,1,6,4,27,-5,1,SAC,SAC,POR,121,13.5,Rebounds,47,38,36,20
Domantas Sabonis,C,22023,1627734,22300170,"NOV 08, 2023",SAC vs. POR,W,40,11,14,0.786,0,0,0.0,5,7,0.714,7,4,11,9,1,1,6,4,27,-5,1,SAC,SAC,POR,121,42.5,Pts+Rebs+Asts,47,38,36,20
Domantas Sabonis,C,22023,1627734,22300170,"NOV 08, 2023",SAC vs. POR,W,40,11,14,0.786,0,0,0.0,5,7,0.714,7,4,11,9,1,1,6,4,27,-5,1,SAC,SAC,POR,121,8.5,Assists,47,38,36,20
Domantas Sabonis,C,22023,1627734,22300170,"NOV 08, 2023",SAC vs. POR,W,40,11,14,0.786,0,0,0.0,5,7,0.714,7,4,11,9,1,1,6,4,27,-5,1,SAC,SAC,POR,121,49.5,Fantasy Score,47,38,36,20
Domantas Sabonis,C,22023,1627734,22300170,"NOV 08, 2023",SAC vs. POR,W,40,11,14,0.786,0,0,0.0,5,7,0.714,7,4,11,9,1,1,6,4,27,-5,1,SAC,SAC,POR,121,10.0,Defensive Rebounds,47,38,36,20
Domantas Sabonis,C,22023,1627734,22300170,"NOV 08, 2023",SAC vs. POR,W,40,11,14,0.786,0,0,0.0,5,7,0.714,7,4,11,9,1,1,6,4,27,-5,1,SAC,SAC,POR,121,3.5,Free Throws Made,47,38,36,20
Domantas Sabonis,C,22023,1627734,22300170,"NOV 08, 2023",SAC vs. POR,W,40,11,14,0.786,0,0,0.0,5,7,0.714,7,4,11,9,1,1,6,4,27,-5,1,SAC,SAC,POR,121,13.0,FG Attempted,47,38,36,20
Domantas Sabonis,C,22023,1627734,22300170,"NOV 08, 2023",SAC vs. POR,W,40,11,14,0.786,0,0,0.0,5,7,0.714,7,4,11,9,1,1,6,4,27,-5,1,SAC,SAC,POR,121,34.5,Pts+Rebs,47,38,36,20
Domantas Sabonis,C,22023,1627734,22300170,"NOV 08, 2023",SAC vs. POR,W,40,11,14,0.786,0,0,0.0,5,7,0.714,7,4,11,9,1,1,6,4,27,-5,1,SAC,SAC,POR,121,1.0,Dunks,47,38,36,20
Domantas Sabonis,C,22023,1627734,22300170,"NOV 08, 2023",SAC vs. POR,W,40,11,14,0.786,0,0,0.0,5,7,0.714,7,4,11,9,1,1,6,4,27,-5,1,SAC,SAC,POR,121,28.5,Pts+Asts,47,38,36,20
Domantas Sabonis,C,22023,1627734,22300170,"NOV 08, 2023",SAC vs. POR,W,40,11,14,0.786,0,0,0.0,5,7,0.714,7,4,11,9,1,1,6,4,27,-5,1,SAC,SAC,POR,121,22.5,Rebs+Asts,47,38,36,20
Domantas Sabonis,C,22023,1627734,22300153,"NOV 06, 2023",SAC @ HOU,L,30,3,4,0.75,0,0,0.0,2,3,0.667,3,5,8,5,0,0,4,4,8,-24,1,SAC,HOU,SAC,97,19.5,Points,21,16,13,13
Domantas Sabonis,C,22023,1627734,22300153,"NOV 06, 2023",SAC @ HOU,L,30,3,4,0.75,0,0,0.0,2,3,0.667,3,5,8,5,0,0,4,4,8,-24,1,SAC,HOU,SAC,97,13.5,Rebounds,21,16,13,13
Domantas Sabonis,C,22023,1627734,22300153,"NOV 06, 2023",SAC @ HOU,L,30,3,4,0.75,0,0,0.0,2,3,0.667,3,5,8,5,0,0,4,4,8,-24,1,SAC,HOU,SAC,97,42.5,Pts+Rebs+Asts,21,16,13,13
Domantas Sabonis,C,22023,1627734,22300153,"NOV 06, 2023",SAC @ HOU,L,30,3,4,0.75,0,0,0.0,2,3,0.667,3,5,8,5,0,0,4,4,8,-24,1,SAC,HOU,SAC,97,8.5,Assists,21,16,13,13
Domantas Sabonis,C,22023,1627734,22300153,"NOV 06, 2023",SAC @ HOU,L,30,3,4,0.75,0,0,0.0,2,3,0.667,3,5,8,5,0,0,4,4,8,-24,1,SAC,HOU,SAC,97,49.5,Fantasy Score,21,16,13,13
Domantas Sabonis,C,22023,1627734,22300153,"NOV 06, 2023",SAC @ HOU,L,30,3,4,0.75,0,0,0.0,2,3,0.667,3,5,8,5,0,0,4,4,8,-24,1,SAC,HOU,SAC,97,10.0,Defensive Rebounds,21,16,13,13
Domantas Sabonis,C,22023,1627734,22300153,"NOV 06, 2023",SAC @ HOU,L,30,3,4,0.75,0,0,0.0,2,3,0.667,3,5,8,5,0,0,4,4,8,-24,1,SAC,HOU,SAC,97,3.5,Free Throws Made,21,16,13,13
Domantas Sabonis,C,22023,1627734,22300153,"NOV 06, 2023",SAC @ HOU,L,30,3,4,0.75,0,0,0.0,2,3,0.667,3,5,8,5,0,0,4,4,8,-24,1,SAC,HOU,SAC,97,13.0,FG Attempted,21,16,13,13
Domantas Sabonis,C,22023,1627734,22300153,"NOV 06, 2023",SAC @ HOU,L,30,3,4,0.75,0,0,0.0,2,3,0.667,3,5,8,5,0,0,4,4,8,-24,1,SAC,HOU,SAC,97,34.5,Pts+Rebs,21,16,13,13
Domantas Sabonis,C,22023,1627734,22300153,"NOV 06, 2023",SAC @ HOU,L,30,3,4,0.75,0,0,0.0,2,3,0.667,3,5,8,5,0,0,4,4,8,-24,1,SAC,HOU,SAC,97,1.0,Dunks,21,16,13,13
Domantas Sabonis,C,22023,1627734,22300153,"NOV 06, 2023",SAC @ HOU,L,30,3,4,0.75,0,0,0.0,2,3,0.667,3,5,8,5,0,0,4,4,8,-24,1,SAC,HOU,SAC,97,28.5,Pts+Asts,21,16,13,13
Domantas Sabonis,C,22023,1627734,22300153,"NOV 06, 2023",SAC @ HOU,L,30,3,4,0.75,0,0,0.0,2,3,0.667,3,5,8,5,0,0,4,4,8,-24,1,SAC,HOU,SAC,97,22.5,Rebs+Asts,21,16,13,13
Domantas Sabonis,C,22023,1627734,22300137,"NOV 04, 2023",SAC @ HOU,L,31,5,10,0.5,0,2,0.0,1,4,0.25,3,12,15,4,1,2,5,2,11,-26,1,SAC,HOU,SAC,89,19.5,Points,30,26,15,19
Domantas Sabonis,C,22023,1627734,22300137,"NOV 04, 2023",SAC @ HOU,L,31,5,10,0.5,0,2,0.0,1,4,0.25,3,12,15,4,1,2,5,2,11,-26,1,SAC,HOU,SAC,89,13.5,Rebounds,30,26,15,19
Domantas Sabonis,C,22023,1627734,22300137,"NOV 04, 2023",SAC @ HOU,L,31,5,10,0.5,0,2,0.0,1,4,0.25,3,12,15,4,1,2,5,2,11,-26,1,SAC,HOU,SAC,89,42.5,Pts+Rebs+Asts,30,26,15,19
Domantas Sabonis,C,22023,1627734,22300137,"NOV 04, 2023",SAC @ HOU,L,31,5,10,0.5,0,2,0.0,1,4,0.25,3,12,15,4,1,2,5,2,11,-26,1,SAC,HOU,SAC,89,8.5,Assists,30,26,15,19
Domantas Sabonis,C,22023,1627734,22300137,"NOV 04, 2023",SAC @ HOU,L,31,5,10,0.5,0,2,0.0,1,4,0.25,3,12,15,4,1,2,5,2,11,-26,1,SAC,HOU,SAC,89,49.5,Fantasy Score,30,26,15,19
Domantas Sabonis,C,22023,1627734,22300137,"NOV 04, 2023",SAC @ HOU,L,31,5,10,0.5,0,2,0.0,1,4,0.25,3,12,15,4,1,2,5,2,11,-26,1,SAC,HOU,SAC,89,10.0,Defensive Rebounds,30,26,15,19
Domantas Sabonis,C,22023,1627734,22300137,"NOV 04, 2023",SAC @ HOU,L,31,5,10,0.5,0,2,0.0,1,4,0.25,3,12,15,4,1,2,5,2,11,-26,1,SAC,HOU,SAC,89,3.5,Free Throws Made,30,26,15,19
Domantas Sabonis,C,22023,1627734,22300137,"NOV 04, 2023",SAC @ HOU,L,31,5,10,0.5,0,2,0.0,1,4,0.25,3,12,15,4,1,2,5,2,11,-26,1,SAC,HOU,SAC,89,13.0,FG Attempted,30,26,15,19
Domantas Sabonis,C,22023,1627734,22300137,"NOV 04, 2023",SAC @ HOU,L,31,5,10,0.5,0,2,0.0,1,4,0.25,3,12,15,4,1,2,5,2,11,-26,1,SAC,HOU,SAC,89,34.5,Pts+Rebs,30,26,15,19
Domantas Sabonis,C,22023,1627734,22300137,"NOV 04, 2023",SAC @ HOU,L,31,5,10,0.5,0,2,0.0,1,4,0.25,3,12,15,4,1,2,5,2,11,-26,1,SAC,HOU,SAC,89,1.0,Dunks,30,26,15,19
Domantas Sabonis,C,22023,1627734,22300137,"NOV 04, 2023",SAC @ HOU,L,31,5,10,0.5,0,2,0.0,1,4,0.25,3,12,15,4,1,2,5,2,11,-26,1,SAC,HOU,SAC,89,28.5,Pts+Asts,30,26,15,19
Domantas Sabonis,C,22023,1627734,22300137,"NOV 04, 2023",SAC @ HOU,L,31,5,10,0.5,0,2,0.0,1,4,0.25,3,12,15,4,1,2,5,2,11,-26,1,SAC,HOU,SAC,89,22.5,Rebs+Asts,30,26,15,19
Domantas Sabonis,C,22023,1627734,22300126,"NOV 01, 2023",SAC @ GSW,L,37,8,16,0.5,0,1,0.0,7,12,0.583,3,8,11,8,0,0,2,2,23,-4,1,SAC,GSW,SAC,101,19.5,Points,42,34,31,19
Domantas Sabonis,C,22023,1627734,22300126,"NOV 01, 2023",SAC @ GSW,L,37,8,16,0.5,0,1,0.0,7,12,0.583,3,8,11,8,0,0,2,2,23,-4,1,SAC,GSW,SAC,101,13.5,Rebounds,42,34,31,19
Domantas Sabonis,C,22023,1627734,22300126,"NOV 01, 2023",SAC @ GSW,L,37,8,16,0.5,0,1,0.0,7,12,0.583,3,8,11,8,0,0,2,2,23,-4,1,SAC,GSW,SAC,101,42.5,Pts+Rebs+Asts,42,34,31,19
Domantas Sabonis,C,22023,1627734,22300126,"NOV 01, 2023",SAC @ GSW,L,37,8,16,0.5,0,1,0.0,7,12,0.583,3,8,11,8,0,0,2,2,23,-4,1,SAC,GSW,SAC,101,8.5,Assists,42,34,31,19
Domantas Sabonis,C,22023,1627734,22300126,"NOV 01, 2023",SAC @ GSW,L,37,8,16,0.5,0,1,0.0,7,12,0.583,3,8,11,8,0,0,2,2,23,-4,1,SAC,GSW,SAC,101,49.5,Fantasy Score,42,34,31,19
Domantas Sabonis,C,22023,1627734,22300126,"NOV 01, 2023",SAC @ GSW,L,37,8,16,0.5,0,1,0.0,7,12,0.583,3,8,11,8,0,0,2,2,23,-4,1,SAC,GSW,SAC,101,10.0,Defensive Rebounds,42,34,31,19
Domantas Sabonis,C,22023,1627734,22300126,"NOV 01, 2023",SAC @ GSW,L,37,8,16,0.5,0,1,0.0,7,12,0.583,3,8,11,8,0,0,2,2,23,-4,1,SAC,GSW,SAC,101,3.5,Free Throws Made,42,34,31,19
Domantas Sabonis,C,22023,1627734,22300126,"NOV 01, 2023",SAC @ GSW,L,37,8,16,0.5,0,1,0.0,7,12,0.583,3,8,11,8,0,0,2,2,23,-4,1,SAC,GSW,SAC,101,13.0,FG Attempted,42,34,31,19
Domantas Sabonis,C,22023,1627734,22300126,"NOV 01, 2023",SAC @ GSW,L,37,8,16,0.5,0,1,0.0,7,12,0.583,3,8,11,8,0,0,2,2,23,-4,1,SAC,GSW,SAC,101,34.5,Pts+Rebs,42,34,31,19
Domantas Sabonis,C,22023,1627734,22300126,"NOV 01, 2023",SAC @ GSW,L,37,8,16,0.5,0,1,0.0,7,12,0.583,3,8,11,8,0,0,2,2,23,-4,1,SAC,GSW,SAC,101,1.0,Dunks,42,34,31,19
Domantas Sabonis,C,22023,1627734,22300126,"NOV 01, 2023",SAC @ GSW,L,37,8,16,0.5,0,1,0.0,7,12,0.583,3,8,11,8,0,0,2,2,23,-4,1,SAC,GSW,SAC,101,28.5,Pts+Asts,42,34,31,19
Domantas Sabonis,C,22023,1627734,22300126,"NOV 01, 2023",SAC @ GSW,L,37,8,16,0.5,0,1,0.0,7,12,0.583,3,8,11,8,0,0,2,2,23,-4,1,SAC,GSW,SAC,101,22.5,Rebs+Asts,42,34,31,19
Domantas Sabonis,C,22023,1627734,22300100,"OCT 29, 2023",SAC vs. LAL,W,34,5,8,0.625,1,1,1.0,1,3,0.333,1,14,15,5,1,0,3,6,12,5,1,SAC,SAC,LAL,132,19.5,Points,32,27,17,20
Domantas Sabonis,C,22023,1627734,22300100,"OCT 29, 2023",SAC vs. LAL,W,34,5,8,0.625,1,1,1.0,1,3,0.333,1,14,15,5,1,0,3,6,12,5,1,SAC,SAC,LAL,132,13.5,Rebounds,32,27,17,20
Domantas Sabonis,C,22023,1627734,22300100,"OCT 29, 2023",SAC vs. LAL,W,34,5,8,0.625,1,1,1.0,1,3,0.333,1,14,15,5,1,0,3,6,12,5,1,SAC,SAC,LAL,132,42.5,Pts+Rebs+Asts,32,27,17,20
Domantas Sabonis,C,22023,1627734,22300100,"OCT 29, 2023",SAC vs. LAL,W,34,5,8,0.625,1,1,1.0,1,3,0.333,1,14,15,5,1,0,3,6,12,5,1,SAC,SAC,LAL,132,8.5,Assists,32,27,17,20
Domantas Sabonis,C,22023,1627734,22300100,"OCT 29, 2023",SAC vs. LAL,W,34,5,8,0.625,1,1,1.0,1,3,0.333,1,14,15,5,1,0,3,6,12,5,1,SAC,SAC,LAL,132,49.5,Fantasy Score,32,27,17,20
Domantas Sabonis,C,22023,1627734,22300100,"OCT 29, 2023",SAC vs. LAL,W,34,5,8,0.625,1,1,1.0,1,3,0.333,1,14,15,5,1,0,3,6,12,5,1,SAC,SAC,LAL,132,10.0,Defensive Rebounds,32,27,17,20
Domantas Sabonis,C,22023,1627734,22300100,"OCT 29, 2023",SAC vs. LAL,W,34,5,8,0.625,1,1,1.0,1,3,0.333,1,14,15,5,1,0,3,6,12,5,1,SAC,SAC,LAL,132,3.5,Free Throws Made,32,27,17,20
Domantas Sabonis,C,22023,1627734,22300100,"OCT 29, 2023",SAC vs. LAL,W,34,5,8,0.625,1,1,1.0,1,3,0.333,1,14,15,5,1,0,3,6,12,5,1,SAC,SAC,LAL,132,13.0,FG Attempted,32,27,17,20
Domantas Sabonis,C,22023,1627734,22300100,"OCT 29, 2023",SAC vs. LAL,W,34,5,8,0.625,1,1,1.0,1,3,0.333,1,14,15,5,1,0,3,6,12,5,1,SAC,SAC,LAL,132,34.5,Pts+Rebs,32,27,17,20
Domantas Sabonis,C,22023,1627734,22300100,"OCT 29, 2023",SAC vs. LAL,W,34,5,8,0.625,1,1,1.0,1,3,0.333,1,14,15,5,1,0,3,6,12,5,1,SAC,SAC,LAL,132,1.0,Dunks,32,27,17,20
Domantas Sabonis,C,22023,1627734,22300100,"OCT 29, 2023",SAC vs. LAL,W,34,5,8,0.625,1,1,1.0,1,3,0.333,1,14,15,5,1,0,3,6,12,5,1,SAC,SAC,LAL,132,28.5,Pts+Asts,32,27,17,20
Domantas Sabonis,C,22023,1627734,22300100,"OCT 29, 2023",SAC vs. LAL,W,34,5,8,0.625,1,1,1.0,1,3,0.333,1,14,15,5,1,0,3,6,12,5,1,SAC,SAC,LAL,132,22.5,Rebs+Asts,32,27,17,20
Domantas Sabonis,C,22023,1627734,22300087,"OCT 27, 2023",SAC vs. GSW,L,36,7,15,0.467,0,2,0.0,5,6,0.833,4,14,18,7,3,0,1,1,19,-9,1,SAC,SAC,GSW,114,19.5,Points,44,37,26,25
Domantas Sabonis,C,22023,1627734,22300087,"OCT 27, 2023",SAC vs. GSW,L,36,7,15,0.467,0,2,0.0,5,6,0.833,4,14,18,7,3,0,1,1,19,-9,1,SAC,SAC,GSW,114,13.5,Rebounds,44,37,26,25
Domantas Sabonis,C,22023,1627734,22300087,"OCT 27, 2023",SAC vs. GSW,L,36,7,15,0.467,0,2,0.0,5,6,0.833,4,14,18,7,3,0,1,1,19,-9,1,SAC,SAC,GSW,114,42.5,Pts+Rebs+Asts,44,37,26,25
Domantas Sabonis,C,22023,1627734,22300087,"OCT 27, 2023",SAC vs. GSW,L,36,7,15,0.467,0,2,0.0,5,6,0.833,4,14,18,7,3,0,1,1,19,-9,1,SAC,SAC,GSW,114,8.5,Assists,44,37,26,25
Domantas Sabonis,C,22023,1627734,22300087,"OCT 27, 2023",SAC vs. GSW,L,36,7,15,0.467,0,2,0.0,5,6,0.833,4,14,18,7,3,0,1,1,19,-9,1,SAC,SAC,GSW,114,49.5,Fantasy Score,44,37,26,25
Domantas Sabonis,C,22023,1627734,22300087,"OCT 27, 2023",SAC vs. GSW,L,36,7,15,0.467,0,2,0.0,5,6,0.833,4,14,18,7,3,0,1,1,19,-9,1,SAC,SAC,GSW,114,10.0,Defensive Rebounds,44,37,26,25
Domantas Sabonis,C,22023,1627734,22300087,"OCT 27, 2023",SAC vs. GSW,L,36,7,15,0.467,0,2,0.0,5,6,0.833,4,14,18,7,3,0,1,1,19,-9,1,SAC,SAC,GSW,114,3.5,Free Throws Made,44,37,26,25
Domantas Sabonis,C,22023,1627734,22300087,"OCT 27, 2023",SAC vs. GSW,L,36,7,15,0.467,0,2,0.0,5,6,0.833,4,14,18,7,3,0,1,1,19,-9,1,SAC,SAC,GSW,114,13.0,FG Attempted,44,37,26,25
Domantas Sabonis,C,22023,1627734,22300087,"OCT 27, 2023",SAC vs. GSW,L,36,7,15,0.467,0,2,0.0,5,6,0.833,4,14,18,7,3,0,1,1,19,-9,1,SAC,SAC,GSW,114,34.5,Pts+Rebs,44,37,26,25
Domantas Sabonis,C,22023,1627734,22300087,"OCT 27, 2023",SAC vs. GSW,L,36,7,15,0.467,0,2,0.0,5,6,0.833,4,14,18,7,3,0,1,1,19,-9,1,SAC,SAC,GSW,114,1.0,Dunks,44,37,26,25
Domantas Sabonis,C,22023,1627734,22300087,"OCT 27, 2023",SAC vs. GSW,L,36,7,15,0.467,0,2,0.0,5,6,0.833,4,14,18,7,3,0,1,1,19,-9,1,SAC,SAC,GSW,114,28.5,Pts+Asts,44,37,26,25
Domantas Sabonis,C,22023,1627734,22300087,"OCT 27, 2023",SAC vs. GSW,L,36,7,15,0.467,0,2,0.0,5,6,0.833,4,14,18,7,3,0,1,1,19,-9,1,SAC,SAC,GSW,114,22.5,Rebs+Asts,44,37,26,25
Domantas Sabonis,C,22023,1627734,22300072,"OCT 25, 2023",SAC @ UTA,W,32,8,14,0.571,1,2,0.5,5,7,0.714,6,6,12,5,1,2,3,3,22,5,1,SAC,UTA,SAC,130,19.5,Points,39,34,27,17
Domantas Sabonis,C,22023,1627734,22300072,"OCT 25, 2023",SAC @ UTA,W,32,8,14,0.571,1,2,0.5,5,7,0.714,6,6,12,5,1,2,3,3,22,5,1,SAC,UTA,SAC,130,13.5,Rebounds,39,34,27,17
Domantas Sabonis,C,22023,1627734,22300072,"OCT 25, 2023",SAC @ UTA,W,32,8,14,0.571,1,2,0.5,5,7,0.714,6,6,12,5,1,2,3,3,22,5,1,SAC,UTA,SAC,130,42.5,Pts+Rebs+Asts,39,34,27,17
Domantas Sabonis,C,22023,1627734,22300072,"OCT 25, 2023",SAC @ UTA,W,32,8,14,0.571,1,2,0.5,5,7,0.714,6,6,12,5,1,2,3,3,22,5,1,SAC,UTA,SAC,130,8.5,Assists,39,34,27,17
Domantas Sabonis,C,22023,1627734,22300072,"OCT 25, 2023",SAC @ UTA,W,32,8,14,0.571,1,2,0.5,5,7,0.714,6,6,12,5,1,2,3,3,22,5,1,SAC,UTA,SAC,130,49.5,Fantasy Score,39,34,27,17
Domantas Sabonis,C,22023,1627734,22300072,"OCT 25, 2023",SAC @ UTA,W,32,8,14,0.571,1,2,0.5,5,7,0.714,6,6,12,5,1,2,3,3,22,5,1,SAC,UTA,SAC,130,10.0,Defensive Rebounds,39,34,27,17
Domantas Sabonis,C,22023,1627734,22300072,"OCT 25, 2023",SAC @ UTA,W,32,8,14,0.571,1,2,0.5,5,7,0.714,6,6,12,5,1,2,3,3,22,5,1,SAC,UTA,SAC,130,3.5,Free Throws Made,39,34,27,17
Domantas Sabonis,C,22023,1627734,22300072,"OCT 25, 2023",SAC @ UTA,W,32,8,14,0.571,1,2,0.5,5,7,0.714,6,6,12,5,1,2,3,3,22,5,1,SAC,UTA,SAC,130,13.0,FG Attempted,39,34,27,17
Domantas Sabonis,C,22023,1627734,22300072,"OCT 25, 2023",SAC @ UTA,W,32,8,14,0.571,1,2,0.5,5,7,0.714,6,6,12,5,1,2,3,3,22,5,1,SAC,UTA,SAC,130,34.5,Pts+Rebs,39,34,27,17
Domantas Sabonis,C,22023,1627734,22300072,"OCT 25, 2023",SAC @ UTA,W,32,8,14,0.571,1,2,0.5,5,7,0.714,6,6,12,5,1,2,3,3,22,5,1,SAC,UTA,SAC,130,1.0,Dunks,39,34,27,17
Domantas Sabonis,C,22023,1627734,22300072,"OCT 25, 2023",SAC @ UTA,W,32,8,14,0.571,1,2,0.5,5,7,0.714,6,6,12,5,1,2,3,3,22,5,1,SAC,UTA,SAC,130,28.5,Pts+Asts,39,34,27,17
Domantas Sabonis,C,22023,1627734,22300072,"OCT 25, 2023",SAC @ UTA,W,32,8,14,0.571,1,2,0.5,5,7,0.714,6,6,12,5,1,2,3,3,22,5,1,SAC,UTA,SAC,130,22.5,Rebs+Asts,39,34,27,17
Zach LaVine,G,22023,203897,22300139,"NOV 04, 2023",CHI @ DEN,L,31,4,12,0.333,1,5,0.2,3,4,0.75,0,4,4,4,1,0,3,2,12,-27,1,CHI,DEN,CHI,101,,,20,16,16,8
Zach LaVine,G,22023,203897,22300580,"JAN 18, 2024",CHI @ TOR,W,24,3,7,0.429,1,3,0.333,1,1,1.0,0,2,2,3,0,0,2,4,8,-4,1,CHI,TOR,CHI,116,,,13,10,11,5
Zach LaVine,G,22023,203897,22300561,"JAN 15, 2024",CHI @ CLE,L,35,7,14,0.5,3,6,0.5,0,0,0.0,0,4,4,4,0,0,3,3,17,-18,1,CHI,CLE,CHI,91,,,25,21,21,8
Zach LaVine,G,22023,203897,22300548,"JAN 13, 2024",CHI @ SAS,W,36,3,8,0.375,1,5,0.2,3,4,0.75,0,6,6,7,1,0,2,3,10,12,1,CHI,SAS,CHI,122,,,23,16,17,13
Zach LaVine,G,22023,203897,22300506,"JAN 08, 2024",CHI @ CHA,W,36,2,8,0.25,2,6,0.333,3,4,0.75,1,2,3,5,0,2,2,1,9,-5,1,CHI,CHA,CHI,119,,,17,12,14,8
Zach LaVine,G,22023,203897,22300484,"JAN 05, 2024",CHI vs. CHA,W,30,6,11,0.545,1,5,0.2,2,3,0.667,0,5,5,4,0,0,2,1,15,4,1,CHI,CHI,CHA,104,,,24,20,19,9
Zach LaVine,G,22023,203897,22300053,"NOV 28, 2023",CHI @ BOS,L,25,1,9,0.111,0,3,0.0,0,0,0.0,1,1,2,4,2,0,0,1,2,-22,1,CHI,BOS,CHI,97,,,8,4,6,6
Zach LaVine,G,22023,203897,22300250,"NOV 26, 2023",CHI @ BKN,L,39,8,18,0.444,1,5,0.2,3,4,0.75,0,6,6,4,0,0,0,1,20,1,1,CHI,BKN,CHI,109,,,30,26,24,10
Zach LaVine,G,22023,203897,22300046,"NOV 24, 2023",CHI @ TOR,L,38,16,23,0.696,4,8,0.5,0,0,0.0,0,4,4,3,1,0,5,4,36,-2,1,CHI,TOR,CHI,108,,,43,40,39,7
Zach LaVine,G,22023,203897,22300220,"NOV 20, 2023",CHI vs. MIA,L,35,5,9,0.556,2,6,0.333,1,1,1.0,0,3,3,5,0,0,1,1,13,-24,1,CHI,CHI,MIA,100,,,21,16,18,8
Zach LaVine,G,22023,203897,22300204,"NOV 18, 2023",CHI vs. MIA,W,35,5,10,0.5,3,7,0.429,0,0,0.0,0,8,8,6,3,1,1,2,13,-2,1,CHI,CHI,MIA,102,,,27,21,19,14
Zach LaVine,G,22023,203897,22300033,"NOV 17, 2023",CHI vs. ORL,L,41,12,20,0.6,4,11,0.364,6,7,0.857,0,6,6,3,1,0,3,4,34,2,1,CHI,CHI,ORL,97,,,43,40,37,9
Zach LaVine,G,22023,203897,22300196,"NOV 15, 2023",CHI vs. ORL,L,36,6,16,0.375,4,7,0.571,3,4,0.75,0,6,6,3,1,0,3,2,19,3,1,CHI,CHI,ORL,94,,,28,25,22,9
Zach LaVine,G,22023,203897,22300190,"NOV 13, 2023",CHI @ MIL,L,39,5,19,0.263,2,10,0.2,8,8,1.0,1,7,8,5,1,1,1,1,20,-6,1,CHI,MIL,CHI,109,,,33,28,25,13
Zach LaVine,G,22023,203897,22300181,"NOV 12, 2023",CHI vs. DET,W,34,6,14,0.429,1,6,0.167,6,6,1.0,0,3,3,2,1,0,0,1,19,1,1,CHI,CHI,DET,119,,,24,22,21,5
Zach LaVine,G,22023,203897,22300162,"NOV 08, 2023",CHI vs. PHX,L,41,7,13,0.538,3,6,0.5,5,7,0.714,1,7,8,8,1,0,3,2,22,-14,1,CHI,CHI,PHX,115,,,38,30,30,16
Zach LaVine,G,22023,203897,22300152,"NOV 06, 2023",CHI vs. UTA,W,31,8,17,0.471,2,5,0.4,6,7,0.857,0,2,2,3,1,0,2,3,24,18,1,CHI,CHI,UTA,130,,,29,26,27,5
Zach LaVine,G,22023,203897,22300004,"NOV 03, 2023",CHI vs. BKN,L,38,10,21,0.476,1,6,0.167,3,4,0.75,1,6,7,5,1,1,2,2,24,8,1,CHI,CHI,BKN,107,,,36,31,29,12
Zach LaVine,G,22023,203897,22300124,"NOV 01, 2023",CHI @ DAL,L,36,7,17,0.412,5,9,0.556,3,3,1.0,0,2,2,1,2,0,0,2,22,-6,1,CHI,DAL,CHI,105,,,25,24,23,3
Zach LaVine,G,22023,203897,22300102,"OCT 30, 2023",CHI @ IND,W,36,6,17,0.353,1,6,0.167,10,11,0.909,0,5,5,1,0,0,1,1,23,2,1,CHI,IND,CHI,112,,,29,28,24,6
Zach LaVine,G,22023,203897,22300088,"OCT 28, 2023",CHI @ DET,L,37,19,33,0.576,7,13,0.538,6,8,0.75,2,3,5,0,1,0,4,2,51,-8,1,CHI,DET,CHI,102,,,56,56,51,5
Zach LaVine,G,22023,203897,22300082,"OCT 27, 2023",CHI vs. TOR,W,38,3,14,0.214,0,6,0.0,2,2,1.0,0,5,5,1,0,1,3,3,8,-23,1,CHI,CHI,TOR,104,,,14,13,9,6
Zach LaVine,G,22023,203897,22300070,"OCT 25, 2023",CHI vs. OKC,L,25,4,16,0.25,2,9,0.222,6,6,1.0,0,4,4,3,0,0,4,3,16,1,1,CHI,CHI,OKC,104,,,23,20,19,7
Zach LaVine,G,22023,203897,22300536,"JAN 12, 2024",CHI vs. GSW,L,35,9,15,0.6,4,8,0.5,3,3,1.0,0,8,8,7,0,1,1,3,25,2,1,CHI,CHI,GSW,131,,,40,33,32,15
Zach LaVine,G,22023,203897,22300523,"JAN 10, 2024",CHI vs. HOU,W,41,8,15,0.533,4,8,0.5,5,6,0.833,1,12,13,7,3,1,4,5,25,15,1,CHI,CHI,HOU,124,,,45,38,32,20
Kristaps Porzingis,C,22023,204001,22300706,"FEB 04, 2024",BOS vs. MEM,W,28,10,17,0.588,2,5,0.4,4,5,0.8,2,6,8,2,1,2,1,2,26,26,1,BOS,BOS,MEM,131,18.5,Points,36,34,28,10
Kristaps Porzingis,C,22023,204001,22300706,"FEB 04, 2024",BOS vs. MEM,W,28,10,17,0.588,2,5,0.4,4,5,0.8,2,6,8,2,1,2,1,2,26,26,1,BOS,BOS,MEM,131,7.0,Rebounds,36,34,28,10
Kristaps Porzingis,C,22023,204001,22300706,"FEB 04, 2024",BOS vs. MEM,W,28,10,17,0.588,2,5,0.4,4,5,0.8,2,6,8,2,1,2,1,2,26,26,1,BOS,BOS,MEM,131,27.5,Pts+Rebs+Asts,36,34,28,10
Kristaps Porzingis,C,22023,204001,22300706,"FEB 04, 2024",BOS vs. MEM,W,28,10,17,0.588,2,5,0.4,4,5,0.8,2,6,8,2,1,2,1,2,26,26,1,BOS,BOS,MEM,131,34.0,Fantasy Score,36,34,28,10
Kristaps Porzingis,C,22023,204001,22300706,"FEB 04, 2024",BOS vs. MEM,W,28,10,17,0.588,2,5,0.4,4,5,0.8,2,6,8,2,1,2,1,2,26,26,1,BOS,BOS,MEM,131,25.5,Pts+Rebs,36,34,28,10
Kristaps Porzingis,C,22023,204001,22300706,"FEB 04, 2024",BOS vs. MEM,W,28,10,17,0.588,2,5,0.4,4,5,0.8,2,6,8,2,1,2,1,2,26,26,1,BOS,BOS,MEM,131,1.5,Dunks,36,34,28,10
Kristaps Porzingis,C,22023,204001,22300706,"FEB 04, 2024",BOS vs. MEM,W,28,10,17,0.588,2,5,0.4,4,5,0.8,2,6,8,2,1,2,1,2,26,26,1,BOS,BOS,MEM,131,20.5,Pts+Asts,36,34,28,10
Kristaps Porzingis,C,22023,204001,22300706,"FEB 04, 2024",BOS vs. MEM,W,28,10,17,0.588,2,5,0.4,4,5,0.8,2,6,8,2,1,2,1,2,26,26,1,BOS,BOS,MEM,131,1.5,Blocked Shots,36,34,28,10
Kristaps Porzingis,C,22023,204001,22300706,"FEB 04, 2024",BOS vs. MEM,W,28,10,17,0.588,2,5,0.4,4,5,0.8,2,6,8,2,1,2,1,2,26,26,1,BOS,BOS,MEM,131,8.5,Rebs+Asts,36,34,28,10
Kristaps Porzingis,C,22023,204001,22300706,"FEB 04, 2024",BOS vs. MEM,W,28,10,17,0.588,2,5,0.4,4,5,0.8,2,6,8,2,1,2,1,2,26,26,1,BOS,BOS,MEM,131,1.5,Turnovers,36,34,28,10
Kristaps Porzingis,C,22023,204001,22300684,"FEB 01, 2024",BOS vs. LAL,L,29,7,15,0.467,1,7,0.143,2,2,1.0,1,6,7,3,1,5,3,1,17,-22,1,BOS,BOS,LAL,105,18.5,Points,27,24,20,10
Kristaps Porzingis,C,22023,204001,22300684,"FEB 01, 2024",BOS vs. LAL,L,29,7,15,0.467,1,7,0.143,2,2,1.0,1,6,7,3,1,5,3,1,17,-22,1,BOS,BOS,LAL,105,7.0,Rebounds,27,24,20,10
Kristaps Porzingis,C,22023,204001,22300684,"FEB 01, 2024",BOS vs. LAL,L,29,7,15,0.467,1,7,0.143,2,2,1.0,1,6,7,3,1,5,3,1,17,-22,1,BOS,BOS,LAL,105,27.5,Pts+Rebs+Asts,27,24,20,10
Kristaps Porzingis,C,22023,204001,22300684,"FEB 01, 2024",BOS vs. LAL,L,29,7,15,0.467,1,7,0.143,2,2,1.0,1,6,7,3,1,5,3,1,17,-22,1,BOS,BOS,LAL,105,34.0,Fantasy Score,27,24,20,10
Kristaps Porzingis,C,22023,204001,22300684,"FEB 01, 2024",BOS vs. LAL,L,29,7,15,0.467,1,7,0.143,2,2,1.0,1,6,7,3,1,5,3,1,17,-22,1,BOS,BOS,LAL,105,25.5,Pts+Rebs,27,24,20,10
Kristaps Porzingis,C,22023,204001,22300684,"FEB 01, 2024",BOS vs. LAL,L,29,7,15,0.467,1,7,0.143,2,2,1.0,1,6,7,3,1,5,3,1,17,-22,1,BOS,BOS,LAL,105,1.5,Dunks,27,24,20,10
Kristaps Porzingis,C,22023,204001,22300684,"FEB 01, 2024",BOS vs. LAL,L,29,7,15,0.467,1,7,0.143,2,2,1.0,1,6,7,3,1,5,3,1,17,-22,1,BOS,BOS,LAL,105,20.5,Pts+Asts,27,24,20,10
Kristaps Porzingis,C,22023,204001,22300684,"FEB 01, 2024",BOS vs. LAL,L,29,7,15,0.467,1,7,0.143,2,2,1.0,1,6,7,3,1,5,3,1,17,-22,1,BOS,BOS,LAL,105,1.5,Blocked Shots,27,24,20,10
Kristaps Porzingis,C,22023,204001,22300684,"FEB 01, 2024",BOS vs. LAL,L,29,7,15,0.467,1,7,0.143,2,2,1.0,1,6,7,3,1,5,3,1,17,-22,1,BOS,BOS,LAL,105,8.5,Rebs+Asts,27,24,20,10
Kristaps Porzingis,C,22023,204001,22300684,"FEB 01, 2024",BOS vs. LAL,L,29,7,15,0.467,1,7,0.143,2,2,1.0,1,6,7,3,1,5,3,1,17,-22,1,BOS,BOS,LAL,105,1.5,Turnovers,27,24,20,10
Kristaps Porzingis,C,22023,204001,22300630,"JAN 25, 2024",BOS @ MIA,W,21,6,9,0.667,3,4,0.75,4,4,1.0,0,4,4,1,0,0,0,1,19,26,1,BOS,MIA,BOS,143,18.5,Points,24,23,20,5
Kristaps Porzingis,C,22023,204001,22300630,"JAN 25, 2024",BOS @ MIA,W,21,6,9,0.667,3,4,0.75,4,4,1.0,0,4,4,1,0,0,0,1,19,26,1,BOS,MIA,BOS,143,7.0,Rebounds,24,23,20,5
Kristaps Porzingis,C,22023,204001,22300630,"JAN 25, 2024",BOS @ MIA,W,21,6,9,0.667,3,4,0.75,4,4,1.0,0,4,4,1,0,0,0,1,19,26,1,BOS,MIA,BOS,143,27.5,Pts+Rebs+Asts,24,23,20,5
Kristaps Porzingis,C,22023,204001,22300630,"JAN 25, 2024",BOS @ MIA,W,21,6,9,0.667,3,4,0.75,4,4,1.0,0,4,4,1,0,0,0,1,19,26,1,BOS,MIA,BOS,143,34.0,Fantasy Score,24,23,20,5
Kristaps Porzingis,C,22023,204001,22300630,"JAN 25, 2024",BOS @ MIA,W,21,6,9,0.667,3,4,0.75,4,4,1.0,0,4,4,1,0,0,0,1,19,26,1,BOS,MIA,BOS,143,25.5,Pts+Rebs,24,23,20,5
Kristaps Porzingis,C,22023,204001,22300630,"JAN 25, 2024",BOS @ MIA,W,21,6,9,0.667,3,4,0.75,4,4,1.0,0,4,4,1,0,0,0,1,19,26,1,BOS,MIA,BOS,143,1.5,Dunks,24,23,20,5
Kristaps Porzingis,C,22023,204001,22300630,"JAN 25, 2024",BOS @ MIA,W,21,6,9,0.667,3,4,0.75,4,4,1.0,0,4,4,1,0,0,0,1,19,26,1,BOS,MIA,BOS,143,20.5,Pts+Asts,24,23,20,5
Kristaps Porzingis,C,22023,204001,22300630,"JAN 25, 2024",BOS @ MIA,W,21,6,9,0.667,3,4,0.75,4,4,1.0,0,4,4,1,0,0,0,1,19,26,1,BOS,MIA,BOS,143,1.5,Blocked Shots,24,23,20,5
Kristaps Porzingis,C,22023,204001,22300630,"JAN 25, 2024",BOS @ MIA,W,21,6,9,0.667,3,4,0.75,4,4,1.0,0,4,4,1,0,0,0,1,19,26,1,BOS,MIA,BOS,143,8.5,Rebs+Asts,24,23,20,5
Kristaps Porzingis,C,22023,204001,22300630,"JAN 25, 2024",BOS @ MIA,W,21,6,9,0.667,3,4,0.75,4,4,1.0,0,4,4,1,0,0,0,1,19,26,1,BOS,MIA,BOS,143,1.5,Turnovers,24,23,20,5
Kristaps Porzingis,C,22023,204001,22300528,"JAN 11, 2024",BOS @ MIL,L,21,3,9,0.333,0,3,0.0,0,0,0.0,1,1,2,4,1,1,1,2,6,-27,1,BOS,MIL,BOS,102,18.5,Points,12,8,10,6
Kristaps Porzingis,C,22023,204001,22300528,"JAN 11, 2024",BOS @ MIL,L,21,3,9,0.333,0,3,0.0,0,0,0.0,1,1,2,4,1,1,1,2,6,-27,1,BOS,MIL,BOS,102,7.0,Rebounds,12,8,10,6
Kristaps Porzingis,C,22023,204001,22300528,"JAN 11, 2024",BOS @ MIL,L,21,3,9,0.333,0,3,0.0,0,0,0.0,1,1,2,4,1,1,1,2,6,-27,1,BOS,MIL,BOS,102,27.5,Pts+Rebs+Asts,12,8,10,6
Kristaps Porzingis,C,22023,204001,22300528,"JAN 11, 2024",BOS @ MIL,L,21,3,9,0.333,0,3,0.0,0,0,0.0,1,1,2,4,1,1,1,2,6,-27,1,BOS,MIL,BOS,102,34.0,Fantasy Score,12,8,10,6
Kristaps Porzingis,C,22023,204001,22300528,"JAN 11, 2024",BOS @ MIL,L,21,3,9,0.333,0,3,0.0,0,0,0.0,1,1,2,4,1,1,1,2,6,-27,1,BOS,MIL,BOS,102,25.5,Pts+Rebs,12,8,10,6
Kristaps Porzingis,C,22023,204001,22300528,"JAN 11, 2024",BOS @ MIL,L,21,3,9,0.333,0,3,0.0,0,0,0.0,1,1,2,4,1,1,1,2,6,-27,1,BOS,MIL,BOS,102,1.5,Dunks,12,8,10,6
Kristaps Porzingis,C,22023,204001,22300528,"JAN 11, 2024",BOS @ MIL,L,21,3,9,0.333,0,3,0.0,0,0,0.0,1,1,2,4,1,1,1,2,6,-27,1,BOS,MIL,BOS,102,20.5,Pts+Asts,12,8,10,6
Kristaps Porzingis,C,22023,204001,22300528,"JAN 11, 2024",BOS @ MIL,L,21,3,9,0.333,0,3,0.0,0,0,0.0,1,1,2,4,1,1,1,2,6,-27,1,BOS,MIL,BOS,102,1.5,Blocked Shots,12,8,10,6
Kristaps Porzingis,C,22023,204001,22300528,"JAN 11, 2024",BOS @ MIL,L,21,3,9,0.333,0,3,0.0,0,0,0.0,1,1,2,4,1,1,1,2,6,-27,1,BOS,MIL,BOS,102,8.5,Rebs+Asts,12,8,10,6
Kristaps Porzingis,C,22023,204001,22300528,"JAN 11, 2024",BOS @ MIL,L,21,3,9,0.333,0,3,0.0,0,0,0.0,1,1,2,4,1,1,1,2,6,-27,1,BOS,MIL,BOS,102,1.5,Turnovers,12,8,10,6
Kristaps Porzingis,C,22023,204001,22300507,"JAN 08, 2024",BOS @ IND,L,38,6,13,0.462,1,4,0.25,6,7,0.857,2,3,5,7,0,3,1,2,19,1,1,BOS,IND,BOS,131,18.5,Points,31,24,26,12
Kristaps Porzingis,C,22023,204001,22300507,"JAN 08, 2024",BOS @ IND,L,38,6,13,0.462,1,4,0.25,6,7,0.857,2,3,5,7,0,3,1,2,19,1,1,BOS,IND,BOS,131,7.0,Rebounds,31,24,26,12
Kristaps Porzingis,C,22023,204001,22300507,"JAN 08, 2024",BOS @ IND,L,38,6,13,0.462,1,4,0.25,6,7,0.857,2,3,5,7,0,3,1,2,19,1,1,BOS,IND,BOS,131,27.5,Pts+Rebs+Asts,31,24,26,12
Kristaps Porzingis,C,22023,204001,22300507,"JAN 08, 2024",BOS @ IND,L,38,6,13,0.462,1,4,0.25,6,7,0.857,2,3,5,7,0,3,1,2,19,1,1,BOS,IND,BOS,131,34.0,Fantasy Score,31,24,26,12
Kristaps Porzingis,C,22023,204001,22300507,"JAN 08, 2024",BOS @ IND,L,38,6,13,0.462,1,4,0.25,6,7,0.857,2,3,5,7,0,3,1,2,19,1,1,BOS,IND,BOS,131,25.5,Pts+Rebs,31,24,26,12
Kristaps Porzingis,C,22023,204001,22300507,"JAN 08, 2024",BOS @ IND,L,38,6,13,0.462,1,4,0.25,6,7,0.857,2,3,5,7,0,3,1,2,19,1,1,BOS,IND,BOS,131,1.5,Dunks,31,24,26,12
Kristaps Porzingis,C,22023,204001,22300507,"JAN 08, 2024",BOS @ IND,L,38,6,13,0.462,1,4,0.25,6,7,0.857,2,3,5,7,0,3,1,2,19,1,1,BOS,IND,BOS,131,20.5,Pts+Asts,31,24,26,12
Kristaps Porzingis,C,22023,204001,22300507,"JAN 08, 2024",BOS @ IND,L,38,6,13,0.462,1,4,0.25,6,7,0.857,2,3,5,7,0,3,1,2,19,1,1,BOS,IND,BOS,131,1.5,Blocked Shots,31,24,26,12
Kristaps Porzingis,C,22023,204001,22300507,"JAN 08, 2024",BOS @ IND,L,38,6,13,0.462,1,4,0.25,6,7,0.857,2,3,5,7,0,3,1,2,19,1,1,BOS,IND,BOS,131,8.5,Rebs+Asts,31,24,26,12
Kristaps Porzingis,C,22023,204001,22300507,"JAN 08, 2024",BOS @ IND,L,38,6,13,0.462,1,4,0.25,6,7,0.857,2,3,5,7,0,3,1,2,19,1,1,BOS,IND,BOS,131,1.5,Turnovers,31,24,26,12
Kristaps Porzingis,C,22023,204001,22300493,"JAN 06, 2024",BOS @ IND,W,6,1,2,0.5,0,1,0.0,0,0,0.0,1,2,3,0,1,1,0,0,2,4,1,BOS,IND,BOS,118,18.5,Points,5,5,2,3
Kristaps Porzingis,C,22023,204001,22300493,"JAN 06, 2024",BOS @ IND,W,6,1,2,0.5,0,1,0.0,0,0,0.0,1,2,3,0,1,1,0,0,2,4,1,BOS,IND,BOS,118,7.0,Rebounds,5,5,2,3
Kristaps Porzingis,C,22023,204001,22300493,"JAN 06, 2024",BOS @ IND,W,6,1,2,0.5,0,1,0.0,0,0,0.0,1,2,3,0,1,1,0,0,2,4,1,BOS,IND,BOS,118,27.5,Pts+Rebs+Asts,5,5,2,3
Kristaps Porzingis,C,22023,204001,22300493,"JAN 06, 2024",BOS @ IND,W,6,1,2,0.5,0,1,0.0,0,0,0.0,1,2,3,0,1,1,0,0,2,4,1,BOS,IND,BOS,118,34.0,Fantasy Score,5,5,2,3
Kristaps Porzingis,C,22023,204001,22300493,"JAN 06, 2024",BOS @ IND,W,6,1,2,0.5,0,1,0.0,0,0,0.0,1,2,3,0,1,1,0,0,2,4,1,BOS,IND,BOS,118,25.5,Pts+Rebs,5,5,2,3
Kristaps Porzingis,C,22023,204001,22300493,"JAN 06, 2024",BOS @ IND,W,6,1,2,0.5,0,1,0.0,0,0,0.0,1,2,3,0,1,1,0,0,2,4,1,BOS,IND,BOS,118,1.5,Dunks,5,5,2,3
Kristaps Porzingis,C,22023,204001,22300493,"JAN 06, 2024",BOS @ IND,W,6,1,2,0.5,0,1,0.0,0,0,0.0,1,2,3,0,1,1,0,0,2,4,1,BOS,IND,BOS,118,20.5,Pts+Asts,5,5,2,3
Kristaps Porzingis,C,22023,204001,22300493,"JAN 06, 2024",BOS @ IND,W,6,1,2,0.5,0,1,0.0,0,0,0.0,1,2,3,0,1,1,0,0,2,4,1,BOS,IND,BOS,118,1.5,Blocked Shots,5,5,2,3
Kristaps Porzingis,C,22023,204001,22300493,"JAN 06, 2024",BOS @ IND,W,6,1,2,0.5,0,1,0.0,0,0,0.0,1,2,3,0,1,1,0,0,2,4,1,BOS,IND,BOS,118,8.5,Rebs+Asts,5,5,2,3
Kristaps Porzingis,C,22023,204001,22300493,"JAN 06, 2024",BOS @ IND,W,6,1,2,0.5,0,1,0.0,0,0,0.0,1,2,3,0,1,1,0,0,2,4,1,BOS,IND,BOS,118,1.5,Turnovers,5,5,2,3
Kristaps Porzingis,C,22023,204001,22300479,"JAN 05, 2024",BOS vs. UTA,W,27,4,7,0.571,1,3,0.333,10,12,0.833,0,5,5,2,0,1,1,3,19,18,1,BOS,BOS,UTA,126,18.5,Points,26,24,21,7
Kristaps Porzingis,C,22023,204001,22300479,"JAN 05, 2024",BOS vs. UTA,W,27,4,7,0.571,1,3,0.333,10,12,0.833,0,5,5,2,0,1,1,3,19,18,1,BOS,BOS,UTA,126,7.0,Rebounds,26,24,21,7
Kristaps Porzingis,C,22023,204001,22300479,"JAN 05, 2024",BOS vs. UTA,W,27,4,7,0.571,1,3,0.333,10,12,0.833,0,5,5,2,0,1,1,3,19,18,1,BOS,BOS,UTA,126,27.5,Pts+Rebs+Asts,26,24,21,7
Kristaps Porzingis,C,22023,204001,22300479,"JAN 05, 2024",BOS vs. UTA,W,27,4,7,0.571,1,3,0.333,10,12,0.833,0,5,5,2,0,1,1,3,19,18,1,BOS,BOS,UTA,126,34.0,Fantasy Score,26,24,21,7
Kristaps Porzingis,C,22023,204001,22300479,"JAN 05, 2024",BOS vs. UTA,W,27,4,7,0.571,1,3,0.333,10,12,0.833,0,5,5,2,0,1,1,3,19,18,1,BOS,BOS,UTA,126,25.5,Pts+Rebs,26,24,21,7
Kristaps Porzingis,C,22023,204001,22300479,"JAN 05, 2024",BOS vs. UTA,W,27,4,7,0.571,1,3,0.333,10,12,0.833,0,5,5,2,0,1,1,3,19,18,1,BOS,BOS,UTA,126,1.5,Dunks,26,24,21,7
Kristaps Porzingis,C,22023,204001,22300479,"JAN 05, 2024",BOS vs. UTA,W,27,4,7,0.571,1,3,0.333,10,12,0.833,0,5,5,2,0,1,1,3,19,18,1,BOS,BOS,UTA,126,20.5,Pts+Asts,26,24,21,7
Kristaps Porzingis,C,22023,204001,22300479,"JAN 05, 2024",BOS vs. UTA,W,27,4,7,0.571,1,3,0.333,10,12,0.833,0,5,5,2,0,1,1,3,19,18,1,BOS,BOS,UTA,126,1.5,Blocked Shots,26,24,21,7
Kristaps Porzingis,C,22023,204001,22300479,"JAN 05, 2024",BOS vs. UTA,W,27,4,7,0.571,1,3,0.333,10,12,0.833,0,5,5,2,0,1,1,3,19,18,1,BOS,BOS,UTA,126,8.5,Rebs+Asts,26,24,21,7
Kristaps Porzingis,C,22023,204001,22300479,"JAN 05, 2024",BOS vs. UTA,W,27,4,7,0.571,1,3,0.333,10,12,0.833,0,5,5,2,0,1,1,3,19,18,1,BOS,BOS,UTA,126,1.5,Turnovers,26,24,21,7
Kristaps Porzingis,C,22023,204001,22300448,"DEC 31, 2023",BOS @ SAS,W,30,4,14,0.286,0,7,0.0,6,6,1.0,1,8,9,2,1,2,1,2,14,33,1,BOS,SAS,BOS,134,18.5,Points,25,23,16,11
Kristaps Porzingis,C,22023,204001,22300448,"DEC 31, 2023",BOS @ SAS,W,30,4,14,0.286,0,7,0.0,6,6,1.0,1,8,9,2,1,2,1,2,14,33,1,BOS,SAS,BOS,134,7.0,Rebounds,25,23,16,11
Kristaps Porzingis,C,22023,204001,22300448,"DEC 31, 2023",BOS @ SAS,W,30,4,14,0.286,0,7,0.0,6,6,1.0,1,8,9,2,1,2,1,2,14,33,1,BOS,SAS,BOS,134,27.5,Pts+Rebs+Asts,25,23,16,11
Kristaps Porzingis,C,22023,204001,22300448,"DEC 31, 2023",BOS @ SAS,W,30,4,14,0.286,0,7,0.0,6,6,1.0,1,8,9,2,1,2,1,2,14,33,1,BOS,SAS,BOS,134,34.0,Fantasy Score,25,23,16,11
Kristaps Porzingis,C,22023,204001,22300448,"DEC 31, 2023",BOS @ SAS,W,30,4,14,0.286,0,7,0.0,6,6,1.0,1,8,9,2,1,2,1,2,14,33,1,BOS,SAS,BOS,134,25.5,Pts+Rebs,25,23,16,11
Kristaps Porzingis,C,22023,204001,22300448,"DEC 31, 2023",BOS @ SAS,W,30,4,14,0.286,0,7,0.0,6,6,1.0,1,8,9,2,1,2,1,2,14,33,1,BOS,SAS,BOS,134,1.5,Dunks,25,23,16,11
Kristaps Porzingis,C,22023,204001,22300448,"DEC 31, 2023",BOS @ SAS,W,30,4,14,0.286,0,7,0.0,6,6,1.0,1,8,9,2,1,2,1,2,14,33,1,BOS,SAS,BOS,134,20.5,Pts+Asts,25,23,16,11
Kristaps Porzingis,C,22023,204001,22300448,"DEC 31, 2023",BOS @ SAS,W,30,4,14,0.286,0,7,0.0,6,6,1.0,1,8,9,2,1,2,1,2,14,33,1,BOS,SAS,BOS,134,1.5,Blocked Shots,25,23,16,11
Kristaps Porzingis,C,22023,204001,22300448,"DEC 31, 2023",BOS @ SAS,W,30,4,14,0.286,0,7,0.0,6,6,1.0,1,8,9,2,1,2,1,2,14,33,1,BOS,SAS,BOS,134,8.5,Rebs+Asts,25,23,16,11
Kristaps Porzingis,C,22023,204001,22300448,"DEC 31, 2023",BOS @ SAS,W,30,4,14,0.286,0,7,0.0,6,6,1.0,1,8,9,2,1,2,1,2,14,33,1,BOS,SAS,BOS,134,1.5,Turnovers,25,23,16,11
Kristaps Porzingis,C,22023,204001,22300344,"DEC 17, 2023",BOS vs. ORL,W,29,6,12,0.5,2,4,0.5,1,1,1.0,1,9,10,0,1,1,4,2,15,4,1,BOS,BOS,ORL,114,18.5,Points,25,25,15,10
Kristaps Porzingis,C,22023,204001,22300344,"DEC 17, 2023",BOS vs. ORL,W,29,6,12,0.5,2,4,0.5,1,1,1.0,1,9,10,0,1,1,4,2,15,4,1,BOS,BOS,ORL,114,7.0,Rebounds,25,25,15,10
Kristaps Porzingis,C,22023,204001,22300344,"DEC 17, 2023",BOS vs. ORL,W,29,6,12,0.5,2,4,0.5,1,1,1.0,1,9,10,0,1,1,4,2,15,4,1,BOS,BOS,ORL,114,27.5,Pts+Rebs+Asts,25,25,15,10
Kristaps Porzingis,C,22023,204001,22300344,"DEC 17, 2023",BOS vs. ORL,W,29,6,12,0.5,2,4,0.5,1,1,1.0,1,9,10,0,1,1,4,2,15,4,1,BOS,BOS,ORL,114,34.0,Fantasy Score,25,25,15,10
Kristaps Porzingis,C,22023,204001,22300344,"DEC 17, 2023",BOS vs. ORL,W,29,6,12,0.5,2,4,0.5,1,1,1.0,1,9,10,0,1,1,4,2,15,4,1,BOS,BOS,ORL,114,25.5,Pts+Rebs,25,25,15,10
Kristaps Porzingis,C,22023,204001,22300344,"DEC 17, 2023",BOS vs. ORL,W,29,6,12,0.5,2,4,0.5,1,1,1.0,1,9,10,0,1,1,4,2,15,4,1,BOS,BOS,ORL,114,1.5,Dunks,25,25,15,10
Kristaps Porzingis,C,22023,204001,22300344,"DEC 17, 2023",BOS vs. ORL,W,29,6,12,0.5,2,4,0.5,1,1,1.0,1,9,10,0,1,1,4,2,15,4,1,BOS,BOS,ORL,114,20.5,Pts+Asts,25,25,15,10
Kristaps Porzingis,C,22023,204001,22300344,"DEC 17, 2023",BOS vs. ORL,W,29,6,12,0.5,2,4,0.5,1,1,1.0,1,9,10,0,1,1,4,2,15,4,1,BOS,BOS,ORL,114,1.5,Blocked Shots,25,25,15,10
Kristaps Porzingis,C,22023,204001,22300344,"DEC 17, 2023",BOS vs. ORL,W,29,6,12,0.5,2,4,0.5,1,1,1.0,1,9,10,0,1,1,4,2,15,4,1,BOS,BOS,ORL,114,8.5,Rebs+Asts,25,25,15,10
Kristaps Porzingis,C,22023,204001,22300344,"DEC 17, 2023",BOS vs. ORL,W,29,6,12,0.5,2,4,0.5,1,1,1.0,1,9,10,0,1,1,4,2,15,4,1,BOS,BOS,ORL,114,1.5,Turnovers,25,25,15,10
Kristaps Porzingis,C,22023,204001,22301227,"DEC 08, 2023",BOS vs. NYK,W,29,7,13,0.538,3,6,0.5,4,4,1.0,1,2,3,1,2,0,2,2,21,13,1,BOS,BOS,NYK,133,18.5,Points,25,24,22,4
Kristaps Porzingis,C,22023,204001,22301227,"DEC 08, 2023",BOS vs. NYK,W,29,7,13,0.538,3,6,0.5,4,4,1.0,1,2,3,1,2,0,2,2,21,13,1,BOS,BOS,NYK,133,7.0,Rebounds,25,24,22,4
Kristaps Porzingis,C,22023,204001,22301227,"DEC 08, 2023",BOS vs. NYK,W,29,7,13,0.538,3,6,0.5,4,4,1.0,1,2,3,1,2,0,2,2,21,13,1,BOS,BOS,NYK,133,27.5,Pts+Rebs+Asts,25,24,22,4
Kristaps Porzingis,C,22023,204001,22301227,"DEC 08, 2023",BOS vs. NYK,W,29,7,13,0.538,3,6,0.5,4,4,1.0,1,2,3,1,2,0,2,2,21,13,1,BOS,BOS,NYK,133,34.0,Fantasy Score,25,24,22,4
Kristaps Porzingis,C,22023,204001,22301227,"DEC 08, 2023",BOS vs. NYK,W,29,7,13,0.538,3,6,0.5,4,4,1.0,1,2,3,1,2,0,2,2,21,13,1,BOS,BOS,NYK,133,25.5,Pts+Rebs,25,24,22,4
Kristaps Porzingis,C,22023,204001,22301227,"DEC 08, 2023",BOS vs. NYK,W,29,7,13,0.538,3,6,0.5,4,4,1.0,1,2,3,1,2,0,2,2,21,13,1,BOS,BOS,NYK,133,1.5,Dunks,25,24,22,4
Kristaps Porzingis,C,22023,204001,22301227,"DEC 08, 2023",BOS vs. NYK,W,29,7,13,0.538,3,6,0.5,4,4,1.0,1,2,3,1,2,0,2,2,21,13,1,BOS,BOS,NYK,133,20.5,Pts+Asts,25,24,22,4
Kristaps Porzingis,C,22023,204001,22301227,"DEC 08, 2023",BOS vs. NYK,W,29,7,13,0.538,3,6,0.5,4,4,1.0,1,2,3,1,2,0,2,2,21,13,1,BOS,BOS,NYK,133,1.5,Blocked Shots,25,24,22,4
Kristaps Porzingis,C,22023,204001,22301227,"DEC 08, 2023",BOS vs. NYK,W,29,7,13,0.538,3,6,0.5,4,4,1.0,1,2,3,1,2,0,2,2,21,13,1,BOS,BOS,NYK,133,8.5,Rebs+Asts,25,24,22,4
Kristaps Porzingis,C,22023,204001,22301227,"DEC 08, 2023",BOS vs. NYK,W,29,7,13,0.538,3,6,0.5,4,4,1.0,1,2,3,1,2,0,2,2,21,13,1,BOS,BOS,NYK,133,1.5,Turnovers,25,24,22,4
Kristaps Porzingis,C,22023,204001,22300043,"NOV 24, 2023",BOS @ ORL,L,22,4,9,0.444,1,4,0.25,0,1,0.0,1,3,4,2,2,0,2,3,9,6,1,BOS,ORL,BOS,96,18.5,Points,15,13,11,6
Kristaps Porzingis,C,22023,204001,22300043,"NOV 24, 2023",BOS @ ORL,L,22,4,9,0.444,1,4,0.25,0,1,0.0,1,3,4,2,2,0,2,3,9,6,1,BOS,ORL,BOS,96,7.0,Rebounds,15,13,11,6
Kristaps Porzingis,C,22023,204001,22300043,"NOV 24, 2023",BOS @ ORL,L,22,4,9,0.444,1,4,0.25,0,1,0.0,1,3,4,2,2,0,2,3,9,6,1,BOS,ORL,BOS,96,27.5,Pts+Rebs+Asts,15,13,11,6
Kristaps Porzingis,C,22023,204001,22300043,"NOV 24, 2023",BOS @ ORL,L,22,4,9,0.444,1,4,0.25,0,1,0.0,1,3,4,2,2,0,2,3,9,6,1,BOS,ORL,BOS,96,34.0,Fantasy Score,15,13,11,6
Kristaps Porzingis,C,22023,204001,22300043,"NOV 24, 2023",BOS @ ORL,L,22,4,9,0.444,1,4,0.25,0,1,0.0,1,3,4,2,2,0,2,3,9,6,1,BOS,ORL,BOS,96,25.5,Pts+Rebs,15,13,11,6
Kristaps Porzingis,C,22023,204001,22300043,"NOV 24, 2023",BOS @ ORL,L,22,4,9,0.444,1,4,0.25,0,1,0.0,1,3,4,2,2,0,2,3,9,6,1,BOS,ORL,BOS,96,1.5,Dunks,15,13,11,6
Kristaps Porzingis,C,22023,204001,22300043,"NOV 24, 2023",BOS @ ORL,L,22,4,9,0.444,1,4,0.25,0,1,0.0,1,3,4,2,2,0,2,3,9,6,1,BOS,ORL,BOS,96,20.5,Pts+Asts,15,13,11,6
Kristaps Porzingis,C,22023,204001,22300043,"NOV 24, 2023",BOS @ ORL,L,22,4,9,0.444,1,4,0.25,0,1,0.0,1,3,4,2,2,0,2,3,9,6,1,BOS,ORL,BOS,96,1.5,Blocked Shots,15,13,11,6
Kristaps Porzingis,C,22023,204001,22300043,"NOV 24, 2023",BOS @ ORL,L,22,4,9,0.444,1,4,0.25,0,1,0.0,1,3,4,2,2,0,2,3,9,6,1,BOS,ORL,BOS,96,8.5,Rebs+Asts,15,13,11,6
Kristaps Porzingis,C,22023,204001,22300043,"NOV 24, 2023",BOS @ ORL,L,22,4,9,0.444,1,4,0.25,0,1,0.0,1,3,4,2,2,0,2,3,9,6,1,BOS,ORL,BOS,96,1.5,Turnovers,15,13,11,6
Kristaps Porzingis,C,22023,204001,22300174,"NOV 11, 2023",BOS vs. TOR,W,28,9,14,0.643,3,7,0.429,0,1,0.0,0,7,7,3,0,0,3,1,21,12,1,BOS,BOS,TOR,117,18.5,Points,31,28,24,10
Kristaps Porzingis,C,22023,204001,22300174,"NOV 11, 2023",BOS vs. TOR,W,28,9,14,0.643,3,7,0.429,0,1,0.0,0,7,7,3,0,0,3,1,21,12,1,BOS,BOS,TOR,117,7.0,Rebounds,31,28,24,10
Kristaps Porzingis,C,22023,204001,22300174,"NOV 11, 2023",BOS vs. TOR,W,28,9,14,0.643,3,7,0.429,0,1,0.0,0,7,7,3,0,0,3,1,21,12,1,BOS,BOS,TOR,117,27.5,Pts+Rebs+Asts,31,28,24,10
Kristaps Porzingis,C,22023,204001,22300174,"NOV 11, 2023",BOS vs. TOR,W,28,9,14,0.643,3,7,0.429,0,1,0.0,0,7,7,3,0,0,3,1,21,12,1,BOS,BOS,TOR,117,34.0,Fantasy Score,31,28,24,10
Kristaps Porzingis,C,22023,204001,22300174,"NOV 11, 2023",BOS vs. TOR,W,28,9,14,0.643,3,7,0.429,0,1,0.0,0,7,7,3,0,0,3,1,21,12,1,BOS,BOS,TOR,117,25.5,Pts+Rebs,31,28,24,10
Kristaps Porzingis,C,22023,204001,22300174,"NOV 11, 2023",BOS vs. TOR,W,28,9,14,0.643,3,7,0.429,0,1,0.0,0,7,7,3,0,0,3,1,21,12,1,BOS,BOS,TOR,117,1.5,Dunks,31,28,24,10
Kristaps Porzingis,C,22023,204001,22300174,"NOV 11, 2023",BOS vs. TOR,W,28,9,14,0.643,3,7,0.429,0,1,0.0,0,7,7,3,0,0,3,1,21,12,1,BOS,BOS,TOR,117,20.5,Pts+Asts,31,28,24,10
Kristaps Porzingis,C,22023,204001,22300174,"NOV 11, 2023",BOS vs. TOR,W,28,9,14,0.643,3,7,0.429,0,1,0.0,0,7,7,3,0,0,3,1,21,12,1,BOS,BOS,TOR,117,1.5,Blocked Shots,31,28,24,10
Kristaps Porzingis,C,22023,204001,22300174,"NOV 11, 2023",BOS vs. TOR,W,28,9,14,0.643,3,7,0.429,0,1,0.0,0,7,7,3,0,0,3,1,21,12,1,BOS,BOS,TOR,117,8.5,Rebs+Asts,31,28,24,10
Kristaps Porzingis,C,22023,204001,22300174,"NOV 11, 2023",BOS vs. TOR,W,28,9,14,0.643,3,7,0.429,0,1,0.0,0,7,7,3,0,0,3,1,21,12,1,BOS,BOS,TOR,117,1.5,Turnovers,31,28,24,10
Kristaps Porzingis,C,22023,204001,22300010,"NOV 10, 2023",BOS vs. BKN,W,25,2,4,0.5,0,2,0.0,5,5,1.0,0,2,2,2,0,1,0,2,9,20,1,BOS,BOS,BKN,121,18.5,Points,13,11,11,4
Kristaps Porzingis,C,22023,204001,22300010,"NOV 10, 2023",BOS vs. BKN,W,25,2,4,0.5,0,2,0.0,5,5,1.0,0,2,2,2,0,1,0,2,9,20,1,BOS,BOS,BKN,121,7.0,Rebounds,13,11,11,4
Kristaps Porzingis,C,22023,204001,22300010,"NOV 10, 2023",BOS vs. BKN,W,25,2,4,0.5,0,2,0.0,5,5,1.0,0,2,2,2,0,1,0,2,9,20,1,BOS,BOS,BKN,121,27.5,Pts+Rebs+Asts,13,11,11,4
Kristaps Porzingis,C,22023,204001,22300010,"NOV 10, 2023",BOS vs. BKN,W,25,2,4,0.5,0,2,0.0,5,5,1.0,0,2,2,2,0,1,0,2,9,20,1,BOS,BOS,BKN,121,34.0,Fantasy Score,13,11,11,4
Kristaps Porzingis,C,22023,204001,22300010,"NOV 10, 2023",BOS vs. BKN,W,25,2,4,0.5,0,2,0.0,5,5,1.0,0,2,2,2,0,1,0,2,9,20,1,BOS,BOS,BKN,121,25.5,Pts+Rebs,13,11,11,4
Kristaps Porzingis,C,22023,204001,22300010,"NOV 10, 2023",BOS vs. BKN,W,25,2,4,0.5,0,2,0.0,5,5,1.0,0,2,2,2,0,1,0,2,9,20,1,BOS,BOS,BKN,121,1.5,Dunks,13,11,11,4
Kristaps Porzingis,C,22023,204001,22300010,"NOV 10, 2023",BOS vs. BKN,W,25,2,4,0.5,0,2,0.0,5,5,1.0,0,2,2,2,0,1,0,2,9,20,1,BOS,BOS,BKN,121,20.5,Pts+Asts,13,11,11,4
Kristaps Porzingis,C,22023,204001,22300010,"NOV 10, 2023",BOS vs. BKN,W,25,2,4,0.5,0,2,0.0,5,5,1.0,0,2,2,2,0,1,0,2,9,20,1,BOS,BOS,BKN,121,1.5,Blocked Shots,13,11,11,4
Kristaps Porzingis,C,22023,204001,22300010,"NOV 10, 2023",BOS vs. BKN,W,25,2,4,0.5,0,2,0.0,5,5,1.0,0,2,2,2,0,1,0,2,9,20,1,BOS,BOS,BKN,121,8.5,Rebs+Asts,13,11,11,4
Kristaps Porzingis,C,22023,204001,22300010,"NOV 10, 2023",BOS vs. BKN,W,25,2,4,0.5,0,2,0.0,5,5,1.0,0,2,2,2,0,1,0,2,9,20,1,BOS,BOS,BKN,121,1.5,Turnovers,13,11,11,4
Kristaps Porzingis,C,22023,204001,22300118,"NOV 01, 2023",BOS vs. IND,W,27,3,7,0.429,1,3,0.333,6,6,1.0,1,5,6,2,0,0,2,3,13,27,1,BOS,BOS,IND,155,18.5,Points,21,19,15,8
Kristaps Porzingis,C,22023,204001,22300118,"NOV 01, 2023",BOS vs. IND,W,27,3,7,0.429,1,3,0.333,6,6,1.0,1,5,6,2,0,0,2,3,13,27,1,BOS,BOS,IND,155,7.0,Rebounds,21,19,15,8
Kristaps Porzingis,C,22023,204001,22300118,"NOV 01, 2023",BOS vs. IND,W,27,3,7,0.429,1,3,0.333,6,6,1.0,1,5,6,2,0,0,2,3,13,27,1,BOS,BOS,IND,155,27.5,Pts+Rebs+Asts,21,19,15,8
Kristaps Porzingis,C,22023,204001,22300118,"NOV 01, 2023",BOS vs. IND,W,27,3,7,0.429,1,3,0.333,6,6,1.0,1,5,6,2,0,0,2,3,13,27,1,BOS,BOS,IND,155,34.0,Fantasy Score,21,19,15,8
Kristaps Porzingis,C,22023,204001,22300118,"NOV 01, 2023",BOS vs. IND,W,27,3,7,0.429,1,3,0.333,6,6,1.0,1,5,6,2,0,0,2,3,13,27,1,BOS,BOS,IND,155,25.5,Pts+Rebs,21,19,15,8
Kristaps Porzingis,C,22023,204001,22300118,"NOV 01, 2023",BOS vs. IND,W,27,3,7,0.429,1,3,0.333,6,6,1.0,1,5,6,2,0,0,2,3,13,27,1,BOS,BOS,IND,155,1.5,Dunks,21,19,15,8
Kristaps Porzingis,C,22023,204001,22300118,"NOV 01, 2023",BOS vs. IND,W,27,3,7,0.429,1,3,0.333,6,6,1.0,1,5,6,2,0,0,2,3,13,27,1,BOS,BOS,IND,155,20.5,Pts+Asts,21,19,15,8
Kristaps Porzingis,C,22023,204001,22300118,"NOV 01, 2023",BOS vs. IND,W,27,3,7,0.429,1,3,0.333,6,6,1.0,1,5,6,2,0,0,2,3,13,27,1,BOS,BOS,IND,155,1.5,Blocked Shots,21,19,15,8
Kristaps Porzingis,C,22023,204001,22300118,"NOV 01, 2023",BOS vs. IND,W,27,3,7,0.429,1,3,0.333,6,6,1.0,1,5,6,2,0,0,2,3,13,27,1,BOS,BOS,IND,155,8.5,Rebs+Asts,21,19,15,8
Kristaps Porzingis,C,22023,204001,22300118,"NOV 01, 2023",BOS vs. IND,W,27,3,7,0.429,1,3,0.333,6,6,1.0,1,5,6,2,0,0,2,3,13,27,1,BOS,BOS,IND,155,1.5,Turnovers,21,19,15,8
Kristaps Porzingis,C,22023,204001,22300103,"OCT 30, 2023",BOS @ WAS,W,24,7,9,0.778,1,2,0.5,0,0,0.0,0,6,6,3,0,1,2,2,15,30,1,BOS,WAS,BOS,126,18.5,Points,24,21,18,9
Kristaps Porzingis,C,22023,204001,22300103,"OCT 30, 2023",BOS @ WAS,W,24,7,9,0.778,1,2,0.5,0,0,0.0,0,6,6,3,0,1,2,2,15,30,1,BOS,WAS,BOS,126,7.0,Rebounds,24,21,18,9
Kristaps Porzingis,C,22023,204001,22300103,"OCT 30, 2023",BOS @ WAS,W,24,7,9,0.778,1,2,0.5,0,0,0.0,0,6,6,3,0,1,2,2,15,30,1,BOS,WAS,BOS,126,27.5,Pts+Rebs+Asts,24,21,18,9
Kristaps Porzingis,C,22023,204001,22300103,"OCT 30, 2023",BOS @ WAS,W,24,7,9,0.778,1,2,0.5,0,0,0.0,0,6,6,3,0,1,2,2,15,30,1,BOS,WAS,BOS,126,34.0,Fantasy Score,24,21,18,9
Kristaps Porzingis,C,22023,204001,22300103,"OCT 30, 2023",BOS @ WAS,W,24,7,9,0.778,1,2,0.5,0,0,0.0,0,6,6,3,0,1,2,2,15,30,1,BOS,WAS,BOS,126,25.5,Pts+Rebs,24,21,18,9
Kristaps Porzingis,C,22023,204001,22300103,"OCT 30, 2023",BOS @ WAS,W,24,7,9,0.778,1,2,0.5,0,0,0.0,0,6,6,3,0,1,2,2,15,30,1,BOS,WAS,BOS,126,1.5,Dunks,24,21,18,9
Kristaps Porzingis,C,22023,204001,22300103,"OCT 30, 2023",BOS @ WAS,W,24,7,9,0.778,1,2,0.5,0,0,0.0,0,6,6,3,0,1,2,2,15,30,1,BOS,WAS,BOS,126,20.5,Pts+Asts,24,21,18,9
Kristaps Porzingis,C,22023,204001,22300103,"OCT 30, 2023",BOS @ WAS,W,24,7,9,0.778,1,2,0.5,0,0,0.0,0,6,6,3,0,1,2,2,15,30,1,BOS,WAS,BOS,126,1.5,Blocked Shots,24,21,18,9
Kristaps Porzingis,C,22023,204001,22300103,"OCT 30, 2023",BOS @ WAS,W,24,7,9,0.778,1,2,0.5,0,0,0.0,0,6,6,3,0,1,2,2,15,30,1,BOS,WAS,BOS,126,8.5,Rebs+Asts,24,21,18,9
Kristaps Porzingis,C,22023,204001,22300103,"OCT 30, 2023",BOS @ WAS,W,24,7,9,0.778,1,2,0.5,0,0,0.0,0,6,6,3,0,1,2,2,15,30,1,BOS,WAS,BOS,126,1.5,Turnovers,24,21,18,9
Kristaps Porzingis,C,22023,204001,22300729,"FEB 07, 2024",BOS vs. ATL,W,31,13,19,0.684,2,4,0.5,3,4,0.75,0,3,3,1,0,2,2,2,31,2,1,BOS,BOS,ATL,125,18.5,Points,35,34,32,4
Kristaps Porzingis,C,22023,204001,22300729,"FEB 07, 2024",BOS vs. ATL,W,31,13,19,0.684,2,4,0.5,3,4,0.75,0,3,3,1,0,2,2,2,31,2,1,BOS,BOS,ATL,125,7.0,Rebounds,35,34,32,4
Kristaps Porzingis,C,22023,204001,22300729,"FEB 07, 2024",BOS vs. ATL,W,31,13,19,0.684,2,4,0.5,3,4,0.75,0,3,3,1,0,2,2,2,31,2,1,BOS,BOS,ATL,125,27.5,Pts+Rebs+Asts,35,34,32,4
Kristaps Porzingis,C,22023,204001,22300729,"FEB 07, 2024",BOS vs. ATL,W,31,13,19,0.684,2,4,0.5,3,4,0.75,0,3,3,1,0,2,2,2,31,2,1,BOS,BOS,ATL,125,34.0,Fantasy Score,35,34,32,4
Kristaps Porzingis,C,22023,204001,22300729,"FEB 07, 2024",BOS vs. ATL,W,31,13,19,0.684,2,4,0.5,3,4,0.75,0,3,3,1,0,2,2,2,31,2,1,BOS,BOS,ATL,125,25.5,Pts+Rebs,35,34,32,4
Kristaps Porzingis,C,22023,204001,22300729,"FEB 07, 2024",BOS vs. ATL,W,31,13,19,0.684,2,4,0.5,3,4,0.75,0,3,3,1,0,2,2,2,31,2,1,BOS,BOS,ATL,125,1.5,Dunks,35,34,32,4
Kristaps Porzingis,C,22023,204001,22300729,"FEB 07, 2024",BOS vs. ATL,W,31,13,19,0.684,2,4,0.5,3,4,0.75,0,3,3,1,0,2,2,2,31,2,1,BOS,BOS,ATL,125,20.5,Pts+Asts,35,34,32,4
Kristaps Porzingis,C,22023,204001,22300729,"FEB 07, 2024",BOS vs. ATL,W,31,13,19,0.684,2,4,0.5,3,4,0.75,0,3,3,1,0,2,2,2,31,2,1,BOS,BOS,ATL,125,1.5,Blocked Shots,35,34,32,4
Kristaps Porzingis,C,22023,204001,22300729,"FEB 07, 2024",BOS vs. ATL,W,31,13,19,0.684,2,4,0.5,3,4,0.75,0,3,3,1,0,2,2,2,31,2,1,BOS,BOS,ATL,125,8.5,Rebs+Asts,35,34,32,4
Kristaps Porzingis,C,22023,204001,22300729,"FEB 07, 2024",BOS vs. ATL,W,31,13,19,0.684,2,4,0.5,3,4,0.75,0,3,3,1,0,2,2,2,31,2,1,BOS,BOS,ATL,125,1.5,Turnovers,35,34,32,4
Kristaps Porzingis,C,22023,204001,22300670,"JAN 30, 2024",BOS vs. IND,W,31,6,17,0.353,2,6,0.333,3,4,0.75,4,8,12,2,0,1,4,5,17,-7,1,BOS,BOS,IND,129,18.5,Points,31,29,19,14
Kristaps Porzingis,C,22023,204001,22300670,"JAN 30, 2024",BOS vs. IND,W,31,6,17,0.353,2,6,0.333,3,4,0.75,4,8,12,2,0,1,4,5,17,-7,1,BOS,BOS,IND,129,7.0,Rebounds,31,29,19,14
Kristaps Porzingis,C,22023,204001,22300670,"JAN 30, 2024",BOS vs. IND,W,31,6,17,0.353,2,6,0.333,3,4,0.75,4,8,12,2,0,1,4,5,17,-7,1,BOS,BOS,IND,129,27.5,Pts+Rebs+Asts,31,29,19,14
Kristaps Porzingis,C,22023,204001,22300670,"JAN 30, 2024",BOS vs. IND,W,31,6,17,0.353,2,6,0.333,3,4,0.75,4,8,12,2,0,1,4,5,17,-7,1,BOS,BOS,IND,129,34.0,Fantasy Score,31,29,19,14
Kristaps Porzingis,C,22023,204001,22300670,"JAN 30, 2024",BOS vs. IND,W,31,6,17,0.353,2,6,0.333,3,4,0.75,4,8,12,2,0,1,4,5,17,-7,1,BOS,BOS,IND,129,25.5,Pts+Rebs,31,29,19,14
Kristaps Porzingis,C,22023,204001,22300670,"JAN 30, 2024",BOS vs. IND,W,31,6,17,0.353,2,6,0.333,3,4,0.75,4,8,12,2,0,1,4,5,17,-7,1,BOS,BOS,IND,129,1.5,Dunks,31,29,19,14
Kristaps Porzingis,C,22023,204001,22300670,"JAN 30, 2024",BOS vs. IND,W,31,6,17,0.353,2,6,0.333,3,4,0.75,4,8,12,2,0,1,4,5,17,-7,1,BOS,BOS,IND,129,20.5,Pts+Asts,31,29,19,14
Kristaps Porzingis,C,22023,204001,22300670,"JAN 30, 2024",BOS vs. IND,W,31,6,17,0.353,2,6,0.333,3,4,0.75,4,8,12,2,0,1,4,5,17,-7,1,BOS,BOS,IND,129,1.5,Blocked Shots,31,29,19,14
Kristaps Porzingis,C,22023,204001,22300670,"JAN 30, 2024",BOS vs. IND,W,31,6,17,0.353,2,6,0.333,3,4,0.75,4,8,12,2,0,1,4,5,17,-7,1,BOS,BOS,IND,129,8.5,Rebs+Asts,31,29,19,14
Kristaps Porzingis,C,22023,204001,22300670,"JAN 30, 2024",BOS vs. IND,W,31,6,17,0.353,2,6,0.333,3,4,0.75,4,8,12,2,0,1,4,5,17,-7,1,BOS,BOS,IND,129,1.5,Turnovers,31,29,19,14
Kristaps Porzingis,C,22023,204001,22300603,"JAN 21, 2024",BOS @ HOU,W,33,11,21,0.524,6,11,0.545,4,4,1.0,4,2,6,1,1,5,3,5,32,18,1,BOS,HOU,BOS,116,18.5,Points,39,38,33,7
Kristaps Porzingis,C,22023,204001,22300603,"JAN 21, 2024",BOS @ HOU,W,33,11,21,0.524,6,11,0.545,4,4,1.0,4,2,6,1,1,5,3,5,32,18,1,BOS,HOU,BOS,116,7.0,Rebounds,39,38,33,7
Kristaps Porzingis,C,22023,204001,22300603,"JAN 21, 2024",BOS @ HOU,W,33,11,21,0.524,6,11,0.545,4,4,1.0,4,2,6,1,1,5,3,5,32,18,1,BOS,HOU,BOS,116,27.5,Pts+Rebs+Asts,39,38,33,7
Kristaps Porzingis,C,22023,204001,22300603,"JAN 21, 2024",BOS @ HOU,W,33,11,21,0.524,6,11,0.545,4,4,1.0,4,2,6,1,1,5,3,5,32,18,1,BOS,HOU,BOS,116,34.0,Fantasy Score,39,38,33,7
Kristaps Porzingis,C,22023,204001,22300603,"JAN 21, 2024",BOS @ HOU,W,33,11,21,0.524,6,11,0.545,4,4,1.0,4,2,6,1,1,5,3,5,32,18,1,BOS,HOU,BOS,116,25.5,Pts+Rebs,39,38,33,7
Kristaps Porzingis,C,22023,204001,22300603,"JAN 21, 2024",BOS @ HOU,W,33,11,21,0.524,6,11,0.545,4,4,1.0,4,2,6,1,1,5,3,5,32,18,1,BOS,HOU,BOS,116,1.5,Dunks,39,38,33,7
Kristaps Porzingis,C,22023,204001,22300603,"JAN 21, 2024",BOS @ HOU,W,33,11,21,0.524,6,11,0.545,4,4,1.0,4,2,6,1,1,5,3,5,32,18,1,BOS,HOU,BOS,116,20.5,Pts+Asts,39,38,33,7
Kristaps Porzingis,C,22023,204001,22300603,"JAN 21, 2024",BOS @ HOU,W,33,11,21,0.524,6,11,0.545,4,4,1.0,4,2,6,1,1,5,3,5,32,18,1,BOS,HOU,BOS,116,1.5,Blocked Shots,39,38,33,7
Kristaps Porzingis,C,22023,204001,22300603,"JAN 21, 2024",BOS @ HOU,W,33,11,21,0.524,6,11,0.545,4,4,1.0,4,2,6,1,1,5,3,5,32,18,1,BOS,HOU,BOS,116,8.5,Rebs+Asts,39,38,33,7
Kristaps Porzingis,C,22023,204001,22300603,"JAN 21, 2024",BOS @ HOU,W,33,11,21,0.524,6,11,0.545,4,4,1.0,4,2,6,1,1,5,3,5,32,18,1,BOS,HOU,BOS,116,1.5,Turnovers,39,38,33,7
Kristaps Porzingis,C,22023,204001,22300563,"JAN 15, 2024",BOS @ TOR,W,32,2,6,0.333,1,4,0.25,10,12,0.833,0,6,6,2,0,2,6,4,15,2,1,BOS,TOR,BOS,105,18.5,Points,23,21,17,8
Kristaps Porzingis,C,22023,204001,22300563,"JAN 15, 2024",BOS @ TOR,W,32,2,6,0.333,1,4,0.25,10,12,0.833,0,6,6,2,0,2,6,4,15,2,1,BOS,TOR,BOS,105,7.0,Rebounds,23,21,17,8
Kristaps Porzingis,C,22023,204001,22300563,"JAN 15, 2024",BOS @ TOR,W,32,2,6,0.333,1,4,0.25,10,12,0.833,0,6,6,2,0,2,6,4,15,2,1,BOS,TOR,BOS,105,27.5,Pts+Rebs+Asts,23,21,17,8
Kristaps Porzingis,C,22023,204001,22300563,"JAN 15, 2024",BOS @ TOR,W,32,2,6,0.333,1,4,0.25,10,12,0.833,0,6,6,2,0,2,6,4,15,2,1,BOS,TOR,BOS,105,34.0,Fantasy Score,23,21,17,8
Kristaps Porzingis,C,22023,204001,22300563,"JAN 15, 2024",BOS @ TOR,W,32,2,6,0.333,1,4,0.25,10,12,0.833,0,6,6,2,0,2,6,4,15,2,1,BOS,TOR,BOS,105,25.5,Pts+Rebs,23,21,17,8
Kristaps Porzingis,C,22023,204001,22300563,"JAN 15, 2024",BOS @ TOR,W,32,2,6,0.333,1,4,0.25,10,12,0.833,0,6,6,2,0,2,6,4,15,2,1,BOS,TOR,BOS,105,1.5,Dunks,23,21,17,8
Kristaps Porzingis,C,22023,204001,22300563,"JAN 15, 2024",BOS @ TOR,W,32,2,6,0.333,1,4,0.25,10,12,0.833,0,6,6,2,0,2,6,4,15,2,1,BOS,TOR,BOS,105,20.5,Pts+Asts,23,21,17,8
Kristaps Porzingis,C,22023,204001,22300563,"JAN 15, 2024",BOS @ TOR,W,32,2,6,0.333,1,4,0.25,10,12,0.833,0,6,6,2,0,2,6,4,15,2,1,BOS,TOR,BOS,105,1.5,Blocked Shots,23,21,17,8
Kristaps Porzingis,C,22023,204001,22300563,"JAN 15, 2024",BOS @ TOR,W,32,2,6,0.333,1,4,0.25,10,12,0.833,0,6,6,2,0,2,6,4,15,2,1,BOS,TOR,BOS,105,8.5,Rebs+Asts,23,21,17,8
Kristaps Porzingis,C,22023,204001,22300563,"JAN 15, 2024",BOS @ TOR,W,32,2,6,0.333,1,4,0.25,10,12,0.833,0,6,6,2,0,2,6,4,15,2,1,BOS,TOR,BOS,105,1.5,Turnovers,23,21,17,8
Kristaps Porzingis,C,22023,204001,22300542,"JAN 13, 2024",BOS vs. HOU,W,28,6,11,0.545,3,5,0.6,2,2,1.0,1,6,7,5,1,3,2,3,17,24,1,BOS,BOS,HOU,145,18.5,Points,29,24,22,12
Kristaps Porzingis,C,22023,204001,22300542,"JAN 13, 2024",BOS vs. HOU,W,28,6,11,0.545,3,5,0.6,2,2,1.0,1,6,7,5,1,3,2,3,17,24,1,BOS,BOS,HOU,145,7.0,Rebounds,29,24,22,12
Kristaps Porzingis,C,22023,204001,22300542,"JAN 13, 2024",BOS vs. HOU,W,28,6,11,0.545,3,5,0.6,2,2,1.0,1,6,7,5,1,3,2,3,17,24,1,BOS,BOS,HOU,145,27.5,Pts+Rebs+Asts,29,24,22,12
Kristaps Porzingis,C,22023,204001,22300542,"JAN 13, 2024",BOS vs. HOU,W,28,6,11,0.545,3,5,0.6,2,2,1.0,1,6,7,5,1,3,2,3,17,24,1,BOS,BOS,HOU,145,34.0,Fantasy Score,29,24,22,12
Kristaps Porzingis,C,22023,204001,22300542,"JAN 13, 2024",BOS vs. HOU,W,28,6,11,0.545,3,5,0.6,2,2,1.0,1,6,7,5,1,3,2,3,17,24,1,BOS,BOS,HOU,145,25.5,Pts+Rebs,29,24,22,12
Kristaps Porzingis,C,22023,204001,22300542,"JAN 13, 2024",BOS vs. HOU,W,28,6,11,0.545,3,5,0.6,2,2,1.0,1,6,7,5,1,3,2,3,17,24,1,BOS,BOS,HOU,145,1.5,Dunks,29,24,22,12
Kristaps Porzingis,C,22023,204001,22300542,"JAN 13, 2024",BOS vs. HOU,W,28,6,11,0.545,3,5,0.6,2,2,1.0,1,6,7,5,1,3,2,3,17,24,1,BOS,BOS,HOU,145,20.5,Pts+Asts,29,24,22,12
Kristaps Porzingis,C,22023,204001,22300542,"JAN 13, 2024",BOS vs. HOU,W,28,6,11,0.545,3,5,0.6,2,2,1.0,1,6,7,5,1,3,2,3,17,24,1,BOS,BOS,HOU,145,1.5,Blocked Shots,29,24,22,12
Kristaps Porzingis,C,22023,204001,22300542,"JAN 13, 2024",BOS vs. HOU,W,28,6,11,0.545,3,5,0.6,2,2,1.0,1,6,7,5,1,3,2,3,17,24,1,BOS,BOS,HOU,145,8.5,Rebs+Asts,29,24,22,12
Kristaps Porzingis,C,22023,204001,22300542,"JAN 13, 2024",BOS vs. HOU,W,28,6,11,0.545,3,5,0.6,2,2,1.0,1,6,7,5,1,3,2,3,17,24,1,BOS,BOS,HOU,145,1.5,Turnovers,29,24,22,12
Kristaps Porzingis,C,22023,204001,22300421,"DEC 28, 2023",BOS vs. DET,W,36,13,21,0.619,3,9,0.333,6,7,0.857,0,8,8,1,1,0,1,4,35,12,1,BOS,BOS,DET,128,18.5,Points,44,43,36,9
Kristaps Porzingis,C,22023,204001,22300421,"DEC 28, 2023",BOS vs. DET,W,36,13,21,0.619,3,9,0.333,6,7,0.857,0,8,8,1,1,0,1,4,35,12,1,BOS,BOS,DET,128,7.0,Rebounds,44,43,36,9
Kristaps Porzingis,C,22023,204001,22300421,"DEC 28, 2023",BOS vs. DET,W,36,13,21,0.619,3,9,0.333,6,7,0.857,0,8,8,1,1,0,1,4,35,12,1,BOS,BOS,DET,128,27.5,Pts+Rebs+Asts,44,43,36,9
Kristaps Porzingis,C,22023,204001,22300421,"DEC 28, 2023",BOS vs. DET,W,36,13,21,0.619,3,9,0.333,6,7,0.857,0,8,8,1,1,0,1,4,35,12,1,BOS,BOS,DET,128,34.0,Fantasy Score,44,43,36,9
Kristaps Porzingis,C,22023,204001,22300421,"DEC 28, 2023",BOS vs. DET,W,36,13,21,0.619,3,9,0.333,6,7,0.857,0,8,8,1,1,0,1,4,35,12,1,BOS,BOS,DET,128,25.5,Pts+Rebs,44,43,36,9
Kristaps Porzingis,C,22023,204001,22300421,"DEC 28, 2023",BOS vs. DET,W,36,13,21,0.619,3,9,0.333,6,7,0.857,0,8,8,1,1,0,1,4,35,12,1,BOS,BOS,DET,128,1.5,Dunks,44,43,36,9
Kristaps Porzingis,C,22023,204001,22300421,"DEC 28, 2023",BOS vs. DET,W,36,13,21,0.619,3,9,0.333,6,7,0.857,0,8,8,1,1,0,1,4,35,12,1,BOS,BOS,DET,128,20.5,Pts+Asts,44,43,36,9
Kristaps Porzingis,C,22023,204001,22300421,"DEC 28, 2023",BOS vs. DET,W,36,13,21,0.619,3,9,0.333,6,7,0.857,0,8,8,1,1,0,1,4,35,12,1,BOS,BOS,DET,128,1.5,Blocked Shots,44,43,36,9
Kristaps Porzingis,C,22023,204001,22300421,"DEC 28, 2023",BOS vs. DET,W,36,13,21,0.619,3,9,0.333,6,7,0.857,0,8,8,1,1,0,1,4,35,12,1,BOS,BOS,DET,128,8.5,Rebs+Asts,44,43,36,9
Kristaps Porzingis,C,22023,204001,22300421,"DEC 28, 2023",BOS vs. DET,W,36,13,21,0.619,3,9,0.333,6,7,0.857,0,8,8,1,1,0,1,4,35,12,1,BOS,BOS,DET,128,1.5,Turnovers,44,43,36,9
Kristaps Porzingis,C,22023,204001,22300373,"DEC 20, 2023",BOS @ SAC,W,29,7,11,0.636,3,4,0.75,7,8,0.875,2,7,9,2,0,6,3,3,24,22,1,BOS,SAC,BOS,144,18.5,Points,35,33,26,11
Kristaps Porzingis,C,22023,204001,22300373,"DEC 20, 2023",BOS @ SAC,W,29,7,11,0.636,3,4,0.75,7,8,0.875,2,7,9,2,0,6,3,3,24,22,1,BOS,SAC,BOS,144,7.0,Rebounds,35,33,26,11
Kristaps Porzingis,C,22023,204001,22300373,"DEC 20, 2023",BOS @ SAC,W,29,7,11,0.636,3,4,0.75,7,8,0.875,2,7,9,2,0,6,3,3,24,22,1,BOS,SAC,BOS,144,27.5,Pts+Rebs+Asts,35,33,26,11
Kristaps Porzingis,C,22023,204001,22300373,"DEC 20, 2023",BOS @ SAC,W,29,7,11,0.636,3,4,0.75,7,8,0.875,2,7,9,2,0,6,3,3,24,22,1,BOS,SAC,BOS,144,34.0,Fantasy Score,35,33,26,11
Kristaps Porzingis,C,22023,204001,22300373,"DEC 20, 2023",BOS @ SAC,W,29,7,11,0.636,3,4,0.75,7,8,0.875,2,7,9,2,0,6,3,3,24,22,1,BOS,SAC,BOS,144,25.5,Pts+Rebs,35,33,26,11
Kristaps Porzingis,C,22023,204001,22300373,"DEC 20, 2023",BOS @ SAC,W,29,7,11,0.636,3,4,0.75,7,8,0.875,2,7,9,2,0,6,3,3,24,22,1,BOS,SAC,BOS,144,1.5,Dunks,35,33,26,11
Kristaps Porzingis,C,22023,204001,22300373,"DEC 20, 2023",BOS @ SAC,W,29,7,11,0.636,3,4,0.75,7,8,0.875,2,7,9,2,0,6,3,3,24,22,1,BOS,SAC,BOS,144,20.5,Pts+Asts,35,33,26,11
Kristaps Porzingis,C,22023,204001,22300373,"DEC 20, 2023",BOS @ SAC,W,29,7,11,0.636,3,4,0.75,7,8,0.875,2,7,9,2,0,6,3,3,24,22,1,BOS,SAC,BOS,144,1.5,Blocked Shots,35,33,26,11
Kristaps Porzingis,C,22023,204001,22300373,"DEC 20, 2023",BOS @ SAC,W,29,7,11,0.636,3,4,0.75,7,8,0.875,2,7,9,2,0,6,3,3,24,22,1,BOS,SAC,BOS,144,8.5,Rebs+Asts,35,33,26,11
Kristaps Porzingis,C,22023,204001,22300373,"DEC 20, 2023",BOS @ SAC,W,29,7,11,0.636,3,4,0.75,7,8,0.875,2,7,9,2,0,6,3,3,24,22,1,BOS,SAC,BOS,144,1.5,Turnovers,35,33,26,11
Kristaps Porzingis,C,22023,204001,22300217,"NOV 20, 2023",BOS @ CHA,L,34,5,14,0.357,1,8,0.125,6,10,0.6,3,5,8,0,2,3,0,2,17,-26,1,BOS,CHA,BOS,118,18.5,Points,25,25,17,8
Kristaps Porzingis,C,22023,204001,22300217,"NOV 20, 2023",BOS @ CHA,L,34,5,14,0.357,1,8,0.125,6,10,0.6,3,5,8,0,2,3,0,2,17,-26,1,BOS,CHA,BOS,118,7.0,Rebounds,25,25,17,8
Kristaps Porzingis,C,22023,204001,22300217,"NOV 20, 2023",BOS @ CHA,L,34,5,14,0.357,1,8,0.125,6,10,0.6,3,5,8,0,2,3,0,2,17,-26,1,BOS,CHA,BOS,118,27.5,Pts+Rebs+Asts,25,25,17,8
Kristaps Porzingis,C,22023,204001,22300217,"NOV 20, 2023",BOS @ CHA,L,34,5,14,0.357,1,8,0.125,6,10,0.6,3,5,8,0,2,3,0,2,17,-26,1,BOS,CHA,BOS,118,34.0,Fantasy Score,25,25,17,8
Kristaps Porzingis,C,22023,204001,22300217,"NOV 20, 2023",BOS @ CHA,L,34,5,14,0.357,1,8,0.125,6,10,0.6,3,5,8,0,2,3,0,2,17,-26,1,BOS,CHA,BOS,118,25.5,Pts+Rebs,25,25,17,8
Kristaps Porzingis,C,22023,204001,22300217,"NOV 20, 2023",BOS @ CHA,L,34,5,14,0.357,1,8,0.125,6,10,0.6,3,5,8,0,2,3,0,2,17,-26,1,BOS,CHA,BOS,118,1.5,Dunks,25,25,17,8
Kristaps Porzingis,C,22023,204001,22300217,"NOV 20, 2023",BOS @ CHA,L,34,5,14,0.357,1,8,0.125,6,10,0.6,3,5,8,0,2,3,0,2,17,-26,1,BOS,CHA,BOS,118,20.5,Pts+Asts,25,25,17,8
Kristaps Porzingis,C,22023,204001,22300217,"NOV 20, 2023",BOS @ CHA,L,34,5,14,0.357,1,8,0.125,6,10,0.6,3,5,8,0,2,3,0,2,17,-26,1,BOS,CHA,BOS,118,1.5,Blocked Shots,25,25,17,8
Kristaps Porzingis,C,22023,204001,22300217,"NOV 20, 2023",BOS @ CHA,L,34,5,14,0.357,1,8,0.125,6,10,0.6,3,5,8,0,2,3,0,2,17,-26,1,BOS,CHA,BOS,118,8.5,Rebs+Asts,25,25,17,8
Kristaps Porzingis,C,22023,204001,22300217,"NOV 20, 2023",BOS @ CHA,L,34,5,14,0.357,1,8,0.125,6,10,0.6,3,5,8,0,2,3,0,2,17,-26,1,BOS,CHA,BOS,118,1.5,Turnovers,25,25,17,8
Kristaps Porzingis,C,22023,204001,22300136,"NOV 04, 2023",BOS @ BKN,W,30,8,10,0.8,1,2,0.5,5,8,0.625,2,5,7,1,0,3,1,2,22,4,1,BOS,BKN,BOS,124,18.5,Points,30,29,23,8
Kristaps Porzingis,C,22023,204001,22300136,"NOV 04, 2023",BOS @ BKN,W,30,8,10,0.8,1,2,0.5,5,8,0.625,2,5,7,1,0,3,1,2,22,4,1,BOS,BKN,BOS,124,7.0,Rebounds,30,29,23,8
Kristaps Porzingis,C,22023,204001,22300136,"NOV 04, 2023",BOS @ BKN,W,30,8,10,0.8,1,2,0.5,5,8,0.625,2,5,7,1,0,3,1,2,22,4,1,BOS,BKN,BOS,124,27.5,Pts+Rebs+Asts,30,29,23,8
Kristaps Porzingis,C,22023,204001,22300136,"NOV 04, 2023",BOS @ BKN,W,30,8,10,0.8,1,2,0.5,5,8,0.625,2,5,7,1,0,3,1,2,22,4,1,BOS,BKN,BOS,124,34.0,Fantasy Score,30,29,23,8
Kristaps Porzingis,C,22023,204001,22300136,"NOV 04, 2023",BOS @ BKN,W,30,8,10,0.8,1,2,0.5,5,8,0.625,2,5,7,1,0,3,1,2,22,4,1,BOS,BKN,BOS,124,25.5,Pts+Rebs,30,29,23,8
Kristaps Porzingis,C,22023,204001,22300136,"NOV 04, 2023",BOS @ BKN,W,30,8,10,0.8,1,2,0.5,5,8,0.625,2,5,7,1,0,3,1,2,22,4,1,BOS,BKN,BOS,124,1.5,Dunks,30,29,23,8
Kristaps Porzingis,C,22023,204001,22300136,"NOV 04, 2023",BOS @ BKN,W,30,8,10,0.8,1,2,0.5,5,8,0.625,2,5,7,1,0,3,1,2,22,4,1,BOS,BKN,BOS,124,20.5,Pts+Asts,30,29,23,8
Kristaps Porzingis,C,22023,204001,22300136,"NOV 04, 2023",BOS @ BKN,W,30,8,10,0.8,1,2,0.5,5,8,0.625,2,5,7,1,0,3,1,2,22,4,1,BOS,BKN,BOS,124,1.5,Blocked Shots,30,29,23,8
Kristaps Porzingis,C,22023,204001,22300136,"NOV 04, 2023",BOS @ BKN,W,30,8,10,0.8,1,2,0.5,5,8,0.625,2,5,7,1,0,3,1,2,22,4,1,BOS,BKN,BOS,124,8.5,Rebs+Asts,30,29,23,8
Kristaps Porzingis,C,22023,204001,22300136,"NOV 04, 2023",BOS @ BKN,W,30,8,10,0.8,1,2,0.5,5,8,0.625,2,5,7,1,0,3,1,2,22,4,1,BOS,BKN,BOS,124,1.5,Turnovers,30,29,23,8
Kristaps Porzingis,C,22023,204001,22300080,"OCT 27, 2023",BOS vs. MIA,W,30,6,12,0.5,2,6,0.333,3,4,0.75,3,6,9,1,3,1,1,6,17,-12,1,BOS,BOS,MIA,119,18.5,Points,27,26,18,10
Kristaps Porzingis,C,22023,204001,22300080,"OCT 27, 2023",BOS vs. MIA,W,30,6,12,0.5,2,6,0.333,3,4,0.75,3,6,9,1,3,1,1,6,17,-12,1,BOS,BOS,MIA,119,7.0,Rebounds,27,26,18,10
Kristaps Porzingis,C,22023,204001,22300080,"OCT 27, 2023",BOS vs. MIA,W,30,6,12,0.5,2,6,0.333,3,4,0.75,3,6,9,1,3,1,1,6,17,-12,1,BOS,BOS,MIA,119,27.5,Pts+Rebs+Asts,27,26,18,10
Kristaps Porzingis,C,22023,204001,22300080,"OCT 27, 2023",BOS vs. MIA,W,30,6,12,0.5,2,6,0.333,3,4,0.75,3,6,9,1,3,1,1,6,17,-12,1,BOS,BOS,MIA,119,34.0,Fantasy Score,27,26,18,10
Kristaps Porzingis,C,22023,204001,22300080,"OCT 27, 2023",BOS vs. MIA,W,30,6,12,0.5,2,6,0.333,3,4,0.75,3,6,9,1,3,1,1,6,17,-12,1,BOS,BOS,MIA,119,25.5,Pts+Rebs,27,26,18,10
Kristaps Porzingis,C,22023,204001,22300080,"OCT 27, 2023",BOS vs. MIA,W,30,6,12,0.5,2,6,0.333,3,4,0.75,3,6,9,1,3,1,1,6,17,-12,1,BOS,BOS,MIA,119,1.5,Dunks,27,26,18,10
Kristaps Porzingis,C,22023,204001,22300080,"OCT 27, 2023",BOS vs. MIA,W,30,6,12,0.5,2,6,0.333,3,4,0.75,3,6,9,1,3,1,1,6,17,-12,1,BOS,BOS,MIA,119,20.5,Pts+Asts,27,26,18,10
Kristaps Porzingis,C,22023,204001,22300080,"OCT 27, 2023",BOS vs. MIA,W,30,6,12,0.5,2,6,0.333,3,4,0.75,3,6,9,1,3,1,1,6,17,-12,1,BOS,BOS,MIA,119,1.5,Blocked Shots,27,26,18,10
Kristaps Porzingis,C,22023,204001,22300080,"OCT 27, 2023",BOS vs. MIA,W,30,6,12,0.5,2,6,0.333,3,4,0.75,3,6,9,1,3,1,1,6,17,-12,1,BOS,BOS,MIA,119,8.5,Rebs+Asts,27,26,18,10
Kristaps Porzingis,C,22023,204001,22300080,"OCT 27, 2023",BOS vs. MIA,W,30,6,12,0.5,2,6,0.333,3,4,0.75,3,6,9,1,3,1,1,6,17,-12,1,BOS,BOS,MIA,119,1.5,Turnovers,27,26,18,10
Kristaps Porzingis,C,22023,204001,22300743,"FEB 09, 2024",BOS vs. WAS,W,33,9,18,0.5,2,4,0.5,14,14,1.0,2,9,11,0,0,1,3,3,34,8,1,BOS,BOS,WAS,133,18.5,Points,45,45,34,11
Kristaps Porzingis,C,22023,204001,22300743,"FEB 09, 2024",BOS vs. WAS,W,33,9,18,0.5,2,4,0.5,14,14,1.0,2,9,11,0,0,1,3,3,34,8,1,BOS,BOS,WAS,133,7.0,Rebounds,45,45,34,11
Kristaps Porzingis,C,22023,204001,22300743,"FEB 09, 2024",BOS vs. WAS,W,33,9,18,0.5,2,4,0.5,14,14,1.0,2,9,11,0,0,1,3,3,34,8,1,BOS,BOS,WAS,133,27.5,Pts+Rebs+Asts,45,45,34,11
Kristaps Porzingis,C,22023,204001,22300743,"FEB 09, 2024",BOS vs. WAS,W,33,9,18,0.5,2,4,0.5,14,14,1.0,2,9,11,0,0,1,3,3,34,8,1,BOS,BOS,WAS,133,34.0,Fantasy Score,45,45,34,11
Kristaps Porzingis,C,22023,204001,22300743,"FEB 09, 2024",BOS vs. WAS,W,33,9,18,0.5,2,4,0.5,14,14,1.0,2,9,11,0,0,1,3,3,34,8,1,BOS,BOS,WAS,133,25.5,Pts+Rebs,45,45,34,11
Kristaps Porzingis,C,22023,204001,22300743,"FEB 09, 2024",BOS vs. WAS,W,33,9,18,0.5,2,4,0.5,14,14,1.0,2,9,11,0,0,1,3,3,34,8,1,BOS,BOS,WAS,133,1.5,Dunks,45,45,34,11
Kristaps Porzingis,C,22023,204001,22300743,"FEB 09, 2024",BOS vs. WAS,W,33,9,18,0.5,2,4,0.5,14,14,1.0,2,9,11,0,0,1,3,3,34,8,1,BOS,BOS,WAS,133,20.5,Pts+Asts,45,45,34,11
Kristaps Porzingis,C,22023,204001,22300743,"FEB 09, 2024",BOS vs. WAS,W,33,9,18,0.5,2,4,0.5,14,14,1.0,2,9,11,0,0,1,3,3,34,8,1,BOS,BOS,WAS,133,1.5,Blocked Shots,45,45,34,11
Kristaps Porzingis,C,22023,204001,22300743,"FEB 09, 2024",BOS vs. WAS,W,33,9,18,0.5,2,4,0.5,14,14,1.0,2,9,11,0,0,1,3,3,34,8,1,BOS,BOS,WAS,133,8.5,Rebs+Asts,45,45,34,11
Kristaps Porzingis,C,22023,204001,22300743,"FEB 09, 2024",BOS vs. WAS,W,33,9,18,0.5,2,4,0.5,14,14,1.0,2,9,11,0,0,1,3,3,34,8,1,BOS,BOS,WAS,133,1.5,Turnovers,45,45,34,11
Kristaps Porzingis,C,22023,204001,22300586,"JAN 19, 2024",BOS vs. DEN,L,36,6,11,0.545,3,5,0.6,6,8,0.75,4,4,8,2,0,1,0,4,21,2,1,BOS,BOS,DEN,100,18.5,Points,31,29,23,10
Kristaps Porzingis,C,22023,204001,22300586,"JAN 19, 2024",BOS vs. DEN,L,36,6,11,0.545,3,5,0.6,6,8,0.75,4,4,8,2,0,1,0,4,21,2,1,BOS,BOS,DEN,100,7.0,Rebounds,31,29,23,10
Kristaps Porzingis,C,22023,204001,22300586,"JAN 19, 2024",BOS vs. DEN,L,36,6,11,0.545,3,5,0.6,6,8,0.75,4,4,8,2,0,1,0,4,21,2,1,BOS,BOS,DEN,100,27.5,Pts+Rebs+Asts,31,29,23,10
Kristaps Porzingis,C,22023,204001,22300586,"JAN 19, 2024",BOS vs. DEN,L,36,6,11,0.545,3,5,0.6,6,8,0.75,4,4,8,2,0,1,0,4,21,2,1,BOS,BOS,DEN,100,34.0,Fantasy Score,31,29,23,10
Kristaps Porzingis,C,22023,204001,22300586,"JAN 19, 2024",BOS vs. DEN,L,36,6,11,0.545,3,5,0.6,6,8,0.75,4,4,8,2,0,1,0,4,21,2,1,BOS,BOS,DEN,100,25.5,Pts+Rebs,31,29,23,10
Kristaps Porzingis,C,22023,204001,22300586,"JAN 19, 2024",BOS vs. DEN,L,36,6,11,0.545,3,5,0.6,6,8,0.75,4,4,8,2,0,1,0,4,21,2,1,BOS,BOS,DEN,100,1.5,Dunks,31,29,23,10
Kristaps Porzingis,C,22023,204001,22300586,"JAN 19, 2024",BOS vs. DEN,L,36,6,11,0.545,3,5,0.6,6,8,0.75,4,4,8,2,0,1,0,4,21,2,1,BOS,BOS,DEN,100,20.5,Pts+Asts,31,29,23,10
Kristaps Porzingis,C,22023,204001,22300586,"JAN 19, 2024",BOS vs. DEN,L,36,6,11,0.545,3,5,0.6,6,8,0.75,4,4,8,2,0,1,0,4,21,2,1,BOS,BOS,DEN,100,1.5,Blocked Shots,31,29,23,10
Kristaps Porzingis,C,22023,204001,22300586,"JAN 19, 2024",BOS vs. DEN,L,36,6,11,0.545,3,5,0.6,6,8,0.75,4,4,8,2,0,1,0,4,21,2,1,BOS,BOS,DEN,100,8.5,Rebs+Asts,31,29,23,10
Kristaps Porzingis,C,22023,204001,22300586,"JAN 19, 2024",BOS vs. DEN,L,36,6,11,0.545,3,5,0.6,6,8,0.75,4,4,8,2,0,1,0,4,21,2,1,BOS,BOS,DEN,100,1.5,Turnovers,31,29,23,10
Kristaps Porzingis,C,22023,204001,22300462,"JAN 02, 2024",BOS @ OKC,L,35,12,18,0.667,2,3,0.667,8,9,0.889,6,4,10,2,0,3,1,1,34,3,1,BOS,OKC,BOS,123,18.5,Points,46,44,36,12
Kristaps Porzingis,C,22023,204001,22300462,"JAN 02, 2024",BOS @ OKC,L,35,12,18,0.667,2,3,0.667,8,9,0.889,6,4,10,2,0,3,1,1,34,3,1,BOS,OKC,BOS,123,7.0,Rebounds,46,44,36,12
Kristaps Porzingis,C,22023,204001,22300462,"JAN 02, 2024",BOS @ OKC,L,35,12,18,0.667,2,3,0.667,8,9,0.889,6,4,10,2,0,3,1,1,34,3,1,BOS,OKC,BOS,123,27.5,Pts+Rebs+Asts,46,44,36,12
Kristaps Porzingis,C,22023,204001,22300462,"JAN 02, 2024",BOS @ OKC,L,35,12,18,0.667,2,3,0.667,8,9,0.889,6,4,10,2,0,3,1,1,34,3,1,BOS,OKC,BOS,123,34.0,Fantasy Score,46,44,36,12
Kristaps Porzingis,C,22023,204001,22300462,"JAN 02, 2024",BOS @ OKC,L,35,12,18,0.667,2,3,0.667,8,9,0.889,6,4,10,2,0,3,1,1,34,3,1,BOS,OKC,BOS,123,25.5,Pts+Rebs,46,44,36,12
Kristaps Porzingis,C,22023,204001,22300462,"JAN 02, 2024",BOS @ OKC,L,35,12,18,0.667,2,3,0.667,8,9,0.889,6,4,10,2,0,3,1,1,34,3,1,BOS,OKC,BOS,123,1.5,Dunks,46,44,36,12
Kristaps Porzingis,C,22023,204001,22300462,"JAN 02, 2024",BOS @ OKC,L,35,12,18,0.667,2,3,0.667,8,9,0.889,6,4,10,2,0,3,1,1,34,3,1,BOS,OKC,BOS,123,20.5,Pts+Asts,46,44,36,12
Kristaps Porzingis,C,22023,204001,22300462,"JAN 02, 2024",BOS @ OKC,L,35,12,18,0.667,2,3,0.667,8,9,0.889,6,4,10,2,0,3,1,1,34,3,1,BOS,OKC,BOS,123,1.5,Blocked Shots,46,44,36,12
Kristaps Porzingis,C,22023,204001,22300462,"JAN 02, 2024",BOS @ OKC,L,35,12,18,0.667,2,3,0.667,8,9,0.889,6,4,10,2,0,3,1,1,34,3,1,BOS,OKC,BOS,123,8.5,Rebs+Asts,46,44,36,12
Kristaps Porzingis,C,22023,204001,22300462,"JAN 02, 2024",BOS @ OKC,L,35,12,18,0.667,2,3,0.667,8,9,0.889,6,4,10,2,0,3,1,1,34,3,1,BOS,OKC,BOS,123,1.5,Turnovers,46,44,36,12
Kristaps Porzingis,C,22023,204001,22300403,"DEC 25, 2023",BOS @ LAL,W,35,11,19,0.579,2,8,0.25,4,7,0.571,3,8,11,2,1,2,1,3,28,16,1,BOS,LAL,BOS,126,18.5,Points,41,39,30,13
Kristaps Porzingis,C,22023,204001,22300403,"DEC 25, 2023",BOS @ LAL,W,35,11,19,0.579,2,8,0.25,4,7,0.571,3,8,11,2,1,2,1,3,28,16,1,BOS,LAL,BOS,126,7.0,Rebounds,41,39,30,13
Kristaps Porzingis,C,22023,204001,22300403,"DEC 25, 2023",BOS @ LAL,W,35,11,19,0.579,2,8,0.25,4,7,0.571,3,8,11,2,1,2,1,3,28,16,1,BOS,LAL,BOS,126,27.5,Pts+Rebs+Asts,41,39,30,13
Kristaps Porzingis,C,22023,204001,22300403,"DEC 25, 2023",BOS @ LAL,W,35,11,19,0.579,2,8,0.25,4,7,0.571,3,8,11,2,1,2,1,3,28,16,1,BOS,LAL,BOS,126,34.0,Fantasy Score,41,39,30,13
Kristaps Porzingis,C,22023,204001,22300403,"DEC 25, 2023",BOS @ LAL,W,35,11,19,0.579,2,8,0.25,4,7,0.571,3,8,11,2,1,2,1,3,28,16,1,BOS,LAL,BOS,126,25.5,Pts+Rebs,41,39,30,13
Kristaps Porzingis,C,22023,204001,22300403,"DEC 25, 2023",BOS @ LAL,W,35,11,19,0.579,2,8,0.25,4,7,0.571,3,8,11,2,1,2,1,3,28,16,1,BOS,LAL,BOS,126,1.5,Dunks,41,39,30,13
Kristaps Porzingis,C,22023,204001,22300403,"DEC 25, 2023",BOS @ LAL,W,35,11,19,0.579,2,8,0.25,4,7,0.571,3,8,11,2,1,2,1,3,28,16,1,BOS,LAL,BOS,126,20.5,Pts+Asts,41,39,30,13
Kristaps Porzingis,C,22023,204001,22300403,"DEC 25, 2023",BOS @ LAL,W,35,11,19,0.579,2,8,0.25,4,7,0.571,3,8,11,2,1,2,1,3,28,16,1,BOS,LAL,BOS,126,1.5,Blocked Shots,41,39,30,13
Kristaps Porzingis,C,22023,204001,22300403,"DEC 25, 2023",BOS @ LAL,W,35,11,19,0.579,2,8,0.25,4,7,0.571,3,8,11,2,1,2,1,3,28,16,1,BOS,LAL,BOS,126,8.5,Rebs+Asts,41,39,30,13
Kristaps Porzingis,C,22023,204001,22300403,"DEC 25, 2023",BOS @ LAL,W,35,11,19,0.579,2,8,0.25,4,7,0.571,3,8,11,2,1,2,1,3,28,16,1,BOS,LAL,BOS,126,1.5,Turnovers,41,39,30,13
Kristaps Porzingis,C,22023,204001,22300319,"DEC 14, 2023",BOS vs. CLE,W,31,5,11,0.455,1,6,0.167,7,8,0.875,1,5,6,0,1,2,3,2,18,-1,1,BOS,BOS,CLE,116,18.5,Points,24,24,18,6
Kristaps Porzingis,C,22023,204001,22300319,"DEC 14, 2023",BOS vs. CLE,W,31,5,11,0.455,1,6,0.167,7,8,0.875,1,5,6,0,1,2,3,2,18,-1,1,BOS,BOS,CLE,116,7.0,Rebounds,24,24,18,6
Kristaps Porzingis,C,22023,204001,22300319,"DEC 14, 2023",BOS vs. CLE,W,31,5,11,0.455,1,6,0.167,7,8,0.875,1,5,6,0,1,2,3,2,18,-1,1,BOS,BOS,CLE,116,27.5,Pts+Rebs+Asts,24,24,18,6
Kristaps Porzingis,C,22023,204001,22300319,"DEC 14, 2023",BOS vs. CLE,W,31,5,11,0.455,1,6,0.167,7,8,0.875,1,5,6,0,1,2,3,2,18,-1,1,BOS,BOS,CLE,116,34.0,Fantasy Score,24,24,18,6
Kristaps Porzingis,C,22023,204001,22300319,"DEC 14, 2023",BOS vs. CLE,W,31,5,11,0.455,1,6,0.167,7,8,0.875,1,5,6,0,1,2,3,2,18,-1,1,BOS,BOS,CLE,116,25.5,Pts+Rebs,24,24,18,6
Kristaps Porzingis,C,22023,204001,22300319,"DEC 14, 2023",BOS vs. CLE,W,31,5,11,0.455,1,6,0.167,7,8,0.875,1,5,6,0,1,2,3,2,18,-1,1,BOS,BOS,CLE,116,1.5,Dunks,24,24,18,6
Kristaps Porzingis,C,22023,204001,22300319,"DEC 14, 2023",BOS vs. CLE,W,31,5,11,0.455,1,6,0.167,7,8,0.875,1,5,6,0,1,2,3,2,18,-1,1,BOS,BOS,CLE,116,20.5,Pts+Asts,24,24,18,6
Kristaps Porzingis,C,22023,204001,22300319,"DEC 14, 2023",BOS vs. CLE,W,31,5,11,0.455,1,6,0.167,7,8,0.875,1,5,6,0,1,2,3,2,18,-1,1,BOS,BOS,CLE,116,1.5,Blocked Shots,24,24,18,6
Kristaps Porzingis,C,22023,204001,22300319,"DEC 14, 2023",BOS vs. CLE,W,31,5,11,0.455,1,6,0.167,7,8,0.875,1,5,6,0,1,2,3,2,18,-1,1,BOS,BOS,CLE,116,8.5,Rebs+Asts,24,24,18,6
Kristaps Porzingis,C,22023,204001,22300319,"DEC 14, 2023",BOS vs. CLE,W,31,5,11,0.455,1,6,0.167,7,8,0.875,1,5,6,0,1,2,3,2,18,-1,1,BOS,BOS,CLE,116,1.5,Turnovers,24,24,18,6
Kristaps Porzingis,C,22023,204001,22300305,"DEC 12, 2023",BOS vs. CLE,W,32,5,16,0.313,2,6,0.333,9,9,1.0,3,7,10,3,1,2,3,1,21,-3,1,BOS,BOS,CLE,120,18.5,Points,34,31,24,13
Kristaps Porzingis,C,22023,204001,22300305,"DEC 12, 2023",BOS vs. CLE,W,32,5,16,0.313,2,6,0.333,9,9,1.0,3,7,10,3,1,2,3,1,21,-3,1,BOS,BOS,CLE,120,7.0,Rebounds,34,31,24,13
Kristaps Porzingis,C,22023,204001,22300305,"DEC 12, 2023",BOS vs. CLE,W,32,5,16,0.313,2,6,0.333,9,9,1.0,3,7,10,3,1,2,3,1,21,-3,1,BOS,BOS,CLE,120,27.5,Pts+Rebs+Asts,34,31,24,13
Kristaps Porzingis,C,22023,204001,22300305,"DEC 12, 2023",BOS vs. CLE,W,32,5,16,0.313,2,6,0.333,9,9,1.0,3,7,10,3,1,2,3,1,21,-3,1,BOS,BOS,CLE,120,34.0,Fantasy Score,34,31,24,13
Kristaps Porzingis,C,22023,204001,22300305,"DEC 12, 2023",BOS vs. CLE,W,32,5,16,0.313,2,6,0.333,9,9,1.0,3,7,10,3,1,2,3,1,21,-3,1,BOS,BOS,CLE,120,25.5,Pts+Rebs,34,31,24,13
Kristaps Porzingis,C,22023,204001,22300305,"DEC 12, 2023",BOS vs. CLE,W,32,5,16,0.313,2,6,0.333,9,9,1.0,3,7,10,3,1,2,3,1,21,-3,1,BOS,BOS,CLE,120,1.5,Dunks,34,31,24,13
Kristaps Porzingis,C,22023,204001,22300305,"DEC 12, 2023",BOS vs. CLE,W,32,5,16,0.313,2,6,0.333,9,9,1.0,3,7,10,3,1,2,3,1,21,-3,1,BOS,BOS,CLE,120,20.5,Pts+Asts,34,31,24,13
Kristaps Porzingis,C,22023,204001,22300305,"DEC 12, 2023",BOS vs. CLE,W,32,5,16,0.313,2,6,0.333,9,9,1.0,3,7,10,3,1,2,3,1,21,-3,1,BOS,BOS,CLE,120,1.5,Blocked Shots,34,31,24,13
Kristaps Porzingis,C,22023,204001,22300305,"DEC 12, 2023",BOS vs. CLE,W,32,5,16,0.313,2,6,0.333,9,9,1.0,3,7,10,3,1,2,3,1,21,-3,1,BOS,BOS,CLE,120,8.5,Rebs+Asts,34,31,24,13
Kristaps Porzingis,C,22023,204001,22300305,"DEC 12, 2023",BOS vs. CLE,W,32,5,16,0.313,2,6,0.333,9,9,1.0,3,7,10,3,1,2,3,1,21,-3,1,BOS,BOS,CLE,120,1.5,Turnovers,34,31,24,13
Kristaps Porzingis,C,22023,204001,22300228,"NOV 22, 2023",BOS vs. MIL,W,27,9,15,0.6,2,7,0.286,1,2,0.5,1,5,6,1,0,0,1,5,21,3,1,BOS,BOS,MIL,119,18.5,Points,28,27,22,7
Kristaps Porzingis,C,22023,204001,22300228,"NOV 22, 2023",BOS vs. MIL,W,27,9,15,0.6,2,7,0.286,1,2,0.5,1,5,6,1,0,0,1,5,21,3,1,BOS,BOS,MIL,119,7.0,Rebounds,28,27,22,7
Kristaps Porzingis,C,22023,204001,22300228,"NOV 22, 2023",BOS vs. MIL,W,27,9,15,0.6,2,7,0.286,1,2,0.5,1,5,6,1,0,0,1,5,21,3,1,BOS,BOS,MIL,119,27.5,Pts+Rebs+Asts,28,27,22,7
Kristaps Porzingis,C,22023,204001,22300228,"NOV 22, 2023",BOS vs. MIL,W,27,9,15,0.6,2,7,0.286,1,2,0.5,1,5,6,1,0,0,1,5,21,3,1,BOS,BOS,MIL,119,34.0,Fantasy Score,28,27,22,7
Kristaps Porzingis,C,22023,204001,22300228,"NOV 22, 2023",BOS vs. MIL,W,27,9,15,0.6,2,7,0.286,1,2,0.5,1,5,6,1,0,0,1,5,21,3,1,BOS,BOS,MIL,119,25.5,Pts+Rebs,28,27,22,7
Kristaps Porzingis,C,22023,204001,22300228,"NOV 22, 2023",BOS vs. MIL,W,27,9,15,0.6,2,7,0.286,1,2,0.5,1,5,6,1,0,0,1,5,21,3,1,BOS,BOS,MIL,119,1.5,Dunks,28,27,22,7
Kristaps Porzingis,C,22023,204001,22300228,"NOV 22, 2023",BOS vs. MIL,W,27,9,15,0.6,2,7,0.286,1,2,0.5,1,5,6,1,0,0,1,5,21,3,1,BOS,BOS,MIL,119,20.5,Pts+Asts,28,27,22,7
Kristaps Porzingis,C,22023,204001,22300228,"NOV 22, 2023",BOS vs. MIL,W,27,9,15,0.6,2,7,0.286,1,2,0.5,1,5,6,1,0,0,1,5,21,3,1,BOS,BOS,MIL,119,1.5,Blocked Shots,28,27,22,7
Kristaps Porzingis,C,22023,204001,22300228,"NOV 22, 2023",BOS vs. MIL,W,27,9,15,0.6,2,7,0.286,1,2,0.5,1,5,6,1,0,0,1,5,21,3,1,BOS,BOS,MIL,119,8.5,Rebs+Asts,28,27,22,7
Kristaps Porzingis,C,22023,204001,22300228,"NOV 22, 2023",BOS vs. MIL,W,27,9,15,0.6,2,7,0.286,1,2,0.5,1,5,6,1,0,0,1,5,21,3,1,BOS,BOS,MIL,119,1.5,Turnovers,28,27,22,7
Kristaps Porzingis,C,22023,204001,22300213,"NOV 19, 2023",BOS @ MEM,W,34,9,13,0.692,0,3,0.0,8,9,0.889,2,6,8,1,1,6,2,4,26,4,1,BOS,MEM,BOS,102,18.5,Points,35,34,27,9
Kristaps Porzingis,C,22023,204001,22300213,"NOV 19, 2023",BOS @ MEM,W,34,9,13,0.692,0,3,0.0,8,9,0.889,2,6,8,1,1,6,2,4,26,4,1,BOS,MEM,BOS,102,7.0,Rebounds,35,34,27,9
Kristaps Porzingis,C,22023,204001,22300213,"NOV 19, 2023",BOS @ MEM,W,34,9,13,0.692,0,3,0.0,8,9,0.889,2,6,8,1,1,6,2,4,26,4,1,BOS,MEM,BOS,102,27.5,Pts+Rebs+Asts,35,34,27,9
Kristaps Porzingis,C,22023,204001,22300213,"NOV 19, 2023",BOS @ MEM,W,34,9,13,0.692,0,3,0.0,8,9,0.889,2,6,8,1,1,6,2,4,26,4,1,BOS,MEM,BOS,102,34.0,Fantasy Score,35,34,27,9
Kristaps Porzingis,C,22023,204001,22300213,"NOV 19, 2023",BOS @ MEM,W,34,9,13,0.692,0,3,0.0,8,9,0.889,2,6,8,1,1,6,2,4,26,4,1,BOS,MEM,BOS,102,25.5,Pts+Rebs,35,34,27,9
Kristaps Porzingis,C,22023,204001,22300213,"NOV 19, 2023",BOS @ MEM,W,34,9,13,0.692,0,3,0.0,8,9,0.889,2,6,8,1,1,6,2,4,26,4,1,BOS,MEM,BOS,102,1.5,Dunks,35,34,27,9
Kristaps Porzingis,C,22023,204001,22300213,"NOV 19, 2023",BOS @ MEM,W,34,9,13,0.692,0,3,0.0,8,9,0.889,2,6,8,1,1,6,2,4,26,4,1,BOS,MEM,BOS,102,20.5,Pts+Asts,35,34,27,9
Kristaps Porzingis,C,22023,204001,22300213,"NOV 19, 2023",BOS @ MEM,W,34,9,13,0.692,0,3,0.0,8,9,0.889,2,6,8,1,1,6,2,4,26,4,1,BOS,MEM,BOS,102,1.5,Blocked Shots,35,34,27,9
Kristaps Porzingis,C,22023,204001,22300213,"NOV 19, 2023",BOS @ MEM,W,34,9,13,0.692,0,3,0.0,8,9,0.889,2,6,8,1,1,6,2,4,26,4,1,BOS,MEM,BOS,102,8.5,Rebs+Asts,35,34,27,9
Kristaps Porzingis,C,22023,204001,22300213,"NOV 19, 2023",BOS @ MEM,W,34,9,13,0.692,0,3,0.0,8,9,0.889,2,6,8,1,1,6,2,4,26,4,1,BOS,MEM,BOS,102,1.5,Turnovers,35,34,27,9
Kristaps Porzingis,C,22023,204001,22300031,"NOV 17, 2023",BOS @ TOR,W,35,6,13,0.462,0,3,0.0,2,2,1.0,2,10,12,5,1,3,2,3,14,2,1,BOS,TOR,BOS,108,18.5,Points,31,26,19,17
Kristaps Porzingis,C,22023,204001,22300031,"NOV 17, 2023",BOS @ TOR,W,35,6,13,0.462,0,3,0.0,2,2,1.0,2,10,12,5,1,3,2,3,14,2,1,BOS,TOR,BOS,108,7.0,Rebounds,31,26,19,17
Kristaps Porzingis,C,22023,204001,22300031,"NOV 17, 2023",BOS @ TOR,W,35,6,13,0.462,0,3,0.0,2,2,1.0,2,10,12,5,1,3,2,3,14,2,1,BOS,TOR,BOS,108,27.5,Pts+Rebs+Asts,31,26,19,17
Kristaps Porzingis,C,22023,204001,22300031,"NOV 17, 2023",BOS @ TOR,W,35,6,13,0.462,0,3,0.0,2,2,1.0,2,10,12,5,1,3,2,3,14,2,1,BOS,TOR,BOS,108,34.0,Fantasy Score,31,26,19,17
Kristaps Porzingis,C,22023,204001,22300031,"NOV 17, 2023",BOS @ TOR,W,35,6,13,0.462,0,3,0.0,2,2,1.0,2,10,12,5,1,3,2,3,14,2,1,BOS,TOR,BOS,108,25.5,Pts+Rebs,31,26,19,17
Kristaps Porzingis,C,22023,204001,22300031,"NOV 17, 2023",BOS @ TOR,W,35,6,13,0.462,0,3,0.0,2,2,1.0,2,10,12,5,1,3,2,3,14,2,1,BOS,TOR,BOS,108,1.5,Dunks,31,26,19,17
Kristaps Porzingis,C,22023,204001,22300031,"NOV 17, 2023",BOS @ TOR,W,35,6,13,0.462,0,3,0.0,2,2,1.0,2,10,12,5,1,3,2,3,14,2,1,BOS,TOR,BOS,108,20.5,Pts+Asts,31,26,19,17
Kristaps Porzingis,C,22023,204001,22300031,"NOV 17, 2023",BOS @ TOR,W,35,6,13,0.462,0,3,0.0,2,2,1.0,2,10,12,5,1,3,2,3,14,2,1,BOS,TOR,BOS,108,1.5,Blocked Shots,31,26,19,17
Kristaps Porzingis,C,22023,204001,22300031,"NOV 17, 2023",BOS @ TOR,W,35,6,13,0.462,0,3,0.0,2,2,1.0,2,10,12,5,1,3,2,3,14,2,1,BOS,TOR,BOS,108,8.5,Rebs+Asts,31,26,19,17
Kristaps Porzingis,C,22023,204001,22300031,"NOV 17, 2023",BOS @ TOR,W,35,6,13,0.462,0,3,0.0,2,2,1.0,2,10,12,5,1,3,2,3,14,2,1,BOS,TOR,BOS,108,1.5,Turnovers,31,26,19,17
Kristaps Porzingis,C,22023,204001,22300188,"NOV 13, 2023",BOS vs. NYK,W,33,7,11,0.636,3,6,0.5,4,4,1.0,1,5,6,3,0,1,1,5,21,19,1,BOS,BOS,NYK,114,18.5,Points,30,27,24,9
Kristaps Porzingis,C,22023,204001,22300188,"NOV 13, 2023",BOS vs. NYK,W,33,7,11,0.636,3,6,0.5,4,4,1.0,1,5,6,3,0,1,1,5,21,19,1,BOS,BOS,NYK,114,7.0,Rebounds,30,27,24,9
Kristaps Porzingis,C,22023,204001,22300188,"NOV 13, 2023",BOS vs. NYK,W,33,7,11,0.636,3,6,0.5,4,4,1.0,1,5,6,3,0,1,1,5,21,19,1,BOS,BOS,NYK,114,27.5,Pts+Rebs+Asts,30,27,24,9
Kristaps Porzingis,C,22023,204001,22300188,"NOV 13, 2023",BOS vs. NYK,W,33,7,11,0.636,3,6,0.5,4,4,1.0,1,5,6,3,0,1,1,5,21,19,1,BOS,BOS,NYK,114,34.0,Fantasy Score,30,27,24,9
Kristaps Porzingis,C,22023,204001,22300188,"NOV 13, 2023",BOS vs. NYK,W,33,7,11,0.636,3,6,0.5,4,4,1.0,1,5,6,3,0,1,1,5,21,19,1,BOS,BOS,NYK,114,25.5,Pts+Rebs,30,27,24,9
Kristaps Porzingis,C,22023,204001,22300188,"NOV 13, 2023",BOS vs. NYK,W,33,7,11,0.636,3,6,0.5,4,4,1.0,1,5,6,3,0,1,1,5,21,19,1,BOS,BOS,NYK,114,1.5,Dunks,30,27,24,9
Kristaps Porzingis,C,22023,204001,22300188,"NOV 13, 2023",BOS vs. NYK,W,33,7,11,0.636,3,6,0.5,4,4,1.0,1,5,6,3,0,1,1,5,21,19,1,BOS,BOS,NYK,114,20.5,Pts+Asts,30,27,24,9
Kristaps Porzingis,C,22023,204001,22300188,"NOV 13, 2023",BOS vs. NYK,W,33,7,11,0.636,3,6,0.5,4,4,1.0,1,5,6,3,0,1,1,5,21,19,1,BOS,BOS,NYK,114,1.5,Blocked Shots,30,27,24,9
Kristaps Porzingis,C,22023,204001,22300188,"NOV 13, 2023",BOS vs. NYK,W,33,7,11,0.636,3,6,0.5,4,4,1.0,1,5,6,3,0,1,1,5,21,19,1,BOS,BOS,NYK,114,8.5,Rebs+Asts,30,27,24,9
Kristaps Porzingis,C,22023,204001,22300188,"NOV 13, 2023",BOS vs. NYK,W,33,7,11,0.636,3,6,0.5,4,4,1.0,1,5,6,3,0,1,1,5,21,19,1,BOS,BOS,NYK,114,1.5,Turnovers,30,27,24,9
Kristaps Porzingis,C,22023,204001,22300159,"NOV 08, 2023",BOS @ PHI,L,31,10,19,0.526,2,6,0.333,7,8,0.875,4,2,6,3,0,1,0,4,29,8,1,BOS,PHI,BOS,103,18.5,Points,38,35,32,9
Kristaps Porzingis,C,22023,204001,22300159,"NOV 08, 2023",BOS @ PHI,L,31,10,19,0.526,2,6,0.333,7,8,0.875,4,2,6,3,0,1,0,4,29,8,1,BOS,PHI,BOS,103,7.0,Rebounds,38,35,32,9
Kristaps Porzingis,C,22023,204001,22300159,"NOV 08, 2023",BOS @ PHI,L,31,10,19,0.526,2,6,0.333,7,8,0.875,4,2,6,3,0,1,0,4,29,8,1,BOS,PHI,BOS,103,27.5,Pts+Rebs+Asts,38,35,32,9
Kristaps Porzingis,C,22023,204001,22300159,"NOV 08, 2023",BOS @ PHI,L,31,10,19,0.526,2,6,0.333,7,8,0.875,4,2,6,3,0,1,0,4,29,8,1,BOS,PHI,BOS,103,34.0,Fantasy Score,38,35,32,9
Kristaps Porzingis,C,22023,204001,22300159,"NOV 08, 2023",BOS @ PHI,L,31,10,19,0.526,2,6,0.333,7,8,0.875,4,2,6,3,0,1,0,4,29,8,1,BOS,PHI,BOS,103,25.5,Pts+Rebs,38,35,32,9
Kristaps Porzingis,C,22023,204001,22300159,"NOV 08, 2023",BOS @ PHI,L,31,10,19,0.526,2,6,0.333,7,8,0.875,4,2,6,3,0,1,0,4,29,8,1,BOS,PHI,BOS,103,1.5,Dunks,38,35,32,9
Kristaps Porzingis,C,22023,204001,22300159,"NOV 08, 2023",BOS @ PHI,L,31,10,19,0.526,2,6,0.333,7,8,0.875,4,2,6,3,0,1,0,4,29,8,1,BOS,PHI,BOS,103,20.5,Pts+Asts,38,35,32,9
Kristaps Porzingis,C,22023,204001,22300159,"NOV 08, 2023",BOS @ PHI,L,31,10,19,0.526,2,6,0.333,7,8,0.875,4,2,6,3,0,1,0,4,29,8,1,BOS,PHI,BOS,103,1.5,Blocked Shots,38,35,32,9
Kristaps Porzingis,C,22023,204001,22300159,"NOV 08, 2023",BOS @ PHI,L,31,10,19,0.526,2,6,0.333,7,8,0.875,4,2,6,3,0,1,0,4,29,8,1,BOS,PHI,BOS,103,8.5,Rebs+Asts,38,35,32,9
Kristaps Porzingis,C,22023,204001,22300159,"NOV 08, 2023",BOS @ PHI,L,31,10,19,0.526,2,6,0.333,7,8,0.875,4,2,6,3,0,1,0,4,29,8,1,BOS,PHI,BOS,103,1.5,Turnovers,38,35,32,9
Kristaps Porzingis,C,22023,204001,22300154,"NOV 06, 2023",BOS @ MIN,L,36,5,14,0.357,2,6,0.333,8,10,0.8,1,4,5,1,1,1,1,5,20,-7,1,BOS,MIN,BOS,109,18.5,Points,26,25,21,6
Kristaps Porzingis,C,22023,204001,22300154,"NOV 06, 2023",BOS @ MIN,L,36,5,14,0.357,2,6,0.333,8,10,0.8,1,4,5,1,1,1,1,5,20,-7,1,BOS,MIN,BOS,109,7.0,Rebounds,26,25,21,6
Kristaps Porzingis,C,22023,204001,22300154,"NOV 06, 2023",BOS @ MIN,L,36,5,14,0.357,2,6,0.333,8,10,0.8,1,4,5,1,1,1,1,5,20,-7,1,BOS,MIN,BOS,109,27.5,Pts+Rebs+Asts,26,25,21,6
Kristaps Porzingis,C,22023,204001,22300154,"NOV 06, 2023",BOS @ MIN,L,36,5,14,0.357,2,6,0.333,8,10,0.8,1,4,5,1,1,1,1,5,20,-7,1,BOS,MIN,BOS,109,34.0,Fantasy Score,26,25,21,6
Kristaps Porzingis,C,22023,204001,22300154,"NOV 06, 2023",BOS @ MIN,L,36,5,14,0.357,2,6,0.333,8,10,0.8,1,4,5,1,1,1,1,5,20,-7,1,BOS,MIN,BOS,109,25.5,Pts+Rebs,26,25,21,6
Kristaps Porzingis,C,22023,204001,22300154,"NOV 06, 2023",BOS @ MIN,L,36,5,14,0.357,2,6,0.333,8,10,0.8,1,4,5,1,1,1,1,5,20,-7,1,BOS,MIN,BOS,109,1.5,Dunks,26,25,21,6
Kristaps Porzingis,C,22023,204001,22300154,"NOV 06, 2023",BOS @ MIN,L,36,5,14,0.357,2,6,0.333,8,10,0.8,1,4,5,1,1,1,1,5,20,-7,1,BOS,MIN,BOS,109,20.5,Pts+Asts,26,25,21,6
Kristaps Porzingis,C,22023,204001,22300154,"NOV 06, 2023",BOS @ MIN,L,36,5,14,0.357,2,6,0.333,8,10,0.8,1,4,5,1,1,1,1,5,20,-7,1,BOS,MIN,BOS,109,1.5,Blocked Shots,26,25,21,6
Kristaps Porzingis,C,22023,204001,22300154,"NOV 06, 2023",BOS @ MIN,L,36,5,14,0.357,2,6,0.333,8,10,0.8,1,4,5,1,1,1,1,5,20,-7,1,BOS,MIN,BOS,109,8.5,Rebs+Asts,26,25,21,6
Kristaps Porzingis,C,22023,204001,22300154,"NOV 06, 2023",BOS @ MIN,L,36,5,14,0.357,2,6,0.333,8,10,0.8,1,4,5,1,1,1,1,5,20,-7,1,BOS,MIN,BOS,109,1.5,Turnovers,26,25,21,6
Kristaps Porzingis,C,22023,204001,22300065,"OCT 25, 2023",BOS @ NYK,W,38,8,15,0.533,5,9,0.556,9,10,0.9,1,7,8,0,0,4,1,4,30,13,1,BOS,NYK,BOS,108,18.5,Points,38,38,30,8
Kristaps Porzingis,C,22023,204001,22300065,"OCT 25, 2023",BOS @ NYK,W,38,8,15,0.533,5,9,0.556,9,10,0.9,1,7,8,0,0,4,1,4,30,13,1,BOS,NYK,BOS,108,7.0,Rebounds,38,38,30,8
Kristaps Porzingis,C,22023,204001,22300065,"OCT 25, 2023",BOS @ NYK,W,38,8,15,0.533,5,9,0.556,9,10,0.9,1,7,8,0,0,4,1,4,30,13,1,BOS,NYK,BOS,108,27.5,Pts+Rebs+Asts,38,38,30,8
Kristaps Porzingis,C,22023,204001,22300065,"OCT 25, 2023",BOS @ NYK,W,38,8,15,0.533,5,9,0.556,9,10,0.9,1,7,8,0,0,4,1,4,30,13,1,BOS,NYK,BOS,108,34.0,Fantasy Score,38,38,30,8
Kristaps Porzingis,C,22023,204001,22300065,"OCT 25, 2023",BOS @ NYK,W,38,8,15,0.533,5,9,0.556,9,10,0.9,1,7,8,0,0,4,1,4,30,13,1,BOS,NYK,BOS,108,25.5,Pts+Rebs,38,38,30,8
Kristaps Porzingis,C,22023,204001,22300065,"OCT 25, 2023",BOS @ NYK,W,38,8,15,0.533,5,9,0.556,9,10,0.9,1,7,8,0,0,4,1,4,30,13,1,BOS,NYK,BOS,108,1.5,Dunks,38,38,30,8
Kristaps Porzingis,C,22023,204001,22300065,"OCT 25, 2023",BOS @ NYK,W,38,8,15,0.533,5,9,0.556,9,10,0.9,1,7,8,0,0,4,1,4,30,13,1,BOS,NYK,BOS,108,20.5,Pts+Asts,38,38,30,8
Kristaps Porzingis,C,22023,204001,22300065,"OCT 25, 2023",BOS @ NYK,W,38,8,15,0.533,5,9,0.556,9,10,0.9,1,7,8,0,0,4,1,4,30,13,1,BOS,NYK,BOS,108,1.5,Blocked Shots,38,38,30,8
Kristaps Porzingis,C,22023,204001,22300065,"OCT 25, 2023",BOS @ NYK,W,38,8,15,0.533,5,9,0.556,9,10,0.9,1,7,8,0,0,4,1,4,30,13,1,BOS,NYK,BOS,108,8.5,Rebs+Asts,38,38,30,8
Kristaps Porzingis,C,22023,204001,22300065,"OCT 25, 2023",BOS @ NYK,W,38,8,15,0.533,5,9,0.556,9,10,0.9,1,7,8,0,0,4,1,4,30,13,1,BOS,NYK,BOS,108,1.5,Turnovers,38,38,30,8
CJ McCollum,G,22023,203468,22300758,"FEB 10, 2024",NOP @ POR,W,32,2,14,0.143,1,9,0.111,3,4,0.75,0,3,3,7,1,1,1,2,8,22,1,NOP,POR,NOP,93,,,18,11,15,10
CJ McCollum,G,22023,203468,22300747,"FEB 09, 2024",NOP @ LAL,L,30,8,16,0.5,3,9,0.333,0,0,0.0,1,3,4,3,0,0,0,3,19,-18,1,NOP,LAL,NOP,122,,,26,23,22,7
CJ McCollum,G,22023,203468,22300731,"FEB 07, 2024",NOP @ LAC,W,36,10,17,0.588,5,11,0.455,0,0,0.0,0,7,7,4,1,0,3,3,25,4,1,NOP,LAC,NOP,117,,,36,32,29,11
CJ McCollum,G,22023,203468,22300718,"FEB 05, 2024",NOP vs. TOR,W,23,7,12,0.583,6,10,0.6,0,0,0.0,1,5,6,3,2,0,0,1,20,15,1,NOP,NOP,TOR,138,,,29,26,23,9
CJ McCollum,G,22023,203468,22300696,"FEB 02, 2024",NOP @ SAS,W,39,8,17,0.471,3,10,0.3,2,4,0.5,1,3,4,4,1,1,2,3,21,13,1,NOP,SAS,NOP,114,,,29,25,25,8
CJ McCollum,G,22023,203468,22300679,"JAN 31, 2024",NOP @ HOU,W,36,7,15,0.467,3,7,0.429,2,2,1.0,0,5,5,3,1,2,3,1,19,3,1,NOP,HOU,NOP,110,,,27,24,22,8
CJ McCollum,G,22023,203468,22300648,"JAN 27, 2024",NOP @ MIL,L,23,2,7,0.286,1,4,0.25,2,2,1.0,0,1,1,4,0,1,2,2,7,-30,1,NOP,MIL,NOP,117,,,12,8,11,5
CJ McCollum,G,22023,203468,22300640,"JAN 26, 2024",NOP vs. OKC,L,35,4,15,0.267,2,7,0.286,2,2,1.0,1,5,6,3,2,0,4,4,12,-20,1,NOP,NOP,OKC,83,,,21,18,15,9
CJ McCollum,G,22023,203468,22300616,"JAN 23, 2024",NOP vs. UTA,W,29,11,17,0.647,9,13,0.692,2,3,0.667,1,4,5,2,1,1,2,3,33,17,1,NOP,NOP,UTA,153,,,40,38,35,7
CJ McCollum,G,22023,203468,22300588,"JAN 19, 2024",NOP vs. PHX,L,31,5,13,0.385,1,7,0.143,2,3,0.667,0,4,4,4,0,2,1,1,13,-8,1,NOP,NOP,PHX,109,,,21,17,17,8
CJ McCollum,G,22023,203468,22300575,"JAN 17, 2024",NOP vs. CHA,W,29,8,15,0.533,4,9,0.444,2,2,1.0,2,3,5,6,0,2,1,2,22,4,1,NOP,NOP,CHA,132,,,33,27,28,11
CJ McCollum,G,22023,203468,22300539,"JAN 12, 2024",NOP @ DEN,L,30,4,10,0.4,3,8,0.375,1,2,0.5,0,5,5,7,1,0,2,2,12,-13,1,NOP,DEN,NOP,113,,,24,17,19,12
CJ McCollum,G,22023,203468,22300486,"JAN 05, 2024",NOP vs. LAC,L,31,4,13,0.308,4,9,0.444,0,0,0.0,1,5,6,3,1,0,1,3,12,-10,1,NOP,NOP,LAC,95,,,21,18,15,9
CJ McCollum,G,22023,203468,22300471,"JAN 03, 2024",NOP @ MIN,W,30,8,16,0.5,4,6,0.667,4,4,1.0,0,3,3,5,0,1,2,2,24,12,1,NOP,MIN,NOP,117,,,32,27,29,8
CJ McCollum,G,22023,203468,22300461,"JAN 02, 2024",NOP vs. BKN,W,25,6,11,0.545,4,8,0.5,0,0,0.0,2,4,6,5,0,0,2,0,16,12,1,NOP,NOP,BKN,112,,,27,22,21,11
CJ McCollum,G,22023,203468,22300446,"DEC 31, 2023",NOP vs. LAL,W,36,8,19,0.421,6,11,0.545,0,0,0.0,0,5,5,9,1,1,1,2,22,15,1,NOP,NOP,LAL,129,,,36,27,31,14
CJ McCollum,G,22023,203468,22300424,"DEC 28, 2023",NOP vs. UTA,W,32,8,16,0.5,4,10,0.4,2,3,0.667,1,2,3,6,2,0,2,2,22,8,1,NOP,NOP,UTA,112,,,31,25,28,9
CJ McCollum,G,22023,203468,22300410,"DEC 26, 2023",NOP vs. MEM,L,39,6,14,0.429,3,8,0.375,1,4,0.25,0,2,2,2,1,1,1,4,16,-9,1,NOP,NOP,MEM,115,,,20,18,18,4
CJ McCollum,G,22023,203468,22300392,"DEC 23, 2023",NOP vs. HOU,L,34,4,10,0.4,2,7,0.286,3,4,0.75,1,4,5,2,1,1,4,4,13,-2,1,NOP,NOP,HOU,104,,,20,18,15,7
CJ McCollum,G,22023,203468,22300375,"DEC 21, 2023",NOP @ CLE,W,34,7,15,0.467,2,8,0.25,2,2,1.0,0,6,6,4,4,1,2,2,18,13,1,NOP,CLE,NOP,123,,,28,24,22,10
CJ McCollum,G,22023,203468,22300360,"DEC 19, 2023",NOP vs. MEM,L,41,6,11,0.545,6,9,0.667,0,0,0.0,0,3,3,6,1,1,1,2,18,9,1,NOP,NOP,MEM,113,,,27,21,24,9
CJ McCollum,G,22023,203468,22300345,"DEC 17, 2023",NOP @ SAS,W,26,10,15,0.667,6,7,0.857,3,3,1.0,0,2,2,2,1,0,3,2,29,21,1,NOP,SAS,NOP,146,,,33,31,31,4
CJ McCollum,G,22023,203468,22300326,"DEC 15, 2023",NOP @ CHA,W,35,7,18,0.389,3,9,0.333,2,2,1.0,2,3,5,4,1,1,2,0,19,4,1,NOP,CHA,NOP,112,,,28,24,23,9
CJ McCollum,G,22023,203468,22300311,"DEC 13, 2023",NOP @ WAS,W,32,8,14,0.571,4,6,0.667,2,2,1.0,0,3,3,6,0,0,0,3,22,13,1,NOP,WAS,NOP,142,,,31,25,28,9
CJ McCollum,G,22023,203468,22300301,"DEC 11, 2023",NOP vs. MIN,W,29,8,15,0.533,4,7,0.571,3,3,1.0,0,4,4,4,1,1,1,2,23,21,1,NOP,NOP,MIN,121,,,31,27,27,8
CJ McCollum,G,22023,203468,22301230,"DEC 07, 2023",NOP @ LAL,L,25,4,14,0.286,1,4,0.25,0,0,0.0,1,3,4,2,2,0,1,2,9,-38,1,NOP,LAL,NOP,89,,,15,13,11,6
CJ McCollum,G,22023,203468,22301204,"DEC 04, 2023",NOP @ SAC,W,36,7,14,0.5,3,5,0.6,0,0,0.0,0,2,2,7,2,2,2,2,17,-4,1,NOP,SAC,NOP,127,,,26,19,24,9
CJ McCollum,G,22023,203468,22300262,"NOV 29, 2023",NOP vs. PHI,W,28,7,16,0.438,3,8,0.375,3,3,1.0,1,3,4,5,2,1,2,3,20,19,1,NOP,NOP,PHI,124,,,29,24,25,9
CJ McCollum,G,22023,203468,22300659,"JAN 29, 2024",NOP @ BOS,L,37,7,14,0.5,1,5,0.2,1,1,1.0,0,2,2,2,0,1,4,3,16,-1,1,NOP,BOS,NOP,112,,,20,18,18,4
CJ McCollum,G,22023,203468,22300556,"JAN 15, 2024",NOP @ DAL,L,29,9,17,0.529,3,7,0.429,2,2,1.0,0,6,6,4,1,0,0,5,23,15,1,NOP,DAL,NOP,120,,,33,29,27,10
CJ McCollum,G,22023,203468,22300525,"JAN 10, 2024",NOP @ GSW,W,26,5,13,0.385,2,7,0.286,2,2,1.0,0,3,3,8,2,1,0,0,14,22,1,NOP,GSW,NOP,141,,,25,17,22,11
CJ McCollum,G,22023,203468,22300500,"JAN 07, 2024",NOP @ SAC,W,27,11,16,0.688,7,10,0.7,1,2,0.5,1,6,7,4,0,2,3,0,30,31,1,NOP,SAC,NOP,133,,,41,37,34,11
CJ McCollum,G,22023,203468,22300278,"DEC 01, 2023",NOP vs. SAS,W,38,8,18,0.444,1,8,0.125,2,2,1.0,1,2,3,8,2,1,1,1,19,16,1,NOP,NOP,SAS,121,,,30,22,27,11
CJ McCollum,G,22023,203468,22300135,"NOV 04, 2023",NOP vs. ATL,L,33,5,12,0.417,1,6,0.167,2,3,0.667,0,1,1,6,2,3,0,3,13,-19,1,NOP,NOP,ATL,105,,,20,14,19,7
CJ McCollum,G,22023,203468,22300129,"NOV 02, 2023",NOP vs. DET,W,35,10,23,0.435,3,10,0.3,10,11,0.909,1,3,4,5,0,0,4,3,33,-17,1,NOP,NOP,DET,125,,,42,37,38,9
CJ McCollum,G,22023,203468,22300121,"NOV 01, 2023",NOP @ OKC,W,37,10,17,0.588,5,8,0.625,4,7,0.571,1,10,11,5,0,1,1,2,29,16,1,NOP,OKC,NOP,110,,,45,40,34,16
CJ McCollum,G,22023,203468,22300108,"OCT 30, 2023",NOP vs. GSW,L,33,7,21,0.333,2,8,0.25,3,4,0.75,2,4,6,5,1,0,0,1,19,-19,1,NOP,NOP,GSW,102,,,30,25,24,11
CJ McCollum,G,22023,203468,22300090,"OCT 28, 2023",NOP vs. NYK,W,30,4,11,0.364,2,7,0.286,2,4,0.5,0,3,3,7,4,0,1,2,12,18,1,NOP,NOP,NYK,96,,,22,15,19,10
CJ McCollum,G,22023,203468,22300071,"OCT 25, 2023",NOP @ MEM,W,37,8,16,0.5,6,11,0.545,2,2,1.0,1,3,4,6,2,1,2,3,24,-1,1,NOP,MEM,NOP,111,,,34,28,30,10
Coby White,G,22023,1629632,22300139,"NOV 04, 2023",CHI @ DEN,L,31,4,10,0.4,1,4,0.25,2,2,1.0,0,2,2,5,2,1,2,2,11,-11,1,CHI,DEN,CHI,101,,,18,13,16,7
Coby White,G,22023,1629632,22300737,"FEB 08, 2024",CHI @ MEM,W,36,6,12,0.5,2,3,0.667,6,6,1.0,1,5,6,8,0,0,5,2,20,7,1,CHI,MEM,CHI,118,,,34,26,28,14
Coby White,G,22023,1629632,22300723,"FEB 06, 2024",CHI vs. MIN,W,42,11,21,0.524,7,13,0.538,4,5,0.8,0,5,5,7,1,0,3,4,33,7,1,CHI,CHI,MIN,129,,,45,38,40,12
Coby White,G,22023,1629632,22300700,"FEB 03, 2024",CHI vs. SAC,L,36,10,18,0.556,4,7,0.571,2,2,1.0,0,6,6,4,0,0,3,1,26,-2,1,CHI,CHI,SAC,115,,,36,32,30,10
Coby White,G,22023,1629632,22300674,"JAN 31, 2024",CHI @ CHA,W,43,12,22,0.545,4,10,0.4,7,9,0.778,1,6,7,9,0,0,3,0,35,12,1,CHI,CHA,CHI,117,,,51,42,44,16
Coby White,G,22023,1629632,22300672,"JAN 30, 2024",CHI vs. TOR,L,35,5,10,0.5,1,4,0.25,2,2,1.0,0,2,2,6,1,0,1,3,13,-17,1,CHI,CHI,TOR,107,,,21,15,19,8
Coby White,G,22023,1629632,22300656,"JAN 28, 2024",CHI @ POR,W,42,7,19,0.368,1,9,0.111,0,1,0.0,0,5,5,9,1,0,3,1,15,7,1,CHI,POR,CHI,104,,,29,20,24,14
Coby White,G,22023,1629632,22300633,"JAN 25, 2024",CHI @ LAL,L,43,8,18,0.444,3,10,0.3,6,7,0.857,2,5,7,3,0,0,4,1,25,-1,1,CHI,LAL,CHI,132,,,35,32,28,10
Coby White,G,22023,1629632,22300612,"JAN 22, 2024",CHI @ PHX,L,41,10,14,0.714,4,5,0.8,2,2,1.0,2,8,10,9,2,0,1,4,26,9,1,CHI,PHX,CHI,113,,,45,36,35,19
Coby White,G,22023,1629632,22300597,"JAN 20, 2024",CHI vs. MEM,W,36,7,14,0.5,1,3,0.333,2,2,1.0,1,4,5,5,0,0,1,1,17,17,1,CHI,CHI,MEM,125,,,27,22,22,10
Coby White,G,22023,1629632,22300580,"JAN 18, 2024",CHI @ TOR,W,35,10,19,0.526,1,6,0.167,2,3,0.667,2,6,8,4,2,0,2,2,23,23,1,CHI,TOR,CHI,116,,,35,31,27,12
Coby White,G,22023,1629632,22300561,"JAN 15, 2024",CHI @ CLE,L,38,5,15,0.333,1,5,0.2,7,9,0.778,1,3,4,3,1,2,7,0,18,-12,1,CHI,CLE,CHI,91,,,25,22,21,7
Coby White,G,22023,1629632,22300548,"JAN 13, 2024",CHI @ SAS,W,32,6,13,0.462,0,3,0.0,3,4,0.75,0,2,2,4,0,1,0,2,15,-11,1,CHI,SAS,CHI,122,,,21,17,19,6
Coby White,G,22023,1629632,22300506,"JAN 08, 2024",CHI @ CHA,W,42,10,19,0.526,3,7,0.429,4,5,0.8,0,6,6,5,0,0,1,3,27,11,1,CHI,CHA,CHI,119,,,38,33,32,11
Coby White,G,22023,1629632,22300484,"JAN 05, 2024",CHI vs. CHA,W,40,7,12,0.583,3,6,0.5,5,6,0.833,1,9,10,6,0,0,5,1,22,0,1,CHI,CHI,CHA,104,,,38,32,28,16
Coby White,G,22023,1629632,22300468,"JAN 03, 2024",CHI @ NYK,L,38,9,19,0.474,6,9,0.667,2,2,1.0,0,4,4,8,0,1,3,1,26,-23,1,CHI,NYK,CHI,100,,,38,30,34,12
Coby White,G,22023,1629632,22300459,"JAN 02, 2024",CHI @ PHI,L,28,5,15,0.333,0,5,0.0,4,5,0.8,0,4,4,3,2,0,1,4,14,-26,1,CHI,PHI,CHI,97,,,21,18,17,7
Coby White,G,22023,1629632,22300442,"DEC 30, 2023",CHI vs. PHI,W,40,7,15,0.467,1,5,0.2,5,6,0.833,2,6,8,2,0,0,5,3,20,10,1,CHI,CHI,PHI,105,,,30,28,22,10
Coby White,G,22023,1629632,22300422,"DEC 28, 2023",CHI vs. IND,L,33,5,19,0.263,2,6,0.333,4,4,1.0,0,5,5,2,0,0,2,3,16,-24,1,CHI,CHI,IND,104,,,23,21,18,7
Coby White,G,22023,1629632,22300408,"DEC 26, 2023",CHI vs. ATL,W,37,7,22,0.318,0,7,0.0,5,8,0.625,0,5,5,5,0,0,1,2,19,7,1,CHI,CHI,ATL,118,,,29,24,24,10
Coby White,G,22023,1629632,22300396,"DEC 23, 2023",CHI vs. CLE,L,40,8,19,0.421,0,8,0.0,1,1,1.0,0,4,4,7,0,1,4,2,17,-5,1,CHI,CHI,CLE,95,,,28,21,24,11
Coby White,G,22023,1629632,22300376,"DEC 21, 2023",CHI vs. SAS,W,36,10,15,0.667,2,6,0.333,0,0,0.0,0,6,6,5,0,0,3,2,22,9,1,CHI,CHI,SAS,114,,,33,28,27,11
Coby White,G,22023,1629632,22300370,"DEC 20, 2023",CHI vs. LAL,W,33,7,18,0.389,3,6,0.5,0,0,0.0,1,6,7,5,0,0,3,2,17,10,1,CHI,CHI,LAL,124,,,29,24,22,12
Coby White,G,22023,1629632,22300351,"DEC 18, 2023",CHI @ PHI,W,40,9,17,0.529,2,6,0.333,4,4,1.0,1,7,8,9,0,1,2,0,24,0,1,CHI,PHI,CHI,108,,,41,32,33,17
Coby White,G,22023,1629632,22300337,"DEC 16, 2023",CHI @ MIA,L,39,7,15,0.467,4,10,0.4,4,4,1.0,1,6,7,5,1,0,1,3,22,3,1,CHI,MIA,CHI,116,,,34,29,27,12
Coby White,G,22023,1629632,22300320,"DEC 14, 2023",CHI @ MIA,W,40,9,20,0.45,4,11,0.364,4,8,0.5,1,6,7,11,1,0,0,1,26,20,1,CHI,MIA,CHI,124,,,44,33,37,18
Coby White,G,22023,1629632,22300307,"DEC 12, 2023",CHI vs. DEN,L,35,8,15,0.533,5,10,0.5,6,6,1.0,2,2,4,8,1,0,2,2,27,-5,1,CHI,CHI,DEN,106,,,39,31,35,12
Coby White,G,22023,1629632,22300300,"DEC 11, 2023",CHI @ MIL,L,45,12,20,0.6,6,10,0.6,3,4,0.75,0,6,6,4,1,0,2,3,33,1,1,CHI,MIL,CHI,129,,,43,39,37,10
Coby White,G,22023,1629632,22301223,"DEC 08, 2023",CHI @ SAS,W,39,9,15,0.6,5,7,0.714,1,1,1.0,0,4,4,6,1,0,3,0,24,18,1,CHI,SAS,CHI,121,,,34,28,30,10
Coby White,G,22023,1629632,22301211,"DEC 06, 2023",CHI vs. CHA,W,38,6,16,0.375,3,7,0.429,4,5,0.8,0,9,9,5,0,0,0,3,19,6,1,CHI,CHI,CHA,111,,,33,28,24,14
Coby White,G,22023,1629632,22300285,"DEC 02, 2023",CHI vs. NOP,W,40,10,17,0.588,8,13,0.615,3,3,1.0,2,7,9,6,1,0,3,4,31,6,1,CHI,CHI,NOP,124,,,46,40,37,15
Coby White,G,22023,1629632,22300269,"NOV 30, 2023",CHI vs. MIL,W,45,7,20,0.35,4,11,0.364,5,6,0.833,0,4,4,7,1,1,3,3,23,1,1,CHI,CHI,MIL,120,,,34,27,30,11
Coby White,G,22023,1629632,22300053,"NOV 28, 2023",CHI @ BOS,L,30,7,12,0.583,3,5,0.6,2,2,1.0,0,1,1,3,0,0,0,0,19,-16,1,CHI,BOS,CHI,97,,,23,20,22,4
Coby White,G,22023,1629632,22300250,"NOV 26, 2023",CHI @ BKN,L,38,7,16,0.438,5,12,0.417,4,4,1.0,1,4,5,4,0,1,1,3,23,7,1,CHI,BKN,CHI,109,,,32,28,27,9
Coby White,G,22023,1629632,22300046,"NOV 24, 2023",CHI @ TOR,L,34,5,9,0.556,4,7,0.571,0,0,0.0,1,2,3,3,0,0,3,4,14,-9,1,CHI,TOR,CHI,108,,,20,17,17,6
Coby White,G,22023,1629632,22300234,"NOV 22, 2023",CHI @ OKC,L,37,8,17,0.471,7,12,0.583,0,0,0.0,0,1,1,5,1,0,3,5,23,-5,1,CHI,OKC,CHI,102,,,29,24,28,6
Coby White,G,22023,1629632,22300220,"NOV 20, 2023",CHI vs. MIA,L,34,7,11,0.636,4,8,0.5,2,2,1.0,1,4,5,3,1,1,2,2,20,-16,1,CHI,CHI,MIA,100,,,28,25,23,8
Coby White,G,22023,1629632,22300204,"NOV 18, 2023",CHI vs. MIA,W,29,5,13,0.385,4,10,0.4,0,0,0.0,0,3,3,5,1,0,3,5,14,-12,1,CHI,CHI,MIA,102,,,22,17,19,8
Coby White,G,22023,1629632,22300033,"NOV 17, 2023",CHI vs. ORL,L,30,2,6,0.333,0,3,0.0,0,1,0.0,0,1,1,4,1,0,2,2,4,9,1,CHI,CHI,ORL,97,,,9,5,8,5
Coby White,G,22023,1629632,22300196,"NOV 15, 2023",CHI vs. ORL,L,33,2,10,0.2,1,5,0.2,0,0,0.0,0,1,1,1,1,0,3,4,5,5,1,CHI,CHI,ORL,94,,,7,6,6,2
Coby White,G,22023,1629632,22300190,"NOV 13, 2023",CHI @ MIL,L,26,6,14,0.429,3,8,0.375,1,2,0.5,0,3,3,1,2,0,1,3,16,1,1,CHI,MIL,CHI,109,,,20,19,17,4
Coby White,G,22023,1629632,22300181,"NOV 12, 2023",CHI vs. DET,W,32,6,14,0.429,3,6,0.5,1,2,0.5,0,0,0,7,2,0,1,6,16,4,1,CHI,CHI,DET,119,,,23,16,23,7
Coby White,G,22023,1629632,22300162,"NOV 08, 2023",CHI vs. PHX,L,37,5,14,0.357,1,5,0.2,0,0,0.0,1,6,7,6,3,1,2,3,11,-11,1,CHI,CHI,PHX,115,,,24,18,17,13
Coby White,G,22023,1629632,22300152,"NOV 06, 2023",CHI vs. UTA,W,29,7,9,0.778,4,6,0.667,0,0,0.0,0,3,3,7,1,0,1,1,18,15,1,CHI,CHI,UTA,130,,,28,21,25,10
Coby White,G,22023,1629632,22300004,"NOV 03, 2023",CHI vs. BKN,L,35,7,17,0.412,2,8,0.25,2,2,1.0,1,2,3,2,0,1,2,0,18,3,1,CHI,CHI,BKN,107,,,23,21,20,5
Coby White,G,22023,1629632,22300124,"NOV 01, 2023",CHI @ DAL,L,33,4,12,0.333,1,6,0.167,1,2,0.5,0,1,1,4,0,0,3,3,10,-6,1,CHI,DAL,CHI,105,,,15,11,14,5
Coby White,G,22023,1629632,22300102,"OCT 30, 2023",CHI @ IND,W,25,3,6,0.5,1,2,0.5,0,0,0.0,0,2,2,3,1,0,1,4,7,5,1,CHI,IND,CHI,112,,,12,9,10,5
Coby White,G,22023,1629632,22300088,"OCT 28, 2023",CHI @ DET,L,28,0,4,0.0,0,2,0.0,0,0,0.0,0,2,2,1,0,0,1,1,0,-10,1,CHI,DET,CHI,102,,,3,2,1,3
Coby White,G,22023,1629632,22300082,"OCT 27, 2023",CHI vs. TOR,W,40,5,15,0.333,2,9,0.222,5,5,1.0,0,6,6,8,1,0,3,2,17,-1,1,CHI,CHI,TOR,104,,,31,23,25,14
Coby White,G,22023,1629632,22300070,"OCT 25, 2023",CHI vs. OKC,L,31,4,14,0.286,2,7,0.286,5,6,0.833,1,3,4,4,0,0,0,3,15,-8,1,CHI,CHI,OKC,104,,,23,19,19,8
Coby White,G,22023,1629632,22300752,"FEB 10, 2024",CHI @ ORL,L,45,5,21,0.238,2,11,0.182,2,2,1.0,1,3,4,7,2,0,1,2,14,1,1,CHI,ORL,CHI,108,,,25,18,21,11
Coby White,G,22023,1629632,22300536,"JAN 12, 2024",CHI vs. GSW,L,37,9,13,0.692,5,7,0.714,2,3,0.667,0,4,4,7,0,0,1,4,25,11,1,CHI,CHI,GSW,131,,,36,29,32,11
Coby White,G,22023,1629632,22300523,"JAN 10, 2024",CHI vs. HOU,W,43,9,17,0.529,6,11,0.545,6,7,0.857,0,4,4,8,0,1,4,1,30,15,1,CHI,CHI,HOU,124,,,42,34,38,12
Jalen Williams,F,22023,1631114,22300622,"JAN 24, 2024",OKC @ SAS,W,29,6,12,0.5,1,5,0.2,0,0,0.0,0,5,5,7,2,0,0,3,13,13,1,OKC,SAS,OKC,140,18.5,Points,25,18,20,12
Jalen Williams,F,22023,1631114,22300622,"JAN 24, 2024",OKC @ SAS,W,29,6,12,0.5,1,5,0.2,0,0,0.0,0,5,5,7,2,0,0,3,13,13,1,OKC,SAS,OKC,140,4.0,Rebounds,25,18,20,12
Jalen Williams,F,22023,1631114,22300622,"JAN 24, 2024",OKC @ SAS,W,29,6,12,0.5,1,5,0.2,0,0,0.0,0,5,5,7,2,0,0,3,13,13,1,OKC,SAS,OKC,140,28.5,Pts+Rebs+Asts,25,18,20,12
Jalen Williams,F,22023,1631114,22300622,"JAN 24, 2024",OKC @ SAS,W,29,6,12,0.5,1,5,0.2,0,0,0.0,0,5,5,7,2,0,0,3,13,13,1,OKC,SAS,OKC,140,5.0,Assists,25,18,20,12
Jalen Williams,F,22023,1631114,22300622,"JAN 24, 2024",OKC @ SAS,W,29,6,12,0.5,1,5,0.2,0,0,0.0,0,5,5,7,2,0,0,3,13,13,1,OKC,SAS,OKC,140,33.5,Fantasy Score,25,18,20,12
Jalen Williams,F,22023,1631114,22300622,"JAN 24, 2024",OKC @ SAS,W,29,6,12,0.5,1,5,0.2,0,0,0.0,0,5,5,7,2,0,0,3,13,13,1,OKC,SAS,OKC,140,1.5,3-PT Made,25,18,20,12
Jalen Williams,F,22023,1631114,22300622,"JAN 24, 2024",OKC @ SAS,W,29,6,12,0.5,1,5,0.2,0,0,0.0,0,5,5,7,2,0,0,3,13,13,1,OKC,SAS,OKC,140,2.5,Free Throws Made,25,18,20,12
Jalen Williams,F,22023,1631114,22300622,"JAN 24, 2024",OKC @ SAS,W,29,6,12,0.5,1,5,0.2,0,0,0.0,0,5,5,7,2,0,0,3,13,13,1,OKC,SAS,OKC,140,14.0,FG Attempted,25,18,20,12
Jalen Williams,F,22023,1631114,22300622,"JAN 24, 2024",OKC @ SAS,W,29,6,12,0.5,1,5,0.2,0,0,0.0,0,5,5,7,2,0,0,3,13,13,1,OKC,SAS,OKC,140,23.5,Pts+Rebs,25,18,20,12
Jalen Williams,F,22023,1631114,22300622,"JAN 24, 2024",OKC @ SAS,W,29,6,12,0.5,1,5,0.2,0,0,0.0,0,5,5,7,2,0,0,3,13,13,1,OKC,SAS,OKC,140,23.5,Pts+Asts,25,18,20,12
Jalen Williams,F,22023,1631114,22300622,"JAN 24, 2024",OKC @ SAS,W,29,6,12,0.5,1,5,0.2,0,0,0.0,0,5,5,7,2,0,0,3,13,13,1,OKC,SAS,OKC,140,9.5,Rebs+Asts,25,18,20,12
Jalen Williams,F,22023,1631114,22300617,"JAN 23, 2024",OKC vs. POR,W,32,9,20,0.45,1,3,0.333,0,0,0.0,0,4,4,2,2,2,0,1,19,8,1,OKC,OKC,POR,111,18.5,Points,25,23,21,6
Jalen Williams,F,22023,1631114,22300617,"JAN 23, 2024",OKC vs. POR,W,32,9,20,0.45,1,3,0.333,0,0,0.0,0,4,4,2,2,2,0,1,19,8,1,OKC,OKC,POR,111,4.0,Rebounds,25,23,21,6
Jalen Williams,F,22023,1631114,22300617,"JAN 23, 2024",OKC vs. POR,W,32,9,20,0.45,1,3,0.333,0,0,0.0,0,4,4,2,2,2,0,1,19,8,1,OKC,OKC,POR,111,28.5,Pts+Rebs+Asts,25,23,21,6
Jalen Williams,F,22023,1631114,22300617,"JAN 23, 2024",OKC vs. POR,W,32,9,20,0.45,1,3,0.333,0,0,0.0,0,4,4,2,2,2,0,1,19,8,1,OKC,OKC,POR,111,5.0,Assists,25,23,21,6
Jalen Williams,F,22023,1631114,22300617,"JAN 23, 2024",OKC vs. POR,W,32,9,20,0.45,1,3,0.333,0,0,0.0,0,4,4,2,2,2,0,1,19,8,1,OKC,OKC,POR,111,33.5,Fantasy Score,25,23,21,6
Jalen Williams,F,22023,1631114,22300617,"JAN 23, 2024",OKC vs. POR,W,32,9,20,0.45,1,3,0.333,0,0,0.0,0,4,4,2,2,2,0,1,19,8,1,OKC,OKC,POR,111,1.5,3-PT Made,25,23,21,6
Jalen Williams,F,22023,1631114,22300617,"JAN 23, 2024",OKC vs. POR,W,32,9,20,0.45,1,3,0.333,0,0,0.0,0,4,4,2,2,2,0,1,19,8,1,OKC,OKC,POR,111,2.5,Free Throws Made,25,23,21,6
Jalen Williams,F,22023,1631114,22300617,"JAN 23, 2024",OKC vs. POR,W,32,9,20,0.45,1,3,0.333,0,0,0.0,0,4,4,2,2,2,0,1,19,8,1,OKC,OKC,POR,111,14.0,FG Attempted,25,23,21,6
Jalen Williams,F,22023,1631114,22300617,"JAN 23, 2024",OKC vs. POR,W,32,9,20,0.45,1,3,0.333,0,0,0.0,0,4,4,2,2,2,0,1,19,8,1,OKC,OKC,POR,111,23.5,Pts+Rebs,25,23,21,6
Jalen Williams,F,22023,1631114,22300617,"JAN 23, 2024",OKC vs. POR,W,32,9,20,0.45,1,3,0.333,0,0,0.0,0,4,4,2,2,2,0,1,19,8,1,OKC,OKC,POR,111,23.5,Pts+Asts,25,23,21,6
Jalen Williams,F,22023,1631114,22300617,"JAN 23, 2024",OKC vs. POR,W,32,9,20,0.45,1,3,0.333,0,0,0.0,0,4,4,2,2,2,0,1,19,8,1,OKC,OKC,POR,111,9.5,Rebs+Asts,25,23,21,6
Jalen Williams,F,22023,1631114,22300481,"JAN 05, 2024",OKC @ BKN,L,36,8,11,0.727,2,4,0.5,2,3,0.667,0,5,5,5,0,1,3,3,20,3,1,OKC,BKN,OKC,115,18.5,Points,30,25,25,10
Jalen Williams,F,22023,1631114,22300481,"JAN 05, 2024",OKC @ BKN,L,36,8,11,0.727,2,4,0.5,2,3,0.667,0,5,5,5,0,1,3,3,20,3,1,OKC,BKN,OKC,115,4.0,Rebounds,30,25,25,10
Jalen Williams,F,22023,1631114,22300481,"JAN 05, 2024",OKC @ BKN,L,36,8,11,0.727,2,4,0.5,2,3,0.667,0,5,5,5,0,1,3,3,20,3,1,OKC,BKN,OKC,115,28.5,Pts+Rebs+Asts,30,25,25,10
Jalen Williams,F,22023,1631114,22300481,"JAN 05, 2024",OKC @ BKN,L,36,8,11,0.727,2,4,0.5,2,3,0.667,0,5,5,5,0,1,3,3,20,3,1,OKC,BKN,OKC,115,5.0,Assists,30,25,25,10
Jalen Williams,F,22023,1631114,22300481,"JAN 05, 2024",OKC @ BKN,L,36,8,11,0.727,2,4,0.5,2,3,0.667,0,5,5,5,0,1,3,3,20,3,1,OKC,BKN,OKC,115,33.5,Fantasy Score,30,25,25,10
Jalen Williams,F,22023,1631114,22300481,"JAN 05, 2024",OKC @ BKN,L,36,8,11,0.727,2,4,0.5,2,3,0.667,0,5,5,5,0,1,3,3,20,3,1,OKC,BKN,OKC,115,1.5,3-PT Made,30,25,25,10
Jalen Williams,F,22023,1631114,22300481,"JAN 05, 2024",OKC @ BKN,L,36,8,11,0.727,2,4,0.5,2,3,0.667,0,5,5,5,0,1,3,3,20,3,1,OKC,BKN,OKC,115,2.5,Free Throws Made,30,25,25,10
Jalen Williams,F,22023,1631114,22300481,"JAN 05, 2024",OKC @ BKN,L,36,8,11,0.727,2,4,0.5,2,3,0.667,0,5,5,5,0,1,3,3,20,3,1,OKC,BKN,OKC,115,14.0,FG Attempted,30,25,25,10
Jalen Williams,F,22023,1631114,22300481,"JAN 05, 2024",OKC @ BKN,L,36,8,11,0.727,2,4,0.5,2,3,0.667,0,5,5,5,0,1,3,3,20,3,1,OKC,BKN,OKC,115,23.5,Pts+Rebs,30,25,25,10
Jalen Williams,F,22023,1631114,22300481,"JAN 05, 2024",OKC @ BKN,L,36,8,11,0.727,2,4,0.5,2,3,0.667,0,5,5,5,0,1,3,3,20,3,1,OKC,BKN,OKC,115,23.5,Pts+Asts,30,25,25,10
Jalen Williams,F,22023,1631114,22300481,"JAN 05, 2024",OKC @ BKN,L,36,8,11,0.727,2,4,0.5,2,3,0.667,0,5,5,5,0,1,3,3,20,3,1,OKC,BKN,OKC,115,9.5,Rebs+Asts,30,25,25,10
Jalen Williams,F,22023,1631114,22300419,"DEC 27, 2023",OKC vs. NYK,W,33,13,17,0.765,5,5,1.0,5,7,0.714,0,0,0,3,1,1,0,4,36,-2,1,OKC,OKC,NYK,129,18.5,Points,39,36,39,3
Jalen Williams,F,22023,1631114,22300419,"DEC 27, 2023",OKC vs. NYK,W,33,13,17,0.765,5,5,1.0,5,7,0.714,0,0,0,3,1,1,0,4,36,-2,1,OKC,OKC,NYK,129,4.0,Rebounds,39,36,39,3
Jalen Williams,F,22023,1631114,22300419,"DEC 27, 2023",OKC vs. NYK,W,33,13,17,0.765,5,5,1.0,5,7,0.714,0,0,0,3,1,1,0,4,36,-2,1,OKC,OKC,NYK,129,28.5,Pts+Rebs+Asts,39,36,39,3
Jalen Williams,F,22023,1631114,22300419,"DEC 27, 2023",OKC vs. NYK,W,33,13,17,0.765,5,5,1.0,5,7,0.714,0,0,0,3,1,1,0,4,36,-2,1,OKC,OKC,NYK,129,5.0,Assists,39,36,39,3
Jalen Williams,F,22023,1631114,22300419,"DEC 27, 2023",OKC vs. NYK,W,33,13,17,0.765,5,5,1.0,5,7,0.714,0,0,0,3,1,1,0,4,36,-2,1,OKC,OKC,NYK,129,33.5,Fantasy Score,39,36,39,3
Jalen Williams,F,22023,1631114,22300419,"DEC 27, 2023",OKC vs. NYK,W,33,13,17,0.765,5,5,1.0,5,7,0.714,0,0,0,3,1,1,0,4,36,-2,1,OKC,OKC,NYK,129,1.5,3-PT Made,39,36,39,3
Jalen Williams,F,22023,1631114,22300419,"DEC 27, 2023",OKC vs. NYK,W,33,13,17,0.765,5,5,1.0,5,7,0.714,0,0,0,3,1,1,0,4,36,-2,1,OKC,OKC,NYK,129,2.5,Free Throws Made,39,36,39,3
Jalen Williams,F,22023,1631114,22300419,"DEC 27, 2023",OKC vs. NYK,W,33,13,17,0.765,5,5,1.0,5,7,0.714,0,0,0,3,1,1,0,4,36,-2,1,OKC,OKC,NYK,129,14.0,FG Attempted,39,36,39,3
Jalen Williams,F,22023,1631114,22300419,"DEC 27, 2023",OKC vs. NYK,W,33,13,17,0.765,5,5,1.0,5,7,0.714,0,0,0,3,1,1,0,4,36,-2,1,OKC,OKC,NYK,129,23.5,Pts+Rebs,39,36,39,3
Jalen Williams,F,22023,1631114,22300419,"DEC 27, 2023",OKC vs. NYK,W,33,13,17,0.765,5,5,1.0,5,7,0.714,0,0,0,3,1,1,0,4,36,-2,1,OKC,OKC,NYK,129,23.5,Pts+Asts,39,36,39,3
Jalen Williams,F,22023,1631114,22300419,"DEC 27, 2023",OKC vs. NYK,W,33,13,17,0.765,5,5,1.0,5,7,0.714,0,0,0,3,1,1,0,4,36,-2,1,OKC,OKC,NYK,129,9.5,Rebs+Asts,39,36,39,3
Jalen Williams,F,22023,1631114,22300397,"DEC 23, 2023",OKC vs. LAL,L,34,11,17,0.647,2,5,0.4,4,4,1.0,0,6,6,3,0,0,1,3,28,2,1,OKC,OKC,LAL,120,18.5,Points,37,34,31,9
Jalen Williams,F,22023,1631114,22300397,"DEC 23, 2023",OKC vs. LAL,L,34,11,17,0.647,2,5,0.4,4,4,1.0,0,6,6,3,0,0,1,3,28,2,1,OKC,OKC,LAL,120,4.0,Rebounds,37,34,31,9
Jalen Williams,F,22023,1631114,22300397,"DEC 23, 2023",OKC vs. LAL,L,34,11,17,0.647,2,5,0.4,4,4,1.0,0,6,6,3,0,0,1,3,28,2,1,OKC,OKC,LAL,120,28.5,Pts+Rebs+Asts,37,34,31,9
Jalen Williams,F,22023,1631114,22300397,"DEC 23, 2023",OKC vs. LAL,L,34,11,17,0.647,2,5,0.4,4,4,1.0,0,6,6,3,0,0,1,3,28,2,1,OKC,OKC,LAL,120,5.0,Assists,37,34,31,9
Jalen Williams,F,22023,1631114,22300397,"DEC 23, 2023",OKC vs. LAL,L,34,11,17,0.647,2,5,0.4,4,4,1.0,0,6,6,3,0,0,1,3,28,2,1,OKC,OKC,LAL,120,33.5,Fantasy Score,37,34,31,9
Jalen Williams,F,22023,1631114,22300397,"DEC 23, 2023",OKC vs. LAL,L,34,11,17,0.647,2,5,0.4,4,4,1.0,0,6,6,3,0,0,1,3,28,2,1,OKC,OKC,LAL,120,1.5,3-PT Made,37,34,31,9
Jalen Williams,F,22023,1631114,22300397,"DEC 23, 2023",OKC vs. LAL,L,34,11,17,0.647,2,5,0.4,4,4,1.0,0,6,6,3,0,0,1,3,28,2,1,OKC,OKC,LAL,120,2.5,Free Throws Made,37,34,31,9
Jalen Williams,F,22023,1631114,22300397,"DEC 23, 2023",OKC vs. LAL,L,34,11,17,0.647,2,5,0.4,4,4,1.0,0,6,6,3,0,0,1,3,28,2,1,OKC,OKC,LAL,120,14.0,FG Attempted,37,34,31,9
Jalen Williams,F,22023,1631114,22300397,"DEC 23, 2023",OKC vs. LAL,L,34,11,17,0.647,2,5,0.4,4,4,1.0,0,6,6,3,0,0,1,3,28,2,1,OKC,OKC,LAL,120,23.5,Pts+Rebs,37,34,31,9
Jalen Williams,F,22023,1631114,22300397,"DEC 23, 2023",OKC vs. LAL,L,34,11,17,0.647,2,5,0.4,4,4,1.0,0,6,6,3,0,0,1,3,28,2,1,OKC,OKC,LAL,120,23.5,Pts+Asts,37,34,31,9
Jalen Williams,F,22023,1631114,22300397,"DEC 23, 2023",OKC vs. LAL,L,34,11,17,0.647,2,5,0.4,4,4,1.0,0,6,6,3,0,0,1,3,28,2,1,OKC,OKC,LAL,120,9.5,Rebs+Asts,37,34,31,9
Jalen Williams,F,22023,1631114,22300324,"DEC 14, 2023",OKC @ SAC,L,29,2,14,0.143,0,4,0.0,1,1,1.0,2,2,4,3,1,1,1,3,5,2,1,OKC,SAC,OKC,123,18.5,Points,12,9,8,7
Jalen Williams,F,22023,1631114,22300324,"DEC 14, 2023",OKC @ SAC,L,29,2,14,0.143,0,4,0.0,1,1,1.0,2,2,4,3,1,1,1,3,5,2,1,OKC,SAC,OKC,123,4.0,Rebounds,12,9,8,7
Jalen Williams,F,22023,1631114,22300324,"DEC 14, 2023",OKC @ SAC,L,29,2,14,0.143,0,4,0.0,1,1,1.0,2,2,4,3,1,1,1,3,5,2,1,OKC,SAC,OKC,123,28.5,Pts+Rebs+Asts,12,9,8,7
Jalen Williams,F,22023,1631114,22300324,"DEC 14, 2023",OKC @ SAC,L,29,2,14,0.143,0,4,0.0,1,1,1.0,2,2,4,3,1,1,1,3,5,2,1,OKC,SAC,OKC,123,5.0,Assists,12,9,8,7
Jalen Williams,F,22023,1631114,22300324,"DEC 14, 2023",OKC @ SAC,L,29,2,14,0.143,0,4,0.0,1,1,1.0,2,2,4,3,1,1,1,3,5,2,1,OKC,SAC,OKC,123,33.5,Fantasy Score,12,9,8,7
Jalen Williams,F,22023,1631114,22300324,"DEC 14, 2023",OKC @ SAC,L,29,2,14,0.143,0,4,0.0,1,1,1.0,2,2,4,3,1,1,1,3,5,2,1,OKC,SAC,OKC,123,1.5,3-PT Made,12,9,8,7
Jalen Williams,F,22023,1631114,22300324,"DEC 14, 2023",OKC @ SAC,L,29,2,14,0.143,0,4,0.0,1,1,1.0,2,2,4,3,1,1,1,3,5,2,1,OKC,SAC,OKC,123,2.5,Free Throws Made,12,9,8,7
Jalen Williams,F,22023,1631114,22300324,"DEC 14, 2023",OKC @ SAC,L,29,2,14,0.143,0,4,0.0,1,1,1.0,2,2,4,3,1,1,1,3,5,2,1,OKC,SAC,OKC,123,14.0,FG Attempted,12,9,8,7
Jalen Williams,F,22023,1631114,22300324,"DEC 14, 2023",OKC @ SAC,L,29,2,14,0.143,0,4,0.0,1,1,1.0,2,2,4,3,1,1,1,3,5,2,1,OKC,SAC,OKC,123,23.5,Pts+Rebs,12,9,8,7
Jalen Williams,F,22023,1631114,22300324,"DEC 14, 2023",OKC @ SAC,L,29,2,14,0.143,0,4,0.0,1,1,1.0,2,2,4,3,1,1,1,3,5,2,1,OKC,SAC,OKC,123,23.5,Pts+Asts,12,9,8,7
Jalen Williams,F,22023,1631114,22300324,"DEC 14, 2023",OKC @ SAC,L,29,2,14,0.143,0,4,0.0,1,1,1.0,2,2,4,3,1,1,1,3,5,2,1,OKC,SAC,OKC,123,9.5,Rebs+Asts,12,9,8,7
Jalen Williams,F,22023,1631114,22300302,"DEC 11, 2023",OKC vs. UTA,W,22,5,10,0.5,2,2,1.0,3,3,1.0,1,2,3,3,0,0,2,1,15,16,1,OKC,OKC,UTA,134,18.5,Points,21,18,18,6
Jalen Williams,F,22023,1631114,22300302,"DEC 11, 2023",OKC vs. UTA,W,22,5,10,0.5,2,2,1.0,3,3,1.0,1,2,3,3,0,0,2,1,15,16,1,OKC,OKC,UTA,134,4.0,Rebounds,21,18,18,6
Jalen Williams,F,22023,1631114,22300302,"DEC 11, 2023",OKC vs. UTA,W,22,5,10,0.5,2,2,1.0,3,3,1.0,1,2,3,3,0,0,2,1,15,16,1,OKC,OKC,UTA,134,28.5,Pts+Rebs+Asts,21,18,18,6
Jalen Williams,F,22023,1631114,22300302,"DEC 11, 2023",OKC vs. UTA,W,22,5,10,0.5,2,2,1.0,3,3,1.0,1,2,3,3,0,0,2,1,15,16,1,OKC,OKC,UTA,134,5.0,Assists,21,18,18,6
Jalen Williams,F,22023,1631114,22300302,"DEC 11, 2023",OKC vs. UTA,W,22,5,10,0.5,2,2,1.0,3,3,1.0,1,2,3,3,0,0,2,1,15,16,1,OKC,OKC,UTA,134,33.5,Fantasy Score,21,18,18,6
Jalen Williams,F,22023,1631114,22300302,"DEC 11, 2023",OKC vs. UTA,W,22,5,10,0.5,2,2,1.0,3,3,1.0,1,2,3,3,0,0,2,1,15,16,1,OKC,OKC,UTA,134,1.5,3-PT Made,21,18,18,6
Jalen Williams,F,22023,1631114,22300302,"DEC 11, 2023",OKC vs. UTA,W,22,5,10,0.5,2,2,1.0,3,3,1.0,1,2,3,3,0,0,2,1,15,16,1,OKC,OKC,UTA,134,2.5,Free Throws Made,21,18,18,6
Jalen Williams,F,22023,1631114,22300302,"DEC 11, 2023",OKC vs. UTA,W,22,5,10,0.5,2,2,1.0,3,3,1.0,1,2,3,3,0,0,2,1,15,16,1,OKC,OKC,UTA,134,14.0,FG Attempted,21,18,18,6
Jalen Williams,F,22023,1631114,22300302,"DEC 11, 2023",OKC vs. UTA,W,22,5,10,0.5,2,2,1.0,3,3,1.0,1,2,3,3,0,0,2,1,15,16,1,OKC,OKC,UTA,134,23.5,Pts+Rebs,21,18,18,6
Jalen Williams,F,22023,1631114,22300302,"DEC 11, 2023",OKC vs. UTA,W,22,5,10,0.5,2,2,1.0,3,3,1.0,1,2,3,3,0,0,2,1,15,16,1,OKC,OKC,UTA,134,23.5,Pts+Asts,21,18,18,6
Jalen Williams,F,22023,1631114,22300302,"DEC 11, 2023",OKC vs. UTA,W,22,5,10,0.5,2,2,1.0,3,3,1.0,1,2,3,3,0,0,2,1,15,16,1,OKC,OKC,UTA,134,9.5,Rebs+Asts,21,18,18,6
Jalen Williams,F,22023,1631114,22301222,"DEC 08, 2023",OKC vs. GSW,W,40,12,15,0.8,1,1,1.0,3,4,0.75,0,5,5,2,3,1,1,3,28,-8,1,OKC,OKC,GSW,138,18.5,Points,35,33,30,7
Jalen Williams,F,22023,1631114,22301222,"DEC 08, 2023",OKC vs. GSW,W,40,12,15,0.8,1,1,1.0,3,4,0.75,0,5,5,2,3,1,1,3,28,-8,1,OKC,OKC,GSW,138,4.0,Rebounds,35,33,30,7
Jalen Williams,F,22023,1631114,22301222,"DEC 08, 2023",OKC vs. GSW,W,40,12,15,0.8,1,1,1.0,3,4,0.75,0,5,5,2,3,1,1,3,28,-8,1,OKC,OKC,GSW,138,28.5,Pts+Rebs+Asts,35,33,30,7
Jalen Williams,F,22023,1631114,22301222,"DEC 08, 2023",OKC vs. GSW,W,40,12,15,0.8,1,1,1.0,3,4,0.75,0,5,5,2,3,1,1,3,28,-8,1,OKC,OKC,GSW,138,5.0,Assists,35,33,30,7
Jalen Williams,F,22023,1631114,22301222,"DEC 08, 2023",OKC vs. GSW,W,40,12,15,0.8,1,1,1.0,3,4,0.75,0,5,5,2,3,1,1,3,28,-8,1,OKC,OKC,GSW,138,33.5,Fantasy Score,35,33,30,7
Jalen Williams,F,22023,1631114,22301222,"DEC 08, 2023",OKC vs. GSW,W,40,12,15,0.8,1,1,1.0,3,4,0.75,0,5,5,2,3,1,1,3,28,-8,1,OKC,OKC,GSW,138,1.5,3-PT Made,35,33,30,7
Jalen Williams,F,22023,1631114,22301222,"DEC 08, 2023",OKC vs. GSW,W,40,12,15,0.8,1,1,1.0,3,4,0.75,0,5,5,2,3,1,1,3,28,-8,1,OKC,OKC,GSW,138,2.5,Free Throws Made,35,33,30,7
Jalen Williams,F,22023,1631114,22301222,"DEC 08, 2023",OKC vs. GSW,W,40,12,15,0.8,1,1,1.0,3,4,0.75,0,5,5,2,3,1,1,3,28,-8,1,OKC,OKC,GSW,138,14.0,FG Attempted,35,33,30,7
Jalen Williams,F,22023,1631114,22301222,"DEC 08, 2023",OKC vs. GSW,W,40,12,15,0.8,1,1,1.0,3,4,0.75,0,5,5,2,3,1,1,3,28,-8,1,OKC,OKC,GSW,138,23.5,Pts+Rebs,35,33,30,7
Jalen Williams,F,22023,1631114,22301222,"DEC 08, 2023",OKC vs. GSW,W,40,12,15,0.8,1,1,1.0,3,4,0.75,0,5,5,2,3,1,1,3,28,-8,1,OKC,OKC,GSW,138,23.5,Pts+Asts,35,33,30,7
Jalen Williams,F,22023,1631114,22301222,"DEC 08, 2023",OKC vs. GSW,W,40,12,15,0.8,1,1,1.0,3,4,0.75,0,5,5,2,3,1,1,3,28,-8,1,OKC,OKC,GSW,138,9.5,Rebs+Asts,35,33,30,7
Jalen Williams,F,22023,1631114,22300287,"DEC 02, 2023",OKC @ DAL,W,30,9,19,0.474,3,5,0.6,2,2,1.0,2,3,5,5,1,0,1,3,23,-2,1,OKC,DAL,OKC,126,18.5,Points,33,28,28,10
Jalen Williams,F,22023,1631114,22300287,"DEC 02, 2023",OKC @ DAL,W,30,9,19,0.474,3,5,0.6,2,2,1.0,2,3,5,5,1,0,1,3,23,-2,1,OKC,DAL,OKC,126,4.0,Rebounds,33,28,28,10
Jalen Williams,F,22023,1631114,22300287,"DEC 02, 2023",OKC @ DAL,W,30,9,19,0.474,3,5,0.6,2,2,1.0,2,3,5,5,1,0,1,3,23,-2,1,OKC,DAL,OKC,126,28.5,Pts+Rebs+Asts,33,28,28,10
Jalen Williams,F,22023,1631114,22300287,"DEC 02, 2023",OKC @ DAL,W,30,9,19,0.474,3,5,0.6,2,2,1.0,2,3,5,5,1,0,1,3,23,-2,1,OKC,DAL,OKC,126,5.0,Assists,33,28,28,10
Jalen Williams,F,22023,1631114,22300287,"DEC 02, 2023",OKC @ DAL,W,30,9,19,0.474,3,5,0.6,2,2,1.0,2,3,5,5,1,0,1,3,23,-2,1,OKC,DAL,OKC,126,33.5,Fantasy Score,33,28,28,10
Jalen Williams,F,22023,1631114,22300287,"DEC 02, 2023",OKC @ DAL,W,30,9,19,0.474,3,5,0.6,2,2,1.0,2,3,5,5,1,0,1,3,23,-2,1,OKC,DAL,OKC,126,1.5,3-PT Made,33,28,28,10
Jalen Williams,F,22023,1631114,22300287,"DEC 02, 2023",OKC @ DAL,W,30,9,19,0.474,3,5,0.6,2,2,1.0,2,3,5,5,1,0,1,3,23,-2,1,OKC,DAL,OKC,126,2.5,Free Throws Made,33,28,28,10
Jalen Williams,F,22023,1631114,22300287,"DEC 02, 2023",OKC @ DAL,W,30,9,19,0.474,3,5,0.6,2,2,1.0,2,3,5,5,1,0,1,3,23,-2,1,OKC,DAL,OKC,126,14.0,FG Attempted,33,28,28,10
Jalen Williams,F,22023,1631114,22300287,"DEC 02, 2023",OKC @ DAL,W,30,9,19,0.474,3,5,0.6,2,2,1.0,2,3,5,5,1,0,1,3,23,-2,1,OKC,DAL,OKC,126,23.5,Pts+Rebs,33,28,28,10
Jalen Williams,F,22023,1631114,22300287,"DEC 02, 2023",OKC @ DAL,W,30,9,19,0.474,3,5,0.6,2,2,1.0,2,3,5,5,1,0,1,3,23,-2,1,OKC,DAL,OKC,126,23.5,Pts+Asts,33,28,28,10
Jalen Williams,F,22023,1631114,22300287,"DEC 02, 2023",OKC @ DAL,W,30,9,19,0.474,3,5,0.6,2,2,1.0,2,3,5,5,1,0,1,3,23,-2,1,OKC,DAL,OKC,126,9.5,Rebs+Asts,33,28,28,10
Jalen Williams,F,22023,1631114,22300185,"NOV 12, 2023",OKC @ PHX,W,38,11,16,0.688,3,4,0.75,6,8,0.75,0,1,1,1,2,0,1,4,31,23,1,OKC,PHX,OKC,111,18.5,Points,33,32,32,2
Jalen Williams,F,22023,1631114,22300185,"NOV 12, 2023",OKC @ PHX,W,38,11,16,0.688,3,4,0.75,6,8,0.75,0,1,1,1,2,0,1,4,31,23,1,OKC,PHX,OKC,111,4.0,Rebounds,33,32,32,2
Jalen Williams,F,22023,1631114,22300185,"NOV 12, 2023",OKC @ PHX,W,38,11,16,0.688,3,4,0.75,6,8,0.75,0,1,1,1,2,0,1,4,31,23,1,OKC,PHX,OKC,111,28.5,Pts+Rebs+Asts,33,32,32,2
Jalen Williams,F,22023,1631114,22300185,"NOV 12, 2023",OKC @ PHX,W,38,11,16,0.688,3,4,0.75,6,8,0.75,0,1,1,1,2,0,1,4,31,23,1,OKC,PHX,OKC,111,5.0,Assists,33,32,32,2
Jalen Williams,F,22023,1631114,22300185,"NOV 12, 2023",OKC @ PHX,W,38,11,16,0.688,3,4,0.75,6,8,0.75,0,1,1,1,2,0,1,4,31,23,1,OKC,PHX,OKC,111,33.5,Fantasy Score,33,32,32,2
Jalen Williams,F,22023,1631114,22300185,"NOV 12, 2023",OKC @ PHX,W,38,11,16,0.688,3,4,0.75,6,8,0.75,0,1,1,1,2,0,1,4,31,23,1,OKC,PHX,OKC,111,1.5,3-PT Made,33,32,32,2
Jalen Williams,F,22023,1631114,22300185,"NOV 12, 2023",OKC @ PHX,W,38,11,16,0.688,3,4,0.75,6,8,0.75,0,1,1,1,2,0,1,4,31,23,1,OKC,PHX,OKC,111,2.5,Free Throws Made,33,32,32,2
Jalen Williams,F,22023,1631114,22300185,"NOV 12, 2023",OKC @ PHX,W,38,11,16,0.688,3,4,0.75,6,8,0.75,0,1,1,1,2,0,1,4,31,23,1,OKC,PHX,OKC,111,14.0,FG Attempted,33,32,32,2
Jalen Williams,F,22023,1631114,22300185,"NOV 12, 2023",OKC @ PHX,W,38,11,16,0.688,3,4,0.75,6,8,0.75,0,1,1,1,2,0,1,4,31,23,1,OKC,PHX,OKC,111,23.5,Pts+Rebs,33,32,32,2
Jalen Williams,F,22023,1631114,22300185,"NOV 12, 2023",OKC @ PHX,W,38,11,16,0.688,3,4,0.75,6,8,0.75,0,1,1,1,2,0,1,4,31,23,1,OKC,PHX,OKC,111,23.5,Pts+Asts,33,32,32,2
Jalen Williams,F,22023,1631114,22300185,"NOV 12, 2023",OKC @ PHX,W,38,11,16,0.688,3,4,0.75,6,8,0.75,0,1,1,1,2,0,1,4,31,23,1,OKC,PHX,OKC,111,9.5,Rebs+Asts,33,32,32,2
Jalen Williams,F,22023,1631114,22300167,"NOV 08, 2023",OKC vs. CLE,W,33,5,10,0.5,1,1,1.0,4,4,1.0,1,3,4,2,1,0,1,3,15,-2,1,OKC,OKC,CLE,128,18.5,Points,21,19,17,6
Jalen Williams,F,22023,1631114,22300167,"NOV 08, 2023",OKC vs. CLE,W,33,5,10,0.5,1,1,1.0,4,4,1.0,1,3,4,2,1,0,1,3,15,-2,1,OKC,OKC,CLE,128,4.0,Rebounds,21,19,17,6
Jalen Williams,F,22023,1631114,22300167,"NOV 08, 2023",OKC vs. CLE,W,33,5,10,0.5,1,1,1.0,4,4,1.0,1,3,4,2,1,0,1,3,15,-2,1,OKC,OKC,CLE,128,28.5,Pts+Rebs+Asts,21,19,17,6
Jalen Williams,F,22023,1631114,22300167,"NOV 08, 2023",OKC vs. CLE,W,33,5,10,0.5,1,1,1.0,4,4,1.0,1,3,4,2,1,0,1,3,15,-2,1,OKC,OKC,CLE,128,5.0,Assists,21,19,17,6
Jalen Williams,F,22023,1631114,22300167,"NOV 08, 2023",OKC vs. CLE,W,33,5,10,0.5,1,1,1.0,4,4,1.0,1,3,4,2,1,0,1,3,15,-2,1,OKC,OKC,CLE,128,33.5,Fantasy Score,21,19,17,6
Jalen Williams,F,22023,1631114,22300167,"NOV 08, 2023",OKC vs. CLE,W,33,5,10,0.5,1,1,1.0,4,4,1.0,1,3,4,2,1,0,1,3,15,-2,1,OKC,OKC,CLE,128,1.5,3-PT Made,21,19,17,6
Jalen Williams,F,22023,1631114,22300167,"NOV 08, 2023",OKC vs. CLE,W,33,5,10,0.5,1,1,1.0,4,4,1.0,1,3,4,2,1,0,1,3,15,-2,1,OKC,OKC,CLE,128,2.5,Free Throws Made,21,19,17,6
Jalen Williams,F,22023,1631114,22300167,"NOV 08, 2023",OKC vs. CLE,W,33,5,10,0.5,1,1,1.0,4,4,1.0,1,3,4,2,1,0,1,3,15,-2,1,OKC,OKC,CLE,128,14.0,FG Attempted,21,19,17,6
Jalen Williams,F,22023,1631114,22300167,"NOV 08, 2023",OKC vs. CLE,W,33,5,10,0.5,1,1,1.0,4,4,1.0,1,3,4,2,1,0,1,3,15,-2,1,OKC,OKC,CLE,128,23.5,Pts+Rebs,21,19,17,6
Jalen Williams,F,22023,1631114,22300167,"NOV 08, 2023",OKC vs. CLE,W,33,5,10,0.5,1,1,1.0,4,4,1.0,1,3,4,2,1,0,1,3,15,-2,1,OKC,OKC,CLE,128,23.5,Pts+Asts,21,19,17,6
Jalen Williams,F,22023,1631114,22300167,"NOV 08, 2023",OKC vs. CLE,W,33,5,10,0.5,1,1,1.0,4,4,1.0,1,3,4,2,1,0,1,3,15,-2,1,OKC,OKC,CLE,128,9.5,Rebs+Asts,21,19,17,6
Jalen Williams,F,22023,1631114,22300109,"OCT 30, 2023",OKC vs. DET,W,31,8,14,0.571,1,3,0.333,2,2,1.0,0,7,7,6,1,1,2,2,19,13,1,OKC,OKC,DET,124,18.5,Points,32,26,25,13
Jalen Williams,F,22023,1631114,22300109,"OCT 30, 2023",OKC vs. DET,W,31,8,14,0.571,1,3,0.333,2,2,1.0,0,7,7,6,1,1,2,2,19,13,1,OKC,OKC,DET,124,4.0,Rebounds,32,26,25,13
Jalen Williams,F,22023,1631114,22300109,"OCT 30, 2023",OKC vs. DET,W,31,8,14,0.571,1,3,0.333,2,2,1.0,0,7,7,6,1,1,2,2,19,13,1,OKC,OKC,DET,124,28.5,Pts+Rebs+Asts,32,26,25,13
Jalen Williams,F,22023,1631114,22300109,"OCT 30, 2023",OKC vs. DET,W,31,8,14,0.571,1,3,0.333,2,2,1.0,0,7,7,6,1,1,2,2,19,13,1,OKC,OKC,DET,124,5.0,Assists,32,26,25,13
Jalen Williams,F,22023,1631114,22300109,"OCT 30, 2023",OKC vs. DET,W,31,8,14,0.571,1,3,0.333,2,2,1.0,0,7,7,6,1,1,2,2,19,13,1,OKC,OKC,DET,124,33.5,Fantasy Score,32,26,25,13
Jalen Williams,F,22023,1631114,22300109,"OCT 30, 2023",OKC vs. DET,W,31,8,14,0.571,1,3,0.333,2,2,1.0,0,7,7,6,1,1,2,2,19,13,1,OKC,OKC,DET,124,1.5,3-PT Made,32,26,25,13
Jalen Williams,F,22023,1631114,22300109,"OCT 30, 2023",OKC vs. DET,W,31,8,14,0.571,1,3,0.333,2,2,1.0,0,7,7,6,1,1,2,2,19,13,1,OKC,OKC,DET,124,2.5,Free Throws Made,32,26,25,13
Jalen Williams,F,22023,1631114,22300109,"OCT 30, 2023",OKC vs. DET,W,31,8,14,0.571,1,3,0.333,2,2,1.0,0,7,7,6,1,1,2,2,19,13,1,OKC,OKC,DET,124,14.0,FG Attempted,32,26,25,13
Jalen Williams,F,22023,1631114,22300109,"OCT 30, 2023",OKC vs. DET,W,31,8,14,0.571,1,3,0.333,2,2,1.0,0,7,7,6,1,1,2,2,19,13,1,OKC,OKC,DET,124,23.5,Pts+Rebs,32,26,25,13
Jalen Williams,F,22023,1631114,22300109,"OCT 30, 2023",OKC vs. DET,W,31,8,14,0.571,1,3,0.333,2,2,1.0,0,7,7,6,1,1,2,2,19,13,1,OKC,OKC,DET,124,23.5,Pts+Asts,32,26,25,13
Jalen Williams,F,22023,1631114,22300109,"OCT 30, 2023",OKC vs. DET,W,31,8,14,0.571,1,3,0.333,2,2,1.0,0,7,7,6,1,1,2,2,19,13,1,OKC,OKC,DET,124,9.5,Rebs+Asts,32,26,25,13
Jalen Williams,F,22023,1631114,22300748,"FEB 10, 2024",OKC @ DAL,L,27,4,10,0.4,1,3,0.333,0,0,0.0,1,2,3,7,0,0,2,2,9,-17,1,OKC,DAL,OKC,111,18.5,Points,19,12,16,10
Jalen Williams,F,22023,1631114,22300748,"FEB 10, 2024",OKC @ DAL,L,27,4,10,0.4,1,3,0.333,0,0,0.0,1,2,3,7,0,0,2,2,9,-17,1,OKC,DAL,OKC,111,4.0,Rebounds,19,12,16,10
Jalen Williams,F,22023,1631114,22300748,"FEB 10, 2024",OKC @ DAL,L,27,4,10,0.4,1,3,0.333,0,0,0.0,1,2,3,7,0,0,2,2,9,-17,1,OKC,DAL,OKC,111,28.5,Pts+Rebs+Asts,19,12,16,10
Jalen Williams,F,22023,1631114,22300748,"FEB 10, 2024",OKC @ DAL,L,27,4,10,0.4,1,3,0.333,0,0,0.0,1,2,3,7,0,0,2,2,9,-17,1,OKC,DAL,OKC,111,5.0,Assists,19,12,16,10
Jalen Williams,F,22023,1631114,22300748,"FEB 10, 2024",OKC @ DAL,L,27,4,10,0.4,1,3,0.333,0,0,0.0,1,2,3,7,0,0,2,2,9,-17,1,OKC,DAL,OKC,111,33.5,Fantasy Score,19,12,16,10
Jalen Williams,F,22023,1631114,22300748,"FEB 10, 2024",OKC @ DAL,L,27,4,10,0.4,1,3,0.333,0,0,0.0,1,2,3,7,0,0,2,2,9,-17,1,OKC,DAL,OKC,111,1.5,3-PT Made,19,12,16,10
Jalen Williams,F,22023,1631114,22300748,"FEB 10, 2024",OKC @ DAL,L,27,4,10,0.4,1,3,0.333,0,0,0.0,1,2,3,7,0,0,2,2,9,-17,1,OKC,DAL,OKC,111,2.5,Free Throws Made,19,12,16,10
Jalen Williams,F,22023,1631114,22300748,"FEB 10, 2024",OKC @ DAL,L,27,4,10,0.4,1,3,0.333,0,0,0.0,1,2,3,7,0,0,2,2,9,-17,1,OKC,DAL,OKC,111,14.0,FG Attempted,19,12,16,10
Jalen Williams,F,22023,1631114,22300748,"FEB 10, 2024",OKC @ DAL,L,27,4,10,0.4,1,3,0.333,0,0,0.0,1,2,3,7,0,0,2,2,9,-17,1,OKC,DAL,OKC,111,23.5,Pts+Rebs,19,12,16,10
Jalen Williams,F,22023,1631114,22300748,"FEB 10, 2024",OKC @ DAL,L,27,4,10,0.4,1,3,0.333,0,0,0.0,1,2,3,7,0,0,2,2,9,-17,1,OKC,DAL,OKC,111,23.5,Pts+Asts,19,12,16,10
Jalen Williams,F,22023,1631114,22300748,"FEB 10, 2024",OKC @ DAL,L,27,4,10,0.4,1,3,0.333,0,0,0.0,1,2,3,7,0,0,2,2,9,-17,1,OKC,DAL,OKC,111,9.5,Rebs+Asts,19,12,16,10
Jalen Williams,F,22023,1631114,22300724,"FEB 06, 2024",OKC @ UTA,L,35,10,18,0.556,3,6,0.5,3,4,0.75,1,4,5,5,1,0,2,0,26,-4,1,OKC,UTA,OKC,117,18.5,Points,36,31,31,10
Jalen Williams,F,22023,1631114,22300724,"FEB 06, 2024",OKC @ UTA,L,35,10,18,0.556,3,6,0.5,3,4,0.75,1,4,5,5,1,0,2,0,26,-4,1,OKC,UTA,OKC,117,4.0,Rebounds,36,31,31,10
Jalen Williams,F,22023,1631114,22300724,"FEB 06, 2024",OKC @ UTA,L,35,10,18,0.556,3,6,0.5,3,4,0.75,1,4,5,5,1,0,2,0,26,-4,1,OKC,UTA,OKC,117,28.5,Pts+Rebs+Asts,36,31,31,10
Jalen Williams,F,22023,1631114,22300724,"FEB 06, 2024",OKC @ UTA,L,35,10,18,0.556,3,6,0.5,3,4,0.75,1,4,5,5,1,0,2,0,26,-4,1,OKC,UTA,OKC,117,5.0,Assists,36,31,31,10
Jalen Williams,F,22023,1631114,22300724,"FEB 06, 2024",OKC @ UTA,L,35,10,18,0.556,3,6,0.5,3,4,0.75,1,4,5,5,1,0,2,0,26,-4,1,OKC,UTA,OKC,117,33.5,Fantasy Score,36,31,31,10
Jalen Williams,F,22023,1631114,22300724,"FEB 06, 2024",OKC @ UTA,L,35,10,18,0.556,3,6,0.5,3,4,0.75,1,4,5,5,1,0,2,0,26,-4,1,OKC,UTA,OKC,117,1.5,3-PT Made,36,31,31,10
Jalen Williams,F,22023,1631114,22300724,"FEB 06, 2024",OKC @ UTA,L,35,10,18,0.556,3,6,0.5,3,4,0.75,1,4,5,5,1,0,2,0,26,-4,1,OKC,UTA,OKC,117,2.5,Free Throws Made,36,31,31,10
Jalen Williams,F,22023,1631114,22300724,"FEB 06, 2024",OKC @ UTA,L,35,10,18,0.556,3,6,0.5,3,4,0.75,1,4,5,5,1,0,2,0,26,-4,1,OKC,UTA,OKC,117,14.0,FG Attempted,36,31,31,10
Jalen Williams,F,22023,1631114,22300724,"FEB 06, 2024",OKC @ UTA,L,35,10,18,0.556,3,6,0.5,3,4,0.75,1,4,5,5,1,0,2,0,26,-4,1,OKC,UTA,OKC,117,23.5,Pts+Rebs,36,31,31,10
Jalen Williams,F,22023,1631114,22300724,"FEB 06, 2024",OKC @ UTA,L,35,10,18,0.556,3,6,0.5,3,4,0.75,1,4,5,5,1,0,2,0,26,-4,1,OKC,UTA,OKC,117,23.5,Pts+Asts,36,31,31,10
Jalen Williams,F,22023,1631114,22300724,"FEB 06, 2024",OKC @ UTA,L,35,10,18,0.556,3,6,0.5,3,4,0.75,1,4,5,5,1,0,2,0,26,-4,1,OKC,UTA,OKC,117,9.5,Rebs+Asts,36,31,31,10
Jalen Williams,F,22023,1631114,22300568,"JAN 16, 2024",OKC @ LAC,L,33,10,14,0.714,2,3,0.667,3,3,1.0,0,3,3,7,0,0,4,5,25,-5,1,OKC,LAC,OKC,117,18.5,Points,35,28,32,10
Jalen Williams,F,22023,1631114,22300568,"JAN 16, 2024",OKC @ LAC,L,33,10,14,0.714,2,3,0.667,3,3,1.0,0,3,3,7,0,0,4,5,25,-5,1,OKC,LAC,OKC,117,4.0,Rebounds,35,28,32,10
Jalen Williams,F,22023,1631114,22300568,"JAN 16, 2024",OKC @ LAC,L,33,10,14,0.714,2,3,0.667,3,3,1.0,0,3,3,7,0,0,4,5,25,-5,1,OKC,LAC,OKC,117,28.5,Pts+Rebs+Asts,35,28,32,10
Jalen Williams,F,22023,1631114,22300568,"JAN 16, 2024",OKC @ LAC,L,33,10,14,0.714,2,3,0.667,3,3,1.0,0,3,3,7,0,0,4,5,25,-5,1,OKC,LAC,OKC,117,5.0,Assists,35,28,32,10
Jalen Williams,F,22023,1631114,22300568,"JAN 16, 2024",OKC @ LAC,L,33,10,14,0.714,2,3,0.667,3,3,1.0,0,3,3,7,0,0,4,5,25,-5,1,OKC,LAC,OKC,117,33.5,Fantasy Score,35,28,32,10
Jalen Williams,F,22023,1631114,22300568,"JAN 16, 2024",OKC @ LAC,L,33,10,14,0.714,2,3,0.667,3,3,1.0,0,3,3,7,0,0,4,5,25,-5,1,OKC,LAC,OKC,117,1.5,3-PT Made,35,28,32,10
Jalen Williams,F,22023,1631114,22300568,"JAN 16, 2024",OKC @ LAC,L,33,10,14,0.714,2,3,0.667,3,3,1.0,0,3,3,7,0,0,4,5,25,-5,1,OKC,LAC,OKC,117,2.5,Free Throws Made,35,28,32,10
Jalen Williams,F,22023,1631114,22300568,"JAN 16, 2024",OKC @ LAC,L,33,10,14,0.714,2,3,0.667,3,3,1.0,0,3,3,7,0,0,4,5,25,-5,1,OKC,LAC,OKC,117,14.0,FG Attempted,35,28,32,10
Jalen Williams,F,22023,1631114,22300568,"JAN 16, 2024",OKC @ LAC,L,33,10,14,0.714,2,3,0.667,3,3,1.0,0,3,3,7,0,0,4,5,25,-5,1,OKC,LAC,OKC,117,23.5,Pts+Rebs,35,28,32,10
Jalen Williams,F,22023,1631114,22300568,"JAN 16, 2024",OKC @ LAC,L,33,10,14,0.714,2,3,0.667,3,3,1.0,0,3,3,7,0,0,4,5,25,-5,1,OKC,LAC,OKC,117,23.5,Pts+Asts,35,28,32,10
Jalen Williams,F,22023,1631114,22300568,"JAN 16, 2024",OKC @ LAC,L,33,10,14,0.714,2,3,0.667,3,3,1.0,0,3,3,7,0,0,4,5,25,-5,1,OKC,LAC,OKC,117,9.5,Rebs+Asts,35,28,32,10
Jalen Williams,F,22023,1631114,22300565,"JAN 15, 2024",OKC @ LAL,L,35,10,18,0.556,2,4,0.5,3,4,0.75,2,1,3,6,3,0,1,1,25,1,1,OKC,LAL,OKC,105,18.5,Points,34,28,31,9
Jalen Williams,F,22023,1631114,22300565,"JAN 15, 2024",OKC @ LAL,L,35,10,18,0.556,2,4,0.5,3,4,0.75,2,1,3,6,3,0,1,1,25,1,1,OKC,LAL,OKC,105,4.0,Rebounds,34,28,31,9
Jalen Williams,F,22023,1631114,22300565,"JAN 15, 2024",OKC @ LAL,L,35,10,18,0.556,2,4,0.5,3,4,0.75,2,1,3,6,3,0,1,1,25,1,1,OKC,LAL,OKC,105,28.5,Pts+Rebs+Asts,34,28,31,9
Jalen Williams,F,22023,1631114,22300565,"JAN 15, 2024",OKC @ LAL,L,35,10,18,0.556,2,4,0.5,3,4,0.75,2,1,3,6,3,0,1,1,25,1,1,OKC,LAL,OKC,105,5.0,Assists,34,28,31,9
Jalen Williams,F,22023,1631114,22300565,"JAN 15, 2024",OKC @ LAL,L,35,10,18,0.556,2,4,0.5,3,4,0.75,2,1,3,6,3,0,1,1,25,1,1,OKC,LAL,OKC,105,33.5,Fantasy Score,34,28,31,9
Jalen Williams,F,22023,1631114,22300565,"JAN 15, 2024",OKC @ LAL,L,35,10,18,0.556,2,4,0.5,3,4,0.75,2,1,3,6,3,0,1,1,25,1,1,OKC,LAL,OKC,105,1.5,3-PT Made,34,28,31,9
Jalen Williams,F,22023,1631114,22300565,"JAN 15, 2024",OKC @ LAL,L,35,10,18,0.556,2,4,0.5,3,4,0.75,2,1,3,6,3,0,1,1,25,1,1,OKC,LAL,OKC,105,2.5,Free Throws Made,34,28,31,9
Jalen Williams,F,22023,1631114,22300565,"JAN 15, 2024",OKC @ LAL,L,35,10,18,0.556,2,4,0.5,3,4,0.75,2,1,3,6,3,0,1,1,25,1,1,OKC,LAL,OKC,105,14.0,FG Attempted,34,28,31,9
Jalen Williams,F,22023,1631114,22300565,"JAN 15, 2024",OKC @ LAL,L,35,10,18,0.556,2,4,0.5,3,4,0.75,2,1,3,6,3,0,1,1,25,1,1,OKC,LAL,OKC,105,23.5,Pts+Rebs,34,28,31,9
Jalen Williams,F,22023,1631114,22300565,"JAN 15, 2024",OKC @ LAL,L,35,10,18,0.556,2,4,0.5,3,4,0.75,2,1,3,6,3,0,1,1,25,1,1,OKC,LAL,OKC,105,23.5,Pts+Asts,34,28,31,9
Jalen Williams,F,22023,1631114,22300565,"JAN 15, 2024",OKC @ LAL,L,35,10,18,0.556,2,4,0.5,3,4,0.75,2,1,3,6,3,0,1,1,25,1,1,OKC,LAL,OKC,105,9.5,Rebs+Asts,34,28,31,9
Jalen Williams,F,22023,1631114,22300546,"JAN 13, 2024",OKC vs. ORL,W,33,7,16,0.438,1,3,0.333,1,1,1.0,2,4,6,2,0,0,2,1,16,12,1,OKC,OKC,ORL,112,18.5,Points,24,22,18,8
Jalen Williams,F,22023,1631114,22300546,"JAN 13, 2024",OKC vs. ORL,W,33,7,16,0.438,1,3,0.333,1,1,1.0,2,4,6,2,0,0,2,1,16,12,1,OKC,OKC,ORL,112,4.0,Rebounds,24,22,18,8
Jalen Williams,F,22023,1631114,22300546,"JAN 13, 2024",OKC vs. ORL,W,33,7,16,0.438,1,3,0.333,1,1,1.0,2,4,6,2,0,0,2,1,16,12,1,OKC,OKC,ORL,112,28.5,Pts+Rebs+Asts,24,22,18,8
Jalen Williams,F,22023,1631114,22300546,"JAN 13, 2024",OKC vs. ORL,W,33,7,16,0.438,1,3,0.333,1,1,1.0,2,4,6,2,0,0,2,1,16,12,1,OKC,OKC,ORL,112,5.0,Assists,24,22,18,8
Jalen Williams,F,22023,1631114,22300546,"JAN 13, 2024",OKC vs. ORL,W,33,7,16,0.438,1,3,0.333,1,1,1.0,2,4,6,2,0,0,2,1,16,12,1,OKC,OKC,ORL,112,33.5,Fantasy Score,24,22,18,8
Jalen Williams,F,22023,1631114,22300546,"JAN 13, 2024",OKC vs. ORL,W,33,7,16,0.438,1,3,0.333,1,1,1.0,2,4,6,2,0,0,2,1,16,12,1,OKC,OKC,ORL,112,1.5,3-PT Made,24,22,18,8
Jalen Williams,F,22023,1631114,22300546,"JAN 13, 2024",OKC vs. ORL,W,33,7,16,0.438,1,3,0.333,1,1,1.0,2,4,6,2,0,0,2,1,16,12,1,OKC,OKC,ORL,112,2.5,Free Throws Made,24,22,18,8
Jalen Williams,F,22023,1631114,22300546,"JAN 13, 2024",OKC vs. ORL,W,33,7,16,0.438,1,3,0.333,1,1,1.0,2,4,6,2,0,0,2,1,16,12,1,OKC,OKC,ORL,112,14.0,FG Attempted,24,22,18,8
Jalen Williams,F,22023,1631114,22300546,"JAN 13, 2024",OKC vs. ORL,W,33,7,16,0.438,1,3,0.333,1,1,1.0,2,4,6,2,0,0,2,1,16,12,1,OKC,OKC,ORL,112,23.5,Pts+Rebs,24,22,18,8
Jalen Williams,F,22023,1631114,22300546,"JAN 13, 2024",OKC vs. ORL,W,33,7,16,0.438,1,3,0.333,1,1,1.0,2,4,6,2,0,0,2,1,16,12,1,OKC,OKC,ORL,112,23.5,Pts+Asts,24,22,18,8
Jalen Williams,F,22023,1631114,22300546,"JAN 13, 2024",OKC vs. ORL,W,33,7,16,0.438,1,3,0.333,1,1,1.0,2,4,6,2,0,0,2,1,16,12,1,OKC,OKC,ORL,112,9.5,Rebs+Asts,24,22,18,8
Jalen Williams,F,22023,1631114,22300529,"JAN 11, 2024",OKC vs. POR,W,19,9,10,0.9,1,1,1.0,2,3,0.667,3,4,7,4,0,2,1,0,21,39,1,OKC,OKC,POR,139,18.5,Points,32,28,25,11
Jalen Williams,F,22023,1631114,22300529,"JAN 11, 2024",OKC vs. POR,W,19,9,10,0.9,1,1,1.0,2,3,0.667,3,4,7,4,0,2,1,0,21,39,1,OKC,OKC,POR,139,4.0,Rebounds,32,28,25,11
Jalen Williams,F,22023,1631114,22300529,"JAN 11, 2024",OKC vs. POR,W,19,9,10,0.9,1,1,1.0,2,3,0.667,3,4,7,4,0,2,1,0,21,39,1,OKC,OKC,POR,139,28.5,Pts+Rebs+Asts,32,28,25,11
Jalen Williams,F,22023,1631114,22300529,"JAN 11, 2024",OKC vs. POR,W,19,9,10,0.9,1,1,1.0,2,3,0.667,3,4,7,4,0,2,1,0,21,39,1,OKC,OKC,POR,139,5.0,Assists,32,28,25,11
Jalen Williams,F,22023,1631114,22300529,"JAN 11, 2024",OKC vs. POR,W,19,9,10,0.9,1,1,1.0,2,3,0.667,3,4,7,4,0,2,1,0,21,39,1,OKC,OKC,POR,139,33.5,Fantasy Score,32,28,25,11
Jalen Williams,F,22023,1631114,22300529,"JAN 11, 2024",OKC vs. POR,W,19,9,10,0.9,1,1,1.0,2,3,0.667,3,4,7,4,0,2,1,0,21,39,1,OKC,OKC,POR,139,1.5,3-PT Made,32,28,25,11
Jalen Williams,F,22023,1631114,22300529,"JAN 11, 2024",OKC vs. POR,W,19,9,10,0.9,1,1,1.0,2,3,0.667,3,4,7,4,0,2,1,0,21,39,1,OKC,OKC,POR,139,2.5,Free Throws Made,32,28,25,11
Jalen Williams,F,22023,1631114,22300529,"JAN 11, 2024",OKC vs. POR,W,19,9,10,0.9,1,1,1.0,2,3,0.667,3,4,7,4,0,2,1,0,21,39,1,OKC,OKC,POR,139,14.0,FG Attempted,32,28,25,11
Jalen Williams,F,22023,1631114,22300529,"JAN 11, 2024",OKC vs. POR,W,19,9,10,0.9,1,1,1.0,2,3,0.667,3,4,7,4,0,2,1,0,21,39,1,OKC,OKC,POR,139,23.5,Pts+Rebs,32,28,25,11
Jalen Williams,F,22023,1631114,22300529,"JAN 11, 2024",OKC vs. POR,W,19,9,10,0.9,1,1,1.0,2,3,0.667,3,4,7,4,0,2,1,0,21,39,1,OKC,OKC,POR,139,23.5,Pts+Asts,32,28,25,11
Jalen Williams,F,22023,1631114,22300529,"JAN 11, 2024",OKC vs. POR,W,19,9,10,0.9,1,1,1.0,2,3,0.667,3,4,7,4,0,2,1,0,21,39,1,OKC,OKC,POR,139,9.5,Rebs+Asts,32,28,25,11
Jalen Williams,F,22023,1631114,22300379,"DEC 21, 2023",OKC vs. LAC,W,29,6,11,0.545,1,3,0.333,0,0,0.0,1,3,4,7,2,0,2,0,13,24,1,OKC,OKC,LAC,134,18.5,Points,24,17,20,11
Jalen Williams,F,22023,1631114,22300379,"DEC 21, 2023",OKC vs. LAC,W,29,6,11,0.545,1,3,0.333,0,0,0.0,1,3,4,7,2,0,2,0,13,24,1,OKC,OKC,LAC,134,4.0,Rebounds,24,17,20,11
Jalen Williams,F,22023,1631114,22300379,"DEC 21, 2023",OKC vs. LAC,W,29,6,11,0.545,1,3,0.333,0,0,0.0,1,3,4,7,2,0,2,0,13,24,1,OKC,OKC,LAC,134,28.5,Pts+Rebs+Asts,24,17,20,11
Jalen Williams,F,22023,1631114,22300379,"DEC 21, 2023",OKC vs. LAC,W,29,6,11,0.545,1,3,0.333,0,0,0.0,1,3,4,7,2,0,2,0,13,24,1,OKC,OKC,LAC,134,5.0,Assists,24,17,20,11
Jalen Williams,F,22023,1631114,22300379,"DEC 21, 2023",OKC vs. LAC,W,29,6,11,0.545,1,3,0.333,0,0,0.0,1,3,4,7,2,0,2,0,13,24,1,OKC,OKC,LAC,134,33.5,Fantasy Score,24,17,20,11
Jalen Williams,F,22023,1631114,22300379,"DEC 21, 2023",OKC vs. LAC,W,29,6,11,0.545,1,3,0.333,0,0,0.0,1,3,4,7,2,0,2,0,13,24,1,OKC,OKC,LAC,134,1.5,3-PT Made,24,17,20,11
Jalen Williams,F,22023,1631114,22300379,"DEC 21, 2023",OKC vs. LAC,W,29,6,11,0.545,1,3,0.333,0,0,0.0,1,3,4,7,2,0,2,0,13,24,1,OKC,OKC,LAC,134,2.5,Free Throws Made,24,17,20,11
Jalen Williams,F,22023,1631114,22300379,"DEC 21, 2023",OKC vs. LAC,W,29,6,11,0.545,1,3,0.333,0,0,0.0,1,3,4,7,2,0,2,0,13,24,1,OKC,OKC,LAC,134,14.0,FG Attempted,24,17,20,11
Jalen Williams,F,22023,1631114,22300379,"DEC 21, 2023",OKC vs. LAC,W,29,6,11,0.545,1,3,0.333,0,0,0.0,1,3,4,7,2,0,2,0,13,24,1,OKC,OKC,LAC,134,23.5,Pts+Rebs,24,17,20,11
Jalen Williams,F,22023,1631114,22300379,"DEC 21, 2023",OKC vs. LAC,W,29,6,11,0.545,1,3,0.333,0,0,0.0,1,3,4,7,2,0,2,0,13,24,1,OKC,OKC,LAC,134,23.5,Pts+Asts,24,17,20,11
Jalen Williams,F,22023,1631114,22300379,"DEC 21, 2023",OKC vs. LAC,W,29,6,11,0.545,1,3,0.333,0,0,0.0,1,3,4,7,2,0,2,0,13,24,1,OKC,OKC,LAC,134,9.5,Rebs+Asts,24,17,20,11
Jalen Williams,F,22023,1631114,22300355,"DEC 18, 2023",OKC vs. MEM,W,28,3,9,0.333,1,3,0.333,3,4,0.75,0,4,4,5,2,1,0,2,10,14,1,OKC,OKC,MEM,116,18.5,Points,19,14,15,9
Jalen Williams,F,22023,1631114,22300355,"DEC 18, 2023",OKC vs. MEM,W,28,3,9,0.333,1,3,0.333,3,4,0.75,0,4,4,5,2,1,0,2,10,14,1,OKC,OKC,MEM,116,4.0,Rebounds,19,14,15,9
Jalen Williams,F,22023,1631114,22300355,"DEC 18, 2023",OKC vs. MEM,W,28,3,9,0.333,1,3,0.333,3,4,0.75,0,4,4,5,2,1,0,2,10,14,1,OKC,OKC,MEM,116,28.5,Pts+Rebs+Asts,19,14,15,9
Jalen Williams,F,22023,1631114,22300355,"DEC 18, 2023",OKC vs. MEM,W,28,3,9,0.333,1,3,0.333,3,4,0.75,0,4,4,5,2,1,0,2,10,14,1,OKC,OKC,MEM,116,5.0,Assists,19,14,15,9
Jalen Williams,F,22023,1631114,22300355,"DEC 18, 2023",OKC vs. MEM,W,28,3,9,0.333,1,3,0.333,3,4,0.75,0,4,4,5,2,1,0,2,10,14,1,OKC,OKC,MEM,116,33.5,Fantasy Score,19,14,15,9
Jalen Williams,F,22023,1631114,22300355,"DEC 18, 2023",OKC vs. MEM,W,28,3,9,0.333,1,3,0.333,3,4,0.75,0,4,4,5,2,1,0,2,10,14,1,OKC,OKC,MEM,116,1.5,3-PT Made,19,14,15,9
Jalen Williams,F,22023,1631114,22300355,"DEC 18, 2023",OKC vs. MEM,W,28,3,9,0.333,1,3,0.333,3,4,0.75,0,4,4,5,2,1,0,2,10,14,1,OKC,OKC,MEM,116,2.5,Free Throws Made,19,14,15,9
Jalen Williams,F,22023,1631114,22300355,"DEC 18, 2023",OKC vs. MEM,W,28,3,9,0.333,1,3,0.333,3,4,0.75,0,4,4,5,2,1,0,2,10,14,1,OKC,OKC,MEM,116,14.0,FG Attempted,19,14,15,9
Jalen Williams,F,22023,1631114,22300355,"DEC 18, 2023",OKC vs. MEM,W,28,3,9,0.333,1,3,0.333,3,4,0.75,0,4,4,5,2,1,0,2,10,14,1,OKC,OKC,MEM,116,23.5,Pts+Rebs,19,14,15,9
Jalen Williams,F,22023,1631114,22300355,"DEC 18, 2023",OKC vs. MEM,W,28,3,9,0.333,1,3,0.333,3,4,0.75,0,4,4,5,2,1,0,2,10,14,1,OKC,OKC,MEM,116,23.5,Pts+Asts,19,14,15,9
Jalen Williams,F,22023,1631114,22300355,"DEC 18, 2023",OKC vs. MEM,W,28,3,9,0.333,1,3,0.333,3,4,0.75,0,4,4,5,2,1,0,2,10,14,1,OKC,OKC,MEM,116,9.5,Rebs+Asts,19,14,15,9
Jalen Williams,F,22023,1631114,22300340,"DEC 16, 2023",OKC @ DEN,W,33,11,20,0.55,0,1,0.0,2,2,1.0,0,1,1,3,1,0,2,1,24,10,1,OKC,DEN,OKC,118,18.5,Points,28,25,27,4
Jalen Williams,F,22023,1631114,22300340,"DEC 16, 2023",OKC @ DEN,W,33,11,20,0.55,0,1,0.0,2,2,1.0,0,1,1,3,1,0,2,1,24,10,1,OKC,DEN,OKC,118,4.0,Rebounds,28,25,27,4
Jalen Williams,F,22023,1631114,22300340,"DEC 16, 2023",OKC @ DEN,W,33,11,20,0.55,0,1,0.0,2,2,1.0,0,1,1,3,1,0,2,1,24,10,1,OKC,DEN,OKC,118,28.5,Pts+Rebs+Asts,28,25,27,4
Jalen Williams,F,22023,1631114,22300340,"DEC 16, 2023",OKC @ DEN,W,33,11,20,0.55,0,1,0.0,2,2,1.0,0,1,1,3,1,0,2,1,24,10,1,OKC,DEN,OKC,118,5.0,Assists,28,25,27,4
Jalen Williams,F,22023,1631114,22300340,"DEC 16, 2023",OKC @ DEN,W,33,11,20,0.55,0,1,0.0,2,2,1.0,0,1,1,3,1,0,2,1,24,10,1,OKC,DEN,OKC,118,33.5,Fantasy Score,28,25,27,4
Jalen Williams,F,22023,1631114,22300340,"DEC 16, 2023",OKC @ DEN,W,33,11,20,0.55,0,1,0.0,2,2,1.0,0,1,1,3,1,0,2,1,24,10,1,OKC,DEN,OKC,118,1.5,3-PT Made,28,25,27,4
Jalen Williams,F,22023,1631114,22300340,"DEC 16, 2023",OKC @ DEN,W,33,11,20,0.55,0,1,0.0,2,2,1.0,0,1,1,3,1,0,2,1,24,10,1,OKC,DEN,OKC,118,2.5,Free Throws Made,28,25,27,4
Jalen Williams,F,22023,1631114,22300340,"DEC 16, 2023",OKC @ DEN,W,33,11,20,0.55,0,1,0.0,2,2,1.0,0,1,1,3,1,0,2,1,24,10,1,OKC,DEN,OKC,118,14.0,FG Attempted,28,25,27,4
Jalen Williams,F,22023,1631114,22300340,"DEC 16, 2023",OKC @ DEN,W,33,11,20,0.55,0,1,0.0,2,2,1.0,0,1,1,3,1,0,2,1,24,10,1,OKC,DEN,OKC,118,23.5,Pts+Rebs,28,25,27,4
Jalen Williams,F,22023,1631114,22300340,"DEC 16, 2023",OKC @ DEN,W,33,11,20,0.55,0,1,0.0,2,2,1.0,0,1,1,3,1,0,2,1,24,10,1,OKC,DEN,OKC,118,23.5,Pts+Asts,28,25,27,4
Jalen Williams,F,22023,1631114,22300340,"DEC 16, 2023",OKC @ DEN,W,33,11,20,0.55,0,1,0.0,2,2,1.0,0,1,1,3,1,0,2,1,24,10,1,OKC,DEN,OKC,118,9.5,Rebs+Asts,28,25,27,4
Jalen Williams,F,22023,1631114,22300058,"NOV 28, 2023",OKC @ MIN,L,34,2,10,0.2,0,3,0.0,6,7,0.857,0,3,3,3,0,1,1,4,10,-15,1,OKC,MIN,OKC,103,18.5,Points,16,13,13,6
Jalen Williams,F,22023,1631114,22300058,"NOV 28, 2023",OKC @ MIN,L,34,2,10,0.2,0,3,0.0,6,7,0.857,0,3,3,3,0,1,1,4,10,-15,1,OKC,MIN,OKC,103,4.0,Rebounds,16,13,13,6
Jalen Williams,F,22023,1631114,22300058,"NOV 28, 2023",OKC @ MIN,L,34,2,10,0.2,0,3,0.0,6,7,0.857,0,3,3,3,0,1,1,4,10,-15,1,OKC,MIN,OKC,103,28.5,Pts+Rebs+Asts,16,13,13,6
Jalen Williams,F,22023,1631114,22300058,"NOV 28, 2023",OKC @ MIN,L,34,2,10,0.2,0,3,0.0,6,7,0.857,0,3,3,3,0,1,1,4,10,-15,1,OKC,MIN,OKC,103,5.0,Assists,16,13,13,6
Jalen Williams,F,22023,1631114,22300058,"NOV 28, 2023",OKC @ MIN,L,34,2,10,0.2,0,3,0.0,6,7,0.857,0,3,3,3,0,1,1,4,10,-15,1,OKC,MIN,OKC,103,33.5,Fantasy Score,16,13,13,6
Jalen Williams,F,22023,1631114,22300058,"NOV 28, 2023",OKC @ MIN,L,34,2,10,0.2,0,3,0.0,6,7,0.857,0,3,3,3,0,1,1,4,10,-15,1,OKC,MIN,OKC,103,1.5,3-PT Made,16,13,13,6
Jalen Williams,F,22023,1631114,22300058,"NOV 28, 2023",OKC @ MIN,L,34,2,10,0.2,0,3,0.0,6,7,0.857,0,3,3,3,0,1,1,4,10,-15,1,OKC,MIN,OKC,103,2.5,Free Throws Made,16,13,13,6
Jalen Williams,F,22023,1631114,22300058,"NOV 28, 2023",OKC @ MIN,L,34,2,10,0.2,0,3,0.0,6,7,0.857,0,3,3,3,0,1,1,4,10,-15,1,OKC,MIN,OKC,103,14.0,FG Attempted,16,13,13,6
Jalen Williams,F,22023,1631114,22300058,"NOV 28, 2023",OKC @ MIN,L,34,2,10,0.2,0,3,0.0,6,7,0.857,0,3,3,3,0,1,1,4,10,-15,1,OKC,MIN,OKC,103,23.5,Pts+Rebs,16,13,13,6
Jalen Williams,F,22023,1631114,22300058,"NOV 28, 2023",OKC @ MIN,L,34,2,10,0.2,0,3,0.0,6,7,0.857,0,3,3,3,0,1,1,4,10,-15,1,OKC,MIN,OKC,103,23.5,Pts+Asts,16,13,13,6
Jalen Williams,F,22023,1631114,22300058,"NOV 28, 2023",OKC @ MIN,L,34,2,10,0.2,0,3,0.0,6,7,0.857,0,3,3,3,0,1,1,4,10,-15,1,OKC,MIN,OKC,103,9.5,Rebs+Asts,16,13,13,6
Jalen Williams,F,22023,1631114,22300016,"NOV 10, 2023",OKC @ SAC,L,31,6,14,0.429,0,3,0.0,2,2,1.0,0,5,5,2,1,0,3,1,14,-14,1,OKC,SAC,OKC,98,18.5,Points,21,19,16,7
Jalen Williams,F,22023,1631114,22300016,"NOV 10, 2023",OKC @ SAC,L,31,6,14,0.429,0,3,0.0,2,2,1.0,0,5,5,2,1,0,3,1,14,-14,1,OKC,SAC,OKC,98,4.0,Rebounds,21,19,16,7
Jalen Williams,F,22023,1631114,22300016,"NOV 10, 2023",OKC @ SAC,L,31,6,14,0.429,0,3,0.0,2,2,1.0,0,5,5,2,1,0,3,1,14,-14,1,OKC,SAC,OKC,98,28.5,Pts+Rebs+Asts,21,19,16,7
Jalen Williams,F,22023,1631114,22300016,"NOV 10, 2023",OKC @ SAC,L,31,6,14,0.429,0,3,0.0,2,2,1.0,0,5,5,2,1,0,3,1,14,-14,1,OKC,SAC,OKC,98,5.0,Assists,21,19,16,7
Jalen Williams,F,22023,1631114,22300016,"NOV 10, 2023",OKC @ SAC,L,31,6,14,0.429,0,3,0.0,2,2,1.0,0,5,5,2,1,0,3,1,14,-14,1,OKC,SAC,OKC,98,33.5,Fantasy Score,21,19,16,7
Jalen Williams,F,22023,1631114,22300016,"NOV 10, 2023",OKC @ SAC,L,31,6,14,0.429,0,3,0.0,2,2,1.0,0,5,5,2,1,0,3,1,14,-14,1,OKC,SAC,OKC,98,1.5,3-PT Made,21,19,16,7
Jalen Williams,F,22023,1631114,22300016,"NOV 10, 2023",OKC @ SAC,L,31,6,14,0.429,0,3,0.0,2,2,1.0,0,5,5,2,1,0,3,1,14,-14,1,OKC,SAC,OKC,98,2.5,Free Throws Made,21,19,16,7
Jalen Williams,F,22023,1631114,22300016,"NOV 10, 2023",OKC @ SAC,L,31,6,14,0.429,0,3,0.0,2,2,1.0,0,5,5,2,1,0,3,1,14,-14,1,OKC,SAC,OKC,98,14.0,FG Attempted,21,19,16,7
Jalen Williams,F,22023,1631114,22300016,"NOV 10, 2023",OKC @ SAC,L,31,6,14,0.429,0,3,0.0,2,2,1.0,0,5,5,2,1,0,3,1,14,-14,1,OKC,SAC,OKC,98,23.5,Pts+Rebs,21,19,16,7
Jalen Williams,F,22023,1631114,22300016,"NOV 10, 2023",OKC @ SAC,L,31,6,14,0.429,0,3,0.0,2,2,1.0,0,5,5,2,1,0,3,1,14,-14,1,OKC,SAC,OKC,98,23.5,Pts+Asts,21,19,16,7
Jalen Williams,F,22023,1631114,22300016,"NOV 10, 2023",OKC @ SAC,L,31,6,14,0.429,0,3,0.0,2,2,1.0,0,5,5,2,1,0,3,1,14,-14,1,OKC,SAC,OKC,98,9.5,Rebs+Asts,21,19,16,7
Jalen Williams,F,22023,1631114,22300155,"NOV 06, 2023",OKC vs. ATL,W,36,8,13,0.615,2,5,0.4,3,3,1.0,0,3,3,2,0,1,2,5,21,4,1,OKC,OKC,ATL,126,18.5,Points,26,24,23,5
Jalen Williams,F,22023,1631114,22300155,"NOV 06, 2023",OKC vs. ATL,W,36,8,13,0.615,2,5,0.4,3,3,1.0,0,3,3,2,0,1,2,5,21,4,1,OKC,OKC,ATL,126,4.0,Rebounds,26,24,23,5
Jalen Williams,F,22023,1631114,22300155,"NOV 06, 2023",OKC vs. ATL,W,36,8,13,0.615,2,5,0.4,3,3,1.0,0,3,3,2,0,1,2,5,21,4,1,OKC,OKC,ATL,126,28.5,Pts+Rebs+Asts,26,24,23,5
Jalen Williams,F,22023,1631114,22300155,"NOV 06, 2023",OKC vs. ATL,W,36,8,13,0.615,2,5,0.4,3,3,1.0,0,3,3,2,0,1,2,5,21,4,1,OKC,OKC,ATL,126,5.0,Assists,26,24,23,5
Jalen Williams,F,22023,1631114,22300155,"NOV 06, 2023",OKC vs. ATL,W,36,8,13,0.615,2,5,0.4,3,3,1.0,0,3,3,2,0,1,2,5,21,4,1,OKC,OKC,ATL,126,33.5,Fantasy Score,26,24,23,5
Jalen Williams,F,22023,1631114,22300155,"NOV 06, 2023",OKC vs. ATL,W,36,8,13,0.615,2,5,0.4,3,3,1.0,0,3,3,2,0,1,2,5,21,4,1,OKC,OKC,ATL,126,1.5,3-PT Made,26,24,23,5
Jalen Williams,F,22023,1631114,22300155,"NOV 06, 2023",OKC vs. ATL,W,36,8,13,0.615,2,5,0.4,3,3,1.0,0,3,3,2,0,1,2,5,21,4,1,OKC,OKC,ATL,126,2.5,Free Throws Made,26,24,23,5
Jalen Williams,F,22023,1631114,22300155,"NOV 06, 2023",OKC vs. ATL,W,36,8,13,0.615,2,5,0.4,3,3,1.0,0,3,3,2,0,1,2,5,21,4,1,OKC,OKC,ATL,126,14.0,FG Attempted,26,24,23,5
Jalen Williams,F,22023,1631114,22300155,"NOV 06, 2023",OKC vs. ATL,W,36,8,13,0.615,2,5,0.4,3,3,1.0,0,3,3,2,0,1,2,5,21,4,1,OKC,OKC,ATL,126,23.5,Pts+Rebs,26,24,23,5
Jalen Williams,F,22023,1631114,22300155,"NOV 06, 2023",OKC vs. ATL,W,36,8,13,0.615,2,5,0.4,3,3,1.0,0,3,3,2,0,1,2,5,21,4,1,OKC,OKC,ATL,126,23.5,Pts+Asts,26,24,23,5
Jalen Williams,F,22023,1631114,22300155,"NOV 06, 2023",OKC vs. ATL,W,36,8,13,0.615,2,5,0.4,3,3,1.0,0,3,3,2,0,1,2,5,21,4,1,OKC,OKC,ATL,126,9.5,Rebs+Asts,26,24,23,5
Jalen Williams,F,22023,1631114,22300005,"NOV 03, 2023",OKC vs. GSW,L,35,8,12,0.667,0,0,0.0,2,5,0.4,1,2,3,8,1,0,6,6,18,0,1,OKC,OKC,GSW,139,18.5,Points,29,21,26,11
Jalen Williams,F,22023,1631114,22300005,"NOV 03, 2023",OKC vs. GSW,L,35,8,12,0.667,0,0,0.0,2,5,0.4,1,2,3,8,1,0,6,6,18,0,1,OKC,OKC,GSW,139,4.0,Rebounds,29,21,26,11
Jalen Williams,F,22023,1631114,22300005,"NOV 03, 2023",OKC vs. GSW,L,35,8,12,0.667,0,0,0.0,2,5,0.4,1,2,3,8,1,0,6,6,18,0,1,OKC,OKC,GSW,139,28.5,Pts+Rebs+Asts,29,21,26,11
Jalen Williams,F,22023,1631114,22300005,"NOV 03, 2023",OKC vs. GSW,L,35,8,12,0.667,0,0,0.0,2,5,0.4,1,2,3,8,1,0,6,6,18,0,1,OKC,OKC,GSW,139,5.0,Assists,29,21,26,11
Jalen Williams,F,22023,1631114,22300005,"NOV 03, 2023",OKC vs. GSW,L,35,8,12,0.667,0,0,0.0,2,5,0.4,1,2,3,8,1,0,6,6,18,0,1,OKC,OKC,GSW,139,33.5,Fantasy Score,29,21,26,11
Jalen Williams,F,22023,1631114,22300005,"NOV 03, 2023",OKC vs. GSW,L,35,8,12,0.667,0,0,0.0,2,5,0.4,1,2,3,8,1,0,6,6,18,0,1,OKC,OKC,GSW,139,1.5,3-PT Made,29,21,26,11
Jalen Williams,F,22023,1631114,22300005,"NOV 03, 2023",OKC vs. GSW,L,35,8,12,0.667,0,0,0.0,2,5,0.4,1,2,3,8,1,0,6,6,18,0,1,OKC,OKC,GSW,139,2.5,Free Throws Made,29,21,26,11
Jalen Williams,F,22023,1631114,22300005,"NOV 03, 2023",OKC vs. GSW,L,35,8,12,0.667,0,0,0.0,2,5,0.4,1,2,3,8,1,0,6,6,18,0,1,OKC,OKC,GSW,139,14.0,FG Attempted,29,21,26,11
Jalen Williams,F,22023,1631114,22300005,"NOV 03, 2023",OKC vs. GSW,L,35,8,12,0.667,0,0,0.0,2,5,0.4,1,2,3,8,1,0,6,6,18,0,1,OKC,OKC,GSW,139,23.5,Pts+Rebs,29,21,26,11
Jalen Williams,F,22023,1631114,22300005,"NOV 03, 2023",OKC vs. GSW,L,35,8,12,0.667,0,0,0.0,2,5,0.4,1,2,3,8,1,0,6,6,18,0,1,OKC,OKC,GSW,139,23.5,Pts+Asts,29,21,26,11
Jalen Williams,F,22023,1631114,22300005,"NOV 03, 2023",OKC vs. GSW,L,35,8,12,0.667,0,0,0.0,2,5,0.4,1,2,3,8,1,0,6,6,18,0,1,OKC,OKC,GSW,139,9.5,Rebs+Asts,29,21,26,11
Jalen Williams,F,22023,1631114,22300121,"NOV 01, 2023",OKC vs. NOP,L,38,5,13,0.385,0,3,0.0,8,9,0.889,1,7,8,3,0,0,1,3,18,-8,1,OKC,OKC,NOP,106,18.5,Points,29,26,21,11
Jalen Williams,F,22023,1631114,22300121,"NOV 01, 2023",OKC vs. NOP,L,38,5,13,0.385,0,3,0.0,8,9,0.889,1,7,8,3,0,0,1,3,18,-8,1,OKC,OKC,NOP,106,4.0,Rebounds,29,26,21,11
Jalen Williams,F,22023,1631114,22300121,"NOV 01, 2023",OKC vs. NOP,L,38,5,13,0.385,0,3,0.0,8,9,0.889,1,7,8,3,0,0,1,3,18,-8,1,OKC,OKC,NOP,106,28.5,Pts+Rebs+Asts,29,26,21,11
Jalen Williams,F,22023,1631114,22300121,"NOV 01, 2023",OKC vs. NOP,L,38,5,13,0.385,0,3,0.0,8,9,0.889,1,7,8,3,0,0,1,3,18,-8,1,OKC,OKC,NOP,106,5.0,Assists,29,26,21,11
Jalen Williams,F,22023,1631114,22300121,"NOV 01, 2023",OKC vs. NOP,L,38,5,13,0.385,0,3,0.0,8,9,0.889,1,7,8,3,0,0,1,3,18,-8,1,OKC,OKC,NOP,106,33.5,Fantasy Score,29,26,21,11
Jalen Williams,F,22023,1631114,22300121,"NOV 01, 2023",OKC vs. NOP,L,38,5,13,0.385,0,3,0.0,8,9,0.889,1,7,8,3,0,0,1,3,18,-8,1,OKC,OKC,NOP,106,1.5,3-PT Made,29,26,21,11
Jalen Williams,F,22023,1631114,22300121,"NOV 01, 2023",OKC vs. NOP,L,38,5,13,0.385,0,3,0.0,8,9,0.889,1,7,8,3,0,0,1,3,18,-8,1,OKC,OKC,NOP,106,2.5,Free Throws Made,29,26,21,11
Jalen Williams,F,22023,1631114,22300121,"NOV 01, 2023",OKC vs. NOP,L,38,5,13,0.385,0,3,0.0,8,9,0.889,1,7,8,3,0,0,1,3,18,-8,1,OKC,OKC,NOP,106,14.0,FG Attempted,29,26,21,11
Jalen Williams,F,22023,1631114,22300121,"NOV 01, 2023",OKC vs. NOP,L,38,5,13,0.385,0,3,0.0,8,9,0.889,1,7,8,3,0,0,1,3,18,-8,1,OKC,OKC,NOP,106,23.5,Pts+Rebs,29,26,21,11
Jalen Williams,F,22023,1631114,22300121,"NOV 01, 2023",OKC vs. NOP,L,38,5,13,0.385,0,3,0.0,8,9,0.889,1,7,8,3,0,0,1,3,18,-8,1,OKC,OKC,NOP,106,23.5,Pts+Asts,29,26,21,11
Jalen Williams,F,22023,1631114,22300121,"NOV 01, 2023",OKC vs. NOP,L,38,5,13,0.385,0,3,0.0,8,9,0.889,1,7,8,3,0,0,1,3,18,-8,1,OKC,OKC,NOP,106,9.5,Rebs+Asts,29,26,21,11
Jalen Williams,F,22023,1631114,22300095,"OCT 29, 2023",OKC vs. DEN,L,28,6,9,0.667,0,1,0.0,1,1,1.0,0,3,3,5,0,1,0,2,13,-21,1,OKC,OKC,DEN,95,18.5,Points,21,16,18,8
Jalen Williams,F,22023,1631114,22300095,"OCT 29, 2023",OKC vs. DEN,L,28,6,9,0.667,0,1,0.0,1,1,1.0,0,3,3,5,0,1,0,2,13,-21,1,OKC,OKC,DEN,95,4.0,Rebounds,21,16,18,8
Jalen Williams,F,22023,1631114,22300095,"OCT 29, 2023",OKC vs. DEN,L,28,6,9,0.667,0,1,0.0,1,1,1.0,0,3,3,5,0,1,0,2,13,-21,1,OKC,OKC,DEN,95,28.5,Pts+Rebs+Asts,21,16,18,8
Jalen Williams,F,22023,1631114,22300095,"OCT 29, 2023",OKC vs. DEN,L,28,6,9,0.667,0,1,0.0,1,1,1.0,0,3,3,5,0,1,0,2,13,-21,1,OKC,OKC,DEN,95,5.0,Assists,21,16,18,8
Jalen Williams,F,22023,1631114,22300095,"OCT 29, 2023",OKC vs. DEN,L,28,6,9,0.667,0,1,0.0,1,1,1.0,0,3,3,5,0,1,0,2,13,-21,1,OKC,OKC,DEN,95,33.5,Fantasy Score,21,16,18,8
Jalen Williams,F,22023,1631114,22300095,"OCT 29, 2023",OKC vs. DEN,L,28,6,9,0.667,0,1,0.0,1,1,1.0,0,3,3,5,0,1,0,2,13,-21,1,OKC,OKC,DEN,95,1.5,3-PT Made,21,16,18,8
Jalen Williams,F,22023,1631114,22300095,"OCT 29, 2023",OKC vs. DEN,L,28,6,9,0.667,0,1,0.0,1,1,1.0,0,3,3,5,0,1,0,2,13,-21,1,OKC,OKC,DEN,95,2.5,Free Throws Made,21,16,18,8
Jalen Williams,F,22023,1631114,22300095,"OCT 29, 2023",OKC vs. DEN,L,28,6,9,0.667,0,1,0.0,1,1,1.0,0,3,3,5,0,1,0,2,13,-21,1,OKC,OKC,DEN,95,14.0,FG Attempted,21,16,18,8
Jalen Williams,F,22023,1631114,22300095,"OCT 29, 2023",OKC vs. DEN,L,28,6,9,0.667,0,1,0.0,1,1,1.0,0,3,3,5,0,1,0,2,13,-21,1,OKC,OKC,DEN,95,23.5,Pts+Rebs,21,16,18,8
Jalen Williams,F,22023,1631114,22300095,"OCT 29, 2023",OKC vs. DEN,L,28,6,9,0.667,0,1,0.0,1,1,1.0,0,3,3,5,0,1,0,2,13,-21,1,OKC,OKC,DEN,95,23.5,Pts+Asts,21,16,18,8
Jalen Williams,F,22023,1631114,22300095,"OCT 29, 2023",OKC vs. DEN,L,28,6,9,0.667,0,1,0.0,1,1,1.0,0,3,3,5,0,1,0,2,13,-21,1,OKC,OKC,DEN,95,9.5,Rebs+Asts,21,16,18,8
Jalen Williams,F,22023,1631114,22300081,"OCT 27, 2023",OKC @ CLE,W,35,4,14,0.286,2,4,0.5,4,4,1.0,0,5,5,2,1,0,4,2,14,5,1,OKC,CLE,OKC,108,18.5,Points,21,19,16,7
Jalen Williams,F,22023,1631114,22300081,"OCT 27, 2023",OKC @ CLE,W,35,4,14,0.286,2,4,0.5,4,4,1.0,0,5,5,2,1,0,4,2,14,5,1,OKC,CLE,OKC,108,4.0,Rebounds,21,19,16,7
Jalen Williams,F,22023,1631114,22300081,"OCT 27, 2023",OKC @ CLE,W,35,4,14,0.286,2,4,0.5,4,4,1.0,0,5,5,2,1,0,4,2,14,5,1,OKC,CLE,OKC,108,28.5,Pts+Rebs+Asts,21,19,16,7
Jalen Williams,F,22023,1631114,22300081,"OCT 27, 2023",OKC @ CLE,W,35,4,14,0.286,2,4,0.5,4,4,1.0,0,5,5,2,1,0,4,2,14,5,1,OKC,CLE,OKC,108,5.0,Assists,21,19,16,7
Jalen Williams,F,22023,1631114,22300081,"OCT 27, 2023",OKC @ CLE,W,35,4,14,0.286,2,4,0.5,4,4,1.0,0,5,5,2,1,0,4,2,14,5,1,OKC,CLE,OKC,108,33.5,Fantasy Score,21,19,16,7
Jalen Williams,F,22023,1631114,22300081,"OCT 27, 2023",OKC @ CLE,W,35,4,14,0.286,2,4,0.5,4,4,1.0,0,5,5,2,1,0,4,2,14,5,1,OKC,CLE,OKC,108,1.5,3-PT Made,21,19,16,7
Jalen Williams,F,22023,1631114,22300081,"OCT 27, 2023",OKC @ CLE,W,35,4,14,0.286,2,4,0.5,4,4,1.0,0,5,5,2,1,0,4,2,14,5,1,OKC,CLE,OKC,108,2.5,Free Throws Made,21,19,16,7
Jalen Williams,F,22023,1631114,22300081,"OCT 27, 2023",OKC @ CLE,W,35,4,14,0.286,2,4,0.5,4,4,1.0,0,5,5,2,1,0,4,2,14,5,1,OKC,CLE,OKC,108,14.0,FG Attempted,21,19,16,7
Jalen Williams,F,22023,1631114,22300081,"OCT 27, 2023",OKC @ CLE,W,35,4,14,0.286,2,4,0.5,4,4,1.0,0,5,5,2,1,0,4,2,14,5,1,OKC,CLE,OKC,108,23.5,Pts+Rebs,21,19,16,7
Jalen Williams,F,22023,1631114,22300081,"OCT 27, 2023",OKC @ CLE,W,35,4,14,0.286,2,4,0.5,4,4,1.0,0,5,5,2,1,0,4,2,14,5,1,OKC,CLE,OKC,108,23.5,Pts+Asts,21,19,16,7
Jalen Williams,F,22023,1631114,22300081,"OCT 27, 2023",OKC @ CLE,W,35,4,14,0.286,2,4,0.5,4,4,1.0,0,5,5,2,1,0,4,2,14,5,1,OKC,CLE,OKC,108,9.5,Rebs+Asts,21,19,16,7
Jalen Williams,F,22023,1631114,22300070,"OCT 25, 2023",OKC @ CHI,W,32,5,11,0.455,2,6,0.333,4,4,1.0,0,3,3,5,1,0,2,3,16,8,1,OKC,CHI,OKC,124,18.5,Points,24,19,21,8
Jalen Williams,F,22023,1631114,22300070,"OCT 25, 2023",OKC @ CHI,W,32,5,11,0.455,2,6,0.333,4,4,1.0,0,3,3,5,1,0,2,3,16,8,1,OKC,CHI,OKC,124,4.0,Rebounds,24,19,21,8
Jalen Williams,F,22023,1631114,22300070,"OCT 25, 2023",OKC @ CHI,W,32,5,11,0.455,2,6,0.333,4,4,1.0,0,3,3,5,1,0,2,3,16,8,1,OKC,CHI,OKC,124,28.5,Pts+Rebs+Asts,24,19,21,8
Jalen Williams,F,22023,1631114,22300070,"OCT 25, 2023",OKC @ CHI,W,32,5,11,0.455,2,6,0.333,4,4,1.0,0,3,3,5,1,0,2,3,16,8,1,OKC,CHI,OKC,124,5.0,Assists,24,19,21,8
Jalen Williams,F,22023,1631114,22300070,"OCT 25, 2023",OKC @ CHI,W,32,5,11,0.455,2,6,0.333,4,4,1.0,0,3,3,5,1,0,2,3,16,8,1,OKC,CHI,OKC,124,33.5,Fantasy Score,24,19,21,8
Jalen Williams,F,22023,1631114,22300070,"OCT 25, 2023",OKC @ CHI,W,32,5,11,0.455,2,6,0.333,4,4,1.0,0,3,3,5,1,0,2,3,16,8,1,OKC,CHI,OKC,124,1.5,3-PT Made,24,19,21,8
Jalen Williams,F,22023,1631114,22300070,"OCT 25, 2023",OKC @ CHI,W,32,5,11,0.455,2,6,0.333,4,4,1.0,0,3,3,5,1,0,2,3,16,8,1,OKC,CHI,OKC,124,2.5,Free Throws Made,24,19,21,8
Jalen Williams,F,22023,1631114,22300070,"OCT 25, 2023",OKC @ CHI,W,32,5,11,0.455,2,6,0.333,4,4,1.0,0,3,3,5,1,0,2,3,16,8,1,OKC,CHI,OKC,124,14.0,FG Attempted,24,19,21,8
Jalen Williams,F,22023,1631114,22300070,"OCT 25, 2023",OKC @ CHI,W,32,5,11,0.455,2,6,0.333,4,4,1.0,0,3,3,5,1,0,2,3,16,8,1,OKC,CHI,OKC,124,23.5,Pts+Rebs,24,19,21,8
Jalen Williams,F,22023,1631114,22300070,"OCT 25, 2023",OKC @ CHI,W,32,5,11,0.455,2,6,0.333,4,4,1.0,0,3,3,5,1,0,2,3,16,8,1,OKC,CHI,OKC,124,23.5,Pts+Asts,24,19,21,8
Jalen Williams,F,22023,1631114,22300070,"OCT 25, 2023",OKC @ CHI,W,32,5,11,0.455,2,6,0.333,4,4,1.0,0,3,3,5,1,0,2,3,16,8,1,OKC,CHI,OKC,124,9.5,Rebs+Asts,24,19,21,8
Jalen Williams,F,22023,1631114,22300664,"JAN 29, 2024",OKC vs. MIN,L,33,8,17,0.471,4,7,0.571,0,2,0.0,0,2,2,3,0,0,2,3,20,-4,1,OKC,OKC,MIN,101,18.5,Points,25,22,23,5
Jalen Williams,F,22023,1631114,22300664,"JAN 29, 2024",OKC vs. MIN,L,33,8,17,0.471,4,7,0.571,0,2,0.0,0,2,2,3,0,0,2,3,20,-4,1,OKC,OKC,MIN,101,4.0,Rebounds,25,22,23,5
Jalen Williams,F,22023,1631114,22300664,"JAN 29, 2024",OKC vs. MIN,L,33,8,17,0.471,4,7,0.571,0,2,0.0,0,2,2,3,0,0,2,3,20,-4,1,OKC,OKC,MIN,101,28.5,Pts+Rebs+Asts,25,22,23,5
Jalen Williams,F,22023,1631114,22300664,"JAN 29, 2024",OKC vs. MIN,L,33,8,17,0.471,4,7,0.571,0,2,0.0,0,2,2,3,0,0,2,3,20,-4,1,OKC,OKC,MIN,101,5.0,Assists,25,22,23,5
Jalen Williams,F,22023,1631114,22300664,"JAN 29, 2024",OKC vs. MIN,L,33,8,17,0.471,4,7,0.571,0,2,0.0,0,2,2,3,0,0,2,3,20,-4,1,OKC,OKC,MIN,101,33.5,Fantasy Score,25,22,23,5
Jalen Williams,F,22023,1631114,22300664,"JAN 29, 2024",OKC vs. MIN,L,33,8,17,0.471,4,7,0.571,0,2,0.0,0,2,2,3,0,0,2,3,20,-4,1,OKC,OKC,MIN,101,1.5,3-PT Made,25,22,23,5
Jalen Williams,F,22023,1631114,22300664,"JAN 29, 2024",OKC vs. MIN,L,33,8,17,0.471,4,7,0.571,0,2,0.0,0,2,2,3,0,0,2,3,20,-4,1,OKC,OKC,MIN,101,2.5,Free Throws Made,25,22,23,5
Jalen Williams,F,22023,1631114,22300664,"JAN 29, 2024",OKC vs. MIN,L,33,8,17,0.471,4,7,0.571,0,2,0.0,0,2,2,3,0,0,2,3,20,-4,1,OKC,OKC,MIN,101,14.0,FG Attempted,25,22,23,5
Jalen Williams,F,22023,1631114,22300664,"JAN 29, 2024",OKC vs. MIN,L,33,8,17,0.471,4,7,0.571,0,2,0.0,0,2,2,3,0,0,2,3,20,-4,1,OKC,OKC,MIN,101,23.5,Pts+Rebs,25,22,23,5
Jalen Williams,F,22023,1631114,22300664,"JAN 29, 2024",OKC vs. MIN,L,33,8,17,0.471,4,7,0.571,0,2,0.0,0,2,2,3,0,0,2,3,20,-4,1,OKC,OKC,MIN,101,23.5,Pts+Asts,25,22,23,5
Jalen Williams,F,22023,1631114,22300664,"JAN 29, 2024",OKC vs. MIN,L,33,8,17,0.471,4,7,0.571,0,2,0.0,0,2,2,3,0,0,2,3,20,-4,1,OKC,OKC,MIN,101,9.5,Rebs+Asts,25,22,23,5
Jalen Williams,F,22023,1631114,22300654,"JAN 28, 2024",OKC @ DET,L,28,8,16,0.5,2,3,0.667,2,4,0.5,0,1,1,3,0,0,0,2,20,-19,1,OKC,DET,OKC,104,18.5,Points,24,21,23,4
Jalen Williams,F,22023,1631114,22300654,"JAN 28, 2024",OKC @ DET,L,28,8,16,0.5,2,3,0.667,2,4,0.5,0,1,1,3,0,0,0,2,20,-19,1,OKC,DET,OKC,104,4.0,Rebounds,24,21,23,4
Jalen Williams,F,22023,1631114,22300654,"JAN 28, 2024",OKC @ DET,L,28,8,16,0.5,2,3,0.667,2,4,0.5,0,1,1,3,0,0,0,2,20,-19,1,OKC,DET,OKC,104,28.5,Pts+Rebs+Asts,24,21,23,4
Jalen Williams,F,22023,1631114,22300654,"JAN 28, 2024",OKC @ DET,L,28,8,16,0.5,2,3,0.667,2,4,0.5,0,1,1,3,0,0,0,2,20,-19,1,OKC,DET,OKC,104,5.0,Assists,24,21,23,4
Jalen Williams,F,22023,1631114,22300654,"JAN 28, 2024",OKC @ DET,L,28,8,16,0.5,2,3,0.667,2,4,0.5,0,1,1,3,0,0,0,2,20,-19,1,OKC,DET,OKC,104,33.5,Fantasy Score,24,21,23,4
Jalen Williams,F,22023,1631114,22300654,"JAN 28, 2024",OKC @ DET,L,28,8,16,0.5,2,3,0.667,2,4,0.5,0,1,1,3,0,0,0,2,20,-19,1,OKC,DET,OKC,104,1.5,3-PT Made,24,21,23,4
Jalen Williams,F,22023,1631114,22300654,"JAN 28, 2024",OKC @ DET,L,28,8,16,0.5,2,3,0.667,2,4,0.5,0,1,1,3,0,0,0,2,20,-19,1,OKC,DET,OKC,104,2.5,Free Throws Made,24,21,23,4
Jalen Williams,F,22023,1631114,22300654,"JAN 28, 2024",OKC @ DET,L,28,8,16,0.5,2,3,0.667,2,4,0.5,0,1,1,3,0,0,0,2,20,-19,1,OKC,DET,OKC,104,14.0,FG Attempted,24,21,23,4
Jalen Williams,F,22023,1631114,22300654,"JAN 28, 2024",OKC @ DET,L,28,8,16,0.5,2,3,0.667,2,4,0.5,0,1,1,3,0,0,0,2,20,-19,1,OKC,DET,OKC,104,23.5,Pts+Rebs,24,21,23,4
Jalen Williams,F,22023,1631114,22300654,"JAN 28, 2024",OKC @ DET,L,28,8,16,0.5,2,3,0.667,2,4,0.5,0,1,1,3,0,0,0,2,20,-19,1,OKC,DET,OKC,104,23.5,Pts+Asts,24,21,23,4
Jalen Williams,F,22023,1631114,22300654,"JAN 28, 2024",OKC @ DET,L,28,8,16,0.5,2,3,0.667,2,4,0.5,0,1,1,3,0,0,0,2,20,-19,1,OKC,DET,OKC,104,9.5,Rebs+Asts,24,21,23,4
Jalen Williams,F,22023,1631114,22300640,"JAN 26, 2024",OKC @ NOP,W,31,7,14,0.5,1,4,0.25,0,0,0.0,0,4,4,7,0,0,1,3,15,22,1,OKC,NOP,OKC,107,18.5,Points,26,19,22,11
Jalen Williams,F,22023,1631114,22300640,"JAN 26, 2024",OKC @ NOP,W,31,7,14,0.5,1,4,0.25,0,0,0.0,0,4,4,7,0,0,1,3,15,22,1,OKC,NOP,OKC,107,4.0,Rebounds,26,19,22,11
Jalen Williams,F,22023,1631114,22300640,"JAN 26, 2024",OKC @ NOP,W,31,7,14,0.5,1,4,0.25,0,0,0.0,0,4,4,7,0,0,1,3,15,22,1,OKC,NOP,OKC,107,28.5,Pts+Rebs+Asts,26,19,22,11
Jalen Williams,F,22023,1631114,22300640,"JAN 26, 2024",OKC @ NOP,W,31,7,14,0.5,1,4,0.25,0,0,0.0,0,4,4,7,0,0,1,3,15,22,1,OKC,NOP,OKC,107,5.0,Assists,26,19,22,11
Jalen Williams,F,22023,1631114,22300640,"JAN 26, 2024",OKC @ NOP,W,31,7,14,0.5,1,4,0.25,0,0,0.0,0,4,4,7,0,0,1,3,15,22,1,OKC,NOP,OKC,107,33.5,Fantasy Score,26,19,22,11
Jalen Williams,F,22023,1631114,22300640,"JAN 26, 2024",OKC @ NOP,W,31,7,14,0.5,1,4,0.25,0,0,0.0,0,4,4,7,0,0,1,3,15,22,1,OKC,NOP,OKC,107,1.5,3-PT Made,26,19,22,11
Jalen Williams,F,22023,1631114,22300640,"JAN 26, 2024",OKC @ NOP,W,31,7,14,0.5,1,4,0.25,0,0,0.0,0,4,4,7,0,0,1,3,15,22,1,OKC,NOP,OKC,107,2.5,Free Throws Made,26,19,22,11
Jalen Williams,F,22023,1631114,22300640,"JAN 26, 2024",OKC @ NOP,W,31,7,14,0.5,1,4,0.25,0,0,0.0,0,4,4,7,0,0,1,3,15,22,1,OKC,NOP,OKC,107,14.0,FG Attempted,26,19,22,11
Jalen Williams,F,22023,1631114,22300640,"JAN 26, 2024",OKC @ NOP,W,31,7,14,0.5,1,4,0.25,0,0,0.0,0,4,4,7,0,0,1,3,15,22,1,OKC,NOP,OKC,107,23.5,Pts+Rebs,26,19,22,11
Jalen Williams,F,22023,1631114,22300640,"JAN 26, 2024",OKC @ NOP,W,31,7,14,0.5,1,4,0.25,0,0,0.0,0,4,4,7,0,0,1,3,15,22,1,OKC,NOP,OKC,107,23.5,Pts+Asts,26,19,22,11
Jalen Williams,F,22023,1631114,22300640,"JAN 26, 2024",OKC @ NOP,W,31,7,14,0.5,1,4,0.25,0,0,0.0,0,4,4,7,0,0,1,3,15,22,1,OKC,NOP,OKC,107,9.5,Rebs+Asts,26,19,22,11
Jalen Williams,F,22023,1631114,22300599,"JAN 20, 2024",OKC @ MIN,W,36,6,18,0.333,0,2,0.0,8,10,0.8,3,2,5,3,3,0,0,4,20,17,1,OKC,MIN,OKC,102,18.5,Points,28,25,23,8
Jalen Williams,F,22023,1631114,22300599,"JAN 20, 2024",OKC @ MIN,W,36,6,18,0.333,0,2,0.0,8,10,0.8,3,2,5,3,3,0,0,4,20,17,1,OKC,MIN,OKC,102,4.0,Rebounds,28,25,23,8
Jalen Williams,F,22023,1631114,22300599,"JAN 20, 2024",OKC @ MIN,W,36,6,18,0.333,0,2,0.0,8,10,0.8,3,2,5,3,3,0,0,4,20,17,1,OKC,MIN,OKC,102,28.5,Pts+Rebs+Asts,28,25,23,8
Jalen Williams,F,22023,1631114,22300599,"JAN 20, 2024",OKC @ MIN,W,36,6,18,0.333,0,2,0.0,8,10,0.8,3,2,5,3,3,0,0,4,20,17,1,OKC,MIN,OKC,102,5.0,Assists,28,25,23,8
Jalen Williams,F,22023,1631114,22300599,"JAN 20, 2024",OKC @ MIN,W,36,6,18,0.333,0,2,0.0,8,10,0.8,3,2,5,3,3,0,0,4,20,17,1,OKC,MIN,OKC,102,33.5,Fantasy Score,28,25,23,8
Jalen Williams,F,22023,1631114,22300599,"JAN 20, 2024",OKC @ MIN,W,36,6,18,0.333,0,2,0.0,8,10,0.8,3,2,5,3,3,0,0,4,20,17,1,OKC,MIN,OKC,102,1.5,3-PT Made,28,25,23,8
Jalen Williams,F,22023,1631114,22300599,"JAN 20, 2024",OKC @ MIN,W,36,6,18,0.333,0,2,0.0,8,10,0.8,3,2,5,3,3,0,0,4,20,17,1,OKC,MIN,OKC,102,2.5,Free Throws Made,28,25,23,8
Jalen Williams,F,22023,1631114,22300599,"JAN 20, 2024",OKC @ MIN,W,36,6,18,0.333,0,2,0.0,8,10,0.8,3,2,5,3,3,0,0,4,20,17,1,OKC,MIN,OKC,102,14.0,FG Attempted,28,25,23,8
Jalen Williams,F,22023,1631114,22300599,"JAN 20, 2024",OKC @ MIN,W,36,6,18,0.333,0,2,0.0,8,10,0.8,3,2,5,3,3,0,0,4,20,17,1,OKC,MIN,OKC,102,23.5,Pts+Rebs,28,25,23,8
Jalen Williams,F,22023,1631114,22300599,"JAN 20, 2024",OKC @ MIN,W,36,6,18,0.333,0,2,0.0,8,10,0.8,3,2,5,3,3,0,0,4,20,17,1,OKC,MIN,OKC,102,23.5,Pts+Asts,28,25,23,8
Jalen Williams,F,22023,1631114,22300599,"JAN 20, 2024",OKC @ MIN,W,36,6,18,0.333,0,2,0.0,8,10,0.8,3,2,5,3,3,0,0,4,20,17,1,OKC,MIN,OKC,102,9.5,Rebs+Asts,28,25,23,8
Jalen Williams,F,22023,1631114,22300522,"JAN 10, 2024",OKC @ MIA,W,35,8,15,0.533,1,3,0.333,2,2,1.0,1,8,9,12,1,0,1,2,19,13,1,OKC,MIA,OKC,128,18.5,Points,40,28,31,21
Jalen Williams,F,22023,1631114,22300522,"JAN 10, 2024",OKC @ MIA,W,35,8,15,0.533,1,3,0.333,2,2,1.0,1,8,9,12,1,0,1,2,19,13,1,OKC,MIA,OKC,128,4.0,Rebounds,40,28,31,21
Jalen Williams,F,22023,1631114,22300522,"JAN 10, 2024",OKC @ MIA,W,35,8,15,0.533,1,3,0.333,2,2,1.0,1,8,9,12,1,0,1,2,19,13,1,OKC,MIA,OKC,128,28.5,Pts+Rebs+Asts,40,28,31,21
Jalen Williams,F,22023,1631114,22300522,"JAN 10, 2024",OKC @ MIA,W,35,8,15,0.533,1,3,0.333,2,2,1.0,1,8,9,12,1,0,1,2,19,13,1,OKC,MIA,OKC,128,5.0,Assists,40,28,31,21
Jalen Williams,F,22023,1631114,22300522,"JAN 10, 2024",OKC @ MIA,W,35,8,15,0.533,1,3,0.333,2,2,1.0,1,8,9,12,1,0,1,2,19,13,1,OKC,MIA,OKC,128,33.5,Fantasy Score,40,28,31,21
Jalen Williams,F,22023,1631114,22300522,"JAN 10, 2024",OKC @ MIA,W,35,8,15,0.533,1,3,0.333,2,2,1.0,1,8,9,12,1,0,1,2,19,13,1,OKC,MIA,OKC,128,1.5,3-PT Made,40,28,31,21
Jalen Williams,F,22023,1631114,22300522,"JAN 10, 2024",OKC @ MIA,W,35,8,15,0.533,1,3,0.333,2,2,1.0,1,8,9,12,1,0,1,2,19,13,1,OKC,MIA,OKC,128,2.5,Free Throws Made,40,28,31,21
Jalen Williams,F,22023,1631114,22300522,"JAN 10, 2024",OKC @ MIA,W,35,8,15,0.533,1,3,0.333,2,2,1.0,1,8,9,12,1,0,1,2,19,13,1,OKC,MIA,OKC,128,14.0,FG Attempted,40,28,31,21
Jalen Williams,F,22023,1631114,22300522,"JAN 10, 2024",OKC @ MIA,W,35,8,15,0.533,1,3,0.333,2,2,1.0,1,8,9,12,1,0,1,2,19,13,1,OKC,MIA,OKC,128,23.5,Pts+Rebs,40,28,31,21
Jalen Williams,F,22023,1631114,22300522,"JAN 10, 2024",OKC @ MIA,W,35,8,15,0.533,1,3,0.333,2,2,1.0,1,8,9,12,1,0,1,2,19,13,1,OKC,MIA,OKC,128,23.5,Pts+Asts,40,28,31,21
Jalen Williams,F,22023,1631114,22300522,"JAN 10, 2024",OKC @ MIA,W,35,8,15,0.533,1,3,0.333,2,2,1.0,1,8,9,12,1,0,1,2,19,13,1,OKC,MIA,OKC,128,9.5,Rebs+Asts,40,28,31,21
Jalen Williams,F,22023,1631114,22300508,"JAN 08, 2024",OKC @ WAS,W,34,9,13,0.692,1,1,1.0,2,2,1.0,1,6,7,10,2,0,4,3,21,22,1,OKC,WAS,OKC,136,18.5,Points,38,28,31,17
Jalen Williams,F,22023,1631114,22300508,"JAN 08, 2024",OKC @ WAS,W,34,9,13,0.692,1,1,1.0,2,2,1.0,1,6,7,10,2,0,4,3,21,22,1,OKC,WAS,OKC,136,4.0,Rebounds,38,28,31,17
Jalen Williams,F,22023,1631114,22300508,"JAN 08, 2024",OKC @ WAS,W,34,9,13,0.692,1,1,1.0,2,2,1.0,1,6,7,10,2,0,4,3,21,22,1,OKC,WAS,OKC,136,28.5,Pts+Rebs+Asts,38,28,31,17
Jalen Williams,F,22023,1631114,22300508,"JAN 08, 2024",OKC @ WAS,W,34,9,13,0.692,1,1,1.0,2,2,1.0,1,6,7,10,2,0,4,3,21,22,1,OKC,WAS,OKC,136,5.0,Assists,38,28,31,17
Jalen Williams,F,22023,1631114,22300508,"JAN 08, 2024",OKC @ WAS,W,34,9,13,0.692,1,1,1.0,2,2,1.0,1,6,7,10,2,0,4,3,21,22,1,OKC,WAS,OKC,136,33.5,Fantasy Score,38,28,31,17
Jalen Williams,F,22023,1631114,22300508,"JAN 08, 2024",OKC @ WAS,W,34,9,13,0.692,1,1,1.0,2,2,1.0,1,6,7,10,2,0,4,3,21,22,1,OKC,WAS,OKC,136,1.5,3-PT Made,38,28,31,17
Jalen Williams,F,22023,1631114,22300508,"JAN 08, 2024",OKC @ WAS,W,34,9,13,0.692,1,1,1.0,2,2,1.0,1,6,7,10,2,0,4,3,21,22,1,OKC,WAS,OKC,136,2.5,Free Throws Made,38,28,31,17
Jalen Williams,F,22023,1631114,22300508,"JAN 08, 2024",OKC @ WAS,W,34,9,13,0.692,1,1,1.0,2,2,1.0,1,6,7,10,2,0,4,3,21,22,1,OKC,WAS,OKC,136,14.0,FG Attempted,38,28,31,17
Jalen Williams,F,22023,1631114,22300508,"JAN 08, 2024",OKC @ WAS,W,34,9,13,0.692,1,1,1.0,2,2,1.0,1,6,7,10,2,0,4,3,21,22,1,OKC,WAS,OKC,136,23.5,Pts+Rebs,38,28,31,17
Jalen Williams,F,22023,1631114,22300508,"JAN 08, 2024",OKC @ WAS,W,34,9,13,0.692,1,1,1.0,2,2,1.0,1,6,7,10,2,0,4,3,21,22,1,OKC,WAS,OKC,136,23.5,Pts+Asts,38,28,31,17
Jalen Williams,F,22023,1631114,22300508,"JAN 08, 2024",OKC @ WAS,W,34,9,13,0.692,1,1,1.0,2,2,1.0,1,6,7,10,2,0,4,3,21,22,1,OKC,WAS,OKC,136,9.5,Rebs+Asts,38,28,31,17
Jalen Williams,F,22023,1631114,22300467,"JAN 03, 2024",OKC @ ATL,L,35,9,12,0.75,1,1,1.0,2,5,0.4,1,2,3,6,4,0,2,4,21,3,1,OKC,ATL,OKC,138,18.5,Points,30,24,27,9
Jalen Williams,F,22023,1631114,22300467,"JAN 03, 2024",OKC @ ATL,L,35,9,12,0.75,1,1,1.0,2,5,0.4,1,2,3,6,4,0,2,4,21,3,1,OKC,ATL,OKC,138,4.0,Rebounds,30,24,27,9
Jalen Williams,F,22023,1631114,22300467,"JAN 03, 2024",OKC @ ATL,L,35,9,12,0.75,1,1,1.0,2,5,0.4,1,2,3,6,4,0,2,4,21,3,1,OKC,ATL,OKC,138,28.5,Pts+Rebs+Asts,30,24,27,9
Jalen Williams,F,22023,1631114,22300467,"JAN 03, 2024",OKC @ ATL,L,35,9,12,0.75,1,1,1.0,2,5,0.4,1,2,3,6,4,0,2,4,21,3,1,OKC,ATL,OKC,138,5.0,Assists,30,24,27,9
Jalen Williams,F,22023,1631114,22300467,"JAN 03, 2024",OKC @ ATL,L,35,9,12,0.75,1,1,1.0,2,5,0.4,1,2,3,6,4,0,2,4,21,3,1,OKC,ATL,OKC,138,33.5,Fantasy Score,30,24,27,9
Jalen Williams,F,22023,1631114,22300467,"JAN 03, 2024",OKC @ ATL,L,35,9,12,0.75,1,1,1.0,2,5,0.4,1,2,3,6,4,0,2,4,21,3,1,OKC,ATL,OKC,138,1.5,3-PT Made,30,24,27,9
Jalen Williams,F,22023,1631114,22300467,"JAN 03, 2024",OKC @ ATL,L,35,9,12,0.75,1,1,1.0,2,5,0.4,1,2,3,6,4,0,2,4,21,3,1,OKC,ATL,OKC,138,2.5,Free Throws Made,30,24,27,9
Jalen Williams,F,22023,1631114,22300467,"JAN 03, 2024",OKC @ ATL,L,35,9,12,0.75,1,1,1.0,2,5,0.4,1,2,3,6,4,0,2,4,21,3,1,OKC,ATL,OKC,138,14.0,FG Attempted,30,24,27,9
Jalen Williams,F,22023,1631114,22300467,"JAN 03, 2024",OKC @ ATL,L,35,9,12,0.75,1,1,1.0,2,5,0.4,1,2,3,6,4,0,2,4,21,3,1,OKC,ATL,OKC,138,23.5,Pts+Rebs,30,24,27,9
Jalen Williams,F,22023,1631114,22300467,"JAN 03, 2024",OKC @ ATL,L,35,9,12,0.75,1,1,1.0,2,5,0.4,1,2,3,6,4,0,2,4,21,3,1,OKC,ATL,OKC,138,23.5,Pts+Asts,30,24,27,9
Jalen Williams,F,22023,1631114,22300467,"JAN 03, 2024",OKC @ ATL,L,35,9,12,0.75,1,1,1.0,2,5,0.4,1,2,3,6,4,0,2,4,21,3,1,OKC,ATL,OKC,138,9.5,Rebs+Asts,30,24,27,9
Jalen Williams,F,22023,1631114,22300462,"JAN 02, 2024",OKC vs. BOS,W,31,6,9,0.667,2,2,1.0,2,2,1.0,0,1,1,1,3,2,5,3,16,2,1,OKC,OKC,BOS,127,18.5,Points,18,17,17,2
Jalen Williams,F,22023,1631114,22300462,"JAN 02, 2024",OKC vs. BOS,W,31,6,9,0.667,2,2,1.0,2,2,1.0,0,1,1,1,3,2,5,3,16,2,1,OKC,OKC,BOS,127,4.0,Rebounds,18,17,17,2
Jalen Williams,F,22023,1631114,22300462,"JAN 02, 2024",OKC vs. BOS,W,31,6,9,0.667,2,2,1.0,2,2,1.0,0,1,1,1,3,2,5,3,16,2,1,OKC,OKC,BOS,127,28.5,Pts+Rebs+Asts,18,17,17,2
Jalen Williams,F,22023,1631114,22300462,"JAN 02, 2024",OKC vs. BOS,W,31,6,9,0.667,2,2,1.0,2,2,1.0,0,1,1,1,3,2,5,3,16,2,1,OKC,OKC,BOS,127,5.0,Assists,18,17,17,2
Jalen Williams,F,22023,1631114,22300462,"JAN 02, 2024",OKC vs. BOS,W,31,6,9,0.667,2,2,1.0,2,2,1.0,0,1,1,1,3,2,5,3,16,2,1,OKC,OKC,BOS,127,33.5,Fantasy Score,18,17,17,2
Jalen Williams,F,22023,1631114,22300462,"JAN 02, 2024",OKC vs. BOS,W,31,6,9,0.667,2,2,1.0,2,2,1.0,0,1,1,1,3,2,5,3,16,2,1,OKC,OKC,BOS,127,1.5,3-PT Made,18,17,17,2
Jalen Williams,F,22023,1631114,22300462,"JAN 02, 2024",OKC vs. BOS,W,31,6,9,0.667,2,2,1.0,2,2,1.0,0,1,1,1,3,2,5,3,16,2,1,OKC,OKC,BOS,127,2.5,Free Throws Made,18,17,17,2
Jalen Williams,F,22023,1631114,22300462,"JAN 02, 2024",OKC vs. BOS,W,31,6,9,0.667,2,2,1.0,2,2,1.0,0,1,1,1,3,2,5,3,16,2,1,OKC,OKC,BOS,127,14.0,FG Attempted,18,17,17,2
Jalen Williams,F,22023,1631114,22300462,"JAN 02, 2024",OKC vs. BOS,W,31,6,9,0.667,2,2,1.0,2,2,1.0,0,1,1,1,3,2,5,3,16,2,1,OKC,OKC,BOS,127,23.5,Pts+Rebs,18,17,17,2
Jalen Williams,F,22023,1631114,22300462,"JAN 02, 2024",OKC vs. BOS,W,31,6,9,0.667,2,2,1.0,2,2,1.0,0,1,1,1,3,2,5,3,16,2,1,OKC,OKC,BOS,127,23.5,Pts+Asts,18,17,17,2
Jalen Williams,F,22023,1631114,22300462,"JAN 02, 2024",OKC vs. BOS,W,31,6,9,0.667,2,2,1.0,2,2,1.0,0,1,1,1,3,2,5,3,16,2,1,OKC,OKC,BOS,127,9.5,Rebs+Asts,18,17,17,2
Jalen Williams,F,22023,1631114,22300447,"DEC 31, 2023",OKC vs. BKN,W,29,7,14,0.5,1,3,0.333,2,4,0.5,0,3,3,5,0,1,3,1,17,7,1,OKC,OKC,BKN,124,18.5,Points,25,20,22,8
Jalen Williams,F,22023,1631114,22300447,"DEC 31, 2023",OKC vs. BKN,W,29,7,14,0.5,1,3,0.333,2,4,0.5,0,3,3,5,0,1,3,1,17,7,1,OKC,OKC,BKN,124,4.0,Rebounds,25,20,22,8
Jalen Williams,F,22023,1631114,22300447,"DEC 31, 2023",OKC vs. BKN,W,29,7,14,0.5,1,3,0.333,2,4,0.5,0,3,3,5,0,1,3,1,17,7,1,OKC,OKC,BKN,124,28.5,Pts+Rebs+Asts,25,20,22,8
Jalen Williams,F,22023,1631114,22300447,"DEC 31, 2023",OKC vs. BKN,W,29,7,14,0.5,1,3,0.333,2,4,0.5,0,3,3,5,0,1,3,1,17,7,1,OKC,OKC,BKN,124,5.0,Assists,25,20,22,8
Jalen Williams,F,22023,1631114,22300447,"DEC 31, 2023",OKC vs. BKN,W,29,7,14,0.5,1,3,0.333,2,4,0.5,0,3,3,5,0,1,3,1,17,7,1,OKC,OKC,BKN,124,33.5,Fantasy Score,25,20,22,8
Jalen Williams,F,22023,1631114,22300447,"DEC 31, 2023",OKC vs. BKN,W,29,7,14,0.5,1,3,0.333,2,4,0.5,0,3,3,5,0,1,3,1,17,7,1,OKC,OKC,BKN,124,1.5,3-PT Made,25,20,22,8
Jalen Williams,F,22023,1631114,22300447,"DEC 31, 2023",OKC vs. BKN,W,29,7,14,0.5,1,3,0.333,2,4,0.5,0,3,3,5,0,1,3,1,17,7,1,OKC,OKC,BKN,124,2.5,Free Throws Made,25,20,22,8
Jalen Williams,F,22023,1631114,22300447,"DEC 31, 2023",OKC vs. BKN,W,29,7,14,0.5,1,3,0.333,2,4,0.5,0,3,3,5,0,1,3,1,17,7,1,OKC,OKC,BKN,124,14.0,FG Attempted,25,20,22,8
Jalen Williams,F,22023,1631114,22300447,"DEC 31, 2023",OKC vs. BKN,W,29,7,14,0.5,1,3,0.333,2,4,0.5,0,3,3,5,0,1,3,1,17,7,1,OKC,OKC,BKN,124,23.5,Pts+Rebs,25,20,22,8
Jalen Williams,F,22023,1631114,22300447,"DEC 31, 2023",OKC vs. BKN,W,29,7,14,0.5,1,3,0.333,2,4,0.5,0,3,3,5,0,1,3,1,17,7,1,OKC,OKC,BKN,124,23.5,Pts+Asts,25,20,22,8
Jalen Williams,F,22023,1631114,22300447,"DEC 31, 2023",OKC vs. BKN,W,29,7,14,0.5,1,3,0.333,2,4,0.5,0,3,3,5,0,1,3,1,17,7,1,OKC,OKC,BKN,124,9.5,Rebs+Asts,25,20,22,8
Jalen Williams,F,22023,1631114,22300435,"DEC 29, 2023",OKC @ DEN,W,31,4,10,0.4,2,5,0.4,1,2,0.5,1,6,7,9,2,1,3,2,11,17,1,OKC,DEN,OKC,119,18.5,Points,27,18,20,16
Jalen Williams,F,22023,1631114,22300435,"DEC 29, 2023",OKC @ DEN,W,31,4,10,0.4,2,5,0.4,1,2,0.5,1,6,7,9,2,1,3,2,11,17,1,OKC,DEN,OKC,119,4.0,Rebounds,27,18,20,16
Jalen Williams,F,22023,1631114,22300435,"DEC 29, 2023",OKC @ DEN,W,31,4,10,0.4,2,5,0.4,1,2,0.5,1,6,7,9,2,1,3,2,11,17,1,OKC,DEN,OKC,119,28.5,Pts+Rebs+Asts,27,18,20,16
Jalen Williams,F,22023,1631114,22300435,"DEC 29, 2023",OKC @ DEN,W,31,4,10,0.4,2,5,0.4,1,2,0.5,1,6,7,9,2,1,3,2,11,17,1,OKC,DEN,OKC,119,5.0,Assists,27,18,20,16
Jalen Williams,F,22023,1631114,22300435,"DEC 29, 2023",OKC @ DEN,W,31,4,10,0.4,2,5,0.4,1,2,0.5,1,6,7,9,2,1,3,2,11,17,1,OKC,DEN,OKC,119,33.5,Fantasy Score,27,18,20,16
Jalen Williams,F,22023,1631114,22300435,"DEC 29, 2023",OKC @ DEN,W,31,4,10,0.4,2,5,0.4,1,2,0.5,1,6,7,9,2,1,3,2,11,17,1,OKC,DEN,OKC,119,1.5,3-PT Made,27,18,20,16
Jalen Williams,F,22023,1631114,22300435,"DEC 29, 2023",OKC @ DEN,W,31,4,10,0.4,2,5,0.4,1,2,0.5,1,6,7,9,2,1,3,2,11,17,1,OKC,DEN,OKC,119,2.5,Free Throws Made,27,18,20,16
Jalen Williams,F,22023,1631114,22300435,"DEC 29, 2023",OKC @ DEN,W,31,4,10,0.4,2,5,0.4,1,2,0.5,1,6,7,9,2,1,3,2,11,17,1,OKC,DEN,OKC,119,14.0,FG Attempted,27,18,20,16
Jalen Williams,F,22023,1631114,22300435,"DEC 29, 2023",OKC @ DEN,W,31,4,10,0.4,2,5,0.4,1,2,0.5,1,6,7,9,2,1,3,2,11,17,1,OKC,DEN,OKC,119,23.5,Pts+Rebs,27,18,20,16
Jalen Williams,F,22023,1631114,22300435,"DEC 29, 2023",OKC @ DEN,W,31,4,10,0.4,2,5,0.4,1,2,0.5,1,6,7,9,2,1,3,2,11,17,1,OKC,DEN,OKC,119,23.5,Pts+Asts,27,18,20,16
Jalen Williams,F,22023,1631114,22300435,"DEC 29, 2023",OKC @ DEN,W,31,4,10,0.4,2,5,0.4,1,2,0.5,1,6,7,9,2,1,3,2,11,17,1,OKC,DEN,OKC,119,9.5,Rebs+Asts,27,18,20,16
Jalen Williams,F,22023,1631114,22300411,"DEC 26, 2023",OKC vs. MIN,W,26,7,11,0.636,4,6,0.667,3,3,1.0,0,1,1,3,0,2,1,3,21,12,1,OKC,OKC,MIN,129,18.5,Points,25,22,24,4
Jalen Williams,F,22023,1631114,22300411,"DEC 26, 2023",OKC vs. MIN,W,26,7,11,0.636,4,6,0.667,3,3,1.0,0,1,1,3,0,2,1,3,21,12,1,OKC,OKC,MIN,129,4.0,Rebounds,25,22,24,4
Jalen Williams,F,22023,1631114,22300411,"DEC 26, 2023",OKC vs. MIN,W,26,7,11,0.636,4,6,0.667,3,3,1.0,0,1,1,3,0,2,1,3,21,12,1,OKC,OKC,MIN,129,28.5,Pts+Rebs+Asts,25,22,24,4
Jalen Williams,F,22023,1631114,22300411,"DEC 26, 2023",OKC vs. MIN,W,26,7,11,0.636,4,6,0.667,3,3,1.0,0,1,1,3,0,2,1,3,21,12,1,OKC,OKC,MIN,129,5.0,Assists,25,22,24,4
Jalen Williams,F,22023,1631114,22300411,"DEC 26, 2023",OKC vs. MIN,W,26,7,11,0.636,4,6,0.667,3,3,1.0,0,1,1,3,0,2,1,3,21,12,1,OKC,OKC,MIN,129,33.5,Fantasy Score,25,22,24,4
Jalen Williams,F,22023,1631114,22300411,"DEC 26, 2023",OKC vs. MIN,W,26,7,11,0.636,4,6,0.667,3,3,1.0,0,1,1,3,0,2,1,3,21,12,1,OKC,OKC,MIN,129,1.5,3-PT Made,25,22,24,4
Jalen Williams,F,22023,1631114,22300411,"DEC 26, 2023",OKC vs. MIN,W,26,7,11,0.636,4,6,0.667,3,3,1.0,0,1,1,3,0,2,1,3,21,12,1,OKC,OKC,MIN,129,2.5,Free Throws Made,25,22,24,4
Jalen Williams,F,22023,1631114,22300411,"DEC 26, 2023",OKC vs. MIN,W,26,7,11,0.636,4,6,0.667,3,3,1.0,0,1,1,3,0,2,1,3,21,12,1,OKC,OKC,MIN,129,14.0,FG Attempted,25,22,24,4
Jalen Williams,F,22023,1631114,22300411,"DEC 26, 2023",OKC vs. MIN,W,26,7,11,0.636,4,6,0.667,3,3,1.0,0,1,1,3,0,2,1,3,21,12,1,OKC,OKC,MIN,129,23.5,Pts+Rebs,25,22,24,4
Jalen Williams,F,22023,1631114,22300411,"DEC 26, 2023",OKC vs. MIN,W,26,7,11,0.636,4,6,0.667,3,3,1.0,0,1,1,3,0,2,1,3,21,12,1,OKC,OKC,MIN,129,23.5,Pts+Asts,25,22,24,4
Jalen Williams,F,22023,1631114,22300411,"DEC 26, 2023",OKC vs. MIN,W,26,7,11,0.636,4,6,0.667,3,3,1.0,0,1,1,3,0,2,1,3,21,12,1,OKC,OKC,MIN,129,9.5,Rebs+Asts,25,22,24,4
Jalen Williams,F,22023,1631114,22301212,"DEC 06, 2023",OKC @ HOU,L,33,5,13,0.385,0,1,0.0,3,3,1.0,0,5,5,3,1,0,2,2,13,-6,1,OKC,HOU,OKC,101,18.5,Points,21,18,16,8
Jalen Williams,F,22023,1631114,22301212,"DEC 06, 2023",OKC @ HOU,L,33,5,13,0.385,0,1,0.0,3,3,1.0,0,5,5,3,1,0,2,2,13,-6,1,OKC,HOU,OKC,101,4.0,Rebounds,21,18,16,8
Jalen Williams,F,22023,1631114,22301212,"DEC 06, 2023",OKC @ HOU,L,33,5,13,0.385,0,1,0.0,3,3,1.0,0,5,5,3,1,0,2,2,13,-6,1,OKC,HOU,OKC,101,28.5,Pts+Rebs+Asts,21,18,16,8
Jalen Williams,F,22023,1631114,22301212,"DEC 06, 2023",OKC @ HOU,L,33,5,13,0.385,0,1,0.0,3,3,1.0,0,5,5,3,1,0,2,2,13,-6,1,OKC,HOU,OKC,101,5.0,Assists,21,18,16,8
Jalen Williams,F,22023,1631114,22301212,"DEC 06, 2023",OKC @ HOU,L,33,5,13,0.385,0,1,0.0,3,3,1.0,0,5,5,3,1,0,2,2,13,-6,1,OKC,HOU,OKC,101,33.5,Fantasy Score,21,18,16,8
Jalen Williams,F,22023,1631114,22301212,"DEC 06, 2023",OKC @ HOU,L,33,5,13,0.385,0,1,0.0,3,3,1.0,0,5,5,3,1,0,2,2,13,-6,1,OKC,HOU,OKC,101,1.5,3-PT Made,21,18,16,8
Jalen Williams,F,22023,1631114,22301212,"DEC 06, 2023",OKC @ HOU,L,33,5,13,0.385,0,1,0.0,3,3,1.0,0,5,5,3,1,0,2,2,13,-6,1,OKC,HOU,OKC,101,2.5,Free Throws Made,21,18,16,8
Jalen Williams,F,22023,1631114,22301212,"DEC 06, 2023",OKC @ HOU,L,33,5,13,0.385,0,1,0.0,3,3,1.0,0,5,5,3,1,0,2,2,13,-6,1,OKC,HOU,OKC,101,14.0,FG Attempted,21,18,16,8
Jalen Williams,F,22023,1631114,22301212,"DEC 06, 2023",OKC @ HOU,L,33,5,13,0.385,0,1,0.0,3,3,1.0,0,5,5,3,1,0,2,2,13,-6,1,OKC,HOU,OKC,101,23.5,Pts+Rebs,21,18,16,8
Jalen Williams,F,22023,1631114,22301212,"DEC 06, 2023",OKC @ HOU,L,33,5,13,0.385,0,1,0.0,3,3,1.0,0,5,5,3,1,0,2,2,13,-6,1,OKC,HOU,OKC,101,23.5,Pts+Asts,21,18,16,8
Jalen Williams,F,22023,1631114,22301212,"DEC 06, 2023",OKC @ HOU,L,33,5,13,0.385,0,1,0.0,3,3,1.0,0,5,5,3,1,0,2,2,13,-6,1,OKC,HOU,OKC,101,9.5,Rebs+Asts,21,18,16,8
Jalen Williams,F,22023,1631114,22300271,"NOV 30, 2023",OKC vs. LAL,W,29,8,13,0.615,1,4,0.25,4,5,0.8,0,5,5,7,0,1,0,3,21,0,1,OKC,OKC,LAL,133,18.5,Points,33,26,28,12
Jalen Williams,F,22023,1631114,22300271,"NOV 30, 2023",OKC vs. LAL,W,29,8,13,0.615,1,4,0.25,4,5,0.8,0,5,5,7,0,1,0,3,21,0,1,OKC,OKC,LAL,133,4.0,Rebounds,33,26,28,12
Jalen Williams,F,22023,1631114,22300271,"NOV 30, 2023",OKC vs. LAL,W,29,8,13,0.615,1,4,0.25,4,5,0.8,0,5,5,7,0,1,0,3,21,0,1,OKC,OKC,LAL,133,28.5,Pts+Rebs+Asts,33,26,28,12
Jalen Williams,F,22023,1631114,22300271,"NOV 30, 2023",OKC vs. LAL,W,29,8,13,0.615,1,4,0.25,4,5,0.8,0,5,5,7,0,1,0,3,21,0,1,OKC,OKC,LAL,133,5.0,Assists,33,26,28,12
Jalen Williams,F,22023,1631114,22300271,"NOV 30, 2023",OKC vs. LAL,W,29,8,13,0.615,1,4,0.25,4,5,0.8,0,5,5,7,0,1,0,3,21,0,1,OKC,OKC,LAL,133,33.5,Fantasy Score,33,26,28,12
Jalen Williams,F,22023,1631114,22300271,"NOV 30, 2023",OKC vs. LAL,W,29,8,13,0.615,1,4,0.25,4,5,0.8,0,5,5,7,0,1,0,3,21,0,1,OKC,OKC,LAL,133,1.5,3-PT Made,33,26,28,12
Jalen Williams,F,22023,1631114,22300271,"NOV 30, 2023",OKC vs. LAL,W,29,8,13,0.615,1,4,0.25,4,5,0.8,0,5,5,7,0,1,0,3,21,0,1,OKC,OKC,LAL,133,2.5,Free Throws Made,33,26,28,12
Jalen Williams,F,22023,1631114,22300271,"NOV 30, 2023",OKC vs. LAL,W,29,8,13,0.615,1,4,0.25,4,5,0.8,0,5,5,7,0,1,0,3,21,0,1,OKC,OKC,LAL,133,14.0,FG Attempted,33,26,28,12
Jalen Williams,F,22023,1631114,22300271,"NOV 30, 2023",OKC vs. LAL,W,29,8,13,0.615,1,4,0.25,4,5,0.8,0,5,5,7,0,1,0,3,21,0,1,OKC,OKC,LAL,133,23.5,Pts+Rebs,33,26,28,12
Jalen Williams,F,22023,1631114,22300271,"NOV 30, 2023",OKC vs. LAL,W,29,8,13,0.615,1,4,0.25,4,5,0.8,0,5,5,7,0,1,0,3,21,0,1,OKC,OKC,LAL,133,23.5,Pts+Asts,33,26,28,12
Jalen Williams,F,22023,1631114,22300271,"NOV 30, 2023",OKC vs. LAL,W,29,8,13,0.615,1,4,0.25,4,5,0.8,0,5,5,7,0,1,0,3,21,0,1,OKC,OKC,LAL,133,9.5,Rebs+Asts,33,26,28,12
Jalen Williams,F,22023,1631114,22300207,"NOV 18, 2023",OKC @ GSW,W,41,8,16,0.5,0,2,0.0,6,6,1.0,0,6,6,3,1,0,1,2,22,6,1,OKC,GSW,OKC,130,18.5,Points,31,28,25,9
Jalen Williams,F,22023,1631114,22300207,"NOV 18, 2023",OKC @ GSW,W,41,8,16,0.5,0,2,0.0,6,6,1.0,0,6,6,3,1,0,1,2,22,6,1,OKC,GSW,OKC,130,4.0,Rebounds,31,28,25,9
Jalen Williams,F,22023,1631114,22300207,"NOV 18, 2023",OKC @ GSW,W,41,8,16,0.5,0,2,0.0,6,6,1.0,0,6,6,3,1,0,1,2,22,6,1,OKC,GSW,OKC,130,28.5,Pts+Rebs+Asts,31,28,25,9
Jalen Williams,F,22023,1631114,22300207,"NOV 18, 2023",OKC @ GSW,W,41,8,16,0.5,0,2,0.0,6,6,1.0,0,6,6,3,1,0,1,2,22,6,1,OKC,GSW,OKC,130,5.0,Assists,31,28,25,9
Jalen Williams,F,22023,1631114,22300207,"NOV 18, 2023",OKC @ GSW,W,41,8,16,0.5,0,2,0.0,6,6,1.0,0,6,6,3,1,0,1,2,22,6,1,OKC,GSW,OKC,130,33.5,Fantasy Score,31,28,25,9
Jalen Williams,F,22023,1631114,22300207,"NOV 18, 2023",OKC @ GSW,W,41,8,16,0.5,0,2,0.0,6,6,1.0,0,6,6,3,1,0,1,2,22,6,1,OKC,GSW,OKC,130,1.5,3-PT Made,31,28,25,9
Jalen Williams,F,22023,1631114,22300207,"NOV 18, 2023",OKC @ GSW,W,41,8,16,0.5,0,2,0.0,6,6,1.0,0,6,6,3,1,0,1,2,22,6,1,OKC,GSW,OKC,130,2.5,Free Throws Made,31,28,25,9
Jalen Williams,F,22023,1631114,22300207,"NOV 18, 2023",OKC @ GSW,W,41,8,16,0.5,0,2,0.0,6,6,1.0,0,6,6,3,1,0,1,2,22,6,1,OKC,GSW,OKC,130,14.0,FG Attempted,31,28,25,9
Jalen Williams,F,22023,1631114,22300207,"NOV 18, 2023",OKC @ GSW,W,41,8,16,0.5,0,2,0.0,6,6,1.0,0,6,6,3,1,0,1,2,22,6,1,OKC,GSW,OKC,130,23.5,Pts+Rebs,31,28,25,9
Jalen Williams,F,22023,1631114,22300207,"NOV 18, 2023",OKC @ GSW,W,41,8,16,0.5,0,2,0.0,6,6,1.0,0,6,6,3,1,0,1,2,22,6,1,OKC,GSW,OKC,130,23.5,Pts+Asts,31,28,25,9
Jalen Williams,F,22023,1631114,22300207,"NOV 18, 2023",OKC @ GSW,W,41,8,16,0.5,0,2,0.0,6,6,1.0,0,6,6,3,1,0,1,2,22,6,1,OKC,GSW,OKC,130,9.5,Rebs+Asts,31,28,25,9
Jalen Williams,F,22023,1631114,22300201,"NOV 16, 2023",OKC @ GSW,W,29,6,13,0.462,2,3,0.667,2,2,1.0,0,3,3,5,2,0,2,3,16,7,1,OKC,GSW,OKC,128,18.5,Points,24,19,21,8
Jalen Williams,F,22023,1631114,22300201,"NOV 16, 2023",OKC @ GSW,W,29,6,13,0.462,2,3,0.667,2,2,1.0,0,3,3,5,2,0,2,3,16,7,1,OKC,GSW,OKC,128,4.0,Rebounds,24,19,21,8
Jalen Williams,F,22023,1631114,22300201,"NOV 16, 2023",OKC @ GSW,W,29,6,13,0.462,2,3,0.667,2,2,1.0,0,3,3,5,2,0,2,3,16,7,1,OKC,GSW,OKC,128,28.5,Pts+Rebs+Asts,24,19,21,8
Jalen Williams,F,22023,1631114,22300201,"NOV 16, 2023",OKC @ GSW,W,29,6,13,0.462,2,3,0.667,2,2,1.0,0,3,3,5,2,0,2,3,16,7,1,OKC,GSW,OKC,128,5.0,Assists,24,19,21,8
Jalen Williams,F,22023,1631114,22300201,"NOV 16, 2023",OKC @ GSW,W,29,6,13,0.462,2,3,0.667,2,2,1.0,0,3,3,5,2,0,2,3,16,7,1,OKC,GSW,OKC,128,33.5,Fantasy Score,24,19,21,8
Jalen Williams,F,22023,1631114,22300201,"NOV 16, 2023",OKC @ GSW,W,29,6,13,0.462,2,3,0.667,2,2,1.0,0,3,3,5,2,0,2,3,16,7,1,OKC,GSW,OKC,128,1.5,3-PT Made,24,19,21,8
Jalen Williams,F,22023,1631114,22300201,"NOV 16, 2023",OKC @ GSW,W,29,6,13,0.462,2,3,0.667,2,2,1.0,0,3,3,5,2,0,2,3,16,7,1,OKC,GSW,OKC,128,2.5,Free Throws Made,24,19,21,8
Jalen Williams,F,22023,1631114,22300201,"NOV 16, 2023",OKC @ GSW,W,29,6,13,0.462,2,3,0.667,2,2,1.0,0,3,3,5,2,0,2,3,16,7,1,OKC,GSW,OKC,128,14.0,FG Attempted,24,19,21,8
Jalen Williams,F,22023,1631114,22300201,"NOV 16, 2023",OKC @ GSW,W,29,6,13,0.462,2,3,0.667,2,2,1.0,0,3,3,5,2,0,2,3,16,7,1,OKC,GSW,OKC,128,23.5,Pts+Rebs,24,19,21,8
Jalen Williams,F,22023,1631114,22300201,"NOV 16, 2023",OKC @ GSW,W,29,6,13,0.462,2,3,0.667,2,2,1.0,0,3,3,5,2,0,2,3,16,7,1,OKC,GSW,OKC,128,23.5,Pts+Asts,24,19,21,8
Jalen Williams,F,22023,1631114,22300201,"NOV 16, 2023",OKC @ GSW,W,29,6,13,0.462,2,3,0.667,2,2,1.0,0,3,3,5,2,0,2,3,16,7,1,OKC,GSW,OKC,128,9.5,Rebs+Asts,24,19,21,8
Jalen Williams,F,22023,1631114,22300021,"NOV 14, 2023",OKC vs. SAS,W,23,5,9,0.556,1,3,0.333,0,0,0.0,0,2,2,3,0,0,3,3,11,23,1,OKC,OKC,SAS,123,18.5,Points,16,13,14,5
Jalen Williams,F,22023,1631114,22300021,"NOV 14, 2023",OKC vs. SAS,W,23,5,9,0.556,1,3,0.333,0,0,0.0,0,2,2,3,0,0,3,3,11,23,1,OKC,OKC,SAS,123,4.0,Rebounds,16,13,14,5
Jalen Williams,F,22023,1631114,22300021,"NOV 14, 2023",OKC vs. SAS,W,23,5,9,0.556,1,3,0.333,0,0,0.0,0,2,2,3,0,0,3,3,11,23,1,OKC,OKC,SAS,123,28.5,Pts+Rebs+Asts,16,13,14,5
Jalen Williams,F,22023,1631114,22300021,"NOV 14, 2023",OKC vs. SAS,W,23,5,9,0.556,1,3,0.333,0,0,0.0,0,2,2,3,0,0,3,3,11,23,1,OKC,OKC,SAS,123,5.0,Assists,16,13,14,5
Jalen Williams,F,22023,1631114,22300021,"NOV 14, 2023",OKC vs. SAS,W,23,5,9,0.556,1,3,0.333,0,0,0.0,0,2,2,3,0,0,3,3,11,23,1,OKC,OKC,SAS,123,33.5,Fantasy Score,16,13,14,5
Jalen Williams,F,22023,1631114,22300021,"NOV 14, 2023",OKC vs. SAS,W,23,5,9,0.556,1,3,0.333,0,0,0.0,0,2,2,3,0,0,3,3,11,23,1,OKC,OKC,SAS,123,1.5,3-PT Made,16,13,14,5
Jalen Williams,F,22023,1631114,22300021,"NOV 14, 2023",OKC vs. SAS,W,23,5,9,0.556,1,3,0.333,0,0,0.0,0,2,2,3,0,0,3,3,11,23,1,OKC,OKC,SAS,123,2.5,Free Throws Made,16,13,14,5
Jalen Williams,F,22023,1631114,22300021,"NOV 14, 2023",OKC vs. SAS,W,23,5,9,0.556,1,3,0.333,0,0,0.0,0,2,2,3,0,0,3,3,11,23,1,OKC,OKC,SAS,123,14.0,FG Attempted,16,13,14,5
Jalen Williams,F,22023,1631114,22300021,"NOV 14, 2023",OKC vs. SAS,W,23,5,9,0.556,1,3,0.333,0,0,0.0,0,2,2,3,0,0,3,3,11,23,1,OKC,OKC,SAS,123,23.5,Pts+Rebs,16,13,14,5
Jalen Williams,F,22023,1631114,22300021,"NOV 14, 2023",OKC vs. SAS,W,23,5,9,0.556,1,3,0.333,0,0,0.0,0,2,2,3,0,0,3,3,11,23,1,OKC,OKC,SAS,123,23.5,Pts+Asts,16,13,14,5
Jalen Williams,F,22023,1631114,22300021,"NOV 14, 2023",OKC vs. SAS,W,23,5,9,0.556,1,3,0.333,0,0,0.0,0,2,2,3,0,0,3,3,11,23,1,OKC,OKC,SAS,123,9.5,Rebs+Asts,16,13,14,5
Jalen Williams,F,22023,1631114,22300581,"JAN 18, 2024",OKC @ UTA,W,37,11,14,0.786,4,5,0.8,1,2,0.5,0,3,3,8,2,2,2,6,27,16,1,OKC,UTA,OKC,134,18.5,Points,38,30,35,11
Jalen Williams,F,22023,1631114,22300581,"JAN 18, 2024",OKC @ UTA,W,37,11,14,0.786,4,5,0.8,1,2,0.5,0,3,3,8,2,2,2,6,27,16,1,OKC,UTA,OKC,134,4.0,Rebounds,38,30,35,11
Jalen Williams,F,22023,1631114,22300581,"JAN 18, 2024",OKC @ UTA,W,37,11,14,0.786,4,5,0.8,1,2,0.5,0,3,3,8,2,2,2,6,27,16,1,OKC,UTA,OKC,134,28.5,Pts+Rebs+Asts,38,30,35,11
Jalen Williams,F,22023,1631114,22300581,"JAN 18, 2024",OKC @ UTA,W,37,11,14,0.786,4,5,0.8,1,2,0.5,0,3,3,8,2,2,2,6,27,16,1,OKC,UTA,OKC,134,5.0,Assists,38,30,35,11
Jalen Williams,F,22023,1631114,22300581,"JAN 18, 2024",OKC @ UTA,W,37,11,14,0.786,4,5,0.8,1,2,0.5,0,3,3,8,2,2,2,6,27,16,1,OKC,UTA,OKC,134,33.5,Fantasy Score,38,30,35,11
Jalen Williams,F,22023,1631114,22300581,"JAN 18, 2024",OKC @ UTA,W,37,11,14,0.786,4,5,0.8,1,2,0.5,0,3,3,8,2,2,2,6,27,16,1,OKC,UTA,OKC,134,1.5,3-PT Made,38,30,35,11
Jalen Williams,F,22023,1631114,22300581,"JAN 18, 2024",OKC @ UTA,W,37,11,14,0.786,4,5,0.8,1,2,0.5,0,3,3,8,2,2,2,6,27,16,1,OKC,UTA,OKC,134,2.5,Free Throws Made,38,30,35,11
Jalen Williams,F,22023,1631114,22300581,"JAN 18, 2024",OKC @ UTA,W,37,11,14,0.786,4,5,0.8,1,2,0.5,0,3,3,8,2,2,2,6,27,16,1,OKC,UTA,OKC,134,14.0,FG Attempted,38,30,35,11
Jalen Williams,F,22023,1631114,22300581,"JAN 18, 2024",OKC @ UTA,W,37,11,14,0.786,4,5,0.8,1,2,0.5,0,3,3,8,2,2,2,6,27,16,1,OKC,UTA,OKC,134,23.5,Pts+Rebs,38,30,35,11
Jalen Williams,F,22023,1631114,22300581,"JAN 18, 2024",OKC @ UTA,W,37,11,14,0.786,4,5,0.8,1,2,0.5,0,3,3,8,2,2,2,6,27,16,1,OKC,UTA,OKC,134,23.5,Pts+Asts,38,30,35,11
Jalen Williams,F,22023,1631114,22300581,"JAN 18, 2024",OKC @ UTA,W,37,11,14,0.786,4,5,0.8,1,2,0.5,0,3,3,8,2,2,2,6,27,16,1,OKC,UTA,OKC,134,9.5,Rebs+Asts,38,30,35,11
Devin Vassell,G,22023,1630170,22300750,"FEB 10, 2024",SAS @ BKN,L,34,7,20,0.35,2,6,0.333,1,1,1.0,1,5,6,4,0,1,2,0,17,-18,1,SAS,BKN,SAS,103,,,27,23,21,10
Devin Vassell,G,22023,1630170,22300681,"JAN 31, 2024",SAS vs. ORL,L,37,8,18,0.444,3,8,0.375,7,10,0.7,0,4,4,4,0,1,1,1,26,-16,1,SAS,SAS,ORL,98,,,34,30,30,8
Devin Vassell,G,22023,1630170,22300665,"JAN 29, 2024",SAS vs. WAS,L,35,9,19,0.474,1,5,0.2,5,6,0.833,1,4,5,4,0,1,5,1,24,-3,1,SAS,SAS,WAS,113,,,33,29,28,9
Devin Vassell,G,22023,1630170,22300649,"JAN 27, 2024",SAS vs. MIN,W,36,11,17,0.647,3,6,0.5,0,0,0.0,0,4,4,5,2,0,2,2,25,-9,1,SAS,SAS,MIN,113,,,34,29,30,9
Devin Vassell,G,22023,1630170,22300584,"JAN 19, 2024",SAS @ CHA,L,36,6,13,0.462,4,8,0.5,1,2,0.5,0,5,5,7,2,0,2,1,17,-5,1,SAS,CHA,SAS,120,,,29,22,24,12
Devin Vassell,G,22023,1630170,22300571,"JAN 17, 2024",SAS @ BOS,L,32,7,15,0.467,0,5,0.0,7,8,0.875,0,2,2,3,1,0,1,1,21,-15,1,SAS,BOS,SAS,95,,,26,23,24,5
Devin Vassell,G,22023,1630170,22300559,"JAN 15, 2024",SAS @ ATL,L,30,2,11,0.182,0,5,0.0,0,0,0.0,1,3,4,4,0,1,0,0,4,-4,1,SAS,ATL,SAS,99,,,12,8,8,8
Devin Vassell,G,22023,1630170,22300548,"JAN 13, 2024",SAS vs. CHI,L,34,1,13,0.077,1,8,0.125,2,3,0.667,0,4,4,2,1,0,2,0,5,-13,1,SAS,SAS,CHI,116,,,11,9,7,6
Devin Vassell,G,22023,1630170,22300541,"JAN 12, 2024",SAS vs. CHA,W,26,4,10,0.4,1,3,0.333,3,3,1.0,0,3,3,5,2,0,2,2,12,28,1,SAS,SAS,CHA,127,,,20,15,17,8
Devin Vassell,G,22023,1630170,22300519,"JAN 10, 2024",SAS @ DET,W,27,6,12,0.5,1,5,0.2,3,4,0.75,0,3,3,5,1,0,1,0,16,13,1,SAS,DET,SAS,129,,,24,19,21,8
Devin Vassell,G,22023,1630170,22300497,"JAN 07, 2024",SAS @ CLE,L,35,9,19,0.474,4,9,0.444,0,0,0.0,0,2,2,3,3,0,0,2,22,12,1,SAS,CLE,SAS,115,,,27,24,25,5
Devin Vassell,G,22023,1630170,22300477,"JAN 04, 2024",SAS vs. MIL,L,35,14,21,0.667,6,9,0.667,0,0,0.0,1,5,6,4,1,0,0,0,34,-10,1,SAS,SAS,MIL,121,,,44,40,38,10
Devin Vassell,G,22023,1630170,22300460,"JAN 02, 2024",SAS @ MEM,L,34,3,8,0.375,1,2,0.5,4,5,0.8,1,1,2,3,1,1,2,2,11,-7,1,SAS,MEM,SAS,98,,,16,13,14,5
Devin Vassell,G,22023,1630170,22300448,"DEC 31, 2023",SAS vs. BOS,L,31,9,15,0.6,2,4,0.5,2,2,1.0,0,4,4,1,2,0,2,3,22,-34,1,SAS,SAS,BOS,101,,,27,26,23,5
Devin Vassell,G,22023,1630170,22300437,"DEC 29, 2023",SAS @ POR,L,31,8,16,0.5,3,6,0.5,3,4,0.75,0,3,3,5,4,1,0,1,22,-6,1,SAS,POR,SAS,128,,,30,25,27,8
Devin Vassell,G,22023,1630170,22300361,"DEC 19, 2023",SAS @ MIL,L,33,7,18,0.389,2,6,0.333,1,1,1.0,0,3,3,2,0,0,2,0,17,-12,1,SAS,MIL,SAS,119,,,22,20,19,5
Devin Vassell,G,22023,1630170,22300278,"DEC 01, 2023",SAS @ NOP,L,27,5,12,0.417,2,7,0.286,2,2,1.0,0,0,0,1,2,0,3,2,14,-16,1,SAS,NOP,SAS,106,,,15,14,15,1
Devin Vassell,G,22023,1630170,22300235,"NOV 22, 2023",SAS vs. LAC,L,27,6,15,0.4,2,8,0.25,4,5,0.8,1,3,4,4,1,0,2,2,18,-7,1,SAS,SAS,LAC,102,,,26,22,22,8
Devin Vassell,G,22023,1630170,22300021,"NOV 14, 2023",SAS @ OKC,L,25,5,12,0.417,1,2,0.5,1,2,0.5,0,3,3,4,2,1,1,1,12,-20,1,SAS,OKC,SAS,87,,,19,15,16,7
Devin Vassell,G,22023,1630170,22300161,"NOV 08, 2023",SAS @ NYK,L,12,2,6,0.333,0,2,0.0,0,0,0.0,0,2,2,2,0,0,1,0,4,-3,1,SAS,NYK,SAS,105,,,8,6,6,4
Devin Vassell,G,22023,1630170,22300099,"OCT 29, 2023",SAS @ LAC,L,28,6,10,0.6,1,3,0.333,1,1,1.0,0,1,1,0,1,0,2,2,14,-30,1,SAS,LAC,SAS,83,,,15,15,14,1
Devin Vassell,G,22023,1630170,22300272,"NOV 30, 2023",SAS vs. ATL,L,27,8,14,0.571,4,10,0.4,5,5,1.0,0,4,4,4,0,0,2,1,25,-4,1,SAS,SAS,ATL,135,,,33,29,29,8
Devin Vassell,G,22023,1630170,22300252,"NOV 26, 2023",SAS @ DEN,L,26,7,13,0.538,4,7,0.571,1,1,1.0,0,1,1,3,1,0,0,1,19,5,1,SAS,DEN,SAS,120,,,23,20,22,4
Devin Vassell,G,22023,1630170,22300051,"NOV 24, 2023",SAS @ GSW,L,27,10,19,0.526,4,10,0.4,0,0,0.0,1,3,4,1,1,0,2,2,24,-9,1,SAS,GSW,SAS,112,,,29,28,25,5
Devin Vassell,G,22023,1630170,22300184,"NOV 12, 2023",SAS vs. MIA,L,33,5,12,0.417,4,9,0.444,0,0,0.0,2,5,7,4,0,0,1,0,14,-15,1,SAS,SAS,MIA,113,,,25,21,18,11
Devin Vassell,G,22023,1630170,22300013,"NOV 10, 2023",SAS vs. MIN,L,35,8,16,0.5,6,11,0.545,7,9,0.778,0,3,3,4,1,0,1,1,29,2,1,SAS,SAS,MIN,110,,,36,32,33,7
Devin Vassell,G,22023,1630170,22300131,"NOV 02, 2023",SAS @ PHX,W,17,7,10,0.7,3,3,1.0,0,0,0.0,0,2,2,1,0,0,0,2,17,16,1,SAS,PHX,SAS,132,,,20,19,18,3
Devin Vassell,G,22023,1630170,22300113,"OCT 31, 2023",SAS @ PHX,W,36,7,17,0.412,3,8,0.375,1,2,0.5,1,5,6,5,3,0,3,0,18,-1,1,SAS,PHX,SAS,115,,,29,24,23,11
Devin Vassell,G,22023,1630170,22300083,"OCT 27, 2023",SAS vs. HOU,W,40,7,13,0.538,3,7,0.429,8,11,0.727,0,3,3,2,0,0,1,0,25,2,1,SAS,SAS,HOU,126,,,30,28,27,5
Devin Vassell,G,22023,1630170,22300073,"OCT 25, 2023",SAS vs. DAL,L,35,9,17,0.529,1,6,0.167,4,5,0.8,1,4,5,3,2,0,2,2,23,4,1,SAS,SAS,DAL,119,,,31,28,26,8
Devin Vassell,G,22023,1630170,22300734,"FEB 08, 2024",SAS @ ORL,L,35,11,18,0.611,3,7,0.429,5,6,0.833,1,4,5,4,0,0,2,0,30,-14,1,SAS,ORL,SAS,111,,,39,35,34,9
Devin Vassell,G,22023,1630170,22300730,"FEB 07, 2024",SAS @ MIA,L,32,8,18,0.444,1,6,0.167,2,2,1.0,0,3,3,3,1,0,2,1,19,-11,1,SAS,MIA,SAS,104,,,25,22,22,6
Devin Vassell,G,22023,1630170,22300703,"FEB 03, 2024",SAS vs. CLE,L,34,7,16,0.438,3,8,0.375,5,5,1.0,0,6,6,3,0,1,0,0,22,-10,1,SAS,SAS,CLE,101,,,31,28,25,9
Devin Vassell,G,22023,1630170,22300696,"FEB 02, 2024",SAS vs. NOP,L,36,11,21,0.524,5,10,0.5,1,2,0.5,0,3,3,3,0,1,2,0,28,7,1,SAS,SAS,NOP,113,,,34,31,31,6
Devin Vassell,G,22023,1630170,22300622,"JAN 24, 2024",SAS vs. OKC,L,34,9,14,0.643,1,4,0.25,2,2,1.0,1,4,5,7,0,1,0,1,21,-19,1,SAS,SAS,OKC,114,,,33,26,28,12
Devin Vassell,G,22023,1630170,22300594,"JAN 20, 2024",SAS @ WAS,W,34,8,14,0.571,4,6,0.667,1,3,0.333,0,5,5,5,1,0,4,1,21,23,1,SAS,WAS,SAS,131,,,31,26,26,10
Devin Vassell,G,22023,1630170,22300427,"DEC 28, 2023",SAS @ POR,W,35,7,16,0.438,2,9,0.222,1,1,1.0,0,5,5,7,4,1,1,0,17,18,1,SAS,POR,SAS,118,,,29,22,24,12
Devin Vassell,G,22023,1630170,22300412,"DEC 26, 2023",SAS vs. UTA,L,34,8,18,0.444,5,10,0.5,1,1,1.0,1,3,4,3,3,0,1,2,22,-11,1,SAS,SAS,UTA,118,,,29,26,25,7
Devin Vassell,G,22023,1630170,22300398,"DEC 23, 2023",SAS @ DAL,L,30,3,13,0.231,0,6,0.0,3,3,1.0,0,0,0,5,0,0,0,1,9,-38,1,SAS,DAL,SAS,119,,,14,9,14,5
Devin Vassell,G,22023,1630170,22300376,"DEC 21, 2023",SAS @ CHI,L,31,7,15,0.467,3,8,0.375,4,4,1.0,1,3,4,2,1,0,1,0,21,-4,1,SAS,CHI,SAS,95,,,27,25,23,6
Devin Vassell,G,22023,1630170,22300345,"DEC 17, 2023",SAS vs. NOP,L,30,5,13,0.385,3,7,0.429,0,1,0.0,0,2,2,3,0,0,1,2,13,-15,1,SAS,SAS,NOP,110,,,18,15,16,5
Devin Vassell,G,22023,1630170,22300331,"DEC 15, 2023",SAS vs. LAL,W,35,12,19,0.632,5,10,0.5,7,7,1.0,0,6,6,3,1,1,1,1,36,20,1,SAS,SAS,LAL,129,,,45,42,39,9
Devin Vassell,G,22023,1630170,22300316,"DEC 13, 2023",SAS vs. LAL,L,35,5,15,0.333,1,7,0.143,2,2,1.0,0,5,5,4,2,0,2,0,13,5,1,SAS,SAS,LAL,119,,,22,18,17,9
Devin Vassell,G,22023,1630170,22300298,"DEC 11, 2023",SAS @ HOU,L,31,5,16,0.313,1,9,0.111,3,5,0.6,3,3,6,2,0,0,0,1,14,1,1,SAS,HOU,SAS,82,,,22,20,16,8
Devin Vassell,G,22023,1630170,22301223,"DEC 08, 2023",SAS vs. CHI,L,34,4,15,0.267,1,9,0.111,2,3,0.667,0,2,2,5,1,0,3,1,11,-14,1,SAS,SAS,CHI,112,,,18,13,16,7
Devin Vassell,G,22023,1630170,22301210,"DEC 06, 2023",SAS @ MIN,L,31,9,16,0.563,4,8,0.5,0,0,0.0,0,3,3,2,1,1,0,1,22,4,1,SAS,MIN,SAS,94,,,27,25,24,5
Devin Vassell,G,22023,1630170,22300641,"JAN 26, 2024",SAS vs. POR,W,32,5,14,0.357,2,7,0.286,3,5,0.6,0,4,4,2,0,0,1,1,15,19,1,SAS,SAS,POR,116,,,21,19,17,6
Devin Vassell,G,22023,1630170,22300608,"JAN 22, 2024",SAS @ PHI,L,38,7,13,0.538,2,6,0.333,6,6,1.0,0,4,4,9,0,0,1,3,22,-17,1,SAS,PHI,SAS,123,,,35,26,31,13
Jalen Green,G,22023,1630224,22300754,"FEB 10, 2024",HOU @ ATL,L,37,10,22,0.455,2,9,0.222,4,7,0.571,2,12,14,10,1,0,5,1,26,-7,1,HOU,ATL,HOU,113,,,50,40,36,24
Jalen Green,G,22023,1630224,22300744,"FEB 09, 2024",HOU @ TOR,L,22,3,11,0.273,1,5,0.2,0,1,0.0,0,2,2,1,0,0,4,0,7,-23,1,HOU,TOR,HOU,104,,,10,9,8,3
Jalen Green,G,22023,1630224,22300719,"FEB 06, 2024",HOU @ IND,L,33,12,21,0.571,3,5,0.6,3,4,0.75,0,3,3,1,2,0,4,1,30,12,1,HOU,IND,HOU,129,,,34,33,31,4
Jalen Green,G,22023,1630224,22300709,"FEB 04, 2024",HOU @ MIN,L,30,3,15,0.2,0,5,0.0,2,3,0.667,0,2,2,7,0,1,2,2,8,-19,1,HOU,MIN,HOU,90,,,17,10,15,9
Jalen Green,G,22023,1630224,22300692,"FEB 02, 2024",HOU vs. TOR,W,27,7,14,0.5,0,4,0.0,0,1,0.0,0,4,4,3,0,0,1,1,14,17,1,HOU,HOU,TOR,135,,,21,18,17,7
Jalen Green,G,22023,1630224,22300679,"JAN 31, 2024",HOU vs. NOP,L,38,11,20,0.55,5,12,0.417,4,4,1.0,0,4,4,4,3,2,3,3,31,-7,1,HOU,HOU,NOP,99,,,39,35,35,8
Jalen Green,G,22023,1630224,22300662,"JAN 29, 2024",HOU vs. LAL,W,41,12,23,0.522,4,10,0.4,6,6,1.0,3,9,12,7,1,0,1,1,34,13,1,HOU,HOU,LAL,135,,,53,46,41,19
Jalen Green,G,22023,1630224,22300645,"JAN 27, 2024",HOU @ BKN,L,33,5,14,0.357,4,9,0.444,5,5,1.0,1,9,10,1,1,0,1,3,19,6,1,HOU,BKN,HOU,104,,,30,29,20,11
Jalen Green,G,22023,1630224,22300635,"JAN 26, 2024",HOU @ CHA,W,28,12,20,0.6,1,7,0.143,11,12,0.917,0,10,10,4,2,0,3,0,36,15,1,HOU,CHA,HOU,138,,,50,46,40,14
Jalen Green,G,22023,1630224,22300623,"JAN 24, 2024",HOU vs. POR,L,39,12,24,0.5,2,7,0.286,3,4,0.75,0,0,0,3,1,1,1,1,29,-6,1,HOU,HOU,POR,131,,,32,29,32,3
Jalen Green,G,22023,1630224,22300603,"JAN 21, 2024",HOU vs. BOS,L,32,7,18,0.389,1,6,0.167,1,3,0.333,1,3,4,5,1,0,3,0,16,-8,1,HOU,HOU,BOS,107,,,25,20,21,9
Jalen Green,G,22023,1630224,22300598,"JAN 20, 2024",HOU vs. UTA,W,28,3,12,0.25,0,6,0.0,1,1,1.0,0,3,3,4,1,0,1,0,7,-7,1,HOU,HOU,UTA,127,,,14,10,11,7
Jalen Green,G,22023,1630224,22300573,"JAN 17, 2024",HOU @ NYK,L,29,6,15,0.4,0,5,0.0,3,3,1.0,0,7,7,1,1,0,5,2,15,-11,1,HOU,NYK,HOU,94,,,23,22,16,8
Jalen Green,G,22023,1630224,22300555,"JAN 15, 2024",HOU @ PHI,L,27,7,16,0.438,1,7,0.143,5,7,0.714,0,5,5,3,0,0,2,2,20,-7,1,HOU,PHI,HOU,115,,,28,25,23,8
Jalen Green,G,22023,1630224,22300542,"JAN 13, 2024",HOU @ BOS,L,20,3,9,0.333,2,5,0.4,2,2,1.0,0,3,3,1,0,0,1,0,10,-17,1,HOU,BOS,HOU,113,,,14,13,11,4
Jalen Green,G,22023,1630224,22300409,"DEC 26, 2023",HOU vs. IND,L,20,2,7,0.286,0,3,0.0,1,2,0.5,0,1,1,2,1,0,0,0,5,-19,1,HOU,HOU,IND,117,,,8,6,7,3
Jalen Green,G,22023,1630224,22300392,"DEC 23, 2023",HOU @ NOP,W,22,2,8,0.25,0,4,0.0,5,6,0.833,0,4,4,2,1,0,5,1,9,-2,1,HOU,NOP,HOU,106,,,15,13,11,6
Jalen Green,G,22023,1630224,22300385,"DEC 22, 2023",HOU vs. DAL,W,27,5,14,0.357,3,7,0.429,4,4,1.0,1,5,6,4,2,0,4,2,17,35,1,HOU,HOU,DAL,122,,,27,23,21,10
Jalen Green,G,22023,1630224,22300371,"DEC 20, 2023",HOU vs. ATL,L,32,7,19,0.368,2,7,0.286,0,0,0.0,1,3,4,2,1,1,1,1,16,-7,1,HOU,HOU,ATL,127,,,22,20,18,6
Jalen Green,G,22023,1630224,22300349,"DEC 18, 2023",HOU @ CLE,L,34,2,12,0.167,1,4,0.25,7,7,1.0,0,6,6,3,1,2,2,2,12,-16,1,HOU,CLE,HOU,130,,,21,18,15,9
Jalen Green,G,22023,1630224,22300346,"DEC 17, 2023",HOU @ MIL,L,29,6,11,0.545,2,4,0.5,2,2,1.0,0,2,2,7,0,0,1,0,16,-8,1,HOU,MIL,HOU,119,,,25,18,23,9
Jalen Green,G,22023,1630224,22300332,"DEC 15, 2023",HOU @ MEM,W,28,4,12,0.333,3,7,0.429,3,4,0.75,1,3,4,4,0,1,1,1,14,-2,1,HOU,MEM,HOU,103,,,22,18,18,8
Jalen Green,G,22023,1630224,22300314,"DEC 13, 2023",HOU vs. MEM,W,24,2,12,0.167,0,5,0.0,4,4,1.0,0,4,4,4,0,0,3,3,8,-1,1,HOU,HOU,MEM,117,,,16,12,12,8
Jalen Green,G,22023,1630224,22300298,"DEC 11, 2023",HOU vs. SAS,W,24,2,10,0.2,1,4,0.25,2,2,1.0,0,3,3,1,0,0,1,1,7,-14,1,HOU,HOU,SAS,93,,,11,10,8,4
Jalen Green,G,22023,1630224,22301224,"DEC 08, 2023",HOU @ DEN,W,35,8,17,0.471,2,9,0.222,7,9,0.778,0,3,3,1,0,0,1,0,25,-8,1,HOU,DEN,HOU,114,,,29,28,26,4
Jalen Green,G,22023,1630224,22301212,"DEC 06, 2023",HOU vs. OKC,W,25,6,12,0.5,1,3,0.333,2,2,1.0,0,7,7,1,0,0,3,3,15,0,1,HOU,HOU,OKC,110,,,23,22,16,8
Jalen Green,G,22023,1630224,22300291,"DEC 02, 2023",HOU @ LAL,L,32,4,15,0.267,1,6,0.167,1,2,0.5,1,6,7,2,0,0,6,1,10,-6,1,HOU,LAL,HOU,97,,,19,17,12,9
Jalen Green,G,22023,1630224,22300263,"NOV 29, 2023",HOU @ DEN,L,34,8,12,0.667,5,8,0.625,5,6,0.833,0,6,6,9,0,1,2,0,26,-11,1,HOU,DEN,HOU,124,,,41,32,35,15
Jalen Green,G,22023,1630224,22300059,"NOV 28, 2023",HOU @ DAL,L,34,5,14,0.357,2,6,0.333,0,0,0.0,1,2,3,5,0,1,2,4,12,5,1,HOU,DAL,HOU,115,,,20,15,17,8
Jalen Green,G,22023,1630224,22300048,"NOV 24, 2023",HOU vs. DEN,W,36,10,18,0.556,3,8,0.375,2,3,0.667,0,5,5,2,3,0,3,0,25,0,1,HOU,HOU,DEN,105,,,32,30,27,7
Jalen Green,G,22023,1630224,22300231,"NOV 22, 2023",HOU vs. MEM,W,30,13,26,0.5,3,13,0.231,5,5,1.0,1,1,2,4,1,0,1,0,34,11,1,HOU,HOU,MEM,111,,,40,36,38,6
Jalen Green,G,22023,1630224,22300224,"NOV 20, 2023",HOU @ GSW,L,23,6,15,0.4,2,9,0.222,2,2,1.0,0,3,3,2,0,0,1,3,16,-13,1,HOU,GSW,HOU,116,,,21,19,18,5
Jalen Green,G,22023,1630224,22300216,"NOV 19, 2023",HOU @ LAL,L,31,3,10,0.3,2,5,0.4,1,3,0.333,0,6,6,3,0,1,4,1,9,3,1,HOU,LAL,HOU,104,,,18,15,12,9
Jalen Green,G,22023,1630224,22300037,"NOV 17, 2023",HOU @ LAC,L,33,5,16,0.313,1,6,0.167,9,10,0.9,0,4,4,5,0,1,4,3,20,-10,1,HOU,LAC,HOU,100,,,29,24,25,9
Jalen Green,G,22023,1630224,22300182,"NOV 12, 2023",HOU vs. DEN,W,35,1,13,0.077,1,4,0.25,6,6,1.0,0,8,8,5,1,0,0,1,9,10,1,HOU,HOU,DEN,107,,,22,17,14,13
Jalen Green,G,22023,1630224,22300011,"NOV 10, 2023",HOU vs. NOP,W,35,7,18,0.389,2,8,0.25,9,10,0.9,0,4,4,1,0,0,1,1,25,-1,1,HOU,HOU,NOP,104,,,30,29,26,5
Jalen Green,G,22023,1630224,22300163,"NOV 08, 2023",HOU vs. LAL,W,21,11,15,0.733,5,6,0.833,1,4,0.25,1,6,7,3,1,0,1,3,28,24,1,HOU,HOU,LAL,128,,,38,35,31,10
Jalen Green,G,22023,1630224,22300153,"NOV 06, 2023",HOU vs. SAC,W,26,5,9,0.556,3,5,0.6,10,12,0.833,0,2,2,2,1,1,3,0,23,13,1,HOU,HOU,SAC,122,,,27,25,25,4
Jalen Green,G,22023,1630224,22300137,"NOV 04, 2023",HOU vs. SAC,W,36,4,10,0.4,0,2,0.0,2,7,0.286,0,2,2,5,0,0,3,1,10,26,1,HOU,HOU,SAC,107,,,17,12,15,7
Jalen Green,G,22023,1630224,22300122,"NOV 01, 2023",HOU vs. CHA,W,31,6,16,0.375,4,8,0.5,7,7,1.0,1,3,4,3,2,0,1,3,23,-4,1,HOU,HOU,CHA,128,,,30,27,26,7
Jalen Green,G,22023,1630224,22300096,"OCT 29, 2023",HOU vs. GSW,L,38,8,20,0.4,1,5,0.2,4,5,0.8,1,8,9,1,0,1,4,1,21,4,1,HOU,HOU,GSW,95,,,31,30,22,10
Jalen Green,G,22023,1630224,22300083,"OCT 27, 2023",HOU @ SAS,L,38,10,20,0.5,2,6,0.333,0,0,0.0,1,4,5,4,0,0,2,2,22,-3,1,HOU,SAS,HOU,122,,,31,27,26,9
Jalen Green,G,22023,1630224,22300066,"OCT 25, 2023",HOU @ ORL,L,30,2,10,0.2,0,1,0.0,6,7,0.857,0,1,1,0,1,1,4,2,10,-12,1,HOU,ORL,HOU,86,,,11,11,10,1
Jalen Green,G,22023,1630224,22300534,"JAN 12, 2024",HOU @ DET,W,39,9,25,0.36,2,9,0.222,8,9,0.889,2,2,4,3,2,1,1,3,28,7,1,HOU,DET,HOU,112,,,35,32,31,7
Jalen Green,G,22023,1630224,22300485,"JAN 05, 2024",HOU vs. MIN,L,31,7,16,0.438,4,8,0.5,2,4,0.5,1,4,5,2,0,0,2,1,20,-9,1,HOU,HOU,MIN,95,,,27,25,22,7
Jalen Green,G,22023,1630224,22300469,"JAN 03, 2024",HOU vs. BKN,W,31,5,15,0.333,3,9,0.333,1,2,0.5,0,8,8,4,0,0,4,1,14,17,1,HOU,HOU,BKN,112,,,26,22,18,12
Jalen Green,G,22023,1630224,22300453,"JAN 01, 2024",HOU vs. DET,W,27,6,12,0.5,5,9,0.556,5,6,0.833,0,5,5,1,1,0,0,0,22,20,1,HOU,HOU,DET,136,,,28,27,23,6
Jalen Green,G,22023,1630224,22300418,"DEC 27, 2023",HOU vs. PHX,L,26,8,20,0.4,6,12,0.5,1,2,0.5,1,4,5,3,1,0,2,0,23,-17,1,HOU,HOU,PHX,113,,,31,28,26,8
Jalen Green,G,22023,1630224,22300434,"DEC 29, 2023",HOU vs. PHI,L,36,12,19,0.632,5,9,0.556,2,4,0.5,0,6,6,4,0,0,1,0,31,-7,1,HOU,HOU,PHI,127,,,41,37,35,10
Jalen Green,G,22023,1630224,22300523,"JAN 10, 2024",HOU @ CHI,L,40,8,19,0.421,2,7,0.286,0,1,0.0,1,5,6,8,1,0,2,2,18,-4,1,HOU,CHI,HOU,119,,,32,24,26,14
Jalen Green,G,22023,1630224,22300509,"JAN 08, 2024",HOU @ MIA,L,31,2,10,0.2,2,8,0.25,5,6,0.833,0,5,5,6,0,0,3,3,11,-11,1,HOU,MIA,HOU,113,,,22,16,17,11
Jalen Green,G,22023,1630224,22300496,"JAN 06, 2024",HOU vs. MIL,W,28,5,12,0.417,1,6,0.167,5,5,1.0,0,4,4,2,1,0,1,1,16,4,1,HOU,HOU,MIL,112,,,22,20,18,6
Tim Hardaway Jr.,G-F,22023,203501,22300487,"JAN 05, 2024",DAL vs. POR,W,27,8,14,0.571,3,7,0.429,0,1,0.0,0,2,2,4,1,1,2,3,19,21,1,DAL,DAL,POR,132,,,25,21,23,6
Tim Hardaway Jr.,G-F,22023,203501,22300398,"DEC 23, 2023",DAL vs. SAS,W,30,9,20,0.45,5,11,0.455,0,0,0.0,0,6,6,3,0,0,0,1,23,28,1,DAL,DAL,SAS,144,,,32,29,26,9
Tim Hardaway Jr.,G-F,22023,203501,22300385,"DEC 22, 2023",DAL @ HOU,L,26,6,20,0.3,2,8,0.25,2,2,1.0,1,2,3,1,0,0,1,0,16,-27,1,DAL,HOU,DAL,96,,,20,19,17,4
Tim Hardaway Jr.,G-F,22023,203501,22300356,"DEC 18, 2023",DAL @ DEN,L,22,3,12,0.25,2,9,0.222,0,0,0.0,0,2,2,1,0,0,2,2,8,-7,1,DAL,DEN,DAL,104,,,11,10,9,3
Tim Hardaway Jr.,G-F,22023,203501,22300341,"DEC 16, 2023",DAL @ POR,W,36,8,21,0.381,5,15,0.333,4,4,1.0,0,6,6,1,1,0,1,0,25,12,1,DAL,POR,DAL,131,,,32,31,26,7
Tim Hardaway Jr.,G-F,22023,203501,22300321,"DEC 14, 2023",DAL vs. MIN,L,32,4,15,0.267,0,7,0.0,2,3,0.667,0,4,4,0,0,0,2,2,10,-30,1,DAL,DAL,MIN,101,,,14,14,10,4
Tim Hardaway Jr.,G-F,22023,203501,22300680,"JAN 31, 2024",DAL @ MIN,L,32,5,16,0.313,2,10,0.2,2,2,1.0,0,3,3,2,2,0,1,0,14,-32,1,DAL,MIN,DAL,82,,,19,17,16,5
Tim Hardaway Jr.,G-F,22023,203501,22300666,"JAN 29, 2024",DAL vs. ORL,W,37,11,17,0.647,5,9,0.556,9,11,0.818,0,8,8,1,1,0,1,2,36,13,1,DAL,DAL,ORL,131,,,45,44,37,9
Tim Hardaway Jr.,G-F,22023,203501,22300651,"JAN 27, 2024",DAL vs. SAC,L,36,8,17,0.471,3,9,0.333,0,0,0.0,0,4,4,1,0,0,1,2,19,-2,1,DAL,DAL,SAC,115,,,24,23,20,5
Tim Hardaway Jr.,G-F,22023,203501,22300577,"JAN 17, 2024",DAL @ LAL,L,28,5,17,0.294,0,7,0.0,2,2,1.0,2,2,4,1,1,0,4,2,12,-10,1,DAL,LAL,DAL,105,,,17,16,13,5
Tim Hardaway Jr.,G-F,22023,203501,22300556,"JAN 15, 2024",DAL vs. NOP,W,41,11,23,0.478,9,15,0.6,10,10,1.0,0,2,2,2,1,0,4,0,41,-1,1,DAL,DAL,NOP,125,,,45,43,43,4
Tim Hardaway Jr.,G-F,22023,203501,22300547,"JAN 13, 2024",DAL vs. NOP,L,39,8,17,0.471,3,8,0.375,5,6,0.833,0,4,4,0,0,0,0,3,24,-6,1,DAL,DAL,NOP,108,,,28,28,24,4
Tim Hardaway Jr.,G-F,22023,203501,22300530,"JAN 11, 2024",DAL vs. NYK,W,39,10,20,0.5,6,13,0.462,6,7,0.857,2,4,6,4,2,0,2,2,32,12,1,DAL,DAL,NYK,128,,,42,38,36,10
Tim Hardaway Jr.,G-F,22023,203501,22300515,"JAN 09, 2024",DAL vs. MEM,L,30,3,6,0.5,2,3,0.667,1,1,1.0,0,3,3,2,0,0,1,3,9,-26,1,DAL,DAL,MEM,103,,,14,12,11,5
Tim Hardaway Jr.,G-F,22023,203501,22300501,"JAN 07, 2024",DAL vs. MIN,W,32,4,13,0.308,2,8,0.25,2,2,1.0,0,4,4,1,0,0,0,2,12,14,1,DAL,DAL,MIN,115,,,17,16,13,5
Tim Hardaway Jr.,G-F,22023,203501,22300472,"JAN 03, 2024",DAL vs. POR,W,23,5,10,0.5,2,5,0.4,2,2,1.0,0,3,3,0,0,0,0,2,14,8,1,DAL,DAL,POR,126,,,17,17,14,3
Tim Hardaway Jr.,G-F,22023,203501,22300423,"DEC 28, 2023",DAL @ MIN,L,32,11,19,0.579,5,11,0.455,5,7,0.714,0,3,3,3,2,0,1,2,32,5,1,DAL,MIN,DAL,110,,,38,35,35,6
Tim Hardaway Jr.,G-F,22023,203501,22300420,"DEC 27, 2023",DAL vs. CLE,L,30,4,13,0.308,1,5,0.2,5,6,0.833,0,4,4,1,0,0,0,2,14,-5,1,DAL,DAL,CLE,110,,,19,18,15,5
Tim Hardaway Jr.,G-F,22023,203501,22300405,"DEC 25, 2023",DAL @ PHX,W,38,6,14,0.429,3,9,0.333,3,3,1.0,0,7,7,2,1,0,1,4,18,10,1,DAL,PHX,DAL,128,,,27,25,20,9
Tim Hardaway Jr.,G-F,22023,203501,22300306,"DEC 12, 2023",DAL vs. LAL,W,37,10,21,0.476,5,10,0.5,7,8,0.875,1,2,3,3,1,0,0,2,32,-6,1,DAL,DAL,LAL,127,,,38,35,35,6
Tim Hardaway Jr.,G-F,22023,203501,22301226,"DEC 08, 2023",DAL @ POR,W,37,7,12,0.583,4,9,0.444,2,2,1.0,0,4,4,0,0,0,1,4,20,15,1,DAL,POR,DAL,125,,,24,24,20,4
Tim Hardaway Jr.,G-F,22023,203501,22301213,"DEC 06, 2023",DAL vs. UTA,W,22,5,14,0.357,4,12,0.333,3,4,0.75,1,3,4,2,0,0,0,1,17,8,1,DAL,DAL,UTA,147,,,23,21,19,6
Tim Hardaway Jr.,G-F,22023,203501,22300059,"NOV 28, 2023",DAL vs. HOU,W,22,4,12,0.333,3,8,0.375,0,0,0.0,1,0,1,0,0,0,0,0,11,1,1,DAL,DAL,HOU,121,,,12,12,11,1
Tim Hardaway Jr.,G-F,22023,203501,22300244,"NOV 25, 2023",DAL @ LAC,L,29,5,14,0.357,2,9,0.222,0,0,0.0,0,3,3,0,0,0,1,2,12,-9,1,DAL,LAC,DAL,88,,,15,15,12,3
Tim Hardaway Jr.,G-F,22023,203501,22300238,"NOV 22, 2023",DAL @ LAL,W,30,2,10,0.2,2,8,0.25,1,2,0.5,1,1,2,3,1,0,0,0,7,11,1,DAL,LAL,DAL,104,,,12,9,10,5
Tim Hardaway Jr.,G-F,22023,203501,22300205,"NOV 18, 2023",DAL @ MIL,L,26,6,14,0.429,4,10,0.4,1,1,1.0,0,2,2,2,0,0,1,0,17,0,1,DAL,MIL,DAL,125,,,21,19,19,4
Tim Hardaway Jr.,G-F,22023,203501,22300192,"NOV 15, 2023",DAL @ WAS,W,27,11,20,0.55,7,11,0.636,2,5,0.4,0,4,4,3,0,0,1,1,31,17,1,DAL,WAS,DAL,130,,,38,35,34,7
Tim Hardaway Jr.,G-F,22023,203501,22300022,"NOV 14, 2023",DAL @ NOP,L,21,5,11,0.455,3,9,0.333,4,4,1.0,0,0,0,1,0,0,1,2,17,-26,1,DAL,NOP,DAL,110,,,18,17,18,1
Tim Hardaway Jr.,G-F,22023,203501,22300183,"NOV 12, 2023",DAL @ NOP,W,28,4,14,0.286,3,10,0.3,4,4,1.0,0,9,9,2,0,0,0,1,15,14,1,DAL,NOP,DAL,136,,,26,24,17,11
Tim Hardaway Jr.,G-F,22023,203501,22300014,"NOV 10, 2023",DAL vs. LAC,W,27,6,13,0.462,2,8,0.25,3,3,1.0,0,3,3,3,0,0,0,0,17,20,1,DAL,DAL,LAC,144,,,23,20,20,6
Tim Hardaway Jr.,G-F,22023,203501,22300006,"NOV 03, 2023",DAL @ DEN,L,27,3,8,0.375,1,5,0.2,2,2,1.0,0,3,3,2,1,0,2,3,9,-10,1,DAL,DEN,DAL,114,,,14,12,11,5
Tim Hardaway Jr.,G-F,22023,203501,22300124,"NOV 01, 2023",DAL vs. CHI,W,27,8,15,0.533,7,13,0.538,1,1,1.0,0,3,3,2,1,0,2,0,24,-9,1,DAL,DAL,CHI,114,,,29,27,26,5
Tim Hardaway Jr.,G-F,22023,203501,22300106,"OCT 30, 2023",DAL @ MEM,W,29,8,14,0.571,3,7,0.429,2,2,1.0,0,5,5,0,0,0,1,1,21,6,1,DAL,MEM,DAL,125,,,26,26,21,5
Tim Hardaway Jr.,G-F,22023,203501,22300084,"OCT 27, 2023",DAL vs. BKN,W,30,6,17,0.353,3,7,0.429,4,4,1.0,1,3,4,1,0,0,1,2,19,13,1,DAL,DAL,BKN,125,,,24,23,20,5
Tim Hardaway Jr.,G-F,22023,203501,22300073,"OCT 25, 2023",DAL @ SAS,W,28,5,14,0.357,3,10,0.3,4,4,1.0,2,4,6,4,1,0,1,0,17,9,1,DAL,SAS,DAL,126,,,27,23,21,10
Tim Hardaway Jr.,G-F,22023,203501,22300748,"FEB 10, 2024",DAL vs. OKC,W,25,4,9,0.444,2,6,0.333,0,0,0.0,0,1,1,1,1,0,1,2,10,28,1,DAL,DAL,OKC,146,,,12,11,11,2
Tim Hardaway Jr.,G-F,22023,203501,22300736,"FEB 08, 2024",DAL @ NYK,W,30,7,14,0.5,5,10,0.5,0,0,0.0,0,2,2,2,0,0,0,1,19,11,1,DAL,NYK,DAL,121,,,23,21,21,4
Tim Hardaway Jr.,G-F,22023,203501,22300720,"FEB 06, 2024",DAL @ BKN,W,25,4,10,0.4,3,7,0.429,3,3,1.0,1,6,7,3,0,0,0,1,14,-1,1,DAL,BKN,DAL,119,,,24,21,17,10
Tim Hardaway Jr.,G-F,22023,203501,22300715,"FEB 05, 2024",DAL @ PHI,W,22,0,8,0.0,0,5,0.0,0,0,0.0,0,2,2,0,0,1,0,2,0,0,1,DAL,PHI,DAL,118,,,2,2,0,2
Tim Hardaway Jr.,G-F,22023,203501,22300702,"FEB 03, 2024",DAL vs. MIL,L,38,6,15,0.4,4,8,0.5,2,2,1.0,1,1,2,2,2,0,1,4,18,-6,1,DAL,DAL,MIL,117,,,22,20,20,4
Tim Hardaway Jr.,G-F,22023,203501,22300634,"JAN 26, 2024",DAL @ ATL,W,32,3,12,0.25,3,9,0.333,4,4,1.0,1,3,4,3,0,0,2,2,13,-5,1,DAL,ATL,DAL,148,,,20,17,16,7
Tim Hardaway Jr.,G-F,22023,203501,22300625,"JAN 24, 2024",DAL vs. PHX,L,34,6,16,0.375,4,10,0.4,1,2,0.5,0,5,5,2,2,0,1,1,17,-21,1,DAL,DAL,PHX,107,,,24,22,19,7
Tim Hardaway Jr.,G-F,22023,203501,22300611,"JAN 22, 2024",DAL vs. BOS,L,32,8,13,0.615,4,7,0.571,0,0,0.0,0,2,2,1,0,0,0,2,20,-3,1,DAL,DAL,BOS,110,,,23,22,21,3
Tim Hardaway Jr.,G-F,22023,203501,22300457,"JAN 01, 2024",DAL @ UTA,L,23,3,9,0.333,0,6,0.0,0,0,0.0,0,2,2,0,0,0,1,1,6,-16,1,DAL,UTA,DAL,86,,,8,8,6,2
Tim Hardaway Jr.,G-F,22023,203501,22300444,"DEC 30, 2023",DAL @ GSW,W,29,5,12,0.417,2,8,0.25,4,5,0.8,0,6,6,5,0,0,0,2,16,9,1,DAL,GSW,DAL,132,,,27,22,21,11
Tim Hardaway Jr.,G-F,22023,203501,22300372,"DEC 20, 2023",DAL vs. LAC,L,37,8,21,0.381,3,11,0.273,2,2,1.0,1,2,3,3,3,0,1,2,21,1,1,DAL,DAL,LAC,111,,,27,24,24,6
Tim Hardaway Jr.,G-F,22023,203501,22300212,"NOV 19, 2023",DAL vs. SAC,L,27,5,11,0.455,2,4,0.5,2,2,1.0,0,2,2,2,0,0,0,3,14,-10,1,DAL,DAL,SAC,113,,,18,16,16,4
Tim Hardaway Jr.,G-F,22023,203501,22300168,"NOV 08, 2023",DAL vs. TOR,L,26,6,11,0.545,5,9,0.556,0,0,0.0,1,1,2,1,0,0,3,0,17,-19,1,DAL,DAL,TOR,116,,,20,19,18,3
Tim Hardaway Jr.,G-F,22023,203501,22300147,"NOV 06, 2023",DAL @ ORL,W,31,8,16,0.5,4,11,0.364,1,1,1.0,0,6,6,0,0,0,0,0,21,3,1,DAL,ORL,DAL,117,,,27,27,21,6
Tim Hardaway Jr.,G-F,22023,203501,22300143,"NOV 05, 2023",DAL vs. CHA,W,32,5,17,0.294,4,12,0.333,2,2,1.0,0,2,2,1,0,0,0,0,16,1,1,DAL,DAL,CHA,124,,,19,18,17,3
Tobias Harris,F,22023,202699,22300742,"FEB 09, 2024",PHI vs. ATL,L,39,7,16,0.438,2,4,0.5,5,6,0.833,0,6,6,7,0,0,1,2,21,-4,1,PHI,PHI,ATL,121,,,34,27,28,13
Tobias Harris,F,22023,202699,22300727,"FEB 07, 2024",PHI vs. GSW,L,29,6,14,0.429,0,1,0.0,1,1,1.0,0,7,7,3,0,1,1,1,13,-22,1,PHI,PHI,GSW,104,,,23,20,16,10
Tobias Harris,F,22023,202699,22300715,"FEB 05, 2024",PHI vs. DAL,L,35,8,11,0.727,1,1,1.0,0,0,0.0,0,6,6,6,2,1,1,2,17,-18,1,PHI,PHI,DAL,102,,,29,23,23,12
Tobias Harris,F,22023,202699,22300686,"FEB 01, 2024",PHI @ UTA,W,39,13,21,0.619,0,5,0.0,2,2,1.0,2,3,5,7,1,1,0,3,28,5,1,PHI,UTA,PHI,127,,,40,33,35,12
Tobias Harris,F,22023,202699,22300668,"JAN 29, 2024",PHI @ POR,L,20,3,9,0.333,0,3,0.0,3,4,0.75,1,3,4,1,0,0,0,0,9,-12,1,PHI,POR,PHI,104,,,14,13,10,5
Tobias Harris,F,22023,202699,22300532,"JAN 12, 2024",PHI vs. SAC,W,36,14,25,0.56,3,7,0.429,6,6,1.0,3,4,7,3,3,0,3,0,37,19,1,PHI,PHI,SAC,112,,,47,44,40,10
Tobias Harris,F,22023,202699,22300521,"JAN 10, 2024",PHI @ ATL,L,41,12,24,0.5,1,2,0.5,7,7,1.0,2,8,10,4,0,1,1,2,32,1,1,PHI,ATL,PHI,132,,,46,42,36,14
Tobias Harris,F,22023,202699,22300483,"JAN 05, 2024",PHI vs. NYK,L,24,2,6,0.333,1,2,0.5,0,1,0.0,0,3,3,4,0,0,0,2,5,-1,1,PHI,PHI,NYK,92,,,12,8,9,7
Tobias Harris,F,22023,202699,22300459,"JAN 02, 2024",PHI vs. CHI,W,30,9,13,0.692,1,4,0.25,1,3,0.333,1,7,8,2,0,2,1,0,20,32,1,PHI,PHI,CHI,110,,,30,28,22,10
Tobias Harris,F,22023,202699,22300442,"DEC 30, 2023",PHI @ CHI,L,34,6,16,0.375,0,3,0.0,3,4,0.75,3,4,7,4,0,1,0,1,15,-20,1,PHI,CHI,PHI,92,,,26,22,19,11
Tobias Harris,F,22023,202699,22300434,"DEC 29, 2023",PHI @ HOU,W,35,10,18,0.556,2,6,0.333,0,0,0.0,1,3,4,7,4,3,3,3,22,5,1,PHI,HOU,PHI,131,,,33,26,29,11
Tobias Harris,F,22023,202699,22300415,"DEC 27, 2023",PHI @ ORL,W,33,10,23,0.435,1,5,0.2,1,1,1.0,1,6,7,2,1,0,0,0,22,20,1,PHI,ORL,PHI,112,,,31,29,24,9
Tobias Harris,F,22023,202699,22300404,"DEC 25, 2023",PHI @ MIA,L,42,10,18,0.556,4,7,0.571,3,3,1.0,1,6,7,6,1,0,2,3,27,2,1,PHI,MIA,PHI,113,,,40,34,33,13
Tobias Harris,F,22023,202699,22300367,"DEC 20, 2023",PHI vs. MIN,W,37,4,10,0.4,0,1,0.0,1,1,1.0,1,4,5,3,1,0,1,5,9,-2,1,PHI,PHI,MIN,127,,,17,14,12,8
Tobias Harris,F,22023,202699,22300335,"DEC 16, 2023",PHI @ CHA,W,25,6,10,0.6,1,3,0.333,2,2,1.0,1,4,5,4,0,1,1,0,15,36,1,PHI,CHA,PHI,135,,,24,20,19,9
Tobias Harris,F,22023,202699,22300327,"DEC 15, 2023",PHI vs. DET,W,24,4,8,0.5,1,3,0.333,4,4,1.0,2,5,7,2,3,1,2,3,13,24,1,PHI,PHI,DET,124,,,22,20,15,9
Tobias Harris,F,22023,202699,22300310,"DEC 13, 2023",PHI @ DET,W,26,7,10,0.7,3,5,0.6,4,4,1.0,1,6,7,1,0,1,1,0,21,20,1,PHI,DET,PHI,129,,,29,28,22,8
Tobias Harris,F,22023,202699,22300295,"DEC 11, 2023",PHI vs. WAS,W,30,2,5,0.4,1,2,0.5,5,6,0.833,0,4,4,6,0,0,0,1,10,21,1,PHI,PHI,WAS,146,,,20,14,16,10
Tobias Harris,F,22023,202699,22301218,"DEC 08, 2023",PHI vs. ATL,W,34,5,9,0.556,0,1,0.0,3,3,1.0,2,6,8,2,1,0,2,3,13,8,1,PHI,PHI,ATL,125,,,23,21,15,10
Tobias Harris,F,22023,202699,22300275,"DEC 01, 2023",PHI @ BOS,L,38,6,16,0.375,1,1,1.0,1,3,0.333,3,2,5,3,4,0,4,1,14,-5,1,PHI,BOS,PHI,119,,,22,19,17,8
Tobias Harris,F,22023,202699,22300262,"NOV 29, 2023",PHI @ NOP,L,29,5,10,0.5,0,2,0.0,2,2,1.0,0,4,4,2,0,0,5,2,12,-14,1,PHI,NOP,PHI,114,,,18,16,14,6
Tobias Harris,F,22023,202699,22300255,"NOV 27, 2023",PHI vs. LAL,W,23,3,12,0.25,0,4,0.0,2,2,1.0,0,5,5,0,0,0,1,1,8,7,1,PHI,PHI,LAL,138,,,13,13,8,5
Tobias Harris,F,22023,202699,22300232,"NOV 22, 2023",PHI @ MIN,L,32,4,11,0.364,0,3,0.0,7,8,0.875,1,5,6,2,0,1,1,1,15,-15,1,PHI,MIN,PHI,99,,,23,21,17,8
Tobias Harris,F,22023,202699,22300208,"NOV 19, 2023",PHI @ BKN,W,32,5,13,0.385,0,4,0.0,0,0,0.0,1,4,5,1,2,0,0,0,10,14,1,PHI,BKN,PHI,121,,,16,15,11,6
Tobias Harris,F,22023,202699,22300148,"NOV 06, 2023",PHI vs. WAS,W,31,6,11,0.545,0,2,0.0,6,6,1.0,1,4,5,5,1,0,2,1,18,8,1,PHI,PHI,WAS,146,,,28,23,23,10
Tobias Harris,F,22023,202699,22300132,"NOV 04, 2023",PHI vs. PHX,W,34,7,10,0.7,0,1,0.0,4,4,1.0,2,8,10,2,1,0,3,4,18,20,1,PHI,PHI,PHX,112,,,30,28,20,12
Tobias Harris,F,22023,202699,22300128,"NOV 02, 2023",PHI vs. TOR,W,40,10,17,0.588,2,6,0.333,1,2,0.5,0,7,7,3,3,0,2,1,23,6,1,PHI,PHI,TOR,114,,,33,30,26,10
Tobias Harris,F,22023,202699,22300098,"OCT 29, 2023",PHI vs. POR,W,38,8,11,0.727,2,4,0.5,6,7,0.857,0,5,5,2,1,2,3,3,24,31,1,PHI,PHI,POR,126,,,31,29,26,7
Tobias Harris,F,22023,202699,22300608,"JAN 22, 2024",PHI vs. SAS,W,35,5,11,0.455,0,5,0.0,4,4,1.0,0,2,2,6,0,0,0,3,14,21,1,PHI,PHI,SAS,133,,,22,16,20,8
Tobias Harris,F,22023,202699,22300593,"JAN 20, 2024",PHI @ CHA,W,36,7,15,0.467,1,3,0.333,6,7,0.857,1,4,5,6,0,0,2,0,21,18,1,PHI,CHA,PHI,97,,,32,26,27,11
Tobias Harris,F,22023,202699,22300585,"JAN 19, 2024",PHI @ ORL,W,35,3,11,0.273,1,3,0.333,5,5,1.0,2,4,6,3,3,1,0,3,12,6,1,PHI,ORL,PHI,124,,,21,18,15,9
Tobias Harris,F,22023,202699,22300566,"JAN 16, 2024",PHI vs. DEN,W,38,8,10,0.8,2,4,0.5,6,6,1.0,0,5,5,4,1,2,0,2,24,13,1,PHI,PHI,DEN,126,,,33,29,28,9
Tobias Harris,F,22023,202699,22300555,"JAN 15, 2024",PHI vs. HOU,W,31,3,7,0.429,2,3,0.667,2,2,1.0,0,3,3,2,0,0,1,2,10,-1,1,PHI,PHI,HOU,124,,,15,13,12,5
Tobias Harris,F,22023,202699,22300351,"DEC 18, 2023",PHI vs. CHI,L,32,1,3,0.333,1,1,1.0,0,0,0.0,0,5,5,2,0,3,2,1,3,6,1,PHI,PHI,CHI,104,,,10,8,5,7
Tobias Harris,F,22023,202699,22301208,"DEC 06, 2023",PHI @ WAS,W,35,3,9,0.333,0,1,0.0,0,0,0.0,2,4,6,1,2,0,0,2,6,10,1,PHI,WAS,PHI,131,,,13,12,7,7
Tobias Harris,F,22023,202699,22300239,"NOV 25, 2023",PHI @ OKC,W,31,6,13,0.462,1,5,0.2,3,3,1.0,0,5,5,6,0,0,3,3,16,20,1,PHI,OKC,PHI,127,,,27,21,22,11
Tobias Harris,F,22023,202699,22300040,"NOV 21, 2023",PHI vs. CLE,L,43,7,13,0.538,3,5,0.6,6,6,1.0,0,2,2,2,2,0,0,3,23,-6,1,PHI,PHI,CLE,119,,,27,25,25,4
Tobias Harris,F,22023,202699,22300180,"NOV 12, 2023",PHI vs. IND,W,36,9,20,0.45,0,3,0.0,0,0,0.0,4,5,9,4,0,0,1,2,18,12,1,PHI,PHI,IND,137,,,31,27,22,13
Tobias Harris,F,22023,202699,22300008,"NOV 10, 2023",PHI @ DET,W,38,8,15,0.533,2,3,0.667,6,6,1.0,1,4,5,2,0,1,3,1,24,10,1,PHI,DET,PHI,114,,,31,29,26,7
Tobias Harris,F,22023,202699,22300159,"NOV 08, 2023",PHI vs. BOS,W,38,5,12,0.417,1,4,0.25,6,6,1.0,2,7,9,3,0,0,2,1,17,3,1,PHI,PHI,BOS,106,,,29,26,20,12
Tobias Harris,F,22023,202699,22300673,"JAN 30, 2024",PHI @ GSW,L,38,10,18,0.556,2,4,0.5,4,4,1.0,6,4,10,2,2,0,2,2,26,-15,1,PHI,GSW,PHI,107,,,38,36,28,12
Tobias Harris,F,22023,202699,22300029,"NOV 17, 2023",PHI @ ATL,W,38,12,20,0.6,3,5,0.6,2,2,1.0,1,9,10,4,1,0,1,1,29,-4,1,PHI,ATL,PHI,126,,,43,39,33,14
Tobias Harris,F,22023,202699,22300194,"NOV 15, 2023",PHI vs. BOS,L,38,6,12,0.5,1,2,0.5,3,3,1.0,0,7,7,3,0,0,1,0,16,-1,1,PHI,PHI,BOS,107,,,26,23,19,10
Tobias Harris,F,22023,202699,22300019,"NOV 14, 2023",PHI vs. IND,L,37,11,17,0.647,0,1,0.0,0,1,0.0,0,7,7,3,1,0,1,3,22,-8,1,PHI,PHI,IND,126,,,32,29,25,10
Tobias Harris,F,22023,202699,22300092,"OCT 28, 2023",PHI @ TOR,W,36,4,10,0.4,1,4,0.25,6,7,0.857,1,1,2,2,2,2,2,1,15,0,1,PHI,TOR,PHI,114,,,19,17,17,4
Tobias Harris,F,22023,202699,22300075,"OCT 26, 2023",PHI @ MIL,L,37,8,9,0.889,3,3,1.0,1,2,0.5,0,7,7,2,0,0,2,2,20,-14,1,PHI,MIL,PHI,117,,,29,27,22,9
Tobias Harris,F,22023,202699,22300753,"FEB 10, 2024",PHI @ WAS,W,33,4,14,0.286,0,2,0.0,3,4,0.75,1,6,7,3,3,1,4,1,11,-8,1,PHI,WAS,PHI,119,,,21,18,14,10
Tobias Harris,F,22023,202699,22300382,"DEC 22, 2023",PHI vs. TOR,W,38,12,23,0.522,5,9,0.556,4,4,1.0,0,8,8,7,1,0,2,2,33,8,1,PHI,PHI,TOR,121,,,48,41,40,15
Jordan Clarkson,G,22023,203903,22300711,"FEB 04, 2024",UTA vs. MIL,W,26,3,11,0.273,0,4,0.0,6,7,0.857,1,4,5,5,0,0,1,2,12,10,1,UTA,UTA,MIL,123,,,22,17,17,10
Jordan Clarkson,G,22023,203903,22300686,"FEB 01, 2024",UTA vs. PHI,L,34,5,15,0.333,1,7,0.143,5,7,0.714,0,2,2,10,0,0,1,1,16,-4,1,UTA,UTA,PHI,124,,,28,18,26,12
Jordan Clarkson,G,22023,203903,22300671,"JAN 30, 2024",UTA @ NYK,L,31,5,12,0.417,1,5,0.2,0,0,0.0,0,1,1,1,0,0,3,2,11,-19,1,UTA,NYK,UTA,103,,,13,12,12,2
Jordan Clarkson,G,22023,203903,22300660,"JAN 29, 2024",UTA @ BKN,L,23,5,10,0.5,0,4,0.0,3,4,0.75,0,1,1,1,0,0,4,1,13,-20,1,UTA,BKN,UTA,114,,,15,14,14,2
Jordan Clarkson,G,22023,203903,22300647,"JAN 27, 2024",UTA @ CHA,W,31,6,15,0.4,1,5,0.2,1,1,1.0,1,0,1,2,0,0,0,3,14,7,1,UTA,CHA,UTA,134,,,17,15,16,3
Jordan Clarkson,G,22023,203903,22300628,"JAN 25, 2024",UTA @ WAS,W,30,7,17,0.412,1,4,0.25,4,4,1.0,0,3,3,8,0,0,4,1,19,16,1,UTA,WAS,UTA,123,,,30,22,27,11
Jordan Clarkson,G,22023,203903,22300616,"JAN 23, 2024",UTA @ NOP,L,22,4,9,0.444,0,3,0.0,1,1,1.0,0,1,1,1,0,0,2,0,9,-22,1,UTA,NOP,UTA,124,,,11,10,10,2
Jordan Clarkson,G,22023,203903,22300598,"JAN 20, 2024",UTA @ HOU,L,38,12,25,0.48,4,10,0.4,5,5,1.0,2,10,12,4,0,0,3,1,33,-7,1,UTA,HOU,UTA,126,,,49,45,37,16
Jordan Clarkson,G,22023,203903,22300581,"JAN 18, 2024",UTA vs. OKC,L,35,7,18,0.389,3,5,0.6,1,1,1.0,2,0,2,5,0,0,1,1,18,-3,1,UTA,UTA,OKC,129,,,25,20,23,7
Jordan Clarkson,G,22023,203903,22300564,"JAN 15, 2024",UTA vs. IND,W,27,6,13,0.462,0,3,0.0,5,6,0.833,0,3,3,2,2,0,2,1,17,6,1,UTA,UTA,IND,132,,,22,20,19,5
Jordan Clarkson,G,22023,203903,22300549,"JAN 13, 2024",UTA vs. LAL,W,31,6,18,0.333,1,6,0.167,8,8,1.0,2,2,4,4,0,1,2,2,21,-2,1,UTA,UTA,LAL,132,,,29,25,25,8
Jordan Clarkson,G,22023,203903,22300540,"JAN 12, 2024",UTA vs. TOR,W,31,8,16,0.5,5,9,0.556,0,0,0.0,0,1,1,5,0,0,0,1,21,17,1,UTA,UTA,TOR,145,,,27,22,26,6
Jordan Clarkson,G,22023,203903,22300524,"JAN 10, 2024",UTA vs. DEN,W,33,12,19,0.632,3,8,0.375,0,1,0.0,0,2,2,9,0,0,3,1,27,8,1,UTA,UTA,DEN,124,,,38,29,36,11
Jordan Clarkson,G,22023,203903,22300510,"JAN 08, 2024",UTA @ MIL,W,31,7,14,0.5,2,3,0.667,5,5,1.0,1,3,4,6,0,1,1,0,21,13,1,UTA,MIL,UTA,132,,,31,25,27,10
Jordan Clarkson,G,22023,203903,22300495,"JAN 06, 2024",UTA @ PHI,W,31,5,14,0.357,0,6,0.0,8,9,0.889,0,5,5,6,1,0,5,0,18,1,1,UTA,PHI,UTA,120,,,29,23,24,11
Jordan Clarkson,G,22023,203903,22300479,"JAN 05, 2024",UTA @ BOS,L,17,1,7,0.143,0,2,0.0,0,0,0.0,1,1,2,2,1,0,4,0,2,-23,1,UTA,BOS,UTA,97,,,6,4,4,4
Jordan Clarkson,G,22023,203903,22300474,"JAN 03, 2024",UTA vs. DET,W,38,11,20,0.55,4,5,0.8,10,11,0.909,1,5,6,3,1,0,5,1,36,5,1,UTA,UTA,DET,154,,,45,42,39,9
Jordan Clarkson,G,22023,203903,22300457,"JAN 01, 2024",UTA vs. DAL,W,28,8,16,0.5,1,6,0.167,3,3,1.0,2,8,10,11,1,0,4,4,20,36,1,UTA,UTA,DAL,127,,,41,30,31,21
Jordan Clarkson,G,22023,203903,22300439,"DEC 30, 2023",UTA vs. MIA,W,25,3,10,0.3,1,5,0.2,2,2,1.0,0,2,2,3,0,0,0,0,9,4,1,UTA,UTA,MIA,117,,,14,11,12,5
Jordan Clarkson,G,22023,203903,22300424,"DEC 28, 2023",UTA @ NOP,L,24,3,11,0.273,1,5,0.2,3,3,1.0,0,2,2,6,0,0,6,0,10,-8,1,UTA,NOP,UTA,105,,,18,12,16,8
Jordan Clarkson,G,22023,203903,22300412,"DEC 26, 2023",UTA @ SAS,W,27,7,17,0.412,2,8,0.25,8,8,1.0,1,5,6,8,0,0,3,6,24,16,1,UTA,SAS,UTA,130,,,38,30,32,14
Jordan Clarkson,G,22023,203903,22300395,"DEC 23, 2023",UTA @ TOR,W,30,11,22,0.5,4,9,0.444,4,4,1.0,1,2,3,6,1,0,2,1,30,19,1,UTA,TOR,UTA,126,,,39,33,36,9
Jordan Clarkson,G,22023,203903,22300302,"DEC 11, 2023",UTA @ OKC,L,22,3,13,0.231,0,4,0.0,2,2,1.0,2,2,4,5,1,1,2,1,8,-25,1,UTA,OKC,UTA,120,,,17,12,13,9
Jordan Clarkson,G,22023,203903,22301225,"DEC 08, 2023",UTA vs. LAC,L,28,2,9,0.222,0,3,0.0,2,3,0.667,1,3,4,5,1,0,1,2,6,-16,1,UTA,UTA,LAC,103,,,15,10,11,9
Jordan Clarkson,G,22023,203903,22300261,"NOV 29, 2023",UTA @ MEM,L,27,4,10,0.4,2,5,0.4,2,3,0.667,1,2,3,5,0,0,4,0,12,-14,1,UTA,MEM,UTA,91,,,20,15,17,8
Jordan Clarkson,G,22023,203903,22300256,"NOV 27, 2023",UTA vs. NOP,W,32,4,16,0.25,2,9,0.222,6,6,1.0,0,4,4,10,0,0,1,1,16,-3,1,UTA,UTA,NOP,114,,,30,20,26,14
Jordan Clarkson,G,22023,203903,22300237,"NOV 22, 2023",UTA @ POR,L,32,5,11,0.455,2,4,0.5,1,2,0.5,0,2,2,5,0,0,7,0,13,-8,1,UTA,POR,UTA,105,,,20,15,18,7
Jordan Clarkson,G,22023,203903,22300042,"NOV 21, 2023",UTA @ LAL,L,24,3,9,0.333,0,3,0.0,1,1,1.0,0,0,0,2,1,0,2,1,7,-24,1,UTA,LAL,UTA,99,,,9,7,9,2
Jordan Clarkson,G,22023,203903,22300214,"NOV 19, 2023",UTA vs. PHX,L,39,8,23,0.348,1,6,0.167,5,7,0.714,3,4,7,5,2,0,2,5,22,-9,1,UTA,UTA,PHX,137,,,34,29,27,12
Jordan Clarkson,G,22023,203903,22300035,"NOV 17, 2023",UTA vs. PHX,L,36,14,26,0.538,5,10,0.5,4,4,1.0,1,2,3,5,1,0,0,0,37,0,1,UTA,UTA,PHX,128,,,45,40,42,8
Jordan Clarkson,G,22023,203903,22300023,"NOV 14, 2023",UTA vs. POR,W,33,13,19,0.684,4,9,0.444,0,0,0.0,0,1,1,3,2,0,1,2,30,8,1,UTA,UTA,POR,115,,,34,31,33,4
Jordan Clarkson,G,22023,203903,22300012,"NOV 10, 2023",UTA @ MEM,W,36,9,16,0.563,2,5,0.4,6,6,1.0,2,2,4,4,2,1,3,1,26,14,1,UTA,MEM,UTA,127,,,34,30,30,8
Jordan Clarkson,G,22023,203903,22300158,"NOV 08, 2023",UTA @ IND,L,34,12,26,0.462,1,3,0.333,8,8,1.0,2,1,3,5,1,1,6,3,33,-5,1,UTA,IND,UTA,118,,,41,36,38,8
Jordan Clarkson,G,22023,203903,22300152,"NOV 06, 2023",UTA @ CHI,L,29,3,14,0.214,1,8,0.125,0,0,0.0,1,0,1,6,0,0,5,1,7,-14,1,UTA,CHI,UTA,113,,,14,8,13,7
Jordan Clarkson,G,22023,203903,22300138,"NOV 04, 2023",UTA @ MIN,L,32,5,14,0.357,0,5,0.0,0,0,0.0,2,1,3,3,0,0,0,0,10,-18,1,UTA,MIN,UTA,95,,,16,13,13,6
Jordan Clarkson,G,22023,203903,22300130,"NOV 02, 2023",UTA vs. ORL,L,37,5,20,0.25,2,8,0.25,9,9,1.0,3,3,6,6,1,0,6,1,21,-3,1,UTA,UTA,ORL,113,,,33,27,27,12
Jordan Clarkson,G,22023,203903,22300125,"NOV 01, 2023",UTA vs. MEM,W,26,8,13,0.615,4,6,0.667,0,0,0.0,0,6,6,5,2,0,3,1,20,21,1,UTA,UTA,MEM,133,,,31,26,25,11
Jordan Clarkson,G,22023,203903,22300110,"OCT 30, 2023",UTA @ DEN,L,34,2,10,0.2,0,4,0.0,0,3,0.0,2,1,3,6,1,0,5,1,4,-7,1,UTA,DEN,UTA,102,,,13,7,10,9
Jordan Clarkson,G,22023,203903,22300094,"OCT 28, 2023",UTA @ PHX,L,22,3,10,0.3,0,3,0.0,1,1,1.0,1,1,2,2,0,0,5,3,7,-26,1,UTA,PHX,UTA,104,,,11,9,9,4
Jordan Clarkson,G,22023,203903,22300085,"OCT 27, 2023",UTA vs. LAC,W,34,4,13,0.308,3,5,0.6,2,3,0.667,1,3,4,6,1,0,2,0,13,-2,1,UTA,UTA,LAC,120,,,23,17,19,10
Jordan Clarkson,G,22023,203903,22300072,"OCT 25, 2023",UTA vs. SAC,L,31,8,16,0.5,2,5,0.4,6,8,0.75,2,2,4,6,0,0,2,4,24,-4,1,UTA,UTA,SAC,114,,,34,28,30,10
Jordan Clarkson,G,22023,203903,22300739,"FEB 08, 2024",UTA @ PHX,L,32,4,12,0.333,3,8,0.375,2,2,1.0,1,0,1,4,0,0,0,0,13,-8,1,UTA,PHX,UTA,115,,,18,14,17,5
Jordan Clarkson,G,22023,203903,22300724,"FEB 06, 2024",UTA vs. OKC,W,27,5,12,0.417,1,6,0.167,1,2,0.5,0,2,2,2,2,0,5,2,12,-3,1,UTA,UTA,OKC,124,,,16,14,14,4
Klay Thompson,F,22023,202691,22300757,"FEB 10, 2024",GSW vs. PHX,W,24,2,10,0.2,1,7,0.143,0,0,0.0,0,2,2,1,1,1,1,0,5,-3,1,GSW,GSW,PHX,113,,,8,7,6,3
Klay Thompson,F,22023,202691,22300727,"FEB 07, 2024",GSW @ PHI,W,28,6,12,0.5,4,5,0.8,2,2,1.0,1,2,3,1,0,1,0,1,18,24,1,GSW,PHI,GSW,127,,,22,21,19,4
Klay Thompson,F,22023,202691,22300717,"FEB 05, 2024",GSW @ BKN,W,30,4,9,0.444,0,3,0.0,0,0,0.0,0,6,6,3,2,0,1,1,8,-1,1,GSW,BKN,GSW,109,,,17,14,11,9
Klay Thompson,F,22023,202691,22300699,"FEB 03, 2024",GSW @ ATL,L,36,4,19,0.211,2,13,0.154,0,0,0.0,0,4,4,2,3,1,1,0,10,-10,1,GSW,ATL,GSW,134,,,16,14,12,6
Klay Thompson,F,22023,202691,22300693,"FEB 02, 2024",GSW @ MEM,W,27,6,15,0.4,2,9,0.222,0,0,0.0,0,2,2,0,0,1,0,0,14,5,1,GSW,MEM,GSW,121,,,16,16,14,2
Klay Thompson,F,22023,202691,22300650,"JAN 27, 2024",GSW vs. LAL,L,47,9,24,0.375,6,17,0.353,0,0,0.0,0,4,4,4,2,0,2,6,24,2,1,GSW,GSW,LAL,144,,,32,28,28,8
Klay Thompson,F,22023,202691,22300632,"JAN 25, 2024",GSW vs. SAC,L,31,5,14,0.357,2,7,0.286,4,4,1.0,0,1,1,1,1,1,1,5,16,-1,1,GSW,GSW,SAC,133,,,18,17,17,2
Klay Thompson,F,22023,202691,22300626,"JAN 24, 2024",GSW vs. ATL,W,30,8,18,0.444,5,10,0.5,3,3,1.0,1,1,2,3,0,1,2,2,24,11,1,GSW,GSW,ATL,134,,,29,26,27,5
Klay Thompson,F,22023,202691,22300560,"JAN 15, 2024",GSW @ MEM,L,34,4,10,0.4,1,4,0.25,0,0,0.0,0,0,0,3,0,0,0,1,9,-22,1,GSW,MEM,GSW,107,,,12,9,12,3
Klay Thompson,F,22023,202691,22300536,"JAN 12, 2024",GSW @ CHI,W,34,9,19,0.474,7,15,0.467,5,6,0.833,2,4,6,6,1,1,1,1,30,10,1,GSW,CHI,GSW,140,,,42,36,36,12
Klay Thompson,F,22023,202691,22300525,"JAN 10, 2024",GSW vs. NOP,L,24,5,10,0.5,3,7,0.429,0,0,0.0,1,3,4,2,0,1,3,1,13,-17,1,GSW,GSW,NOP,105,,,19,17,15,6
Klay Thompson,F,22023,202691,22300504,"JAN 07, 2024",GSW vs. TOR,L,28,10,15,0.667,5,7,0.714,0,0,0.0,0,0,0,3,0,0,2,0,25,-16,1,GSW,GSW,TOR,118,,,28,25,28,3
Klay Thompson,F,22023,202691,22300490,"JAN 05, 2024",GSW vs. DET,W,35,6,18,0.333,3,9,0.333,4,4,1.0,1,2,3,4,1,2,2,2,19,14,1,GSW,GSW,DET,113,,,26,22,23,7
Klay Thompson,F,22023,202691,22300478,"JAN 04, 2024",GSW vs. DEN,L,35,9,18,0.5,4,10,0.4,2,2,1.0,0,3,3,3,1,1,0,2,24,-9,1,GSW,GSW,DEN,127,,,30,27,27,6
Klay Thompson,F,22023,202691,22300463,"JAN 02, 2024",GSW vs. ORL,W,25,6,11,0.545,3,8,0.375,0,0,0.0,0,3,3,2,0,1,1,4,15,4,1,GSW,GSW,ORL,121,,,20,18,17,5
Klay Thompson,F,22023,202691,22300444,"DEC 30, 2023",GSW vs. DAL,L,26,1,11,0.091,1,6,0.167,0,0,0.0,0,2,2,1,0,0,1,0,3,-7,1,GSW,GSW,DAL,122,,,6,5,4,3
Klay Thompson,F,22023,202691,22300426,"DEC 28, 2023",GSW vs. MIA,L,25,4,11,0.364,2,6,0.333,3,4,0.75,0,0,0,5,2,0,0,2,13,-26,1,GSW,GSW,MIA,102,,,18,13,18,5
Klay Thompson,F,22023,202691,22300402,"DEC 25, 2023",GSW @ DEN,L,32,3,12,0.25,3,10,0.3,0,0,0.0,0,6,6,1,1,1,3,1,9,-2,1,GSW,DEN,GSW,114,,,16,15,10,7
Klay Thompson,F,22023,202691,22300399,"DEC 23, 2023",GSW vs. POR,W,31,11,16,0.688,6,10,0.6,0,0,0.0,1,2,3,0,0,0,3,1,28,14,1,GSW,GSW,POR,126,,,31,31,28,3
Klay Thompson,F,22023,202691,22300386,"DEC 22, 2023",GSW vs. WAS,W,27,8,17,0.471,4,10,0.4,0,0,0.0,0,3,3,2,0,0,2,0,20,7,1,GSW,GSW,WAS,129,,,25,23,22,5
Klay Thompson,F,22023,202691,22300362,"DEC 19, 2023",GSW vs. BOS,W,40,9,21,0.429,6,15,0.4,0,0,0.0,0,4,4,4,1,1,1,0,24,7,1,GSW,GSW,BOS,132,,,32,28,28,8
Klay Thompson,F,22023,202691,22300348,"DEC 17, 2023",GSW @ POR,W,29,11,16,0.688,5,10,0.5,1,1,1.0,0,4,4,1,1,0,1,3,28,-5,1,GSW,POR,GSW,118,,,33,32,29,5
Klay Thompson,F,22023,202691,22300339,"DEC 16, 2023",GSW vs. BKN,W,34,7,19,0.368,4,9,0.444,6,6,1.0,2,3,5,3,1,0,0,2,24,6,1,GSW,GSW,BKN,124,,,32,29,27,8
Klay Thompson,F,22023,202691,22300325,"DEC 14, 2023",GSW @ LAC,L,32,9,15,0.6,8,12,0.667,4,4,1.0,0,1,1,5,2,0,0,1,30,-12,1,GSW,LAC,GSW,113,,,36,31,35,6
Klay Thompson,F,22023,202691,22300308,"DEC 12, 2023",GSW @ PHX,L,27,2,10,0.2,1,8,0.125,2,2,1.0,0,5,5,0,0,0,1,1,7,4,1,GSW,PHX,GSW,116,,,12,12,7,5
Klay Thompson,F,22023,202691,22301222,"DEC 08, 2023",GSW @ OKC,L,39,8,15,0.533,4,9,0.444,2,2,1.0,1,3,4,0,0,1,4,4,22,11,1,GSW,OKC,GSW,136,,,26,26,22,4
Klay Thompson,F,22023,202691,22301214,"DEC 06, 2023",GSW vs. POR,W,27,3,13,0.231,1,8,0.125,4,4,1.0,0,5,5,1,0,0,0,0,11,-6,1,GSW,GSW,POR,110,,,17,16,12,6
Klay Thompson,F,22023,202691,22300280,"DEC 02, 2023",GSW @ LAC,L,33,5,13,0.385,4,11,0.364,3,4,0.75,1,5,6,2,1,0,2,3,17,-2,1,GSW,LAC,GSW,112,,,25,23,19,8
Klay Thompson,F,22023,202691,22300273,"NOV 30, 2023",GSW vs. LAC,W,34,8,18,0.444,2,7,0.286,4,4,1.0,2,4,6,2,0,1,2,2,22,8,1,GSW,GSW,LAC,120,,,30,28,24,8
Klay Thompson,F,22023,202691,22300060,"NOV 28, 2023",GSW @ SAC,L,36,6,14,0.429,3,9,0.333,5,6,0.833,0,9,9,2,1,2,3,2,20,-5,1,GSW,SAC,GSW,123,,,31,29,22,11
Klay Thompson,F,22023,202691,22300051,"NOV 24, 2023",GSW vs. SAS,W,29,3,11,0.273,3,8,0.375,6,7,0.857,1,2,3,6,1,0,2,3,15,7,1,GSW,GSW,SAS,118,,,24,18,21,9
Klay Thompson,F,22023,202691,22300236,"NOV 22, 2023",GSW @ PHX,L,25,8,17,0.471,6,10,0.6,1,1,1.0,1,2,3,1,0,1,2,3,23,-24,1,GSW,PHX,GSW,115,,,27,26,24,4
Klay Thompson,F,22023,202691,22300224,"NOV 20, 2023",GSW vs. HOU,W,31,7,16,0.438,5,11,0.455,1,1,1.0,0,3,3,3,0,0,1,1,20,-3,1,GSW,GSW,HOU,121,,,26,23,23,6
Klay Thompson,F,22023,202691,22300207,"NOV 18, 2023",GSW vs. OKC,L,37,5,13,0.385,3,9,0.333,3,3,1.0,0,2,2,4,0,1,4,4,16,4,1,GSW,GSW,OKC,123,,,22,18,20,6
Klay Thompson,F,22023,202691,22300186,"NOV 12, 2023",GSW vs. MIN,L,33,5,16,0.313,3,10,0.3,3,3,1.0,0,5,5,3,1,0,1,1,16,4,1,GSW,GSW,MIN,110,,,24,21,19,8
Klay Thompson,F,22023,202691,22300176,"NOV 11, 2023",GSW vs. CLE,L,28,5,16,0.313,2,5,0.4,2,2,1.0,1,4,5,1,0,1,3,3,14,-7,1,GSW,GSW,CLE,110,,,20,19,15,6
Klay Thompson,F,22023,202691,22300169,"NOV 08, 2023",GSW @ DEN,L,32,5,12,0.417,2,8,0.25,3,6,0.5,0,6,6,1,1,0,2,1,15,-13,1,GSW,DEN,GSW,105,,,22,21,16,7
Klay Thompson,F,22023,202691,22300145,"NOV 06, 2023",GSW @ DET,W,28,8,16,0.5,1,8,0.125,0,0,0.0,1,0,1,3,0,0,2,1,17,1,1,GSW,DET,GSW,120,,,21,18,20,4
Klay Thompson,F,22023,202691,22300142,"NOV 05, 2023",GSW @ CLE,L,32,5,14,0.357,3,9,0.333,2,2,1.0,2,1,3,2,1,0,2,2,15,-12,1,GSW,CLE,GSW,104,,,20,18,17,5
Klay Thompson,F,22023,202691,22300005,"NOV 03, 2023",GSW @ OKC,W,33,6,10,0.6,4,6,0.667,2,2,1.0,0,3,3,1,0,0,1,4,18,0,1,GSW,OKC,GSW,141,,,22,21,19,4
Klay Thompson,F,22023,202691,22300126,"NOV 01, 2023",GSW vs. SAC,W,29,6,15,0.4,1,4,0.25,1,1,1.0,1,1,2,2,0,3,2,3,14,10,1,GSW,GSW,SAC,102,,,18,16,16,4
Klay Thompson,F,22023,202691,22300096,"OCT 29, 2023",GSW @ HOU,W,29,7,12,0.583,5,10,0.5,0,0,0.0,1,3,4,0,0,1,1,3,19,-2,1,GSW,HOU,GSW,106,,,23,23,19,4
Klay Thompson,F,22023,202691,22300087,"OCT 27, 2023",GSW @ SAC,W,33,7,12,0.583,2,4,0.5,2,2,1.0,0,3,3,4,1,0,3,4,18,4,1,GSW,SAC,GSW,122,,,25,21,22,7
Klay Thompson,F,22023,202691,22300062,"OCT 24, 2023",GSW vs. PHX,L,36,6,18,0.333,3,11,0.273,0,0,0.0,1,6,7,3,0,1,3,3,15,9,1,GSW,GSW,PHX,104,,,25,22,18,10
Klay Thompson,F,22023,202691,22300025,"NOV 14, 2023",GSW vs. MIN,L,2,0,1,0.0,0,1,0.0,0,0,0.0,0,0,0,0,0,0,0,0,0,-2,1,GSW,GSW,MIN,101,,,0,0,0,0
Klay Thompson,F,22023,202691,22300545,"JAN 13, 2024",GSW @ MIL,L,36,7,23,0.304,6,17,0.353,1,1,1.0,2,1,3,3,0,0,2,2,21,-8,1,GSW,MIL,GSW,118,,,27,24,24,6
Klay Thompson,F,22023,202691,22300201,"NOV 16, 2023",GSW vs. OKC,L,27,1,10,0.1,1,6,0.167,2,2,1.0,0,2,2,3,1,0,2,1,5,-2,1,GSW,GSW,OKC,109,,,10,7,8,5
Collin Sexton,G,22023,1629012,22300711,"FEB 04, 2024",UTA vs. MIL,W,25,5,13,0.385,3,7,0.429,6,6,1.0,0,1,1,3,0,0,4,2,19,-3,1,UTA,UTA,MIL,123,,,23,20,22,4
Collin Sexton,G,22023,1629012,22300686,"FEB 01, 2024",UTA vs. PHI,L,25,8,14,0.571,2,4,0.5,4,4,1.0,0,1,1,6,1,1,3,2,22,-6,1,UTA,UTA,PHI,124,,,29,23,28,7
Collin Sexton,G,22023,1629012,22300671,"JAN 30, 2024",UTA @ NYK,L,28,7,13,0.538,2,4,0.5,6,8,0.75,2,1,3,7,0,0,2,2,22,-6,1,UTA,NYK,UTA,103,,,32,25,29,10
Collin Sexton,G,22023,1629012,22300660,"JAN 29, 2024",UTA @ BKN,L,24,1,10,0.1,0,2,0.0,4,4,1.0,0,1,1,7,0,0,2,1,6,-5,1,UTA,BKN,UTA,114,,,14,7,13,8
Collin Sexton,G,22023,1629012,22300647,"JAN 27, 2024",UTA @ CHA,W,35,9,19,0.474,3,7,0.429,3,5,0.6,2,2,4,13,2,0,3,0,24,19,1,UTA,CHA,UTA,134,,,41,28,37,17
Collin Sexton,G,22023,1629012,22300628,"JAN 25, 2024",UTA @ WAS,W,17,4,11,0.364,1,2,0.5,2,2,1.0,1,2,3,6,1,0,2,2,11,2,1,UTA,WAS,UTA,123,,,20,14,17,9
Collin Sexton,G,22023,1629012,22300616,"JAN 23, 2024",UTA @ NOP,L,24,9,12,0.75,2,4,0.5,2,3,0.667,0,3,3,7,0,1,1,0,22,-15,1,UTA,NOP,UTA,124,,,32,25,29,10
Collin Sexton,G,22023,1629012,22300598,"JAN 20, 2024",UTA @ HOU,L,40,11,27,0.407,2,7,0.286,4,4,1.0,3,0,3,5,2,0,2,4,28,12,1,UTA,HOU,UTA,126,,,36,31,33,8
Collin Sexton,G,22023,1629012,22300581,"JAN 18, 2024",UTA vs. OKC,L,34,10,19,0.526,4,7,0.571,7,10,0.7,1,0,1,7,1,0,2,4,31,4,1,UTA,UTA,OKC,129,,,39,32,38,8
Collin Sexton,G,22023,1629012,22300564,"JAN 15, 2024",UTA vs. IND,W,24,11,17,0.647,4,5,0.8,4,4,1.0,1,2,3,5,0,0,1,2,30,14,1,UTA,UTA,IND,132,,,38,33,35,8
Collin Sexton,G,22023,1629012,22300549,"JAN 13, 2024",UTA vs. LAL,W,28,8,13,0.615,1,4,0.25,10,10,1.0,1,3,4,5,0,0,1,5,27,18,1,UTA,UTA,LAL,132,,,36,31,32,9
Collin Sexton,G,22023,1629012,22300540,"JAN 12, 2024",UTA vs. TOR,W,20,5,10,0.5,3,3,1.0,7,8,0.875,0,2,2,5,2,0,2,0,20,15,1,UTA,UTA,TOR,145,,,27,22,25,7
Collin Sexton,G,22023,1629012,22300524,"JAN 10, 2024",UTA vs. DEN,W,21,8,14,0.571,2,4,0.5,4,4,1.0,1,1,2,4,1,1,1,3,22,11,1,UTA,UTA,DEN,124,,,28,24,26,6
Collin Sexton,G,22023,1629012,22300510,"JAN 08, 2024",UTA @ MIL,W,18,8,13,0.615,3,6,0.5,0,0,0.0,0,0,0,3,1,0,0,0,19,1,1,UTA,MIL,UTA,132,,,22,19,22,3
Collin Sexton,G,22023,1629012,22300495,"JAN 06, 2024",UTA @ PHI,W,27,9,14,0.643,1,3,0.333,3,4,0.75,1,2,3,10,0,0,5,3,22,7,1,UTA,PHI,UTA,120,,,35,25,32,13
Collin Sexton,G,22023,1629012,22300479,"JAN 05, 2024",UTA @ BOS,L,20,5,12,0.417,0,3,0.0,3,3,1.0,0,1,1,3,3,0,3,1,13,-13,1,UTA,BOS,UTA,97,,,17,14,16,4
Collin Sexton,G,22023,1629012,22300474,"JAN 03, 2024",UTA vs. DET,W,30,7,14,0.5,1,2,0.5,10,10,1.0,1,1,2,5,1,0,0,5,25,2,1,UTA,UTA,DET,154,,,32,27,30,7
Collin Sexton,G,22023,1629012,22300457,"JAN 01, 2024",UTA vs. DAL,W,19,2,8,0.25,0,3,0.0,4,4,1.0,1,2,3,6,0,0,1,1,8,1,1,UTA,UTA,DAL,127,,,17,11,14,9
Collin Sexton,G,22023,1629012,22300439,"DEC 30, 2023",UTA vs. MIA,W,26,8,14,0.571,1,4,0.25,5,6,0.833,1,1,2,5,1,0,3,1,22,-2,1,UTA,UTA,MIA,117,,,29,24,27,7
Collin Sexton,G,22023,1629012,22300424,"DEC 28, 2023",UTA @ NOP,L,30,8,17,0.471,3,6,0.5,7,9,0.778,1,4,5,3,0,0,0,4,26,3,1,UTA,NOP,UTA,105,,,34,31,29,8
Collin Sexton,G,22023,1629012,22300412,"DEC 26, 2023",UTA @ SAS,W,29,8,10,0.8,0,2,0.0,4,5,0.8,0,3,3,6,1,1,1,4,20,-7,1,UTA,SAS,UTA,130,,,29,23,26,9
Collin Sexton,G,22023,1629012,22300395,"DEC 23, 2023",UTA @ TOR,W,25,5,11,0.455,1,2,0.5,5,6,0.833,0,0,0,3,1,0,1,0,16,-11,1,UTA,TOR,UTA,126,,,19,16,19,3
Collin Sexton,G,22023,1629012,22300374,"DEC 21, 2023",UTA @ DET,W,32,6,18,0.333,1,3,0.333,6,6,1.0,3,1,4,8,4,0,3,3,19,-10,1,UTA,DET,UTA,119,,,31,23,27,12
Collin Sexton,G,22023,1629012,22300364,"DEC 20, 2023",UTA @ CLE,L,34,7,17,0.412,3,6,0.5,3,4,0.75,0,3,3,2,0,1,2,5,20,6,1,UTA,CLE,UTA,116,,,25,23,22,5
Collin Sexton,G,22023,1629012,22300357,"DEC 18, 2023",UTA vs. BKN,W,35,6,17,0.353,3,7,0.429,12,13,0.923,1,2,3,6,0,0,2,3,27,18,1,UTA,UTA,BKN,125,,,36,30,33,9
Collin Sexton,G,22023,1629012,22300342,"DEC 16, 2023",UTA @ SAC,L,33,10,18,0.556,2,6,0.333,6,7,0.857,1,2,3,1,1,0,1,2,28,-27,1,UTA,SAC,UTA,104,,,32,31,29,4
Collin Sexton,G,22023,1629012,22300323,"DEC 14, 2023",UTA @ POR,W,32,11,17,0.647,2,5,0.4,3,3,1.0,1,1,2,4,1,0,2,2,27,17,1,UTA,POR,UTA,122,,,33,29,31,6
Collin Sexton,G,22023,1629012,22300318,"DEC 13, 2023",UTA vs. NYK,W,30,10,18,0.556,3,8,0.375,3,3,1.0,1,3,4,7,0,0,2,4,26,-9,1,UTA,UTA,NYK,117,,,37,30,33,11
Collin Sexton,G,22023,1629012,22300302,"DEC 11, 2023",UTA @ OKC,L,26,7,13,0.538,1,4,0.25,5,6,0.833,2,2,4,2,2,0,0,1,20,-1,1,UTA,OKC,UTA,120,,,26,24,22,6
Collin Sexton,G,22023,1629012,22301225,"DEC 08, 2023",UTA vs. LAC,L,18,5,12,0.417,1,4,0.25,2,2,1.0,0,3,3,3,1,0,1,2,13,-1,1,UTA,UTA,LAC,103,,,19,16,16,6
Collin Sexton,G,22023,1629012,22301213,"DEC 06, 2023",UTA @ DAL,L,18,0,4,0.0,0,1,0.0,7,8,0.875,0,3,3,5,1,0,2,1,7,-3,1,UTA,DAL,UTA,97,,,15,10,12,8
Collin Sexton,G,22023,1629012,22300289,"DEC 02, 2023",UTA vs. POR,W,30,9,13,0.692,0,2,0.0,7,7,1.0,1,3,4,5,0,0,3,2,25,4,1,UTA,UTA,POR,118,,,34,29,30,9
Collin Sexton,G,22023,1629012,22300270,"NOV 30, 2023",UTA @ MIN,L,23,4,8,0.5,1,2,0.5,5,5,1.0,0,3,3,4,0,0,3,1,14,-3,1,UTA,MIN,UTA,90,,,21,17,18,7
Collin Sexton,G,22023,1629012,22300261,"NOV 29, 2023",UTA @ MEM,L,22,3,10,0.3,1,4,0.25,2,3,0.667,1,0,1,3,1,0,2,3,9,-3,1,UTA,MEM,UTA,91,,,13,10,12,4
Collin Sexton,G,22023,1629012,22300256,"NOV 27, 2023",UTA vs. NOP,W,18,4,9,0.444,3,6,0.5,0,0,0.0,1,1,2,0,2,0,4,2,11,6,1,UTA,UTA,NOP,114,,,13,13,11,2
Collin Sexton,G,22023,1629012,22300243,"NOV 25, 2023",UTA vs. NOP,W,28,5,13,0.385,3,8,0.375,3,4,0.75,2,1,3,6,0,0,2,0,16,3,1,UTA,UTA,NOP,105,,,25,19,22,9
Collin Sexton,G,22023,1629012,22300237,"NOV 22, 2023",UTA @ POR,L,11,0,5,0.0,0,3,0.0,1,2,0.5,1,1,2,2,1,0,2,2,1,-16,1,UTA,POR,UTA,105,,,5,3,3,4
Collin Sexton,G,22023,1629012,22300042,"NOV 21, 2023",UTA @ LAL,L,22,6,11,0.545,2,3,0.667,0,0,0.0,0,3,3,4,0,0,1,2,14,-9,1,UTA,LAL,UTA,99,,,21,17,18,7
Collin Sexton,G,22023,1629012,22300214,"NOV 19, 2023",UTA vs. PHX,L,23,6,13,0.462,3,6,0.5,3,3,1.0,3,2,5,2,1,0,2,0,18,12,1,UTA,UTA,PHX,137,,,25,23,20,7
Collin Sexton,G,22023,1629012,22300035,"NOV 17, 2023",UTA vs. PHX,L,20,3,8,0.375,0,2,0.0,2,2,1.0,2,2,4,4,0,2,0,3,8,-6,1,UTA,UTA,PHX,128,,,16,12,12,8
Collin Sexton,G,22023,1629012,22300023,"NOV 14, 2023",UTA vs. POR,W,28,5,11,0.455,1,5,0.2,2,2,1.0,0,4,4,7,2,1,2,3,13,14,1,UTA,UTA,POR,115,,,24,17,20,11
Collin Sexton,G,22023,1629012,22300012,"NOV 10, 2023",UTA @ MEM,W,18,3,8,0.375,0,2,0.0,4,4,1.0,1,1,2,6,1,0,3,0,10,3,1,UTA,MEM,UTA,127,,,18,12,16,8
Collin Sexton,G,22023,1629012,22300158,"NOV 08, 2023",UTA @ IND,L,16,3,9,0.333,1,2,0.5,3,3,1.0,0,2,2,2,0,0,0,0,10,-7,1,UTA,IND,UTA,118,,,14,12,12,4
Collin Sexton,G,22023,1629012,22300152,"NOV 06, 2023",UTA @ CHI,L,17,6,10,0.6,1,3,0.333,1,1,1.0,1,2,3,2,0,0,1,3,14,1,1,UTA,CHI,UTA,113,,,19,17,16,5
Collin Sexton,G,22023,1629012,22300138,"NOV 04, 2023",UTA @ MIN,L,19,1,3,0.333,1,3,0.333,4,4,1.0,2,2,4,4,0,1,6,2,7,-14,1,UTA,MIN,UTA,95,,,15,11,11,8
Collin Sexton,G,22023,1629012,22300130,"NOV 02, 2023",UTA vs. ORL,L,17,3,8,0.375,0,2,0.0,4,6,0.667,1,0,1,1,0,0,2,1,10,-5,1,UTA,UTA,ORL,113,,,12,11,11,2
Collin Sexton,G,22023,1629012,22300125,"NOV 01, 2023",UTA vs. MEM,W,22,8,10,0.8,4,6,0.667,3,3,1.0,1,2,3,6,0,0,2,1,23,22,1,UTA,UTA,MEM,133,,,32,26,29,9
Collin Sexton,G,22023,1629012,22300110,"OCT 30, 2023",UTA @ DEN,L,17,5,10,0.5,2,5,0.4,0,0,0.0,0,0,0,0,0,0,1,2,12,-10,1,UTA,DEN,UTA,102,,,12,12,12,0
Collin Sexton,G,22023,1629012,22300094,"OCT 28, 2023",UTA @ PHX,L,23,4,8,0.5,0,0,0.0,6,6,1.0,1,1,2,6,0,0,2,1,14,-7,1,UTA,PHX,UTA,104,,,22,16,20,8
Collin Sexton,G,22023,1629012,22300085,"OCT 27, 2023",UTA vs. LAC,W,20,5,12,0.417,0,2,0.0,3,4,0.75,0,1,1,0,0,0,0,3,13,-4,1,UTA,UTA,LAC,120,,,14,14,13,1
Collin Sexton,G,22023,1629012,22300072,"OCT 25, 2023",UTA vs. SAC,L,20,2,9,0.222,0,2,0.0,5,7,0.714,0,3,3,0,0,0,3,3,9,-10,1,UTA,UTA,SAC,114,,,12,12,9,3
Collin Sexton,G,22023,1629012,22300739,"FEB 08, 2024",UTA @ PHX,L,24,7,15,0.467,3,6,0.5,2,6,0.333,2,2,4,8,0,1,5,2,19,-6,1,UTA,PHX,UTA,115,,,31,23,27,12
Collin Sexton,G,22023,1629012,22300724,"FEB 06, 2024",UTA vs. OKC,W,26,4,10,0.4,1,3,0.333,5,5,1.0,0,0,0,4,0,0,2,2,14,5,1,UTA,UTA,OKC,124,,,18,14,18,4
Bradley Beal,G,22023,203078,22300757,"FEB 10, 2024",PHX @ GSW,L,34,7,16,0.438,1,4,0.25,0,0,0.0,2,4,6,5,2,0,2,4,15,2,1,PHX,GSW,PHX,112,,,26,21,20,11
Bradley Beal,G,22023,203078,22300739,"FEB 08, 2024",PHX vs. UTA,W,37,11,21,0.524,6,9,0.667,2,2,1.0,1,1,2,7,1,0,5,2,30,7,1,PHX,PHX,UTA,129,,,39,32,37,9
Bradley Beal,G,22023,203078,22300725,"FEB 06, 2024",PHX vs. MIL,W,38,10,22,0.455,2,8,0.25,3,5,0.6,2,8,10,3,3,0,4,3,25,9,1,PHX,PHX,MIL,114,,,38,35,28,13
Bradley Beal,G,22023,203078,22300705,"FEB 04, 2024",PHX @ WAS,W,31,16,21,0.762,4,5,0.8,7,7,1.0,0,2,2,6,2,0,2,1,43,17,1,PHX,WAS,PHX,140,,,51,45,49,8
Bradley Beal,G,22023,203078,22300690,"FEB 02, 2024",PHX @ ATL,L,40,5,16,0.313,0,7,0.0,4,4,1.0,1,3,4,10,0,0,4,2,14,-6,1,PHX,ATL,PHX,120,,,28,18,24,14
Bradley Beal,G,22023,203078,22300661,"JAN 29, 2024",PHX @ MIA,W,39,8,21,0.381,2,9,0.222,1,1,1.0,0,5,5,7,1,0,1,3,19,2,1,PHX,MIA,PHX,118,,,31,24,26,12
Bradley Beal,G,22023,203078,22300655,"JAN 28, 2024",PHX @ ORL,L,35,4,13,0.308,0,5,0.0,1,4,0.25,1,4,5,6,1,0,4,4,9,-16,1,PHX,ORL,PHX,98,,,20,14,15,11
Bradley Beal,G,22023,203078,22300636,"JAN 26, 2024",PHX @ IND,L,34,5,13,0.385,1,5,0.2,1,1,1.0,1,3,4,3,1,1,6,5,12,-4,1,PHX,IND,PHX,131,,,19,16,15,7
Bradley Beal,G,22023,203078,22300625,"JAN 24, 2024",PHX @ DAL,W,36,8,15,0.533,3,7,0.429,1,2,0.5,2,5,7,7,1,1,2,4,20,9,1,PHX,DAL,PHX,132,,,34,27,27,14
Bradley Beal,G,22023,203078,22300612,"JAN 22, 2024",PHX vs. CHI,W,38,7,17,0.412,2,4,0.5,2,2,1.0,0,4,4,5,0,0,1,0,18,6,1,PHX,PHX,CHI,115,,,27,22,23,9
Bradley Beal,G,22023,203078,22300604,"JAN 21, 2024",PHX vs. IND,W,38,11,16,0.688,0,1,0.0,3,3,1.0,1,3,4,3,1,0,2,4,25,11,1,PHX,PHX,IND,117,,,32,29,28,7
Bradley Beal,G,22023,203078,22300588,"JAN 19, 2024",PHX @ NOP,W,31,6,12,0.5,1,4,0.25,0,0,0.0,1,6,7,5,0,0,0,4,13,19,1,PHX,NOP,PHX,123,,,25,20,18,12
Bradley Beal,G,22023,203078,22300567,"JAN 16, 2024",PHX vs. SAC,W,38,6,14,0.429,0,4,0.0,1,2,0.5,1,2,3,5,2,0,1,2,13,-12,1,PHX,PHX,SAC,119,,,21,16,18,8
Bradley Beal,G,22023,203078,22300554,"JAN 14, 2024",PHX @ POR,W,37,9,13,0.692,4,6,0.667,1,3,0.333,0,4,4,5,2,0,4,4,23,4,1,PHX,POR,PHX,127,,,32,27,28,9
Bradley Beal,G,22023,203078,22300531,"JAN 11, 2024",PHX @ LAL,W,32,14,21,0.667,8,10,0.8,1,1,1.0,2,4,6,4,1,0,3,3,37,25,1,PHX,LAL,PHX,127,,,47,43,41,10
Bradley Beal,G,22023,203078,22300511,"JAN 08, 2024",PHX @ LAC,L,35,7,15,0.467,0,2,0.0,1,2,0.5,0,3,3,2,2,0,2,4,15,-7,1,PHX,LAC,PHX,111,,,20,18,17,5
Bradley Beal,G,22023,203078,22300503,"JAN 07, 2024",PHX vs. MEM,L,37,5,12,0.417,0,1,0.0,2,4,0.5,3,3,6,5,0,0,1,3,12,-8,1,PHX,PHX,MEM,115,,,23,18,17,11
Bradley Beal,G,22023,203078,22300489,"JAN 05, 2024",PHX vs. MIA,W,37,11,18,0.611,2,6,0.333,1,1,1.0,1,7,8,9,0,0,2,2,25,27,1,PHX,PHX,MIA,113,,,42,33,34,17
Bradley Beal,G,22023,203078,22300473,"JAN 03, 2024",PHX vs. LAC,L,41,7,20,0.35,0,6,0.0,7,7,1.0,2,3,5,4,1,1,3,5,21,-8,1,PHX,PHX,LAC,122,,,30,26,25,9
Bradley Beal,G,22023,203078,22300456,"JAN 01, 2024",PHX vs. POR,W,34,8,16,0.5,1,3,0.333,4,4,1.0,0,4,4,1,1,1,4,2,21,22,1,PHX,PHX,POR,109,,,26,25,22,5
Bradley Beal,G,22023,203078,22300450,"DEC 31, 2023",PHX vs. ORL,W,35,10,13,0.769,1,2,0.5,4,4,1.0,0,1,1,2,1,1,1,1,25,-1,1,PHX,PHX,ORL,112,,,28,26,27,3
Bradley Beal,G,22023,203078,22300436,"DEC 29, 2023",PHX vs. CHA,W,30,3,8,0.375,0,2,0.0,0,0,0.0,0,3,3,7,0,1,2,2,6,-1,1,PHX,PHX,CHA,133,,,16,9,13,10
Bradley Beal,G,22023,203078,22300333,"DEC 15, 2023",PHX vs. NYK,L,5,2,2,1.0,1,1,1.0,1,1,1.0,0,0,0,1,0,0,0,0,6,3,1,PHX,PHX,NYK,122,,,7,6,7,1
Bradley Beal,G,22023,203078,22300185,"NOV 12, 2023",PHX vs. OKC,L,30,6,17,0.353,0,5,0.0,3,6,0.5,1,7,8,5,0,0,5,5,15,-18,1,PHX,PHX,OKC,99,,,28,23,20,13
Bradley Beal,G,22023,203078,22300015,"NOV 10, 2023",PHX vs. LAL,L,32,9,17,0.529,2,4,0.5,4,6,0.667,2,2,4,2,2,0,2,4,24,-14,1,PHX,PHX,LAL,119,,,30,28,26,6
Bradley Beal,G,22023,203078,22300162,"NOV 08, 2023",PHX @ CHI,W,24,3,12,0.25,3,6,0.5,4,4,1.0,0,4,4,4,0,1,2,0,13,16,1,PHX,CHI,PHX,116,,,21,17,17,8
Bradley Beal,G,22023,203078,22300677,"JAN 31, 2024",PHX @ BKN,W,37,3,8,0.375,1,3,0.333,5,6,0.833,1,3,4,5,0,0,3,1,12,1,1,PHX,BKN,PHX,136,,,21,16,17,9
Bradley Beal,G,22023,203078,22300317,"DEC 13, 2023",PHX vs. BKN,L,34,6,9,0.667,2,2,1.0,0,0,0.0,0,1,1,4,1,0,2,1,14,-11,1,PHX,PHX,BKN,112,,,19,15,18,5
Bradley Beal,G,22023,203078,22300308,"DEC 12, 2023",PHX vs. GSW,W,27,5,12,0.417,1,3,0.333,5,7,0.714,0,3,3,3,1,1,3,3,16,-15,1,PHX,PHX,GSW,119,,,22,19,19,6
James Harden,G,22023,201935,22300731,"FEB 07, 2024",LAC vs. NOP,L,38,6,11,0.545,5,6,0.833,2,3,0.667,1,7,8,5,1,1,4,2,19,-1,1,LAC,LAC,NOP,106,,,32,27,24,13
James Harden,G,22023,201935,22300688,"FEB 02, 2024",LAC @ DET,W,34,1,10,0.1,0,5,0.0,2,2,1.0,1,2,3,6,1,0,1,1,4,8,1,LAC,DET,LAC,136,,,13,7,10,9
James Harden,G,22023,201935,22300676,"JAN 31, 2024",LAC @ WAS,W,33,7,15,0.467,5,10,0.5,6,6,1.0,1,8,9,5,2,4,2,2,25,20,1,LAC,WAS,LAC,125,,,39,34,30,14
James Harden,G,22023,201935,22300658,"JAN 29, 2024",LAC @ CLE,L,39,3,8,0.375,2,5,0.4,3,4,0.75,0,7,7,10,1,1,3,2,11,-2,1,LAC,CLE,LAC,108,,,28,18,21,17
James Harden,G,22023,201935,22300646,"JAN 27, 2024",LAC @ BOS,W,27,2,11,0.182,0,6,0.0,5,6,0.833,1,7,8,7,0,0,1,2,9,36,1,LAC,BOS,LAC,115,,,24,17,16,15
James Harden,G,22023,201935,22300637,"JAN 26, 2024",LAC @ TOR,W,35,8,14,0.571,2,7,0.286,4,4,1.0,0,10,10,13,1,1,1,3,22,27,1,LAC,TOR,LAC,127,,,45,32,35,23
James Harden,G,22023,201935,22300537,"JAN 12, 2024",LAC @ MEM,W,28,3,7,0.429,2,4,0.5,3,3,1.0,0,1,1,9,1,0,3,0,11,20,1,LAC,MEM,LAC,128,,,21,12,20,10
James Harden,G,22023,201935,22300511,"JAN 08, 2024",LAC vs. PHX,W,30,6,8,0.75,3,4,0.75,4,4,1.0,0,7,7,10,0,0,3,1,19,25,1,LAC,LAC,PHX,138,,,36,26,29,17
James Harden,G,22023,201935,22300486,"JAN 05, 2024",LAC @ NOP,W,29,2,7,0.286,1,6,0.167,3,3,1.0,0,3,3,13,0,0,1,2,8,18,1,LAC,NOP,LAC,111,,,24,11,21,16
James Harden,G,22023,201935,22300458,"JAN 01, 2024",LAC vs. MIA,W,31,5,8,0.625,3,5,0.6,2,2,1.0,0,4,4,10,1,2,2,1,15,26,1,LAC,LAC,MIA,121,,,29,19,25,14
James Harden,G,22023,201935,22300389,"DEC 23, 2023",LAC vs. BOS,L,29,6,13,0.462,2,5,0.4,0,0,0.0,0,4,4,9,1,0,4,4,14,-34,1,LAC,LAC,BOS,108,,,27,18,23,13
James Harden,G,22023,201935,22300379,"DEC 21, 2023",LAC @ OKC,L,34,7,18,0.389,4,9,0.444,5,6,0.833,2,7,9,6,3,1,3,1,23,-17,1,LAC,OKC,LAC,115,,,38,32,29,15
James Harden,G,22023,201935,22300350,"DEC 18, 2023",LAC @ IND,W,28,12,16,0.75,8,11,0.727,3,3,1.0,0,3,3,9,1,1,1,2,35,32,1,LAC,IND,LAC,151,,,47,38,44,12
James Harden,G,22023,201935,22300343,"DEC 16, 2023",LAC vs. NYK,W,28,2,6,0.333,1,4,0.25,5,7,0.714,0,4,4,12,1,2,1,3,10,22,1,LAC,LAC,NYK,144,,,26,14,22,16
James Harden,G,22023,201935,22300618,"JAN 23, 2024",LAC vs. LAL,W,39,8,17,0.471,4,8,0.5,3,5,0.6,1,1,2,10,1,1,1,3,23,10,1,LAC,LAC,LAL,127,,,35,25,33,12
James Harden,G,22023,201935,22300438,"DEC 29, 2023",LAC vs. MEM,W,44,4,13,0.308,2,9,0.222,6,8,0.75,0,4,4,13,0,3,5,1,16,16,1,LAC,LAC,MEM,117,,,33,20,29,17
James Harden,G,22023,201935,22300414,"DEC 26, 2023",LAC vs. CHA,W,40,8,16,0.5,6,12,0.5,7,8,0.875,0,6,6,8,2,1,4,2,29,20,1,LAC,LAC,CHA,113,,,43,35,37,14
James Harden,G,22023,201935,22300325,"DEC 14, 2023",LAC vs. GSW,W,42,6,12,0.5,5,6,0.833,11,12,0.917,2,5,7,15,1,4,4,3,28,12,1,LAC,LAC,GSW,121,,,50,35,43,22
James Harden,G,22023,201935,22300309,"DEC 12, 2023",LAC vs. SAC,W,28,4,9,0.444,0,4,0.0,7,7,1.0,0,6,6,7,2,0,2,3,15,26,1,LAC,LAC,SAC,117,,,28,21,22,13
James Harden,G,22023,201935,22300304,"DEC 11, 2023",LAC vs. POR,W,37,7,14,0.5,3,6,0.5,3,3,1.0,0,7,7,7,1,2,3,2,20,3,1,LAC,LAC,POR,132,,,34,27,27,14
James Harden,G,22023,201935,22301225,"DEC 08, 2023",LAC @ UTA,W,34,2,8,0.25,2,6,0.333,6,7,0.857,0,7,7,8,0,1,2,2,12,18,1,LAC,UTA,LAC,117,,,27,19,20,15
James Harden,G,22023,201935,22301215,"DEC 06, 2023",LAC vs. DEN,W,32,6,10,0.6,2,3,0.667,6,7,0.857,0,1,1,11,3,1,4,0,20,6,1,LAC,LAC,DEN,111,,,32,21,31,12
James Harden,G,22023,201935,22300280,"DEC 02, 2023",LAC vs. GSW,W,35,7,14,0.5,2,7,0.286,5,5,1.0,0,5,5,9,1,0,1,4,21,0,1,LAC,LAC,GSW,113,,,35,26,30,14
James Harden,G,22023,201935,22300273,"NOV 30, 2023",LAC @ GSW,L,37,6,13,0.462,5,10,0.5,1,2,0.5,0,3,3,7,1,0,1,3,18,-1,1,LAC,GSW,LAC,114,,,28,21,25,10
James Harden,G,22023,201935,22300264,"NOV 29, 2023",LAC @ SAC,W,39,8,14,0.571,5,8,0.625,5,5,1.0,1,2,3,6,5,0,2,4,26,19,1,LAC,SAC,LAC,131,,,35,29,32,9
James Harden,G,22023,201935,22300244,"NOV 25, 2023",LAC vs. DAL,W,28,2,8,0.25,2,6,0.333,2,2,1.0,0,4,4,7,1,2,2,1,8,14,1,LAC,LAC,DAL,107,,,19,12,15,11
James Harden,G,22023,201935,22300014,"NOV 10, 2023",LAC @ DAL,L,29,3,6,0.5,2,3,0.667,6,6,1.0,0,5,5,3,2,0,2,0,14,-6,1,LAC,DAL,LAC,126,,,22,19,17,8
James Harden,G,22023,201935,22300151,"NOV 06, 2023",LAC @ NYK,L,31,6,9,0.667,2,4,0.5,3,3,1.0,0,3,3,6,1,0,2,2,17,-18,1,LAC,NYK,LAC,97,,,26,20,23,9
James Harden,G,22023,201935,22300749,"FEB 10, 2024",LAC vs. DET,W,36,4,11,0.364,2,8,0.25,4,4,1.0,0,6,6,8,1,1,5,1,14,8,1,LAC,LAC,DET,112,,,28,20,22,14
James Harden,G,22023,201935,22300716,"FEB 05, 2024",LAC @ ATL,W,39,7,14,0.5,6,9,0.667,10,10,1.0,2,6,8,10,2,1,2,3,30,11,1,LAC,ATL,LAC,149,,,48,38,40,18
James Harden,G,22023,201935,22300708,"FEB 04, 2024",LAC @ MIA,W,42,7,13,0.538,5,9,0.556,2,4,0.5,0,8,8,11,1,1,4,1,21,10,1,LAC,MIA,LAC,103,,,40,29,32,19
James Harden,G,22023,201935,22300600,"JAN 21, 2024",LAC vs. BKN,W,38,6,11,0.545,3,6,0.5,9,9,1.0,0,5,5,10,2,1,4,2,24,9,1,LAC,LAC,BKN,125,,,39,29,34,15
James Harden,G,22023,201935,22300568,"JAN 16, 2024",LAC vs. OKC,W,41,5,14,0.357,4,10,0.4,2,2,1.0,0,5,5,8,0,1,1,2,16,8,1,LAC,LAC,OKC,128,,,29,21,24,13
James Harden,G,22023,201935,22300553,"JAN 14, 2024",LAC @ MIN,L,36,4,14,0.286,2,9,0.222,4,5,0.8,0,1,1,8,2,2,4,3,14,-3,1,LAC,MIN,LAC,105,,,23,15,22,9
James Harden,G,22023,201935,22300526,"JAN 10, 2024",LAC vs. TOR,W,34,5,13,0.385,2,7,0.286,2,2,1.0,0,5,5,11,1,0,3,4,14,8,1,LAC,LAC,TOR,126,,,30,19,25,16
James Harden,G,22023,201935,22300505,"JAN 07, 2024",LAC @ LAL,L,39,4,13,0.308,3,7,0.429,4,5,0.8,2,2,4,9,1,0,5,3,15,-1,1,LAC,LAL,LAC,103,,,28,19,24,13
James Harden,G,22023,201935,22300473,"JAN 03, 2024",LAC @ PHX,W,36,7,13,0.538,4,7,0.571,4,4,1.0,0,5,5,11,0,1,4,2,22,1,1,LAC,PHX,LAC,131,,,38,27,33,16
James Harden,G,22023,201935,22300372,"DEC 20, 2023",LAC @ DAL,W,39,4,12,0.333,2,8,0.25,7,8,0.875,0,5,5,11,0,2,4,3,17,10,1,LAC,DAL,LAC,120,,,33,22,28,16
James Harden,G,22023,201935,22300235,"NOV 22, 2023",LAC @ SAS,W,36,3,7,0.429,2,4,0.5,8,12,0.667,0,6,6,9,1,1,4,3,16,-2,1,LAC,SAS,LAC,109,,,31,22,25,15
James Harden,G,22023,201935,22300223,"NOV 20, 2023",LAC @ SAS,W,28,4,12,0.333,2,8,0.25,3,3,1.0,1,2,3,10,2,0,0,2,13,17,1,LAC,SAS,LAC,124,,,26,16,23,13
James Harden,G,22023,201935,22300179,"NOV 12, 2023",LAC vs. MEM,L,29,4,12,0.333,1,7,0.143,2,2,1.0,2,2,4,3,1,1,1,0,11,-28,1,LAC,LAC,MEM,101,,,18,15,14,7
James Harden,G,22023,201935,22300257,"NOV 27, 2023",LAC vs. DEN,L,36,3,7,0.429,3,5,0.6,2,2,1.0,0,2,2,4,1,0,3,3,11,6,1,LAC,LAC,DEN,104,,,17,13,15,6
James Harden,G,22023,201935,22300052,"NOV 24, 2023",LAC vs. NOP,L,37,2,8,0.25,1,6,0.167,3,6,0.5,0,5,5,10,4,1,3,3,8,-6,1,LAC,LAC,NOP,106,,,23,13,18,15
James Harden,G,22023,201935,22300037,"NOV 17, 2023",LAC vs. HOU,W,34,8,11,0.727,2,4,0.5,6,7,0.857,1,8,9,7,0,1,3,1,24,21,1,LAC,LAC,HOU,106,,,40,33,31,16
James Harden,G,22023,201935,22300024,"NOV 14, 2023",LAC @ DEN,L,35,7,15,0.467,3,8,0.375,4,4,1.0,0,2,2,4,0,0,1,3,21,-3,1,LAC,DEN,LAC,108,,,27,23,25,6
James Harden,G,22023,201935,22300160,"NOV 08, 2023",LAC @ BKN,L,36,4,9,0.444,2,5,0.4,2,2,1.0,0,8,8,5,2,0,5,0,12,-15,1,LAC,BKN,LAC,93,,,25,20,17,13
Myles Turner,C,22023,1626167,22300550,"JAN 14, 2024",IND @ DEN,L,26,5,11,0.455,0,4,0.0,2,3,0.667,1,3,4,1,2,1,3,5,12,-5,1,IND,DEN,IND,109,,,17,16,13,5
Myles Turner,C,22023,1626167,22300533,"JAN 12, 2024",IND @ ATL,W,26,5,9,0.556,0,3,0.0,2,3,0.667,2,5,7,4,2,2,3,2,12,9,1,IND,ATL,IND,126,,,23,19,16,11
Myles Turner,C,22023,1626167,22300520,"JAN 10, 2024",IND vs. WAS,W,31,7,15,0.467,1,5,0.2,3,3,1.0,6,7,13,3,0,2,2,3,18,4,1,IND,IND,WAS,112,,,34,31,21,16
Myles Turner,C,22023,1626167,22300507,"JAN 08, 2024",IND vs. BOS,W,35,7,13,0.538,1,3,0.333,1,2,0.5,2,6,8,1,0,0,2,2,16,-1,1,IND,IND,BOS,133,,,25,24,17,9
Myles Turner,C,22023,1626167,22300480,"JAN 05, 2024",IND vs. ATL,W,22,10,14,0.714,2,3,0.667,5,5,1.0,2,3,5,3,1,1,1,0,27,25,1,IND,IND,ATL,148,,,35,32,30,8
Myles Turner,C,22023,1626167,22300466,"JAN 03, 2024",IND vs. MIL,W,30,6,9,0.667,1,4,0.25,2,4,0.5,0,7,7,2,0,2,2,4,15,15,1,IND,IND,MIL,142,,,24,22,17,9
Myles Turner,C,22023,1626167,22300377,"DEC 21, 2023",IND @ MEM,L,36,5,10,0.5,0,2,0.0,5,5,1.0,3,3,6,2,1,4,4,5,15,-2,1,IND,MEM,IND,103,,,23,21,17,8
Myles Turner,C,22023,1626167,22300365,"DEC 20, 2023",IND vs. CHA,W,25,5,9,0.556,1,4,0.25,7,7,1.0,1,5,6,0,0,2,1,2,18,19,1,IND,IND,CHA,142,,,24,24,18,6
Myles Turner,C,22023,1626167,22300338,"DEC 16, 2023",IND @ MIN,L,21,2,7,0.286,1,2,0.5,7,8,0.875,2,3,5,0,1,0,1,1,12,-15,1,IND,MIN,IND,109,,,17,17,12,5
Myles Turner,C,22023,1626167,22300328,"DEC 15, 2023",IND @ WAS,L,20,2,10,0.2,1,4,0.25,1,2,0.5,2,2,4,1,0,3,1,1,6,-17,1,IND,WAS,IND,123,,,11,10,7,5
Myles Turner,C,22023,1626167,22300315,"DEC 13, 2023",IND @ MIL,L,33,8,14,0.571,2,2,1.0,4,4,1.0,4,5,9,0,0,2,2,4,22,-5,1,IND,MIL,IND,126,,,31,31,22,9
Myles Turner,C,22023,1626167,22300293,"DEC 11, 2023",IND @ DET,W,31,10,15,0.667,0,2,0.0,3,6,0.5,3,5,8,1,1,3,2,2,23,12,1,IND,DET,IND,131,,,32,31,24,9
Myles Turner,C,22023,1626167,22301229,"DEC 07, 2023",IND @ MIL,W,32,9,18,0.5,2,8,0.25,6,8,0.75,1,9,10,2,1,3,0,2,26,-5,1,IND,MIL,IND,128,,,38,36,28,12
Myles Turner,C,22023,1626167,22301202,"DEC 04, 2023",IND vs. BOS,W,34,7,16,0.438,2,6,0.333,1,1,1.0,1,9,10,1,1,1,0,1,17,22,1,IND,IND,BOS,122,,,28,27,18,11
Myles Turner,C,22023,1626167,22300284,"DEC 02, 2023",IND @ MIA,W,30,8,12,0.667,1,4,0.25,0,0,0.0,2,8,10,1,0,2,2,4,17,10,1,IND,MIA,IND,144,,,28,27,18,11
Myles Turner,C,22023,1626167,22300267,"NOV 30, 2023",IND @ MIA,L,29,5,14,0.357,0,5,0.0,3,5,0.6,4,5,9,2,0,1,0,3,13,-13,1,IND,MIA,IND,132,,,24,22,15,11
Myles Turner,C,22023,1626167,22300254,"NOV 27, 2023",IND vs. POR,L,27,5,11,0.455,0,3,0.0,1,1,1.0,1,7,8,0,2,2,1,4,11,2,1,IND,IND,POR,110,,,19,19,11,8
Myles Turner,C,22023,1626167,22300047,"NOV 24, 2023",IND vs. DET,W,27,8,14,0.571,1,3,0.333,6,6,1.0,5,5,10,2,1,5,2,5,23,23,1,IND,IND,DET,136,,,35,33,25,12
Myles Turner,C,22023,1626167,22300230,"NOV 22, 2023",IND vs. TOR,L,29,7,11,0.636,2,3,0.667,1,2,0.5,1,7,8,0,1,2,2,3,17,13,1,IND,IND,TOR,131,,,25,25,17,8
Myles Turner,C,22023,1626167,22300039,"NOV 21, 2023",IND @ ATL,W,25,4,7,0.571,0,2,0.0,3,4,0.75,1,8,9,1,0,4,1,3,11,5,1,IND,ATL,IND,157,,,21,20,12,10
Myles Turner,C,22023,1626167,22300209,"NOV 19, 2023",IND vs. ORL,L,23,3,10,0.3,0,3,0.0,4,6,0.667,3,1,4,3,1,3,1,2,10,-20,1,IND,IND,ORL,116,,,17,14,13,7
Myles Turner,C,22023,1626167,22300019,"NOV 14, 2023",IND @ PHI,W,19,5,11,0.455,1,4,0.25,6,8,0.75,1,2,3,0,1,1,1,6,17,5,1,IND,PHI,IND,132,,,20,20,17,3
Myles Turner,C,22023,1626167,22300180,"NOV 12, 2023",IND @ PHI,L,29,7,17,0.412,4,9,0.444,4,4,1.0,2,3,5,0,1,3,3,4,22,-6,1,IND,PHI,IND,126,,,27,27,22,5
Myles Turner,C,22023,1626167,22300171,"NOV 09, 2023",IND vs. MIL,W,37,8,16,0.5,4,9,0.444,1,1,1.0,1,5,6,4,0,1,1,4,21,14,1,IND,IND,MIL,126,,,31,27,25,10
Myles Turner,C,22023,1626167,22300158,"NOV 08, 2023",IND vs. UTA,W,23,8,12,0.667,0,2,0.0,6,8,0.75,3,3,6,0,0,3,0,2,22,3,1,IND,IND,UTA,134,,,28,28,22,6
Myles Turner,C,22023,1626167,22300146,"NOV 06, 2023",IND vs. SAS,W,21,5,7,0.714,1,1,1.0,4,4,1.0,4,7,11,2,0,1,0,3,15,19,1,IND,IND,SAS,152,,,28,26,17,13
Myles Turner,C,22023,1626167,22300133,"NOV 04, 2023",IND vs. CHA,L,27,5,9,0.556,3,5,0.6,1,2,0.5,0,6,6,2,1,0,4,4,14,12,1,IND,IND,CHA,124,,,22,20,16,8
Myles Turner,C,22023,1626167,22300001,"NOV 03, 2023",IND vs. CLE,W,31,9,14,0.643,4,5,0.8,5,6,0.833,1,8,9,0,2,2,3,4,27,11,1,IND,IND,CLE,121,,,36,36,27,9
Myles Turner,C,22023,1626167,22300118,"NOV 01, 2023",IND @ BOS,L,22,4,12,0.333,0,3,0.0,0,0,0.0,1,4,5,3,1,1,1,1,8,-20,1,IND,BOS,IND,104,,,16,13,11,8
Myles Turner,C,22023,1626167,22300102,"OCT 30, 2023",IND vs. CHI,L,32,6,14,0.429,3,8,0.375,5,8,0.625,2,9,11,3,0,2,1,2,20,-9,1,IND,IND,CHI,105,,,34,31,23,14
Myles Turner,C,22023,1626167,22300091,"OCT 28, 2023",IND @ CLE,W,29,7,14,0.5,1,5,0.2,5,5,1.0,1,11,12,1,0,2,2,5,20,-5,1,IND,CLE,IND,125,,,33,32,21,13
Myles Turner,C,22023,1626167,22300064,"OCT 25, 2023",IND vs. WAS,W,23,5,8,0.625,0,2,0.0,1,2,0.5,0,8,8,1,0,3,2,4,11,14,1,IND,IND,WAS,143,,,20,19,12,9
Myles Turner,C,22023,1626167,22300707,"FEB 04, 2024",IND @ CHA,W,26,7,14,0.5,0,3,0.0,2,2,1.0,3,7,10,2,1,0,0,3,16,16,1,IND,CHA,IND,115,,,28,26,18,12
Myles Turner,C,22023,1626167,22300627,"JAN 25, 2024",IND vs. PHI,W,27,7,12,0.583,3,6,0.5,3,4,0.75,3,6,9,1,1,2,1,4,20,21,1,IND,IND,PHI,134,,,30,29,21,10
Myles Turner,C,22023,1626167,22300564,"JAN 15, 2024",IND @ UTA,L,17,4,8,0.5,1,2,0.5,3,4,0.75,1,3,4,0,0,0,2,5,12,-8,1,IND,UTA,IND,105,,,16,16,12,4
Myles Turner,C,22023,1626167,22300493,"JAN 06, 2024",IND vs. BOS,L,30,5,11,0.455,0,5,0.0,2,4,0.5,3,4,7,2,0,0,0,3,12,-11,1,IND,IND,BOS,101,,,21,19,14,9
Myles Turner,C,22023,1626167,22300755,"FEB 10, 2024",IND @ NYK,W,31,9,9,1.0,2,2,1.0,3,4,0.75,0,8,8,4,1,0,2,4,23,5,1,IND,NYK,IND,125,,,35,31,27,12
Myles Turner,C,22023,1626167,22300733,"FEB 08, 2024",IND vs. GSW,L,23,5,12,0.417,2,5,0.4,3,6,0.5,0,7,7,1,0,1,1,3,15,-13,1,IND,IND,GSW,109,,,23,22,16,8
Myles Turner,C,22023,1626167,22300719,"FEB 06, 2024",IND vs. HOU,W,29,8,16,0.5,2,6,0.333,3,4,0.75,0,3,3,2,1,2,1,6,21,0,1,IND,IND,HOU,132,,,26,24,23,5
Myles Turner,C,22023,1626167,22300685,"FEB 01, 2024",IND @ NYK,L,24,2,6,0.333,0,0,0.0,1,3,0.333,0,4,4,1,1,0,1,5,5,-6,1,IND,NYK,IND,105,,,10,9,6,5
Myles Turner,C,22023,1626167,22300670,"JAN 30, 2024",IND @ BOS,L,26,7,18,0.389,2,7,0.286,1,4,0.25,1,4,5,1,0,1,3,4,17,7,1,IND,BOS,IND,124,,,23,22,18,6
Myles Turner,C,22023,1626167,22300590,"JAN 19, 2024",IND @ POR,L,34,10,17,0.588,6,10,0.6,3,3,1.0,2,10,12,1,0,5,1,3,29,6,1,IND,POR,IND,115,,,42,41,30,13
Myles Turner,C,22023,1626167,22300454,"JAN 01, 2024",IND @ MIL,W,28,3,5,0.6,0,2,0.0,7,7,1.0,1,3,4,0,0,2,0,5,13,-20,1,IND,MIL,IND,122,,,17,17,13,4
Myles Turner,C,22023,1626167,22300441,"DEC 30, 2023",IND vs. NYK,W,31,10,17,0.588,6,8,0.75,2,3,0.667,1,7,8,2,0,0,1,0,28,17,1,IND,IND,NYK,140,,,38,36,30,10
Myles Turner,C,22023,1626167,22300422,"DEC 28, 2023",IND @ CHI,W,26,8,12,0.667,1,2,0.5,7,7,1.0,0,6,6,0,0,3,3,5,24,30,1,IND,CHI,IND,120,,,30,30,24,6
Myles Turner,C,22023,1626167,22300409,"DEC 26, 2023",IND @ HOU,W,24,5,9,0.556,2,3,0.667,6,7,0.857,1,4,5,1,0,2,0,5,18,4,1,IND,HOU,IND,123,,,24,23,19,6
Myles Turner,C,22023,1626167,22300391,"DEC 23, 2023",IND vs. ORL,L,29,9,11,0.818,2,4,0.5,4,4,1.0,1,6,7,0,1,4,1,4,24,18,1,IND,IND,ORL,110,,,31,31,24,7
Myles Turner,C,22023,1626167,22300636,"JAN 26, 2024",IND vs. PHX,W,18,2,6,0.333,0,2,0.0,1,1,1.0,0,3,3,2,0,0,2,2,5,-2,1,IND,IND,PHX,133,,,10,8,7,5
Myles Turner,C,22023,1626167,22300614,"JAN 23, 2024",IND vs. DEN,L,37,8,18,0.444,0,5,0.0,6,7,0.857,0,6,6,1,1,0,2,3,22,-9,1,IND,IND,DEN,109,,,29,28,23,7
Myles Turner,C,22023,1626167,22300604,"JAN 21, 2024",IND @ PHX,L,19,5,11,0.455,1,2,0.5,1,2,0.5,1,1,2,1,0,2,1,1,12,-25,1,IND,PHX,IND,110,,,15,14,13,3
Myles Turner,C,22023,1626167,22300583,"JAN 18, 2024",IND @ SAC,W,32,6,12,0.5,1,4,0.25,5,7,0.714,0,2,2,1,0,1,1,4,18,-8,1,IND,SAC,IND,126,,,21,20,19,3
Bogdan Bogdanovic,G,22023,203992,22300754,"FEB 10, 2024",ATL vs. HOU,W,31,3,12,0.25,1,6,0.167,1,1,1.0,1,6,7,2,0,0,2,4,8,13,1,ATL,ATL,HOU,122,,,17,15,10,9
Bogdan Bogdanovic,G,22023,203992,22300742,"FEB 09, 2024",ATL @ PHI,W,34,5,12,0.417,3,7,0.429,0,0,0.0,2,1,3,3,0,3,0,2,13,1,1,ATL,PHI,ATL,127,,,19,16,16,6
Bogdan Bogdanovic,G,22023,203992,22300729,"FEB 07, 2024",ATL @ BOS,L,35,5,18,0.278,2,10,0.2,0,0,0.0,2,4,6,3,1,0,0,3,12,-4,1,ATL,BOS,ATL,117,,,21,18,15,9
Bogdan Bogdanovic,G,22023,203992,22300716,"FEB 05, 2024",ATL vs. LAC,L,27,6,12,0.5,4,8,0.5,0,0,0.0,1,2,3,6,1,0,0,4,16,4,1,ATL,ATL,LAC,144,,,25,19,22,9
Bogdan Bogdanovic,G,22023,203992,22300690,"FEB 02, 2024",ATL vs. PHX,W,34,8,12,0.667,4,7,0.571,3,3,1.0,1,3,4,5,0,0,0,2,23,13,1,ATL,ATL,PHX,129,,,32,27,28,9
Bogdan Bogdanovic,G,22023,203992,22300669,"JAN 30, 2024",ATL vs. LAL,W,25,7,15,0.467,4,9,0.444,0,0,0.0,0,1,1,1,0,0,1,1,18,6,1,ATL,ATL,LAL,138,,,20,19,19,2
Bogdan Bogdanovic,G,22023,203992,22300653,"JAN 28, 2024",ATL vs. TOR,W,39,7,11,0.636,4,8,0.5,6,7,0.857,0,4,4,2,2,2,5,4,24,17,1,ATL,ATL,TOR,126,,,30,28,26,6
Bogdan Bogdanovic,G,22023,203992,22300634,"JAN 26, 2024",ATL vs. DAL,L,27,9,22,0.409,4,9,0.444,2,2,1.0,2,2,4,2,2,0,0,2,24,3,1,ATL,ATL,DAL,143,,,30,28,26,6
Bogdan Bogdanovic,G,22023,203992,22300626,"JAN 24, 2024",ATL @ GSW,L,33,6,11,0.545,4,9,0.444,1,1,1.0,0,0,0,3,1,0,1,1,17,-6,1,ATL,GSW,ATL,112,,,20,17,20,3
Bogdan Bogdanovic,G,22023,203992,22300613,"JAN 22, 2024",ATL @ SAC,L,34,5,12,0.417,2,8,0.25,6,6,1.0,0,2,2,4,0,0,2,4,18,-21,1,ATL,SAC,ATL,107,,,24,20,22,6
Bogdan Bogdanovic,G,22023,203992,22300595,"JAN 20, 2024",ATL vs. CLE,L,28,5,11,0.455,1,6,0.167,3,4,0.75,0,2,2,4,1,0,1,0,14,-13,1,ATL,ATL,CLE,95,,,20,16,18,6
Bogdan Bogdanovic,G,22023,203992,22300587,"JAN 19, 2024",ATL @ MIA,W,35,6,15,0.4,3,7,0.429,2,2,1.0,0,3,3,1,0,0,3,2,17,1,1,ATL,MIA,ATL,109,,,21,20,18,4
Bogdan Bogdanovic,G,22023,203992,22300570,"JAN 17, 2024",ATL vs. ORL,W,24,4,7,0.571,2,4,0.5,2,2,1.0,1,3,4,1,1,1,1,1,12,4,1,ATL,ATL,ORL,106,,,17,16,13,5
Bogdan Bogdanovic,G,22023,203992,22300559,"JAN 15, 2024",ATL vs. SAS,W,26,2,10,0.2,1,6,0.167,0,0,0.0,0,2,2,1,1,0,3,2,5,4,1,ATL,ATL,SAS,109,,,8,7,6,3
Bogdan Bogdanovic,G,22023,203992,22300543,"JAN 13, 2024",ATL vs. WAS,L,24,5,13,0.385,3,8,0.375,1,1,1.0,1,2,3,2,3,0,0,2,14,-20,1,ATL,ATL,WAS,99,,,19,17,16,5
Bogdan Bogdanovic,G,22023,203992,22300533,"JAN 12, 2024",ATL vs. IND,L,25,3,12,0.25,2,5,0.4,2,2,1.0,3,2,5,2,3,0,2,2,10,-24,1,ATL,ATL,IND,108,,,17,15,12,7
Bogdan Bogdanovic,G,22023,203992,22300521,"JAN 10, 2024",ATL vs. PHI,W,28,7,16,0.438,1,8,0.125,0,1,0.0,0,2,2,4,2,0,1,1,15,12,1,ATL,ATL,PHI,139,,,21,17,19,6
Bogdan Bogdanovic,G,22023,203992,22300499,"JAN 07, 2024",ATL @ ORL,L,26,7,17,0.412,4,9,0.444,0,0,0.0,1,2,3,1,4,0,0,5,18,13,1,ATL,ORL,ATL,110,,,22,21,19,4
Bogdan Bogdanovic,G,22023,203992,22300480,"JAN 05, 2024",ATL @ IND,L,23,3,14,0.214,1,9,0.111,9,10,0.9,0,4,4,3,2,0,3,2,16,-18,1,ATL,IND,ATL,116,,,23,20,19,7
Bogdan Bogdanovic,G,22023,203992,22300467,"JAN 03, 2024",ATL vs. OKC,W,28,7,16,0.438,5,11,0.455,4,4,1.0,0,1,1,4,1,0,0,2,23,11,1,ATL,ATL,OKC,141,,,28,24,27,5
Bogdan Bogdanovic,G,22023,203992,22300445,"DEC 31, 2023",ATL @ WAS,W,27,5,19,0.263,1,8,0.125,1,1,1.0,0,1,1,1,0,0,0,1,12,24,1,ATL,WAS,ATL,130,,,14,13,13,2
Bogdan Bogdanovic,G,22023,203992,22300431,"DEC 29, 2023",ATL vs. SAC,L,27,4,14,0.286,2,10,0.2,2,2,1.0,2,2,4,5,0,0,1,1,12,-14,1,ATL,ATL,SAC,110,,,21,16,17,9
Bogdan Bogdanovic,G,22023,203992,22300408,"DEC 26, 2023",ATL @ CHI,L,31,8,21,0.381,3,12,0.25,3,3,1.0,1,2,3,1,0,0,0,2,22,3,1,ATL,CHI,ATL,113,,,26,25,23,4
Bogdan Bogdanovic,G,22023,203992,22300393,"DEC 23, 2023",ATL vs. MEM,L,34,6,15,0.4,2,8,0.25,2,3,0.667,1,3,4,3,0,0,0,2,16,-1,1,ATL,ATL,MEM,119,,,23,20,19,7
Bogdan Bogdanovic,G,22023,203992,22300384,"DEC 22, 2023",ATL @ MIA,L,35,8,24,0.333,6,18,0.333,1,2,0.5,1,1,2,5,1,0,0,3,23,-8,1,ATL,MIA,ATL,113,,,30,25,28,7
Bogdan Bogdanovic,G,22023,203992,22300371,"DEC 20, 2023",ATL @ HOU,W,30,8,14,0.571,4,8,0.5,2,2,1.0,0,4,4,5,1,1,0,3,22,14,1,ATL,HOU,ATL,134,,,31,26,27,9
Bogdan Bogdanovic,G,22023,203992,22300330,"DEC 15, 2023",ATL @ TOR,W,33,7,16,0.438,3,7,0.429,3,3,1.0,0,3,3,6,0,0,0,2,20,21,1,ATL,TOR,ATL,125,,,29,23,26,9
Bogdan Bogdanovic,G,22023,203992,22300313,"DEC 13, 2023",ATL @ TOR,L,32,7,13,0.538,4,7,0.571,2,3,0.667,1,2,3,5,4,0,1,4,20,5,1,ATL,TOR,ATL,128,,,28,23,25,8
Bogdan Bogdanovic,G,22023,203992,22300296,"DEC 11, 2023",ATL vs. DEN,L,36,14,24,0.583,10,17,0.588,2,2,1.0,1,2,3,3,2,0,1,4,40,-2,1,ATL,ATL,DEN,122,,,46,43,43,6
Bogdan Bogdanovic,G,22023,203992,22301218,"DEC 08, 2023",ATL @ PHI,L,39,7,17,0.412,3,11,0.273,3,3,1.0,1,8,9,2,1,0,2,5,20,-3,1,ATL,PHI,ATL,114,,,31,29,22,11
Bogdan Bogdanovic,G,22023,203992,22301209,"DEC 06, 2023",ATL vs. BKN,L,27,7,14,0.5,4,9,0.444,2,2,1.0,0,4,4,1,0,0,0,2,20,-6,1,ATL,ATL,BKN,113,,,25,24,21,5
Bogdan Bogdanovic,G,22023,203992,22300286,"DEC 02, 2023",ATL @ MIL,L,25,6,18,0.333,2,7,0.286,0,0,0.0,0,3,3,0,2,1,0,2,14,-7,1,ATL,MIL,ATL,121,,,17,17,14,3
Bogdan Bogdanovic,G,22023,203992,22300272,"NOV 30, 2023",ATL @ SAS,W,32,5,10,0.5,2,4,0.5,2,2,1.0,0,2,2,3,2,0,1,4,14,12,1,ATL,SAS,ATL,137,,,19,16,17,5
Bogdan Bogdanovic,G,22023,203992,22300055,"NOV 28, 2023",ATL @ CLE,L,31,6,16,0.375,4,10,0.4,2,2,1.0,1,5,6,1,2,0,1,2,18,-3,1,ATL,CLE,ATL,105,,,25,24,19,7
Bogdan Bogdanovic,G,22023,203992,22300246,"NOV 26, 2023",ATL @ BOS,L,32,8,12,0.667,7,10,0.7,0,0,0.0,1,6,7,0,1,0,4,3,23,-1,1,ATL,BOS,ATL,103,,,30,30,23,7
Bogdan Bogdanovic,G,22023,203992,22300241,"NOV 25, 2023",ATL @ WAS,W,21,6,9,0.667,3,3,1.0,0,1,0.0,0,3,3,1,1,0,2,3,15,13,1,ATL,WAS,ATL,136,,,19,18,16,4
Bogdan Bogdanovic,G,22023,203992,22300227,"NOV 22, 2023",ATL vs. BKN,W,26,5,15,0.333,3,11,0.273,1,1,1.0,1,3,4,3,1,1,1,4,14,17,1,ATL,ATL,BKN,147,,,21,18,17,7
Bogdan Bogdanovic,G,22023,203992,22300039,"NOV 21, 2023",ATL vs. IND,L,26,10,15,0.667,2,5,0.4,4,4,1.0,0,2,2,0,0,0,0,4,26,-2,1,ATL,ATL,IND,152,,,28,28,26,2
Bogdan Bogdanovic,G,22023,203992,22300029,"NOV 17, 2023",ATL vs. PHI,L,24,4,12,0.333,3,8,0.375,2,3,0.667,0,2,2,3,3,0,3,3,13,-14,1,ATL,ATL,PHI,116,,,18,15,16,5
Bogdan Bogdanovic,G,22023,203992,22300193,"NOV 15, 2023",ATL vs. NYK,L,29,8,15,0.533,4,11,0.364,8,8,1.0,1,2,3,3,2,1,1,4,28,11,1,ATL,ATL,NYK,114,,,34,31,31,6
Bogdan Bogdanovic,G,22023,203992,22300018,"NOV 14, 2023",ATL @ DET,W,34,7,17,0.412,3,11,0.273,0,0,0.0,0,3,3,3,0,1,3,0,17,5,1,ATL,DET,ATL,126,,,23,20,20,6
Bogdan Bogdanovic,G,22023,203992,22300175,"NOV 11, 2023",ATL vs. MIA,L,29,5,13,0.385,5,12,0.417,0,0,0.0,0,3,3,1,0,0,2,4,15,-3,1,ATL,ATL,MIA,109,,,19,18,16,4
Bogdan Bogdanovic,G,22023,203992,22300172,"NOV 09, 2023",ATL @ ORL,W,29,6,11,0.545,3,6,0.5,0,0,0.0,0,4,4,3,3,0,1,3,15,-4,1,ATL,ORL,ATL,120,,,22,19,18,7
Bogdan Bogdanovic,G,22023,203992,22300155,"NOV 06, 2023",ATL @ OKC,L,27,7,14,0.5,3,8,0.375,0,0,0.0,0,2,2,3,2,0,0,1,17,3,1,ATL,OKC,ATL,117,,,22,19,20,5
Bogdan Bogdanovic,G,22023,203992,22300135,"NOV 04, 2023",ATL @ NOP,W,21,4,14,0.286,2,10,0.2,0,0,0.0,3,2,5,2,1,2,0,1,10,7,1,ATL,NOP,ATL,123,,,17,15,12,7
Bogdan Bogdanovic,G,22023,203992,22300117,"NOV 01, 2023",ATL vs. WAS,W,23,4,10,0.4,1,5,0.2,3,3,1.0,0,3,3,1,1,1,1,2,12,8,1,ATL,ATL,WAS,130,,,16,15,13,4
Bogdan Bogdanovic,G,22023,203992,22300104,"OCT 30, 2023",ATL vs. MIN,W,20,3,10,0.3,2,7,0.286,0,0,0.0,0,1,1,4,1,0,1,1,8,3,1,ATL,ATL,MIN,127,,,13,9,12,5
Bogdan Bogdanovic,G,22023,203992,22300097,"OCT 29, 2023",ATL @ MIL,W,26,6,10,0.6,4,7,0.571,1,1,1.0,0,1,1,6,2,0,2,1,17,12,1,ATL,MIL,ATL,127,,,24,18,23,7
Bogdan Bogdanovic,G,22023,203992,22300079,"OCT 27, 2023",ATL vs. NYK,L,26,6,11,0.545,4,9,0.444,0,0,0.0,0,1,1,3,1,0,2,3,16,0,1,ATL,ATL,NYK,120,,,20,17,19,4
Bogdan Bogdanovic,G,22023,203992,22300063,"OCT 25, 2023",ATL @ CHA,L,24,3,9,0.333,1,5,0.2,0,0,0.0,0,4,4,4,3,0,0,1,7,6,1,ATL,CHA,ATL,110,,,15,11,11,8
Bogdan Bogdanovic,G,22023,203992,22300699,"FEB 03, 2024",ATL vs. GSW,W,38,5,16,0.313,2,10,0.2,1,1,1.0,0,4,4,4,2,0,2,3,13,1,1,ATL,ATL,GSW,141,,,21,17,17,8
D'Angelo Russell,G,22023,1626156,22300605,"JAN 21, 2024",LAL vs. POR,W,34,14,21,0.667,6,11,0.545,0,0,0.0,1,0,1,8,0,2,0,2,34,29,1,LAL,LAL,POR,134,,,43,35,42,9
D'Angelo Russell,G,22023,1626156,22300271,"NOV 30, 2023",LAL @ OKC,L,32,6,13,0.462,2,5,0.4,2,2,1.0,1,2,3,10,1,0,2,3,16,-4,1,LAL,OKC,LAL,110,,,29,19,26,13
D'Angelo Russell,G,22023,1626156,22300163,"NOV 08, 2023",LAL @ HOU,L,28,9,18,0.5,4,7,0.571,0,0,0.0,0,2,2,4,0,3,1,1,22,-18,1,LAL,HOU,LAL,94,,,28,24,26,6
D'Angelo Russell,G,22023,1626156,22300134,"NOV 04, 2023",LAL @ ORL,L,35,4,17,0.235,1,10,0.1,2,2,1.0,2,2,4,4,0,0,1,2,11,-17,1,LAL,ORL,LAL,101,,,19,15,15,8
D'Angelo Russell,G,22023,1626156,22300713,"FEB 05, 2024",LAL @ CHA,W,40,10,21,0.476,5,12,0.417,3,3,1.0,0,4,4,6,1,0,3,2,28,-2,1,LAL,CHA,LAL,124,,,38,32,34,10
D'Angelo Russell,G,22023,1626156,22300701,"FEB 03, 2024",LAL @ NYK,W,27,5,14,0.357,2,7,0.286,4,4,1.0,0,1,1,4,0,1,0,4,16,-6,1,LAL,NYK,LAL,113,,,21,17,20,5
D'Angelo Russell,G,22023,1626156,22300684,"FEB 01, 2024",LAL @ BOS,W,39,5,20,0.25,4,8,0.5,2,4,0.5,2,6,8,14,2,0,1,1,16,4,1,LAL,BOS,LAL,114,,,38,24,30,22
D'Angelo Russell,G,22023,1626156,22300669,"JAN 30, 2024",LAL @ ATL,L,27,3,11,0.273,1,5,0.2,2,2,1.0,0,1,1,5,0,0,2,2,9,-11,1,LAL,ATL,LAL,122,,,15,10,14,6
D'Angelo Russell,G,22023,1626156,22300662,"JAN 29, 2024",LAL @ HOU,L,41,8,19,0.421,3,12,0.25,4,5,0.8,0,1,1,5,1,0,1,0,23,-19,1,LAL,HOU,LAL,119,,,29,24,28,6
D'Angelo Russell,G,22023,1626156,22300650,"JAN 27, 2024",LAL @ GSW,W,49,8,19,0.421,5,8,0.625,7,7,1.0,1,2,3,5,2,1,4,4,28,12,1,LAL,GSW,LAL,145,,,36,31,33,8
D'Angelo Russell,G,22023,1626156,22300633,"JAN 25, 2024",LAL vs. CHI,W,38,10,18,0.556,8,13,0.615,1,2,0.5,0,0,0,4,1,1,2,3,29,7,1,LAL,LAL,CHI,141,,,33,29,33,4
D'Angelo Russell,G,22023,1626156,22300618,"JAN 23, 2024",LAL @ LAC,L,40,9,21,0.429,4,10,0.4,5,6,0.833,2,3,5,10,0,1,5,3,27,-7,1,LAL,LAC,LAL,116,,,42,32,37,15
D'Angelo Russell,G,22023,1626156,22300591,"JAN 19, 2024",LAL vs. BKN,L,35,7,14,0.5,3,5,0.6,3,3,1.0,0,1,1,7,1,0,2,4,20,-16,1,LAL,LAL,BKN,112,,,28,21,27,8
D'Angelo Russell,G,22023,1626156,22300577,"JAN 17, 2024",LAL vs. DAL,W,36,11,20,0.55,5,7,0.714,2,2,1.0,1,3,4,3,0,0,1,0,29,16,1,LAL,LAL,DAL,127,,,36,33,32,7
D'Angelo Russell,G,22023,1626156,22300565,"JAN 15, 2024",LAL vs. OKC,W,36,5,12,0.417,2,7,0.286,2,2,1.0,1,1,2,6,2,1,5,2,14,3,1,LAL,LAL,OKC,112,,,22,16,20,8
D'Angelo Russell,G,22023,1626156,22300549,"JAN 13, 2024",LAL @ UTA,L,41,15,26,0.577,6,11,0.545,3,3,1.0,0,3,3,8,1,2,3,3,39,-2,1,LAL,UTA,LAL,125,,,50,42,47,11
D'Angelo Russell,G,22023,1626156,22300531,"JAN 11, 2024",LAL vs. PHX,L,27,7,14,0.5,3,7,0.429,2,4,0.5,0,1,1,6,2,0,3,2,19,2,1,LAL,LAL,PHX,109,,,26,20,25,7
D'Angelo Russell,G,22023,1626156,22300516,"JAN 09, 2024",LAL vs. TOR,W,17,4,8,0.5,2,6,0.333,1,2,0.5,1,0,1,5,0,0,2,1,11,7,1,LAL,LAL,TOR,132,,,17,12,16,6
D'Angelo Russell,G,22023,1626156,22300505,"JAN 07, 2024",LAL vs. LAC,W,31,5,14,0.357,3,9,0.333,0,0,0.0,0,0,0,6,1,1,3,2,13,5,1,LAL,LAL,LAC,106,,,19,13,19,6
D'Angelo Russell,G,22023,1626156,22300428,"DEC 28, 2023",LAL vs. CHA,W,29,5,10,0.5,4,7,0.571,2,2,1.0,0,3,3,9,0,0,1,3,16,18,1,LAL,LAL,CHA,133,,,28,19,25,12
D'Angelo Russell,G,22023,1626156,22300370,"DEC 20, 2023",LAL @ CHI,L,28,1,6,0.167,0,4,0.0,0,0,0.0,0,1,1,2,0,0,1,2,2,3,1,LAL,CHI,LAL,108,,,5,3,4,3
D'Angelo Russell,G,22023,1626156,22300316,"DEC 13, 2023",LAL @ SAS,W,33,6,13,0.462,0,4,0.0,0,1,0.0,0,3,3,10,3,0,3,4,12,-6,1,LAL,SAS,LAL,122,,,25,15,22,13
D'Angelo Russell,G,22023,1626156,22300306,"DEC 12, 2023",LAL @ DAL,L,25,3,9,0.333,1,4,0.25,0,0,0.0,0,2,2,7,0,0,2,4,7,-6,1,LAL,DAL,LAL,125,,,16,9,14,9
D'Angelo Russell,G,22023,1626156,22301230,"DEC 07, 2023",LAL vs. NOP,W,22,6,10,0.6,2,5,0.4,0,0,0.0,0,3,3,1,1,0,4,1,14,23,1,LAL,LAL,NOP,133,,,18,17,15,4
D'Angelo Russell,G,22023,1626156,22301203,"DEC 05, 2023",LAL vs. PHX,W,24,3,11,0.273,2,6,0.333,0,0,0.0,1,0,1,5,0,0,0,2,8,-7,1,LAL,LAL,PHX,106,,,14,9,13,6
D'Angelo Russell,G,22023,1626156,22300291,"DEC 02, 2023",LAL vs. HOU,W,26,4,10,0.4,1,5,0.2,0,0,0.0,0,2,2,7,5,0,0,2,9,8,1,LAL,LAL,HOU,107,,,18,11,16,9
D'Angelo Russell,G,22023,1626156,22300258,"NOV 29, 2023",LAL @ DET,W,34,13,17,0.765,5,7,0.714,4,5,0.8,0,4,4,9,1,2,3,0,35,31,1,LAL,DET,LAL,133,,,48,39,44,13
D'Angelo Russell,G,22023,1626156,22300255,"NOV 27, 2023",LAL @ PHI,L,24,5,10,0.5,1,2,0.5,1,2,0.5,0,2,2,7,0,0,0,0,12,-8,1,LAL,PHI,LAL,94,,,21,14,19,9
D'Angelo Russell,G,22023,1626156,22300242,"NOV 25, 2023",LAL @ CLE,W,32,4,12,0.333,2,6,0.333,0,0,0.0,0,5,5,5,2,0,4,3,10,3,1,LAL,CLE,LAL,121,,,20,15,15,10
D'Angelo Russell,G,22023,1626156,22300238,"NOV 22, 2023",LAL vs. DAL,L,24,5,11,0.455,2,4,0.5,3,3,1.0,0,3,3,5,0,1,1,1,15,1,1,LAL,LAL,DAL,101,,,23,18,20,8
D'Angelo Russell,G,22023,1626156,22300042,"NOV 21, 2023",LAL vs. UTA,W,26,7,9,0.778,3,4,0.75,3,5,0.6,0,3,3,8,0,1,0,2,20,30,1,LAL,LAL,UTA,131,,,31,23,28,11
D'Angelo Russell,G,22023,1626156,22300036,"NOV 17, 2023",LAL @ POR,W,29,5,10,0.5,4,7,0.571,0,1,0.0,1,2,3,6,0,0,4,1,14,2,1,LAL,POR,LAL,107,,,23,17,20,9
D'Angelo Russell,G,22023,1626156,22300198,"NOV 15, 2023",LAL vs. SAC,L,35,12,20,0.6,4,6,0.667,0,0,0.0,3,2,5,5,0,1,2,3,28,-13,1,LAL,LAL,SAC,110,,,38,33,33,10
D'Angelo Russell,G,22023,1626156,22300026,"NOV 14, 2023",LAL vs. MEM,W,27,8,12,0.667,6,8,0.75,2,3,0.667,0,3,3,5,0,0,0,0,24,25,1,LAL,LAL,MEM,134,,,32,27,29,8
D'Angelo Russell,G,22023,1626156,22300187,"NOV 12, 2023",LAL vs. POR,W,32,5,14,0.357,0,3,0.0,1,2,0.5,1,4,5,11,1,0,1,2,11,4,1,LAL,LAL,POR,116,,,27,16,22,16
D'Angelo Russell,G,22023,1626156,22300150,"NOV 06, 2023",LAL @ MIA,L,29,6,10,0.6,1,3,0.333,0,0,0.0,0,4,4,6,0,1,3,2,13,-4,1,LAL,MIA,LAL,107,,,23,17,19,10
D'Angelo Russell,G,22023,1626156,22300127,"NOV 01, 2023",LAL vs. LAC,W,36,10,19,0.526,3,7,0.429,4,4,1.0,0,2,2,6,0,0,3,2,27,3,1,LAL,LAL,LAC,130,,,35,29,33,8
D'Angelo Russell,G,22023,1626156,22300061,"OCT 24, 2023",LAL @ DEN,L,36,4,12,0.333,2,5,0.4,1,2,0.5,0,4,4,7,1,0,3,3,11,1,1,LAL,DEN,LAL,107,,,22,15,18,11
D'Angelo Russell,G,22023,1626156,22300747,"FEB 09, 2024",LAL vs. NOP,W,40,9,19,0.474,6,13,0.462,6,6,1.0,0,2,2,5,1,0,0,4,30,13,1,LAL,LAL,NOP,139,,,37,32,35,7
D'Angelo Russell,G,22023,1626156,22300443,"DEC 30, 2023",LAL @ MIN,L,20,1,4,0.25,0,1,0.0,3,4,0.75,0,1,1,3,0,0,1,1,5,-19,1,LAL,MIN,LAL,106,,,9,6,8,4
D'Angelo Russell,G,22023,1626156,22300403,"DEC 25, 2023",LAL vs. BOS,L,18,4,6,0.667,0,1,0.0,0,0,0.0,0,1,1,6,1,0,2,1,8,-3,1,LAL,LAL,BOS,115,,,15,9,14,7
D'Angelo Russell,G,22023,1626156,22300397,"DEC 23, 2023",LAL @ OKC,W,17,5,9,0.556,3,6,0.5,2,3,0.667,0,1,1,3,0,0,1,1,15,0,1,LAL,OKC,LAL,129,,,19,16,18,4
D'Angelo Russell,G,22023,1626156,22300380,"DEC 21, 2023",LAL @ MIN,L,38,7,19,0.368,2,6,0.333,1,1,1.0,0,4,4,8,2,3,4,1,17,-4,1,LAL,MIN,LAL,111,,,29,21,25,12
D'Angelo Russell,G,22023,1626156,22300359,"DEC 18, 2023",LAL vs. NYK,L,28,3,10,0.3,3,6,0.5,0,0,0.0,0,3,3,4,1,0,0,1,9,-4,1,LAL,LAL,NYK,109,,,16,12,13,7
D'Angelo Russell,G,22023,1626156,22300216,"NOV 19, 2023",LAL vs. HOU,W,24,1,8,0.125,1,5,0.2,1,2,0.5,0,5,5,2,3,0,3,1,4,-7,1,LAL,LAL,HOU,105,,,11,9,6,7
D'Angelo Russell,G,22023,1626156,22300015,"NOV 10, 2023",LAL @ PHX,W,29,6,12,0.5,0,3,0.0,7,9,0.778,0,3,3,9,0,1,1,4,19,1,1,LAL,PHX,LAL,122,,,31,22,28,12
D'Angelo Russell,G,22023,1626156,22300111,"OCT 30, 2023",LAL vs. ORL,W,36,10,14,0.714,3,6,0.5,5,5,1.0,0,2,2,8,1,1,3,4,28,7,1,LAL,LAL,ORL,106,,,38,30,36,10
D'Angelo Russell,G,22023,1626156,22300100,"OCT 29, 2023",LAL @ SAC,L,41,5,13,0.385,1,5,0.2,6,7,0.857,0,3,3,9,0,0,0,4,17,-7,1,LAL,SAC,LAL,127,,,29,20,26,12
D'Angelo Russell,G,22023,1626156,22300076,"OCT 26, 2023",LAL vs. PHX,W,33,6,16,0.375,1,7,0.143,1,1,1.0,0,4,4,5,2,1,3,2,14,8,1,LAL,LAL,PHX,100,,,23,18,19,9
Nikola Vucevic,C,22023,202696,22300139,"NOV 04, 2023",CHI @ DEN,L,30,8,17,0.471,1,2,0.5,2,2,1.0,2,5,7,3,0,0,2,3,19,-27,1,CHI,DEN,CHI,101,,,29,26,22,10
Nikola Vucevic,C,22023,202696,22300737,"FEB 08, 2024",CHI @ MEM,W,39,7,19,0.368,3,7,0.429,3,3,1.0,2,8,10,5,0,2,3,1,20,19,1,CHI,MEM,CHI,118,,,35,30,25,15
Nikola Vucevic,C,22023,202696,22300723,"FEB 06, 2024",CHI vs. MIN,W,43,10,16,0.625,2,4,0.5,2,2,1.0,1,5,6,2,0,4,0,5,24,5,1,CHI,CHI,MIN,129,,,32,30,26,8
Nikola Vucevic,C,22023,202696,22300700,"FEB 03, 2024",CHI vs. SAC,L,34,10,18,0.556,1,4,0.25,3,3,1.0,2,10,12,3,1,0,2,2,24,-3,1,CHI,CHI,SAC,115,,,39,36,27,15
Nikola Vucevic,C,22023,202696,22300674,"JAN 31, 2024",CHI @ CHA,W,33,10,22,0.455,1,4,0.25,1,2,0.5,3,9,12,3,0,2,0,0,22,3,1,CHI,CHA,CHI,117,,,37,34,25,15
Nikola Vucevic,C,22023,202696,22300672,"JAN 30, 2024",CHI vs. TOR,L,36,5,11,0.455,2,5,0.4,2,2,1.0,1,8,9,3,2,1,1,2,14,-11,1,CHI,CHI,TOR,107,,,26,23,17,12
Nikola Vucevic,C,22023,202696,22300656,"JAN 28, 2024",CHI @ POR,W,34,6,14,0.429,0,4,0.0,2,2,1.0,0,7,7,3,0,3,0,2,14,4,1,CHI,POR,CHI,104,,,24,21,17,10
Nikola Vucevic,C,22023,202696,22300633,"JAN 25, 2024",CHI @ LAL,L,39,9,12,0.75,2,3,0.667,0,0,0.0,3,5,8,1,0,1,2,2,20,-7,1,CHI,LAL,CHI,132,,,29,28,21,9
Nikola Vucevic,C,22023,202696,22300612,"JAN 22, 2024",CHI @ PHX,L,37,9,17,0.529,1,5,0.2,0,0,0.0,5,12,17,7,0,0,1,2,19,10,1,CHI,PHX,CHI,113,,,43,36,26,24
Nikola Vucevic,C,22023,202696,22300597,"JAN 20, 2024",CHI vs. MEM,W,25,5,8,0.625,1,3,0.333,0,0,0.0,2,9,11,3,0,0,2,3,11,7,1,CHI,CHI,MEM,125,,,25,22,14,14
Nikola Vucevic,C,22023,202696,22300580,"JAN 18, 2024",CHI @ TOR,W,35,12,20,0.6,0,3,0.0,0,0,0.0,5,9,14,7,2,1,0,1,24,23,1,CHI,TOR,CHI,116,,,45,38,31,21
Nikola Vucevic,C,22023,202696,22300561,"JAN 15, 2024",CHI @ CLE,L,37,8,19,0.421,1,7,0.143,0,0,0.0,0,10,10,4,0,0,2,3,17,-8,1,CHI,CLE,CHI,91,,,31,27,21,14
Nikola Vucevic,C,22023,202696,22300548,"JAN 13, 2024",CHI @ SAS,W,31,10,17,0.588,2,5,0.4,2,3,0.667,3,13,16,5,0,3,1,2,24,13,1,CHI,SAS,CHI,122,,,45,40,29,21
Nikola Vucevic,C,22023,202696,22300506,"JAN 08, 2024",CHI @ CHA,W,30,10,18,0.556,1,3,0.333,0,0,0.0,3,7,10,4,1,1,1,4,21,-9,1,CHI,CHA,CHI,119,,,35,31,25,14
Nikola Vucevic,C,22023,202696,22300484,"JAN 05, 2024",CHI vs. CHA,W,25,5,12,0.417,1,5,0.2,0,0,0.0,0,7,7,3,0,0,1,3,11,5,1,CHI,CHI,CHA,104,,,21,18,14,10
Nikola Vucevic,C,22023,202696,22300396,"DEC 23, 2023",CHI vs. CLE,L,34,7,11,0.636,2,5,0.4,4,4,1.0,1,11,12,4,1,1,1,1,20,-12,1,CHI,CHI,CLE,95,,,36,32,24,16
Nikola Vucevic,C,22023,202696,22300376,"DEC 21, 2023",CHI vs. SAS,W,27,8,19,0.421,0,7,0.0,0,0,0.0,1,4,5,3,1,0,2,2,16,3,1,CHI,CHI,SAS,114,,,24,21,19,8
Nikola Vucevic,C,22023,202696,22300370,"DEC 20, 2023",CHI vs. LAL,W,31,4,13,0.308,3,5,0.6,2,2,1.0,1,9,10,2,1,1,1,2,13,6,1,CHI,CHI,LAL,124,,,25,23,15,12
Nikola Vucevic,C,22023,202696,22300351,"DEC 18, 2023",CHI @ PHI,W,34,10,18,0.556,3,7,0.429,0,0,0.0,3,5,8,4,0,2,2,4,23,-4,1,CHI,PHI,CHI,108,,,35,31,27,12
Nikola Vucevic,C,22023,202696,22300337,"DEC 16, 2023",CHI @ MIA,L,32,3,13,0.231,1,4,0.25,5,6,0.833,4,7,11,3,1,0,2,1,12,-5,1,CHI,MIA,CHI,116,,,26,23,15,14
Nikola Vucevic,C,22023,202696,22300320,"DEC 14, 2023",CHI @ MIA,W,36,10,21,0.476,2,5,0.4,2,2,1.0,2,10,12,7,2,0,0,2,24,12,1,CHI,MIA,CHI,124,,,43,36,31,19
Nikola Vucevic,C,22023,202696,22300307,"DEC 12, 2023",CHI vs. DEN,L,33,12,21,0.571,1,4,0.25,1,1,1.0,4,12,16,5,0,2,3,1,26,-5,1,CHI,CHI,DEN,106,,,47,42,31,21
Nikola Vucevic,C,22023,202696,22300300,"DEC 11, 2023",CHI @ MIL,L,39,6,16,0.375,2,5,0.4,0,0,0.0,1,9,10,5,1,1,1,5,14,-2,1,CHI,MIL,CHI,129,,,29,24,19,15
Nikola Vucevic,C,22023,202696,22301223,"DEC 08, 2023",CHI @ SAS,W,36,9,22,0.409,0,2,0.0,3,3,1.0,10,6,16,2,0,1,0,2,21,15,1,CHI,SAS,CHI,121,,,39,37,23,18
Nikola Vucevic,C,22023,202696,22301211,"DEC 06, 2023",CHI vs. CHA,W,34,8,17,0.471,2,3,0.667,2,2,1.0,6,6,12,3,0,1,2,0,20,2,1,CHI,CHI,CHA,111,,,35,32,23,15
Nikola Vucevic,C,22023,202696,22300285,"DEC 02, 2023",CHI vs. NOP,W,33,3,12,0.25,0,5,0.0,0,0,0.0,3,4,7,4,0,3,1,1,6,8,1,CHI,CHI,NOP,124,,,17,13,10,11
Nikola Vucevic,C,22023,202696,22300269,"NOV 30, 2023",CHI vs. MIL,W,40,11,21,0.524,2,4,0.5,5,6,0.833,1,9,10,6,1,0,4,2,29,-6,1,CHI,CHI,MIL,120,,,45,39,35,16
Nikola Vucevic,C,22023,202696,22300053,"NOV 28, 2023",CHI @ BOS,L,25,4,11,0.364,0,2,0.0,0,0,0.0,0,8,8,2,2,1,1,1,8,-26,1,CHI,BOS,CHI,97,,,18,16,10,10
Nikola Vucevic,C,22023,202696,22300250,"NOV 26, 2023",CHI @ BKN,L,37,3,9,0.333,0,3,0.0,0,0,0.0,1,8,9,5,1,1,2,5,6,2,1,CHI,BKN,CHI,109,,,20,15,11,14
Nikola Vucevic,C,22023,202696,22300046,"NOV 24, 2023",CHI @ TOR,L,36,4,8,0.5,1,2,0.5,0,0,0.0,0,8,8,5,1,0,1,3,9,-4,1,CHI,TOR,CHI,108,,,22,17,14,13
Nikola Vucevic,C,22023,202696,22300234,"NOV 22, 2023",CHI @ OKC,L,37,6,13,0.462,2,5,0.4,2,2,1.0,5,7,12,3,2,0,1,4,16,-3,1,CHI,OKC,CHI,102,,,31,28,19,15
Nikola Vucevic,C,22023,202696,22300220,"NOV 20, 2023",CHI vs. MIA,L,32,7,16,0.438,0,4,0.0,4,4,1.0,2,6,8,2,0,0,2,4,18,-22,1,CHI,CHI,MIA,100,,,28,26,20,10
Nikola Vucevic,C,22023,202696,22300204,"NOV 18, 2023",CHI vs. MIA,W,33,7,14,0.5,1,5,0.2,0,0,0.0,1,7,8,0,1,1,2,2,15,-5,1,CHI,CHI,MIA,102,,,23,23,15,8
Nikola Vucevic,C,22023,202696,22300033,"NOV 17, 2023",CHI vs. ORL,L,30,4,16,0.25,0,3,0.0,2,2,1.0,3,7,10,6,0,0,1,4,10,-4,1,CHI,CHI,ORL,97,,,26,20,16,16
Nikola Vucevic,C,22023,202696,22300196,"NOV 15, 2023",CHI vs. ORL,L,36,8,18,0.444,0,4,0.0,1,1,1.0,3,6,9,3,0,1,5,4,17,4,1,CHI,CHI,ORL,94,,,29,26,20,12
Nikola Vucevic,C,22023,202696,22300190,"NOV 13, 2023",CHI @ MIL,L,36,11,24,0.458,2,7,0.286,2,3,0.667,6,6,12,5,1,1,1,5,26,-1,1,CHI,MIL,CHI,109,,,43,38,31,17
Nikola Vucevic,C,22023,202696,22300181,"NOV 12, 2023",CHI vs. DET,W,33,8,17,0.471,3,7,0.429,2,2,1.0,2,10,12,4,2,1,1,2,21,6,1,CHI,CHI,DET,119,,,37,33,25,16
Nikola Vucevic,C,22023,202696,22300162,"NOV 08, 2023",CHI vs. PHX,L,41,11,19,0.579,2,5,0.4,2,3,0.667,2,4,6,3,1,1,2,5,26,-16,1,CHI,CHI,PHX,115,,,35,32,29,9
Nikola Vucevic,C,22023,202696,22300152,"NOV 06, 2023",CHI vs. UTA,W,31,5,11,0.455,0,2,0.0,0,0,0.0,1,7,8,4,1,1,0,1,10,18,1,CHI,CHI,UTA,130,,,22,18,14,12
Nikola Vucevic,C,22023,202696,22300004,"NOV 03, 2023",CHI vs. BKN,L,36,6,13,0.462,1,1,1.0,0,0,0.0,6,7,13,3,0,0,0,1,13,8,1,CHI,CHI,BKN,107,,,29,26,16,16
Nikola Vucevic,C,22023,202696,22300124,"NOV 01, 2023",CHI @ DAL,L,36,10,17,0.588,1,3,0.333,0,0,0.0,5,15,20,1,2,0,3,2,21,-6,1,CHI,DAL,CHI,105,,,42,41,22,21
Nikola Vucevic,C,22023,202696,22300102,"OCT 30, 2023",CHI @ IND,W,34,10,19,0.526,0,1,0.0,4,6,0.667,5,12,17,3,1,0,1,3,24,0,1,CHI,IND,CHI,112,,,44,41,27,20
Nikola Vucevic,C,22023,202696,22300088,"OCT 28, 2023",CHI @ DET,L,32,5,11,0.455,1,2,0.5,1,1,1.0,0,4,4,1,0,0,1,5,12,-11,1,CHI,DET,CHI,102,,,17,16,13,5
Nikola Vucevic,C,22023,202696,22300082,"OCT 27, 2023",CHI vs. TOR,W,40,4,15,0.267,1,5,0.2,2,3,0.667,3,9,12,1,0,1,3,2,11,0,1,CHI,CHI,TOR,104,,,24,23,12,13
Nikola Vucevic,C,22023,202696,22300070,"OCT 25, 2023",CHI vs. OKC,L,32,5,8,0.625,0,2,0.0,1,1,1.0,1,8,9,4,3,2,4,2,11,-19,1,CHI,CHI,OKC,104,,,24,20,15,13
Nikola Vucevic,C,22023,202696,22300752,"FEB 10, 2024",CHI @ ORL,L,43,12,25,0.48,1,7,0.143,1,2,0.5,9,8,17,4,3,1,0,3,26,1,1,CHI,ORL,CHI,108,,,47,43,30,21
Nikola Vucevic,C,22023,202696,22300536,"JAN 12, 2024",CHI vs. GSW,L,33,6,12,0.5,2,5,0.4,0,0,0.0,2,5,7,2,0,0,3,1,14,-7,1,CHI,CHI,GSW,131,,,23,21,16,9
Nikola Vucevic,C,22023,202696,22300523,"JAN 10, 2024",CHI vs. HOU,W,41,9,17,0.529,0,5,0.0,0,0,0.0,3,12,15,3,0,1,0,4,18,16,1,CHI,CHI,HOU,124,,,36,33,21,18
Fred VanVleet,G,22023,1627832,22300709,"FEB 04, 2024",HOU @ MIN,L,32,4,11,0.364,2,6,0.333,1,1,1.0,0,3,3,1,2,4,2,1,11,-27,1,HOU,MIN,HOU,90,,,15,14,12,4
Fred VanVleet,G,22023,1627832,22300692,"FEB 02, 2024",HOU vs. TOR,W,25,4,7,0.571,2,4,0.5,0,0,0.0,0,2,2,6,0,1,1,3,10,13,1,HOU,HOU,TOR,135,,,18,12,16,8
Fred VanVleet,G,22023,1627832,22300679,"JAN 31, 2024",HOU vs. NOP,L,37,6,12,0.5,2,6,0.333,2,2,1.0,0,3,3,5,2,0,0,1,16,-5,1,HOU,HOU,NOP,99,,,24,19,21,8
Fred VanVleet,G,22023,1627832,22300662,"JAN 29, 2024",HOU vs. LAL,W,37,0,4,0.0,0,4,0.0,3,4,0.75,1,3,4,14,2,0,2,3,3,17,1,HOU,HOU,LAL,135,,,21,7,17,18
Fred VanVleet,G,22023,1627832,22300645,"JAN 27, 2024",HOU @ BKN,L,39,4,12,0.333,1,9,0.111,4,6,0.667,0,4,4,8,1,0,4,5,13,8,1,HOU,BKN,HOU,104,,,25,17,21,12
Fred VanVleet,G,22023,1627832,22300635,"JAN 26, 2024",HOU @ CHA,W,30,5,9,0.556,3,5,0.6,1,1,1.0,0,3,3,3,1,6,0,3,14,26,1,HOU,CHA,HOU,138,,,20,17,17,6
Fred VanVleet,G,22023,1627832,22300623,"JAN 24, 2024",HOU vs. POR,L,46,8,17,0.471,2,10,0.2,0,0,0.0,0,6,6,7,3,3,2,1,18,-6,1,HOU,HOU,POR,131,,,31,24,25,13
Fred VanVleet,G,22023,1627832,22300598,"JAN 20, 2024",HOU vs. UTA,W,34,8,19,0.421,2,10,0.2,0,0,0.0,2,3,5,7,1,3,2,6,18,-3,1,HOU,HOU,UTA,127,,,30,23,25,12
Fred VanVleet,G,22023,1627832,22300573,"JAN 17, 2024",HOU @ NYK,L,41,8,19,0.421,5,12,0.417,3,3,1.0,0,3,3,12,1,0,1,3,24,-7,1,HOU,NYK,HOU,94,,,39,27,36,15
Fred VanVleet,G,22023,1627832,22300555,"JAN 15, 2024",HOU @ PHI,L,33,2,5,0.4,2,4,0.5,2,4,0.5,0,1,1,5,0,2,1,4,8,-12,1,HOU,PHI,HOU,115,,,14,9,13,6
Fred VanVleet,G,22023,1627832,22300542,"JAN 13, 2024",HOU @ BOS,L,23,2,6,0.333,1,3,0.333,0,0,0.0,1,0,1,7,0,1,0,2,5,-15,1,HOU,BOS,HOU,113,,,13,6,12,8
Fred VanVleet,G,22023,1627832,22300409,"DEC 26, 2023",HOU vs. IND,L,40,7,18,0.389,1,7,0.143,3,3,1.0,0,4,4,9,2,1,3,2,18,-11,1,HOU,HOU,IND,117,,,31,22,27,13
Fred VanVleet,G,22023,1627832,22300392,"DEC 23, 2023",HOU @ NOP,W,36,3,11,0.273,2,7,0.286,2,3,0.667,0,0,0,3,1,0,1,1,10,1,1,HOU,NOP,HOU,106,,,13,10,13,3
Fred VanVleet,G,22023,1627832,22300385,"DEC 22, 2023",HOU vs. DAL,W,26,3,8,0.375,1,5,0.2,3,3,1.0,0,2,2,4,1,0,0,2,10,29,1,HOU,HOU,DAL,122,,,16,12,14,6
Fred VanVleet,G,22023,1627832,22300371,"DEC 20, 2023",HOU vs. ATL,L,44,10,20,0.5,3,7,0.429,9,9,1.0,0,4,4,15,1,0,2,3,32,-2,1,HOU,HOU,ATL,127,,,51,36,47,19
Fred VanVleet,G,22023,1627832,22300349,"DEC 18, 2023",HOU @ CLE,L,45,9,19,0.474,4,8,0.5,5,5,1.0,0,8,8,17,2,1,2,4,27,2,1,HOU,CLE,HOU,130,,,52,35,44,25
Fred VanVleet,G,22023,1627832,22300346,"DEC 17, 2023",HOU @ MIL,L,39,8,16,0.5,4,8,0.5,2,2,1.0,1,1,2,6,1,2,1,2,22,-6,1,HOU,MIL,HOU,119,,,30,24,28,8
Fred VanVleet,G,22023,1627832,22300332,"DEC 15, 2023",HOU @ MEM,W,36,5,12,0.417,2,4,0.5,4,5,0.8,1,5,6,8,4,2,0,2,16,2,1,HOU,MEM,HOU,103,,,30,22,24,14
Fred VanVleet,G,22023,1627832,22300314,"DEC 13, 2023",HOU vs. MEM,W,39,2,8,0.25,0,3,0.0,7,9,0.778,0,5,5,9,3,0,3,4,11,18,1,HOU,HOU,MEM,117,,,25,16,20,14
Fred VanVleet,G,22023,1627832,22300298,"DEC 11, 2023",HOU vs. SAS,W,39,6,17,0.353,4,11,0.364,0,0,0.0,0,6,6,5,2,0,3,0,16,9,1,HOU,HOU,SAS,93,,,27,22,21,11
Fred VanVleet,G,22023,1627832,22301224,"DEC 08, 2023",HOU @ DEN,W,40,6,17,0.353,4,10,0.4,10,13,0.769,1,3,4,3,0,1,1,3,26,16,1,HOU,DEN,HOU,114,,,33,30,29,7
Fred VanVleet,G,22023,1627832,22301212,"DEC 06, 2023",HOU vs. OKC,W,38,4,14,0.286,3,7,0.429,0,0,0.0,0,3,3,9,3,1,3,0,11,11,1,HOU,HOU,OKC,110,,,23,14,20,12
Fred VanVleet,G,22023,1627832,22300291,"DEC 02, 2023",HOU @ LAL,L,40,7,15,0.467,4,7,0.571,4,4,1.0,1,4,5,7,0,0,3,1,22,-22,1,HOU,LAL,HOU,97,,,34,27,29,12
Fred VanVleet,G,22023,1627832,22300059,"NOV 28, 2023",HOU @ DAL,L,41,3,9,0.333,1,7,0.143,3,3,1.0,0,4,4,12,1,1,0,3,10,-12,1,HOU,DAL,HOU,115,,,26,14,22,16
Fred VanVleet,G,22023,1627832,22300048,"NOV 24, 2023",HOU vs. DEN,W,39,6,12,0.5,3,5,0.6,2,2,1.0,0,6,6,11,1,2,1,3,17,30,1,HOU,HOU,DEN,105,,,34,23,28,17
Fred VanVleet,G,22023,1627832,22300231,"NOV 22, 2023",HOU vs. MEM,W,39,5,12,0.417,4,8,0.5,2,3,0.667,1,6,7,4,2,0,1,0,16,22,1,HOU,HOU,MEM,111,,,27,23,20,11
Fred VanVleet,G,22023,1627832,22300224,"NOV 20, 2023",HOU @ GSW,L,41,3,13,0.231,1,8,0.125,3,3,1.0,0,5,5,14,0,0,0,2,10,-3,1,HOU,GSW,HOU,116,,,29,15,24,19
Fred VanVleet,G,22023,1627832,22300216,"NOV 19, 2023",HOU @ LAL,L,40,5,14,0.357,3,10,0.3,2,2,1.0,0,1,1,16,1,0,3,1,15,4,1,HOU,LAL,HOU,104,,,32,16,31,17
Fred VanVleet,G,22023,1627832,22300037,"NOV 17, 2023",HOU @ LAC,L,41,7,14,0.5,5,9,0.556,0,0,0.0,1,7,8,10,1,1,2,0,19,-14,1,HOU,LAC,HOU,100,,,37,27,29,18
Fred VanVleet,G,22023,1627832,22300182,"NOV 12, 2023",HOU vs. DEN,W,41,9,21,0.429,3,9,0.333,5,7,0.714,0,2,2,4,0,0,2,2,26,-4,1,HOU,HOU,DEN,107,,,32,28,30,6
Fred VanVleet,G,22023,1627832,22300011,"NOV 10, 2023",HOU vs. NOP,W,40,7,15,0.467,4,9,0.444,2,2,1.0,1,2,3,8,1,1,1,2,20,-8,1,HOU,HOU,NOP,104,,,31,23,28,11
Fred VanVleet,G,22023,1627832,22300163,"NOV 08, 2023",HOU vs. LAL,W,29,2,9,0.222,1,6,0.167,4,4,1.0,1,3,4,10,1,0,1,2,9,28,1,HOU,HOU,LAL,128,,,23,13,19,14
Fred VanVleet,G,22023,1627832,22300153,"NOV 06, 2023",HOU vs. SAC,W,27,3,8,0.375,3,5,0.6,2,2,1.0,0,4,4,5,0,0,1,1,11,34,1,HOU,HOU,SAC,122,,,20,15,16,9
Fred VanVleet,G,22023,1627832,22300137,"NOV 04, 2023",HOU vs. SAC,W,36,7,22,0.318,4,14,0.286,3,3,1.0,0,6,6,12,0,2,2,4,21,13,1,HOU,HOU,SAC,107,,,39,27,33,18
Fred VanVleet,G,22023,1627832,22300122,"NOV 01, 2023",HOU vs. CHA,W,39,8,17,0.471,5,10,0.5,1,1,1.0,0,3,3,11,0,0,2,1,22,14,1,HOU,HOU,CHA,128,,,36,25,33,14
Fred VanVleet,G,22023,1627832,22300096,"OCT 29, 2023",HOU vs. GSW,L,32,2,13,0.154,2,7,0.286,2,2,1.0,0,0,0,4,2,0,0,2,8,-13,1,HOU,HOU,GSW,95,,,12,8,12,4
Fred VanVleet,G,22023,1627832,22300083,"OCT 27, 2023",HOU @ SAS,L,45,10,20,0.5,2,10,0.2,2,3,0.667,0,8,8,12,0,0,3,5,24,-9,1,HOU,SAS,HOU,122,,,44,32,36,20
Fred VanVleet,G,22023,1627832,22300066,"OCT 25, 2023",HOU @ ORL,L,34,5,13,0.385,4,6,0.667,0,0,0.0,0,1,1,5,1,0,3,0,14,-3,1,HOU,ORL,HOU,86,,,20,15,19,6
Fred VanVleet,G,22023,1627832,22300534,"JAN 12, 2024",HOU @ DET,W,43,7,15,0.467,3,9,0.333,3,3,1.0,1,3,4,12,2,2,0,5,20,12,1,HOU,DET,HOU,112,,,36,24,32,16
Fred VanVleet,G,22023,1627832,22300485,"JAN 05, 2024",HOU vs. MIN,L,31,2,9,0.222,2,5,0.4,1,1,1.0,0,1,1,8,1,1,1,0,7,-13,1,HOU,HOU,MIN,95,,,16,8,15,9
Fred VanVleet,G,22023,1627832,22300469,"JAN 03, 2024",HOU vs. BKN,W,36,7,9,0.778,6,8,0.75,1,2,0.5,0,6,6,10,0,2,4,2,21,24,1,HOU,HOU,BKN,112,,,37,27,31,16
Fred VanVleet,G,22023,1627832,22300453,"JAN 01, 2024",HOU vs. DET,W,26,6,11,0.545,3,6,0.5,0,0,0.0,0,1,1,7,1,0,1,1,15,20,1,HOU,HOU,DET,136,,,23,16,22,8
Fred VanVleet,G,22023,1627832,22300418,"DEC 27, 2023",HOU vs. PHX,L,29,4,11,0.364,1,3,0.333,1,2,0.5,1,1,2,6,0,0,1,2,10,-14,1,HOU,HOU,PHX,113,,,18,12,16,8
Fred VanVleet,G,22023,1627832,22300434,"DEC 29, 2023",HOU vs. PHI,L,43,9,16,0.563,8,12,0.667,7,8,0.875,0,3,3,10,1,1,5,3,33,-3,1,HOU,HOU,PHI,127,,,46,36,43,13
Fred VanVleet,G,22023,1627832,22300523,"JAN 10, 2024",HOU @ CHI,L,42,7,19,0.368,3,14,0.214,3,4,0.75,0,6,6,10,1,3,2,3,20,-10,1,HOU,CHI,HOU,119,,,36,26,30,16
Fred VanVleet,G,22023,1627832,22300509,"JAN 08, 2024",HOU @ MIA,L,39,10,22,0.455,7,14,0.5,5,5,1.0,2,3,5,7,0,2,1,2,32,-3,1,HOU,MIA,HOU,113,,,44,37,39,12
Fred VanVleet,G,22023,1627832,22300496,"JAN 06, 2024",HOU vs. MIL,W,37,4,13,0.308,3,10,0.3,3,3,1.0,1,1,2,7,2,0,1,3,14,-4,1,HOU,HOU,MIL,112,,,23,16,21,9
Keldon Johnson,F,22023,1629640,22300750,"FEB 10, 2024",SAS @ BKN,L,30,7,14,0.5,3,6,0.5,2,2,1.0,1,3,4,1,0,1,2,2,19,-17,1,SAS,BKN,SAS,103,,,24,23,20,5
Keldon Johnson,F,22023,1629640,22300665,"JAN 29, 2024",SAS vs. WAS,L,31,5,10,0.5,2,5,0.4,2,2,1.0,0,5,5,3,3,0,2,1,14,-4,1,SAS,SAS,WAS,113,,,22,19,17,8
Keldon Johnson,F,22023,1629640,22300649,"JAN 27, 2024",SAS vs. MIN,W,27,6,14,0.429,1,3,0.333,1,2,0.5,5,2,7,2,2,2,1,2,14,0,1,SAS,SAS,MIN,113,,,23,21,16,9
Keldon Johnson,F,22023,1629640,22300584,"JAN 19, 2024",SAS @ CHA,L,29,9,15,0.6,4,8,0.5,3,4,0.75,0,4,4,3,0,0,1,3,25,-3,1,SAS,CHA,SAS,120,,,32,29,28,7
Keldon Johnson,F,22023,1629640,22300571,"JAN 17, 2024",SAS @ BOS,L,23,2,4,0.5,1,2,0.5,0,0,0.0,0,2,2,1,1,0,0,1,5,-17,1,SAS,BOS,SAS,95,,,8,7,6,3
Keldon Johnson,F,22023,1629640,22300559,"JAN 15, 2024",SAS @ ATL,L,26,1,11,0.091,0,5,0.0,3,5,0.6,2,4,6,0,1,0,5,4,5,-4,1,SAS,ATL,SAS,99,,,11,11,5,6
Keldon Johnson,F,22023,1629640,22300548,"JAN 13, 2024",SAS vs. CHI,L,30,8,14,0.571,4,5,0.8,6,6,1.0,0,4,4,5,0,1,2,2,26,-1,1,SAS,SAS,CHI,116,,,35,30,31,9
Keldon Johnson,F,22023,1629640,22300541,"JAN 12, 2024",SAS vs. CHA,W,19,3,11,0.273,2,7,0.286,2,2,1.0,0,2,2,1,1,0,2,2,10,6,1,SAS,SAS,CHA,127,,,13,12,11,3
Keldon Johnson,F,22023,1629640,22300519,"JAN 10, 2024",SAS @ DET,W,25,4,8,0.5,1,2,0.5,8,8,1.0,0,1,1,3,2,1,0,2,17,12,1,SAS,DET,SAS,129,,,21,18,20,4
Keldon Johnson,F,22023,1629640,22300497,"JAN 07, 2024",SAS @ CLE,L,33,6,16,0.375,3,6,0.5,3,4,0.75,3,1,4,2,1,0,0,3,18,-12,1,SAS,CLE,SAS,115,,,24,22,20,6
Keldon Johnson,F,22023,1629640,22300477,"JAN 04, 2024",SAS vs. MIL,L,30,5,17,0.294,2,8,0.25,2,2,1.0,2,8,10,1,0,0,1,1,14,7,1,SAS,SAS,MIL,121,,,25,24,15,11
Keldon Johnson,F,22023,1629640,22300460,"JAN 02, 2024",SAS @ MEM,L,31,7,16,0.438,1,4,0.25,4,5,0.8,1,5,6,4,1,0,3,4,19,-15,1,SAS,MEM,SAS,98,,,29,25,23,10
Keldon Johnson,F,22023,1629640,22300437,"DEC 29, 2023",SAS @ POR,L,32,9,18,0.5,3,8,0.375,8,11,0.727,2,5,7,7,1,0,1,4,29,6,1,SAS,POR,SAS,128,,,43,36,36,14
Keldon Johnson,F,22023,1629640,22300361,"DEC 19, 2023",SAS @ MIL,L,35,9,13,0.692,0,1,0.0,10,12,0.833,2,10,12,1,0,0,5,2,28,-5,1,SAS,MIL,SAS,119,,,41,40,29,13
Keldon Johnson,F,22023,1629640,22300278,"DEC 01, 2023",SAS @ NOP,L,33,4,7,0.571,1,3,0.333,2,2,1.0,1,6,7,3,1,0,2,2,11,-7,1,SAS,NOP,SAS,106,,,21,18,14,10
Keldon Johnson,F,22023,1629640,22300235,"NOV 22, 2023",SAS vs. LAC,L,36,5,13,0.385,2,8,0.25,3,3,1.0,2,1,3,6,0,1,0,4,15,0,1,SAS,SAS,LAC,102,,,24,18,21,9
Keldon Johnson,F,22023,1629640,22300206,"NOV 18, 2023",SAS vs. MEM,L,33,8,14,0.571,4,7,0.571,2,3,0.667,0,3,3,1,0,0,0,1,22,-13,1,SAS,SAS,MEM,108,,,26,25,23,4
Keldon Johnson,F,22023,1629640,22300161,"NOV 08, 2023",SAS @ NYK,L,33,4,9,0.444,1,4,0.25,0,2,0.0,0,7,7,8,0,0,3,4,9,-21,1,SAS,NYK,SAS,105,,,24,16,17,15
Keldon Johnson,F,22023,1629640,22300146,"NOV 06, 2023",SAS @ IND,L,23,6,12,0.5,0,0,0.0,4,5,0.8,1,2,3,3,0,0,1,1,16,-19,1,SAS,IND,SAS,111,,,22,19,19,6
Keldon Johnson,F,22023,1629640,22300099,"OCT 29, 2023",SAS @ LAC,L,24,1,9,0.111,1,5,0.2,2,2,1.0,0,5,5,1,1,0,0,4,5,-27,1,SAS,LAC,SAS,83,,,11,10,6,6
Keldon Johnson,F,22023,1629640,22300272,"NOV 30, 2023",SAS vs. ATL,L,33,8,15,0.533,2,3,0.667,4,5,0.8,4,7,11,3,1,0,2,2,22,-1,1,SAS,SAS,ATL,135,,,36,33,25,14
Keldon Johnson,F,22023,1629640,22300252,"NOV 26, 2023",SAS @ DEN,L,31,3,7,0.429,0,2,0.0,4,5,0.8,0,1,1,2,0,0,0,1,10,-16,1,SAS,DEN,SAS,120,,,13,11,12,3
Keldon Johnson,F,22023,1629640,22300051,"NOV 24, 2023",SAS @ GSW,L,34,8,13,0.615,3,7,0.429,3,5,0.6,4,8,12,4,2,0,3,3,22,5,1,SAS,GSW,SAS,112,,,38,34,26,16
Keldon Johnson,F,22023,1629640,22300223,"NOV 20, 2023",SAS vs. LAC,L,32,9,16,0.563,2,8,0.25,2,4,0.5,2,8,10,5,1,0,1,2,22,-10,1,SAS,SAS,LAC,99,,,37,32,27,15
Keldon Johnson,F,22023,1629640,22300032,"NOV 17, 2023",SAS vs. SAC,L,36,7,16,0.438,5,9,0.556,2,2,1.0,0,9,9,7,1,1,3,1,21,-12,1,SAS,SAS,SAC,120,,,37,30,28,16
Keldon Johnson,F,22023,1629640,22300184,"NOV 12, 2023",SAS vs. MIA,L,37,8,18,0.444,3,10,0.3,1,1,1.0,0,12,12,6,1,1,1,2,20,7,1,SAS,SAS,MIA,113,,,38,32,26,18
Keldon Johnson,F,22023,1629640,22300013,"NOV 10, 2023",SAS vs. MIN,L,33,2,10,0.2,0,3,0.0,2,4,0.5,0,5,5,1,0,0,1,2,6,-9,1,SAS,SAS,MIN,110,,,12,11,7,6
Keldon Johnson,F,22023,1629640,22300141,"NOV 05, 2023",SAS vs. TOR,L,38,11,18,0.611,2,4,0.5,2,2,1.0,1,5,6,3,2,0,0,1,26,-17,1,SAS,SAS,TOR,116,,,35,32,29,9
Keldon Johnson,F,22023,1629640,22300131,"NOV 02, 2023",SAS @ PHX,W,35,3,11,0.273,1,6,0.167,0,0,0.0,1,6,7,6,2,1,0,5,7,11,1,SAS,PHX,SAS,132,,,20,14,13,13
Keldon Johnson,F,22023,1629640,22300113,"OCT 31, 2023",SAS @ PHX,W,33,10,20,0.5,4,9,0.444,3,4,0.75,1,2,3,4,2,0,0,1,27,1,1,SAS,PHX,SAS,115,,,34,30,31,7
Keldon Johnson,F,22023,1629640,22300083,"OCT 27, 2023",SAS vs. HOU,W,35,8,14,0.571,3,7,0.429,1,2,0.5,2,2,4,4,0,1,3,5,20,-2,1,SAS,SAS,HOU,126,,,28,24,24,8
Keldon Johnson,F,22023,1629640,22300073,"OCT 25, 2023",SAS vs. DAL,L,32,7,15,0.467,1,3,0.333,2,3,0.667,2,7,9,7,0,0,3,4,17,0,1,SAS,SAS,DAL,119,,,33,26,24,16
Keldon Johnson,F,22023,1629640,22300734,"FEB 08, 2024",SAS @ ORL,L,24,5,12,0.417,2,7,0.286,0,0,0.0,0,4,4,1,0,0,1,1,12,5,1,SAS,ORL,SAS,111,,,17,16,13,5
Keldon Johnson,F,22023,1629640,22300730,"FEB 07, 2024",SAS @ MIA,L,25,3,10,0.3,0,4,0.0,1,1,1.0,3,3,6,0,0,1,0,3,7,-15,1,SAS,MIA,SAS,104,,,13,13,7,6
Keldon Johnson,F,22023,1629640,22300703,"FEB 03, 2024",SAS vs. CLE,L,22,7,11,0.636,2,3,0.667,1,2,0.5,2,3,5,0,1,0,1,2,17,-15,1,SAS,SAS,CLE,101,,,22,22,17,5
Keldon Johnson,F,22023,1629640,22300622,"JAN 24, 2024",SAS vs. OKC,L,19,3,8,0.375,0,2,0.0,1,1,1.0,0,0,0,1,1,1,2,0,7,-32,1,SAS,SAS,OKC,114,,,8,7,8,1
Keldon Johnson,F,22023,1629640,22300594,"JAN 20, 2024",SAS @ WAS,W,28,7,15,0.467,0,3,0.0,5,7,0.714,4,5,9,2,0,0,1,2,19,5,1,SAS,WAS,SAS,131,,,30,28,21,11
Keldon Johnson,F,22023,1629640,22300427,"DEC 28, 2023",SAS @ POR,W,31,4,11,0.364,1,6,0.167,0,0,0.0,0,3,3,2,1,0,2,5,9,1,1,SAS,POR,SAS,118,,,14,12,11,5
Keldon Johnson,F,22023,1629640,22300412,"DEC 26, 2023",SAS vs. UTA,L,30,9,20,0.45,3,7,0.429,5,6,0.833,2,2,4,3,0,0,1,0,26,-14,1,SAS,SAS,UTA,118,,,33,30,29,7
Keldon Johnson,F,22023,1629640,22300398,"DEC 23, 2023",SAS @ DAL,L,23,6,16,0.375,2,8,0.25,2,4,0.5,2,3,5,2,0,0,2,2,16,-8,1,SAS,DAL,SAS,119,,,23,21,18,7
Keldon Johnson,F,22023,1629640,22300376,"DEC 21, 2023",SAS @ CHI,L,32,5,13,0.385,0,2,0.0,1,3,0.333,2,4,6,2,0,0,3,3,11,-10,1,SAS,CHI,SAS,95,,,19,17,13,8
Keldon Johnson,F,22023,1629640,22300345,"DEC 17, 2023",SAS vs. NOP,L,32,6,18,0.333,0,4,0.0,1,2,0.5,4,4,8,3,4,0,5,2,13,-30,1,SAS,SAS,NOP,110,,,24,21,16,11
Keldon Johnson,F,22023,1629640,22300331,"DEC 15, 2023",SAS vs. LAL,W,31,6,16,0.375,3,8,0.375,2,2,1.0,1,1,2,6,0,0,2,1,17,4,1,SAS,SAS,LAL,129,,,25,19,23,8
Keldon Johnson,F,22023,1629640,22300316,"DEC 13, 2023",SAS vs. LAL,L,36,10,14,0.714,4,4,1.0,4,4,1.0,1,4,5,8,0,0,1,3,28,1,1,SAS,SAS,LAL,119,,,41,33,36,13
Keldon Johnson,F,22023,1629640,22300298,"DEC 11, 2023",SAS @ HOU,L,37,3,14,0.214,0,9,0.0,6,6,1.0,2,5,7,2,4,0,3,1,12,-18,1,SAS,HOU,SAS,82,,,21,19,14,9
Keldon Johnson,F,22023,1629640,22301223,"DEC 08, 2023",SAS vs. CHI,L,35,6,11,0.545,6,11,0.545,2,2,1.0,0,2,2,5,0,1,0,3,20,-7,1,SAS,SAS,CHI,112,,,27,22,25,7
Keldon Johnson,F,22023,1629640,22301210,"DEC 06, 2023",SAS @ MIN,L,32,8,15,0.533,1,2,0.5,4,5,0.8,1,9,10,3,2,1,4,4,21,-3,1,SAS,MIN,SAS,94,,,34,31,24,13
Keldon Johnson,F,22023,1629640,22300641,"JAN 26, 2024",SAS vs. POR,W,30,9,15,0.6,0,2,0.0,3,4,0.75,8,8,16,1,1,2,1,2,21,8,1,SAS,SAS,POR,116,,,38,37,22,17
Keldon Johnson,F,22023,1629640,22300608,"JAN 22, 2024",SAS @ PHI,L,21,4,12,0.333,0,4,0.0,0,0,0.0,0,2,2,0,0,0,1,3,8,4,1,SAS,PHI,SAS,123,,,10,10,8,2
Immanuel Quickley,G,22023,1630193,22300756,"FEB 10, 2024",TOR vs. CLE,L,32,4,10,0.4,2,4,0.5,0,0,0.0,1,2,3,4,1,0,0,1,10,-12,1,TOR,TOR,CLE,95,,,17,13,14,7
Immanuel Quickley,G,22023,1630193,22300388,"DEC 23, 2023",NYK vs. MIL,L,22,2,8,0.25,1,5,0.2,2,2,1.0,0,2,2,1,0,0,1,1,7,-11,1,NYK,NYK,MIL,109,,,10,9,8,3
Immanuel Quickley,G,22023,1630193,22300368,"DEC 20, 2023",NYK @ BKN,W,24,7,12,0.583,4,6,0.667,1,4,0.25,0,0,0,2,1,1,1,0,19,6,1,NYK,BKN,NYK,119,,,21,19,21,2
Immanuel Quickley,G,22023,1630193,22300343,"DEC 16, 2023",NYK @ LAC,L,19,3,8,0.375,0,3,0.0,3,4,0.75,0,4,4,3,0,0,0,0,9,3,1,NYK,LAC,NYK,120,,,16,13,12,7
Immanuel Quickley,G,22023,1630193,22300333,"DEC 15, 2023",NYK @ PHX,W,24,3,8,0.375,1,3,0.333,3,4,0.75,0,5,5,3,2,0,1,2,10,28,1,NYK,PHX,NYK,139,,,18,15,13,8
Immanuel Quickley,G,22023,1630193,22301201,"DEC 05, 2023",NYK @ MIL,L,19,1,7,0.143,1,4,0.25,4,4,1.0,0,1,1,3,0,0,1,0,7,-10,1,NYK,MIL,NYK,122,,,11,8,10,4
Immanuel Quickley,G,22023,1630193,22300221,"NOV 20, 2023",NYK @ MIN,L,17,4,14,0.286,1,7,0.143,6,6,1.0,0,1,1,0,0,0,0,3,15,-6,1,NYK,MIN,NYK,100,,,16,16,15,1
Immanuel Quickley,G,22023,1630193,22300028,"NOV 17, 2023",NYK @ WAS,W,33,10,18,0.556,3,7,0.429,4,5,0.8,0,6,6,4,1,0,1,5,27,11,1,NYK,WAS,NYK,120,,,37,33,31,10
Immanuel Quickley,G,22023,1630193,22300177,"NOV 12, 2023",NYK vs. CHA,W,26,5,9,0.556,4,6,0.667,3,3,1.0,0,5,5,9,0,0,1,1,17,22,1,NYK,NYK,CHA,129,,,31,22,26,14
Immanuel Quickley,G,22023,1630193,22300161,"NOV 08, 2023",NYK vs. SAS,W,28,8,17,0.471,3,9,0.333,0,0,0.0,0,0,0,5,1,0,0,1,19,-3,1,NYK,NYK,SAS,126,,,24,19,24,5
Immanuel Quickley,G,22023,1630193,22300112,"OCT 31, 2023",NYK @ CLE,W,24,6,11,0.545,3,6,0.5,3,3,1.0,0,3,3,2,0,0,3,0,18,9,1,NYK,CLE,NYK,109,,,23,21,20,5
Immanuel Quickley,G,22023,1630193,22300744,"FEB 09, 2024",TOR vs. HOU,W,38,9,19,0.474,4,9,0.444,3,4,0.75,0,4,4,2,1,0,1,2,25,21,1,TOR,TOR,HOU,100,,,31,29,27,6
Immanuel Quickley,G,22023,1630193,22300726,"FEB 07, 2024",TOR @ CHA,W,31,6,13,0.462,3,6,0.5,3,4,0.75,0,3,3,4,0,0,0,1,18,-4,1,TOR,CHA,TOR,123,,,25,21,22,7
Immanuel Quickley,G,22023,1630193,22300718,"FEB 05, 2024",TOR @ NOP,L,24,3,10,0.3,1,3,0.333,1,1,1.0,1,0,1,6,0,0,2,1,8,-20,1,TOR,NOP,TOR,100,,,15,9,14,7
Immanuel Quickley,G,22023,1630193,22300710,"FEB 04, 2024",TOR @ OKC,L,43,7,20,0.35,2,9,0.222,1,2,0.5,1,2,3,11,1,0,1,1,17,-1,1,TOR,OKC,TOR,127,,,31,20,28,14
Immanuel Quickley,G,22023,1630193,22300692,"FEB 02, 2024",TOR @ HOU,L,30,7,16,0.438,6,11,0.545,5,7,0.714,0,1,1,6,0,0,0,2,25,-6,1,TOR,HOU,TOR,106,,,32,26,31,7
Immanuel Quickley,G,22023,1630193,22300609,"JAN 22, 2024",TOR vs. MEM,L,37,3,13,0.231,2,6,0.333,0,0,0.0,0,5,5,10,2,0,4,1,8,-9,1,TOR,TOR,MEM,100,,,23,13,18,15
Immanuel Quickley,G,22023,1630193,22300596,"JAN 20, 2024",TOR @ NYK,L,31,4,8,0.5,2,4,0.5,2,3,0.667,0,2,2,11,1,0,2,1,12,-26,1,TOR,NYK,TOR,94,,,25,14,23,13
Immanuel Quickley,G,22023,1630193,22300580,"JAN 18, 2024",TOR vs. CHI,L,35,4,10,0.4,2,7,0.286,2,2,1.0,0,3,3,3,1,0,2,2,12,-17,1,TOR,TOR,CHI,100,,,18,15,15,6
Immanuel Quickley,G,22023,1630193,22300574,"JAN 17, 2024",TOR vs. MIA,W,30,6,16,0.375,3,6,0.5,2,2,1.0,1,7,8,9,0,0,2,1,17,-2,1,TOR,TOR,MIA,115,,,34,25,26,17
Immanuel Quickley,G,22023,1630193,22300563,"JAN 15, 2024",TOR vs. BOS,L,37,8,20,0.4,2,7,0.286,3,4,0.75,0,6,6,3,1,1,0,3,21,2,1,TOR,TOR,BOS,94,,,30,27,24,9
Immanuel Quickley,G,22023,1630193,22300540,"JAN 12, 2024",TOR @ UTA,L,25,4,8,0.5,3,3,1.0,4,4,1.0,1,2,3,0,0,0,1,1,15,-28,1,TOR,UTA,TOR,104,,,18,18,15,3
Immanuel Quickley,G,22023,1630193,22300526,"JAN 10, 2024",TOR @ LAC,L,36,7,16,0.438,2,4,0.5,9,9,1.0,0,4,4,6,1,0,1,1,25,-5,1,TOR,LAC,TOR,111,,,35,29,31,10
Immanuel Quickley,G,22023,1630193,22300516,"JAN 09, 2024",TOR @ LAL,L,26,8,14,0.571,4,6,0.667,1,3,0.333,1,4,5,5,0,0,1,6,21,2,1,TOR,LAL,TOR,131,,,31,26,26,10
Immanuel Quickley,G,22023,1630193,22300504,"JAN 07, 2024",TOR @ GSW,W,26,4,10,0.4,1,4,0.25,0,0,0.0,1,4,5,10,1,0,0,0,9,4,1,TOR,GSW,TOR,131,,,24,14,19,15
Immanuel Quickley,G,22023,1630193,22300492,"JAN 05, 2024",TOR @ SAC,L,38,6,17,0.353,4,12,0.333,4,4,1.0,0,5,5,8,0,0,3,1,20,-3,1,TOR,SAC,TOR,120,,,33,25,28,13
Immanuel Quickley,G,22023,1630193,22300470,"JAN 03, 2024",TOR @ MEM,W,33,8,18,0.444,5,8,0.625,5,6,0.833,0,3,3,5,0,1,1,3,26,9,1,TOR,MEM,TOR,116,,,34,29,31,8
Immanuel Quickley,G,22023,1630193,22300452,"JAN 01, 2024",TOR vs. CLE,W,28,5,13,0.385,2,5,0.4,2,3,0.667,0,6,6,3,2,0,0,4,14,7,1,TOR,TOR,CLE,124,,,23,20,17,9
Immanuel Quickley,G,22023,1630193,22300429,"DEC 29, 2023",NYK @ ORL,L,28,4,10,0.4,3,7,0.429,1,1,1.0,0,1,1,1,0,0,1,4,12,3,1,NYK,ORL,NYK,106,,,14,13,13,2
Immanuel Quickley,G,22023,1630193,22300419,"DEC 27, 2023",NYK @ OKC,L,25,7,10,0.7,4,5,0.8,4,4,1.0,0,0,0,2,0,0,1,0,22,2,1,NYK,OKC,NYK,116,,,24,22,24,2
Immanuel Quickley,G,22023,1630193,22300401,"DEC 25, 2023",NYK vs. MIL,W,22,7,10,0.7,2,4,0.5,4,4,1.0,0,0,0,1,1,0,1,1,20,14,1,NYK,NYK,MIL,129,,,21,20,21,1
Immanuel Quickley,G,22023,1630193,22300359,"DEC 18, 2023",NYK @ LAL,W,29,8,15,0.533,3,7,0.429,1,1,1.0,0,3,3,2,1,0,1,2,20,7,1,NYK,LAL,NYK,114,,,25,23,22,5
Immanuel Quickley,G,22023,1630193,22300318,"DEC 13, 2023",NYK @ UTA,L,18,6,8,0.75,3,4,0.75,0,0,0.0,1,1,2,1,2,0,1,1,15,-13,1,NYK,UTA,NYK,113,,,18,17,16,3
Immanuel Quickley,G,22023,1630193,22301227,"DEC 08, 2023",NYK @ BOS,L,25,4,10,0.4,3,8,0.375,6,6,1.0,0,0,0,1,0,0,0,2,17,15,1,NYK,BOS,NYK,123,,,18,17,18,1
Immanuel Quickley,G,22023,1630193,22300276,"DEC 01, 2023",NYK @ TOR,W,19,3,6,0.5,1,3,0.333,3,4,0.75,0,1,1,1,1,0,1,0,10,16,1,NYK,TOR,NYK,119,,,12,11,11,2
Immanuel Quickley,G,22023,1630193,22300268,"NOV 30, 2023",NYK vs. DET,W,19,2,10,0.2,1,5,0.2,0,0,0.0,0,1,1,2,0,0,1,0,5,3,1,NYK,NYK,DET,118,,,8,6,7,3
Immanuel Quickley,G,22023,1630193,22300057,"NOV 28, 2023",NYK vs. CHA,W,26,9,20,0.45,4,10,0.4,1,1,1.0,0,3,3,1,0,0,1,1,23,21,1,NYK,NYK,CHA,115,,,27,26,24,4
Immanuel Quickley,G,22023,1630193,22300247,"NOV 26, 2023",NYK vs. PHX,L,29,4,10,0.4,3,5,0.6,7,8,0.875,0,2,2,1,1,1,0,1,18,5,1,NYK,NYK,PHX,113,,,21,20,19,3
Immanuel Quickley,G,22023,1630193,22300045,"NOV 24, 2023",NYK vs. MIA,W,26,8,17,0.471,4,8,0.5,0,0,0.0,0,4,4,2,0,1,2,1,20,22,1,NYK,NYK,MIA,100,,,26,24,22,6
Immanuel Quickley,G,22023,1630193,22300202,"NOV 18, 2023",NYK @ CHA,W,23,4,11,0.364,0,5,0.0,1,1,1.0,0,4,4,1,0,0,1,3,9,-1,1,NYK,CHA,NYK,122,,,14,13,10,5
Immanuel Quickley,G,22023,1630193,22300151,"NOV 06, 2023",NYK vs. LAC,W,20,3,5,0.6,1,3,0.333,0,0,0.0,0,1,1,5,0,0,0,0,7,22,1,NYK,NYK,LAC,111,,,13,8,12,6
Immanuel Quickley,G,22023,1630193,22300090,"OCT 28, 2023",NYK @ NOP,L,19,4,9,0.444,0,3,0.0,2,2,1.0,0,1,1,1,0,0,2,3,10,-11,1,NYK,NOP,NYK,87,,,12,11,11,2
Immanuel Quickley,G,22023,1630193,22300079,"OCT 27, 2023",NYK @ ATL,W,24,4,14,0.286,1,9,0.111,2,2,1.0,0,6,6,6,1,0,4,2,11,-3,1,NYK,ATL,NYK,126,,,23,17,17,12
Immanuel Quickley,G,22023,1630193,22300065,"OCT 25, 2023",NYK vs. BOS,L,28,7,11,0.636,5,7,0.714,5,6,0.833,2,4,6,4,1,0,2,3,24,-3,1,NYK,NYK,BOS,104,,,34,30,28,10
Immanuel Quickley,G,22023,1630193,22300193,"NOV 15, 2023",NYK @ ATL,W,28,6,11,0.545,3,5,0.6,5,6,0.833,0,0,0,4,1,0,2,3,20,-12,1,NYK,ATL,NYK,116,,,24,20,24,4
Immanuel Quickley,G,22023,1630193,22300188,"NOV 13, 2023",NYK @ BOS,L,26,1,10,0.1,1,2,0.5,4,4,1.0,0,6,6,1,1,0,0,3,7,-12,1,NYK,BOS,NYK,98,,,14,13,8,7
Immanuel Quickley,G,22023,1630193,22300002,"NOV 03, 2023",NYK @ MIL,L,22,5,10,0.5,1,3,0.333,3,3,1.0,0,3,3,1,0,0,1,1,14,-1,1,NYK,MIL,NYK,105,,,18,17,15,4
Immanuel Quickley,G,22023,1630193,22300120,"NOV 01, 2023",NYK vs. CLE,L,28,7,16,0.438,0,3,0.0,4,6,0.667,2,4,6,4,1,0,0,0,18,-1,1,NYK,NYK,CLE,89,,,28,24,22,10
Immanuel Quickley,G,22023,1630193,22300756,"FEB 10, 2024",TOR vs. CLE,L,32,4,10,0.4,2,4,0.5,0,0,0.0,1,2,3,4,1,0,0,1,10,-12,1,TOR,TOR,CLE,95,,,17,13,14,7
Immanuel Quickley,G,22023,1630193,22300388,"DEC 23, 2023",NYK vs. MIL,L,22,2,8,0.25,1,5,0.2,2,2,1.0,0,2,2,1,0,0,1,1,7,-11,1,NYK,NYK,MIL,109,,,10,9,8,3
Immanuel Quickley,G,22023,1630193,22300368,"DEC 20, 2023",NYK @ BKN,W,24,7,12,0.583,4,6,0.667,1,4,0.25,0,0,0,2,1,1,1,0,19,6,1,NYK,BKN,NYK,119,,,21,19,21,2
Immanuel Quickley,G,22023,1630193,22300343,"DEC 16, 2023",NYK @ LAC,L,19,3,8,0.375,0,3,0.0,3,4,0.75,0,4,4,3,0,0,0,0,9,3,1,NYK,LAC,NYK,120,,,16,13,12,7
Immanuel Quickley,G,22023,1630193,22300333,"DEC 15, 2023",NYK @ PHX,W,24,3,8,0.375,1,3,0.333,3,4,0.75,0,5,5,3,2,0,1,2,10,28,1,NYK,PHX,NYK,139,,,18,15,13,8
Immanuel Quickley,G,22023,1630193,22301201,"DEC 05, 2023",NYK @ MIL,L,19,1,7,0.143,1,4,0.25,4,4,1.0,0,1,1,3,0,0,1,0,7,-10,1,NYK,MIL,NYK,122,,,11,8,10,4
Immanuel Quickley,G,22023,1630193,22300221,"NOV 20, 2023",NYK @ MIN,L,17,4,14,0.286,1,7,0.143,6,6,1.0,0,1,1,0,0,0,0,3,15,-6,1,NYK,MIN,NYK,100,,,16,16,15,1
Immanuel Quickley,G,22023,1630193,22300028,"NOV 17, 2023",NYK @ WAS,W,33,10,18,0.556,3,7,0.429,4,5,0.8,0,6,6,4,1,0,1,5,27,11,1,NYK,WAS,NYK,120,,,37,33,31,10
Immanuel Quickley,G,22023,1630193,22300177,"NOV 12, 2023",NYK vs. CHA,W,26,5,9,0.556,4,6,0.667,3,3,1.0,0,5,5,9,0,0,1,1,17,22,1,NYK,NYK,CHA,129,,,31,22,26,14
Immanuel Quickley,G,22023,1630193,22300161,"NOV 08, 2023",NYK vs. SAS,W,28,8,17,0.471,3,9,0.333,0,0,0.0,0,0,0,5,1,0,0,1,19,-3,1,NYK,NYK,SAS,126,,,24,19,24,5
Immanuel Quickley,G,22023,1630193,22300112,"OCT 31, 2023",NYK @ CLE,W,24,6,11,0.545,3,6,0.5,3,3,1.0,0,3,3,2,0,0,3,0,18,9,1,NYK,CLE,NYK,109,,,23,21,20,5
Immanuel Quickley,G,22023,1630193,22300744,"FEB 09, 2024",TOR vs. HOU,W,38,9,19,0.474,4,9,0.444,3,4,0.75,0,4,4,2,1,0,1,2,25,21,1,TOR,TOR,HOU,100,,,31,29,27,6
Immanuel Quickley,G,22023,1630193,22300726,"FEB 07, 2024",TOR @ CHA,W,31,6,13,0.462,3,6,0.5,3,4,0.75,0,3,3,4,0,0,0,1,18,-4,1,TOR,CHA,TOR,123,,,25,21,22,7
Immanuel Quickley,G,22023,1630193,22300718,"FEB 05, 2024",TOR @ NOP,L,24,3,10,0.3,1,3,0.333,1,1,1.0,1,0,1,6,0,0,2,1,8,-20,1,TOR,NOP,TOR,100,,,15,9,14,7
Immanuel Quickley,G,22023,1630193,22300710,"FEB 04, 2024",TOR @ OKC,L,43,7,20,0.35,2,9,0.222,1,2,0.5,1,2,3,11,1,0,1,1,17,-1,1,TOR,OKC,TOR,127,,,31,20,28,14
Immanuel Quickley,G,22023,1630193,22300692,"FEB 02, 2024",TOR @ HOU,L,30,7,16,0.438,6,11,0.545,5,7,0.714,0,1,1,6,0,0,0,2,25,-6,1,TOR,HOU,TOR,106,,,32,26,31,7
Immanuel Quickley,G,22023,1630193,22300609,"JAN 22, 2024",TOR vs. MEM,L,37,3,13,0.231,2,6,0.333,0,0,0.0,0,5,5,10,2,0,4,1,8,-9,1,TOR,TOR,MEM,100,,,23,13,18,15
Immanuel Quickley,G,22023,1630193,22300596,"JAN 20, 2024",TOR @ NYK,L,31,4,8,0.5,2,4,0.5,2,3,0.667,0,2,2,11,1,0,2,1,12,-26,1,TOR,NYK,TOR,94,,,25,14,23,13
Immanuel Quickley,G,22023,1630193,22300580,"JAN 18, 2024",TOR vs. CHI,L,35,4,10,0.4,2,7,0.286,2,2,1.0,0,3,3,3,1,0,2,2,12,-17,1,TOR,TOR,CHI,100,,,18,15,15,6
Immanuel Quickley,G,22023,1630193,22300574,"JAN 17, 2024",TOR vs. MIA,W,30,6,16,0.375,3,6,0.5,2,2,1.0,1,7,8,9,0,0,2,1,17,-2,1,TOR,TOR,MIA,115,,,34,25,26,17
Immanuel Quickley,G,22023,1630193,22300563,"JAN 15, 2024",TOR vs. BOS,L,37,8,20,0.4,2,7,0.286,3,4,0.75,0,6,6,3,1,1,0,3,21,2,1,TOR,TOR,BOS,94,,,30,27,24,9
Immanuel Quickley,G,22023,1630193,22300540,"JAN 12, 2024",TOR @ UTA,L,25,4,8,0.5,3,3,1.0,4,4,1.0,1,2,3,0,0,0,1,1,15,-28,1,TOR,UTA,TOR,104,,,18,18,15,3
Immanuel Quickley,G,22023,1630193,22300526,"JAN 10, 2024",TOR @ LAC,L,36,7,16,0.438,2,4,0.5,9,9,1.0,0,4,4,6,1,0,1,1,25,-5,1,TOR,LAC,TOR,111,,,35,29,31,10
Immanuel Quickley,G,22023,1630193,22300516,"JAN 09, 2024",TOR @ LAL,L,26,8,14,0.571,4,6,0.667,1,3,0.333,1,4,5,5,0,0,1,6,21,2,1,TOR,LAL,TOR,131,,,31,26,26,10
Immanuel Quickley,G,22023,1630193,22300504,"JAN 07, 2024",TOR @ GSW,W,26,4,10,0.4,1,4,0.25,0,0,0.0,1,4,5,10,1,0,0,0,9,4,1,TOR,GSW,TOR,131,,,24,14,19,15
Immanuel Quickley,G,22023,1630193,22300492,"JAN 05, 2024",TOR @ SAC,L,38,6,17,0.353,4,12,0.333,4,4,1.0,0,5,5,8,0,0,3,1,20,-3,1,TOR,SAC,TOR,120,,,33,25,28,13
Immanuel Quickley,G,22023,1630193,22300470,"JAN 03, 2024",TOR @ MEM,W,33,8,18,0.444,5,8,0.625,5,6,0.833,0,3,3,5,0,1,1,3,26,9,1,TOR,MEM,TOR,116,,,34,29,31,8
Immanuel Quickley,G,22023,1630193,22300452,"JAN 01, 2024",TOR vs. CLE,W,28,5,13,0.385,2,5,0.4,2,3,0.667,0,6,6,3,2,0,0,4,14,7,1,TOR,TOR,CLE,124,,,23,20,17,9
Immanuel Quickley,G,22023,1630193,22300429,"DEC 29, 2023",NYK @ ORL,L,28,4,10,0.4,3,7,0.429,1,1,1.0,0,1,1,1,0,0,1,4,12,3,1,NYK,ORL,NYK,106,,,14,13,13,2
Immanuel Quickley,G,22023,1630193,22300419,"DEC 27, 2023",NYK @ OKC,L,25,7,10,0.7,4,5,0.8,4,4,1.0,0,0,0,2,0,0,1,0,22,2,1,NYK,OKC,NYK,116,,,24,22,24,2
Immanuel Quickley,G,22023,1630193,22300401,"DEC 25, 2023",NYK vs. MIL,W,22,7,10,0.7,2,4,0.5,4,4,1.0,0,0,0,1,1,0,1,1,20,14,1,NYK,NYK,MIL,129,,,21,20,21,1
Immanuel Quickley,G,22023,1630193,22300359,"DEC 18, 2023",NYK @ LAL,W,29,8,15,0.533,3,7,0.429,1,1,1.0,0,3,3,2,1,0,1,2,20,7,1,NYK,LAL,NYK,114,,,25,23,22,5
Immanuel Quickley,G,22023,1630193,22300318,"DEC 13, 2023",NYK @ UTA,L,18,6,8,0.75,3,4,0.75,0,0,0.0,1,1,2,1,2,0,1,1,15,-13,1,NYK,UTA,NYK,113,,,18,17,16,3
Immanuel Quickley,G,22023,1630193,22301227,"DEC 08, 2023",NYK @ BOS,L,25,4,10,0.4,3,8,0.375,6,6,1.0,0,0,0,1,0,0,0,2,17,15,1,NYK,BOS,NYK,123,,,18,17,18,1
Immanuel Quickley,G,22023,1630193,22300276,"DEC 01, 2023",NYK @ TOR,W,19,3,6,0.5,1,3,0.333,3,4,0.75,0,1,1,1,1,0,1,0,10,16,1,NYK,TOR,NYK,119,,,12,11,11,2
Immanuel Quickley,G,22023,1630193,22300268,"NOV 30, 2023",NYK vs. DET,W,19,2,10,0.2,1,5,0.2,0,0,0.0,0,1,1,2,0,0,1,0,5,3,1,NYK,NYK,DET,118,,,8,6,7,3
Immanuel Quickley,G,22023,1630193,22300057,"NOV 28, 2023",NYK vs. CHA,W,26,9,20,0.45,4,10,0.4,1,1,1.0,0,3,3,1,0,0,1,1,23,21,1,NYK,NYK,CHA,115,,,27,26,24,4
Immanuel Quickley,G,22023,1630193,22300247,"NOV 26, 2023",NYK vs. PHX,L,29,4,10,0.4,3,5,0.6,7,8,0.875,0,2,2,1,1,1,0,1,18,5,1,NYK,NYK,PHX,113,,,21,20,19,3
Immanuel Quickley,G,22023,1630193,22300045,"NOV 24, 2023",NYK vs. MIA,W,26,8,17,0.471,4,8,0.5,0,0,0.0,0,4,4,2,0,1,2,1,20,22,1,NYK,NYK,MIA,100,,,26,24,22,6
Immanuel Quickley,G,22023,1630193,22300202,"NOV 18, 2023",NYK @ CHA,W,23,4,11,0.364,0,5,0.0,1,1,1.0,0,4,4,1,0,0,1,3,9,-1,1,NYK,CHA,NYK,122,,,14,13,10,5
Immanuel Quickley,G,22023,1630193,22300151,"NOV 06, 2023",NYK vs. LAC,W,20,3,5,0.6,1,3,0.333,0,0,0.0,0,1,1,5,0,0,0,0,7,22,1,NYK,NYK,LAC,111,,,13,8,12,6
Immanuel Quickley,G,22023,1630193,22300090,"OCT 28, 2023",NYK @ NOP,L,19,4,9,0.444,0,3,0.0,2,2,1.0,0,1,1,1,0,0,2,3,10,-11,1,NYK,NOP,NYK,87,,,12,11,11,2
Immanuel Quickley,G,22023,1630193,22300079,"OCT 27, 2023",NYK @ ATL,W,24,4,14,0.286,1,9,0.111,2,2,1.0,0,6,6,6,1,0,4,2,11,-3,1,NYK,ATL,NYK,126,,,23,17,17,12
Immanuel Quickley,G,22023,1630193,22300065,"OCT 25, 2023",NYK vs. BOS,L,28,7,11,0.636,5,7,0.714,5,6,0.833,2,4,6,4,1,0,2,3,24,-3,1,NYK,NYK,BOS,104,,,34,30,28,10
Immanuel Quickley,G,22023,1630193,22300193,"NOV 15, 2023",NYK @ ATL,W,28,6,11,0.545,3,5,0.6,5,6,0.833,0,0,0,4,1,0,2,3,20,-12,1,NYK,ATL,NYK,116,,,24,20,24,4
Immanuel Quickley,G,22023,1630193,22300188,"NOV 13, 2023",NYK @ BOS,L,26,1,10,0.1,1,2,0.5,4,4,1.0,0,6,6,1,1,0,0,3,7,-12,1,NYK,BOS,NYK,98,,,14,13,8,7
Immanuel Quickley,G,22023,1630193,22300002,"NOV 03, 2023",NYK @ MIL,L,22,5,10,0.5,1,3,0.333,3,3,1.0,0,3,3,1,0,0,1,1,14,-1,1,NYK,MIL,NYK,105,,,18,17,15,4
Immanuel Quickley,G,22023,1630193,22300120,"NOV 01, 2023",NYK vs. CLE,L,28,7,16,0.438,0,3,0.0,4,6,0.667,2,4,6,4,1,0,0,0,18,-1,1,NYK,NYK,CLE,89,,,28,24,22,10
Chet Holmgren,C,22023,1631096,22300682,"JAN 31, 2024",OKC vs. DEN,W,32,7,13,0.538,3,4,0.75,1,2,0.5,5,8,13,3,0,5,2,0,18,13,1,OKC,OKC,DEN,105,16.5,Points,34,31,21,16
Chet Holmgren,C,22023,1631096,22300682,"JAN 31, 2024",OKC vs. DEN,W,32,7,13,0.538,3,4,0.75,1,2,0.5,5,8,13,3,0,5,2,0,18,13,1,OKC,OKC,DEN,105,8.5,Rebounds,34,31,21,16
Chet Holmgren,C,22023,1631096,22300682,"JAN 31, 2024",OKC vs. DEN,W,32,7,13,0.538,3,4,0.75,1,2,0.5,5,8,13,3,0,5,2,0,18,13,1,OKC,OKC,DEN,105,28.5,Pts+Rebs+Asts,34,31,21,16
Chet Holmgren,C,22023,1631096,22300682,"JAN 31, 2024",OKC vs. DEN,W,32,7,13,0.538,3,4,0.75,1,2,0.5,5,8,13,3,0,5,2,0,18,13,1,OKC,OKC,DEN,105,37.5,Fantasy Score,34,31,21,16
Chet Holmgren,C,22023,1631096,22300682,"JAN 31, 2024",OKC vs. DEN,W,32,7,13,0.538,3,4,0.75,1,2,0.5,5,8,13,3,0,5,2,0,18,13,1,OKC,OKC,DEN,105,1.5,Offensive Rebounds,34,31,21,16
Chet Holmgren,C,22023,1631096,22300682,"JAN 31, 2024",OKC vs. DEN,W,32,7,13,0.538,3,4,0.75,1,2,0.5,5,8,13,3,0,5,2,0,18,13,1,OKC,OKC,DEN,105,25.5,Pts+Rebs,34,31,21,16
Chet Holmgren,C,22023,1631096,22300682,"JAN 31, 2024",OKC vs. DEN,W,32,7,13,0.538,3,4,0.75,1,2,0.5,5,8,13,3,0,5,2,0,18,13,1,OKC,OKC,DEN,105,1.5,Dunks,34,31,21,16
Chet Holmgren,C,22023,1631096,22300682,"JAN 31, 2024",OKC vs. DEN,W,32,7,13,0.538,3,4,0.75,1,2,0.5,5,8,13,3,0,5,2,0,18,13,1,OKC,OKC,DEN,105,20.5,Pts+Asts,34,31,21,16
Chet Holmgren,C,22023,1631096,22300682,"JAN 31, 2024",OKC vs. DEN,W,32,7,13,0.538,3,4,0.75,1,2,0.5,5,8,13,3,0,5,2,0,18,13,1,OKC,OKC,DEN,105,0.5,Steals,34,31,21,16
Chet Holmgren,C,22023,1631096,22300682,"JAN 31, 2024",OKC vs. DEN,W,32,7,13,0.538,3,4,0.75,1,2,0.5,5,8,13,3,0,5,2,0,18,13,1,OKC,OKC,DEN,105,11.5,Rebs+Asts,34,31,21,16
Chet Holmgren,C,22023,1631096,22300682,"JAN 31, 2024",OKC vs. DEN,W,32,7,13,0.538,3,4,0.75,1,2,0.5,5,8,13,3,0,5,2,0,18,13,1,OKC,OKC,DEN,105,1.5,Turnovers,34,31,21,16
Chet Holmgren,C,22023,1631096,22300622,"JAN 24, 2024",OKC @ SAS,W,30,7,13,0.538,2,4,0.5,1,3,0.333,4,5,9,4,1,3,3,3,17,11,1,OKC,SAS,OKC,140,16.5,Points,30,26,21,13
Chet Holmgren,C,22023,1631096,22300622,"JAN 24, 2024",OKC @ SAS,W,30,7,13,0.538,2,4,0.5,1,3,0.333,4,5,9,4,1,3,3,3,17,11,1,OKC,SAS,OKC,140,8.5,Rebounds,30,26,21,13
Chet Holmgren,C,22023,1631096,22300622,"JAN 24, 2024",OKC @ SAS,W,30,7,13,0.538,2,4,0.5,1,3,0.333,4,5,9,4,1,3,3,3,17,11,1,OKC,SAS,OKC,140,28.5,Pts+Rebs+Asts,30,26,21,13
Chet Holmgren,C,22023,1631096,22300622,"JAN 24, 2024",OKC @ SAS,W,30,7,13,0.538,2,4,0.5,1,3,0.333,4,5,9,4,1,3,3,3,17,11,1,OKC,SAS,OKC,140,37.5,Fantasy Score,30,26,21,13
Chet Holmgren,C,22023,1631096,22300622,"JAN 24, 2024",OKC @ SAS,W,30,7,13,0.538,2,4,0.5,1,3,0.333,4,5,9,4,1,3,3,3,17,11,1,OKC,SAS,OKC,140,1.5,Offensive Rebounds,30,26,21,13
Chet Holmgren,C,22023,1631096,22300622,"JAN 24, 2024",OKC @ SAS,W,30,7,13,0.538,2,4,0.5,1,3,0.333,4,5,9,4,1,3,3,3,17,11,1,OKC,SAS,OKC,140,25.5,Pts+Rebs,30,26,21,13
Chet Holmgren,C,22023,1631096,22300622,"JAN 24, 2024",OKC @ SAS,W,30,7,13,0.538,2,4,0.5,1,3,0.333,4,5,9,4,1,3,3,3,17,11,1,OKC,SAS,OKC,140,1.5,Dunks,30,26,21,13
Chet Holmgren,C,22023,1631096,22300622,"JAN 24, 2024",OKC @ SAS,W,30,7,13,0.538,2,4,0.5,1,3,0.333,4,5,9,4,1,3,3,3,17,11,1,OKC,SAS,OKC,140,20.5,Pts+Asts,30,26,21,13
Chet Holmgren,C,22023,1631096,22300622,"JAN 24, 2024",OKC @ SAS,W,30,7,13,0.538,2,4,0.5,1,3,0.333,4,5,9,4,1,3,3,3,17,11,1,OKC,SAS,OKC,140,0.5,Steals,30,26,21,13
Chet Holmgren,C,22023,1631096,22300622,"JAN 24, 2024",OKC @ SAS,W,30,7,13,0.538,2,4,0.5,1,3,0.333,4,5,9,4,1,3,3,3,17,11,1,OKC,SAS,OKC,140,11.5,Rebs+Asts,30,26,21,13
Chet Holmgren,C,22023,1631096,22300622,"JAN 24, 2024",OKC @ SAS,W,30,7,13,0.538,2,4,0.5,1,3,0.333,4,5,9,4,1,3,3,3,17,11,1,OKC,SAS,OKC,140,1.5,Turnovers,30,26,21,13
Chet Holmgren,C,22023,1631096,22300617,"JAN 23, 2024",OKC vs. POR,W,32,3,6,0.5,0,2,0.0,2,4,0.5,1,9,10,3,0,6,1,1,8,8,1,OKC,OKC,POR,111,16.5,Points,21,18,11,13
Chet Holmgren,C,22023,1631096,22300617,"JAN 23, 2024",OKC vs. POR,W,32,3,6,0.5,0,2,0.0,2,4,0.5,1,9,10,3,0,6,1,1,8,8,1,OKC,OKC,POR,111,8.5,Rebounds,21,18,11,13
Chet Holmgren,C,22023,1631096,22300617,"JAN 23, 2024",OKC vs. POR,W,32,3,6,0.5,0,2,0.0,2,4,0.5,1,9,10,3,0,6,1,1,8,8,1,OKC,OKC,POR,111,28.5,Pts+Rebs+Asts,21,18,11,13
Chet Holmgren,C,22023,1631096,22300617,"JAN 23, 2024",OKC vs. POR,W,32,3,6,0.5,0,2,0.0,2,4,0.5,1,9,10,3,0,6,1,1,8,8,1,OKC,OKC,POR,111,37.5,Fantasy Score,21,18,11,13
Chet Holmgren,C,22023,1631096,22300617,"JAN 23, 2024",OKC vs. POR,W,32,3,6,0.5,0,2,0.0,2,4,0.5,1,9,10,3,0,6,1,1,8,8,1,OKC,OKC,POR,111,1.5,Offensive Rebounds,21,18,11,13
Chet Holmgren,C,22023,1631096,22300617,"JAN 23, 2024",OKC vs. POR,W,32,3,6,0.5,0,2,0.0,2,4,0.5,1,9,10,3,0,6,1,1,8,8,1,OKC,OKC,POR,111,25.5,Pts+Rebs,21,18,11,13
Chet Holmgren,C,22023,1631096,22300617,"JAN 23, 2024",OKC vs. POR,W,32,3,6,0.5,0,2,0.0,2,4,0.5,1,9,10,3,0,6,1,1,8,8,1,OKC,OKC,POR,111,1.5,Dunks,21,18,11,13
Chet Holmgren,C,22023,1631096,22300617,"JAN 23, 2024",OKC vs. POR,W,32,3,6,0.5,0,2,0.0,2,4,0.5,1,9,10,3,0,6,1,1,8,8,1,OKC,OKC,POR,111,20.5,Pts+Asts,21,18,11,13
Chet Holmgren,C,22023,1631096,22300617,"JAN 23, 2024",OKC vs. POR,W,32,3,6,0.5,0,2,0.0,2,4,0.5,1,9,10,3,0,6,1,1,8,8,1,OKC,OKC,POR,111,0.5,Steals,21,18,11,13
Chet Holmgren,C,22023,1631096,22300617,"JAN 23, 2024",OKC vs. POR,W,32,3,6,0.5,0,2,0.0,2,4,0.5,1,9,10,3,0,6,1,1,8,8,1,OKC,OKC,POR,111,11.5,Rebs+Asts,21,18,11,13
Chet Holmgren,C,22023,1631096,22300617,"JAN 23, 2024",OKC vs. POR,W,32,3,6,0.5,0,2,0.0,2,4,0.5,1,9,10,3,0,6,1,1,8,8,1,OKC,OKC,POR,111,1.5,Turnovers,21,18,11,13
Chet Holmgren,C,22023,1631096,22300481,"JAN 05, 2024",OKC @ BKN,L,35,8,15,0.533,0,4,0.0,1,2,0.5,3,3,6,3,1,1,1,3,17,-3,1,OKC,BKN,OKC,115,16.5,Points,26,23,20,9
Chet Holmgren,C,22023,1631096,22300481,"JAN 05, 2024",OKC @ BKN,L,35,8,15,0.533,0,4,0.0,1,2,0.5,3,3,6,3,1,1,1,3,17,-3,1,OKC,BKN,OKC,115,8.5,Rebounds,26,23,20,9
Chet Holmgren,C,22023,1631096,22300481,"JAN 05, 2024",OKC @ BKN,L,35,8,15,0.533,0,4,0.0,1,2,0.5,3,3,6,3,1,1,1,3,17,-3,1,OKC,BKN,OKC,115,28.5,Pts+Rebs+Asts,26,23,20,9
Chet Holmgren,C,22023,1631096,22300481,"JAN 05, 2024",OKC @ BKN,L,35,8,15,0.533,0,4,0.0,1,2,0.5,3,3,6,3,1,1,1,3,17,-3,1,OKC,BKN,OKC,115,37.5,Fantasy Score,26,23,20,9
Chet Holmgren,C,22023,1631096,22300481,"JAN 05, 2024",OKC @ BKN,L,35,8,15,0.533,0,4,0.0,1,2,0.5,3,3,6,3,1,1,1,3,17,-3,1,OKC,BKN,OKC,115,1.5,Offensive Rebounds,26,23,20,9
Chet Holmgren,C,22023,1631096,22300481,"JAN 05, 2024",OKC @ BKN,L,35,8,15,0.533,0,4,0.0,1,2,0.5,3,3,6,3,1,1,1,3,17,-3,1,OKC,BKN,OKC,115,25.5,Pts+Rebs,26,23,20,9
Chet Holmgren,C,22023,1631096,22300481,"JAN 05, 2024",OKC @ BKN,L,35,8,15,0.533,0,4,0.0,1,2,0.5,3,3,6,3,1,1,1,3,17,-3,1,OKC,BKN,OKC,115,1.5,Dunks,26,23,20,9
Chet Holmgren,C,22023,1631096,22300481,"JAN 05, 2024",OKC @ BKN,L,35,8,15,0.533,0,4,0.0,1,2,0.5,3,3,6,3,1,1,1,3,17,-3,1,OKC,BKN,OKC,115,20.5,Pts+Asts,26,23,20,9
Chet Holmgren,C,22023,1631096,22300481,"JAN 05, 2024",OKC @ BKN,L,35,8,15,0.533,0,4,0.0,1,2,0.5,3,3,6,3,1,1,1,3,17,-3,1,OKC,BKN,OKC,115,0.5,Steals,26,23,20,9
Chet Holmgren,C,22023,1631096,22300481,"JAN 05, 2024",OKC @ BKN,L,35,8,15,0.533,0,4,0.0,1,2,0.5,3,3,6,3,1,1,1,3,17,-3,1,OKC,BKN,OKC,115,11.5,Rebs+Asts,26,23,20,9
Chet Holmgren,C,22023,1631096,22300481,"JAN 05, 2024",OKC @ BKN,L,35,8,15,0.533,0,4,0.0,1,2,0.5,3,3,6,3,1,1,1,3,17,-3,1,OKC,BKN,OKC,115,1.5,Turnovers,26,23,20,9
Chet Holmgren,C,22023,1631096,22300419,"DEC 27, 2023",OKC vs. NYK,W,30,9,14,0.643,1,4,0.25,3,4,0.75,1,4,5,1,0,4,0,4,22,4,1,OKC,OKC,NYK,129,16.5,Points,28,27,23,6
Chet Holmgren,C,22023,1631096,22300419,"DEC 27, 2023",OKC vs. NYK,W,30,9,14,0.643,1,4,0.25,3,4,0.75,1,4,5,1,0,4,0,4,22,4,1,OKC,OKC,NYK,129,8.5,Rebounds,28,27,23,6
Chet Holmgren,C,22023,1631096,22300419,"DEC 27, 2023",OKC vs. NYK,W,30,9,14,0.643,1,4,0.25,3,4,0.75,1,4,5,1,0,4,0,4,22,4,1,OKC,OKC,NYK,129,28.5,Pts+Rebs+Asts,28,27,23,6
Chet Holmgren,C,22023,1631096,22300419,"DEC 27, 2023",OKC vs. NYK,W,30,9,14,0.643,1,4,0.25,3,4,0.75,1,4,5,1,0,4,0,4,22,4,1,OKC,OKC,NYK,129,37.5,Fantasy Score,28,27,23,6
Chet Holmgren,C,22023,1631096,22300419,"DEC 27, 2023",OKC vs. NYK,W,30,9,14,0.643,1,4,0.25,3,4,0.75,1,4,5,1,0,4,0,4,22,4,1,OKC,OKC,NYK,129,1.5,Offensive Rebounds,28,27,23,6
Chet Holmgren,C,22023,1631096,22300419,"DEC 27, 2023",OKC vs. NYK,W,30,9,14,0.643,1,4,0.25,3,4,0.75,1,4,5,1,0,4,0,4,22,4,1,OKC,OKC,NYK,129,25.5,Pts+Rebs,28,27,23,6
Chet Holmgren,C,22023,1631096,22300419,"DEC 27, 2023",OKC vs. NYK,W,30,9,14,0.643,1,4,0.25,3,4,0.75,1,4,5,1,0,4,0,4,22,4,1,OKC,OKC,NYK,129,1.5,Dunks,28,27,23,6
Chet Holmgren,C,22023,1631096,22300419,"DEC 27, 2023",OKC vs. NYK,W,30,9,14,0.643,1,4,0.25,3,4,0.75,1,4,5,1,0,4,0,4,22,4,1,OKC,OKC,NYK,129,20.5,Pts+Asts,28,27,23,6
Chet Holmgren,C,22023,1631096,22300419,"DEC 27, 2023",OKC vs. NYK,W,30,9,14,0.643,1,4,0.25,3,4,0.75,1,4,5,1,0,4,0,4,22,4,1,OKC,OKC,NYK,129,0.5,Steals,28,27,23,6
Chet Holmgren,C,22023,1631096,22300419,"DEC 27, 2023",OKC vs. NYK,W,30,9,14,0.643,1,4,0.25,3,4,0.75,1,4,5,1,0,4,0,4,22,4,1,OKC,OKC,NYK,129,11.5,Rebs+Asts,28,27,23,6
Chet Holmgren,C,22023,1631096,22300419,"DEC 27, 2023",OKC vs. NYK,W,30,9,14,0.643,1,4,0.25,3,4,0.75,1,4,5,1,0,4,0,4,22,4,1,OKC,OKC,NYK,129,1.5,Turnovers,28,27,23,6
Chet Holmgren,C,22023,1631096,22300397,"DEC 23, 2023",OKC vs. LAL,L,34,8,18,0.444,1,6,0.167,2,5,0.4,4,6,10,0,1,3,0,1,19,-7,1,OKC,OKC,LAL,120,16.5,Points,29,29,19,10
Chet Holmgren,C,22023,1631096,22300397,"DEC 23, 2023",OKC vs. LAL,L,34,8,18,0.444,1,6,0.167,2,5,0.4,4,6,10,0,1,3,0,1,19,-7,1,OKC,OKC,LAL,120,8.5,Rebounds,29,29,19,10
Chet Holmgren,C,22023,1631096,22300397,"DEC 23, 2023",OKC vs. LAL,L,34,8,18,0.444,1,6,0.167,2,5,0.4,4,6,10,0,1,3,0,1,19,-7,1,OKC,OKC,LAL,120,28.5,Pts+Rebs+Asts,29,29,19,10
Chet Holmgren,C,22023,1631096,22300397,"DEC 23, 2023",OKC vs. LAL,L,34,8,18,0.444,1,6,0.167,2,5,0.4,4,6,10,0,1,3,0,1,19,-7,1,OKC,OKC,LAL,120,37.5,Fantasy Score,29,29,19,10
Chet Holmgren,C,22023,1631096,22300397,"DEC 23, 2023",OKC vs. LAL,L,34,8,18,0.444,1,6,0.167,2,5,0.4,4,6,10,0,1,3,0,1,19,-7,1,OKC,OKC,LAL,120,1.5,Offensive Rebounds,29,29,19,10
Chet Holmgren,C,22023,1631096,22300397,"DEC 23, 2023",OKC vs. LAL,L,34,8,18,0.444,1,6,0.167,2,5,0.4,4,6,10,0,1,3,0,1,19,-7,1,OKC,OKC,LAL,120,25.5,Pts+Rebs,29,29,19,10
Chet Holmgren,C,22023,1631096,22300397,"DEC 23, 2023",OKC vs. LAL,L,34,8,18,0.444,1,6,0.167,2,5,0.4,4,6,10,0,1,3,0,1,19,-7,1,OKC,OKC,LAL,120,1.5,Dunks,29,29,19,10
Chet Holmgren,C,22023,1631096,22300397,"DEC 23, 2023",OKC vs. LAL,L,34,8,18,0.444,1,6,0.167,2,5,0.4,4,6,10,0,1,3,0,1,19,-7,1,OKC,OKC,LAL,120,20.5,Pts+Asts,29,29,19,10
Chet Holmgren,C,22023,1631096,22300397,"DEC 23, 2023",OKC vs. LAL,L,34,8,18,0.444,1,6,0.167,2,5,0.4,4,6,10,0,1,3,0,1,19,-7,1,OKC,OKC,LAL,120,0.5,Steals,29,29,19,10
Chet Holmgren,C,22023,1631096,22300397,"DEC 23, 2023",OKC vs. LAL,L,34,8,18,0.444,1,6,0.167,2,5,0.4,4,6,10,0,1,3,0,1,19,-7,1,OKC,OKC,LAL,120,11.5,Rebs+Asts,29,29,19,10
Chet Holmgren,C,22023,1631096,22300397,"DEC 23, 2023",OKC vs. LAL,L,34,8,18,0.444,1,6,0.167,2,5,0.4,4,6,10,0,1,3,0,1,19,-7,1,OKC,OKC,LAL,120,1.5,Turnovers,29,29,19,10
Chet Holmgren,C,22023,1631096,22300324,"DEC 14, 2023",OKC @ SAC,L,30,6,12,0.5,0,2,0.0,2,2,1.0,2,9,11,1,0,3,1,4,14,-10,1,OKC,SAC,OKC,123,16.5,Points,26,25,15,12
Chet Holmgren,C,22023,1631096,22300324,"DEC 14, 2023",OKC @ SAC,L,30,6,12,0.5,0,2,0.0,2,2,1.0,2,9,11,1,0,3,1,4,14,-10,1,OKC,SAC,OKC,123,8.5,Rebounds,26,25,15,12
Chet Holmgren,C,22023,1631096,22300324,"DEC 14, 2023",OKC @ SAC,L,30,6,12,0.5,0,2,0.0,2,2,1.0,2,9,11,1,0,3,1,4,14,-10,1,OKC,SAC,OKC,123,28.5,Pts+Rebs+Asts,26,25,15,12
Chet Holmgren,C,22023,1631096,22300324,"DEC 14, 2023",OKC @ SAC,L,30,6,12,0.5,0,2,0.0,2,2,1.0,2,9,11,1,0,3,1,4,14,-10,1,OKC,SAC,OKC,123,37.5,Fantasy Score,26,25,15,12
Chet Holmgren,C,22023,1631096,22300324,"DEC 14, 2023",OKC @ SAC,L,30,6,12,0.5,0,2,0.0,2,2,1.0,2,9,11,1,0,3,1,4,14,-10,1,OKC,SAC,OKC,123,1.5,Offensive Rebounds,26,25,15,12
Chet Holmgren,C,22023,1631096,22300324,"DEC 14, 2023",OKC @ SAC,L,30,6,12,0.5,0,2,0.0,2,2,1.0,2,9,11,1,0,3,1,4,14,-10,1,OKC,SAC,OKC,123,25.5,Pts+Rebs,26,25,15,12
Chet Holmgren,C,22023,1631096,22300324,"DEC 14, 2023",OKC @ SAC,L,30,6,12,0.5,0,2,0.0,2,2,1.0,2,9,11,1,0,3,1,4,14,-10,1,OKC,SAC,OKC,123,1.5,Dunks,26,25,15,12
Chet Holmgren,C,22023,1631096,22300324,"DEC 14, 2023",OKC @ SAC,L,30,6,12,0.5,0,2,0.0,2,2,1.0,2,9,11,1,0,3,1,4,14,-10,1,OKC,SAC,OKC,123,20.5,Pts+Asts,26,25,15,12
Chet Holmgren,C,22023,1631096,22300324,"DEC 14, 2023",OKC @ SAC,L,30,6,12,0.5,0,2,0.0,2,2,1.0,2,9,11,1,0,3,1,4,14,-10,1,OKC,SAC,OKC,123,0.5,Steals,26,25,15,12
Chet Holmgren,C,22023,1631096,22300324,"DEC 14, 2023",OKC @ SAC,L,30,6,12,0.5,0,2,0.0,2,2,1.0,2,9,11,1,0,3,1,4,14,-10,1,OKC,SAC,OKC,123,11.5,Rebs+Asts,26,25,15,12
Chet Holmgren,C,22023,1631096,22300324,"DEC 14, 2023",OKC @ SAC,L,30,6,12,0.5,0,2,0.0,2,2,1.0,2,9,11,1,0,3,1,4,14,-10,1,OKC,SAC,OKC,123,1.5,Turnovers,26,25,15,12
Chet Holmgren,C,22023,1631096,22300302,"DEC 11, 2023",OKC vs. UTA,W,25,6,9,0.667,2,3,0.667,2,2,1.0,2,6,8,2,1,2,3,2,16,24,1,OKC,OKC,UTA,134,16.5,Points,26,24,18,10
Chet Holmgren,C,22023,1631096,22300302,"DEC 11, 2023",OKC vs. UTA,W,25,6,9,0.667,2,3,0.667,2,2,1.0,2,6,8,2,1,2,3,2,16,24,1,OKC,OKC,UTA,134,8.5,Rebounds,26,24,18,10
Chet Holmgren,C,22023,1631096,22300302,"DEC 11, 2023",OKC vs. UTA,W,25,6,9,0.667,2,3,0.667,2,2,1.0,2,6,8,2,1,2,3,2,16,24,1,OKC,OKC,UTA,134,28.5,Pts+Rebs+Asts,26,24,18,10
Chet Holmgren,C,22023,1631096,22300302,"DEC 11, 2023",OKC vs. UTA,W,25,6,9,0.667,2,3,0.667,2,2,1.0,2,6,8,2,1,2,3,2,16,24,1,OKC,OKC,UTA,134,37.5,Fantasy Score,26,24,18,10
Chet Holmgren,C,22023,1631096,22300302,"DEC 11, 2023",OKC vs. UTA,W,25,6,9,0.667,2,3,0.667,2,2,1.0,2,6,8,2,1,2,3,2,16,24,1,OKC,OKC,UTA,134,1.5,Offensive Rebounds,26,24,18,10
Chet Holmgren,C,22023,1631096,22300302,"DEC 11, 2023",OKC vs. UTA,W,25,6,9,0.667,2,3,0.667,2,2,1.0,2,6,8,2,1,2,3,2,16,24,1,OKC,OKC,UTA,134,25.5,Pts+Rebs,26,24,18,10
Chet Holmgren,C,22023,1631096,22300302,"DEC 11, 2023",OKC vs. UTA,W,25,6,9,0.667,2,3,0.667,2,2,1.0,2,6,8,2,1,2,3,2,16,24,1,OKC,OKC,UTA,134,1.5,Dunks,26,24,18,10
Chet Holmgren,C,22023,1631096,22300302,"DEC 11, 2023",OKC vs. UTA,W,25,6,9,0.667,2,3,0.667,2,2,1.0,2,6,8,2,1,2,3,2,16,24,1,OKC,OKC,UTA,134,20.5,Pts+Asts,26,24,18,10
Chet Holmgren,C,22023,1631096,22300302,"DEC 11, 2023",OKC vs. UTA,W,25,6,9,0.667,2,3,0.667,2,2,1.0,2,6,8,2,1,2,3,2,16,24,1,OKC,OKC,UTA,134,0.5,Steals,26,24,18,10
Chet Holmgren,C,22023,1631096,22300302,"DEC 11, 2023",OKC vs. UTA,W,25,6,9,0.667,2,3,0.667,2,2,1.0,2,6,8,2,1,2,3,2,16,24,1,OKC,OKC,UTA,134,11.5,Rebs+Asts,26,24,18,10
Chet Holmgren,C,22023,1631096,22300302,"DEC 11, 2023",OKC vs. UTA,W,25,6,9,0.667,2,3,0.667,2,2,1.0,2,6,8,2,1,2,3,2,16,24,1,OKC,OKC,UTA,134,1.5,Turnovers,26,24,18,10
Chet Holmgren,C,22023,1631096,22301222,"DEC 08, 2023",OKC vs. GSW,W,35,6,12,0.5,1,4,0.25,8,8,1.0,2,5,7,1,0,3,3,4,21,-3,1,OKC,OKC,GSW,138,16.5,Points,29,28,22,8
Chet Holmgren,C,22023,1631096,22301222,"DEC 08, 2023",OKC vs. GSW,W,35,6,12,0.5,1,4,0.25,8,8,1.0,2,5,7,1,0,3,3,4,21,-3,1,OKC,OKC,GSW,138,8.5,Rebounds,29,28,22,8
Chet Holmgren,C,22023,1631096,22301222,"DEC 08, 2023",OKC vs. GSW,W,35,6,12,0.5,1,4,0.25,8,8,1.0,2,5,7,1,0,3,3,4,21,-3,1,OKC,OKC,GSW,138,28.5,Pts+Rebs+Asts,29,28,22,8
Chet Holmgren,C,22023,1631096,22301222,"DEC 08, 2023",OKC vs. GSW,W,35,6,12,0.5,1,4,0.25,8,8,1.0,2,5,7,1,0,3,3,4,21,-3,1,OKC,OKC,GSW,138,37.5,Fantasy Score,29,28,22,8
Chet Holmgren,C,22023,1631096,22301222,"DEC 08, 2023",OKC vs. GSW,W,35,6,12,0.5,1,4,0.25,8,8,1.0,2,5,7,1,0,3,3,4,21,-3,1,OKC,OKC,GSW,138,1.5,Offensive Rebounds,29,28,22,8
Chet Holmgren,C,22023,1631096,22301222,"DEC 08, 2023",OKC vs. GSW,W,35,6,12,0.5,1,4,0.25,8,8,1.0,2,5,7,1,0,3,3,4,21,-3,1,OKC,OKC,GSW,138,25.5,Pts+Rebs,29,28,22,8
Chet Holmgren,C,22023,1631096,22301222,"DEC 08, 2023",OKC vs. GSW,W,35,6,12,0.5,1,4,0.25,8,8,1.0,2,5,7,1,0,3,3,4,21,-3,1,OKC,OKC,GSW,138,1.5,Dunks,29,28,22,8
Chet Holmgren,C,22023,1631096,22301222,"DEC 08, 2023",OKC vs. GSW,W,35,6,12,0.5,1,4,0.25,8,8,1.0,2,5,7,1,0,3,3,4,21,-3,1,OKC,OKC,GSW,138,20.5,Pts+Asts,29,28,22,8
Chet Holmgren,C,22023,1631096,22301222,"DEC 08, 2023",OKC vs. GSW,W,35,6,12,0.5,1,4,0.25,8,8,1.0,2,5,7,1,0,3,3,4,21,-3,1,OKC,OKC,GSW,138,0.5,Steals,29,28,22,8
Chet Holmgren,C,22023,1631096,22301222,"DEC 08, 2023",OKC vs. GSW,W,35,6,12,0.5,1,4,0.25,8,8,1.0,2,5,7,1,0,3,3,4,21,-3,1,OKC,OKC,GSW,138,11.5,Rebs+Asts,29,28,22,8
Chet Holmgren,C,22023,1631096,22301222,"DEC 08, 2023",OKC vs. GSW,W,35,6,12,0.5,1,4,0.25,8,8,1.0,2,5,7,1,0,3,3,4,21,-3,1,OKC,OKC,GSW,138,1.5,Turnovers,29,28,22,8
Chet Holmgren,C,22023,1631096,22300287,"DEC 02, 2023",OKC @ DAL,W,30,4,10,0.4,0,3,0.0,3,4,0.75,3,8,11,3,1,4,2,3,11,4,1,OKC,DAL,OKC,126,16.5,Points,25,22,14,14
Chet Holmgren,C,22023,1631096,22300287,"DEC 02, 2023",OKC @ DAL,W,30,4,10,0.4,0,3,0.0,3,4,0.75,3,8,11,3,1,4,2,3,11,4,1,OKC,DAL,OKC,126,8.5,Rebounds,25,22,14,14
Chet Holmgren,C,22023,1631096,22300287,"DEC 02, 2023",OKC @ DAL,W,30,4,10,0.4,0,3,0.0,3,4,0.75,3,8,11,3,1,4,2,3,11,4,1,OKC,DAL,OKC,126,28.5,Pts+Rebs+Asts,25,22,14,14
Chet Holmgren,C,22023,1631096,22300287,"DEC 02, 2023",OKC @ DAL,W,30,4,10,0.4,0,3,0.0,3,4,0.75,3,8,11,3,1,4,2,3,11,4,1,OKC,DAL,OKC,126,37.5,Fantasy Score,25,22,14,14
Chet Holmgren,C,22023,1631096,22300287,"DEC 02, 2023",OKC @ DAL,W,30,4,10,0.4,0,3,0.0,3,4,0.75,3,8,11,3,1,4,2,3,11,4,1,OKC,DAL,OKC,126,1.5,Offensive Rebounds,25,22,14,14
Chet Holmgren,C,22023,1631096,22300287,"DEC 02, 2023",OKC @ DAL,W,30,4,10,0.4,0,3,0.0,3,4,0.75,3,8,11,3,1,4,2,3,11,4,1,OKC,DAL,OKC,126,25.5,Pts+Rebs,25,22,14,14
Chet Holmgren,C,22023,1631096,22300287,"DEC 02, 2023",OKC @ DAL,W,30,4,10,0.4,0,3,0.0,3,4,0.75,3,8,11,3,1,4,2,3,11,4,1,OKC,DAL,OKC,126,1.5,Dunks,25,22,14,14
Chet Holmgren,C,22023,1631096,22300287,"DEC 02, 2023",OKC @ DAL,W,30,4,10,0.4,0,3,0.0,3,4,0.75,3,8,11,3,1,4,2,3,11,4,1,OKC,DAL,OKC,126,20.5,Pts+Asts,25,22,14,14
Chet Holmgren,C,22023,1631096,22300287,"DEC 02, 2023",OKC @ DAL,W,30,4,10,0.4,0,3,0.0,3,4,0.75,3,8,11,3,1,4,2,3,11,4,1,OKC,DAL,OKC,126,0.5,Steals,25,22,14,14
Chet Holmgren,C,22023,1631096,22300287,"DEC 02, 2023",OKC @ DAL,W,30,4,10,0.4,0,3,0.0,3,4,0.75,3,8,11,3,1,4,2,3,11,4,1,OKC,DAL,OKC,126,11.5,Rebs+Asts,25,22,14,14
Chet Holmgren,C,22023,1631096,22300287,"DEC 02, 2023",OKC @ DAL,W,30,4,10,0.4,0,3,0.0,3,4,0.75,3,8,11,3,1,4,2,3,11,4,1,OKC,DAL,OKC,126,1.5,Turnovers,25,22,14,14
Chet Holmgren,C,22023,1631096,22300239,"NOV 25, 2023",OKC vs. PHI,L,32,13,21,0.619,5,11,0.455,2,2,1.0,1,5,6,2,0,3,1,3,33,4,1,OKC,OKC,PHI,123,16.5,Points,41,39,35,8
Chet Holmgren,C,22023,1631096,22300239,"NOV 25, 2023",OKC vs. PHI,L,32,13,21,0.619,5,11,0.455,2,2,1.0,1,5,6,2,0,3,1,3,33,4,1,OKC,OKC,PHI,123,8.5,Rebounds,41,39,35,8
Chet Holmgren,C,22023,1631096,22300239,"NOV 25, 2023",OKC vs. PHI,L,32,13,21,0.619,5,11,0.455,2,2,1.0,1,5,6,2,0,3,1,3,33,4,1,OKC,OKC,PHI,123,28.5,Pts+Rebs+Asts,41,39,35,8
Chet Holmgren,C,22023,1631096,22300239,"NOV 25, 2023",OKC vs. PHI,L,32,13,21,0.619,5,11,0.455,2,2,1.0,1,5,6,2,0,3,1,3,33,4,1,OKC,OKC,PHI,123,37.5,Fantasy Score,41,39,35,8
Chet Holmgren,C,22023,1631096,22300239,"NOV 25, 2023",OKC vs. PHI,L,32,13,21,0.619,5,11,0.455,2,2,1.0,1,5,6,2,0,3,1,3,33,4,1,OKC,OKC,PHI,123,1.5,Offensive Rebounds,41,39,35,8
Chet Holmgren,C,22023,1631096,22300239,"NOV 25, 2023",OKC vs. PHI,L,32,13,21,0.619,5,11,0.455,2,2,1.0,1,5,6,2,0,3,1,3,33,4,1,OKC,OKC,PHI,123,25.5,Pts+Rebs,41,39,35,8
Chet Holmgren,C,22023,1631096,22300239,"NOV 25, 2023",OKC vs. PHI,L,32,13,21,0.619,5,11,0.455,2,2,1.0,1,5,6,2,0,3,1,3,33,4,1,OKC,OKC,PHI,123,1.5,Dunks,41,39,35,8
Chet Holmgren,C,22023,1631096,22300239,"NOV 25, 2023",OKC vs. PHI,L,32,13,21,0.619,5,11,0.455,2,2,1.0,1,5,6,2,0,3,1,3,33,4,1,OKC,OKC,PHI,123,20.5,Pts+Asts,41,39,35,8
Chet Holmgren,C,22023,1631096,22300239,"NOV 25, 2023",OKC vs. PHI,L,32,13,21,0.619,5,11,0.455,2,2,1.0,1,5,6,2,0,3,1,3,33,4,1,OKC,OKC,PHI,123,0.5,Steals,41,39,35,8
Chet Holmgren,C,22023,1631096,22300239,"NOV 25, 2023",OKC vs. PHI,L,32,13,21,0.619,5,11,0.455,2,2,1.0,1,5,6,2,0,3,1,3,33,4,1,OKC,OKC,PHI,123,11.5,Rebs+Asts,41,39,35,8
Chet Holmgren,C,22023,1631096,22300239,"NOV 25, 2023",OKC vs. PHI,L,32,13,21,0.619,5,11,0.455,2,2,1.0,1,5,6,2,0,3,1,3,33,4,1,OKC,OKC,PHI,123,1.5,Turnovers,41,39,35,8
Chet Holmgren,C,22023,1631096,22300215,"NOV 19, 2023",OKC @ POR,W,20,6,6,1.0,2,2,1.0,2,2,1.0,0,6,6,0,0,2,0,1,16,10,1,OKC,POR,OKC,134,16.5,Points,22,22,16,6
Chet Holmgren,C,22023,1631096,22300215,"NOV 19, 2023",OKC @ POR,W,20,6,6,1.0,2,2,1.0,2,2,1.0,0,6,6,0,0,2,0,1,16,10,1,OKC,POR,OKC,134,8.5,Rebounds,22,22,16,6
Chet Holmgren,C,22023,1631096,22300215,"NOV 19, 2023",OKC @ POR,W,20,6,6,1.0,2,2,1.0,2,2,1.0,0,6,6,0,0,2,0,1,16,10,1,OKC,POR,OKC,134,28.5,Pts+Rebs+Asts,22,22,16,6
Chet Holmgren,C,22023,1631096,22300215,"NOV 19, 2023",OKC @ POR,W,20,6,6,1.0,2,2,1.0,2,2,1.0,0,6,6,0,0,2,0,1,16,10,1,OKC,POR,OKC,134,37.5,Fantasy Score,22,22,16,6
Chet Holmgren,C,22023,1631096,22300215,"NOV 19, 2023",OKC @ POR,W,20,6,6,1.0,2,2,1.0,2,2,1.0,0,6,6,0,0,2,0,1,16,10,1,OKC,POR,OKC,134,1.5,Offensive Rebounds,22,22,16,6
Chet Holmgren,C,22023,1631096,22300215,"NOV 19, 2023",OKC @ POR,W,20,6,6,1.0,2,2,1.0,2,2,1.0,0,6,6,0,0,2,0,1,16,10,1,OKC,POR,OKC,134,25.5,Pts+Rebs,22,22,16,6
Chet Holmgren,C,22023,1631096,22300215,"NOV 19, 2023",OKC @ POR,W,20,6,6,1.0,2,2,1.0,2,2,1.0,0,6,6,0,0,2,0,1,16,10,1,OKC,POR,OKC,134,1.5,Dunks,22,22,16,6
Chet Holmgren,C,22023,1631096,22300215,"NOV 19, 2023",OKC @ POR,W,20,6,6,1.0,2,2,1.0,2,2,1.0,0,6,6,0,0,2,0,1,16,10,1,OKC,POR,OKC,134,20.5,Pts+Asts,22,22,16,6
Chet Holmgren,C,22023,1631096,22300215,"NOV 19, 2023",OKC @ POR,W,20,6,6,1.0,2,2,1.0,2,2,1.0,0,6,6,0,0,2,0,1,16,10,1,OKC,POR,OKC,134,0.5,Steals,22,22,16,6
Chet Holmgren,C,22023,1631096,22300215,"NOV 19, 2023",OKC @ POR,W,20,6,6,1.0,2,2,1.0,2,2,1.0,0,6,6,0,0,2,0,1,16,10,1,OKC,POR,OKC,134,11.5,Rebs+Asts,22,22,16,6
Chet Holmgren,C,22023,1631096,22300215,"NOV 19, 2023",OKC @ POR,W,20,6,6,1.0,2,2,1.0,2,2,1.0,0,6,6,0,0,2,0,1,16,10,1,OKC,POR,OKC,134,1.5,Turnovers,22,22,16,6
Chet Holmgren,C,22023,1631096,22300185,"NOV 12, 2023",OKC @ PHX,W,33,5,10,0.5,3,6,0.5,5,5,1.0,0,6,6,4,0,2,0,3,18,27,1,OKC,PHX,OKC,111,16.5,Points,28,24,22,10
Chet Holmgren,C,22023,1631096,22300185,"NOV 12, 2023",OKC @ PHX,W,33,5,10,0.5,3,6,0.5,5,5,1.0,0,6,6,4,0,2,0,3,18,27,1,OKC,PHX,OKC,111,8.5,Rebounds,28,24,22,10
Chet Holmgren,C,22023,1631096,22300185,"NOV 12, 2023",OKC @ PHX,W,33,5,10,0.5,3,6,0.5,5,5,1.0,0,6,6,4,0,2,0,3,18,27,1,OKC,PHX,OKC,111,28.5,Pts+Rebs+Asts,28,24,22,10
Chet Holmgren,C,22023,1631096,22300185,"NOV 12, 2023",OKC @ PHX,W,33,5,10,0.5,3,6,0.5,5,5,1.0,0,6,6,4,0,2,0,3,18,27,1,OKC,PHX,OKC,111,37.5,Fantasy Score,28,24,22,10
Chet Holmgren,C,22023,1631096,22300185,"NOV 12, 2023",OKC @ PHX,W,33,5,10,0.5,3,6,0.5,5,5,1.0,0,6,6,4,0,2,0,3,18,27,1,OKC,PHX,OKC,111,1.5,Offensive Rebounds,28,24,22,10
Chet Holmgren,C,22023,1631096,22300185,"NOV 12, 2023",OKC @ PHX,W,33,5,10,0.5,3,6,0.5,5,5,1.0,0,6,6,4,0,2,0,3,18,27,1,OKC,PHX,OKC,111,25.5,Pts+Rebs,28,24,22,10
Chet Holmgren,C,22023,1631096,22300185,"NOV 12, 2023",OKC @ PHX,W,33,5,10,0.5,3,6,0.5,5,5,1.0,0,6,6,4,0,2,0,3,18,27,1,OKC,PHX,OKC,111,1.5,Dunks,28,24,22,10
Chet Holmgren,C,22023,1631096,22300185,"NOV 12, 2023",OKC @ PHX,W,33,5,10,0.5,3,6,0.5,5,5,1.0,0,6,6,4,0,2,0,3,18,27,1,OKC,PHX,OKC,111,20.5,Pts+Asts,28,24,22,10
Chet Holmgren,C,22023,1631096,22300185,"NOV 12, 2023",OKC @ PHX,W,33,5,10,0.5,3,6,0.5,5,5,1.0,0,6,6,4,0,2,0,3,18,27,1,OKC,PHX,OKC,111,0.5,Steals,28,24,22,10
Chet Holmgren,C,22023,1631096,22300185,"NOV 12, 2023",OKC @ PHX,W,33,5,10,0.5,3,6,0.5,5,5,1.0,0,6,6,4,0,2,0,3,18,27,1,OKC,PHX,OKC,111,11.5,Rebs+Asts,28,24,22,10
Chet Holmgren,C,22023,1631096,22300185,"NOV 12, 2023",OKC @ PHX,W,33,5,10,0.5,3,6,0.5,5,5,1.0,0,6,6,4,0,2,0,3,18,27,1,OKC,PHX,OKC,111,1.5,Turnovers,28,24,22,10
Chet Holmgren,C,22023,1631096,22300167,"NOV 08, 2023",OKC vs. CLE,W,29,7,10,0.7,1,1,1.0,0,0,0.0,3,4,7,2,1,3,2,4,15,3,1,OKC,OKC,CLE,128,16.5,Points,24,22,17,9
Chet Holmgren,C,22023,1631096,22300167,"NOV 08, 2023",OKC vs. CLE,W,29,7,10,0.7,1,1,1.0,0,0,0.0,3,4,7,2,1,3,2,4,15,3,1,OKC,OKC,CLE,128,8.5,Rebounds,24,22,17,9
Chet Holmgren,C,22023,1631096,22300167,"NOV 08, 2023",OKC vs. CLE,W,29,7,10,0.7,1,1,1.0,0,0,0.0,3,4,7,2,1,3,2,4,15,3,1,OKC,OKC,CLE,128,28.5,Pts+Rebs+Asts,24,22,17,9
Chet Holmgren,C,22023,1631096,22300167,"NOV 08, 2023",OKC vs. CLE,W,29,7,10,0.7,1,1,1.0,0,0,0.0,3,4,7,2,1,3,2,4,15,3,1,OKC,OKC,CLE,128,37.5,Fantasy Score,24,22,17,9
Chet Holmgren,C,22023,1631096,22300167,"NOV 08, 2023",OKC vs. CLE,W,29,7,10,0.7,1,1,1.0,0,0,0.0,3,4,7,2,1,3,2,4,15,3,1,OKC,OKC,CLE,128,1.5,Offensive Rebounds,24,22,17,9
Chet Holmgren,C,22023,1631096,22300167,"NOV 08, 2023",OKC vs. CLE,W,29,7,10,0.7,1,1,1.0,0,0,0.0,3,4,7,2,1,3,2,4,15,3,1,OKC,OKC,CLE,128,25.5,Pts+Rebs,24,22,17,9
Chet Holmgren,C,22023,1631096,22300167,"NOV 08, 2023",OKC vs. CLE,W,29,7,10,0.7,1,1,1.0,0,0,0.0,3,4,7,2,1,3,2,4,15,3,1,OKC,OKC,CLE,128,1.5,Dunks,24,22,17,9
Chet Holmgren,C,22023,1631096,22300167,"NOV 08, 2023",OKC vs. CLE,W,29,7,10,0.7,1,1,1.0,0,0,0.0,3,4,7,2,1,3,2,4,15,3,1,OKC,OKC,CLE,128,20.5,Pts+Asts,24,22,17,9
Chet Holmgren,C,22023,1631096,22300167,"NOV 08, 2023",OKC vs. CLE,W,29,7,10,0.7,1,1,1.0,0,0,0.0,3,4,7,2,1,3,2,4,15,3,1,OKC,OKC,CLE,128,0.5,Steals,24,22,17,9
Chet Holmgren,C,22023,1631096,22300167,"NOV 08, 2023",OKC vs. CLE,W,29,7,10,0.7,1,1,1.0,0,0,0.0,3,4,7,2,1,3,2,4,15,3,1,OKC,OKC,CLE,128,11.5,Rebs+Asts,24,22,17,9
Chet Holmgren,C,22023,1631096,22300167,"NOV 08, 2023",OKC vs. CLE,W,29,7,10,0.7,1,1,1.0,0,0,0.0,3,4,7,2,1,3,2,4,15,3,1,OKC,OKC,CLE,128,1.5,Turnovers,24,22,17,9
Chet Holmgren,C,22023,1631096,22300109,"OCT 30, 2023",OKC vs. DET,W,24,4,5,0.8,4,5,0.8,2,2,1.0,0,4,4,3,2,4,3,5,14,9,1,OKC,OKC,DET,124,16.5,Points,21,18,17,7
Chet Holmgren,C,22023,1631096,22300109,"OCT 30, 2023",OKC vs. DET,W,24,4,5,0.8,4,5,0.8,2,2,1.0,0,4,4,3,2,4,3,5,14,9,1,OKC,OKC,DET,124,8.5,Rebounds,21,18,17,7
Chet Holmgren,C,22023,1631096,22300109,"OCT 30, 2023",OKC vs. DET,W,24,4,5,0.8,4,5,0.8,2,2,1.0,0,4,4,3,2,4,3,5,14,9,1,OKC,OKC,DET,124,28.5,Pts+Rebs+Asts,21,18,17,7
Chet Holmgren,C,22023,1631096,22300109,"OCT 30, 2023",OKC vs. DET,W,24,4,5,0.8,4,5,0.8,2,2,1.0,0,4,4,3,2,4,3,5,14,9,1,OKC,OKC,DET,124,37.5,Fantasy Score,21,18,17,7
Chet Holmgren,C,22023,1631096,22300109,"OCT 30, 2023",OKC vs. DET,W,24,4,5,0.8,4,5,0.8,2,2,1.0,0,4,4,3,2,4,3,5,14,9,1,OKC,OKC,DET,124,1.5,Offensive Rebounds,21,18,17,7
Chet Holmgren,C,22023,1631096,22300109,"OCT 30, 2023",OKC vs. DET,W,24,4,5,0.8,4,5,0.8,2,2,1.0,0,4,4,3,2,4,3,5,14,9,1,OKC,OKC,DET,124,25.5,Pts+Rebs,21,18,17,7
Chet Holmgren,C,22023,1631096,22300109,"OCT 30, 2023",OKC vs. DET,W,24,4,5,0.8,4,5,0.8,2,2,1.0,0,4,4,3,2,4,3,5,14,9,1,OKC,OKC,DET,124,1.5,Dunks,21,18,17,7
Chet Holmgren,C,22023,1631096,22300109,"OCT 30, 2023",OKC vs. DET,W,24,4,5,0.8,4,5,0.8,2,2,1.0,0,4,4,3,2,4,3,5,14,9,1,OKC,OKC,DET,124,20.5,Pts+Asts,21,18,17,7
Chet Holmgren,C,22023,1631096,22300109,"OCT 30, 2023",OKC vs. DET,W,24,4,5,0.8,4,5,0.8,2,2,1.0,0,4,4,3,2,4,3,5,14,9,1,OKC,OKC,DET,124,0.5,Steals,21,18,17,7
Chet Holmgren,C,22023,1631096,22300109,"OCT 30, 2023",OKC vs. DET,W,24,4,5,0.8,4,5,0.8,2,2,1.0,0,4,4,3,2,4,3,5,14,9,1,OKC,OKC,DET,124,11.5,Rebs+Asts,21,18,17,7
Chet Holmgren,C,22023,1631096,22300109,"OCT 30, 2023",OKC vs. DET,W,24,4,5,0.8,4,5,0.8,2,2,1.0,0,4,4,3,2,4,3,5,14,9,1,OKC,OKC,DET,124,1.5,Turnovers,21,18,17,7
Chet Holmgren,C,22023,1631096,22300748,"FEB 10, 2024",OKC @ DAL,L,22,4,7,0.571,2,3,0.667,3,4,0.75,4,8,12,0,0,1,0,4,13,-3,1,OKC,DAL,OKC,111,16.5,Points,25,25,13,12
Chet Holmgren,C,22023,1631096,22300748,"FEB 10, 2024",OKC @ DAL,L,22,4,7,0.571,2,3,0.667,3,4,0.75,4,8,12,0,0,1,0,4,13,-3,1,OKC,DAL,OKC,111,8.5,Rebounds,25,25,13,12
Chet Holmgren,C,22023,1631096,22300748,"FEB 10, 2024",OKC @ DAL,L,22,4,7,0.571,2,3,0.667,3,4,0.75,4,8,12,0,0,1,0,4,13,-3,1,OKC,DAL,OKC,111,28.5,Pts+Rebs+Asts,25,25,13,12
Chet Holmgren,C,22023,1631096,22300748,"FEB 10, 2024",OKC @ DAL,L,22,4,7,0.571,2,3,0.667,3,4,0.75,4,8,12,0,0,1,0,4,13,-3,1,OKC,DAL,OKC,111,37.5,Fantasy Score,25,25,13,12
Chet Holmgren,C,22023,1631096,22300748,"FEB 10, 2024",OKC @ DAL,L,22,4,7,0.571,2,3,0.667,3,4,0.75,4,8,12,0,0,1,0,4,13,-3,1,OKC,DAL,OKC,111,1.5,Offensive Rebounds,25,25,13,12
Chet Holmgren,C,22023,1631096,22300748,"FEB 10, 2024",OKC @ DAL,L,22,4,7,0.571,2,3,0.667,3,4,0.75,4,8,12,0,0,1,0,4,13,-3,1,OKC,DAL,OKC,111,25.5,Pts+Rebs,25,25,13,12
Chet Holmgren,C,22023,1631096,22300748,"FEB 10, 2024",OKC @ DAL,L,22,4,7,0.571,2,3,0.667,3,4,0.75,4,8,12,0,0,1,0,4,13,-3,1,OKC,DAL,OKC,111,1.5,Dunks,25,25,13,12
Chet Holmgren,C,22023,1631096,22300748,"FEB 10, 2024",OKC @ DAL,L,22,4,7,0.571,2,3,0.667,3,4,0.75,4,8,12,0,0,1,0,4,13,-3,1,OKC,DAL,OKC,111,20.5,Pts+Asts,25,25,13,12
Chet Holmgren,C,22023,1631096,22300748,"FEB 10, 2024",OKC @ DAL,L,22,4,7,0.571,2,3,0.667,3,4,0.75,4,8,12,0,0,1,0,4,13,-3,1,OKC,DAL,OKC,111,0.5,Steals,25,25,13,12
Chet Holmgren,C,22023,1631096,22300748,"FEB 10, 2024",OKC @ DAL,L,22,4,7,0.571,2,3,0.667,3,4,0.75,4,8,12,0,0,1,0,4,13,-3,1,OKC,DAL,OKC,111,11.5,Rebs+Asts,25,25,13,12
Chet Holmgren,C,22023,1631096,22300748,"FEB 10, 2024",OKC @ DAL,L,22,4,7,0.571,2,3,0.667,3,4,0.75,4,8,12,0,0,1,0,4,13,-3,1,OKC,DAL,OKC,111,1.5,Turnovers,25,25,13,12
Chet Holmgren,C,22023,1631096,22300724,"FEB 06, 2024",OKC @ UTA,L,31,8,13,0.615,4,6,0.667,2,4,0.5,3,5,8,3,3,4,1,3,22,-5,1,OKC,UTA,OKC,117,16.5,Points,33,30,25,11
Chet Holmgren,C,22023,1631096,22300724,"FEB 06, 2024",OKC @ UTA,L,31,8,13,0.615,4,6,0.667,2,4,0.5,3,5,8,3,3,4,1,3,22,-5,1,OKC,UTA,OKC,117,8.5,Rebounds,33,30,25,11
Chet Holmgren,C,22023,1631096,22300724,"FEB 06, 2024",OKC @ UTA,L,31,8,13,0.615,4,6,0.667,2,4,0.5,3,5,8,3,3,4,1,3,22,-5,1,OKC,UTA,OKC,117,28.5,Pts+Rebs+Asts,33,30,25,11
Chet Holmgren,C,22023,1631096,22300724,"FEB 06, 2024",OKC @ UTA,L,31,8,13,0.615,4,6,0.667,2,4,0.5,3,5,8,3,3,4,1,3,22,-5,1,OKC,UTA,OKC,117,37.5,Fantasy Score,33,30,25,11
Chet Holmgren,C,22023,1631096,22300724,"FEB 06, 2024",OKC @ UTA,L,31,8,13,0.615,4,6,0.667,2,4,0.5,3,5,8,3,3,4,1,3,22,-5,1,OKC,UTA,OKC,117,1.5,Offensive Rebounds,33,30,25,11
Chet Holmgren,C,22023,1631096,22300724,"FEB 06, 2024",OKC @ UTA,L,31,8,13,0.615,4,6,0.667,2,4,0.5,3,5,8,3,3,4,1,3,22,-5,1,OKC,UTA,OKC,117,25.5,Pts+Rebs,33,30,25,11
Chet Holmgren,C,22023,1631096,22300724,"FEB 06, 2024",OKC @ UTA,L,31,8,13,0.615,4,6,0.667,2,4,0.5,3,5,8,3,3,4,1,3,22,-5,1,OKC,UTA,OKC,117,1.5,Dunks,33,30,25,11
Chet Holmgren,C,22023,1631096,22300724,"FEB 06, 2024",OKC @ UTA,L,31,8,13,0.615,4,6,0.667,2,4,0.5,3,5,8,3,3,4,1,3,22,-5,1,OKC,UTA,OKC,117,20.5,Pts+Asts,33,30,25,11
Chet Holmgren,C,22023,1631096,22300724,"FEB 06, 2024",OKC @ UTA,L,31,8,13,0.615,4,6,0.667,2,4,0.5,3,5,8,3,3,4,1,3,22,-5,1,OKC,UTA,OKC,117,0.5,Steals,33,30,25,11
Chet Holmgren,C,22023,1631096,22300724,"FEB 06, 2024",OKC @ UTA,L,31,8,13,0.615,4,6,0.667,2,4,0.5,3,5,8,3,3,4,1,3,22,-5,1,OKC,UTA,OKC,117,11.5,Rebs+Asts,33,30,25,11
Chet Holmgren,C,22023,1631096,22300724,"FEB 06, 2024",OKC @ UTA,L,31,8,13,0.615,4,6,0.667,2,4,0.5,3,5,8,3,3,4,1,3,22,-5,1,OKC,UTA,OKC,117,1.5,Turnovers,33,30,25,11
Chet Holmgren,C,22023,1631096,22300710,"FEB 04, 2024",OKC vs. TOR,W,41,9,17,0.529,4,10,0.4,0,0,0.0,0,5,5,4,2,2,2,1,22,10,1,OKC,OKC,TOR,135,16.5,Points,31,27,26,9
Chet Holmgren,C,22023,1631096,22300710,"FEB 04, 2024",OKC vs. TOR,W,41,9,17,0.529,4,10,0.4,0,0,0.0,0,5,5,4,2,2,2,1,22,10,1,OKC,OKC,TOR,135,8.5,Rebounds,31,27,26,9
Chet Holmgren,C,22023,1631096,22300710,"FEB 04, 2024",OKC vs. TOR,W,41,9,17,0.529,4,10,0.4,0,0,0.0,0,5,5,4,2,2,2,1,22,10,1,OKC,OKC,TOR,135,28.5,Pts+Rebs+Asts,31,27,26,9
Chet Holmgren,C,22023,1631096,22300710,"FEB 04, 2024",OKC vs. TOR,W,41,9,17,0.529,4,10,0.4,0,0,0.0,0,5,5,4,2,2,2,1,22,10,1,OKC,OKC,TOR,135,37.5,Fantasy Score,31,27,26,9
Chet Holmgren,C,22023,1631096,22300710,"FEB 04, 2024",OKC vs. TOR,W,41,9,17,0.529,4,10,0.4,0,0,0.0,0,5,5,4,2,2,2,1,22,10,1,OKC,OKC,TOR,135,1.5,Offensive Rebounds,31,27,26,9
Chet Holmgren,C,22023,1631096,22300710,"FEB 04, 2024",OKC vs. TOR,W,41,9,17,0.529,4,10,0.4,0,0,0.0,0,5,5,4,2,2,2,1,22,10,1,OKC,OKC,TOR,135,25.5,Pts+Rebs,31,27,26,9
Chet Holmgren,C,22023,1631096,22300710,"FEB 04, 2024",OKC vs. TOR,W,41,9,17,0.529,4,10,0.4,0,0,0.0,0,5,5,4,2,2,2,1,22,10,1,OKC,OKC,TOR,135,1.5,Dunks,31,27,26,9
Chet Holmgren,C,22023,1631096,22300710,"FEB 04, 2024",OKC vs. TOR,W,41,9,17,0.529,4,10,0.4,0,0,0.0,0,5,5,4,2,2,2,1,22,10,1,OKC,OKC,TOR,135,20.5,Pts+Asts,31,27,26,9
Chet Holmgren,C,22023,1631096,22300710,"FEB 04, 2024",OKC vs. TOR,W,41,9,17,0.529,4,10,0.4,0,0,0.0,0,5,5,4,2,2,2,1,22,10,1,OKC,OKC,TOR,135,0.5,Steals,31,27,26,9
Chet Holmgren,C,22023,1631096,22300710,"FEB 04, 2024",OKC vs. TOR,W,41,9,17,0.529,4,10,0.4,0,0,0.0,0,5,5,4,2,2,2,1,22,10,1,OKC,OKC,TOR,135,11.5,Rebs+Asts,31,27,26,9
Chet Holmgren,C,22023,1631096,22300710,"FEB 04, 2024",OKC vs. TOR,W,41,9,17,0.529,4,10,0.4,0,0,0.0,0,5,5,4,2,2,2,1,22,10,1,OKC,OKC,TOR,135,1.5,Turnovers,31,27,26,9
Chet Holmgren,C,22023,1631096,22300695,"FEB 02, 2024",OKC vs. CHA,W,23,5,9,0.556,3,6,0.5,3,4,0.75,0,6,6,3,1,2,1,1,16,13,1,OKC,OKC,CHA,126,16.5,Points,25,22,19,9
Chet Holmgren,C,22023,1631096,22300695,"FEB 02, 2024",OKC vs. CHA,W,23,5,9,0.556,3,6,0.5,3,4,0.75,0,6,6,3,1,2,1,1,16,13,1,OKC,OKC,CHA,126,8.5,Rebounds,25,22,19,9
Chet Holmgren,C,22023,1631096,22300695,"FEB 02, 2024",OKC vs. CHA,W,23,5,9,0.556,3,6,0.5,3,4,0.75,0,6,6,3,1,2,1,1,16,13,1,OKC,OKC,CHA,126,28.5,Pts+Rebs+Asts,25,22,19,9
Chet Holmgren,C,22023,1631096,22300695,"FEB 02, 2024",OKC vs. CHA,W,23,5,9,0.556,3,6,0.5,3,4,0.75,0,6,6,3,1,2,1,1,16,13,1,OKC,OKC,CHA,126,37.5,Fantasy Score,25,22,19,9
Chet Holmgren,C,22023,1631096,22300695,"FEB 02, 2024",OKC vs. CHA,W,23,5,9,0.556,3,6,0.5,3,4,0.75,0,6,6,3,1,2,1,1,16,13,1,OKC,OKC,CHA,126,1.5,Offensive Rebounds,25,22,19,9
Chet Holmgren,C,22023,1631096,22300695,"FEB 02, 2024",OKC vs. CHA,W,23,5,9,0.556,3,6,0.5,3,4,0.75,0,6,6,3,1,2,1,1,16,13,1,OKC,OKC,CHA,126,25.5,Pts+Rebs,25,22,19,9
Chet Holmgren,C,22023,1631096,22300695,"FEB 02, 2024",OKC vs. CHA,W,23,5,9,0.556,3,6,0.5,3,4,0.75,0,6,6,3,1,2,1,1,16,13,1,OKC,OKC,CHA,126,1.5,Dunks,25,22,19,9
Chet Holmgren,C,22023,1631096,22300695,"FEB 02, 2024",OKC vs. CHA,W,23,5,9,0.556,3,6,0.5,3,4,0.75,0,6,6,3,1,2,1,1,16,13,1,OKC,OKC,CHA,126,20.5,Pts+Asts,25,22,19,9
Chet Holmgren,C,22023,1631096,22300695,"FEB 02, 2024",OKC vs. CHA,W,23,5,9,0.556,3,6,0.5,3,4,0.75,0,6,6,3,1,2,1,1,16,13,1,OKC,OKC,CHA,126,0.5,Steals,25,22,19,9
Chet Holmgren,C,22023,1631096,22300695,"FEB 02, 2024",OKC vs. CHA,W,23,5,9,0.556,3,6,0.5,3,4,0.75,0,6,6,3,1,2,1,1,16,13,1,OKC,OKC,CHA,126,11.5,Rebs+Asts,25,22,19,9
Chet Holmgren,C,22023,1631096,22300695,"FEB 02, 2024",OKC vs. CHA,W,23,5,9,0.556,3,6,0.5,3,4,0.75,0,6,6,3,1,2,1,1,16,13,1,OKC,OKC,CHA,126,1.5,Turnovers,25,22,19,9
Chet Holmgren,C,22023,1631096,22300568,"JAN 16, 2024",OKC @ LAC,L,33,2,10,0.2,0,2,0.0,4,6,0.667,0,5,5,5,0,1,1,4,8,-14,1,OKC,LAC,OKC,117,16.5,Points,18,13,13,10
Chet Holmgren,C,22023,1631096,22300568,"JAN 16, 2024",OKC @ LAC,L,33,2,10,0.2,0,2,0.0,4,6,0.667,0,5,5,5,0,1,1,4,8,-14,1,OKC,LAC,OKC,117,8.5,Rebounds,18,13,13,10
Chet Holmgren,C,22023,1631096,22300568,"JAN 16, 2024",OKC @ LAC,L,33,2,10,0.2,0,2,0.0,4,6,0.667,0,5,5,5,0,1,1,4,8,-14,1,OKC,LAC,OKC,117,28.5,Pts+Rebs+Asts,18,13,13,10
Chet Holmgren,C,22023,1631096,22300568,"JAN 16, 2024",OKC @ LAC,L,33,2,10,0.2,0,2,0.0,4,6,0.667,0,5,5,5,0,1,1,4,8,-14,1,OKC,LAC,OKC,117,37.5,Fantasy Score,18,13,13,10
Chet Holmgren,C,22023,1631096,22300568,"JAN 16, 2024",OKC @ LAC,L,33,2,10,0.2,0,2,0.0,4,6,0.667,0,5,5,5,0,1,1,4,8,-14,1,OKC,LAC,OKC,117,1.5,Offensive Rebounds,18,13,13,10
Chet Holmgren,C,22023,1631096,22300568,"JAN 16, 2024",OKC @ LAC,L,33,2,10,0.2,0,2,0.0,4,6,0.667,0,5,5,5,0,1,1,4,8,-14,1,OKC,LAC,OKC,117,25.5,Pts+Rebs,18,13,13,10
Chet Holmgren,C,22023,1631096,22300568,"JAN 16, 2024",OKC @ LAC,L,33,2,10,0.2,0,2,0.0,4,6,0.667,0,5,5,5,0,1,1,4,8,-14,1,OKC,LAC,OKC,117,1.5,Dunks,18,13,13,10
Chet Holmgren,C,22023,1631096,22300568,"JAN 16, 2024",OKC @ LAC,L,33,2,10,0.2,0,2,0.0,4,6,0.667,0,5,5,5,0,1,1,4,8,-14,1,OKC,LAC,OKC,117,20.5,Pts+Asts,18,13,13,10
Chet Holmgren,C,22023,1631096,22300568,"JAN 16, 2024",OKC @ LAC,L,33,2,10,0.2,0,2,0.0,4,6,0.667,0,5,5,5,0,1,1,4,8,-14,1,OKC,LAC,OKC,117,0.5,Steals,18,13,13,10
Chet Holmgren,C,22023,1631096,22300568,"JAN 16, 2024",OKC @ LAC,L,33,2,10,0.2,0,2,0.0,4,6,0.667,0,5,5,5,0,1,1,4,8,-14,1,OKC,LAC,OKC,117,11.5,Rebs+Asts,18,13,13,10
Chet Holmgren,C,22023,1631096,22300568,"JAN 16, 2024",OKC @ LAC,L,33,2,10,0.2,0,2,0.0,4,6,0.667,0,5,5,5,0,1,1,4,8,-14,1,OKC,LAC,OKC,117,1.5,Turnovers,18,13,13,10
Chet Holmgren,C,22023,1631096,22300565,"JAN 15, 2024",OKC @ LAL,L,30,4,9,0.444,1,4,0.25,0,0,0.0,1,7,8,4,1,3,3,5,9,-8,1,OKC,LAL,OKC,105,16.5,Points,21,17,13,12
Chet Holmgren,C,22023,1631096,22300565,"JAN 15, 2024",OKC @ LAL,L,30,4,9,0.444,1,4,0.25,0,0,0.0,1,7,8,4,1,3,3,5,9,-8,1,OKC,LAL,OKC,105,8.5,Rebounds,21,17,13,12
Chet Holmgren,C,22023,1631096,22300565,"JAN 15, 2024",OKC @ LAL,L,30,4,9,0.444,1,4,0.25,0,0,0.0,1,7,8,4,1,3,3,5,9,-8,1,OKC,LAL,OKC,105,28.5,Pts+Rebs+Asts,21,17,13,12
Chet Holmgren,C,22023,1631096,22300565,"JAN 15, 2024",OKC @ LAL,L,30,4,9,0.444,1,4,0.25,0,0,0.0,1,7,8,4,1,3,3,5,9,-8,1,OKC,LAL,OKC,105,37.5,Fantasy Score,21,17,13,12
Chet Holmgren,C,22023,1631096,22300565,"JAN 15, 2024",OKC @ LAL,L,30,4,9,0.444,1,4,0.25,0,0,0.0,1,7,8,4,1,3,3,5,9,-8,1,OKC,LAL,OKC,105,1.5,Offensive Rebounds,21,17,13,12
Chet Holmgren,C,22023,1631096,22300565,"JAN 15, 2024",OKC @ LAL,L,30,4,9,0.444,1,4,0.25,0,0,0.0,1,7,8,4,1,3,3,5,9,-8,1,OKC,LAL,OKC,105,25.5,Pts+Rebs,21,17,13,12
Chet Holmgren,C,22023,1631096,22300565,"JAN 15, 2024",OKC @ LAL,L,30,4,9,0.444,1,4,0.25,0,0,0.0,1,7,8,4,1,3,3,5,9,-8,1,OKC,LAL,OKC,105,1.5,Dunks,21,17,13,12
Chet Holmgren,C,22023,1631096,22300565,"JAN 15, 2024",OKC @ LAL,L,30,4,9,0.444,1,4,0.25,0,0,0.0,1,7,8,4,1,3,3,5,9,-8,1,OKC,LAL,OKC,105,20.5,Pts+Asts,21,17,13,12
Chet Holmgren,C,22023,1631096,22300565,"JAN 15, 2024",OKC @ LAL,L,30,4,9,0.444,1,4,0.25,0,0,0.0,1,7,8,4,1,3,3,5,9,-8,1,OKC,LAL,OKC,105,0.5,Steals,21,17,13,12
Chet Holmgren,C,22023,1631096,22300565,"JAN 15, 2024",OKC @ LAL,L,30,4,9,0.444,1,4,0.25,0,0,0.0,1,7,8,4,1,3,3,5,9,-8,1,OKC,LAL,OKC,105,11.5,Rebs+Asts,21,17,13,12
Chet Holmgren,C,22023,1631096,22300565,"JAN 15, 2024",OKC @ LAL,L,30,4,9,0.444,1,4,0.25,0,0,0.0,1,7,8,4,1,3,3,5,9,-8,1,OKC,LAL,OKC,105,1.5,Turnovers,21,17,13,12
Chet Holmgren,C,22023,1631096,22300546,"JAN 13, 2024",OKC vs. ORL,W,32,7,14,0.5,1,5,0.2,0,0,0.0,2,6,8,3,1,2,2,0,15,5,1,OKC,OKC,ORL,112,16.5,Points,26,23,18,11
Chet Holmgren,C,22023,1631096,22300546,"JAN 13, 2024",OKC vs. ORL,W,32,7,14,0.5,1,5,0.2,0,0,0.0,2,6,8,3,1,2,2,0,15,5,1,OKC,OKC,ORL,112,8.5,Rebounds,26,23,18,11
Chet Holmgren,C,22023,1631096,22300546,"JAN 13, 2024",OKC vs. ORL,W,32,7,14,0.5,1,5,0.2,0,0,0.0,2,6,8,3,1,2,2,0,15,5,1,OKC,OKC,ORL,112,28.5,Pts+Rebs+Asts,26,23,18,11
Chet Holmgren,C,22023,1631096,22300546,"JAN 13, 2024",OKC vs. ORL,W,32,7,14,0.5,1,5,0.2,0,0,0.0,2,6,8,3,1,2,2,0,15,5,1,OKC,OKC,ORL,112,37.5,Fantasy Score,26,23,18,11
Chet Holmgren,C,22023,1631096,22300546,"JAN 13, 2024",OKC vs. ORL,W,32,7,14,0.5,1,5,0.2,0,0,0.0,2,6,8,3,1,2,2,0,15,5,1,OKC,OKC,ORL,112,1.5,Offensive Rebounds,26,23,18,11
Chet Holmgren,C,22023,1631096,22300546,"JAN 13, 2024",OKC vs. ORL,W,32,7,14,0.5,1,5,0.2,0,0,0.0,2,6,8,3,1,2,2,0,15,5,1,OKC,OKC,ORL,112,25.5,Pts+Rebs,26,23,18,11
Chet Holmgren,C,22023,1631096,22300546,"JAN 13, 2024",OKC vs. ORL,W,32,7,14,0.5,1,5,0.2,0,0,0.0,2,6,8,3,1,2,2,0,15,5,1,OKC,OKC,ORL,112,1.5,Dunks,26,23,18,11
Chet Holmgren,C,22023,1631096,22300546,"JAN 13, 2024",OKC vs. ORL,W,32,7,14,0.5,1,5,0.2,0,0,0.0,2,6,8,3,1,2,2,0,15,5,1,OKC,OKC,ORL,112,20.5,Pts+Asts,26,23,18,11
Chet Holmgren,C,22023,1631096,22300546,"JAN 13, 2024",OKC vs. ORL,W,32,7,14,0.5,1,5,0.2,0,0,0.0,2,6,8,3,1,2,2,0,15,5,1,OKC,OKC,ORL,112,0.5,Steals,26,23,18,11
Chet Holmgren,C,22023,1631096,22300546,"JAN 13, 2024",OKC vs. ORL,W,32,7,14,0.5,1,5,0.2,0,0,0.0,2,6,8,3,1,2,2,0,15,5,1,OKC,OKC,ORL,112,11.5,Rebs+Asts,26,23,18,11
Chet Holmgren,C,22023,1631096,22300546,"JAN 13, 2024",OKC vs. ORL,W,32,7,14,0.5,1,5,0.2,0,0,0.0,2,6,8,3,1,2,2,0,15,5,1,OKC,OKC,ORL,112,1.5,Turnovers,26,23,18,11
Chet Holmgren,C,22023,1631096,22300529,"JAN 11, 2024",OKC vs. POR,W,20,9,13,0.692,1,3,0.333,0,2,0.0,1,3,4,3,1,0,0,2,19,41,1,OKC,OKC,POR,139,16.5,Points,26,23,22,7
Chet Holmgren,C,22023,1631096,22300529,"JAN 11, 2024",OKC vs. POR,W,20,9,13,0.692,1,3,0.333,0,2,0.0,1,3,4,3,1,0,0,2,19,41,1,OKC,OKC,POR,139,8.5,Rebounds,26,23,22,7
Chet Holmgren,C,22023,1631096,22300529,"JAN 11, 2024",OKC vs. POR,W,20,9,13,0.692,1,3,0.333,0,2,0.0,1,3,4,3,1,0,0,2,19,41,1,OKC,OKC,POR,139,28.5,Pts+Rebs+Asts,26,23,22,7
Chet Holmgren,C,22023,1631096,22300529,"JAN 11, 2024",OKC vs. POR,W,20,9,13,0.692,1,3,0.333,0,2,0.0,1,3,4,3,1,0,0,2,19,41,1,OKC,OKC,POR,139,37.5,Fantasy Score,26,23,22,7
Chet Holmgren,C,22023,1631096,22300529,"JAN 11, 2024",OKC vs. POR,W,20,9,13,0.692,1,3,0.333,0,2,0.0,1,3,4,3,1,0,0,2,19,41,1,OKC,OKC,POR,139,1.5,Offensive Rebounds,26,23,22,7
Chet Holmgren,C,22023,1631096,22300529,"JAN 11, 2024",OKC vs. POR,W,20,9,13,0.692,1,3,0.333,0,2,0.0,1,3,4,3,1,0,0,2,19,41,1,OKC,OKC,POR,139,25.5,Pts+Rebs,26,23,22,7
Chet Holmgren,C,22023,1631096,22300529,"JAN 11, 2024",OKC vs. POR,W,20,9,13,0.692,1,3,0.333,0,2,0.0,1,3,4,3,1,0,0,2,19,41,1,OKC,OKC,POR,139,1.5,Dunks,26,23,22,7
Chet Holmgren,C,22023,1631096,22300529,"JAN 11, 2024",OKC vs. POR,W,20,9,13,0.692,1,3,0.333,0,2,0.0,1,3,4,3,1,0,0,2,19,41,1,OKC,OKC,POR,139,20.5,Pts+Asts,26,23,22,7
Chet Holmgren,C,22023,1631096,22300529,"JAN 11, 2024",OKC vs. POR,W,20,9,13,0.692,1,3,0.333,0,2,0.0,1,3,4,3,1,0,0,2,19,41,1,OKC,OKC,POR,139,0.5,Steals,26,23,22,7
Chet Holmgren,C,22023,1631096,22300529,"JAN 11, 2024",OKC vs. POR,W,20,9,13,0.692,1,3,0.333,0,2,0.0,1,3,4,3,1,0,0,2,19,41,1,OKC,OKC,POR,139,11.5,Rebs+Asts,26,23,22,7
Chet Holmgren,C,22023,1631096,22300529,"JAN 11, 2024",OKC vs. POR,W,20,9,13,0.692,1,3,0.333,0,2,0.0,1,3,4,3,1,0,0,2,19,41,1,OKC,OKC,POR,139,1.5,Turnovers,26,23,22,7
Chet Holmgren,C,22023,1631096,22300379,"DEC 21, 2023",OKC vs. LAC,W,30,9,11,0.818,2,3,0.667,3,3,1.0,0,6,6,7,0,0,1,1,23,17,1,OKC,OKC,LAC,134,16.5,Points,36,29,30,13
Chet Holmgren,C,22023,1631096,22300379,"DEC 21, 2023",OKC vs. LAC,W,30,9,11,0.818,2,3,0.667,3,3,1.0,0,6,6,7,0,0,1,1,23,17,1,OKC,OKC,LAC,134,8.5,Rebounds,36,29,30,13
Chet Holmgren,C,22023,1631096,22300379,"DEC 21, 2023",OKC vs. LAC,W,30,9,11,0.818,2,3,0.667,3,3,1.0,0,6,6,7,0,0,1,1,23,17,1,OKC,OKC,LAC,134,28.5,Pts+Rebs+Asts,36,29,30,13
Chet Holmgren,C,22023,1631096,22300379,"DEC 21, 2023",OKC vs. LAC,W,30,9,11,0.818,2,3,0.667,3,3,1.0,0,6,6,7,0,0,1,1,23,17,1,OKC,OKC,LAC,134,37.5,Fantasy Score,36,29,30,13
Chet Holmgren,C,22023,1631096,22300379,"DEC 21, 2023",OKC vs. LAC,W,30,9,11,0.818,2,3,0.667,3,3,1.0,0,6,6,7,0,0,1,1,23,17,1,OKC,OKC,LAC,134,1.5,Offensive Rebounds,36,29,30,13
Chet Holmgren,C,22023,1631096,22300379,"DEC 21, 2023",OKC vs. LAC,W,30,9,11,0.818,2,3,0.667,3,3,1.0,0,6,6,7,0,0,1,1,23,17,1,OKC,OKC,LAC,134,25.5,Pts+Rebs,36,29,30,13
Chet Holmgren,C,22023,1631096,22300379,"DEC 21, 2023",OKC vs. LAC,W,30,9,11,0.818,2,3,0.667,3,3,1.0,0,6,6,7,0,0,1,1,23,17,1,OKC,OKC,LAC,134,1.5,Dunks,36,29,30,13
Chet Holmgren,C,22023,1631096,22300379,"DEC 21, 2023",OKC vs. LAC,W,30,9,11,0.818,2,3,0.667,3,3,1.0,0,6,6,7,0,0,1,1,23,17,1,OKC,OKC,LAC,134,20.5,Pts+Asts,36,29,30,13
Chet Holmgren,C,22023,1631096,22300379,"DEC 21, 2023",OKC vs. LAC,W,30,9,11,0.818,2,3,0.667,3,3,1.0,0,6,6,7,0,0,1,1,23,17,1,OKC,OKC,LAC,134,0.5,Steals,36,29,30,13
Chet Holmgren,C,22023,1631096,22300379,"DEC 21, 2023",OKC vs. LAC,W,30,9,11,0.818,2,3,0.667,3,3,1.0,0,6,6,7,0,0,1,1,23,17,1,OKC,OKC,LAC,134,11.5,Rebs+Asts,36,29,30,13
Chet Holmgren,C,22023,1631096,22300379,"DEC 21, 2023",OKC vs. LAC,W,30,9,11,0.818,2,3,0.667,3,3,1.0,0,6,6,7,0,0,1,1,23,17,1,OKC,OKC,LAC,134,1.5,Turnovers,36,29,30,13
Chet Holmgren,C,22023,1631096,22300355,"DEC 18, 2023",OKC vs. MEM,W,25,7,14,0.5,2,4,0.5,1,1,1.0,2,4,6,2,1,7,2,2,17,13,1,OKC,OKC,MEM,116,16.5,Points,25,23,19,8
Chet Holmgren,C,22023,1631096,22300355,"DEC 18, 2023",OKC vs. MEM,W,25,7,14,0.5,2,4,0.5,1,1,1.0,2,4,6,2,1,7,2,2,17,13,1,OKC,OKC,MEM,116,8.5,Rebounds,25,23,19,8
Chet Holmgren,C,22023,1631096,22300355,"DEC 18, 2023",OKC vs. MEM,W,25,7,14,0.5,2,4,0.5,1,1,1.0,2,4,6,2,1,7,2,2,17,13,1,OKC,OKC,MEM,116,28.5,Pts+Rebs+Asts,25,23,19,8
Chet Holmgren,C,22023,1631096,22300355,"DEC 18, 2023",OKC vs. MEM,W,25,7,14,0.5,2,4,0.5,1,1,1.0,2,4,6,2,1,7,2,2,17,13,1,OKC,OKC,MEM,116,37.5,Fantasy Score,25,23,19,8
Chet Holmgren,C,22023,1631096,22300355,"DEC 18, 2023",OKC vs. MEM,W,25,7,14,0.5,2,4,0.5,1,1,1.0,2,4,6,2,1,7,2,2,17,13,1,OKC,OKC,MEM,116,1.5,Offensive Rebounds,25,23,19,8
Chet Holmgren,C,22023,1631096,22300355,"DEC 18, 2023",OKC vs. MEM,W,25,7,14,0.5,2,4,0.5,1,1,1.0,2,4,6,2,1,7,2,2,17,13,1,OKC,OKC,MEM,116,25.5,Pts+Rebs,25,23,19,8
Chet Holmgren,C,22023,1631096,22300355,"DEC 18, 2023",OKC vs. MEM,W,25,7,14,0.5,2,4,0.5,1,1,1.0,2,4,6,2,1,7,2,2,17,13,1,OKC,OKC,MEM,116,1.5,Dunks,25,23,19,8
Chet Holmgren,C,22023,1631096,22300355,"DEC 18, 2023",OKC vs. MEM,W,25,7,14,0.5,2,4,0.5,1,1,1.0,2,4,6,2,1,7,2,2,17,13,1,OKC,OKC,MEM,116,20.5,Pts+Asts,25,23,19,8
Chet Holmgren,C,22023,1631096,22300355,"DEC 18, 2023",OKC vs. MEM,W,25,7,14,0.5,2,4,0.5,1,1,1.0,2,4,6,2,1,7,2,2,17,13,1,OKC,OKC,MEM,116,0.5,Steals,25,23,19,8
Chet Holmgren,C,22023,1631096,22300355,"DEC 18, 2023",OKC vs. MEM,W,25,7,14,0.5,2,4,0.5,1,1,1.0,2,4,6,2,1,7,2,2,17,13,1,OKC,OKC,MEM,116,11.5,Rebs+Asts,25,23,19,8
Chet Holmgren,C,22023,1631096,22300355,"DEC 18, 2023",OKC vs. MEM,W,25,7,14,0.5,2,4,0.5,1,1,1.0,2,4,6,2,1,7,2,2,17,13,1,OKC,OKC,MEM,116,1.5,Turnovers,25,23,19,8
Chet Holmgren,C,22023,1631096,22300340,"DEC 16, 2023",OKC @ DEN,W,32,6,12,0.5,1,4,0.25,4,6,0.667,1,10,11,1,0,8,1,3,17,10,1,OKC,DEN,OKC,118,16.5,Points,29,28,18,12
Chet Holmgren,C,22023,1631096,22300340,"DEC 16, 2023",OKC @ DEN,W,32,6,12,0.5,1,4,0.25,4,6,0.667,1,10,11,1,0,8,1,3,17,10,1,OKC,DEN,OKC,118,8.5,Rebounds,29,28,18,12
Chet Holmgren,C,22023,1631096,22300340,"DEC 16, 2023",OKC @ DEN,W,32,6,12,0.5,1,4,0.25,4,6,0.667,1,10,11,1,0,8,1,3,17,10,1,OKC,DEN,OKC,118,28.5,Pts+Rebs+Asts,29,28,18,12
Chet Holmgren,C,22023,1631096,22300340,"DEC 16, 2023",OKC @ DEN,W,32,6,12,0.5,1,4,0.25,4,6,0.667,1,10,11,1,0,8,1,3,17,10,1,OKC,DEN,OKC,118,37.5,Fantasy Score,29,28,18,12
Chet Holmgren,C,22023,1631096,22300340,"DEC 16, 2023",OKC @ DEN,W,32,6,12,0.5,1,4,0.25,4,6,0.667,1,10,11,1,0,8,1,3,17,10,1,OKC,DEN,OKC,118,1.5,Offensive Rebounds,29,28,18,12
Chet Holmgren,C,22023,1631096,22300340,"DEC 16, 2023",OKC @ DEN,W,32,6,12,0.5,1,4,0.25,4,6,0.667,1,10,11,1,0,8,1,3,17,10,1,OKC,DEN,OKC,118,25.5,Pts+Rebs,29,28,18,12
Chet Holmgren,C,22023,1631096,22300340,"DEC 16, 2023",OKC @ DEN,W,32,6,12,0.5,1,4,0.25,4,6,0.667,1,10,11,1,0,8,1,3,17,10,1,OKC,DEN,OKC,118,1.5,Dunks,29,28,18,12
Chet Holmgren,C,22023,1631096,22300340,"DEC 16, 2023",OKC @ DEN,W,32,6,12,0.5,1,4,0.25,4,6,0.667,1,10,11,1,0,8,1,3,17,10,1,OKC,DEN,OKC,118,20.5,Pts+Asts,29,28,18,12
Chet Holmgren,C,22023,1631096,22300340,"DEC 16, 2023",OKC @ DEN,W,32,6,12,0.5,1,4,0.25,4,6,0.667,1,10,11,1,0,8,1,3,17,10,1,OKC,DEN,OKC,118,0.5,Steals,29,28,18,12
Chet Holmgren,C,22023,1631096,22300340,"DEC 16, 2023",OKC @ DEN,W,32,6,12,0.5,1,4,0.25,4,6,0.667,1,10,11,1,0,8,1,3,17,10,1,OKC,DEN,OKC,118,11.5,Rebs+Asts,29,28,18,12
Chet Holmgren,C,22023,1631096,22300340,"DEC 16, 2023",OKC @ DEN,W,32,6,12,0.5,1,4,0.25,4,6,0.667,1,10,11,1,0,8,1,3,17,10,1,OKC,DEN,OKC,118,1.5,Turnovers,29,28,18,12
Chet Holmgren,C,22023,1631096,22300058,"NOV 28, 2023",OKC @ MIN,L,34,6,20,0.3,3,8,0.375,1,2,0.5,2,6,8,6,1,1,0,2,16,-4,1,OKC,MIN,OKC,103,16.5,Points,30,24,22,14
Chet Holmgren,C,22023,1631096,22300058,"NOV 28, 2023",OKC @ MIN,L,34,6,20,0.3,3,8,0.375,1,2,0.5,2,6,8,6,1,1,0,2,16,-4,1,OKC,MIN,OKC,103,8.5,Rebounds,30,24,22,14
Chet Holmgren,C,22023,1631096,22300058,"NOV 28, 2023",OKC @ MIN,L,34,6,20,0.3,3,8,0.375,1,2,0.5,2,6,8,6,1,1,0,2,16,-4,1,OKC,MIN,OKC,103,28.5,Pts+Rebs+Asts,30,24,22,14
Chet Holmgren,C,22023,1631096,22300058,"NOV 28, 2023",OKC @ MIN,L,34,6,20,0.3,3,8,0.375,1,2,0.5,2,6,8,6,1,1,0,2,16,-4,1,OKC,MIN,OKC,103,37.5,Fantasy Score,30,24,22,14
Chet Holmgren,C,22023,1631096,22300058,"NOV 28, 2023",OKC @ MIN,L,34,6,20,0.3,3,8,0.375,1,2,0.5,2,6,8,6,1,1,0,2,16,-4,1,OKC,MIN,OKC,103,1.5,Offensive Rebounds,30,24,22,14
Chet Holmgren,C,22023,1631096,22300058,"NOV 28, 2023",OKC @ MIN,L,34,6,20,0.3,3,8,0.375,1,2,0.5,2,6,8,6,1,1,0,2,16,-4,1,OKC,MIN,OKC,103,25.5,Pts+Rebs,30,24,22,14
Chet Holmgren,C,22023,1631096,22300058,"NOV 28, 2023",OKC @ MIN,L,34,6,20,0.3,3,8,0.375,1,2,0.5,2,6,8,6,1,1,0,2,16,-4,1,OKC,MIN,OKC,103,1.5,Dunks,30,24,22,14
Chet Holmgren,C,22023,1631096,22300058,"NOV 28, 2023",OKC @ MIN,L,34,6,20,0.3,3,8,0.375,1,2,0.5,2,6,8,6,1,1,0,2,16,-4,1,OKC,MIN,OKC,103,20.5,Pts+Asts,30,24,22,14
Chet Holmgren,C,22023,1631096,22300058,"NOV 28, 2023",OKC @ MIN,L,34,6,20,0.3,3,8,0.375,1,2,0.5,2,6,8,6,1,1,0,2,16,-4,1,OKC,MIN,OKC,103,0.5,Steals,30,24,22,14
Chet Holmgren,C,22023,1631096,22300058,"NOV 28, 2023",OKC @ MIN,L,34,6,20,0.3,3,8,0.375,1,2,0.5,2,6,8,6,1,1,0,2,16,-4,1,OKC,MIN,OKC,103,11.5,Rebs+Asts,30,24,22,14
Chet Holmgren,C,22023,1631096,22300058,"NOV 28, 2023",OKC @ MIN,L,34,6,20,0.3,3,8,0.375,1,2,0.5,2,6,8,6,1,1,0,2,16,-4,1,OKC,MIN,OKC,103,1.5,Turnovers,30,24,22,14
Chet Holmgren,C,22023,1631096,22300016,"NOV 10, 2023",OKC @ SAC,L,30,5,12,0.417,0,3,0.0,2,3,0.667,1,6,7,1,1,1,4,2,12,-13,1,OKC,SAC,OKC,98,16.5,Points,20,19,13,8
Chet Holmgren,C,22023,1631096,22300016,"NOV 10, 2023",OKC @ SAC,L,30,5,12,0.417,0,3,0.0,2,3,0.667,1,6,7,1,1,1,4,2,12,-13,1,OKC,SAC,OKC,98,8.5,Rebounds,20,19,13,8
Chet Holmgren,C,22023,1631096,22300016,"NOV 10, 2023",OKC @ SAC,L,30,5,12,0.417,0,3,0.0,2,3,0.667,1,6,7,1,1,1,4,2,12,-13,1,OKC,SAC,OKC,98,28.5,Pts+Rebs+Asts,20,19,13,8
Chet Holmgren,C,22023,1631096,22300016,"NOV 10, 2023",OKC @ SAC,L,30,5,12,0.417,0,3,0.0,2,3,0.667,1,6,7,1,1,1,4,2,12,-13,1,OKC,SAC,OKC,98,37.5,Fantasy Score,20,19,13,8
Chet Holmgren,C,22023,1631096,22300016,"NOV 10, 2023",OKC @ SAC,L,30,5,12,0.417,0,3,0.0,2,3,0.667,1,6,7,1,1,1,4,2,12,-13,1,OKC,SAC,OKC,98,1.5,Offensive Rebounds,20,19,13,8
Chet Holmgren,C,22023,1631096,22300016,"NOV 10, 2023",OKC @ SAC,L,30,5,12,0.417,0,3,0.0,2,3,0.667,1,6,7,1,1,1,4,2,12,-13,1,OKC,SAC,OKC,98,25.5,Pts+Rebs,20,19,13,8
Chet Holmgren,C,22023,1631096,22300016,"NOV 10, 2023",OKC @ SAC,L,30,5,12,0.417,0,3,0.0,2,3,0.667,1,6,7,1,1,1,4,2,12,-13,1,OKC,SAC,OKC,98,1.5,Dunks,20,19,13,8
Chet Holmgren,C,22023,1631096,22300016,"NOV 10, 2023",OKC @ SAC,L,30,5,12,0.417,0,3,0.0,2,3,0.667,1,6,7,1,1,1,4,2,12,-13,1,OKC,SAC,OKC,98,20.5,Pts+Asts,20,19,13,8
Chet Holmgren,C,22023,1631096,22300016,"NOV 10, 2023",OKC @ SAC,L,30,5,12,0.417,0,3,0.0,2,3,0.667,1,6,7,1,1,1,4,2,12,-13,1,OKC,SAC,OKC,98,0.5,Steals,20,19,13,8
Chet Holmgren,C,22023,1631096,22300016,"NOV 10, 2023",OKC @ SAC,L,30,5,12,0.417,0,3,0.0,2,3,0.667,1,6,7,1,1,1,4,2,12,-13,1,OKC,SAC,OKC,98,11.5,Rebs+Asts,20,19,13,8
Chet Holmgren,C,22023,1631096,22300016,"NOV 10, 2023",OKC @ SAC,L,30,5,12,0.417,0,3,0.0,2,3,0.667,1,6,7,1,1,1,4,2,12,-13,1,OKC,SAC,OKC,98,1.5,Turnovers,20,19,13,8
Chet Holmgren,C,22023,1631096,22300155,"NOV 06, 2023",OKC vs. ATL,W,34,4,14,0.286,1,3,0.333,7,7,1.0,3,9,12,3,1,3,1,3,16,4,1,OKC,OKC,ATL,126,16.5,Points,31,28,19,15
Chet Holmgren,C,22023,1631096,22300155,"NOV 06, 2023",OKC vs. ATL,W,34,4,14,0.286,1,3,0.333,7,7,1.0,3,9,12,3,1,3,1,3,16,4,1,OKC,OKC,ATL,126,8.5,Rebounds,31,28,19,15
Chet Holmgren,C,22023,1631096,22300155,"NOV 06, 2023",OKC vs. ATL,W,34,4,14,0.286,1,3,0.333,7,7,1.0,3,9,12,3,1,3,1,3,16,4,1,OKC,OKC,ATL,126,28.5,Pts+Rebs+Asts,31,28,19,15
Chet Holmgren,C,22023,1631096,22300155,"NOV 06, 2023",OKC vs. ATL,W,34,4,14,0.286,1,3,0.333,7,7,1.0,3,9,12,3,1,3,1,3,16,4,1,OKC,OKC,ATL,126,37.5,Fantasy Score,31,28,19,15
Chet Holmgren,C,22023,1631096,22300155,"NOV 06, 2023",OKC vs. ATL,W,34,4,14,0.286,1,3,0.333,7,7,1.0,3,9,12,3,1,3,1,3,16,4,1,OKC,OKC,ATL,126,1.5,Offensive Rebounds,31,28,19,15
Chet Holmgren,C,22023,1631096,22300155,"NOV 06, 2023",OKC vs. ATL,W,34,4,14,0.286,1,3,0.333,7,7,1.0,3,9,12,3,1,3,1,3,16,4,1,OKC,OKC,ATL,126,25.5,Pts+Rebs,31,28,19,15
Chet Holmgren,C,22023,1631096,22300155,"NOV 06, 2023",OKC vs. ATL,W,34,4,14,0.286,1,3,0.333,7,7,1.0,3,9,12,3,1,3,1,3,16,4,1,OKC,OKC,ATL,126,1.5,Dunks,31,28,19,15
Chet Holmgren,C,22023,1631096,22300155,"NOV 06, 2023",OKC vs. ATL,W,34,4,14,0.286,1,3,0.333,7,7,1.0,3,9,12,3,1,3,1,3,16,4,1,OKC,OKC,ATL,126,20.5,Pts+Asts,31,28,19,15
Chet Holmgren,C,22023,1631096,22300155,"NOV 06, 2023",OKC vs. ATL,W,34,4,14,0.286,1,3,0.333,7,7,1.0,3,9,12,3,1,3,1,3,16,4,1,OKC,OKC,ATL,126,0.5,Steals,31,28,19,15
Chet Holmgren,C,22023,1631096,22300155,"NOV 06, 2023",OKC vs. ATL,W,34,4,14,0.286,1,3,0.333,7,7,1.0,3,9,12,3,1,3,1,3,16,4,1,OKC,OKC,ATL,126,11.5,Rebs+Asts,31,28,19,15
Chet Holmgren,C,22023,1631096,22300155,"NOV 06, 2023",OKC vs. ATL,W,34,4,14,0.286,1,3,0.333,7,7,1.0,3,9,12,3,1,3,1,3,16,4,1,OKC,OKC,ATL,126,1.5,Turnovers,31,28,19,15
Chet Holmgren,C,22023,1631096,22300005,"NOV 03, 2023",OKC vs. GSW,L,32,7,9,0.778,2,2,1.0,8,8,1.0,3,5,8,5,1,1,2,4,24,-1,1,OKC,OKC,GSW,139,16.5,Points,37,32,29,13
Chet Holmgren,C,22023,1631096,22300005,"NOV 03, 2023",OKC vs. GSW,L,32,7,9,0.778,2,2,1.0,8,8,1.0,3,5,8,5,1,1,2,4,24,-1,1,OKC,OKC,GSW,139,8.5,Rebounds,37,32,29,13
Chet Holmgren,C,22023,1631096,22300005,"NOV 03, 2023",OKC vs. GSW,L,32,7,9,0.778,2,2,1.0,8,8,1.0,3,5,8,5,1,1,2,4,24,-1,1,OKC,OKC,GSW,139,28.5,Pts+Rebs+Asts,37,32,29,13
Chet Holmgren,C,22023,1631096,22300005,"NOV 03, 2023",OKC vs. GSW,L,32,7,9,0.778,2,2,1.0,8,8,1.0,3,5,8,5,1,1,2,4,24,-1,1,OKC,OKC,GSW,139,37.5,Fantasy Score,37,32,29,13
Chet Holmgren,C,22023,1631096,22300005,"NOV 03, 2023",OKC vs. GSW,L,32,7,9,0.778,2,2,1.0,8,8,1.0,3,5,8,5,1,1,2,4,24,-1,1,OKC,OKC,GSW,139,1.5,Offensive Rebounds,37,32,29,13
Chet Holmgren,C,22023,1631096,22300005,"NOV 03, 2023",OKC vs. GSW,L,32,7,9,0.778,2,2,1.0,8,8,1.0,3,5,8,5,1,1,2,4,24,-1,1,OKC,OKC,GSW,139,25.5,Pts+Rebs,37,32,29,13
Chet Holmgren,C,22023,1631096,22300005,"NOV 03, 2023",OKC vs. GSW,L,32,7,9,0.778,2,2,1.0,8,8,1.0,3,5,8,5,1,1,2,4,24,-1,1,OKC,OKC,GSW,139,1.5,Dunks,37,32,29,13
Chet Holmgren,C,22023,1631096,22300005,"NOV 03, 2023",OKC vs. GSW,L,32,7,9,0.778,2,2,1.0,8,8,1.0,3,5,8,5,1,1,2,4,24,-1,1,OKC,OKC,GSW,139,20.5,Pts+Asts,37,32,29,13
Chet Holmgren,C,22023,1631096,22300005,"NOV 03, 2023",OKC vs. GSW,L,32,7,9,0.778,2,2,1.0,8,8,1.0,3,5,8,5,1,1,2,4,24,-1,1,OKC,OKC,GSW,139,0.5,Steals,37,32,29,13
Chet Holmgren,C,22023,1631096,22300005,"NOV 03, 2023",OKC vs. GSW,L,32,7,9,0.778,2,2,1.0,8,8,1.0,3,5,8,5,1,1,2,4,24,-1,1,OKC,OKC,GSW,139,11.5,Rebs+Asts,37,32,29,13
Chet Holmgren,C,22023,1631096,22300005,"NOV 03, 2023",OKC vs. GSW,L,32,7,9,0.778,2,2,1.0,8,8,1.0,3,5,8,5,1,1,2,4,24,-1,1,OKC,OKC,GSW,139,1.5,Turnovers,37,32,29,13
Chet Holmgren,C,22023,1631096,22300121,"NOV 01, 2023",OKC vs. NOP,L,37,8,14,0.571,1,5,0.2,2,2,1.0,3,8,11,3,1,2,5,4,19,-3,1,OKC,OKC,NOP,106,16.5,Points,33,30,22,14
Chet Holmgren,C,22023,1631096,22300121,"NOV 01, 2023",OKC vs. NOP,L,37,8,14,0.571,1,5,0.2,2,2,1.0,3,8,11,3,1,2,5,4,19,-3,1,OKC,OKC,NOP,106,8.5,Rebounds,33,30,22,14
Chet Holmgren,C,22023,1631096,22300121,"NOV 01, 2023",OKC vs. NOP,L,37,8,14,0.571,1,5,0.2,2,2,1.0,3,8,11,3,1,2,5,4,19,-3,1,OKC,OKC,NOP,106,28.5,Pts+Rebs+Asts,33,30,22,14
Chet Holmgren,C,22023,1631096,22300121,"NOV 01, 2023",OKC vs. NOP,L,37,8,14,0.571,1,5,0.2,2,2,1.0,3,8,11,3,1,2,5,4,19,-3,1,OKC,OKC,NOP,106,37.5,Fantasy Score,33,30,22,14
Chet Holmgren,C,22023,1631096,22300121,"NOV 01, 2023",OKC vs. NOP,L,37,8,14,0.571,1,5,0.2,2,2,1.0,3,8,11,3,1,2,5,4,19,-3,1,OKC,OKC,NOP,106,1.5,Offensive Rebounds,33,30,22,14
Chet Holmgren,C,22023,1631096,22300121,"NOV 01, 2023",OKC vs. NOP,L,37,8,14,0.571,1,5,0.2,2,2,1.0,3,8,11,3,1,2,5,4,19,-3,1,OKC,OKC,NOP,106,25.5,Pts+Rebs,33,30,22,14
Chet Holmgren,C,22023,1631096,22300121,"NOV 01, 2023",OKC vs. NOP,L,37,8,14,0.571,1,5,0.2,2,2,1.0,3,8,11,3,1,2,5,4,19,-3,1,OKC,OKC,NOP,106,1.5,Dunks,33,30,22,14
Chet Holmgren,C,22023,1631096,22300121,"NOV 01, 2023",OKC vs. NOP,L,37,8,14,0.571,1,5,0.2,2,2,1.0,3,8,11,3,1,2,5,4,19,-3,1,OKC,OKC,NOP,106,20.5,Pts+Asts,33,30,22,14
Chet Holmgren,C,22023,1631096,22300121,"NOV 01, 2023",OKC vs. NOP,L,37,8,14,0.571,1,5,0.2,2,2,1.0,3,8,11,3,1,2,5,4,19,-3,1,OKC,OKC,NOP,106,0.5,Steals,33,30,22,14
Chet Holmgren,C,22023,1631096,22300121,"NOV 01, 2023",OKC vs. NOP,L,37,8,14,0.571,1,5,0.2,2,2,1.0,3,8,11,3,1,2,5,4,19,-3,1,OKC,OKC,NOP,106,11.5,Rebs+Asts,33,30,22,14
Chet Holmgren,C,22023,1631096,22300121,"NOV 01, 2023",OKC vs. NOP,L,37,8,14,0.571,1,5,0.2,2,2,1.0,3,8,11,3,1,2,5,4,19,-3,1,OKC,OKC,NOP,106,1.5,Turnovers,33,30,22,14
Chet Holmgren,C,22023,1631096,22300095,"OCT 29, 2023",OKC vs. DEN,L,26,7,12,0.583,1,4,0.25,4,4,1.0,2,2,4,0,0,0,1,2,19,-23,1,OKC,OKC,DEN,95,16.5,Points,23,23,19,4
Chet Holmgren,C,22023,1631096,22300095,"OCT 29, 2023",OKC vs. DEN,L,26,7,12,0.583,1,4,0.25,4,4,1.0,2,2,4,0,0,0,1,2,19,-23,1,OKC,OKC,DEN,95,8.5,Rebounds,23,23,19,4
Chet Holmgren,C,22023,1631096,22300095,"OCT 29, 2023",OKC vs. DEN,L,26,7,12,0.583,1,4,0.25,4,4,1.0,2,2,4,0,0,0,1,2,19,-23,1,OKC,OKC,DEN,95,28.5,Pts+Rebs+Asts,23,23,19,4
Chet Holmgren,C,22023,1631096,22300095,"OCT 29, 2023",OKC vs. DEN,L,26,7,12,0.583,1,4,0.25,4,4,1.0,2,2,4,0,0,0,1,2,19,-23,1,OKC,OKC,DEN,95,37.5,Fantasy Score,23,23,19,4
Chet Holmgren,C,22023,1631096,22300095,"OCT 29, 2023",OKC vs. DEN,L,26,7,12,0.583,1,4,0.25,4,4,1.0,2,2,4,0,0,0,1,2,19,-23,1,OKC,OKC,DEN,95,1.5,Offensive Rebounds,23,23,19,4
Chet Holmgren,C,22023,1631096,22300095,"OCT 29, 2023",OKC vs. DEN,L,26,7,12,0.583,1,4,0.25,4,4,1.0,2,2,4,0,0,0,1,2,19,-23,1,OKC,OKC,DEN,95,25.5,Pts+Rebs,23,23,19,4
Chet Holmgren,C,22023,1631096,22300095,"OCT 29, 2023",OKC vs. DEN,L,26,7,12,0.583,1,4,0.25,4,4,1.0,2,2,4,0,0,0,1,2,19,-23,1,OKC,OKC,DEN,95,1.5,Dunks,23,23,19,4
Chet Holmgren,C,22023,1631096,22300095,"OCT 29, 2023",OKC vs. DEN,L,26,7,12,0.583,1,4,0.25,4,4,1.0,2,2,4,0,0,0,1,2,19,-23,1,OKC,OKC,DEN,95,20.5,Pts+Asts,23,23,19,4
Chet Holmgren,C,22023,1631096,22300095,"OCT 29, 2023",OKC vs. DEN,L,26,7,12,0.583,1,4,0.25,4,4,1.0,2,2,4,0,0,0,1,2,19,-23,1,OKC,OKC,DEN,95,0.5,Steals,23,23,19,4
Chet Holmgren,C,22023,1631096,22300095,"OCT 29, 2023",OKC vs. DEN,L,26,7,12,0.583,1,4,0.25,4,4,1.0,2,2,4,0,0,0,1,2,19,-23,1,OKC,OKC,DEN,95,11.5,Rebs+Asts,23,23,19,4
Chet Holmgren,C,22023,1631096,22300095,"OCT 29, 2023",OKC vs. DEN,L,26,7,12,0.583,1,4,0.25,4,4,1.0,2,2,4,0,0,0,1,2,19,-23,1,OKC,OKC,DEN,95,1.5,Turnovers,23,23,19,4
Chet Holmgren,C,22023,1631096,22300081,"OCT 27, 2023",OKC @ CLE,W,31,5,9,0.556,3,4,0.75,3,4,0.75,1,12,13,2,1,7,1,3,16,6,1,OKC,CLE,OKC,108,16.5,Points,31,29,18,15
Chet Holmgren,C,22023,1631096,22300081,"OCT 27, 2023",OKC @ CLE,W,31,5,9,0.556,3,4,0.75,3,4,0.75,1,12,13,2,1,7,1,3,16,6,1,OKC,CLE,OKC,108,8.5,Rebounds,31,29,18,15
Chet Holmgren,C,22023,1631096,22300081,"OCT 27, 2023",OKC @ CLE,W,31,5,9,0.556,3,4,0.75,3,4,0.75,1,12,13,2,1,7,1,3,16,6,1,OKC,CLE,OKC,108,28.5,Pts+Rebs+Asts,31,29,18,15
Chet Holmgren,C,22023,1631096,22300081,"OCT 27, 2023",OKC @ CLE,W,31,5,9,0.556,3,4,0.75,3,4,0.75,1,12,13,2,1,7,1,3,16,6,1,OKC,CLE,OKC,108,37.5,Fantasy Score,31,29,18,15
Chet Holmgren,C,22023,1631096,22300081,"OCT 27, 2023",OKC @ CLE,W,31,5,9,0.556,3,4,0.75,3,4,0.75,1,12,13,2,1,7,1,3,16,6,1,OKC,CLE,OKC,108,1.5,Offensive Rebounds,31,29,18,15
Chet Holmgren,C,22023,1631096,22300081,"OCT 27, 2023",OKC @ CLE,W,31,5,9,0.556,3,4,0.75,3,4,0.75,1,12,13,2,1,7,1,3,16,6,1,OKC,CLE,OKC,108,25.5,Pts+Rebs,31,29,18,15
Chet Holmgren,C,22023,1631096,22300081,"OCT 27, 2023",OKC @ CLE,W,31,5,9,0.556,3,4,0.75,3,4,0.75,1,12,13,2,1,7,1,3,16,6,1,OKC,CLE,OKC,108,1.5,Dunks,31,29,18,15
Chet Holmgren,C,22023,1631096,22300081,"OCT 27, 2023",OKC @ CLE,W,31,5,9,0.556,3,4,0.75,3,4,0.75,1,12,13,2,1,7,1,3,16,6,1,OKC,CLE,OKC,108,20.5,Pts+Asts,31,29,18,15
Chet Holmgren,C,22023,1631096,22300081,"OCT 27, 2023",OKC @ CLE,W,31,5,9,0.556,3,4,0.75,3,4,0.75,1,12,13,2,1,7,1,3,16,6,1,OKC,CLE,OKC,108,0.5,Steals,31,29,18,15
Chet Holmgren,C,22023,1631096,22300081,"OCT 27, 2023",OKC @ CLE,W,31,5,9,0.556,3,4,0.75,3,4,0.75,1,12,13,2,1,7,1,3,16,6,1,OKC,CLE,OKC,108,11.5,Rebs+Asts,31,29,18,15
Chet Holmgren,C,22023,1631096,22300081,"OCT 27, 2023",OKC @ CLE,W,31,5,9,0.556,3,4,0.75,3,4,0.75,1,12,13,2,1,7,1,3,16,6,1,OKC,CLE,OKC,108,1.5,Turnovers,31,29,18,15
Chet Holmgren,C,22023,1631096,22300070,"OCT 25, 2023",OKC @ CHI,W,25,4,7,0.571,2,3,0.667,1,3,0.333,0,4,4,3,1,0,1,3,11,14,1,OKC,CHI,OKC,124,16.5,Points,18,15,14,7
Chet Holmgren,C,22023,1631096,22300070,"OCT 25, 2023",OKC @ CHI,W,25,4,7,0.571,2,3,0.667,1,3,0.333,0,4,4,3,1,0,1,3,11,14,1,OKC,CHI,OKC,124,8.5,Rebounds,18,15,14,7
Chet Holmgren,C,22023,1631096,22300070,"OCT 25, 2023",OKC @ CHI,W,25,4,7,0.571,2,3,0.667,1,3,0.333,0,4,4,3,1,0,1,3,11,14,1,OKC,CHI,OKC,124,28.5,Pts+Rebs+Asts,18,15,14,7
Chet Holmgren,C,22023,1631096,22300070,"OCT 25, 2023",OKC @ CHI,W,25,4,7,0.571,2,3,0.667,1,3,0.333,0,4,4,3,1,0,1,3,11,14,1,OKC,CHI,OKC,124,37.5,Fantasy Score,18,15,14,7
Chet Holmgren,C,22023,1631096,22300070,"OCT 25, 2023",OKC @ CHI,W,25,4,7,0.571,2,3,0.667,1,3,0.333,0,4,4,3,1,0,1,3,11,14,1,OKC,CHI,OKC,124,1.5,Offensive Rebounds,18,15,14,7
Chet Holmgren,C,22023,1631096,22300070,"OCT 25, 2023",OKC @ CHI,W,25,4,7,0.571,2,3,0.667,1,3,0.333,0,4,4,3,1,0,1,3,11,14,1,OKC,CHI,OKC,124,25.5,Pts+Rebs,18,15,14,7
Chet Holmgren,C,22023,1631096,22300070,"OCT 25, 2023",OKC @ CHI,W,25,4,7,0.571,2,3,0.667,1,3,0.333,0,4,4,3,1,0,1,3,11,14,1,OKC,CHI,OKC,124,1.5,Dunks,18,15,14,7
Chet Holmgren,C,22023,1631096,22300070,"OCT 25, 2023",OKC @ CHI,W,25,4,7,0.571,2,3,0.667,1,3,0.333,0,4,4,3,1,0,1,3,11,14,1,OKC,CHI,OKC,124,20.5,Pts+Asts,18,15,14,7
Chet Holmgren,C,22023,1631096,22300070,"OCT 25, 2023",OKC @ CHI,W,25,4,7,0.571,2,3,0.667,1,3,0.333,0,4,4,3,1,0,1,3,11,14,1,OKC,CHI,OKC,124,0.5,Steals,18,15,14,7
Chet Holmgren,C,22023,1631096,22300070,"OCT 25, 2023",OKC @ CHI,W,25,4,7,0.571,2,3,0.667,1,3,0.333,0,4,4,3,1,0,1,3,11,14,1,OKC,CHI,OKC,124,11.5,Rebs+Asts,18,15,14,7
Chet Holmgren,C,22023,1631096,22300070,"OCT 25, 2023",OKC @ CHI,W,25,4,7,0.571,2,3,0.667,1,3,0.333,0,4,4,3,1,0,1,3,11,14,1,OKC,CHI,OKC,124,1.5,Turnovers,18,15,14,7
Chet Holmgren,C,22023,1631096,22300664,"JAN 29, 2024",OKC vs. MIN,L,32,2,9,0.222,0,2,0.0,0,0,0.0,1,6,7,2,0,3,2,0,4,-13,1,OKC,OKC,MIN,101,16.5,Points,13,11,6,9
Chet Holmgren,C,22023,1631096,22300664,"JAN 29, 2024",OKC vs. MIN,L,32,2,9,0.222,0,2,0.0,0,0,0.0,1,6,7,2,0,3,2,0,4,-13,1,OKC,OKC,MIN,101,8.5,Rebounds,13,11,6,9
Chet Holmgren,C,22023,1631096,22300664,"JAN 29, 2024",OKC vs. MIN,L,32,2,9,0.222,0,2,0.0,0,0,0.0,1,6,7,2,0,3,2,0,4,-13,1,OKC,OKC,MIN,101,28.5,Pts+Rebs+Asts,13,11,6,9
Chet Holmgren,C,22023,1631096,22300664,"JAN 29, 2024",OKC vs. MIN,L,32,2,9,0.222,0,2,0.0,0,0,0.0,1,6,7,2,0,3,2,0,4,-13,1,OKC,OKC,MIN,101,37.5,Fantasy Score,13,11,6,9
Chet Holmgren,C,22023,1631096,22300664,"JAN 29, 2024",OKC vs. MIN,L,32,2,9,0.222,0,2,0.0,0,0,0.0,1,6,7,2,0,3,2,0,4,-13,1,OKC,OKC,MIN,101,1.5,Offensive Rebounds,13,11,6,9
Chet Holmgren,C,22023,1631096,22300664,"JAN 29, 2024",OKC vs. MIN,L,32,2,9,0.222,0,2,0.0,0,0,0.0,1,6,7,2,0,3,2,0,4,-13,1,OKC,OKC,MIN,101,25.5,Pts+Rebs,13,11,6,9
Chet Holmgren,C,22023,1631096,22300664,"JAN 29, 2024",OKC vs. MIN,L,32,2,9,0.222,0,2,0.0,0,0,0.0,1,6,7,2,0,3,2,0,4,-13,1,OKC,OKC,MIN,101,1.5,Dunks,13,11,6,9
Chet Holmgren,C,22023,1631096,22300664,"JAN 29, 2024",OKC vs. MIN,L,32,2,9,0.222,0,2,0.0,0,0,0.0,1,6,7,2,0,3,2,0,4,-13,1,OKC,OKC,MIN,101,20.5,Pts+Asts,13,11,6,9
Chet Holmgren,C,22023,1631096,22300664,"JAN 29, 2024",OKC vs. MIN,L,32,2,9,0.222,0,2,0.0,0,0,0.0,1,6,7,2,0,3,2,0,4,-13,1,OKC,OKC,MIN,101,0.5,Steals,13,11,6,9
Chet Holmgren,C,22023,1631096,22300664,"JAN 29, 2024",OKC vs. MIN,L,32,2,9,0.222,0,2,0.0,0,0,0.0,1,6,7,2,0,3,2,0,4,-13,1,OKC,OKC,MIN,101,11.5,Rebs+Asts,13,11,6,9
Chet Holmgren,C,22023,1631096,22300664,"JAN 29, 2024",OKC vs. MIN,L,32,2,9,0.222,0,2,0.0,0,0,0.0,1,6,7,2,0,3,2,0,4,-13,1,OKC,OKC,MIN,101,1.5,Turnovers,13,11,6,9
Chet Holmgren,C,22023,1631096,22300654,"JAN 28, 2024",OKC @ DET,L,23,4,11,0.364,1,5,0.2,0,1,0.0,1,11,12,1,0,1,1,0,9,-20,1,OKC,DET,OKC,104,16.5,Points,22,21,10,13
Chet Holmgren,C,22023,1631096,22300654,"JAN 28, 2024",OKC @ DET,L,23,4,11,0.364,1,5,0.2,0,1,0.0,1,11,12,1,0,1,1,0,9,-20,1,OKC,DET,OKC,104,8.5,Rebounds,22,21,10,13
Chet Holmgren,C,22023,1631096,22300654,"JAN 28, 2024",OKC @ DET,L,23,4,11,0.364,1,5,0.2,0,1,0.0,1,11,12,1,0,1,1,0,9,-20,1,OKC,DET,OKC,104,28.5,Pts+Rebs+Asts,22,21,10,13
Chet Holmgren,C,22023,1631096,22300654,"JAN 28, 2024",OKC @ DET,L,23,4,11,0.364,1,5,0.2,0,1,0.0,1,11,12,1,0,1,1,0,9,-20,1,OKC,DET,OKC,104,37.5,Fantasy Score,22,21,10,13
Chet Holmgren,C,22023,1631096,22300654,"JAN 28, 2024",OKC @ DET,L,23,4,11,0.364,1,5,0.2,0,1,0.0,1,11,12,1,0,1,1,0,9,-20,1,OKC,DET,OKC,104,1.5,Offensive Rebounds,22,21,10,13
Chet Holmgren,C,22023,1631096,22300654,"JAN 28, 2024",OKC @ DET,L,23,4,11,0.364,1,5,0.2,0,1,0.0,1,11,12,1,0,1,1,0,9,-20,1,OKC,DET,OKC,104,25.5,Pts+Rebs,22,21,10,13
Chet Holmgren,C,22023,1631096,22300654,"JAN 28, 2024",OKC @ DET,L,23,4,11,0.364,1,5,0.2,0,1,0.0,1,11,12,1,0,1,1,0,9,-20,1,OKC,DET,OKC,104,1.5,Dunks,22,21,10,13
Chet Holmgren,C,22023,1631096,22300654,"JAN 28, 2024",OKC @ DET,L,23,4,11,0.364,1,5,0.2,0,1,0.0,1,11,12,1,0,1,1,0,9,-20,1,OKC,DET,OKC,104,20.5,Pts+Asts,22,21,10,13
Chet Holmgren,C,22023,1631096,22300654,"JAN 28, 2024",OKC @ DET,L,23,4,11,0.364,1,5,0.2,0,1,0.0,1,11,12,1,0,1,1,0,9,-20,1,OKC,DET,OKC,104,0.5,Steals,22,21,10,13
Chet Holmgren,C,22023,1631096,22300654,"JAN 28, 2024",OKC @ DET,L,23,4,11,0.364,1,5,0.2,0,1,0.0,1,11,12,1,0,1,1,0,9,-20,1,OKC,DET,OKC,104,11.5,Rebs+Asts,22,21,10,13
Chet Holmgren,C,22023,1631096,22300654,"JAN 28, 2024",OKC @ DET,L,23,4,11,0.364,1,5,0.2,0,1,0.0,1,11,12,1,0,1,1,0,9,-20,1,OKC,DET,OKC,104,1.5,Turnovers,22,21,10,13
Chet Holmgren,C,22023,1631096,22300640,"JAN 26, 2024",OKC @ NOP,W,30,9,16,0.563,2,6,0.333,0,0,0.0,2,11,13,0,1,2,0,1,20,18,1,OKC,NOP,OKC,107,16.5,Points,33,33,20,13
Chet Holmgren,C,22023,1631096,22300640,"JAN 26, 2024",OKC @ NOP,W,30,9,16,0.563,2,6,0.333,0,0,0.0,2,11,13,0,1,2,0,1,20,18,1,OKC,NOP,OKC,107,8.5,Rebounds,33,33,20,13
Chet Holmgren,C,22023,1631096,22300640,"JAN 26, 2024",OKC @ NOP,W,30,9,16,0.563,2,6,0.333,0,0,0.0,2,11,13,0,1,2,0,1,20,18,1,OKC,NOP,OKC,107,28.5,Pts+Rebs+Asts,33,33,20,13
Chet Holmgren,C,22023,1631096,22300640,"JAN 26, 2024",OKC @ NOP,W,30,9,16,0.563,2,6,0.333,0,0,0.0,2,11,13,0,1,2,0,1,20,18,1,OKC,NOP,OKC,107,37.5,Fantasy Score,33,33,20,13
Chet Holmgren,C,22023,1631096,22300640,"JAN 26, 2024",OKC @ NOP,W,30,9,16,0.563,2,6,0.333,0,0,0.0,2,11,13,0,1,2,0,1,20,18,1,OKC,NOP,OKC,107,1.5,Offensive Rebounds,33,33,20,13
Chet Holmgren,C,22023,1631096,22300640,"JAN 26, 2024",OKC @ NOP,W,30,9,16,0.563,2,6,0.333,0,0,0.0,2,11,13,0,1,2,0,1,20,18,1,OKC,NOP,OKC,107,25.5,Pts+Rebs,33,33,20,13
Chet Holmgren,C,22023,1631096,22300640,"JAN 26, 2024",OKC @ NOP,W,30,9,16,0.563,2,6,0.333,0,0,0.0,2,11,13,0,1,2,0,1,20,18,1,OKC,NOP,OKC,107,1.5,Dunks,33,33,20,13
Chet Holmgren,C,22023,1631096,22300640,"JAN 26, 2024",OKC @ NOP,W,30,9,16,0.563,2,6,0.333,0,0,0.0,2,11,13,0,1,2,0,1,20,18,1,OKC,NOP,OKC,107,20.5,Pts+Asts,33,33,20,13
Chet Holmgren,C,22023,1631096,22300640,"JAN 26, 2024",OKC @ NOP,W,30,9,16,0.563,2,6,0.333,0,0,0.0,2,11,13,0,1,2,0,1,20,18,1,OKC,NOP,OKC,107,0.5,Steals,33,33,20,13
Chet Holmgren,C,22023,1631096,22300640,"JAN 26, 2024",OKC @ NOP,W,30,9,16,0.563,2,6,0.333,0,0,0.0,2,11,13,0,1,2,0,1,20,18,1,OKC,NOP,OKC,107,11.5,Rebs+Asts,33,33,20,13
Chet Holmgren,C,22023,1631096,22300640,"JAN 26, 2024",OKC @ NOP,W,30,9,16,0.563,2,6,0.333,0,0,0.0,2,11,13,0,1,2,0,1,20,18,1,OKC,NOP,OKC,107,1.5,Turnovers,33,33,20,13
Chet Holmgren,C,22023,1631096,22300599,"JAN 20, 2024",OKC @ MIN,W,33,4,8,0.5,1,2,0.5,6,6,1.0,1,4,5,2,1,2,0,4,15,8,1,OKC,MIN,OKC,102,16.5,Points,22,20,17,7
Chet Holmgren,C,22023,1631096,22300599,"JAN 20, 2024",OKC @ MIN,W,33,4,8,0.5,1,2,0.5,6,6,1.0,1,4,5,2,1,2,0,4,15,8,1,OKC,MIN,OKC,102,8.5,Rebounds,22,20,17,7
Chet Holmgren,C,22023,1631096,22300599,"JAN 20, 2024",OKC @ MIN,W,33,4,8,0.5,1,2,0.5,6,6,1.0,1,4,5,2,1,2,0,4,15,8,1,OKC,MIN,OKC,102,28.5,Pts+Rebs+Asts,22,20,17,7
Chet Holmgren,C,22023,1631096,22300599,"JAN 20, 2024",OKC @ MIN,W,33,4,8,0.5,1,2,0.5,6,6,1.0,1,4,5,2,1,2,0,4,15,8,1,OKC,MIN,OKC,102,37.5,Fantasy Score,22,20,17,7
Chet Holmgren,C,22023,1631096,22300599,"JAN 20, 2024",OKC @ MIN,W,33,4,8,0.5,1,2,0.5,6,6,1.0,1,4,5,2,1,2,0,4,15,8,1,OKC,MIN,OKC,102,1.5,Offensive Rebounds,22,20,17,7
Chet Holmgren,C,22023,1631096,22300599,"JAN 20, 2024",OKC @ MIN,W,33,4,8,0.5,1,2,0.5,6,6,1.0,1,4,5,2,1,2,0,4,15,8,1,OKC,MIN,OKC,102,25.5,Pts+Rebs,22,20,17,7
Chet Holmgren,C,22023,1631096,22300599,"JAN 20, 2024",OKC @ MIN,W,33,4,8,0.5,1,2,0.5,6,6,1.0,1,4,5,2,1,2,0,4,15,8,1,OKC,MIN,OKC,102,1.5,Dunks,22,20,17,7
Chet Holmgren,C,22023,1631096,22300599,"JAN 20, 2024",OKC @ MIN,W,33,4,8,0.5,1,2,0.5,6,6,1.0,1,4,5,2,1,2,0,4,15,8,1,OKC,MIN,OKC,102,20.5,Pts+Asts,22,20,17,7
Chet Holmgren,C,22023,1631096,22300599,"JAN 20, 2024",OKC @ MIN,W,33,4,8,0.5,1,2,0.5,6,6,1.0,1,4,5,2,1,2,0,4,15,8,1,OKC,MIN,OKC,102,0.5,Steals,22,20,17,7
Chet Holmgren,C,22023,1631096,22300599,"JAN 20, 2024",OKC @ MIN,W,33,4,8,0.5,1,2,0.5,6,6,1.0,1,4,5,2,1,2,0,4,15,8,1,OKC,MIN,OKC,102,11.5,Rebs+Asts,22,20,17,7
Chet Holmgren,C,22023,1631096,22300599,"JAN 20, 2024",OKC @ MIN,W,33,4,8,0.5,1,2,0.5,6,6,1.0,1,4,5,2,1,2,0,4,15,8,1,OKC,MIN,OKC,102,1.5,Turnovers,22,20,17,7
Chet Holmgren,C,22023,1631096,22300522,"JAN 10, 2024",OKC @ MIA,W,33,10,15,0.667,1,5,0.2,2,3,0.667,0,9,9,2,0,3,2,4,23,3,1,OKC,MIA,OKC,128,16.5,Points,34,32,25,11
Chet Holmgren,C,22023,1631096,22300522,"JAN 10, 2024",OKC @ MIA,W,33,10,15,0.667,1,5,0.2,2,3,0.667,0,9,9,2,0,3,2,4,23,3,1,OKC,MIA,OKC,128,8.5,Rebounds,34,32,25,11
Chet Holmgren,C,22023,1631096,22300522,"JAN 10, 2024",OKC @ MIA,W,33,10,15,0.667,1,5,0.2,2,3,0.667,0,9,9,2,0,3,2,4,23,3,1,OKC,MIA,OKC,128,28.5,Pts+Rebs+Asts,34,32,25,11
Chet Holmgren,C,22023,1631096,22300522,"JAN 10, 2024",OKC @ MIA,W,33,10,15,0.667,1,5,0.2,2,3,0.667,0,9,9,2,0,3,2,4,23,3,1,OKC,MIA,OKC,128,37.5,Fantasy Score,34,32,25,11
Chet Holmgren,C,22023,1631096,22300522,"JAN 10, 2024",OKC @ MIA,W,33,10,15,0.667,1,5,0.2,2,3,0.667,0,9,9,2,0,3,2,4,23,3,1,OKC,MIA,OKC,128,1.5,Offensive Rebounds,34,32,25,11
Chet Holmgren,C,22023,1631096,22300522,"JAN 10, 2024",OKC @ MIA,W,33,10,15,0.667,1,5,0.2,2,3,0.667,0,9,9,2,0,3,2,4,23,3,1,OKC,MIA,OKC,128,25.5,Pts+Rebs,34,32,25,11
Chet Holmgren,C,22023,1631096,22300522,"JAN 10, 2024",OKC @ MIA,W,33,10,15,0.667,1,5,0.2,2,3,0.667,0,9,9,2,0,3,2,4,23,3,1,OKC,MIA,OKC,128,1.5,Dunks,34,32,25,11
Chet Holmgren,C,22023,1631096,22300522,"JAN 10, 2024",OKC @ MIA,W,33,10,15,0.667,1,5,0.2,2,3,0.667,0,9,9,2,0,3,2,4,23,3,1,OKC,MIA,OKC,128,20.5,Pts+Asts,34,32,25,11
Chet Holmgren,C,22023,1631096,22300522,"JAN 10, 2024",OKC @ MIA,W,33,10,15,0.667,1,5,0.2,2,3,0.667,0,9,9,2,0,3,2,4,23,3,1,OKC,MIA,OKC,128,0.5,Steals,34,32,25,11
Chet Holmgren,C,22023,1631096,22300522,"JAN 10, 2024",OKC @ MIA,W,33,10,15,0.667,1,5,0.2,2,3,0.667,0,9,9,2,0,3,2,4,23,3,1,OKC,MIA,OKC,128,11.5,Rebs+Asts,34,32,25,11
Chet Holmgren,C,22023,1631096,22300522,"JAN 10, 2024",OKC @ MIA,W,33,10,15,0.667,1,5,0.2,2,3,0.667,0,9,9,2,0,3,2,4,23,3,1,OKC,MIA,OKC,128,1.5,Turnovers,34,32,25,11
Chet Holmgren,C,22023,1631096,22300508,"JAN 08, 2024",OKC @ WAS,W,32,11,14,0.786,4,5,0.8,5,8,0.625,1,3,4,5,0,2,0,3,31,1,1,OKC,WAS,OKC,136,16.5,Points,40,35,36,9
Chet Holmgren,C,22023,1631096,22300508,"JAN 08, 2024",OKC @ WAS,W,32,11,14,0.786,4,5,0.8,5,8,0.625,1,3,4,5,0,2,0,3,31,1,1,OKC,WAS,OKC,136,8.5,Rebounds,40,35,36,9
Chet Holmgren,C,22023,1631096,22300508,"JAN 08, 2024",OKC @ WAS,W,32,11,14,0.786,4,5,0.8,5,8,0.625,1,3,4,5,0,2,0,3,31,1,1,OKC,WAS,OKC,136,28.5,Pts+Rebs+Asts,40,35,36,9
Chet Holmgren,C,22023,1631096,22300508,"JAN 08, 2024",OKC @ WAS,W,32,11,14,0.786,4,5,0.8,5,8,0.625,1,3,4,5,0,2,0,3,31,1,1,OKC,WAS,OKC,136,37.5,Fantasy Score,40,35,36,9
Chet Holmgren,C,22023,1631096,22300508,"JAN 08, 2024",OKC @ WAS,W,32,11,14,0.786,4,5,0.8,5,8,0.625,1,3,4,5,0,2,0,3,31,1,1,OKC,WAS,OKC,136,1.5,Offensive Rebounds,40,35,36,9
Chet Holmgren,C,22023,1631096,22300508,"JAN 08, 2024",OKC @ WAS,W,32,11,14,0.786,4,5,0.8,5,8,0.625,1,3,4,5,0,2,0,3,31,1,1,OKC,WAS,OKC,136,25.5,Pts+Rebs,40,35,36,9
Chet Holmgren,C,22023,1631096,22300508,"JAN 08, 2024",OKC @ WAS,W,32,11,14,0.786,4,5,0.8,5,8,0.625,1,3,4,5,0,2,0,3,31,1,1,OKC,WAS,OKC,136,1.5,Dunks,40,35,36,9
Chet Holmgren,C,22023,1631096,22300508,"JAN 08, 2024",OKC @ WAS,W,32,11,14,0.786,4,5,0.8,5,8,0.625,1,3,4,5,0,2,0,3,31,1,1,OKC,WAS,OKC,136,20.5,Pts+Asts,40,35,36,9
Chet Holmgren,C,22023,1631096,22300508,"JAN 08, 2024",OKC @ WAS,W,32,11,14,0.786,4,5,0.8,5,8,0.625,1,3,4,5,0,2,0,3,31,1,1,OKC,WAS,OKC,136,0.5,Steals,40,35,36,9
Chet Holmgren,C,22023,1631096,22300508,"JAN 08, 2024",OKC @ WAS,W,32,11,14,0.786,4,5,0.8,5,8,0.625,1,3,4,5,0,2,0,3,31,1,1,OKC,WAS,OKC,136,11.5,Rebs+Asts,40,35,36,9
Chet Holmgren,C,22023,1631096,22300508,"JAN 08, 2024",OKC @ WAS,W,32,11,14,0.786,4,5,0.8,5,8,0.625,1,3,4,5,0,2,0,3,31,1,1,OKC,WAS,OKC,136,1.5,Turnovers,40,35,36,9
Chet Holmgren,C,22023,1631096,22300467,"JAN 03, 2024",OKC @ ATL,L,25,5,9,0.556,2,5,0.4,0,0,0.0,0,3,3,1,0,0,4,1,12,-1,1,OKC,ATL,OKC,138,16.5,Points,16,15,13,4
Chet Holmgren,C,22023,1631096,22300467,"JAN 03, 2024",OKC @ ATL,L,25,5,9,0.556,2,5,0.4,0,0,0.0,0,3,3,1,0,0,4,1,12,-1,1,OKC,ATL,OKC,138,8.5,Rebounds,16,15,13,4
Chet Holmgren,C,22023,1631096,22300467,"JAN 03, 2024",OKC @ ATL,L,25,5,9,0.556,2,5,0.4,0,0,0.0,0,3,3,1,0,0,4,1,12,-1,1,OKC,ATL,OKC,138,28.5,Pts+Rebs+Asts,16,15,13,4
Chet Holmgren,C,22023,1631096,22300467,"JAN 03, 2024",OKC @ ATL,L,25,5,9,0.556,2,5,0.4,0,0,0.0,0,3,3,1,0,0,4,1,12,-1,1,OKC,ATL,OKC,138,37.5,Fantasy Score,16,15,13,4
Chet Holmgren,C,22023,1631096,22300467,"JAN 03, 2024",OKC @ ATL,L,25,5,9,0.556,2,5,0.4,0,0,0.0,0,3,3,1,0,0,4,1,12,-1,1,OKC,ATL,OKC,138,1.5,Offensive Rebounds,16,15,13,4
Chet Holmgren,C,22023,1631096,22300467,"JAN 03, 2024",OKC @ ATL,L,25,5,9,0.556,2,5,0.4,0,0,0.0,0,3,3,1,0,0,4,1,12,-1,1,OKC,ATL,OKC,138,25.5,Pts+Rebs,16,15,13,4
Chet Holmgren,C,22023,1631096,22300467,"JAN 03, 2024",OKC @ ATL,L,25,5,9,0.556,2,5,0.4,0,0,0.0,0,3,3,1,0,0,4,1,12,-1,1,OKC,ATL,OKC,138,1.5,Dunks,16,15,13,4
Chet Holmgren,C,22023,1631096,22300467,"JAN 03, 2024",OKC @ ATL,L,25,5,9,0.556,2,5,0.4,0,0,0.0,0,3,3,1,0,0,4,1,12,-1,1,OKC,ATL,OKC,138,20.5,Pts+Asts,16,15,13,4
Chet Holmgren,C,22023,1631096,22300467,"JAN 03, 2024",OKC @ ATL,L,25,5,9,0.556,2,5,0.4,0,0,0.0,0,3,3,1,0,0,4,1,12,-1,1,OKC,ATL,OKC,138,0.5,Steals,16,15,13,4
Chet Holmgren,C,22023,1631096,22300467,"JAN 03, 2024",OKC @ ATL,L,25,5,9,0.556,2,5,0.4,0,0,0.0,0,3,3,1,0,0,4,1,12,-1,1,OKC,ATL,OKC,138,11.5,Rebs+Asts,16,15,13,4
Chet Holmgren,C,22023,1631096,22300467,"JAN 03, 2024",OKC @ ATL,L,25,5,9,0.556,2,5,0.4,0,0,0.0,0,3,3,1,0,0,4,1,12,-1,1,OKC,ATL,OKC,138,1.5,Turnovers,16,15,13,4
Chet Holmgren,C,22023,1631096,22300462,"JAN 02, 2024",OKC vs. BOS,W,33,5,9,0.556,3,5,0.6,1,2,0.5,0,3,3,7,0,4,1,1,14,4,1,OKC,OKC,BOS,127,16.5,Points,24,17,21,10
Chet Holmgren,C,22023,1631096,22300462,"JAN 02, 2024",OKC vs. BOS,W,33,5,9,0.556,3,5,0.6,1,2,0.5,0,3,3,7,0,4,1,1,14,4,1,OKC,OKC,BOS,127,8.5,Rebounds,24,17,21,10
Chet Holmgren,C,22023,1631096,22300462,"JAN 02, 2024",OKC vs. BOS,W,33,5,9,0.556,3,5,0.6,1,2,0.5,0,3,3,7,0,4,1,1,14,4,1,OKC,OKC,BOS,127,28.5,Pts+Rebs+Asts,24,17,21,10
Chet Holmgren,C,22023,1631096,22300462,"JAN 02, 2024",OKC vs. BOS,W,33,5,9,0.556,3,5,0.6,1,2,0.5,0,3,3,7,0,4,1,1,14,4,1,OKC,OKC,BOS,127,37.5,Fantasy Score,24,17,21,10
Chet Holmgren,C,22023,1631096,22300462,"JAN 02, 2024",OKC vs. BOS,W,33,5,9,0.556,3,5,0.6,1,2,0.5,0,3,3,7,0,4,1,1,14,4,1,OKC,OKC,BOS,127,1.5,Offensive Rebounds,24,17,21,10
Chet Holmgren,C,22023,1631096,22300462,"JAN 02, 2024",OKC vs. BOS,W,33,5,9,0.556,3,5,0.6,1,2,0.5,0,3,3,7,0,4,1,1,14,4,1,OKC,OKC,BOS,127,25.5,Pts+Rebs,24,17,21,10
Chet Holmgren,C,22023,1631096,22300462,"JAN 02, 2024",OKC vs. BOS,W,33,5,9,0.556,3,5,0.6,1,2,0.5,0,3,3,7,0,4,1,1,14,4,1,OKC,OKC,BOS,127,1.5,Dunks,24,17,21,10
Chet Holmgren,C,22023,1631096,22300462,"JAN 02, 2024",OKC vs. BOS,W,33,5,9,0.556,3,5,0.6,1,2,0.5,0,3,3,7,0,4,1,1,14,4,1,OKC,OKC,BOS,127,20.5,Pts+Asts,24,17,21,10
Chet Holmgren,C,22023,1631096,22300462,"JAN 02, 2024",OKC vs. BOS,W,33,5,9,0.556,3,5,0.6,1,2,0.5,0,3,3,7,0,4,1,1,14,4,1,OKC,OKC,BOS,127,0.5,Steals,24,17,21,10
Chet Holmgren,C,22023,1631096,22300462,"JAN 02, 2024",OKC vs. BOS,W,33,5,9,0.556,3,5,0.6,1,2,0.5,0,3,3,7,0,4,1,1,14,4,1,OKC,OKC,BOS,127,11.5,Rebs+Asts,24,17,21,10
Chet Holmgren,C,22023,1631096,22300462,"JAN 02, 2024",OKC vs. BOS,W,33,5,9,0.556,3,5,0.6,1,2,0.5,0,3,3,7,0,4,1,1,14,4,1,OKC,OKC,BOS,127,1.5,Turnovers,24,17,21,10
Chet Holmgren,C,22023,1631096,22300447,"DEC 31, 2023",OKC vs. BKN,W,32,7,10,0.7,3,5,0.6,1,2,0.5,0,10,10,3,0,2,3,3,18,16,1,OKC,OKC,BKN,124,16.5,Points,31,28,21,13
Chet Holmgren,C,22023,1631096,22300447,"DEC 31, 2023",OKC vs. BKN,W,32,7,10,0.7,3,5,0.6,1,2,0.5,0,10,10,3,0,2,3,3,18,16,1,OKC,OKC,BKN,124,8.5,Rebounds,31,28,21,13
Chet Holmgren,C,22023,1631096,22300447,"DEC 31, 2023",OKC vs. BKN,W,32,7,10,0.7,3,5,0.6,1,2,0.5,0,10,10,3,0,2,3,3,18,16,1,OKC,OKC,BKN,124,28.5,Pts+Rebs+Asts,31,28,21,13
Chet Holmgren,C,22023,1631096,22300447,"DEC 31, 2023",OKC vs. BKN,W,32,7,10,0.7,3,5,0.6,1,2,0.5,0,10,10,3,0,2,3,3,18,16,1,OKC,OKC,BKN,124,37.5,Fantasy Score,31,28,21,13
Chet Holmgren,C,22023,1631096,22300447,"DEC 31, 2023",OKC vs. BKN,W,32,7,10,0.7,3,5,0.6,1,2,0.5,0,10,10,3,0,2,3,3,18,16,1,OKC,OKC,BKN,124,1.5,Offensive Rebounds,31,28,21,13
Chet Holmgren,C,22023,1631096,22300447,"DEC 31, 2023",OKC vs. BKN,W,32,7,10,0.7,3,5,0.6,1,2,0.5,0,10,10,3,0,2,3,3,18,16,1,OKC,OKC,BKN,124,25.5,Pts+Rebs,31,28,21,13
Chet Holmgren,C,22023,1631096,22300447,"DEC 31, 2023",OKC vs. BKN,W,32,7,10,0.7,3,5,0.6,1,2,0.5,0,10,10,3,0,2,3,3,18,16,1,OKC,OKC,BKN,124,1.5,Dunks,31,28,21,13
Chet Holmgren,C,22023,1631096,22300447,"DEC 31, 2023",OKC vs. BKN,W,32,7,10,0.7,3,5,0.6,1,2,0.5,0,10,10,3,0,2,3,3,18,16,1,OKC,OKC,BKN,124,20.5,Pts+Asts,31,28,21,13
Chet Holmgren,C,22023,1631096,22300447,"DEC 31, 2023",OKC vs. BKN,W,32,7,10,0.7,3,5,0.6,1,2,0.5,0,10,10,3,0,2,3,3,18,16,1,OKC,OKC,BKN,124,0.5,Steals,31,28,21,13
Chet Holmgren,C,22023,1631096,22300447,"DEC 31, 2023",OKC vs. BKN,W,32,7,10,0.7,3,5,0.6,1,2,0.5,0,10,10,3,0,2,3,3,18,16,1,OKC,OKC,BKN,124,11.5,Rebs+Asts,31,28,21,13
Chet Holmgren,C,22023,1631096,22300447,"DEC 31, 2023",OKC vs. BKN,W,32,7,10,0.7,3,5,0.6,1,2,0.5,0,10,10,3,0,2,3,3,18,16,1,OKC,OKC,BKN,124,1.5,Turnovers,31,28,21,13
Chet Holmgren,C,22023,1631096,22300435,"DEC 29, 2023",OKC @ DEN,W,28,9,14,0.643,4,4,1.0,2,2,1.0,3,3,6,3,0,2,2,1,24,9,1,OKC,DEN,OKC,119,16.5,Points,33,30,27,9
Chet Holmgren,C,22023,1631096,22300435,"DEC 29, 2023",OKC @ DEN,W,28,9,14,0.643,4,4,1.0,2,2,1.0,3,3,6,3,0,2,2,1,24,9,1,OKC,DEN,OKC,119,8.5,Rebounds,33,30,27,9
Chet Holmgren,C,22023,1631096,22300435,"DEC 29, 2023",OKC @ DEN,W,28,9,14,0.643,4,4,1.0,2,2,1.0,3,3,6,3,0,2,2,1,24,9,1,OKC,DEN,OKC,119,28.5,Pts+Rebs+Asts,33,30,27,9
Chet Holmgren,C,22023,1631096,22300435,"DEC 29, 2023",OKC @ DEN,W,28,9,14,0.643,4,4,1.0,2,2,1.0,3,3,6,3,0,2,2,1,24,9,1,OKC,DEN,OKC,119,37.5,Fantasy Score,33,30,27,9
Chet Holmgren,C,22023,1631096,22300435,"DEC 29, 2023",OKC @ DEN,W,28,9,14,0.643,4,4,1.0,2,2,1.0,3,3,6,3,0,2,2,1,24,9,1,OKC,DEN,OKC,119,1.5,Offensive Rebounds,33,30,27,9
Chet Holmgren,C,22023,1631096,22300435,"DEC 29, 2023",OKC @ DEN,W,28,9,14,0.643,4,4,1.0,2,2,1.0,3,3,6,3,0,2,2,1,24,9,1,OKC,DEN,OKC,119,25.5,Pts+Rebs,33,30,27,9
Chet Holmgren,C,22023,1631096,22300435,"DEC 29, 2023",OKC @ DEN,W,28,9,14,0.643,4,4,1.0,2,2,1.0,3,3,6,3,0,2,2,1,24,9,1,OKC,DEN,OKC,119,1.5,Dunks,33,30,27,9
Chet Holmgren,C,22023,1631096,22300435,"DEC 29, 2023",OKC @ DEN,W,28,9,14,0.643,4,4,1.0,2,2,1.0,3,3,6,3,0,2,2,1,24,9,1,OKC,DEN,OKC,119,20.5,Pts+Asts,33,30,27,9
Chet Holmgren,C,22023,1631096,22300435,"DEC 29, 2023",OKC @ DEN,W,28,9,14,0.643,4,4,1.0,2,2,1.0,3,3,6,3,0,2,2,1,24,9,1,OKC,DEN,OKC,119,0.5,Steals,33,30,27,9
Chet Holmgren,C,22023,1631096,22300435,"DEC 29, 2023",OKC @ DEN,W,28,9,14,0.643,4,4,1.0,2,2,1.0,3,3,6,3,0,2,2,1,24,9,1,OKC,DEN,OKC,119,11.5,Rebs+Asts,33,30,27,9
Chet Holmgren,C,22023,1631096,22300435,"DEC 29, 2023",OKC @ DEN,W,28,9,14,0.643,4,4,1.0,2,2,1.0,3,3,6,3,0,2,2,1,24,9,1,OKC,DEN,OKC,119,1.5,Turnovers,33,30,27,9
Chet Holmgren,C,22023,1631096,22300411,"DEC 26, 2023",OKC vs. MIN,W,29,8,13,0.615,3,6,0.5,1,2,0.5,0,4,4,5,0,1,1,4,20,17,1,OKC,OKC,MIN,129,16.5,Points,29,24,25,9
Chet Holmgren,C,22023,1631096,22300411,"DEC 26, 2023",OKC vs. MIN,W,29,8,13,0.615,3,6,0.5,1,2,0.5,0,4,4,5,0,1,1,4,20,17,1,OKC,OKC,MIN,129,8.5,Rebounds,29,24,25,9
Chet Holmgren,C,22023,1631096,22300411,"DEC 26, 2023",OKC vs. MIN,W,29,8,13,0.615,3,6,0.5,1,2,0.5,0,4,4,5,0,1,1,4,20,17,1,OKC,OKC,MIN,129,28.5,Pts+Rebs+Asts,29,24,25,9
Chet Holmgren,C,22023,1631096,22300411,"DEC 26, 2023",OKC vs. MIN,W,29,8,13,0.615,3,6,0.5,1,2,0.5,0,4,4,5,0,1,1,4,20,17,1,OKC,OKC,MIN,129,37.5,Fantasy Score,29,24,25,9
Chet Holmgren,C,22023,1631096,22300411,"DEC 26, 2023",OKC vs. MIN,W,29,8,13,0.615,3,6,0.5,1,2,0.5,0,4,4,5,0,1,1,4,20,17,1,OKC,OKC,MIN,129,1.5,Offensive Rebounds,29,24,25,9
Chet Holmgren,C,22023,1631096,22300411,"DEC 26, 2023",OKC vs. MIN,W,29,8,13,0.615,3,6,0.5,1,2,0.5,0,4,4,5,0,1,1,4,20,17,1,OKC,OKC,MIN,129,25.5,Pts+Rebs,29,24,25,9
Chet Holmgren,C,22023,1631096,22300411,"DEC 26, 2023",OKC vs. MIN,W,29,8,13,0.615,3,6,0.5,1,2,0.5,0,4,4,5,0,1,1,4,20,17,1,OKC,OKC,MIN,129,1.5,Dunks,29,24,25,9
Chet Holmgren,C,22023,1631096,22300411,"DEC 26, 2023",OKC vs. MIN,W,29,8,13,0.615,3,6,0.5,1,2,0.5,0,4,4,5,0,1,1,4,20,17,1,OKC,OKC,MIN,129,20.5,Pts+Asts,29,24,25,9
Chet Holmgren,C,22023,1631096,22300411,"DEC 26, 2023",OKC vs. MIN,W,29,8,13,0.615,3,6,0.5,1,2,0.5,0,4,4,5,0,1,1,4,20,17,1,OKC,OKC,MIN,129,0.5,Steals,29,24,25,9
Chet Holmgren,C,22023,1631096,22300411,"DEC 26, 2023",OKC vs. MIN,W,29,8,13,0.615,3,6,0.5,1,2,0.5,0,4,4,5,0,1,1,4,20,17,1,OKC,OKC,MIN,129,11.5,Rebs+Asts,29,24,25,9
Chet Holmgren,C,22023,1631096,22300411,"DEC 26, 2023",OKC vs. MIN,W,29,8,13,0.615,3,6,0.5,1,2,0.5,0,4,4,5,0,1,1,4,20,17,1,OKC,OKC,MIN,129,1.5,Turnovers,29,24,25,9
Chet Holmgren,C,22023,1631096,22301212,"DEC 06, 2023",OKC @ HOU,L,26,2,9,0.222,0,4,0.0,0,0,0.0,1,4,5,2,1,6,1,2,4,-16,1,OKC,HOU,OKC,101,16.5,Points,11,9,6,7
Chet Holmgren,C,22023,1631096,22301212,"DEC 06, 2023",OKC @ HOU,L,26,2,9,0.222,0,4,0.0,0,0,0.0,1,4,5,2,1,6,1,2,4,-16,1,OKC,HOU,OKC,101,8.5,Rebounds,11,9,6,7
Chet Holmgren,C,22023,1631096,22301212,"DEC 06, 2023",OKC @ HOU,L,26,2,9,0.222,0,4,0.0,0,0,0.0,1,4,5,2,1,6,1,2,4,-16,1,OKC,HOU,OKC,101,28.5,Pts+Rebs+Asts,11,9,6,7
Chet Holmgren,C,22023,1631096,22301212,"DEC 06, 2023",OKC @ HOU,L,26,2,9,0.222,0,4,0.0,0,0,0.0,1,4,5,2,1,6,1,2,4,-16,1,OKC,HOU,OKC,101,37.5,Fantasy Score,11,9,6,7
Chet Holmgren,C,22023,1631096,22301212,"DEC 06, 2023",OKC @ HOU,L,26,2,9,0.222,0,4,0.0,0,0,0.0,1,4,5,2,1,6,1,2,4,-16,1,OKC,HOU,OKC,101,1.5,Offensive Rebounds,11,9,6,7
Chet Holmgren,C,22023,1631096,22301212,"DEC 06, 2023",OKC @ HOU,L,26,2,9,0.222,0,4,0.0,0,0,0.0,1,4,5,2,1,6,1,2,4,-16,1,OKC,HOU,OKC,101,25.5,Pts+Rebs,11,9,6,7
Chet Holmgren,C,22023,1631096,22301212,"DEC 06, 2023",OKC @ HOU,L,26,2,9,0.222,0,4,0.0,0,0,0.0,1,4,5,2,1,6,1,2,4,-16,1,OKC,HOU,OKC,101,1.5,Dunks,11,9,6,7
Chet Holmgren,C,22023,1631096,22301212,"DEC 06, 2023",OKC @ HOU,L,26,2,9,0.222,0,4,0.0,0,0,0.0,1,4,5,2,1,6,1,2,4,-16,1,OKC,HOU,OKC,101,20.5,Pts+Asts,11,9,6,7
Chet Holmgren,C,22023,1631096,22301212,"DEC 06, 2023",OKC @ HOU,L,26,2,9,0.222,0,4,0.0,0,0,0.0,1,4,5,2,1,6,1,2,4,-16,1,OKC,HOU,OKC,101,0.5,Steals,11,9,6,7
Chet Holmgren,C,22023,1631096,22301212,"DEC 06, 2023",OKC @ HOU,L,26,2,9,0.222,0,4,0.0,0,0,0.0,1,4,5,2,1,6,1,2,4,-16,1,OKC,HOU,OKC,101,11.5,Rebs+Asts,11,9,6,7
Chet Holmgren,C,22023,1631096,22301212,"DEC 06, 2023",OKC @ HOU,L,26,2,9,0.222,0,4,0.0,0,0,0.0,1,4,5,2,1,6,1,2,4,-16,1,OKC,HOU,OKC,101,1.5,Turnovers,11,9,6,7
Chet Holmgren,C,22023,1631096,22300271,"NOV 30, 2023",OKC vs. LAL,W,28,8,15,0.533,1,6,0.167,1,1,1.0,1,4,5,1,2,0,2,3,18,16,1,OKC,OKC,LAL,133,16.5,Points,24,23,19,6
Chet Holmgren,C,22023,1631096,22300271,"NOV 30, 2023",OKC vs. LAL,W,28,8,15,0.533,1,6,0.167,1,1,1.0,1,4,5,1,2,0,2,3,18,16,1,OKC,OKC,LAL,133,8.5,Rebounds,24,23,19,6
Chet Holmgren,C,22023,1631096,22300271,"NOV 30, 2023",OKC vs. LAL,W,28,8,15,0.533,1,6,0.167,1,1,1.0,1,4,5,1,2,0,2,3,18,16,1,OKC,OKC,LAL,133,28.5,Pts+Rebs+Asts,24,23,19,6
Chet Holmgren,C,22023,1631096,22300271,"NOV 30, 2023",OKC vs. LAL,W,28,8,15,0.533,1,6,0.167,1,1,1.0,1,4,5,1,2,0,2,3,18,16,1,OKC,OKC,LAL,133,37.5,Fantasy Score,24,23,19,6
Chet Holmgren,C,22023,1631096,22300271,"NOV 30, 2023",OKC vs. LAL,W,28,8,15,0.533,1,6,0.167,1,1,1.0,1,4,5,1,2,0,2,3,18,16,1,OKC,OKC,LAL,133,1.5,Offensive Rebounds,24,23,19,6
Chet Holmgren,C,22023,1631096,22300271,"NOV 30, 2023",OKC vs. LAL,W,28,8,15,0.533,1,6,0.167,1,1,1.0,1,4,5,1,2,0,2,3,18,16,1,OKC,OKC,LAL,133,25.5,Pts+Rebs,24,23,19,6
Chet Holmgren,C,22023,1631096,22300271,"NOV 30, 2023",OKC vs. LAL,W,28,8,15,0.533,1,6,0.167,1,1,1.0,1,4,5,1,2,0,2,3,18,16,1,OKC,OKC,LAL,133,1.5,Dunks,24,23,19,6
Chet Holmgren,C,22023,1631096,22300271,"NOV 30, 2023",OKC vs. LAL,W,28,8,15,0.533,1,6,0.167,1,1,1.0,1,4,5,1,2,0,2,3,18,16,1,OKC,OKC,LAL,133,20.5,Pts+Asts,24,23,19,6
Chet Holmgren,C,22023,1631096,22300271,"NOV 30, 2023",OKC vs. LAL,W,28,8,15,0.533,1,6,0.167,1,1,1.0,1,4,5,1,2,0,2,3,18,16,1,OKC,OKC,LAL,133,0.5,Steals,24,23,19,6
Chet Holmgren,C,22023,1631096,22300271,"NOV 30, 2023",OKC vs. LAL,W,28,8,15,0.533,1,6,0.167,1,1,1.0,1,4,5,1,2,0,2,3,18,16,1,OKC,OKC,LAL,133,11.5,Rebs+Asts,24,23,19,6
Chet Holmgren,C,22023,1631096,22300271,"NOV 30, 2023",OKC vs. LAL,W,28,8,15,0.533,1,6,0.167,1,1,1.0,1,4,5,1,2,0,2,3,18,16,1,OKC,OKC,LAL,133,1.5,Turnovers,24,23,19,6
Chet Holmgren,C,22023,1631096,22300234,"NOV 22, 2023",OKC vs. CHI,W,32,5,11,0.455,0,3,0.0,8,11,0.727,5,8,13,2,1,4,2,3,18,18,1,OKC,OKC,CHI,116,16.5,Points,33,31,20,15
Chet Holmgren,C,22023,1631096,22300234,"NOV 22, 2023",OKC vs. CHI,W,32,5,11,0.455,0,3,0.0,8,11,0.727,5,8,13,2,1,4,2,3,18,18,1,OKC,OKC,CHI,116,8.5,Rebounds,33,31,20,15
Chet Holmgren,C,22023,1631096,22300234,"NOV 22, 2023",OKC vs. CHI,W,32,5,11,0.455,0,3,0.0,8,11,0.727,5,8,13,2,1,4,2,3,18,18,1,OKC,OKC,CHI,116,28.5,Pts+Rebs+Asts,33,31,20,15
Chet Holmgren,C,22023,1631096,22300234,"NOV 22, 2023",OKC vs. CHI,W,32,5,11,0.455,0,3,0.0,8,11,0.727,5,8,13,2,1,4,2,3,18,18,1,OKC,OKC,CHI,116,37.5,Fantasy Score,33,31,20,15
Chet Holmgren,C,22023,1631096,22300234,"NOV 22, 2023",OKC vs. CHI,W,32,5,11,0.455,0,3,0.0,8,11,0.727,5,8,13,2,1,4,2,3,18,18,1,OKC,OKC,CHI,116,1.5,Offensive Rebounds,33,31,20,15
Chet Holmgren,C,22023,1631096,22300234,"NOV 22, 2023",OKC vs. CHI,W,32,5,11,0.455,0,3,0.0,8,11,0.727,5,8,13,2,1,4,2,3,18,18,1,OKC,OKC,CHI,116,25.5,Pts+Rebs,33,31,20,15
Chet Holmgren,C,22023,1631096,22300234,"NOV 22, 2023",OKC vs. CHI,W,32,5,11,0.455,0,3,0.0,8,11,0.727,5,8,13,2,1,4,2,3,18,18,1,OKC,OKC,CHI,116,1.5,Dunks,33,31,20,15
Chet Holmgren,C,22023,1631096,22300234,"NOV 22, 2023",OKC vs. CHI,W,32,5,11,0.455,0,3,0.0,8,11,0.727,5,8,13,2,1,4,2,3,18,18,1,OKC,OKC,CHI,116,20.5,Pts+Asts,33,31,20,15
Chet Holmgren,C,22023,1631096,22300234,"NOV 22, 2023",OKC vs. CHI,W,32,5,11,0.455,0,3,0.0,8,11,0.727,5,8,13,2,1,4,2,3,18,18,1,OKC,OKC,CHI,116,0.5,Steals,33,31,20,15
Chet Holmgren,C,22023,1631096,22300234,"NOV 22, 2023",OKC vs. CHI,W,32,5,11,0.455,0,3,0.0,8,11,0.727,5,8,13,2,1,4,2,3,18,18,1,OKC,OKC,CHI,116,11.5,Rebs+Asts,33,31,20,15
Chet Holmgren,C,22023,1631096,22300234,"NOV 22, 2023",OKC vs. CHI,W,32,5,11,0.455,0,3,0.0,8,11,0.727,5,8,13,2,1,4,2,3,18,18,1,OKC,OKC,CHI,116,1.5,Turnovers,33,31,20,15
Chet Holmgren,C,22023,1631096,22300207,"NOV 18, 2023",OKC @ GSW,W,37,14,22,0.636,2,5,0.4,6,7,0.857,4,6,10,5,2,2,4,2,36,9,1,OKC,GSW,OKC,130,16.5,Points,51,46,41,15
Chet Holmgren,C,22023,1631096,22300207,"NOV 18, 2023",OKC @ GSW,W,37,14,22,0.636,2,5,0.4,6,7,0.857,4,6,10,5,2,2,4,2,36,9,1,OKC,GSW,OKC,130,8.5,Rebounds,51,46,41,15
Chet Holmgren,C,22023,1631096,22300207,"NOV 18, 2023",OKC @ GSW,W,37,14,22,0.636,2,5,0.4,6,7,0.857,4,6,10,5,2,2,4,2,36,9,1,OKC,GSW,OKC,130,28.5,Pts+Rebs+Asts,51,46,41,15
Chet Holmgren,C,22023,1631096,22300207,"NOV 18, 2023",OKC @ GSW,W,37,14,22,0.636,2,5,0.4,6,7,0.857,4,6,10,5,2,2,4,2,36,9,1,OKC,GSW,OKC,130,37.5,Fantasy Score,51,46,41,15
Chet Holmgren,C,22023,1631096,22300207,"NOV 18, 2023",OKC @ GSW,W,37,14,22,0.636,2,5,0.4,6,7,0.857,4,6,10,5,2,2,4,2,36,9,1,OKC,GSW,OKC,130,1.5,Offensive Rebounds,51,46,41,15
Chet Holmgren,C,22023,1631096,22300207,"NOV 18, 2023",OKC @ GSW,W,37,14,22,0.636,2,5,0.4,6,7,0.857,4,6,10,5,2,2,4,2,36,9,1,OKC,GSW,OKC,130,25.5,Pts+Rebs,51,46,41,15
Chet Holmgren,C,22023,1631096,22300207,"NOV 18, 2023",OKC @ GSW,W,37,14,22,0.636,2,5,0.4,6,7,0.857,4,6,10,5,2,2,4,2,36,9,1,OKC,GSW,OKC,130,1.5,Dunks,51,46,41,15
Chet Holmgren,C,22023,1631096,22300207,"NOV 18, 2023",OKC @ GSW,W,37,14,22,0.636,2,5,0.4,6,7,0.857,4,6,10,5,2,2,4,2,36,9,1,OKC,GSW,OKC,130,20.5,Pts+Asts,51,46,41,15
Chet Holmgren,C,22023,1631096,22300207,"NOV 18, 2023",OKC @ GSW,W,37,14,22,0.636,2,5,0.4,6,7,0.857,4,6,10,5,2,2,4,2,36,9,1,OKC,GSW,OKC,130,0.5,Steals,51,46,41,15
Chet Holmgren,C,22023,1631096,22300207,"NOV 18, 2023",OKC @ GSW,W,37,14,22,0.636,2,5,0.4,6,7,0.857,4,6,10,5,2,2,4,2,36,9,1,OKC,GSW,OKC,130,11.5,Rebs+Asts,51,46,41,15
Chet Holmgren,C,22023,1631096,22300207,"NOV 18, 2023",OKC @ GSW,W,37,14,22,0.636,2,5,0.4,6,7,0.857,4,6,10,5,2,2,4,2,36,9,1,OKC,GSW,OKC,130,1.5,Turnovers,51,46,41,15
Chet Holmgren,C,22023,1631096,22300201,"NOV 16, 2023",OKC @ GSW,W,27,4,7,0.571,0,2,0.0,5,5,1.0,1,9,10,2,0,2,4,2,13,-1,1,OKC,GSW,OKC,128,16.5,Points,25,23,15,12
Chet Holmgren,C,22023,1631096,22300201,"NOV 16, 2023",OKC @ GSW,W,27,4,7,0.571,0,2,0.0,5,5,1.0,1,9,10,2,0,2,4,2,13,-1,1,OKC,GSW,OKC,128,8.5,Rebounds,25,23,15,12
Chet Holmgren,C,22023,1631096,22300201,"NOV 16, 2023",OKC @ GSW,W,27,4,7,0.571,0,2,0.0,5,5,1.0,1,9,10,2,0,2,4,2,13,-1,1,OKC,GSW,OKC,128,28.5,Pts+Rebs+Asts,25,23,15,12
Chet Holmgren,C,22023,1631096,22300201,"NOV 16, 2023",OKC @ GSW,W,27,4,7,0.571,0,2,0.0,5,5,1.0,1,9,10,2,0,2,4,2,13,-1,1,OKC,GSW,OKC,128,37.5,Fantasy Score,25,23,15,12
Chet Holmgren,C,22023,1631096,22300201,"NOV 16, 2023",OKC @ GSW,W,27,4,7,0.571,0,2,0.0,5,5,1.0,1,9,10,2,0,2,4,2,13,-1,1,OKC,GSW,OKC,128,1.5,Offensive Rebounds,25,23,15,12
Chet Holmgren,C,22023,1631096,22300201,"NOV 16, 2023",OKC @ GSW,W,27,4,7,0.571,0,2,0.0,5,5,1.0,1,9,10,2,0,2,4,2,13,-1,1,OKC,GSW,OKC,128,25.5,Pts+Rebs,25,23,15,12
Chet Holmgren,C,22023,1631096,22300201,"NOV 16, 2023",OKC @ GSW,W,27,4,7,0.571,0,2,0.0,5,5,1.0,1,9,10,2,0,2,4,2,13,-1,1,OKC,GSW,OKC,128,1.5,Dunks,25,23,15,12
Chet Holmgren,C,22023,1631096,22300201,"NOV 16, 2023",OKC @ GSW,W,27,4,7,0.571,0,2,0.0,5,5,1.0,1,9,10,2,0,2,4,2,13,-1,1,OKC,GSW,OKC,128,20.5,Pts+Asts,25,23,15,12
Chet Holmgren,C,22023,1631096,22300201,"NOV 16, 2023",OKC @ GSW,W,27,4,7,0.571,0,2,0.0,5,5,1.0,1,9,10,2,0,2,4,2,13,-1,1,OKC,GSW,OKC,128,0.5,Steals,25,23,15,12
Chet Holmgren,C,22023,1631096,22300201,"NOV 16, 2023",OKC @ GSW,W,27,4,7,0.571,0,2,0.0,5,5,1.0,1,9,10,2,0,2,4,2,13,-1,1,OKC,GSW,OKC,128,11.5,Rebs+Asts,25,23,15,12
Chet Holmgren,C,22023,1631096,22300201,"NOV 16, 2023",OKC @ GSW,W,27,4,7,0.571,0,2,0.0,5,5,1.0,1,9,10,2,0,2,4,2,13,-1,1,OKC,GSW,OKC,128,1.5,Turnovers,25,23,15,12
Chet Holmgren,C,22023,1631096,22300021,"NOV 14, 2023",OKC vs. SAS,W,30,3,10,0.3,1,5,0.2,2,2,1.0,0,7,7,3,2,1,2,2,9,30,1,OKC,OKC,SAS,123,16.5,Points,19,16,12,10
Chet Holmgren,C,22023,1631096,22300021,"NOV 14, 2023",OKC vs. SAS,W,30,3,10,0.3,1,5,0.2,2,2,1.0,0,7,7,3,2,1,2,2,9,30,1,OKC,OKC,SAS,123,8.5,Rebounds,19,16,12,10
Chet Holmgren,C,22023,1631096,22300021,"NOV 14, 2023",OKC vs. SAS,W,30,3,10,0.3,1,5,0.2,2,2,1.0,0,7,7,3,2,1,2,2,9,30,1,OKC,OKC,SAS,123,28.5,Pts+Rebs+Asts,19,16,12,10
Chet Holmgren,C,22023,1631096,22300021,"NOV 14, 2023",OKC vs. SAS,W,30,3,10,0.3,1,5,0.2,2,2,1.0,0,7,7,3,2,1,2,2,9,30,1,OKC,OKC,SAS,123,37.5,Fantasy Score,19,16,12,10
Chet Holmgren,C,22023,1631096,22300021,"NOV 14, 2023",OKC vs. SAS,W,30,3,10,0.3,1,5,0.2,2,2,1.0,0,7,7,3,2,1,2,2,9,30,1,OKC,OKC,SAS,123,1.5,Offensive Rebounds,19,16,12,10
Chet Holmgren,C,22023,1631096,22300021,"NOV 14, 2023",OKC vs. SAS,W,30,3,10,0.3,1,5,0.2,2,2,1.0,0,7,7,3,2,1,2,2,9,30,1,OKC,OKC,SAS,123,25.5,Pts+Rebs,19,16,12,10
Chet Holmgren,C,22023,1631096,22300021,"NOV 14, 2023",OKC vs. SAS,W,30,3,10,0.3,1,5,0.2,2,2,1.0,0,7,7,3,2,1,2,2,9,30,1,OKC,OKC,SAS,123,1.5,Dunks,19,16,12,10
Chet Holmgren,C,22023,1631096,22300021,"NOV 14, 2023",OKC vs. SAS,W,30,3,10,0.3,1,5,0.2,2,2,1.0,0,7,7,3,2,1,2,2,9,30,1,OKC,OKC,SAS,123,20.5,Pts+Asts,19,16,12,10
Chet Holmgren,C,22023,1631096,22300021,"NOV 14, 2023",OKC vs. SAS,W,30,3,10,0.3,1,5,0.2,2,2,1.0,0,7,7,3,2,1,2,2,9,30,1,OKC,OKC,SAS,123,0.5,Steals,19,16,12,10
Chet Holmgren,C,22023,1631096,22300021,"NOV 14, 2023",OKC vs. SAS,W,30,3,10,0.3,1,5,0.2,2,2,1.0,0,7,7,3,2,1,2,2,9,30,1,OKC,OKC,SAS,123,11.5,Rebs+Asts,19,16,12,10
Chet Holmgren,C,22023,1631096,22300021,"NOV 14, 2023",OKC vs. SAS,W,30,3,10,0.3,1,5,0.2,2,2,1.0,0,7,7,3,2,1,2,2,9,30,1,OKC,OKC,SAS,123,1.5,Turnovers,19,16,12,10
Chet Holmgren,C,22023,1631096,22300581,"JAN 18, 2024",OKC @ UTA,W,32,6,16,0.375,2,6,0.333,1,2,0.5,0,5,5,5,0,4,3,3,15,2,1,OKC,UTA,OKC,134,16.5,Points,25,20,20,10
Chet Holmgren,C,22023,1631096,22300581,"JAN 18, 2024",OKC @ UTA,W,32,6,16,0.375,2,6,0.333,1,2,0.5,0,5,5,5,0,4,3,3,15,2,1,OKC,UTA,OKC,134,8.5,Rebounds,25,20,20,10
Chet Holmgren,C,22023,1631096,22300581,"JAN 18, 2024",OKC @ UTA,W,32,6,16,0.375,2,6,0.333,1,2,0.5,0,5,5,5,0,4,3,3,15,2,1,OKC,UTA,OKC,134,28.5,Pts+Rebs+Asts,25,20,20,10
Chet Holmgren,C,22023,1631096,22300581,"JAN 18, 2024",OKC @ UTA,W,32,6,16,0.375,2,6,0.333,1,2,0.5,0,5,5,5,0,4,3,3,15,2,1,OKC,UTA,OKC,134,37.5,Fantasy Score,25,20,20,10
Chet Holmgren,C,22023,1631096,22300581,"JAN 18, 2024",OKC @ UTA,W,32,6,16,0.375,2,6,0.333,1,2,0.5,0,5,5,5,0,4,3,3,15,2,1,OKC,UTA,OKC,134,1.5,Offensive Rebounds,25,20,20,10
Chet Holmgren,C,22023,1631096,22300581,"JAN 18, 2024",OKC @ UTA,W,32,6,16,0.375,2,6,0.333,1,2,0.5,0,5,5,5,0,4,3,3,15,2,1,OKC,UTA,OKC,134,25.5,Pts+Rebs,25,20,20,10
Chet Holmgren,C,22023,1631096,22300581,"JAN 18, 2024",OKC @ UTA,W,32,6,16,0.375,2,6,0.333,1,2,0.5,0,5,5,5,0,4,3,3,15,2,1,OKC,UTA,OKC,134,1.5,Dunks,25,20,20,10
Chet Holmgren,C,22023,1631096,22300581,"JAN 18, 2024",OKC @ UTA,W,32,6,16,0.375,2,6,0.333,1,2,0.5,0,5,5,5,0,4,3,3,15,2,1,OKC,UTA,OKC,134,20.5,Pts+Asts,25,20,20,10
Chet Holmgren,C,22023,1631096,22300581,"JAN 18, 2024",OKC @ UTA,W,32,6,16,0.375,2,6,0.333,1,2,0.5,0,5,5,5,0,4,3,3,15,2,1,OKC,UTA,OKC,134,0.5,Steals,25,20,20,10
Chet Holmgren,C,22023,1631096,22300581,"JAN 18, 2024",OKC @ UTA,W,32,6,16,0.375,2,6,0.333,1,2,0.5,0,5,5,5,0,4,3,3,15,2,1,OKC,UTA,OKC,134,11.5,Rebs+Asts,25,20,20,10
Chet Holmgren,C,22023,1631096,22300581,"JAN 18, 2024",OKC @ UTA,W,32,6,16,0.375,2,6,0.333,1,2,0.5,0,5,5,5,0,4,3,3,15,2,1,OKC,UTA,OKC,134,1.5,Turnovers,25,20,20,10
Jordan Poole,G,22023,1629673,22300753,"FEB 10, 2024",WAS vs. PHI,L,29,4,8,0.5,2,4,0.5,1,2,0.5,1,3,4,4,2,0,2,4,11,3,1,WAS,WAS,PHI,113,,,19,15,15,8
Jordan Poole,G,22023,1629673,22300743,"FEB 09, 2024",WAS @ BOS,L,37,7,19,0.368,3,10,0.3,2,3,0.667,0,2,2,5,1,0,3,5,19,1,1,WAS,BOS,WAS,129,,,26,21,24,7
Jordan Poole,G,22023,1629673,22300728,"FEB 07, 2024",WAS vs. CLE,L,25,0,5,0.0,0,4,0.0,0,0,0.0,0,2,2,5,1,0,1,6,0,-4,1,WAS,WAS,CLE,106,,,7,2,5,7
Jordan Poole,G,22023,1629673,22300705,"FEB 04, 2024",WAS vs. PHX,L,20,1,7,0.143,0,3,0.0,2,2,1.0,0,5,5,7,0,0,1,3,4,-16,1,WAS,WAS,PHX,109,,,16,9,11,12
Jordan Poole,G,22023,1629673,22300689,"FEB 02, 2024",WAS vs. MIA,L,33,6,21,0.286,2,14,0.143,2,3,0.667,0,4,4,10,2,1,1,3,16,-3,1,WAS,WAS,MIA,102,,,30,20,26,14
Jordan Poole,G,22023,1629673,22300665,"JAN 29, 2024",WAS @ SAS,W,33,6,13,0.462,1,5,0.2,0,0,0.0,0,1,1,3,2,1,4,2,13,5,1,WAS,SAS,WAS,118,,,17,14,16,4
Jordan Poole,G,22023,1629673,22300642,"JAN 27, 2024",WAS @ DET,W,29,6,12,0.5,3,6,0.5,2,2,1.0,1,0,1,2,1,0,0,1,17,25,1,WAS,DET,WAS,118,,,20,18,19,3
Jordan Poole,G,22023,1629673,22300628,"JAN 25, 2024",WAS vs. UTA,L,28,6,12,0.5,3,7,0.429,3,4,0.75,0,2,2,2,2,2,0,5,18,-3,1,WAS,WAS,UTA,108,,,22,20,20,4
Jordan Poole,G,22023,1629673,22300620,"JAN 24, 2024",WAS vs. MIN,L,28,2,11,0.182,1,4,0.25,2,2,1.0,0,2,2,3,0,0,4,3,7,-10,1,WAS,WAS,MIN,107,,,12,9,10,5
Jordan Poole,G,22023,1629673,22300602,"JAN 21, 2024",WAS vs. DEN,L,28,1,7,0.143,1,4,0.25,1,1,1.0,0,1,1,0,0,0,2,4,4,-10,1,WAS,WAS,DEN,104,,,5,5,4,1
Jordan Poole,G,22023,1629673,22300594,"JAN 20, 2024",WAS vs. SAS,L,29,7,15,0.467,0,3,0.0,2,2,1.0,0,0,0,2,2,1,1,4,16,-15,1,WAS,WAS,SAS,127,,,18,16,18,2
Jordan Poole,G,22023,1629673,22300579,"JAN 18, 2024",WAS @ NYK,L,34,7,19,0.368,2,9,0.222,8,8,1.0,0,4,4,2,1,0,0,1,24,-8,1,WAS,NYK,WAS,109,,,30,28,26,6
Jordan Poole,G,22023,1629673,22300558,"JAN 15, 2024",WAS vs. DET,L,32,6,14,0.429,2,7,0.286,2,2,1.0,0,0,0,2,0,0,1,3,16,-9,1,WAS,WAS,DET,117,,,18,16,18,2
Jordan Poole,G,22023,1629673,22300543,"JAN 13, 2024",WAS @ ATL,W,26,8,16,0.5,2,6,0.333,2,2,1.0,0,2,2,2,1,1,1,1,20,19,1,WAS,ATL,WAS,125,,,24,22,22,4
Jordan Poole,G,22023,1629673,22300520,"JAN 10, 2024",WAS @ IND,L,34,11,21,0.524,2,7,0.286,4,6,0.667,1,3,4,7,3,0,1,3,28,0,1,WAS,IND,WAS,104,,,39,32,35,11
Jordan Poole,G,22023,1629673,22300508,"JAN 08, 2024",WAS vs. OKC,L,29,8,17,0.471,4,8,0.5,4,5,0.8,0,0,0,5,0,0,1,5,24,3,1,WAS,WAS,OKC,128,,,29,24,29,5
Jordan Poole,G,22023,1629673,22300494,"JAN 06, 2024",WAS vs. NYK,L,30,4,10,0.4,1,5,0.2,1,2,0.5,0,3,3,4,2,0,2,3,10,-1,1,WAS,WAS,NYK,105,,,17,13,14,7
Jordan Poole,G,22023,1629673,22300482,"JAN 05, 2024",WAS @ CLE,L,23,0,4,0.0,0,2,0.0,2,2,1.0,0,0,0,1,0,1,0,4,2,-14,1,WAS,CLE,WAS,90,,,3,2,3,1
Jordan Poole,G,22023,1629673,22300465,"JAN 03, 2024",WAS @ CLE,L,23,3,11,0.273,2,4,0.5,0,0,0.0,3,0,3,2,0,0,1,3,8,-22,1,WAS,CLE,WAS,101,,,13,11,10,5
Jordan Poole,G,22023,1629673,22300445,"DEC 31, 2023",WAS vs. ATL,L,29,6,14,0.429,1,7,0.143,0,0,0.0,0,3,3,6,0,1,0,3,13,6,1,WAS,WAS,ATL,126,,,22,16,19,9
Jordan Poole,G,22023,1629673,22300430,"DEC 29, 2023",WAS vs. BKN,W,25,2,6,0.333,1,4,0.25,0,0,0.0,0,0,0,5,0,0,1,4,5,-16,1,WAS,WAS,BKN,110,,,10,5,10,5
Jordan Poole,G,22023,1629673,22300416,"DEC 27, 2023",WAS vs. TOR,L,28,5,12,0.417,1,7,0.143,3,4,0.75,2,2,4,4,0,1,2,1,14,-17,1,WAS,WAS,TOR,102,,,22,18,18,8
Jordan Poole,G,22023,1629673,22300407,"DEC 26, 2023",WAS vs. ORL,L,33,11,20,0.55,6,11,0.545,2,2,1.0,0,2,2,3,3,0,3,3,30,-18,1,WAS,WAS,ORL,119,,,35,32,33,5
Jordan Poole,G,22023,1629673,22300386,"DEC 22, 2023",WAS @ GSW,L,27,7,21,0.333,3,12,0.25,8,9,0.889,1,2,3,3,2,0,1,3,25,-9,1,WAS,GSW,WAS,118,,,31,28,28,6
Jordan Poole,G,22023,1629673,22300381,"DEC 21, 2023",WAS @ POR,W,34,4,13,0.308,0,4,0.0,5,5,1.0,0,2,2,6,1,0,3,2,13,5,1,WAS,POR,WAS,118,,,21,15,19,8
Jordan Poole,G,22023,1629673,22300358,"DEC 18, 2023",WAS @ SAC,L,29,10,18,0.556,8,13,0.615,0,0,0.0,0,0,0,2,0,0,1,4,28,-8,1,WAS,SAC,WAS,131,,,30,28,30,2
Jordan Poole,G,22023,1629673,22300347,"DEC 17, 2023",WAS @ PHX,L,32,5,17,0.294,2,9,0.222,2,2,1.0,0,4,4,4,1,0,4,4,14,4,1,WAS,PHX,WAS,108,,,22,18,18,8
Jordan Poole,G,22023,1629673,22300328,"DEC 15, 2023",WAS vs. IND,W,32,12,18,0.667,3,4,0.75,3,4,0.75,0,4,4,8,1,0,2,4,30,15,1,WAS,WAS,IND,137,,,42,34,38,12
Jordan Poole,G,22023,1629673,22300311,"DEC 13, 2023",WAS vs. NOP,L,31,5,12,0.417,1,5,0.2,0,0,0.0,0,1,1,4,2,1,4,2,11,-10,1,WAS,WAS,NOP,122,,,16,12,15,5
Jordan Poole,G,22023,1629673,22300295,"DEC 11, 2023",WAS @ PHI,L,26,3,11,0.273,1,3,0.333,4,4,1.0,0,0,0,3,0,0,3,1,11,-30,1,WAS,PHI,WAS,99,,,14,11,14,3
Jordan Poole,G,22023,1629673,22301219,"DEC 08, 2023",WAS @ BKN,L,24,3,7,0.429,0,2,0.0,2,2,1.0,0,2,2,2,0,0,3,3,8,-16,1,WAS,BKN,WAS,97,,,12,10,10,4
Jordan Poole,G,22023,1629673,22301208,"DEC 06, 2023",WAS vs. PHI,L,32,10,16,0.625,3,5,0.6,0,0,0.0,0,1,1,2,1,0,3,3,23,-10,1,WAS,WAS,PHI,126,,,26,24,25,3
Jordan Poole,G,22023,1629673,22300274,"DEC 01, 2023",WAS @ ORL,L,30,3,12,0.25,0,5,0.0,8,9,0.889,0,4,4,4,1,0,2,5,14,-4,1,WAS,ORL,WAS,125,,,22,18,18,8
Jordan Poole,G,22023,1629673,22300259,"NOV 29, 2023",WAS @ ORL,L,26,5,12,0.417,4,7,0.571,5,6,0.833,0,5,5,2,2,1,2,3,19,-6,1,WAS,ORL,WAS,120,,,26,24,21,7
Jordan Poole,G,22023,1629673,22300253,"NOV 27, 2023",WAS @ DET,W,25,3,9,0.333,0,2,0.0,4,4,1.0,0,0,0,3,1,0,4,3,10,10,1,WAS,DET,WAS,126,,,13,10,13,3
Jordan Poole,G,22023,1629673,22300049,"NOV 24, 2023",WAS @ MIL,L,34,9,20,0.45,1,6,0.167,7,9,0.778,1,4,5,7,0,0,2,5,26,-3,1,WAS,MIL,WAS,128,,,38,31,33,12
Jordan Poole,G,22023,1629673,22300225,"NOV 22, 2023",WAS @ CHA,L,33,8,21,0.381,4,11,0.364,4,4,1.0,2,3,5,2,3,0,3,1,24,-14,1,WAS,CHA,WAS,114,,,31,29,26,7
Jordan Poole,G,22023,1629673,22300219,"NOV 20, 2023",WAS vs. MIL,L,33,11,26,0.423,3,9,0.333,5,5,1.0,0,1,1,1,0,0,0,4,30,-26,1,WAS,WAS,MIL,129,,,32,31,31,2
Jordan Poole,G,22023,1629673,22300028,"NOV 17, 2023",WAS vs. NYK,L,29,2,11,0.182,0,6,0.0,4,4,1.0,0,1,1,4,0,0,5,2,8,-18,1,WAS,WAS,NYK,99,,,13,9,12,5
Jordan Poole,G,22023,1629673,22300192,"NOV 15, 2023",WAS vs. DAL,L,32,6,17,0.353,2,7,0.286,2,2,1.0,1,4,5,3,1,0,5,4,16,-10,1,WAS,WAS,DAL,117,,,24,21,19,8
Jordan Poole,G,22023,1629673,22300189,"NOV 13, 2023",WAS @ TOR,L,35,6,16,0.375,2,6,0.333,0,0,0.0,2,2,4,6,3,1,4,5,14,-12,1,WAS,TOR,WAS,107,,,24,18,20,10
Jordan Poole,G,22023,1629673,22300178,"NOV 12, 2023",WAS @ BKN,L,32,5,12,0.417,2,8,0.25,0,1,0.0,0,5,5,2,0,1,3,6,12,-22,1,WAS,BKN,WAS,94,,,19,17,14,7
Jordan Poole,G,22023,1629673,22300009,"NOV 10, 2023",WAS vs. CHA,L,31,6,14,0.429,1,5,0.2,1,1,1.0,0,2,2,6,0,0,3,4,14,-17,1,WAS,WAS,CHA,117,,,22,16,20,8
Jordan Poole,G,22023,1629673,22300157,"NOV 08, 2023",WAS @ CHA,W,20,3,12,0.25,1,5,0.2,4,5,0.8,1,1,2,1,0,0,1,2,11,-5,1,WAS,CHA,WAS,132,,,14,13,12,3
Jordan Poole,G,22023,1629673,22300148,"NOV 06, 2023",WAS @ PHI,L,31,8,15,0.533,4,9,0.444,3,3,1.0,0,1,1,6,0,1,2,4,23,-3,1,WAS,PHI,WAS,128,,,30,24,29,7
Jordan Poole,G,22023,1629673,22300003,"NOV 03, 2023",WAS @ MIA,L,28,8,14,0.571,3,4,0.75,0,1,0.0,0,1,1,6,4,0,2,3,19,-21,1,WAS,MIA,WAS,114,,,26,20,25,7
Jordan Poole,G,22023,1629673,22300117,"NOV 01, 2023",WAS @ ATL,L,20,5,13,0.385,2,6,0.333,1,1,1.0,0,0,0,1,1,0,1,1,13,-22,1,WAS,ATL,WAS,121,,,14,13,14,1
Jordan Poole,G,22023,1629673,22300103,"OCT 30, 2023",WAS vs. BOS,L,25,5,11,0.455,1,5,0.2,0,0,0.0,2,1,3,2,3,1,3,3,11,-29,1,WAS,WAS,BOS,107,,,16,14,13,5
Jordan Poole,G,22023,1629673,22300089,"OCT 28, 2023",WAS vs. MEM,W,36,8,23,0.348,4,12,0.333,7,9,0.778,0,4,4,2,1,1,5,2,27,13,1,WAS,WAS,MEM,113,,,33,31,29,6
Jordan Poole,G,22023,1629673,22300064,"OCT 25, 2023",WAS @ IND,L,26,7,18,0.389,0,6,0.0,4,5,0.8,0,2,2,5,1,1,4,1,18,-12,1,WAS,IND,WAS,120,,,25,20,23,7
Keegan Murray,F,22023,1631099,22300746,"FEB 09, 2024",SAC vs. DEN,W,27,6,11,0.545,1,4,0.25,4,4,1.0,0,1,1,2,0,0,1,3,17,9,1,SAC,SAC,DEN,135,14.0,Points,20,18,19,3
Keegan Murray,F,22023,1631099,22300746,"FEB 09, 2024",SAC vs. DEN,W,27,6,11,0.545,1,4,0.25,4,4,1.0,0,1,1,2,0,0,1,3,17,9,1,SAC,SAC,DEN,135,5.0,Rebounds,20,18,19,3
Keegan Murray,F,22023,1631099,22300746,"FEB 09, 2024",SAC vs. DEN,W,27,6,11,0.545,1,4,0.25,4,4,1.0,0,1,1,2,0,0,1,3,17,9,1,SAC,SAC,DEN,135,20.5,Pts+Rebs+Asts,20,18,19,3
Keegan Murray,F,22023,1631099,22300746,"FEB 09, 2024",SAC vs. DEN,W,27,6,11,0.545,1,4,0.25,4,4,1.0,0,1,1,2,0,0,1,3,17,9,1,SAC,SAC,DEN,135,26.5,Fantasy Score,20,18,19,3
Keegan Murray,F,22023,1631099,22300746,"FEB 09, 2024",SAC vs. DEN,W,27,6,11,0.545,1,4,0.25,4,4,1.0,0,1,1,2,0,0,1,3,17,9,1,SAC,SAC,DEN,135,18.5,Pts+Rebs,20,18,19,3
Keegan Murray,F,22023,1631099,22300746,"FEB 09, 2024",SAC vs. DEN,W,27,6,11,0.545,1,4,0.25,4,4,1.0,0,1,1,2,0,0,1,3,17,9,1,SAC,SAC,DEN,135,15.5,Pts+Asts,20,18,19,3
Keegan Murray,F,22023,1631099,22300732,"FEB 07, 2024",SAC vs. DET,L,20,0,4,0.0,0,3,0.0,0,0,0.0,0,4,4,4,1,1,1,4,0,-4,1,SAC,SAC,DET,120,14.0,Points,8,4,4,8
Keegan Murray,F,22023,1631099,22300732,"FEB 07, 2024",SAC vs. DET,L,20,0,4,0.0,0,3,0.0,0,0,0.0,0,4,4,4,1,1,1,4,0,-4,1,SAC,SAC,DET,120,5.0,Rebounds,8,4,4,8
Keegan Murray,F,22023,1631099,22300732,"FEB 07, 2024",SAC vs. DET,L,20,0,4,0.0,0,3,0.0,0,0,0.0,0,4,4,4,1,1,1,4,0,-4,1,SAC,SAC,DET,120,20.5,Pts+Rebs+Asts,8,4,4,8
Keegan Murray,F,22023,1631099,22300732,"FEB 07, 2024",SAC vs. DET,L,20,0,4,0.0,0,3,0.0,0,0,0.0,0,4,4,4,1,1,1,4,0,-4,1,SAC,SAC,DET,120,26.5,Fantasy Score,8,4,4,8
Keegan Murray,F,22023,1631099,22300732,"FEB 07, 2024",SAC vs. DET,L,20,0,4,0.0,0,3,0.0,0,0,0.0,0,4,4,4,1,1,1,4,0,-4,1,SAC,SAC,DET,120,18.5,Pts+Rebs,8,4,4,8
Keegan Murray,F,22023,1631099,22300732,"FEB 07, 2024",SAC vs. DET,L,20,0,4,0.0,0,3,0.0,0,0,0.0,0,4,4,4,1,1,1,4,0,-4,1,SAC,SAC,DET,120,15.5,Pts+Asts,8,4,4,8
Keegan Murray,F,22023,1631099,22300714,"FEB 05, 2024",SAC @ CLE,L,30,4,9,0.444,2,4,0.5,0,0,0.0,0,1,1,2,0,0,0,3,10,-18,1,SAC,CLE,SAC,110,14.0,Points,13,11,12,3
Keegan Murray,F,22023,1631099,22300714,"FEB 05, 2024",SAC @ CLE,L,30,4,9,0.444,2,4,0.5,0,0,0.0,0,1,1,2,0,0,0,3,10,-18,1,SAC,CLE,SAC,110,5.0,Rebounds,13,11,12,3
Keegan Murray,F,22023,1631099,22300714,"FEB 05, 2024",SAC @ CLE,L,30,4,9,0.444,2,4,0.5,0,0,0.0,0,1,1,2,0,0,0,3,10,-18,1,SAC,CLE,SAC,110,20.5,Pts+Rebs+Asts,13,11,12,3
Keegan Murray,F,22023,1631099,22300714,"FEB 05, 2024",SAC @ CLE,L,30,4,9,0.444,2,4,0.5,0,0,0.0,0,1,1,2,0,0,0,3,10,-18,1,SAC,CLE,SAC,110,26.5,Fantasy Score,13,11,12,3
Keegan Murray,F,22023,1631099,22300714,"FEB 05, 2024",SAC @ CLE,L,30,4,9,0.444,2,4,0.5,0,0,0.0,0,1,1,2,0,0,0,3,10,-18,1,SAC,CLE,SAC,110,18.5,Pts+Rebs,13,11,12,3
Keegan Murray,F,22023,1631099,22300714,"FEB 05, 2024",SAC @ CLE,L,30,4,9,0.444,2,4,0.5,0,0,0.0,0,1,1,2,0,0,0,3,10,-18,1,SAC,CLE,SAC,110,15.5,Pts+Asts,13,11,12,3
Keegan Murray,F,22023,1631099,22300700,"FEB 03, 2024",SAC @ CHI,W,31,2,6,0.333,1,5,0.2,0,0,0.0,0,6,6,3,2,0,0,4,5,13,1,SAC,CHI,SAC,123,14.0,Points,14,11,8,9
Keegan Murray,F,22023,1631099,22300700,"FEB 03, 2024",SAC @ CHI,W,31,2,6,0.333,1,5,0.2,0,0,0.0,0,6,6,3,2,0,0,4,5,13,1,SAC,CHI,SAC,123,5.0,Rebounds,14,11,8,9
Keegan Murray,F,22023,1631099,22300700,"FEB 03, 2024",SAC @ CHI,W,31,2,6,0.333,1,5,0.2,0,0,0.0,0,6,6,3,2,0,0,4,5,13,1,SAC,CHI,SAC,123,20.5,Pts+Rebs+Asts,14,11,8,9
Keegan Murray,F,22023,1631099,22300700,"FEB 03, 2024",SAC @ CHI,W,31,2,6,0.333,1,5,0.2,0,0,0.0,0,6,6,3,2,0,0,4,5,13,1,SAC,CHI,SAC,123,26.5,Fantasy Score,14,11,8,9
Keegan Murray,F,22023,1631099,22300700,"FEB 03, 2024",SAC @ CHI,W,31,2,6,0.333,1,5,0.2,0,0,0.0,0,6,6,3,2,0,0,4,5,13,1,SAC,CHI,SAC,123,18.5,Pts+Rebs,14,11,8,9
Keegan Murray,F,22023,1631099,22300700,"FEB 03, 2024",SAC @ CHI,W,31,2,6,0.333,1,5,0.2,0,0,0.0,0,6,6,3,2,0,0,4,5,13,1,SAC,CHI,SAC,123,15.5,Pts+Asts,14,11,8,9
Keegan Murray,F,22023,1631099,22300691,"FEB 02, 2024",SAC @ IND,W,28,2,7,0.286,1,6,0.167,0,0,0.0,1,0,1,1,0,0,0,0,5,12,1,SAC,IND,SAC,133,14.0,Points,7,6,6,2
Keegan Murray,F,22023,1631099,22300691,"FEB 02, 2024",SAC @ IND,W,28,2,7,0.286,1,6,0.167,0,0,0.0,1,0,1,1,0,0,0,0,5,12,1,SAC,IND,SAC,133,5.0,Rebounds,7,6,6,2
Keegan Murray,F,22023,1631099,22300691,"FEB 02, 2024",SAC @ IND,W,28,2,7,0.286,1,6,0.167,0,0,0.0,1,0,1,1,0,0,0,0,5,12,1,SAC,IND,SAC,133,20.5,Pts+Rebs+Asts,7,6,6,2
Keegan Murray,F,22023,1631099,22300691,"FEB 02, 2024",SAC @ IND,W,28,2,7,0.286,1,6,0.167,0,0,0.0,1,0,1,1,0,0,0,0,5,12,1,SAC,IND,SAC,133,26.5,Fantasy Score,7,6,6,2
Keegan Murray,F,22023,1631099,22300691,"FEB 02, 2024",SAC @ IND,W,28,2,7,0.286,1,6,0.167,0,0,0.0,1,0,1,1,0,0,0,0,5,12,1,SAC,IND,SAC,133,18.5,Pts+Rebs,7,6,6,2
Keegan Murray,F,22023,1631099,22300691,"FEB 02, 2024",SAC @ IND,W,28,2,7,0.286,1,6,0.167,0,0,0.0,1,0,1,1,0,0,0,0,5,12,1,SAC,IND,SAC,133,15.5,Pts+Asts,7,6,6,2
Keegan Murray,F,22023,1631099,22300678,"JAN 31, 2024",SAC @ MIA,L,38,12,18,0.667,7,11,0.636,2,2,1.0,1,4,5,2,1,2,0,5,33,4,1,SAC,MIA,SAC,106,14.0,Points,40,38,35,7
Keegan Murray,F,22023,1631099,22300678,"JAN 31, 2024",SAC @ MIA,L,38,12,18,0.667,7,11,0.636,2,2,1.0,1,4,5,2,1,2,0,5,33,4,1,SAC,MIA,SAC,106,5.0,Rebounds,40,38,35,7
Keegan Murray,F,22023,1631099,22300678,"JAN 31, 2024",SAC @ MIA,L,38,12,18,0.667,7,11,0.636,2,2,1.0,1,4,5,2,1,2,0,5,33,4,1,SAC,MIA,SAC,106,20.5,Pts+Rebs+Asts,40,38,35,7
Keegan Murray,F,22023,1631099,22300678,"JAN 31, 2024",SAC @ MIA,L,38,12,18,0.667,7,11,0.636,2,2,1.0,1,4,5,2,1,2,0,5,33,4,1,SAC,MIA,SAC,106,26.5,Fantasy Score,40,38,35,7
Keegan Murray,F,22023,1631099,22300678,"JAN 31, 2024",SAC @ MIA,L,38,12,18,0.667,7,11,0.636,2,2,1.0,1,4,5,2,1,2,0,5,33,4,1,SAC,MIA,SAC,106,18.5,Pts+Rebs,40,38,35,7
Keegan Murray,F,22023,1631099,22300678,"JAN 31, 2024",SAC @ MIA,L,38,12,18,0.667,7,11,0.636,2,2,1.0,1,4,5,2,1,2,0,5,33,4,1,SAC,MIA,SAC,106,15.5,Pts+Asts,40,38,35,7
Keegan Murray,F,22023,1631099,22300663,"JAN 29, 2024",SAC @ MEM,W,25,2,7,0.286,1,4,0.25,0,0,0.0,1,4,5,2,2,0,4,2,5,-3,1,SAC,MEM,SAC,103,14.0,Points,12,10,7,7
Keegan Murray,F,22023,1631099,22300663,"JAN 29, 2024",SAC @ MEM,W,25,2,7,0.286,1,4,0.25,0,0,0.0,1,4,5,2,2,0,4,2,5,-3,1,SAC,MEM,SAC,103,5.0,Rebounds,12,10,7,7
Keegan Murray,F,22023,1631099,22300663,"JAN 29, 2024",SAC @ MEM,W,25,2,7,0.286,1,4,0.25,0,0,0.0,1,4,5,2,2,0,4,2,5,-3,1,SAC,MEM,SAC,103,20.5,Pts+Rebs+Asts,12,10,7,7
Keegan Murray,F,22023,1631099,22300663,"JAN 29, 2024",SAC @ MEM,W,25,2,7,0.286,1,4,0.25,0,0,0.0,1,4,5,2,2,0,4,2,5,-3,1,SAC,MEM,SAC,103,26.5,Fantasy Score,12,10,7,7
Keegan Murray,F,22023,1631099,22300663,"JAN 29, 2024",SAC @ MEM,W,25,2,7,0.286,1,4,0.25,0,0,0.0,1,4,5,2,2,0,4,2,5,-3,1,SAC,MEM,SAC,103,18.5,Pts+Rebs,12,10,7,7
Keegan Murray,F,22023,1631099,22300663,"JAN 29, 2024",SAC @ MEM,W,25,2,7,0.286,1,4,0.25,0,0,0.0,1,4,5,2,2,0,4,2,5,-3,1,SAC,MEM,SAC,103,15.5,Pts+Asts,12,10,7,7
Keegan Murray,F,22023,1631099,22300651,"JAN 27, 2024",SAC @ DAL,W,40,5,13,0.385,1,6,0.167,4,6,0.667,1,3,4,2,0,3,0,4,15,4,1,SAC,DAL,SAC,120,14.0,Points,21,19,17,6
Keegan Murray,F,22023,1631099,22300651,"JAN 27, 2024",SAC @ DAL,W,40,5,13,0.385,1,6,0.167,4,6,0.667,1,3,4,2,0,3,0,4,15,4,1,SAC,DAL,SAC,120,5.0,Rebounds,21,19,17,6
Keegan Murray,F,22023,1631099,22300651,"JAN 27, 2024",SAC @ DAL,W,40,5,13,0.385,1,6,0.167,4,6,0.667,1,3,4,2,0,3,0,4,15,4,1,SAC,DAL,SAC,120,20.5,Pts+Rebs+Asts,21,19,17,6
Keegan Murray,F,22023,1631099,22300651,"JAN 27, 2024",SAC @ DAL,W,40,5,13,0.385,1,6,0.167,4,6,0.667,1,3,4,2,0,3,0,4,15,4,1,SAC,DAL,SAC,120,26.5,Fantasy Score,21,19,17,6
Keegan Murray,F,22023,1631099,22300651,"JAN 27, 2024",SAC @ DAL,W,40,5,13,0.385,1,6,0.167,4,6,0.667,1,3,4,2,0,3,0,4,15,4,1,SAC,DAL,SAC,120,18.5,Pts+Rebs,21,19,17,6
Keegan Murray,F,22023,1631099,22300651,"JAN 27, 2024",SAC @ DAL,W,40,5,13,0.385,1,6,0.167,4,6,0.667,1,3,4,2,0,3,0,4,15,4,1,SAC,DAL,SAC,120,15.5,Pts+Asts,21,19,17,6
Keegan Murray,F,22023,1631099,22300632,"JAN 25, 2024",SAC @ GSW,W,38,5,12,0.417,2,7,0.286,2,2,1.0,1,5,6,1,1,2,0,2,14,11,1,SAC,GSW,SAC,134,14.0,Points,21,20,15,7
Keegan Murray,F,22023,1631099,22300632,"JAN 25, 2024",SAC @ GSW,W,38,5,12,0.417,2,7,0.286,2,2,1.0,1,5,6,1,1,2,0,2,14,11,1,SAC,GSW,SAC,134,5.0,Rebounds,21,20,15,7
Keegan Murray,F,22023,1631099,22300632,"JAN 25, 2024",SAC @ GSW,W,38,5,12,0.417,2,7,0.286,2,2,1.0,1,5,6,1,1,2,0,2,14,11,1,SAC,GSW,SAC,134,20.5,Pts+Rebs+Asts,21,20,15,7
Keegan Murray,F,22023,1631099,22300632,"JAN 25, 2024",SAC @ GSW,W,38,5,12,0.417,2,7,0.286,2,2,1.0,1,5,6,1,1,2,0,2,14,11,1,SAC,GSW,SAC,134,26.5,Fantasy Score,21,20,15,7
Keegan Murray,F,22023,1631099,22300632,"JAN 25, 2024",SAC @ GSW,W,38,5,12,0.417,2,7,0.286,2,2,1.0,1,5,6,1,1,2,0,2,14,11,1,SAC,GSW,SAC,134,18.5,Pts+Rebs,21,20,15,7
Keegan Murray,F,22023,1631099,22300632,"JAN 25, 2024",SAC @ GSW,W,38,5,12,0.417,2,7,0.286,2,2,1.0,1,5,6,1,1,2,0,2,14,11,1,SAC,GSW,SAC,134,15.5,Pts+Asts,21,20,15,7
Keegan Murray,F,22023,1631099,22300613,"JAN 22, 2024",SAC vs. ATL,W,32,5,12,0.417,2,7,0.286,1,2,0.5,2,4,6,2,2,0,0,3,13,8,1,SAC,SAC,ATL,122,14.0,Points,21,19,15,8
Keegan Murray,F,22023,1631099,22300613,"JAN 22, 2024",SAC vs. ATL,W,32,5,12,0.417,2,7,0.286,1,2,0.5,2,4,6,2,2,0,0,3,13,8,1,SAC,SAC,ATL,122,5.0,Rebounds,21,19,15,8
Keegan Murray,F,22023,1631099,22300613,"JAN 22, 2024",SAC vs. ATL,W,32,5,12,0.417,2,7,0.286,1,2,0.5,2,4,6,2,2,0,0,3,13,8,1,SAC,SAC,ATL,122,20.5,Pts+Rebs+Asts,21,19,15,8
Keegan Murray,F,22023,1631099,22300613,"JAN 22, 2024",SAC vs. ATL,W,32,5,12,0.417,2,7,0.286,1,2,0.5,2,4,6,2,2,0,0,3,13,8,1,SAC,SAC,ATL,122,26.5,Fantasy Score,21,19,15,8
Keegan Murray,F,22023,1631099,22300613,"JAN 22, 2024",SAC vs. ATL,W,32,5,12,0.417,2,7,0.286,1,2,0.5,2,4,6,2,2,0,0,3,13,8,1,SAC,SAC,ATL,122,18.5,Pts+Rebs,21,19,15,8
Keegan Murray,F,22023,1631099,22300613,"JAN 22, 2024",SAC vs. ATL,W,32,5,12,0.417,2,7,0.286,1,2,0.5,2,4,6,2,2,0,0,3,13,8,1,SAC,SAC,ATL,122,15.5,Pts+Asts,21,19,15,8
Keegan Murray,F,22023,1631099,22300583,"JAN 18, 2024",SAC vs. IND,L,38,11,18,0.611,1,5,0.2,4,5,0.8,3,6,9,0,2,1,1,3,27,10,1,SAC,SAC,IND,121,14.0,Points,36,36,27,9
Keegan Murray,F,22023,1631099,22300583,"JAN 18, 2024",SAC vs. IND,L,38,11,18,0.611,1,5,0.2,4,5,0.8,3,6,9,0,2,1,1,3,27,10,1,SAC,SAC,IND,121,5.0,Rebounds,36,36,27,9
Keegan Murray,F,22023,1631099,22300583,"JAN 18, 2024",SAC vs. IND,L,38,11,18,0.611,1,5,0.2,4,5,0.8,3,6,9,0,2,1,1,3,27,10,1,SAC,SAC,IND,121,20.5,Pts+Rebs+Asts,36,36,27,9
Keegan Murray,F,22023,1631099,22300583,"JAN 18, 2024",SAC vs. IND,L,38,11,18,0.611,1,5,0.2,4,5,0.8,3,6,9,0,2,1,1,3,27,10,1,SAC,SAC,IND,121,26.5,Fantasy Score,36,36,27,9
Keegan Murray,F,22023,1631099,22300583,"JAN 18, 2024",SAC vs. IND,L,38,11,18,0.611,1,5,0.2,4,5,0.8,3,6,9,0,2,1,1,3,27,10,1,SAC,SAC,IND,121,18.5,Pts+Rebs,36,36,27,9
Keegan Murray,F,22023,1631099,22300583,"JAN 18, 2024",SAC vs. IND,L,38,11,18,0.611,1,5,0.2,4,5,0.8,3,6,9,0,2,1,1,3,27,10,1,SAC,SAC,IND,121,15.5,Pts+Asts,36,36,27,9
Keegan Murray,F,22023,1631099,22300567,"JAN 16, 2024",SAC @ PHX,L,35,7,12,0.583,3,5,0.6,1,2,0.5,1,3,4,3,1,1,1,3,18,-9,1,SAC,PHX,SAC,117,14.0,Points,25,22,21,7
Keegan Murray,F,22023,1631099,22300567,"JAN 16, 2024",SAC @ PHX,L,35,7,12,0.583,3,5,0.6,1,2,0.5,1,3,4,3,1,1,1,3,18,-9,1,SAC,PHX,SAC,117,5.0,Rebounds,25,22,21,7
Keegan Murray,F,22023,1631099,22300567,"JAN 16, 2024",SAC @ PHX,L,35,7,12,0.583,3,5,0.6,1,2,0.5,1,3,4,3,1,1,1,3,18,-9,1,SAC,PHX,SAC,117,20.5,Pts+Rebs+Asts,25,22,21,7
Keegan Murray,F,22023,1631099,22300567,"JAN 16, 2024",SAC @ PHX,L,35,7,12,0.583,3,5,0.6,1,2,0.5,1,3,4,3,1,1,1,3,18,-9,1,SAC,PHX,SAC,117,26.5,Fantasy Score,25,22,21,7
Keegan Murray,F,22023,1631099,22300567,"JAN 16, 2024",SAC @ PHX,L,35,7,12,0.583,3,5,0.6,1,2,0.5,1,3,4,3,1,1,1,3,18,-9,1,SAC,PHX,SAC,117,18.5,Pts+Rebs,25,22,21,7
Keegan Murray,F,22023,1631099,22300567,"JAN 16, 2024",SAC @ PHX,L,35,7,12,0.583,3,5,0.6,1,2,0.5,1,3,4,3,1,1,1,3,18,-9,1,SAC,PHX,SAC,117,15.5,Pts+Asts,25,22,21,7
Keegan Murray,F,22023,1631099,22300552,"JAN 14, 2024",SAC @ MIL,L,19,2,9,0.222,0,2,0.0,0,0,0.0,0,1,1,0,0,1,0,1,4,1,1,SAC,MIL,SAC,142,14.0,Points,5,5,4,1
Keegan Murray,F,22023,1631099,22300552,"JAN 14, 2024",SAC @ MIL,L,19,2,9,0.222,0,2,0.0,0,0,0.0,0,1,1,0,0,1,0,1,4,1,1,SAC,MIL,SAC,142,5.0,Rebounds,5,5,4,1
Keegan Murray,F,22023,1631099,22300552,"JAN 14, 2024",SAC @ MIL,L,19,2,9,0.222,0,2,0.0,0,0,0.0,0,1,1,0,0,1,0,1,4,1,1,SAC,MIL,SAC,142,20.5,Pts+Rebs+Asts,5,5,4,1
Keegan Murray,F,22023,1631099,22300552,"JAN 14, 2024",SAC @ MIL,L,19,2,9,0.222,0,2,0.0,0,0,0.0,0,1,1,0,0,1,0,1,4,1,1,SAC,MIL,SAC,142,26.5,Fantasy Score,5,5,4,1
Keegan Murray,F,22023,1631099,22300552,"JAN 14, 2024",SAC @ MIL,L,19,2,9,0.222,0,2,0.0,0,0,0.0,0,1,1,0,0,1,0,1,4,1,1,SAC,MIL,SAC,142,18.5,Pts+Rebs,5,5,4,1
Keegan Murray,F,22023,1631099,22300552,"JAN 14, 2024",SAC @ MIL,L,19,2,9,0.222,0,2,0.0,0,0,0.0,0,1,1,0,0,1,0,1,4,1,1,SAC,MIL,SAC,142,15.5,Pts+Asts,5,5,4,1
Keegan Murray,F,22023,1631099,22300532,"JAN 12, 2024",SAC @ PHI,L,35,6,14,0.429,3,7,0.429,0,1,0.0,2,6,8,3,1,2,2,2,15,-6,1,SAC,PHI,SAC,90,14.0,Points,26,23,18,11
Keegan Murray,F,22023,1631099,22300532,"JAN 12, 2024",SAC @ PHI,L,35,6,14,0.429,3,7,0.429,0,1,0.0,2,6,8,3,1,2,2,2,15,-6,1,SAC,PHI,SAC,90,5.0,Rebounds,26,23,18,11
Keegan Murray,F,22023,1631099,22300532,"JAN 12, 2024",SAC @ PHI,L,35,6,14,0.429,3,7,0.429,0,1,0.0,2,6,8,3,1,2,2,2,15,-6,1,SAC,PHI,SAC,90,20.5,Pts+Rebs+Asts,26,23,18,11
Keegan Murray,F,22023,1631099,22300532,"JAN 12, 2024",SAC @ PHI,L,35,6,14,0.429,3,7,0.429,0,1,0.0,2,6,8,3,1,2,2,2,15,-6,1,SAC,PHI,SAC,90,26.5,Fantasy Score,26,23,18,11
Keegan Murray,F,22023,1631099,22300532,"JAN 12, 2024",SAC @ PHI,L,35,6,14,0.429,3,7,0.429,0,1,0.0,2,6,8,3,1,2,2,2,15,-6,1,SAC,PHI,SAC,90,18.5,Pts+Rebs,26,23,18,11
Keegan Murray,F,22023,1631099,22300532,"JAN 12, 2024",SAC @ PHI,L,35,6,14,0.429,3,7,0.429,0,1,0.0,2,6,8,3,1,2,2,2,15,-6,1,SAC,PHI,SAC,90,15.5,Pts+Asts,26,23,18,11
Keegan Murray,F,22023,1631099,22300518,"JAN 10, 2024",SAC @ CHA,W,32,11,18,0.611,3,7,0.429,0,0,0.0,0,6,6,3,0,1,0,2,25,5,1,SAC,CHA,SAC,121,14.0,Points,34,31,28,9
Keegan Murray,F,22023,1631099,22300518,"JAN 10, 2024",SAC @ CHA,W,32,11,18,0.611,3,7,0.429,0,0,0.0,0,6,6,3,0,1,0,2,25,5,1,SAC,CHA,SAC,121,5.0,Rebounds,34,31,28,9
Keegan Murray,F,22023,1631099,22300518,"JAN 10, 2024",SAC @ CHA,W,32,11,18,0.611,3,7,0.429,0,0,0.0,0,6,6,3,0,1,0,2,25,5,1,SAC,CHA,SAC,121,20.5,Pts+Rebs+Asts,34,31,28,9
Keegan Murray,F,22023,1631099,22300518,"JAN 10, 2024",SAC @ CHA,W,32,11,18,0.611,3,7,0.429,0,0,0.0,0,6,6,3,0,1,0,2,25,5,1,SAC,CHA,SAC,121,26.5,Fantasy Score,34,31,28,9
Keegan Murray,F,22023,1631099,22300518,"JAN 10, 2024",SAC @ CHA,W,32,11,18,0.611,3,7,0.429,0,0,0.0,0,6,6,3,0,1,0,2,25,5,1,SAC,CHA,SAC,121,18.5,Pts+Rebs,34,31,28,9
Keegan Murray,F,22023,1631099,22300518,"JAN 10, 2024",SAC @ CHA,W,32,11,18,0.611,3,7,0.429,0,0,0.0,0,6,6,3,0,1,0,2,25,5,1,SAC,CHA,SAC,121,15.5,Pts+Asts,34,31,28,9
Keegan Murray,F,22023,1631099,22300512,"JAN 09, 2024",SAC @ DET,W,35,13,17,0.765,5,9,0.556,1,1,1.0,0,5,5,2,1,2,1,2,32,32,1,SAC,DET,SAC,131,14.0,Points,39,37,34,7
Keegan Murray,F,22023,1631099,22300512,"JAN 09, 2024",SAC @ DET,W,35,13,17,0.765,5,9,0.556,1,1,1.0,0,5,5,2,1,2,1,2,32,32,1,SAC,DET,SAC,131,5.0,Rebounds,39,37,34,7
Keegan Murray,F,22023,1631099,22300512,"JAN 09, 2024",SAC @ DET,W,35,13,17,0.765,5,9,0.556,1,1,1.0,0,5,5,2,1,2,1,2,32,32,1,SAC,DET,SAC,131,20.5,Pts+Rebs+Asts,39,37,34,7
Keegan Murray,F,22023,1631099,22300512,"JAN 09, 2024",SAC @ DET,W,35,13,17,0.765,5,9,0.556,1,1,1.0,0,5,5,2,1,2,1,2,32,32,1,SAC,DET,SAC,131,26.5,Fantasy Score,39,37,34,7
Keegan Murray,F,22023,1631099,22300512,"JAN 09, 2024",SAC @ DET,W,35,13,17,0.765,5,9,0.556,1,1,1.0,0,5,5,2,1,2,1,2,32,32,1,SAC,DET,SAC,131,18.5,Pts+Rebs,39,37,34,7
Keegan Murray,F,22023,1631099,22300512,"JAN 09, 2024",SAC @ DET,W,35,13,17,0.765,5,9,0.556,1,1,1.0,0,5,5,2,1,2,1,2,32,32,1,SAC,DET,SAC,131,15.5,Pts+Asts,39,37,34,7
Keegan Murray,F,22023,1631099,22300500,"JAN 07, 2024",SAC vs. NOP,L,26,2,9,0.222,1,6,0.167,3,3,1.0,1,0,1,0,1,0,0,1,8,-31,1,SAC,SAC,NOP,100,14.0,Points,9,9,8,1
Keegan Murray,F,22023,1631099,22300500,"JAN 07, 2024",SAC vs. NOP,L,26,2,9,0.222,1,6,0.167,3,3,1.0,1,0,1,0,1,0,0,1,8,-31,1,SAC,SAC,NOP,100,5.0,Rebounds,9,9,8,1
Keegan Murray,F,22023,1631099,22300500,"JAN 07, 2024",SAC vs. NOP,L,26,2,9,0.222,1,6,0.167,3,3,1.0,1,0,1,0,1,0,0,1,8,-31,1,SAC,SAC,NOP,100,20.5,Pts+Rebs+Asts,9,9,8,1
Keegan Murray,F,22023,1631099,22300500,"JAN 07, 2024",SAC vs. NOP,L,26,2,9,0.222,1,6,0.167,3,3,1.0,1,0,1,0,1,0,0,1,8,-31,1,SAC,SAC,NOP,100,26.5,Fantasy Score,9,9,8,1
Keegan Murray,F,22023,1631099,22300500,"JAN 07, 2024",SAC vs. NOP,L,26,2,9,0.222,1,6,0.167,3,3,1.0,1,0,1,0,1,0,0,1,8,-31,1,SAC,SAC,NOP,100,18.5,Pts+Rebs,9,9,8,1
Keegan Murray,F,22023,1631099,22300500,"JAN 07, 2024",SAC vs. NOP,L,26,2,9,0.222,1,6,0.167,3,3,1.0,1,0,1,0,1,0,0,1,8,-31,1,SAC,SAC,NOP,100,15.5,Pts+Asts,9,9,8,1
Keegan Murray,F,22023,1631099,22300492,"JAN 05, 2024",SAC vs. TOR,W,35,6,11,0.545,4,4,1.0,2,4,0.5,3,9,12,1,1,0,3,1,18,-3,1,SAC,SAC,TOR,135,14.0,Points,31,30,19,13
Keegan Murray,F,22023,1631099,22300492,"JAN 05, 2024",SAC vs. TOR,W,35,6,11,0.545,4,4,1.0,2,4,0.5,3,9,12,1,1,0,3,1,18,-3,1,SAC,SAC,TOR,135,5.0,Rebounds,31,30,19,13
Keegan Murray,F,22023,1631099,22300492,"JAN 05, 2024",SAC vs. TOR,W,35,6,11,0.545,4,4,1.0,2,4,0.5,3,9,12,1,1,0,3,1,18,-3,1,SAC,SAC,TOR,135,20.5,Pts+Rebs+Asts,31,30,19,13
Keegan Murray,F,22023,1631099,22300492,"JAN 05, 2024",SAC vs. TOR,W,35,6,11,0.545,4,4,1.0,2,4,0.5,3,9,12,1,1,0,3,1,18,-3,1,SAC,SAC,TOR,135,26.5,Fantasy Score,31,30,19,13
Keegan Murray,F,22023,1631099,22300492,"JAN 05, 2024",SAC vs. TOR,W,35,6,11,0.545,4,4,1.0,2,4,0.5,3,9,12,1,1,0,3,1,18,-3,1,SAC,SAC,TOR,135,18.5,Pts+Rebs,31,30,19,13
Keegan Murray,F,22023,1631099,22300492,"JAN 05, 2024",SAC vs. TOR,W,35,6,11,0.545,4,4,1.0,2,4,0.5,3,9,12,1,1,0,3,1,18,-3,1,SAC,SAC,TOR,135,15.5,Pts+Asts,31,30,19,13
Keegan Murray,F,22023,1631099,22300476,"JAN 03, 2024",SAC vs. ORL,W,46,13,21,0.619,2,6,0.333,0,0,0.0,4,8,12,1,1,0,0,0,28,-7,1,SAC,SAC,ORL,138,14.0,Points,41,40,29,13
Keegan Murray,F,22023,1631099,22300476,"JAN 03, 2024",SAC vs. ORL,W,46,13,21,0.619,2,6,0.333,0,0,0.0,4,8,12,1,1,0,0,0,28,-7,1,SAC,SAC,ORL,138,5.0,Rebounds,41,40,29,13
Keegan Murray,F,22023,1631099,22300476,"JAN 03, 2024",SAC vs. ORL,W,46,13,21,0.619,2,6,0.333,0,0,0.0,4,8,12,1,1,0,0,0,28,-7,1,SAC,SAC,ORL,138,20.5,Pts+Rebs+Asts,41,40,29,13
Keegan Murray,F,22023,1631099,22300476,"JAN 03, 2024",SAC vs. ORL,W,46,13,21,0.619,2,6,0.333,0,0,0.0,4,8,12,1,1,0,0,0,28,-7,1,SAC,SAC,ORL,138,26.5,Fantasy Score,41,40,29,13
Keegan Murray,F,22023,1631099,22300476,"JAN 03, 2024",SAC vs. ORL,W,46,13,21,0.619,2,6,0.333,0,0,0.0,4,8,12,1,1,0,0,0,28,-7,1,SAC,SAC,ORL,138,18.5,Pts+Rebs,41,40,29,13
Keegan Murray,F,22023,1631099,22300476,"JAN 03, 2024",SAC vs. ORL,W,46,13,21,0.619,2,6,0.333,0,0,0.0,4,8,12,1,1,0,0,0,28,-7,1,SAC,SAC,ORL,138,15.5,Pts+Asts,41,40,29,13
Keegan Murray,F,22023,1631099,22300464,"JAN 02, 2024",SAC vs. CHA,L,37,4,12,0.333,1,6,0.167,1,2,0.5,1,2,3,2,3,0,1,5,10,-8,1,SAC,SAC,CHA,104,14.0,Points,15,13,12,5
Keegan Murray,F,22023,1631099,22300464,"JAN 02, 2024",SAC vs. CHA,L,37,4,12,0.333,1,6,0.167,1,2,0.5,1,2,3,2,3,0,1,5,10,-8,1,SAC,SAC,CHA,104,5.0,Rebounds,15,13,12,5
Keegan Murray,F,22023,1631099,22300464,"JAN 02, 2024",SAC vs. CHA,L,37,4,12,0.333,1,6,0.167,1,2,0.5,1,2,3,2,3,0,1,5,10,-8,1,SAC,SAC,CHA,104,20.5,Pts+Rebs+Asts,15,13,12,5
Keegan Murray,F,22023,1631099,22300464,"JAN 02, 2024",SAC vs. CHA,L,37,4,12,0.333,1,6,0.167,1,2,0.5,1,2,3,2,3,0,1,5,10,-8,1,SAC,SAC,CHA,104,26.5,Fantasy Score,15,13,12,5
Keegan Murray,F,22023,1631099,22300464,"JAN 02, 2024",SAC vs. CHA,L,37,4,12,0.333,1,6,0.167,1,2,0.5,1,2,3,2,3,0,1,5,10,-8,1,SAC,SAC,CHA,104,18.5,Pts+Rebs,15,13,12,5
Keegan Murray,F,22023,1631099,22300464,"JAN 02, 2024",SAC vs. CHA,L,37,4,12,0.333,1,6,0.167,1,2,0.5,1,2,3,2,3,0,1,5,10,-8,1,SAC,SAC,CHA,104,15.5,Pts+Asts,15,13,12,5
Keegan Murray,F,22023,1631099,22300449,"DEC 31, 2023",SAC @ MEM,W,26,4,9,0.444,2,4,0.5,0,0,0.0,1,2,3,1,0,0,1,1,10,13,1,SAC,MEM,SAC,123,14.0,Points,14,13,11,4
Keegan Murray,F,22023,1631099,22300449,"DEC 31, 2023",SAC @ MEM,W,26,4,9,0.444,2,4,0.5,0,0,0.0,1,2,3,1,0,0,1,1,10,13,1,SAC,MEM,SAC,123,5.0,Rebounds,14,13,11,4
Keegan Murray,F,22023,1631099,22300449,"DEC 31, 2023",SAC @ MEM,W,26,4,9,0.444,2,4,0.5,0,0,0.0,1,2,3,1,0,0,1,1,10,13,1,SAC,MEM,SAC,123,20.5,Pts+Rebs+Asts,14,13,11,4
Keegan Murray,F,22023,1631099,22300449,"DEC 31, 2023",SAC @ MEM,W,26,4,9,0.444,2,4,0.5,0,0,0.0,1,2,3,1,0,0,1,1,10,13,1,SAC,MEM,SAC,123,26.5,Fantasy Score,14,13,11,4
Keegan Murray,F,22023,1631099,22300449,"DEC 31, 2023",SAC @ MEM,W,26,4,9,0.444,2,4,0.5,0,0,0.0,1,2,3,1,0,0,1,1,10,13,1,SAC,MEM,SAC,123,18.5,Pts+Rebs,14,13,11,4
Keegan Murray,F,22023,1631099,22300449,"DEC 31, 2023",SAC @ MEM,W,26,4,9,0.444,2,4,0.5,0,0,0.0,1,2,3,1,0,0,1,1,10,13,1,SAC,MEM,SAC,123,15.5,Pts+Asts,14,13,11,4
Keegan Murray,F,22023,1631099,22300431,"DEC 29, 2023",SAC @ ATL,W,36,4,12,0.333,1,6,0.167,0,0,0.0,0,5,5,0,2,2,0,5,9,-3,1,SAC,ATL,SAC,117,14.0,Points,14,14,9,5
Keegan Murray,F,22023,1631099,22300431,"DEC 29, 2023",SAC @ ATL,W,36,4,12,0.333,1,6,0.167,0,0,0.0,0,5,5,0,2,2,0,5,9,-3,1,SAC,ATL,SAC,117,5.0,Rebounds,14,14,9,5
Keegan Murray,F,22023,1631099,22300431,"DEC 29, 2023",SAC @ ATL,W,36,4,12,0.333,1,6,0.167,0,0,0.0,0,5,5,0,2,2,0,5,9,-3,1,SAC,ATL,SAC,117,20.5,Pts+Rebs+Asts,14,14,9,5
Keegan Murray,F,22023,1631099,22300431,"DEC 29, 2023",SAC @ ATL,W,36,4,12,0.333,1,6,0.167,0,0,0.0,0,5,5,0,2,2,0,5,9,-3,1,SAC,ATL,SAC,117,26.5,Fantasy Score,14,14,9,5
Keegan Murray,F,22023,1631099,22300431,"DEC 29, 2023",SAC @ ATL,W,36,4,12,0.333,1,6,0.167,0,0,0.0,0,5,5,0,2,2,0,5,9,-3,1,SAC,ATL,SAC,117,18.5,Pts+Rebs,14,14,9,5
Keegan Murray,F,22023,1631099,22300431,"DEC 29, 2023",SAC @ ATL,W,36,4,12,0.333,1,6,0.167,0,0,0.0,0,5,5,0,2,2,0,5,9,-3,1,SAC,ATL,SAC,117,15.5,Pts+Asts,14,14,9,5
Keegan Murray,F,22023,1631099,22300413,"DEC 26, 2023",SAC @ POR,L,36,2,11,0.182,1,7,0.143,0,0,0.0,1,3,4,2,1,1,0,1,5,-10,1,SAC,POR,SAC,113,14.0,Points,11,9,7,6
Keegan Murray,F,22023,1631099,22300413,"DEC 26, 2023",SAC @ POR,L,36,2,11,0.182,1,7,0.143,0,0,0.0,1,3,4,2,1,1,0,1,5,-10,1,SAC,POR,SAC,113,5.0,Rebounds,11,9,7,6
Keegan Murray,F,22023,1631099,22300413,"DEC 26, 2023",SAC @ POR,L,36,2,11,0.182,1,7,0.143,0,0,0.0,1,3,4,2,1,1,0,1,5,-10,1,SAC,POR,SAC,113,20.5,Pts+Rebs+Asts,11,9,7,6
Keegan Murray,F,22023,1631099,22300413,"DEC 26, 2023",SAC @ POR,L,36,2,11,0.182,1,7,0.143,0,0,0.0,1,3,4,2,1,1,0,1,5,-10,1,SAC,POR,SAC,113,26.5,Fantasy Score,11,9,7,6
Keegan Murray,F,22023,1631099,22300413,"DEC 26, 2023",SAC @ POR,L,36,2,11,0.182,1,7,0.143,0,0,0.0,1,3,4,2,1,1,0,1,5,-10,1,SAC,POR,SAC,113,18.5,Pts+Rebs,11,9,7,6
Keegan Murray,F,22023,1631099,22300413,"DEC 26, 2023",SAC @ POR,L,36,2,11,0.182,1,7,0.143,0,0,0.0,1,3,4,2,1,1,0,1,5,-10,1,SAC,POR,SAC,113,15.5,Pts+Asts,11,9,7,6
Keegan Murray,F,22023,1631099,22300400,"DEC 23, 2023",SAC vs. MIN,L,40,8,16,0.5,3,7,0.429,1,2,0.5,1,6,7,0,3,1,1,4,20,-8,1,SAC,SAC,MIN,98,14.0,Points,27,27,20,7
Keegan Murray,F,22023,1631099,22300400,"DEC 23, 2023",SAC vs. MIN,L,40,8,16,0.5,3,7,0.429,1,2,0.5,1,6,7,0,3,1,1,4,20,-8,1,SAC,SAC,MIN,98,5.0,Rebounds,27,27,20,7
Keegan Murray,F,22023,1631099,22300400,"DEC 23, 2023",SAC vs. MIN,L,40,8,16,0.5,3,7,0.429,1,2,0.5,1,6,7,0,3,1,1,4,20,-8,1,SAC,SAC,MIN,98,20.5,Pts+Rebs+Asts,27,27,20,7
Keegan Murray,F,22023,1631099,22300400,"DEC 23, 2023",SAC vs. MIN,L,40,8,16,0.5,3,7,0.429,1,2,0.5,1,6,7,0,3,1,1,4,20,-8,1,SAC,SAC,MIN,98,26.5,Fantasy Score,27,27,20,7
Keegan Murray,F,22023,1631099,22300400,"DEC 23, 2023",SAC vs. MIN,L,40,8,16,0.5,3,7,0.429,1,2,0.5,1,6,7,0,3,1,1,4,20,-8,1,SAC,SAC,MIN,98,18.5,Pts+Rebs,27,27,20,7
Keegan Murray,F,22023,1631099,22300400,"DEC 23, 2023",SAC vs. MIN,L,40,8,16,0.5,3,7,0.429,1,2,0.5,1,6,7,0,3,1,1,4,20,-8,1,SAC,SAC,MIN,98,15.5,Pts+Asts,27,27,20,7
Keegan Murray,F,22023,1631099,22300387,"DEC 22, 2023",SAC vs. PHX,W,33,8,13,0.615,3,7,0.429,2,2,1.0,1,4,5,2,0,0,1,3,21,25,1,SAC,SAC,PHX,120,14.0,Points,28,26,23,7
Keegan Murray,F,22023,1631099,22300387,"DEC 22, 2023",SAC vs. PHX,W,33,8,13,0.615,3,7,0.429,2,2,1.0,1,4,5,2,0,0,1,3,21,25,1,SAC,SAC,PHX,120,5.0,Rebounds,28,26,23,7
Keegan Murray,F,22023,1631099,22300387,"DEC 22, 2023",SAC vs. PHX,W,33,8,13,0.615,3,7,0.429,2,2,1.0,1,4,5,2,0,0,1,3,21,25,1,SAC,SAC,PHX,120,20.5,Pts+Rebs+Asts,28,26,23,7
Keegan Murray,F,22023,1631099,22300387,"DEC 22, 2023",SAC vs. PHX,W,33,8,13,0.615,3,7,0.429,2,2,1.0,1,4,5,2,0,0,1,3,21,25,1,SAC,SAC,PHX,120,26.5,Fantasy Score,28,26,23,7
Keegan Murray,F,22023,1631099,22300387,"DEC 22, 2023",SAC vs. PHX,W,33,8,13,0.615,3,7,0.429,2,2,1.0,1,4,5,2,0,0,1,3,21,25,1,SAC,SAC,PHX,120,18.5,Pts+Rebs,28,26,23,7
Keegan Murray,F,22023,1631099,22300387,"DEC 22, 2023",SAC vs. PHX,W,33,8,13,0.615,3,7,0.429,2,2,1.0,1,4,5,2,0,0,1,3,21,25,1,SAC,SAC,PHX,120,15.5,Pts+Asts,28,26,23,7
Keegan Murray,F,22023,1631099,22300373,"DEC 20, 2023",SAC vs. BOS,L,26,5,11,0.455,3,7,0.429,0,0,0.0,1,0,1,0,0,0,1,4,13,-23,1,SAC,SAC,BOS,119,14.0,Points,14,14,13,1
Keegan Murray,F,22023,1631099,22300373,"DEC 20, 2023",SAC vs. BOS,L,26,5,11,0.455,3,7,0.429,0,0,0.0,1,0,1,0,0,0,1,4,13,-23,1,SAC,SAC,BOS,119,5.0,Rebounds,14,14,13,1
Keegan Murray,F,22023,1631099,22300373,"DEC 20, 2023",SAC vs. BOS,L,26,5,11,0.455,3,7,0.429,0,0,0.0,1,0,1,0,0,0,1,4,13,-23,1,SAC,SAC,BOS,119,20.5,Pts+Rebs+Asts,14,14,13,1
Keegan Murray,F,22023,1631099,22300373,"DEC 20, 2023",SAC vs. BOS,L,26,5,11,0.455,3,7,0.429,0,0,0.0,1,0,1,0,0,0,1,4,13,-23,1,SAC,SAC,BOS,119,26.5,Fantasy Score,14,14,13,1
Keegan Murray,F,22023,1631099,22300373,"DEC 20, 2023",SAC vs. BOS,L,26,5,11,0.455,3,7,0.429,0,0,0.0,1,0,1,0,0,0,1,4,13,-23,1,SAC,SAC,BOS,119,18.5,Pts+Rebs,14,14,13,1
Keegan Murray,F,22023,1631099,22300373,"DEC 20, 2023",SAC vs. BOS,L,26,5,11,0.455,3,7,0.429,0,0,0.0,1,0,1,0,0,0,1,4,13,-23,1,SAC,SAC,BOS,119,15.5,Pts+Asts,14,14,13,1
Keegan Murray,F,22023,1631099,22300358,"DEC 18, 2023",SAC vs. WAS,W,32,9,17,0.529,4,7,0.571,3,3,1.0,1,4,5,4,1,0,0,4,25,20,1,SAC,SAC,WAS,141,14.0,Points,34,30,29,9
Keegan Murray,F,22023,1631099,22300358,"DEC 18, 2023",SAC vs. WAS,W,32,9,17,0.529,4,7,0.571,3,3,1.0,1,4,5,4,1,0,0,4,25,20,1,SAC,SAC,WAS,141,5.0,Rebounds,34,30,29,9
Keegan Murray,F,22023,1631099,22300358,"DEC 18, 2023",SAC vs. WAS,W,32,9,17,0.529,4,7,0.571,3,3,1.0,1,4,5,4,1,0,0,4,25,20,1,SAC,SAC,WAS,141,20.5,Pts+Rebs+Asts,34,30,29,9
Keegan Murray,F,22023,1631099,22300358,"DEC 18, 2023",SAC vs. WAS,W,32,9,17,0.529,4,7,0.571,3,3,1.0,1,4,5,4,1,0,0,4,25,20,1,SAC,SAC,WAS,141,26.5,Fantasy Score,34,30,29,9
Keegan Murray,F,22023,1631099,22300358,"DEC 18, 2023",SAC vs. WAS,W,32,9,17,0.529,4,7,0.571,3,3,1.0,1,4,5,4,1,0,0,4,25,20,1,SAC,SAC,WAS,141,18.5,Pts+Rebs,34,30,29,9
Keegan Murray,F,22023,1631099,22300358,"DEC 18, 2023",SAC vs. WAS,W,32,9,17,0.529,4,7,0.571,3,3,1.0,1,4,5,4,1,0,0,4,25,20,1,SAC,SAC,WAS,141,15.5,Pts+Asts,34,30,29,9
Keegan Murray,F,22023,1631099,22300342,"DEC 16, 2023",SAC vs. UTA,W,36,16,23,0.696,12,15,0.8,3,4,0.75,1,7,8,2,2,0,0,1,47,33,1,SAC,SAC,UTA,125,14.0,Points,57,55,49,10
Keegan Murray,F,22023,1631099,22300342,"DEC 16, 2023",SAC vs. UTA,W,36,16,23,0.696,12,15,0.8,3,4,0.75,1,7,8,2,2,0,0,1,47,33,1,SAC,SAC,UTA,125,5.0,Rebounds,57,55,49,10
Keegan Murray,F,22023,1631099,22300342,"DEC 16, 2023",SAC vs. UTA,W,36,16,23,0.696,12,15,0.8,3,4,0.75,1,7,8,2,2,0,0,1,47,33,1,SAC,SAC,UTA,125,20.5,Pts+Rebs+Asts,57,55,49,10
Keegan Murray,F,22023,1631099,22300342,"DEC 16, 2023",SAC vs. UTA,W,36,16,23,0.696,12,15,0.8,3,4,0.75,1,7,8,2,2,0,0,1,47,33,1,SAC,SAC,UTA,125,26.5,Fantasy Score,57,55,49,10
Keegan Murray,F,22023,1631099,22300342,"DEC 16, 2023",SAC vs. UTA,W,36,16,23,0.696,12,15,0.8,3,4,0.75,1,7,8,2,2,0,0,1,47,33,1,SAC,SAC,UTA,125,18.5,Pts+Rebs,57,55,49,10
Keegan Murray,F,22023,1631099,22300342,"DEC 16, 2023",SAC vs. UTA,W,36,16,23,0.696,12,15,0.8,3,4,0.75,1,7,8,2,2,0,0,1,47,33,1,SAC,SAC,UTA,125,15.5,Pts+Asts,57,55,49,10
Keegan Murray,F,22023,1631099,22300324,"DEC 14, 2023",SAC vs. OKC,W,31,4,8,0.5,0,2,0.0,7,8,0.875,2,1,3,1,1,0,1,4,15,-12,1,SAC,SAC,OKC,128,14.0,Points,19,18,16,4
Keegan Murray,F,22023,1631099,22300324,"DEC 14, 2023",SAC vs. OKC,W,31,4,8,0.5,0,2,0.0,7,8,0.875,2,1,3,1,1,0,1,4,15,-12,1,SAC,SAC,OKC,128,5.0,Rebounds,19,18,16,4
Keegan Murray,F,22023,1631099,22300324,"DEC 14, 2023",SAC vs. OKC,W,31,4,8,0.5,0,2,0.0,7,8,0.875,2,1,3,1,1,0,1,4,15,-12,1,SAC,SAC,OKC,128,20.5,Pts+Rebs+Asts,19,18,16,4
Keegan Murray,F,22023,1631099,22300324,"DEC 14, 2023",SAC vs. OKC,W,31,4,8,0.5,0,2,0.0,7,8,0.875,2,1,3,1,1,0,1,4,15,-12,1,SAC,SAC,OKC,128,26.5,Fantasy Score,19,18,16,4
Keegan Murray,F,22023,1631099,22300324,"DEC 14, 2023",SAC vs. OKC,W,31,4,8,0.5,0,2,0.0,7,8,0.875,2,1,3,1,1,0,1,4,15,-12,1,SAC,SAC,OKC,128,18.5,Pts+Rebs,19,18,16,4
Keegan Murray,F,22023,1631099,22300324,"DEC 14, 2023",SAC vs. OKC,W,31,4,8,0.5,0,2,0.0,7,8,0.875,2,1,3,1,1,0,1,4,15,-12,1,SAC,SAC,OKC,128,15.5,Pts+Asts,19,18,16,4
Keegan Murray,F,22023,1631099,22300309,"DEC 12, 2023",SAC @ LAC,L,31,6,14,0.429,0,5,0.0,5,6,0.833,0,7,7,1,3,0,0,2,17,-21,1,SAC,LAC,SAC,99,14.0,Points,25,24,18,8
Keegan Murray,F,22023,1631099,22300309,"DEC 12, 2023",SAC @ LAC,L,31,6,14,0.429,0,5,0.0,5,6,0.833,0,7,7,1,3,0,0,2,17,-21,1,SAC,LAC,SAC,99,5.0,Rebounds,25,24,18,8
Keegan Murray,F,22023,1631099,22300309,"DEC 12, 2023",SAC @ LAC,L,31,6,14,0.429,0,5,0.0,5,6,0.833,0,7,7,1,3,0,0,2,17,-21,1,SAC,LAC,SAC,99,20.5,Pts+Rebs+Asts,25,24,18,8
Keegan Murray,F,22023,1631099,22300309,"DEC 12, 2023",SAC @ LAC,L,31,6,14,0.429,0,5,0.0,5,6,0.833,0,7,7,1,3,0,0,2,17,-21,1,SAC,LAC,SAC,99,26.5,Fantasy Score,25,24,18,8
Keegan Murray,F,22023,1631099,22300309,"DEC 12, 2023",SAC @ LAC,L,31,6,14,0.429,0,5,0.0,5,6,0.833,0,7,7,1,3,0,0,2,17,-21,1,SAC,LAC,SAC,99,18.5,Pts+Rebs,25,24,18,8
Keegan Murray,F,22023,1631099,22300309,"DEC 12, 2023",SAC @ LAC,L,31,6,14,0.429,0,5,0.0,5,6,0.833,0,7,7,1,3,0,0,2,17,-21,1,SAC,LAC,SAC,99,15.5,Pts+Asts,25,24,18,8
Keegan Murray,F,22023,1631099,22300303,"DEC 11, 2023",SAC vs. BKN,W,34,9,13,0.692,4,4,1.0,2,2,1.0,1,2,3,3,0,0,0,4,24,17,1,SAC,SAC,BKN,131,14.0,Points,30,27,27,6
Keegan Murray,F,22023,1631099,22300303,"DEC 11, 2023",SAC vs. BKN,W,34,9,13,0.692,4,4,1.0,2,2,1.0,1,2,3,3,0,0,0,4,24,17,1,SAC,SAC,BKN,131,5.0,Rebounds,30,27,27,6
Keegan Murray,F,22023,1631099,22300303,"DEC 11, 2023",SAC vs. BKN,W,34,9,13,0.692,4,4,1.0,2,2,1.0,1,2,3,3,0,0,0,4,24,17,1,SAC,SAC,BKN,131,20.5,Pts+Rebs+Asts,30,27,27,6
Keegan Murray,F,22023,1631099,22300303,"DEC 11, 2023",SAC vs. BKN,W,34,9,13,0.692,4,4,1.0,2,2,1.0,1,2,3,3,0,0,0,4,24,17,1,SAC,SAC,BKN,131,26.5,Fantasy Score,30,27,27,6
Keegan Murray,F,22023,1631099,22300303,"DEC 11, 2023",SAC vs. BKN,W,34,9,13,0.692,4,4,1.0,2,2,1.0,1,2,3,3,0,0,0,4,24,17,1,SAC,SAC,BKN,131,18.5,Pts+Rebs,30,27,27,6
Keegan Murray,F,22023,1631099,22300303,"DEC 11, 2023",SAC vs. BKN,W,34,9,13,0.692,4,4,1.0,2,2,1.0,1,2,3,3,0,0,0,4,24,17,1,SAC,SAC,BKN,131,15.5,Pts+Asts,30,27,27,6
Keegan Murray,F,22023,1631099,22301228,"DEC 08, 2023",SAC @ PHX,W,30,6,13,0.462,1,7,0.143,0,0,0.0,2,2,4,0,1,0,1,6,13,-1,1,SAC,PHX,SAC,114,14.0,Points,17,17,13,4
Keegan Murray,F,22023,1631099,22301228,"DEC 08, 2023",SAC @ PHX,W,30,6,13,0.462,1,7,0.143,0,0,0.0,2,2,4,0,1,0,1,6,13,-1,1,SAC,PHX,SAC,114,5.0,Rebounds,17,17,13,4
Keegan Murray,F,22023,1631099,22301228,"DEC 08, 2023",SAC @ PHX,W,30,6,13,0.462,1,7,0.143,0,0,0.0,2,2,4,0,1,0,1,6,13,-1,1,SAC,PHX,SAC,114,20.5,Pts+Rebs+Asts,17,17,13,4
Keegan Murray,F,22023,1631099,22301228,"DEC 08, 2023",SAC @ PHX,W,30,6,13,0.462,1,7,0.143,0,0,0.0,2,2,4,0,1,0,1,6,13,-1,1,SAC,PHX,SAC,114,26.5,Fantasy Score,17,17,13,4
Keegan Murray,F,22023,1631099,22301228,"DEC 08, 2023",SAC @ PHX,W,30,6,13,0.462,1,7,0.143,0,0,0.0,2,2,4,0,1,0,1,6,13,-1,1,SAC,PHX,SAC,114,18.5,Pts+Rebs,17,17,13,4
Keegan Murray,F,22023,1631099,22301228,"DEC 08, 2023",SAC @ PHX,W,30,6,13,0.462,1,7,0.143,0,0,0.0,2,2,4,0,1,0,1,6,13,-1,1,SAC,PHX,SAC,114,15.5,Pts+Asts,17,17,13,4
Keegan Murray,F,22023,1631099,22301204,"DEC 04, 2023",SAC vs. NOP,L,31,5,11,0.455,4,8,0.5,0,0,0.0,0,4,4,1,0,0,1,5,14,-8,1,SAC,SAC,NOP,117,14.0,Points,19,18,15,5
Keegan Murray,F,22023,1631099,22301204,"DEC 04, 2023",SAC vs. NOP,L,31,5,11,0.455,4,8,0.5,0,0,0.0,0,4,4,1,0,0,1,5,14,-8,1,SAC,SAC,NOP,117,5.0,Rebounds,19,18,15,5
Keegan Murray,F,22023,1631099,22301204,"DEC 04, 2023",SAC vs. NOP,L,31,5,11,0.455,4,8,0.5,0,0,0.0,0,4,4,1,0,0,1,5,14,-8,1,SAC,SAC,NOP,117,20.5,Pts+Rebs+Asts,19,18,15,5
Keegan Murray,F,22023,1631099,22301204,"DEC 04, 2023",SAC vs. NOP,L,31,5,11,0.455,4,8,0.5,0,0,0.0,0,4,4,1,0,0,1,5,14,-8,1,SAC,SAC,NOP,117,26.5,Fantasy Score,19,18,15,5
Keegan Murray,F,22023,1631099,22301204,"DEC 04, 2023",SAC vs. NOP,L,31,5,11,0.455,4,8,0.5,0,0,0.0,0,4,4,1,0,0,1,5,14,-8,1,SAC,SAC,NOP,117,18.5,Pts+Rebs,19,18,15,5
Keegan Murray,F,22023,1631099,22301204,"DEC 04, 2023",SAC vs. NOP,L,31,5,11,0.455,4,8,0.5,0,0,0.0,0,4,4,1,0,0,1,5,14,-8,1,SAC,SAC,NOP,117,15.5,Pts+Asts,19,18,15,5
Keegan Murray,F,22023,1631099,22300290,"DEC 02, 2023",SAC vs. DEN,W,23,3,10,0.3,2,5,0.4,0,0,0.0,0,5,5,1,0,0,2,0,8,-16,1,SAC,SAC,DEN,123,14.0,Points,14,13,9,6
Keegan Murray,F,22023,1631099,22300290,"DEC 02, 2023",SAC vs. DEN,W,23,3,10,0.3,2,5,0.4,0,0,0.0,0,5,5,1,0,0,2,0,8,-16,1,SAC,SAC,DEN,123,5.0,Rebounds,14,13,9,6
Keegan Murray,F,22023,1631099,22300290,"DEC 02, 2023",SAC vs. DEN,W,23,3,10,0.3,2,5,0.4,0,0,0.0,0,5,5,1,0,0,2,0,8,-16,1,SAC,SAC,DEN,123,20.5,Pts+Rebs+Asts,14,13,9,6
Keegan Murray,F,22023,1631099,22300290,"DEC 02, 2023",SAC vs. DEN,W,23,3,10,0.3,2,5,0.4,0,0,0.0,0,5,5,1,0,0,2,0,8,-16,1,SAC,SAC,DEN,123,26.5,Fantasy Score,14,13,9,6
Keegan Murray,F,22023,1631099,22300290,"DEC 02, 2023",SAC vs. DEN,W,23,3,10,0.3,2,5,0.4,0,0,0.0,0,5,5,1,0,0,2,0,8,-16,1,SAC,SAC,DEN,123,18.5,Pts+Rebs,14,13,9,6
Keegan Murray,F,22023,1631099,22300290,"DEC 02, 2023",SAC vs. DEN,W,23,3,10,0.3,2,5,0.4,0,0,0.0,0,5,5,1,0,0,2,0,8,-16,1,SAC,SAC,DEN,123,15.5,Pts+Asts,14,13,9,6
Keegan Murray,F,22023,1631099,22300222,"NOV 20, 2023",SAC @ NOP,L,16,1,4,0.25,1,2,0.5,2,2,1.0,2,1,3,0,1,1,0,2,5,-20,1,SAC,NOP,SAC,93,14.0,Points,8,8,5,3
Keegan Murray,F,22023,1631099,22300222,"NOV 20, 2023",SAC @ NOP,L,16,1,4,0.25,1,2,0.5,2,2,1.0,2,1,3,0,1,1,0,2,5,-20,1,SAC,NOP,SAC,93,5.0,Rebounds,8,8,5,3
Keegan Murray,F,22023,1631099,22300222,"NOV 20, 2023",SAC @ NOP,L,16,1,4,0.25,1,2,0.5,2,2,1.0,2,1,3,0,1,1,0,2,5,-20,1,SAC,NOP,SAC,93,20.5,Pts+Rebs+Asts,8,8,5,3
Keegan Murray,F,22023,1631099,22300222,"NOV 20, 2023",SAC @ NOP,L,16,1,4,0.25,1,2,0.5,2,2,1.0,2,1,3,0,1,1,0,2,5,-20,1,SAC,NOP,SAC,93,26.5,Fantasy Score,8,8,5,3
Keegan Murray,F,22023,1631099,22300222,"NOV 20, 2023",SAC @ NOP,L,16,1,4,0.25,1,2,0.5,2,2,1.0,2,1,3,0,1,1,0,2,5,-20,1,SAC,NOP,SAC,93,18.5,Pts+Rebs,8,8,5,3
Keegan Murray,F,22023,1631099,22300222,"NOV 20, 2023",SAC @ NOP,L,16,1,4,0.25,1,2,0.5,2,2,1.0,2,1,3,0,1,1,0,2,5,-20,1,SAC,NOP,SAC,93,15.5,Pts+Asts,8,8,5,3
Keegan Murray,F,22023,1631099,22300212,"NOV 19, 2023",SAC @ DAL,W,33,7,13,0.538,2,7,0.286,1,1,1.0,3,0,3,4,1,0,1,5,17,21,1,SAC,DAL,SAC,129,14.0,Points,24,20,21,7
Keegan Murray,F,22023,1631099,22300212,"NOV 19, 2023",SAC @ DAL,W,33,7,13,0.538,2,7,0.286,1,1,1.0,3,0,3,4,1,0,1,5,17,21,1,SAC,DAL,SAC,129,5.0,Rebounds,24,20,21,7
Keegan Murray,F,22023,1631099,22300212,"NOV 19, 2023",SAC @ DAL,W,33,7,13,0.538,2,7,0.286,1,1,1.0,3,0,3,4,1,0,1,5,17,21,1,SAC,DAL,SAC,129,20.5,Pts+Rebs+Asts,24,20,21,7
Keegan Murray,F,22023,1631099,22300212,"NOV 19, 2023",SAC @ DAL,W,33,7,13,0.538,2,7,0.286,1,1,1.0,3,0,3,4,1,0,1,5,17,21,1,SAC,DAL,SAC,129,26.5,Fantasy Score,24,20,21,7
Keegan Murray,F,22023,1631099,22300212,"NOV 19, 2023",SAC @ DAL,W,33,7,13,0.538,2,7,0.286,1,1,1.0,3,0,3,4,1,0,1,5,17,21,1,SAC,DAL,SAC,129,18.5,Pts+Rebs,24,20,21,7
Keegan Murray,F,22023,1631099,22300212,"NOV 19, 2023",SAC @ DAL,W,33,7,13,0.538,2,7,0.286,1,1,1.0,3,0,3,4,1,0,1,5,17,21,1,SAC,DAL,SAC,129,15.5,Pts+Asts,24,20,21,7
Keegan Murray,F,22023,1631099,22300032,"NOV 17, 2023",SAC @ SAS,W,38,3,10,0.3,0,4,0.0,0,0,0.0,1,5,6,3,1,0,2,2,6,19,1,SAC,SAS,SAC,129,14.0,Points,15,12,9,9
Keegan Murray,F,22023,1631099,22300032,"NOV 17, 2023",SAC @ SAS,W,38,3,10,0.3,0,4,0.0,0,0,0.0,1,5,6,3,1,0,2,2,6,19,1,SAC,SAS,SAC,129,5.0,Rebounds,15,12,9,9
Keegan Murray,F,22023,1631099,22300032,"NOV 17, 2023",SAC @ SAS,W,38,3,10,0.3,0,4,0.0,0,0,0.0,1,5,6,3,1,0,2,2,6,19,1,SAC,SAS,SAC,129,20.5,Pts+Rebs+Asts,15,12,9,9
Keegan Murray,F,22023,1631099,22300032,"NOV 17, 2023",SAC @ SAS,W,38,3,10,0.3,0,4,0.0,0,0,0.0,1,5,6,3,1,0,2,2,6,19,1,SAC,SAS,SAC,129,26.5,Fantasy Score,15,12,9,9
Keegan Murray,F,22023,1631099,22300032,"NOV 17, 2023",SAC @ SAS,W,38,3,10,0.3,0,4,0.0,0,0,0.0,1,5,6,3,1,0,2,2,6,19,1,SAC,SAS,SAC,129,18.5,Pts+Rebs,15,12,9,9
Keegan Murray,F,22023,1631099,22300032,"NOV 17, 2023",SAC @ SAS,W,38,3,10,0.3,0,4,0.0,0,0,0.0,1,5,6,3,1,0,2,2,6,19,1,SAC,SAS,SAC,129,15.5,Pts+Asts,15,12,9,9
Keegan Murray,F,22023,1631099,22300198,"NOV 15, 2023",SAC @ LAL,W,31,3,9,0.333,2,7,0.286,1,2,0.5,0,6,6,2,2,0,1,2,9,13,1,SAC,LAL,SAC,125,14.0,Points,17,15,11,8
Keegan Murray,F,22023,1631099,22300198,"NOV 15, 2023",SAC @ LAL,W,31,3,9,0.333,2,7,0.286,1,2,0.5,0,6,6,2,2,0,1,2,9,13,1,SAC,LAL,SAC,125,5.0,Rebounds,17,15,11,8
Keegan Murray,F,22023,1631099,22300198,"NOV 15, 2023",SAC @ LAL,W,31,3,9,0.333,2,7,0.286,1,2,0.5,0,6,6,2,2,0,1,2,9,13,1,SAC,LAL,SAC,125,20.5,Pts+Rebs+Asts,17,15,11,8
Keegan Murray,F,22023,1631099,22300198,"NOV 15, 2023",SAC @ LAL,W,31,3,9,0.333,2,7,0.286,1,2,0.5,0,6,6,2,2,0,1,2,9,13,1,SAC,LAL,SAC,125,26.5,Fantasy Score,17,15,11,8
Keegan Murray,F,22023,1631099,22300198,"NOV 15, 2023",SAC @ LAL,W,31,3,9,0.333,2,7,0.286,1,2,0.5,0,6,6,2,2,0,1,2,9,13,1,SAC,LAL,SAC,125,18.5,Pts+Rebs,17,15,11,8
Keegan Murray,F,22023,1631099,22300198,"NOV 15, 2023",SAC @ LAL,W,31,3,9,0.333,2,7,0.286,1,2,0.5,0,6,6,2,2,0,1,2,9,13,1,SAC,LAL,SAC,125,15.5,Pts+Asts,17,15,11,8
Keegan Murray,F,22023,1631099,22300191,"NOV 13, 2023",SAC vs. CLE,W,38,9,13,0.692,5,8,0.625,2,2,1.0,2,6,8,1,1,0,0,0,25,21,1,SAC,SAC,CLE,132,14.0,Points,34,33,26,9
Keegan Murray,F,22023,1631099,22300191,"NOV 13, 2023",SAC vs. CLE,W,38,9,13,0.692,5,8,0.625,2,2,1.0,2,6,8,1,1,0,0,0,25,21,1,SAC,SAC,CLE,132,5.0,Rebounds,34,33,26,9
Keegan Murray,F,22023,1631099,22300191,"NOV 13, 2023",SAC vs. CLE,W,38,9,13,0.692,5,8,0.625,2,2,1.0,2,6,8,1,1,0,0,0,25,21,1,SAC,SAC,CLE,132,20.5,Pts+Rebs+Asts,34,33,26,9
Keegan Murray,F,22023,1631099,22300191,"NOV 13, 2023",SAC vs. CLE,W,38,9,13,0.692,5,8,0.625,2,2,1.0,2,6,8,1,1,0,0,0,25,21,1,SAC,SAC,CLE,132,26.5,Fantasy Score,34,33,26,9
Keegan Murray,F,22023,1631099,22300191,"NOV 13, 2023",SAC vs. CLE,W,38,9,13,0.692,5,8,0.625,2,2,1.0,2,6,8,1,1,0,0,0,25,21,1,SAC,SAC,CLE,132,18.5,Pts+Rebs,34,33,26,9
Keegan Murray,F,22023,1631099,22300191,"NOV 13, 2023",SAC vs. CLE,W,38,9,13,0.692,5,8,0.625,2,2,1.0,2,6,8,1,1,0,0,0,25,21,1,SAC,SAC,CLE,132,15.5,Pts+Asts,34,33,26,9
Keegan Murray,F,22023,1631099,22300016,"NOV 10, 2023",SAC vs. OKC,W,40,8,17,0.471,3,10,0.3,5,5,1.0,4,7,11,1,3,1,3,1,24,-3,1,SAC,SAC,OKC,105,14.0,Points,36,35,25,12
Keegan Murray,F,22023,1631099,22300016,"NOV 10, 2023",SAC vs. OKC,W,40,8,17,0.471,3,10,0.3,5,5,1.0,4,7,11,1,3,1,3,1,24,-3,1,SAC,SAC,OKC,105,5.0,Rebounds,36,35,25,12
Keegan Murray,F,22023,1631099,22300016,"NOV 10, 2023",SAC vs. OKC,W,40,8,17,0.471,3,10,0.3,5,5,1.0,4,7,11,1,3,1,3,1,24,-3,1,SAC,SAC,OKC,105,20.5,Pts+Rebs+Asts,36,35,25,12
Keegan Murray,F,22023,1631099,22300016,"NOV 10, 2023",SAC vs. OKC,W,40,8,17,0.471,3,10,0.3,5,5,1.0,4,7,11,1,3,1,3,1,24,-3,1,SAC,SAC,OKC,105,26.5,Fantasy Score,36,35,25,12
Keegan Murray,F,22023,1631099,22300016,"NOV 10, 2023",SAC vs. OKC,W,40,8,17,0.471,3,10,0.3,5,5,1.0,4,7,11,1,3,1,3,1,24,-3,1,SAC,SAC,OKC,105,18.5,Pts+Rebs,36,35,25,12
Keegan Murray,F,22023,1631099,22300016,"NOV 10, 2023",SAC vs. OKC,W,40,8,17,0.471,3,10,0.3,5,5,1.0,4,7,11,1,3,1,3,1,24,-3,1,SAC,SAC,OKC,105,15.5,Pts+Asts,36,35,25,12
Keegan Murray,F,22023,1631099,22300170,"NOV 08, 2023",SAC vs. POR,W,31,4,17,0.235,1,6,0.167,0,0,0.0,2,5,7,3,1,2,1,3,9,8,1,SAC,SAC,POR,121,14.0,Points,19,16,12,10
Keegan Murray,F,22023,1631099,22300170,"NOV 08, 2023",SAC vs. POR,W,31,4,17,0.235,1,6,0.167,0,0,0.0,2,5,7,3,1,2,1,3,9,8,1,SAC,SAC,POR,121,5.0,Rebounds,19,16,12,10
Keegan Murray,F,22023,1631099,22300170,"NOV 08, 2023",SAC vs. POR,W,31,4,17,0.235,1,6,0.167,0,0,0.0,2,5,7,3,1,2,1,3,9,8,1,SAC,SAC,POR,121,20.5,Pts+Rebs+Asts,19,16,12,10
Keegan Murray,F,22023,1631099,22300170,"NOV 08, 2023",SAC vs. POR,W,31,4,17,0.235,1,6,0.167,0,0,0.0,2,5,7,3,1,2,1,3,9,8,1,SAC,SAC,POR,121,26.5,Fantasy Score,19,16,12,10
Keegan Murray,F,22023,1631099,22300170,"NOV 08, 2023",SAC vs. POR,W,31,4,17,0.235,1,6,0.167,0,0,0.0,2,5,7,3,1,2,1,3,9,8,1,SAC,SAC,POR,121,18.5,Pts+Rebs,19,16,12,10
Keegan Murray,F,22023,1631099,22300170,"NOV 08, 2023",SAC vs. POR,W,31,4,17,0.235,1,6,0.167,0,0,0.0,2,5,7,3,1,2,1,3,9,8,1,SAC,SAC,POR,121,15.5,Pts+Asts,19,16,12,10
Keegan Murray,F,22023,1631099,22300153,"NOV 06, 2023",SAC @ HOU,L,28,5,11,0.455,2,6,0.333,0,0,0.0,0,5,5,1,1,0,2,3,12,-18,1,SAC,HOU,SAC,97,14.0,Points,18,17,13,6
Keegan Murray,F,22023,1631099,22300153,"NOV 06, 2023",SAC @ HOU,L,28,5,11,0.455,2,6,0.333,0,0,0.0,0,5,5,1,1,0,2,3,12,-18,1,SAC,HOU,SAC,97,5.0,Rebounds,18,17,13,6
Keegan Murray,F,22023,1631099,22300153,"NOV 06, 2023",SAC @ HOU,L,28,5,11,0.455,2,6,0.333,0,0,0.0,0,5,5,1,1,0,2,3,12,-18,1,SAC,HOU,SAC,97,20.5,Pts+Rebs+Asts,18,17,13,6
Keegan Murray,F,22023,1631099,22300153,"NOV 06, 2023",SAC @ HOU,L,28,5,11,0.455,2,6,0.333,0,0,0.0,0,5,5,1,1,0,2,3,12,-18,1,SAC,HOU,SAC,97,26.5,Fantasy Score,18,17,13,6
Keegan Murray,F,22023,1631099,22300153,"NOV 06, 2023",SAC @ HOU,L,28,5,11,0.455,2,6,0.333,0,0,0.0,0,5,5,1,1,0,2,3,12,-18,1,SAC,HOU,SAC,97,18.5,Pts+Rebs,18,17,13,6
Keegan Murray,F,22023,1631099,22300153,"NOV 06, 2023",SAC @ HOU,L,28,5,11,0.455,2,6,0.333,0,0,0.0,0,5,5,1,1,0,2,3,12,-18,1,SAC,HOU,SAC,97,15.5,Pts+Asts,18,17,13,6
Keegan Murray,F,22023,1631099,22300137,"NOV 04, 2023",SAC @ HOU,L,33,3,12,0.25,1,8,0.125,0,0,0.0,0,2,2,1,0,0,0,1,7,-17,1,SAC,HOU,SAC,89,14.0,Points,10,9,8,3
Keegan Murray,F,22023,1631099,22300137,"NOV 04, 2023",SAC @ HOU,L,33,3,12,0.25,1,8,0.125,0,0,0.0,0,2,2,1,0,0,0,1,7,-17,1,SAC,HOU,SAC,89,5.0,Rebounds,10,9,8,3
Keegan Murray,F,22023,1631099,22300137,"NOV 04, 2023",SAC @ HOU,L,33,3,12,0.25,1,8,0.125,0,0,0.0,0,2,2,1,0,0,0,1,7,-17,1,SAC,HOU,SAC,89,20.5,Pts+Rebs+Asts,10,9,8,3
Keegan Murray,F,22023,1631099,22300137,"NOV 04, 2023",SAC @ HOU,L,33,3,12,0.25,1,8,0.125,0,0,0.0,0,2,2,1,0,0,0,1,7,-17,1,SAC,HOU,SAC,89,26.5,Fantasy Score,10,9,8,3
Keegan Murray,F,22023,1631099,22300137,"NOV 04, 2023",SAC @ HOU,L,33,3,12,0.25,1,8,0.125,0,0,0.0,0,2,2,1,0,0,0,1,7,-17,1,SAC,HOU,SAC,89,18.5,Pts+Rebs,10,9,8,3
Keegan Murray,F,22023,1631099,22300137,"NOV 04, 2023",SAC @ HOU,L,33,3,12,0.25,1,8,0.125,0,0,0.0,0,2,2,1,0,0,0,1,7,-17,1,SAC,HOU,SAC,89,15.5,Pts+Asts,10,9,8,3
Keegan Murray,F,22023,1631099,22300126,"NOV 01, 2023",SAC @ GSW,L,39,4,15,0.267,0,7,0.0,2,2,1.0,2,4,6,3,2,0,0,2,10,3,1,SAC,GSW,SAC,101,14.0,Points,19,16,13,9
Keegan Murray,F,22023,1631099,22300126,"NOV 01, 2023",SAC @ GSW,L,39,4,15,0.267,0,7,0.0,2,2,1.0,2,4,6,3,2,0,0,2,10,3,1,SAC,GSW,SAC,101,5.0,Rebounds,19,16,13,9
Keegan Murray,F,22023,1631099,22300126,"NOV 01, 2023",SAC @ GSW,L,39,4,15,0.267,0,7,0.0,2,2,1.0,2,4,6,3,2,0,0,2,10,3,1,SAC,GSW,SAC,101,20.5,Pts+Rebs+Asts,19,16,13,9
Keegan Murray,F,22023,1631099,22300126,"NOV 01, 2023",SAC @ GSW,L,39,4,15,0.267,0,7,0.0,2,2,1.0,2,4,6,3,2,0,0,2,10,3,1,SAC,GSW,SAC,101,26.5,Fantasy Score,19,16,13,9
Keegan Murray,F,22023,1631099,22300126,"NOV 01, 2023",SAC @ GSW,L,39,4,15,0.267,0,7,0.0,2,2,1.0,2,4,6,3,2,0,0,2,10,3,1,SAC,GSW,SAC,101,18.5,Pts+Rebs,19,16,13,9
Keegan Murray,F,22023,1631099,22300126,"NOV 01, 2023",SAC @ GSW,L,39,4,15,0.267,0,7,0.0,2,2,1.0,2,4,6,3,2,0,0,2,10,3,1,SAC,GSW,SAC,101,15.5,Pts+Asts,19,16,13,9
Keegan Murray,F,22023,1631099,22300100,"OCT 29, 2023",SAC vs. LAL,W,33,6,14,0.429,3,9,0.333,2,3,0.667,3,5,8,5,2,1,1,4,17,13,1,SAC,SAC,LAL,132,14.0,Points,30,25,22,13
Keegan Murray,F,22023,1631099,22300100,"OCT 29, 2023",SAC vs. LAL,W,33,6,14,0.429,3,9,0.333,2,3,0.667,3,5,8,5,2,1,1,4,17,13,1,SAC,SAC,LAL,132,5.0,Rebounds,30,25,22,13
Keegan Murray,F,22023,1631099,22300100,"OCT 29, 2023",SAC vs. LAL,W,33,6,14,0.429,3,9,0.333,2,3,0.667,3,5,8,5,2,1,1,4,17,13,1,SAC,SAC,LAL,132,20.5,Pts+Rebs+Asts,30,25,22,13
Keegan Murray,F,22023,1631099,22300100,"OCT 29, 2023",SAC vs. LAL,W,33,6,14,0.429,3,9,0.333,2,3,0.667,3,5,8,5,2,1,1,4,17,13,1,SAC,SAC,LAL,132,26.5,Fantasy Score,30,25,22,13
Keegan Murray,F,22023,1631099,22300100,"OCT 29, 2023",SAC vs. LAL,W,33,6,14,0.429,3,9,0.333,2,3,0.667,3,5,8,5,2,1,1,4,17,13,1,SAC,SAC,LAL,132,18.5,Pts+Rebs,30,25,22,13
Keegan Murray,F,22023,1631099,22300100,"OCT 29, 2023",SAC vs. LAL,W,33,6,14,0.429,3,9,0.333,2,3,0.667,3,5,8,5,2,1,1,4,17,13,1,SAC,SAC,LAL,132,15.5,Pts+Asts,30,25,22,13
Keegan Murray,F,22023,1631099,22300087,"OCT 27, 2023",SAC vs. GSW,L,40,6,16,0.375,3,11,0.273,1,2,0.5,3,4,7,1,2,1,4,2,16,-11,1,SAC,SAC,GSW,114,14.0,Points,24,23,17,8
Keegan Murray,F,22023,1631099,22300087,"OCT 27, 2023",SAC vs. GSW,L,40,6,16,0.375,3,11,0.273,1,2,0.5,3,4,7,1,2,1,4,2,16,-11,1,SAC,SAC,GSW,114,5.0,Rebounds,24,23,17,8
Keegan Murray,F,22023,1631099,22300087,"OCT 27, 2023",SAC vs. GSW,L,40,6,16,0.375,3,11,0.273,1,2,0.5,3,4,7,1,2,1,4,2,16,-11,1,SAC,SAC,GSW,114,20.5,Pts+Rebs+Asts,24,23,17,8
Keegan Murray,F,22023,1631099,22300087,"OCT 27, 2023",SAC vs. GSW,L,40,6,16,0.375,3,11,0.273,1,2,0.5,3,4,7,1,2,1,4,2,16,-11,1,SAC,SAC,GSW,114,26.5,Fantasy Score,24,23,17,8
Keegan Murray,F,22023,1631099,22300087,"OCT 27, 2023",SAC vs. GSW,L,40,6,16,0.375,3,11,0.273,1,2,0.5,3,4,7,1,2,1,4,2,16,-11,1,SAC,SAC,GSW,114,18.5,Pts+Rebs,24,23,17,8
Keegan Murray,F,22023,1631099,22300087,"OCT 27, 2023",SAC vs. GSW,L,40,6,16,0.375,3,11,0.273,1,2,0.5,3,4,7,1,2,1,4,2,16,-11,1,SAC,SAC,GSW,114,15.5,Pts+Asts,24,23,17,8
Keegan Murray,F,22023,1631099,22300072,"OCT 25, 2023",SAC @ UTA,W,30,5,13,0.385,4,9,0.444,1,1,1.0,2,6,8,1,1,2,0,4,15,12,1,SAC,UTA,SAC,130,14.0,Points,24,23,16,9
Keegan Murray,F,22023,1631099,22300072,"OCT 25, 2023",SAC @ UTA,W,30,5,13,0.385,4,9,0.444,1,1,1.0,2,6,8,1,1,2,0,4,15,12,1,SAC,UTA,SAC,130,5.0,Rebounds,24,23,16,9
Keegan Murray,F,22023,1631099,22300072,"OCT 25, 2023",SAC @ UTA,W,30,5,13,0.385,4,9,0.444,1,1,1.0,2,6,8,1,1,2,0,4,15,12,1,SAC,UTA,SAC,130,20.5,Pts+Rebs+Asts,24,23,16,9
Keegan Murray,F,22023,1631099,22300072,"OCT 25, 2023",SAC @ UTA,W,30,5,13,0.385,4,9,0.444,1,1,1.0,2,6,8,1,1,2,0,4,15,12,1,SAC,UTA,SAC,130,26.5,Fantasy Score,24,23,16,9
Keegan Murray,F,22023,1631099,22300072,"OCT 25, 2023",SAC @ UTA,W,30,5,13,0.385,4,9,0.444,1,1,1.0,2,6,8,1,1,2,0,4,15,12,1,SAC,UTA,SAC,130,18.5,Pts+Rebs,24,23,16,9
Keegan Murray,F,22023,1631099,22300072,"OCT 25, 2023",SAC @ UTA,W,30,5,13,0.385,4,9,0.444,1,1,1.0,2,6,8,1,1,2,0,4,15,12,1,SAC,UTA,SAC,130,15.5,Pts+Asts,24,23,16,9
Michael Porter Jr.,F,22023,1629008,22300740,"FEB 08, 2024",DEN @ LAL,W,38,11,20,0.55,4,7,0.571,1,1,1.0,1,7,8,2,0,1,1,1,27,6,1,DEN,LAL,DEN,114,,,37,35,29,10
Michael Porter Jr.,F,22023,1629008,22300712,"FEB 04, 2024",DEN vs. POR,W,24,4,10,0.4,2,6,0.333,2,2,1.0,3,2,5,3,0,3,3,1,12,-2,1,DEN,DEN,POR,112,,,20,17,15,8
Michael Porter Jr.,F,22023,1629008,22300697,"FEB 02, 2024",DEN vs. POR,W,35,5,14,0.357,3,10,0.3,0,0,0.0,0,4,4,1,0,0,1,0,13,8,1,DEN,DEN,POR,120,,,18,17,14,5
Michael Porter Jr.,F,22023,1629008,22300682,"JAN 31, 2024",DEN @ OKC,L,39,6,17,0.353,3,9,0.333,0,0,0.0,1,7,8,2,1,0,0,4,15,-16,1,DEN,OKC,DEN,100,,,25,23,17,10
Michael Porter Jr.,F,22023,1629008,22300667,"JAN 29, 2024",DEN vs. MIL,W,37,6,14,0.429,1,3,0.333,0,0,0.0,2,6,8,0,0,0,1,2,13,-1,1,DEN,DEN,MIL,113,,,21,21,13,8
Michael Porter Jr.,F,22023,1629008,22300644,"JAN 27, 2024",DEN vs. PHI,W,35,8,19,0.421,4,12,0.333,0,0,0.0,3,5,8,2,0,0,1,2,20,18,1,DEN,DEN,PHI,111,,,30,28,22,10
Michael Porter Jr.,F,22023,1629008,22300631,"JAN 25, 2024",DEN @ NYK,L,22,2,4,0.5,0,0,0.0,1,1,1.0,3,3,6,0,0,0,2,2,5,-29,1,DEN,NYK,DEN,84,,,11,11,5,6
Michael Porter Jr.,F,22023,1629008,22300614,"JAN 23, 2024",DEN @ IND,W,31,2,9,0.222,1,5,0.2,0,0,0.0,0,4,4,1,0,1,0,1,5,7,1,DEN,IND,DEN,114,,,10,9,6,5
Michael Porter Jr.,F,22023,1629008,22300602,"JAN 21, 2024",DEN @ WAS,W,32,8,14,0.571,3,7,0.429,0,0,0.0,0,5,5,0,2,2,3,2,19,13,1,DEN,WAS,DEN,113,,,24,24,19,5
Michael Porter Jr.,F,22023,1629008,22300586,"JAN 19, 2024",DEN @ BOS,W,37,5,9,0.556,1,4,0.25,2,3,0.667,4,4,8,0,0,0,1,3,13,6,1,DEN,BOS,DEN,102,,,21,21,13,8
Michael Porter Jr.,F,22023,1629008,22300566,"JAN 16, 2024",DEN @ PHI,L,34,6,12,0.5,4,8,0.5,4,5,0.8,0,5,5,0,1,0,1,3,20,-12,1,DEN,PHI,DEN,121,,,25,25,20,5
Michael Porter Jr.,F,22023,1629008,22300550,"JAN 14, 2024",DEN vs. IND,W,37,9,15,0.6,7,11,0.636,0,0,0.0,0,8,8,5,1,2,1,1,25,13,1,DEN,DEN,IND,117,,,38,33,30,13
Michael Porter Jr.,F,22023,1629008,22300539,"JAN 12, 2024",DEN vs. NOP,W,33,8,12,0.667,2,5,0.4,2,3,0.667,1,9,10,1,1,1,1,2,20,14,1,DEN,DEN,NOP,125,,,31,30,21,11
Michael Porter Jr.,F,22023,1629008,22300524,"JAN 10, 2024",DEN @ UTA,L,24,2,9,0.222,1,3,0.333,0,0,0.0,1,3,4,1,0,0,1,2,5,-18,1,DEN,UTA,DEN,111,,,10,9,6,5
Michael Porter Jr.,F,22023,1629008,22300502,"JAN 07, 2024",DEN vs. DET,W,28,7,12,0.583,1,5,0.2,3,3,1.0,0,1,1,2,0,0,1,1,18,29,1,DEN,DEN,DET,131,,,21,19,20,3
Michael Porter Jr.,F,22023,1629008,22300488,"JAN 05, 2024",DEN vs. ORL,L,31,9,14,0.643,4,6,0.667,0,0,0.0,0,3,3,1,2,0,0,2,22,6,1,DEN,DEN,ORL,120,,,26,25,23,4
Michael Porter Jr.,F,22023,1629008,22300478,"JAN 04, 2024",DEN @ GSW,W,30,3,6,0.5,2,5,0.4,0,0,0.0,0,4,4,0,0,0,0,3,8,5,1,DEN,GSW,DEN,130,,,12,12,8,4
Michael Porter Jr.,F,22023,1629008,22300455,"JAN 01, 2024",DEN vs. CHA,W,31,8,17,0.471,4,11,0.364,2,2,1.0,1,7,8,1,0,0,1,1,22,33,1,DEN,DEN,CHA,111,,,31,30,23,9
Michael Porter Jr.,F,22023,1629008,22300435,"DEC 29, 2023",DEN vs. OKC,L,31,4,12,0.333,2,8,0.25,2,2,1.0,0,6,6,1,0,1,0,1,12,-10,1,DEN,DEN,OKC,93,,,19,18,13,7
Michael Porter Jr.,F,22023,1629008,22300425,"DEC 28, 2023",DEN vs. MEM,W,23,3,6,0.5,2,3,0.667,0,0,0.0,0,4,4,0,0,1,2,3,8,28,1,DEN,DEN,MEM,142,,,12,12,8,4
Michael Porter Jr.,F,22023,1629008,22300402,"DEC 25, 2023",DEN vs. GSW,W,40,8,17,0.471,3,10,0.3,0,0,0.0,0,10,10,1,0,4,0,1,19,23,1,DEN,DEN,GSW,120,,,30,29,20,11
Michael Porter Jr.,F,22023,1629008,22300390,"DEC 23, 2023",DEN @ CHA,W,31,8,14,0.571,5,8,0.625,1,2,0.5,1,4,5,1,1,2,1,2,22,15,1,DEN,CHA,DEN,102,,,28,27,23,6
Michael Porter Jr.,F,22023,1629008,22300383,"DEC 22, 2023",DEN @ BKN,W,34,6,10,0.6,3,5,0.6,0,0,0.0,0,4,4,3,0,1,1,1,15,13,1,DEN,BKN,DEN,122,,,22,19,18,7
Michael Porter Jr.,F,22023,1629008,22300369,"DEC 20, 2023",DEN @ TOR,W,33,5,13,0.385,2,7,0.286,0,0,0.0,1,5,6,2,1,0,0,1,12,10,1,DEN,TOR,DEN,113,,,20,18,14,8
Michael Porter Jr.,F,22023,1629008,22300356,"DEC 18, 2023",DEN vs. DAL,W,23,3,8,0.375,2,3,0.667,0,0,0.0,2,2,4,1,0,0,2,1,8,13,1,DEN,DEN,DAL,130,,,13,12,9,5
Michael Porter Jr.,F,22023,1629008,22300340,"DEC 16, 2023",DEN vs. OKC,L,32,8,18,0.444,4,8,0.5,0,0,0.0,0,11,11,0,0,0,1,0,20,1,1,DEN,DEN,OKC,117,,,31,31,20,11
Michael Porter Jr.,F,22023,1629008,22300322,"DEC 14, 2023",DEN vs. BKN,W,23,3,8,0.375,1,4,0.25,2,2,1.0,2,4,6,1,1,0,0,0,9,11,1,DEN,DEN,BKN,124,,,16,15,10,7
Michael Porter Jr.,F,22023,1629008,22300307,"DEC 12, 2023",DEN @ CHI,W,32,6,16,0.375,2,8,0.25,3,4,0.75,0,7,7,0,1,0,0,1,17,3,1,DEN,CHI,DEN,114,,,24,24,17,7
Michael Porter Jr.,F,22023,1629008,22300296,"DEC 11, 2023",DEN @ ATL,W,26,1,11,0.091,0,4,0.0,1,2,0.5,2,5,7,3,0,0,1,3,3,12,1,DEN,ATL,DEN,129,,,13,10,6,10
Michael Porter Jr.,F,22023,1629008,22301224,"DEC 08, 2023",DEN vs. HOU,L,40,8,12,0.667,3,6,0.5,1,1,1.0,1,7,8,0,0,2,2,3,20,11,1,DEN,DEN,HOU,106,,,28,28,20,8
Michael Porter Jr.,F,22023,1629008,22301215,"DEC 06, 2023",DEN @ LAC,L,34,7,8,0.875,4,5,0.8,0,0,0.0,3,6,9,0,0,1,2,2,18,4,1,DEN,LAC,DEN,102,,,27,27,18,9
Michael Porter Jr.,F,22023,1629008,22300290,"DEC 02, 2023",DEN @ SAC,L,33,6,12,0.5,1,5,0.2,0,0,0.0,0,8,8,2,0,2,1,1,13,-6,1,DEN,SAC,DEN,117,,,23,21,15,10
Michael Porter Jr.,F,22023,1629008,22300279,"DEC 01, 2023",DEN @ PHX,W,37,8,16,0.5,0,4,0.0,3,3,1.0,1,9,10,4,2,1,2,1,19,8,1,DEN,PHX,DEN,119,,,33,29,23,14
Michael Porter Jr.,F,22023,1629008,22300263,"NOV 29, 2023",DEN vs. HOU,W,34,11,17,0.647,7,12,0.583,1,3,0.333,2,8,10,5,1,0,0,2,30,26,1,DEN,DEN,HOU,134,,,45,40,35,15
Michael Porter Jr.,F,22023,1629008,22300257,"NOV 27, 2023",DEN @ LAC,W,29,3,13,0.231,2,7,0.286,0,0,0.0,3,7,10,3,0,0,1,5,8,4,1,DEN,LAC,DEN,113,,,21,18,11,13
Michael Porter Jr.,F,22023,1629008,22300252,"NOV 26, 2023",DEN vs. SAS,W,33,8,14,0.571,4,9,0.444,5,6,0.833,1,6,7,2,0,1,3,0,25,15,1,DEN,DEN,SAS,132,,,34,32,27,9
Michael Porter Jr.,F,22023,1629008,22300048,"NOV 24, 2023",DEN @ HOU,L,37,6,14,0.429,2,8,0.25,0,0,0.0,1,6,7,1,1,2,1,1,14,-8,1,DEN,HOU,DEN,86,,,22,21,15,8
Michael Porter Jr.,F,22023,1629008,22300226,"NOV 22, 2023",DEN @ ORL,L,31,9,16,0.563,5,9,0.556,2,2,1.0,0,2,2,0,1,0,0,4,25,5,1,DEN,ORL,DEN,119,,,27,27,25,2
Michael Porter Jr.,F,22023,1629008,22300218,"NOV 20, 2023",DEN @ DET,W,38,5,15,0.333,4,9,0.444,0,1,0.0,2,9,11,2,0,1,4,3,14,-1,1,DEN,DET,DEN,107,,,27,25,16,13
Michael Porter Jr.,F,22023,1629008,22300210,"NOV 19, 2023",DEN @ CLE,L,27,7,15,0.467,5,9,0.556,2,2,1.0,1,5,6,0,1,0,2,2,21,-31,1,DEN,CLE,DEN,109,,,27,27,21,6
Michael Porter Jr.,F,22023,1629008,22300034,"NOV 17, 2023",DEN @ NOP,L,33,8,14,0.571,2,6,0.333,0,1,0.0,3,8,11,0,0,0,0,3,18,-15,1,DEN,NOP,DEN,110,,,29,29,18,11
Michael Porter Jr.,F,22023,1629008,22300024,"NOV 14, 2023",DEN vs. LAC,W,34,4,11,0.364,2,8,0.25,0,2,0.0,1,4,5,0,1,1,2,3,10,4,1,DEN,DEN,LAC,111,,,15,15,10,5
Michael Porter Jr.,F,22023,1629008,22300182,"NOV 12, 2023",DEN @ HOU,L,38,11,19,0.579,3,10,0.3,0,0,0.0,2,8,10,0,0,1,2,3,25,2,1,DEN,HOU,DEN,104,,,35,35,25,10
Michael Porter Jr.,F,22023,1629008,22300169,"NOV 08, 2023",DEN vs. GSW,W,37,7,17,0.412,3,8,0.375,0,0,0.0,2,6,8,2,0,2,0,1,17,13,1,DEN,DEN,GSW,108,,,27,25,19,10
Michael Porter Jr.,F,22023,1629008,22300156,"NOV 06, 2023",DEN vs. NOP,W,29,8,16,0.5,2,6,0.333,4,4,1.0,2,7,9,3,0,0,1,2,22,13,1,DEN,DEN,NOP,134,,,34,31,25,12
Michael Porter Jr.,F,22023,1629008,22300139,"NOV 04, 2023",DEN vs. CHI,W,31,9,16,0.563,5,10,0.5,4,5,0.8,1,5,6,2,1,2,2,4,27,30,1,DEN,DEN,CHI,123,,,35,33,29,8
Michael Porter Jr.,F,22023,1629008,22300006,"NOV 03, 2023",DEN vs. DAL,W,34,10,18,0.556,4,8,0.5,0,0,0.0,5,4,9,1,0,2,1,2,24,17,1,DEN,DEN,DAL,125,,,34,33,25,10
Michael Porter Jr.,F,22023,1629008,22300123,"NOV 01, 2023",DEN @ MIN,L,25,2,11,0.182,0,5,0.0,1,1,1.0,2,3,5,1,1,1,0,0,5,-19,1,DEN,MIN,DEN,89,,,11,10,6,6
Michael Porter Jr.,F,22023,1629008,22300110,"OCT 30, 2023",DEN vs. UTA,W,19,3,8,0.375,2,6,0.333,0,0,0.0,0,1,1,2,0,1,1,3,8,2,1,DEN,DEN,UTA,110,,,11,9,10,3
Michael Porter Jr.,F,22023,1629008,22300095,"OCT 29, 2023",DEN @ OKC,W,25,8,14,0.571,4,7,0.571,0,0,0.0,3,6,9,2,0,0,1,3,20,12,1,DEN,OKC,DEN,128,,,31,29,22,11
Michael Porter Jr.,F,22023,1629008,22300078,"OCT 27, 2023",DEN @ MEM,W,29,3,7,0.429,2,5,0.4,1,1,1.0,1,12,13,3,0,0,1,4,9,4,1,DEN,MEM,DEN,108,,,25,22,12,16
Michael Porter Jr.,F,22023,1629008,22300061,"OCT 24, 2023",DEN vs. LAL,W,30,5,13,0.385,2,9,0.222,0,0,0.0,2,10,12,2,2,0,0,1,12,12,1,DEN,DEN,LAL,119,,,26,24,14,14
Shaedon Sharpe,G,22023,1631101,22300363,"DEC 19, 2023",POR vs. PHX,W,8,0,1,0.0,0,0,0.0,0,0,0.0,0,1,1,0,0,0,0,2,0,1,1,POR,POR,PHX,109,,,1,1,0,1
Shaedon Sharpe,G,22023,1631101,22300348,"DEC 17, 2023",POR vs. GSW,L,27,4,10,0.4,3,5,0.6,1,1,1.0,1,4,5,1,1,0,2,3,12,0,1,POR,POR,GSW,114,,,18,17,13,6
Shaedon Sharpe,G,22023,1631101,22300341,"DEC 16, 2023",POR vs. DAL,L,32,2,7,0.286,1,3,0.333,2,3,0.667,0,2,2,2,0,0,2,4,7,0,1,POR,POR,DAL,120,,,11,9,9,4
Shaedon Sharpe,G,22023,1631101,22300323,"DEC 14, 2023",POR vs. UTA,L,27,1,12,0.083,0,5,0.0,2,2,1.0,2,5,7,2,0,1,0,3,4,-23,1,POR,POR,UTA,114,,,13,11,6,9
Shaedon Sharpe,G,22023,1631101,22300289,"DEC 02, 2023",POR @ UTA,L,44,9,20,0.45,3,8,0.375,4,4,1.0,2,3,5,4,2,0,0,5,25,-5,1,POR,UTA,POR,113,,,34,30,29,9
Shaedon Sharpe,G,22023,1631101,22300265,"NOV 30, 2023",POR @ CLE,W,39,11,15,0.733,4,7,0.571,3,3,1.0,0,10,10,5,1,0,5,3,29,10,1,POR,CLE,POR,103,,,44,39,34,15
Shaedon Sharpe,G,22023,1631101,22300254,"NOV 27, 2023",POR @ IND,W,35,4,15,0.267,1,3,0.333,2,2,1.0,1,4,5,6,3,0,2,5,11,3,1,POR,IND,POR,114,,,22,16,17,11
Shaedon Sharpe,G,22023,1631101,22300245,"NOV 26, 2023",POR @ MIL,L,37,7,19,0.368,1,5,0.2,2,3,0.667,1,5,6,3,2,0,3,0,17,-19,1,POR,MIL,POR,102,,,26,23,20,9
Shaedon Sharpe,G,22023,1631101,22300041,"NOV 21, 2023",POR @ PHX,L,32,3,13,0.231,0,5,0.0,4,4,1.0,1,2,3,0,1,0,4,3,10,-20,1,POR,PHX,POR,107,,,13,13,10,3
Shaedon Sharpe,G,22023,1631101,22300215,"NOV 19, 2023",POR vs. OKC,L,24,3,8,0.375,1,1,1.0,0,0,0.0,2,2,4,1,0,0,1,3,7,-20,1,POR,POR,OKC,89,,,12,11,8,5
Shaedon Sharpe,G,22023,1631101,22300036,"NOV 17, 2023",POR vs. LAL,L,38,7,17,0.412,1,5,0.2,2,2,1.0,2,7,9,2,1,1,10,4,17,-5,1,POR,POR,LAL,95,,,28,26,19,11
Shaedon Sharpe,G,22023,1631101,22300199,"NOV 15, 2023",POR vs. CLE,L,27,2,12,0.167,1,5,0.2,6,7,0.857,3,4,7,5,0,0,0,3,11,-27,1,POR,POR,CLE,93,,,23,18,16,12
Shaedon Sharpe,G,22023,1631101,22300023,"NOV 14, 2023",POR @ UTA,L,41,4,16,0.25,2,10,0.2,7,10,0.7,2,6,8,7,2,0,3,3,17,-10,1,POR,UTA,POR,99,,,32,25,24,15
Shaedon Sharpe,G,22023,1631101,22300187,"NOV 12, 2023",POR @ LAL,L,42,7,15,0.467,3,6,0.5,2,2,1.0,0,3,3,4,0,0,7,4,19,-10,1,POR,LAL,POR,104,,,26,22,23,7
Shaedon Sharpe,G,22023,1631101,22300170,"NOV 08, 2023",POR @ SAC,L,40,5,14,0.357,1,5,0.2,7,8,0.875,0,1,1,3,1,0,4,6,18,2,1,POR,SAC,POR,118,,,22,19,21,4
Shaedon Sharpe,G,22023,1631101,22300144,"NOV 05, 2023",POR vs. MEM,L,41,7,15,0.467,3,8,0.375,1,3,0.333,1,7,8,3,1,1,3,1,18,-16,1,POR,POR,MEM,100,,,29,26,21,11
Shaedon Sharpe,G,22023,1631101,22300007,"NOV 03, 2023",POR vs. MEM,W,46,7,17,0.412,2,5,0.4,6,7,0.857,1,4,5,2,1,1,3,2,22,-1,1,POR,POR,MEM,115,,,29,27,24,7
Shaedon Sharpe,G,22023,1631101,22300115,"NOV 01, 2023",POR @ DET,W,42,9,16,0.563,3,6,0.5,8,10,0.8,2,5,7,5,1,2,2,1,29,3,1,POR,DET,POR,110,,,41,36,34,12
Shaedon Sharpe,G,22023,1631101,22300105,"OCT 30, 2023",POR @ TOR,W,38,4,10,0.4,2,5,0.4,4,4,1.0,2,3,5,3,1,2,4,3,14,4,1,POR,TOR,POR,99,,,22,19,17,8
Shaedon Sharpe,G,22023,1631101,22300098,"OCT 29, 2023",POR @ PHI,L,36,7,13,0.538,2,4,0.5,4,5,0.8,1,4,5,2,0,0,3,3,20,-23,1,POR,PHI,POR,98,,,27,25,22,7
Shaedon Sharpe,G,22023,1631101,22300086,"OCT 27, 2023",POR vs. ORL,L,41,9,23,0.391,4,11,0.364,2,2,1.0,4,1,5,2,2,0,3,1,24,-4,1,POR,POR,ORL,97,,,31,29,26,7
Shaedon Sharpe,G,22023,1631101,22300074,"OCT 25, 2023",POR @ LAC,L,28,6,14,0.429,1,6,0.167,1,1,1.0,4,2,6,3,1,0,0,4,14,10,1,POR,LAC,POR,111,,,23,20,17,9
Shaedon Sharpe,G,22023,1631101,22300514,"JAN 09, 2024",POR @ NYK,L,22,4,8,0.5,0,2,0.0,1,1,1.0,1,3,4,4,2,1,1,1,9,-23,1,POR,NYK,POR,80,,,17,13,13,8
Shaedon Sharpe,G,22023,1631101,22300498,"JAN 07, 2024",POR @ BKN,W,40,7,14,0.5,3,6,0.5,4,7,0.571,0,1,1,1,2,1,0,2,21,14,1,POR,BKN,POR,134,,,23,22,22,2
Shaedon Sharpe,G,22023,1631101,22300487,"JAN 05, 2024",POR @ DAL,L,24,5,15,0.333,1,6,0.167,4,4,1.0,1,4,5,2,0,1,2,2,15,-11,1,POR,DAL,POR,103,,,22,20,17,7
Shaedon Sharpe,G,22023,1631101,22300472,"JAN 03, 2024",POR @ DAL,L,22,6,12,0.5,1,5,0.2,3,3,1.0,1,3,4,0,0,0,0,3,16,-12,1,POR,DAL,POR,97,,,20,20,16,4
Shaedon Sharpe,G,22023,1631101,22300456,"JAN 01, 2024",POR @ PHX,L,18,2,8,0.25,0,5,0.0,2,2,1.0,1,0,1,1,0,0,1,0,6,-14,1,POR,PHX,POR,84,,,8,7,7,2
Shaedon Sharpe,G,22023,1631101,22301214,"DEC 06, 2023",POR @ GSW,L,42,10,18,0.556,4,9,0.444,2,4,0.5,0,6,6,5,0,0,1,1,26,-7,1,POR,GSW,POR,106,,,37,32,31,11
Shaedon Sharpe,G,22023,1631101,22300237,"NOV 22, 2023",POR vs. UTA,W,31,6,11,0.545,2,4,0.5,0,0,0.0,0,4,4,4,1,1,1,4,14,10,1,POR,POR,UTA,121,,,22,18,18,8
Shaedon Sharpe,G,22023,1631101,22300304,"DEC 11, 2023",POR @ LAC,L,41,8,17,0.471,4,9,0.444,7,9,0.778,1,2,3,6,1,0,2,2,27,-15,1,POR,LAC,POR,127,,,36,30,33,9
Shaedon Sharpe,G,22023,1631101,22300529,"JAN 11, 2024",POR @ OKC,L,21,3,14,0.214,1,6,0.167,0,0,0.0,3,3,6,1,0,0,1,3,7,-39,1,POR,OKC,POR,77,,,14,13,8,7
Shaedon Sharpe,G,22023,1631101,22301226,"DEC 08, 2023",POR vs. DAL,L,32,7,15,0.467,5,10,0.5,5,6,0.833,2,7,9,5,1,0,2,4,24,1,1,POR,POR,DAL,112,,,38,33,29,14
Malcolm Brogdon,G,22023,1627763,22300697,"FEB 02, 2024",POR @ DEN,L,36,5,13,0.385,0,2,0.0,1,3,0.333,3,5,8,6,0,0,0,2,11,-10,1,POR,DEN,POR,108,,,25,19,17,14
Malcolm Brogdon,G,22023,1627763,22300683,"JAN 31, 2024",POR vs. MIL,W,36,5,12,0.417,2,6,0.333,2,2,1.0,1,5,6,6,1,0,3,3,14,9,1,POR,POR,MIL,119,,,26,20,20,12
Malcolm Brogdon,G,22023,1627763,22300668,"JAN 29, 2024",POR vs. PHI,W,32,10,14,0.714,3,5,0.6,1,1,1.0,0,5,5,9,1,1,3,2,24,14,1,POR,POR,PHI,128,,,38,29,33,14
Malcolm Brogdon,G,22023,1627763,22300656,"JAN 28, 2024",POR vs. CHI,L,38,4,13,0.308,1,6,0.167,7,7,1.0,2,4,6,6,2,0,2,2,16,-3,1,POR,POR,CHI,96,,,28,22,22,12
Malcolm Brogdon,G,22023,1627763,22300623,"JAN 24, 2024",POR @ HOU,W,41,8,19,0.421,3,7,0.429,0,0,0.0,1,1,2,6,0,0,2,2,19,2,1,POR,HOU,POR,137,,,27,21,25,8
Malcolm Brogdon,G,22023,1627763,22300617,"JAN 23, 2024",POR @ OKC,L,35,5,12,0.417,2,4,0.5,6,6,1.0,0,2,2,7,0,1,7,2,18,-8,1,POR,OKC,POR,109,,,27,20,25,9
Malcolm Brogdon,G,22023,1627763,22300605,"JAN 21, 2024",POR @ LAL,L,33,8,17,0.471,3,4,0.75,4,5,0.8,1,6,7,9,0,1,1,3,23,-14,1,POR,LAL,POR,108,,,39,30,32,16
Malcolm Brogdon,G,22023,1627763,22300590,"JAN 19, 2024",POR vs. IND,W,37,9,18,0.5,2,4,0.5,10,10,1.0,1,6,7,6,1,1,1,3,30,-7,1,POR,POR,IND,118,,,43,37,36,13
Malcolm Brogdon,G,22023,1627763,22300399,"DEC 23, 2023",POR @ GSW,L,37,8,14,0.571,1,4,0.25,0,0,0.0,2,4,6,12,3,1,2,2,17,-4,1,POR,GSW,POR,106,,,35,23,29,18
Malcolm Brogdon,G,22023,1627763,22300381,"DEC 21, 2023",POR vs. WAS,L,28,3,8,0.375,1,3,0.333,0,0,0.0,0,2,2,4,1,0,1,3,7,-16,1,POR,POR,WAS,117,,,13,9,11,6
Malcolm Brogdon,G,22023,1627763,22300363,"DEC 19, 2023",POR vs. PHX,W,32,5,10,0.5,4,9,0.444,0,0,0.0,0,4,4,4,0,0,1,0,14,9,1,POR,POR,PHX,109,,,22,18,18,8
Malcolm Brogdon,G,22023,1627763,22300348,"DEC 17, 2023",POR vs. GSW,L,27,3,8,0.375,2,5,0.4,0,0,0.0,0,1,1,5,0,0,0,1,8,-2,1,POR,POR,GSW,114,,,14,9,13,6
Malcolm Brogdon,G,22023,1627763,22300341,"DEC 16, 2023",POR vs. DAL,L,24,4,7,0.571,1,4,0.25,0,0,0.0,0,2,2,2,1,0,1,4,9,-23,1,POR,POR,DAL,120,,,13,11,11,4
Malcolm Brogdon,G,22023,1627763,22300323,"DEC 14, 2023",POR vs. UTA,L,14,3,6,0.5,3,6,0.5,0,2,0.0,0,0,0,1,0,0,0,0,9,-8,1,POR,POR,UTA,114,,,10,9,10,1
Malcolm Brogdon,G,22023,1627763,22300289,"DEC 02, 2023",POR @ UTA,L,38,8,17,0.471,5,9,0.556,4,6,0.667,1,2,3,6,2,1,3,0,25,-2,1,POR,UTA,POR,113,,,34,28,31,9
Malcolm Brogdon,G,22023,1627763,22300265,"NOV 30, 2023",POR @ CLE,W,31,3,7,0.429,1,3,0.333,4,4,1.0,2,1,3,7,2,1,5,0,11,-9,1,POR,CLE,POR,103,,,21,14,18,10
Malcolm Brogdon,G,22023,1627763,22300254,"NOV 27, 2023",POR @ IND,W,36,9,20,0.45,1,3,0.333,5,6,0.833,0,2,2,7,0,0,1,1,24,-6,1,POR,IND,POR,114,,,33,26,31,9
Malcolm Brogdon,G,22023,1627763,22300245,"NOV 26, 2023",POR @ MIL,L,34,7,23,0.304,2,6,0.333,2,3,0.667,2,6,8,12,2,1,2,4,18,-6,1,POR,MIL,POR,102,,,38,26,30,20
Malcolm Brogdon,G,22023,1627763,22300041,"NOV 21, 2023",POR @ PHX,L,25,6,14,0.429,4,5,0.8,3,4,0.75,1,0,1,5,0,0,2,2,19,-3,1,POR,PHX,POR,107,,,25,20,24,6
Malcolm Brogdon,G,22023,1627763,22300170,"NOV 08, 2023",POR @ SAC,L,5,2,3,0.667,1,2,0.5,0,0,0.0,0,1,1,1,0,0,0,1,5,1,1,POR,SAC,POR,118,,,7,6,6,2
Malcolm Brogdon,G,22023,1627763,22300144,"NOV 05, 2023",POR vs. MEM,L,39,6,20,0.3,2,8,0.25,4,4,1.0,3,4,7,11,1,0,1,2,18,-17,1,POR,POR,MEM,100,,,36,25,29,18
Malcolm Brogdon,G,22023,1627763,22300007,"NOV 03, 2023",POR vs. MEM,W,44,6,19,0.316,2,9,0.222,10,12,0.833,0,7,7,10,3,0,4,1,24,14,1,POR,POR,MEM,115,,,41,31,34,17
Malcolm Brogdon,G,22023,1627763,22300115,"NOV 01, 2023",POR @ DET,W,25,5,11,0.455,1,4,0.25,3,4,0.75,1,5,6,6,1,0,2,1,14,17,1,POR,DET,POR,110,,,26,20,20,12
Malcolm Brogdon,G,22023,1627763,22300105,"OCT 30, 2023",POR @ TOR,W,29,9,21,0.429,3,7,0.429,0,1,0.0,1,2,3,5,0,0,1,2,21,9,1,POR,TOR,POR,99,,,29,24,26,8
Malcolm Brogdon,G,22023,1627763,22300098,"OCT 29, 2023",POR @ PHI,L,26,7,16,0.438,2,6,0.333,2,2,1.0,1,4,5,5,1,0,2,2,18,-6,1,POR,PHI,POR,98,,,28,23,23,10
Malcolm Brogdon,G,22023,1627763,22300086,"OCT 27, 2023",POR vs. ORL,L,31,6,15,0.4,2,6,0.333,4,6,0.667,2,5,7,1,0,0,2,2,18,-4,1,POR,POR,ORL,97,,,26,25,19,8
Malcolm Brogdon,G,22023,1627763,22300074,"OCT 25, 2023",POR @ LAC,L,23,8,16,0.5,3,5,0.6,1,1,1.0,0,2,2,5,0,0,1,0,20,-5,1,POR,LAC,POR,111,,,27,22,25,7
Malcolm Brogdon,G,22023,1627763,22300578,"JAN 17, 2024",POR vs. BKN,W,30,6,12,0.5,2,6,0.333,2,2,1.0,0,5,5,6,1,0,0,2,16,-2,1,POR,POR,BKN,103,,,27,21,22,11
Malcolm Brogdon,G,22023,1627763,22300538,"JAN 12, 2024",POR @ MIN,L,26,2,7,0.286,2,5,0.4,3,4,0.75,0,2,2,3,0,0,1,1,9,-9,1,POR,MIN,POR,91,,,14,11,12,5
Malcolm Brogdon,G,22023,1627763,22300514,"JAN 09, 2024",POR @ NYK,L,13,1,5,0.2,0,0,0.0,0,0,0.0,0,1,1,0,0,0,1,2,2,-13,1,POR,NYK,POR,80,,,3,3,2,1
Malcolm Brogdon,G,22023,1627763,22300498,"JAN 07, 2024",POR @ BKN,W,22,5,8,0.625,4,6,0.667,4,4,1.0,1,2,3,2,0,0,0,0,18,17,1,POR,BKN,POR,134,,,23,21,20,5
Malcolm Brogdon,G,22023,1627763,22300487,"JAN 05, 2024",POR @ DAL,L,16,2,8,0.25,0,4,0.0,0,2,0.0,0,3,3,3,1,0,3,0,4,-16,1,POR,DAL,POR,103,,,10,7,7,6
Malcolm Brogdon,G,22023,1627763,22300472,"JAN 03, 2024",POR @ DAL,L,17,2,6,0.333,0,3,0.0,1,1,1.0,0,2,2,2,0,0,0,1,5,-12,1,POR,DAL,POR,97,,,9,7,7,4
Malcolm Brogdon,G,22023,1627763,22300456,"JAN 01, 2024",POR @ PHX,L,21,3,8,0.375,2,4,0.5,2,2,1.0,0,2,2,5,0,0,2,0,10,-5,1,POR,PHX,POR,84,,,17,12,15,7
Malcolm Brogdon,G,22023,1627763,22300437,"DEC 29, 2023",POR vs. SAS,W,37,9,18,0.5,5,7,0.714,4,4,1.0,0,1,1,7,1,0,1,2,27,16,1,POR,POR,SAS,132,,,35,28,34,8
Malcolm Brogdon,G,22023,1627763,22300427,"DEC 28, 2023",POR vs. SAS,L,37,10,19,0.526,6,8,0.75,3,5,0.6,1,5,6,6,1,0,1,1,29,-10,1,POR,POR,SAS,98,,,41,35,35,12
Malcolm Brogdon,G,22023,1627763,22300413,"DEC 26, 2023",POR vs. SAC,W,30,7,13,0.538,3,8,0.375,2,2,1.0,0,5,5,6,0,0,0,1,19,13,1,POR,POR,SAC,130,,,30,24,25,11
Malcolm Brogdon,G,22023,1627763,22301214,"DEC 06, 2023",POR @ GSW,L,13,0,3,0.0,0,1,0.0,0,0,0.0,0,1,1,2,0,0,1,1,0,5,1,POR,GSW,POR,106,,,3,1,2,3
Malcolm Brogdon,G,22023,1627763,22300237,"NOV 22, 2023",POR vs. UTA,W,24,9,16,0.563,1,5,0.2,1,1,1.0,1,3,4,8,1,0,0,0,20,12,1,POR,POR,UTA,121,,,32,24,28,12
Derrick White,G,22023,1628401,22300706,"FEB 04, 2024",BOS vs. MEM,W,28,5,10,0.5,4,8,0.5,1,2,0.5,1,2,3,3,1,1,1,1,15,27,1,BOS,BOS,MEM,131,14.0,Points,21,18,18,6
Derrick White,G,22023,1628401,22300706,"FEB 04, 2024",BOS vs. MEM,W,28,5,10,0.5,4,8,0.5,1,2,0.5,1,2,3,3,1,1,1,1,15,27,1,BOS,BOS,MEM,131,3.5,Rebounds,21,18,18,6
Derrick White,G,22023,1628401,22300706,"FEB 04, 2024",BOS vs. MEM,W,28,5,10,0.5,4,8,0.5,1,2,0.5,1,2,3,3,1,1,1,1,15,27,1,BOS,BOS,MEM,131,21.5,Pts+Rebs+Asts,21,18,18,6
Derrick White,G,22023,1628401,22300706,"FEB 04, 2024",BOS vs. MEM,W,28,5,10,0.5,4,8,0.5,1,2,0.5,1,2,3,3,1,1,1,1,15,27,1,BOS,BOS,MEM,131,4.0,Assists,21,18,18,6
Derrick White,G,22023,1628401,22300706,"FEB 04, 2024",BOS vs. MEM,W,28,5,10,0.5,4,8,0.5,1,2,0.5,1,2,3,3,1,1,1,1,15,27,1,BOS,BOS,MEM,131,27.5,Fantasy Score,21,18,18,6
Derrick White,G,22023,1628401,22300706,"FEB 04, 2024",BOS vs. MEM,W,28,5,10,0.5,4,8,0.5,1,2,0.5,1,2,3,3,1,1,1,1,15,27,1,BOS,BOS,MEM,131,0.5,Offensive Rebounds,21,18,18,6
Derrick White,G,22023,1628401,22300706,"FEB 04, 2024",BOS vs. MEM,W,28,5,10,0.5,4,8,0.5,1,2,0.5,1,2,3,3,1,1,1,1,15,27,1,BOS,BOS,MEM,131,6.5,3-PT Attempted,21,18,18,6
Derrick White,G,22023,1628401,22300706,"FEB 04, 2024",BOS vs. MEM,W,28,5,10,0.5,4,8,0.5,1,2,0.5,1,2,3,3,1,1,1,1,15,27,1,BOS,BOS,MEM,131,17.5,Pts+Rebs,21,18,18,6
Derrick White,G,22023,1628401,22300706,"FEB 04, 2024",BOS vs. MEM,W,28,5,10,0.5,4,8,0.5,1,2,0.5,1,2,3,3,1,1,1,1,15,27,1,BOS,BOS,MEM,131,17.5,Pts+Asts,21,18,18,6
Derrick White,G,22023,1628401,22300706,"FEB 04, 2024",BOS vs. MEM,W,28,5,10,0.5,4,8,0.5,1,2,0.5,1,2,3,3,1,1,1,1,15,27,1,BOS,BOS,MEM,131,7.5,Rebs+Asts,21,18,18,6
Derrick White,G,22023,1628401,22300684,"FEB 01, 2024",BOS vs. LAL,L,33,4,11,0.364,1,5,0.2,0,0,0.0,1,3,4,6,0,2,2,3,9,-19,1,BOS,BOS,LAL,105,14.0,Points,19,13,15,10
Derrick White,G,22023,1628401,22300684,"FEB 01, 2024",BOS vs. LAL,L,33,4,11,0.364,1,5,0.2,0,0,0.0,1,3,4,6,0,2,2,3,9,-19,1,BOS,BOS,LAL,105,3.5,Rebounds,19,13,15,10
Derrick White,G,22023,1628401,22300684,"FEB 01, 2024",BOS vs. LAL,L,33,4,11,0.364,1,5,0.2,0,0,0.0,1,3,4,6,0,2,2,3,9,-19,1,BOS,BOS,LAL,105,21.5,Pts+Rebs+Asts,19,13,15,10
Derrick White,G,22023,1628401,22300684,"FEB 01, 2024",BOS vs. LAL,L,33,4,11,0.364,1,5,0.2,0,0,0.0,1,3,4,6,0,2,2,3,9,-19,1,BOS,BOS,LAL,105,4.0,Assists,19,13,15,10
Derrick White,G,22023,1628401,22300684,"FEB 01, 2024",BOS vs. LAL,L,33,4,11,0.364,1,5,0.2,0,0,0.0,1,3,4,6,0,2,2,3,9,-19,1,BOS,BOS,LAL,105,27.5,Fantasy Score,19,13,15,10
Derrick White,G,22023,1628401,22300684,"FEB 01, 2024",BOS vs. LAL,L,33,4,11,0.364,1,5,0.2,0,0,0.0,1,3,4,6,0,2,2,3,9,-19,1,BOS,BOS,LAL,105,0.5,Offensive Rebounds,19,13,15,10
Derrick White,G,22023,1628401,22300684,"FEB 01, 2024",BOS vs. LAL,L,33,4,11,0.364,1,5,0.2,0,0,0.0,1,3,4,6,0,2,2,3,9,-19,1,BOS,BOS,LAL,105,6.5,3-PT Attempted,19,13,15,10
Derrick White,G,22023,1628401,22300684,"FEB 01, 2024",BOS vs. LAL,L,33,4,11,0.364,1,5,0.2,0,0,0.0,1,3,4,6,0,2,2,3,9,-19,1,BOS,BOS,LAL,105,17.5,Pts+Rebs,19,13,15,10
Derrick White,G,22023,1628401,22300684,"FEB 01, 2024",BOS vs. LAL,L,33,4,11,0.364,1,5,0.2,0,0,0.0,1,3,4,6,0,2,2,3,9,-19,1,BOS,BOS,LAL,105,17.5,Pts+Asts,19,13,15,10
Derrick White,G,22023,1628401,22300684,"FEB 01, 2024",BOS vs. LAL,L,33,4,11,0.364,1,5,0.2,0,0,0.0,1,3,4,6,0,2,2,3,9,-19,1,BOS,BOS,LAL,105,7.5,Rebs+Asts,19,13,15,10
Derrick White,G,22023,1628401,22300646,"JAN 27, 2024",BOS vs. LAC,L,24,0,8,0.0,0,4,0.0,2,2,1.0,0,2,2,2,0,3,1,2,2,-22,1,BOS,BOS,LAC,96,14.0,Points,6,4,4,4
Derrick White,G,22023,1628401,22300646,"JAN 27, 2024",BOS vs. LAC,L,24,0,8,0.0,0,4,0.0,2,2,1.0,0,2,2,2,0,3,1,2,2,-22,1,BOS,BOS,LAC,96,3.5,Rebounds,6,4,4,4
Derrick White,G,22023,1628401,22300646,"JAN 27, 2024",BOS vs. LAC,L,24,0,8,0.0,0,4,0.0,2,2,1.0,0,2,2,2,0,3,1,2,2,-22,1,BOS,BOS,LAC,96,21.5,Pts+Rebs+Asts,6,4,4,4
Derrick White,G,22023,1628401,22300646,"JAN 27, 2024",BOS vs. LAC,L,24,0,8,0.0,0,4,0.0,2,2,1.0,0,2,2,2,0,3,1,2,2,-22,1,BOS,BOS,LAC,96,4.0,Assists,6,4,4,4
Derrick White,G,22023,1628401,22300646,"JAN 27, 2024",BOS vs. LAC,L,24,0,8,0.0,0,4,0.0,2,2,1.0,0,2,2,2,0,3,1,2,2,-22,1,BOS,BOS,LAC,96,27.5,Fantasy Score,6,4,4,4
Derrick White,G,22023,1628401,22300646,"JAN 27, 2024",BOS vs. LAC,L,24,0,8,0.0,0,4,0.0,2,2,1.0,0,2,2,2,0,3,1,2,2,-22,1,BOS,BOS,LAC,96,0.5,Offensive Rebounds,6,4,4,4
Derrick White,G,22023,1628401,22300646,"JAN 27, 2024",BOS vs. LAC,L,24,0,8,0.0,0,4,0.0,2,2,1.0,0,2,2,2,0,3,1,2,2,-22,1,BOS,BOS,LAC,96,6.5,3-PT Attempted,6,4,4,4
Derrick White,G,22023,1628401,22300646,"JAN 27, 2024",BOS vs. LAC,L,24,0,8,0.0,0,4,0.0,2,2,1.0,0,2,2,2,0,3,1,2,2,-22,1,BOS,BOS,LAC,96,17.5,Pts+Rebs,6,4,4,4
Derrick White,G,22023,1628401,22300646,"JAN 27, 2024",BOS vs. LAC,L,24,0,8,0.0,0,4,0.0,2,2,1.0,0,2,2,2,0,3,1,2,2,-22,1,BOS,BOS,LAC,96,17.5,Pts+Asts,6,4,4,4
Derrick White,G,22023,1628401,22300646,"JAN 27, 2024",BOS vs. LAC,L,24,0,8,0.0,0,4,0.0,2,2,1.0,0,2,2,2,0,3,1,2,2,-22,1,BOS,BOS,LAC,96,7.5,Rebs+Asts,6,4,4,4
Derrick White,G,22023,1628401,22300630,"JAN 25, 2024",BOS @ MIA,W,29,6,12,0.5,3,9,0.333,0,0,0.0,2,4,6,6,0,2,1,0,15,24,1,BOS,MIA,BOS,143,14.0,Points,27,21,21,12
Derrick White,G,22023,1628401,22300630,"JAN 25, 2024",BOS @ MIA,W,29,6,12,0.5,3,9,0.333,0,0,0.0,2,4,6,6,0,2,1,0,15,24,1,BOS,MIA,BOS,143,3.5,Rebounds,27,21,21,12
Derrick White,G,22023,1628401,22300630,"JAN 25, 2024",BOS @ MIA,W,29,6,12,0.5,3,9,0.333,0,0,0.0,2,4,6,6,0,2,1,0,15,24,1,BOS,MIA,BOS,143,21.5,Pts+Rebs+Asts,27,21,21,12
Derrick White,G,22023,1628401,22300630,"JAN 25, 2024",BOS @ MIA,W,29,6,12,0.5,3,9,0.333,0,0,0.0,2,4,6,6,0,2,1,0,15,24,1,BOS,MIA,BOS,143,4.0,Assists,27,21,21,12
Derrick White,G,22023,1628401,22300630,"JAN 25, 2024",BOS @ MIA,W,29,6,12,0.5,3,9,0.333,0,0,0.0,2,4,6,6,0,2,1,0,15,24,1,BOS,MIA,BOS,143,27.5,Fantasy Score,27,21,21,12
Derrick White,G,22023,1628401,22300630,"JAN 25, 2024",BOS @ MIA,W,29,6,12,0.5,3,9,0.333,0,0,0.0,2,4,6,6,0,2,1,0,15,24,1,BOS,MIA,BOS,143,0.5,Offensive Rebounds,27,21,21,12
Derrick White,G,22023,1628401,22300630,"JAN 25, 2024",BOS @ MIA,W,29,6,12,0.5,3,9,0.333,0,0,0.0,2,4,6,6,0,2,1,0,15,24,1,BOS,MIA,BOS,143,6.5,3-PT Attempted,27,21,21,12
Derrick White,G,22023,1628401,22300630,"JAN 25, 2024",BOS @ MIA,W,29,6,12,0.5,3,9,0.333,0,0,0.0,2,4,6,6,0,2,1,0,15,24,1,BOS,MIA,BOS,143,17.5,Pts+Rebs,27,21,21,12
Derrick White,G,22023,1628401,22300630,"JAN 25, 2024",BOS @ MIA,W,29,6,12,0.5,3,9,0.333,0,0,0.0,2,4,6,6,0,2,1,0,15,24,1,BOS,MIA,BOS,143,17.5,Pts+Asts,27,21,21,12
Derrick White,G,22023,1628401,22300630,"JAN 25, 2024",BOS @ MIA,W,29,6,12,0.5,3,9,0.333,0,0,0.0,2,4,6,6,0,2,1,0,15,24,1,BOS,MIA,BOS,143,7.5,Rebs+Asts,27,21,21,12
Derrick White,G,22023,1628401,22300528,"JAN 11, 2024",BOS @ MIL,L,18,1,4,0.25,0,1,0.0,0,0,0.0,0,1,1,0,0,0,0,0,2,-14,1,BOS,MIL,BOS,102,14.0,Points,3,3,2,1
Derrick White,G,22023,1628401,22300528,"JAN 11, 2024",BOS @ MIL,L,18,1,4,0.25,0,1,0.0,0,0,0.0,0,1,1,0,0,0,0,0,2,-14,1,BOS,MIL,BOS,102,3.5,Rebounds,3,3,2,1
Derrick White,G,22023,1628401,22300528,"JAN 11, 2024",BOS @ MIL,L,18,1,4,0.25,0,1,0.0,0,0,0.0,0,1,1,0,0,0,0,0,2,-14,1,BOS,MIL,BOS,102,21.5,Pts+Rebs+Asts,3,3,2,1
Derrick White,G,22023,1628401,22300528,"JAN 11, 2024",BOS @ MIL,L,18,1,4,0.25,0,1,0.0,0,0,0.0,0,1,1,0,0,0,0,0,2,-14,1,BOS,MIL,BOS,102,4.0,Assists,3,3,2,1
Derrick White,G,22023,1628401,22300528,"JAN 11, 2024",BOS @ MIL,L,18,1,4,0.25,0,1,0.0,0,0,0.0,0,1,1,0,0,0,0,0,2,-14,1,BOS,MIL,BOS,102,27.5,Fantasy Score,3,3,2,1
Derrick White,G,22023,1628401,22300528,"JAN 11, 2024",BOS @ MIL,L,18,1,4,0.25,0,1,0.0,0,0,0.0,0,1,1,0,0,0,0,0,2,-14,1,BOS,MIL,BOS,102,0.5,Offensive Rebounds,3,3,2,1
Derrick White,G,22023,1628401,22300528,"JAN 11, 2024",BOS @ MIL,L,18,1,4,0.25,0,1,0.0,0,0,0.0,0,1,1,0,0,0,0,0,2,-14,1,BOS,MIL,BOS,102,6.5,3-PT Attempted,3,3,2,1
Derrick White,G,22023,1628401,22300528,"JAN 11, 2024",BOS @ MIL,L,18,1,4,0.25,0,1,0.0,0,0,0.0,0,1,1,0,0,0,0,0,2,-14,1,BOS,MIL,BOS,102,17.5,Pts+Rebs,3,3,2,1
Derrick White,G,22023,1628401,22300528,"JAN 11, 2024",BOS @ MIL,L,18,1,4,0.25,0,1,0.0,0,0,0.0,0,1,1,0,0,0,0,0,2,-14,1,BOS,MIL,BOS,102,17.5,Pts+Asts,3,3,2,1
Derrick White,G,22023,1628401,22300528,"JAN 11, 2024",BOS @ MIL,L,18,1,4,0.25,0,1,0.0,0,0,0.0,0,1,1,0,0,0,0,0,2,-14,1,BOS,MIL,BOS,102,7.5,Rebs+Asts,3,3,2,1
Derrick White,G,22023,1628401,22300507,"JAN 08, 2024",BOS @ IND,L,36,4,16,0.25,2,8,0.25,3,3,1.0,0,4,4,6,0,2,1,3,13,-2,1,BOS,IND,BOS,131,14.0,Points,23,17,19,10
Derrick White,G,22023,1628401,22300507,"JAN 08, 2024",BOS @ IND,L,36,4,16,0.25,2,8,0.25,3,3,1.0,0,4,4,6,0,2,1,3,13,-2,1,BOS,IND,BOS,131,3.5,Rebounds,23,17,19,10
Derrick White,G,22023,1628401,22300507,"JAN 08, 2024",BOS @ IND,L,36,4,16,0.25,2,8,0.25,3,3,1.0,0,4,4,6,0,2,1,3,13,-2,1,BOS,IND,BOS,131,21.5,Pts+Rebs+Asts,23,17,19,10
Derrick White,G,22023,1628401,22300507,"JAN 08, 2024",BOS @ IND,L,36,4,16,0.25,2,8,0.25,3,3,1.0,0,4,4,6,0,2,1,3,13,-2,1,BOS,IND,BOS,131,4.0,Assists,23,17,19,10
Derrick White,G,22023,1628401,22300507,"JAN 08, 2024",BOS @ IND,L,36,4,16,0.25,2,8,0.25,3,3,1.0,0,4,4,6,0,2,1,3,13,-2,1,BOS,IND,BOS,131,27.5,Fantasy Score,23,17,19,10
Derrick White,G,22023,1628401,22300507,"JAN 08, 2024",BOS @ IND,L,36,4,16,0.25,2,8,0.25,3,3,1.0,0,4,4,6,0,2,1,3,13,-2,1,BOS,IND,BOS,131,0.5,Offensive Rebounds,23,17,19,10
Derrick White,G,22023,1628401,22300507,"JAN 08, 2024",BOS @ IND,L,36,4,16,0.25,2,8,0.25,3,3,1.0,0,4,4,6,0,2,1,3,13,-2,1,BOS,IND,BOS,131,6.5,3-PT Attempted,23,17,19,10
Derrick White,G,22023,1628401,22300507,"JAN 08, 2024",BOS @ IND,L,36,4,16,0.25,2,8,0.25,3,3,1.0,0,4,4,6,0,2,1,3,13,-2,1,BOS,IND,BOS,131,17.5,Pts+Rebs,23,17,19,10
Derrick White,G,22023,1628401,22300507,"JAN 08, 2024",BOS @ IND,L,36,4,16,0.25,2,8,0.25,3,3,1.0,0,4,4,6,0,2,1,3,13,-2,1,BOS,IND,BOS,131,17.5,Pts+Asts,23,17,19,10
Derrick White,G,22023,1628401,22300507,"JAN 08, 2024",BOS @ IND,L,36,4,16,0.25,2,8,0.25,3,3,1.0,0,4,4,6,0,2,1,3,13,-2,1,BOS,IND,BOS,131,7.5,Rebs+Asts,23,17,19,10
Derrick White,G,22023,1628401,22300493,"JAN 06, 2024",BOS @ IND,W,24,3,6,0.5,1,2,0.5,0,0,0.0,0,5,5,2,0,1,4,5,7,20,1,BOS,IND,BOS,118,14.0,Points,14,12,9,7
Derrick White,G,22023,1628401,22300493,"JAN 06, 2024",BOS @ IND,W,24,3,6,0.5,1,2,0.5,0,0,0.0,0,5,5,2,0,1,4,5,7,20,1,BOS,IND,BOS,118,3.5,Rebounds,14,12,9,7
Derrick White,G,22023,1628401,22300493,"JAN 06, 2024",BOS @ IND,W,24,3,6,0.5,1,2,0.5,0,0,0.0,0,5,5,2,0,1,4,5,7,20,1,BOS,IND,BOS,118,21.5,Pts+Rebs+Asts,14,12,9,7
Derrick White,G,22023,1628401,22300493,"JAN 06, 2024",BOS @ IND,W,24,3,6,0.5,1,2,0.5,0,0,0.0,0,5,5,2,0,1,4,5,7,20,1,BOS,IND,BOS,118,4.0,Assists,14,12,9,7
Derrick White,G,22023,1628401,22300493,"JAN 06, 2024",BOS @ IND,W,24,3,6,0.5,1,2,0.5,0,0,0.0,0,5,5,2,0,1,4,5,7,20,1,BOS,IND,BOS,118,27.5,Fantasy Score,14,12,9,7
Derrick White,G,22023,1628401,22300493,"JAN 06, 2024",BOS @ IND,W,24,3,6,0.5,1,2,0.5,0,0,0.0,0,5,5,2,0,1,4,5,7,20,1,BOS,IND,BOS,118,0.5,Offensive Rebounds,14,12,9,7
Derrick White,G,22023,1628401,22300493,"JAN 06, 2024",BOS @ IND,W,24,3,6,0.5,1,2,0.5,0,0,0.0,0,5,5,2,0,1,4,5,7,20,1,BOS,IND,BOS,118,6.5,3-PT Attempted,14,12,9,7
Derrick White,G,22023,1628401,22300493,"JAN 06, 2024",BOS @ IND,W,24,3,6,0.5,1,2,0.5,0,0,0.0,0,5,5,2,0,1,4,5,7,20,1,BOS,IND,BOS,118,17.5,Pts+Rebs,14,12,9,7
Derrick White,G,22023,1628401,22300493,"JAN 06, 2024",BOS @ IND,W,24,3,6,0.5,1,2,0.5,0,0,0.0,0,5,5,2,0,1,4,5,7,20,1,BOS,IND,BOS,118,17.5,Pts+Asts,14,12,9,7
Derrick White,G,22023,1628401,22300493,"JAN 06, 2024",BOS @ IND,W,24,3,6,0.5,1,2,0.5,0,0,0.0,0,5,5,2,0,1,4,5,7,20,1,BOS,IND,BOS,118,7.5,Rebs+Asts,14,12,9,7
Derrick White,G,22023,1628401,22300479,"JAN 05, 2024",BOS vs. UTA,W,26,3,9,0.333,2,7,0.286,2,2,1.0,0,7,7,3,1,1,0,2,10,19,1,BOS,BOS,UTA,126,14.0,Points,20,17,13,10
Derrick White,G,22023,1628401,22300479,"JAN 05, 2024",BOS vs. UTA,W,26,3,9,0.333,2,7,0.286,2,2,1.0,0,7,7,3,1,1,0,2,10,19,1,BOS,BOS,UTA,126,3.5,Rebounds,20,17,13,10
Derrick White,G,22023,1628401,22300479,"JAN 05, 2024",BOS vs. UTA,W,26,3,9,0.333,2,7,0.286,2,2,1.0,0,7,7,3,1,1,0,2,10,19,1,BOS,BOS,UTA,126,21.5,Pts+Rebs+Asts,20,17,13,10
Derrick White,G,22023,1628401,22300479,"JAN 05, 2024",BOS vs. UTA,W,26,3,9,0.333,2,7,0.286,2,2,1.0,0,7,7,3,1,1,0,2,10,19,1,BOS,BOS,UTA,126,4.0,Assists,20,17,13,10
Derrick White,G,22023,1628401,22300479,"JAN 05, 2024",BOS vs. UTA,W,26,3,9,0.333,2,7,0.286,2,2,1.0,0,7,7,3,1,1,0,2,10,19,1,BOS,BOS,UTA,126,27.5,Fantasy Score,20,17,13,10
Derrick White,G,22023,1628401,22300479,"JAN 05, 2024",BOS vs. UTA,W,26,3,9,0.333,2,7,0.286,2,2,1.0,0,7,7,3,1,1,0,2,10,19,1,BOS,BOS,UTA,126,0.5,Offensive Rebounds,20,17,13,10
Derrick White,G,22023,1628401,22300479,"JAN 05, 2024",BOS vs. UTA,W,26,3,9,0.333,2,7,0.286,2,2,1.0,0,7,7,3,1,1,0,2,10,19,1,BOS,BOS,UTA,126,6.5,3-PT Attempted,20,17,13,10
Derrick White,G,22023,1628401,22300479,"JAN 05, 2024",BOS vs. UTA,W,26,3,9,0.333,2,7,0.286,2,2,1.0,0,7,7,3,1,1,0,2,10,19,1,BOS,BOS,UTA,126,17.5,Pts+Rebs,20,17,13,10
Derrick White,G,22023,1628401,22300479,"JAN 05, 2024",BOS vs. UTA,W,26,3,9,0.333,2,7,0.286,2,2,1.0,0,7,7,3,1,1,0,2,10,19,1,BOS,BOS,UTA,126,17.5,Pts+Asts,20,17,13,10
Derrick White,G,22023,1628401,22300479,"JAN 05, 2024",BOS vs. UTA,W,26,3,9,0.333,2,7,0.286,2,2,1.0,0,7,7,3,1,1,0,2,10,19,1,BOS,BOS,UTA,126,7.5,Rebs+Asts,20,17,13,10
Derrick White,G,22023,1628401,22300448,"DEC 31, 2023",BOS @ SAS,W,26,7,11,0.636,3,6,0.5,0,0,0.0,1,2,3,5,0,0,0,1,17,24,1,BOS,SAS,BOS,134,14.0,Points,25,20,22,8
Derrick White,G,22023,1628401,22300448,"DEC 31, 2023",BOS @ SAS,W,26,7,11,0.636,3,6,0.5,0,0,0.0,1,2,3,5,0,0,0,1,17,24,1,BOS,SAS,BOS,134,3.5,Rebounds,25,20,22,8
Derrick White,G,22023,1628401,22300448,"DEC 31, 2023",BOS @ SAS,W,26,7,11,0.636,3,6,0.5,0,0,0.0,1,2,3,5,0,0,0,1,17,24,1,BOS,SAS,BOS,134,21.5,Pts+Rebs+Asts,25,20,22,8
Derrick White,G,22023,1628401,22300448,"DEC 31, 2023",BOS @ SAS,W,26,7,11,0.636,3,6,0.5,0,0,0.0,1,2,3,5,0,0,0,1,17,24,1,BOS,SAS,BOS,134,4.0,Assists,25,20,22,8
Derrick White,G,22023,1628401,22300448,"DEC 31, 2023",BOS @ SAS,W,26,7,11,0.636,3,6,0.5,0,0,0.0,1,2,3,5,0,0,0,1,17,24,1,BOS,SAS,BOS,134,27.5,Fantasy Score,25,20,22,8
Derrick White,G,22023,1628401,22300448,"DEC 31, 2023",BOS @ SAS,W,26,7,11,0.636,3,6,0.5,0,0,0.0,1,2,3,5,0,0,0,1,17,24,1,BOS,SAS,BOS,134,0.5,Offensive Rebounds,25,20,22,8
Derrick White,G,22023,1628401,22300448,"DEC 31, 2023",BOS @ SAS,W,26,7,11,0.636,3,6,0.5,0,0,0.0,1,2,3,5,0,0,0,1,17,24,1,BOS,SAS,BOS,134,6.5,3-PT Attempted,25,20,22,8
Derrick White,G,22023,1628401,22300448,"DEC 31, 2023",BOS @ SAS,W,26,7,11,0.636,3,6,0.5,0,0,0.0,1,2,3,5,0,0,0,1,17,24,1,BOS,SAS,BOS,134,17.5,Pts+Rebs,25,20,22,8
Derrick White,G,22023,1628401,22300448,"DEC 31, 2023",BOS @ SAS,W,26,7,11,0.636,3,6,0.5,0,0,0.0,1,2,3,5,0,0,0,1,17,24,1,BOS,SAS,BOS,134,17.5,Pts+Asts,25,20,22,8
Derrick White,G,22023,1628401,22300448,"DEC 31, 2023",BOS @ SAS,W,26,7,11,0.636,3,6,0.5,0,0,0.0,1,2,3,5,0,0,0,1,17,24,1,BOS,SAS,BOS,134,7.5,Rebs+Asts,25,20,22,8
Derrick White,G,22023,1628401,22300432,"DEC 29, 2023",BOS vs. TOR,W,36,5,19,0.263,2,10,0.2,9,9,1.0,1,4,5,7,3,2,3,2,21,7,1,BOS,BOS,TOR,120,14.0,Points,33,26,28,12
Derrick White,G,22023,1628401,22300432,"DEC 29, 2023",BOS vs. TOR,W,36,5,19,0.263,2,10,0.2,9,9,1.0,1,4,5,7,3,2,3,2,21,7,1,BOS,BOS,TOR,120,3.5,Rebounds,33,26,28,12
Derrick White,G,22023,1628401,22300432,"DEC 29, 2023",BOS vs. TOR,W,36,5,19,0.263,2,10,0.2,9,9,1.0,1,4,5,7,3,2,3,2,21,7,1,BOS,BOS,TOR,120,21.5,Pts+Rebs+Asts,33,26,28,12
Derrick White,G,22023,1628401,22300432,"DEC 29, 2023",BOS vs. TOR,W,36,5,19,0.263,2,10,0.2,9,9,1.0,1,4,5,7,3,2,3,2,21,7,1,BOS,BOS,TOR,120,4.0,Assists,33,26,28,12
Derrick White,G,22023,1628401,22300432,"DEC 29, 2023",BOS vs. TOR,W,36,5,19,0.263,2,10,0.2,9,9,1.0,1,4,5,7,3,2,3,2,21,7,1,BOS,BOS,TOR,120,27.5,Fantasy Score,33,26,28,12
Derrick White,G,22023,1628401,22300432,"DEC 29, 2023",BOS vs. TOR,W,36,5,19,0.263,2,10,0.2,9,9,1.0,1,4,5,7,3,2,3,2,21,7,1,BOS,BOS,TOR,120,0.5,Offensive Rebounds,33,26,28,12
Derrick White,G,22023,1628401,22300432,"DEC 29, 2023",BOS vs. TOR,W,36,5,19,0.263,2,10,0.2,9,9,1.0,1,4,5,7,3,2,3,2,21,7,1,BOS,BOS,TOR,120,6.5,3-PT Attempted,33,26,28,12
Derrick White,G,22023,1628401,22300432,"DEC 29, 2023",BOS vs. TOR,W,36,5,19,0.263,2,10,0.2,9,9,1.0,1,4,5,7,3,2,3,2,21,7,1,BOS,BOS,TOR,120,17.5,Pts+Rebs,33,26,28,12
Derrick White,G,22023,1628401,22300432,"DEC 29, 2023",BOS vs. TOR,W,36,5,19,0.263,2,10,0.2,9,9,1.0,1,4,5,7,3,2,3,2,21,7,1,BOS,BOS,TOR,120,17.5,Pts+Asts,33,26,28,12
Derrick White,G,22023,1628401,22300432,"DEC 29, 2023",BOS vs. TOR,W,36,5,19,0.263,2,10,0.2,9,9,1.0,1,4,5,7,3,2,3,2,21,7,1,BOS,BOS,TOR,120,7.5,Rebs+Asts,33,26,28,12
Derrick White,G,22023,1628401,22300389,"DEC 23, 2023",BOS @ LAC,W,29,5,12,0.417,3,10,0.3,5,5,1.0,0,3,3,3,0,3,2,2,18,27,1,BOS,LAC,BOS,142,14.0,Points,24,21,21,6
Derrick White,G,22023,1628401,22300389,"DEC 23, 2023",BOS @ LAC,W,29,5,12,0.417,3,10,0.3,5,5,1.0,0,3,3,3,0,3,2,2,18,27,1,BOS,LAC,BOS,142,3.5,Rebounds,24,21,21,6
Derrick White,G,22023,1628401,22300389,"DEC 23, 2023",BOS @ LAC,W,29,5,12,0.417,3,10,0.3,5,5,1.0,0,3,3,3,0,3,2,2,18,27,1,BOS,LAC,BOS,142,21.5,Pts+Rebs+Asts,24,21,21,6
Derrick White,G,22023,1628401,22300389,"DEC 23, 2023",BOS @ LAC,W,29,5,12,0.417,3,10,0.3,5,5,1.0,0,3,3,3,0,3,2,2,18,27,1,BOS,LAC,BOS,142,4.0,Assists,24,21,21,6
Derrick White,G,22023,1628401,22300389,"DEC 23, 2023",BOS @ LAC,W,29,5,12,0.417,3,10,0.3,5,5,1.0,0,3,3,3,0,3,2,2,18,27,1,BOS,LAC,BOS,142,27.5,Fantasy Score,24,21,21,6
Derrick White,G,22023,1628401,22300389,"DEC 23, 2023",BOS @ LAC,W,29,5,12,0.417,3,10,0.3,5,5,1.0,0,3,3,3,0,3,2,2,18,27,1,BOS,LAC,BOS,142,0.5,Offensive Rebounds,24,21,21,6
Derrick White,G,22023,1628401,22300389,"DEC 23, 2023",BOS @ LAC,W,29,5,12,0.417,3,10,0.3,5,5,1.0,0,3,3,3,0,3,2,2,18,27,1,BOS,LAC,BOS,142,6.5,3-PT Attempted,24,21,21,6
Derrick White,G,22023,1628401,22300389,"DEC 23, 2023",BOS @ LAC,W,29,5,12,0.417,3,10,0.3,5,5,1.0,0,3,3,3,0,3,2,2,18,27,1,BOS,LAC,BOS,142,17.5,Pts+Rebs,24,21,21,6
Derrick White,G,22023,1628401,22300389,"DEC 23, 2023",BOS @ LAC,W,29,5,12,0.417,3,10,0.3,5,5,1.0,0,3,3,3,0,3,2,2,18,27,1,BOS,LAC,BOS,142,17.5,Pts+Asts,24,21,21,6
Derrick White,G,22023,1628401,22300389,"DEC 23, 2023",BOS @ LAC,W,29,5,12,0.417,3,10,0.3,5,5,1.0,0,3,3,3,0,3,2,2,18,27,1,BOS,LAC,BOS,142,7.5,Rebs+Asts,24,21,21,6
Derrick White,G,22023,1628401,22300344,"DEC 17, 2023",BOS vs. ORL,W,27,4,9,0.444,1,5,0.2,1,1,1.0,0,5,5,4,1,3,2,1,10,7,1,BOS,BOS,ORL,114,14.0,Points,19,15,14,9
Derrick White,G,22023,1628401,22300344,"DEC 17, 2023",BOS vs. ORL,W,27,4,9,0.444,1,5,0.2,1,1,1.0,0,5,5,4,1,3,2,1,10,7,1,BOS,BOS,ORL,114,3.5,Rebounds,19,15,14,9
Derrick White,G,22023,1628401,22300344,"DEC 17, 2023",BOS vs. ORL,W,27,4,9,0.444,1,5,0.2,1,1,1.0,0,5,5,4,1,3,2,1,10,7,1,BOS,BOS,ORL,114,21.5,Pts+Rebs+Asts,19,15,14,9
Derrick White,G,22023,1628401,22300344,"DEC 17, 2023",BOS vs. ORL,W,27,4,9,0.444,1,5,0.2,1,1,1.0,0,5,5,4,1,3,2,1,10,7,1,BOS,BOS,ORL,114,4.0,Assists,19,15,14,9
Derrick White,G,22023,1628401,22300344,"DEC 17, 2023",BOS vs. ORL,W,27,4,9,0.444,1,5,0.2,1,1,1.0,0,5,5,4,1,3,2,1,10,7,1,BOS,BOS,ORL,114,27.5,Fantasy Score,19,15,14,9
Derrick White,G,22023,1628401,22300344,"DEC 17, 2023",BOS vs. ORL,W,27,4,9,0.444,1,5,0.2,1,1,1.0,0,5,5,4,1,3,2,1,10,7,1,BOS,BOS,ORL,114,0.5,Offensive Rebounds,19,15,14,9
Derrick White,G,22023,1628401,22300344,"DEC 17, 2023",BOS vs. ORL,W,27,4,9,0.444,1,5,0.2,1,1,1.0,0,5,5,4,1,3,2,1,10,7,1,BOS,BOS,ORL,114,6.5,3-PT Attempted,19,15,14,9
Derrick White,G,22023,1628401,22300344,"DEC 17, 2023",BOS vs. ORL,W,27,4,9,0.444,1,5,0.2,1,1,1.0,0,5,5,4,1,3,2,1,10,7,1,BOS,BOS,ORL,114,17.5,Pts+Rebs,19,15,14,9
Derrick White,G,22023,1628401,22300344,"DEC 17, 2023",BOS vs. ORL,W,27,4,9,0.444,1,5,0.2,1,1,1.0,0,5,5,4,1,3,2,1,10,7,1,BOS,BOS,ORL,114,17.5,Pts+Asts,19,15,14,9
Derrick White,G,22023,1628401,22300344,"DEC 17, 2023",BOS vs. ORL,W,27,4,9,0.444,1,5,0.2,1,1,1.0,0,5,5,4,1,3,2,1,10,7,1,BOS,BOS,ORL,114,7.5,Rebs+Asts,19,15,14,9
Derrick White,G,22023,1628401,22301227,"DEC 08, 2023",BOS vs. NYK,W,32,10,16,0.625,6,10,0.6,4,4,1.0,2,1,3,3,2,2,0,4,30,21,1,BOS,BOS,NYK,133,14.0,Points,36,33,33,6
Derrick White,G,22023,1628401,22301227,"DEC 08, 2023",BOS vs. NYK,W,32,10,16,0.625,6,10,0.6,4,4,1.0,2,1,3,3,2,2,0,4,30,21,1,BOS,BOS,NYK,133,3.5,Rebounds,36,33,33,6
Derrick White,G,22023,1628401,22301227,"DEC 08, 2023",BOS vs. NYK,W,32,10,16,0.625,6,10,0.6,4,4,1.0,2,1,3,3,2,2,0,4,30,21,1,BOS,BOS,NYK,133,21.5,Pts+Rebs+Asts,36,33,33,6
Derrick White,G,22023,1628401,22301227,"DEC 08, 2023",BOS vs. NYK,W,32,10,16,0.625,6,10,0.6,4,4,1.0,2,1,3,3,2,2,0,4,30,21,1,BOS,BOS,NYK,133,4.0,Assists,36,33,33,6
Derrick White,G,22023,1628401,22301227,"DEC 08, 2023",BOS vs. NYK,W,32,10,16,0.625,6,10,0.6,4,4,1.0,2,1,3,3,2,2,0,4,30,21,1,BOS,BOS,NYK,133,27.5,Fantasy Score,36,33,33,6
Derrick White,G,22023,1628401,22301227,"DEC 08, 2023",BOS vs. NYK,W,32,10,16,0.625,6,10,0.6,4,4,1.0,2,1,3,3,2,2,0,4,30,21,1,BOS,BOS,NYK,133,0.5,Offensive Rebounds,36,33,33,6
Derrick White,G,22023,1628401,22301227,"DEC 08, 2023",BOS vs. NYK,W,32,10,16,0.625,6,10,0.6,4,4,1.0,2,1,3,3,2,2,0,4,30,21,1,BOS,BOS,NYK,133,6.5,3-PT Attempted,36,33,33,6
Derrick White,G,22023,1628401,22301227,"DEC 08, 2023",BOS vs. NYK,W,32,10,16,0.625,6,10,0.6,4,4,1.0,2,1,3,3,2,2,0,4,30,21,1,BOS,BOS,NYK,133,17.5,Pts+Rebs,36,33,33,6
Derrick White,G,22023,1628401,22301227,"DEC 08, 2023",BOS vs. NYK,W,32,10,16,0.625,6,10,0.6,4,4,1.0,2,1,3,3,2,2,0,4,30,21,1,BOS,BOS,NYK,133,17.5,Pts+Asts,36,33,33,6
Derrick White,G,22023,1628401,22301227,"DEC 08, 2023",BOS vs. NYK,W,32,10,16,0.625,6,10,0.6,4,4,1.0,2,1,3,3,2,2,0,4,30,21,1,BOS,BOS,NYK,133,7.5,Rebs+Asts,36,33,33,6
Derrick White,G,22023,1628401,22301202,"DEC 04, 2023",BOS @ IND,L,36,7,16,0.438,2,9,0.222,2,2,1.0,0,4,4,8,1,1,5,4,18,-4,1,BOS,IND,BOS,112,14.0,Points,30,22,26,12
Derrick White,G,22023,1628401,22301202,"DEC 04, 2023",BOS @ IND,L,36,7,16,0.438,2,9,0.222,2,2,1.0,0,4,4,8,1,1,5,4,18,-4,1,BOS,IND,BOS,112,3.5,Rebounds,30,22,26,12
Derrick White,G,22023,1628401,22301202,"DEC 04, 2023",BOS @ IND,L,36,7,16,0.438,2,9,0.222,2,2,1.0,0,4,4,8,1,1,5,4,18,-4,1,BOS,IND,BOS,112,21.5,Pts+Rebs+Asts,30,22,26,12
Derrick White,G,22023,1628401,22301202,"DEC 04, 2023",BOS @ IND,L,36,7,16,0.438,2,9,0.222,2,2,1.0,0,4,4,8,1,1,5,4,18,-4,1,BOS,IND,BOS,112,4.0,Assists,30,22,26,12
Derrick White,G,22023,1628401,22301202,"DEC 04, 2023",BOS @ IND,L,36,7,16,0.438,2,9,0.222,2,2,1.0,0,4,4,8,1,1,5,4,18,-4,1,BOS,IND,BOS,112,27.5,Fantasy Score,30,22,26,12
Derrick White,G,22023,1628401,22301202,"DEC 04, 2023",BOS @ IND,L,36,7,16,0.438,2,9,0.222,2,2,1.0,0,4,4,8,1,1,5,4,18,-4,1,BOS,IND,BOS,112,0.5,Offensive Rebounds,30,22,26,12
Derrick White,G,22023,1628401,22301202,"DEC 04, 2023",BOS @ IND,L,36,7,16,0.438,2,9,0.222,2,2,1.0,0,4,4,8,1,1,5,4,18,-4,1,BOS,IND,BOS,112,6.5,3-PT Attempted,30,22,26,12
Derrick White,G,22023,1628401,22301202,"DEC 04, 2023",BOS @ IND,L,36,7,16,0.438,2,9,0.222,2,2,1.0,0,4,4,8,1,1,5,4,18,-4,1,BOS,IND,BOS,112,17.5,Pts+Rebs,30,22,26,12
Derrick White,G,22023,1628401,22301202,"DEC 04, 2023",BOS @ IND,L,36,7,16,0.438,2,9,0.222,2,2,1.0,0,4,4,8,1,1,5,4,18,-4,1,BOS,IND,BOS,112,17.5,Pts+Asts,30,22,26,12
Derrick White,G,22023,1628401,22301202,"DEC 04, 2023",BOS @ IND,L,36,7,16,0.438,2,9,0.222,2,2,1.0,0,4,4,8,1,1,5,4,18,-4,1,BOS,IND,BOS,112,7.5,Rebs+Asts,30,22,26,12
Derrick White,G,22023,1628401,22300275,"DEC 01, 2023",BOS vs. PHI,W,32,5,11,0.455,3,4,0.75,8,8,1.0,1,5,6,5,1,1,1,2,21,20,1,BOS,BOS,PHI,125,14.0,Points,32,27,26,11
Derrick White,G,22023,1628401,22300275,"DEC 01, 2023",BOS vs. PHI,W,32,5,11,0.455,3,4,0.75,8,8,1.0,1,5,6,5,1,1,1,2,21,20,1,BOS,BOS,PHI,125,3.5,Rebounds,32,27,26,11
Derrick White,G,22023,1628401,22300275,"DEC 01, 2023",BOS vs. PHI,W,32,5,11,0.455,3,4,0.75,8,8,1.0,1,5,6,5,1,1,1,2,21,20,1,BOS,BOS,PHI,125,21.5,Pts+Rebs+Asts,32,27,26,11
Derrick White,G,22023,1628401,22300275,"DEC 01, 2023",BOS vs. PHI,W,32,5,11,0.455,3,4,0.75,8,8,1.0,1,5,6,5,1,1,1,2,21,20,1,BOS,BOS,PHI,125,4.0,Assists,32,27,26,11
Derrick White,G,22023,1628401,22300275,"DEC 01, 2023",BOS vs. PHI,W,32,5,11,0.455,3,4,0.75,8,8,1.0,1,5,6,5,1,1,1,2,21,20,1,BOS,BOS,PHI,125,27.5,Fantasy Score,32,27,26,11
Derrick White,G,22023,1628401,22300275,"DEC 01, 2023",BOS vs. PHI,W,32,5,11,0.455,3,4,0.75,8,8,1.0,1,5,6,5,1,1,1,2,21,20,1,BOS,BOS,PHI,125,0.5,Offensive Rebounds,32,27,26,11
Derrick White,G,22023,1628401,22300275,"DEC 01, 2023",BOS vs. PHI,W,32,5,11,0.455,3,4,0.75,8,8,1.0,1,5,6,5,1,1,1,2,21,20,1,BOS,BOS,PHI,125,6.5,3-PT Attempted,32,27,26,11
Derrick White,G,22023,1628401,22300275,"DEC 01, 2023",BOS vs. PHI,W,32,5,11,0.455,3,4,0.75,8,8,1.0,1,5,6,5,1,1,1,2,21,20,1,BOS,BOS,PHI,125,17.5,Pts+Rebs,32,27,26,11
Derrick White,G,22023,1628401,22300275,"DEC 01, 2023",BOS vs. PHI,W,32,5,11,0.455,3,4,0.75,8,8,1.0,1,5,6,5,1,1,1,2,21,20,1,BOS,BOS,PHI,125,17.5,Pts+Asts,32,27,26,11
Derrick White,G,22023,1628401,22300275,"DEC 01, 2023",BOS vs. PHI,W,32,5,11,0.455,3,4,0.75,8,8,1.0,1,5,6,5,1,1,1,2,21,20,1,BOS,BOS,PHI,125,7.5,Rebs+Asts,32,27,26,11
Derrick White,G,22023,1628401,22300053,"NOV 28, 2023",BOS vs. CHI,W,29,5,7,0.714,2,3,0.667,2,2,1.0,0,3,3,7,2,0,0,4,14,15,1,BOS,BOS,CHI,124,14.0,Points,24,17,21,10
Derrick White,G,22023,1628401,22300053,"NOV 28, 2023",BOS vs. CHI,W,29,5,7,0.714,2,3,0.667,2,2,1.0,0,3,3,7,2,0,0,4,14,15,1,BOS,BOS,CHI,124,3.5,Rebounds,24,17,21,10
Derrick White,G,22023,1628401,22300053,"NOV 28, 2023",BOS vs. CHI,W,29,5,7,0.714,2,3,0.667,2,2,1.0,0,3,3,7,2,0,0,4,14,15,1,BOS,BOS,CHI,124,21.5,Pts+Rebs+Asts,24,17,21,10
Derrick White,G,22023,1628401,22300053,"NOV 28, 2023",BOS vs. CHI,W,29,5,7,0.714,2,3,0.667,2,2,1.0,0,3,3,7,2,0,0,4,14,15,1,BOS,BOS,CHI,124,4.0,Assists,24,17,21,10
Derrick White,G,22023,1628401,22300053,"NOV 28, 2023",BOS vs. CHI,W,29,5,7,0.714,2,3,0.667,2,2,1.0,0,3,3,7,2,0,0,4,14,15,1,BOS,BOS,CHI,124,27.5,Fantasy Score,24,17,21,10
Derrick White,G,22023,1628401,22300053,"NOV 28, 2023",BOS vs. CHI,W,29,5,7,0.714,2,3,0.667,2,2,1.0,0,3,3,7,2,0,0,4,14,15,1,BOS,BOS,CHI,124,0.5,Offensive Rebounds,24,17,21,10
Derrick White,G,22023,1628401,22300053,"NOV 28, 2023",BOS vs. CHI,W,29,5,7,0.714,2,3,0.667,2,2,1.0,0,3,3,7,2,0,0,4,14,15,1,BOS,BOS,CHI,124,6.5,3-PT Attempted,24,17,21,10
Derrick White,G,22023,1628401,22300053,"NOV 28, 2023",BOS vs. CHI,W,29,5,7,0.714,2,3,0.667,2,2,1.0,0,3,3,7,2,0,0,4,14,15,1,BOS,BOS,CHI,124,17.5,Pts+Rebs,24,17,21,10
Derrick White,G,22023,1628401,22300053,"NOV 28, 2023",BOS vs. CHI,W,29,5,7,0.714,2,3,0.667,2,2,1.0,0,3,3,7,2,0,0,4,14,15,1,BOS,BOS,CHI,124,17.5,Pts+Asts,24,17,21,10
Derrick White,G,22023,1628401,22300053,"NOV 28, 2023",BOS vs. CHI,W,29,5,7,0.714,2,3,0.667,2,2,1.0,0,3,3,7,2,0,0,4,14,15,1,BOS,BOS,CHI,124,7.5,Rebs+Asts,24,17,21,10
Derrick White,G,22023,1628401,22300246,"NOV 26, 2023",BOS vs. ATL,W,37,5,13,0.385,0,6,0.0,5,5,1.0,2,2,4,11,3,0,3,5,15,29,1,BOS,BOS,ATL,113,14.0,Points,30,19,26,15
Derrick White,G,22023,1628401,22300246,"NOV 26, 2023",BOS vs. ATL,W,37,5,13,0.385,0,6,0.0,5,5,1.0,2,2,4,11,3,0,3,5,15,29,1,BOS,BOS,ATL,113,3.5,Rebounds,30,19,26,15
Derrick White,G,22023,1628401,22300246,"NOV 26, 2023",BOS vs. ATL,W,37,5,13,0.385,0,6,0.0,5,5,1.0,2,2,4,11,3,0,3,5,15,29,1,BOS,BOS,ATL,113,21.5,Pts+Rebs+Asts,30,19,26,15
Derrick White,G,22023,1628401,22300246,"NOV 26, 2023",BOS vs. ATL,W,37,5,13,0.385,0,6,0.0,5,5,1.0,2,2,4,11,3,0,3,5,15,29,1,BOS,BOS,ATL,113,4.0,Assists,30,19,26,15
Derrick White,G,22023,1628401,22300246,"NOV 26, 2023",BOS vs. ATL,W,37,5,13,0.385,0,6,0.0,5,5,1.0,2,2,4,11,3,0,3,5,15,29,1,BOS,BOS,ATL,113,27.5,Fantasy Score,30,19,26,15
Derrick White,G,22023,1628401,22300246,"NOV 26, 2023",BOS vs. ATL,W,37,5,13,0.385,0,6,0.0,5,5,1.0,2,2,4,11,3,0,3,5,15,29,1,BOS,BOS,ATL,113,0.5,Offensive Rebounds,30,19,26,15
Derrick White,G,22023,1628401,22300246,"NOV 26, 2023",BOS vs. ATL,W,37,5,13,0.385,0,6,0.0,5,5,1.0,2,2,4,11,3,0,3,5,15,29,1,BOS,BOS,ATL,113,6.5,3-PT Attempted,30,19,26,15
Derrick White,G,22023,1628401,22300246,"NOV 26, 2023",BOS vs. ATL,W,37,5,13,0.385,0,6,0.0,5,5,1.0,2,2,4,11,3,0,3,5,15,29,1,BOS,BOS,ATL,113,17.5,Pts+Rebs,30,19,26,15
Derrick White,G,22023,1628401,22300246,"NOV 26, 2023",BOS vs. ATL,W,37,5,13,0.385,0,6,0.0,5,5,1.0,2,2,4,11,3,0,3,5,15,29,1,BOS,BOS,ATL,113,17.5,Pts+Asts,30,19,26,15
Derrick White,G,22023,1628401,22300246,"NOV 26, 2023",BOS vs. ATL,W,37,5,13,0.385,0,6,0.0,5,5,1.0,2,2,4,11,3,0,3,5,15,29,1,BOS,BOS,ATL,113,7.5,Rebs+Asts,30,19,26,15
Derrick White,G,22023,1628401,22300043,"NOV 24, 2023",BOS @ ORL,L,37,3,9,0.333,1,5,0.2,9,12,0.75,0,5,5,4,1,1,3,1,16,-6,1,BOS,ORL,BOS,96,14.0,Points,25,21,20,9
Derrick White,G,22023,1628401,22300043,"NOV 24, 2023",BOS @ ORL,L,37,3,9,0.333,1,5,0.2,9,12,0.75,0,5,5,4,1,1,3,1,16,-6,1,BOS,ORL,BOS,96,3.5,Rebounds,25,21,20,9
Derrick White,G,22023,1628401,22300043,"NOV 24, 2023",BOS @ ORL,L,37,3,9,0.333,1,5,0.2,9,12,0.75,0,5,5,4,1,1,3,1,16,-6,1,BOS,ORL,BOS,96,21.5,Pts+Rebs+Asts,25,21,20,9
Derrick White,G,22023,1628401,22300043,"NOV 24, 2023",BOS @ ORL,L,37,3,9,0.333,1,5,0.2,9,12,0.75,0,5,5,4,1,1,3,1,16,-6,1,BOS,ORL,BOS,96,4.0,Assists,25,21,20,9
Derrick White,G,22023,1628401,22300043,"NOV 24, 2023",BOS @ ORL,L,37,3,9,0.333,1,5,0.2,9,12,0.75,0,5,5,4,1,1,3,1,16,-6,1,BOS,ORL,BOS,96,27.5,Fantasy Score,25,21,20,9
Derrick White,G,22023,1628401,22300043,"NOV 24, 2023",BOS @ ORL,L,37,3,9,0.333,1,5,0.2,9,12,0.75,0,5,5,4,1,1,3,1,16,-6,1,BOS,ORL,BOS,96,0.5,Offensive Rebounds,25,21,20,9
Derrick White,G,22023,1628401,22300043,"NOV 24, 2023",BOS @ ORL,L,37,3,9,0.333,1,5,0.2,9,12,0.75,0,5,5,4,1,1,3,1,16,-6,1,BOS,ORL,BOS,96,6.5,3-PT Attempted,25,21,20,9
Derrick White,G,22023,1628401,22300043,"NOV 24, 2023",BOS @ ORL,L,37,3,9,0.333,1,5,0.2,9,12,0.75,0,5,5,4,1,1,3,1,16,-6,1,BOS,ORL,BOS,96,17.5,Pts+Rebs,25,21,20,9
Derrick White,G,22023,1628401,22300043,"NOV 24, 2023",BOS @ ORL,L,37,3,9,0.333,1,5,0.2,9,12,0.75,0,5,5,4,1,1,3,1,16,-6,1,BOS,ORL,BOS,96,17.5,Pts+Asts,25,21,20,9
Derrick White,G,22023,1628401,22300043,"NOV 24, 2023",BOS @ ORL,L,37,3,9,0.333,1,5,0.2,9,12,0.75,0,5,5,4,1,1,3,1,16,-6,1,BOS,ORL,BOS,96,7.5,Rebs+Asts,25,21,20,9
Derrick White,G,22023,1628401,22300194,"NOV 15, 2023",BOS @ PHI,W,36,7,12,0.583,4,8,0.5,9,10,0.9,0,3,3,5,1,0,2,3,27,3,1,BOS,PHI,BOS,117,14.0,Points,35,30,32,8
Derrick White,G,22023,1628401,22300194,"NOV 15, 2023",BOS @ PHI,W,36,7,12,0.583,4,8,0.5,9,10,0.9,0,3,3,5,1,0,2,3,27,3,1,BOS,PHI,BOS,117,3.5,Rebounds,35,30,32,8
Derrick White,G,22023,1628401,22300194,"NOV 15, 2023",BOS @ PHI,W,36,7,12,0.583,4,8,0.5,9,10,0.9,0,3,3,5,1,0,2,3,27,3,1,BOS,PHI,BOS,117,21.5,Pts+Rebs+Asts,35,30,32,8
Derrick White,G,22023,1628401,22300194,"NOV 15, 2023",BOS @ PHI,W,36,7,12,0.583,4,8,0.5,9,10,0.9,0,3,3,5,1,0,2,3,27,3,1,BOS,PHI,BOS,117,4.0,Assists,35,30,32,8
Derrick White,G,22023,1628401,22300194,"NOV 15, 2023",BOS @ PHI,W,36,7,12,0.583,4,8,0.5,9,10,0.9,0,3,3,5,1,0,2,3,27,3,1,BOS,PHI,BOS,117,27.5,Fantasy Score,35,30,32,8
Derrick White,G,22023,1628401,22300194,"NOV 15, 2023",BOS @ PHI,W,36,7,12,0.583,4,8,0.5,9,10,0.9,0,3,3,5,1,0,2,3,27,3,1,BOS,PHI,BOS,117,0.5,Offensive Rebounds,35,30,32,8
Derrick White,G,22023,1628401,22300194,"NOV 15, 2023",BOS @ PHI,W,36,7,12,0.583,4,8,0.5,9,10,0.9,0,3,3,5,1,0,2,3,27,3,1,BOS,PHI,BOS,117,6.5,3-PT Attempted,35,30,32,8
Derrick White,G,22023,1628401,22300194,"NOV 15, 2023",BOS @ PHI,W,36,7,12,0.583,4,8,0.5,9,10,0.9,0,3,3,5,1,0,2,3,27,3,1,BOS,PHI,BOS,117,17.5,Pts+Rebs,35,30,32,8
Derrick White,G,22023,1628401,22300194,"NOV 15, 2023",BOS @ PHI,W,36,7,12,0.583,4,8,0.5,9,10,0.9,0,3,3,5,1,0,2,3,27,3,1,BOS,PHI,BOS,117,17.5,Pts+Asts,35,30,32,8
Derrick White,G,22023,1628401,22300194,"NOV 15, 2023",BOS @ PHI,W,36,7,12,0.583,4,8,0.5,9,10,0.9,0,3,3,5,1,0,2,3,27,3,1,BOS,PHI,BOS,117,7.5,Rebs+Asts,35,30,32,8
Derrick White,G,22023,1628401,22300174,"NOV 11, 2023",BOS vs. TOR,W,26,2,5,0.4,0,3,0.0,0,1,0.0,0,4,4,5,0,1,0,2,4,20,1,BOS,BOS,TOR,117,14.0,Points,13,8,9,9
Derrick White,G,22023,1628401,22300174,"NOV 11, 2023",BOS vs. TOR,W,26,2,5,0.4,0,3,0.0,0,1,0.0,0,4,4,5,0,1,0,2,4,20,1,BOS,BOS,TOR,117,3.5,Rebounds,13,8,9,9
Derrick White,G,22023,1628401,22300174,"NOV 11, 2023",BOS vs. TOR,W,26,2,5,0.4,0,3,0.0,0,1,0.0,0,4,4,5,0,1,0,2,4,20,1,BOS,BOS,TOR,117,21.5,Pts+Rebs+Asts,13,8,9,9
Derrick White,G,22023,1628401,22300174,"NOV 11, 2023",BOS vs. TOR,W,26,2,5,0.4,0,3,0.0,0,1,0.0,0,4,4,5,0,1,0,2,4,20,1,BOS,BOS,TOR,117,4.0,Assists,13,8,9,9
Derrick White,G,22023,1628401,22300174,"NOV 11, 2023",BOS vs. TOR,W,26,2,5,0.4,0,3,0.0,0,1,0.0,0,4,4,5,0,1,0,2,4,20,1,BOS,BOS,TOR,117,27.5,Fantasy Score,13,8,9,9
Derrick White,G,22023,1628401,22300174,"NOV 11, 2023",BOS vs. TOR,W,26,2,5,0.4,0,3,0.0,0,1,0.0,0,4,4,5,0,1,0,2,4,20,1,BOS,BOS,TOR,117,0.5,Offensive Rebounds,13,8,9,9
Derrick White,G,22023,1628401,22300174,"NOV 11, 2023",BOS vs. TOR,W,26,2,5,0.4,0,3,0.0,0,1,0.0,0,4,4,5,0,1,0,2,4,20,1,BOS,BOS,TOR,117,6.5,3-PT Attempted,13,8,9,9
Derrick White,G,22023,1628401,22300174,"NOV 11, 2023",BOS vs. TOR,W,26,2,5,0.4,0,3,0.0,0,1,0.0,0,4,4,5,0,1,0,2,4,20,1,BOS,BOS,TOR,117,17.5,Pts+Rebs,13,8,9,9
Derrick White,G,22023,1628401,22300174,"NOV 11, 2023",BOS vs. TOR,W,26,2,5,0.4,0,3,0.0,0,1,0.0,0,4,4,5,0,1,0,2,4,20,1,BOS,BOS,TOR,117,17.5,Pts+Asts,13,8,9,9
Derrick White,G,22023,1628401,22300174,"NOV 11, 2023",BOS vs. TOR,W,26,2,5,0.4,0,3,0.0,0,1,0.0,0,4,4,5,0,1,0,2,4,20,1,BOS,BOS,TOR,117,7.5,Rebs+Asts,13,8,9,9
Derrick White,G,22023,1628401,22300010,"NOV 10, 2023",BOS vs. BKN,W,27,4,10,0.4,2,5,0.4,1,2,0.5,0,4,4,5,0,1,0,2,11,1,1,BOS,BOS,BKN,121,14.0,Points,20,15,16,9
Derrick White,G,22023,1628401,22300010,"NOV 10, 2023",BOS vs. BKN,W,27,4,10,0.4,2,5,0.4,1,2,0.5,0,4,4,5,0,1,0,2,11,1,1,BOS,BOS,BKN,121,3.5,Rebounds,20,15,16,9
Derrick White,G,22023,1628401,22300010,"NOV 10, 2023",BOS vs. BKN,W,27,4,10,0.4,2,5,0.4,1,2,0.5,0,4,4,5,0,1,0,2,11,1,1,BOS,BOS,BKN,121,21.5,Pts+Rebs+Asts,20,15,16,9
Derrick White,G,22023,1628401,22300010,"NOV 10, 2023",BOS vs. BKN,W,27,4,10,0.4,2,5,0.4,1,2,0.5,0,4,4,5,0,1,0,2,11,1,1,BOS,BOS,BKN,121,4.0,Assists,20,15,16,9
Derrick White,G,22023,1628401,22300010,"NOV 10, 2023",BOS vs. BKN,W,27,4,10,0.4,2,5,0.4,1,2,0.5,0,4,4,5,0,1,0,2,11,1,1,BOS,BOS,BKN,121,27.5,Fantasy Score,20,15,16,9
Derrick White,G,22023,1628401,22300010,"NOV 10, 2023",BOS vs. BKN,W,27,4,10,0.4,2,5,0.4,1,2,0.5,0,4,4,5,0,1,0,2,11,1,1,BOS,BOS,BKN,121,0.5,Offensive Rebounds,20,15,16,9
Derrick White,G,22023,1628401,22300010,"NOV 10, 2023",BOS vs. BKN,W,27,4,10,0.4,2,5,0.4,1,2,0.5,0,4,4,5,0,1,0,2,11,1,1,BOS,BOS,BKN,121,6.5,3-PT Attempted,20,15,16,9
Derrick White,G,22023,1628401,22300010,"NOV 10, 2023",BOS vs. BKN,W,27,4,10,0.4,2,5,0.4,1,2,0.5,0,4,4,5,0,1,0,2,11,1,1,BOS,BOS,BKN,121,17.5,Pts+Rebs,20,15,16,9
Derrick White,G,22023,1628401,22300010,"NOV 10, 2023",BOS vs. BKN,W,27,4,10,0.4,2,5,0.4,1,2,0.5,0,4,4,5,0,1,0,2,11,1,1,BOS,BOS,BKN,121,17.5,Pts+Asts,20,15,16,9
Derrick White,G,22023,1628401,22300010,"NOV 10, 2023",BOS vs. BKN,W,27,4,10,0.4,2,5,0.4,1,2,0.5,0,4,4,5,0,1,0,2,11,1,1,BOS,BOS,BKN,121,7.5,Rebs+Asts,20,15,16,9
Derrick White,G,22023,1628401,22300118,"NOV 01, 2023",BOS vs. IND,W,27,7,10,0.7,4,7,0.571,0,0,0.0,1,2,3,4,0,0,2,3,18,34,1,BOS,BOS,IND,155,14.0,Points,25,21,22,7
Derrick White,G,22023,1628401,22300118,"NOV 01, 2023",BOS vs. IND,W,27,7,10,0.7,4,7,0.571,0,0,0.0,1,2,3,4,0,0,2,3,18,34,1,BOS,BOS,IND,155,3.5,Rebounds,25,21,22,7
Derrick White,G,22023,1628401,22300118,"NOV 01, 2023",BOS vs. IND,W,27,7,10,0.7,4,7,0.571,0,0,0.0,1,2,3,4,0,0,2,3,18,34,1,BOS,BOS,IND,155,21.5,Pts+Rebs+Asts,25,21,22,7
Derrick White,G,22023,1628401,22300118,"NOV 01, 2023",BOS vs. IND,W,27,7,10,0.7,4,7,0.571,0,0,0.0,1,2,3,4,0,0,2,3,18,34,1,BOS,BOS,IND,155,4.0,Assists,25,21,22,7
Derrick White,G,22023,1628401,22300118,"NOV 01, 2023",BOS vs. IND,W,27,7,10,0.7,4,7,0.571,0,0,0.0,1,2,3,4,0,0,2,3,18,34,1,BOS,BOS,IND,155,27.5,Fantasy Score,25,21,22,7
Derrick White,G,22023,1628401,22300118,"NOV 01, 2023",BOS vs. IND,W,27,7,10,0.7,4,7,0.571,0,0,0.0,1,2,3,4,0,0,2,3,18,34,1,BOS,BOS,IND,155,0.5,Offensive Rebounds,25,21,22,7
Derrick White,G,22023,1628401,22300118,"NOV 01, 2023",BOS vs. IND,W,27,7,10,0.7,4,7,0.571,0,0,0.0,1,2,3,4,0,0,2,3,18,34,1,BOS,BOS,IND,155,6.5,3-PT Attempted,25,21,22,7
Derrick White,G,22023,1628401,22300118,"NOV 01, 2023",BOS vs. IND,W,27,7,10,0.7,4,7,0.571,0,0,0.0,1,2,3,4,0,0,2,3,18,34,1,BOS,BOS,IND,155,17.5,Pts+Rebs,25,21,22,7
Derrick White,G,22023,1628401,22300118,"NOV 01, 2023",BOS vs. IND,W,27,7,10,0.7,4,7,0.571,0,0,0.0,1,2,3,4,0,0,2,3,18,34,1,BOS,BOS,IND,155,17.5,Pts+Asts,25,21,22,7
Derrick White,G,22023,1628401,22300118,"NOV 01, 2023",BOS vs. IND,W,27,7,10,0.7,4,7,0.571,0,0,0.0,1,2,3,4,0,0,2,3,18,34,1,BOS,BOS,IND,155,7.5,Rebs+Asts,25,21,22,7
Derrick White,G,22023,1628401,22300103,"OCT 30, 2023",BOS @ WAS,W,24,2,3,0.667,1,2,0.5,0,0,0.0,1,0,1,8,2,1,2,1,5,27,1,BOS,WAS,BOS,126,14.0,Points,14,6,13,9
Derrick White,G,22023,1628401,22300103,"OCT 30, 2023",BOS @ WAS,W,24,2,3,0.667,1,2,0.5,0,0,0.0,1,0,1,8,2,1,2,1,5,27,1,BOS,WAS,BOS,126,3.5,Rebounds,14,6,13,9
Derrick White,G,22023,1628401,22300103,"OCT 30, 2023",BOS @ WAS,W,24,2,3,0.667,1,2,0.5,0,0,0.0,1,0,1,8,2,1,2,1,5,27,1,BOS,WAS,BOS,126,21.5,Pts+Rebs+Asts,14,6,13,9
Derrick White,G,22023,1628401,22300103,"OCT 30, 2023",BOS @ WAS,W,24,2,3,0.667,1,2,0.5,0,0,0.0,1,0,1,8,2,1,2,1,5,27,1,BOS,WAS,BOS,126,4.0,Assists,14,6,13,9
Derrick White,G,22023,1628401,22300103,"OCT 30, 2023",BOS @ WAS,W,24,2,3,0.667,1,2,0.5,0,0,0.0,1,0,1,8,2,1,2,1,5,27,1,BOS,WAS,BOS,126,27.5,Fantasy Score,14,6,13,9
Derrick White,G,22023,1628401,22300103,"OCT 30, 2023",BOS @ WAS,W,24,2,3,0.667,1,2,0.5,0,0,0.0,1,0,1,8,2,1,2,1,5,27,1,BOS,WAS,BOS,126,0.5,Offensive Rebounds,14,6,13,9
Derrick White,G,22023,1628401,22300103,"OCT 30, 2023",BOS @ WAS,W,24,2,3,0.667,1,2,0.5,0,0,0.0,1,0,1,8,2,1,2,1,5,27,1,BOS,WAS,BOS,126,6.5,3-PT Attempted,14,6,13,9
Derrick White,G,22023,1628401,22300103,"OCT 30, 2023",BOS @ WAS,W,24,2,3,0.667,1,2,0.5,0,0,0.0,1,0,1,8,2,1,2,1,5,27,1,BOS,WAS,BOS,126,17.5,Pts+Rebs,14,6,13,9
Derrick White,G,22023,1628401,22300103,"OCT 30, 2023",BOS @ WAS,W,24,2,3,0.667,1,2,0.5,0,0,0.0,1,0,1,8,2,1,2,1,5,27,1,BOS,WAS,BOS,126,17.5,Pts+Asts,14,6,13,9
Derrick White,G,22023,1628401,22300103,"OCT 30, 2023",BOS @ WAS,W,24,2,3,0.667,1,2,0.5,0,0,0.0,1,0,1,8,2,1,2,1,5,27,1,BOS,WAS,BOS,126,7.5,Rebs+Asts,14,6,13,9
Derrick White,G,22023,1628401,22300729,"FEB 07, 2024",BOS vs. ATL,W,35,8,14,0.571,5,10,0.5,0,0,0.0,1,5,6,7,1,1,2,2,21,0,1,BOS,BOS,ATL,125,14.0,Points,34,27,28,13
Derrick White,G,22023,1628401,22300729,"FEB 07, 2024",BOS vs. ATL,W,35,8,14,0.571,5,10,0.5,0,0,0.0,1,5,6,7,1,1,2,2,21,0,1,BOS,BOS,ATL,125,3.5,Rebounds,34,27,28,13
Derrick White,G,22023,1628401,22300729,"FEB 07, 2024",BOS vs. ATL,W,35,8,14,0.571,5,10,0.5,0,0,0.0,1,5,6,7,1,1,2,2,21,0,1,BOS,BOS,ATL,125,21.5,Pts+Rebs+Asts,34,27,28,13
Derrick White,G,22023,1628401,22300729,"FEB 07, 2024",BOS vs. ATL,W,35,8,14,0.571,5,10,0.5,0,0,0.0,1,5,6,7,1,1,2,2,21,0,1,BOS,BOS,ATL,125,4.0,Assists,34,27,28,13
Derrick White,G,22023,1628401,22300729,"FEB 07, 2024",BOS vs. ATL,W,35,8,14,0.571,5,10,0.5,0,0,0.0,1,5,6,7,1,1,2,2,21,0,1,BOS,BOS,ATL,125,27.5,Fantasy Score,34,27,28,13
Derrick White,G,22023,1628401,22300729,"FEB 07, 2024",BOS vs. ATL,W,35,8,14,0.571,5,10,0.5,0,0,0.0,1,5,6,7,1,1,2,2,21,0,1,BOS,BOS,ATL,125,0.5,Offensive Rebounds,34,27,28,13
Derrick White,G,22023,1628401,22300729,"FEB 07, 2024",BOS vs. ATL,W,35,8,14,0.571,5,10,0.5,0,0,0.0,1,5,6,7,1,1,2,2,21,0,1,BOS,BOS,ATL,125,6.5,3-PT Attempted,34,27,28,13
Derrick White,G,22023,1628401,22300729,"FEB 07, 2024",BOS vs. ATL,W,35,8,14,0.571,5,10,0.5,0,0,0.0,1,5,6,7,1,1,2,2,21,0,1,BOS,BOS,ATL,125,17.5,Pts+Rebs,34,27,28,13
Derrick White,G,22023,1628401,22300729,"FEB 07, 2024",BOS vs. ATL,W,35,8,14,0.571,5,10,0.5,0,0,0.0,1,5,6,7,1,1,2,2,21,0,1,BOS,BOS,ATL,125,17.5,Pts+Asts,34,27,28,13
Derrick White,G,22023,1628401,22300729,"FEB 07, 2024",BOS vs. ATL,W,35,8,14,0.571,5,10,0.5,0,0,0.0,1,5,6,7,1,1,2,2,21,0,1,BOS,BOS,ATL,125,7.5,Rebs+Asts,34,27,28,13
Derrick White,G,22023,1628401,22300670,"JAN 30, 2024",BOS vs. IND,W,35,8,16,0.5,4,7,0.571,4,4,1.0,0,2,2,5,1,1,0,2,24,-4,1,BOS,BOS,IND,129,14.0,Points,31,26,29,7
Derrick White,G,22023,1628401,22300670,"JAN 30, 2024",BOS vs. IND,W,35,8,16,0.5,4,7,0.571,4,4,1.0,0,2,2,5,1,1,0,2,24,-4,1,BOS,BOS,IND,129,3.5,Rebounds,31,26,29,7
Derrick White,G,22023,1628401,22300670,"JAN 30, 2024",BOS vs. IND,W,35,8,16,0.5,4,7,0.571,4,4,1.0,0,2,2,5,1,1,0,2,24,-4,1,BOS,BOS,IND,129,21.5,Pts+Rebs+Asts,31,26,29,7
Derrick White,G,22023,1628401,22300670,"JAN 30, 2024",BOS vs. IND,W,35,8,16,0.5,4,7,0.571,4,4,1.0,0,2,2,5,1,1,0,2,24,-4,1,BOS,BOS,IND,129,4.0,Assists,31,26,29,7
Derrick White,G,22023,1628401,22300670,"JAN 30, 2024",BOS vs. IND,W,35,8,16,0.5,4,7,0.571,4,4,1.0,0,2,2,5,1,1,0,2,24,-4,1,BOS,BOS,IND,129,27.5,Fantasy Score,31,26,29,7
Derrick White,G,22023,1628401,22300670,"JAN 30, 2024",BOS vs. IND,W,35,8,16,0.5,4,7,0.571,4,4,1.0,0,2,2,5,1,1,0,2,24,-4,1,BOS,BOS,IND,129,0.5,Offensive Rebounds,31,26,29,7
Derrick White,G,22023,1628401,22300670,"JAN 30, 2024",BOS vs. IND,W,35,8,16,0.5,4,7,0.571,4,4,1.0,0,2,2,5,1,1,0,2,24,-4,1,BOS,BOS,IND,129,6.5,3-PT Attempted,31,26,29,7
Derrick White,G,22023,1628401,22300670,"JAN 30, 2024",BOS vs. IND,W,35,8,16,0.5,4,7,0.571,4,4,1.0,0,2,2,5,1,1,0,2,24,-4,1,BOS,BOS,IND,129,17.5,Pts+Rebs,31,26,29,7
Derrick White,G,22023,1628401,22300670,"JAN 30, 2024",BOS vs. IND,W,35,8,16,0.5,4,7,0.571,4,4,1.0,0,2,2,5,1,1,0,2,24,-4,1,BOS,BOS,IND,129,17.5,Pts+Asts,31,26,29,7
Derrick White,G,22023,1628401,22300670,"JAN 30, 2024",BOS vs. IND,W,35,8,16,0.5,4,7,0.571,4,4,1.0,0,2,2,5,1,1,0,2,24,-4,1,BOS,BOS,IND,129,7.5,Rebs+Asts,31,26,29,7
Derrick White,G,22023,1628401,22300659,"JAN 29, 2024",BOS vs. NOP,W,35,6,14,0.429,4,10,0.4,1,2,0.5,0,1,1,4,1,1,1,2,17,7,1,BOS,BOS,NOP,118,14.0,Points,22,18,21,5
Derrick White,G,22023,1628401,22300659,"JAN 29, 2024",BOS vs. NOP,W,35,6,14,0.429,4,10,0.4,1,2,0.5,0,1,1,4,1,1,1,2,17,7,1,BOS,BOS,NOP,118,3.5,Rebounds,22,18,21,5
Derrick White,G,22023,1628401,22300659,"JAN 29, 2024",BOS vs. NOP,W,35,6,14,0.429,4,10,0.4,1,2,0.5,0,1,1,4,1,1,1,2,17,7,1,BOS,BOS,NOP,118,21.5,Pts+Rebs+Asts,22,18,21,5
Derrick White,G,22023,1628401,22300659,"JAN 29, 2024",BOS vs. NOP,W,35,6,14,0.429,4,10,0.4,1,2,0.5,0,1,1,4,1,1,1,2,17,7,1,BOS,BOS,NOP,118,4.0,Assists,22,18,21,5
Derrick White,G,22023,1628401,22300659,"JAN 29, 2024",BOS vs. NOP,W,35,6,14,0.429,4,10,0.4,1,2,0.5,0,1,1,4,1,1,1,2,17,7,1,BOS,BOS,NOP,118,27.5,Fantasy Score,22,18,21,5
Derrick White,G,22023,1628401,22300659,"JAN 29, 2024",BOS vs. NOP,W,35,6,14,0.429,4,10,0.4,1,2,0.5,0,1,1,4,1,1,1,2,17,7,1,BOS,BOS,NOP,118,0.5,Offensive Rebounds,22,18,21,5
Derrick White,G,22023,1628401,22300659,"JAN 29, 2024",BOS vs. NOP,W,35,6,14,0.429,4,10,0.4,1,2,0.5,0,1,1,4,1,1,1,2,17,7,1,BOS,BOS,NOP,118,6.5,3-PT Attempted,22,18,21,5
Derrick White,G,22023,1628401,22300659,"JAN 29, 2024",BOS vs. NOP,W,35,6,14,0.429,4,10,0.4,1,2,0.5,0,1,1,4,1,1,1,2,17,7,1,BOS,BOS,NOP,118,17.5,Pts+Rebs,22,18,21,5
Derrick White,G,22023,1628401,22300659,"JAN 29, 2024",BOS vs. NOP,W,35,6,14,0.429,4,10,0.4,1,2,0.5,0,1,1,4,1,1,1,2,17,7,1,BOS,BOS,NOP,118,17.5,Pts+Asts,22,18,21,5
Derrick White,G,22023,1628401,22300659,"JAN 29, 2024",BOS vs. NOP,W,35,6,14,0.429,4,10,0.4,1,2,0.5,0,1,1,4,1,1,1,2,17,7,1,BOS,BOS,NOP,118,7.5,Rebs+Asts,22,18,21,5
Derrick White,G,22023,1628401,22300603,"JAN 21, 2024",BOS @ HOU,W,36,9,19,0.474,3,8,0.375,0,0,0.0,2,9,11,3,0,2,3,2,21,13,1,BOS,HOU,BOS,116,14.0,Points,35,32,24,14
Derrick White,G,22023,1628401,22300603,"JAN 21, 2024",BOS @ HOU,W,36,9,19,0.474,3,8,0.375,0,0,0.0,2,9,11,3,0,2,3,2,21,13,1,BOS,HOU,BOS,116,3.5,Rebounds,35,32,24,14
Derrick White,G,22023,1628401,22300603,"JAN 21, 2024",BOS @ HOU,W,36,9,19,0.474,3,8,0.375,0,0,0.0,2,9,11,3,0,2,3,2,21,13,1,BOS,HOU,BOS,116,21.5,Pts+Rebs+Asts,35,32,24,14
Derrick White,G,22023,1628401,22300603,"JAN 21, 2024",BOS @ HOU,W,36,9,19,0.474,3,8,0.375,0,0,0.0,2,9,11,3,0,2,3,2,21,13,1,BOS,HOU,BOS,116,4.0,Assists,35,32,24,14
Derrick White,G,22023,1628401,22300603,"JAN 21, 2024",BOS @ HOU,W,36,9,19,0.474,3,8,0.375,0,0,0.0,2,9,11,3,0,2,3,2,21,13,1,BOS,HOU,BOS,116,27.5,Fantasy Score,35,32,24,14
Derrick White,G,22023,1628401,22300603,"JAN 21, 2024",BOS @ HOU,W,36,9,19,0.474,3,8,0.375,0,0,0.0,2,9,11,3,0,2,3,2,21,13,1,BOS,HOU,BOS,116,0.5,Offensive Rebounds,35,32,24,14
Derrick White,G,22023,1628401,22300603,"JAN 21, 2024",BOS @ HOU,W,36,9,19,0.474,3,8,0.375,0,0,0.0,2,9,11,3,0,2,3,2,21,13,1,BOS,HOU,BOS,116,6.5,3-PT Attempted,35,32,24,14
Derrick White,G,22023,1628401,22300603,"JAN 21, 2024",BOS @ HOU,W,36,9,19,0.474,3,8,0.375,0,0,0.0,2,9,11,3,0,2,3,2,21,13,1,BOS,HOU,BOS,116,17.5,Pts+Rebs,35,32,24,14
Derrick White,G,22023,1628401,22300603,"JAN 21, 2024",BOS @ HOU,W,36,9,19,0.474,3,8,0.375,0,0,0.0,2,9,11,3,0,2,3,2,21,13,1,BOS,HOU,BOS,116,17.5,Pts+Asts,35,32,24,14
Derrick White,G,22023,1628401,22300603,"JAN 21, 2024",BOS @ HOU,W,36,9,19,0.474,3,8,0.375,0,0,0.0,2,9,11,3,0,2,3,2,21,13,1,BOS,HOU,BOS,116,7.5,Rebs+Asts,35,32,24,14
Derrick White,G,22023,1628401,22300563,"JAN 15, 2024",BOS @ TOR,W,37,7,18,0.389,5,11,0.455,3,3,1.0,0,2,2,1,0,0,3,1,22,-8,1,BOS,TOR,BOS,105,14.0,Points,25,24,23,3
Derrick White,G,22023,1628401,22300563,"JAN 15, 2024",BOS @ TOR,W,37,7,18,0.389,5,11,0.455,3,3,1.0,0,2,2,1,0,0,3,1,22,-8,1,BOS,TOR,BOS,105,3.5,Rebounds,25,24,23,3
Derrick White,G,22023,1628401,22300563,"JAN 15, 2024",BOS @ TOR,W,37,7,18,0.389,5,11,0.455,3,3,1.0,0,2,2,1,0,0,3,1,22,-8,1,BOS,TOR,BOS,105,21.5,Pts+Rebs+Asts,25,24,23,3
Derrick White,G,22023,1628401,22300563,"JAN 15, 2024",BOS @ TOR,W,37,7,18,0.389,5,11,0.455,3,3,1.0,0,2,2,1,0,0,3,1,22,-8,1,BOS,TOR,BOS,105,4.0,Assists,25,24,23,3
Derrick White,G,22023,1628401,22300563,"JAN 15, 2024",BOS @ TOR,W,37,7,18,0.389,5,11,0.455,3,3,1.0,0,2,2,1,0,0,3,1,22,-8,1,BOS,TOR,BOS,105,27.5,Fantasy Score,25,24,23,3
Derrick White,G,22023,1628401,22300563,"JAN 15, 2024",BOS @ TOR,W,37,7,18,0.389,5,11,0.455,3,3,1.0,0,2,2,1,0,0,3,1,22,-8,1,BOS,TOR,BOS,105,0.5,Offensive Rebounds,25,24,23,3
Derrick White,G,22023,1628401,22300563,"JAN 15, 2024",BOS @ TOR,W,37,7,18,0.389,5,11,0.455,3,3,1.0,0,2,2,1,0,0,3,1,22,-8,1,BOS,TOR,BOS,105,6.5,3-PT Attempted,25,24,23,3
Derrick White,G,22023,1628401,22300563,"JAN 15, 2024",BOS @ TOR,W,37,7,18,0.389,5,11,0.455,3,3,1.0,0,2,2,1,0,0,3,1,22,-8,1,BOS,TOR,BOS,105,17.5,Pts+Rebs,25,24,23,3
Derrick White,G,22023,1628401,22300563,"JAN 15, 2024",BOS @ TOR,W,37,7,18,0.389,5,11,0.455,3,3,1.0,0,2,2,1,0,0,3,1,22,-8,1,BOS,TOR,BOS,105,17.5,Pts+Asts,25,24,23,3
Derrick White,G,22023,1628401,22300563,"JAN 15, 2024",BOS @ TOR,W,37,7,18,0.389,5,11,0.455,3,3,1.0,0,2,2,1,0,0,3,1,22,-8,1,BOS,TOR,BOS,105,7.5,Rebs+Asts,25,24,23,3
Derrick White,G,22023,1628401,22300542,"JAN 13, 2024",BOS vs. HOU,W,25,5,9,0.556,3,5,0.6,0,0,0.0,1,2,3,5,2,0,0,1,13,29,1,BOS,BOS,HOU,145,14.0,Points,21,16,18,8
Derrick White,G,22023,1628401,22300542,"JAN 13, 2024",BOS vs. HOU,W,25,5,9,0.556,3,5,0.6,0,0,0.0,1,2,3,5,2,0,0,1,13,29,1,BOS,BOS,HOU,145,3.5,Rebounds,21,16,18,8
Derrick White,G,22023,1628401,22300542,"JAN 13, 2024",BOS vs. HOU,W,25,5,9,0.556,3,5,0.6,0,0,0.0,1,2,3,5,2,0,0,1,13,29,1,BOS,BOS,HOU,145,21.5,Pts+Rebs+Asts,21,16,18,8
Derrick White,G,22023,1628401,22300542,"JAN 13, 2024",BOS vs. HOU,W,25,5,9,0.556,3,5,0.6,0,0,0.0,1,2,3,5,2,0,0,1,13,29,1,BOS,BOS,HOU,145,4.0,Assists,21,16,18,8
Derrick White,G,22023,1628401,22300542,"JAN 13, 2024",BOS vs. HOU,W,25,5,9,0.556,3,5,0.6,0,0,0.0,1,2,3,5,2,0,0,1,13,29,1,BOS,BOS,HOU,145,27.5,Fantasy Score,21,16,18,8
Derrick White,G,22023,1628401,22300542,"JAN 13, 2024",BOS vs. HOU,W,25,5,9,0.556,3,5,0.6,0,0,0.0,1,2,3,5,2,0,0,1,13,29,1,BOS,BOS,HOU,145,0.5,Offensive Rebounds,21,16,18,8
Derrick White,G,22023,1628401,22300542,"JAN 13, 2024",BOS vs. HOU,W,25,5,9,0.556,3,5,0.6,0,0,0.0,1,2,3,5,2,0,0,1,13,29,1,BOS,BOS,HOU,145,6.5,3-PT Attempted,21,16,18,8
Derrick White,G,22023,1628401,22300542,"JAN 13, 2024",BOS vs. HOU,W,25,5,9,0.556,3,5,0.6,0,0,0.0,1,2,3,5,2,0,0,1,13,29,1,BOS,BOS,HOU,145,17.5,Pts+Rebs,21,16,18,8
Derrick White,G,22023,1628401,22300542,"JAN 13, 2024",BOS vs. HOU,W,25,5,9,0.556,3,5,0.6,0,0,0.0,1,2,3,5,2,0,0,1,13,29,1,BOS,BOS,HOU,145,17.5,Pts+Asts,21,16,18,8
Derrick White,G,22023,1628401,22300542,"JAN 13, 2024",BOS vs. HOU,W,25,5,9,0.556,3,5,0.6,0,0,0.0,1,2,3,5,2,0,0,1,13,29,1,BOS,BOS,HOU,145,7.5,Rebs+Asts,21,16,18,8
Derrick White,G,22023,1628401,22300517,"JAN 10, 2024",BOS vs. MIN,W,43,3,11,0.273,1,5,0.2,2,2,1.0,2,4,6,6,0,0,2,5,9,11,1,BOS,BOS,MIN,127,14.0,Points,21,15,15,12
Derrick White,G,22023,1628401,22300517,"JAN 10, 2024",BOS vs. MIN,W,43,3,11,0.273,1,5,0.2,2,2,1.0,2,4,6,6,0,0,2,5,9,11,1,BOS,BOS,MIN,127,3.5,Rebounds,21,15,15,12
Derrick White,G,22023,1628401,22300517,"JAN 10, 2024",BOS vs. MIN,W,43,3,11,0.273,1,5,0.2,2,2,1.0,2,4,6,6,0,0,2,5,9,11,1,BOS,BOS,MIN,127,21.5,Pts+Rebs+Asts,21,15,15,12
Derrick White,G,22023,1628401,22300517,"JAN 10, 2024",BOS vs. MIN,W,43,3,11,0.273,1,5,0.2,2,2,1.0,2,4,6,6,0,0,2,5,9,11,1,BOS,BOS,MIN,127,4.0,Assists,21,15,15,12
Derrick White,G,22023,1628401,22300517,"JAN 10, 2024",BOS vs. MIN,W,43,3,11,0.273,1,5,0.2,2,2,1.0,2,4,6,6,0,0,2,5,9,11,1,BOS,BOS,MIN,127,27.5,Fantasy Score,21,15,15,12
Derrick White,G,22023,1628401,22300517,"JAN 10, 2024",BOS vs. MIN,W,43,3,11,0.273,1,5,0.2,2,2,1.0,2,4,6,6,0,0,2,5,9,11,1,BOS,BOS,MIN,127,0.5,Offensive Rebounds,21,15,15,12
Derrick White,G,22023,1628401,22300517,"JAN 10, 2024",BOS vs. MIN,W,43,3,11,0.273,1,5,0.2,2,2,1.0,2,4,6,6,0,0,2,5,9,11,1,BOS,BOS,MIN,127,6.5,3-PT Attempted,21,15,15,12
Derrick White,G,22023,1628401,22300517,"JAN 10, 2024",BOS vs. MIN,W,43,3,11,0.273,1,5,0.2,2,2,1.0,2,4,6,6,0,0,2,5,9,11,1,BOS,BOS,MIN,127,17.5,Pts+Rebs,21,15,15,12
Derrick White,G,22023,1628401,22300517,"JAN 10, 2024",BOS vs. MIN,W,43,3,11,0.273,1,5,0.2,2,2,1.0,2,4,6,6,0,0,2,5,9,11,1,BOS,BOS,MIN,127,17.5,Pts+Asts,21,15,15,12
Derrick White,G,22023,1628401,22300517,"JAN 10, 2024",BOS vs. MIN,W,43,3,11,0.273,1,5,0.2,2,2,1.0,2,4,6,6,0,0,2,5,9,11,1,BOS,BOS,MIN,127,7.5,Rebs+Asts,21,15,15,12
Derrick White,G,22023,1628401,22300421,"DEC 28, 2023",BOS vs. DET,W,38,9,15,0.6,2,4,0.5,3,3,1.0,1,3,4,5,0,2,2,1,23,8,1,BOS,BOS,DET,128,14.0,Points,32,27,28,9
Derrick White,G,22023,1628401,22300421,"DEC 28, 2023",BOS vs. DET,W,38,9,15,0.6,2,4,0.5,3,3,1.0,1,3,4,5,0,2,2,1,23,8,1,BOS,BOS,DET,128,3.5,Rebounds,32,27,28,9
Derrick White,G,22023,1628401,22300421,"DEC 28, 2023",BOS vs. DET,W,38,9,15,0.6,2,4,0.5,3,3,1.0,1,3,4,5,0,2,2,1,23,8,1,BOS,BOS,DET,128,21.5,Pts+Rebs+Asts,32,27,28,9
Derrick White,G,22023,1628401,22300421,"DEC 28, 2023",BOS vs. DET,W,38,9,15,0.6,2,4,0.5,3,3,1.0,1,3,4,5,0,2,2,1,23,8,1,BOS,BOS,DET,128,4.0,Assists,32,27,28,9
Derrick White,G,22023,1628401,22300421,"DEC 28, 2023",BOS vs. DET,W,38,9,15,0.6,2,4,0.5,3,3,1.0,1,3,4,5,0,2,2,1,23,8,1,BOS,BOS,DET,128,27.5,Fantasy Score,32,27,28,9
Derrick White,G,22023,1628401,22300421,"DEC 28, 2023",BOS vs. DET,W,38,9,15,0.6,2,4,0.5,3,3,1.0,1,3,4,5,0,2,2,1,23,8,1,BOS,BOS,DET,128,0.5,Offensive Rebounds,32,27,28,9
Derrick White,G,22023,1628401,22300421,"DEC 28, 2023",BOS vs. DET,W,38,9,15,0.6,2,4,0.5,3,3,1.0,1,3,4,5,0,2,2,1,23,8,1,BOS,BOS,DET,128,6.5,3-PT Attempted,32,27,28,9
Derrick White,G,22023,1628401,22300421,"DEC 28, 2023",BOS vs. DET,W,38,9,15,0.6,2,4,0.5,3,3,1.0,1,3,4,5,0,2,2,1,23,8,1,BOS,BOS,DET,128,17.5,Pts+Rebs,32,27,28,9
Derrick White,G,22023,1628401,22300421,"DEC 28, 2023",BOS vs. DET,W,38,9,15,0.6,2,4,0.5,3,3,1.0,1,3,4,5,0,2,2,1,23,8,1,BOS,BOS,DET,128,17.5,Pts+Asts,32,27,28,9
Derrick White,G,22023,1628401,22300421,"DEC 28, 2023",BOS vs. DET,W,38,9,15,0.6,2,4,0.5,3,3,1.0,1,3,4,5,0,2,2,1,23,8,1,BOS,BOS,DET,128,7.5,Rebs+Asts,32,27,28,9
Derrick White,G,22023,1628401,22300373,"DEC 20, 2023",BOS @ SAC,W,29,10,13,0.769,6,9,0.667,2,3,0.667,1,1,2,7,1,3,1,1,28,16,1,BOS,SAC,BOS,144,14.0,Points,37,30,35,9
Derrick White,G,22023,1628401,22300373,"DEC 20, 2023",BOS @ SAC,W,29,10,13,0.769,6,9,0.667,2,3,0.667,1,1,2,7,1,3,1,1,28,16,1,BOS,SAC,BOS,144,3.5,Rebounds,37,30,35,9
Derrick White,G,22023,1628401,22300373,"DEC 20, 2023",BOS @ SAC,W,29,10,13,0.769,6,9,0.667,2,3,0.667,1,1,2,7,1,3,1,1,28,16,1,BOS,SAC,BOS,144,21.5,Pts+Rebs+Asts,37,30,35,9
Derrick White,G,22023,1628401,22300373,"DEC 20, 2023",BOS @ SAC,W,29,10,13,0.769,6,9,0.667,2,3,0.667,1,1,2,7,1,3,1,1,28,16,1,BOS,SAC,BOS,144,4.0,Assists,37,30,35,9
Derrick White,G,22023,1628401,22300373,"DEC 20, 2023",BOS @ SAC,W,29,10,13,0.769,6,9,0.667,2,3,0.667,1,1,2,7,1,3,1,1,28,16,1,BOS,SAC,BOS,144,27.5,Fantasy Score,37,30,35,9
Derrick White,G,22023,1628401,22300373,"DEC 20, 2023",BOS @ SAC,W,29,10,13,0.769,6,9,0.667,2,3,0.667,1,1,2,7,1,3,1,1,28,16,1,BOS,SAC,BOS,144,0.5,Offensive Rebounds,37,30,35,9
Derrick White,G,22023,1628401,22300373,"DEC 20, 2023",BOS @ SAC,W,29,10,13,0.769,6,9,0.667,2,3,0.667,1,1,2,7,1,3,1,1,28,16,1,BOS,SAC,BOS,144,6.5,3-PT Attempted,37,30,35,9
Derrick White,G,22023,1628401,22300373,"DEC 20, 2023",BOS @ SAC,W,29,10,13,0.769,6,9,0.667,2,3,0.667,1,1,2,7,1,3,1,1,28,16,1,BOS,SAC,BOS,144,17.5,Pts+Rebs,37,30,35,9
Derrick White,G,22023,1628401,22300373,"DEC 20, 2023",BOS @ SAC,W,29,10,13,0.769,6,9,0.667,2,3,0.667,1,1,2,7,1,3,1,1,28,16,1,BOS,SAC,BOS,144,17.5,Pts+Asts,37,30,35,9
Derrick White,G,22023,1628401,22300373,"DEC 20, 2023",BOS @ SAC,W,29,10,13,0.769,6,9,0.667,2,3,0.667,1,1,2,7,1,3,1,1,28,16,1,BOS,SAC,BOS,144,7.5,Rebs+Asts,37,30,35,9
Derrick White,G,22023,1628401,22300362,"DEC 19, 2023",BOS @ GSW,L,40,11,24,0.458,7,18,0.389,1,2,0.5,2,5,7,3,0,3,0,2,30,-1,1,BOS,GSW,BOS,126,14.0,Points,40,37,33,10
Derrick White,G,22023,1628401,22300362,"DEC 19, 2023",BOS @ GSW,L,40,11,24,0.458,7,18,0.389,1,2,0.5,2,5,7,3,0,3,0,2,30,-1,1,BOS,GSW,BOS,126,3.5,Rebounds,40,37,33,10
Derrick White,G,22023,1628401,22300362,"DEC 19, 2023",BOS @ GSW,L,40,11,24,0.458,7,18,0.389,1,2,0.5,2,5,7,3,0,3,0,2,30,-1,1,BOS,GSW,BOS,126,21.5,Pts+Rebs+Asts,40,37,33,10
Derrick White,G,22023,1628401,22300362,"DEC 19, 2023",BOS @ GSW,L,40,11,24,0.458,7,18,0.389,1,2,0.5,2,5,7,3,0,3,0,2,30,-1,1,BOS,GSW,BOS,126,4.0,Assists,40,37,33,10
Derrick White,G,22023,1628401,22300362,"DEC 19, 2023",BOS @ GSW,L,40,11,24,0.458,7,18,0.389,1,2,0.5,2,5,7,3,0,3,0,2,30,-1,1,BOS,GSW,BOS,126,27.5,Fantasy Score,40,37,33,10
Derrick White,G,22023,1628401,22300362,"DEC 19, 2023",BOS @ GSW,L,40,11,24,0.458,7,18,0.389,1,2,0.5,2,5,7,3,0,3,0,2,30,-1,1,BOS,GSW,BOS,126,0.5,Offensive Rebounds,40,37,33,10
Derrick White,G,22023,1628401,22300362,"DEC 19, 2023",BOS @ GSW,L,40,11,24,0.458,7,18,0.389,1,2,0.5,2,5,7,3,0,3,0,2,30,-1,1,BOS,GSW,BOS,126,6.5,3-PT Attempted,40,37,33,10
Derrick White,G,22023,1628401,22300362,"DEC 19, 2023",BOS @ GSW,L,40,11,24,0.458,7,18,0.389,1,2,0.5,2,5,7,3,0,3,0,2,30,-1,1,BOS,GSW,BOS,126,17.5,Pts+Rebs,40,37,33,10
Derrick White,G,22023,1628401,22300362,"DEC 19, 2023",BOS @ GSW,L,40,11,24,0.458,7,18,0.389,1,2,0.5,2,5,7,3,0,3,0,2,30,-1,1,BOS,GSW,BOS,126,17.5,Pts+Asts,40,37,33,10
Derrick White,G,22023,1628401,22300362,"DEC 19, 2023",BOS @ GSW,L,40,11,24,0.458,7,18,0.389,1,2,0.5,2,5,7,3,0,3,0,2,30,-1,1,BOS,GSW,BOS,126,7.5,Rebs+Asts,40,37,33,10
Derrick White,G,22023,1628401,22300329,"DEC 15, 2023",BOS vs. ORL,W,30,7,15,0.467,3,7,0.429,2,2,1.0,1,3,4,8,4,1,1,0,19,13,1,BOS,BOS,ORL,128,14.0,Points,31,23,27,12
Derrick White,G,22023,1628401,22300329,"DEC 15, 2023",BOS vs. ORL,W,30,7,15,0.467,3,7,0.429,2,2,1.0,1,3,4,8,4,1,1,0,19,13,1,BOS,BOS,ORL,128,3.5,Rebounds,31,23,27,12
Derrick White,G,22023,1628401,22300329,"DEC 15, 2023",BOS vs. ORL,W,30,7,15,0.467,3,7,0.429,2,2,1.0,1,3,4,8,4,1,1,0,19,13,1,BOS,BOS,ORL,128,21.5,Pts+Rebs+Asts,31,23,27,12
Derrick White,G,22023,1628401,22300329,"DEC 15, 2023",BOS vs. ORL,W,30,7,15,0.467,3,7,0.429,2,2,1.0,1,3,4,8,4,1,1,0,19,13,1,BOS,BOS,ORL,128,4.0,Assists,31,23,27,12
Derrick White,G,22023,1628401,22300329,"DEC 15, 2023",BOS vs. ORL,W,30,7,15,0.467,3,7,0.429,2,2,1.0,1,3,4,8,4,1,1,0,19,13,1,BOS,BOS,ORL,128,27.5,Fantasy Score,31,23,27,12
Derrick White,G,22023,1628401,22300329,"DEC 15, 2023",BOS vs. ORL,W,30,7,15,0.467,3,7,0.429,2,2,1.0,1,3,4,8,4,1,1,0,19,13,1,BOS,BOS,ORL,128,0.5,Offensive Rebounds,31,23,27,12
Derrick White,G,22023,1628401,22300329,"DEC 15, 2023",BOS vs. ORL,W,30,7,15,0.467,3,7,0.429,2,2,1.0,1,3,4,8,4,1,1,0,19,13,1,BOS,BOS,ORL,128,6.5,3-PT Attempted,31,23,27,12
Derrick White,G,22023,1628401,22300329,"DEC 15, 2023",BOS vs. ORL,W,30,7,15,0.467,3,7,0.429,2,2,1.0,1,3,4,8,4,1,1,0,19,13,1,BOS,BOS,ORL,128,17.5,Pts+Rebs,31,23,27,12
Derrick White,G,22023,1628401,22300329,"DEC 15, 2023",BOS vs. ORL,W,30,7,15,0.467,3,7,0.429,2,2,1.0,1,3,4,8,4,1,1,0,19,13,1,BOS,BOS,ORL,128,17.5,Pts+Asts,31,23,27,12
Derrick White,G,22023,1628401,22300329,"DEC 15, 2023",BOS vs. ORL,W,30,7,15,0.467,3,7,0.429,2,2,1.0,1,3,4,8,4,1,1,0,19,13,1,BOS,BOS,ORL,128,7.5,Rebs+Asts,31,23,27,12
Derrick White,G,22023,1628401,22300080,"OCT 27, 2023",BOS vs. MIA,W,36,9,15,0.6,5,7,0.714,5,6,0.833,3,3,6,3,1,3,2,1,28,4,1,BOS,BOS,MIA,119,14.0,Points,37,34,31,9
Derrick White,G,22023,1628401,22300080,"OCT 27, 2023",BOS vs. MIA,W,36,9,15,0.6,5,7,0.714,5,6,0.833,3,3,6,3,1,3,2,1,28,4,1,BOS,BOS,MIA,119,3.5,Rebounds,37,34,31,9
Derrick White,G,22023,1628401,22300080,"OCT 27, 2023",BOS vs. MIA,W,36,9,15,0.6,5,7,0.714,5,6,0.833,3,3,6,3,1,3,2,1,28,4,1,BOS,BOS,MIA,119,21.5,Pts+Rebs+Asts,37,34,31,9
Derrick White,G,22023,1628401,22300080,"OCT 27, 2023",BOS vs. MIA,W,36,9,15,0.6,5,7,0.714,5,6,0.833,3,3,6,3,1,3,2,1,28,4,1,BOS,BOS,MIA,119,4.0,Assists,37,34,31,9
Derrick White,G,22023,1628401,22300080,"OCT 27, 2023",BOS vs. MIA,W,36,9,15,0.6,5,7,0.714,5,6,0.833,3,3,6,3,1,3,2,1,28,4,1,BOS,BOS,MIA,119,27.5,Fantasy Score,37,34,31,9
Derrick White,G,22023,1628401,22300080,"OCT 27, 2023",BOS vs. MIA,W,36,9,15,0.6,5,7,0.714,5,6,0.833,3,3,6,3,1,3,2,1,28,4,1,BOS,BOS,MIA,119,0.5,Offensive Rebounds,37,34,31,9
Derrick White,G,22023,1628401,22300080,"OCT 27, 2023",BOS vs. MIA,W,36,9,15,0.6,5,7,0.714,5,6,0.833,3,3,6,3,1,3,2,1,28,4,1,BOS,BOS,MIA,119,6.5,3-PT Attempted,37,34,31,9
Derrick White,G,22023,1628401,22300080,"OCT 27, 2023",BOS vs. MIA,W,36,9,15,0.6,5,7,0.714,5,6,0.833,3,3,6,3,1,3,2,1,28,4,1,BOS,BOS,MIA,119,17.5,Pts+Rebs,37,34,31,9
Derrick White,G,22023,1628401,22300080,"OCT 27, 2023",BOS vs. MIA,W,36,9,15,0.6,5,7,0.714,5,6,0.833,3,3,6,3,1,3,2,1,28,4,1,BOS,BOS,MIA,119,17.5,Pts+Asts,37,34,31,9
Derrick White,G,22023,1628401,22300080,"OCT 27, 2023",BOS vs. MIA,W,36,9,15,0.6,5,7,0.714,5,6,0.833,3,3,6,3,1,3,2,1,28,4,1,BOS,BOS,MIA,119,7.5,Rebs+Asts,37,34,31,9
Derrick White,G,22023,1628401,22300743,"FEB 09, 2024",BOS vs. WAS,W,33,2,6,0.333,0,4,0.0,0,0,0.0,0,2,2,6,3,1,3,4,4,-3,1,BOS,BOS,WAS,133,14.0,Points,12,6,10,8
Derrick White,G,22023,1628401,22300743,"FEB 09, 2024",BOS vs. WAS,W,33,2,6,0.333,0,4,0.0,0,0,0.0,0,2,2,6,3,1,3,4,4,-3,1,BOS,BOS,WAS,133,3.5,Rebounds,12,6,10,8
Derrick White,G,22023,1628401,22300743,"FEB 09, 2024",BOS vs. WAS,W,33,2,6,0.333,0,4,0.0,0,0,0.0,0,2,2,6,3,1,3,4,4,-3,1,BOS,BOS,WAS,133,21.5,Pts+Rebs+Asts,12,6,10,8
Derrick White,G,22023,1628401,22300743,"FEB 09, 2024",BOS vs. WAS,W,33,2,6,0.333,0,4,0.0,0,0,0.0,0,2,2,6,3,1,3,4,4,-3,1,BOS,BOS,WAS,133,4.0,Assists,12,6,10,8
Derrick White,G,22023,1628401,22300743,"FEB 09, 2024",BOS vs. WAS,W,33,2,6,0.333,0,4,0.0,0,0,0.0,0,2,2,6,3,1,3,4,4,-3,1,BOS,BOS,WAS,133,27.5,Fantasy Score,12,6,10,8
Derrick White,G,22023,1628401,22300743,"FEB 09, 2024",BOS vs. WAS,W,33,2,6,0.333,0,4,0.0,0,0,0.0,0,2,2,6,3,1,3,4,4,-3,1,BOS,BOS,WAS,133,0.5,Offensive Rebounds,12,6,10,8
Derrick White,G,22023,1628401,22300743,"FEB 09, 2024",BOS vs. WAS,W,33,2,6,0.333,0,4,0.0,0,0,0.0,0,2,2,6,3,1,3,4,4,-3,1,BOS,BOS,WAS,133,6.5,3-PT Attempted,12,6,10,8
Derrick White,G,22023,1628401,22300743,"FEB 09, 2024",BOS vs. WAS,W,33,2,6,0.333,0,4,0.0,0,0,0.0,0,2,2,6,3,1,3,4,4,-3,1,BOS,BOS,WAS,133,17.5,Pts+Rebs,12,6,10,8
Derrick White,G,22023,1628401,22300743,"FEB 09, 2024",BOS vs. WAS,W,33,2,6,0.333,0,4,0.0,0,0,0.0,0,2,2,6,3,1,3,4,4,-3,1,BOS,BOS,WAS,133,17.5,Pts+Asts,12,6,10,8
Derrick White,G,22023,1628401,22300743,"FEB 09, 2024",BOS vs. WAS,W,33,2,6,0.333,0,4,0.0,0,0,0.0,0,2,2,6,3,1,3,4,4,-3,1,BOS,BOS,WAS,133,7.5,Rebs+Asts,12,6,10,8
Derrick White,G,22023,1628401,22300611,"JAN 22, 2024",BOS @ DAL,W,34,2,12,0.167,1,7,0.143,1,2,0.5,0,4,4,1,2,1,1,3,6,-11,1,BOS,DAL,BOS,119,14.0,Points,11,10,7,5
Derrick White,G,22023,1628401,22300611,"JAN 22, 2024",BOS @ DAL,W,34,2,12,0.167,1,7,0.143,1,2,0.5,0,4,4,1,2,1,1,3,6,-11,1,BOS,DAL,BOS,119,3.5,Rebounds,11,10,7,5
Derrick White,G,22023,1628401,22300611,"JAN 22, 2024",BOS @ DAL,W,34,2,12,0.167,1,7,0.143,1,2,0.5,0,4,4,1,2,1,1,3,6,-11,1,BOS,DAL,BOS,119,21.5,Pts+Rebs+Asts,11,10,7,5
Derrick White,G,22023,1628401,22300611,"JAN 22, 2024",BOS @ DAL,W,34,2,12,0.167,1,7,0.143,1,2,0.5,0,4,4,1,2,1,1,3,6,-11,1,BOS,DAL,BOS,119,4.0,Assists,11,10,7,5
Derrick White,G,22023,1628401,22300611,"JAN 22, 2024",BOS @ DAL,W,34,2,12,0.167,1,7,0.143,1,2,0.5,0,4,4,1,2,1,1,3,6,-11,1,BOS,DAL,BOS,119,27.5,Fantasy Score,11,10,7,5
Derrick White,G,22023,1628401,22300611,"JAN 22, 2024",BOS @ DAL,W,34,2,12,0.167,1,7,0.143,1,2,0.5,0,4,4,1,2,1,1,3,6,-11,1,BOS,DAL,BOS,119,0.5,Offensive Rebounds,11,10,7,5
Derrick White,G,22023,1628401,22300611,"JAN 22, 2024",BOS @ DAL,W,34,2,12,0.167,1,7,0.143,1,2,0.5,0,4,4,1,2,1,1,3,6,-11,1,BOS,DAL,BOS,119,6.5,3-PT Attempted,11,10,7,5
Derrick White,G,22023,1628401,22300611,"JAN 22, 2024",BOS @ DAL,W,34,2,12,0.167,1,7,0.143,1,2,0.5,0,4,4,1,2,1,1,3,6,-11,1,BOS,DAL,BOS,119,17.5,Pts+Rebs,11,10,7,5
Derrick White,G,22023,1628401,22300611,"JAN 22, 2024",BOS @ DAL,W,34,2,12,0.167,1,7,0.143,1,2,0.5,0,4,4,1,2,1,1,3,6,-11,1,BOS,DAL,BOS,119,17.5,Pts+Asts,11,10,7,5
Derrick White,G,22023,1628401,22300611,"JAN 22, 2024",BOS @ DAL,W,34,2,12,0.167,1,7,0.143,1,2,0.5,0,4,4,1,2,1,1,3,6,-11,1,BOS,DAL,BOS,119,7.5,Rebs+Asts,11,10,7,5
Derrick White,G,22023,1628401,22300586,"JAN 19, 2024",BOS vs. DEN,L,36,9,18,0.5,5,12,0.417,1,1,1.0,1,2,3,5,2,1,1,3,24,-2,1,BOS,BOS,DEN,100,14.0,Points,32,27,29,8
Derrick White,G,22023,1628401,22300586,"JAN 19, 2024",BOS vs. DEN,L,36,9,18,0.5,5,12,0.417,1,1,1.0,1,2,3,5,2,1,1,3,24,-2,1,BOS,BOS,DEN,100,3.5,Rebounds,32,27,29,8
Derrick White,G,22023,1628401,22300586,"JAN 19, 2024",BOS vs. DEN,L,36,9,18,0.5,5,12,0.417,1,1,1.0,1,2,3,5,2,1,1,3,24,-2,1,BOS,BOS,DEN,100,21.5,Pts+Rebs+Asts,32,27,29,8
Derrick White,G,22023,1628401,22300586,"JAN 19, 2024",BOS vs. DEN,L,36,9,18,0.5,5,12,0.417,1,1,1.0,1,2,3,5,2,1,1,3,24,-2,1,BOS,BOS,DEN,100,4.0,Assists,32,27,29,8
Derrick White,G,22023,1628401,22300586,"JAN 19, 2024",BOS vs. DEN,L,36,9,18,0.5,5,12,0.417,1,1,1.0,1,2,3,5,2,1,1,3,24,-2,1,BOS,BOS,DEN,100,27.5,Fantasy Score,32,27,29,8
Derrick White,G,22023,1628401,22300586,"JAN 19, 2024",BOS vs. DEN,L,36,9,18,0.5,5,12,0.417,1,1,1.0,1,2,3,5,2,1,1,3,24,-2,1,BOS,BOS,DEN,100,0.5,Offensive Rebounds,32,27,29,8
Derrick White,G,22023,1628401,22300586,"JAN 19, 2024",BOS vs. DEN,L,36,9,18,0.5,5,12,0.417,1,1,1.0,1,2,3,5,2,1,1,3,24,-2,1,BOS,BOS,DEN,100,6.5,3-PT Attempted,32,27,29,8
Derrick White,G,22023,1628401,22300586,"JAN 19, 2024",BOS vs. DEN,L,36,9,18,0.5,5,12,0.417,1,1,1.0,1,2,3,5,2,1,1,3,24,-2,1,BOS,BOS,DEN,100,17.5,Pts+Rebs,32,27,29,8
Derrick White,G,22023,1628401,22300586,"JAN 19, 2024",BOS vs. DEN,L,36,9,18,0.5,5,12,0.417,1,1,1.0,1,2,3,5,2,1,1,3,24,-2,1,BOS,BOS,DEN,100,17.5,Pts+Asts,32,27,29,8
Derrick White,G,22023,1628401,22300586,"JAN 19, 2024",BOS vs. DEN,L,36,9,18,0.5,5,12,0.417,1,1,1.0,1,2,3,5,2,1,1,3,24,-2,1,BOS,BOS,DEN,100,7.5,Rebs+Asts,32,27,29,8
Derrick White,G,22023,1628401,22300462,"JAN 02, 2024",BOS @ OKC,L,29,7,12,0.583,5,9,0.556,0,0,0.0,0,5,5,6,1,1,2,4,19,5,1,BOS,OKC,BOS,123,14.0,Points,30,24,25,11
Derrick White,G,22023,1628401,22300462,"JAN 02, 2024",BOS @ OKC,L,29,7,12,0.583,5,9,0.556,0,0,0.0,0,5,5,6,1,1,2,4,19,5,1,BOS,OKC,BOS,123,3.5,Rebounds,30,24,25,11
Derrick White,G,22023,1628401,22300462,"JAN 02, 2024",BOS @ OKC,L,29,7,12,0.583,5,9,0.556,0,0,0.0,0,5,5,6,1,1,2,4,19,5,1,BOS,OKC,BOS,123,21.5,Pts+Rebs+Asts,30,24,25,11
Derrick White,G,22023,1628401,22300462,"JAN 02, 2024",BOS @ OKC,L,29,7,12,0.583,5,9,0.556,0,0,0.0,0,5,5,6,1,1,2,4,19,5,1,BOS,OKC,BOS,123,4.0,Assists,30,24,25,11
Derrick White,G,22023,1628401,22300462,"JAN 02, 2024",BOS @ OKC,L,29,7,12,0.583,5,9,0.556,0,0,0.0,0,5,5,6,1,1,2,4,19,5,1,BOS,OKC,BOS,123,27.5,Fantasy Score,30,24,25,11
Derrick White,G,22023,1628401,22300462,"JAN 02, 2024",BOS @ OKC,L,29,7,12,0.583,5,9,0.556,0,0,0.0,0,5,5,6,1,1,2,4,19,5,1,BOS,OKC,BOS,123,0.5,Offensive Rebounds,30,24,25,11
Derrick White,G,22023,1628401,22300462,"JAN 02, 2024",BOS @ OKC,L,29,7,12,0.583,5,9,0.556,0,0,0.0,0,5,5,6,1,1,2,4,19,5,1,BOS,OKC,BOS,123,6.5,3-PT Attempted,30,24,25,11
Derrick White,G,22023,1628401,22300462,"JAN 02, 2024",BOS @ OKC,L,29,7,12,0.583,5,9,0.556,0,0,0.0,0,5,5,6,1,1,2,4,19,5,1,BOS,OKC,BOS,123,17.5,Pts+Rebs,30,24,25,11
Derrick White,G,22023,1628401,22300462,"JAN 02, 2024",BOS @ OKC,L,29,7,12,0.583,5,9,0.556,0,0,0.0,0,5,5,6,1,1,2,4,19,5,1,BOS,OKC,BOS,123,17.5,Pts+Asts,30,24,25,11
Derrick White,G,22023,1628401,22300462,"JAN 02, 2024",BOS @ OKC,L,29,7,12,0.583,5,9,0.556,0,0,0.0,0,5,5,6,1,1,2,4,19,5,1,BOS,OKC,BOS,123,7.5,Rebs+Asts,30,24,25,11
Derrick White,G,22023,1628401,22300403,"DEC 25, 2023",BOS @ LAL,W,35,8,13,0.615,2,4,0.5,0,0,0.0,0,2,2,11,2,2,2,3,18,16,1,BOS,LAL,BOS,126,14.0,Points,31,20,29,13
Derrick White,G,22023,1628401,22300403,"DEC 25, 2023",BOS @ LAL,W,35,8,13,0.615,2,4,0.5,0,0,0.0,0,2,2,11,2,2,2,3,18,16,1,BOS,LAL,BOS,126,3.5,Rebounds,31,20,29,13
Derrick White,G,22023,1628401,22300403,"DEC 25, 2023",BOS @ LAL,W,35,8,13,0.615,2,4,0.5,0,0,0.0,0,2,2,11,2,2,2,3,18,16,1,BOS,LAL,BOS,126,21.5,Pts+Rebs+Asts,31,20,29,13
Derrick White,G,22023,1628401,22300403,"DEC 25, 2023",BOS @ LAL,W,35,8,13,0.615,2,4,0.5,0,0,0.0,0,2,2,11,2,2,2,3,18,16,1,BOS,LAL,BOS,126,4.0,Assists,31,20,29,13
Derrick White,G,22023,1628401,22300403,"DEC 25, 2023",BOS @ LAL,W,35,8,13,0.615,2,4,0.5,0,0,0.0,0,2,2,11,2,2,2,3,18,16,1,BOS,LAL,BOS,126,27.5,Fantasy Score,31,20,29,13
Derrick White,G,22023,1628401,22300403,"DEC 25, 2023",BOS @ LAL,W,35,8,13,0.615,2,4,0.5,0,0,0.0,0,2,2,11,2,2,2,3,18,16,1,BOS,LAL,BOS,126,0.5,Offensive Rebounds,31,20,29,13
Derrick White,G,22023,1628401,22300403,"DEC 25, 2023",BOS @ LAL,W,35,8,13,0.615,2,4,0.5,0,0,0.0,0,2,2,11,2,2,2,3,18,16,1,BOS,LAL,BOS,126,6.5,3-PT Attempted,31,20,29,13
Derrick White,G,22023,1628401,22300403,"DEC 25, 2023",BOS @ LAL,W,35,8,13,0.615,2,4,0.5,0,0,0.0,0,2,2,11,2,2,2,3,18,16,1,BOS,LAL,BOS,126,17.5,Pts+Rebs,31,20,29,13
Derrick White,G,22023,1628401,22300403,"DEC 25, 2023",BOS @ LAL,W,35,8,13,0.615,2,4,0.5,0,0,0.0,0,2,2,11,2,2,2,3,18,16,1,BOS,LAL,BOS,126,17.5,Pts+Asts,31,20,29,13
Derrick White,G,22023,1628401,22300403,"DEC 25, 2023",BOS @ LAL,W,35,8,13,0.615,2,4,0.5,0,0,0.0,0,2,2,11,2,2,2,3,18,16,1,BOS,LAL,BOS,126,7.5,Rebs+Asts,31,20,29,13
Derrick White,G,22023,1628401,22300319,"DEC 14, 2023",BOS vs. CLE,W,35,5,10,0.5,2,4,0.5,2,2,1.0,2,3,5,3,3,0,3,0,14,9,1,BOS,BOS,CLE,116,14.0,Points,22,19,17,8
Derrick White,G,22023,1628401,22300319,"DEC 14, 2023",BOS vs. CLE,W,35,5,10,0.5,2,4,0.5,2,2,1.0,2,3,5,3,3,0,3,0,14,9,1,BOS,BOS,CLE,116,3.5,Rebounds,22,19,17,8
Derrick White,G,22023,1628401,22300319,"DEC 14, 2023",BOS vs. CLE,W,35,5,10,0.5,2,4,0.5,2,2,1.0,2,3,5,3,3,0,3,0,14,9,1,BOS,BOS,CLE,116,21.5,Pts+Rebs+Asts,22,19,17,8
Derrick White,G,22023,1628401,22300319,"DEC 14, 2023",BOS vs. CLE,W,35,5,10,0.5,2,4,0.5,2,2,1.0,2,3,5,3,3,0,3,0,14,9,1,BOS,BOS,CLE,116,4.0,Assists,22,19,17,8
Derrick White,G,22023,1628401,22300319,"DEC 14, 2023",BOS vs. CLE,W,35,5,10,0.5,2,4,0.5,2,2,1.0,2,3,5,3,3,0,3,0,14,9,1,BOS,BOS,CLE,116,27.5,Fantasy Score,22,19,17,8
Derrick White,G,22023,1628401,22300319,"DEC 14, 2023",BOS vs. CLE,W,35,5,10,0.5,2,4,0.5,2,2,1.0,2,3,5,3,3,0,3,0,14,9,1,BOS,BOS,CLE,116,0.5,Offensive Rebounds,22,19,17,8
Derrick White,G,22023,1628401,22300319,"DEC 14, 2023",BOS vs. CLE,W,35,5,10,0.5,2,4,0.5,2,2,1.0,2,3,5,3,3,0,3,0,14,9,1,BOS,BOS,CLE,116,6.5,3-PT Attempted,22,19,17,8
Derrick White,G,22023,1628401,22300319,"DEC 14, 2023",BOS vs. CLE,W,35,5,10,0.5,2,4,0.5,2,2,1.0,2,3,5,3,3,0,3,0,14,9,1,BOS,BOS,CLE,116,17.5,Pts+Rebs,22,19,17,8
Derrick White,G,22023,1628401,22300319,"DEC 14, 2023",BOS vs. CLE,W,35,5,10,0.5,2,4,0.5,2,2,1.0,2,3,5,3,3,0,3,0,14,9,1,BOS,BOS,CLE,116,17.5,Pts+Asts,22,19,17,8
Derrick White,G,22023,1628401,22300319,"DEC 14, 2023",BOS vs. CLE,W,35,5,10,0.5,2,4,0.5,2,2,1.0,2,3,5,3,3,0,3,0,14,9,1,BOS,BOS,CLE,116,7.5,Rebs+Asts,22,19,17,8
Derrick White,G,22023,1628401,22300305,"DEC 12, 2023",BOS vs. CLE,W,37,5,9,0.556,5,8,0.625,2,2,1.0,0,4,4,4,1,2,1,3,17,-6,1,BOS,BOS,CLE,120,14.0,Points,25,21,21,8
Derrick White,G,22023,1628401,22300305,"DEC 12, 2023",BOS vs. CLE,W,37,5,9,0.556,5,8,0.625,2,2,1.0,0,4,4,4,1,2,1,3,17,-6,1,BOS,BOS,CLE,120,3.5,Rebounds,25,21,21,8
Derrick White,G,22023,1628401,22300305,"DEC 12, 2023",BOS vs. CLE,W,37,5,9,0.556,5,8,0.625,2,2,1.0,0,4,4,4,1,2,1,3,17,-6,1,BOS,BOS,CLE,120,21.5,Pts+Rebs+Asts,25,21,21,8
Derrick White,G,22023,1628401,22300305,"DEC 12, 2023",BOS vs. CLE,W,37,5,9,0.556,5,8,0.625,2,2,1.0,0,4,4,4,1,2,1,3,17,-6,1,BOS,BOS,CLE,120,4.0,Assists,25,21,21,8
Derrick White,G,22023,1628401,22300305,"DEC 12, 2023",BOS vs. CLE,W,37,5,9,0.556,5,8,0.625,2,2,1.0,0,4,4,4,1,2,1,3,17,-6,1,BOS,BOS,CLE,120,27.5,Fantasy Score,25,21,21,8
Derrick White,G,22023,1628401,22300305,"DEC 12, 2023",BOS vs. CLE,W,37,5,9,0.556,5,8,0.625,2,2,1.0,0,4,4,4,1,2,1,3,17,-6,1,BOS,BOS,CLE,120,0.5,Offensive Rebounds,25,21,21,8
Derrick White,G,22023,1628401,22300305,"DEC 12, 2023",BOS vs. CLE,W,37,5,9,0.556,5,8,0.625,2,2,1.0,0,4,4,4,1,2,1,3,17,-6,1,BOS,BOS,CLE,120,6.5,3-PT Attempted,25,21,21,8
Derrick White,G,22023,1628401,22300305,"DEC 12, 2023",BOS vs. CLE,W,37,5,9,0.556,5,8,0.625,2,2,1.0,0,4,4,4,1,2,1,3,17,-6,1,BOS,BOS,CLE,120,17.5,Pts+Rebs,25,21,21,8
Derrick White,G,22023,1628401,22300305,"DEC 12, 2023",BOS vs. CLE,W,37,5,9,0.556,5,8,0.625,2,2,1.0,0,4,4,4,1,2,1,3,17,-6,1,BOS,BOS,CLE,120,17.5,Pts+Asts,25,21,21,8
Derrick White,G,22023,1628401,22300305,"DEC 12, 2023",BOS vs. CLE,W,37,5,9,0.556,5,8,0.625,2,2,1.0,0,4,4,4,1,2,1,3,17,-6,1,BOS,BOS,CLE,120,7.5,Rebs+Asts,25,21,21,8
Derrick White,G,22023,1628401,22300228,"NOV 22, 2023",BOS vs. MIL,W,35,5,9,0.556,3,6,0.5,0,0,0.0,0,4,4,5,1,1,6,1,13,-3,1,BOS,BOS,MIL,119,14.0,Points,22,17,18,9
Derrick White,G,22023,1628401,22300228,"NOV 22, 2023",BOS vs. MIL,W,35,5,9,0.556,3,6,0.5,0,0,0.0,0,4,4,5,1,1,6,1,13,-3,1,BOS,BOS,MIL,119,3.5,Rebounds,22,17,18,9
Derrick White,G,22023,1628401,22300228,"NOV 22, 2023",BOS vs. MIL,W,35,5,9,0.556,3,6,0.5,0,0,0.0,0,4,4,5,1,1,6,1,13,-3,1,BOS,BOS,MIL,119,21.5,Pts+Rebs+Asts,22,17,18,9
Derrick White,G,22023,1628401,22300228,"NOV 22, 2023",BOS vs. MIL,W,35,5,9,0.556,3,6,0.5,0,0,0.0,0,4,4,5,1,1,6,1,13,-3,1,BOS,BOS,MIL,119,4.0,Assists,22,17,18,9
Derrick White,G,22023,1628401,22300228,"NOV 22, 2023",BOS vs. MIL,W,35,5,9,0.556,3,6,0.5,0,0,0.0,0,4,4,5,1,1,6,1,13,-3,1,BOS,BOS,MIL,119,27.5,Fantasy Score,22,17,18,9
Derrick White,G,22023,1628401,22300228,"NOV 22, 2023",BOS vs. MIL,W,35,5,9,0.556,3,6,0.5,0,0,0.0,0,4,4,5,1,1,6,1,13,-3,1,BOS,BOS,MIL,119,0.5,Offensive Rebounds,22,17,18,9
Derrick White,G,22023,1628401,22300228,"NOV 22, 2023",BOS vs. MIL,W,35,5,9,0.556,3,6,0.5,0,0,0.0,0,4,4,5,1,1,6,1,13,-3,1,BOS,BOS,MIL,119,6.5,3-PT Attempted,22,17,18,9
Derrick White,G,22023,1628401,22300228,"NOV 22, 2023",BOS vs. MIL,W,35,5,9,0.556,3,6,0.5,0,0,0.0,0,4,4,5,1,1,6,1,13,-3,1,BOS,BOS,MIL,119,17.5,Pts+Rebs,22,17,18,9
Derrick White,G,22023,1628401,22300228,"NOV 22, 2023",BOS vs. MIL,W,35,5,9,0.556,3,6,0.5,0,0,0.0,0,4,4,5,1,1,6,1,13,-3,1,BOS,BOS,MIL,119,17.5,Pts+Asts,22,17,18,9
Derrick White,G,22023,1628401,22300228,"NOV 22, 2023",BOS vs. MIL,W,35,5,9,0.556,3,6,0.5,0,0,0.0,0,4,4,5,1,1,6,1,13,-3,1,BOS,BOS,MIL,119,7.5,Rebs+Asts,22,17,18,9
Derrick White,G,22023,1628401,22300213,"NOV 19, 2023",BOS @ MEM,W,34,3,9,0.333,2,5,0.4,2,2,1.0,1,2,3,4,0,1,2,2,10,1,1,BOS,MEM,BOS,102,14.0,Points,17,13,14,7
Derrick White,G,22023,1628401,22300213,"NOV 19, 2023",BOS @ MEM,W,34,3,9,0.333,2,5,0.4,2,2,1.0,1,2,3,4,0,1,2,2,10,1,1,BOS,MEM,BOS,102,3.5,Rebounds,17,13,14,7
Derrick White,G,22023,1628401,22300213,"NOV 19, 2023",BOS @ MEM,W,34,3,9,0.333,2,5,0.4,2,2,1.0,1,2,3,4,0,1,2,2,10,1,1,BOS,MEM,BOS,102,21.5,Pts+Rebs+Asts,17,13,14,7
Derrick White,G,22023,1628401,22300213,"NOV 19, 2023",BOS @ MEM,W,34,3,9,0.333,2,5,0.4,2,2,1.0,1,2,3,4,0,1,2,2,10,1,1,BOS,MEM,BOS,102,4.0,Assists,17,13,14,7
Derrick White,G,22023,1628401,22300213,"NOV 19, 2023",BOS @ MEM,W,34,3,9,0.333,2,5,0.4,2,2,1.0,1,2,3,4,0,1,2,2,10,1,1,BOS,MEM,BOS,102,27.5,Fantasy Score,17,13,14,7
Derrick White,G,22023,1628401,22300213,"NOV 19, 2023",BOS @ MEM,W,34,3,9,0.333,2,5,0.4,2,2,1.0,1,2,3,4,0,1,2,2,10,1,1,BOS,MEM,BOS,102,0.5,Offensive Rebounds,17,13,14,7
Derrick White,G,22023,1628401,22300213,"NOV 19, 2023",BOS @ MEM,W,34,3,9,0.333,2,5,0.4,2,2,1.0,1,2,3,4,0,1,2,2,10,1,1,BOS,MEM,BOS,102,6.5,3-PT Attempted,17,13,14,7
Derrick White,G,22023,1628401,22300213,"NOV 19, 2023",BOS @ MEM,W,34,3,9,0.333,2,5,0.4,2,2,1.0,1,2,3,4,0,1,2,2,10,1,1,BOS,MEM,BOS,102,17.5,Pts+Rebs,17,13,14,7
Derrick White,G,22023,1628401,22300213,"NOV 19, 2023",BOS @ MEM,W,34,3,9,0.333,2,5,0.4,2,2,1.0,1,2,3,4,0,1,2,2,10,1,1,BOS,MEM,BOS,102,17.5,Pts+Asts,17,13,14,7
Derrick White,G,22023,1628401,22300213,"NOV 19, 2023",BOS @ MEM,W,34,3,9,0.333,2,5,0.4,2,2,1.0,1,2,3,4,0,1,2,2,10,1,1,BOS,MEM,BOS,102,7.5,Rebs+Asts,17,13,14,7
Derrick White,G,22023,1628401,22300031,"NOV 17, 2023",BOS @ TOR,W,34,4,10,0.4,3,8,0.375,2,2,1.0,0,4,4,5,0,0,1,1,13,-1,1,BOS,TOR,BOS,108,14.0,Points,22,17,18,9
Derrick White,G,22023,1628401,22300031,"NOV 17, 2023",BOS @ TOR,W,34,4,10,0.4,3,8,0.375,2,2,1.0,0,4,4,5,0,0,1,1,13,-1,1,BOS,TOR,BOS,108,3.5,Rebounds,22,17,18,9
Derrick White,G,22023,1628401,22300031,"NOV 17, 2023",BOS @ TOR,W,34,4,10,0.4,3,8,0.375,2,2,1.0,0,4,4,5,0,0,1,1,13,-1,1,BOS,TOR,BOS,108,21.5,Pts+Rebs+Asts,22,17,18,9
Derrick White,G,22023,1628401,22300031,"NOV 17, 2023",BOS @ TOR,W,34,4,10,0.4,3,8,0.375,2,2,1.0,0,4,4,5,0,0,1,1,13,-1,1,BOS,TOR,BOS,108,4.0,Assists,22,17,18,9
Derrick White,G,22023,1628401,22300031,"NOV 17, 2023",BOS @ TOR,W,34,4,10,0.4,3,8,0.375,2,2,1.0,0,4,4,5,0,0,1,1,13,-1,1,BOS,TOR,BOS,108,27.5,Fantasy Score,22,17,18,9
Derrick White,G,22023,1628401,22300031,"NOV 17, 2023",BOS @ TOR,W,34,4,10,0.4,3,8,0.375,2,2,1.0,0,4,4,5,0,0,1,1,13,-1,1,BOS,TOR,BOS,108,0.5,Offensive Rebounds,22,17,18,9
Derrick White,G,22023,1628401,22300031,"NOV 17, 2023",BOS @ TOR,W,34,4,10,0.4,3,8,0.375,2,2,1.0,0,4,4,5,0,0,1,1,13,-1,1,BOS,TOR,BOS,108,6.5,3-PT Attempted,22,17,18,9
Derrick White,G,22023,1628401,22300031,"NOV 17, 2023",BOS @ TOR,W,34,4,10,0.4,3,8,0.375,2,2,1.0,0,4,4,5,0,0,1,1,13,-1,1,BOS,TOR,BOS,108,17.5,Pts+Rebs,22,17,18,9
Derrick White,G,22023,1628401,22300031,"NOV 17, 2023",BOS @ TOR,W,34,4,10,0.4,3,8,0.375,2,2,1.0,0,4,4,5,0,0,1,1,13,-1,1,BOS,TOR,BOS,108,17.5,Pts+Asts,22,17,18,9
Derrick White,G,22023,1628401,22300031,"NOV 17, 2023",BOS @ TOR,W,34,4,10,0.4,3,8,0.375,2,2,1.0,0,4,4,5,0,0,1,1,13,-1,1,BOS,TOR,BOS,108,7.5,Rebs+Asts,22,17,18,9
Derrick White,G,22023,1628401,22300188,"NOV 13, 2023",BOS vs. NYK,W,31,1,7,0.143,1,3,0.333,0,0,0.0,1,1,2,4,1,1,1,2,3,14,1,BOS,BOS,NYK,114,14.0,Points,9,5,7,6
Derrick White,G,22023,1628401,22300188,"NOV 13, 2023",BOS vs. NYK,W,31,1,7,0.143,1,3,0.333,0,0,0.0,1,1,2,4,1,1,1,2,3,14,1,BOS,BOS,NYK,114,3.5,Rebounds,9,5,7,6
Derrick White,G,22023,1628401,22300188,"NOV 13, 2023",BOS vs. NYK,W,31,1,7,0.143,1,3,0.333,0,0,0.0,1,1,2,4,1,1,1,2,3,14,1,BOS,BOS,NYK,114,21.5,Pts+Rebs+Asts,9,5,7,6
Derrick White,G,22023,1628401,22300188,"NOV 13, 2023",BOS vs. NYK,W,31,1,7,0.143,1,3,0.333,0,0,0.0,1,1,2,4,1,1,1,2,3,14,1,BOS,BOS,NYK,114,4.0,Assists,9,5,7,6
Derrick White,G,22023,1628401,22300188,"NOV 13, 2023",BOS vs. NYK,W,31,1,7,0.143,1,3,0.333,0,0,0.0,1,1,2,4,1,1,1,2,3,14,1,BOS,BOS,NYK,114,27.5,Fantasy Score,9,5,7,6
Derrick White,G,22023,1628401,22300188,"NOV 13, 2023",BOS vs. NYK,W,31,1,7,0.143,1,3,0.333,0,0,0.0,1,1,2,4,1,1,1,2,3,14,1,BOS,BOS,NYK,114,0.5,Offensive Rebounds,9,5,7,6
Derrick White,G,22023,1628401,22300188,"NOV 13, 2023",BOS vs. NYK,W,31,1,7,0.143,1,3,0.333,0,0,0.0,1,1,2,4,1,1,1,2,3,14,1,BOS,BOS,NYK,114,6.5,3-PT Attempted,9,5,7,6
Derrick White,G,22023,1628401,22300188,"NOV 13, 2023",BOS vs. NYK,W,31,1,7,0.143,1,3,0.333,0,0,0.0,1,1,2,4,1,1,1,2,3,14,1,BOS,BOS,NYK,114,17.5,Pts+Rebs,9,5,7,6
Derrick White,G,22023,1628401,22300188,"NOV 13, 2023",BOS vs. NYK,W,31,1,7,0.143,1,3,0.333,0,0,0.0,1,1,2,4,1,1,1,2,3,14,1,BOS,BOS,NYK,114,17.5,Pts+Asts,9,5,7,6
Derrick White,G,22023,1628401,22300188,"NOV 13, 2023",BOS vs. NYK,W,31,1,7,0.143,1,3,0.333,0,0,0.0,1,1,2,4,1,1,1,2,3,14,1,BOS,BOS,NYK,114,7.5,Rebs+Asts,9,5,7,6
Derrick White,G,22023,1628401,22300159,"NOV 08, 2023",BOS @ PHI,L,38,6,18,0.333,3,11,0.273,4,4,1.0,1,3,4,5,2,1,2,3,19,2,1,BOS,PHI,BOS,103,14.0,Points,28,23,24,9
Derrick White,G,22023,1628401,22300159,"NOV 08, 2023",BOS @ PHI,L,38,6,18,0.333,3,11,0.273,4,4,1.0,1,3,4,5,2,1,2,3,19,2,1,BOS,PHI,BOS,103,3.5,Rebounds,28,23,24,9
Derrick White,G,22023,1628401,22300159,"NOV 08, 2023",BOS @ PHI,L,38,6,18,0.333,3,11,0.273,4,4,1.0,1,3,4,5,2,1,2,3,19,2,1,BOS,PHI,BOS,103,21.5,Pts+Rebs+Asts,28,23,24,9
Derrick White,G,22023,1628401,22300159,"NOV 08, 2023",BOS @ PHI,L,38,6,18,0.333,3,11,0.273,4,4,1.0,1,3,4,5,2,1,2,3,19,2,1,BOS,PHI,BOS,103,4.0,Assists,28,23,24,9
Derrick White,G,22023,1628401,22300159,"NOV 08, 2023",BOS @ PHI,L,38,6,18,0.333,3,11,0.273,4,4,1.0,1,3,4,5,2,1,2,3,19,2,1,BOS,PHI,BOS,103,27.5,Fantasy Score,28,23,24,9
Derrick White,G,22023,1628401,22300159,"NOV 08, 2023",BOS @ PHI,L,38,6,18,0.333,3,11,0.273,4,4,1.0,1,3,4,5,2,1,2,3,19,2,1,BOS,PHI,BOS,103,0.5,Offensive Rebounds,28,23,24,9
Derrick White,G,22023,1628401,22300159,"NOV 08, 2023",BOS @ PHI,L,38,6,18,0.333,3,11,0.273,4,4,1.0,1,3,4,5,2,1,2,3,19,2,1,BOS,PHI,BOS,103,6.5,3-PT Attempted,28,23,24,9
Derrick White,G,22023,1628401,22300159,"NOV 08, 2023",BOS @ PHI,L,38,6,18,0.333,3,11,0.273,4,4,1.0,1,3,4,5,2,1,2,3,19,2,1,BOS,PHI,BOS,103,17.5,Pts+Rebs,28,23,24,9
Derrick White,G,22023,1628401,22300159,"NOV 08, 2023",BOS @ PHI,L,38,6,18,0.333,3,11,0.273,4,4,1.0,1,3,4,5,2,1,2,3,19,2,1,BOS,PHI,BOS,103,17.5,Pts+Asts,28,23,24,9
Derrick White,G,22023,1628401,22300159,"NOV 08, 2023",BOS @ PHI,L,38,6,18,0.333,3,11,0.273,4,4,1.0,1,3,4,5,2,1,2,3,19,2,1,BOS,PHI,BOS,103,7.5,Rebs+Asts,28,23,24,9
Derrick White,G,22023,1628401,22300065,"OCT 25, 2023",BOS @ NYK,W,32,4,6,0.667,1,3,0.333,3,4,0.75,0,6,6,2,2,1,1,3,12,7,1,BOS,NYK,BOS,108,14.0,Points,20,18,14,8
Derrick White,G,22023,1628401,22300065,"OCT 25, 2023",BOS @ NYK,W,32,4,6,0.667,1,3,0.333,3,4,0.75,0,6,6,2,2,1,1,3,12,7,1,BOS,NYK,BOS,108,3.5,Rebounds,20,18,14,8
Derrick White,G,22023,1628401,22300065,"OCT 25, 2023",BOS @ NYK,W,32,4,6,0.667,1,3,0.333,3,4,0.75,0,6,6,2,2,1,1,3,12,7,1,BOS,NYK,BOS,108,21.5,Pts+Rebs+Asts,20,18,14,8
Derrick White,G,22023,1628401,22300065,"OCT 25, 2023",BOS @ NYK,W,32,4,6,0.667,1,3,0.333,3,4,0.75,0,6,6,2,2,1,1,3,12,7,1,BOS,NYK,BOS,108,4.0,Assists,20,18,14,8
Derrick White,G,22023,1628401,22300065,"OCT 25, 2023",BOS @ NYK,W,32,4,6,0.667,1,3,0.333,3,4,0.75,0,6,6,2,2,1,1,3,12,7,1,BOS,NYK,BOS,108,27.5,Fantasy Score,20,18,14,8
Derrick White,G,22023,1628401,22300065,"OCT 25, 2023",BOS @ NYK,W,32,4,6,0.667,1,3,0.333,3,4,0.75,0,6,6,2,2,1,1,3,12,7,1,BOS,NYK,BOS,108,0.5,Offensive Rebounds,20,18,14,8
Derrick White,G,22023,1628401,22300065,"OCT 25, 2023",BOS @ NYK,W,32,4,6,0.667,1,3,0.333,3,4,0.75,0,6,6,2,2,1,1,3,12,7,1,BOS,NYK,BOS,108,6.5,3-PT Attempted,20,18,14,8
Derrick White,G,22023,1628401,22300065,"OCT 25, 2023",BOS @ NYK,W,32,4,6,0.667,1,3,0.333,3,4,0.75,0,6,6,2,2,1,1,3,12,7,1,BOS,NYK,BOS,108,17.5,Pts+Rebs,20,18,14,8
Derrick White,G,22023,1628401,22300065,"OCT 25, 2023",BOS @ NYK,W,32,4,6,0.667,1,3,0.333,3,4,0.75,0,6,6,2,2,1,1,3,12,7,1,BOS,NYK,BOS,108,17.5,Pts+Asts,20,18,14,8
Derrick White,G,22023,1628401,22300065,"OCT 25, 2023",BOS @ NYK,W,32,4,6,0.667,1,3,0.333,3,4,0.75,0,6,6,2,2,1,1,3,12,7,1,BOS,NYK,BOS,108,7.5,Rebs+Asts,20,18,14,8
OG Anunoby,F,22023,1628384,22300643,"JAN 27, 2024",NYK vs. MIA,W,34,8,14,0.571,2,5,0.4,1,3,0.333,0,1,1,4,2,0,1,2,19,13,1,NYK,NYK,MIA,125,,,24,20,23,5
OG Anunoby,F,22023,1628384,22300631,"JAN 25, 2024",NYK vs. DEN,W,29,10,18,0.556,3,9,0.333,3,5,0.6,0,2,2,1,6,0,1,2,26,38,1,NYK,NYK,DEN,122,,,29,28,27,3
OG Anunoby,F,22023,1628384,22300615,"JAN 23, 2024",NYK @ BKN,W,33,3,8,0.375,0,1,0.0,4,4,1.0,1,4,5,1,4,2,3,2,10,11,1,NYK,BKN,NYK,108,,,16,15,11,6
OG Anunoby,F,22023,1628384,22300596,"JAN 20, 2024",NYK vs. TOR,W,37,5,11,0.455,0,3,0.0,4,4,1.0,0,7,7,1,1,3,1,2,14,20,1,NYK,NYK,TOR,126,,,22,21,15,8
OG Anunoby,F,22023,1628384,22300579,"JAN 18, 2024",NYK vs. WAS,W,43,6,9,0.667,3,5,0.6,4,4,1.0,0,7,7,1,0,2,1,3,19,12,1,NYK,NYK,WAS,113,,,27,26,20,8
OG Anunoby,F,22023,1628384,22300573,"JAN 17, 2024",NYK vs. HOU,W,43,5,10,0.5,2,5,0.4,3,3,1.0,0,5,5,0,4,1,1,2,15,24,1,NYK,NYK,HOU,109,,,20,20,15,5
OG Anunoby,F,22023,1628384,22300557,"JAN 15, 2024",NYK vs. ORL,L,44,5,11,0.455,3,4,0.75,4,4,1.0,1,1,2,4,0,0,2,2,17,2,1,NYK,NYK,ORL,94,,,23,19,21,6
OG Anunoby,F,22023,1628384,22300544,"JAN 13, 2024",NYK @ MEM,W,32,7,15,0.467,1,4,0.25,3,4,0.75,2,3,5,2,1,4,4,1,18,7,1,NYK,MEM,NYK,106,,,25,23,20,7
OG Anunoby,F,22023,1628384,22300530,"JAN 11, 2024",NYK @ DAL,L,39,4,10,0.4,1,6,0.167,1,1,1.0,1,5,6,2,0,2,1,1,10,14,1,NYK,DAL,NYK,124,,,18,16,12,8
OG Anunoby,F,22023,1628384,22300514,"JAN 09, 2024",NYK vs. POR,W,29,9,12,0.75,4,6,0.667,1,2,0.5,2,2,4,0,1,1,1,3,23,26,1,NYK,NYK,POR,112,,,27,27,23,4
OG Anunoby,F,22023,1628384,22300494,"JAN 06, 2024",NYK @ WAS,W,31,4,7,0.571,1,3,0.333,0,0,0.0,2,3,5,2,1,0,1,3,9,11,1,NYK,WAS,NYK,121,,,16,14,11,7
OG Anunoby,F,22023,1628384,22300483,"JAN 05, 2024",NYK @ PHI,W,37,3,11,0.273,1,3,0.333,4,4,1.0,1,1,2,0,1,0,0,3,11,20,1,NYK,PHI,NYK,128,,,13,13,11,2
OG Anunoby,F,22023,1628384,22300468,"JAN 03, 2024",NYK vs. CHI,W,34,5,9,0.556,1,4,0.25,0,0,0.0,2,6,8,2,2,0,1,2,11,35,1,NYK,NYK,CHI,116,,,21,19,13,10
OG Anunoby,F,22023,1628384,22300451,"JAN 01, 2024",NYK vs. MIN,W,35,7,12,0.583,3,6,0.5,0,0,0.0,3,3,6,1,2,0,1,6,17,19,1,NYK,NYK,MIN,112,,,24,23,18,7
OG Anunoby,F,22023,1628384,22300432,"DEC 29, 2023",TOR @ BOS,L,37,5,8,0.625,2,4,0.5,0,0,0.0,0,2,2,2,2,0,1,1,12,4,1,TOR,BOS,TOR,118,,,16,14,14,4
OG Anunoby,F,22023,1628384,22300416,"DEC 27, 2023",TOR @ WAS,W,29,11,16,0.688,3,7,0.429,1,2,0.5,2,4,6,2,0,0,1,1,26,24,1,TOR,WAS,TOR,132,,,34,32,28,8
OG Anunoby,F,22023,1628384,22300395,"DEC 23, 2023",TOR vs. UTA,L,36,8,13,0.615,2,3,0.667,1,1,1.0,1,1,2,4,2,0,0,1,19,-4,1,TOR,TOR,UTA,119,,,25,21,23,6
OG Anunoby,F,22023,1628384,22300382,"DEC 22, 2023",TOR @ PHI,L,35,4,9,0.444,0,4,0.0,4,4,1.0,0,4,4,6,1,0,2,4,12,-11,1,TOR,PHI,TOR,111,,,22,16,18,10
OG Anunoby,F,22023,1628384,22300369,"DEC 20, 2023",TOR vs. DEN,L,40,4,9,0.444,1,4,0.25,0,0,0.0,0,1,1,3,0,0,1,2,9,-5,1,TOR,TOR,DEN,104,,,13,10,12,4
OG Anunoby,F,22023,1628384,22300354,"DEC 18, 2023",TOR vs. CHA,W,32,2,10,0.2,0,5,0.0,1,1,1.0,0,2,2,2,1,0,2,3,5,3,1,TOR,TOR,CHA,114,,,9,7,7,4
OG Anunoby,F,22023,1628384,22300330,"DEC 15, 2023",TOR vs. ATL,L,33,3,8,0.375,1,4,0.25,0,0,0.0,0,2,2,4,0,0,2,0,7,-19,1,TOR,TOR,ATL,104,,,13,9,11,6
OG Anunoby,F,22023,1628384,22300313,"DEC 13, 2023",TOR vs. ATL,W,37,10,13,0.769,2,5,0.4,0,0,0.0,2,3,5,3,1,0,2,4,22,17,1,TOR,TOR,ATL,135,,,30,27,25,8
OG Anunoby,F,22023,1628384,22300297,"DEC 11, 2023",TOR @ NYK,L,37,11,20,0.55,5,11,0.455,2,2,1.0,1,4,5,2,1,0,2,3,29,-6,1,TOR,NYK,TOR,130,,,36,34,31,7
OG Anunoby,F,22023,1628384,22301216,"DEC 08, 2023",TOR @ CHA,L,36,3,12,0.25,0,6,0.0,5,5,1.0,0,3,3,4,1,0,0,3,11,0,1,TOR,CHA,TOR,116,,,18,14,15,7
OG Anunoby,F,22023,1628384,22301207,"DEC 06, 2023",TOR vs. MIA,L,39,8,13,0.615,5,10,0.5,2,2,1.0,1,7,8,6,1,1,2,2,23,-9,1,TOR,TOR,MIA,103,,,37,31,29,14
OG Anunoby,F,22023,1628384,22300276,"DEC 01, 2023",TOR vs. NYK,L,27,4,13,0.308,1,6,0.167,0,0,0.0,1,4,5,3,1,2,3,5,9,-4,1,TOR,TOR,NYK,106,,,17,14,12,8
OG Anunoby,F,22023,1628384,22300260,"NOV 29, 2023",TOR vs. PHX,W,34,5,10,0.5,3,5,0.6,0,1,0.0,0,3,3,1,3,1,0,3,13,1,1,TOR,TOR,PHX,112,,,17,16,14,4
OG Anunoby,F,22023,1628384,22300054,"NOV 28, 2023",TOR @ BKN,L,37,4,12,0.333,2,6,0.333,0,0,0.0,2,1,3,2,0,0,2,3,10,-14,1,TOR,BKN,TOR,103,,,15,13,12,5
OG Anunoby,F,22023,1628384,22300251,"NOV 26, 2023",TOR @ CLE,L,34,4,12,0.333,2,5,0.4,1,3,0.333,5,2,7,1,0,1,1,1,11,11,1,TOR,CLE,TOR,102,,,19,18,12,8
OG Anunoby,F,22023,1628384,22300046,"NOV 24, 2023",TOR vs. CHI,W,34,10,14,0.714,5,7,0.714,1,2,0.5,1,5,6,3,1,0,2,2,26,9,1,TOR,TOR,CHI,121,,,35,32,29,9
OG Anunoby,F,22023,1628384,22300038,"NOV 21, 2023",TOR @ ORL,L,30,4,8,0.5,3,5,0.6,0,0,0.0,0,1,1,4,0,3,4,0,11,-15,1,TOR,ORL,TOR,107,,,16,12,15,5
OG Anunoby,F,22023,1628384,22300211,"NOV 19, 2023",TOR vs. DET,W,27,2,11,0.182,1,6,0.167,4,6,0.667,1,4,5,3,2,0,1,3,9,15,1,TOR,TOR,DET,142,,,17,14,12,8
OG Anunoby,F,22023,1628384,22300174,"NOV 11, 2023",TOR @ BOS,L,28,3,13,0.231,2,8,0.25,0,0,0.0,1,2,3,2,1,0,0,0,8,-26,1,TOR,BOS,TOR,94,,,13,11,10,5
OG Anunoby,F,22023,1628384,22300082,"OCT 27, 2023",TOR @ CHI,L,28,5,8,0.625,1,4,0.25,0,1,0.0,0,3,3,0,2,0,1,2,11,28,1,TOR,CHI,TOR,103,,,14,14,11,3
OG Anunoby,F,22023,1628384,22300069,"OCT 25, 2023",TOR vs. MIN,W,34,7,13,0.538,4,9,0.444,2,2,1.0,0,6,6,1,2,3,2,2,20,6,1,TOR,TOR,MIN,97,,,27,26,21,7
OG Anunoby,F,22023,1628384,22300230,"NOV 22, 2023",TOR @ IND,W,36,5,12,0.417,1,4,0.25,2,2,1.0,2,2,4,3,1,0,2,3,13,-6,1,TOR,IND,TOR,132,,,20,17,16,7
OG Anunoby,F,22023,1628384,22300168,"NOV 08, 2023",TOR @ DAL,W,36,9,17,0.529,3,8,0.375,5,6,0.833,1,4,5,2,0,0,2,4,26,9,1,TOR,DAL,TOR,127,,,33,31,28,7
OG Anunoby,F,22023,1628384,22300141,"NOV 05, 2023",TOR @ SAS,W,38,8,16,0.5,7,13,0.538,1,4,0.25,2,4,6,4,2,0,1,3,24,8,1,TOR,SAS,TOR,123,,,34,30,28,10
OG Anunoby,F,22023,1628384,22300128,"NOV 02, 2023",TOR @ PHI,L,33,7,12,0.583,2,4,0.5,0,0,0.0,1,3,4,1,0,1,3,2,16,5,1,TOR,PHI,TOR,99,,,21,20,17,5
OG Anunoby,F,22023,1628384,22300116,"NOV 01, 2023",TOR vs. MIL,W,25,7,7,1.0,1,1,1.0,1,2,0.5,0,2,2,3,1,0,2,5,16,16,1,TOR,TOR,MIL,130,,,21,18,19,5
OG Anunoby,F,22023,1628384,22300105,"OCT 30, 2023",TOR vs. POR,L,30,4,12,0.333,2,9,0.222,0,0,0.0,0,3,3,1,2,1,2,0,10,0,1,TOR,TOR,POR,91,,,14,13,11,4
OG Anunoby,F,22023,1628384,22300643,"JAN 27, 2024",NYK vs. MIA,W,34,8,14,0.571,2,5,0.4,1,3,0.333,0,1,1,4,2,0,1,2,19,13,1,NYK,NYK,MIA,125,,,24,20,23,5
OG Anunoby,F,22023,1628384,22300631,"JAN 25, 2024",NYK vs. DEN,W,29,10,18,0.556,3,9,0.333,3,5,0.6,0,2,2,1,6,0,1,2,26,38,1,NYK,NYK,DEN,122,,,29,28,27,3
OG Anunoby,F,22023,1628384,22300615,"JAN 23, 2024",NYK @ BKN,W,33,3,8,0.375,0,1,0.0,4,4,1.0,1,4,5,1,4,2,3,2,10,11,1,NYK,BKN,NYK,108,,,16,15,11,6
OG Anunoby,F,22023,1628384,22300596,"JAN 20, 2024",NYK vs. TOR,W,37,5,11,0.455,0,3,0.0,4,4,1.0,0,7,7,1,1,3,1,2,14,20,1,NYK,NYK,TOR,126,,,22,21,15,8
OG Anunoby,F,22023,1628384,22300579,"JAN 18, 2024",NYK vs. WAS,W,43,6,9,0.667,3,5,0.6,4,4,1.0,0,7,7,1,0,2,1,3,19,12,1,NYK,NYK,WAS,113,,,27,26,20,8
OG Anunoby,F,22023,1628384,22300573,"JAN 17, 2024",NYK vs. HOU,W,43,5,10,0.5,2,5,0.4,3,3,1.0,0,5,5,0,4,1,1,2,15,24,1,NYK,NYK,HOU,109,,,20,20,15,5
OG Anunoby,F,22023,1628384,22300557,"JAN 15, 2024",NYK vs. ORL,L,44,5,11,0.455,3,4,0.75,4,4,1.0,1,1,2,4,0,0,2,2,17,2,1,NYK,NYK,ORL,94,,,23,19,21,6
OG Anunoby,F,22023,1628384,22300544,"JAN 13, 2024",NYK @ MEM,W,32,7,15,0.467,1,4,0.25,3,4,0.75,2,3,5,2,1,4,4,1,18,7,1,NYK,MEM,NYK,106,,,25,23,20,7
OG Anunoby,F,22023,1628384,22300530,"JAN 11, 2024",NYK @ DAL,L,39,4,10,0.4,1,6,0.167,1,1,1.0,1,5,6,2,0,2,1,1,10,14,1,NYK,DAL,NYK,124,,,18,16,12,8
OG Anunoby,F,22023,1628384,22300514,"JAN 09, 2024",NYK vs. POR,W,29,9,12,0.75,4,6,0.667,1,2,0.5,2,2,4,0,1,1,1,3,23,26,1,NYK,NYK,POR,112,,,27,27,23,4
OG Anunoby,F,22023,1628384,22300494,"JAN 06, 2024",NYK @ WAS,W,31,4,7,0.571,1,3,0.333,0,0,0.0,2,3,5,2,1,0,1,3,9,11,1,NYK,WAS,NYK,121,,,16,14,11,7
OG Anunoby,F,22023,1628384,22300483,"JAN 05, 2024",NYK @ PHI,W,37,3,11,0.273,1,3,0.333,4,4,1.0,1,1,2,0,1,0,0,3,11,20,1,NYK,PHI,NYK,128,,,13,13,11,2
OG Anunoby,F,22023,1628384,22300468,"JAN 03, 2024",NYK vs. CHI,W,34,5,9,0.556,1,4,0.25,0,0,0.0,2,6,8,2,2,0,1,2,11,35,1,NYK,NYK,CHI,116,,,21,19,13,10
OG Anunoby,F,22023,1628384,22300451,"JAN 01, 2024",NYK vs. MIN,W,35,7,12,0.583,3,6,0.5,0,0,0.0,3,3,6,1,2,0,1,6,17,19,1,NYK,NYK,MIN,112,,,24,23,18,7
OG Anunoby,F,22023,1628384,22300432,"DEC 29, 2023",TOR @ BOS,L,37,5,8,0.625,2,4,0.5,0,0,0.0,0,2,2,2,2,0,1,1,12,4,1,TOR,BOS,TOR,118,,,16,14,14,4
OG Anunoby,F,22023,1628384,22300416,"DEC 27, 2023",TOR @ WAS,W,29,11,16,0.688,3,7,0.429,1,2,0.5,2,4,6,2,0,0,1,1,26,24,1,TOR,WAS,TOR,132,,,34,32,28,8
OG Anunoby,F,22023,1628384,22300395,"DEC 23, 2023",TOR vs. UTA,L,36,8,13,0.615,2,3,0.667,1,1,1.0,1,1,2,4,2,0,0,1,19,-4,1,TOR,TOR,UTA,119,,,25,21,23,6
OG Anunoby,F,22023,1628384,22300382,"DEC 22, 2023",TOR @ PHI,L,35,4,9,0.444,0,4,0.0,4,4,1.0,0,4,4,6,1,0,2,4,12,-11,1,TOR,PHI,TOR,111,,,22,16,18,10
OG Anunoby,F,22023,1628384,22300369,"DEC 20, 2023",TOR vs. DEN,L,40,4,9,0.444,1,4,0.25,0,0,0.0,0,1,1,3,0,0,1,2,9,-5,1,TOR,TOR,DEN,104,,,13,10,12,4
OG Anunoby,F,22023,1628384,22300354,"DEC 18, 2023",TOR vs. CHA,W,32,2,10,0.2,0,5,0.0,1,1,1.0,0,2,2,2,1,0,2,3,5,3,1,TOR,TOR,CHA,114,,,9,7,7,4
OG Anunoby,F,22023,1628384,22300330,"DEC 15, 2023",TOR vs. ATL,L,33,3,8,0.375,1,4,0.25,0,0,0.0,0,2,2,4,0,0,2,0,7,-19,1,TOR,TOR,ATL,104,,,13,9,11,6
OG Anunoby,F,22023,1628384,22300313,"DEC 13, 2023",TOR vs. ATL,W,37,10,13,0.769,2,5,0.4,0,0,0.0,2,3,5,3,1,0,2,4,22,17,1,TOR,TOR,ATL,135,,,30,27,25,8
OG Anunoby,F,22023,1628384,22300297,"DEC 11, 2023",TOR @ NYK,L,37,11,20,0.55,5,11,0.455,2,2,1.0,1,4,5,2,1,0,2,3,29,-6,1,TOR,NYK,TOR,130,,,36,34,31,7
OG Anunoby,F,22023,1628384,22301216,"DEC 08, 2023",TOR @ CHA,L,36,3,12,0.25,0,6,0.0,5,5,1.0,0,3,3,4,1,0,0,3,11,0,1,TOR,CHA,TOR,116,,,18,14,15,7
OG Anunoby,F,22023,1628384,22301207,"DEC 06, 2023",TOR vs. MIA,L,39,8,13,0.615,5,10,0.5,2,2,1.0,1,7,8,6,1,1,2,2,23,-9,1,TOR,TOR,MIA,103,,,37,31,29,14
OG Anunoby,F,22023,1628384,22300276,"DEC 01, 2023",TOR vs. NYK,L,27,4,13,0.308,1,6,0.167,0,0,0.0,1,4,5,3,1,2,3,5,9,-4,1,TOR,TOR,NYK,106,,,17,14,12,8
OG Anunoby,F,22023,1628384,22300260,"NOV 29, 2023",TOR vs. PHX,W,34,5,10,0.5,3,5,0.6,0,1,0.0,0,3,3,1,3,1,0,3,13,1,1,TOR,TOR,PHX,112,,,17,16,14,4
OG Anunoby,F,22023,1628384,22300054,"NOV 28, 2023",TOR @ BKN,L,37,4,12,0.333,2,6,0.333,0,0,0.0,2,1,3,2,0,0,2,3,10,-14,1,TOR,BKN,TOR,103,,,15,13,12,5
OG Anunoby,F,22023,1628384,22300251,"NOV 26, 2023",TOR @ CLE,L,34,4,12,0.333,2,5,0.4,1,3,0.333,5,2,7,1,0,1,1,1,11,11,1,TOR,CLE,TOR,102,,,19,18,12,8
OG Anunoby,F,22023,1628384,22300046,"NOV 24, 2023",TOR vs. CHI,W,34,10,14,0.714,5,7,0.714,1,2,0.5,1,5,6,3,1,0,2,2,26,9,1,TOR,TOR,CHI,121,,,35,32,29,9
OG Anunoby,F,22023,1628384,22300038,"NOV 21, 2023",TOR @ ORL,L,30,4,8,0.5,3,5,0.6,0,0,0.0,0,1,1,4,0,3,4,0,11,-15,1,TOR,ORL,TOR,107,,,16,12,15,5
OG Anunoby,F,22023,1628384,22300211,"NOV 19, 2023",TOR vs. DET,W,27,2,11,0.182,1,6,0.167,4,6,0.667,1,4,5,3,2,0,1,3,9,15,1,TOR,TOR,DET,142,,,17,14,12,8
OG Anunoby,F,22023,1628384,22300174,"NOV 11, 2023",TOR @ BOS,L,28,3,13,0.231,2,8,0.25,0,0,0.0,1,2,3,2,1,0,0,0,8,-26,1,TOR,BOS,TOR,94,,,13,11,10,5
OG Anunoby,F,22023,1628384,22300082,"OCT 27, 2023",TOR @ CHI,L,28,5,8,0.625,1,4,0.25,0,1,0.0,0,3,3,0,2,0,1,2,11,28,1,TOR,CHI,TOR,103,,,14,14,11,3
OG Anunoby,F,22023,1628384,22300069,"OCT 25, 2023",TOR vs. MIN,W,34,7,13,0.538,4,9,0.444,2,2,1.0,0,6,6,1,2,3,2,2,20,6,1,TOR,TOR,MIN,97,,,27,26,21,7
OG Anunoby,F,22023,1628384,22300230,"NOV 22, 2023",TOR @ IND,W,36,5,12,0.417,1,4,0.25,2,2,1.0,2,2,4,3,1,0,2,3,13,-6,1,TOR,IND,TOR,132,,,20,17,16,7
OG Anunoby,F,22023,1628384,22300168,"NOV 08, 2023",TOR @ DAL,W,36,9,17,0.529,3,8,0.375,5,6,0.833,1,4,5,2,0,0,2,4,26,9,1,TOR,DAL,TOR,127,,,33,31,28,7
OG Anunoby,F,22023,1628384,22300141,"NOV 05, 2023",TOR @ SAS,W,38,8,16,0.5,7,13,0.538,1,4,0.25,2,4,6,4,2,0,1,3,24,8,1,TOR,SAS,TOR,123,,,34,30,28,10
OG Anunoby,F,22023,1628384,22300128,"NOV 02, 2023",TOR @ PHI,L,33,7,12,0.583,2,4,0.5,0,0,0.0,1,3,4,1,0,1,3,2,16,5,1,TOR,PHI,TOR,99,,,21,20,17,5
OG Anunoby,F,22023,1628384,22300116,"NOV 01, 2023",TOR vs. MIL,W,25,7,7,1.0,1,1,1.0,1,2,0.5,0,2,2,3,1,0,2,5,16,16,1,TOR,TOR,MIL,130,,,21,18,19,5
OG Anunoby,F,22023,1628384,22300105,"OCT 30, 2023",TOR vs. POR,L,30,4,12,0.333,2,9,0.222,0,0,0.0,0,3,3,1,2,1,2,0,10,0,1,TOR,TOR,POR,91,,,14,13,11,4
Jalen Johnson,F,22023,1630552,22300754,"FEB 10, 2024",ATL vs. HOU,W,40,8,11,0.727,1,2,0.5,4,4,1.0,2,4,6,3,2,2,2,3,21,10,1,ATL,ATL,HOU,122,,,30,27,24,9
Jalen Johnson,F,22023,1630552,22300742,"FEB 09, 2024",ATL @ PHI,W,38,5,12,0.417,1,4,0.25,0,2,0.0,0,11,11,6,0,2,1,3,11,7,1,ATL,PHI,ATL,127,,,28,22,17,17
Jalen Johnson,F,22023,1630552,22300729,"FEB 07, 2024",ATL @ BOS,L,36,8,16,0.5,2,5,0.4,1,1,1.0,2,13,15,4,3,0,2,0,19,1,1,ATL,BOS,ATL,117,,,38,34,23,19
Jalen Johnson,F,22023,1630552,22300716,"FEB 05, 2024",ATL vs. LAC,L,37,3,14,0.214,1,3,0.333,2,3,0.667,1,6,7,5,0,1,1,4,9,-7,1,ATL,ATL,LAC,144,,,21,16,14,12
Jalen Johnson,F,22023,1630552,22300690,"FEB 02, 2024",ATL vs. PHX,W,38,6,14,0.429,2,6,0.333,2,3,0.667,0,7,7,4,1,1,1,2,16,-2,1,ATL,ATL,PHX,129,,,27,23,20,11
Jalen Johnson,F,22023,1630552,22300669,"JAN 30, 2024",ATL vs. LAL,W,35,8,14,0.571,1,2,0.5,2,2,1.0,1,10,11,3,3,0,0,5,19,3,1,ATL,ATL,LAL,138,,,33,30,22,14
Jalen Johnson,F,22023,1630552,22300653,"JAN 28, 2024",ATL vs. TOR,W,42,6,17,0.353,1,4,0.25,4,4,1.0,3,9,12,5,2,0,2,4,17,6,1,ATL,ATL,TOR,126,,,34,29,22,17
Jalen Johnson,F,22023,1630552,22300634,"JAN 26, 2024",ATL vs. DAL,L,37,10,12,0.833,2,3,0.667,3,4,0.75,0,3,3,3,1,1,0,6,25,6,1,ATL,ATL,DAL,143,,,31,28,28,6
Jalen Johnson,F,22023,1630552,22300626,"JAN 24, 2024",ATL @ GSW,L,36,8,16,0.5,2,6,0.333,3,5,0.6,1,8,9,6,1,0,0,4,21,-6,1,ATL,GSW,ATL,112,,,36,30,27,15
Jalen Johnson,F,22023,1630552,22300613,"JAN 22, 2024",ATL @ SAC,L,38,4,18,0.222,1,7,0.143,2,4,0.5,2,5,7,0,1,2,0,1,11,-24,1,ATL,SAC,ATL,107,,,18,18,11,7
Jalen Johnson,F,22023,1630552,22300595,"JAN 20, 2024",ATL vs. CLE,L,34,8,16,0.5,1,5,0.2,3,6,0.5,1,6,7,4,1,2,1,2,20,-19,1,ATL,ATL,CLE,95,,,31,27,24,11
Jalen Johnson,F,22023,1630552,22300587,"JAN 19, 2024",ATL @ MIA,W,34,7,14,0.5,1,4,0.25,0,0,0.0,2,5,7,2,2,0,2,1,15,1,1,ATL,MIA,ATL,109,,,24,22,17,9
Jalen Johnson,F,22023,1630552,22300570,"JAN 17, 2024",ATL vs. ORL,W,38,3,9,0.333,1,2,0.5,3,5,0.6,0,9,9,3,2,0,4,3,10,9,1,ATL,ATL,ORL,106,,,22,19,13,12
Jalen Johnson,F,22023,1630552,22300559,"JAN 15, 2024",ATL vs. SAS,W,38,7,13,0.538,1,2,0.5,1,1,1.0,0,10,10,7,6,0,5,3,16,16,1,ATL,ATL,SAS,109,,,33,26,23,17
Jalen Johnson,F,22023,1630552,22300543,"JAN 13, 2024",ATL vs. WAS,L,36,2,7,0.286,1,3,0.333,0,0,0.0,0,6,6,3,0,2,4,3,5,-23,1,ATL,ATL,WAS,99,,,14,11,8,9
Jalen Johnson,F,22023,1630552,22300533,"JAN 12, 2024",ATL vs. IND,L,32,7,11,0.636,1,2,0.5,1,3,0.333,0,4,4,3,2,0,3,3,16,-17,1,ATL,ATL,IND,108,,,23,20,19,7
Jalen Johnson,F,22023,1630552,22300521,"JAN 10, 2024",ATL vs. PHI,W,41,8,13,0.615,3,4,0.75,6,6,1.0,2,14,16,7,1,2,1,3,25,6,1,ATL,ATL,PHI,139,,,48,41,32,23
Jalen Johnson,F,22023,1630552,22300499,"JAN 07, 2024",ATL @ ORL,L,40,6,12,0.5,0,4,0.0,0,0,0.0,1,10,11,4,0,1,3,6,12,-20,1,ATL,ORL,ATL,110,,,27,23,16,15
Jalen Johnson,F,22023,1630552,22300480,"JAN 05, 2024",ATL @ IND,L,29,5,11,0.455,1,4,0.25,1,1,1.0,1,7,8,3,1,0,0,1,12,-26,1,ATL,IND,ATL,116,,,23,20,15,11
Jalen Johnson,F,22023,1630552,22300467,"JAN 03, 2024",ATL vs. OKC,W,29,11,18,0.611,2,4,0.5,4,4,1.0,1,6,7,3,4,0,1,5,28,-1,1,ATL,ATL,OKC,141,,,38,35,31,10
Jalen Johnson,F,22023,1630552,22300445,"DEC 31, 2023",ATL @ WAS,W,37,9,12,0.75,2,4,0.5,4,5,0.8,0,13,13,4,0,0,1,2,24,-13,1,ATL,WAS,ATL,130,,,41,37,28,17
Jalen Johnson,F,22023,1630552,22300431,"DEC 29, 2023",ATL vs. SAC,L,35,5,12,0.417,1,4,0.25,5,6,0.833,2,13,15,4,0,1,4,2,16,-7,1,ATL,ATL,SAC,110,,,35,31,20,19
Jalen Johnson,F,22023,1630552,22300408,"DEC 26, 2023",ATL @ CHI,L,29,5,8,0.625,0,1,0.0,0,0,0.0,3,6,9,4,1,0,2,1,10,-9,1,ATL,CHI,ATL,113,,,23,19,14,13
Jalen Johnson,F,22023,1630552,22300241,"NOV 25, 2023",ATL @ WAS,W,8,3,4,0.75,1,2,0.5,1,2,0.5,1,0,1,1,2,1,0,0,8,7,1,ATL,WAS,ATL,136,,,10,9,9,2
Jalen Johnson,F,22023,1630552,22300227,"NOV 22, 2023",ATL vs. BKN,W,40,3,7,0.429,1,2,0.5,0,0,0.0,0,6,6,3,2,1,5,3,7,-15,1,ATL,ATL,BKN,147,,,16,13,10,9
Jalen Johnson,F,22023,1630552,22300039,"NOV 21, 2023",ATL vs. IND,L,33,6,12,0.5,0,2,0.0,5,5,1.0,1,6,7,6,2,1,1,2,17,-4,1,ATL,ATL,IND,152,,,30,24,23,13
Jalen Johnson,F,22023,1630552,22300029,"NOV 17, 2023",ATL vs. PHI,L,36,7,12,0.583,0,2,0.0,4,4,1.0,1,9,10,2,1,3,0,2,18,3,1,ATL,ATL,PHI,116,,,30,28,20,12
Jalen Johnson,F,22023,1630552,22300193,"NOV 15, 2023",ATL vs. NYK,L,31,7,9,0.778,4,4,1.0,0,0,0.0,0,5,5,0,0,2,3,1,18,-13,1,ATL,ATL,NYK,114,,,23,23,18,5
Jalen Johnson,F,22023,1630552,22300018,"NOV 14, 2023",ATL @ DET,W,36,6,9,0.667,2,2,1.0,2,2,1.0,1,4,5,1,1,1,2,2,16,0,1,ATL,DET,ATL,126,,,22,21,17,6
Jalen Johnson,F,22023,1630552,22300175,"NOV 11, 2023",ATL vs. MIA,L,22,4,8,0.5,1,3,0.333,0,0,0.0,0,4,4,2,0,0,3,2,9,-6,1,ATL,ATL,MIA,109,,,15,13,11,6
Jalen Johnson,F,22023,1630552,22300172,"NOV 09, 2023",ATL @ ORL,W,31,7,9,0.778,2,4,0.5,3,4,0.75,2,7,9,2,0,1,3,4,19,15,1,ATL,ORL,ATL,120,,,30,28,21,11
Jalen Johnson,F,22023,1630552,22300155,"NOV 06, 2023",ATL @ OKC,L,34,6,15,0.4,0,4,0.0,1,2,0.5,6,6,12,5,3,1,0,2,13,-16,1,ATL,OKC,ATL,117,,,30,25,18,17
Jalen Johnson,F,22023,1630552,22300135,"NOV 04, 2023",ATL @ NOP,W,36,8,13,0.615,2,3,0.667,3,4,0.75,2,9,11,4,0,0,1,3,21,19,1,ATL,NOP,ATL,123,,,36,32,25,15
Jalen Johnson,F,22023,1630552,22300117,"NOV 01, 2023",ATL vs. WAS,W,24,3,7,0.429,0,2,0.0,2,2,1.0,4,7,11,2,0,0,5,2,8,10,1,ATL,ATL,WAS,130,,,21,19,10,13
Jalen Johnson,F,22023,1630552,22300104,"OCT 30, 2023",ATL vs. MIN,W,33,5,7,0.714,1,2,0.5,1,1,1.0,1,4,5,3,1,1,2,3,12,19,1,ATL,ATL,MIN,127,,,20,17,15,8
Jalen Johnson,F,22023,1630552,22300097,"OCT 29, 2023",ATL @ MIL,W,26,6,10,0.6,2,3,0.667,0,0,0.0,1,6,7,1,2,1,2,4,14,14,1,ATL,MIL,ATL,127,,,22,21,15,8
Jalen Johnson,F,22023,1630552,22300079,"OCT 27, 2023",ATL vs. NYK,L,30,5,8,0.625,0,2,0.0,1,3,0.333,0,9,9,2,1,1,3,2,11,-1,1,ATL,ATL,NYK,120,,,22,20,13,11
Jalen Johnson,F,22023,1630552,22300063,"OCT 25, 2023",ATL @ CHA,L,29,9,13,0.692,1,3,0.333,2,4,0.5,0,7,7,2,2,1,0,1,21,8,1,ATL,CHA,ATL,110,,,30,28,23,9
Jalen Johnson,F,22023,1630552,22300699,"FEB 03, 2024",ATL vs. GSW,W,43,9,20,0.45,2,6,0.333,1,1,1.0,3,10,13,8,0,1,0,3,21,-3,1,ATL,ATL,GSW,141,,,42,34,29,21
Marvin Bagley III,F,22023,1628963,22300753,"FEB 10, 2024",WAS vs. PHI,L,15,1,7,0.143,0,1,0.0,0,0,0.0,0,1,1,0,0,2,0,1,2,1,1,WAS,WAS,PHI,113,,,3,3,2,1
Marvin Bagley III,F,22023,1628963,22300676,"JAN 31, 2024",WAS vs. LAC,L,18,5,7,0.714,0,0,0.0,0,0,0.0,3,5,8,2,0,0,1,1,10,-10,1,WAS,WAS,LAC,107,,,20,18,12,10
Marvin Bagley III,F,22023,1628963,22300665,"JAN 29, 2024",WAS @ SAS,W,20,5,6,0.833,0,0,0.0,5,6,0.833,0,3,3,1,0,0,5,3,15,2,1,WAS,SAS,WAS,118,,,19,18,16,4
Marvin Bagley III,F,22023,1628963,22300642,"JAN 27, 2024",WAS @ DET,W,20,3,7,0.429,0,0,0.0,7,8,0.875,5,3,8,2,1,0,3,4,13,9,1,WAS,DET,WAS,118,,,23,21,15,10
Marvin Bagley III,F,22023,1628963,22300628,"JAN 25, 2024",WAS vs. UTA,L,16,4,5,0.8,0,0,0.0,6,9,0.667,1,2,3,1,0,0,1,2,14,-15,1,WAS,WAS,UTA,108,,,18,17,15,4
Marvin Bagley III,F,22023,1628963,22300620,"JAN 24, 2024",WAS vs. MIN,L,26,7,8,0.875,0,0,0.0,3,8,0.375,6,9,15,0,1,0,1,3,17,-1,1,WAS,WAS,MIN,107,,,32,32,17,15
Marvin Bagley III,F,22023,1628963,22300602,"JAN 21, 2024",WAS vs. DEN,L,18,5,9,0.556,0,0,0.0,4,4,1.0,5,2,7,1,0,0,0,3,14,1,1,WAS,WAS,DEN,104,,,22,21,15,8
Marvin Bagley III,F,22023,1628963,22300594,"JAN 20, 2024",WAS vs. SAS,L,36,8,19,0.421,1,3,0.333,4,4,1.0,7,5,12,2,1,0,2,5,21,-19,1,WAS,WAS,SAS,127,,,35,33,23,14
Marvin Bagley III,F,22023,1628963,22300579,"JAN 18, 2024",WAS @ NYK,L,39,10,16,0.625,0,0,0.0,0,5,0.0,6,5,11,2,2,3,3,3,20,2,1,WAS,NYK,WAS,109,,,33,31,22,13
Marvin Bagley III,F,22023,1628963,22300534,"JAN 12, 2024",DET vs. HOU,L,12,4,6,0.667,0,0,0.0,3,4,0.75,1,3,4,1,1,0,0,2,11,-2,1,DET,DET,HOU,110,,,16,15,12,5
Marvin Bagley III,F,22023,1628963,22300453,"JAN 01, 2024",DET @ HOU,L,9,1,2,0.5,0,0,0.0,0,0,0.0,0,0,0,2,1,0,0,0,2,1,1,DET,HOU,DET,113,,,4,2,4,2
Marvin Bagley III,F,22023,1628963,22300394,"DEC 23, 2023",DET @ BKN,L,15,2,4,0.5,0,0,0.0,1,2,0.5,2,3,5,0,0,0,1,0,5,-9,1,DET,BKN,DET,115,,,10,10,5,5
Marvin Bagley III,F,22023,1628963,22300374,"DEC 21, 2023",DET vs. UTA,L,31,10,12,0.833,0,1,0.0,2,2,1.0,2,3,5,0,0,0,0,3,22,6,1,DET,DET,UTA,111,,,27,27,22,5
Marvin Bagley III,F,22023,1628963,22300352,"DEC 18, 2023",DET @ ATL,L,23,7,12,0.583,0,0,0.0,3,4,0.75,1,0,1,0,0,0,2,2,17,-10,1,DET,ATL,DET,124,,,18,18,17,1
Marvin Bagley III,F,22023,1628963,22300334,"DEC 16, 2023",DET @ MIL,L,22,6,11,0.545,0,0,0.0,0,1,0.0,3,4,7,1,1,2,0,3,12,-17,1,DET,MIL,DET,114,,,20,19,13,8
Marvin Bagley III,F,22023,1628963,22301217,"DEC 08, 2023",DET @ ORL,L,23,4,7,0.571,0,0,0.0,1,2,0.5,2,3,5,0,0,0,4,1,9,-19,1,DET,ORL,DET,91,,,14,14,9,5
Marvin Bagley III,F,22023,1628963,22300283,"DEC 02, 2023",DET vs. CLE,L,7,0,1,0.0,0,0,0.0,0,0,0.0,1,2,3,0,1,0,0,1,0,-11,1,DET,DET,CLE,101,,,3,3,0,3
Marvin Bagley III,F,22023,1628963,22300268,"NOV 30, 2023",DET @ NYK,L,14,3,6,0.5,0,0,0.0,2,2,1.0,3,0,3,1,0,1,1,1,8,-7,1,DET,NYK,DET,112,,,12,11,9,4
Marvin Bagley III,F,22023,1628963,22300258,"NOV 29, 2023",DET vs. LAL,L,14,2,4,0.5,0,0,0.0,0,2,0.0,1,1,2,0,0,0,0,0,4,-4,1,DET,DET,LAL,107,,,6,6,4,2
Marvin Bagley III,F,22023,1628963,22300047,"NOV 24, 2023",DET @ IND,L,14,3,6,0.5,0,0,0.0,0,0,0.0,3,3,6,2,0,3,1,1,6,-8,1,DET,IND,DET,113,,,14,12,8,8
Marvin Bagley III,F,22023,1628963,22300218,"NOV 20, 2023",DET vs. DEN,L,26,7,13,0.538,0,0,0.0,4,5,0.8,3,5,8,1,0,0,1,4,18,8,1,DET,DET,DEN,103,,,27,26,19,9
Marvin Bagley III,F,22023,1628963,22300211,"NOV 19, 2023",DET @ TOR,L,15,3,4,0.75,0,0,0.0,0,0,0.0,1,1,2,3,0,0,0,0,6,-21,1,DET,TOR,DET,113,,,11,8,9,5
Marvin Bagley III,F,22023,1628963,22300030,"NOV 17, 2023",DET @ CLE,L,16,3,5,0.6,0,0,0.0,2,2,1.0,1,2,3,1,1,1,1,0,8,-17,1,DET,CLE,DET,100,,,12,11,9,4
Marvin Bagley III,F,22023,1628963,22300018,"NOV 14, 2023",DET vs. ATL,L,30,9,12,0.75,0,0,0.0,4,4,1.0,6,5,11,1,0,1,4,2,22,4,1,DET,DET,ATL,120,,,34,33,23,12
Marvin Bagley III,F,22023,1628963,22300181,"NOV 12, 2023",DET @ CHI,L,23,6,12,0.5,0,1,0.0,2,2,1.0,2,3,5,1,0,1,3,1,14,-8,1,DET,CHI,DET,108,,,20,19,15,6
Marvin Bagley III,F,22023,1628963,22300008,"NOV 10, 2023",DET vs. PHI,L,13,3,4,0.75,0,0,0.0,0,0,0.0,2,3,5,1,0,0,1,2,6,2,1,DET,DET,PHI,106,,,12,11,7,6
Marvin Bagley III,F,22023,1628963,22300165,"NOV 08, 2023",DET @ MIL,L,20,5,6,0.833,0,0,0.0,2,2,1.0,2,0,2,2,0,1,1,4,12,1,1,DET,MIL,DET,118,,,16,14,14,4
Marvin Bagley III,F,22023,1628963,22300145,"NOV 06, 2023",DET vs. GSW,L,24,4,8,0.5,0,0,0.0,2,2,1.0,0,2,2,1,0,0,1,1,10,1,1,DET,DET,GSW,109,,,13,12,11,3
Marvin Bagley III,F,22023,1628963,22300140,"NOV 05, 2023",DET vs. PHX,L,11,3,5,0.6,0,0,0.0,5,5,1.0,1,1,2,1,0,0,1,5,11,7,1,DET,DET,PHX,106,,,14,13,12,3
Marvin Bagley III,F,22023,1628963,22300129,"NOV 02, 2023",DET @ NOP,L,13,3,7,0.429,0,0,0.0,0,0,0.0,4,5,9,0,0,1,1,0,6,5,1,DET,NOP,DET,116,,,15,15,6,9
Marvin Bagley III,F,22023,1628963,22300115,"NOV 01, 2023",DET vs. POR,L,33,3,10,0.3,0,2,0.0,4,5,0.8,0,6,6,3,0,2,5,3,10,8,1,DET,DET,POR,101,,,19,16,13,9
Marvin Bagley III,F,22023,1628963,22300109,"OCT 30, 2023",DET @ OKC,L,24,3,4,0.75,0,0,0.0,7,8,0.875,1,3,4,1,0,0,0,1,13,0,1,DET,OKC,DET,112,,,18,17,14,5
Marvin Bagley III,F,22023,1628963,22300088,"OCT 28, 2023",DET vs. CHI,W,15,5,8,0.625,1,1,1.0,0,0,0.0,2,4,6,0,0,0,0,2,11,10,1,DET,DET,CHI,118,,,17,17,11,6
Marvin Bagley III,F,22023,1628963,22300077,"OCT 27, 2023",DET @ CHA,W,13,5,9,0.556,0,1,0.0,4,5,0.8,0,4,4,1,0,0,0,0,14,7,1,DET,CHA,DET,111,,,19,18,15,5
Marvin Bagley III,F,22023,1628963,22300068,"OCT 25, 2023",DET @ MIA,L,16,3,3,1.0,0,0,0.0,2,2,1.0,2,6,8,3,0,1,1,1,8,3,1,DET,MIA,DET,102,,,19,16,11,11
Marvin Bagley III,F,22023,1628963,22300753,"FEB 10, 2024",WAS vs. PHI,L,15,1,7,0.143,0,1,0.0,0,0,0.0,0,1,1,0,0,2,0,1,2,1,1,WAS,WAS,PHI,113,,,3,3,2,1
Marvin Bagley III,F,22023,1628963,22300676,"JAN 31, 2024",WAS vs. LAC,L,18,5,7,0.714,0,0,0.0,0,0,0.0,3,5,8,2,0,0,1,1,10,-10,1,WAS,WAS,LAC,107,,,20,18,12,10
Marvin Bagley III,F,22023,1628963,22300665,"JAN 29, 2024",WAS @ SAS,W,20,5,6,0.833,0,0,0.0,5,6,0.833,0,3,3,1,0,0,5,3,15,2,1,WAS,SAS,WAS,118,,,19,18,16,4
Marvin Bagley III,F,22023,1628963,22300642,"JAN 27, 2024",WAS @ DET,W,20,3,7,0.429,0,0,0.0,7,8,0.875,5,3,8,2,1,0,3,4,13,9,1,WAS,DET,WAS,118,,,23,21,15,10
Marvin Bagley III,F,22023,1628963,22300628,"JAN 25, 2024",WAS vs. UTA,L,16,4,5,0.8,0,0,0.0,6,9,0.667,1,2,3,1,0,0,1,2,14,-15,1,WAS,WAS,UTA,108,,,18,17,15,4
Marvin Bagley III,F,22023,1628963,22300620,"JAN 24, 2024",WAS vs. MIN,L,26,7,8,0.875,0,0,0.0,3,8,0.375,6,9,15,0,1,0,1,3,17,-1,1,WAS,WAS,MIN,107,,,32,32,17,15
Marvin Bagley III,F,22023,1628963,22300602,"JAN 21, 2024",WAS vs. DEN,L,18,5,9,0.556,0,0,0.0,4,4,1.0,5,2,7,1,0,0,0,3,14,1,1,WAS,WAS,DEN,104,,,22,21,15,8
Marvin Bagley III,F,22023,1628963,22300594,"JAN 20, 2024",WAS vs. SAS,L,36,8,19,0.421,1,3,0.333,4,4,1.0,7,5,12,2,1,0,2,5,21,-19,1,WAS,WAS,SAS,127,,,35,33,23,14
Marvin Bagley III,F,22023,1628963,22300579,"JAN 18, 2024",WAS @ NYK,L,39,10,16,0.625,0,0,0.0,0,5,0.0,6,5,11,2,2,3,3,3,20,2,1,WAS,NYK,WAS,109,,,33,31,22,13
Marvin Bagley III,F,22023,1628963,22300534,"JAN 12, 2024",DET vs. HOU,L,12,4,6,0.667,0,0,0.0,3,4,0.75,1,3,4,1,1,0,0,2,11,-2,1,DET,DET,HOU,110,,,16,15,12,5
Marvin Bagley III,F,22023,1628963,22300453,"JAN 01, 2024",DET @ HOU,L,9,1,2,0.5,0,0,0.0,0,0,0.0,0,0,0,2,1,0,0,0,2,1,1,DET,HOU,DET,113,,,4,2,4,2
Marvin Bagley III,F,22023,1628963,22300394,"DEC 23, 2023",DET @ BKN,L,15,2,4,0.5,0,0,0.0,1,2,0.5,2,3,5,0,0,0,1,0,5,-9,1,DET,BKN,DET,115,,,10,10,5,5
Marvin Bagley III,F,22023,1628963,22300374,"DEC 21, 2023",DET vs. UTA,L,31,10,12,0.833,0,1,0.0,2,2,1.0,2,3,5,0,0,0,0,3,22,6,1,DET,DET,UTA,111,,,27,27,22,5
Marvin Bagley III,F,22023,1628963,22300352,"DEC 18, 2023",DET @ ATL,L,23,7,12,0.583,0,0,0.0,3,4,0.75,1,0,1,0,0,0,2,2,17,-10,1,DET,ATL,DET,124,,,18,18,17,1
Marvin Bagley III,F,22023,1628963,22300334,"DEC 16, 2023",DET @ MIL,L,22,6,11,0.545,0,0,0.0,0,1,0.0,3,4,7,1,1,2,0,3,12,-17,1,DET,MIL,DET,114,,,20,19,13,8
Marvin Bagley III,F,22023,1628963,22301217,"DEC 08, 2023",DET @ ORL,L,23,4,7,0.571,0,0,0.0,1,2,0.5,2,3,5,0,0,0,4,1,9,-19,1,DET,ORL,DET,91,,,14,14,9,5
Marvin Bagley III,F,22023,1628963,22300283,"DEC 02, 2023",DET vs. CLE,L,7,0,1,0.0,0,0,0.0,0,0,0.0,1,2,3,0,1,0,0,1,0,-11,1,DET,DET,CLE,101,,,3,3,0,3
Marvin Bagley III,F,22023,1628963,22300268,"NOV 30, 2023",DET @ NYK,L,14,3,6,0.5,0,0,0.0,2,2,1.0,3,0,3,1,0,1,1,1,8,-7,1,DET,NYK,DET,112,,,12,11,9,4
Marvin Bagley III,F,22023,1628963,22300258,"NOV 29, 2023",DET vs. LAL,L,14,2,4,0.5,0,0,0.0,0,2,0.0,1,1,2,0,0,0,0,0,4,-4,1,DET,DET,LAL,107,,,6,6,4,2
Marvin Bagley III,F,22023,1628963,22300047,"NOV 24, 2023",DET @ IND,L,14,3,6,0.5,0,0,0.0,0,0,0.0,3,3,6,2,0,3,1,1,6,-8,1,DET,IND,DET,113,,,14,12,8,8
Marvin Bagley III,F,22023,1628963,22300218,"NOV 20, 2023",DET vs. DEN,L,26,7,13,0.538,0,0,0.0,4,5,0.8,3,5,8,1,0,0,1,4,18,8,1,DET,DET,DEN,103,,,27,26,19,9
Marvin Bagley III,F,22023,1628963,22300211,"NOV 19, 2023",DET @ TOR,L,15,3,4,0.75,0,0,0.0,0,0,0.0,1,1,2,3,0,0,0,0,6,-21,1,DET,TOR,DET,113,,,11,8,9,5
Marvin Bagley III,F,22023,1628963,22300030,"NOV 17, 2023",DET @ CLE,L,16,3,5,0.6,0,0,0.0,2,2,1.0,1,2,3,1,1,1,1,0,8,-17,1,DET,CLE,DET,100,,,12,11,9,4
Marvin Bagley III,F,22023,1628963,22300018,"NOV 14, 2023",DET vs. ATL,L,30,9,12,0.75,0,0,0.0,4,4,1.0,6,5,11,1,0,1,4,2,22,4,1,DET,DET,ATL,120,,,34,33,23,12
Marvin Bagley III,F,22023,1628963,22300181,"NOV 12, 2023",DET @ CHI,L,23,6,12,0.5,0,1,0.0,2,2,1.0,2,3,5,1,0,1,3,1,14,-8,1,DET,CHI,DET,108,,,20,19,15,6
Marvin Bagley III,F,22023,1628963,22300008,"NOV 10, 2023",DET vs. PHI,L,13,3,4,0.75,0,0,0.0,0,0,0.0,2,3,5,1,0,0,1,2,6,2,1,DET,DET,PHI,106,,,12,11,7,6
Marvin Bagley III,F,22023,1628963,22300165,"NOV 08, 2023",DET @ MIL,L,20,5,6,0.833,0,0,0.0,2,2,1.0,2,0,2,2,0,1,1,4,12,1,1,DET,MIL,DET,118,,,16,14,14,4
Marvin Bagley III,F,22023,1628963,22300145,"NOV 06, 2023",DET vs. GSW,L,24,4,8,0.5,0,0,0.0,2,2,1.0,0,2,2,1,0,0,1,1,10,1,1,DET,DET,GSW,109,,,13,12,11,3
Marvin Bagley III,F,22023,1628963,22300140,"NOV 05, 2023",DET vs. PHX,L,11,3,5,0.6,0,0,0.0,5,5,1.0,1,1,2,1,0,0,1,5,11,7,1,DET,DET,PHX,106,,,14,13,12,3
Marvin Bagley III,F,22023,1628963,22300129,"NOV 02, 2023",DET @ NOP,L,13,3,7,0.429,0,0,0.0,0,0,0.0,4,5,9,0,0,1,1,0,6,5,1,DET,NOP,DET,116,,,15,15,6,9
Marvin Bagley III,F,22023,1628963,22300115,"NOV 01, 2023",DET vs. POR,L,33,3,10,0.3,0,2,0.0,4,5,0.8,0,6,6,3,0,2,5,3,10,8,1,DET,DET,POR,101,,,19,16,13,9
Marvin Bagley III,F,22023,1628963,22300109,"OCT 30, 2023",DET @ OKC,L,24,3,4,0.75,0,0,0.0,7,8,0.875,1,3,4,1,0,0,0,1,13,0,1,DET,OKC,DET,112,,,18,17,14,5
Marvin Bagley III,F,22023,1628963,22300088,"OCT 28, 2023",DET vs. CHI,W,15,5,8,0.625,1,1,1.0,0,0,0.0,2,4,6,0,0,0,0,2,11,10,1,DET,DET,CHI,118,,,17,17,11,6
Marvin Bagley III,F,22023,1628963,22300077,"OCT 27, 2023",DET @ CHA,W,13,5,9,0.556,0,1,0.0,4,5,0.8,0,4,4,1,0,0,0,0,14,7,1,DET,CHA,DET,111,,,19,18,15,5
Marvin Bagley III,F,22023,1628963,22300068,"OCT 25, 2023",DET @ MIA,L,16,3,3,1.0,0,0,0.0,2,2,1.0,2,6,8,3,0,1,1,1,8,3,1,DET,MIA,DET,102,,,19,16,11,11
Caris LeVert,G,22023,1627747,22300756,"FEB 10, 2024",CLE @ TOR,W,22,6,8,0.75,1,2,0.5,0,0,0.0,1,4,5,5,0,1,2,2,13,24,1,CLE,TOR,CLE,119,,,23,18,18,10
Caris LeVert,G,22023,1627747,22300735,"FEB 08, 2024",CLE @ BKN,W,23,2,6,0.333,0,2,0.0,0,0,0.0,0,3,3,5,1,0,2,1,4,8,1,CLE,BKN,CLE,118,,,12,7,9,8
Caris LeVert,G,22023,1627747,22300728,"FEB 07, 2024",CLE @ WAS,W,13,2,7,0.286,0,2,0.0,0,0,0.0,0,5,5,5,0,0,0,1,4,12,1,CLE,WAS,CLE,114,,,14,9,9,10
Caris LeVert,G,22023,1627747,22300714,"FEB 05, 2024",CLE vs. SAC,W,24,6,12,0.5,3,4,0.75,2,4,0.5,1,5,6,7,1,0,1,3,17,18,1,CLE,CLE,SAC,136,,,30,23,24,13
Caris LeVert,G,22023,1627747,22300703,"FEB 03, 2024",CLE @ SAS,W,25,4,10,0.4,2,5,0.4,0,0,0.0,1,4,5,6,1,0,1,2,10,20,1,CLE,SAS,CLE,117,,,21,15,16,11
Caris LeVert,G,22023,1627747,22300687,"FEB 01, 2024",CLE @ MEM,W,29,6,10,0.6,1,4,0.25,3,4,0.75,0,1,1,3,2,0,2,1,16,-11,1,CLE,MEM,CLE,108,,,20,17,19,4
Caris LeVert,G,22023,1627747,22300675,"JAN 31, 2024",CLE vs. DET,W,25,3,8,0.375,1,4,0.25,4,4,1.0,0,1,1,4,1,2,2,0,11,7,1,CLE,CLE,DET,128,,,16,12,15,5
Caris LeVert,G,22023,1627747,22300658,"JAN 29, 2024",CLE vs. LAC,W,23,6,12,0.5,1,4,0.25,0,0,0.0,1,1,2,3,1,0,1,1,13,8,1,CLE,CLE,LAC,118,,,18,15,16,5
Caris LeVert,G,22023,1627747,22300639,"JAN 26, 2024",CLE @ MIL,W,24,3,10,0.3,1,4,0.25,5,6,0.833,1,3,4,5,1,0,1,5,12,4,1,CLE,MIL,CLE,112,,,21,16,17,9
Caris LeVert,G,22023,1627747,22300624,"JAN 24, 2024",CLE @ MIL,L,28,4,10,0.4,1,4,0.25,0,0,0.0,0,4,4,4,2,1,2,2,9,-10,1,CLE,MIL,CLE,116,,,17,13,13,8
Caris LeVert,G,22023,1627747,22300572,"JAN 17, 2024",CLE vs. MIL,W,22,1,7,0.143,0,2,0.0,2,3,0.667,1,2,3,4,0,0,2,1,4,2,1,CLE,CLE,MIL,135,,,11,7,8,7
Caris LeVert,G,22023,1627747,22300561,"JAN 15, 2024",CLE vs. CHI,W,30,6,17,0.353,4,10,0.4,0,0,0.0,1,6,7,7,0,0,3,2,16,8,1,CLE,CLE,CHI,109,,,30,23,23,14
Caris LeVert,G,22023,1627747,22300527,"JAN 11, 2024",CLE vs. BKN,W,35,5,14,0.357,3,9,0.333,8,12,0.667,0,3,3,1,1,2,1,2,21,0,1,CLE,CLE,BKN,111,,,25,24,22,4
Caris LeVert,G,22023,1627747,22300497,"JAN 07, 2024",CLE vs. SAS,W,26,9,13,0.692,4,5,0.8,1,3,0.333,0,2,2,3,2,0,4,2,23,3,1,CLE,CLE,SAS,117,,,28,25,26,5
Caris LeVert,G,22023,1627747,22300482,"JAN 05, 2024",CLE vs. WAS,W,27,3,7,0.429,1,2,0.5,4,4,1.0,0,4,4,11,2,0,2,0,11,13,1,CLE,CLE,WAS,114,,,26,15,22,15
Caris LeVert,G,22023,1627747,22300465,"JAN 03, 2024",CLE vs. WAS,W,23,9,18,0.5,3,6,0.5,0,0,0.0,2,3,5,5,1,1,0,1,21,22,1,CLE,CLE,WAS,140,,,31,26,26,10
Caris LeVert,G,22023,1627747,22300452,"JAN 01, 2024",CLE @ TOR,L,29,12,20,0.6,2,7,0.286,5,5,1.0,0,4,4,4,0,0,0,0,31,1,1,CLE,TOR,CLE,121,,,39,35,35,8
Caris LeVert,G,22023,1627747,22300433,"DEC 29, 2023",CLE vs. MIL,L,28,3,14,0.214,0,6,0.0,0,0,0.0,0,1,1,4,1,0,2,2,6,-3,1,CLE,CLE,MIL,111,,,11,7,10,5
Caris LeVert,G,22023,1627747,22300420,"DEC 27, 2023",CLE @ DAL,W,28,9,19,0.474,6,11,0.545,5,8,0.625,0,2,2,7,0,0,2,3,29,-16,1,CLE,DAL,CLE,113,,,38,31,36,9
Caris LeVert,G,22023,1627747,22300375,"DEC 21, 2023",CLE vs. NOP,L,23,3,9,0.333,1,4,0.25,2,2,1.0,0,0,0,4,1,0,1,1,9,-24,1,CLE,CLE,NOP,104,,,13,9,13,4
Caris LeVert,G,22023,1627747,22300364,"DEC 20, 2023",CLE vs. UTA,W,27,6,15,0.4,4,7,0.571,7,8,0.875,0,3,3,7,1,0,0,3,23,11,1,CLE,CLE,UTA,124,,,33,26,30,10
Caris LeVert,G,22023,1627747,22300349,"DEC 18, 2023",CLE vs. HOU,W,27,5,13,0.385,1,6,0.167,1,2,0.5,1,6,7,5,2,0,3,0,12,-3,1,CLE,CLE,HOU,135,,,24,19,17,12
Caris LeVert,G,22023,1627747,22300336,"DEC 16, 2023",CLE vs. ATL,W,25,6,15,0.4,1,4,0.25,1,2,0.5,2,3,5,1,1,1,3,1,14,-1,1,CLE,CLE,ATL,127,,,20,19,15,6
Caris LeVert,G,22023,1627747,22300319,"DEC 14, 2023",CLE @ BOS,L,35,9,16,0.563,3,6,0.5,5,6,0.833,1,2,3,5,3,1,1,2,26,-1,1,CLE,BOS,CLE,107,,,34,29,31,8
Caris LeVert,G,22023,1627747,22300305,"DEC 12, 2023",CLE @ BOS,L,23,5,11,0.455,1,4,0.25,0,0,0.0,0,2,2,3,0,1,2,1,11,-5,1,CLE,BOS,CLE,113,,,16,13,14,5
Caris LeVert,G,22023,1627747,22300265,"NOV 30, 2023",CLE vs. POR,L,26,2,9,0.222,1,4,0.25,0,0,0.0,1,1,2,2,0,0,2,3,5,-17,1,CLE,CLE,POR,95,,,9,7,7,4
Caris LeVert,G,22023,1627747,22300055,"NOV 28, 2023",CLE vs. ATL,W,30,4,8,0.5,2,5,0.4,0,0,0.0,0,3,3,1,1,0,4,3,10,14,1,CLE,CLE,ATL,128,,,14,13,11,4
Caris LeVert,G,22023,1627747,22300251,"NOV 26, 2023",CLE vs. TOR,W,22,3,10,0.3,1,4,0.25,0,0,0.0,0,3,3,1,0,0,0,1,7,6,1,CLE,CLE,TOR,105,,,11,10,8,4
Caris LeVert,G,22023,1627747,22300242,"NOV 25, 2023",CLE vs. LAL,L,26,3,9,0.333,0,4,0.0,0,0,0.0,0,1,1,8,1,0,0,2,6,-2,1,CLE,CLE,LAL,115,,,15,7,14,9
Caris LeVert,G,22023,1627747,22300229,"NOV 22, 2023",CLE vs. MIA,L,18,4,8,0.5,2,3,0.667,2,2,1.0,0,2,2,3,0,1,2,0,12,-17,1,CLE,CLE,MIA,96,,,17,14,15,5
Caris LeVert,G,22023,1627747,22300030,"NOV 17, 2023",CLE vs. DET,W,33,4,14,0.286,1,6,0.167,1,2,0.5,0,1,1,1,2,0,0,0,10,11,1,CLE,CLE,DET,108,,,12,11,11,2
Caris LeVert,G,22023,1627747,22300199,"NOV 15, 2023",CLE @ POR,W,33,8,17,0.471,1,7,0.143,0,0,0.0,1,7,8,6,2,1,1,2,17,7,1,CLE,POR,CLE,109,,,31,25,23,14
Caris LeVert,G,22023,1627747,22300191,"NOV 13, 2023",CLE @ SAC,L,28,7,13,0.538,2,3,0.667,5,6,0.833,1,2,3,1,0,0,2,3,21,-7,1,CLE,SAC,CLE,120,,,25,24,22,4
Caris LeVert,G,22023,1627747,22300176,"NOV 11, 2023",CLE @ GSW,W,36,8,18,0.444,2,7,0.286,4,5,0.8,2,3,5,3,4,1,0,1,22,23,1,CLE,GSW,CLE,118,,,30,27,25,8
Caris LeVert,G,22023,1627747,22300167,"NOV 08, 2023",CLE @ OKC,L,34,7,14,0.5,2,6,0.333,13,16,0.813,0,5,5,5,0,0,3,5,29,-14,1,CLE,OKC,CLE,120,,,39,34,34,10
Caris LeVert,G,22023,1627747,22300142,"NOV 05, 2023",CLE vs. GSW,W,32,3,6,0.5,0,3,0.0,2,2,1.0,0,5,5,2,2,0,1,0,8,6,1,CLE,CLE,GSW,115,,,15,13,10,7
Caris LeVert,G,22023,1627747,22300001,"NOV 03, 2023",CLE @ IND,L,30,5,12,0.417,0,4,0.0,3,4,0.75,0,5,5,4,0,1,1,2,13,-1,1,CLE,IND,CLE,116,,,22,18,17,9
Caris LeVert,G,22023,1627747,22300091,"OCT 28, 2023",CLE vs. IND,L,44,12,28,0.429,4,10,0.4,3,9,0.333,2,3,5,8,1,0,2,2,31,-2,1,CLE,CLE,IND,113,,,44,36,39,13
Caris LeVert,G,22023,1627747,22300067,"OCT 25, 2023",CLE @ BKN,W,31,4,17,0.235,3,8,0.375,0,0,0.0,0,3,3,5,1,1,0,1,11,-6,1,CLE,BKN,CLE,114,,,19,14,16,8
Caris LeVert,G,22023,1627747,22300081,"OCT 27, 2023",CLE vs. OKC,L,31,7,16,0.438,3,9,0.333,0,0,0.0,0,2,2,2,1,1,1,1,17,-3,1,CLE,CLE,OKC,105,,,21,19,19,4
Caris LeVert,G,22023,1627747,22300120,"NOV 01, 2023",CLE @ NYK,W,31,6,14,0.429,3,4,0.75,4,4,1.0,0,6,6,5,1,0,3,3,19,10,1,CLE,NYK,CLE,95,,,30,25,24,11
Evan Mobley,C,22023,1630596,22300756,"FEB 10, 2024",CLE @ TOR,W,27,7,13,0.538,1,4,0.25,2,4,0.5,4,7,11,3,0,0,2,3,17,17,1,CLE,TOR,CLE,119,,,31,28,20,14
Evan Mobley,C,22023,1630596,22300735,"FEB 08, 2024",CLE @ BKN,W,26,5,8,0.625,0,0,0.0,4,4,1.0,0,12,12,2,0,2,2,3,14,25,1,CLE,BKN,CLE,118,,,28,26,16,14
Evan Mobley,C,22023,1630596,22300728,"FEB 07, 2024",CLE @ WAS,W,25,9,10,0.9,2,2,1.0,2,2,1.0,2,6,8,1,1,1,2,2,22,7,1,CLE,WAS,CLE,114,,,31,30,23,9
Evan Mobley,C,22023,1630596,22300714,"FEB 05, 2024",CLE vs. SAC,W,28,5,12,0.417,0,1,0.0,1,2,0.5,1,13,14,7,2,1,0,3,11,4,1,CLE,CLE,SAC,136,,,32,25,18,21
Evan Mobley,C,22023,1630596,22300703,"FEB 03, 2024",CLE @ SAS,W,24,11,15,0.733,3,3,1.0,3,4,0.75,2,8,10,3,0,0,0,5,28,-7,1,CLE,SAS,CLE,117,,,41,38,31,13
Evan Mobley,C,22023,1630596,22300675,"JAN 31, 2024",CLE vs. DET,W,22,3,7,0.429,0,1,0.0,2,2,1.0,1,2,3,4,1,0,0,2,8,-4,1,CLE,CLE,DET,128,,,15,11,12,7
Evan Mobley,C,22023,1630596,22300658,"JAN 29, 2024",CLE vs. LAC,W,21,5,7,0.714,0,0,0.0,0,0,0.0,1,8,9,0,1,0,3,3,10,-5,1,CLE,CLE,LAC,118,,,19,19,10,9
Evan Mobley,C,22023,1630596,22301205,"DEC 06, 2023",CLE vs. ORL,W,37,8,12,0.667,0,0,0.0,0,0,0.0,1,4,5,2,1,1,4,5,16,13,1,CLE,CLE,ORL,121,,,23,21,18,7
Evan Mobley,C,22023,1630596,22300283,"DEC 02, 2023",CLE @ DET,W,36,2,5,0.4,0,0,0.0,2,3,0.667,1,10,11,1,0,0,2,3,6,1,1,CLE,DET,CLE,110,,,18,17,7,12
Evan Mobley,C,22023,1630596,22300265,"NOV 30, 2023",CLE vs. POR,L,34,9,14,0.643,0,1,0.0,2,2,1.0,2,6,8,3,2,0,3,1,20,3,1,CLE,CLE,POR,95,,,31,28,23,11
Evan Mobley,C,22023,1630596,22300055,"NOV 28, 2023",CLE vs. ATL,W,34,8,11,0.727,1,1,1.0,0,0,0.0,5,14,19,1,0,7,1,4,17,25,1,CLE,CLE,ATL,128,,,37,36,18,20
Evan Mobley,C,22023,1630596,22300251,"NOV 26, 2023",CLE vs. TOR,W,38,5,14,0.357,0,1,0.0,2,2,1.0,3,11,14,1,0,2,3,3,12,-4,1,CLE,CLE,TOR,105,,,27,26,13,15
Evan Mobley,C,22023,1630596,22300242,"NOV 25, 2023",CLE vs. LAL,L,36,8,12,0.667,0,0,0.0,2,3,0.667,1,5,6,6,4,1,2,3,18,-5,1,CLE,CLE,LAL,115,,,30,24,24,12
Evan Mobley,C,22023,1630596,22300229,"NOV 22, 2023",CLE vs. MIA,L,25,5,7,0.714,0,0,0.0,3,3,1.0,2,8,10,2,0,0,2,0,13,-12,1,CLE,CLE,MIA,96,,,25,23,15,12
Evan Mobley,C,22023,1630596,22300040,"NOV 21, 2023",CLE @ PHI,W,38,6,10,0.6,0,0,0.0,6,6,1.0,0,12,12,3,0,1,4,4,18,-4,1,CLE,PHI,CLE,122,,,33,30,21,15
Evan Mobley,C,22023,1630596,22300210,"NOV 19, 2023",CLE vs. DEN,W,32,8,11,0.727,0,0,0.0,0,0,0.0,3,7,10,5,0,2,2,3,16,12,1,CLE,CLE,DEN,121,,,31,26,21,15
Evan Mobley,C,22023,1630596,22300030,"NOV 17, 2023",CLE vs. DET,W,35,8,12,0.667,0,0,0.0,2,4,0.5,4,6,10,5,1,0,3,4,18,-6,1,CLE,CLE,DET,108,,,33,28,23,15
Evan Mobley,C,22023,1630596,22300199,"NOV 15, 2023",CLE @ POR,W,35,8,11,0.727,0,1,0.0,5,8,0.625,3,9,12,3,1,3,1,1,21,26,1,CLE,POR,CLE,109,,,36,33,24,15
Evan Mobley,C,22023,1630596,22300191,"NOV 13, 2023",CLE @ SAC,L,30,8,14,0.571,0,0,0.0,0,0,0.0,7,5,12,2,1,0,3,4,16,-3,1,CLE,SAC,CLE,120,,,30,28,18,14
Evan Mobley,C,22023,1630596,22300176,"NOV 11, 2023",CLE @ GSW,W,31,6,10,0.6,0,1,0.0,7,7,1.0,1,4,5,2,1,1,2,4,19,-4,1,CLE,GSW,CLE,118,,,26,24,21,7
Evan Mobley,C,22023,1630596,22300167,"NOV 08, 2023",CLE @ OKC,L,33,9,16,0.563,0,1,0.0,4,4,1.0,2,3,5,1,1,1,1,2,22,3,1,CLE,OKC,CLE,120,,,28,27,23,6
Evan Mobley,C,22023,1630596,22300142,"NOV 05, 2023",CLE vs. GSW,W,29,6,10,0.6,0,1,0.0,1,4,0.25,5,11,16,2,0,1,5,4,13,8,1,CLE,CLE,GSW,115,,,31,29,15,18
Evan Mobley,C,22023,1630596,22300001,"NOV 03, 2023",CLE @ IND,L,36,7,13,0.538,0,2,0.0,0,0,0.0,2,8,10,5,3,4,2,2,14,11,1,CLE,IND,CLE,116,,,29,24,19,15
Evan Mobley,C,22023,1630596,22300112,"OCT 31, 2023",CLE vs. NYK,L,29,3,9,0.333,0,0,0.0,0,0,0.0,4,8,12,5,0,2,2,0,6,-19,1,CLE,CLE,NYK,91,,,23,18,11,17
Evan Mobley,C,22023,1630596,22300091,"OCT 28, 2023",CLE vs. IND,L,33,12,22,0.545,1,1,1.0,8,10,0.8,5,9,14,3,0,3,2,4,33,-15,1,CLE,CLE,IND,113,,,50,47,36,17
Evan Mobley,C,22023,1630596,22300067,"OCT 25, 2023",CLE @ BKN,W,34,5,11,0.455,0,0,0.0,0,0,0.0,1,5,6,1,0,2,0,3,10,3,1,CLE,BKN,CLE,114,,,17,16,11,7
Evan Mobley,C,22023,1630596,22300081,"OCT 27, 2023",CLE vs. OKC,L,34,5,12,0.417,0,0,0.0,4,6,0.667,2,13,15,3,0,2,2,4,14,-9,1,CLE,CLE,OKC,105,,,32,29,17,18
Evan Mobley,C,22023,1630596,22300120,"NOV 01, 2023",CLE @ NYK,W,35,6,12,0.5,0,0,0.0,2,3,0.667,2,6,8,5,2,2,2,2,14,8,1,CLE,NYK,CLE,95,,,27,22,19,13
Jarrett Allen,C,22023,1628386,22300756,"FEB 10, 2024",CLE @ TOR,W,30,9,12,0.75,0,1,0.0,0,2,0.0,6,9,15,2,0,1,1,2,18,4,1,CLE,TOR,CLE,119,,,35,33,20,17
Jarrett Allen,C,22023,1628386,22300735,"FEB 08, 2024",CLE @ BKN,W,30,3,6,0.5,0,1,0.0,8,8,1.0,2,8,10,2,0,2,2,2,14,17,1,CLE,BKN,CLE,118,,,26,24,16,12
Jarrett Allen,C,22023,1628386,22300728,"FEB 07, 2024",CLE @ WAS,W,37,5,12,0.417,0,1,0.0,2,4,0.5,3,6,9,2,0,2,3,1,12,-4,1,CLE,WAS,CLE,114,,,23,21,14,11
Jarrett Allen,C,22023,1628386,22300714,"FEB 05, 2024",CLE vs. SAC,W,30,8,10,0.8,0,0,0.0,3,4,0.75,1,6,7,3,0,2,0,1,19,22,1,CLE,CLE,SAC,136,,,29,26,22,10
Jarrett Allen,C,22023,1628386,22300703,"FEB 03, 2024",CLE @ SAS,W,31,12,18,0.667,0,0,0.0,2,2,1.0,4,12,16,0,0,0,1,1,26,26,1,CLE,SAS,CLE,117,,,42,42,26,16
Jarrett Allen,C,22023,1628386,22300687,"FEB 01, 2024",CLE @ MEM,W,21,6,13,0.462,0,0,0.0,2,4,0.5,2,7,9,2,0,3,2,1,14,6,1,CLE,MEM,CLE,108,,,25,23,16,11
Jarrett Allen,C,22023,1628386,22300675,"JAN 31, 2024",CLE vs. DET,W,30,7,10,0.7,0,0,0.0,0,0,0.0,5,6,11,0,1,1,1,2,14,19,1,CLE,CLE,DET,128,,,25,25,14,11
Jarrett Allen,C,22023,1628386,22300658,"JAN 29, 2024",CLE vs. LAC,W,36,6,9,0.667,0,0,0.0,8,11,0.727,4,13,17,3,1,1,3,3,20,11,1,CLE,CLE,LAC,118,,,40,37,23,20
Jarrett Allen,C,22023,1628386,22300639,"JAN 26, 2024",CLE @ MIL,W,36,9,20,0.45,0,0,0.0,6,7,0.857,8,6,14,1,1,2,4,4,24,12,1,CLE,MIL,CLE,112,,,39,38,25,15
Jarrett Allen,C,22023,1628386,22300624,"JAN 24, 2024",CLE @ MIL,L,32,10,19,0.526,0,0,0.0,1,2,0.5,4,8,12,5,0,0,1,0,21,-17,1,CLE,MIL,CLE,116,,,38,33,26,17
Jarrett Allen,C,22023,1628386,22300607,"JAN 22, 2024",CLE @ ORL,W,27,6,8,0.75,0,0,0.0,2,4,0.5,5,6,11,4,0,2,2,2,14,21,1,CLE,ORL,CLE,126,,,29,25,18,15
Jarrett Allen,C,22023,1628386,22300595,"JAN 20, 2024",CLE @ ATL,W,33,6,8,0.75,0,0,0.0,2,2,1.0,1,10,11,2,3,3,4,2,14,7,1,CLE,ATL,CLE,116,,,27,25,16,13
Jarrett Allen,C,22023,1628386,22300572,"JAN 17, 2024",CLE vs. MIL,W,26,9,15,0.6,0,0,0.0,3,3,1.0,3,10,13,3,0,1,1,0,21,37,1,CLE,CLE,MIL,135,,,37,34,24,16
Jarrett Allen,C,22023,1628386,22300561,"JAN 15, 2024",CLE vs. CHI,W,34,4,5,0.8,0,0,0.0,2,2,1.0,5,9,14,3,2,1,2,1,10,32,1,CLE,CLE,CHI,109,,,27,24,13,17
Jarrett Allen,C,22023,1628386,22300527,"JAN 11, 2024",CLE vs. BKN,W,38,3,5,0.6,0,0,0.0,6,6,1.0,3,9,12,4,2,4,1,5,12,6,1,CLE,CLE,BKN,111,,,28,24,16,16
Jarrett Allen,C,22023,1628386,22300497,"JAN 07, 2024",CLE vs. SAS,W,31,11,19,0.579,0,0,0.0,7,7,1.0,5,11,16,2,1,1,1,3,29,-10,1,CLE,CLE,SAS,117,,,47,45,31,18
Jarrett Allen,C,22023,1628386,22300482,"JAN 05, 2024",CLE vs. WAS,W,29,5,7,0.714,0,0,0.0,2,2,1.0,6,6,12,3,2,1,4,2,12,16,1,CLE,CLE,WAS,114,,,27,24,15,15
Jarrett Allen,C,22023,1628386,22300465,"JAN 03, 2024",CLE vs. WAS,W,29,7,10,0.7,0,0,0.0,3,4,0.75,7,12,19,7,0,2,1,0,17,27,1,CLE,CLE,WAS,140,,,43,36,24,26
Jarrett Allen,C,22023,1628386,22300452,"JAN 01, 2024",CLE @ TOR,L,34,5,11,0.455,0,0,0.0,6,8,0.75,3,8,11,4,1,0,0,4,16,-3,1,CLE,TOR,CLE,121,,,31,27,20,15
Jarrett Allen,C,22023,1628386,22300433,"DEC 29, 2023",CLE vs. MIL,L,40,15,17,0.882,0,0,0.0,0,0,0.0,3,9,12,6,0,2,0,2,30,-12,1,CLE,CLE,MIL,111,,,48,42,36,18
Jarrett Allen,C,22023,1628386,22300420,"DEC 27, 2023",CLE @ DAL,W,35,9,17,0.529,0,0,0.0,6,6,1.0,9,14,23,6,2,0,4,1,24,14,1,CLE,DAL,CLE,113,,,53,47,30,29
Jarrett Allen,C,22023,1628386,22300396,"DEC 23, 2023",CLE @ CHI,W,35,6,9,0.667,0,1,0.0,7,10,0.7,8,9,17,7,1,1,0,0,19,6,1,CLE,CHI,CLE,109,,,43,36,26,24
Jarrett Allen,C,22023,1628386,22300375,"DEC 21, 2023",CLE vs. NOP,L,27,7,8,0.875,0,0,0.0,0,0,0.0,1,6,7,3,1,0,1,0,14,-6,1,CLE,CLE,NOP,104,,,24,21,17,10
Jarrett Allen,C,22023,1628386,22300364,"DEC 20, 2023",CLE vs. UTA,W,30,8,13,0.615,0,0,0.0,1,2,0.5,3,5,8,3,2,0,2,1,17,-4,1,CLE,CLE,UTA,124,,,28,25,20,11
Jarrett Allen,C,22023,1628386,22300349,"DEC 18, 2023",CLE vs. HOU,W,29,3,7,0.429,0,0,0.0,4,7,0.571,2,4,6,2,0,2,1,5,10,-4,1,CLE,CLE,HOU,135,,,18,16,12,8
Jarrett Allen,C,22023,1628386,22300336,"DEC 16, 2023",CLE vs. ATL,W,35,12,14,0.857,0,0,0.0,1,1,1.0,4,10,14,1,2,1,4,1,25,5,1,CLE,CLE,ATL,127,,,40,39,26,15
Jarrett Allen,C,22023,1628386,22300319,"DEC 14, 2023",CLE @ BOS,L,39,4,7,0.571,0,0,0.0,0,0,0.0,1,9,10,3,0,0,3,1,8,-1,1,CLE,BOS,CLE,107,,,21,18,11,13
Jarrett Allen,C,22023,1628386,22300305,"DEC 12, 2023",CLE @ BOS,L,37,6,9,0.667,0,0,0.0,2,5,0.4,2,3,5,5,3,2,2,4,14,4,1,CLE,BOS,CLE,113,,,24,19,19,10
Jarrett Allen,C,22023,1628386,22300294,"DEC 11, 2023",CLE @ ORL,L,15,2,3,0.667,0,0,0.0,0,0,0.0,2,5,7,1,1,0,1,6,4,-15,1,CLE,ORL,CLE,94,,,12,11,5,8
Jarrett Allen,C,22023,1628386,22301220,"DEC 08, 2023",CLE @ MIA,W,25,3,9,0.333,0,0,0.0,0,2,0.0,2,7,9,1,1,0,0,2,6,-2,1,CLE,MIA,CLE,111,,,16,15,7,10
Jarrett Allen,C,22023,1628386,22301205,"DEC 06, 2023",CLE vs. ORL,W,19,4,5,0.8,0,0,0.0,0,0,0.0,2,9,11,2,1,0,4,5,8,2,1,CLE,CLE,ORL,121,,,21,19,10,13
Jarrett Allen,C,22023,1628386,22300283,"DEC 02, 2023",CLE @ DET,W,34,8,9,0.889,0,0,0.0,3,5,0.6,5,6,11,3,1,0,2,2,19,4,1,CLE,DET,CLE,110,,,33,30,22,14
Jarrett Allen,C,22023,1628386,22300265,"NOV 30, 2023",CLE vs. POR,L,38,6,9,0.667,0,0,0.0,0,0,0.0,6,4,10,2,0,2,1,3,12,-3,1,CLE,CLE,POR,95,,,24,22,14,12
Jarrett Allen,C,22023,1628386,22300055,"NOV 28, 2023",CLE vs. ATL,W,30,5,6,0.833,0,0,0.0,1,1,1.0,1,7,8,2,0,0,0,4,11,16,1,CLE,CLE,ATL,128,,,21,19,13,10
Jarrett Allen,C,22023,1628386,22300251,"NOV 26, 2023",CLE vs. TOR,W,27,9,10,0.9,0,0,0.0,0,0,0.0,3,1,4,3,0,2,2,4,18,-13,1,CLE,CLE,TOR,105,,,25,22,21,7
Jarrett Allen,C,22023,1628386,22300242,"NOV 25, 2023",CLE vs. LAL,L,37,9,12,0.75,0,0,0.0,3,4,0.75,5,9,14,3,3,2,2,3,21,-3,1,CLE,CLE,LAL,115,,,38,35,24,17
Jarrett Allen,C,22023,1628386,22300229,"NOV 22, 2023",CLE vs. MIA,L,23,1,2,0.5,0,0,0.0,2,2,1.0,0,4,4,2,0,0,3,2,4,-24,1,CLE,CLE,MIA,96,,,10,8,6,6
Jarrett Allen,C,22023,1628386,22300040,"NOV 21, 2023",CLE @ PHI,W,35,12,20,0.6,0,0,0.0,2,2,1.0,6,7,13,3,0,0,2,4,26,-6,1,CLE,PHI,CLE,122,,,42,39,29,16
Jarrett Allen,C,22023,1628386,22300210,"NOV 19, 2023",CLE vs. DEN,W,29,6,10,0.6,0,0,0.0,3,6,0.5,2,3,5,5,1,0,2,3,15,42,1,CLE,CLE,DEN,121,,,25,20,20,10
Jarrett Allen,C,22023,1628386,22300030,"NOV 17, 2023",CLE vs. DET,W,32,4,8,0.5,0,0,0.0,2,3,0.667,1,6,7,2,0,5,2,1,10,5,1,CLE,CLE,DET,108,,,19,17,12,9
Jarrett Allen,C,22023,1628386,22300199,"NOV 15, 2023",CLE @ POR,W,29,3,3,1.0,0,0,0.0,5,6,0.833,1,8,9,1,0,3,3,3,11,0,1,CLE,POR,CLE,109,,,21,20,12,10
Jarrett Allen,C,22023,1628386,22300191,"NOV 13, 2023",CLE @ SAC,L,22,5,6,0.833,0,0,0.0,2,3,0.667,4,5,9,1,0,0,2,2,12,-25,1,CLE,SAC,CLE,120,,,22,21,13,10
Jarrett Allen,C,22023,1628386,22300176,"NOV 11, 2023",CLE @ GSW,W,28,2,6,0.333,0,0,0.0,8,9,0.889,3,2,5,4,0,0,1,4,12,13,1,CLE,GSW,CLE,118,,,21,17,16,9
Jarrett Allen,C,22023,1628386,22300167,"NOV 08, 2023",CLE @ OKC,L,26,4,6,0.667,0,0,0.0,6,9,0.667,4,2,6,1,2,1,1,0,14,-4,1,CLE,OKC,CLE,120,,,21,20,15,7
Jarrett Allen,C,22023,1628386,22300142,"NOV 05, 2023",CLE vs. GSW,W,28,5,7,0.714,0,0,0.0,2,2,1.0,5,4,9,3,0,0,2,1,12,9,1,CLE,CLE,GSW,115,,,24,21,15,12
Jarrett Allen,C,22023,1628386,22300001,"NOV 03, 2023",CLE @ IND,L,21,4,6,0.667,0,0,0.0,2,3,0.667,2,5,7,0,1,2,1,4,10,-1,1,CLE,IND,CLE,116,,,17,17,10,7
Brandon Miller,F,22023,1641706,22300745,"FEB 09, 2024",CHA @ MIL,L,29,6,18,0.333,1,6,0.167,3,4,0.75,2,4,6,3,1,1,2,2,16,-31,1,CHA,MIL,CHA,80,,,25,22,19,9
Brandon Miller,F,22023,1641706,22300335,"DEC 16, 2023",CHA vs. PHI,L,29,4,16,0.25,2,7,0.286,4,4,1.0,0,4,4,4,0,1,3,0,14,-28,1,CHA,CHA,PHI,80,,,22,18,18,8
Brandon Miller,F,22023,1641706,22300177,"NOV 12, 2023",CHA @ NYK,L,10,5,6,0.833,1,2,0.5,0,1,0.0,1,2,3,0,0,0,0,0,11,4,1,CHA,NYK,CHA,107,,,14,14,11,3
Brandon Miller,F,22023,1641706,22300635,"JAN 26, 2024",CHA vs. HOU,L,20,2,8,0.25,1,3,0.333,0,0,0.0,0,1,1,2,0,0,0,4,5,-25,1,CHA,CHA,HOU,104,,,8,6,7,3
Brandon Miller,F,22023,1641706,22300619,"JAN 24, 2024",CHA @ DET,L,39,8,17,0.471,5,10,0.5,2,3,0.667,1,6,7,4,0,1,2,4,23,-15,1,CHA,DET,CHA,106,,,34,30,27,11
Brandon Miller,F,22023,1641706,22300610,"JAN 22, 2024",CHA @ MIN,W,29,11,13,0.846,3,4,0.75,2,2,1.0,0,3,3,2,1,0,0,4,27,14,1,CHA,MIN,CHA,126,,,32,30,29,5
Brandon Miller,F,22023,1641706,22300584,"JAN 19, 2024",CHA vs. SAS,W,35,8,14,0.571,4,7,0.571,4,5,0.8,3,6,9,2,2,0,3,0,24,5,1,CHA,CHA,SAS,124,,,35,33,26,11
Brandon Miller,F,22023,1641706,22300541,"JAN 12, 2024",CHA @ SAS,L,9,0,5,0.0,0,1,0.0,1,2,0.5,2,0,2,1,1,0,1,1,1,-5,1,CHA,SAS,CHA,99,,,4,3,2,3
Brandon Miller,F,22023,1641706,22300248,"NOV 26, 2023",CHA @ ORL,L,33,7,11,0.636,2,3,0.667,4,5,0.8,0,5,5,1,1,0,2,5,20,-1,1,CHA,ORL,CHA,117,,,26,25,21,6
Brandon Miller,F,22023,1641706,22300225,"NOV 22, 2023",CHA vs. WAS,W,31,6,12,0.5,3,6,0.5,0,0,0.0,0,0,0,3,1,0,0,2,15,-2,1,CHA,CHA,WAS,117,,,18,15,18,3
Brandon Miller,F,22023,1641706,22300217,"NOV 20, 2023",CHA vs. BOS,W,40,4,12,0.333,1,4,0.25,0,0,0.0,4,3,7,4,2,1,2,2,9,22,1,CHA,CHA,BOS,121,,,20,16,13,11
Brandon Miller,F,22023,1641706,22300202,"NOV 18, 2023",CHA vs. NYK,L,34,10,15,0.667,5,7,0.714,4,4,1.0,0,3,3,2,0,0,2,3,29,-7,1,CHA,CHA,NYK,108,,,34,32,31,5
Brandon Miller,F,22023,1641706,22300027,"NOV 17, 2023",CHA vs. MIL,L,27,5,12,0.417,0,3,0.0,0,1,0.0,2,2,4,3,1,0,1,2,10,-24,1,CHA,CHA,MIL,99,,,17,14,13,7
Brandon Miller,F,22023,1641706,22300009,"NOV 10, 2023",CHA @ WAS,W,32,5,16,0.313,0,6,0.0,2,2,1.0,2,1,3,2,1,2,1,5,12,3,1,CHA,WAS,CHA,124,,,17,15,14,5
Brandon Miller,F,22023,1641706,22300157,"NOV 08, 2023",CHA vs. WAS,L,30,5,11,0.455,1,2,0.5,2,3,0.667,2,3,5,2,1,0,2,2,13,-11,1,CHA,CHA,WAS,116,,,20,18,15,7
Brandon Miller,F,22023,1641706,22300143,"NOV 05, 2023",CHA @ DAL,L,36,3,12,0.25,0,5,0.0,1,2,0.5,0,1,1,1,1,0,0,3,7,-9,1,CHA,DAL,CHA,118,,,9,8,8,2
Brandon Miller,F,22023,1641706,22300133,"NOV 04, 2023",CHA @ IND,W,34,4,7,0.571,0,2,0.0,2,2,1.0,1,2,3,1,0,1,0,4,10,17,1,CHA,IND,CHA,125,,,14,13,11,4
Brandon Miller,F,22023,1641706,22300122,"NOV 01, 2023",CHA @ HOU,L,24,4,9,0.444,1,3,0.333,1,2,0.5,1,4,5,2,0,0,1,5,10,-6,1,CHA,HOU,CHA,119,,,17,15,12,7
Brandon Miller,F,22023,1641706,22300101,"OCT 30, 2023",CHA vs. BKN,L,36,7,16,0.438,2,5,0.4,6,6,1.0,4,5,9,2,0,1,0,3,22,-4,1,CHA,CHA,BKN,121,,,33,31,24,11
Brandon Miller,F,22023,1641706,22300077,"OCT 27, 2023",CHA vs. DET,L,33,6,13,0.462,2,4,0.5,3,4,0.75,2,4,6,2,1,1,3,4,17,-2,1,CHA,CHA,DET,99,,,25,23,19,8
Brandon Miller,F,22023,1641706,22300063,"OCT 25, 2023",CHA vs. ATL,W,25,5,9,0.556,3,7,0.429,0,0,0.0,0,3,3,2,0,0,1,3,13,-13,1,CHA,CHA,ATL,116,,,18,16,15,5
Brandon Miller,F,22023,1641706,22300751,"FEB 10, 2024",CHA vs. MEM,W,31,7,9,0.778,3,4,0.75,1,1,1.0,0,6,6,1,0,0,3,4,18,0,1,CHA,CHA,MEM,115,,,25,24,19,7
Brandon Miller,F,22023,1641706,22300726,"FEB 07, 2024",CHA vs. TOR,L,41,9,17,0.529,2,8,0.25,0,0,0.0,0,4,4,1,2,1,4,1,20,-12,1,CHA,CHA,TOR,117,,,25,24,21,5
Brandon Miller,F,22023,1641706,22300713,"FEB 05, 2024",CHA vs. LAL,L,33,13,25,0.52,5,11,0.455,2,2,1.0,1,3,4,3,4,0,2,4,33,3,1,CHA,CHA,LAL,118,,,40,37,36,7
Brandon Miller,F,22023,1641706,22300707,"FEB 04, 2024",CHA vs. IND,L,38,10,25,0.4,5,12,0.417,10,12,0.833,2,4,6,1,1,2,1,1,35,0,1,CHA,CHA,IND,99,,,42,41,36,7
Brandon Miller,F,22023,1641706,22300695,"FEB 02, 2024",CHA @ OKC,L,32,11,19,0.579,5,8,0.625,1,1,1.0,1,3,4,4,3,2,2,4,28,-17,1,CHA,OKC,CHA,106,,,36,32,32,8
Brandon Miller,F,22023,1641706,22300674,"JAN 31, 2024",CHA vs. CHI,L,38,8,21,0.381,3,10,0.3,2,2,1.0,0,1,1,3,1,0,2,2,21,-17,1,CHA,CHA,CHI,110,,,25,22,24,4
Brandon Miller,F,22023,1641706,22300657,"JAN 29, 2024",CHA vs. NYK,L,39,11,19,0.579,3,6,0.5,4,5,0.8,1,6,7,3,0,1,1,1,29,-19,1,CHA,CHA,NYK,92,,,39,36,32,10
Brandon Miller,F,22023,1641706,22300647,"JAN 27, 2024",CHA vs. UTA,L,37,6,18,0.333,0,7,0.0,0,0,0.0,0,1,1,3,1,0,1,3,12,-6,1,CHA,CHA,UTA,122,,,16,13,15,4
Brandon Miller,F,22023,1641706,22300518,"JAN 10, 2024",CHA vs. SAC,L,28,5,10,0.5,4,6,0.667,1,2,0.5,0,1,1,2,0,0,0,1,15,4,1,CHA,CHA,SAC,96,,,18,16,17,3
Brandon Miller,F,22023,1641706,22300365,"DEC 20, 2023",CHA @ IND,L,33,9,17,0.529,2,4,0.5,1,2,0.5,2,4,6,3,1,0,1,4,21,-30,1,CHA,IND,CHA,109,,,30,27,24,9
Brandon Miller,F,22023,1641706,22300354,"DEC 18, 2023",CHA @ TOR,L,37,6,16,0.375,0,5,0.0,2,2,1.0,0,3,3,0,0,1,3,3,14,-6,1,CHA,TOR,CHA,99,,,17,17,14,3
Brandon Miller,F,22023,1641706,22300057,"NOV 28, 2023",CHA @ NYK,L,36,7,18,0.389,4,8,0.5,0,0,0.0,0,3,3,2,1,0,3,2,18,-24,1,CHA,NYK,CHA,91,,,23,21,20,5
Brandon Miller,F,22023,1641706,22300506,"JAN 08, 2024",CHA vs. CHI,L,31,2,11,0.182,0,7,0.0,0,0,0.0,0,6,6,4,1,0,3,4,4,-6,1,CHA,CHA,CHI,109,,,14,10,8,10
Brandon Miller,F,22023,1641706,22300455,"JAN 01, 2024",CHA @ DEN,L,32,5,17,0.294,3,9,0.333,2,2,1.0,0,5,5,1,0,0,2,1,15,-31,1,CHA,DEN,CHA,91,,,21,20,16,6
Brandon Miller,F,22023,1641706,22300428,"DEC 28, 2023",CHA @ LAL,L,29,5,9,0.556,3,5,0.6,4,4,1.0,1,0,1,2,1,1,3,0,17,-4,1,CHA,LAL,CHA,110,,,20,18,19,3
Brandon Miller,F,22023,1641706,22300593,"JAN 20, 2024",CHA vs. PHI,L,35,8,17,0.471,2,10,0.2,5,5,1.0,2,5,7,3,0,1,1,1,23,-6,1,CHA,CHA,PHI,89,,,33,30,26,10
Brandon Miller,F,22023,1641706,22300484,"JAN 05, 2024",CHA @ CHI,L,23,3,13,0.231,1,7,0.143,2,2,1.0,0,3,3,1,1,0,0,3,9,3,1,CHA,CHI,CHA,87,,,13,12,10,4
Brandon Miller,F,22023,1641706,22300436,"DEC 29, 2023",CHA @ PHX,L,31,7,16,0.438,6,10,0.6,0,0,0.0,1,0,1,3,1,1,0,4,20,-15,1,CHA,PHX,CHA,119,,,24,21,23,4
Brandon Miller,F,22023,1641706,22300390,"DEC 23, 2023",CHA vs. DEN,L,11,2,5,0.4,0,2,0.0,0,0,0.0,0,1,1,2,0,0,3,1,4,-4,1,CHA,CHA,DEN,95,,,7,5,6,3
Brandon Miller,F,22023,1641706,22300326,"DEC 15, 2023",CHA vs. NOP,L,35,7,16,0.438,2,5,0.4,0,2,0.0,0,4,4,3,1,0,0,3,16,-1,1,CHA,CHA,NOP,105,,,23,20,19,7
Brandon Miller,F,22023,1641706,22300312,"DEC 13, 2023",CHA @ MIA,L,39,7,16,0.438,4,10,0.4,0,0,0.0,0,2,2,3,3,0,5,3,18,-4,1,CHA,MIA,CHA,104,,,23,20,21,5
Brandon Miller,F,22023,1641706,22300292,"DEC 11, 2023",CHA vs. MIA,L,30,6,14,0.429,3,8,0.375,1,1,1.0,0,4,4,2,0,0,2,5,16,3,1,CHA,CHA,MIA,114,,,22,20,18,6
Brandon Miller,F,22023,1641706,22301216,"DEC 08, 2023",CHA vs. TOR,W,35,7,15,0.467,4,7,0.571,2,2,1.0,0,5,5,3,0,2,4,1,20,2,1,CHA,CHA,TOR,119,,,28,25,23,8
Brandon Miller,F,22023,1641706,22301211,"DEC 06, 2023",CHA @ CHI,L,39,4,14,0.286,3,6,0.5,1,1,1.0,0,6,6,4,1,1,2,3,12,-8,1,CHA,CHI,CHA,100,,,22,18,16,10
Brandon Miller,F,22023,1641706,22300281,"DEC 02, 2023",CHA vs. MIN,L,36,5,13,0.385,2,4,0.5,2,2,1.0,1,4,5,3,0,2,2,3,14,-8,1,CHA,CHA,MIN,117,,,22,19,17,8
Austin Reaves,G,22023,1630559,22300605,"JAN 21, 2024",LAL vs. POR,W,26,5,10,0.5,3,4,0.75,2,2,1.0,1,3,4,2,1,0,1,1,15,4,1,LAL,LAL,POR,134,,,21,19,17,6
Austin Reaves,G,22023,1630559,22300331,"DEC 15, 2023",LAL @ SAS,L,34,8,18,0.444,4,10,0.4,2,2,1.0,2,5,7,4,0,0,2,0,22,-8,1,LAL,SAS,LAL,115,,,33,29,26,11
Austin Reaves,G,22023,1630559,22300271,"NOV 30, 2023",LAL @ OKC,L,29,5,9,0.556,1,4,0.25,3,3,1.0,0,2,2,3,0,0,2,2,14,-23,1,LAL,OKC,LAL,110,,,19,16,17,5
Austin Reaves,G,22023,1630559,22300163,"NOV 08, 2023",LAL @ HOU,L,26,2,9,0.222,0,4,0.0,3,3,1.0,0,1,1,4,2,0,2,1,7,-28,1,LAL,HOU,LAL,94,,,12,8,11,5
Austin Reaves,G,22023,1630559,22300134,"NOV 04, 2023",LAL @ ORL,L,34,7,11,0.636,3,5,0.6,3,4,0.75,0,2,2,2,2,0,1,0,20,6,1,LAL,ORL,LAL,101,,,24,22,22,4
Austin Reaves,G,22023,1630559,22300740,"FEB 08, 2024",LAL vs. DEN,L,36,6,16,0.375,2,7,0.286,1,2,0.5,1,1,2,10,2,0,1,2,15,-9,1,LAL,LAL,DEN,106,,,27,17,25,12
Austin Reaves,G,22023,1630559,22300713,"FEB 05, 2024",LAL @ CHA,W,36,3,8,0.375,0,5,0.0,3,3,1.0,0,4,4,11,1,1,5,3,9,15,1,LAL,CHA,LAL,124,,,24,13,20,15
Austin Reaves,G,22023,1630559,22300701,"FEB 03, 2024",LAL @ NYK,W,39,6,13,0.462,3,6,0.5,7,8,0.875,0,6,6,7,0,2,1,3,22,8,1,LAL,NYK,LAL,113,,,35,28,29,13
Austin Reaves,G,22023,1630559,22300684,"FEB 01, 2024",LAL @ BOS,W,35,10,18,0.556,7,10,0.7,5,7,0.714,0,2,2,3,0,0,0,1,32,16,1,LAL,BOS,LAL,114,,,37,34,35,5
Austin Reaves,G,22023,1630559,22300669,"JAN 30, 2024",LAL @ ATL,L,32,10,19,0.526,3,8,0.375,5,7,0.714,0,0,0,6,2,0,2,1,28,-15,1,LAL,ATL,LAL,122,,,34,28,34,6
Austin Reaves,G,22023,1630559,22300662,"JAN 29, 2024",LAL @ HOU,L,30,3,8,0.375,1,3,0.333,1,2,0.5,1,2,3,5,1,0,2,1,8,-11,1,LAL,HOU,LAL,119,,,16,11,13,8
Austin Reaves,G,22023,1630559,22300650,"JAN 27, 2024",LAL @ GSW,W,47,4,14,0.286,1,7,0.143,8,9,0.889,0,2,2,6,2,0,5,3,17,4,1,LAL,GSW,LAL,145,,,25,19,23,8
Austin Reaves,G,22023,1630559,22300633,"JAN 25, 2024",LAL vs. CHI,W,33,7,9,0.778,2,3,0.667,4,4,1.0,0,3,3,8,0,0,1,4,20,14,1,LAL,LAL,CHI,141,,,31,23,28,11
Austin Reaves,G,22023,1630559,22300618,"JAN 23, 2024",LAL @ LAC,L,34,5,14,0.357,2,8,0.25,0,0,0.0,0,2,2,5,2,1,3,3,12,-8,1,LAL,LAC,LAL,116,,,19,14,17,7
Austin Reaves,G,22023,1630559,22300591,"JAN 19, 2024",LAL vs. BKN,L,33,4,12,0.333,0,6,0.0,1,1,1.0,0,3,3,5,1,0,0,2,9,-13,1,LAL,LAL,BKN,112,,,17,12,14,8
Austin Reaves,G,22023,1630559,22300577,"JAN 17, 2024",LAL vs. DAL,W,30,6,8,0.75,2,2,1.0,0,0,0.0,0,3,3,7,1,0,3,2,14,20,1,LAL,LAL,DAL,127,,,24,17,21,10
Austin Reaves,G,22023,1630559,22300565,"JAN 15, 2024",LAL vs. OKC,W,33,6,10,0.6,1,3,0.333,2,2,1.0,0,3,3,7,0,1,2,0,15,9,1,LAL,LAL,OKC,112,,,25,18,22,10
Austin Reaves,G,22023,1630559,22300549,"JAN 13, 2024",LAL @ UTA,L,31,7,8,0.875,1,2,0.5,4,6,0.667,1,3,4,2,0,0,1,6,19,-21,1,LAL,UTA,LAL,125,,,25,23,21,6
Austin Reaves,G,22023,1630559,22300531,"JAN 11, 2024",LAL vs. PHX,L,30,4,7,0.571,2,3,0.667,3,3,1.0,1,0,1,6,1,0,3,2,13,-23,1,LAL,LAL,PHX,109,,,20,14,19,7
Austin Reaves,G,22023,1630559,22300516,"JAN 09, 2024",LAL vs. TOR,W,32,3,10,0.3,1,6,0.167,4,4,1.0,0,3,3,7,1,0,0,2,11,-2,1,LAL,LAL,TOR,132,,,21,14,18,10
Austin Reaves,G,22023,1630559,22300505,"JAN 07, 2024",LAL vs. LAC,W,32,2,5,0.4,0,3,0.0,4,5,0.8,0,0,0,2,0,0,2,0,8,-4,1,LAL,LAL,LAC,106,,,10,8,10,2
Austin Reaves,G,22023,1630559,22300491,"JAN 05, 2024",LAL vs. MEM,L,40,8,14,0.571,0,3,0.0,3,4,0.75,0,7,7,12,2,0,1,4,19,-23,1,LAL,LAL,MEM,113,,,38,26,31,19
Austin Reaves,G,22023,1630559,22300475,"JAN 03, 2024",LAL vs. MIA,L,37,7,12,0.583,2,6,0.333,8,9,0.889,0,5,5,8,0,0,3,2,24,-2,1,LAL,LAL,MIA,96,,,37,29,32,13
Austin Reaves,G,22023,1630559,22300446,"DEC 31, 2023",LAL @ NOP,L,36,7,12,0.583,1,5,0.2,5,6,0.833,1,1,2,9,1,1,0,3,20,-19,1,LAL,NOP,LAL,109,,,31,22,29,11
Austin Reaves,G,22023,1630559,22300428,"DEC 28, 2023",LAL vs. CHA,W,24,6,8,0.75,2,3,0.667,2,2,1.0,0,2,2,4,1,0,0,4,16,9,1,LAL,LAL,CHA,133,,,22,18,20,6
Austin Reaves,G,22023,1630559,22300370,"DEC 20, 2023",LAL @ CHI,L,28,9,14,0.643,2,5,0.4,1,1,1.0,0,0,0,3,1,1,3,1,21,-22,1,LAL,CHI,LAL,108,,,24,21,24,3
Austin Reaves,G,22023,1630559,22300316,"DEC 13, 2023",LAL @ SAS,W,29,6,10,0.6,3,6,0.5,0,0,0.0,2,2,4,8,1,0,1,2,15,-9,1,LAL,SAS,LAL,122,,,27,19,23,12
Austin Reaves,G,22023,1630559,22300306,"DEC 12, 2023",LAL @ DAL,L,32,7,14,0.5,4,7,0.571,4,5,0.8,0,5,5,8,0,0,3,2,22,4,1,LAL,DAL,LAL,125,,,35,27,30,13
Austin Reaves,G,22023,1630559,22301230,"DEC 07, 2023",LAL vs. NOP,W,23,5,9,0.556,3,6,0.5,4,4,1.0,0,5,5,7,1,0,2,0,17,21,1,LAL,LAL,NOP,133,,,29,22,24,12
Austin Reaves,G,22023,1630559,22301203,"DEC 05, 2023",LAL vs. PHX,W,27,7,16,0.438,3,8,0.375,3,3,1.0,2,4,6,2,0,0,3,1,20,17,1,LAL,LAL,PHX,106,,,28,26,22,8
Austin Reaves,G,22023,1630559,22300291,"DEC 02, 2023",LAL vs. HOU,W,22,6,11,0.545,1,4,0.25,5,6,0.833,1,3,4,1,3,0,1,2,18,15,1,LAL,LAL,HOU,107,,,23,22,19,5
Austin Reaves,G,22023,1630559,22300258,"NOV 29, 2023",LAL @ DET,W,24,3,8,0.375,0,4,0.0,0,0,0.0,1,2,3,4,0,1,2,2,6,13,1,LAL,DET,LAL,133,,,13,9,10,7
Austin Reaves,G,22023,1630559,22300255,"NOV 27, 2023",LAL @ PHI,L,29,4,10,0.4,1,4,0.25,3,3,1.0,0,2,2,2,0,0,3,2,12,-19,1,LAL,PHI,LAL,94,,,16,14,14,4
Austin Reaves,G,22023,1630559,22300242,"NOV 25, 2023",LAL @ CLE,W,32,4,8,0.5,1,2,0.5,6,6,1.0,1,4,5,10,2,0,2,1,15,-2,1,LAL,CLE,LAL,121,,,30,20,25,15
Austin Reaves,G,22023,1630559,22300238,"NOV 22, 2023",LAL vs. DAL,L,31,7,14,0.5,1,5,0.2,2,3,0.667,1,5,6,6,0,0,2,5,17,-3,1,LAL,LAL,DAL,101,,,29,23,23,12
Austin Reaves,G,22023,1630559,22300042,"NOV 21, 2023",LAL vs. UTA,W,26,7,13,0.538,1,4,0.25,4,4,1.0,0,5,5,5,3,0,2,0,19,10,1,LAL,LAL,UTA,131,,,29,24,24,10
Austin Reaves,G,22023,1630559,22300036,"NOV 17, 2023",LAL @ POR,W,18,1,4,0.25,0,0,0.0,5,6,0.833,1,1,2,4,0,0,3,0,7,11,1,LAL,POR,LAL,107,,,13,9,11,6
Austin Reaves,G,22023,1630559,22300198,"NOV 15, 2023",LAL vs. SAC,L,34,4,10,0.4,0,5,0.0,1,2,0.5,2,9,11,8,1,0,4,1,9,0,1,LAL,LAL,SAC,110,,,28,20,17,19
Austin Reaves,G,22023,1630559,22300026,"NOV 14, 2023",LAL vs. MEM,W,29,5,9,0.556,4,4,1.0,2,3,0.667,2,10,12,7,0,0,3,0,16,13,1,LAL,LAL,MEM,134,,,35,28,23,19
Austin Reaves,G,22023,1630559,22300187,"NOV 12, 2023",LAL vs. POR,W,28,6,12,0.5,2,4,0.5,4,4,1.0,0,4,4,4,0,0,1,0,18,3,1,LAL,LAL,POR,116,,,26,22,22,8
Austin Reaves,G,22023,1630559,22300150,"NOV 06, 2023",LAL @ MIA,L,40,9,14,0.643,3,8,0.375,2,3,0.667,3,7,10,9,1,0,4,1,23,2,1,LAL,MIA,LAL,107,,,42,33,32,19
Austin Reaves,G,22023,1630559,22300127,"NOV 01, 2023",LAL vs. LAC,W,38,5,13,0.385,0,3,0.0,5,5,1.0,2,5,7,7,3,0,5,4,15,-5,1,LAL,LAL,LAC,130,,,29,22,22,14
Austin Reaves,G,22023,1630559,22300061,"OCT 24, 2023",LAL @ DEN,L,31,4,11,0.364,1,2,0.5,5,7,0.714,4,4,8,4,2,0,2,2,14,-14,1,LAL,DEN,LAL,107,,,26,22,18,12
Austin Reaves,G,22023,1630559,22300747,"FEB 09, 2024",LAL vs. NOP,W,31,10,15,0.667,3,4,0.75,4,5,0.8,0,2,2,4,0,0,0,3,27,3,1,LAL,LAL,NOP,139,,,33,29,31,6
Austin Reaves,G,22023,1630559,22300443,"DEC 30, 2023",LAL @ MIN,L,29,2,11,0.182,0,5,0.0,5,6,0.833,1,1,2,0,0,0,1,2,9,2,1,LAL,MIN,LAL,106,,,11,11,9,2
Austin Reaves,G,22023,1630559,22300403,"DEC 25, 2023",LAL vs. BOS,L,28,4,9,0.444,2,3,0.667,1,1,1.0,4,2,6,3,1,0,2,3,11,-1,1,LAL,LAL,BOS,115,,,20,17,14,9
Austin Reaves,G,22023,1630559,22300397,"DEC 23, 2023",LAL @ OKC,W,28,4,8,0.5,2,5,0.4,1,1,1.0,0,3,3,9,0,0,1,3,11,-2,1,LAL,OKC,LAL,129,,,23,14,20,12
Austin Reaves,G,22023,1630559,22300380,"DEC 21, 2023",LAL @ MIN,L,27,7,14,0.5,1,4,0.25,5,5,1.0,2,6,8,5,2,0,4,2,20,-9,1,LAL,MIN,LAL,111,,,33,28,25,13
Austin Reaves,G,22023,1630559,22300359,"DEC 18, 2023",LAL vs. NYK,L,33,6,15,0.4,3,7,0.429,5,5,1.0,0,3,3,7,1,0,4,2,20,7,1,LAL,LAL,NYK,109,,,30,23,27,10
Austin Reaves,G,22023,1630559,22300216,"NOV 19, 2023",LAL vs. HOU,W,25,5,7,0.714,2,3,0.667,5,6,0.833,0,6,6,6,0,0,2,0,17,9,1,LAL,LAL,HOU,105,,,29,23,23,12
Austin Reaves,G,22023,1630559,22300015,"NOV 10, 2023",LAL @ PHX,W,35,6,11,0.545,2,4,0.5,1,1,1.0,0,1,1,7,1,0,2,1,15,-2,1,LAL,PHX,LAL,122,,,23,16,22,8
Austin Reaves,G,22023,1630559,22300111,"OCT 30, 2023",LAL vs. ORL,W,31,5,12,0.417,1,4,0.25,0,0,0.0,0,3,3,3,0,1,3,0,11,-14,1,LAL,LAL,ORL,106,,,17,14,14,6
Austin Reaves,G,22023,1630559,22300100,"OCT 29, 2023",LAL @ SAC,L,28,1,12,0.083,1,8,0.125,2,2,1.0,0,2,2,2,1,0,3,2,5,-12,1,LAL,SAC,LAL,127,,,9,7,7,4
Austin Reaves,G,22023,1630559,22300076,"OCT 26, 2023",LAL vs. PHX,W,28,4,7,0.571,1,2,0.5,1,2,0.5,1,1,2,1,1,0,1,5,10,-11,1,LAL,LAL,PHX,100,,,13,12,11,3
Khris Middleton,F,22023,203114,22300725,"FEB 06, 2024",MIL @ PHX,L,8,2,3,0.667,1,1,1.0,1,2,0.5,0,3,3,1,1,0,1,1,6,-1,1,MIL,PHX,MIL,106,,,10,9,7,4
Khris Middleton,F,22023,203114,22300702,"FEB 03, 2024",MIL @ DAL,W,38,5,15,0.333,1,4,0.25,2,2,1.0,1,2,3,8,1,0,2,5,13,24,1,MIL,DAL,MIL,129,,,24,16,21,11
Khris Middleton,F,22023,203114,22300683,"JAN 31, 2024",MIL @ POR,L,34,9,13,0.692,3,5,0.6,0,0,0.0,0,2,2,8,0,1,1,3,21,7,1,MIL,POR,MIL,116,,,31,23,29,10
Khris Middleton,F,22023,203114,22300667,"JAN 29, 2024",MIL @ DEN,L,30,6,10,0.6,2,6,0.333,0,0,0.0,0,8,8,3,0,1,4,5,14,2,1,MIL,DEN,MIL,107,,,25,22,17,11
Khris Middleton,F,22023,203114,22300639,"JAN 26, 2024",MIL vs. CLE,L,36,5,16,0.313,2,6,0.333,2,2,1.0,2,6,8,8,2,0,3,3,14,-19,1,MIL,MIL,CLE,100,,,30,22,22,16
Khris Middleton,F,22023,203114,22300624,"JAN 24, 2024",MIL vs. CLE,W,32,8,15,0.533,1,4,0.25,7,8,0.875,2,3,5,5,2,0,0,3,24,16,1,MIL,MIL,CLE,126,,,34,29,29,10
Khris Middleton,F,22023,203114,22300606,"JAN 22, 2024",MIL @ DET,W,31,9,14,0.643,2,5,0.4,6,6,1.0,0,2,2,2,2,0,1,2,26,9,1,MIL,DET,MIL,122,,,30,28,28,4
Khris Middleton,F,22023,203114,22300592,"JAN 20, 2024",MIL @ DET,W,33,5,12,0.417,3,7,0.429,4,6,0.667,0,5,5,4,1,2,1,4,17,7,1,MIL,DET,MIL,141,,,26,22,21,9
Khris Middleton,F,22023,203114,22300545,"JAN 13, 2024",MIL vs. GSW,W,33,10,13,0.769,3,5,0.6,1,2,0.5,1,2,3,10,1,1,3,2,24,-2,1,MIL,MIL,GSW,129,,,37,27,34,13
Khris Middleton,F,22023,203114,22300528,"JAN 11, 2024",MIL vs. BOS,W,20,2,9,0.222,1,5,0.2,0,0,0.0,0,2,2,7,1,0,0,2,5,25,1,MIL,MIL,BOS,135,,,14,7,12,9
Khris Middleton,F,22023,203114,22300510,"JAN 08, 2024",MIL vs. UTA,L,34,7,16,0.438,3,6,0.5,6,6,1.0,0,3,3,8,2,1,3,1,23,-8,1,MIL,MIL,UTA,116,,,34,26,31,11
Khris Middleton,F,22023,203114,22300496,"JAN 06, 2024",MIL @ HOU,L,33,3,9,0.333,0,5,0.0,4,6,0.667,0,3,3,5,1,0,3,5,10,7,1,MIL,HOU,MIL,108,,,18,13,15,8
Khris Middleton,F,22023,203114,22300477,"JAN 04, 2024",MIL @ SAS,W,15,5,8,0.625,2,3,0.667,0,0,0.0,0,3,3,5,1,0,1,0,12,7,1,MIL,SAS,MIL,125,,,20,15,17,8
Khris Middleton,F,22023,203114,22300466,"JAN 03, 2024",MIL @ IND,L,32,7,13,0.538,4,7,0.571,1,1,1.0,1,5,6,7,0,2,4,2,19,-15,1,MIL,IND,MIL,130,,,32,25,26,13
Khris Middleton,F,22023,203114,22300454,"JAN 01, 2024",MIL vs. IND,L,32,9,13,0.692,2,5,0.4,1,2,0.5,1,2,3,6,1,0,4,5,21,5,1,MIL,MIL,IND,113,,,30,24,27,9
Khris Middleton,F,22023,203114,22300433,"DEC 29, 2023",MIL @ CLE,W,33,4,10,0.4,1,3,0.333,4,4,1.0,0,3,3,11,3,0,4,1,13,7,1,MIL,CLE,MIL,119,,,27,16,24,14
Khris Middleton,F,22023,203114,22300417,"DEC 27, 2023",MIL @ BKN,W,32,11,18,0.611,3,7,0.429,2,2,1.0,1,2,3,10,0,2,3,2,27,5,1,MIL,BKN,MIL,144,,,40,30,37,13
Khris Middleton,F,22023,203114,22300401,"DEC 25, 2023",MIL @ NYK,L,33,10,20,0.5,4,9,0.444,0,0,0.0,0,2,2,6,1,0,2,4,24,9,1,MIL,NYK,MIL,122,,,32,26,30,8
Khris Middleton,F,22023,203114,22300388,"DEC 23, 2023",MIL @ NYK,W,33,9,16,0.563,2,4,0.5,0,0,0.0,1,4,5,5,0,0,3,4,20,17,1,MIL,NYK,MIL,130,,,30,25,25,10
Khris Middleton,F,22023,203114,22300378,"DEC 21, 2023",MIL vs. ORL,W,29,5,11,0.455,2,7,0.286,2,2,1.0,0,4,4,3,0,1,1,2,14,11,1,MIL,MIL,ORL,118,,,21,18,17,7
Khris Middleton,F,22023,203114,22300361,"DEC 19, 2023",MIL vs. SAS,W,28,7,15,0.467,3,6,0.5,0,0,0.0,0,3,3,4,1,0,1,2,17,12,1,MIL,MIL,SAS,132,,,24,20,21,7
Khris Middleton,F,22023,203114,22300346,"DEC 17, 2023",MIL vs. HOU,W,29,7,15,0.467,1,5,0.2,5,5,1.0,0,3,3,2,0,0,4,3,20,7,1,MIL,MIL,HOU,128,,,25,23,22,5
Khris Middleton,F,22023,203114,22300315,"DEC 13, 2023",MIL vs. IND,W,29,6,11,0.545,1,3,0.333,1,1,1.0,1,8,9,7,1,0,1,3,14,14,1,MIL,MIL,IND,140,,,30,23,21,16
Khris Middleton,F,22023,203114,22300300,"DEC 11, 2023",MIL vs. CHI,W,33,5,11,0.455,0,3,0.0,3,4,0.75,1,12,13,6,1,0,4,4,13,0,1,MIL,MIL,CHI,133,,,32,26,19,19
Khris Middleton,F,22023,203114,22301229,"DEC 07, 2023",MIL vs. IND,L,30,7,13,0.538,4,5,0.8,2,2,1.0,1,6,7,4,2,0,4,2,20,-3,1,MIL,MIL,IND,119,,,31,27,24,11
Khris Middleton,F,22023,203114,22301201,"DEC 05, 2023",MIL vs. NYK,W,26,6,12,0.5,2,3,0.667,0,0,0.0,2,2,4,7,1,0,2,1,14,11,1,MIL,MIL,NYK,146,,,25,18,21,11
Khris Middleton,F,22023,203114,22300286,"DEC 02, 2023",MIL vs. ATL,W,25,5,9,0.556,2,4,0.5,0,0,0.0,0,5,5,3,1,0,1,0,12,-8,1,MIL,MIL,ATL,132,,,20,17,15,8
Khris Middleton,F,22023,203114,22300269,"NOV 30, 2023",MIL @ CHI,L,27,3,10,0.3,1,4,0.25,2,5,0.4,0,3,3,3,2,0,3,3,9,-8,1,MIL,CHI,MIL,113,,,15,12,12,6
Khris Middleton,F,22023,203114,22300056,"NOV 28, 2023",MIL @ MIA,W,23,7,13,0.538,1,3,0.333,2,2,1.0,1,7,8,2,0,0,0,3,17,20,1,MIL,MIA,MIL,131,,,27,25,19,10
Khris Middleton,F,22023,203114,22300049,"NOV 24, 2023",MIL vs. WAS,W,13,3,8,0.375,1,3,0.333,0,0,0.0,0,1,1,5,0,0,1,1,7,5,1,MIL,MIL,WAS,131,,,13,8,12,6
Khris Middleton,F,22023,203114,22300228,"NOV 22, 2023",MIL @ BOS,L,29,4,14,0.286,2,5,0.4,2,2,1.0,2,3,5,7,1,0,0,4,12,-6,1,MIL,BOS,MIL,116,,,24,17,19,12
Khris Middleton,F,22023,203114,22300219,"NOV 20, 2023",MIL @ WAS,W,23,6,12,0.5,0,2,0.0,6,7,0.857,1,5,6,7,0,0,4,3,18,23,1,MIL,WAS,MIL,142,,,31,24,25,13
Khris Middleton,F,22023,203114,22300027,"NOV 17, 2023",MIL @ CHA,W,22,4,11,0.364,2,7,0.286,2,2,1.0,1,5,6,1,1,0,1,3,12,16,1,MIL,CHA,MIL,130,,,19,18,13,7
Khris Middleton,F,22023,203114,22300190,"NOV 13, 2023",MIL vs. CHI,W,19,6,10,0.6,1,5,0.2,0,0,0.0,1,5,6,2,1,0,2,2,13,0,1,MIL,MIL,CHI,118,,,21,19,15,8
Khris Middleton,F,22023,203114,22300173,"NOV 11, 2023",MIL @ ORL,L,20,4,8,0.5,2,4,0.5,0,0,0.0,0,0,0,7,0,1,1,1,10,-3,1,MIL,ORL,MIL,97,,,17,10,17,7
Khris Middleton,F,22023,203114,22300171,"NOV 09, 2023",MIL @ IND,L,20,7,13,0.538,2,6,0.333,3,4,0.75,1,1,2,4,0,0,2,1,19,-5,1,MIL,IND,MIL,124,,,25,21,23,6
Khris Middleton,F,22023,203114,22300149,"NOV 06, 2023",MIL @ BKN,W,21,6,10,0.6,1,4,0.25,2,2,1.0,0,3,3,4,0,0,0,1,15,9,1,MIL,BKN,MIL,129,,,22,18,19,7
Khris Middleton,F,22023,203114,22300002,"NOV 03, 2023",MIL vs. NYK,W,21,5,10,0.5,2,3,0.667,0,0,0.0,3,6,9,4,0,0,0,1,12,-2,1,MIL,MIL,NYK,110,,,25,21,16,13
Khris Middleton,F,22023,203114,22300116,"NOV 01, 2023",MIL @ TOR,L,17,4,10,0.4,1,4,0.25,2,2,1.0,0,3,3,0,1,0,4,2,11,-13,1,MIL,TOR,MIL,111,,,14,14,11,3
Khris Middleton,F,22023,203114,22300107,"OCT 30, 2023",MIL vs. MIA,W,17,1,4,0.25,0,2,0.0,3,4,0.75,0,2,2,5,1,0,1,2,5,14,1,MIL,MIL,MIA,122,,,12,7,10,7
Khris Middleton,F,22023,203114,22300075,"OCT 26, 2023",MIL vs. PHI,W,16,2,5,0.4,1,3,0.333,1,2,0.5,0,3,3,4,2,0,2,0,6,14,1,MIL,MIL,PHI,118,,,13,9,10,7
Khris Middleton,F,22023,203114,22300572,"JAN 17, 2024",MIL @ CLE,L,20,1,10,0.1,0,3,0.0,0,0,0.0,0,2,2,2,0,1,3,3,2,-40,1,MIL,CLE,MIL,95,,,6,4,4,4
Khris Middleton,F,22023,203114,22300195,"NOV 15, 2023",MIL @ TOR,W,20,5,9,0.556,1,2,0.5,0,0,0.0,1,4,5,4,2,0,4,3,11,12,1,MIL,TOR,MIL,128,,,20,16,15,9
Jonathan Kuminga,F,22023,1630228,22300757,"FEB 10, 2024",GSW vs. PHX,W,34,9,18,0.5,0,1,0.0,3,5,0.6,1,4,5,2,0,0,1,4,21,-2,1,GSW,GSW,PHX,113,,,28,26,23,7
Jonathan Kuminga,F,22023,1630228,22300733,"FEB 08, 2024",GSW @ IND,W,33,9,16,0.563,0,2,0.0,0,0,0.0,1,1,2,4,0,2,3,1,18,20,1,GSW,IND,GSW,131,,,24,20,22,6
Jonathan Kuminga,F,22023,1630228,22300727,"FEB 07, 2024",GSW @ PHI,W,29,7,14,0.5,0,3,0.0,4,6,0.667,1,5,6,5,1,0,1,0,18,22,1,GSW,PHI,GSW,127,,,29,24,23,11
Jonathan Kuminga,F,22023,1630228,22300717,"FEB 05, 2024",GSW @ BKN,W,33,9,18,0.5,0,0,0.0,10,12,0.833,2,8,10,3,1,2,3,0,28,5,1,GSW,BKN,GSW,109,,,41,38,31,13
Jonathan Kuminga,F,22023,1630228,22300699,"FEB 03, 2024",GSW @ ATL,L,34,6,12,0.5,1,3,0.333,3,4,0.75,2,2,4,3,1,0,4,6,16,-5,1,GSW,ATL,GSW,134,,,23,20,19,7
Jonathan Kuminga,F,22023,1630228,22300693,"FEB 02, 2024",GSW @ MEM,W,37,11,15,0.733,1,1,1.0,6,7,0.857,1,5,6,4,2,0,2,3,29,15,1,GSW,MEM,GSW,121,,,39,35,33,10
Jonathan Kuminga,F,22023,1630228,22300673,"JAN 30, 2024",GSW vs. PHI,W,39,11,19,0.579,1,3,0.333,3,4,0.75,2,5,7,2,3,1,3,3,26,10,1,GSW,GSW,PHI,119,,,35,33,28,9
Jonathan Kuminga,F,22023,1630228,22300650,"JAN 27, 2024",GSW vs. LAL,L,43,8,16,0.5,2,3,0.667,4,6,0.667,4,5,9,2,0,0,2,5,22,-9,1,GSW,GSW,LAL,144,,,33,31,24,11
Jonathan Kuminga,F,22023,1630228,22300632,"JAN 25, 2024",GSW vs. SAC,L,30,12,19,0.632,2,4,0.5,5,6,0.833,1,2,3,3,2,0,2,2,31,16,1,GSW,GSW,SAC,133,,,37,34,34,6
Jonathan Kuminga,F,22023,1630228,22300626,"JAN 24, 2024",GSW vs. ATL,W,29,11,11,1.0,0,0,0.0,3,5,0.6,0,9,9,2,2,2,1,1,25,18,1,GSW,GSW,ATL,134,,,36,34,27,11
Jonathan Kuminga,F,22023,1630228,22300560,"JAN 15, 2024",GSW @ MEM,L,29,9,18,0.5,1,5,0.2,1,1,1.0,2,9,11,0,0,0,3,3,20,-9,1,GSW,MEM,GSW,107,,,31,31,20,11
Jonathan Kuminga,F,22023,1630228,22300536,"JAN 12, 2024",GSW @ CHI,W,24,9,12,0.75,4,4,1.0,2,3,0.667,0,5,5,1,1,0,0,2,24,6,1,GSW,CHI,GSW,140,,,30,29,25,6
Jonathan Kuminga,F,22023,1630228,22300525,"JAN 10, 2024",GSW vs. NOP,L,28,4,7,0.571,0,1,0.0,4,6,0.667,0,3,3,4,0,1,3,3,12,-20,1,GSW,GSW,NOP,105,,,19,15,16,7
Jonathan Kuminga,F,22023,1630228,22300504,"JAN 07, 2024",GSW vs. TOR,L,25,5,13,0.385,1,5,0.2,2,2,1.0,1,3,4,4,1,1,1,0,13,-5,1,GSW,GSW,TOR,118,,,21,17,17,8
Jonathan Kuminga,F,22023,1630228,22300490,"JAN 05, 2024",GSW vs. DET,W,36,4,8,0.5,0,1,0.0,3,3,1.0,0,6,6,1,0,0,4,2,11,16,1,GSW,GSW,DET,113,,,18,17,12,7
Jonathan Kuminga,F,22023,1630228,22300478,"JAN 04, 2024",GSW vs. DEN,L,19,5,7,0.714,0,1,0.0,6,7,0.857,1,3,4,4,0,0,1,1,16,6,1,GSW,GSW,DEN,127,,,24,20,20,8
Jonathan Kuminga,F,22023,1630228,22300463,"JAN 02, 2024",GSW vs. ORL,W,34,7,14,0.5,1,5,0.2,4,5,0.8,2,4,6,4,0,2,1,2,19,10,1,GSW,GSW,ORL,121,,,29,25,23,10
Jonathan Kuminga,F,22023,1630228,22300444,"DEC 30, 2023",GSW vs. DAL,L,25,6,12,0.5,1,5,0.2,3,4,0.75,5,4,9,3,1,0,1,3,16,-9,1,GSW,GSW,DAL,122,,,28,25,19,12
Jonathan Kuminga,F,22023,1630228,22300426,"DEC 28, 2023",GSW vs. MIA,L,24,5,11,0.455,0,3,0.0,0,0,0.0,1,4,5,1,0,0,6,0,10,-26,1,GSW,GSW,MIA,102,,,16,15,11,6
Jonathan Kuminga,F,22023,1630228,22300402,"DEC 25, 2023",GSW @ DEN,L,23,4,8,0.5,0,1,0.0,5,8,0.625,0,5,5,2,0,0,1,1,13,-24,1,GSW,DEN,GSW,114,,,20,18,15,7
Jonathan Kuminga,F,22023,1630228,22300399,"DEC 23, 2023",GSW vs. POR,W,30,3,7,0.429,0,2,0.0,5,5,1.0,1,5,6,5,0,0,0,0,11,18,1,GSW,GSW,POR,126,,,22,17,16,11
Jonathan Kuminga,F,22023,1630228,22300386,"DEC 22, 2023",GSW vs. WAS,W,27,9,11,0.818,1,2,0.5,3,3,1.0,2,2,4,3,1,0,1,2,22,9,1,GSW,GSW,WAS,129,,,29,26,25,7
Jonathan Kuminga,F,22023,1630228,22300362,"DEC 19, 2023",GSW vs. BOS,W,34,8,13,0.615,1,4,0.25,0,2,0.0,4,3,7,2,2,0,1,0,17,3,1,GSW,GSW,BOS,132,,,26,24,19,9
Jonathan Kuminga,F,22023,1630228,22300348,"DEC 17, 2023",GSW @ POR,W,19,5,7,0.714,2,3,0.667,0,4,0.0,2,2,4,0,1,0,1,3,12,4,1,GSW,POR,GSW,118,,,16,16,12,4
Jonathan Kuminga,F,22023,1630228,22300339,"DEC 16, 2023",GSW vs. BKN,W,21,3,6,0.5,0,0,0.0,4,4,1.0,2,2,4,2,0,1,1,1,10,4,1,GSW,GSW,BKN,124,,,16,14,12,6
Jonathan Kuminga,F,22023,1630228,22300325,"DEC 14, 2023",GSW @ LAC,L,25,5,10,0.5,2,3,0.667,3,3,1.0,0,5,5,1,1,0,1,4,15,5,1,GSW,LAC,GSW,113,,,21,20,16,6
Jonathan Kuminga,F,22023,1630228,22300308,"DEC 12, 2023",GSW @ PHX,L,29,6,10,0.6,1,3,0.333,3,7,0.429,2,4,6,0,1,0,1,4,16,13,1,GSW,PHX,GSW,116,,,22,22,16,6
Jonathan Kuminga,F,22023,1630228,22301222,"DEC 08, 2023",GSW @ OKC,L,29,10,21,0.476,3,6,0.5,1,1,1.0,6,6,12,0,0,0,3,6,24,-15,1,GSW,OKC,GSW,136,,,36,36,24,12
Jonathan Kuminga,F,22023,1630228,22301214,"DEC 06, 2023",GSW vs. POR,W,17,6,6,1.0,0,0,0.0,1,2,0.5,0,1,1,1,2,0,0,2,13,13,1,GSW,GSW,POR,110,,,15,14,14,2
Jonathan Kuminga,F,22023,1630228,22300280,"DEC 02, 2023",GSW @ LAC,L,16,2,6,0.333,1,3,0.333,1,2,0.5,0,2,2,0,0,0,1,0,6,5,1,GSW,LAC,GSW,112,,,8,8,6,2
Jonathan Kuminga,F,22023,1630228,22300273,"NOV 30, 2023",GSW vs. LAC,W,23,6,8,0.75,3,5,0.6,2,4,0.5,1,5,6,3,1,1,1,0,17,13,1,GSW,GSW,LAC,120,,,26,23,20,9
Jonathan Kuminga,F,22023,1630228,22300060,"NOV 28, 2023",GSW @ SAC,L,10,0,3,0.0,0,1,0.0,0,0,0.0,0,1,1,0,0,0,2,3,0,4,1,GSW,SAC,GSW,123,,,1,1,0,1
Jonathan Kuminga,F,22023,1630228,22300051,"NOV 24, 2023",GSW vs. SAS,W,20,5,7,0.714,1,2,0.5,1,2,0.5,0,1,1,2,0,0,1,0,12,-1,1,GSW,GSW,SAS,118,,,15,13,14,3
Jonathan Kuminga,F,22023,1630228,22300236,"NOV 22, 2023",GSW @ PHX,L,21,3,7,0.429,0,1,0.0,1,2,0.5,0,1,1,2,1,0,0,5,7,-1,1,GSW,PHX,GSW,115,,,10,8,9,3
Jonathan Kuminga,F,22023,1630228,22300224,"NOV 20, 2023",GSW vs. HOU,W,18,3,7,0.429,1,3,0.333,0,2,0.0,0,3,3,1,0,0,1,3,7,8,1,GSW,GSW,HOU,121,,,11,10,8,4
Jonathan Kuminga,F,22023,1630228,22300207,"NOV 18, 2023",GSW vs. OKC,L,20,6,10,0.6,0,2,0.0,1,2,0.5,2,3,5,2,1,1,3,2,13,-18,1,GSW,GSW,OKC,123,,,20,18,15,7
Jonathan Kuminga,F,22023,1630228,22300186,"NOV 12, 2023",GSW vs. MIN,L,24,2,11,0.182,0,3,0.0,6,7,0.857,2,1,3,0,2,0,0,2,10,5,1,GSW,GSW,MIN,110,,,13,13,10,3
Jonathan Kuminga,F,22023,1630228,22300176,"NOV 11, 2023",GSW vs. CLE,L,21,2,7,0.286,0,1,0.0,8,11,0.727,0,3,3,0,0,0,0,4,12,-1,1,GSW,GSW,CLE,110,,,15,15,12,3
Jonathan Kuminga,F,22023,1630228,22300169,"NOV 08, 2023",GSW @ DEN,L,19,4,12,0.333,0,1,0.0,2,2,1.0,2,2,4,2,0,0,0,1,10,9,1,GSW,DEN,GSW,105,,,16,14,12,6
Jonathan Kuminga,F,22023,1630228,22300145,"NOV 06, 2023",GSW @ DET,W,19,2,8,0.25,0,3,0.0,6,8,0.75,0,1,1,0,1,1,1,3,10,0,1,GSW,DET,GSW,120,,,11,11,10,1
Jonathan Kuminga,F,22023,1630228,22300142,"NOV 05, 2023",GSW @ CLE,L,20,5,14,0.357,1,4,0.25,4,5,0.8,1,2,3,0,0,2,1,2,15,-9,1,GSW,CLE,GSW,104,,,18,18,15,3
Jonathan Kuminga,F,22023,1630228,22300005,"NOV 03, 2023",GSW @ OKC,W,22,9,15,0.6,0,2,0.0,1,2,0.5,1,1,2,1,0,0,3,2,19,3,1,GSW,OKC,GSW,141,,,22,21,20,3
Jonathan Kuminga,F,22023,1630228,22300126,"NOV 01, 2023",GSW vs. SAC,W,17,4,9,0.444,1,2,0.5,3,3,1.0,0,1,1,1,1,0,0,2,12,3,1,GSW,GSW,SAC,102,,,14,13,13,2
Jonathan Kuminga,F,22023,1630228,22300096,"OCT 29, 2023",GSW @ HOU,W,19,3,8,0.375,1,3,0.333,2,3,0.667,0,2,2,1,1,0,3,4,9,4,1,GSW,HOU,GSW,106,,,12,11,10,3
Jonathan Kuminga,F,22023,1630228,22300087,"OCT 27, 2023",GSW @ SAC,W,26,5,11,0.455,1,3,0.333,1,2,0.5,1,4,5,0,0,0,2,3,12,9,1,GSW,SAC,GSW,122,,,17,17,12,5
Jonathan Kuminga,F,22023,1630228,22300062,"OCT 24, 2023",GSW vs. PHX,L,20,4,8,0.5,0,0,0.0,4,6,0.667,3,3,6,1,2,1,2,5,12,4,1,GSW,GSW,PHX,104,,,19,18,13,7
Jonathan Kuminga,F,22023,1630228,22300025,"NOV 14, 2023",GSW vs. MIN,L,16,2,3,0.667,0,1,0.0,1,2,0.5,1,1,2,1,0,0,1,2,5,-1,1,GSW,GSW,MIN,101,,,8,7,6,3
Jonathan Kuminga,F,22023,1630228,22300545,"JAN 13, 2024",GSW @ MIL,L,30,10,18,0.556,2,3,0.667,6,6,1.0,0,3,3,2,1,1,0,2,28,-18,1,GSW,MIL,GSW,118,,,33,31,30,5
Jonathan Kuminga,F,22023,1630228,22300201,"NOV 16, 2023",GSW vs. OKC,L,27,8,13,0.615,1,4,0.25,4,5,0.8,0,6,6,2,0,1,4,0,21,-11,1,GSW,GSW,OKC,109,,,29,27,23,8
De'Andre Hunter,F,22023,1629631,22300742,"FEB 09, 2024",ATL @ PHI,W,24,3,6,0.5,3,4,0.75,2,2,1.0,0,2,2,2,1,0,3,1,11,-3,1,ATL,PHI,ATL,127,,,15,13,13,4
De'Andre Hunter,F,22023,1629631,22300729,"FEB 07, 2024",ATL @ BOS,L,23,3,9,0.333,1,4,0.25,3,3,1.0,0,1,1,1,0,0,1,3,10,-13,1,ATL,BOS,ATL,117,,,12,11,11,2
De'Andre Hunter,F,22023,1629631,22300716,"FEB 05, 2024",ATL vs. LAC,L,19,10,12,0.833,3,5,0.6,4,5,0.8,2,5,7,3,0,0,0,2,27,3,1,ATL,ATL,LAC,144,,,37,34,30,10
De'Andre Hunter,F,22023,1629631,22300669,"JAN 30, 2024",ATL vs. LAL,W,16,2,5,0.4,2,5,0.4,0,0,0.0,0,1,1,1,0,0,2,0,6,1,1,ATL,ATL,LAL,138,,,8,7,7,2
De'Andre Hunter,F,22023,1629631,22300371,"DEC 20, 2023",ATL @ HOU,W,28,5,10,0.5,1,4,0.25,0,0,0.0,0,1,1,3,0,0,0,2,11,-19,1,ATL,HOU,ATL,134,,,15,12,14,4
De'Andre Hunter,F,22023,1629631,22300352,"DEC 18, 2023",ATL vs. DET,W,29,7,15,0.467,5,6,0.833,0,0,0.0,1,5,6,2,1,2,4,5,19,9,1,ATL,ATL,DET,130,,,27,25,21,8
De'Andre Hunter,F,22023,1629631,22300336,"DEC 16, 2023",ATL @ CLE,L,26,5,7,0.714,2,2,1.0,6,6,1.0,0,2,2,0,1,0,0,1,18,-3,1,ATL,CLE,ATL,119,,,20,20,18,2
De'Andre Hunter,F,22023,1629631,22301218,"DEC 08, 2023",ATL @ PHI,L,37,9,18,0.5,4,7,0.571,2,2,1.0,1,6,7,1,0,0,3,2,24,-13,1,ATL,PHI,ATL,114,,,32,31,25,8
De'Andre Hunter,F,22023,1629631,22301209,"DEC 06, 2023",ATL vs. BKN,L,36,6,15,0.4,1,3,0.333,1,1,1.0,0,4,4,2,0,0,1,1,14,3,1,ATL,ATL,BKN,113,,,20,18,16,6
De'Andre Hunter,F,22023,1629631,22300286,"DEC 02, 2023",ATL @ MIL,L,31,3,10,0.3,0,2,0.0,6,6,1.0,0,1,1,0,2,0,2,2,12,6,1,ATL,MIL,ATL,121,,,13,13,12,1
De'Andre Hunter,F,22023,1629631,22300272,"NOV 30, 2023",ATL @ SAS,W,22,3,8,0.375,2,4,0.5,4,4,1.0,0,6,6,2,1,0,3,6,12,-5,1,ATL,SAS,ATL,137,,,20,18,14,8
De'Andre Hunter,F,22023,1629631,22300055,"NOV 28, 2023",ATL @ CLE,L,26,5,12,0.417,1,6,0.167,7,7,1.0,0,4,4,2,0,0,0,4,18,-18,1,ATL,CLE,ATL,105,,,24,22,20,6
De'Andre Hunter,F,22023,1629631,22300246,"NOV 26, 2023",ATL @ BOS,L,40,7,14,0.5,5,11,0.455,5,5,1.0,0,4,4,2,1,1,2,4,24,-11,1,ATL,BOS,ATL,103,,,30,28,26,6
De'Andre Hunter,F,22023,1629631,22300241,"NOV 25, 2023",ATL @ WAS,W,31,7,11,0.636,3,5,0.6,3,3,1.0,1,3,4,0,2,0,2,4,20,21,1,ATL,WAS,ATL,136,,,24,24,20,4
De'Andre Hunter,F,22023,1629631,22300227,"NOV 22, 2023",ATL vs. BKN,W,39,8,16,0.5,2,7,0.286,7,7,1.0,3,8,11,0,1,2,1,3,25,-3,1,ATL,ATL,BKN,147,,,36,36,25,11
De'Andre Hunter,F,22023,1629631,22300039,"NOV 21, 2023",ATL vs. IND,L,27,3,7,0.429,1,2,0.5,0,0,0.0,2,2,4,1,1,0,3,2,7,-11,1,ATL,ATL,IND,152,,,12,11,8,5
De'Andre Hunter,F,22023,1629631,22300029,"NOV 17, 2023",ATL vs. PHI,L,18,4,7,0.571,1,2,0.5,0,0,0.0,0,1,1,0,0,0,0,1,9,-10,1,ATL,ATL,PHI,116,,,10,10,9,1
De'Andre Hunter,F,22023,1629631,22300193,"NOV 15, 2023",ATL vs. NYK,L,26,2,7,0.286,1,3,0.333,0,0,0.0,1,1,2,1,0,0,1,3,5,-12,1,ATL,ATL,NYK,114,,,8,7,6,3
De'Andre Hunter,F,22023,1629631,22300018,"NOV 14, 2023",ATL @ DET,W,35,6,14,0.429,2,5,0.4,2,3,0.667,2,3,5,5,1,0,1,3,16,2,1,ATL,DET,ATL,126,,,26,21,21,10
De'Andre Hunter,F,22023,1629631,22300175,"NOV 11, 2023",ATL vs. MIA,L,36,4,11,0.364,0,4,0.0,2,2,1.0,0,5,5,2,1,1,3,4,10,-9,1,ATL,ATL,MIA,109,,,17,15,12,7
De'Andre Hunter,F,22023,1629631,22300172,"NOV 09, 2023",ATL @ ORL,W,26,3,9,0.333,2,5,0.4,4,5,0.8,0,0,0,1,1,1,2,4,12,6,1,ATL,ORL,ATL,120,,,13,12,13,1
De'Andre Hunter,F,22023,1629631,22300155,"NOV 06, 2023",ATL @ OKC,L,33,2,13,0.154,1,7,0.143,3,4,0.75,0,2,2,0,0,0,0,2,8,-3,1,ATL,OKC,ATL,117,,,10,10,8,2
De'Andre Hunter,F,22023,1629631,22300135,"NOV 04, 2023",ATL @ NOP,W,30,1,3,0.333,1,2,0.5,1,2,0.5,1,4,5,1,0,1,2,3,4,17,1,ATL,NOP,ATL,123,,,10,9,5,6
De'Andre Hunter,F,22023,1629631,22300117,"NOV 01, 2023",ATL vs. WAS,W,33,8,16,0.5,2,7,0.286,5,6,0.833,0,7,7,3,2,0,5,5,23,3,1,ATL,ATL,WAS,130,,,33,30,26,10
De'Andre Hunter,F,22023,1629631,22300104,"OCT 30, 2023",ATL vs. MIN,W,30,6,10,0.6,3,5,0.6,1,2,0.5,0,4,4,2,1,0,0,0,16,4,1,ATL,ATL,MIN,127,,,22,20,18,6
De'Andre Hunter,F,22023,1629631,22300097,"OCT 29, 2023",ATL @ MIL,W,24,6,10,0.6,2,4,0.5,1,1,1.0,1,2,3,1,4,0,2,3,15,17,1,ATL,MIL,ATL,127,,,19,18,16,4
De'Andre Hunter,F,22023,1629631,22300079,"OCT 27, 2023",ATL vs. NYK,L,32,8,13,0.615,3,7,0.429,8,8,1.0,0,6,6,1,0,1,0,3,27,-1,1,ATL,ATL,NYK,120,,,34,33,28,7
De'Andre Hunter,F,22023,1629631,22300063,"OCT 25, 2023",ATL @ CHA,L,31,4,9,0.444,1,4,0.25,0,1,0.0,2,2,4,1,0,0,0,6,9,-13,1,ATL,CHA,ATL,110,,,14,13,10,5
De'Andre Hunter,F,22023,1629631,22300699,"FEB 03, 2024",ATL vs. GSW,W,16,2,5,0.4,0,2,0.0,2,5,0.4,0,1,1,0,1,0,0,1,6,-5,1,ATL,ATL,GSW,141,,,7,7,6,1
Gordon Hayward,F,22023,202330,22300177,"NOV 12, 2023",CHA @ NYK,L,29,3,9,0.333,0,1,0.0,0,0,0.0,0,1,1,2,0,0,2,3,6,-16,1,CHA,NYK,CHA,107,,,9,7,8,3
Gordon Hayward,F,22023,202330,22300248,"NOV 26, 2023",CHA @ ORL,L,33,4,11,0.364,2,4,0.5,0,2,0.0,0,5,5,2,0,1,3,1,10,-15,1,CHA,ORL,CHA,117,,,17,15,12,7
Gordon Hayward,F,22023,202330,22300225,"NOV 22, 2023",CHA vs. WAS,W,30,2,8,0.25,0,1,0.0,0,0,0.0,1,8,9,6,0,0,3,1,4,-18,1,CHA,CHA,WAS,117,,,19,13,10,15
Gordon Hayward,F,22023,202330,22300217,"NOV 20, 2023",CHA vs. BOS,W,39,6,15,0.4,1,2,0.5,7,8,0.875,3,2,5,4,1,1,2,3,20,20,1,CHA,CHA,BOS,121,,,29,25,24,9
Gordon Hayward,F,22023,202330,22300202,"NOV 18, 2023",CHA vs. NYK,L,32,1,7,0.143,0,2,0.0,2,2,1.0,0,3,3,4,2,0,0,3,4,-18,1,CHA,CHA,NYK,108,,,11,7,8,7
Gordon Hayward,F,22023,202330,22300027,"NOV 17, 2023",CHA vs. MIL,L,29,1,9,0.111,0,3,0.0,0,0,0.0,0,4,4,0,0,0,0,2,2,-27,1,CHA,CHA,MIL,99,,,6,6,2,4
Gordon Hayward,F,22023,202330,22300009,"NOV 10, 2023",CHA @ WAS,W,36,10,20,0.5,1,4,0.25,6,8,0.75,0,5,5,9,4,1,0,0,27,16,1,CHA,WAS,CHA,124,,,41,32,36,14
Gordon Hayward,F,22023,202330,22300157,"NOV 08, 2023",CHA vs. WAS,L,32,6,14,0.429,2,4,0.5,4,6,0.667,1,6,7,4,3,0,3,2,18,-8,1,CHA,CHA,WAS,116,,,29,25,22,11
Gordon Hayward,F,22023,202330,22300143,"NOV 05, 2023",CHA @ DAL,L,34,9,23,0.391,1,4,0.25,1,4,0.25,2,2,4,8,1,0,1,2,20,-4,1,CHA,DAL,CHA,118,,,32,24,28,12
Gordon Hayward,F,22023,202330,22300133,"NOV 04, 2023",CHA @ IND,W,34,10,17,0.588,1,2,0.5,2,2,1.0,1,5,6,3,0,2,1,3,23,-3,1,CHA,IND,CHA,125,,,32,29,26,9
Gordon Hayward,F,22023,202330,22300122,"NOV 01, 2023",CHA @ HOU,L,31,6,11,0.545,0,1,0.0,5,7,0.714,2,5,7,5,1,1,1,1,17,-3,1,CHA,HOU,CHA,119,,,29,24,22,12
Gordon Hayward,F,22023,202330,22300101,"OCT 30, 2023",CHA vs. BKN,L,31,6,11,0.545,2,2,1.0,1,1,1.0,0,0,0,5,2,1,0,4,15,-8,1,CHA,CHA,BKN,121,,,20,15,20,5
Gordon Hayward,F,22023,202330,22300077,"OCT 27, 2023",CHA vs. DET,L,34,6,15,0.4,2,4,0.5,5,6,0.833,1,8,9,4,3,0,3,2,19,-10,1,CHA,CHA,DET,99,,,32,28,23,13
Gordon Hayward,F,22023,202330,22300063,"OCT 25, 2023",CHA vs. ATL,W,33,4,8,0.5,0,1,0.0,2,3,0.667,3,5,8,7,1,1,6,1,10,15,1,CHA,CHA,ATL,116,,,25,18,17,15
Gordon Hayward,F,22023,202330,22300365,"DEC 20, 2023",CHA @ IND,L,24,3,5,0.6,1,1,1.0,4,6,0.667,0,1,1,3,0,0,2,0,11,-25,1,CHA,IND,CHA,109,,,15,12,14,4
Gordon Hayward,F,22023,202330,22300057,"NOV 28, 2023",CHA @ NYK,L,28,2,7,0.286,0,2,0.0,0,0,0.0,2,4,6,6,0,0,2,1,4,-3,1,CHA,NYK,CHA,91,,,16,10,10,12
Gordon Hayward,F,22023,202330,22300414,"DEC 26, 2023",CHA @ LAC,L,24,3,8,0.375,0,2,0.0,2,2,1.0,1,1,2,5,1,0,1,2,8,-4,1,CHA,LAC,CHA,104,,,15,10,13,7
Gordon Hayward,F,22023,202330,22300390,"DEC 23, 2023",CHA vs. DEN,L,31,4,7,0.571,0,0,0.0,0,0,0.0,0,6,6,4,1,2,4,2,8,-3,1,CHA,CHA,DEN,95,,,18,14,12,10
Gordon Hayward,F,22023,202330,22300326,"DEC 15, 2023",CHA vs. NOP,L,34,4,10,0.4,1,4,0.25,0,0,0.0,0,3,3,4,1,1,1,2,9,0,1,CHA,CHA,NOP,105,,,16,12,13,7
Gordon Hayward,F,22023,202330,22300312,"DEC 13, 2023",CHA @ MIA,L,35,7,12,0.583,1,2,0.5,5,5,1.0,1,4,5,7,0,0,4,2,20,1,1,CHA,MIA,CHA,104,,,32,25,27,12
Gordon Hayward,F,22023,202330,22300292,"DEC 11, 2023",CHA vs. MIA,L,32,7,12,0.583,1,3,0.333,2,4,0.5,0,6,6,7,1,0,0,4,17,-13,1,CHA,CHA,MIA,114,,,30,23,24,13
Gordon Hayward,F,22023,202330,22301216,"DEC 08, 2023",CHA vs. TOR,W,35,10,15,0.667,1,2,0.5,3,4,0.75,3,1,4,4,1,0,3,1,24,2,1,CHA,CHA,TOR,119,,,32,28,28,8
Gordon Hayward,F,22023,202330,22301211,"DEC 06, 2023",CHA @ CHI,L,35,10,18,0.556,2,4,0.5,5,5,1.0,2,2,4,4,3,1,5,2,27,2,1,CHA,CHI,CHA,100,,,35,31,31,8
Gordon Hayward,F,22023,202330,22300281,"DEC 02, 2023",CHA vs. MIN,L,31,7,11,0.636,1,2,0.5,2,2,1.0,0,1,1,3,2,0,2,1,17,-14,1,CHA,CHA,MIN,117,,,21,18,20,4
Gordon Hayward,F,22023,202330,22300266,"NOV 30, 2023",CHA @ BKN,W,32,8,14,0.571,2,4,0.5,4,4,1.0,2,4,6,6,0,0,2,1,22,3,1,CHA,BKN,CHA,129,,,34,28,28,12
Marcus Smart,G,22023,203935,22300503,"JAN 07, 2024",MEM @ PHX,W,38,9,20,0.45,4,13,0.308,3,5,0.6,0,6,6,8,3,0,5,2,25,10,1,MEM,PHX,MEM,121,,,39,31,33,14
Marcus Smart,G,22023,203935,22300491,"JAN 05, 2024",MEM @ LAL,W,39,9,16,0.563,8,14,0.571,3,4,0.75,1,1,2,5,1,0,3,2,29,13,1,MEM,LAL,MEM,127,,,36,31,34,7
Marcus Smart,G,22023,203935,22300470,"JAN 03, 2024",MEM vs. TOR,L,33,2,10,0.2,0,5,0.0,2,3,0.667,0,5,5,2,1,0,3,4,6,11,1,MEM,MEM,TOR,111,,,13,11,8,7
Marcus Smart,G,22023,203935,22300460,"JAN 02, 2024",MEM vs. SAS,W,30,1,7,0.143,0,4,0.0,3,4,0.75,1,1,2,3,0,0,3,3,5,2,1,MEM,MEM,SAS,106,,,10,7,8,5
Marcus Smart,G,22023,203935,22300449,"DEC 31, 2023",MEM vs. SAC,L,31,4,11,0.364,0,4,0.0,4,7,0.571,0,1,1,2,3,0,2,2,12,-15,1,MEM,MEM,SAC,92,,,15,13,14,3
Marcus Smart,G,22023,203935,22300438,"DEC 29, 2023",MEM @ LAC,L,32,7,14,0.5,4,11,0.364,4,4,1.0,0,2,2,2,3,0,2,0,22,-5,1,MEM,LAC,MEM,106,,,26,24,24,4
Marcus Smart,G,22023,203935,22300410,"DEC 26, 2023",MEM @ NOP,W,29,4,10,0.4,2,8,0.25,3,3,1.0,0,1,1,3,5,1,3,4,13,9,1,MEM,NOP,MEM,116,,,17,14,16,4
Marcus Smart,G,22023,203935,22300026,"NOV 14, 2023",MEM @ LAL,L,8,1,3,0.333,1,2,0.5,0,0,0.0,0,1,1,1,1,1,0,0,3,-7,1,MEM,LAL,MEM,107,,,5,4,4,2
Marcus Smart,G,22023,203935,22300179,"NOV 12, 2023",MEM @ LAC,W,36,5,12,0.417,3,7,0.429,4,4,1.0,0,3,3,7,0,0,5,3,17,16,1,MEM,LAC,MEM,105,,,27,20,24,10
Marcus Smart,G,22023,203935,22300012,"NOV 10, 2023",MEM vs. UTA,L,25,3,9,0.333,0,4,0.0,2,2,1.0,0,1,1,2,0,1,1,6,8,10,1,MEM,MEM,UTA,121,,,11,9,10,3
Marcus Smart,G,22023,203935,22300164,"NOV 08, 2023",MEM vs. MIA,L,32,4,14,0.286,0,3,0.0,3,4,0.75,0,4,4,7,2,0,3,4,11,-17,1,MEM,MEM,MIA,102,,,22,15,18,11
Marcus Smart,G,22023,203935,22300144,"NOV 05, 2023",MEM @ POR,W,29,4,9,0.444,2,5,0.4,0,0,0.0,0,2,2,5,2,0,3,3,10,10,1,MEM,POR,MEM,112,,,17,12,15,7
Marcus Smart,G,22023,203935,22300515,"JAN 09, 2024",MEM @ DAL,W,21,9,16,0.563,4,8,0.5,1,1,1.0,0,4,4,1,2,0,1,0,23,16,1,MEM,DAL,MEM,120,,,28,27,24,5
Marcus Smart,G,22023,203935,22300425,"DEC 28, 2023",MEM @ DEN,L,23,6,14,0.429,2,6,0.333,3,4,0.75,1,2,3,5,1,0,3,1,17,-7,1,MEM,DEN,MEM,105,,,25,20,22,8
Marcus Smart,G,22023,203935,22300007,"NOV 03, 2023",MEM @ POR,L,39,4,12,0.333,0,5,0.0,0,0,0.0,1,2,3,4,1,0,5,2,8,-19,1,MEM,POR,MEM,113,,,15,11,12,7
Marcus Smart,G,22023,203935,22300125,"NOV 01, 2023",MEM @ UTA,L,28,4,11,0.364,1,7,0.143,2,2,1.0,0,2,2,6,4,0,5,3,11,-28,1,MEM,UTA,MEM,109,,,19,13,17,8
Marcus Smart,G,22023,203935,22300106,"OCT 30, 2023",MEM vs. DAL,L,35,9,17,0.529,5,10,0.5,0,0,0.0,1,4,5,9,3,0,6,6,23,-1,1,MEM,MEM,DAL,110,,,37,28,32,14
Marcus Smart,G,22023,203935,22300089,"OCT 28, 2023",MEM @ WAS,L,32,4,8,0.5,1,5,0.2,0,0,0.0,0,4,4,6,2,2,2,2,9,-14,1,MEM,WAS,MEM,106,,,19,13,15,10
Marcus Smart,G,22023,203935,22300078,"OCT 27, 2023",MEM vs. DEN,L,31,7,13,0.538,3,7,0.429,3,3,1.0,1,1,2,5,5,0,2,3,20,-6,1,MEM,MEM,DEN,104,,,27,22,25,7
Marcus Smart,G,22023,203935,22300071,"OCT 25, 2023",MEM vs. NOP,L,32,6,11,0.545,2,6,0.333,3,6,0.5,0,0,0,3,2,0,5,3,17,3,1,MEM,MEM,NOP,104,,,20,17,20,3
Jaden Ivey,G,22023,1631093,22300534,"JAN 12, 2024",DET vs. HOU,L,28,8,19,0.421,1,6,0.167,1,4,0.25,5,2,7,8,0,1,3,3,18,7,1,DET,DET,HOU,110,,,33,25,26,15
Jaden Ivey,G,22023,1631093,22300453,"JAN 01, 2024",DET @ HOU,L,26,6,10,0.6,3,4,0.75,4,4,1.0,4,2,6,3,0,0,2,1,19,-19,1,DET,HOU,DET,113,,,28,25,22,9
Jaden Ivey,G,22023,1631093,22300394,"DEC 23, 2023",DET @ BKN,L,35,6,11,0.545,3,6,0.5,8,10,0.8,0,6,6,7,0,2,3,4,23,6,1,DET,BKN,DET,115,,,36,29,30,13
Jaden Ivey,G,22023,1631093,22300374,"DEC 21, 2023",DET vs. UTA,L,35,9,16,0.563,2,5,0.4,4,4,1.0,2,3,5,7,3,2,5,4,24,5,1,DET,DET,UTA,111,,,36,29,31,12
Jaden Ivey,G,22023,1631093,22300352,"DEC 18, 2023",DET @ ATL,L,29,6,13,0.462,0,2,0.0,3,5,0.6,2,6,8,4,0,0,2,6,15,-12,1,DET,ATL,DET,124,,,27,23,19,12
Jaden Ivey,G,22023,1631093,22300334,"DEC 16, 2023",DET @ MIL,L,28,5,17,0.294,2,6,0.333,1,2,0.5,1,3,4,2,1,1,1,0,13,-32,1,DET,MIL,DET,114,,,19,17,15,6
Jaden Ivey,G,22023,1631093,22301217,"DEC 08, 2023",DET @ ORL,L,21,2,7,0.286,0,4,0.0,4,4,1.0,0,2,2,0,0,0,0,2,8,-14,1,DET,ORL,DET,91,,,10,10,8,2
Jaden Ivey,G,22023,1631093,22300283,"DEC 02, 2023",DET vs. CLE,L,29,2,7,0.286,0,3,0.0,3,4,0.75,0,2,2,1,0,0,1,3,7,-1,1,DET,DET,CLE,101,,,10,9,8,3
Jaden Ivey,G,22023,1631093,22300268,"NOV 30, 2023",DET @ NYK,L,13,1,2,0.5,1,1,1.0,2,2,1.0,0,2,2,1,0,1,1,3,5,4,1,DET,NYK,DET,112,,,8,7,6,3
Jaden Ivey,G,22023,1631093,22300258,"NOV 29, 2023",DET vs. LAL,L,19,1,6,0.167,1,2,0.5,4,4,1.0,0,1,1,3,1,0,1,6,7,-17,1,DET,DET,LAL,107,,,11,8,10,4
Jaden Ivey,G,22023,1631093,22300047,"NOV 24, 2023",DET @ IND,L,32,9,16,0.563,1,6,0.167,6,9,0.667,2,0,2,3,1,1,3,3,25,-15,1,DET,IND,DET,113,,,30,27,28,5
Jaden Ivey,G,22023,1631093,22300218,"NOV 20, 2023",DET vs. DEN,L,30,7,8,0.875,1,1,1.0,2,2,1.0,1,3,4,3,1,0,4,2,17,8,1,DET,DET,DEN,103,,,24,21,20,7
Jaden Ivey,G,22023,1631093,22300211,"NOV 19, 2023",DET @ TOR,L,28,3,10,0.3,0,5,0.0,3,4,0.75,0,3,3,4,0,0,0,1,9,0,1,DET,TOR,DET,113,,,16,12,13,7
Jaden Ivey,G,22023,1631093,22300030,"NOV 17, 2023",DET @ CLE,L,29,4,6,0.667,1,2,0.5,2,2,1.0,1,1,2,3,1,0,6,3,11,-10,1,DET,CLE,DET,100,,,16,13,14,5
Jaden Ivey,G,22023,1631093,22300018,"NOV 14, 2023",DET vs. ATL,L,21,4,7,0.571,1,2,0.5,2,4,0.5,3,2,5,5,1,0,1,1,11,1,1,DET,DET,ATL,120,,,21,16,16,10
Jaden Ivey,G,22023,1631093,22300181,"NOV 12, 2023",DET @ CHI,L,11,2,4,0.5,0,2,0.0,2,2,1.0,0,0,0,2,1,0,2,1,6,9,1,DET,CHI,DET,108,,,8,6,8,2
Jaden Ivey,G,22023,1631093,22300129,"NOV 02, 2023",DET @ NOP,L,22,4,6,0.667,1,3,0.333,3,4,0.75,3,4,7,0,0,1,2,4,12,-9,1,DET,NOP,DET,116,,,19,19,12,7
Jaden Ivey,G,22023,1631093,22300115,"NOV 01, 2023",DET vs. POR,L,22,3,7,0.429,1,3,0.333,3,3,1.0,0,2,2,2,1,1,1,3,10,-14,1,DET,DET,POR,101,,,14,12,12,4
Jaden Ivey,G,22023,1631093,22300109,"OCT 30, 2023",DET @ OKC,L,19,7,13,0.538,4,6,0.667,2,2,1.0,1,1,2,3,1,1,1,5,20,-4,1,DET,OKC,DET,112,,,25,22,23,5
Jaden Ivey,G,22023,1631093,22300088,"OCT 28, 2023",DET vs. CHI,W,22,3,6,0.5,1,2,0.5,0,0,0.0,0,0,0,3,1,0,2,0,7,5,1,DET,DET,CHI,118,,,10,7,10,3
Jaden Ivey,G,22023,1631093,22300077,"OCT 27, 2023",DET @ CHA,W,23,8,14,0.571,2,6,0.333,0,0,0.0,0,2,2,4,1,0,2,4,18,-2,1,DET,CHA,DET,111,,,24,20,22,6
Jaden Ivey,G,22023,1631093,22300068,"OCT 25, 2023",DET @ MIA,L,17,1,7,0.143,0,2,0.0,2,3,0.667,0,2,2,3,0,0,3,3,4,-2,1,DET,MIA,DET,102,,,9,6,7,5
Jaden Ivey,G,22023,1631093,22300704,"FEB 04, 2024",DET vs. ORL,L,35,7,12,0.583,2,4,0.5,2,2,1.0,0,3,3,3,1,1,3,3,18,-12,1,DET,DET,ORL,99,,,24,21,21,6
Jaden Ivey,G,22023,1631093,22300688,"FEB 02, 2024",DET vs. LAC,L,34,11,18,0.611,3,8,0.375,3,6,0.5,5,2,7,3,0,0,3,2,28,5,1,DET,DET,LAC,125,,,38,35,31,10
Jaden Ivey,G,22023,1631093,22300675,"JAN 31, 2024",DET @ CLE,L,29,5,7,0.714,2,3,0.667,2,3,0.667,0,1,1,4,2,1,4,5,14,-21,1,DET,CLE,DET,121,,,19,15,18,5
Jaden Ivey,G,22023,1631093,22300654,"JAN 28, 2024",DET vs. OKC,W,35,7,20,0.35,3,7,0.429,2,5,0.4,3,5,8,6,0,0,0,2,19,13,1,DET,DET,OKC,120,,,33,27,25,14
Jaden Ivey,G,22023,1631093,22300642,"JAN 27, 2024",DET vs. WAS,L,26,4,8,0.5,2,3,0.667,0,0,0.0,2,2,4,1,0,2,3,3,10,1,1,DET,DET,WAS,104,,,15,14,11,5
Jaden Ivey,G,22023,1631093,22300619,"JAN 24, 2024",DET vs. CHA,W,22,4,10,0.4,1,3,0.333,0,0,0.0,0,1,1,2,1,0,2,2,9,-11,1,DET,DET,CHA,113,,,12,10,11,3
Jaden Ivey,G,22023,1631093,22300606,"JAN 22, 2024",DET vs. MIL,L,32,5,14,0.357,1,4,0.25,6,7,0.857,1,2,3,6,0,0,3,0,17,-23,1,DET,DET,MIL,113,,,26,20,23,9
Jaden Ivey,G,22023,1631093,22300592,"JAN 20, 2024",DET vs. MIL,L,32,6,16,0.375,2,5,0.4,4,7,0.571,2,4,6,6,0,1,3,5,18,-15,1,DET,DET,MIL,135,,,30,24,24,12
Jaden Ivey,G,22023,1631093,22300569,"JAN 17, 2024",DET vs. MIN,L,36,13,22,0.591,4,6,0.667,2,2,1.0,0,4,4,6,1,0,2,4,32,8,1,DET,DET,MIN,117,,,42,36,38,10
Jaden Ivey,G,22023,1631093,22300519,"JAN 10, 2024",DET vs. SAS,L,30,7,18,0.389,2,10,0.2,3,5,0.6,0,3,3,5,2,2,1,0,19,-5,1,DET,DET,SAS,108,,,27,22,24,8
Jaden Ivey,G,22023,1631093,22300512,"JAN 09, 2024",DET vs. SAC,L,33,7,17,0.412,2,9,0.222,6,8,0.75,5,0,5,6,2,0,4,4,22,-15,1,DET,DET,SAC,110,,,33,27,28,11
Jaden Ivey,G,22023,1631093,22300502,"JAN 07, 2024",DET @ DEN,L,27,4,11,0.364,0,6,0.0,5,8,0.625,1,3,4,6,1,0,4,2,13,-16,1,DET,DEN,DET,114,,,23,17,19,10
Jaden Ivey,G,22023,1631093,22300490,"JAN 05, 2024",DET @ GSW,L,24,5,10,0.5,2,5,0.4,0,0,0.0,2,2,4,3,0,1,4,6,12,-1,1,DET,GSW,DET,109,,,19,16,15,7
Jaden Ivey,G,22023,1631093,22300474,"JAN 03, 2024",DET @ UTA,L,22,4,8,0.5,2,3,0.667,1,2,0.5,0,1,1,2,0,0,2,2,11,0,1,DET,UTA,DET,148,,,14,12,13,3
Jaden Ivey,G,22023,1631093,22300440,"DEC 30, 2023",DET vs. TOR,W,29,1,5,0.2,1,3,0.333,9,12,0.75,4,1,5,4,1,0,1,2,12,3,1,DET,DET,TOR,129,,,21,17,16,9
Jaden Ivey,G,22023,1631093,22300421,"DEC 28, 2023",DET @ BOS,L,33,8,15,0.533,3,5,0.6,3,5,0.6,5,5,10,4,0,1,3,6,22,8,1,DET,BOS,DET,122,,,36,32,26,14
Jaden Ivey,G,22023,1631093,22300406,"DEC 26, 2023",DET vs. BKN,L,28,3,12,0.25,0,2,0.0,3,6,0.5,2,1,3,4,3,1,1,5,9,12,1,DET,DET,BKN,112,,,16,12,13,7
Jaden Ivey,G,22023,1631093,22300327,"DEC 15, 2023",DET @ PHI,L,29,4,12,0.333,0,2,0.0,5,5,1.0,1,3,4,4,0,0,5,3,13,-6,1,DET,PHI,DET,92,,,21,17,17,8
Jaden Ivey,G,22023,1631093,22300310,"DEC 13, 2023",DET vs. PHI,L,21,2,8,0.25,0,3,0.0,3,6,0.5,0,2,2,1,0,1,0,2,7,-21,1,DET,DET,PHI,111,,,10,9,8,3
Jaden Ivey,G,22023,1631093,22300293,"DEC 11, 2023",DET vs. IND,L,34,7,15,0.467,0,3,0.0,4,4,1.0,1,2,3,2,1,0,2,2,18,-4,1,DET,DET,IND,123,,,23,21,20,5
Jaden Ivey,G,22023,1631093,22301206,"DEC 06, 2023",DET vs. MEM,L,24,4,8,0.5,1,3,0.333,0,0,0.0,0,3,3,2,3,2,1,0,9,-10,1,DET,DET,MEM,102,,,14,12,11,5
Jaden Ivey,G,22023,1631093,22300749,"FEB 10, 2024",DET @ LAC,L,36,10,21,0.476,2,6,0.333,1,1,1.0,1,3,4,2,0,0,3,3,23,-4,1,DET,LAC,DET,106,,,29,27,25,6
Jaden Ivey,G,22023,1631093,22300732,"FEB 07, 2024",DET @ SAC,W,38,13,23,0.565,5,7,0.714,6,6,1.0,2,4,6,7,0,0,5,3,37,10,1,DET,SAC,DET,133,,,50,43,44,13
Jaden Ivey,G,22023,1631093,22300558,"JAN 15, 2024",DET @ WAS,W,32,9,18,0.5,2,7,0.286,4,7,0.571,1,6,7,6,0,3,5,0,24,3,1,DET,WAS,DET,129,,,37,31,30,13
Jaden Ivey,G,22023,1631093,22300253,"NOV 27, 2023",DET vs. WAS,L,33,6,12,0.5,2,3,0.667,1,2,0.5,2,5,7,7,1,1,3,3,15,2,1,DET,DET,WAS,107,,,29,22,22,14
Jaden Ivey,G,22023,1631093,22300741,"FEB 08, 2024",DET @ POR,W,48,8,21,0.381,7,7,1.0,3,6,0.5,0,3,3,4,0,0,6,4,26,3,1,DET,POR,DET,128,,,33,29,30,7
Bennedict Mathurin,F,22023,1631097,22300550,"JAN 14, 2024",IND @ DEN,L,22,3,9,0.333,1,3,0.333,5,5,1.0,1,2,3,2,0,0,2,3,12,-7,1,IND,DEN,IND,109,,,17,15,14,5
Bennedict Mathurin,F,22023,1631097,22300533,"JAN 12, 2024",IND @ ATL,W,27,6,9,0.667,0,1,0.0,3,5,0.6,1,0,1,3,0,0,5,2,15,16,1,IND,ATL,IND,126,,,19,16,18,4
Bennedict Mathurin,F,22023,1631097,22300520,"JAN 10, 2024",IND vs. WAS,W,28,4,13,0.308,0,1,0.0,8,8,1.0,2,5,7,0,1,0,1,2,16,6,1,IND,IND,WAS,112,,,23,23,16,7
Bennedict Mathurin,F,22023,1631097,22300507,"JAN 08, 2024",IND vs. BOS,W,29,8,15,0.533,5,9,0.556,5,7,0.714,0,4,4,3,2,0,2,4,26,-2,1,IND,IND,BOS,133,,,33,30,29,7
Bennedict Mathurin,F,22023,1631097,22300480,"JAN 05, 2024",IND vs. ATL,W,18,6,9,0.667,2,4,0.5,4,4,1.0,1,2,3,4,0,0,0,2,18,11,1,IND,IND,ATL,148,,,25,21,22,7
Bennedict Mathurin,F,22023,1631097,22300466,"JAN 03, 2024",IND vs. MIL,W,25,6,9,0.667,2,2,1.0,2,2,1.0,0,1,1,3,0,0,1,4,16,-3,1,IND,IND,MIL,142,,,20,17,19,4
Bennedict Mathurin,F,22023,1631097,22300377,"DEC 21, 2023",IND @ MEM,L,19,3,10,0.3,0,4,0.0,0,0,0.0,2,2,4,3,1,0,1,0,6,-22,1,IND,MEM,IND,103,,,13,10,9,7
Bennedict Mathurin,F,22023,1631097,22300365,"DEC 20, 2023",IND vs. CHA,W,28,5,7,0.714,4,6,0.667,0,0,0.0,0,2,2,1,1,0,2,2,14,10,1,IND,IND,CHA,142,,,17,16,15,3
Bennedict Mathurin,F,22023,1631097,22300350,"DEC 18, 2023",IND vs. LAC,L,35,12,20,0.6,3,7,0.429,7,7,1.0,2,4,6,2,1,0,1,3,34,-11,1,IND,IND,LAC,127,,,42,40,36,8
Bennedict Mathurin,F,22023,1631097,22300338,"DEC 16, 2023",IND @ MIN,L,23,3,11,0.273,0,1,0.0,0,0,0.0,0,1,1,3,0,1,1,1,6,8,1,IND,MIN,IND,109,,,10,7,9,4
Bennedict Mathurin,F,22023,1631097,22300328,"DEC 15, 2023",IND @ WAS,L,22,4,9,0.444,1,1,1.0,4,4,1.0,1,2,3,2,1,0,2,2,13,-14,1,IND,WAS,IND,123,,,18,16,15,5
Bennedict Mathurin,F,22023,1631097,22300315,"DEC 13, 2023",IND @ MIL,L,25,2,8,0.25,0,3,0.0,10,10,1.0,0,1,1,1,0,0,3,3,14,-15,1,IND,MIL,IND,126,,,16,15,15,2
Bennedict Mathurin,F,22023,1631097,22300293,"DEC 11, 2023",IND @ DET,W,37,10,17,0.588,3,5,0.6,7,8,0.875,3,4,7,8,2,0,2,3,30,8,1,IND,DET,IND,131,,,45,37,38,15
Bennedict Mathurin,F,22023,1631097,22301229,"DEC 07, 2023",IND @ MIL,W,24,3,12,0.25,0,2,0.0,3,3,1.0,2,4,6,1,0,1,2,4,9,17,1,IND,MIL,IND,128,,,16,15,10,7
Bennedict Mathurin,F,22023,1631097,22301202,"DEC 04, 2023",IND vs. BOS,W,27,5,14,0.357,4,7,0.571,2,2,1.0,1,4,5,2,0,0,1,1,16,-6,1,IND,IND,BOS,122,,,23,21,18,7
Bennedict Mathurin,F,22023,1631097,22300284,"DEC 02, 2023",IND @ MIA,W,25,6,10,0.6,2,3,0.667,2,3,0.667,1,4,5,4,0,0,4,4,16,-4,1,IND,MIA,IND,144,,,25,21,20,9
Bennedict Mathurin,F,22023,1631097,22300267,"NOV 30, 2023",IND @ MIA,L,24,5,7,0.714,0,0,0.0,2,2,1.0,0,3,3,0,0,0,1,1,12,-14,1,IND,MIA,IND,132,,,15,15,12,3
Bennedict Mathurin,F,22023,1631097,22300254,"NOV 27, 2023",IND vs. POR,L,22,4,10,0.4,0,2,0.0,3,5,0.6,1,3,4,0,0,0,2,3,11,-9,1,IND,IND,POR,110,,,15,15,11,4
Bennedict Mathurin,F,22023,1631097,22300047,"NOV 24, 2023",IND vs. DET,W,31,6,12,0.5,1,2,0.5,2,2,1.0,1,1,2,0,1,0,1,4,15,27,1,IND,IND,DET,136,,,17,17,15,2
Bennedict Mathurin,F,22023,1631097,22300230,"NOV 22, 2023",IND vs. TOR,L,24,2,7,0.286,0,1,0.0,1,2,0.5,0,0,0,2,1,1,0,1,5,-10,1,IND,IND,TOR,131,,,7,5,7,2
Bennedict Mathurin,F,22023,1631097,22300039,"NOV 21, 2023",IND @ ATL,W,20,7,10,0.7,2,4,0.5,3,4,0.75,0,2,2,1,0,0,0,2,19,-1,1,IND,ATL,IND,157,,,22,21,20,3
Bennedict Mathurin,F,22023,1631097,22300209,"NOV 19, 2023",IND vs. ORL,L,25,4,12,0.333,1,3,0.333,5,5,1.0,0,6,6,3,1,0,0,6,14,-7,1,IND,IND,ORL,116,,,23,20,17,9
Bennedict Mathurin,F,22023,1631097,22300019,"NOV 14, 2023",IND @ PHI,W,16,3,8,0.375,2,4,0.5,0,0,0.0,0,0,0,0,0,0,2,0,8,3,1,IND,PHI,IND,132,,,8,8,8,0
Bennedict Mathurin,F,22023,1631097,22300180,"NOV 12, 2023",IND @ PHI,L,26,4,11,0.364,0,3,0.0,1,3,0.333,1,4,5,1,0,1,1,1,9,-24,1,IND,PHI,IND,126,,,15,14,10,6
Bennedict Mathurin,F,22023,1631097,22300171,"NOV 09, 2023",IND vs. MIL,W,36,9,18,0.5,3,7,0.429,5,6,0.833,4,7,11,2,1,1,1,1,26,14,1,IND,IND,MIL,126,,,39,37,28,13
Bennedict Mathurin,F,22023,1631097,22300158,"NOV 08, 2023",IND vs. UTA,W,38,9,18,0.5,4,7,0.571,0,0,0.0,5,4,9,4,2,0,3,1,22,18,1,IND,IND,UTA,134,,,35,31,26,13
Bennedict Mathurin,F,22023,1631097,22300146,"NOV 06, 2023",IND vs. SAS,W,22,4,8,0.5,0,2,0.0,2,2,1.0,1,2,3,2,1,0,1,2,10,14,1,IND,IND,SAS,152,,,15,13,12,5
Bennedict Mathurin,F,22023,1631097,22300133,"NOV 04, 2023",IND vs. CHA,L,24,3,11,0.273,0,2,0.0,2,2,1.0,4,1,5,5,1,0,3,1,8,6,1,IND,IND,CHA,124,,,18,13,13,10
Bennedict Mathurin,F,22023,1631097,22300001,"NOV 03, 2023",IND vs. CLE,W,24,2,7,0.286,1,2,0.5,0,3,0.0,1,2,3,5,1,0,1,1,5,-4,1,IND,IND,CLE,121,,,13,8,10,8
Bennedict Mathurin,F,22023,1631097,22300118,"NOV 01, 2023",IND @ BOS,L,15,4,7,0.571,0,3,0.0,0,0,0.0,0,1,1,0,0,0,0,1,8,-24,1,IND,BOS,IND,104,,,9,9,8,1
Bennedict Mathurin,F,22023,1631097,22300102,"OCT 30, 2023",IND vs. CHI,L,28,4,11,0.364,1,4,0.25,6,6,1.0,1,3,4,0,0,0,2,5,15,-7,1,IND,IND,CHI,105,,,19,19,15,4
Bennedict Mathurin,F,22023,1631097,22300091,"OCT 28, 2023",IND @ CLE,W,17,5,10,0.5,1,3,0.333,2,3,0.667,0,0,0,1,0,0,0,0,13,-11,1,IND,CLE,IND,125,,,14,13,14,1
Bennedict Mathurin,F,22023,1631097,22300064,"OCT 25, 2023",IND vs. WAS,W,26,6,15,0.4,2,6,0.333,4,4,1.0,0,4,4,5,2,0,2,1,18,14,1,IND,IND,WAS,143,,,27,22,23,9
Bennedict Mathurin,F,22023,1631097,22300707,"FEB 04, 2024",IND @ CHA,W,27,4,12,0.333,2,3,0.667,4,6,0.667,1,4,5,1,0,0,0,0,14,3,1,IND,CHA,IND,115,,,20,19,15,6
Bennedict Mathurin,F,22023,1631097,22300627,"JAN 25, 2024",IND vs. PHI,W,25,5,13,0.385,0,2,0.0,3,3,1.0,1,4,5,4,0,0,3,2,13,-16,1,IND,IND,PHI,134,,,22,18,17,9
Bennedict Mathurin,F,22023,1631097,22300564,"JAN 15, 2024",IND @ UTA,L,25,5,10,0.5,0,1,0.0,1,1,1.0,1,0,1,2,0,0,0,1,11,-18,1,IND,UTA,IND,105,,,14,12,13,3
Bennedict Mathurin,F,22023,1631097,22300493,"JAN 06, 2024",IND vs. BOS,L,35,7,14,0.5,0,3,0.0,6,9,0.667,2,2,4,2,2,1,2,2,20,-21,1,IND,IND,BOS,101,,,26,24,22,6
Bennedict Mathurin,F,22023,1631097,22300755,"FEB 10, 2024",IND @ NYK,W,23,2,6,0.333,0,1,0.0,0,2,0.0,1,5,6,0,0,1,4,1,4,0,1,IND,NYK,IND,125,,,10,10,4,6
Bennedict Mathurin,F,22023,1631097,22300733,"FEB 08, 2024",IND vs. GSW,L,24,2,11,0.182,0,3,0.0,7,8,0.875,0,0,0,1,0,0,1,2,11,-13,1,IND,IND,GSW,109,,,12,11,12,1
Bennedict Mathurin,F,22023,1631097,22300691,"FEB 02, 2024",IND vs. SAC,L,37,10,14,0.714,2,2,1.0,9,10,0.9,0,5,5,4,2,0,5,1,31,-3,1,IND,IND,SAC,122,,,40,36,35,9
Bennedict Mathurin,F,22023,1631097,22300590,"JAN 19, 2024",IND @ POR,L,23,0,8,0.0,0,5,0.0,2,3,0.667,0,3,3,0,0,0,3,1,2,-21,1,IND,POR,IND,115,,,5,5,2,3
Bennedict Mathurin,F,22023,1631097,22300454,"JAN 01, 2024",IND @ MIL,W,36,9,15,0.6,1,5,0.2,6,9,0.667,3,10,13,0,0,0,1,3,25,22,1,IND,MIL,IND,122,,,38,38,25,13
Bennedict Mathurin,F,22023,1631097,22300441,"DEC 30, 2023",IND vs. NYK,W,26,7,10,0.7,3,5,0.6,3,3,1.0,0,0,0,0,0,0,2,0,20,11,1,IND,IND,NYK,140,,,20,20,20,0
Bennedict Mathurin,F,22023,1631097,22300422,"DEC 28, 2023",IND @ CHI,W,26,5,9,0.556,1,3,0.333,4,5,0.8,2,3,5,1,0,1,3,1,15,2,1,IND,CHI,IND,120,,,21,20,16,6
Bennedict Mathurin,F,22023,1631097,22300409,"DEC 26, 2023",IND @ HOU,W,24,3,9,0.333,2,5,0.4,2,2,1.0,0,4,4,0,1,0,3,2,10,-6,1,IND,HOU,IND,123,,,14,14,10,4
Bennedict Mathurin,F,22023,1631097,22300391,"DEC 23, 2023",IND vs. ORL,L,16,1,5,0.2,0,2,0.0,0,0,0.0,0,2,2,1,0,0,1,1,2,-24,1,IND,IND,ORL,110,,,5,4,3,3
Bennedict Mathurin,F,22023,1631097,22300652,"JAN 28, 2024",IND vs. MEM,W,30,9,14,0.643,3,5,0.6,3,3,1.0,0,7,7,1,1,1,2,4,24,14,1,IND,IND,MEM,116,,,32,31,25,8
Bennedict Mathurin,F,22023,1631097,22300636,"JAN 26, 2024",IND vs. PHX,W,21,5,14,0.357,1,3,0.333,0,0,0.0,3,2,5,0,1,0,1,0,11,-2,1,IND,IND,PHX,133,,,16,16,11,5
Bennedict Mathurin,F,22023,1631097,22300614,"JAN 23, 2024",IND vs. DEN,L,28,3,8,0.375,1,2,0.5,4,5,0.8,0,5,5,3,0,0,1,2,11,2,1,IND,IND,DEN,109,,,19,16,14,8
Bennedict Mathurin,F,22023,1631097,22300604,"JAN 21, 2024",IND @ PHX,L,14,1,8,0.125,1,4,0.25,1,2,0.5,0,3,3,0,0,0,0,0,4,7,1,IND,PHX,IND,110,,,7,7,4,3
Bennedict Mathurin,F,22023,1631097,22300583,"JAN 18, 2024",IND @ SAC,W,37,11,21,0.524,2,6,0.333,1,1,1.0,1,2,3,4,1,2,3,2,25,-1,1,IND,SAC,IND,126,,,32,28,29,7
Malik Monk,G,22023,1628370,22300746,"FEB 09, 2024",SAC vs. DEN,W,20,9,13,0.692,3,7,0.429,2,2,1.0,0,1,1,2,1,1,2,1,23,14,1,SAC,SAC,DEN,135,15.5,Points,26,24,25,3
Malik Monk,G,22023,1628370,22300746,"FEB 09, 2024",SAC vs. DEN,W,20,9,13,0.692,3,7,0.429,2,2,1.0,0,1,1,2,1,1,2,1,23,14,1,SAC,SAC,DEN,135,24.5,Pts+Rebs+Asts,26,24,25,3
Malik Monk,G,22023,1628370,22300746,"FEB 09, 2024",SAC vs. DEN,W,20,9,13,0.692,3,7,0.429,2,2,1.0,0,1,1,2,1,1,2,1,23,14,1,SAC,SAC,DEN,135,5.0,Assists,26,24,25,3
Malik Monk,G,22023,1628370,22300746,"FEB 09, 2024",SAC vs. DEN,W,20,9,13,0.692,3,7,0.429,2,2,1.0,0,1,1,2,1,1,2,1,23,14,1,SAC,SAC,DEN,135,19.0,Pts+Rebs,26,24,25,3
Malik Monk,G,22023,1628370,22300746,"FEB 09, 2024",SAC vs. DEN,W,20,9,13,0.692,3,7,0.429,2,2,1.0,0,1,1,2,1,1,2,1,23,14,1,SAC,SAC,DEN,135,20.5,Pts+Asts,26,24,25,3
Malik Monk,G,22023,1628370,22300746,"FEB 09, 2024",SAC vs. DEN,W,20,9,13,0.692,3,7,0.429,2,2,1.0,0,1,1,2,1,1,2,1,23,14,1,SAC,SAC,DEN,135,0.5,Blocked Shots,26,24,25,3
Malik Monk,G,22023,1628370,22300746,"FEB 09, 2024",SAC vs. DEN,W,20,9,13,0.692,3,7,0.429,2,2,1.0,0,1,1,2,1,1,2,1,23,14,1,SAC,SAC,DEN,135,0.5,Steals,26,24,25,3
Malik Monk,G,22023,1628370,22300746,"FEB 09, 2024",SAC vs. DEN,W,20,9,13,0.692,3,7,0.429,2,2,1.0,0,1,1,2,1,1,2,1,23,14,1,SAC,SAC,DEN,135,8.5,Rebs+Asts,26,24,25,3
Malik Monk,G,22023,1628370,22300732,"FEB 07, 2024",SAC vs. DET,L,34,10,21,0.476,2,8,0.25,1,1,1.0,0,5,5,10,0,2,1,2,23,-8,1,SAC,SAC,DET,120,15.5,Points,38,28,33,15
Malik Monk,G,22023,1628370,22300732,"FEB 07, 2024",SAC vs. DET,L,34,10,21,0.476,2,8,0.25,1,1,1.0,0,5,5,10,0,2,1,2,23,-8,1,SAC,SAC,DET,120,24.5,Pts+Rebs+Asts,38,28,33,15
Malik Monk,G,22023,1628370,22300732,"FEB 07, 2024",SAC vs. DET,L,34,10,21,0.476,2,8,0.25,1,1,1.0,0,5,5,10,0,2,1,2,23,-8,1,SAC,SAC,DET,120,5.0,Assists,38,28,33,15
Malik Monk,G,22023,1628370,22300732,"FEB 07, 2024",SAC vs. DET,L,34,10,21,0.476,2,8,0.25,1,1,1.0,0,5,5,10,0,2,1,2,23,-8,1,SAC,SAC,DET,120,19.0,Pts+Rebs,38,28,33,15
Malik Monk,G,22023,1628370,22300732,"FEB 07, 2024",SAC vs. DET,L,34,10,21,0.476,2,8,0.25,1,1,1.0,0,5,5,10,0,2,1,2,23,-8,1,SAC,SAC,DET,120,20.5,Pts+Asts,38,28,33,15
Malik Monk,G,22023,1628370,22300732,"FEB 07, 2024",SAC vs. DET,L,34,10,21,0.476,2,8,0.25,1,1,1.0,0,5,5,10,0,2,1,2,23,-8,1,SAC,SAC,DET,120,0.5,Blocked Shots,38,28,33,15
Malik Monk,G,22023,1628370,22300732,"FEB 07, 2024",SAC vs. DET,L,34,10,21,0.476,2,8,0.25,1,1,1.0,0,5,5,10,0,2,1,2,23,-8,1,SAC,SAC,DET,120,0.5,Steals,38,28,33,15
Malik Monk,G,22023,1628370,22300732,"FEB 07, 2024",SAC vs. DET,L,34,10,21,0.476,2,8,0.25,1,1,1.0,0,5,5,10,0,2,1,2,23,-8,1,SAC,SAC,DET,120,8.5,Rebs+Asts,38,28,33,15
Malik Monk,G,22023,1628370,22300714,"FEB 05, 2024",SAC @ CLE,L,24,7,12,0.583,2,4,0.5,2,4,0.5,1,3,4,1,0,0,2,5,18,-19,1,SAC,CLE,SAC,110,15.5,Points,23,22,19,5
Malik Monk,G,22023,1628370,22300714,"FEB 05, 2024",SAC @ CLE,L,24,7,12,0.583,2,4,0.5,2,4,0.5,1,3,4,1,0,0,2,5,18,-19,1,SAC,CLE,SAC,110,24.5,Pts+Rebs+Asts,23,22,19,5
Malik Monk,G,22023,1628370,22300714,"FEB 05, 2024",SAC @ CLE,L,24,7,12,0.583,2,4,0.5,2,4,0.5,1,3,4,1,0,0,2,5,18,-19,1,SAC,CLE,SAC,110,5.0,Assists,23,22,19,5
Malik Monk,G,22023,1628370,22300714,"FEB 05, 2024",SAC @ CLE,L,24,7,12,0.583,2,4,0.5,2,4,0.5,1,3,4,1,0,0,2,5,18,-19,1,SAC,CLE,SAC,110,19.0,Pts+Rebs,23,22,19,5
Malik Monk,G,22023,1628370,22300714,"FEB 05, 2024",SAC @ CLE,L,24,7,12,0.583,2,4,0.5,2,4,0.5,1,3,4,1,0,0,2,5,18,-19,1,SAC,CLE,SAC,110,20.5,Pts+Asts,23,22,19,5
Malik Monk,G,22023,1628370,22300714,"FEB 05, 2024",SAC @ CLE,L,24,7,12,0.583,2,4,0.5,2,4,0.5,1,3,4,1,0,0,2,5,18,-19,1,SAC,CLE,SAC,110,0.5,Blocked Shots,23,22,19,5
Malik Monk,G,22023,1628370,22300714,"FEB 05, 2024",SAC @ CLE,L,24,7,12,0.583,2,4,0.5,2,4,0.5,1,3,4,1,0,0,2,5,18,-19,1,SAC,CLE,SAC,110,0.5,Steals,23,22,19,5
Malik Monk,G,22023,1628370,22300714,"FEB 05, 2024",SAC @ CLE,L,24,7,12,0.583,2,4,0.5,2,4,0.5,1,3,4,1,0,0,2,5,18,-19,1,SAC,CLE,SAC,110,8.5,Rebs+Asts,23,22,19,5
Malik Monk,G,22023,1628370,22300700,"FEB 03, 2024",SAC @ CHI,W,34,7,14,0.5,2,4,0.5,6,7,0.857,0,5,5,7,0,1,1,3,22,6,1,SAC,CHI,SAC,123,15.5,Points,34,27,29,12
Malik Monk,G,22023,1628370,22300700,"FEB 03, 2024",SAC @ CHI,W,34,7,14,0.5,2,4,0.5,6,7,0.857,0,5,5,7,0,1,1,3,22,6,1,SAC,CHI,SAC,123,24.5,Pts+Rebs+Asts,34,27,29,12
Malik Monk,G,22023,1628370,22300700,"FEB 03, 2024",SAC @ CHI,W,34,7,14,0.5,2,4,0.5,6,7,0.857,0,5,5,7,0,1,1,3,22,6,1,SAC,CHI,SAC,123,5.0,Assists,34,27,29,12
Malik Monk,G,22023,1628370,22300700,"FEB 03, 2024",SAC @ CHI,W,34,7,14,0.5,2,4,0.5,6,7,0.857,0,5,5,7,0,1,1,3,22,6,1,SAC,CHI,SAC,123,19.0,Pts+Rebs,34,27,29,12
Malik Monk,G,22023,1628370,22300700,"FEB 03, 2024",SAC @ CHI,W,34,7,14,0.5,2,4,0.5,6,7,0.857,0,5,5,7,0,1,1,3,22,6,1,SAC,CHI,SAC,123,20.5,Pts+Asts,34,27,29,12
Malik Monk,G,22023,1628370,22300700,"FEB 03, 2024",SAC @ CHI,W,34,7,14,0.5,2,4,0.5,6,7,0.857,0,5,5,7,0,1,1,3,22,6,1,SAC,CHI,SAC,123,0.5,Blocked Shots,34,27,29,12
Malik Monk,G,22023,1628370,22300700,"FEB 03, 2024",SAC @ CHI,W,34,7,14,0.5,2,4,0.5,6,7,0.857,0,5,5,7,0,1,1,3,22,6,1,SAC,CHI,SAC,123,0.5,Steals,34,27,29,12
Malik Monk,G,22023,1628370,22300700,"FEB 03, 2024",SAC @ CHI,W,34,7,14,0.5,2,4,0.5,6,7,0.857,0,5,5,7,0,1,1,3,22,6,1,SAC,CHI,SAC,123,8.5,Rebs+Asts,34,27,29,12
Malik Monk,G,22023,1628370,22300691,"FEB 02, 2024",SAC @ IND,W,27,9,14,0.643,1,3,0.333,4,6,0.667,1,4,5,6,1,0,1,4,23,6,1,SAC,IND,SAC,133,15.5,Points,34,28,29,11
Malik Monk,G,22023,1628370,22300691,"FEB 02, 2024",SAC @ IND,W,27,9,14,0.643,1,3,0.333,4,6,0.667,1,4,5,6,1,0,1,4,23,6,1,SAC,IND,SAC,133,24.5,Pts+Rebs+Asts,34,28,29,11
Malik Monk,G,22023,1628370,22300691,"FEB 02, 2024",SAC @ IND,W,27,9,14,0.643,1,3,0.333,4,6,0.667,1,4,5,6,1,0,1,4,23,6,1,SAC,IND,SAC,133,5.0,Assists,34,28,29,11
Malik Monk,G,22023,1628370,22300691,"FEB 02, 2024",SAC @ IND,W,27,9,14,0.643,1,3,0.333,4,6,0.667,1,4,5,6,1,0,1,4,23,6,1,SAC,IND,SAC,133,19.0,Pts+Rebs,34,28,29,11
Malik Monk,G,22023,1628370,22300691,"FEB 02, 2024",SAC @ IND,W,27,9,14,0.643,1,3,0.333,4,6,0.667,1,4,5,6,1,0,1,4,23,6,1,SAC,IND,SAC,133,20.5,Pts+Asts,34,28,29,11
Malik Monk,G,22023,1628370,22300691,"FEB 02, 2024",SAC @ IND,W,27,9,14,0.643,1,3,0.333,4,6,0.667,1,4,5,6,1,0,1,4,23,6,1,SAC,IND,SAC,133,0.5,Blocked Shots,34,28,29,11
Malik Monk,G,22023,1628370,22300691,"FEB 02, 2024",SAC @ IND,W,27,9,14,0.643,1,3,0.333,4,6,0.667,1,4,5,6,1,0,1,4,23,6,1,SAC,IND,SAC,133,0.5,Steals,34,28,29,11
Malik Monk,G,22023,1628370,22300691,"FEB 02, 2024",SAC @ IND,W,27,9,14,0.643,1,3,0.333,4,6,0.667,1,4,5,6,1,0,1,4,23,6,1,SAC,IND,SAC,133,8.5,Rebs+Asts,34,28,29,11
Malik Monk,G,22023,1628370,22300678,"JAN 31, 2024",SAC @ MIA,L,14,3,8,0.375,0,4,0.0,0,0,0.0,0,0,0,0,0,0,3,2,6,-16,1,SAC,MIA,SAC,106,15.5,Points,6,6,6,0
Malik Monk,G,22023,1628370,22300678,"JAN 31, 2024",SAC @ MIA,L,14,3,8,0.375,0,4,0.0,0,0,0.0,0,0,0,0,0,0,3,2,6,-16,1,SAC,MIA,SAC,106,24.5,Pts+Rebs+Asts,6,6,6,0
Malik Monk,G,22023,1628370,22300678,"JAN 31, 2024",SAC @ MIA,L,14,3,8,0.375,0,4,0.0,0,0,0.0,0,0,0,0,0,0,3,2,6,-16,1,SAC,MIA,SAC,106,5.0,Assists,6,6,6,0
Malik Monk,G,22023,1628370,22300678,"JAN 31, 2024",SAC @ MIA,L,14,3,8,0.375,0,4,0.0,0,0,0.0,0,0,0,0,0,0,3,2,6,-16,1,SAC,MIA,SAC,106,19.0,Pts+Rebs,6,6,6,0
Malik Monk,G,22023,1628370,22300678,"JAN 31, 2024",SAC @ MIA,L,14,3,8,0.375,0,4,0.0,0,0,0.0,0,0,0,0,0,0,3,2,6,-16,1,SAC,MIA,SAC,106,20.5,Pts+Asts,6,6,6,0
Malik Monk,G,22023,1628370,22300678,"JAN 31, 2024",SAC @ MIA,L,14,3,8,0.375,0,4,0.0,0,0,0.0,0,0,0,0,0,0,3,2,6,-16,1,SAC,MIA,SAC,106,0.5,Blocked Shots,6,6,6,0
Malik Monk,G,22023,1628370,22300678,"JAN 31, 2024",SAC @ MIA,L,14,3,8,0.375,0,4,0.0,0,0,0.0,0,0,0,0,0,0,3,2,6,-16,1,SAC,MIA,SAC,106,0.5,Steals,6,6,6,0
Malik Monk,G,22023,1628370,22300678,"JAN 31, 2024",SAC @ MIA,L,14,3,8,0.375,0,4,0.0,0,0,0.0,0,0,0,0,0,0,3,2,6,-16,1,SAC,MIA,SAC,106,8.5,Rebs+Asts,6,6,6,0
Malik Monk,G,22023,1628370,22300663,"JAN 29, 2024",SAC @ MEM,W,20,1,6,0.167,1,4,0.25,0,0,0.0,0,3,3,5,1,0,3,1,3,-7,1,SAC,MEM,SAC,103,15.5,Points,11,6,8,8
Malik Monk,G,22023,1628370,22300663,"JAN 29, 2024",SAC @ MEM,W,20,1,6,0.167,1,4,0.25,0,0,0.0,0,3,3,5,1,0,3,1,3,-7,1,SAC,MEM,SAC,103,24.5,Pts+Rebs+Asts,11,6,8,8
Malik Monk,G,22023,1628370,22300663,"JAN 29, 2024",SAC @ MEM,W,20,1,6,0.167,1,4,0.25,0,0,0.0,0,3,3,5,1,0,3,1,3,-7,1,SAC,MEM,SAC,103,5.0,Assists,11,6,8,8
Malik Monk,G,22023,1628370,22300663,"JAN 29, 2024",SAC @ MEM,W,20,1,6,0.167,1,4,0.25,0,0,0.0,0,3,3,5,1,0,3,1,3,-7,1,SAC,MEM,SAC,103,19.0,Pts+Rebs,11,6,8,8
Malik Monk,G,22023,1628370,22300663,"JAN 29, 2024",SAC @ MEM,W,20,1,6,0.167,1,4,0.25,0,0,0.0,0,3,3,5,1,0,3,1,3,-7,1,SAC,MEM,SAC,103,20.5,Pts+Asts,11,6,8,8
Malik Monk,G,22023,1628370,22300663,"JAN 29, 2024",SAC @ MEM,W,20,1,6,0.167,1,4,0.25,0,0,0.0,0,3,3,5,1,0,3,1,3,-7,1,SAC,MEM,SAC,103,0.5,Blocked Shots,11,6,8,8
Malik Monk,G,22023,1628370,22300663,"JAN 29, 2024",SAC @ MEM,W,20,1,6,0.167,1,4,0.25,0,0,0.0,0,3,3,5,1,0,3,1,3,-7,1,SAC,MEM,SAC,103,0.5,Steals,11,6,8,8
Malik Monk,G,22023,1628370,22300663,"JAN 29, 2024",SAC @ MEM,W,20,1,6,0.167,1,4,0.25,0,0,0.0,0,3,3,5,1,0,3,1,3,-7,1,SAC,MEM,SAC,103,8.5,Rebs+Asts,11,6,8,8
Malik Monk,G,22023,1628370,22300651,"JAN 27, 2024",SAC @ DAL,W,20,2,5,0.4,0,2,0.0,5,7,0.714,0,3,3,6,0,0,3,0,9,6,1,SAC,DAL,SAC,120,15.5,Points,18,12,15,9
Malik Monk,G,22023,1628370,22300651,"JAN 27, 2024",SAC @ DAL,W,20,2,5,0.4,0,2,0.0,5,7,0.714,0,3,3,6,0,0,3,0,9,6,1,SAC,DAL,SAC,120,24.5,Pts+Rebs+Asts,18,12,15,9
Malik Monk,G,22023,1628370,22300651,"JAN 27, 2024",SAC @ DAL,W,20,2,5,0.4,0,2,0.0,5,7,0.714,0,3,3,6,0,0,3,0,9,6,1,SAC,DAL,SAC,120,5.0,Assists,18,12,15,9
Malik Monk,G,22023,1628370,22300651,"JAN 27, 2024",SAC @ DAL,W,20,2,5,0.4,0,2,0.0,5,7,0.714,0,3,3,6,0,0,3,0,9,6,1,SAC,DAL,SAC,120,19.0,Pts+Rebs,18,12,15,9
Malik Monk,G,22023,1628370,22300651,"JAN 27, 2024",SAC @ DAL,W,20,2,5,0.4,0,2,0.0,5,7,0.714,0,3,3,6,0,0,3,0,9,6,1,SAC,DAL,SAC,120,20.5,Pts+Asts,18,12,15,9
Malik Monk,G,22023,1628370,22300651,"JAN 27, 2024",SAC @ DAL,W,20,2,5,0.4,0,2,0.0,5,7,0.714,0,3,3,6,0,0,3,0,9,6,1,SAC,DAL,SAC,120,0.5,Blocked Shots,18,12,15,9
Malik Monk,G,22023,1628370,22300651,"JAN 27, 2024",SAC @ DAL,W,20,2,5,0.4,0,2,0.0,5,7,0.714,0,3,3,6,0,0,3,0,9,6,1,SAC,DAL,SAC,120,0.5,Steals,18,12,15,9
Malik Monk,G,22023,1628370,22300651,"JAN 27, 2024",SAC @ DAL,W,20,2,5,0.4,0,2,0.0,5,7,0.714,0,3,3,6,0,0,3,0,9,6,1,SAC,DAL,SAC,120,8.5,Rebs+Asts,18,12,15,9
Malik Monk,G,22023,1628370,22300632,"JAN 25, 2024",SAC @ GSW,W,19,2,5,0.4,0,2,0.0,0,0,0.0,1,1,2,3,0,0,3,3,4,-11,1,SAC,GSW,SAC,134,15.5,Points,9,6,7,5
Malik Monk,G,22023,1628370,22300632,"JAN 25, 2024",SAC @ GSW,W,19,2,5,0.4,0,2,0.0,0,0,0.0,1,1,2,3,0,0,3,3,4,-11,1,SAC,GSW,SAC,134,24.5,Pts+Rebs+Asts,9,6,7,5
Malik Monk,G,22023,1628370,22300632,"JAN 25, 2024",SAC @ GSW,W,19,2,5,0.4,0,2,0.0,0,0,0.0,1,1,2,3,0,0,3,3,4,-11,1,SAC,GSW,SAC,134,5.0,Assists,9,6,7,5
Malik Monk,G,22023,1628370,22300632,"JAN 25, 2024",SAC @ GSW,W,19,2,5,0.4,0,2,0.0,0,0,0.0,1,1,2,3,0,0,3,3,4,-11,1,SAC,GSW,SAC,134,19.0,Pts+Rebs,9,6,7,5
Malik Monk,G,22023,1628370,22300632,"JAN 25, 2024",SAC @ GSW,W,19,2,5,0.4,0,2,0.0,0,0,0.0,1,1,2,3,0,0,3,3,4,-11,1,SAC,GSW,SAC,134,20.5,Pts+Asts,9,6,7,5
Malik Monk,G,22023,1628370,22300632,"JAN 25, 2024",SAC @ GSW,W,19,2,5,0.4,0,2,0.0,0,0,0.0,1,1,2,3,0,0,3,3,4,-11,1,SAC,GSW,SAC,134,0.5,Blocked Shots,9,6,7,5
Malik Monk,G,22023,1628370,22300632,"JAN 25, 2024",SAC @ GSW,W,19,2,5,0.4,0,2,0.0,0,0,0.0,1,1,2,3,0,0,3,3,4,-11,1,SAC,GSW,SAC,134,0.5,Steals,9,6,7,5
Malik Monk,G,22023,1628370,22300632,"JAN 25, 2024",SAC @ GSW,W,19,2,5,0.4,0,2,0.0,0,0,0.0,1,1,2,3,0,0,3,3,4,-11,1,SAC,GSW,SAC,134,8.5,Rebs+Asts,9,6,7,5
Malik Monk,G,22023,1628370,22300613,"JAN 22, 2024",SAC vs. ATL,W,25,4,6,0.667,0,1,0.0,5,5,1.0,0,1,1,8,1,0,1,3,13,14,1,SAC,SAC,ATL,122,15.5,Points,22,14,21,9
Malik Monk,G,22023,1628370,22300613,"JAN 22, 2024",SAC vs. ATL,W,25,4,6,0.667,0,1,0.0,5,5,1.0,0,1,1,8,1,0,1,3,13,14,1,SAC,SAC,ATL,122,24.5,Pts+Rebs+Asts,22,14,21,9
Malik Monk,G,22023,1628370,22300613,"JAN 22, 2024",SAC vs. ATL,W,25,4,6,0.667,0,1,0.0,5,5,1.0,0,1,1,8,1,0,1,3,13,14,1,SAC,SAC,ATL,122,5.0,Assists,22,14,21,9
Malik Monk,G,22023,1628370,22300613,"JAN 22, 2024",SAC vs. ATL,W,25,4,6,0.667,0,1,0.0,5,5,1.0,0,1,1,8,1,0,1,3,13,14,1,SAC,SAC,ATL,122,19.0,Pts+Rebs,22,14,21,9
Malik Monk,G,22023,1628370,22300613,"JAN 22, 2024",SAC vs. ATL,W,25,4,6,0.667,0,1,0.0,5,5,1.0,0,1,1,8,1,0,1,3,13,14,1,SAC,SAC,ATL,122,20.5,Pts+Asts,22,14,21,9
Malik Monk,G,22023,1628370,22300613,"JAN 22, 2024",SAC vs. ATL,W,25,4,6,0.667,0,1,0.0,5,5,1.0,0,1,1,8,1,0,1,3,13,14,1,SAC,SAC,ATL,122,0.5,Blocked Shots,22,14,21,9
Malik Monk,G,22023,1628370,22300613,"JAN 22, 2024",SAC vs. ATL,W,25,4,6,0.667,0,1,0.0,5,5,1.0,0,1,1,8,1,0,1,3,13,14,1,SAC,SAC,ATL,122,0.5,Steals,22,14,21,9
Malik Monk,G,22023,1628370,22300613,"JAN 22, 2024",SAC vs. ATL,W,25,4,6,0.667,0,1,0.0,5,5,1.0,0,1,1,8,1,0,1,3,13,14,1,SAC,SAC,ATL,122,8.5,Rebs+Asts,22,14,21,9
Malik Monk,G,22023,1628370,22300583,"JAN 18, 2024",SAC vs. IND,L,26,3,9,0.333,2,6,0.333,1,6,0.167,1,2,3,4,1,2,1,3,9,-7,1,SAC,SAC,IND,121,15.5,Points,16,12,13,7
Malik Monk,G,22023,1628370,22300583,"JAN 18, 2024",SAC vs. IND,L,26,3,9,0.333,2,6,0.333,1,6,0.167,1,2,3,4,1,2,1,3,9,-7,1,SAC,SAC,IND,121,24.5,Pts+Rebs+Asts,16,12,13,7
Malik Monk,G,22023,1628370,22300583,"JAN 18, 2024",SAC vs. IND,L,26,3,9,0.333,2,6,0.333,1,6,0.167,1,2,3,4,1,2,1,3,9,-7,1,SAC,SAC,IND,121,5.0,Assists,16,12,13,7
Malik Monk,G,22023,1628370,22300583,"JAN 18, 2024",SAC vs. IND,L,26,3,9,0.333,2,6,0.333,1,6,0.167,1,2,3,4,1,2,1,3,9,-7,1,SAC,SAC,IND,121,19.0,Pts+Rebs,16,12,13,7
Malik Monk,G,22023,1628370,22300583,"JAN 18, 2024",SAC vs. IND,L,26,3,9,0.333,2,6,0.333,1,6,0.167,1,2,3,4,1,2,1,3,9,-7,1,SAC,SAC,IND,121,20.5,Pts+Asts,16,12,13,7
Malik Monk,G,22023,1628370,22300583,"JAN 18, 2024",SAC vs. IND,L,26,3,9,0.333,2,6,0.333,1,6,0.167,1,2,3,4,1,2,1,3,9,-7,1,SAC,SAC,IND,121,0.5,Blocked Shots,16,12,13,7
Malik Monk,G,22023,1628370,22300583,"JAN 18, 2024",SAC vs. IND,L,26,3,9,0.333,2,6,0.333,1,6,0.167,1,2,3,4,1,2,1,3,9,-7,1,SAC,SAC,IND,121,0.5,Steals,16,12,13,7
Malik Monk,G,22023,1628370,22300583,"JAN 18, 2024",SAC vs. IND,L,26,3,9,0.333,2,6,0.333,1,6,0.167,1,2,3,4,1,2,1,3,9,-7,1,SAC,SAC,IND,121,8.5,Rebs+Asts,16,12,13,7
Malik Monk,G,22023,1628370,22300567,"JAN 16, 2024",SAC @ PHX,L,29,5,16,0.313,2,7,0.286,1,1,1.0,0,3,3,8,0,1,5,2,13,-12,1,SAC,PHX,SAC,117,15.5,Points,24,16,21,11
Malik Monk,G,22023,1628370,22300567,"JAN 16, 2024",SAC @ PHX,L,29,5,16,0.313,2,7,0.286,1,1,1.0,0,3,3,8,0,1,5,2,13,-12,1,SAC,PHX,SAC,117,24.5,Pts+Rebs+Asts,24,16,21,11
Malik Monk,G,22023,1628370,22300567,"JAN 16, 2024",SAC @ PHX,L,29,5,16,0.313,2,7,0.286,1,1,1.0,0,3,3,8,0,1,5,2,13,-12,1,SAC,PHX,SAC,117,5.0,Assists,24,16,21,11
Malik Monk,G,22023,1628370,22300567,"JAN 16, 2024",SAC @ PHX,L,29,5,16,0.313,2,7,0.286,1,1,1.0,0,3,3,8,0,1,5,2,13,-12,1,SAC,PHX,SAC,117,19.0,Pts+Rebs,24,16,21,11
Malik Monk,G,22023,1628370,22300567,"JAN 16, 2024",SAC @ PHX,L,29,5,16,0.313,2,7,0.286,1,1,1.0,0,3,3,8,0,1,5,2,13,-12,1,SAC,PHX,SAC,117,20.5,Pts+Asts,24,16,21,11
Malik Monk,G,22023,1628370,22300567,"JAN 16, 2024",SAC @ PHX,L,29,5,16,0.313,2,7,0.286,1,1,1.0,0,3,3,8,0,1,5,2,13,-12,1,SAC,PHX,SAC,117,0.5,Blocked Shots,24,16,21,11
Malik Monk,G,22023,1628370,22300567,"JAN 16, 2024",SAC @ PHX,L,29,5,16,0.313,2,7,0.286,1,1,1.0,0,3,3,8,0,1,5,2,13,-12,1,SAC,PHX,SAC,117,0.5,Steals,24,16,21,11
Malik Monk,G,22023,1628370,22300567,"JAN 16, 2024",SAC @ PHX,L,29,5,16,0.313,2,7,0.286,1,1,1.0,0,3,3,8,0,1,5,2,13,-12,1,SAC,PHX,SAC,117,8.5,Rebs+Asts,24,16,21,11
Malik Monk,G,22023,1628370,22300552,"JAN 14, 2024",SAC @ MIL,L,36,9,21,0.429,4,9,0.444,6,10,0.6,1,6,7,7,0,0,1,1,28,-11,1,SAC,MIL,SAC,142,15.5,Points,42,35,35,14
Malik Monk,G,22023,1628370,22300552,"JAN 14, 2024",SAC @ MIL,L,36,9,21,0.429,4,9,0.444,6,10,0.6,1,6,7,7,0,0,1,1,28,-11,1,SAC,MIL,SAC,142,24.5,Pts+Rebs+Asts,42,35,35,14
Malik Monk,G,22023,1628370,22300552,"JAN 14, 2024",SAC @ MIL,L,36,9,21,0.429,4,9,0.444,6,10,0.6,1,6,7,7,0,0,1,1,28,-11,1,SAC,MIL,SAC,142,5.0,Assists,42,35,35,14
Malik Monk,G,22023,1628370,22300552,"JAN 14, 2024",SAC @ MIL,L,36,9,21,0.429,4,9,0.444,6,10,0.6,1,6,7,7,0,0,1,1,28,-11,1,SAC,MIL,SAC,142,19.0,Pts+Rebs,42,35,35,14
Malik Monk,G,22023,1628370,22300552,"JAN 14, 2024",SAC @ MIL,L,36,9,21,0.429,4,9,0.444,6,10,0.6,1,6,7,7,0,0,1,1,28,-11,1,SAC,MIL,SAC,142,20.5,Pts+Asts,42,35,35,14
Malik Monk,G,22023,1628370,22300552,"JAN 14, 2024",SAC @ MIL,L,36,9,21,0.429,4,9,0.444,6,10,0.6,1,6,7,7,0,0,1,1,28,-11,1,SAC,MIL,SAC,142,0.5,Blocked Shots,42,35,35,14
Malik Monk,G,22023,1628370,22300552,"JAN 14, 2024",SAC @ MIL,L,36,9,21,0.429,4,9,0.444,6,10,0.6,1,6,7,7,0,0,1,1,28,-11,1,SAC,MIL,SAC,142,0.5,Steals,42,35,35,14
Malik Monk,G,22023,1628370,22300552,"JAN 14, 2024",SAC @ MIL,L,36,9,21,0.429,4,9,0.444,6,10,0.6,1,6,7,7,0,0,1,1,28,-11,1,SAC,MIL,SAC,142,8.5,Rebs+Asts,42,35,35,14
Malik Monk,G,22023,1628370,22300532,"JAN 12, 2024",SAC @ PHI,L,27,5,17,0.294,0,7,0.0,5,6,0.833,0,1,1,4,2,1,2,1,15,-9,1,SAC,PHI,SAC,90,15.5,Points,20,16,19,5
Malik Monk,G,22023,1628370,22300532,"JAN 12, 2024",SAC @ PHI,L,27,5,17,0.294,0,7,0.0,5,6,0.833,0,1,1,4,2,1,2,1,15,-9,1,SAC,PHI,SAC,90,24.5,Pts+Rebs+Asts,20,16,19,5
Malik Monk,G,22023,1628370,22300532,"JAN 12, 2024",SAC @ PHI,L,27,5,17,0.294,0,7,0.0,5,6,0.833,0,1,1,4,2,1,2,1,15,-9,1,SAC,PHI,SAC,90,5.0,Assists,20,16,19,5
Malik Monk,G,22023,1628370,22300532,"JAN 12, 2024",SAC @ PHI,L,27,5,17,0.294,0,7,0.0,5,6,0.833,0,1,1,4,2,1,2,1,15,-9,1,SAC,PHI,SAC,90,19.0,Pts+Rebs,20,16,19,5
Malik Monk,G,22023,1628370,22300532,"JAN 12, 2024",SAC @ PHI,L,27,5,17,0.294,0,7,0.0,5,6,0.833,0,1,1,4,2,1,2,1,15,-9,1,SAC,PHI,SAC,90,20.5,Pts+Asts,20,16,19,5
Malik Monk,G,22023,1628370,22300532,"JAN 12, 2024",SAC @ PHI,L,27,5,17,0.294,0,7,0.0,5,6,0.833,0,1,1,4,2,1,2,1,15,-9,1,SAC,PHI,SAC,90,0.5,Blocked Shots,20,16,19,5
Malik Monk,G,22023,1628370,22300532,"JAN 12, 2024",SAC @ PHI,L,27,5,17,0.294,0,7,0.0,5,6,0.833,0,1,1,4,2,1,2,1,15,-9,1,SAC,PHI,SAC,90,0.5,Steals,20,16,19,5
Malik Monk,G,22023,1628370,22300532,"JAN 12, 2024",SAC @ PHI,L,27,5,17,0.294,0,7,0.0,5,6,0.833,0,1,1,4,2,1,2,1,15,-9,1,SAC,PHI,SAC,90,8.5,Rebs+Asts,20,16,19,5
Malik Monk,G,22023,1628370,22300518,"JAN 10, 2024",SAC @ CHA,W,30,6,13,0.462,1,5,0.2,7,7,1.0,0,4,4,4,0,2,1,0,20,17,1,SAC,CHA,SAC,121,15.5,Points,28,24,24,8
Malik Monk,G,22023,1628370,22300518,"JAN 10, 2024",SAC @ CHA,W,30,6,13,0.462,1,5,0.2,7,7,1.0,0,4,4,4,0,2,1,0,20,17,1,SAC,CHA,SAC,121,24.5,Pts+Rebs+Asts,28,24,24,8
Malik Monk,G,22023,1628370,22300518,"JAN 10, 2024",SAC @ CHA,W,30,6,13,0.462,1,5,0.2,7,7,1.0,0,4,4,4,0,2,1,0,20,17,1,SAC,CHA,SAC,121,5.0,Assists,28,24,24,8
Malik Monk,G,22023,1628370,22300518,"JAN 10, 2024",SAC @ CHA,W,30,6,13,0.462,1,5,0.2,7,7,1.0,0,4,4,4,0,2,1,0,20,17,1,SAC,CHA,SAC,121,19.0,Pts+Rebs,28,24,24,8
Malik Monk,G,22023,1628370,22300518,"JAN 10, 2024",SAC @ CHA,W,30,6,13,0.462,1,5,0.2,7,7,1.0,0,4,4,4,0,2,1,0,20,17,1,SAC,CHA,SAC,121,20.5,Pts+Asts,28,24,24,8
Malik Monk,G,22023,1628370,22300518,"JAN 10, 2024",SAC @ CHA,W,30,6,13,0.462,1,5,0.2,7,7,1.0,0,4,4,4,0,2,1,0,20,17,1,SAC,CHA,SAC,121,0.5,Blocked Shots,28,24,24,8
Malik Monk,G,22023,1628370,22300518,"JAN 10, 2024",SAC @ CHA,W,30,6,13,0.462,1,5,0.2,7,7,1.0,0,4,4,4,0,2,1,0,20,17,1,SAC,CHA,SAC,121,0.5,Steals,28,24,24,8
Malik Monk,G,22023,1628370,22300518,"JAN 10, 2024",SAC @ CHA,W,30,6,13,0.462,1,5,0.2,7,7,1.0,0,4,4,4,0,2,1,0,20,17,1,SAC,CHA,SAC,121,8.5,Rebs+Asts,28,24,24,8
Malik Monk,G,22023,1628370,22300512,"JAN 09, 2024",SAC @ DET,W,28,9,15,0.6,2,6,0.333,0,0,0.0,0,2,2,9,1,2,3,5,20,18,1,SAC,DET,SAC,131,15.5,Points,31,22,29,11
Malik Monk,G,22023,1628370,22300512,"JAN 09, 2024",SAC @ DET,W,28,9,15,0.6,2,6,0.333,0,0,0.0,0,2,2,9,1,2,3,5,20,18,1,SAC,DET,SAC,131,24.5,Pts+Rebs+Asts,31,22,29,11
Malik Monk,G,22023,1628370,22300512,"JAN 09, 2024",SAC @ DET,W,28,9,15,0.6,2,6,0.333,0,0,0.0,0,2,2,9,1,2,3,5,20,18,1,SAC,DET,SAC,131,5.0,Assists,31,22,29,11
Malik Monk,G,22023,1628370,22300512,"JAN 09, 2024",SAC @ DET,W,28,9,15,0.6,2,6,0.333,0,0,0.0,0,2,2,9,1,2,3,5,20,18,1,SAC,DET,SAC,131,19.0,Pts+Rebs,31,22,29,11
Malik Monk,G,22023,1628370,22300512,"JAN 09, 2024",SAC @ DET,W,28,9,15,0.6,2,6,0.333,0,0,0.0,0,2,2,9,1,2,3,5,20,18,1,SAC,DET,SAC,131,20.5,Pts+Asts,31,22,29,11
Malik Monk,G,22023,1628370,22300512,"JAN 09, 2024",SAC @ DET,W,28,9,15,0.6,2,6,0.333,0,0,0.0,0,2,2,9,1,2,3,5,20,18,1,SAC,DET,SAC,131,0.5,Blocked Shots,31,22,29,11
Malik Monk,G,22023,1628370,22300512,"JAN 09, 2024",SAC @ DET,W,28,9,15,0.6,2,6,0.333,0,0,0.0,0,2,2,9,1,2,3,5,20,18,1,SAC,DET,SAC,131,0.5,Steals,31,22,29,11
Malik Monk,G,22023,1628370,22300512,"JAN 09, 2024",SAC @ DET,W,28,9,15,0.6,2,6,0.333,0,0,0.0,0,2,2,9,1,2,3,5,20,18,1,SAC,DET,SAC,131,8.5,Rebs+Asts,31,22,29,11
Malik Monk,G,22023,1628370,22300500,"JAN 07, 2024",SAC vs. NOP,L,21,2,9,0.222,2,6,0.333,0,0,0.0,0,1,1,5,1,1,1,1,6,-26,1,SAC,SAC,NOP,100,15.5,Points,12,7,11,6
Malik Monk,G,22023,1628370,22300500,"JAN 07, 2024",SAC vs. NOP,L,21,2,9,0.222,2,6,0.333,0,0,0.0,0,1,1,5,1,1,1,1,6,-26,1,SAC,SAC,NOP,100,24.5,Pts+Rebs+Asts,12,7,11,6
Malik Monk,G,22023,1628370,22300500,"JAN 07, 2024",SAC vs. NOP,L,21,2,9,0.222,2,6,0.333,0,0,0.0,0,1,1,5,1,1,1,1,6,-26,1,SAC,SAC,NOP,100,5.0,Assists,12,7,11,6
Malik Monk,G,22023,1628370,22300500,"JAN 07, 2024",SAC vs. NOP,L,21,2,9,0.222,2,6,0.333,0,0,0.0,0,1,1,5,1,1,1,1,6,-26,1,SAC,SAC,NOP,100,19.0,Pts+Rebs,12,7,11,6
Malik Monk,G,22023,1628370,22300500,"JAN 07, 2024",SAC vs. NOP,L,21,2,9,0.222,2,6,0.333,0,0,0.0,0,1,1,5,1,1,1,1,6,-26,1,SAC,SAC,NOP,100,20.5,Pts+Asts,12,7,11,6
Malik Monk,G,22023,1628370,22300500,"JAN 07, 2024",SAC vs. NOP,L,21,2,9,0.222,2,6,0.333,0,0,0.0,0,1,1,5,1,1,1,1,6,-26,1,SAC,SAC,NOP,100,0.5,Blocked Shots,12,7,11,6
Malik Monk,G,22023,1628370,22300500,"JAN 07, 2024",SAC vs. NOP,L,21,2,9,0.222,2,6,0.333,0,0,0.0,0,1,1,5,1,1,1,1,6,-26,1,SAC,SAC,NOP,100,0.5,Steals,12,7,11,6
Malik Monk,G,22023,1628370,22300500,"JAN 07, 2024",SAC vs. NOP,L,21,2,9,0.222,2,6,0.333,0,0,0.0,0,1,1,5,1,1,1,1,6,-26,1,SAC,SAC,NOP,100,8.5,Rebs+Asts,12,7,11,6
Malik Monk,G,22023,1628370,22300492,"JAN 05, 2024",SAC vs. TOR,W,32,6,16,0.375,3,9,0.333,0,1,0.0,0,1,1,9,1,0,1,4,15,10,1,SAC,SAC,TOR,135,15.5,Points,25,16,24,10
Malik Monk,G,22023,1628370,22300492,"JAN 05, 2024",SAC vs. TOR,W,32,6,16,0.375,3,9,0.333,0,1,0.0,0,1,1,9,1,0,1,4,15,10,1,SAC,SAC,TOR,135,24.5,Pts+Rebs+Asts,25,16,24,10
Malik Monk,G,22023,1628370,22300492,"JAN 05, 2024",SAC vs. TOR,W,32,6,16,0.375,3,9,0.333,0,1,0.0,0,1,1,9,1,0,1,4,15,10,1,SAC,SAC,TOR,135,5.0,Assists,25,16,24,10
Malik Monk,G,22023,1628370,22300492,"JAN 05, 2024",SAC vs. TOR,W,32,6,16,0.375,3,9,0.333,0,1,0.0,0,1,1,9,1,0,1,4,15,10,1,SAC,SAC,TOR,135,19.0,Pts+Rebs,25,16,24,10
Malik Monk,G,22023,1628370,22300492,"JAN 05, 2024",SAC vs. TOR,W,32,6,16,0.375,3,9,0.333,0,1,0.0,0,1,1,9,1,0,1,4,15,10,1,SAC,SAC,TOR,135,20.5,Pts+Asts,25,16,24,10
Malik Monk,G,22023,1628370,22300492,"JAN 05, 2024",SAC vs. TOR,W,32,6,16,0.375,3,9,0.333,0,1,0.0,0,1,1,9,1,0,1,4,15,10,1,SAC,SAC,TOR,135,0.5,Blocked Shots,25,16,24,10
Malik Monk,G,22023,1628370,22300492,"JAN 05, 2024",SAC vs. TOR,W,32,6,16,0.375,3,9,0.333,0,1,0.0,0,1,1,9,1,0,1,4,15,10,1,SAC,SAC,TOR,135,0.5,Steals,25,16,24,10
Malik Monk,G,22023,1628370,22300492,"JAN 05, 2024",SAC vs. TOR,W,32,6,16,0.375,3,9,0.333,0,1,0.0,0,1,1,9,1,0,1,4,15,10,1,SAC,SAC,TOR,135,8.5,Rebs+Asts,25,16,24,10
Malik Monk,G,22023,1628370,22300476,"JAN 03, 2024",SAC vs. ORL,W,46,12,20,0.6,7,13,0.538,6,8,0.75,0,3,3,9,2,1,3,5,37,14,1,SAC,SAC,ORL,138,15.5,Points,49,40,46,12
Malik Monk,G,22023,1628370,22300476,"JAN 03, 2024",SAC vs. ORL,W,46,12,20,0.6,7,13,0.538,6,8,0.75,0,3,3,9,2,1,3,5,37,14,1,SAC,SAC,ORL,138,24.5,Pts+Rebs+Asts,49,40,46,12
Malik Monk,G,22023,1628370,22300476,"JAN 03, 2024",SAC vs. ORL,W,46,12,20,0.6,7,13,0.538,6,8,0.75,0,3,3,9,2,1,3,5,37,14,1,SAC,SAC,ORL,138,5.0,Assists,49,40,46,12
Malik Monk,G,22023,1628370,22300476,"JAN 03, 2024",SAC vs. ORL,W,46,12,20,0.6,7,13,0.538,6,8,0.75,0,3,3,9,2,1,3,5,37,14,1,SAC,SAC,ORL,138,19.0,Pts+Rebs,49,40,46,12
Malik Monk,G,22023,1628370,22300476,"JAN 03, 2024",SAC vs. ORL,W,46,12,20,0.6,7,13,0.538,6,8,0.75,0,3,3,9,2,1,3,5,37,14,1,SAC,SAC,ORL,138,20.5,Pts+Asts,49,40,46,12
Malik Monk,G,22023,1628370,22300476,"JAN 03, 2024",SAC vs. ORL,W,46,12,20,0.6,7,13,0.538,6,8,0.75,0,3,3,9,2,1,3,5,37,14,1,SAC,SAC,ORL,138,0.5,Blocked Shots,49,40,46,12
Malik Monk,G,22023,1628370,22300476,"JAN 03, 2024",SAC vs. ORL,W,46,12,20,0.6,7,13,0.538,6,8,0.75,0,3,3,9,2,1,3,5,37,14,1,SAC,SAC,ORL,138,0.5,Steals,49,40,46,12
Malik Monk,G,22023,1628370,22300476,"JAN 03, 2024",SAC vs. ORL,W,46,12,20,0.6,7,13,0.538,6,8,0.75,0,3,3,9,2,1,3,5,37,14,1,SAC,SAC,ORL,138,8.5,Rebs+Asts,49,40,46,12
Malik Monk,G,22023,1628370,22300464,"JAN 02, 2024",SAC vs. CHA,L,20,2,7,0.286,2,5,0.4,0,0,0.0,1,2,3,2,0,1,1,2,6,-21,1,SAC,SAC,CHA,104,15.5,Points,11,9,8,5
Malik Monk,G,22023,1628370,22300464,"JAN 02, 2024",SAC vs. CHA,L,20,2,7,0.286,2,5,0.4,0,0,0.0,1,2,3,2,0,1,1,2,6,-21,1,SAC,SAC,CHA,104,24.5,Pts+Rebs+Asts,11,9,8,5
Malik Monk,G,22023,1628370,22300464,"JAN 02, 2024",SAC vs. CHA,L,20,2,7,0.286,2,5,0.4,0,0,0.0,1,2,3,2,0,1,1,2,6,-21,1,SAC,SAC,CHA,104,5.0,Assists,11,9,8,5
Malik Monk,G,22023,1628370,22300464,"JAN 02, 2024",SAC vs. CHA,L,20,2,7,0.286,2,5,0.4,0,0,0.0,1,2,3,2,0,1,1,2,6,-21,1,SAC,SAC,CHA,104,19.0,Pts+Rebs,11,9,8,5
Malik Monk,G,22023,1628370,22300464,"JAN 02, 2024",SAC vs. CHA,L,20,2,7,0.286,2,5,0.4,0,0,0.0,1,2,3,2,0,1,1,2,6,-21,1,SAC,SAC,CHA,104,20.5,Pts+Asts,11,9,8,5
Malik Monk,G,22023,1628370,22300464,"JAN 02, 2024",SAC vs. CHA,L,20,2,7,0.286,2,5,0.4,0,0,0.0,1,2,3,2,0,1,1,2,6,-21,1,SAC,SAC,CHA,104,0.5,Blocked Shots,11,9,8,5
Malik Monk,G,22023,1628370,22300464,"JAN 02, 2024",SAC vs. CHA,L,20,2,7,0.286,2,5,0.4,0,0,0.0,1,2,3,2,0,1,1,2,6,-21,1,SAC,SAC,CHA,104,0.5,Steals,11,9,8,5
Malik Monk,G,22023,1628370,22300464,"JAN 02, 2024",SAC vs. CHA,L,20,2,7,0.286,2,5,0.4,0,0,0.0,1,2,3,2,0,1,1,2,6,-21,1,SAC,SAC,CHA,104,8.5,Rebs+Asts,11,9,8,5
Malik Monk,G,22023,1628370,22300449,"DEC 31, 2023",SAC @ MEM,W,21,10,13,0.769,4,5,0.8,3,3,1.0,0,4,4,5,0,0,0,1,27,16,1,SAC,MEM,SAC,123,15.5,Points,36,31,32,9
Malik Monk,G,22023,1628370,22300449,"DEC 31, 2023",SAC @ MEM,W,21,10,13,0.769,4,5,0.8,3,3,1.0,0,4,4,5,0,0,0,1,27,16,1,SAC,MEM,SAC,123,24.5,Pts+Rebs+Asts,36,31,32,9
Malik Monk,G,22023,1628370,22300449,"DEC 31, 2023",SAC @ MEM,W,21,10,13,0.769,4,5,0.8,3,3,1.0,0,4,4,5,0,0,0,1,27,16,1,SAC,MEM,SAC,123,5.0,Assists,36,31,32,9
Malik Monk,G,22023,1628370,22300449,"DEC 31, 2023",SAC @ MEM,W,21,10,13,0.769,4,5,0.8,3,3,1.0,0,4,4,5,0,0,0,1,27,16,1,SAC,MEM,SAC,123,19.0,Pts+Rebs,36,31,32,9
Malik Monk,G,22023,1628370,22300449,"DEC 31, 2023",SAC @ MEM,W,21,10,13,0.769,4,5,0.8,3,3,1.0,0,4,4,5,0,0,0,1,27,16,1,SAC,MEM,SAC,123,20.5,Pts+Asts,36,31,32,9
Malik Monk,G,22023,1628370,22300449,"DEC 31, 2023",SAC @ MEM,W,21,10,13,0.769,4,5,0.8,3,3,1.0,0,4,4,5,0,0,0,1,27,16,1,SAC,MEM,SAC,123,0.5,Blocked Shots,36,31,32,9
Malik Monk,G,22023,1628370,22300449,"DEC 31, 2023",SAC @ MEM,W,21,10,13,0.769,4,5,0.8,3,3,1.0,0,4,4,5,0,0,0,1,27,16,1,SAC,MEM,SAC,123,0.5,Steals,36,31,32,9
Malik Monk,G,22023,1628370,22300449,"DEC 31, 2023",SAC @ MEM,W,21,10,13,0.769,4,5,0.8,3,3,1.0,0,4,4,5,0,0,0,1,27,16,1,SAC,MEM,SAC,123,8.5,Rebs+Asts,36,31,32,9
Malik Monk,G,22023,1628370,22300431,"DEC 29, 2023",SAC @ ATL,W,31,6,10,0.6,2,5,0.4,1,1,1.0,0,4,4,8,1,1,5,3,15,18,1,SAC,ATL,SAC,117,15.5,Points,27,19,23,12
Malik Monk,G,22023,1628370,22300431,"DEC 29, 2023",SAC @ ATL,W,31,6,10,0.6,2,5,0.4,1,1,1.0,0,4,4,8,1,1,5,3,15,18,1,SAC,ATL,SAC,117,24.5,Pts+Rebs+Asts,27,19,23,12
Malik Monk,G,22023,1628370,22300431,"DEC 29, 2023",SAC @ ATL,W,31,6,10,0.6,2,5,0.4,1,1,1.0,0,4,4,8,1,1,5,3,15,18,1,SAC,ATL,SAC,117,5.0,Assists,27,19,23,12
Malik Monk,G,22023,1628370,22300431,"DEC 29, 2023",SAC @ ATL,W,31,6,10,0.6,2,5,0.4,1,1,1.0,0,4,4,8,1,1,5,3,15,18,1,SAC,ATL,SAC,117,19.0,Pts+Rebs,27,19,23,12
Malik Monk,G,22023,1628370,22300431,"DEC 29, 2023",SAC @ ATL,W,31,6,10,0.6,2,5,0.4,1,1,1.0,0,4,4,8,1,1,5,3,15,18,1,SAC,ATL,SAC,117,20.5,Pts+Asts,27,19,23,12
Malik Monk,G,22023,1628370,22300431,"DEC 29, 2023",SAC @ ATL,W,31,6,10,0.6,2,5,0.4,1,1,1.0,0,4,4,8,1,1,5,3,15,18,1,SAC,ATL,SAC,117,0.5,Blocked Shots,27,19,23,12
Malik Monk,G,22023,1628370,22300431,"DEC 29, 2023",SAC @ ATL,W,31,6,10,0.6,2,5,0.4,1,1,1.0,0,4,4,8,1,1,5,3,15,18,1,SAC,ATL,SAC,117,0.5,Steals,27,19,23,12
Malik Monk,G,22023,1628370,22300431,"DEC 29, 2023",SAC @ ATL,W,31,6,10,0.6,2,5,0.4,1,1,1.0,0,4,4,8,1,1,5,3,15,18,1,SAC,ATL,SAC,117,8.5,Rebs+Asts,27,19,23,12
Malik Monk,G,22023,1628370,22300413,"DEC 26, 2023",SAC @ POR,L,19,3,11,0.273,1,7,0.143,0,0,0.0,0,1,1,4,0,1,0,2,7,-21,1,SAC,POR,SAC,113,15.5,Points,12,8,11,5
Malik Monk,G,22023,1628370,22300413,"DEC 26, 2023",SAC @ POR,L,19,3,11,0.273,1,7,0.143,0,0,0.0,0,1,1,4,0,1,0,2,7,-21,1,SAC,POR,SAC,113,24.5,Pts+Rebs+Asts,12,8,11,5
Malik Monk,G,22023,1628370,22300413,"DEC 26, 2023",SAC @ POR,L,19,3,11,0.273,1,7,0.143,0,0,0.0,0,1,1,4,0,1,0,2,7,-21,1,SAC,POR,SAC,113,5.0,Assists,12,8,11,5
Malik Monk,G,22023,1628370,22300413,"DEC 26, 2023",SAC @ POR,L,19,3,11,0.273,1,7,0.143,0,0,0.0,0,1,1,4,0,1,0,2,7,-21,1,SAC,POR,SAC,113,19.0,Pts+Rebs,12,8,11,5
Malik Monk,G,22023,1628370,22300413,"DEC 26, 2023",SAC @ POR,L,19,3,11,0.273,1,7,0.143,0,0,0.0,0,1,1,4,0,1,0,2,7,-21,1,SAC,POR,SAC,113,20.5,Pts+Asts,12,8,11,5
Malik Monk,G,22023,1628370,22300413,"DEC 26, 2023",SAC @ POR,L,19,3,11,0.273,1,7,0.143,0,0,0.0,0,1,1,4,0,1,0,2,7,-21,1,SAC,POR,SAC,113,0.5,Blocked Shots,12,8,11,5
Malik Monk,G,22023,1628370,22300413,"DEC 26, 2023",SAC @ POR,L,19,3,11,0.273,1,7,0.143,0,0,0.0,0,1,1,4,0,1,0,2,7,-21,1,SAC,POR,SAC,113,0.5,Steals,12,8,11,5
Malik Monk,G,22023,1628370,22300413,"DEC 26, 2023",SAC @ POR,L,19,3,11,0.273,1,7,0.143,0,0,0.0,0,1,1,4,0,1,0,2,7,-21,1,SAC,POR,SAC,113,8.5,Rebs+Asts,12,8,11,5
Malik Monk,G,22023,1628370,22300387,"DEC 22, 2023",SAC vs. PHX,W,20,3,8,0.375,0,3,0.0,1,2,0.5,0,2,2,5,0,3,2,4,7,-3,1,SAC,SAC,PHX,120,15.5,Points,14,9,12,7
Malik Monk,G,22023,1628370,22300387,"DEC 22, 2023",SAC vs. PHX,W,20,3,8,0.375,0,3,0.0,1,2,0.5,0,2,2,5,0,3,2,4,7,-3,1,SAC,SAC,PHX,120,24.5,Pts+Rebs+Asts,14,9,12,7
Malik Monk,G,22023,1628370,22300387,"DEC 22, 2023",SAC vs. PHX,W,20,3,8,0.375,0,3,0.0,1,2,0.5,0,2,2,5,0,3,2,4,7,-3,1,SAC,SAC,PHX,120,5.0,Assists,14,9,12,7
Malik Monk,G,22023,1628370,22300387,"DEC 22, 2023",SAC vs. PHX,W,20,3,8,0.375,0,3,0.0,1,2,0.5,0,2,2,5,0,3,2,4,7,-3,1,SAC,SAC,PHX,120,19.0,Pts+Rebs,14,9,12,7
Malik Monk,G,22023,1628370,22300387,"DEC 22, 2023",SAC vs. PHX,W,20,3,8,0.375,0,3,0.0,1,2,0.5,0,2,2,5,0,3,2,4,7,-3,1,SAC,SAC,PHX,120,20.5,Pts+Asts,14,9,12,7
Malik Monk,G,22023,1628370,22300387,"DEC 22, 2023",SAC vs. PHX,W,20,3,8,0.375,0,3,0.0,1,2,0.5,0,2,2,5,0,3,2,4,7,-3,1,SAC,SAC,PHX,120,0.5,Blocked Shots,14,9,12,7
Malik Monk,G,22023,1628370,22300387,"DEC 22, 2023",SAC vs. PHX,W,20,3,8,0.375,0,3,0.0,1,2,0.5,0,2,2,5,0,3,2,4,7,-3,1,SAC,SAC,PHX,120,0.5,Steals,14,9,12,7
Malik Monk,G,22023,1628370,22300387,"DEC 22, 2023",SAC vs. PHX,W,20,3,8,0.375,0,3,0.0,1,2,0.5,0,2,2,5,0,3,2,4,7,-3,1,SAC,SAC,PHX,120,8.5,Rebs+Asts,14,9,12,7
Malik Monk,G,22023,1628370,22300373,"DEC 20, 2023",SAC vs. BOS,L,25,3,10,0.3,0,4,0.0,4,4,1.0,0,2,2,5,0,0,1,1,10,-7,1,SAC,SAC,BOS,119,15.5,Points,17,12,15,7
Malik Monk,G,22023,1628370,22300373,"DEC 20, 2023",SAC vs. BOS,L,25,3,10,0.3,0,4,0.0,4,4,1.0,0,2,2,5,0,0,1,1,10,-7,1,SAC,SAC,BOS,119,24.5,Pts+Rebs+Asts,17,12,15,7
Malik Monk,G,22023,1628370,22300373,"DEC 20, 2023",SAC vs. BOS,L,25,3,10,0.3,0,4,0.0,4,4,1.0,0,2,2,5,0,0,1,1,10,-7,1,SAC,SAC,BOS,119,5.0,Assists,17,12,15,7
Malik Monk,G,22023,1628370,22300373,"DEC 20, 2023",SAC vs. BOS,L,25,3,10,0.3,0,4,0.0,4,4,1.0,0,2,2,5,0,0,1,1,10,-7,1,SAC,SAC,BOS,119,19.0,Pts+Rebs,17,12,15,7
Malik Monk,G,22023,1628370,22300373,"DEC 20, 2023",SAC vs. BOS,L,25,3,10,0.3,0,4,0.0,4,4,1.0,0,2,2,5,0,0,1,1,10,-7,1,SAC,SAC,BOS,119,20.5,Pts+Asts,17,12,15,7
Malik Monk,G,22023,1628370,22300373,"DEC 20, 2023",SAC vs. BOS,L,25,3,10,0.3,0,4,0.0,4,4,1.0,0,2,2,5,0,0,1,1,10,-7,1,SAC,SAC,BOS,119,0.5,Blocked Shots,17,12,15,7
Malik Monk,G,22023,1628370,22300373,"DEC 20, 2023",SAC vs. BOS,L,25,3,10,0.3,0,4,0.0,4,4,1.0,0,2,2,5,0,0,1,1,10,-7,1,SAC,SAC,BOS,119,0.5,Steals,17,12,15,7
Malik Monk,G,22023,1628370,22300373,"DEC 20, 2023",SAC vs. BOS,L,25,3,10,0.3,0,4,0.0,4,4,1.0,0,2,2,5,0,0,1,1,10,-7,1,SAC,SAC,BOS,119,8.5,Rebs+Asts,17,12,15,7
Malik Monk,G,22023,1628370,22300358,"DEC 18, 2023",SAC vs. WAS,W,22,3,7,0.429,3,6,0.5,1,2,0.5,0,1,1,6,0,1,1,3,10,3,1,SAC,SAC,WAS,141,15.5,Points,17,11,16,7
Malik Monk,G,22023,1628370,22300358,"DEC 18, 2023",SAC vs. WAS,W,22,3,7,0.429,3,6,0.5,1,2,0.5,0,1,1,6,0,1,1,3,10,3,1,SAC,SAC,WAS,141,24.5,Pts+Rebs+Asts,17,11,16,7
Malik Monk,G,22023,1628370,22300358,"DEC 18, 2023",SAC vs. WAS,W,22,3,7,0.429,3,6,0.5,1,2,0.5,0,1,1,6,0,1,1,3,10,3,1,SAC,SAC,WAS,141,5.0,Assists,17,11,16,7
Malik Monk,G,22023,1628370,22300358,"DEC 18, 2023",SAC vs. WAS,W,22,3,7,0.429,3,6,0.5,1,2,0.5,0,1,1,6,0,1,1,3,10,3,1,SAC,SAC,WAS,141,19.0,Pts+Rebs,17,11,16,7
Malik Monk,G,22023,1628370,22300358,"DEC 18, 2023",SAC vs. WAS,W,22,3,7,0.429,3,6,0.5,1,2,0.5,0,1,1,6,0,1,1,3,10,3,1,SAC,SAC,WAS,141,20.5,Pts+Asts,17,11,16,7
Malik Monk,G,22023,1628370,22300358,"DEC 18, 2023",SAC vs. WAS,W,22,3,7,0.429,3,6,0.5,1,2,0.5,0,1,1,6,0,1,1,3,10,3,1,SAC,SAC,WAS,141,0.5,Blocked Shots,17,11,16,7
Malik Monk,G,22023,1628370,22300358,"DEC 18, 2023",SAC vs. WAS,W,22,3,7,0.429,3,6,0.5,1,2,0.5,0,1,1,6,0,1,1,3,10,3,1,SAC,SAC,WAS,141,0.5,Steals,17,11,16,7
Malik Monk,G,22023,1628370,22300358,"DEC 18, 2023",SAC vs. WAS,W,22,3,7,0.429,3,6,0.5,1,2,0.5,0,1,1,6,0,1,1,3,10,3,1,SAC,SAC,WAS,141,8.5,Rebs+Asts,17,11,16,7
Malik Monk,G,22023,1628370,22300342,"DEC 16, 2023",SAC vs. UTA,W,26,6,16,0.375,4,12,0.333,2,2,1.0,0,4,4,8,0,1,1,0,18,-3,1,SAC,SAC,UTA,125,15.5,Points,30,22,26,12
Malik Monk,G,22023,1628370,22300342,"DEC 16, 2023",SAC vs. UTA,W,26,6,16,0.375,4,12,0.333,2,2,1.0,0,4,4,8,0,1,1,0,18,-3,1,SAC,SAC,UTA,125,24.5,Pts+Rebs+Asts,30,22,26,12
Malik Monk,G,22023,1628370,22300342,"DEC 16, 2023",SAC vs. UTA,W,26,6,16,0.375,4,12,0.333,2,2,1.0,0,4,4,8,0,1,1,0,18,-3,1,SAC,SAC,UTA,125,5.0,Assists,30,22,26,12
Malik Monk,G,22023,1628370,22300342,"DEC 16, 2023",SAC vs. UTA,W,26,6,16,0.375,4,12,0.333,2,2,1.0,0,4,4,8,0,1,1,0,18,-3,1,SAC,SAC,UTA,125,19.0,Pts+Rebs,30,22,26,12
Malik Monk,G,22023,1628370,22300342,"DEC 16, 2023",SAC vs. UTA,W,26,6,16,0.375,4,12,0.333,2,2,1.0,0,4,4,8,0,1,1,0,18,-3,1,SAC,SAC,UTA,125,20.5,Pts+Asts,30,22,26,12
Malik Monk,G,22023,1628370,22300342,"DEC 16, 2023",SAC vs. UTA,W,26,6,16,0.375,4,12,0.333,2,2,1.0,0,4,4,8,0,1,1,0,18,-3,1,SAC,SAC,UTA,125,0.5,Blocked Shots,30,22,26,12
Malik Monk,G,22023,1628370,22300342,"DEC 16, 2023",SAC vs. UTA,W,26,6,16,0.375,4,12,0.333,2,2,1.0,0,4,4,8,0,1,1,0,18,-3,1,SAC,SAC,UTA,125,0.5,Steals,30,22,26,12
Malik Monk,G,22023,1628370,22300342,"DEC 16, 2023",SAC vs. UTA,W,26,6,16,0.375,4,12,0.333,2,2,1.0,0,4,4,8,0,1,1,0,18,-3,1,SAC,SAC,UTA,125,8.5,Rebs+Asts,30,22,26,12
Malik Monk,G,22023,1628370,22300324,"DEC 14, 2023",SAC vs. OKC,W,33,7,15,0.467,4,8,0.5,0,0,0.0,0,1,1,9,0,1,4,2,18,12,1,SAC,SAC,OKC,128,15.5,Points,28,19,27,10
Malik Monk,G,22023,1628370,22300324,"DEC 14, 2023",SAC vs. OKC,W,33,7,15,0.467,4,8,0.5,0,0,0.0,0,1,1,9,0,1,4,2,18,12,1,SAC,SAC,OKC,128,24.5,Pts+Rebs+Asts,28,19,27,10
Malik Monk,G,22023,1628370,22300324,"DEC 14, 2023",SAC vs. OKC,W,33,7,15,0.467,4,8,0.5,0,0,0.0,0,1,1,9,0,1,4,2,18,12,1,SAC,SAC,OKC,128,5.0,Assists,28,19,27,10
Malik Monk,G,22023,1628370,22300324,"DEC 14, 2023",SAC vs. OKC,W,33,7,15,0.467,4,8,0.5,0,0,0.0,0,1,1,9,0,1,4,2,18,12,1,SAC,SAC,OKC,128,19.0,Pts+Rebs,28,19,27,10
Malik Monk,G,22023,1628370,22300324,"DEC 14, 2023",SAC vs. OKC,W,33,7,15,0.467,4,8,0.5,0,0,0.0,0,1,1,9,0,1,4,2,18,12,1,SAC,SAC,OKC,128,20.5,Pts+Asts,28,19,27,10
Malik Monk,G,22023,1628370,22300324,"DEC 14, 2023",SAC vs. OKC,W,33,7,15,0.467,4,8,0.5,0,0,0.0,0,1,1,9,0,1,4,2,18,12,1,SAC,SAC,OKC,128,0.5,Blocked Shots,28,19,27,10
Malik Monk,G,22023,1628370,22300324,"DEC 14, 2023",SAC vs. OKC,W,33,7,15,0.467,4,8,0.5,0,0,0.0,0,1,1,9,0,1,4,2,18,12,1,SAC,SAC,OKC,128,0.5,Steals,28,19,27,10
Malik Monk,G,22023,1628370,22300324,"DEC 14, 2023",SAC vs. OKC,W,33,7,15,0.467,4,8,0.5,0,0,0.0,0,1,1,9,0,1,4,2,18,12,1,SAC,SAC,OKC,128,8.5,Rebs+Asts,28,19,27,10
Malik Monk,G,22023,1628370,22300309,"DEC 12, 2023",SAC @ LAC,L,22,3,8,0.375,2,5,0.4,0,0,0.0,0,0,0,5,0,0,4,4,8,-20,1,SAC,LAC,SAC,99,15.5,Points,13,8,13,5
Malik Monk,G,22023,1628370,22300309,"DEC 12, 2023",SAC @ LAC,L,22,3,8,0.375,2,5,0.4,0,0,0.0,0,0,0,5,0,0,4,4,8,-20,1,SAC,LAC,SAC,99,24.5,Pts+Rebs+Asts,13,8,13,5
Malik Monk,G,22023,1628370,22300309,"DEC 12, 2023",SAC @ LAC,L,22,3,8,0.375,2,5,0.4,0,0,0.0,0,0,0,5,0,0,4,4,8,-20,1,SAC,LAC,SAC,99,5.0,Assists,13,8,13,5
Malik Monk,G,22023,1628370,22300309,"DEC 12, 2023",SAC @ LAC,L,22,3,8,0.375,2,5,0.4,0,0,0.0,0,0,0,5,0,0,4,4,8,-20,1,SAC,LAC,SAC,99,19.0,Pts+Rebs,13,8,13,5
Malik Monk,G,22023,1628370,22300309,"DEC 12, 2023",SAC @ LAC,L,22,3,8,0.375,2,5,0.4,0,0,0.0,0,0,0,5,0,0,4,4,8,-20,1,SAC,LAC,SAC,99,20.5,Pts+Asts,13,8,13,5
Malik Monk,G,22023,1628370,22300309,"DEC 12, 2023",SAC @ LAC,L,22,3,8,0.375,2,5,0.4,0,0,0.0,0,0,0,5,0,0,4,4,8,-20,1,SAC,LAC,SAC,99,0.5,Blocked Shots,13,8,13,5
Malik Monk,G,22023,1628370,22300309,"DEC 12, 2023",SAC @ LAC,L,22,3,8,0.375,2,5,0.4,0,0,0.0,0,0,0,5,0,0,4,4,8,-20,1,SAC,LAC,SAC,99,0.5,Steals,13,8,13,5
Malik Monk,G,22023,1628370,22300309,"DEC 12, 2023",SAC @ LAC,L,22,3,8,0.375,2,5,0.4,0,0,0.0,0,0,0,5,0,0,4,4,8,-20,1,SAC,LAC,SAC,99,8.5,Rebs+Asts,13,8,13,5
Malik Monk,G,22023,1628370,22300303,"DEC 11, 2023",SAC vs. BKN,W,28,8,13,0.615,4,7,0.571,1,1,1.0,1,1,2,9,1,0,2,0,21,12,1,SAC,SAC,BKN,131,15.5,Points,32,23,30,11
Malik Monk,G,22023,1628370,22300303,"DEC 11, 2023",SAC vs. BKN,W,28,8,13,0.615,4,7,0.571,1,1,1.0,1,1,2,9,1,0,2,0,21,12,1,SAC,SAC,BKN,131,24.5,Pts+Rebs+Asts,32,23,30,11
Malik Monk,G,22023,1628370,22300303,"DEC 11, 2023",SAC vs. BKN,W,28,8,13,0.615,4,7,0.571,1,1,1.0,1,1,2,9,1,0,2,0,21,12,1,SAC,SAC,BKN,131,5.0,Assists,32,23,30,11
Malik Monk,G,22023,1628370,22300303,"DEC 11, 2023",SAC vs. BKN,W,28,8,13,0.615,4,7,0.571,1,1,1.0,1,1,2,9,1,0,2,0,21,12,1,SAC,SAC,BKN,131,19.0,Pts+Rebs,32,23,30,11
Malik Monk,G,22023,1628370,22300303,"DEC 11, 2023",SAC vs. BKN,W,28,8,13,0.615,4,7,0.571,1,1,1.0,1,1,2,9,1,0,2,0,21,12,1,SAC,SAC,BKN,131,20.5,Pts+Asts,32,23,30,11
Malik Monk,G,22023,1628370,22300303,"DEC 11, 2023",SAC vs. BKN,W,28,8,13,0.615,4,7,0.571,1,1,1.0,1,1,2,9,1,0,2,0,21,12,1,SAC,SAC,BKN,131,0.5,Blocked Shots,32,23,30,11
Malik Monk,G,22023,1628370,22300303,"DEC 11, 2023",SAC vs. BKN,W,28,8,13,0.615,4,7,0.571,1,1,1.0,1,1,2,9,1,0,2,0,21,12,1,SAC,SAC,BKN,131,0.5,Steals,32,23,30,11
Malik Monk,G,22023,1628370,22300303,"DEC 11, 2023",SAC vs. BKN,W,28,8,13,0.615,4,7,0.571,1,1,1.0,1,1,2,9,1,0,2,0,21,12,1,SAC,SAC,BKN,131,8.5,Rebs+Asts,32,23,30,11
Malik Monk,G,22023,1628370,22301228,"DEC 08, 2023",SAC @ PHX,W,28,5,10,0.5,3,7,0.429,0,0,0.0,0,2,2,6,0,0,2,2,13,18,1,SAC,PHX,SAC,114,15.5,Points,21,15,19,8
Malik Monk,G,22023,1628370,22301228,"DEC 08, 2023",SAC @ PHX,W,28,5,10,0.5,3,7,0.429,0,0,0.0,0,2,2,6,0,0,2,2,13,18,1,SAC,PHX,SAC,114,24.5,Pts+Rebs+Asts,21,15,19,8
Malik Monk,G,22023,1628370,22301228,"DEC 08, 2023",SAC @ PHX,W,28,5,10,0.5,3,7,0.429,0,0,0.0,0,2,2,6,0,0,2,2,13,18,1,SAC,PHX,SAC,114,5.0,Assists,21,15,19,8
Malik Monk,G,22023,1628370,22301228,"DEC 08, 2023",SAC @ PHX,W,28,5,10,0.5,3,7,0.429,0,0,0.0,0,2,2,6,0,0,2,2,13,18,1,SAC,PHX,SAC,114,19.0,Pts+Rebs,21,15,19,8
Malik Monk,G,22023,1628370,22301228,"DEC 08, 2023",SAC @ PHX,W,28,5,10,0.5,3,7,0.429,0,0,0.0,0,2,2,6,0,0,2,2,13,18,1,SAC,PHX,SAC,114,20.5,Pts+Asts,21,15,19,8
Malik Monk,G,22023,1628370,22301228,"DEC 08, 2023",SAC @ PHX,W,28,5,10,0.5,3,7,0.429,0,0,0.0,0,2,2,6,0,0,2,2,13,18,1,SAC,PHX,SAC,114,0.5,Blocked Shots,21,15,19,8
Malik Monk,G,22023,1628370,22301228,"DEC 08, 2023",SAC @ PHX,W,28,5,10,0.5,3,7,0.429,0,0,0.0,0,2,2,6,0,0,2,2,13,18,1,SAC,PHX,SAC,114,0.5,Steals,21,15,19,8
Malik Monk,G,22023,1628370,22301228,"DEC 08, 2023",SAC @ PHX,W,28,5,10,0.5,3,7,0.429,0,0,0.0,0,2,2,6,0,0,2,2,13,18,1,SAC,PHX,SAC,114,8.5,Rebs+Asts,21,15,19,8
Malik Monk,G,22023,1628370,22301204,"DEC 04, 2023",SAC vs. NOP,L,32,7,14,0.5,5,9,0.556,2,2,1.0,1,2,3,5,2,0,3,0,21,-17,1,SAC,SAC,NOP,117,15.5,Points,29,24,26,8
Malik Monk,G,22023,1628370,22301204,"DEC 04, 2023",SAC vs. NOP,L,32,7,14,0.5,5,9,0.556,2,2,1.0,1,2,3,5,2,0,3,0,21,-17,1,SAC,SAC,NOP,117,24.5,Pts+Rebs+Asts,29,24,26,8
Malik Monk,G,22023,1628370,22301204,"DEC 04, 2023",SAC vs. NOP,L,32,7,14,0.5,5,9,0.556,2,2,1.0,1,2,3,5,2,0,3,0,21,-17,1,SAC,SAC,NOP,117,5.0,Assists,29,24,26,8
Malik Monk,G,22023,1628370,22301204,"DEC 04, 2023",SAC vs. NOP,L,32,7,14,0.5,5,9,0.556,2,2,1.0,1,2,3,5,2,0,3,0,21,-17,1,SAC,SAC,NOP,117,19.0,Pts+Rebs,29,24,26,8
Malik Monk,G,22023,1628370,22301204,"DEC 04, 2023",SAC vs. NOP,L,32,7,14,0.5,5,9,0.556,2,2,1.0,1,2,3,5,2,0,3,0,21,-17,1,SAC,SAC,NOP,117,20.5,Pts+Asts,29,24,26,8
Malik Monk,G,22023,1628370,22301204,"DEC 04, 2023",SAC vs. NOP,L,32,7,14,0.5,5,9,0.556,2,2,1.0,1,2,3,5,2,0,3,0,21,-17,1,SAC,SAC,NOP,117,0.5,Blocked Shots,29,24,26,8
Malik Monk,G,22023,1628370,22301204,"DEC 04, 2023",SAC vs. NOP,L,32,7,14,0.5,5,9,0.556,2,2,1.0,1,2,3,5,2,0,3,0,21,-17,1,SAC,SAC,NOP,117,0.5,Steals,29,24,26,8
Malik Monk,G,22023,1628370,22301204,"DEC 04, 2023",SAC vs. NOP,L,32,7,14,0.5,5,9,0.556,2,2,1.0,1,2,3,5,2,0,3,0,21,-17,1,SAC,SAC,NOP,117,8.5,Rebs+Asts,29,24,26,8
Malik Monk,G,22023,1628370,22300290,"DEC 02, 2023",SAC vs. DEN,W,28,9,14,0.643,4,7,0.571,4,4,1.0,0,3,3,4,2,0,3,1,26,12,1,SAC,SAC,DEN,123,15.5,Points,33,29,30,7
Malik Monk,G,22023,1628370,22300290,"DEC 02, 2023",SAC vs. DEN,W,28,9,14,0.643,4,7,0.571,4,4,1.0,0,3,3,4,2,0,3,1,26,12,1,SAC,SAC,DEN,123,24.5,Pts+Rebs+Asts,33,29,30,7
Malik Monk,G,22023,1628370,22300290,"DEC 02, 2023",SAC vs. DEN,W,28,9,14,0.643,4,7,0.571,4,4,1.0,0,3,3,4,2,0,3,1,26,12,1,SAC,SAC,DEN,123,5.0,Assists,33,29,30,7
Malik Monk,G,22023,1628370,22300290,"DEC 02, 2023",SAC vs. DEN,W,28,9,14,0.643,4,7,0.571,4,4,1.0,0,3,3,4,2,0,3,1,26,12,1,SAC,SAC,DEN,123,19.0,Pts+Rebs,33,29,30,7
Malik Monk,G,22023,1628370,22300290,"DEC 02, 2023",SAC vs. DEN,W,28,9,14,0.643,4,7,0.571,4,4,1.0,0,3,3,4,2,0,3,1,26,12,1,SAC,SAC,DEN,123,20.5,Pts+Asts,33,29,30,7
Malik Monk,G,22023,1628370,22300290,"DEC 02, 2023",SAC vs. DEN,W,28,9,14,0.643,4,7,0.571,4,4,1.0,0,3,3,4,2,0,3,1,26,12,1,SAC,SAC,DEN,123,0.5,Blocked Shots,33,29,30,7
Malik Monk,G,22023,1628370,22300290,"DEC 02, 2023",SAC vs. DEN,W,28,9,14,0.643,4,7,0.571,4,4,1.0,0,3,3,4,2,0,3,1,26,12,1,SAC,SAC,DEN,123,0.5,Steals,33,29,30,7
Malik Monk,G,22023,1628370,22300290,"DEC 02, 2023",SAC vs. DEN,W,28,9,14,0.643,4,7,0.571,4,4,1.0,0,3,3,4,2,0,3,1,26,12,1,SAC,SAC,DEN,123,8.5,Rebs+Asts,33,29,30,7
Malik Monk,G,22023,1628370,22300264,"NOV 29, 2023",SAC vs. LAC,L,28,3,8,0.375,2,5,0.4,7,7,1.0,0,4,4,2,0,0,2,1,15,-8,1,SAC,SAC,LAC,117,15.5,Points,21,19,17,6
Malik Monk,G,22023,1628370,22300264,"NOV 29, 2023",SAC vs. LAC,L,28,3,8,0.375,2,5,0.4,7,7,1.0,0,4,4,2,0,0,2,1,15,-8,1,SAC,SAC,LAC,117,24.5,Pts+Rebs+Asts,21,19,17,6
Malik Monk,G,22023,1628370,22300264,"NOV 29, 2023",SAC vs. LAC,L,28,3,8,0.375,2,5,0.4,7,7,1.0,0,4,4,2,0,0,2,1,15,-8,1,SAC,SAC,LAC,117,5.0,Assists,21,19,17,6
Malik Monk,G,22023,1628370,22300264,"NOV 29, 2023",SAC vs. LAC,L,28,3,8,0.375,2,5,0.4,7,7,1.0,0,4,4,2,0,0,2,1,15,-8,1,SAC,SAC,LAC,117,19.0,Pts+Rebs,21,19,17,6
Malik Monk,G,22023,1628370,22300264,"NOV 29, 2023",SAC vs. LAC,L,28,3,8,0.375,2,5,0.4,7,7,1.0,0,4,4,2,0,0,2,1,15,-8,1,SAC,SAC,LAC,117,20.5,Pts+Asts,21,19,17,6
Malik Monk,G,22023,1628370,22300264,"NOV 29, 2023",SAC vs. LAC,L,28,3,8,0.375,2,5,0.4,7,7,1.0,0,4,4,2,0,0,2,1,15,-8,1,SAC,SAC,LAC,117,0.5,Blocked Shots,21,19,17,6
Malik Monk,G,22023,1628370,22300264,"NOV 29, 2023",SAC vs. LAC,L,28,3,8,0.375,2,5,0.4,7,7,1.0,0,4,4,2,0,0,2,1,15,-8,1,SAC,SAC,LAC,117,0.5,Steals,21,19,17,6
Malik Monk,G,22023,1628370,22300264,"NOV 29, 2023",SAC vs. LAC,L,28,3,8,0.375,2,5,0.4,7,7,1.0,0,4,4,2,0,0,2,1,15,-8,1,SAC,SAC,LAC,117,8.5,Rebs+Asts,21,19,17,6
Malik Monk,G,22023,1628370,22300060,"NOV 28, 2023",SAC vs. GSW,W,26,8,15,0.533,3,7,0.429,2,2,1.0,1,2,3,1,1,1,3,2,21,12,1,SAC,SAC,GSW,124,15.5,Points,25,24,22,4
Malik Monk,G,22023,1628370,22300060,"NOV 28, 2023",SAC vs. GSW,W,26,8,15,0.533,3,7,0.429,2,2,1.0,1,2,3,1,1,1,3,2,21,12,1,SAC,SAC,GSW,124,24.5,Pts+Rebs+Asts,25,24,22,4
Malik Monk,G,22023,1628370,22300060,"NOV 28, 2023",SAC vs. GSW,W,26,8,15,0.533,3,7,0.429,2,2,1.0,1,2,3,1,1,1,3,2,21,12,1,SAC,SAC,GSW,124,5.0,Assists,25,24,22,4
Malik Monk,G,22023,1628370,22300060,"NOV 28, 2023",SAC vs. GSW,W,26,8,15,0.533,3,7,0.429,2,2,1.0,1,2,3,1,1,1,3,2,21,12,1,SAC,SAC,GSW,124,19.0,Pts+Rebs,25,24,22,4
Malik Monk,G,22023,1628370,22300060,"NOV 28, 2023",SAC vs. GSW,W,26,8,15,0.533,3,7,0.429,2,2,1.0,1,2,3,1,1,1,3,2,21,12,1,SAC,SAC,GSW,124,20.5,Pts+Asts,25,24,22,4
Malik Monk,G,22023,1628370,22300060,"NOV 28, 2023",SAC vs. GSW,W,26,8,15,0.533,3,7,0.429,2,2,1.0,1,2,3,1,1,1,3,2,21,12,1,SAC,SAC,GSW,124,0.5,Blocked Shots,25,24,22,4
Malik Monk,G,22023,1628370,22300060,"NOV 28, 2023",SAC vs. GSW,W,26,8,15,0.533,3,7,0.429,2,2,1.0,1,2,3,1,1,1,3,2,21,12,1,SAC,SAC,GSW,124,0.5,Steals,25,24,22,4
Malik Monk,G,22023,1628370,22300060,"NOV 28, 2023",SAC vs. GSW,W,26,8,15,0.533,3,7,0.429,2,2,1.0,1,2,3,1,1,1,3,2,21,12,1,SAC,SAC,GSW,124,8.5,Rebs+Asts,25,24,22,4
Malik Monk,G,22023,1628370,22300050,"NOV 24, 2023",SAC @ MIN,W,30,6,14,0.429,3,6,0.5,2,2,1.0,0,2,2,0,1,0,3,2,17,11,1,SAC,MIN,SAC,124,15.5,Points,19,19,17,2
Malik Monk,G,22023,1628370,22300050,"NOV 24, 2023",SAC @ MIN,W,30,6,14,0.429,3,6,0.5,2,2,1.0,0,2,2,0,1,0,3,2,17,11,1,SAC,MIN,SAC,124,24.5,Pts+Rebs+Asts,19,19,17,2
Malik Monk,G,22023,1628370,22300050,"NOV 24, 2023",SAC @ MIN,W,30,6,14,0.429,3,6,0.5,2,2,1.0,0,2,2,0,1,0,3,2,17,11,1,SAC,MIN,SAC,124,5.0,Assists,19,19,17,2
Malik Monk,G,22023,1628370,22300050,"NOV 24, 2023",SAC @ MIN,W,30,6,14,0.429,3,6,0.5,2,2,1.0,0,2,2,0,1,0,3,2,17,11,1,SAC,MIN,SAC,124,19.0,Pts+Rebs,19,19,17,2
Malik Monk,G,22023,1628370,22300050,"NOV 24, 2023",SAC @ MIN,W,30,6,14,0.429,3,6,0.5,2,2,1.0,0,2,2,0,1,0,3,2,17,11,1,SAC,MIN,SAC,124,20.5,Pts+Asts,19,19,17,2
Malik Monk,G,22023,1628370,22300050,"NOV 24, 2023",SAC @ MIN,W,30,6,14,0.429,3,6,0.5,2,2,1.0,0,2,2,0,1,0,3,2,17,11,1,SAC,MIN,SAC,124,0.5,Blocked Shots,19,19,17,2
Malik Monk,G,22023,1628370,22300050,"NOV 24, 2023",SAC @ MIN,W,30,6,14,0.429,3,6,0.5,2,2,1.0,0,2,2,0,1,0,3,2,17,11,1,SAC,MIN,SAC,124,0.5,Steals,19,19,17,2
Malik Monk,G,22023,1628370,22300050,"NOV 24, 2023",SAC @ MIN,W,30,6,14,0.429,3,6,0.5,2,2,1.0,0,2,2,0,1,0,3,2,17,11,1,SAC,MIN,SAC,124,8.5,Rebs+Asts,19,19,17,2
Malik Monk,G,22023,1628370,22300233,"NOV 22, 2023",SAC @ NOP,L,26,2,8,0.25,1,6,0.167,5,5,1.0,0,4,4,5,2,0,2,2,10,-2,1,SAC,NOP,SAC,112,15.5,Points,19,14,15,9
Malik Monk,G,22023,1628370,22300233,"NOV 22, 2023",SAC @ NOP,L,26,2,8,0.25,1,6,0.167,5,5,1.0,0,4,4,5,2,0,2,2,10,-2,1,SAC,NOP,SAC,112,24.5,Pts+Rebs+Asts,19,14,15,9
Malik Monk,G,22023,1628370,22300233,"NOV 22, 2023",SAC @ NOP,L,26,2,8,0.25,1,6,0.167,5,5,1.0,0,4,4,5,2,0,2,2,10,-2,1,SAC,NOP,SAC,112,5.0,Assists,19,14,15,9
Malik Monk,G,22023,1628370,22300233,"NOV 22, 2023",SAC @ NOP,L,26,2,8,0.25,1,6,0.167,5,5,1.0,0,4,4,5,2,0,2,2,10,-2,1,SAC,NOP,SAC,112,19.0,Pts+Rebs,19,14,15,9
Malik Monk,G,22023,1628370,22300233,"NOV 22, 2023",SAC @ NOP,L,26,2,8,0.25,1,6,0.167,5,5,1.0,0,4,4,5,2,0,2,2,10,-2,1,SAC,NOP,SAC,112,20.5,Pts+Asts,19,14,15,9
Malik Monk,G,22023,1628370,22300233,"NOV 22, 2023",SAC @ NOP,L,26,2,8,0.25,1,6,0.167,5,5,1.0,0,4,4,5,2,0,2,2,10,-2,1,SAC,NOP,SAC,112,0.5,Blocked Shots,19,14,15,9
Malik Monk,G,22023,1628370,22300233,"NOV 22, 2023",SAC @ NOP,L,26,2,8,0.25,1,6,0.167,5,5,1.0,0,4,4,5,2,0,2,2,10,-2,1,SAC,NOP,SAC,112,0.5,Steals,19,14,15,9
Malik Monk,G,22023,1628370,22300233,"NOV 22, 2023",SAC @ NOP,L,26,2,8,0.25,1,6,0.167,5,5,1.0,0,4,4,5,2,0,2,2,10,-2,1,SAC,NOP,SAC,112,8.5,Rebs+Asts,19,14,15,9
Malik Monk,G,22023,1628370,22300222,"NOV 20, 2023",SAC @ NOP,L,24,3,11,0.273,2,6,0.333,0,0,0.0,0,0,0,5,0,0,1,2,8,-16,1,SAC,NOP,SAC,93,15.5,Points,13,8,13,5
Malik Monk,G,22023,1628370,22300222,"NOV 20, 2023",SAC @ NOP,L,24,3,11,0.273,2,6,0.333,0,0,0.0,0,0,0,5,0,0,1,2,8,-16,1,SAC,NOP,SAC,93,24.5,Pts+Rebs+Asts,13,8,13,5
Malik Monk,G,22023,1628370,22300222,"NOV 20, 2023",SAC @ NOP,L,24,3,11,0.273,2,6,0.333,0,0,0.0,0,0,0,5,0,0,1,2,8,-16,1,SAC,NOP,SAC,93,5.0,Assists,13,8,13,5
Malik Monk,G,22023,1628370,22300222,"NOV 20, 2023",SAC @ NOP,L,24,3,11,0.273,2,6,0.333,0,0,0.0,0,0,0,5,0,0,1,2,8,-16,1,SAC,NOP,SAC,93,19.0,Pts+Rebs,13,8,13,5
Malik Monk,G,22023,1628370,22300222,"NOV 20, 2023",SAC @ NOP,L,24,3,11,0.273,2,6,0.333,0,0,0.0,0,0,0,5,0,0,1,2,8,-16,1,SAC,NOP,SAC,93,20.5,Pts+Asts,13,8,13,5
Malik Monk,G,22023,1628370,22300222,"NOV 20, 2023",SAC @ NOP,L,24,3,11,0.273,2,6,0.333,0,0,0.0,0,0,0,5,0,0,1,2,8,-16,1,SAC,NOP,SAC,93,0.5,Blocked Shots,13,8,13,5
Malik Monk,G,22023,1628370,22300222,"NOV 20, 2023",SAC @ NOP,L,24,3,11,0.273,2,6,0.333,0,0,0.0,0,0,0,5,0,0,1,2,8,-16,1,SAC,NOP,SAC,93,0.5,Steals,13,8,13,5
Malik Monk,G,22023,1628370,22300222,"NOV 20, 2023",SAC @ NOP,L,24,3,11,0.273,2,6,0.333,0,0,0.0,0,0,0,5,0,0,1,2,8,-16,1,SAC,NOP,SAC,93,8.5,Rebs+Asts,13,8,13,5
Malik Monk,G,22023,1628370,22300212,"NOV 19, 2023",SAC @ DAL,W,18,4,9,0.444,4,6,0.667,0,0,0.0,0,2,2,3,1,1,2,2,12,8,1,SAC,DAL,SAC,129,15.5,Points,17,14,15,5
Malik Monk,G,22023,1628370,22300212,"NOV 19, 2023",SAC @ DAL,W,18,4,9,0.444,4,6,0.667,0,0,0.0,0,2,2,3,1,1,2,2,12,8,1,SAC,DAL,SAC,129,24.5,Pts+Rebs+Asts,17,14,15,5
Malik Monk,G,22023,1628370,22300212,"NOV 19, 2023",SAC @ DAL,W,18,4,9,0.444,4,6,0.667,0,0,0.0,0,2,2,3,1,1,2,2,12,8,1,SAC,DAL,SAC,129,5.0,Assists,17,14,15,5
Malik Monk,G,22023,1628370,22300212,"NOV 19, 2023",SAC @ DAL,W,18,4,9,0.444,4,6,0.667,0,0,0.0,0,2,2,3,1,1,2,2,12,8,1,SAC,DAL,SAC,129,19.0,Pts+Rebs,17,14,15,5
Malik Monk,G,22023,1628370,22300212,"NOV 19, 2023",SAC @ DAL,W,18,4,9,0.444,4,6,0.667,0,0,0.0,0,2,2,3,1,1,2,2,12,8,1,SAC,DAL,SAC,129,20.5,Pts+Asts,17,14,15,5
Malik Monk,G,22023,1628370,22300212,"NOV 19, 2023",SAC @ DAL,W,18,4,9,0.444,4,6,0.667,0,0,0.0,0,2,2,3,1,1,2,2,12,8,1,SAC,DAL,SAC,129,0.5,Blocked Shots,17,14,15,5
Malik Monk,G,22023,1628370,22300212,"NOV 19, 2023",SAC @ DAL,W,18,4,9,0.444,4,6,0.667,0,0,0.0,0,2,2,3,1,1,2,2,12,8,1,SAC,DAL,SAC,129,0.5,Steals,17,14,15,5
Malik Monk,G,22023,1628370,22300212,"NOV 19, 2023",SAC @ DAL,W,18,4,9,0.444,4,6,0.667,0,0,0.0,0,2,2,3,1,1,2,2,12,8,1,SAC,DAL,SAC,129,8.5,Rebs+Asts,17,14,15,5
Malik Monk,G,22023,1628370,22300032,"NOV 17, 2023",SAC @ SAS,W,26,7,11,0.636,6,9,0.667,0,0,0.0,1,3,4,8,1,0,1,3,20,13,1,SAC,SAS,SAC,129,15.5,Points,32,24,28,12
Malik Monk,G,22023,1628370,22300032,"NOV 17, 2023",SAC @ SAS,W,26,7,11,0.636,6,9,0.667,0,0,0.0,1,3,4,8,1,0,1,3,20,13,1,SAC,SAS,SAC,129,24.5,Pts+Rebs+Asts,32,24,28,12
Malik Monk,G,22023,1628370,22300032,"NOV 17, 2023",SAC @ SAS,W,26,7,11,0.636,6,9,0.667,0,0,0.0,1,3,4,8,1,0,1,3,20,13,1,SAC,SAS,SAC,129,5.0,Assists,32,24,28,12
Malik Monk,G,22023,1628370,22300032,"NOV 17, 2023",SAC @ SAS,W,26,7,11,0.636,6,9,0.667,0,0,0.0,1,3,4,8,1,0,1,3,20,13,1,SAC,SAS,SAC,129,19.0,Pts+Rebs,32,24,28,12
Malik Monk,G,22023,1628370,22300032,"NOV 17, 2023",SAC @ SAS,W,26,7,11,0.636,6,9,0.667,0,0,0.0,1,3,4,8,1,0,1,3,20,13,1,SAC,SAS,SAC,129,20.5,Pts+Asts,32,24,28,12
Malik Monk,G,22023,1628370,22300032,"NOV 17, 2023",SAC @ SAS,W,26,7,11,0.636,6,9,0.667,0,0,0.0,1,3,4,8,1,0,1,3,20,13,1,SAC,SAS,SAC,129,0.5,Blocked Shots,32,24,28,12
Malik Monk,G,22023,1628370,22300032,"NOV 17, 2023",SAC @ SAS,W,26,7,11,0.636,6,9,0.667,0,0,0.0,1,3,4,8,1,0,1,3,20,13,1,SAC,SAS,SAC,129,0.5,Steals,32,24,28,12
Malik Monk,G,22023,1628370,22300032,"NOV 17, 2023",SAC @ SAS,W,26,7,11,0.636,6,9,0.667,0,0,0.0,1,3,4,8,1,0,1,3,20,13,1,SAC,SAS,SAC,129,8.5,Rebs+Asts,32,24,28,12
Malik Monk,G,22023,1628370,22300198,"NOV 15, 2023",SAC @ LAL,W,21,1,8,0.125,1,5,0.2,0,0,0.0,0,5,5,5,1,0,3,1,3,-6,1,SAC,LAL,SAC,125,15.5,Points,13,8,8,10
Malik Monk,G,22023,1628370,22300198,"NOV 15, 2023",SAC @ LAL,W,21,1,8,0.125,1,5,0.2,0,0,0.0,0,5,5,5,1,0,3,1,3,-6,1,SAC,LAL,SAC,125,24.5,Pts+Rebs+Asts,13,8,8,10
Malik Monk,G,22023,1628370,22300198,"NOV 15, 2023",SAC @ LAL,W,21,1,8,0.125,1,5,0.2,0,0,0.0,0,5,5,5,1,0,3,1,3,-6,1,SAC,LAL,SAC,125,5.0,Assists,13,8,8,10
Malik Monk,G,22023,1628370,22300198,"NOV 15, 2023",SAC @ LAL,W,21,1,8,0.125,1,5,0.2,0,0,0.0,0,5,5,5,1,0,3,1,3,-6,1,SAC,LAL,SAC,125,19.0,Pts+Rebs,13,8,8,10
Malik Monk,G,22023,1628370,22300198,"NOV 15, 2023",SAC @ LAL,W,21,1,8,0.125,1,5,0.2,0,0,0.0,0,5,5,5,1,0,3,1,3,-6,1,SAC,LAL,SAC,125,20.5,Pts+Asts,13,8,8,10
Malik Monk,G,22023,1628370,22300198,"NOV 15, 2023",SAC @ LAL,W,21,1,8,0.125,1,5,0.2,0,0,0.0,0,5,5,5,1,0,3,1,3,-6,1,SAC,LAL,SAC,125,0.5,Blocked Shots,13,8,8,10
Malik Monk,G,22023,1628370,22300198,"NOV 15, 2023",SAC @ LAL,W,21,1,8,0.125,1,5,0.2,0,0,0.0,0,5,5,5,1,0,3,1,3,-6,1,SAC,LAL,SAC,125,0.5,Steals,13,8,8,10
Malik Monk,G,22023,1628370,22300198,"NOV 15, 2023",SAC @ LAL,W,21,1,8,0.125,1,5,0.2,0,0,0.0,0,5,5,5,1,0,3,1,3,-6,1,SAC,LAL,SAC,125,8.5,Rebs+Asts,13,8,8,10
Malik Monk,G,22023,1628370,22300191,"NOV 13, 2023",SAC vs. CLE,W,26,4,8,0.5,3,5,0.6,2,2,1.0,1,4,5,4,1,1,2,2,13,10,1,SAC,SAC,CLE,132,15.5,Points,22,18,17,9
Malik Monk,G,22023,1628370,22300191,"NOV 13, 2023",SAC vs. CLE,W,26,4,8,0.5,3,5,0.6,2,2,1.0,1,4,5,4,1,1,2,2,13,10,1,SAC,SAC,CLE,132,24.5,Pts+Rebs+Asts,22,18,17,9
Malik Monk,G,22023,1628370,22300191,"NOV 13, 2023",SAC vs. CLE,W,26,4,8,0.5,3,5,0.6,2,2,1.0,1,4,5,4,1,1,2,2,13,10,1,SAC,SAC,CLE,132,5.0,Assists,22,18,17,9
Malik Monk,G,22023,1628370,22300191,"NOV 13, 2023",SAC vs. CLE,W,26,4,8,0.5,3,5,0.6,2,2,1.0,1,4,5,4,1,1,2,2,13,10,1,SAC,SAC,CLE,132,19.0,Pts+Rebs,22,18,17,9
Malik Monk,G,22023,1628370,22300191,"NOV 13, 2023",SAC vs. CLE,W,26,4,8,0.5,3,5,0.6,2,2,1.0,1,4,5,4,1,1,2,2,13,10,1,SAC,SAC,CLE,132,20.5,Pts+Asts,22,18,17,9
Malik Monk,G,22023,1628370,22300191,"NOV 13, 2023",SAC vs. CLE,W,26,4,8,0.5,3,5,0.6,2,2,1.0,1,4,5,4,1,1,2,2,13,10,1,SAC,SAC,CLE,132,0.5,Blocked Shots,22,18,17,9
Malik Monk,G,22023,1628370,22300191,"NOV 13, 2023",SAC vs. CLE,W,26,4,8,0.5,3,5,0.6,2,2,1.0,1,4,5,4,1,1,2,2,13,10,1,SAC,SAC,CLE,132,0.5,Steals,22,18,17,9
Malik Monk,G,22023,1628370,22300191,"NOV 13, 2023",SAC vs. CLE,W,26,4,8,0.5,3,5,0.6,2,2,1.0,1,4,5,4,1,1,2,2,13,10,1,SAC,SAC,CLE,132,8.5,Rebs+Asts,22,18,17,9
Malik Monk,G,22023,1628370,22300016,"NOV 10, 2023",SAC vs. OKC,W,29,5,12,0.417,2,5,0.4,0,0,0.0,0,2,2,8,1,0,2,3,12,7,1,SAC,SAC,OKC,105,15.5,Points,22,14,20,10
Malik Monk,G,22023,1628370,22300016,"NOV 10, 2023",SAC vs. OKC,W,29,5,12,0.417,2,5,0.4,0,0,0.0,0,2,2,8,1,0,2,3,12,7,1,SAC,SAC,OKC,105,24.5,Pts+Rebs+Asts,22,14,20,10
Malik Monk,G,22023,1628370,22300016,"NOV 10, 2023",SAC vs. OKC,W,29,5,12,0.417,2,5,0.4,0,0,0.0,0,2,2,8,1,0,2,3,12,7,1,SAC,SAC,OKC,105,5.0,Assists,22,14,20,10
Malik Monk,G,22023,1628370,22300016,"NOV 10, 2023",SAC vs. OKC,W,29,5,12,0.417,2,5,0.4,0,0,0.0,0,2,2,8,1,0,2,3,12,7,1,SAC,SAC,OKC,105,19.0,Pts+Rebs,22,14,20,10
Malik Monk,G,22023,1628370,22300016,"NOV 10, 2023",SAC vs. OKC,W,29,5,12,0.417,2,5,0.4,0,0,0.0,0,2,2,8,1,0,2,3,12,7,1,SAC,SAC,OKC,105,20.5,Pts+Asts,22,14,20,10
Malik Monk,G,22023,1628370,22300016,"NOV 10, 2023",SAC vs. OKC,W,29,5,12,0.417,2,5,0.4,0,0,0.0,0,2,2,8,1,0,2,3,12,7,1,SAC,SAC,OKC,105,0.5,Blocked Shots,22,14,20,10
Malik Monk,G,22023,1628370,22300016,"NOV 10, 2023",SAC vs. OKC,W,29,5,12,0.417,2,5,0.4,0,0,0.0,0,2,2,8,1,0,2,3,12,7,1,SAC,SAC,OKC,105,0.5,Steals,22,14,20,10
Malik Monk,G,22023,1628370,22300016,"NOV 10, 2023",SAC vs. OKC,W,29,5,12,0.417,2,5,0.4,0,0,0.0,0,2,2,8,1,0,2,3,12,7,1,SAC,SAC,OKC,105,8.5,Rebs+Asts,22,14,20,10
Malik Monk,G,22023,1628370,22300170,"NOV 08, 2023",SAC vs. POR,W,30,4,16,0.25,0,7,0.0,15,19,0.789,2,4,6,10,1,0,5,0,23,8,1,SAC,SAC,POR,121,15.5,Points,39,29,33,16
Malik Monk,G,22023,1628370,22300170,"NOV 08, 2023",SAC vs. POR,W,30,4,16,0.25,0,7,0.0,15,19,0.789,2,4,6,10,1,0,5,0,23,8,1,SAC,SAC,POR,121,24.5,Pts+Rebs+Asts,39,29,33,16
Malik Monk,G,22023,1628370,22300170,"NOV 08, 2023",SAC vs. POR,W,30,4,16,0.25,0,7,0.0,15,19,0.789,2,4,6,10,1,0,5,0,23,8,1,SAC,SAC,POR,121,5.0,Assists,39,29,33,16
Malik Monk,G,22023,1628370,22300170,"NOV 08, 2023",SAC vs. POR,W,30,4,16,0.25,0,7,0.0,15,19,0.789,2,4,6,10,1,0,5,0,23,8,1,SAC,SAC,POR,121,19.0,Pts+Rebs,39,29,33,16
Malik Monk,G,22023,1628370,22300170,"NOV 08, 2023",SAC vs. POR,W,30,4,16,0.25,0,7,0.0,15,19,0.789,2,4,6,10,1,0,5,0,23,8,1,SAC,SAC,POR,121,20.5,Pts+Asts,39,29,33,16
Malik Monk,G,22023,1628370,22300170,"NOV 08, 2023",SAC vs. POR,W,30,4,16,0.25,0,7,0.0,15,19,0.789,2,4,6,10,1,0,5,0,23,8,1,SAC,SAC,POR,121,0.5,Blocked Shots,39,29,33,16
Malik Monk,G,22023,1628370,22300170,"NOV 08, 2023",SAC vs. POR,W,30,4,16,0.25,0,7,0.0,15,19,0.789,2,4,6,10,1,0,5,0,23,8,1,SAC,SAC,POR,121,0.5,Steals,39,29,33,16
Malik Monk,G,22023,1628370,22300170,"NOV 08, 2023",SAC vs. POR,W,30,4,16,0.25,0,7,0.0,15,19,0.789,2,4,6,10,1,0,5,0,23,8,1,SAC,SAC,POR,121,8.5,Rebs+Asts,39,29,33,16
Malik Monk,G,22023,1628370,22300153,"NOV 06, 2023",SAC @ HOU,L,15,2,6,0.333,1,3,0.333,0,0,0.0,0,1,1,2,1,0,1,3,5,-16,1,SAC,HOU,SAC,97,15.5,Points,8,6,7,3
Malik Monk,G,22023,1628370,22300153,"NOV 06, 2023",SAC @ HOU,L,15,2,6,0.333,1,3,0.333,0,0,0.0,0,1,1,2,1,0,1,3,5,-16,1,SAC,HOU,SAC,97,24.5,Pts+Rebs+Asts,8,6,7,3
Malik Monk,G,22023,1628370,22300153,"NOV 06, 2023",SAC @ HOU,L,15,2,6,0.333,1,3,0.333,0,0,0.0,0,1,1,2,1,0,1,3,5,-16,1,SAC,HOU,SAC,97,5.0,Assists,8,6,7,3
Malik Monk,G,22023,1628370,22300153,"NOV 06, 2023",SAC @ HOU,L,15,2,6,0.333,1,3,0.333,0,0,0.0,0,1,1,2,1,0,1,3,5,-16,1,SAC,HOU,SAC,97,19.0,Pts+Rebs,8,6,7,3
Malik Monk,G,22023,1628370,22300153,"NOV 06, 2023",SAC @ HOU,L,15,2,6,0.333,1,3,0.333,0,0,0.0,0,1,1,2,1,0,1,3,5,-16,1,SAC,HOU,SAC,97,20.5,Pts+Asts,8,6,7,3
Malik Monk,G,22023,1628370,22300153,"NOV 06, 2023",SAC @ HOU,L,15,2,6,0.333,1,3,0.333,0,0,0.0,0,1,1,2,1,0,1,3,5,-16,1,SAC,HOU,SAC,97,0.5,Blocked Shots,8,6,7,3
Malik Monk,G,22023,1628370,22300153,"NOV 06, 2023",SAC @ HOU,L,15,2,6,0.333,1,3,0.333,0,0,0.0,0,1,1,2,1,0,1,3,5,-16,1,SAC,HOU,SAC,97,0.5,Steals,8,6,7,3
Malik Monk,G,22023,1628370,22300153,"NOV 06, 2023",SAC @ HOU,L,15,2,6,0.333,1,3,0.333,0,0,0.0,0,1,1,2,1,0,1,3,5,-16,1,SAC,HOU,SAC,97,8.5,Rebs+Asts,8,6,7,3
Malik Monk,G,22023,1628370,22300137,"NOV 04, 2023",SAC @ HOU,L,26,6,13,0.462,3,7,0.429,3,4,0.75,0,3,3,7,0,1,1,1,18,-9,1,SAC,HOU,SAC,89,15.5,Points,28,21,25,10
Malik Monk,G,22023,1628370,22300137,"NOV 04, 2023",SAC @ HOU,L,26,6,13,0.462,3,7,0.429,3,4,0.75,0,3,3,7,0,1,1,1,18,-9,1,SAC,HOU,SAC,89,24.5,Pts+Rebs+Asts,28,21,25,10
Malik Monk,G,22023,1628370,22300137,"NOV 04, 2023",SAC @ HOU,L,26,6,13,0.462,3,7,0.429,3,4,0.75,0,3,3,7,0,1,1,1,18,-9,1,SAC,HOU,SAC,89,5.0,Assists,28,21,25,10
Malik Monk,G,22023,1628370,22300137,"NOV 04, 2023",SAC @ HOU,L,26,6,13,0.462,3,7,0.429,3,4,0.75,0,3,3,7,0,1,1,1,18,-9,1,SAC,HOU,SAC,89,19.0,Pts+Rebs,28,21,25,10
Malik Monk,G,22023,1628370,22300137,"NOV 04, 2023",SAC @ HOU,L,26,6,13,0.462,3,7,0.429,3,4,0.75,0,3,3,7,0,1,1,1,18,-9,1,SAC,HOU,SAC,89,20.5,Pts+Asts,28,21,25,10
Malik Monk,G,22023,1628370,22300137,"NOV 04, 2023",SAC @ HOU,L,26,6,13,0.462,3,7,0.429,3,4,0.75,0,3,3,7,0,1,1,1,18,-9,1,SAC,HOU,SAC,89,0.5,Blocked Shots,28,21,25,10
Malik Monk,G,22023,1628370,22300137,"NOV 04, 2023",SAC @ HOU,L,26,6,13,0.462,3,7,0.429,3,4,0.75,0,3,3,7,0,1,1,1,18,-9,1,SAC,HOU,SAC,89,0.5,Steals,28,21,25,10
Malik Monk,G,22023,1628370,22300137,"NOV 04, 2023",SAC @ HOU,L,26,6,13,0.462,3,7,0.429,3,4,0.75,0,3,3,7,0,1,1,1,18,-9,1,SAC,HOU,SAC,89,8.5,Rebs+Asts,28,21,25,10
Malik Monk,G,22023,1628370,22300126,"NOV 01, 2023",SAC @ GSW,L,25,5,9,0.556,3,5,0.6,3,3,1.0,3,0,3,2,0,2,3,1,16,1,1,SAC,GSW,SAC,101,15.5,Points,21,19,18,5
Malik Monk,G,22023,1628370,22300126,"NOV 01, 2023",SAC @ GSW,L,25,5,9,0.556,3,5,0.6,3,3,1.0,3,0,3,2,0,2,3,1,16,1,1,SAC,GSW,SAC,101,24.5,Pts+Rebs+Asts,21,19,18,5
Malik Monk,G,22023,1628370,22300126,"NOV 01, 2023",SAC @ GSW,L,25,5,9,0.556,3,5,0.6,3,3,1.0,3,0,3,2,0,2,3,1,16,1,1,SAC,GSW,SAC,101,5.0,Assists,21,19,18,5
Malik Monk,G,22023,1628370,22300126,"NOV 01, 2023",SAC @ GSW,L,25,5,9,0.556,3,5,0.6,3,3,1.0,3,0,3,2,0,2,3,1,16,1,1,SAC,GSW,SAC,101,19.0,Pts+Rebs,21,19,18,5
Malik Monk,G,22023,1628370,22300126,"NOV 01, 2023",SAC @ GSW,L,25,5,9,0.556,3,5,0.6,3,3,1.0,3,0,3,2,0,2,3,1,16,1,1,SAC,GSW,SAC,101,20.5,Pts+Asts,21,19,18,5
Malik Monk,G,22023,1628370,22300126,"NOV 01, 2023",SAC @ GSW,L,25,5,9,0.556,3,5,0.6,3,3,1.0,3,0,3,2,0,2,3,1,16,1,1,SAC,GSW,SAC,101,0.5,Blocked Shots,21,19,18,5
Malik Monk,G,22023,1628370,22300126,"NOV 01, 2023",SAC @ GSW,L,25,5,9,0.556,3,5,0.6,3,3,1.0,3,0,3,2,0,2,3,1,16,1,1,SAC,GSW,SAC,101,0.5,Steals,21,19,18,5
Malik Monk,G,22023,1628370,22300126,"NOV 01, 2023",SAC @ GSW,L,25,5,9,0.556,3,5,0.6,3,3,1.0,3,0,3,2,0,2,3,1,16,1,1,SAC,GSW,SAC,101,8.5,Rebs+Asts,21,19,18,5
Malik Monk,G,22023,1628370,22300100,"OCT 29, 2023",SAC vs. LAL,W,25,7,17,0.412,4,9,0.444,4,5,0.8,1,2,3,3,0,0,2,1,22,0,1,SAC,SAC,LAL,132,15.5,Points,28,25,25,6
Malik Monk,G,22023,1628370,22300100,"OCT 29, 2023",SAC vs. LAL,W,25,7,17,0.412,4,9,0.444,4,5,0.8,1,2,3,3,0,0,2,1,22,0,1,SAC,SAC,LAL,132,24.5,Pts+Rebs+Asts,28,25,25,6
Malik Monk,G,22023,1628370,22300100,"OCT 29, 2023",SAC vs. LAL,W,25,7,17,0.412,4,9,0.444,4,5,0.8,1,2,3,3,0,0,2,1,22,0,1,SAC,SAC,LAL,132,5.0,Assists,28,25,25,6
Malik Monk,G,22023,1628370,22300100,"OCT 29, 2023",SAC vs. LAL,W,25,7,17,0.412,4,9,0.444,4,5,0.8,1,2,3,3,0,0,2,1,22,0,1,SAC,SAC,LAL,132,19.0,Pts+Rebs,28,25,25,6
Malik Monk,G,22023,1628370,22300100,"OCT 29, 2023",SAC vs. LAL,W,25,7,17,0.412,4,9,0.444,4,5,0.8,1,2,3,3,0,0,2,1,22,0,1,SAC,SAC,LAL,132,20.5,Pts+Asts,28,25,25,6
Malik Monk,G,22023,1628370,22300100,"OCT 29, 2023",SAC vs. LAL,W,25,7,17,0.412,4,9,0.444,4,5,0.8,1,2,3,3,0,0,2,1,22,0,1,SAC,SAC,LAL,132,0.5,Blocked Shots,28,25,25,6
Malik Monk,G,22023,1628370,22300100,"OCT 29, 2023",SAC vs. LAL,W,25,7,17,0.412,4,9,0.444,4,5,0.8,1,2,3,3,0,0,2,1,22,0,1,SAC,SAC,LAL,132,0.5,Steals,28,25,25,6
Malik Monk,G,22023,1628370,22300100,"OCT 29, 2023",SAC vs. LAL,W,25,7,17,0.412,4,9,0.444,4,5,0.8,1,2,3,3,0,0,2,1,22,0,1,SAC,SAC,LAL,132,8.5,Rebs+Asts,28,25,25,6
Malik Monk,G,22023,1628370,22300087,"OCT 27, 2023",SAC vs. GSW,L,18,2,4,0.5,1,2,0.5,4,4,1.0,0,0,0,6,0,1,2,2,9,-6,1,SAC,SAC,GSW,114,15.5,Points,15,9,15,6
Malik Monk,G,22023,1628370,22300087,"OCT 27, 2023",SAC vs. GSW,L,18,2,4,0.5,1,2,0.5,4,4,1.0,0,0,0,6,0,1,2,2,9,-6,1,SAC,SAC,GSW,114,24.5,Pts+Rebs+Asts,15,9,15,6
Malik Monk,G,22023,1628370,22300087,"OCT 27, 2023",SAC vs. GSW,L,18,2,4,0.5,1,2,0.5,4,4,1.0,0,0,0,6,0,1,2,2,9,-6,1,SAC,SAC,GSW,114,5.0,Assists,15,9,15,6
Malik Monk,G,22023,1628370,22300087,"OCT 27, 2023",SAC vs. GSW,L,18,2,4,0.5,1,2,0.5,4,4,1.0,0,0,0,6,0,1,2,2,9,-6,1,SAC,SAC,GSW,114,19.0,Pts+Rebs,15,9,15,6
Malik Monk,G,22023,1628370,22300087,"OCT 27, 2023",SAC vs. GSW,L,18,2,4,0.5,1,2,0.5,4,4,1.0,0,0,0,6,0,1,2,2,9,-6,1,SAC,SAC,GSW,114,20.5,Pts+Asts,15,9,15,6
Malik Monk,G,22023,1628370,22300087,"OCT 27, 2023",SAC vs. GSW,L,18,2,4,0.5,1,2,0.5,4,4,1.0,0,0,0,6,0,1,2,2,9,-6,1,SAC,SAC,GSW,114,0.5,Blocked Shots,15,9,15,6
Malik Monk,G,22023,1628370,22300087,"OCT 27, 2023",SAC vs. GSW,L,18,2,4,0.5,1,2,0.5,4,4,1.0,0,0,0,6,0,1,2,2,9,-6,1,SAC,SAC,GSW,114,0.5,Steals,15,9,15,6
Malik Monk,G,22023,1628370,22300087,"OCT 27, 2023",SAC vs. GSW,L,18,2,4,0.5,1,2,0.5,4,4,1.0,0,0,0,6,0,1,2,2,9,-6,1,SAC,SAC,GSW,114,8.5,Rebs+Asts,15,9,15,6
Malik Monk,G,22023,1628370,22300072,"OCT 25, 2023",SAC @ UTA,W,23,4,12,0.333,2,9,0.222,0,0,0.0,1,1,2,7,0,2,2,2,10,12,1,SAC,UTA,SAC,130,15.5,Points,19,12,17,9
Malik Monk,G,22023,1628370,22300072,"OCT 25, 2023",SAC @ UTA,W,23,4,12,0.333,2,9,0.222,0,0,0.0,1,1,2,7,0,2,2,2,10,12,1,SAC,UTA,SAC,130,24.5,Pts+Rebs+Asts,19,12,17,9
Malik Monk,G,22023,1628370,22300072,"OCT 25, 2023",SAC @ UTA,W,23,4,12,0.333,2,9,0.222,0,0,0.0,1,1,2,7,0,2,2,2,10,12,1,SAC,UTA,SAC,130,5.0,Assists,19,12,17,9
Malik Monk,G,22023,1628370,22300072,"OCT 25, 2023",SAC @ UTA,W,23,4,12,0.333,2,9,0.222,0,0,0.0,1,1,2,7,0,2,2,2,10,12,1,SAC,UTA,SAC,130,19.0,Pts+Rebs,19,12,17,9
Malik Monk,G,22023,1628370,22300072,"OCT 25, 2023",SAC @ UTA,W,23,4,12,0.333,2,9,0.222,0,0,0.0,1,1,2,7,0,2,2,2,10,12,1,SAC,UTA,SAC,130,20.5,Pts+Asts,19,12,17,9
Malik Monk,G,22023,1628370,22300072,"OCT 25, 2023",SAC @ UTA,W,23,4,12,0.333,2,9,0.222,0,0,0.0,1,1,2,7,0,2,2,2,10,12,1,SAC,UTA,SAC,130,0.5,Blocked Shots,19,12,17,9
Malik Monk,G,22023,1628370,22300072,"OCT 25, 2023",SAC @ UTA,W,23,4,12,0.333,2,9,0.222,0,0,0.0,1,1,2,7,0,2,2,2,10,12,1,SAC,UTA,SAC,130,0.5,Steals,19,12,17,9
Malik Monk,G,22023,1628370,22300072,"OCT 25, 2023",SAC @ UTA,W,23,4,12,0.333,2,9,0.222,0,0,0.0,1,1,2,7,0,2,2,2,10,12,1,SAC,UTA,SAC,130,8.5,Rebs+Asts,19,12,17,9
Jonas Valanciunas,C,22023,202685,22300758,"FEB 10, 2024",NOP @ POR,W,29,7,9,0.778,0,0,0.0,2,2,1.0,1,8,9,1,0,1,3,4,16,7,1,NOP,POR,NOP,93,,,26,25,17,10
Jonas Valanciunas,C,22023,202685,22300747,"FEB 09, 2024",NOP @ LAL,L,23,4,6,0.667,0,0,0.0,2,2,1.0,2,8,10,2,0,2,2,2,10,3,1,NOP,LAL,NOP,122,,,22,20,12,12
Jonas Valanciunas,C,22023,202685,22300731,"FEB 07, 2024",NOP @ LAC,W,11,3,3,1.0,0,0,0.0,2,2,1.0,0,2,2,1,1,0,1,1,8,2,1,NOP,LAC,NOP,117,,,11,10,9,3
Jonas Valanciunas,C,22023,202685,22300718,"FEB 05, 2024",NOP vs. TOR,W,20,4,14,0.286,0,0,0.0,2,2,1.0,8,4,12,3,0,0,0,1,10,13,1,NOP,NOP,TOR,138,,,25,22,13,15
Jonas Valanciunas,C,22023,202685,22300696,"FEB 02, 2024",NOP @ SAS,W,27,9,12,0.75,0,0,0.0,0,0,0.0,3,6,9,4,0,0,0,2,18,-15,1,NOP,SAS,NOP,114,,,31,27,22,13
Jonas Valanciunas,C,22023,202685,22300679,"JAN 31, 2024",NOP @ HOU,W,33,10,15,0.667,0,1,0.0,5,9,0.556,4,10,14,2,0,1,3,5,25,13,1,NOP,HOU,NOP,110,,,41,39,27,16
Jonas Valanciunas,C,22023,202685,22300648,"JAN 27, 2024",NOP @ MIL,L,24,6,8,0.75,1,3,0.333,0,0,0.0,1,9,10,6,0,0,0,3,13,-8,1,NOP,MIL,NOP,117,,,29,23,19,16
Jonas Valanciunas,C,22023,202685,22300640,"JAN 26, 2024",NOP vs. OKC,L,20,6,12,0.5,0,0,0.0,2,2,1.0,5,4,9,0,0,0,2,1,14,-7,1,NOP,NOP,OKC,83,,,23,23,14,9
Jonas Valanciunas,C,22023,202685,22300616,"JAN 23, 2024",NOP vs. UTA,W,23,7,13,0.538,1,5,0.2,2,4,0.5,3,9,12,3,0,0,1,2,17,20,1,NOP,NOP,UTA,153,,,32,29,20,15
Jonas Valanciunas,C,22023,202685,22300588,"JAN 19, 2024",NOP vs. PHX,L,26,5,10,0.5,0,2,0.0,6,6,1.0,4,7,11,3,0,0,2,3,16,-20,1,NOP,NOP,PHX,109,,,30,27,19,14
Jonas Valanciunas,C,22023,202685,22300575,"JAN 17, 2024",NOP vs. CHA,W,25,1,3,0.333,0,0,0.0,2,2,1.0,3,4,7,0,0,0,1,1,4,4,1,NOP,NOP,CHA,132,,,11,11,4,7
Jonas Valanciunas,C,22023,202685,22300547,"JAN 13, 2024",NOP @ DAL,W,28,4,6,0.667,0,0,0.0,6,9,0.667,5,7,12,7,0,2,0,4,14,-4,1,NOP,DAL,NOP,118,,,33,26,21,19
Jonas Valanciunas,C,22023,202685,22300539,"JAN 12, 2024",NOP @ DEN,L,26,5,11,0.455,1,3,0.333,6,6,1.0,2,4,6,1,0,0,0,3,17,-9,1,NOP,DEN,NOP,113,,,24,23,18,7
Jonas Valanciunas,C,22023,202685,22300486,"JAN 05, 2024",NOP vs. LAC,L,23,6,12,0.5,1,1,1.0,0,0,0.0,4,7,11,1,0,1,3,2,13,-7,1,NOP,NOP,LAC,95,,,25,24,14,12
Jonas Valanciunas,C,22023,202685,22300471,"JAN 03, 2024",NOP @ MIN,W,20,2,5,0.4,0,2,0.0,0,0,0.0,1,6,7,3,0,0,1,5,4,14,1,NOP,MIN,NOP,117,,,14,11,7,10
Jonas Valanciunas,C,22023,202685,22300461,"JAN 02, 2024",NOP vs. BKN,W,20,5,5,1.0,1,1,1.0,0,0,0.0,3,9,12,0,1,1,1,0,11,17,1,NOP,NOP,BKN,112,,,23,23,11,12
Jonas Valanciunas,C,22023,202685,22300446,"DEC 31, 2023",NOP vs. LAL,W,25,4,7,0.571,0,0,0.0,5,5,1.0,2,6,8,1,1,1,0,1,13,3,1,NOP,NOP,LAL,129,,,22,21,14,9
Jonas Valanciunas,C,22023,202685,22300424,"DEC 28, 2023",NOP vs. UTA,W,23,2,6,0.333,0,1,0.0,2,2,1.0,2,2,4,1,0,1,2,1,6,-9,1,NOP,NOP,UTA,112,,,11,10,7,5
Jonas Valanciunas,C,22023,202685,22300410,"DEC 26, 2023",NOP vs. MEM,L,36,8,14,0.571,0,1,0.0,1,3,0.333,3,10,13,0,1,1,1,5,17,-7,1,NOP,NOP,MEM,115,,,30,30,17,13
Jonas Valanciunas,C,22023,202685,22300392,"DEC 23, 2023",NOP vs. HOU,L,26,5,11,0.455,0,2,0.0,0,0,0.0,2,9,11,5,2,1,6,6,10,5,1,NOP,NOP,HOU,104,,,26,21,15,16
Jonas Valanciunas,C,22023,202685,22300375,"DEC 21, 2023",NOP @ CLE,W,28,6,9,0.667,1,3,0.333,0,0,0.0,1,6,7,5,1,1,2,3,13,-3,1,NOP,CLE,NOP,123,,,25,20,18,12
Jonas Valanciunas,C,22023,202685,22300360,"DEC 19, 2023",NOP vs. MEM,L,33,9,12,0.75,1,1,1.0,3,3,1.0,4,10,14,1,1,1,2,5,22,5,1,NOP,NOP,MEM,113,,,37,36,23,15
Jonas Valanciunas,C,22023,202685,22300345,"DEC 17, 2023",NOP @ SAS,W,23,6,12,0.5,1,4,0.25,2,3,0.667,3,12,15,3,1,1,1,3,15,25,1,NOP,SAS,NOP,146,,,33,30,18,18
Jonas Valanciunas,C,22023,202685,22300326,"DEC 15, 2023",NOP @ CHA,W,37,11,16,0.688,2,4,0.5,5,6,0.833,4,9,13,4,0,2,2,3,29,5,1,NOP,CHA,NOP,112,,,46,42,33,17
Jonas Valanciunas,C,22023,202685,22300311,"DEC 13, 2023",NOP @ WAS,W,33,6,9,0.667,1,1,1.0,3,4,0.75,3,15,18,3,1,1,4,4,16,13,1,NOP,WAS,NOP,142,,,37,34,19,21
Jonas Valanciunas,C,22023,202685,22300301,"DEC 11, 2023",NOP vs. MIN,W,35,5,9,0.556,0,1,0.0,4,7,0.571,3,10,13,4,2,2,3,3,14,13,1,NOP,NOP,MIN,121,,,31,27,18,17
Jonas Valanciunas,C,22023,202685,22301230,"DEC 07, 2023",NOP @ LAL,L,23,3,9,0.333,1,4,0.25,2,2,1.0,0,3,3,2,1,3,1,2,9,-25,1,NOP,LAL,NOP,89,,,14,12,11,5
Jonas Valanciunas,C,22023,202685,22301204,"DEC 04, 2023",NOP @ SAC,W,29,7,11,0.636,0,0,0.0,4,4,1.0,4,7,11,0,0,0,1,6,18,-7,1,NOP,SAC,NOP,127,,,29,29,18,11
Jonas Valanciunas,C,22023,202685,22300285,"DEC 02, 2023",NOP @ CHI,L,36,6,11,0.545,2,4,0.5,1,2,0.5,2,8,10,1,0,0,0,3,15,13,1,NOP,CHI,NOP,118,,,26,25,16,11
Jonas Valanciunas,C,22023,202685,22300262,"NOV 29, 2023",NOP vs. PHI,W,32,8,9,0.889,0,1,0.0,3,3,1.0,3,3,6,3,0,0,2,5,19,18,1,NOP,NOP,PHI,124,,,28,25,22,9
Jonas Valanciunas,C,22023,202685,22300256,"NOV 27, 2023",NOP @ UTA,L,30,5,10,0.5,0,1,0.0,4,6,0.667,5,8,13,2,0,1,0,3,14,3,1,NOP,UTA,NOP,112,,,29,27,16,15
Jonas Valanciunas,C,22023,202685,22300243,"NOV 25, 2023",NOP @ UTA,L,26,3,10,0.3,0,2,0.0,2,4,0.5,5,2,7,2,1,0,1,2,8,-17,1,NOP,UTA,NOP,100,,,17,15,10,9
Jonas Valanciunas,C,22023,202685,22300052,"NOV 24, 2023",NOP @ LAC,W,28,4,6,0.667,2,2,1.0,2,2,1.0,2,6,8,4,1,0,1,4,12,15,1,NOP,LAC,NOP,116,,,24,20,16,12
Jonas Valanciunas,C,22023,202685,22300233,"NOV 22, 2023",NOP vs. SAC,W,28,6,9,0.667,0,0,0.0,3,4,0.75,3,8,11,2,0,0,1,5,15,2,1,NOP,NOP,SAC,117,,,28,26,17,13
Jonas Valanciunas,C,22023,202685,22300222,"NOV 20, 2023",NOP vs. SAC,W,21,3,4,0.75,0,0,0.0,4,4,1.0,1,12,13,7,1,3,0,3,10,33,1,NOP,NOP,SAC,129,,,30,23,17,20
Jonas Valanciunas,C,22023,202685,22300659,"JAN 29, 2024",NOP @ BOS,L,20,4,9,0.444,0,2,0.0,3,4,0.75,1,6,7,2,1,1,0,1,11,6,1,NOP,BOS,NOP,112,,,20,18,13,9
Jonas Valanciunas,C,22023,202685,22300556,"JAN 15, 2024",NOP @ DAL,L,19,2,5,0.4,0,0,0.0,2,2,1.0,4,2,6,2,0,2,3,4,6,-22,1,NOP,DAL,NOP,120,,,14,12,8,8
Jonas Valanciunas,C,22023,202685,22300525,"JAN 10, 2024",NOP @ GSW,W,21,9,13,0.692,2,3,0.667,1,2,0.5,4,5,9,2,2,1,0,4,21,18,1,NOP,GSW,NOP,141,,,32,30,23,11
Jonas Valanciunas,C,22023,202685,22300500,"JAN 07, 2024",NOP @ SAC,W,22,6,10,0.6,1,2,0.5,2,2,1.0,1,11,12,1,0,1,1,2,15,20,1,NOP,SAC,NOP,133,,,28,27,16,13
Jonas Valanciunas,C,22023,202685,22300278,"DEC 01, 2023",NOP vs. SAS,W,31,9,12,0.75,0,1,0.0,6,7,0.857,2,10,12,1,1,2,1,3,24,15,1,NOP,NOP,SAS,121,,,37,36,25,13
Jonas Valanciunas,C,22023,202685,22300203,"NOV 18, 2023",NOP vs. MIN,L,30,10,15,0.667,0,1,0.0,6,6,1.0,5,6,11,3,1,3,3,5,26,2,1,NOP,NOP,MIN,120,,,40,37,29,14
Jonas Valanciunas,C,22023,202685,22300034,"NOV 17, 2023",NOP vs. DEN,W,34,10,18,0.556,1,3,0.333,1,3,0.333,2,6,8,3,0,1,0,4,22,-8,1,NOP,NOP,DEN,115,,,33,30,25,11
Jonas Valanciunas,C,22023,202685,22300022,"NOV 14, 2023",NOP vs. DAL,W,22,3,5,0.6,0,2,0.0,0,0,0.0,0,3,3,4,1,2,0,1,6,22,1,NOP,NOP,DAL,131,,,13,9,10,7
Jonas Valanciunas,C,22023,202685,22300183,"NOV 12, 2023",NOP vs. DAL,L,21,6,11,0.545,3,5,0.6,0,0,0.0,2,8,10,3,0,2,0,0,15,-13,1,NOP,NOP,DAL,124,,,28,25,18,13
Jonas Valanciunas,C,22023,202685,22300011,"NOV 10, 2023",NOP @ HOU,L,29,7,12,0.583,1,1,1.0,0,1,0.0,3,6,9,2,0,4,2,6,15,1,1,NOP,HOU,NOP,101,,,26,24,17,11
Jonas Valanciunas,C,22023,202685,22300166,"NOV 08, 2023",NOP @ MIN,L,22,4,9,0.444,0,2,0.0,0,0,0.0,1,5,6,0,0,0,0,1,8,-29,1,NOP,MIN,NOP,101,,,14,14,8,6
Jonas Valanciunas,C,22023,202685,22300156,"NOV 06, 2023",NOP @ DEN,L,24,2,6,0.333,0,1,0.0,2,2,1.0,2,9,11,2,0,1,2,6,6,-10,1,NOP,DEN,NOP,116,,,19,17,8,13
Jonas Valanciunas,C,22023,202685,22300135,"NOV 04, 2023",NOP vs. ATL,L,21,3,6,0.5,0,0,0.0,0,0,0.0,2,5,7,0,1,1,3,1,6,-20,1,NOP,NOP,ATL,105,,,13,13,6,7
Jonas Valanciunas,C,22023,202685,22300129,"NOV 02, 2023",NOP vs. DET,W,33,9,16,0.563,2,3,0.667,3,4,0.75,4,9,13,5,0,3,2,5,23,20,1,NOP,NOP,DET,125,,,41,36,28,18
Jonas Valanciunas,C,22023,202685,22300121,"NOV 01, 2023",NOP @ OKC,W,21,6,10,0.6,1,1,1.0,6,7,0.857,3,6,9,2,1,1,0,2,19,8,1,NOP,OKC,NOP,110,,,30,28,21,11
Jonas Valanciunas,C,22023,202685,22300108,"OCT 30, 2023",NOP vs. GSW,L,23,4,11,0.364,1,5,0.2,2,2,1.0,2,4,6,3,0,2,0,1,11,-17,1,NOP,NOP,GSW,102,,,20,17,14,9
Jonas Valanciunas,C,22023,202685,22300090,"OCT 28, 2023",NOP vs. NYK,W,21,3,7,0.429,0,1,0.0,2,2,1.0,0,4,4,0,0,0,4,4,8,5,1,NOP,NOP,NYK,96,,,12,12,8,4
Jonas Valanciunas,C,22023,202685,22300071,"OCT 25, 2023",NOP @ MEM,W,29,4,7,0.571,2,4,0.5,2,2,1.0,0,12,12,1,0,1,3,1,12,16,1,NOP,MEM,NOP,111,,,25,24,13,13
John Collins,F,22023,1628381,22300711,"FEB 04, 2024",UTA vs. MIL,W,24,7,11,0.636,1,4,0.25,0,1,0.0,3,7,10,2,1,0,3,2,15,-9,1,UTA,UTA,MIL,123,,,27,25,17,12
John Collins,F,22023,1628381,22300686,"FEB 01, 2024",UTA vs. PHI,L,34,6,10,0.6,1,3,0.333,2,3,0.667,3,6,9,2,1,2,0,2,15,-7,1,UTA,UTA,PHI,124,,,26,24,17,11
John Collins,F,22023,1628381,22300671,"JAN 30, 2024",UTA @ NYK,L,28,5,12,0.417,1,4,0.25,0,1,0.0,3,8,11,3,0,0,1,4,11,-12,1,UTA,NYK,UTA,103,,,25,22,14,14
John Collins,F,22023,1628381,22300660,"JAN 29, 2024",UTA @ BKN,L,21,7,10,0.7,0,0,0.0,1,2,0.5,3,4,7,0,1,2,0,2,15,-7,1,UTA,BKN,UTA,114,,,22,22,15,7
John Collins,F,22023,1628381,22300647,"JAN 27, 2024",UTA @ CHA,W,32,9,13,0.692,1,4,0.25,1,2,0.5,3,7,10,0,0,2,0,4,20,10,1,UTA,CHA,UTA,134,,,30,30,20,10
John Collins,F,22023,1628381,22300628,"JAN 25, 2024",UTA @ WAS,W,33,11,15,0.733,0,2,0.0,0,0,0.0,7,9,16,1,1,0,1,2,22,22,1,UTA,WAS,UTA,123,,,39,38,23,17
John Collins,F,22023,1628381,22300616,"JAN 23, 2024",UTA @ NOP,L,24,5,12,0.417,0,3,0.0,4,4,1.0,1,8,9,2,0,3,1,5,14,-6,1,UTA,NOP,UTA,124,,,25,23,16,11
John Collins,F,22023,1628381,22300598,"JAN 20, 2024",UTA @ HOU,L,20,3,9,0.333,0,4,0.0,1,1,1.0,1,5,6,2,0,0,0,2,7,6,1,UTA,HOU,UTA,126,,,15,13,9,8
John Collins,F,22023,1628381,22300581,"JAN 18, 2024",UTA vs. OKC,L,24,7,11,0.636,1,5,0.2,6,6,1.0,0,4,4,1,0,1,2,5,21,-19,1,UTA,UTA,OKC,129,,,26,25,22,5
John Collins,F,22023,1628381,22300564,"JAN 15, 2024",UTA vs. IND,W,20,3,8,0.375,0,2,0.0,4,4,1.0,4,2,6,1,0,0,1,0,10,13,1,UTA,UTA,IND,132,,,17,16,11,7
John Collins,F,22023,1628381,22300549,"JAN 13, 2024",UTA vs. LAL,W,34,7,9,0.778,3,4,0.75,2,2,1.0,2,11,13,2,3,1,1,5,19,18,1,UTA,UTA,LAL,132,,,34,32,21,15
John Collins,F,22023,1628381,22300540,"JAN 12, 2024",UTA vs. TOR,W,14,2,3,0.667,0,1,0.0,0,0,0.0,1,6,7,1,0,0,1,4,4,2,1,UTA,UTA,TOR,145,,,12,11,5,8
John Collins,F,22023,1628381,22300524,"JAN 10, 2024",UTA vs. DEN,W,24,6,10,0.6,2,4,0.5,1,2,0.5,0,6,6,3,1,0,1,2,15,12,1,UTA,UTA,DEN,124,,,24,21,18,9
John Collins,F,22023,1628381,22300510,"JAN 08, 2024",UTA @ MIL,W,27,8,15,0.533,3,7,0.429,0,0,0.0,0,3,3,1,1,0,3,3,19,6,1,UTA,MIL,UTA,132,,,23,22,20,4
John Collins,F,22023,1628381,22300495,"JAN 06, 2024",UTA @ PHI,W,28,9,10,0.9,0,0,0.0,1,2,0.5,1,4,5,2,0,1,1,1,19,7,1,UTA,PHI,UTA,120,,,26,24,21,7
John Collins,F,22023,1628381,22300479,"JAN 05, 2024",UTA @ BOS,L,22,5,8,0.625,0,1,0.0,2,3,0.667,0,11,11,2,0,1,2,5,12,-28,1,UTA,BOS,UTA,97,,,25,23,14,13
John Collins,F,22023,1628381,22300474,"JAN 03, 2024",UTA vs. DET,W,24,7,13,0.538,2,6,0.333,1,2,0.5,4,0,4,3,0,0,2,3,17,-12,1,UTA,UTA,DET,154,,,24,21,20,7
John Collins,F,22023,1628381,22300457,"JAN 01, 2024",UTA vs. DAL,W,18,7,13,0.538,0,5,0.0,1,1,1.0,0,5,5,1,1,0,0,1,15,-1,1,UTA,UTA,DAL,127,,,21,20,16,6
John Collins,F,22023,1628381,22300439,"DEC 30, 2023",UTA vs. MIA,W,21,4,11,0.364,2,6,0.333,0,0,0.0,0,6,6,0,0,0,1,3,10,-6,1,UTA,UTA,MIA,117,,,16,16,10,6
John Collins,F,22023,1628381,22300424,"DEC 28, 2023",UTA @ NOP,L,26,3,7,0.429,1,3,0.333,1,2,0.5,3,9,12,0,0,1,1,2,8,-3,1,UTA,NOP,UTA,105,,,20,20,8,12
John Collins,F,22023,1628381,22300412,"DEC 26, 2023",UTA @ SAS,W,18,2,7,0.286,1,4,0.25,2,2,1.0,0,4,4,0,0,1,3,1,7,6,1,UTA,SAS,UTA,130,,,11,11,7,4
John Collins,F,22023,1628381,22300395,"DEC 23, 2023",UTA @ TOR,W,27,4,7,0.571,2,2,1.0,0,0,0.0,1,4,5,0,0,0,0,2,10,-8,1,UTA,TOR,UTA,126,,,15,15,10,5
John Collins,F,22023,1628381,22300374,"DEC 21, 2023",UTA @ DET,W,32,4,12,0.333,0,3,0.0,5,5,1.0,2,7,9,1,2,1,3,4,13,3,1,UTA,DET,UTA,119,,,23,22,14,10
John Collins,F,22023,1628381,22300364,"DEC 20, 2023",UTA @ CLE,L,23,5,8,0.625,2,4,0.5,4,4,1.0,0,5,5,0,1,1,2,1,16,-16,1,UTA,CLE,UTA,116,,,21,21,16,5
John Collins,F,22023,1628381,22300357,"DEC 18, 2023",UTA vs. BKN,W,20,4,9,0.444,3,4,0.75,0,0,0.0,1,2,3,0,0,1,4,2,11,5,1,UTA,UTA,BKN,125,,,14,14,11,3
John Collins,F,22023,1628381,22301225,"DEC 08, 2023",UTA vs. LAC,L,35,7,12,0.583,1,5,0.2,5,5,1.0,3,10,13,2,2,4,2,1,20,-18,1,UTA,UTA,LAC,103,,,35,33,22,15
John Collins,F,22023,1628381,22301213,"DEC 06, 2023",UTA @ DAL,L,23,5,11,0.455,0,2,0.0,0,0,0.0,2,6,8,0,0,0,2,2,10,-40,1,UTA,DAL,UTA,97,,,18,18,10,8
John Collins,F,22023,1628381,22300289,"DEC 02, 2023",UTA vs. POR,W,35,6,14,0.429,1,4,0.25,4,4,1.0,2,7,9,3,1,3,2,2,17,4,1,UTA,UTA,POR,118,,,29,26,20,12
John Collins,F,22023,1628381,22300270,"NOV 30, 2023",UTA @ MIN,L,28,3,12,0.25,1,4,0.25,2,2,1.0,3,9,12,0,0,0,4,4,9,-17,1,UTA,MIN,UTA,90,,,21,21,9,12
John Collins,F,22023,1628381,22300261,"NOV 29, 2023",UTA @ MEM,L,29,7,14,0.5,3,5,0.6,0,2,0.0,1,3,4,1,1,0,1,2,17,-8,1,UTA,MEM,UTA,91,,,22,21,18,5
John Collins,F,22023,1628381,22300256,"NOV 27, 2023",UTA vs. NOP,W,29,4,10,0.4,2,6,0.333,2,3,0.667,1,2,3,0,0,0,1,1,12,-2,1,UTA,UTA,NOP,114,,,15,15,12,3
John Collins,F,22023,1628381,22300243,"NOV 25, 2023",UTA vs. NOP,W,23,5,11,0.455,0,2,0.0,2,2,1.0,2,7,9,0,0,0,3,1,12,-6,1,UTA,UTA,NOP,105,,,21,21,12,9
John Collins,F,22023,1628381,22300237,"NOV 22, 2023",UTA @ POR,L,32,6,12,0.5,0,1,0.0,0,0,0.0,6,5,11,1,0,0,0,0,12,-8,1,UTA,POR,UTA,105,,,24,23,13,12
John Collins,F,22023,1628381,22300042,"NOV 21, 2023",UTA @ LAL,L,25,6,12,0.5,2,5,0.4,1,2,0.5,2,2,4,1,1,1,1,3,15,-29,1,UTA,LAL,UTA,99,,,20,19,16,5
John Collins,F,22023,1628381,22300214,"NOV 19, 2023",UTA vs. PHX,L,43,5,14,0.357,3,5,0.6,2,2,1.0,4,8,12,0,2,1,1,2,15,-4,1,UTA,UTA,PHX,137,,,27,27,15,12
John Collins,F,22023,1628381,22300035,"NOV 17, 2023",UTA vs. PHX,L,35,5,10,0.5,1,2,0.5,4,6,0.667,4,10,14,1,0,2,0,6,15,-7,1,UTA,UTA,PHX,128,,,30,29,16,15
John Collins,F,22023,1628381,22300023,"NOV 14, 2023",UTA vs. POR,W,32,6,16,0.375,2,5,0.4,0,0,0.0,4,6,10,2,1,3,1,3,14,6,1,UTA,UTA,POR,115,,,26,24,16,12
John Collins,F,22023,1628381,22300012,"NOV 10, 2023",UTA @ MEM,W,38,5,6,0.833,3,3,1.0,5,7,0.714,0,3,3,0,0,4,3,2,18,8,1,UTA,MEM,UTA,127,,,21,21,18,3
John Collins,F,22023,1628381,22300158,"NOV 08, 2023",UTA @ IND,L,27,6,9,0.667,1,2,0.5,1,1,1.0,1,8,9,1,0,0,2,3,14,-7,1,UTA,IND,UTA,118,,,24,23,15,10
John Collins,F,22023,1628381,22300152,"NOV 06, 2023",UTA @ CHI,L,29,6,9,0.667,1,2,0.5,1,1,1.0,1,5,6,0,1,0,2,5,14,-13,1,UTA,CHI,UTA,113,,,20,20,14,6
John Collins,F,22023,1628381,22300138,"NOV 04, 2023",UTA @ MIN,L,29,5,10,0.5,1,5,0.2,3,4,0.75,2,4,6,0,1,1,2,5,14,-21,1,UTA,MIN,UTA,95,,,20,20,14,6
John Collins,F,22023,1628381,22300130,"NOV 02, 2023",UTA vs. ORL,L,33,7,10,0.7,3,4,0.75,3,4,0.75,3,7,10,0,0,1,2,5,20,0,1,UTA,UTA,ORL,113,,,30,30,20,10
John Collins,F,22023,1628381,22300125,"NOV 01, 2023",UTA vs. MEM,W,27,5,12,0.417,2,5,0.4,4,6,0.667,2,2,4,2,2,0,1,2,16,21,1,UTA,UTA,MEM,133,,,22,20,18,6
John Collins,F,22023,1628381,22300110,"OCT 30, 2023",UTA @ DEN,L,34,7,16,0.438,1,3,0.333,0,3,0.0,3,6,9,1,1,0,0,3,15,-5,1,UTA,DEN,UTA,102,,,25,24,16,10
John Collins,F,22023,1628381,22300094,"OCT 28, 2023",UTA @ PHX,L,28,5,9,0.556,1,3,0.333,0,0,0.0,5,5,10,3,0,0,1,3,11,-28,1,UTA,PHX,UTA,104,,,24,21,14,13
John Collins,F,22023,1628381,22300085,"OCT 27, 2023",UTA vs. LAC,W,34,4,11,0.364,1,5,0.2,4,4,1.0,5,7,12,0,0,1,0,4,13,-4,1,UTA,UTA,LAC,120,,,25,25,13,12
John Collins,F,22023,1628381,22300072,"OCT 25, 2023",UTA vs. SAC,L,31,6,11,0.545,1,3,0.333,2,2,1.0,3,8,11,2,1,0,0,3,15,-9,1,UTA,UTA,SAC,114,,,28,26,17,13
John Collins,F,22023,1628381,22300739,"FEB 08, 2024",UTA @ PHX,L,31,9,15,0.6,1,2,0.5,2,2,1.0,4,10,14,1,1,0,0,5,21,-20,1,UTA,PHX,UTA,115,,,36,35,22,15
John Collins,F,22023,1628381,22300724,"FEB 06, 2024",UTA vs. OKC,W,29,9,15,0.6,1,4,0.25,3,3,1.0,3,6,9,0,0,1,1,3,22,-2,1,UTA,UTA,OKC,124,,,31,31,22,9
Cameron Johnson,F,22023,1629661,22300717,"FEB 05, 2024",BKN vs. GSW,L,27,5,9,0.556,3,6,0.5,0,0,0.0,1,7,8,4,1,2,1,5,13,-6,1,BKN,BKN,GSW,98,,,25,21,17,12
Cameron Johnson,F,22023,1629661,22300698,"FEB 03, 2024",BKN @ PHI,W,33,5,12,0.417,2,9,0.222,1,1,1.0,2,5,7,3,2,1,3,0,13,-1,1,BKN,PHI,BKN,136,,,23,20,16,10
Cameron Johnson,F,22023,1629661,22300677,"JAN 31, 2024",BKN vs. PHX,L,29,6,12,0.5,3,7,0.429,3,3,1.0,0,2,2,1,2,1,3,3,18,3,1,BKN,BKN,PHX,120,,,21,20,19,3
Cameron Johnson,F,22023,1629661,22300660,"JAN 29, 2024",BKN vs. UTA,W,30,6,10,0.6,3,4,0.75,2,2,1.0,0,6,6,3,1,0,1,0,17,14,1,BKN,BKN,UTA,147,,,26,23,20,9
Cameron Johnson,F,22023,1629661,22300629,"JAN 25, 2024",BKN vs. MIN,L,22,2,5,0.4,1,3,0.333,0,0,0.0,0,4,4,3,0,0,1,2,5,-6,1,BKN,BKN,MIN,94,,,12,9,8,7
Cameron Johnson,F,22023,1629661,22300615,"JAN 23, 2024",BKN vs. NYK,L,25,7,14,0.5,4,6,0.667,1,1,1.0,2,3,5,2,0,0,0,1,19,1,1,BKN,BKN,NYK,103,,,26,24,21,7
Cameron Johnson,F,22023,1629661,22300600,"JAN 21, 2024",BKN @ LAC,L,29,3,11,0.273,2,7,0.286,1,2,0.5,0,4,4,6,1,0,0,1,9,-8,1,BKN,LAC,BKN,114,,,19,13,15,10
Cameron Johnson,F,22023,1629661,22300591,"JAN 19, 2024",BKN @ LAL,W,23,4,9,0.444,2,4,0.5,0,0,0.0,3,1,4,5,1,0,0,1,10,16,1,BKN,LAL,BKN,130,,,19,14,15,9
Cameron Johnson,F,22023,1629661,22300578,"JAN 17, 2024",BKN @ POR,L,27,6,9,0.667,1,3,0.333,0,0,0.0,1,2,3,5,0,1,0,1,13,1,1,BKN,POR,BKN,103,,,21,16,18,8
Cameron Johnson,F,22023,1629661,22300562,"JAN 15, 2024",BKN vs. MIA,L,23,3,13,0.231,0,8,0.0,0,0,0.0,0,2,2,0,0,0,0,3,6,-12,1,BKN,BKN,MIA,95,,,8,8,6,2
Cameron Johnson,F,22023,1629661,22300527,"JAN 11, 2024",BKN @ CLE,L,23,1,7,0.143,1,5,0.2,0,2,0.0,1,1,2,1,1,0,3,3,3,-11,1,BKN,CLE,BKN,102,,,6,5,4,3
Cameron Johnson,F,22023,1629661,22300498,"JAN 07, 2024",BKN vs. POR,L,34,5,11,0.455,3,8,0.375,4,5,0.8,1,5,6,3,1,1,0,3,17,-3,1,BKN,BKN,POR,127,,,26,23,20,9
Cameron Johnson,F,22023,1629661,22300481,"JAN 05, 2024",BKN vs. OKC,W,32,3,15,0.2,3,10,0.3,0,0,0.0,1,2,3,2,1,0,0,4,9,-6,1,BKN,BKN,OKC,124,,,14,12,11,5
Cameron Johnson,F,22023,1629661,22300469,"JAN 03, 2024",BKN @ HOU,L,32,6,13,0.462,3,6,0.5,0,2,0.0,0,6,6,5,0,1,0,0,15,-5,1,BKN,HOU,BKN,101,,,26,21,20,11
Cameron Johnson,F,22023,1629661,22300461,"JAN 02, 2024",BKN @ NOP,L,26,6,12,0.5,5,9,0.556,0,0,0.0,0,4,4,2,1,0,1,2,17,-16,1,BKN,NOP,BKN,85,,,23,21,19,6
Cameron Johnson,F,22023,1629661,22300447,"DEC 31, 2023",BKN @ OKC,L,34,5,11,0.455,2,6,0.333,1,2,0.5,1,5,6,0,1,0,1,4,13,-8,1,BKN,OKC,BKN,108,,,19,19,13,6
Cameron Johnson,F,22023,1629661,22300430,"DEC 29, 2023",BKN @ WAS,L,33,6,11,0.545,3,5,0.6,1,1,1.0,1,6,7,3,0,0,1,1,16,6,1,BKN,WAS,BKN,104,,,26,23,19,10
Cameron Johnson,F,22023,1629661,22300406,"DEC 26, 2023",BKN @ DET,W,26,9,13,0.692,4,6,0.667,2,4,0.5,0,2,2,1,1,0,0,0,24,-6,1,BKN,DET,BKN,118,,,27,26,25,3
Cameron Johnson,F,22023,1629661,22300394,"DEC 23, 2023",BKN vs. DET,W,28,6,10,0.6,2,5,0.4,4,4,1.0,0,2,2,2,2,0,1,3,18,6,1,BKN,BKN,DET,126,,,22,20,20,4
Cameron Johnson,F,22023,1629661,22300383,"DEC 22, 2023",BKN vs. DEN,L,25,6,9,0.667,3,6,0.5,2,3,0.667,0,1,1,2,1,0,1,2,17,-13,1,BKN,BKN,DEN,117,,,20,18,19,3
Cameron Johnson,F,22023,1629661,22300368,"DEC 20, 2023",BKN vs. NYK,L,28,8,14,0.571,4,6,0.667,0,1,0.0,0,4,4,2,0,0,0,3,20,-5,1,BKN,BKN,NYK,102,,,26,24,22,6
Cameron Johnson,F,22023,1629661,22300357,"DEC 18, 2023",BKN @ UTA,L,27,2,9,0.222,1,5,0.2,2,2,1.0,1,4,5,1,1,0,1,1,7,-6,1,BKN,UTA,BKN,108,,,13,12,8,6
Cameron Johnson,F,22023,1629661,22300339,"DEC 16, 2023",BKN @ GSW,L,29,5,12,0.417,3,7,0.429,0,1,0.0,0,2,2,5,0,0,0,4,13,-2,1,BKN,GSW,BKN,120,,,20,15,18,7
Cameron Johnson,F,22023,1629661,22300322,"DEC 14, 2023",BKN @ DEN,L,22,4,10,0.4,2,7,0.286,0,0,0.0,1,2,3,0,0,0,1,2,10,-6,1,BKN,DEN,BKN,101,,,13,13,10,3
Cameron Johnson,F,22023,1629661,22300317,"DEC 13, 2023",BKN @ PHX,W,34,5,10,0.5,3,7,0.429,2,2,1.0,1,4,5,4,2,2,1,1,15,2,1,BKN,PHX,BKN,116,,,24,20,19,9
Cameron Johnson,F,22023,1629661,22300303,"DEC 11, 2023",BKN @ SAC,L,32,6,13,0.462,3,4,0.75,0,0,0.0,0,4,4,2,1,0,1,0,15,-5,1,BKN,SAC,BKN,118,,,21,19,17,6
Cameron Johnson,F,22023,1629661,22301219,"DEC 08, 2023",BKN vs. WAS,W,25,3,8,0.375,1,5,0.2,0,0,0.0,2,3,5,0,0,0,1,3,7,14,1,BKN,BKN,WAS,124,,,12,12,7,5
Cameron Johnson,F,22023,1629661,22301209,"DEC 06, 2023",BKN @ ATL,W,30,7,13,0.538,3,6,0.5,0,0,0.0,1,5,6,3,1,0,0,2,17,-5,1,BKN,ATL,BKN,114,,,26,23,20,9
Cameron Johnson,F,22023,1629661,22300282,"DEC 02, 2023",BKN vs. ORL,W,30,5,10,0.5,3,6,0.5,1,2,0.5,3,4,7,3,0,0,0,2,14,10,1,BKN,BKN,ORL,129,,,24,21,17,10
Cameron Johnson,F,22023,1629661,22300266,"NOV 30, 2023",BKN vs. CHA,L,28,6,18,0.333,3,9,0.333,0,0,0.0,6,0,6,2,0,0,2,1,15,-4,1,BKN,BKN,CHA,128,,,23,21,17,8
Cameron Johnson,F,22023,1629661,22300054,"NOV 28, 2023",BKN vs. TOR,W,27,6,11,0.545,1,4,0.25,5,5,1.0,1,8,9,3,0,0,2,1,18,8,1,BKN,BKN,TOR,115,,,30,27,21,12
Cameron Johnson,F,22023,1629661,22300250,"NOV 26, 2023",BKN vs. CHI,W,22,4,8,0.5,2,5,0.4,0,0,0.0,2,2,4,6,0,0,0,2,10,-1,1,BKN,BKN,CHI,118,,,20,14,16,10
Cameron Johnson,F,22023,1629661,22300240,"NOV 25, 2023",BKN vs. MIA,W,35,8,13,0.615,2,6,0.333,1,2,0.5,1,9,10,5,2,0,1,2,19,29,1,BKN,BKN,MIA,112,,,34,29,24,15
Cameron Johnson,F,22023,1629661,22300227,"NOV 22, 2023",BKN @ ATL,L,38,8,13,0.615,5,8,0.625,2,2,1.0,2,3,5,5,2,0,2,1,23,12,1,BKN,ATL,BKN,145,,,33,28,28,10
Cameron Johnson,F,22023,1629661,22300208,"NOV 19, 2023",BKN vs. PHI,L,28,3,12,0.25,1,5,0.2,2,2,1.0,3,2,5,2,0,1,2,2,9,-28,1,BKN,BKN,PHI,99,,,16,14,11,7
Cameron Johnson,F,22023,1629661,22300200,"NOV 16, 2023",BKN @ MIA,L,27,5,10,0.5,3,6,0.5,3,3,1.0,0,4,4,3,1,0,1,5,16,18,1,BKN,MIA,BKN,115,,,23,20,19,7
Cameron Johnson,F,22023,1629661,22300020,"NOV 14, 2023",BKN vs. ORL,W,29,7,11,0.636,3,7,0.429,3,4,0.75,1,4,5,2,3,0,1,1,20,21,1,BKN,BKN,ORL,124,,,27,25,22,7
Cameron Johnson,F,22023,1629661,22300178,"NOV 12, 2023",BKN vs. WAS,W,35,5,16,0.313,2,11,0.182,2,2,1.0,1,5,6,1,0,0,3,0,14,15,1,BKN,BKN,WAS,102,,,21,20,15,7
Cameron Johnson,F,22023,1629661,22300010,"NOV 10, 2023",BKN @ BOS,L,25,4,13,0.308,3,6,0.5,0,0,0.0,2,3,5,0,0,0,1,3,11,-22,1,BKN,BOS,BKN,107,,,16,16,11,5
Cameron Johnson,F,22023,1629661,22300067,"OCT 25, 2023",BKN vs. CLE,L,26,5,10,0.5,1,4,0.25,1,2,0.5,2,3,5,3,2,0,2,1,12,-1,1,BKN,BKN,CLE,113,,,20,17,15,8
Jalen Duren,C,22023,1631105,22300534,"JAN 12, 2024",DET vs. HOU,L,32,7,12,0.583,0,0,0.0,1,2,0.5,2,6,8,3,2,1,2,3,15,9,1,DET,DET,HOU,110,,,26,23,18,11
Jalen Duren,C,22023,1631105,22300453,"JAN 01, 2024",DET @ HOU,L,22,6,8,0.75,0,0,0.0,0,0,0.0,3,11,14,1,0,0,1,5,12,0,1,DET,HOU,DET,113,,,27,26,13,15
Jalen Duren,C,22023,1631105,22300283,"DEC 02, 2023",DET vs. CLE,L,30,8,8,1.0,0,0,0.0,1,6,0.167,3,8,11,1,1,2,2,3,17,6,1,DET,DET,CLE,101,,,29,28,18,12
Jalen Duren,C,22023,1631105,22300268,"NOV 30, 2023",DET @ NYK,L,34,5,7,0.714,0,0,0.0,0,0,0.0,0,12,12,2,0,0,2,3,10,1,1,DET,NYK,DET,112,,,24,22,12,14
Jalen Duren,C,22023,1631105,22300258,"NOV 29, 2023",DET vs. LAL,L,18,3,8,0.375,0,0,0.0,0,0,0.0,4,3,7,0,0,1,2,3,6,-20,1,DET,DET,LAL,107,,,13,13,6,7
Jalen Duren,C,22023,1631105,22300047,"NOV 24, 2023",DET @ IND,L,29,5,10,0.5,0,1,0.0,3,4,0.75,4,9,13,4,1,1,2,5,13,-11,1,DET,IND,DET,113,,,30,26,17,17
Jalen Duren,C,22023,1631105,22300008,"NOV 10, 2023",DET vs. PHI,L,23,2,5,0.4,0,0,0.0,0,0,0.0,1,3,4,3,0,1,3,1,4,-8,1,DET,DET,PHI,106,,,11,8,7,7
Jalen Duren,C,22023,1631105,22300165,"NOV 08, 2023",DET @ MIL,L,28,5,10,0.5,0,1,0.0,1,1,1.0,3,9,12,5,0,0,2,5,11,-3,1,DET,MIL,DET,118,,,28,23,16,17
Jalen Duren,C,22023,1631105,22300140,"NOV 05, 2023",DET vs. PHX,L,31,6,10,0.6,0,0,0.0,0,0,0.0,3,8,11,3,2,0,5,4,12,-19,1,DET,DET,PHX,106,,,26,23,15,14
Jalen Duren,C,22023,1631105,22300129,"NOV 02, 2023",DET @ NOP,L,25,5,8,0.625,0,0,0.0,2,2,1.0,0,5,5,1,0,0,1,5,12,-12,1,DET,NOP,DET,116,,,18,17,13,6
Jalen Duren,C,22023,1631105,22300109,"OCT 30, 2023",DET @ OKC,L,23,4,11,0.364,0,0,0.0,0,1,0.0,3,4,7,1,1,0,1,3,8,-8,1,DET,OKC,DET,112,,,16,15,9,8
Jalen Duren,C,22023,1631105,22300088,"OCT 28, 2023",DET vs. CHI,W,33,9,11,0.818,0,0,0.0,5,5,1.0,6,9,15,5,1,2,1,3,23,6,1,DET,DET,CHI,118,,,43,38,28,20
Jalen Duren,C,22023,1631105,22300077,"OCT 27, 2023",DET @ CHA,W,35,7,8,0.875,0,0,0.0,0,0,0.0,6,11,17,3,1,2,5,3,14,5,1,DET,CHA,DET,111,,,34,31,17,20
Jalen Duren,C,22023,1631105,22300068,"OCT 25, 2023",DET @ MIA,L,32,8,11,0.727,0,0,0.0,1,3,0.333,6,8,14,4,0,4,4,4,17,-4,1,DET,MIA,DET,102,,,35,31,21,18
Jalen Duren,C,22023,1631105,22300704,"FEB 04, 2024",DET vs. ORL,L,27,7,7,1.0,0,0,0.0,1,1,1.0,2,3,5,2,0,0,1,5,15,-5,1,DET,DET,ORL,99,,,22,20,17,7
Jalen Duren,C,22023,1631105,22300688,"FEB 02, 2024",DET vs. LAC,L,31,5,7,0.714,0,0,0.0,1,2,0.5,2,11,13,2,0,0,0,1,11,-8,1,DET,DET,LAC,125,,,26,24,13,15
Jalen Duren,C,22023,1631105,22300675,"JAN 31, 2024",DET @ CLE,L,30,5,9,0.556,0,0,0.0,0,0,0.0,4,5,9,0,0,0,2,1,10,-19,1,DET,CLE,DET,121,,,19,19,10,9
Jalen Duren,C,22023,1631105,22300654,"JAN 28, 2024",DET vs. OKC,W,31,9,13,0.692,0,0,0.0,4,5,0.8,9,12,21,6,0,1,1,2,22,1,1,DET,DET,OKC,120,,,49,43,28,27
Jalen Duren,C,22023,1631105,22300642,"JAN 27, 2024",DET vs. WAS,L,36,5,6,0.833,0,0,0.0,0,0,0.0,3,15,18,3,0,0,1,4,10,-4,1,DET,DET,WAS,104,,,31,28,13,21
Jalen Duren,C,22023,1631105,22300619,"JAN 24, 2024",DET vs. CHA,W,22,7,9,0.778,0,0,0.0,0,1,0.0,2,6,8,2,0,0,1,3,14,5,1,DET,DET,CHA,113,,,24,22,16,10
Jalen Duren,C,22023,1631105,22300606,"JAN 22, 2024",DET vs. MIL,L,33,5,14,0.357,0,0,0.0,2,2,1.0,1,11,12,1,0,1,2,4,12,-15,1,DET,DET,MIL,113,,,25,24,13,13
Jalen Duren,C,22023,1631105,22300592,"JAN 20, 2024",DET vs. MIL,L,30,4,8,0.5,0,0,0.0,0,0,0.0,2,7,9,1,1,0,1,5,8,-22,1,DET,DET,MIL,135,,,18,17,9,10
Jalen Duren,C,22023,1631105,22300569,"JAN 17, 2024",DET vs. MIN,L,31,8,14,0.571,0,0,0.0,0,1,0.0,2,9,11,3,0,0,2,4,16,-8,1,DET,DET,MIN,117,,,30,27,19,14
Jalen Duren,C,22023,1631105,22300519,"JAN 10, 2024",DET vs. SAS,L,30,10,16,0.625,0,0,0.0,1,1,1.0,2,10,12,2,0,0,1,4,21,-7,1,DET,DET,SAS,108,,,35,33,23,14
Jalen Duren,C,22023,1631105,22300512,"JAN 09, 2024",DET vs. SAC,L,24,8,14,0.571,0,0,0.0,0,0,0.0,3,7,10,3,0,0,3,4,16,-22,1,DET,DET,SAC,110,,,29,26,19,13
Jalen Duren,C,22023,1631105,22300502,"JAN 07, 2024",DET @ DEN,L,30,8,12,0.667,0,0,0.0,4,6,0.667,2,3,5,4,0,0,1,1,20,-14,1,DET,DEN,DET,114,,,29,25,24,9
Jalen Duren,C,22023,1631105,22300490,"JAN 05, 2024",DET @ GSW,L,33,6,6,1.0,0,0,0.0,1,2,0.5,4,8,12,2,0,2,1,2,13,-5,1,DET,GSW,DET,109,,,27,25,15,14
Jalen Duren,C,22023,1631105,22300474,"JAN 03, 2024",DET @ UTA,L,36,6,7,0.857,0,0,0.0,5,5,1.0,4,6,10,3,0,1,2,0,17,-14,1,DET,UTA,DET,148,,,30,27,20,13
Jalen Duren,C,22023,1631105,22300440,"DEC 30, 2023",DET vs. TOR,W,34,6,11,0.545,0,0,0.0,6,6,1.0,2,15,17,2,0,0,1,5,18,-6,1,DET,DET,TOR,129,,,37,35,20,19
Jalen Duren,C,22023,1631105,22300421,"DEC 28, 2023",DET @ BOS,L,40,5,6,0.833,0,0,0.0,5,6,0.833,8,6,14,2,0,0,0,1,15,-6,1,DET,BOS,DET,122,,,31,29,17,16
Jalen Duren,C,22023,1631105,22300406,"DEC 26, 2023",DET vs. BKN,L,33,6,11,0.545,0,0,0.0,0,0,0.0,5,10,15,4,1,1,1,3,12,8,1,DET,DET,BKN,112,,,31,27,16,19
Jalen Duren,C,22023,1631105,22301206,"DEC 06, 2023",DET vs. MEM,L,30,8,12,0.667,0,0,0.0,1,1,1.0,1,10,11,0,0,1,2,1,17,2,1,DET,DET,MEM,102,,,28,28,17,11
Jalen Duren,C,22023,1631105,22300749,"FEB 10, 2024",DET @ LAC,L,35,5,12,0.417,0,0,0.0,0,0,0.0,3,15,18,1,2,1,3,4,10,-7,1,DET,LAC,DET,106,,,29,28,11,19
Jalen Duren,C,22023,1631105,22300732,"FEB 07, 2024",DET @ SAC,W,37,7,10,0.7,0,0,0.0,6,6,1.0,2,13,15,6,0,0,3,4,20,11,1,DET,SAC,DET,133,,,41,35,26,21
Jalen Duren,C,22023,1631105,22300558,"JAN 15, 2024",DET @ WAS,W,26,8,8,1.0,0,0,0.0,4,5,0.8,2,17,19,4,0,1,2,3,20,8,1,DET,WAS,DET,129,,,43,39,24,23
Jalen Duren,C,22023,1631105,22300253,"NOV 27, 2023",DET vs. WAS,L,33,5,8,0.625,0,0,0.0,2,5,0.4,7,7,14,3,1,5,6,5,12,-4,1,DET,DET,WAS,107,,,29,26,15,17
Jalen Duren,C,22023,1631105,22300741,"FEB 08, 2024",DET @ POR,W,37,9,15,0.6,0,1,0.0,9,10,0.9,8,14,22,1,0,3,3,5,27,4,1,DET,POR,DET,128,,,50,49,28,23
Dennis Schroder,G,22023,203471,22300432,"DEC 29, 2023",TOR @ BOS,L,35,6,12,0.5,2,5,0.4,1,2,0.5,2,0,2,9,0,1,0,2,15,2,1,TOR,BOS,TOR,118,,,26,17,24,11
Dennis Schroder,G,22023,203471,22300416,"DEC 27, 2023",TOR @ WAS,W,28,4,6,0.667,1,2,0.5,0,0,0.0,0,4,4,10,0,0,3,1,9,29,1,TOR,WAS,TOR,132,,,23,13,19,14
Dennis Schroder,G,22023,203471,22300395,"DEC 23, 2023",TOR vs. UTA,L,33,4,9,0.444,1,3,0.333,2,3,0.667,1,2,3,7,3,0,4,2,11,-1,1,TOR,TOR,UTA,119,,,21,14,18,10
Dennis Schroder,G,22023,203471,22300382,"DEC 22, 2023",TOR @ PHI,L,34,2,8,0.25,0,2,0.0,2,2,1.0,1,2,3,6,2,0,0,0,6,-16,1,TOR,PHI,TOR,111,,,15,9,12,9
Dennis Schroder,G,22023,203471,22300369,"DEC 20, 2023",TOR vs. DEN,L,31,3,8,0.375,1,2,0.5,0,0,0.0,0,2,2,7,1,0,2,2,7,-17,1,TOR,TOR,DEN,104,,,16,9,14,9
Dennis Schroder,G,22023,203471,22300354,"DEC 18, 2023",TOR vs. CHA,W,34,4,6,0.667,3,5,0.6,2,2,1.0,0,0,0,5,0,0,3,2,13,12,1,TOR,TOR,CHA,114,,,18,13,18,5
Dennis Schroder,G,22023,203471,22300330,"DEC 15, 2023",TOR vs. ATL,L,31,3,7,0.429,0,2,0.0,0,0,0.0,0,2,2,4,2,0,1,5,6,-20,1,TOR,TOR,ATL,104,,,12,8,10,6
Dennis Schroder,G,22023,203471,22300313,"DEC 13, 2023",TOR vs. ATL,W,37,5,11,0.455,3,4,0.75,4,4,1.0,0,3,3,7,1,1,2,5,17,15,1,TOR,TOR,ATL,135,,,27,20,24,10
Dennis Schroder,G,22023,203471,22300297,"DEC 11, 2023",TOR @ NYK,L,33,6,12,0.5,2,4,0.5,6,7,0.857,0,2,2,10,4,0,0,2,20,-5,1,TOR,NYK,TOR,130,,,32,22,30,12
Dennis Schroder,G,22023,203471,22301216,"DEC 08, 2023",TOR @ CHA,L,30,3,10,0.3,0,4,0.0,1,1,1.0,0,1,1,5,1,0,2,4,7,-9,1,TOR,CHA,TOR,116,,,13,8,12,6
Dennis Schroder,G,22023,203471,22301207,"DEC 06, 2023",TOR vs. MIA,L,35,4,18,0.222,1,5,0.2,0,0,0.0,2,3,5,5,0,0,3,5,9,-6,1,TOR,TOR,MIA,103,,,19,14,14,10
Dennis Schroder,G,22023,203471,22300276,"DEC 01, 2023",TOR vs. NYK,L,37,3,10,0.3,1,6,0.167,3,4,0.75,0,1,1,9,0,0,2,1,10,-10,1,TOR,TOR,NYK,106,,,20,11,19,10
Dennis Schroder,G,22023,203471,22300260,"NOV 29, 2023",TOR vs. PHX,W,34,3,11,0.273,1,2,0.5,1,1,1.0,1,5,6,12,1,0,0,2,8,-2,1,TOR,TOR,PHX,112,,,26,14,20,18
Dennis Schroder,G,22023,203471,22300054,"NOV 28, 2023",TOR @ BKN,L,32,5,15,0.333,2,5,0.4,2,3,0.667,1,4,5,9,1,0,0,3,14,-2,1,TOR,BKN,TOR,103,,,28,19,23,14
Dennis Schroder,G,22023,203471,22300251,"NOV 26, 2023",TOR @ CLE,L,29,5,11,0.455,2,5,0.4,3,3,1.0,0,2,2,4,2,0,1,5,15,10,1,TOR,CLE,TOR,102,,,21,17,19,6
Dennis Schroder,G,22023,203471,22300046,"NOV 24, 2023",TOR vs. CHI,W,34,6,16,0.375,1,9,0.111,4,4,1.0,0,0,0,5,0,0,3,2,17,9,1,TOR,TOR,CHI,121,,,22,17,22,5
Dennis Schroder,G,22023,203471,22300038,"NOV 21, 2023",TOR @ ORL,L,27,8,13,0.615,4,4,1.0,4,4,1.0,0,1,1,1,0,0,2,2,24,-11,1,TOR,ORL,TOR,107,,,26,25,25,2
Dennis Schroder,G,22023,203471,22300211,"NOV 19, 2023",TOR vs. DET,W,26,8,15,0.533,0,4,0.0,1,2,0.5,0,2,2,7,1,0,0,0,17,19,1,TOR,TOR,DET,142,,,26,19,24,9
Dennis Schroder,G,22023,203471,22300031,"NOV 17, 2023",TOR vs. BOS,L,35,9,19,0.474,5,11,0.455,0,0,0.0,0,7,7,6,0,0,2,2,23,1,1,TOR,TOR,BOS,105,,,36,30,29,13
Dennis Schroder,G,22023,203471,22300195,"NOV 15, 2023",TOR vs. MIL,L,23,2,9,0.222,1,4,0.25,4,4,1.0,0,3,3,5,2,0,2,3,9,-29,1,TOR,TOR,MIL,112,,,17,12,14,8
Dennis Schroder,G,22023,203471,22300189,"NOV 13, 2023",TOR vs. WAS,W,35,1,12,0.083,0,4,0.0,2,2,1.0,1,3,4,6,0,0,3,2,4,2,1,TOR,TOR,WAS,111,,,14,8,10,10
Dennis Schroder,G,22023,203471,22300174,"NOV 11, 2023",TOR @ BOS,L,25,3,7,0.429,1,3,0.333,7,7,1.0,0,1,1,4,1,0,1,3,14,-2,1,TOR,BOS,TOR,94,,,19,15,18,5
Dennis Schroder,G,22023,203471,22300092,"OCT 28, 2023",TOR vs. PHI,L,35,5,14,0.357,4,6,0.667,1,2,0.5,3,1,4,10,2,0,1,1,15,-5,1,TOR,TOR,PHI,107,,,29,19,25,14
Dennis Schroder,G,22023,203471,22300082,"OCT 27, 2023",TOR @ CHI,L,35,3,11,0.273,2,5,0.4,2,3,0.667,0,2,2,10,0,0,2,1,10,-6,1,TOR,CHI,TOR,103,,,22,12,20,12
Dennis Schroder,G,22023,203471,22300069,"OCT 25, 2023",TOR vs. MIN,W,33,8,17,0.471,4,8,0.5,2,2,1.0,1,2,3,7,0,0,2,1,22,10,1,TOR,TOR,MIN,97,,,32,25,29,10
Dennis Schroder,G,22023,203471,22300230,"NOV 22, 2023",TOR @ IND,W,32,10,16,0.625,2,5,0.4,4,4,1.0,0,6,6,5,1,0,4,3,26,-2,1,TOR,IND,TOR,132,,,37,32,31,11
Dennis Schroder,G,22023,203471,22300168,"NOV 08, 2023",TOR @ DAL,W,30,7,13,0.538,1,4,0.25,3,4,0.75,0,2,2,5,2,1,2,4,18,1,1,TOR,DAL,TOR,127,,,25,20,23,7
Dennis Schroder,G,22023,203471,22300141,"NOV 05, 2023",TOR @ SAS,W,38,10,19,0.526,1,8,0.125,3,4,0.75,2,1,3,6,2,1,2,1,24,1,1,TOR,SAS,TOR,123,,,33,27,30,9
Dennis Schroder,G,22023,203471,22300128,"NOV 02, 2023",TOR @ PHI,L,31,4,9,0.444,1,2,0.5,4,6,0.667,0,3,3,10,1,0,3,0,13,-7,1,TOR,PHI,TOR,99,,,26,16,23,13
Dennis Schroder,G,22023,203471,22300116,"NOV 01, 2023",TOR vs. MIL,W,29,9,13,0.692,2,4,0.5,4,4,1.0,1,3,4,11,1,0,2,2,24,21,1,TOR,TOR,MIL,130,,,39,28,35,15
Dennis Schroder,G,22023,203471,22300105,"OCT 30, 2023",TOR vs. POR,L,32,4,10,0.4,1,3,0.333,1,1,1.0,0,1,1,8,1,0,1,1,10,1,1,TOR,TOR,POR,91,,,19,11,18,9
Dennis Schroder,G,22023,203471,22300726,"FEB 07, 2024",TOR @ CHA,W,27,4,9,0.444,3,6,0.5,5,7,0.714,0,4,4,5,0,0,2,2,16,9,1,TOR,CHA,TOR,123,,,25,20,21,9
Dennis Schroder,G,22023,203471,22300718,"FEB 05, 2024",TOR @ NOP,L,18,0,4,0.0,0,2,0.0,0,0,0.0,0,0,0,5,0,1,2,0,0,-25,1,TOR,NOP,TOR,100,,,5,0,5,5
Dennis Schroder,G,22023,203471,22300710,"FEB 04, 2024",TOR @ OKC,L,36,5,16,0.313,3,6,0.5,6,6,1.0,2,6,8,4,1,0,0,1,19,-23,1,TOR,OKC,TOR,127,,,31,27,23,12
Dennis Schroder,G,22023,203471,22300692,"FEB 02, 2024",TOR @ HOU,L,22,4,10,0.4,0,5,0.0,0,0,0.0,0,2,2,1,1,0,1,1,8,-18,1,TOR,HOU,TOR,106,,,11,10,9,3
Dennis Schroder,G,22023,203471,22300672,"JAN 30, 2024",TOR @ CHI,W,34,5,11,0.455,0,1,0.0,6,7,0.857,1,2,3,10,2,1,6,2,16,6,1,TOR,CHI,TOR,118,,,29,19,26,13
Dennis Schroder,G,22023,203471,22300653,"JAN 28, 2024",TOR @ ATL,L,29,5,12,0.417,1,4,0.25,3,4,0.75,0,3,3,6,4,0,4,6,14,7,1,TOR,ATL,TOR,113,,,23,17,20,9
Dennis Schroder,G,22023,203471,22300637,"JAN 26, 2024",TOR vs. LAC,L,28,4,9,0.444,1,4,0.25,4,5,0.8,0,4,4,5,2,1,1,2,13,4,1,TOR,TOR,LAC,107,,,22,17,18,9
Dennis Schroder,G,22023,203471,22300609,"JAN 22, 2024",TOR vs. MEM,L,22,3,9,0.333,1,3,0.333,4,4,1.0,1,1,2,3,1,0,2,1,11,-15,1,TOR,TOR,MEM,100,,,16,13,14,5
Dennis Schroder,G,22023,203471,22300596,"JAN 20, 2024",TOR @ NYK,L,23,1,5,0.2,0,1,0.0,0,0,0.0,0,1,1,3,0,0,0,1,2,-13,1,TOR,NYK,TOR,94,,,6,3,5,4
Dennis Schroder,G,22023,203471,22300580,"JAN 18, 2024",TOR vs. CHI,L,26,3,7,0.429,1,4,0.25,0,0,0.0,0,0,0,5,0,0,0,1,7,4,1,TOR,TOR,CHI,100,,,12,7,12,5
Dennis Schroder,G,22023,203471,22300574,"JAN 17, 2024",TOR vs. MIA,W,27,3,6,0.5,3,5,0.6,0,0,0.0,0,1,1,6,1,0,1,1,9,31,1,TOR,TOR,MIA,115,,,16,10,15,7
Dennis Schroder,G,22023,203471,22300563,"JAN 15, 2024",TOR vs. BOS,L,33,5,9,0.556,1,3,0.333,2,2,1.0,0,7,7,2,0,0,2,4,13,-15,1,TOR,TOR,BOS,94,,,22,20,15,9
Dennis Schroder,G,22023,203471,22300540,"JAN 12, 2024",TOR @ UTA,L,23,4,9,0.444,4,7,0.571,0,0,0.0,0,0,0,4,1,0,1,2,12,-9,1,TOR,UTA,TOR,104,,,16,12,16,4
Dennis Schroder,G,22023,203471,22300526,"JAN 10, 2024",TOR @ LAC,L,34,8,13,0.615,1,5,0.2,5,5,1.0,0,1,1,4,0,0,2,1,22,-1,1,TOR,LAC,TOR,111,,,27,23,26,5
Dennis Schroder,G,22023,203471,22300516,"JAN 09, 2024",TOR @ LAL,L,30,3,6,0.5,2,3,0.667,2,2,1.0,1,1,2,6,0,0,2,2,10,-2,1,TOR,LAL,TOR,131,,,18,12,16,8
Dennis Schroder,G,22023,203471,22300504,"JAN 07, 2024",TOR @ GSW,W,28,6,10,0.6,1,3,0.333,0,1,0.0,0,3,3,4,0,0,0,5,13,14,1,TOR,GSW,TOR,131,,,20,16,17,7
Dennis Schroder,G,22023,203471,22300492,"JAN 05, 2024",TOR @ SAC,L,32,7,11,0.636,0,4,0.0,4,5,0.8,1,1,2,3,1,1,0,1,18,12,1,TOR,SAC,TOR,120,,,23,20,21,5
Dennis Schroder,G,22023,203471,22300470,"JAN 03, 2024",TOR @ MEM,W,29,6,11,0.545,1,3,0.333,3,4,0.75,0,7,7,5,0,0,0,0,16,5,1,TOR,MEM,TOR,116,,,28,23,21,12
Dennis Schroder,G,22023,203471,22300452,"JAN 01, 2024",TOR vs. CLE,W,30,3,7,0.429,1,5,0.2,5,7,0.714,0,3,3,8,0,0,1,2,12,12,1,TOR,TOR,CLE,124,,,23,15,20,11
Dennis Schroder,G,22023,203471,22300440,"DEC 30, 2023",TOR @ DET,L,37,11,18,0.611,3,6,0.5,5,5,1.0,0,0,0,9,0,0,1,1,30,4,1,TOR,DET,TOR,127,,,39,30,39,9
Dennis Schroder,G,22023,203471,22300750,"FEB 10, 2024",BKN vs. SAS,W,27,6,13,0.462,3,5,0.6,0,0,0.0,0,3,3,12,0,0,2,4,15,10,1,BKN,BKN,SAS,123,,,30,18,27,15
Dillon Brooks,F,22023,1628415,22300754,"FEB 10, 2024",HOU @ ATL,L,35,5,19,0.263,2,10,0.2,2,2,1.0,1,0,1,1,0,0,0,3,14,-10,1,HOU,ATL,HOU,113,,,16,15,15,2
Dillon Brooks,F,22023,1628415,22300744,"FEB 09, 2024",HOU @ TOR,L,30,6,13,0.462,4,5,0.8,4,4,1.0,0,2,2,3,1,2,4,5,20,-11,1,HOU,TOR,HOU,104,,,25,22,23,5
Dillon Brooks,F,22023,1628415,22300719,"FEB 06, 2024",HOU @ IND,L,31,8,15,0.533,3,6,0.5,4,4,1.0,1,2,3,4,1,0,0,1,23,2,1,HOU,IND,HOU,129,,,30,26,27,7
Dillon Brooks,F,22023,1628415,22300709,"FEB 04, 2024",HOU @ MIN,L,28,2,7,0.286,1,3,0.333,2,2,1.0,0,2,2,3,2,0,1,3,7,-18,1,HOU,MIN,HOU,90,,,12,9,10,5
Dillon Brooks,F,22023,1628415,22300692,"FEB 02, 2024",HOU vs. TOR,W,24,2,6,0.333,1,2,0.5,1,2,0.5,0,5,5,0,0,1,0,1,6,11,1,HOU,HOU,TOR,135,,,11,11,6,5
Dillon Brooks,F,22023,1628415,22300679,"JAN 31, 2024",HOU vs. NOP,L,31,4,11,0.364,3,7,0.429,2,2,1.0,0,3,3,1,0,0,0,4,13,-6,1,HOU,HOU,NOP,99,,,17,16,14,4
Dillon Brooks,F,22023,1628415,22300662,"JAN 29, 2024",HOU vs. LAL,W,28,7,12,0.583,2,4,0.5,1,2,0.5,3,0,3,1,1,0,1,5,17,4,1,HOU,HOU,LAL,135,,,21,20,18,4
Dillon Brooks,F,22023,1628415,22300645,"JAN 27, 2024",HOU @ BKN,L,39,7,18,0.389,1,7,0.143,4,4,1.0,1,4,5,2,1,0,2,6,19,-3,1,HOU,BKN,HOU,104,,,26,24,21,7
Dillon Brooks,F,22023,1628415,22300635,"JAN 26, 2024",HOU @ CHA,W,25,3,7,0.429,1,3,0.333,5,6,0.833,0,0,0,1,0,1,0,3,12,20,1,HOU,CHA,HOU,138,,,13,12,13,1
Dillon Brooks,F,22023,1628415,22300623,"JAN 24, 2024",HOU vs. POR,L,32,5,11,0.455,3,6,0.5,1,1,1.0,0,4,4,4,0,0,3,3,14,-6,1,HOU,HOU,POR,131,,,22,18,18,8
Dillon Brooks,F,22023,1628415,22300603,"JAN 21, 2024",HOU vs. BOS,L,40,8,22,0.364,5,15,0.333,4,5,0.8,1,4,5,1,4,0,0,5,25,-14,1,HOU,HOU,BOS,107,,,31,30,26,6
Dillon Brooks,F,22023,1628415,22300598,"JAN 20, 2024",HOU vs. UTA,W,35,3,10,0.3,1,3,0.333,0,0,0.0,0,5,5,1,0,0,0,2,7,-7,1,HOU,HOU,UTA,127,,,13,12,8,6
Dillon Brooks,F,22023,1628415,22300573,"JAN 17, 2024",HOU @ NYK,L,40,4,13,0.308,1,6,0.167,2,2,1.0,0,1,1,0,1,1,1,3,11,-8,1,HOU,NYK,HOU,94,,,12,12,11,1
Dillon Brooks,F,22023,1628415,22300555,"JAN 15, 2024",HOU @ PHI,L,31,7,9,0.778,2,3,0.667,2,4,0.5,2,4,6,0,2,0,0,2,18,-6,1,HOU,PHI,HOU,115,,,24,24,18,6
Dillon Brooks,F,22023,1628415,22300542,"JAN 13, 2024",HOU @ BOS,L,25,3,8,0.375,0,1,0.0,6,6,1.0,1,0,1,0,1,0,0,4,12,-20,1,HOU,BOS,HOU,113,,,13,13,12,1
Dillon Brooks,F,22023,1628415,22300409,"DEC 26, 2023",HOU vs. IND,L,22,4,9,0.444,0,1,0.0,1,1,1.0,1,0,1,1,1,0,0,0,9,-15,1,HOU,HOU,IND,117,,,11,10,10,2
Dillon Brooks,F,22023,1628415,22300392,"DEC 23, 2023",HOU @ NOP,W,28,2,7,0.286,1,4,0.25,0,0,0.0,0,5,5,5,1,0,1,3,5,6,1,HOU,NOP,HOU,106,,,15,10,10,10
Dillon Brooks,F,22023,1628415,22300385,"DEC 22, 2023",HOU vs. DAL,W,22,4,9,0.444,2,5,0.4,0,0,0.0,0,3,3,1,0,0,2,2,10,35,1,HOU,HOU,DAL,122,,,14,13,11,4
Dillon Brooks,F,22023,1628415,22300371,"DEC 20, 2023",HOU vs. ATL,L,30,7,9,0.778,5,6,0.833,0,0,0.0,0,2,2,1,2,0,0,5,19,1,1,HOU,HOU,ATL,127,,,22,21,20,3
Dillon Brooks,F,22023,1628415,22300349,"DEC 18, 2023",HOU @ CLE,L,38,6,12,0.5,3,7,0.429,1,2,0.5,1,2,3,2,0,0,0,3,16,0,1,HOU,CLE,HOU,130,,,21,19,18,5
Dillon Brooks,F,22023,1628415,22300346,"DEC 17, 2023",HOU @ MIL,L,35,7,12,0.583,2,4,0.5,2,2,1.0,1,3,4,1,2,0,2,4,18,-15,1,HOU,MIL,HOU,119,,,23,22,19,5
Dillon Brooks,F,22023,1628415,22300332,"DEC 15, 2023",HOU @ MEM,W,40,10,20,0.5,3,9,0.333,3,4,0.75,1,6,7,1,1,0,2,3,26,3,1,HOU,MEM,HOU,103,,,34,33,27,8
Dillon Brooks,F,22023,1628415,22300314,"DEC 13, 2023",HOU vs. MEM,W,28,4,8,0.5,1,3,0.333,2,2,1.0,0,2,2,1,0,0,4,6,11,12,1,HOU,HOU,MEM,117,,,14,13,12,3
Dillon Brooks,F,22023,1628415,22300298,"DEC 11, 2023",HOU vs. SAS,W,30,1,12,0.083,0,6,0.0,0,0,0.0,1,4,5,2,0,0,2,3,2,7,1,HOU,HOU,SAS,93,,,9,7,4,7
Dillon Brooks,F,22023,1628415,22301224,"DEC 08, 2023",HOU @ DEN,W,33,6,12,0.5,4,10,0.4,0,0,0.0,1,4,5,1,2,0,3,5,16,2,1,HOU,DEN,HOU,114,,,22,21,17,6
Dillon Brooks,F,22023,1628415,22301212,"DEC 06, 2023",HOU vs. OKC,W,40,9,17,0.529,2,7,0.286,3,3,1.0,2,2,4,2,1,0,3,2,23,3,1,HOU,HOU,OKC,110,,,29,27,25,6
Dillon Brooks,F,22023,1628415,22300291,"DEC 02, 2023",HOU @ LAL,L,33,4,9,0.444,2,4,0.5,0,0,0.0,1,1,2,1,0,0,1,4,10,-14,1,HOU,LAL,HOU,97,,,13,12,11,3
Dillon Brooks,F,22023,1628415,22300263,"NOV 29, 2023",HOU @ DEN,L,23,4,7,0.571,1,4,0.25,2,3,0.667,1,0,1,2,0,0,4,4,11,-22,1,HOU,DEN,HOU,124,,,14,12,13,3
Dillon Brooks,F,22023,1628415,22300059,"NOV 28, 2023",HOU @ DAL,L,28,7,13,0.538,1,4,0.25,1,2,0.5,0,1,1,1,0,0,1,6,16,-12,1,HOU,DAL,HOU,115,,,18,17,17,2
Dillon Brooks,F,22023,1628415,22300048,"NOV 24, 2023",HOU vs. DEN,W,30,2,8,0.25,2,3,0.667,2,2,1.0,1,0,1,2,0,0,2,4,8,8,1,HOU,HOU,DEN,105,,,11,9,10,3
Dillon Brooks,F,22023,1628415,22300231,"NOV 22, 2023",HOU vs. MEM,W,27,4,14,0.286,0,5,0.0,5,5,1.0,1,4,5,1,1,0,1,4,13,-2,1,HOU,HOU,MEM,111,,,19,18,14,6
Dillon Brooks,F,22023,1628415,22300224,"NOV 20, 2023",HOU @ GSW,L,31,6,13,0.462,2,5,0.4,2,2,1.0,2,2,4,2,0,0,1,5,16,3,1,HOU,GSW,HOU,116,,,22,20,18,6
Dillon Brooks,F,22023,1628415,22300216,"NOV 19, 2023",HOU @ LAL,L,41,9,21,0.429,6,11,0.545,0,0,0.0,1,0,1,2,4,0,2,5,24,3,1,HOU,LAL,HOU,104,,,27,25,26,3
Dillon Brooks,F,22023,1628415,22300037,"NOV 17, 2023",HOU @ LAC,L,31,2,6,0.333,0,2,0.0,0,1,0.0,1,3,4,1,1,0,0,6,4,-16,1,HOU,LAC,HOU,100,,,9,8,5,5
Dillon Brooks,F,22023,1628415,22300182,"NOV 12, 2023",HOU vs. DEN,W,29,3,6,0.5,1,3,0.333,3,4,0.75,0,4,4,2,0,0,3,4,10,-9,1,HOU,HOU,DEN,107,,,16,14,12,6
Dillon Brooks,F,22023,1628415,22300011,"NOV 10, 2023",HOU vs. NOP,W,21,3,7,0.429,1,1,1.0,3,5,0.6,0,2,2,2,2,1,0,5,10,12,1,HOU,HOU,NOP,104,,,14,12,12,4
Dillon Brooks,F,22023,1628415,22300163,"NOV 08, 2023",HOU vs. LAL,W,25,2,6,0.333,1,3,0.333,0,0,0.0,0,4,4,1,0,0,2,4,5,18,1,HOU,HOU,LAL,128,,,10,9,6,5
Dillon Brooks,F,22023,1628415,22300153,"NOV 06, 2023",HOU vs. SAC,W,28,3,6,0.5,1,3,0.333,2,2,1.0,0,6,6,1,0,0,1,1,9,34,1,HOU,HOU,SAC,122,,,16,15,10,7
Dillon Brooks,F,22023,1628415,22300137,"NOV 04, 2023",HOU vs. SAC,W,38,9,14,0.643,2,4,0.5,6,6,1.0,3,6,9,1,1,0,1,0,26,25,1,HOU,HOU,SAC,107,,,36,35,27,10
Dillon Brooks,F,22023,1628415,22300122,"NOV 01, 2023",HOU vs. CHA,W,38,7,9,0.778,3,3,1.0,3,4,0.75,1,2,3,5,5,0,7,4,20,-3,1,HOU,HOU,CHA,128,,,28,23,25,8
Dillon Brooks,F,22023,1628415,22300096,"OCT 29, 2023",HOU vs. GSW,L,34,4,10,0.4,2,5,0.4,2,2,1.0,0,4,4,2,0,0,0,5,12,2,1,HOU,HOU,GSW,95,,,18,16,14,6
Dillon Brooks,F,22023,1628415,22300083,"OCT 27, 2023",HOU @ SAS,L,39,7,13,0.538,1,2,0.5,2,2,1.0,0,2,2,2,1,0,2,4,17,4,1,HOU,SAS,HOU,122,,,21,19,19,4
Dillon Brooks,F,22023,1628415,22300066,"OCT 25, 2023",HOU @ ORL,L,26,5,7,0.714,4,6,0.667,0,0,0.0,0,4,4,2,1,0,2,4,14,-15,1,HOU,ORL,HOU,86,,,20,18,16,6
P.J. Washington,F,22023,1629023,22300177,"NOV 12, 2023",CHA @ NYK,L,22,1,8,0.125,1,5,0.2,1,2,0.5,1,1,2,3,0,1,2,4,4,-30,1,CHA,NYK,CHA,107,,,9,6,7,5
P.J. Washington,F,22023,1629023,22300635,"JAN 26, 2024",CHA vs. HOU,L,29,4,9,0.444,0,2,0.0,4,5,0.8,0,2,2,2,0,3,2,1,12,-23,1,CHA,CHA,HOU,104,,,16,14,14,4
P.J. Washington,F,22023,1629023,22300619,"JAN 24, 2024",CHA @ DET,L,29,4,6,0.667,4,6,0.667,0,0,0.0,0,6,6,5,1,1,2,4,12,6,1,CHA,DET,CHA,106,,,23,18,17,11
P.J. Washington,F,22023,1629023,22300610,"JAN 22, 2024",CHA @ MIN,W,33,5,7,0.714,2,4,0.5,0,1,0.0,0,7,7,3,1,1,0,4,12,6,1,CHA,MIN,CHA,126,,,22,19,15,10
P.J. Washington,F,22023,1629023,22300584,"JAN 19, 2024",CHA vs. SAS,W,28,7,11,0.636,3,4,0.75,3,3,1.0,1,5,6,0,1,0,2,4,20,14,1,CHA,CHA,SAS,124,,,26,26,20,6
P.J. Washington,F,22023,1629023,22300575,"JAN 17, 2024",CHA @ NOP,L,24,3,9,0.333,1,4,0.25,0,0,0.0,4,1,5,2,1,2,1,3,7,-10,1,CHA,NOP,CHA,108,,,14,12,9,7
P.J. Washington,F,22023,1629023,22300551,"JAN 14, 2024",CHA @ MIA,L,28,2,7,0.286,1,5,0.2,0,2,0.0,2,4,6,1,1,0,1,3,5,-4,1,CHA,MIA,CHA,85,,,12,11,6,7
P.J. Washington,F,22023,1629023,22300248,"NOV 26, 2023",CHA @ ORL,L,28,3,10,0.3,3,9,0.333,4,6,0.667,0,4,4,2,0,3,1,5,13,-5,1,CHA,ORL,CHA,117,,,19,17,15,6
P.J. Washington,F,22023,1629023,22300217,"NOV 20, 2023",CHA vs. BOS,W,28,6,13,0.462,3,9,0.333,0,0,0.0,0,1,1,1,2,1,0,1,15,-21,1,CHA,CHA,BOS,121,,,17,16,16,2
P.J. Washington,F,22023,1629023,22300202,"NOV 18, 2023",CHA vs. NYK,L,33,1,10,0.1,1,7,0.143,0,0,0.0,0,6,6,2,1,2,6,4,3,-25,1,CHA,CHA,NYK,108,,,11,9,5,8
P.J. Washington,F,22023,1629023,22300027,"NOV 17, 2023",CHA vs. MIL,L,26,1,3,0.333,1,3,0.333,0,0,0.0,0,3,3,1,0,0,0,4,3,-2,1,CHA,CHA,MIL,99,,,7,6,4,4
P.J. Washington,F,22023,1629023,22300017,"NOV 14, 2023",CHA vs. MIA,L,36,12,23,0.522,6,11,0.545,2,2,1.0,2,4,6,1,0,0,1,1,32,-2,1,CHA,CHA,MIA,105,,,39,38,33,7
P.J. Washington,F,22023,1629023,22300009,"NOV 10, 2023",CHA @ WAS,W,38,5,15,0.333,0,6,0.0,1,2,0.5,3,7,10,4,1,0,2,0,11,-1,1,CHA,WAS,CHA,124,,,25,21,15,14
P.J. Washington,F,22023,1629023,22300157,"NOV 08, 2023",CHA vs. WAS,L,36,4,11,0.364,0,5,0.0,6,7,0.857,1,6,7,1,0,2,2,2,14,-8,1,CHA,CHA,WAS,116,,,22,21,15,8
P.J. Washington,F,22023,1629023,22300143,"NOV 05, 2023",CHA @ DAL,L,34,8,15,0.533,1,4,0.25,3,4,0.75,0,4,4,1,0,0,0,3,20,8,1,CHA,DAL,CHA,118,,,25,24,21,5
P.J. Washington,F,22023,1629023,22300133,"NOV 04, 2023",CHA @ IND,W,33,6,13,0.462,1,1,1.0,2,2,1.0,1,2,3,4,1,2,1,0,15,-13,1,CHA,IND,CHA,125,,,22,18,19,7
P.J. Washington,F,22023,1629023,22300122,"NOV 01, 2023",CHA @ HOU,L,35,8,13,0.615,5,6,0.833,2,2,1.0,1,2,3,0,0,0,1,2,23,0,1,CHA,HOU,CHA,119,,,26,26,23,3
P.J. Washington,F,22023,1629023,22300101,"OCT 30, 2023",CHA vs. BKN,L,35,7,14,0.5,1,3,0.333,0,1,0.0,3,9,12,2,0,0,1,4,15,-14,1,CHA,CHA,BKN,121,,,29,27,17,14
P.J. Washington,F,22023,1629023,22300077,"OCT 27, 2023",CHA vs. DET,L,29,6,13,0.462,1,5,0.2,0,1,0.0,0,3,3,3,2,1,2,6,13,-12,1,CHA,CHA,DET,99,,,19,16,16,6
P.J. Washington,F,22023,1629023,22300063,"OCT 25, 2023",CHA vs. ATL,W,32,12,18,0.667,1,6,0.167,0,0,0.0,1,4,5,2,0,0,1,4,25,5,1,CHA,CHA,ATL,116,,,32,30,27,7
P.J. Washington,F,22023,1629023,22300726,"FEB 07, 2024",CHA vs. TOR,L,31,2,11,0.182,0,5,0.0,2,4,0.5,0,5,5,1,0,0,1,2,6,-19,1,CHA,CHA,TOR,117,,,12,11,7,6
P.J. Washington,F,22023,1629023,22300713,"FEB 05, 2024",CHA vs. LAL,L,34,6,14,0.429,1,5,0.2,2,4,0.5,1,7,8,4,1,0,0,0,15,-3,1,CHA,CHA,LAL,118,,,27,23,19,12
P.J. Washington,F,22023,1629023,22300707,"FEB 04, 2024",CHA vs. IND,L,32,9,16,0.563,1,6,0.167,3,5,0.6,3,6,9,2,2,1,0,3,22,-4,1,CHA,CHA,IND,99,,,33,31,24,11
P.J. Washington,F,22023,1629023,22300695,"FEB 02, 2024",CHA @ OKC,L,26,2,9,0.222,0,3,0.0,1,2,0.5,1,5,6,1,2,0,5,3,5,-19,1,CHA,OKC,CHA,106,,,12,11,6,7
P.J. Washington,F,22023,1629023,22300674,"JAN 31, 2024",CHA vs. CHI,L,36,10,17,0.588,3,9,0.333,3,4,0.75,3,5,8,1,0,1,3,3,26,2,1,CHA,CHA,CHI,110,,,35,34,27,9
P.J. Washington,F,22023,1629023,22300657,"JAN 29, 2024",CHA vs. NYK,L,35,7,19,0.368,2,9,0.222,0,0,0.0,0,2,2,2,0,1,1,0,16,-12,1,CHA,CHA,NYK,92,,,20,18,18,4
P.J. Washington,F,22023,1629023,22300647,"JAN 27, 2024",CHA vs. UTA,L,36,17,22,0.773,7,9,0.778,2,3,0.667,1,1,2,3,2,0,2,1,43,-7,1,CHA,CHA,UTA,122,,,48,45,46,5
P.J. Washington,F,22023,1629023,22300365,"DEC 20, 2023",CHA @ IND,L,27,4,10,0.4,2,7,0.286,2,2,1.0,3,1,4,0,0,0,1,1,12,-31,1,CHA,IND,CHA,109,,,16,16,12,4
P.J. Washington,F,22023,1629023,22300354,"DEC 18, 2023",CHA @ TOR,L,39,5,16,0.313,3,9,0.333,2,2,1.0,1,6,7,5,4,0,2,5,15,-17,1,CHA,TOR,CHA,99,,,27,22,20,12
P.J. Washington,F,22023,1629023,22300057,"NOV 28, 2023",CHA @ NYK,L,27,4,10,0.4,3,8,0.375,0,2,0.0,3,5,8,3,1,1,3,3,11,-13,1,CHA,NYK,CHA,91,,,22,19,14,11
P.J. Washington,F,22023,1629023,22300455,"JAN 01, 2024",CHA @ DEN,L,26,2,5,0.4,1,3,0.333,1,1,1.0,1,5,6,0,0,0,2,2,6,3,1,CHA,DEN,CHA,91,,,12,12,6,6
P.J. Washington,F,22023,1629023,22300428,"DEC 28, 2023",CHA @ LAL,L,25,4,11,0.364,0,4,0.0,1,2,0.5,1,5,6,0,0,0,3,1,9,-15,1,CHA,LAL,CHA,110,,,15,15,9,6
P.J. Washington,F,22023,1629023,22300593,"JAN 20, 2024",CHA vs. PHI,L,26,3,8,0.375,1,4,0.25,2,2,1.0,0,3,3,0,0,0,2,6,9,-24,1,CHA,CHA,PHI,89,,,12,12,9,3
P.J. Washington,F,22023,1629023,22300484,"JAN 05, 2024",CHA @ CHI,L,6,0,2,0.0,0,1,0.0,0,0,0.0,1,2,3,2,0,0,0,0,0,-1,1,CHA,CHI,CHA,87,,,5,3,2,5
P.J. Washington,F,22023,1629023,22300464,"JAN 02, 2024",CHA @ SAC,W,29,7,13,0.538,3,6,0.5,0,0,0.0,1,3,4,4,1,0,1,1,17,16,1,CHA,SAC,CHA,111,,,25,21,21,8
P.J. Washington,F,22023,1629023,22300436,"DEC 29, 2023",CHA @ PHX,L,28,5,12,0.417,3,8,0.375,0,0,0.0,1,3,4,4,0,1,1,3,13,-7,1,CHA,PHX,CHA,119,,,21,17,17,8
P.J. Washington,F,22023,1629023,22300414,"DEC 26, 2023",CHA @ LAC,L,26,7,10,0.7,0,2,0.0,4,4,1.0,4,4,8,3,2,0,2,3,18,-4,1,CHA,LAC,CHA,104,,,29,26,21,11
P.J. Washington,F,22023,1629023,22300390,"DEC 23, 2023",CHA vs. DEN,L,28,6,20,0.3,1,7,0.143,7,9,0.778,1,7,8,2,4,2,2,1,20,-10,1,CHA,CHA,DEN,95,,,30,28,22,10
P.J. Washington,F,22023,1629023,22300312,"DEC 13, 2023",CHA @ MIA,L,4,0,0,0.0,0,0,0.0,0,0,0.0,0,0,0,1,1,0,1,0,0,1,1,CHA,MIA,CHA,104,,,1,0,1,1
P.J. Washington,F,22023,1629023,22300292,"DEC 11, 2023",CHA vs. MIA,L,32,5,11,0.455,2,6,0.333,3,4,0.75,1,7,8,3,0,1,0,3,15,6,1,CHA,CHA,MIA,114,,,26,23,18,11
P.J. Washington,F,22023,1629023,22301216,"DEC 08, 2023",CHA vs. TOR,W,25,4,7,0.571,3,5,0.6,0,0,0.0,0,1,1,2,2,0,2,4,11,-7,1,CHA,CHA,TOR,119,,,14,12,13,3
P.J. Washington,F,22023,1629023,22301211,"DEC 06, 2023",CHA @ CHI,L,29,4,13,0.308,1,7,0.143,0,0,0.0,1,5,6,4,1,2,1,5,9,-5,1,CHA,CHI,CHA,100,,,19,15,13,10
P.J. Washington,F,22023,1629023,22300281,"DEC 02, 2023",CHA vs. MIN,L,31,7,14,0.5,4,7,0.571,0,0,0.0,3,4,7,5,0,1,1,1,18,8,1,CHA,CHA,MIN,117,,,30,25,23,12
P.J. Washington,F,22023,1629023,22300266,"NOV 30, 2023",CHA @ BKN,W,33,2,11,0.182,2,9,0.222,4,4,1.0,2,6,8,5,3,2,2,2,10,4,1,CHA,BKN,CHA,129,,,23,18,15,13
P.J. Washington,F,22023,1629023,22300748,"FEB 10, 2024",DAL vs. OKC,W,24,6,10,0.6,1,4,0.25,1,2,0.5,1,4,5,1,1,0,2,3,14,24,1,DAL,DAL,OKC,146,,,20,19,15,6
Aaron Gordon,F,22023,203932,22300746,"FEB 09, 2024",DEN @ SAC,L,27,5,8,0.625,1,2,0.5,3,6,0.5,2,1,3,2,0,1,2,0,14,-28,1,DEN,SAC,DEN,106,,,19,17,16,5
Aaron Gordon,F,22023,203932,22300740,"FEB 08, 2024",DEN @ LAL,W,32,5,8,0.625,0,2,0.0,1,2,0.5,0,4,4,3,2,1,1,1,11,18,1,DEN,LAL,DEN,114,,,18,15,14,7
Aaron Gordon,F,22023,203932,22300712,"FEB 04, 2024",DEN vs. POR,W,30,4,8,0.5,0,1,0.0,4,4,1.0,3,4,7,2,0,0,0,3,12,-3,1,DEN,DEN,POR,112,,,21,19,14,9
Aaron Gordon,F,22023,203932,22300697,"FEB 02, 2024",DEN vs. POR,W,28,7,9,0.778,1,1,1.0,3,3,1.0,2,2,4,5,0,0,3,4,18,20,1,DEN,DEN,POR,120,,,27,22,23,9
Aaron Gordon,F,22023,203932,22300682,"JAN 31, 2024",DEN @ OKC,L,39,7,16,0.438,1,3,0.333,1,6,0.167,4,9,13,7,1,4,1,2,16,7,1,DEN,OKC,DEN,100,,,36,29,23,20
Aaron Gordon,F,22023,203932,22300667,"JAN 29, 2024",DEN vs. MIL,W,25,2,6,0.333,1,2,0.5,3,4,0.75,2,4,6,2,0,1,2,6,8,-9,1,DEN,DEN,MIL,113,,,16,14,10,8
Aaron Gordon,F,22023,203932,22300644,"JAN 27, 2024",DEN vs. PHI,W,31,6,8,0.75,2,3,0.667,4,6,0.667,2,2,4,2,1,0,1,1,18,6,1,DEN,DEN,PHI,111,,,24,22,20,6
Aaron Gordon,F,22023,203932,22300631,"JAN 25, 2024",DEN @ NYK,L,30,5,10,0.5,0,1,0.0,2,2,1.0,1,4,5,2,1,0,1,2,12,-28,1,DEN,NYK,DEN,84,,,19,17,14,7
Aaron Gordon,F,22023,203932,22300614,"JAN 23, 2024",DEN @ IND,W,32,3,5,0.6,0,1,0.0,3,3,1.0,0,1,1,1,0,2,0,3,9,5,1,DEN,IND,DEN,114,,,11,10,10,2
Aaron Gordon,F,22023,203932,22300602,"JAN 21, 2024",DEN @ WAS,W,31,4,10,0.4,0,0,0.0,3,7,0.429,3,7,10,2,1,3,1,0,11,12,1,DEN,WAS,DEN,113,,,23,21,13,12
Aaron Gordon,F,22023,203932,22300586,"JAN 19, 2024",DEN @ BOS,W,42,0,6,0.0,0,3,0.0,2,3,0.667,2,8,10,3,0,1,1,3,2,1,1,DEN,BOS,DEN,102,,,15,12,5,13
Aaron Gordon,F,22023,203932,22300566,"JAN 16, 2024",DEN @ PHI,L,39,7,11,0.636,0,1,0.0,2,6,0.333,3,3,6,4,0,0,2,5,16,0,1,DEN,PHI,DEN,121,,,26,22,20,10
Aaron Gordon,F,22023,203932,22300550,"JAN 14, 2024",DEN vs. IND,W,37,7,10,0.7,0,1,0.0,6,8,0.75,1,9,10,3,0,0,2,0,20,17,1,DEN,DEN,IND,117,,,33,30,23,13
Aaron Gordon,F,22023,203932,22300539,"JAN 12, 2024",DEN vs. NOP,W,31,7,12,0.583,0,2,0.0,1,3,0.333,3,2,5,2,0,0,2,2,15,9,1,DEN,DEN,NOP,125,,,22,20,17,7
Aaron Gordon,F,22023,203932,22300524,"JAN 10, 2024",DEN @ UTA,L,29,5,6,0.833,2,2,1.0,0,0,0.0,2,3,5,4,1,0,2,4,12,-20,1,DEN,UTA,DEN,111,,,21,17,16,9
Aaron Gordon,F,22023,203932,22300502,"JAN 07, 2024",DEN vs. DET,W,20,3,4,0.75,0,0,0.0,2,2,1.0,1,0,1,1,1,0,0,0,8,10,1,DEN,DEN,DET,131,,,10,9,9,2
Aaron Gordon,F,22023,203932,22300488,"JAN 05, 2024",DEN vs. ORL,L,36,5,8,0.625,2,4,0.5,4,5,0.8,3,5,8,3,0,0,1,4,16,-4,1,DEN,DEN,ORL,120,,,27,24,19,11
Aaron Gordon,F,22023,203932,22300478,"JAN 04, 2024",DEN @ GSW,W,35,11,17,0.647,2,4,0.5,6,7,0.857,5,4,9,2,0,1,0,2,30,6,1,DEN,GSW,DEN,130,,,41,39,32,11
Aaron Gordon,F,22023,203932,22300455,"JAN 01, 2024",DEN vs. CHA,W,25,4,5,0.8,1,1,1.0,1,2,0.5,1,1,2,0,1,1,0,0,10,29,1,DEN,DEN,CHA,111,,,12,12,10,2
Aaron Gordon,F,22023,203932,22300402,"DEC 25, 2023",DEN vs. GSW,W,32,7,10,0.7,1,4,0.25,1,4,0.25,4,6,10,3,1,0,2,2,16,13,1,DEN,DEN,GSW,120,,,29,26,19,13
Aaron Gordon,F,22023,203932,22300390,"DEC 23, 2023",DEN @ CHA,W,32,5,11,0.455,0,0,0.0,4,5,0.8,2,0,2,1,1,1,2,1,14,12,1,DEN,CHA,DEN,102,,,17,16,15,3
Aaron Gordon,F,22023,203932,22300383,"DEC 22, 2023",DEN @ BKN,W,32,5,6,0.833,0,0,0.0,8,9,0.889,2,3,5,2,1,0,1,1,18,19,1,DEN,BKN,DEN,122,,,25,23,20,7
Aaron Gordon,F,22023,203932,22300369,"DEC 20, 2023",DEN @ TOR,W,30,6,9,0.667,0,1,0.0,0,0,0.0,3,2,5,2,0,0,1,1,12,14,1,DEN,TOR,DEN,113,,,19,17,14,7
Aaron Gordon,F,22023,203932,22300356,"DEC 18, 2023",DEN vs. DAL,W,24,7,9,0.778,2,3,0.667,5,6,0.833,1,4,5,5,1,0,0,1,21,18,1,DEN,DEN,DAL,130,,,31,26,26,10
Aaron Gordon,F,22023,203932,22300340,"DEC 16, 2023",DEN vs. OKC,L,33,5,10,0.5,0,0,0.0,6,7,0.857,6,3,9,5,2,0,0,2,16,-7,1,DEN,DEN,OKC,117,,,30,25,21,14
Aaron Gordon,F,22023,203932,22300322,"DEC 14, 2023",DEN vs. BKN,W,24,6,9,0.667,0,1,0.0,1,1,1.0,0,3,3,2,1,1,2,0,13,16,1,DEN,DEN,BKN,124,,,18,16,15,5
Aaron Gordon,F,22023,203932,22300307,"DEC 12, 2023",DEN @ CHI,W,32,6,13,0.462,1,2,0.5,1,2,0.5,5,2,7,6,0,0,0,1,14,8,1,DEN,CHI,DEN,114,,,27,21,20,13
Aaron Gordon,F,22023,203932,22300296,"DEC 11, 2023",DEN @ ATL,W,29,7,10,0.7,0,0,0.0,4,5,0.8,7,5,12,1,0,0,2,2,18,9,1,DEN,ATL,DEN,129,,,31,30,19,13
Aaron Gordon,F,22023,203932,22301224,"DEC 08, 2023",DEN vs. HOU,L,22,1,5,0.2,0,2,0.0,1,5,0.2,1,5,6,3,0,0,1,1,3,-12,1,DEN,DEN,HOU,106,,,12,9,6,9
Aaron Gordon,F,22023,203932,22301215,"DEC 06, 2023",DEN @ LAC,L,31,4,9,0.444,0,0,0.0,0,0,0.0,2,4,6,2,2,0,0,2,8,6,1,DEN,LAC,DEN,102,,,16,14,10,8
Aaron Gordon,F,22023,203932,22300290,"DEC 02, 2023",DEN @ SAC,L,33,8,13,0.615,1,3,0.333,0,0,0.0,4,3,7,3,0,1,1,1,17,-11,1,DEN,SAC,DEN,117,,,27,24,20,10
Aaron Gordon,F,22023,203932,22300048,"NOV 24, 2023",DEN @ HOU,L,39,0,12,0.0,0,4,0.0,2,4,0.5,3,4,7,2,0,0,1,1,2,-9,1,DEN,HOU,DEN,86,,,11,9,4,9
Aaron Gordon,F,22023,203932,22300226,"NOV 22, 2023",DEN @ ORL,L,37,7,16,0.438,1,3,0.333,0,2,0.0,7,3,10,1,2,0,2,3,15,4,1,DEN,ORL,DEN,119,,,26,25,16,11
Aaron Gordon,F,22023,203932,22300218,"NOV 20, 2023",DEN @ DET,W,37,4,11,0.364,0,1,0.0,3,4,0.75,5,4,9,7,1,0,2,1,11,-2,1,DEN,DET,DEN,107,,,27,20,18,16
Aaron Gordon,F,22023,203932,22300210,"NOV 19, 2023",DEN @ CLE,L,32,4,11,0.364,0,2,0.0,3,6,0.5,2,2,4,5,1,2,1,2,11,-18,1,DEN,CLE,DEN,109,,,20,15,16,9
Aaron Gordon,F,22023,203932,22300034,"NOV 17, 2023",DEN @ NOP,L,39,7,14,0.5,0,4,0.0,0,3,0.0,1,7,8,2,1,0,0,4,14,1,1,DEN,NOP,DEN,110,,,24,22,16,10
Aaron Gordon,F,22023,203932,22300024,"NOV 14, 2023",DEN vs. LAC,W,39,8,12,0.667,1,2,0.5,3,3,1.0,1,4,5,5,0,0,3,1,20,2,1,DEN,DEN,LAC,111,,,30,25,25,10
Aaron Gordon,F,22023,203932,22300182,"NOV 12, 2023",DEN @ HOU,L,39,6,10,0.6,1,2,0.5,3,6,0.5,1,7,8,5,0,2,2,2,16,8,1,DEN,HOU,DEN,104,,,29,24,21,13
Aaron Gordon,F,22023,203932,22300169,"NOV 08, 2023",DEN vs. GSW,W,34,5,14,0.357,1,2,0.5,3,4,0.75,4,7,11,3,3,1,2,2,14,12,1,DEN,DEN,GSW,108,,,28,25,17,14
Aaron Gordon,F,22023,203932,22300156,"NOV 06, 2023",DEN vs. NOP,W,36,7,11,0.636,0,2,0.0,1,2,0.5,5,7,12,6,0,1,2,1,15,8,1,DEN,DEN,NOP,134,,,33,27,21,18
Aaron Gordon,F,22023,203932,22300139,"NOV 04, 2023",DEN vs. CHI,W,35,4,9,0.444,1,3,0.333,6,8,0.75,3,9,12,5,2,1,3,2,15,26,1,DEN,DEN,CHI,123,,,32,27,20,17
Aaron Gordon,F,22023,203932,22300006,"NOV 03, 2023",DEN vs. DAL,W,35,8,17,0.471,2,6,0.333,0,0,0.0,2,6,8,6,2,1,4,2,18,22,1,DEN,DEN,DAL,125,,,32,26,24,14
Aaron Gordon,F,22023,203932,22300123,"NOV 01, 2023",DEN @ MIN,L,18,2,3,0.667,0,1,0.0,0,0,0.0,1,1,2,2,0,1,2,4,4,-13,1,DEN,MIN,DEN,89,,,8,6,6,4
Aaron Gordon,F,22023,203932,22300110,"OCT 30, 2023",DEN vs. UTA,W,33,10,12,0.833,0,0,0.0,1,4,0.25,3,4,7,2,0,0,3,2,21,8,1,DEN,DEN,UTA,110,,,30,28,23,9
Aaron Gordon,F,22023,203932,22300095,"OCT 29, 2023",DEN @ OKC,W,23,4,7,0.571,0,1,0.0,1,3,0.333,1,2,3,2,1,3,1,1,9,22,1,DEN,OKC,DEN,128,,,14,12,11,5
Aaron Gordon,F,22023,203932,22300078,"OCT 27, 2023",DEN @ MEM,W,30,5,11,0.455,0,1,0.0,0,1,0.0,1,1,2,3,3,1,1,3,10,8,1,DEN,MEM,DEN,108,,,15,12,13,5
Aaron Gordon,F,22023,203932,22300061,"OCT 24, 2023",DEN vs. LAL,W,35,7,11,0.636,1,2,0.5,0,0,0.0,2,5,7,5,2,1,0,0,15,6,1,DEN,DEN,LAL,119,,,27,22,20,12
Deandre Ayton,C,22023,1629028,22300758,"FEB 10, 2024",POR vs. NOP,L,37,9,18,0.5,0,0,0.0,0,0,0.0,6,11,17,3,2,3,3,0,18,-7,1,POR,POR,NOP,75,,,38,35,21,20
Deandre Ayton,C,22023,1629028,22300712,"FEB 04, 2024",POR @ DEN,L,39,13,19,0.684,0,0,0.0,1,1,1.0,4,5,9,4,1,2,1,1,27,5,1,POR,DEN,POR,103,,,40,36,31,13
Deandre Ayton,C,22023,1629028,22300697,"FEB 02, 2024",POR @ DEN,L,27,3,6,0.5,0,0,0.0,2,2,1.0,1,2,3,1,0,1,0,1,8,-16,1,POR,DEN,POR,108,,,12,11,9,4
Deandre Ayton,C,22023,1629028,22300683,"JAN 31, 2024",POR vs. MIL,W,35,10,17,0.588,0,0,0.0,0,0,0.0,3,8,11,1,1,1,1,3,20,-10,1,POR,POR,MIL,119,,,32,31,21,12
Deandre Ayton,C,22023,1629028,22300668,"JAN 29, 2024",POR vs. PHI,W,31,9,14,0.643,0,0,0.0,0,0,0.0,0,6,6,2,1,0,0,2,18,28,1,POR,POR,PHI,128,,,26,24,20,8
Deandre Ayton,C,22023,1629028,22300656,"JAN 28, 2024",POR vs. CHI,L,37,9,12,0.75,0,0,0.0,4,4,1.0,1,11,12,1,0,1,0,0,22,0,1,POR,POR,CHI,96,,,35,34,23,13
Deandre Ayton,C,22023,1629028,22300641,"JAN 26, 2024",POR @ SAS,L,34,10,17,0.588,0,0,0.0,0,0,0.0,2,10,12,2,2,0,2,2,20,-8,1,POR,SAS,POR,98,,,34,32,22,14
Deandre Ayton,C,22023,1629028,22300623,"JAN 24, 2024",POR @ HOU,W,41,8,13,0.615,0,0,0.0,2,2,1.0,6,11,17,3,1,2,1,3,18,15,1,POR,HOU,POR,137,,,38,35,21,20
Deandre Ayton,C,22023,1629028,22300617,"JAN 23, 2024",POR @ OKC,L,27,2,7,0.286,0,0,0.0,1,2,0.5,2,5,7,2,0,0,3,2,5,-9,1,POR,OKC,POR,109,,,14,12,7,9
Deandre Ayton,C,22023,1629028,22300605,"JAN 21, 2024",POR @ LAL,L,22,3,7,0.429,0,0,0.0,0,0,0.0,1,3,4,0,0,0,1,3,6,-17,1,POR,LAL,POR,108,,,10,10,6,4
Deandre Ayton,C,22023,1629028,22300590,"JAN 19, 2024",POR vs. IND,W,30,6,15,0.4,0,0,0.0,0,0,0.0,2,6,8,1,0,2,1,1,12,-14,1,POR,POR,IND,118,,,21,20,13,9
Deandre Ayton,C,22023,1629028,22300399,"DEC 23, 2023",POR @ GSW,L,29,6,12,0.5,0,0,0.0,1,3,0.333,1,5,6,2,3,0,1,2,13,2,1,POR,GSW,POR,106,,,21,19,15,8
Deandre Ayton,C,22023,1629028,22300381,"DEC 21, 2023",POR vs. WAS,L,35,10,21,0.476,0,0,0.0,3,4,0.75,10,6,16,2,0,1,5,3,23,-8,1,POR,POR,WAS,117,,,41,39,25,18
Deandre Ayton,C,22023,1629028,22300363,"DEC 19, 2023",POR vs. PHX,W,40,6,18,0.333,0,0,0.0,4,4,1.0,4,11,15,3,0,0,3,3,16,7,1,POR,POR,PHX,109,,,34,31,19,18
Deandre Ayton,C,22023,1629028,22300348,"DEC 17, 2023",POR vs. GSW,L,33,4,8,0.5,0,0,0.0,0,0,0.0,3,5,8,1,0,1,1,0,8,-3,1,POR,POR,GSW,114,,,17,16,9,9
Deandre Ayton,C,22023,1629028,22300341,"DEC 16, 2023",POR vs. DAL,L,27,3,5,0.6,0,0,0.0,1,2,0.5,3,7,10,2,2,0,1,3,7,1,1,POR,POR,DAL,120,,,19,17,9,12
Deandre Ayton,C,22023,1629028,22300323,"DEC 14, 2023",POR vs. UTA,L,21,6,13,0.462,0,0,0.0,2,2,1.0,5,4,9,0,1,1,4,2,14,-13,1,POR,POR,UTA,114,,,23,23,14,9
Deandre Ayton,C,22023,1629028,22300289,"DEC 02, 2023",POR @ UTA,L,35,4,8,0.5,0,0,0.0,2,2,1.0,1,10,11,0,0,0,0,3,10,-8,1,POR,UTA,POR,113,,,21,21,10,11
Deandre Ayton,C,22023,1629028,22300265,"NOV 30, 2023",POR @ CLE,W,30,5,9,0.556,0,0,0.0,0,0,0.0,2,4,6,3,0,0,3,2,10,-6,1,POR,CLE,POR,103,,,19,16,13,9
Deandre Ayton,C,22023,1629028,22300254,"NOV 27, 2023",POR @ IND,W,38,9,13,0.692,0,0,0.0,4,4,1.0,3,10,13,1,1,0,4,1,22,3,1,POR,IND,POR,114,,,36,35,23,14
Deandre Ayton,C,22023,1629028,22300245,"NOV 26, 2023",POR @ MIL,L,32,5,6,0.833,0,0,0.0,4,6,0.667,4,9,13,2,1,2,0,3,14,-13,1,POR,MIL,POR,102,,,29,27,16,15
Deandre Ayton,C,22023,1629028,22300041,"NOV 21, 2023",POR @ PHX,L,31,9,14,0.643,0,0,0.0,0,0,0.0,6,2,8,4,1,1,2,1,18,-33,1,POR,PHX,POR,107,,,30,26,22,12
Deandre Ayton,C,22023,1629028,22300215,"NOV 19, 2023",POR vs. OKC,L,24,5,7,0.714,0,0,0.0,1,2,0.5,2,3,5,2,1,1,2,0,11,-26,1,POR,POR,OKC,89,,,18,16,13,7
Deandre Ayton,C,22023,1629028,22300036,"NOV 17, 2023",POR vs. LAL,L,38,8,14,0.571,0,0,0.0,1,2,0.5,7,5,12,2,2,0,4,4,17,-7,1,POR,POR,LAL,95,,,31,29,19,14
Deandre Ayton,C,22023,1629028,22300199,"NOV 15, 2023",POR vs. CLE,L,26,3,10,0.3,0,0,0.0,0,0,0.0,2,4,6,0,0,0,2,3,6,-14,1,POR,POR,CLE,93,,,12,12,6,6
Deandre Ayton,C,22023,1629028,22300023,"NOV 14, 2023",POR @ UTA,L,34,10,17,0.588,0,0,0.0,2,2,1.0,5,5,10,3,0,0,2,1,22,-5,1,POR,UTA,POR,99,,,35,32,25,13
Deandre Ayton,C,22023,1629028,22300187,"NOV 12, 2023",POR @ LAL,L,34,6,10,0.6,0,0,0.0,0,0,0.0,0,7,7,0,0,2,2,2,12,-17,1,POR,LAL,POR,104,,,19,19,12,7
Deandre Ayton,C,22023,1629028,22300170,"NOV 08, 2023",POR @ SAC,L,41,9,14,0.643,0,0,0.0,0,0,0.0,1,9,10,2,0,0,2,5,18,7,1,POR,SAC,POR,118,,,30,28,20,12
Deandre Ayton,C,22023,1629028,22300144,"NOV 05, 2023",POR vs. MEM,L,35,3,9,0.333,0,0,0.0,0,0,0.0,2,9,11,0,2,1,3,4,6,-18,1,POR,POR,MEM,100,,,17,17,6,11
Deandre Ayton,C,22023,1629028,22300007,"NOV 03, 2023",POR vs. MEM,W,36,7,11,0.636,0,0,0.0,2,2,1.0,4,8,12,2,3,1,1,4,16,10,1,POR,POR,MEM,115,,,30,28,18,14
Deandre Ayton,C,22023,1629028,22300115,"NOV 01, 2023",POR @ DET,W,34,8,13,0.615,0,0,0.0,0,0,0.0,1,10,11,1,5,1,2,0,16,5,1,POR,DET,POR,110,,,28,27,17,12
Deandre Ayton,C,22023,1629028,22300105,"OCT 30, 2023",POR @ TOR,W,32,5,9,0.556,0,0,0.0,0,0,0.0,7,16,23,2,1,2,1,1,10,7,1,POR,TOR,POR,99,,,35,33,12,25
Deandre Ayton,C,22023,1629028,22300098,"OCT 29, 2023",POR @ PHI,L,21,3,7,0.429,0,0,0.0,1,1,1.0,2,7,9,2,2,1,0,3,7,-15,1,POR,PHI,POR,98,,,18,16,9,11
Deandre Ayton,C,22023,1629028,22300086,"OCT 27, 2023",POR vs. ORL,L,30,7,9,0.778,0,0,0.0,0,0,0.0,4,11,15,1,0,0,2,4,14,6,1,POR,POR,ORL,97,,,30,29,15,16
Deandre Ayton,C,22023,1629028,22300074,"OCT 25, 2023",POR @ LAC,L,23,2,4,0.5,0,0,0.0,0,0,0.0,3,9,12,1,3,1,3,5,4,-5,1,POR,LAC,POR,111,,,17,16,5,13
Norman Powell,G,22023,1626181,22300099,"OCT 29, 2023",LAC vs. SAS,W,19,5,11,0.455,2,5,0.4,1,2,0.5,1,2,3,1,2,1,0,1,13,8,1,LAC,LAC,SAS,123,,,17,16,14,4
Norman Powell,G,22023,1626181,22300085,"OCT 27, 2023",LAC @ UTA,L,25,7,10,0.7,2,4,0.5,4,4,1.0,0,3,3,1,1,0,1,2,20,3,1,LAC,UTA,LAC,118,,,24,23,21,4
Norman Powell,G,22023,1626181,22300074,"OCT 25, 2023",LAC vs. POR,W,23,2,6,0.333,2,5,0.4,2,2,1.0,0,3,3,1,0,0,2,0,8,-4,1,LAC,LAC,POR,123,,,12,11,9,4
Norman Powell,G,22023,1626181,22300731,"FEB 07, 2024",LAC vs. NOP,L,26,7,14,0.5,2,7,0.286,2,2,1.0,0,1,1,0,1,0,1,0,18,-12,1,LAC,LAC,NOP,106,,,19,19,18,1
Norman Powell,G,22023,1626181,22300688,"FEB 02, 2024",LAC @ DET,W,25,6,11,0.545,3,6,0.5,0,0,0.0,1,4,5,2,0,0,0,5,15,19,1,LAC,DET,LAC,136,,,22,20,17,7
Norman Powell,G,22023,1626181,22300676,"JAN 31, 2024",LAC @ WAS,W,27,5,10,0.5,3,5,0.6,1,2,0.5,1,6,7,3,0,0,2,1,14,14,1,LAC,WAS,LAC,125,,,24,21,17,10
Norman Powell,G,22023,1626181,22300658,"JAN 29, 2024",LAC @ CLE,L,28,6,13,0.462,4,7,0.571,2,4,0.5,0,3,3,2,0,0,0,2,18,-6,1,LAC,CLE,LAC,108,,,23,21,20,5
Norman Powell,G,22023,1626181,22300646,"JAN 27, 2024",LAC @ BOS,W,17,2,7,0.286,0,2,0.0,0,0,0.0,0,4,4,2,1,0,0,2,4,10,1,LAC,BOS,LAC,115,,,10,8,6,6
Norman Powell,G,22023,1626181,22300637,"JAN 26, 2024",LAC @ TOR,W,26,6,13,0.462,2,7,0.286,3,4,0.75,0,4,4,0,1,0,2,2,17,-2,1,LAC,TOR,LAC,127,,,21,21,17,4
Norman Powell,G,22023,1626181,22300537,"JAN 12, 2024",LAC @ MEM,W,24,5,8,0.625,0,2,0.0,1,1,1.0,0,5,5,0,0,0,1,2,11,11,1,LAC,MEM,LAC,128,,,16,16,11,5
Norman Powell,G,22023,1626181,22300511,"JAN 08, 2024",LAC vs. PHX,W,25,4,6,0.667,2,3,0.667,4,4,1.0,1,4,5,1,0,0,1,1,14,20,1,LAC,LAC,PHX,138,,,20,19,15,6
Norman Powell,G,22023,1626181,22300486,"JAN 05, 2024",LAC @ NOP,W,25,5,13,0.385,3,6,0.5,0,0,0.0,0,3,3,2,1,0,0,1,13,36,1,LAC,NOP,LAC,111,,,18,16,15,5
Norman Powell,G,22023,1626181,22300458,"JAN 01, 2024",LAC vs. MIA,W,33,9,11,0.818,4,5,0.8,0,0,0.0,0,2,2,2,2,0,1,4,22,13,1,LAC,LAC,MIA,121,,,26,24,24,4
Norman Powell,G,22023,1626181,22300389,"DEC 23, 2023",LAC vs. BOS,L,25,3,9,0.333,1,3,0.333,0,0,0.0,0,0,0,0,0,0,1,5,7,-10,1,LAC,LAC,BOS,108,,,7,7,7,0
Norman Powell,G,22023,1626181,22300379,"DEC 21, 2023",LAC @ OKC,L,23,6,11,0.545,4,8,0.5,0,0,0.0,1,3,4,1,0,1,1,0,16,-2,1,LAC,OKC,LAC,115,,,21,20,17,5
Norman Powell,G,22023,1626181,22300350,"DEC 18, 2023",LAC @ IND,W,30,6,11,0.545,4,6,0.667,3,3,1.0,0,3,3,0,0,0,0,1,19,23,1,LAC,IND,LAC,151,,,22,22,19,3
Norman Powell,G,22023,1626181,22300343,"DEC 16, 2023",LAC vs. NYK,W,24,6,10,0.6,1,2,0.5,3,3,1.0,0,2,2,0,0,1,1,1,16,9,1,LAC,LAC,NYK,144,,,18,18,16,2
Norman Powell,G,22023,1626181,22300618,"JAN 23, 2024",LAC vs. LAL,W,27,8,14,0.571,1,4,0.25,0,0,0.0,0,5,5,2,0,2,1,0,17,10,1,LAC,LAC,LAL,127,,,24,22,19,7
Norman Powell,G,22023,1626181,22300438,"DEC 29, 2023",LAC vs. MEM,W,25,5,12,0.417,1,4,0.25,2,2,1.0,0,6,6,1,0,0,1,2,13,-7,1,LAC,LAC,MEM,117,,,20,19,14,7
Norman Powell,G,22023,1626181,22300414,"DEC 26, 2023",LAC vs. CHA,W,28,2,7,0.286,1,5,0.2,2,2,1.0,0,3,3,0,0,0,0,1,7,5,1,LAC,LAC,CHA,113,,,10,10,7,3
Norman Powell,G,22023,1626181,22300325,"DEC 14, 2023",LAC vs. GSW,W,36,9,13,0.692,1,4,0.25,2,2,1.0,0,5,5,2,1,0,1,3,21,20,1,LAC,LAC,GSW,121,,,28,26,23,7
Norman Powell,G,22023,1626181,22300309,"DEC 12, 2023",LAC vs. SAC,W,27,5,11,0.455,2,4,0.5,3,3,1.0,0,1,1,2,0,0,1,1,15,26,1,LAC,LAC,SAC,117,,,18,16,17,3
Norman Powell,G,22023,1626181,22300304,"DEC 11, 2023",LAC vs. POR,W,25,6,9,0.667,2,4,0.5,2,2,1.0,0,3,3,1,1,2,0,4,16,3,1,LAC,LAC,POR,132,,,20,19,17,4
Norman Powell,G,22023,1626181,22301225,"DEC 08, 2023",LAC @ UTA,W,28,4,11,0.364,2,8,0.25,0,0,0.0,0,1,1,1,0,0,1,0,10,2,1,LAC,UTA,LAC,117,,,12,11,11,2
Norman Powell,G,22023,1626181,22301215,"DEC 06, 2023",LAC vs. DEN,W,32,5,12,0.417,1,3,0.333,6,6,1.0,0,5,5,2,1,0,1,0,17,24,1,LAC,LAC,DEN,111,,,24,22,19,7
Norman Powell,G,22023,1626181,22300280,"DEC 02, 2023",LAC vs. GSW,W,30,5,12,0.417,2,5,0.4,0,0,0.0,1,0,1,0,0,0,2,1,12,14,1,LAC,LAC,GSW,113,,,13,13,12,1
Norman Powell,G,22023,1626181,22300273,"NOV 30, 2023",LAC @ GSW,L,18,1,2,0.5,0,0,0.0,3,3,1.0,0,0,0,0,1,0,2,1,5,-13,1,LAC,GSW,LAC,114,,,5,5,5,0
Norman Powell,G,22023,1626181,22300264,"NOV 29, 2023",LAC @ SAC,W,13,1,6,0.167,1,2,0.5,0,0,0.0,0,1,1,0,0,0,0,1,3,0,1,LAC,SAC,LAC,131,,,4,4,3,1
Norman Powell,G,22023,1626181,22300244,"NOV 25, 2023",LAC vs. DAL,W,25,4,4,1.0,3,3,1.0,4,4,1.0,0,3,3,1,0,0,1,2,15,2,1,LAC,LAC,DAL,107,,,19,18,16,4
Norman Powell,G,22023,1626181,22300014,"NOV 10, 2023",LAC @ DAL,L,11,0,1,0.0,0,0,0.0,0,0,0.0,0,0,0,0,0,0,2,1,0,-35,1,LAC,DAL,LAC,126,,,0,0,0,0
Norman Powell,G,22023,1626181,22300151,"NOV 06, 2023",LAC @ NYK,L,22,5,7,0.714,4,6,0.667,0,0,0.0,0,1,1,0,0,1,3,1,14,-6,1,LAC,NYK,LAC,97,,,15,15,14,1
Norman Powell,G,22023,1626181,22300127,"NOV 01, 2023",LAC @ LAL,L,35,6,14,0.429,0,4,0.0,0,0,0.0,0,2,2,3,0,1,0,6,12,-14,1,LAC,LAL,LAC,125,,,17,14,15,5
Norman Powell,G,22023,1626181,22300114,"OCT 31, 2023",LAC vs. ORL,W,29,5,8,0.625,2,5,0.4,5,7,0.714,0,3,3,3,0,0,3,4,17,-2,1,LAC,LAC,ORL,118,,,23,20,20,6
Norman Powell,G,22023,1626181,22300749,"FEB 10, 2024",LAC vs. DET,W,23,1,3,0.333,0,0,0.0,0,0,0.0,0,3,3,0,1,1,0,2,2,10,1,LAC,LAC,DET,112,,,5,5,2,3
Norman Powell,G,22023,1626181,22300716,"FEB 05, 2024",LAC @ ATL,W,18,4,8,0.5,3,5,0.6,2,3,0.667,0,0,0,0,0,0,1,2,13,-9,1,LAC,ATL,LAC,149,,,13,13,13,0
Norman Powell,G,22023,1626181,22300708,"FEB 04, 2024",LAC @ MIA,W,28,6,12,0.5,2,7,0.286,2,2,1.0,0,1,1,1,0,0,0,1,16,9,1,LAC,MIA,LAC,103,,,18,17,17,2
Norman Powell,G,22023,1626181,22300600,"JAN 21, 2024",LAC vs. BKN,W,24,4,7,0.571,2,3,0.667,2,3,0.667,0,5,5,0,0,0,0,2,12,16,1,LAC,LAC,BKN,125,,,17,17,12,5
Norman Powell,G,22023,1626181,22300568,"JAN 16, 2024",LAC vs. OKC,W,19,2,10,0.2,2,7,0.286,2,4,0.5,0,0,0,1,1,0,0,3,8,-5,1,LAC,LAC,OKC,128,,,9,8,9,1
Norman Powell,G,22023,1626181,22300553,"JAN 14, 2024",LAC @ MIN,L,30,9,12,0.75,6,9,0.667,0,0,0.0,0,1,1,0,0,2,1,1,24,11,1,LAC,MIN,LAC,105,,,25,25,24,1
Norman Powell,G,22023,1626181,22300526,"JAN 10, 2024",LAC vs. TOR,W,27,4,11,0.364,3,8,0.375,2,2,1.0,0,3,3,1,0,0,0,1,13,2,1,LAC,LAC,TOR,126,,,17,16,14,4
Norman Powell,G,22023,1626181,22300505,"JAN 07, 2024",LAC @ LAL,L,25,3,12,0.25,2,5,0.4,6,6,1.0,0,0,0,0,2,0,0,1,14,-1,1,LAC,LAL,LAC,103,,,14,14,14,0
Norman Powell,G,22023,1626181,22300473,"JAN 03, 2024",LAC @ PHX,W,26,5,8,0.625,3,5,0.6,0,0,0.0,0,2,2,1,0,0,3,1,13,-6,1,LAC,PHX,LAC,131,,,16,15,14,3
Norman Powell,G,22023,1626181,22300372,"DEC 20, 2023",LAC @ DAL,W,31,7,10,0.7,3,6,0.5,4,4,1.0,0,3,3,2,1,0,1,2,21,16,1,LAC,DAL,LAC,120,,,26,24,23,5
Norman Powell,G,22023,1626181,22300235,"NOV 22, 2023",LAC @ SAS,W,14,2,4,0.5,1,1,1.0,0,1,0.0,0,1,1,0,0,1,2,1,5,1,1,LAC,SAS,LAC,109,,,6,6,5,1
Norman Powell,G,22023,1626181,22300223,"NOV 20, 2023",LAC @ SAS,W,30,5,12,0.417,2,6,0.333,7,7,1.0,0,5,5,0,2,1,1,0,19,18,1,LAC,SAS,LAC,124,,,24,24,19,5
Norman Powell,G,22023,1626181,22300179,"NOV 12, 2023",LAC vs. MEM,L,31,7,13,0.538,4,7,0.571,2,6,0.333,0,2,2,3,0,0,0,5,20,8,1,LAC,LAC,MEM,101,,,25,22,23,5
Norman Powell,G,22023,1626181,22300257,"NOV 27, 2023",LAC vs. DEN,L,21,2,8,0.25,1,5,0.2,5,5,1.0,1,1,2,1,1,1,0,3,10,-10,1,LAC,LAC,DEN,104,,,13,12,11,3
Norman Powell,G,22023,1626181,22300052,"NOV 24, 2023",LAC vs. NOP,L,28,8,14,0.571,3,5,0.6,1,1,1.0,0,1,1,0,3,0,0,1,20,-2,1,LAC,LAC,NOP,106,,,21,21,20,1
Norman Powell,G,22023,1626181,22300037,"NOV 17, 2023",LAC vs. HOU,W,30,3,11,0.273,2,5,0.4,2,2,1.0,1,2,3,3,1,1,0,2,10,-6,1,LAC,LAC,HOU,106,,,16,13,13,6
Norman Powell,G,22023,1626181,22300024,"NOV 14, 2023",LAC @ DEN,L,26,4,7,0.571,2,3,0.667,4,5,0.8,0,1,1,1,0,0,0,5,14,5,1,LAC,DEN,LAC,108,,,16,15,15,2
Norman Powell,G,22023,1626181,22300160,"NOV 08, 2023",LAC @ BKN,L,22,4,8,0.5,2,5,0.4,0,0,0.0,0,1,1,1,2,2,1,2,10,-6,1,LAC,BKN,LAC,93,,,12,11,11,2
Jrue Holiday,G,22023,201950,22300706,"FEB 04, 2024",BOS vs. MEM,W,27,2,6,0.333,1,3,0.333,2,2,1.0,0,3,3,4,1,0,2,1,7,11,1,BOS,BOS,MEM,131,12.5,Points,14,10,11,7
Jrue Holiday,G,22023,201950,22300684,"FEB 01, 2024",BOS vs. LAL,L,29,4,9,0.444,0,2,0.0,0,0,0.0,2,5,7,7,0,0,4,3,8,-9,1,BOS,BOS,LAL,105,12.5,Points,22,15,15,14
Jrue Holiday,G,22023,201950,22300646,"JAN 27, 2024",BOS vs. LAC,L,28,2,11,0.182,1,7,0.143,2,2,1.0,0,3,3,4,1,0,2,1,7,-28,1,BOS,BOS,LAC,96,12.5,Points,14,10,11,7
Jrue Holiday,G,22023,201950,22300630,"JAN 25, 2024",BOS @ MIA,W,29,7,8,0.875,3,4,0.75,0,0,0.0,0,5,5,5,0,1,3,1,17,13,1,BOS,MIA,BOS,143,12.5,Points,27,22,22,10
Jrue Holiday,G,22023,201950,22300571,"JAN 17, 2024",BOS vs. SAS,W,31,8,14,0.571,6,7,0.857,0,0,0.0,0,4,4,4,0,0,1,0,22,10,1,BOS,BOS,SAS,117,12.5,Points,30,26,26,8
Jrue Holiday,G,22023,201950,22300528,"JAN 11, 2024",BOS @ MIL,L,19,2,9,0.222,0,4,0.0,2,2,1.0,1,3,4,2,0,0,1,1,6,-31,1,BOS,MIL,BOS,102,12.5,Points,12,10,8,6
Jrue Holiday,G,22023,201950,22300507,"JAN 08, 2024",BOS @ IND,L,38,9,16,0.563,3,6,0.5,0,0,0.0,1,5,6,6,1,0,3,2,21,0,1,BOS,IND,BOS,131,12.5,Points,33,27,27,12
Jrue Holiday,G,22023,201950,22300493,"JAN 06, 2024",BOS @ IND,W,37,3,9,0.333,1,5,0.2,1,2,0.5,1,5,6,5,1,0,2,2,8,6,1,BOS,IND,BOS,118,12.5,Points,19,14,13,11
Jrue Holiday,G,22023,201950,22300479,"JAN 05, 2024",BOS vs. UTA,W,24,6,8,0.75,2,3,0.667,0,0,0.0,1,5,6,1,0,2,2,1,14,22,1,BOS,BOS,UTA,126,12.5,Points,21,20,15,7
Jrue Holiday,G,22023,201950,22300432,"DEC 29, 2023",BOS vs. TOR,W,32,5,15,0.333,3,5,0.6,2,4,0.5,0,2,2,3,0,0,1,1,15,8,1,BOS,BOS,TOR,120,12.5,Points,20,17,18,5
Jrue Holiday,G,22023,201950,22300389,"DEC 23, 2023",BOS @ LAC,W,28,8,12,0.667,4,6,0.667,0,0,0.0,3,3,6,7,1,0,1,1,20,22,1,BOS,LAC,BOS,142,12.5,Points,33,26,27,13
Jrue Holiday,G,22023,201950,22300344,"DEC 17, 2023",BOS vs. ORL,W,34,6,12,0.5,2,5,0.4,0,0,0.0,1,5,6,0,0,2,3,2,14,17,1,BOS,BOS,ORL,114,12.5,Points,20,20,14,6
Jrue Holiday,G,22023,201950,22301227,"DEC 08, 2023",BOS vs. NYK,W,35,7,11,0.636,1,3,0.333,1,1,1.0,0,6,6,5,2,1,1,1,16,7,1,BOS,BOS,NYK,133,12.5,Points,27,22,21,11
Jrue Holiday,G,22023,201950,22301202,"DEC 04, 2023",BOS @ IND,L,38,3,9,0.333,1,5,0.2,2,2,1.0,1,5,6,3,1,1,1,1,9,-15,1,BOS,IND,BOS,112,12.5,Points,18,15,12,9
Jrue Holiday,G,22023,201950,22300275,"DEC 01, 2023",BOS vs. PHI,W,35,4,11,0.364,3,5,0.6,2,2,1.0,0,5,5,6,1,0,3,2,13,7,1,BOS,BOS,PHI,125,12.5,Points,24,18,19,11
Jrue Holiday,G,22023,201950,22300053,"NOV 28, 2023",BOS vs. CHI,W,33,5,8,0.625,4,5,0.8,0,0,0.0,1,6,7,9,1,0,3,3,14,19,1,BOS,BOS,CHI,124,12.5,Points,30,21,23,16
Jrue Holiday,G,22023,201950,22300194,"NOV 15, 2023",BOS @ PHI,W,35,8,18,0.444,2,9,0.222,0,1,0.0,2,8,10,3,1,2,1,0,18,16,1,BOS,PHI,BOS,117,12.5,Points,31,28,21,13
Jrue Holiday,G,22023,201950,22300174,"NOV 11, 2023",BOS vs. TOR,W,30,4,9,0.444,0,2,0.0,0,0,0.0,0,3,3,7,1,2,4,2,8,22,1,BOS,BOS,TOR,117,12.5,Points,18,11,15,10
Jrue Holiday,G,22023,201950,22300010,"NOV 10, 2023",BOS vs. BKN,W,33,6,14,0.429,1,5,0.2,0,0,0.0,3,9,12,9,2,0,0,2,13,26,1,BOS,BOS,BKN,121,12.5,Points,34,25,22,21
Jrue Holiday,G,22023,201950,22300118,"NOV 01, 2023",BOS vs. IND,W,25,6,9,0.667,3,4,0.75,0,0,0.0,0,7,7,4,0,1,1,0,15,20,1,BOS,BOS,IND,155,12.5,Points,26,22,19,11
Jrue Holiday,G,22023,201950,22300103,"OCT 30, 2023",BOS @ WAS,W,27,4,7,0.571,1,3,0.333,2,2,1.0,1,4,5,3,1,2,1,1,11,28,1,BOS,WAS,BOS,126,12.5,Points,19,16,14,8
Jrue Holiday,G,22023,201950,22300670,"JAN 30, 2024",BOS vs. IND,W,39,6,8,0.75,3,3,1.0,2,2,1.0,0,5,5,4,1,3,1,0,17,2,1,BOS,BOS,IND,129,12.5,Points,26,22,21,9
Jrue Holiday,G,22023,201950,22300659,"JAN 29, 2024",BOS vs. NOP,W,33,7,11,0.636,3,5,0.6,3,4,0.75,2,1,3,2,1,0,1,1,20,-4,1,BOS,BOS,NOP,118,12.5,Points,25,23,22,5
Jrue Holiday,G,22023,201950,22300563,"JAN 15, 2024",BOS @ TOR,W,34,7,14,0.5,4,6,0.667,4,4,1.0,1,5,6,7,1,2,1,2,22,4,1,BOS,TOR,BOS,105,12.5,Points,35,28,29,13
Jrue Holiday,G,22023,201950,22300542,"JAN 13, 2024",BOS vs. HOU,W,26,4,10,0.4,1,4,0.25,2,2,1.0,2,4,6,3,0,0,1,2,11,22,1,BOS,BOS,HOU,145,12.5,Points,20,17,14,9
Jrue Holiday,G,22023,201950,22300517,"JAN 10, 2024",BOS vs. MIN,W,40,5,15,0.333,2,10,0.2,0,0,0.0,1,4,5,4,2,1,2,3,12,8,1,BOS,BOS,MIN,127,12.5,Points,21,17,16,9
Jrue Holiday,G,22023,201950,22300421,"DEC 28, 2023",BOS vs. DET,W,44,4,9,0.444,0,2,0.0,4,5,0.8,2,7,9,3,1,1,3,1,12,1,1,BOS,BOS,DET,128,12.5,Points,24,21,15,12
Jrue Holiday,G,22023,201950,22300373,"DEC 20, 2023",BOS @ SAC,W,34,7,13,0.538,4,6,0.667,3,3,1.0,2,6,8,10,2,1,3,1,21,17,1,BOS,SAC,BOS,144,12.5,Points,39,29,31,18
Jrue Holiday,G,22023,201950,22300362,"DEC 19, 2023",BOS @ GSW,L,36,5,12,0.417,1,5,0.2,2,2,1.0,1,6,7,1,2,0,1,5,13,-14,1,BOS,GSW,BOS,126,12.5,Points,21,20,14,8
Jrue Holiday,G,22023,201950,22300329,"DEC 15, 2023",BOS vs. ORL,W,28,2,7,0.286,2,3,0.667,0,0,0.0,1,3,4,4,2,1,0,2,6,12,1,BOS,BOS,ORL,128,12.5,Points,14,10,10,8
Jrue Holiday,G,22023,201950,22300217,"NOV 20, 2023",BOS @ CHA,L,37,5,11,0.455,1,3,0.333,0,2,0.0,3,3,6,5,1,2,7,1,11,-4,1,BOS,CHA,BOS,118,12.5,Points,22,17,16,11
Jrue Holiday,G,22023,201950,22300136,"NOV 04, 2023",BOS @ BKN,W,40,6,15,0.4,4,9,0.444,2,2,1.0,4,5,9,10,0,1,3,1,18,14,1,BOS,BKN,BOS,124,12.5,Points,37,27,28,19
Jrue Holiday,G,22023,201950,22300080,"OCT 27, 2023",BOS vs. MIA,W,36,7,13,0.538,1,4,0.25,2,2,1.0,2,8,10,7,0,1,1,2,17,4,1,BOS,BOS,MIA,119,12.5,Points,34,27,24,17
Jrue Holiday,G,22023,201950,22300743,"FEB 09, 2024",BOS vs. WAS,W,34,9,13,0.692,2,2,1.0,0,0,0.0,3,4,7,5,1,0,2,2,20,-11,1,BOS,BOS,WAS,133,12.5,Points,32,27,25,12
Jrue Holiday,G,22023,201950,22300611,"JAN 22, 2024",BOS @ DAL,W,38,6,13,0.462,5,12,0.417,0,0,0.0,0,7,7,6,0,1,1,2,17,19,1,BOS,DAL,BOS,119,12.5,Points,30,24,23,13
Jrue Holiday,G,22023,201950,22300586,"JAN 19, 2024",BOS vs. DEN,L,30,3,7,0.429,1,3,0.333,0,0,0.0,1,1,2,3,0,0,1,0,7,-12,1,BOS,BOS,DEN,100,12.5,Points,12,9,10,5
Jrue Holiday,G,22023,201950,22300462,"JAN 02, 2024",BOS @ OKC,L,31,2,8,0.25,2,5,0.4,1,2,0.5,1,4,5,7,1,0,3,1,7,-15,1,BOS,OKC,BOS,123,12.5,Points,19,12,14,12
Jrue Holiday,G,22023,201950,22300403,"DEC 25, 2023",BOS @ LAL,W,38,7,10,0.7,3,5,0.6,1,1,1.0,2,5,7,7,1,1,2,1,18,15,1,BOS,LAL,BOS,126,12.5,Points,32,25,25,14
Jrue Holiday,G,22023,201950,22300319,"DEC 14, 2023",BOS vs. CLE,W,37,7,11,0.636,1,3,0.333,0,0,0.0,2,1,3,4,0,0,2,2,15,11,1,BOS,BOS,CLE,116,12.5,Points,22,18,19,7
Jrue Holiday,G,22023,201950,22300305,"DEC 12, 2023",BOS vs. CLE,W,34,4,7,0.571,3,5,0.6,0,0,0.0,2,2,4,2,3,1,1,3,11,2,1,BOS,BOS,CLE,120,12.5,Points,17,15,13,6
Jrue Holiday,G,22023,201950,22300228,"NOV 22, 2023",BOS vs. MIL,W,35,1,8,0.125,1,5,0.2,2,2,1.0,1,7,8,1,1,1,2,3,5,-1,1,BOS,BOS,MIL,119,12.5,Points,14,13,6,9
Jrue Holiday,G,22023,201950,22300213,"NOV 19, 2023",BOS @ MEM,W,37,2,7,0.286,1,3,0.333,2,2,1.0,2,4,6,4,0,0,2,1,7,-9,1,BOS,MEM,BOS,102,12.5,Points,17,13,11,10
Jrue Holiday,G,22023,201950,22300031,"NOV 17, 2023",BOS @ TOR,W,35,5,14,0.357,2,4,0.5,2,2,1.0,2,6,8,5,0,0,1,2,14,-2,1,BOS,TOR,BOS,108,12.5,Points,27,22,19,13
Jrue Holiday,G,22023,201950,22300188,"NOV 13, 2023",BOS vs. NYK,W,37,5,9,0.556,3,5,0.6,1,1,1.0,4,3,7,2,0,0,2,2,14,5,1,BOS,BOS,NYK,114,12.5,Points,23,21,16,9
Jrue Holiday,G,22023,201950,22300159,"NOV 08, 2023",BOS @ PHI,L,35,4,9,0.444,2,3,0.667,2,2,1.0,1,4,5,5,1,0,2,1,12,13,1,BOS,PHI,BOS,103,12.5,Points,22,17,17,10
Jrue Holiday,G,22023,201950,22300154,"NOV 06, 2023",BOS @ MIN,L,42,4,16,0.25,0,4,0.0,4,6,0.667,3,8,11,6,1,0,3,3,12,-19,1,BOS,MIN,BOS,109,12.5,Points,29,23,18,17
Jrue Holiday,G,22023,201950,22300065,"OCT 25, 2023",BOS @ NYK,W,35,4,10,0.4,1,5,0.2,0,0,0.0,2,2,4,2,0,3,2,3,9,3,1,BOS,NYK,BOS,108,12.5,Points,15,13,11,6
Rudy Gobert,C,22023,203497,22300738,"FEB 08, 2024",MIN @ MIL,W,35,8,9,0.889,0,0,0.0,0,1,0.0,3,8,11,4,1,0,0,3,16,13,1,MIN,MIL,MIN,129,,,31,27,20,15
Rudy Gobert,C,22023,203497,22300723,"FEB 06, 2024",MIN @ CHI,L,44,3,6,0.5,0,0,0.0,6,10,0.6,7,9,16,1,1,1,1,5,12,-8,1,MIN,CHI,MIN,123,,,29,28,13,17
Rudy Gobert,C,22023,203497,22300709,"FEB 04, 2024",MIN vs. HOU,W,31,7,9,0.778,0,0,0.0,3,5,0.6,3,10,13,1,1,4,0,1,17,32,1,MIN,MIN,HOU,111,,,31,30,18,14
Rudy Gobert,C,22023,203497,22300694,"FEB 02, 2024",MIN vs. ORL,L,39,6,7,0.857,0,0,0.0,10,11,0.909,3,13,16,2,0,2,1,5,22,0,1,MIN,MIN,ORL,106,,,40,38,24,18
Rudy Gobert,C,22023,203497,22300680,"JAN 31, 2024",MIN vs. DAL,W,28,5,9,0.556,0,0,0.0,7,12,0.583,2,4,6,0,0,2,2,4,17,18,1,MIN,MIN,DAL,121,,,23,23,17,6
Rudy Gobert,C,22023,203497,22300664,"JAN 29, 2024",MIN @ OKC,W,36,6,6,1.0,0,0,0.0,0,1,0.0,4,14,18,1,1,1,3,0,12,11,1,MIN,OKC,MIN,107,,,31,30,13,19
Rudy Gobert,C,22023,203497,22300649,"JAN 27, 2024",MIN @ SAS,L,37,8,9,0.889,0,0,0.0,3,4,0.75,2,5,7,1,1,1,1,4,19,-4,1,MIN,SAS,MIN,112,,,27,26,20,8
Rudy Gobert,C,22023,203497,22300629,"JAN 25, 2024",MIN @ BKN,W,33,4,9,0.444,0,0,0.0,2,2,1.0,1,12,13,1,1,2,1,3,10,3,1,MIN,BKN,MIN,96,,,24,23,11,14
Rudy Gobert,C,22023,203497,22300620,"JAN 24, 2024",MIN @ WAS,W,35,7,11,0.636,0,0,0.0,5,6,0.833,7,9,16,1,0,4,0,4,19,9,1,MIN,WAS,MIN,118,,,36,35,20,17
Rudy Gobert,C,22023,203497,22300610,"JAN 22, 2024",MIN vs. CHA,L,39,6,6,1.0,0,0,0.0,1,2,0.5,2,9,11,1,0,0,0,3,13,-10,1,MIN,MIN,CHA,125,,,25,24,14,12
Rudy Gobert,C,22023,203497,22300599,"JAN 20, 2024",MIN vs. OKC,L,33,1,6,0.167,0,0,0.0,5,8,0.625,4,14,18,2,0,0,2,4,7,-4,1,MIN,MIN,OKC,97,,,27,25,9,20
Rudy Gobert,C,22023,203497,22300582,"JAN 18, 2024",MIN vs. MEM,W,39,5,10,0.5,0,1,0.0,7,10,0.7,3,7,10,4,0,6,3,3,17,20,1,MIN,MIN,MEM,118,,,31,27,21,14
Rudy Gobert,C,22023,203497,22300569,"JAN 17, 2024",MIN @ DET,W,38,8,11,0.727,0,0,0.0,3,4,0.75,5,11,16,2,0,1,1,4,19,12,1,MIN,DET,MIN,124,,,37,35,21,18
Rudy Gobert,C,22023,203497,22300553,"JAN 14, 2024",MIN vs. LAC,W,37,4,5,0.8,0,0,0.0,7,14,0.5,3,15,18,0,0,4,1,4,15,-1,1,MIN,MIN,LAC,109,,,33,33,15,18
Rudy Gobert,C,22023,203497,22300538,"JAN 12, 2024",MIN vs. POR,W,28,9,11,0.818,0,0,0.0,6,8,0.75,5,12,17,0,0,2,1,2,24,33,1,MIN,MIN,POR,116,,,41,41,24,17
Rudy Gobert,C,22023,203497,22300513,"JAN 09, 2024",MIN @ ORL,W,34,8,10,0.8,0,0,0.0,5,6,0.833,1,11,12,1,1,3,2,3,21,13,1,MIN,ORL,MIN,113,,,34,33,22,13
Rudy Gobert,C,22023,203497,22300501,"JAN 07, 2024",MIN @ DAL,L,34,4,9,0.444,0,0,0.0,1,4,0.25,6,11,17,1,1,0,5,4,9,1,1,MIN,DAL,MIN,108,,,27,26,10,18
Rudy Gobert,C,22023,203497,22300485,"JAN 05, 2024",MIN @ HOU,W,33,6,7,0.857,0,0,0.0,1,3,0.333,3,9,12,1,2,2,1,2,13,22,1,MIN,HOU,MIN,122,,,26,25,14,13
Rudy Gobert,C,22023,203497,22300471,"JAN 03, 2024",MIN vs. NOP,L,24,2,3,0.667,0,0,0.0,1,2,0.5,1,4,5,0,0,1,1,4,5,-16,1,MIN,MIN,NOP,106,,,10,10,5,5
Rudy Gobert,C,22023,203497,22300451,"JAN 01, 2024",MIN @ NYK,L,38,3,8,0.375,0,0,0.0,4,6,0.667,2,13,15,1,0,0,1,2,10,-11,1,MIN,NYK,MIN,106,,,26,25,11,16
Rudy Gobert,C,22023,203497,22300443,"DEC 30, 2023",MIN vs. LAL,W,38,6,7,0.857,0,0,0.0,1,1,1.0,4,9,13,0,2,1,4,3,13,19,1,MIN,MIN,LAL,108,,,26,26,13,13
Rudy Gobert,C,22023,203497,22300423,"DEC 28, 2023",MIN vs. DAL,W,38,7,7,1.0,0,0,0.0,6,7,0.857,2,9,11,2,0,3,2,2,20,3,1,MIN,MIN,DAL,118,,,33,31,22,13
Rudy Gobert,C,22023,203497,22300411,"DEC 26, 2023",MIN @ OKC,L,29,2,6,0.333,0,1,0.0,6,8,0.75,0,5,5,0,0,0,1,1,10,-14,1,MIN,OKC,MIN,106,,,15,15,10,5
Rudy Gobert,C,22023,203497,22300400,"DEC 23, 2023",MIN @ SAC,W,39,10,13,0.769,0,0,0.0,1,2,0.5,6,11,17,1,0,2,1,3,21,27,1,MIN,SAC,MIN,110,,,39,38,22,18
Rudy Gobert,C,22023,203497,22300380,"DEC 21, 2023",MIN vs. LAL,W,37,6,11,0.545,0,0,0.0,3,6,0.5,5,8,13,3,1,3,2,3,15,-1,1,MIN,MIN,LAL,118,,,31,28,18,16
Rudy Gobert,C,22023,203497,22300367,"DEC 20, 2023",MIN @ PHI,L,24,3,4,0.75,0,0,0.0,2,2,1.0,2,7,9,1,2,0,0,4,8,6,1,MIN,PHI,MIN,113,,,18,17,9,10
Rudy Gobert,C,22023,203497,22300353,"DEC 18, 2023",MIN @ MIA,W,35,3,8,0.375,0,0,0.0,3,4,0.75,3,13,16,2,2,2,1,2,9,4,1,MIN,MIA,MIN,112,,,27,25,11,18
Rudy Gobert,C,22023,203497,22300338,"DEC 16, 2023",MIN vs. IND,W,25,2,3,0.667,0,0,0.0,1,4,0.25,2,5,7,1,1,1,2,1,5,3,1,MIN,MIN,IND,127,,,13,12,6,8
Rudy Gobert,C,22023,203497,22300321,"DEC 14, 2023",MIN @ DAL,W,30,3,4,0.75,0,0,0.0,2,6,0.333,2,10,12,5,3,1,2,4,8,11,1,MIN,DAL,MIN,119,,,25,20,13,17
Rudy Gobert,C,22023,203497,22300301,"DEC 11, 2023",MIN @ NOP,L,25,4,8,0.5,0,0,0.0,0,0,0.0,2,6,8,0,0,2,2,4,8,-20,1,MIN,NOP,MIN,107,,,16,16,8,8
Rudy Gobert,C,22023,203497,22301221,"DEC 08, 2023",MIN @ MEM,W,36,6,9,0.667,0,0,0.0,4,4,1.0,9,11,20,1,1,6,2,4,16,25,1,MIN,MEM,MIN,127,,,37,36,17,21
Rudy Gobert,C,22023,203497,22301210,"DEC 06, 2023",MIN vs. SAS,W,30,7,8,0.875,0,0,0.0,2,2,1.0,5,15,20,2,0,2,1,3,16,31,1,MIN,MIN,SAS,102,,,38,36,18,22
Rudy Gobert,C,22023,203497,22300281,"DEC 02, 2023",MIN @ CHA,W,39,10,12,0.833,0,0,0.0,6,9,0.667,2,10,12,0,0,3,1,1,26,10,1,MIN,CHA,MIN,123,,,38,38,26,12
Rudy Gobert,C,22023,203497,22300270,"NOV 30, 2023",MIN vs. UTA,W,37,6,11,0.545,0,0,0.0,3,4,0.75,3,10,13,0,0,3,0,4,15,15,1,MIN,MIN,UTA,101,,,28,28,15,13
Rudy Gobert,C,22023,203497,22300058,"NOV 28, 2023",MIN vs. OKC,W,36,6,10,0.6,0,0,0.0,5,6,0.833,6,10,16,0,1,4,1,1,17,-1,1,MIN,MIN,OKC,106,,,33,33,17,16
Rudy Gobert,C,22023,203497,22300249,"NOV 26, 2023",MIN @ MEM,W,25,5,7,0.714,0,0,0.0,3,4,0.75,1,3,4,0,0,2,2,5,13,16,1,MIN,MEM,MIN,119,,,17,17,13,4
Rudy Gobert,C,22023,203497,22300050,"NOV 24, 2023",MIN vs. SAC,L,36,5,8,0.625,0,0,0.0,2,2,1.0,3,8,11,0,0,2,3,5,12,4,1,MIN,MIN,SAC,111,,,23,23,12,11
Rudy Gobert,C,22023,203497,22300232,"NOV 22, 2023",MIN vs. PHI,W,31,6,8,0.75,0,0,0.0,1,2,0.5,3,8,11,3,0,3,2,3,13,1,1,MIN,MIN,PHI,112,,,27,24,16,14
Rudy Gobert,C,22023,203497,22300221,"NOV 20, 2023",MIN vs. NYK,W,26,7,7,1.0,0,0,0.0,2,7,0.286,3,4,7,1,0,2,1,2,16,16,1,MIN,MIN,NYK,117,,,24,23,17,8
Rudy Gobert,C,22023,203497,22300203,"NOV 18, 2023",MIN @ NOP,W,34,5,7,0.714,0,0,0.0,7,10,0.7,2,9,11,1,2,1,1,2,17,-7,1,MIN,NOP,MIN,121,,,29,28,18,12
Rudy Gobert,C,22023,203497,22300197,"NOV 15, 2023",MIN @ PHX,L,25,2,5,0.4,0,0,0.0,0,0,0.0,4,4,8,2,1,2,2,2,4,-25,1,MIN,PHX,MIN,115,,,14,12,6,10
Rudy Gobert,C,22023,203497,22300025,"NOV 14, 2023",MIN @ GSW,W,35,2,8,0.25,0,0,0.0,5,6,0.833,6,7,13,2,0,3,2,4,9,8,1,MIN,GSW,MIN,104,,,24,22,11,15
Rudy Gobert,C,22023,203497,22300186,"NOV 12, 2023",MIN @ GSW,W,35,4,7,0.571,0,0,0.0,2,8,0.25,4,6,10,3,1,5,2,3,10,-1,1,MIN,GSW,MIN,116,,,23,20,13,13
Rudy Gobert,C,22023,203497,22300013,"NOV 10, 2023",MIN @ SAS,W,34,5,10,0.5,0,0,0.0,1,1,1.0,4,6,10,1,1,0,1,3,11,1,1,MIN,SAS,MIN,117,,,22,21,12,11
Rudy Gobert,C,22023,203497,22300166,"NOV 08, 2023",MIN vs. NOP,W,32,4,5,0.8,0,0,0.0,9,12,0.75,5,16,21,1,0,2,4,2,17,24,1,MIN,MIN,NOP,122,,,39,38,18,22
Rudy Gobert,C,22023,203497,22300154,"NOV 06, 2023",MIN vs. BOS,W,41,6,6,1.0,0,0,0.0,2,11,0.182,2,10,12,1,0,1,2,4,14,24,1,MIN,MIN,BOS,114,,,27,26,15,13
Rudy Gobert,C,22023,203497,22300138,"NOV 04, 2023",MIN vs. UTA,W,29,5,10,0.5,0,0,0.0,1,2,0.5,4,6,10,1,0,4,1,3,11,10,1,MIN,MIN,UTA,123,,,22,21,12,11
Rudy Gobert,C,22023,203497,22300123,"NOV 01, 2023",MIN vs. DEN,W,32,0,7,0.0,0,0,0.0,4,4,1.0,2,10,12,1,1,2,1,3,4,15,1,MIN,MIN,DEN,110,,,17,16,5,13
Rudy Gobert,C,22023,203497,22300104,"OCT 30, 2023",MIN @ ATL,L,31,3,7,0.429,0,0,0.0,8,11,0.727,6,7,13,1,1,2,0,2,14,-13,1,MIN,ATL,MIN,113,,,28,27,15,14
Rudy Gobert,C,22023,203497,22300093,"OCT 28, 2023",MIN vs. MIA,W,31,7,9,0.778,0,0,0.0,0,0,0.0,4,10,14,1,1,0,2,1,14,14,1,MIN,MIN,MIA,106,,,29,28,15,15
Rudy Gobert,C,22023,203497,22300069,"OCT 25, 2023",MIN @ TOR,L,32,6,12,0.5,0,0,0.0,3,5,0.6,5,8,13,1,2,4,2,3,15,-11,1,MIN,TOR,MIN,94,,,29,28,16,14
Jabari Smith Jr.,F,22023,1631095,22300754,"FEB 10, 2024",HOU @ ATL,L,37,4,15,0.267,1,7,0.143,0,0,0.0,2,8,10,2,4,4,3,2,9,-6,1,HOU,ATL,HOU,113,,,21,19,11,12
Jabari Smith Jr.,F,22023,1631095,22300744,"FEB 09, 2024",HOU @ TOR,L,33,5,11,0.455,2,6,0.333,0,0,0.0,5,5,10,2,0,0,2,2,12,2,1,HOU,TOR,HOU,104,,,24,22,14,12
Jabari Smith Jr.,F,22023,1631095,22300719,"FEB 06, 2024",HOU @ IND,L,40,8,15,0.533,2,4,0.5,2,2,1.0,5,4,9,0,0,0,3,1,20,8,1,HOU,IND,HOU,129,,,29,29,20,9
Jabari Smith Jr.,F,22023,1631095,22300709,"FEB 04, 2024",HOU @ MIN,L,19,1,4,0.25,1,2,0.5,0,0,0.0,0,2,2,0,1,0,0,5,3,-14,1,HOU,MIN,HOU,90,,,5,5,3,2
Jabari Smith Jr.,F,22023,1631095,22300692,"FEB 02, 2024",HOU vs. TOR,W,24,4,9,0.444,2,5,0.4,1,1,1.0,1,2,3,1,0,0,1,0,11,8,1,HOU,HOU,TOR,135,,,15,14,12,4
Jabari Smith Jr.,F,22023,1631095,22300679,"JAN 31, 2024",HOU vs. NOP,L,22,0,6,0.0,0,4,0.0,0,0,0.0,0,1,1,0,1,0,0,2,0,-19,1,HOU,HOU,NOP,99,,,1,1,0,1
Jabari Smith Jr.,F,22023,1631095,22300662,"JAN 29, 2024",HOU vs. LAL,W,36,8,13,0.615,2,5,0.4,0,0,0.0,2,7,9,4,3,1,1,1,18,11,1,HOU,HOU,LAL,135,,,31,27,22,13
Jabari Smith Jr.,F,22023,1631095,22300598,"JAN 20, 2024",HOU vs. UTA,W,41,9,19,0.474,4,8,0.5,2,4,0.5,4,6,10,1,2,1,0,2,24,2,1,HOU,HOU,UTA,127,,,35,34,25,11
Jabari Smith Jr.,F,22023,1631095,22300573,"JAN 17, 2024",HOU @ NYK,L,31,5,9,0.556,1,2,0.5,0,0,0.0,2,4,6,1,1,0,0,2,11,-20,1,HOU,NYK,HOU,94,,,18,17,12,7
Jabari Smith Jr.,F,22023,1631095,22300555,"JAN 15, 2024",HOU @ PHI,L,31,5,9,0.556,0,1,0.0,3,5,0.6,1,6,7,2,0,0,2,3,13,-8,1,HOU,PHI,HOU,115,,,22,20,15,9
Jabari Smith Jr.,F,22023,1631095,22300542,"JAN 13, 2024",HOU @ BOS,L,27,4,11,0.364,0,4,0.0,1,1,1.0,1,5,6,2,0,0,2,2,9,-20,1,HOU,BOS,HOU,113,,,17,15,11,8
Jabari Smith Jr.,F,22023,1631095,22300409,"DEC 26, 2023",HOU vs. IND,L,34,4,11,0.364,0,5,0.0,2,2,1.0,2,4,6,0,1,1,0,4,10,-13,1,HOU,HOU,IND,117,,,16,16,10,6
Jabari Smith Jr.,F,22023,1631095,22300392,"DEC 23, 2023",HOU @ NOP,W,37,10,14,0.714,4,5,0.8,2,3,0.667,4,7,11,2,1,1,1,3,26,1,1,HOU,NOP,HOU,106,,,39,37,28,13
Jabari Smith Jr.,F,22023,1631095,22300385,"DEC 22, 2023",HOU vs. DAL,W,31,8,13,0.615,1,3,0.333,4,5,0.8,2,6,8,1,0,0,1,0,21,37,1,HOU,HOU,DAL,122,,,30,29,22,9
Jabari Smith Jr.,F,22023,1631095,22300371,"DEC 20, 2023",HOU vs. ATL,L,42,8,14,0.571,4,7,0.571,14,14,1.0,5,8,13,1,0,4,0,3,34,3,1,HOU,HOU,ATL,127,,,48,47,35,14
Jabari Smith Jr.,F,22023,1631095,22300349,"DEC 18, 2023",HOU @ CLE,L,23,2,7,0.286,1,4,0.25,0,0,0.0,3,4,7,0,0,0,2,4,5,-17,1,HOU,CLE,HOU,130,,,12,12,5,7
Jabari Smith Jr.,F,22023,1631095,22300346,"DEC 17, 2023",HOU @ MIL,L,28,7,13,0.538,1,4,0.25,1,1,1.0,0,5,5,2,0,1,0,5,16,-4,1,HOU,MIL,HOU,119,,,23,21,18,7
Jabari Smith Jr.,F,22023,1631095,22300332,"DEC 15, 2023",HOU @ MEM,W,30,1,9,0.111,1,4,0.25,2,2,1.0,3,9,12,2,0,1,1,5,5,-2,1,HOU,MEM,HOU,103,,,19,17,7,14
Jabari Smith Jr.,F,22023,1631095,22300314,"DEC 13, 2023",HOU vs. MEM,W,30,7,10,0.7,3,5,0.6,3,6,0.5,2,8,10,1,1,1,1,2,20,11,1,HOU,HOU,MEM,117,,,31,30,21,11
Jabari Smith Jr.,F,22023,1631095,22300298,"DEC 11, 2023",HOU vs. SAS,W,36,3,12,0.25,1,3,0.333,2,2,1.0,3,9,12,5,1,1,1,3,9,15,1,HOU,HOU,SAS,93,,,26,21,14,17
Jabari Smith Jr.,F,22023,1631095,22301224,"DEC 08, 2023",HOU @ DEN,W,25,3,9,0.333,0,2,0.0,3,4,0.75,4,6,10,5,0,0,1,1,9,-2,1,HOU,DEN,HOU,114,,,24,19,14,15
Jabari Smith Jr.,F,22023,1631095,22301212,"DEC 06, 2023",HOU vs. OKC,W,32,2,4,0.5,1,1,1.0,1,1,1.0,4,14,18,1,0,0,3,1,6,9,1,HOU,HOU,OKC,110,,,25,24,7,19
Jabari Smith Jr.,F,22023,1631095,22300291,"DEC 02, 2023",HOU @ LAL,L,30,4,7,0.571,0,3,0.0,2,2,1.0,1,8,9,3,2,3,3,5,10,-16,1,HOU,LAL,HOU,97,,,22,19,13,12
Jabari Smith Jr.,F,22023,1631095,22300263,"NOV 29, 2023",HOU @ DEN,L,32,6,14,0.429,2,7,0.286,1,2,0.5,1,6,7,2,0,1,0,3,15,-22,1,HOU,DEN,HOU,124,,,24,22,17,9
Jabari Smith Jr.,F,22023,1631095,22300059,"NOV 28, 2023",HOU @ DAL,L,37,7,11,0.636,2,5,0.4,0,0,0.0,1,8,9,2,0,1,1,2,16,-5,1,HOU,DAL,HOU,115,,,27,25,18,11
Jabari Smith Jr.,F,22023,1631095,22300048,"NOV 24, 2023",HOU vs. DEN,W,38,6,9,0.667,2,3,0.667,2,2,1.0,3,12,15,1,1,1,2,2,16,16,1,HOU,HOU,DEN,105,,,32,31,17,16
Jabari Smith Jr.,F,22023,1631095,22300231,"NOV 22, 2023",HOU vs. MEM,W,27,6,10,0.6,3,4,0.75,3,4,0.75,0,9,9,2,0,1,0,2,18,4,1,HOU,HOU,MEM,111,,,29,27,20,11
Jabari Smith Jr.,F,22023,1631095,22300224,"NOV 20, 2023",HOU @ GSW,L,32,7,12,0.583,1,5,0.2,2,2,1.0,2,7,9,2,1,2,2,4,17,1,1,HOU,GSW,HOU,116,,,28,26,19,11
Jabari Smith Jr.,F,22023,1631095,22300216,"NOV 19, 2023",HOU @ LAL,L,32,5,10,0.5,2,6,0.333,2,2,1.0,1,4,5,1,1,0,3,4,14,-5,1,HOU,LAL,HOU,104,,,20,19,15,6
Jabari Smith Jr.,F,22023,1631095,22300037,"NOV 17, 2023",HOU @ LAC,L,33,4,12,0.333,1,4,0.25,0,0,0.0,2,5,7,0,1,1,0,5,9,-3,1,HOU,LAC,HOU,100,,,16,16,9,7
Jabari Smith Jr.,F,22023,1631095,22300182,"NOV 12, 2023",HOU vs. DEN,W,20,4,7,0.571,0,2,0.0,0,0,0.0,2,5,7,0,0,1,1,1,8,-6,1,HOU,HOU,DEN,107,,,15,15,8,7
Jabari Smith Jr.,F,22023,1631095,22300011,"NOV 10, 2023",HOU vs. NOP,W,23,2,8,0.25,1,4,0.25,1,1,1.0,1,6,7,2,0,0,2,3,6,-8,1,HOU,HOU,NOP,104,,,15,13,8,9
Jabari Smith Jr.,F,22023,1631095,22300163,"NOV 08, 2023",HOU vs. LAL,W,26,4,8,0.5,2,4,0.5,2,2,1.0,1,5,6,0,1,0,2,2,12,19,1,HOU,HOU,LAL,128,,,18,18,12,6
Jabari Smith Jr.,F,22023,1631095,22300153,"NOV 06, 2023",HOU vs. SAC,W,22,5,8,0.625,3,5,0.6,0,0,0.0,0,4,4,0,0,1,0,4,13,10,1,HOU,HOU,SAC,122,,,17,17,13,4
Jabari Smith Jr.,F,22023,1631095,22300137,"NOV 04, 2023",HOU vs. SAC,W,35,9,15,0.6,3,6,0.5,0,0,0.0,3,8,11,0,0,1,0,4,21,4,1,HOU,HOU,SAC,107,,,32,32,21,11
Jabari Smith Jr.,F,22023,1631095,22300122,"NOV 01, 2023",HOU vs. CHA,W,30,7,10,0.7,3,5,0.6,0,0,0.0,0,6,6,4,0,1,2,3,17,-1,1,HOU,HOU,CHA,128,,,27,23,21,10
Jabari Smith Jr.,F,22023,1631095,22300096,"OCT 29, 2023",HOU vs. GSW,L,34,6,12,0.5,2,6,0.333,0,0,0.0,2,6,8,5,2,0,1,3,14,12,1,HOU,HOU,GSW,95,,,27,22,19,13
Jabari Smith Jr.,F,22023,1631095,22300083,"OCT 27, 2023",HOU @ SAS,L,37,5,16,0.313,2,8,0.25,1,4,0.25,4,5,9,0,1,0,2,4,13,-6,1,HOU,SAS,HOU,122,,,22,22,13,9
Jabari Smith Jr.,F,22023,1631095,22300066,"OCT 25, 2023",HOU @ ORL,L,26,3,9,0.333,0,4,0.0,1,2,0.5,1,4,5,1,1,0,1,6,7,-8,1,HOU,ORL,HOU,86,,,13,12,8,6
Jabari Smith Jr.,F,22023,1631095,22300534,"JAN 12, 2024",HOU @ DET,W,41,7,15,0.467,1,3,0.333,4,4,1.0,5,6,11,1,1,2,1,0,19,-3,1,HOU,DET,HOU,112,,,31,30,20,12
Jabari Smith Jr.,F,22023,1631095,22300485,"JAN 05, 2024",HOU vs. MIN,L,32,6,13,0.462,3,5,0.6,1,2,0.5,1,8,9,2,0,0,4,3,16,-12,1,HOU,HOU,MIN,95,,,27,25,18,11
Jabari Smith Jr.,F,22023,1631095,22300469,"JAN 03, 2024",HOU vs. BKN,W,33,2,8,0.25,1,4,0.25,2,2,1.0,1,11,12,0,0,1,1,4,7,11,1,HOU,HOU,BKN,112,,,19,19,7,12
Jabari Smith Jr.,F,22023,1631095,22300453,"JAN 01, 2024",HOU vs. DET,W,27,3,7,0.429,3,5,0.6,0,0,0.0,0,6,6,1,0,1,1,1,9,20,1,HOU,HOU,DET,136,,,16,15,10,7
Jabari Smith Jr.,F,22023,1631095,22300418,"DEC 27, 2023",HOU vs. PHX,L,22,2,5,0.4,1,3,0.333,4,4,1.0,0,3,3,0,2,0,1,1,9,-11,1,HOU,HOU,PHX,113,,,12,12,9,3
Jabari Smith Jr.,F,22023,1631095,22300523,"JAN 10, 2024",HOU @ CHI,L,47,7,14,0.5,4,9,0.444,0,0,0.0,2,13,15,1,0,1,2,3,18,8,1,HOU,CHI,HOU,119,,,34,33,19,16
Jabari Smith Jr.,F,22023,1631095,22300509,"JAN 08, 2024",HOU @ MIA,L,32,3,13,0.231,1,5,0.2,3,3,1.0,3,3,6,0,0,0,1,3,10,-11,1,HOU,MIA,HOU,113,,,16,16,10,6
Jabari Smith Jr.,F,22023,1631095,22300496,"JAN 06, 2024",HOU vs. MIL,W,40,3,7,0.429,3,5,0.6,5,6,0.833,1,11,12,2,2,1,1,4,14,1,1,HOU,HOU,MIL,112,,,28,26,16,14
Jaime Jaquez Jr.,G,22023,1631170,22300730,"FEB 07, 2024",MIA vs. SAS,W,28,4,6,0.667,0,2,0.0,2,5,0.4,0,3,3,0,0,0,2,1,10,-2,1,MIA,MIA,SAS,116,11.5,Points,13,13,10,3
Jaime Jaquez Jr.,G,22023,1631170,22300730,"FEB 07, 2024",MIA vs. SAS,W,28,4,6,0.667,0,2,0.0,2,5,0.4,0,3,3,0,0,0,2,1,10,-2,1,MIA,MIA,SAS,116,4.0,Rebounds,13,13,10,3
Jaime Jaquez Jr.,G,22023,1631170,22300730,"FEB 07, 2024",MIA vs. SAS,W,28,4,6,0.667,0,2,0.0,2,5,0.4,0,3,3,0,0,0,2,1,10,-2,1,MIA,MIA,SAS,116,18.5,Pts+Rebs+Asts,13,13,10,3
Jaime Jaquez Jr.,G,22023,1631170,22300730,"FEB 07, 2024",MIA vs. SAS,W,28,4,6,0.667,0,2,0.0,2,5,0.4,0,3,3,0,0,0,2,1,10,-2,1,MIA,MIA,SAS,116,2.5,Assists,13,13,10,3
Jaime Jaquez Jr.,G,22023,1631170,22300730,"FEB 07, 2024",MIA vs. SAS,W,28,4,6,0.667,0,2,0.0,2,5,0.4,0,3,3,0,0,0,2,1,10,-2,1,MIA,MIA,SAS,116,16.5,Pts+Rebs,13,13,10,3
Jaime Jaquez Jr.,G,22023,1631170,22300730,"FEB 07, 2024",MIA vs. SAS,W,28,4,6,0.667,0,2,0.0,2,5,0.4,0,3,3,0,0,0,2,1,10,-2,1,MIA,MIA,SAS,116,14.5,Pts+Asts,13,13,10,3
Jaime Jaquez Jr.,G,22023,1631170,22300730,"FEB 07, 2024",MIA vs. SAS,W,28,4,6,0.667,0,2,0.0,2,5,0.4,0,3,3,0,0,0,2,1,10,-2,1,MIA,MIA,SAS,116,1.5,Turnovers,13,13,10,3
Jaime Jaquez Jr.,G,22023,1631170,22300721,"FEB 06, 2024",MIA vs. ORL,W,23,4,11,0.364,1,5,0.2,3,3,1.0,2,4,6,2,3,0,2,3,12,8,1,MIA,MIA,ORL,121,11.5,Points,20,18,14,8
Jaime Jaquez Jr.,G,22023,1631170,22300721,"FEB 06, 2024",MIA vs. ORL,W,23,4,11,0.364,1,5,0.2,3,3,1.0,2,4,6,2,3,0,2,3,12,8,1,MIA,MIA,ORL,121,4.0,Rebounds,20,18,14,8
Jaime Jaquez Jr.,G,22023,1631170,22300721,"FEB 06, 2024",MIA vs. ORL,W,23,4,11,0.364,1,5,0.2,3,3,1.0,2,4,6,2,3,0,2,3,12,8,1,MIA,MIA,ORL,121,18.5,Pts+Rebs+Asts,20,18,14,8
Jaime Jaquez Jr.,G,22023,1631170,22300721,"FEB 06, 2024",MIA vs. ORL,W,23,4,11,0.364,1,5,0.2,3,3,1.0,2,4,6,2,3,0,2,3,12,8,1,MIA,MIA,ORL,121,2.5,Assists,20,18,14,8
Jaime Jaquez Jr.,G,22023,1631170,22300721,"FEB 06, 2024",MIA vs. ORL,W,23,4,11,0.364,1,5,0.2,3,3,1.0,2,4,6,2,3,0,2,3,12,8,1,MIA,MIA,ORL,121,16.5,Pts+Rebs,20,18,14,8
Jaime Jaquez Jr.,G,22023,1631170,22300721,"FEB 06, 2024",MIA vs. ORL,W,23,4,11,0.364,1,5,0.2,3,3,1.0,2,4,6,2,3,0,2,3,12,8,1,MIA,MIA,ORL,121,14.5,Pts+Asts,20,18,14,8
Jaime Jaquez Jr.,G,22023,1631170,22300721,"FEB 06, 2024",MIA vs. ORL,W,23,4,11,0.364,1,5,0.2,3,3,1.0,2,4,6,2,3,0,2,3,12,8,1,MIA,MIA,ORL,121,1.5,Turnovers,20,18,14,8
Jaime Jaquez Jr.,G,22023,1631170,22300708,"FEB 04, 2024",MIA vs. LAC,L,26,3,11,0.273,1,3,0.333,0,0,0.0,3,1,4,4,0,0,3,2,7,-9,1,MIA,MIA,LAC,95,11.5,Points,15,11,11,8
Jaime Jaquez Jr.,G,22023,1631170,22300708,"FEB 04, 2024",MIA vs. LAC,L,26,3,11,0.273,1,3,0.333,0,0,0.0,3,1,4,4,0,0,3,2,7,-9,1,MIA,MIA,LAC,95,4.0,Rebounds,15,11,11,8
Jaime Jaquez Jr.,G,22023,1631170,22300708,"FEB 04, 2024",MIA vs. LAC,L,26,3,11,0.273,1,3,0.333,0,0,0.0,3,1,4,4,0,0,3,2,7,-9,1,MIA,MIA,LAC,95,18.5,Pts+Rebs+Asts,15,11,11,8
Jaime Jaquez Jr.,G,22023,1631170,22300708,"FEB 04, 2024",MIA vs. LAC,L,26,3,11,0.273,1,3,0.333,0,0,0.0,3,1,4,4,0,0,3,2,7,-9,1,MIA,MIA,LAC,95,2.5,Assists,15,11,11,8
Jaime Jaquez Jr.,G,22023,1631170,22300708,"FEB 04, 2024",MIA vs. LAC,L,26,3,11,0.273,1,3,0.333,0,0,0.0,3,1,4,4,0,0,3,2,7,-9,1,MIA,MIA,LAC,95,16.5,Pts+Rebs,15,11,11,8
Jaime Jaquez Jr.,G,22023,1631170,22300708,"FEB 04, 2024",MIA vs. LAC,L,26,3,11,0.273,1,3,0.333,0,0,0.0,3,1,4,4,0,0,3,2,7,-9,1,MIA,MIA,LAC,95,14.5,Pts+Asts,15,11,11,8
Jaime Jaquez Jr.,G,22023,1631170,22300708,"FEB 04, 2024",MIA vs. LAC,L,26,3,11,0.273,1,3,0.333,0,0,0.0,3,1,4,4,0,0,3,2,7,-9,1,MIA,MIA,LAC,95,1.5,Turnovers,15,11,11,8
Jaime Jaquez Jr.,G,22023,1631170,22300689,"FEB 02, 2024",MIA @ WAS,W,26,4,7,0.571,0,1,0.0,0,0,0.0,2,2,4,2,2,0,0,2,8,10,1,MIA,WAS,MIA,110,11.5,Points,14,12,10,6
Jaime Jaquez Jr.,G,22023,1631170,22300689,"FEB 02, 2024",MIA @ WAS,W,26,4,7,0.571,0,1,0.0,0,0,0.0,2,2,4,2,2,0,0,2,8,10,1,MIA,WAS,MIA,110,4.0,Rebounds,14,12,10,6
Jaime Jaquez Jr.,G,22023,1631170,22300689,"FEB 02, 2024",MIA @ WAS,W,26,4,7,0.571,0,1,0.0,0,0,0.0,2,2,4,2,2,0,0,2,8,10,1,MIA,WAS,MIA,110,18.5,Pts+Rebs+Asts,14,12,10,6
Jaime Jaquez Jr.,G,22023,1631170,22300689,"FEB 02, 2024",MIA @ WAS,W,26,4,7,0.571,0,1,0.0,0,0,0.0,2,2,4,2,2,0,0,2,8,10,1,MIA,WAS,MIA,110,2.5,Assists,14,12,10,6
Jaime Jaquez Jr.,G,22023,1631170,22300689,"FEB 02, 2024",MIA @ WAS,W,26,4,7,0.571,0,1,0.0,0,0,0.0,2,2,4,2,2,0,0,2,8,10,1,MIA,WAS,MIA,110,16.5,Pts+Rebs,14,12,10,6
Jaime Jaquez Jr.,G,22023,1631170,22300689,"FEB 02, 2024",MIA @ WAS,W,26,4,7,0.571,0,1,0.0,0,0,0.0,2,2,4,2,2,0,0,2,8,10,1,MIA,WAS,MIA,110,14.5,Pts+Asts,14,12,10,6
Jaime Jaquez Jr.,G,22023,1631170,22300689,"FEB 02, 2024",MIA @ WAS,W,26,4,7,0.571,0,1,0.0,0,0,0.0,2,2,4,2,2,0,0,2,8,10,1,MIA,WAS,MIA,110,1.5,Turnovers,14,12,10,6
Jaime Jaquez Jr.,G,22023,1631170,22300678,"JAN 31, 2024",MIA vs. SAC,W,25,3,9,0.333,0,1,0.0,2,2,1.0,0,4,4,1,0,0,2,2,8,15,1,MIA,MIA,SAC,115,11.5,Points,13,12,9,5
Jaime Jaquez Jr.,G,22023,1631170,22300678,"JAN 31, 2024",MIA vs. SAC,W,25,3,9,0.333,0,1,0.0,2,2,1.0,0,4,4,1,0,0,2,2,8,15,1,MIA,MIA,SAC,115,4.0,Rebounds,13,12,9,5
Jaime Jaquez Jr.,G,22023,1631170,22300678,"JAN 31, 2024",MIA vs. SAC,W,25,3,9,0.333,0,1,0.0,2,2,1.0,0,4,4,1,0,0,2,2,8,15,1,MIA,MIA,SAC,115,18.5,Pts+Rebs+Asts,13,12,9,5
Jaime Jaquez Jr.,G,22023,1631170,22300678,"JAN 31, 2024",MIA vs. SAC,W,25,3,9,0.333,0,1,0.0,2,2,1.0,0,4,4,1,0,0,2,2,8,15,1,MIA,MIA,SAC,115,2.5,Assists,13,12,9,5
Jaime Jaquez Jr.,G,22023,1631170,22300678,"JAN 31, 2024",MIA vs. SAC,W,25,3,9,0.333,0,1,0.0,2,2,1.0,0,4,4,1,0,0,2,2,8,15,1,MIA,MIA,SAC,115,16.5,Pts+Rebs,13,12,9,5
Jaime Jaquez Jr.,G,22023,1631170,22300678,"JAN 31, 2024",MIA vs. SAC,W,25,3,9,0.333,0,1,0.0,2,2,1.0,0,4,4,1,0,0,2,2,8,15,1,MIA,MIA,SAC,115,14.5,Pts+Asts,13,12,9,5
Jaime Jaquez Jr.,G,22023,1631170,22300678,"JAN 31, 2024",MIA vs. SAC,W,25,3,9,0.333,0,1,0.0,2,2,1.0,0,4,4,1,0,0,2,2,8,15,1,MIA,MIA,SAC,115,1.5,Turnovers,13,12,9,5
Jaime Jaquez Jr.,G,22023,1631170,22300661,"JAN 29, 2024",MIA vs. PHX,L,25,0,6,0.0,0,4,0.0,2,2,1.0,0,3,3,1,1,0,2,1,2,-4,1,MIA,MIA,PHX,105,11.5,Points,6,5,3,4
Jaime Jaquez Jr.,G,22023,1631170,22300661,"JAN 29, 2024",MIA vs. PHX,L,25,0,6,0.0,0,4,0.0,2,2,1.0,0,3,3,1,1,0,2,1,2,-4,1,MIA,MIA,PHX,105,4.0,Rebounds,6,5,3,4
Jaime Jaquez Jr.,G,22023,1631170,22300661,"JAN 29, 2024",MIA vs. PHX,L,25,0,6,0.0,0,4,0.0,2,2,1.0,0,3,3,1,1,0,2,1,2,-4,1,MIA,MIA,PHX,105,18.5,Pts+Rebs+Asts,6,5,3,4
Jaime Jaquez Jr.,G,22023,1631170,22300661,"JAN 29, 2024",MIA vs. PHX,L,25,0,6,0.0,0,4,0.0,2,2,1.0,0,3,3,1,1,0,2,1,2,-4,1,MIA,MIA,PHX,105,2.5,Assists,6,5,3,4
Jaime Jaquez Jr.,G,22023,1631170,22300661,"JAN 29, 2024",MIA vs. PHX,L,25,0,6,0.0,0,4,0.0,2,2,1.0,0,3,3,1,1,0,2,1,2,-4,1,MIA,MIA,PHX,105,16.5,Pts+Rebs,6,5,3,4
Jaime Jaquez Jr.,G,22023,1631170,22300661,"JAN 29, 2024",MIA vs. PHX,L,25,0,6,0.0,0,4,0.0,2,2,1.0,0,3,3,1,1,0,2,1,2,-4,1,MIA,MIA,PHX,105,14.5,Pts+Asts,6,5,3,4
Jaime Jaquez Jr.,G,22023,1631170,22300661,"JAN 29, 2024",MIA vs. PHX,L,25,0,6,0.0,0,4,0.0,2,2,1.0,0,3,3,1,1,0,2,1,2,-4,1,MIA,MIA,PHX,105,1.5,Turnovers,6,5,3,4
Jaime Jaquez Jr.,G,22023,1631170,22300643,"JAN 27, 2024",MIA @ NYK,L,24,1,3,0.333,1,2,0.5,3,4,0.75,0,1,1,4,2,1,0,4,6,-18,1,MIA,NYK,MIA,109,11.5,Points,11,7,10,5
Jaime Jaquez Jr.,G,22023,1631170,22300643,"JAN 27, 2024",MIA @ NYK,L,24,1,3,0.333,1,2,0.5,3,4,0.75,0,1,1,4,2,1,0,4,6,-18,1,MIA,NYK,MIA,109,4.0,Rebounds,11,7,10,5
Jaime Jaquez Jr.,G,22023,1631170,22300643,"JAN 27, 2024",MIA @ NYK,L,24,1,3,0.333,1,2,0.5,3,4,0.75,0,1,1,4,2,1,0,4,6,-18,1,MIA,NYK,MIA,109,18.5,Pts+Rebs+Asts,11,7,10,5
Jaime Jaquez Jr.,G,22023,1631170,22300643,"JAN 27, 2024",MIA @ NYK,L,24,1,3,0.333,1,2,0.5,3,4,0.75,0,1,1,4,2,1,0,4,6,-18,1,MIA,NYK,MIA,109,2.5,Assists,11,7,10,5
Jaime Jaquez Jr.,G,22023,1631170,22300643,"JAN 27, 2024",MIA @ NYK,L,24,1,3,0.333,1,2,0.5,3,4,0.75,0,1,1,4,2,1,0,4,6,-18,1,MIA,NYK,MIA,109,16.5,Pts+Rebs,11,7,10,5
Jaime Jaquez Jr.,G,22023,1631170,22300643,"JAN 27, 2024",MIA @ NYK,L,24,1,3,0.333,1,2,0.5,3,4,0.75,0,1,1,4,2,1,0,4,6,-18,1,MIA,NYK,MIA,109,14.5,Pts+Asts,11,7,10,5
Jaime Jaquez Jr.,G,22023,1631170,22300643,"JAN 27, 2024",MIA @ NYK,L,24,1,3,0.333,1,2,0.5,3,4,0.75,0,1,1,4,2,1,0,4,6,-18,1,MIA,NYK,MIA,109,1.5,Turnovers,11,7,10,5
Jaime Jaquez Jr.,G,22023,1631170,22300551,"JAN 14, 2024",MIA vs. CHA,W,15,7,11,0.636,0,0,0.0,1,1,1.0,1,4,5,2,1,0,0,1,15,8,1,MIA,MIA,CHA,104,11.5,Points,22,20,17,7
Jaime Jaquez Jr.,G,22023,1631170,22300551,"JAN 14, 2024",MIA vs. CHA,W,15,7,11,0.636,0,0,0.0,1,1,1.0,1,4,5,2,1,0,0,1,15,8,1,MIA,MIA,CHA,104,4.0,Rebounds,22,20,17,7
Jaime Jaquez Jr.,G,22023,1631170,22300551,"JAN 14, 2024",MIA vs. CHA,W,15,7,11,0.636,0,0,0.0,1,1,1.0,1,4,5,2,1,0,0,1,15,8,1,MIA,MIA,CHA,104,18.5,Pts+Rebs+Asts,22,20,17,7
Jaime Jaquez Jr.,G,22023,1631170,22300551,"JAN 14, 2024",MIA vs. CHA,W,15,7,11,0.636,0,0,0.0,1,1,1.0,1,4,5,2,1,0,0,1,15,8,1,MIA,MIA,CHA,104,2.5,Assists,22,20,17,7
Jaime Jaquez Jr.,G,22023,1631170,22300551,"JAN 14, 2024",MIA vs. CHA,W,15,7,11,0.636,0,0,0.0,1,1,1.0,1,4,5,2,1,0,0,1,15,8,1,MIA,MIA,CHA,104,16.5,Pts+Rebs,22,20,17,7
Jaime Jaquez Jr.,G,22023,1631170,22300551,"JAN 14, 2024",MIA vs. CHA,W,15,7,11,0.636,0,0,0.0,1,1,1.0,1,4,5,2,1,0,0,1,15,8,1,MIA,MIA,CHA,104,14.5,Pts+Asts,22,20,17,7
Jaime Jaquez Jr.,G,22023,1631170,22300551,"JAN 14, 2024",MIA vs. CHA,W,15,7,11,0.636,0,0,0.0,1,1,1.0,1,4,5,2,1,0,0,1,15,8,1,MIA,MIA,CHA,104,1.5,Turnovers,22,20,17,7
Jaime Jaquez Jr.,G,22023,1631170,22300535,"JAN 12, 2024",MIA vs. ORL,W,37,8,16,0.5,0,2,0.0,3,3,1.0,4,3,7,3,1,0,3,3,19,-4,1,MIA,MIA,ORL,99,11.5,Points,29,26,22,10
Jaime Jaquez Jr.,G,22023,1631170,22300535,"JAN 12, 2024",MIA vs. ORL,W,37,8,16,0.5,0,2,0.0,3,3,1.0,4,3,7,3,1,0,3,3,19,-4,1,MIA,MIA,ORL,99,4.0,Rebounds,29,26,22,10
Jaime Jaquez Jr.,G,22023,1631170,22300535,"JAN 12, 2024",MIA vs. ORL,W,37,8,16,0.5,0,2,0.0,3,3,1.0,4,3,7,3,1,0,3,3,19,-4,1,MIA,MIA,ORL,99,18.5,Pts+Rebs+Asts,29,26,22,10
Jaime Jaquez Jr.,G,22023,1631170,22300535,"JAN 12, 2024",MIA vs. ORL,W,37,8,16,0.5,0,2,0.0,3,3,1.0,4,3,7,3,1,0,3,3,19,-4,1,MIA,MIA,ORL,99,2.5,Assists,29,26,22,10
Jaime Jaquez Jr.,G,22023,1631170,22300535,"JAN 12, 2024",MIA vs. ORL,W,37,8,16,0.5,0,2,0.0,3,3,1.0,4,3,7,3,1,0,3,3,19,-4,1,MIA,MIA,ORL,99,16.5,Pts+Rebs,29,26,22,10
Jaime Jaquez Jr.,G,22023,1631170,22300535,"JAN 12, 2024",MIA vs. ORL,W,37,8,16,0.5,0,2,0.0,3,3,1.0,4,3,7,3,1,0,3,3,19,-4,1,MIA,MIA,ORL,99,14.5,Pts+Asts,29,26,22,10
Jaime Jaquez Jr.,G,22023,1631170,22300535,"JAN 12, 2024",MIA vs. ORL,W,37,8,16,0.5,0,2,0.0,3,3,1.0,4,3,7,3,1,0,3,3,19,-4,1,MIA,MIA,ORL,99,1.5,Turnovers,29,26,22,10
Jaime Jaquez Jr.,G,22023,1631170,22300522,"JAN 10, 2024",MIA vs. OKC,L,34,6,9,0.667,3,5,0.6,6,9,0.667,0,5,5,2,0,0,3,4,21,-4,1,MIA,MIA,OKC,120,11.5,Points,28,26,23,7
Jaime Jaquez Jr.,G,22023,1631170,22300522,"JAN 10, 2024",MIA vs. OKC,L,34,6,9,0.667,3,5,0.6,6,9,0.667,0,5,5,2,0,0,3,4,21,-4,1,MIA,MIA,OKC,120,4.0,Rebounds,28,26,23,7
Jaime Jaquez Jr.,G,22023,1631170,22300522,"JAN 10, 2024",MIA vs. OKC,L,34,6,9,0.667,3,5,0.6,6,9,0.667,0,5,5,2,0,0,3,4,21,-4,1,MIA,MIA,OKC,120,18.5,Pts+Rebs+Asts,28,26,23,7
Jaime Jaquez Jr.,G,22023,1631170,22300522,"JAN 10, 2024",MIA vs. OKC,L,34,6,9,0.667,3,5,0.6,6,9,0.667,0,5,5,2,0,0,3,4,21,-4,1,MIA,MIA,OKC,120,2.5,Assists,28,26,23,7
Jaime Jaquez Jr.,G,22023,1631170,22300522,"JAN 10, 2024",MIA vs. OKC,L,34,6,9,0.667,3,5,0.6,6,9,0.667,0,5,5,2,0,0,3,4,21,-4,1,MIA,MIA,OKC,120,16.5,Pts+Rebs,28,26,23,7
Jaime Jaquez Jr.,G,22023,1631170,22300522,"JAN 10, 2024",MIA vs. OKC,L,34,6,9,0.667,3,5,0.6,6,9,0.667,0,5,5,2,0,0,3,4,21,-4,1,MIA,MIA,OKC,120,14.5,Pts+Asts,28,26,23,7
Jaime Jaquez Jr.,G,22023,1631170,22300522,"JAN 10, 2024",MIA vs. OKC,L,34,6,9,0.667,3,5,0.6,6,9,0.667,0,5,5,2,0,0,3,4,21,-4,1,MIA,MIA,OKC,120,1.5,Turnovers,28,26,23,7
Jaime Jaquez Jr.,G,22023,1631170,22300509,"JAN 08, 2024",MIA vs. HOU,W,39,5,11,0.455,1,2,0.5,3,4,0.75,0,4,4,4,1,0,2,1,14,6,1,MIA,MIA,HOU,120,11.5,Points,22,18,18,8
Jaime Jaquez Jr.,G,22023,1631170,22300509,"JAN 08, 2024",MIA vs. HOU,W,39,5,11,0.455,1,2,0.5,3,4,0.75,0,4,4,4,1,0,2,1,14,6,1,MIA,MIA,HOU,120,4.0,Rebounds,22,18,18,8
Jaime Jaquez Jr.,G,22023,1631170,22300509,"JAN 08, 2024",MIA vs. HOU,W,39,5,11,0.455,1,2,0.5,3,4,0.75,0,4,4,4,1,0,2,1,14,6,1,MIA,MIA,HOU,120,18.5,Pts+Rebs+Asts,22,18,18,8
Jaime Jaquez Jr.,G,22023,1631170,22300509,"JAN 08, 2024",MIA vs. HOU,W,39,5,11,0.455,1,2,0.5,3,4,0.75,0,4,4,4,1,0,2,1,14,6,1,MIA,MIA,HOU,120,2.5,Assists,22,18,18,8
Jaime Jaquez Jr.,G,22023,1631170,22300509,"JAN 08, 2024",MIA vs. HOU,W,39,5,11,0.455,1,2,0.5,3,4,0.75,0,4,4,4,1,0,2,1,14,6,1,MIA,MIA,HOU,120,16.5,Pts+Rebs,22,18,18,8
Jaime Jaquez Jr.,G,22023,1631170,22300509,"JAN 08, 2024",MIA vs. HOU,W,39,5,11,0.455,1,2,0.5,3,4,0.75,0,4,4,4,1,0,2,1,14,6,1,MIA,MIA,HOU,120,14.5,Pts+Asts,22,18,18,8
Jaime Jaquez Jr.,G,22023,1631170,22300509,"JAN 08, 2024",MIA vs. HOU,W,39,5,11,0.455,1,2,0.5,3,4,0.75,0,4,4,4,1,0,2,1,14,6,1,MIA,MIA,HOU,120,1.5,Turnovers,22,18,18,8
Jaime Jaquez Jr.,G,22023,1631170,22300489,"JAN 05, 2024",MIA @ PHX,L,35,5,7,0.714,0,2,0.0,0,0,0.0,1,2,3,1,2,0,3,4,10,-18,1,MIA,PHX,MIA,97,11.5,Points,14,13,11,4
Jaime Jaquez Jr.,G,22023,1631170,22300489,"JAN 05, 2024",MIA @ PHX,L,35,5,7,0.714,0,2,0.0,0,0,0.0,1,2,3,1,2,0,3,4,10,-18,1,MIA,PHX,MIA,97,4.0,Rebounds,14,13,11,4
Jaime Jaquez Jr.,G,22023,1631170,22300489,"JAN 05, 2024",MIA @ PHX,L,35,5,7,0.714,0,2,0.0,0,0,0.0,1,2,3,1,2,0,3,4,10,-18,1,MIA,PHX,MIA,97,18.5,Pts+Rebs+Asts,14,13,11,4
Jaime Jaquez Jr.,G,22023,1631170,22300489,"JAN 05, 2024",MIA @ PHX,L,35,5,7,0.714,0,2,0.0,0,0,0.0,1,2,3,1,2,0,3,4,10,-18,1,MIA,PHX,MIA,97,2.5,Assists,14,13,11,4
Jaime Jaquez Jr.,G,22023,1631170,22300489,"JAN 05, 2024",MIA @ PHX,L,35,5,7,0.714,0,2,0.0,0,0,0.0,1,2,3,1,2,0,3,4,10,-18,1,MIA,PHX,MIA,97,16.5,Pts+Rebs,14,13,11,4
Jaime Jaquez Jr.,G,22023,1631170,22300489,"JAN 05, 2024",MIA @ PHX,L,35,5,7,0.714,0,2,0.0,0,0,0.0,1,2,3,1,2,0,3,4,10,-18,1,MIA,PHX,MIA,97,14.5,Pts+Asts,14,13,11,4
Jaime Jaquez Jr.,G,22023,1631170,22300489,"JAN 05, 2024",MIA @ PHX,L,35,5,7,0.714,0,2,0.0,0,0,0.0,1,2,3,1,2,0,3,4,10,-18,1,MIA,PHX,MIA,97,1.5,Turnovers,14,13,11,4
Jaime Jaquez Jr.,G,22023,1631170,22300475,"JAN 03, 2024",MIA @ LAL,W,39,7,14,0.5,2,6,0.333,0,0,0.0,0,0,0,8,1,1,2,1,16,24,1,MIA,LAL,MIA,110,11.5,Points,24,16,24,8
Jaime Jaquez Jr.,G,22023,1631170,22300475,"JAN 03, 2024",MIA @ LAL,W,39,7,14,0.5,2,6,0.333,0,0,0.0,0,0,0,8,1,1,2,1,16,24,1,MIA,LAL,MIA,110,4.0,Rebounds,24,16,24,8
Jaime Jaquez Jr.,G,22023,1631170,22300475,"JAN 03, 2024",MIA @ LAL,W,39,7,14,0.5,2,6,0.333,0,0,0.0,0,0,0,8,1,1,2,1,16,24,1,MIA,LAL,MIA,110,18.5,Pts+Rebs+Asts,24,16,24,8
Jaime Jaquez Jr.,G,22023,1631170,22300475,"JAN 03, 2024",MIA @ LAL,W,39,7,14,0.5,2,6,0.333,0,0,0.0,0,0,0,8,1,1,2,1,16,24,1,MIA,LAL,MIA,110,2.5,Assists,24,16,24,8
Jaime Jaquez Jr.,G,22023,1631170,22300475,"JAN 03, 2024",MIA @ LAL,W,39,7,14,0.5,2,6,0.333,0,0,0.0,0,0,0,8,1,1,2,1,16,24,1,MIA,LAL,MIA,110,16.5,Pts+Rebs,24,16,24,8
Jaime Jaquez Jr.,G,22023,1631170,22300475,"JAN 03, 2024",MIA @ LAL,W,39,7,14,0.5,2,6,0.333,0,0,0.0,0,0,0,8,1,1,2,1,16,24,1,MIA,LAL,MIA,110,14.5,Pts+Asts,24,16,24,8
Jaime Jaquez Jr.,G,22023,1631170,22300475,"JAN 03, 2024",MIA @ LAL,W,39,7,14,0.5,2,6,0.333,0,0,0.0,0,0,0,8,1,1,2,1,16,24,1,MIA,LAL,MIA,110,1.5,Turnovers,24,16,24,8
Jaime Jaquez Jr.,G,22023,1631170,22300458,"JAN 01, 2024",MIA @ LAC,L,38,6,13,0.462,0,3,0.0,3,4,0.75,3,1,4,2,4,0,2,2,15,-17,1,MIA,LAC,MIA,104,11.5,Points,21,19,17,6
Jaime Jaquez Jr.,G,22023,1631170,22300458,"JAN 01, 2024",MIA @ LAC,L,38,6,13,0.462,0,3,0.0,3,4,0.75,3,1,4,2,4,0,2,2,15,-17,1,MIA,LAC,MIA,104,4.0,Rebounds,21,19,17,6
Jaime Jaquez Jr.,G,22023,1631170,22300458,"JAN 01, 2024",MIA @ LAC,L,38,6,13,0.462,0,3,0.0,3,4,0.75,3,1,4,2,4,0,2,2,15,-17,1,MIA,LAC,MIA,104,18.5,Pts+Rebs+Asts,21,19,17,6
Jaime Jaquez Jr.,G,22023,1631170,22300458,"JAN 01, 2024",MIA @ LAC,L,38,6,13,0.462,0,3,0.0,3,4,0.75,3,1,4,2,4,0,2,2,15,-17,1,MIA,LAC,MIA,104,2.5,Assists,21,19,17,6
Jaime Jaquez Jr.,G,22023,1631170,22300458,"JAN 01, 2024",MIA @ LAC,L,38,6,13,0.462,0,3,0.0,3,4,0.75,3,1,4,2,4,0,2,2,15,-17,1,MIA,LAC,MIA,104,16.5,Pts+Rebs,21,19,17,6
Jaime Jaquez Jr.,G,22023,1631170,22300458,"JAN 01, 2024",MIA @ LAC,L,38,6,13,0.462,0,3,0.0,3,4,0.75,3,1,4,2,4,0,2,2,15,-17,1,MIA,LAC,MIA,104,14.5,Pts+Asts,21,19,17,6
Jaime Jaquez Jr.,G,22023,1631170,22300458,"JAN 01, 2024",MIA @ LAC,L,38,6,13,0.462,0,3,0.0,3,4,0.75,3,1,4,2,4,0,2,2,15,-17,1,MIA,LAC,MIA,104,1.5,Turnovers,21,19,17,6
Jaime Jaquez Jr.,G,22023,1631170,22300439,"DEC 30, 2023",MIA @ UTA,L,35,2,9,0.222,0,4,0.0,5,5,1.0,0,1,1,1,0,0,2,4,9,-16,1,MIA,UTA,MIA,109,11.5,Points,11,10,10,2
Jaime Jaquez Jr.,G,22023,1631170,22300439,"DEC 30, 2023",MIA @ UTA,L,35,2,9,0.222,0,4,0.0,5,5,1.0,0,1,1,1,0,0,2,4,9,-16,1,MIA,UTA,MIA,109,4.0,Rebounds,11,10,10,2
Jaime Jaquez Jr.,G,22023,1631170,22300439,"DEC 30, 2023",MIA @ UTA,L,35,2,9,0.222,0,4,0.0,5,5,1.0,0,1,1,1,0,0,2,4,9,-16,1,MIA,UTA,MIA,109,18.5,Pts+Rebs+Asts,11,10,10,2
Jaime Jaquez Jr.,G,22023,1631170,22300439,"DEC 30, 2023",MIA @ UTA,L,35,2,9,0.222,0,4,0.0,5,5,1.0,0,1,1,1,0,0,2,4,9,-16,1,MIA,UTA,MIA,109,2.5,Assists,11,10,10,2
Jaime Jaquez Jr.,G,22023,1631170,22300439,"DEC 30, 2023",MIA @ UTA,L,35,2,9,0.222,0,4,0.0,5,5,1.0,0,1,1,1,0,0,2,4,9,-16,1,MIA,UTA,MIA,109,16.5,Pts+Rebs,11,10,10,2
Jaime Jaquez Jr.,G,22023,1631170,22300439,"DEC 30, 2023",MIA @ UTA,L,35,2,9,0.222,0,4,0.0,5,5,1.0,0,1,1,1,0,0,2,4,9,-16,1,MIA,UTA,MIA,109,14.5,Pts+Asts,11,10,10,2
Jaime Jaquez Jr.,G,22023,1631170,22300439,"DEC 30, 2023",MIA @ UTA,L,35,2,9,0.222,0,4,0.0,5,5,1.0,0,1,1,1,0,0,2,4,9,-16,1,MIA,UTA,MIA,109,1.5,Turnovers,11,10,10,2
Jaime Jaquez Jr.,G,22023,1631170,22300426,"DEC 28, 2023",MIA @ GSW,W,39,7,15,0.467,2,5,0.4,1,2,0.5,1,4,5,6,1,0,2,2,17,8,1,MIA,GSW,MIA,114,11.5,Points,28,22,23,11
Jaime Jaquez Jr.,G,22023,1631170,22300426,"DEC 28, 2023",MIA @ GSW,W,39,7,15,0.467,2,5,0.4,1,2,0.5,1,4,5,6,1,0,2,2,17,8,1,MIA,GSW,MIA,114,4.0,Rebounds,28,22,23,11
Jaime Jaquez Jr.,G,22023,1631170,22300426,"DEC 28, 2023",MIA @ GSW,W,39,7,15,0.467,2,5,0.4,1,2,0.5,1,4,5,6,1,0,2,2,17,8,1,MIA,GSW,MIA,114,18.5,Pts+Rebs+Asts,28,22,23,11
Jaime Jaquez Jr.,G,22023,1631170,22300426,"DEC 28, 2023",MIA @ GSW,W,39,7,15,0.467,2,5,0.4,1,2,0.5,1,4,5,6,1,0,2,2,17,8,1,MIA,GSW,MIA,114,2.5,Assists,28,22,23,11
Jaime Jaquez Jr.,G,22023,1631170,22300426,"DEC 28, 2023",MIA @ GSW,W,39,7,15,0.467,2,5,0.4,1,2,0.5,1,4,5,6,1,0,2,2,17,8,1,MIA,GSW,MIA,114,16.5,Pts+Rebs,28,22,23,11
Jaime Jaquez Jr.,G,22023,1631170,22300426,"DEC 28, 2023",MIA @ GSW,W,39,7,15,0.467,2,5,0.4,1,2,0.5,1,4,5,6,1,0,2,2,17,8,1,MIA,GSW,MIA,114,14.5,Pts+Asts,28,22,23,11
Jaime Jaquez Jr.,G,22023,1631170,22300426,"DEC 28, 2023",MIA @ GSW,W,39,7,15,0.467,2,5,0.4,1,2,0.5,1,4,5,6,1,0,2,2,17,8,1,MIA,GSW,MIA,114,1.5,Turnovers,28,22,23,11
Jaime Jaquez Jr.,G,22023,1631170,22300404,"DEC 25, 2023",MIA vs. PHI,W,39,11,15,0.733,1,3,0.333,8,8,1.0,5,5,10,1,2,0,0,3,31,-1,1,MIA,MIA,PHI,119,11.5,Points,42,41,32,11
Jaime Jaquez Jr.,G,22023,1631170,22300404,"DEC 25, 2023",MIA vs. PHI,W,39,11,15,0.733,1,3,0.333,8,8,1.0,5,5,10,1,2,0,0,3,31,-1,1,MIA,MIA,PHI,119,4.0,Rebounds,42,41,32,11
Jaime Jaquez Jr.,G,22023,1631170,22300404,"DEC 25, 2023",MIA vs. PHI,W,39,11,15,0.733,1,3,0.333,8,8,1.0,5,5,10,1,2,0,0,3,31,-1,1,MIA,MIA,PHI,119,18.5,Pts+Rebs+Asts,42,41,32,11
Jaime Jaquez Jr.,G,22023,1631170,22300404,"DEC 25, 2023",MIA vs. PHI,W,39,11,15,0.733,1,3,0.333,8,8,1.0,5,5,10,1,2,0,0,3,31,-1,1,MIA,MIA,PHI,119,2.5,Assists,42,41,32,11
Jaime Jaquez Jr.,G,22023,1631170,22300404,"DEC 25, 2023",MIA vs. PHI,W,39,11,15,0.733,1,3,0.333,8,8,1.0,5,5,10,1,2,0,0,3,31,-1,1,MIA,MIA,PHI,119,16.5,Pts+Rebs,42,41,32,11
Jaime Jaquez Jr.,G,22023,1631170,22300404,"DEC 25, 2023",MIA vs. PHI,W,39,11,15,0.733,1,3,0.333,8,8,1.0,5,5,10,1,2,0,0,3,31,-1,1,MIA,MIA,PHI,119,14.5,Pts+Asts,42,41,32,11
Jaime Jaquez Jr.,G,22023,1631170,22300404,"DEC 25, 2023",MIA vs. PHI,W,39,11,15,0.733,1,3,0.333,8,8,1.0,5,5,10,1,2,0,0,3,31,-1,1,MIA,MIA,PHI,119,1.5,Turnovers,42,41,32,11
Jaime Jaquez Jr.,G,22023,1631170,22300384,"DEC 22, 2023",MIA vs. ATL,W,37,7,14,0.5,1,1,1.0,4,5,0.8,4,3,7,1,1,1,2,4,19,11,1,MIA,MIA,ATL,122,11.5,Points,27,26,20,8
Jaime Jaquez Jr.,G,22023,1631170,22300384,"DEC 22, 2023",MIA vs. ATL,W,37,7,14,0.5,1,1,1.0,4,5,0.8,4,3,7,1,1,1,2,4,19,11,1,MIA,MIA,ATL,122,4.0,Rebounds,27,26,20,8
Jaime Jaquez Jr.,G,22023,1631170,22300384,"DEC 22, 2023",MIA vs. ATL,W,37,7,14,0.5,1,1,1.0,4,5,0.8,4,3,7,1,1,1,2,4,19,11,1,MIA,MIA,ATL,122,18.5,Pts+Rebs+Asts,27,26,20,8
Jaime Jaquez Jr.,G,22023,1631170,22300384,"DEC 22, 2023",MIA vs. ATL,W,37,7,14,0.5,1,1,1.0,4,5,0.8,4,3,7,1,1,1,2,4,19,11,1,MIA,MIA,ATL,122,2.5,Assists,27,26,20,8
Jaime Jaquez Jr.,G,22023,1631170,22300384,"DEC 22, 2023",MIA vs. ATL,W,37,7,14,0.5,1,1,1.0,4,5,0.8,4,3,7,1,1,1,2,4,19,11,1,MIA,MIA,ATL,122,16.5,Pts+Rebs,27,26,20,8
Jaime Jaquez Jr.,G,22023,1631170,22300384,"DEC 22, 2023",MIA vs. ATL,W,37,7,14,0.5,1,1,1.0,4,5,0.8,4,3,7,1,1,1,2,4,19,11,1,MIA,MIA,ATL,122,14.5,Pts+Asts,27,26,20,8
Jaime Jaquez Jr.,G,22023,1631170,22300384,"DEC 22, 2023",MIA vs. ATL,W,37,7,14,0.5,1,1,1.0,4,5,0.8,4,3,7,1,1,1,2,4,19,11,1,MIA,MIA,ATL,122,1.5,Turnovers,27,26,20,8
Jaime Jaquez Jr.,G,22023,1631170,22300366,"DEC 20, 2023",MIA @ ORL,W,34,3,10,0.3,0,3,0.0,4,6,0.667,2,1,3,1,1,1,1,1,10,-8,1,MIA,ORL,MIA,115,11.5,Points,14,13,11,4
Jaime Jaquez Jr.,G,22023,1631170,22300366,"DEC 20, 2023",MIA @ ORL,W,34,3,10,0.3,0,3,0.0,4,6,0.667,2,1,3,1,1,1,1,1,10,-8,1,MIA,ORL,MIA,115,4.0,Rebounds,14,13,11,4
Jaime Jaquez Jr.,G,22023,1631170,22300366,"DEC 20, 2023",MIA @ ORL,W,34,3,10,0.3,0,3,0.0,4,6,0.667,2,1,3,1,1,1,1,1,10,-8,1,MIA,ORL,MIA,115,18.5,Pts+Rebs+Asts,14,13,11,4
Jaime Jaquez Jr.,G,22023,1631170,22300366,"DEC 20, 2023",MIA @ ORL,W,34,3,10,0.3,0,3,0.0,4,6,0.667,2,1,3,1,1,1,1,1,10,-8,1,MIA,ORL,MIA,115,2.5,Assists,14,13,11,4
Jaime Jaquez Jr.,G,22023,1631170,22300366,"DEC 20, 2023",MIA @ ORL,W,34,3,10,0.3,0,3,0.0,4,6,0.667,2,1,3,1,1,1,1,1,10,-8,1,MIA,ORL,MIA,115,16.5,Pts+Rebs,14,13,11,4
Jaime Jaquez Jr.,G,22023,1631170,22300366,"DEC 20, 2023",MIA @ ORL,W,34,3,10,0.3,0,3,0.0,4,6,0.667,2,1,3,1,1,1,1,1,10,-8,1,MIA,ORL,MIA,115,14.5,Pts+Asts,14,13,11,4
Jaime Jaquez Jr.,G,22023,1631170,22300366,"DEC 20, 2023",MIA @ ORL,W,34,3,10,0.3,0,3,0.0,4,6,0.667,2,1,3,1,1,1,1,1,10,-8,1,MIA,ORL,MIA,115,1.5,Turnovers,14,13,11,4
Jaime Jaquez Jr.,G,22023,1631170,22300353,"DEC 18, 2023",MIA vs. MIN,L,30,3,8,0.375,0,1,0.0,2,2,1.0,1,2,3,0,2,2,3,4,8,-1,1,MIA,MIA,MIN,108,11.5,Points,11,11,8,3
Jaime Jaquez Jr.,G,22023,1631170,22300353,"DEC 18, 2023",MIA vs. MIN,L,30,3,8,0.375,0,1,0.0,2,2,1.0,1,2,3,0,2,2,3,4,8,-1,1,MIA,MIA,MIN,108,4.0,Rebounds,11,11,8,3
Jaime Jaquez Jr.,G,22023,1631170,22300353,"DEC 18, 2023",MIA vs. MIN,L,30,3,8,0.375,0,1,0.0,2,2,1.0,1,2,3,0,2,2,3,4,8,-1,1,MIA,MIA,MIN,108,18.5,Pts+Rebs+Asts,11,11,8,3
Jaime Jaquez Jr.,G,22023,1631170,22300353,"DEC 18, 2023",MIA vs. MIN,L,30,3,8,0.375,0,1,0.0,2,2,1.0,1,2,3,0,2,2,3,4,8,-1,1,MIA,MIA,MIN,108,2.5,Assists,11,11,8,3
Jaime Jaquez Jr.,G,22023,1631170,22300353,"DEC 18, 2023",MIA vs. MIN,L,30,3,8,0.375,0,1,0.0,2,2,1.0,1,2,3,0,2,2,3,4,8,-1,1,MIA,MIA,MIN,108,16.5,Pts+Rebs,11,11,8,3
Jaime Jaquez Jr.,G,22023,1631170,22300353,"DEC 18, 2023",MIA vs. MIN,L,30,3,8,0.375,0,1,0.0,2,2,1.0,1,2,3,0,2,2,3,4,8,-1,1,MIA,MIA,MIN,108,14.5,Pts+Asts,11,11,8,3
Jaime Jaquez Jr.,G,22023,1631170,22300353,"DEC 18, 2023",MIA vs. MIN,L,30,3,8,0.375,0,1,0.0,2,2,1.0,1,2,3,0,2,2,3,4,8,-1,1,MIA,MIA,MIN,108,1.5,Turnovers,11,11,8,3
Jaime Jaquez Jr.,G,22023,1631170,22300267,"NOV 30, 2023",MIA vs. IND,W,33,8,13,0.615,1,3,0.333,7,7,1.0,0,5,5,1,1,0,3,3,24,18,1,MIA,MIA,IND,142,11.5,Points,30,29,25,6
Jaime Jaquez Jr.,G,22023,1631170,22300267,"NOV 30, 2023",MIA vs. IND,W,33,8,13,0.615,1,3,0.333,7,7,1.0,0,5,5,1,1,0,3,3,24,18,1,MIA,MIA,IND,142,4.0,Rebounds,30,29,25,6
Jaime Jaquez Jr.,G,22023,1631170,22300267,"NOV 30, 2023",MIA vs. IND,W,33,8,13,0.615,1,3,0.333,7,7,1.0,0,5,5,1,1,0,3,3,24,18,1,MIA,MIA,IND,142,18.5,Pts+Rebs+Asts,30,29,25,6
Jaime Jaquez Jr.,G,22023,1631170,22300267,"NOV 30, 2023",MIA vs. IND,W,33,8,13,0.615,1,3,0.333,7,7,1.0,0,5,5,1,1,0,3,3,24,18,1,MIA,MIA,IND,142,2.5,Assists,30,29,25,6
Jaime Jaquez Jr.,G,22023,1631170,22300267,"NOV 30, 2023",MIA vs. IND,W,33,8,13,0.615,1,3,0.333,7,7,1.0,0,5,5,1,1,0,3,3,24,18,1,MIA,MIA,IND,142,16.5,Pts+Rebs,30,29,25,6
Jaime Jaquez Jr.,G,22023,1631170,22300267,"NOV 30, 2023",MIA vs. IND,W,33,8,13,0.615,1,3,0.333,7,7,1.0,0,5,5,1,1,0,3,3,24,18,1,MIA,MIA,IND,142,14.5,Pts+Asts,30,29,25,6
Jaime Jaquez Jr.,G,22023,1631170,22300267,"NOV 30, 2023",MIA vs. IND,W,33,8,13,0.615,1,3,0.333,7,7,1.0,0,5,5,1,1,0,3,3,24,18,1,MIA,MIA,IND,142,1.5,Turnovers,30,29,25,6
Jaime Jaquez Jr.,G,22023,1631170,22300056,"NOV 28, 2023",MIA vs. MIL,L,33,7,9,0.778,0,1,0.0,0,0,0.0,1,3,4,6,1,1,1,5,14,5,1,MIA,MIA,MIL,124,11.5,Points,24,18,20,10
Jaime Jaquez Jr.,G,22023,1631170,22300056,"NOV 28, 2023",MIA vs. MIL,L,33,7,9,0.778,0,1,0.0,0,0,0.0,1,3,4,6,1,1,1,5,14,5,1,MIA,MIA,MIL,124,4.0,Rebounds,24,18,20,10
Jaime Jaquez Jr.,G,22023,1631170,22300056,"NOV 28, 2023",MIA vs. MIL,L,33,7,9,0.778,0,1,0.0,0,0,0.0,1,3,4,6,1,1,1,5,14,5,1,MIA,MIA,MIL,124,18.5,Pts+Rebs+Asts,24,18,20,10
Jaime Jaquez Jr.,G,22023,1631170,22300056,"NOV 28, 2023",MIA vs. MIL,L,33,7,9,0.778,0,1,0.0,0,0,0.0,1,3,4,6,1,1,1,5,14,5,1,MIA,MIA,MIL,124,2.5,Assists,24,18,20,10
Jaime Jaquez Jr.,G,22023,1631170,22300056,"NOV 28, 2023",MIA vs. MIL,L,33,7,9,0.778,0,1,0.0,0,0,0.0,1,3,4,6,1,1,1,5,14,5,1,MIA,MIA,MIL,124,16.5,Pts+Rebs,24,18,20,10
Jaime Jaquez Jr.,G,22023,1631170,22300056,"NOV 28, 2023",MIA vs. MIL,L,33,7,9,0.778,0,1,0.0,0,0,0.0,1,3,4,6,1,1,1,5,14,5,1,MIA,MIA,MIL,124,14.5,Pts+Asts,24,18,20,10
Jaime Jaquez Jr.,G,22023,1631170,22300056,"NOV 28, 2023",MIA vs. MIL,L,33,7,9,0.778,0,1,0.0,0,0,0.0,1,3,4,6,1,1,1,5,14,5,1,MIA,MIA,MIL,124,1.5,Turnovers,24,18,20,10
Jaime Jaquez Jr.,G,22023,1631170,22300045,"NOV 24, 2023",MIA @ NYK,L,35,6,17,0.353,1,6,0.167,2,2,1.0,3,2,5,4,1,0,0,3,15,-18,1,MIA,NYK,MIA,98,11.5,Points,24,20,19,9
Jaime Jaquez Jr.,G,22023,1631170,22300045,"NOV 24, 2023",MIA @ NYK,L,35,6,17,0.353,1,6,0.167,2,2,1.0,3,2,5,4,1,0,0,3,15,-18,1,MIA,NYK,MIA,98,4.0,Rebounds,24,20,19,9
Jaime Jaquez Jr.,G,22023,1631170,22300045,"NOV 24, 2023",MIA @ NYK,L,35,6,17,0.353,1,6,0.167,2,2,1.0,3,2,5,4,1,0,0,3,15,-18,1,MIA,NYK,MIA,98,18.5,Pts+Rebs+Asts,24,20,19,9
Jaime Jaquez Jr.,G,22023,1631170,22300045,"NOV 24, 2023",MIA @ NYK,L,35,6,17,0.353,1,6,0.167,2,2,1.0,3,2,5,4,1,0,0,3,15,-18,1,MIA,NYK,MIA,98,2.5,Assists,24,20,19,9
Jaime Jaquez Jr.,G,22023,1631170,22300045,"NOV 24, 2023",MIA @ NYK,L,35,6,17,0.353,1,6,0.167,2,2,1.0,3,2,5,4,1,0,0,3,15,-18,1,MIA,NYK,MIA,98,16.5,Pts+Rebs,24,20,19,9
Jaime Jaquez Jr.,G,22023,1631170,22300045,"NOV 24, 2023",MIA @ NYK,L,35,6,17,0.353,1,6,0.167,2,2,1.0,3,2,5,4,1,0,0,3,15,-18,1,MIA,NYK,MIA,98,14.5,Pts+Asts,24,20,19,9
Jaime Jaquez Jr.,G,22023,1631170,22300045,"NOV 24, 2023",MIA @ NYK,L,35,6,17,0.353,1,6,0.167,2,2,1.0,3,2,5,4,1,0,0,3,15,-18,1,MIA,NYK,MIA,98,1.5,Turnovers,24,20,19,9
Jaime Jaquez Jr.,G,22023,1631170,22300220,"NOV 20, 2023",MIA @ CHI,W,33,8,13,0.615,3,4,0.75,0,0,0.0,2,1,3,4,2,0,0,1,19,24,1,MIA,CHI,MIA,118,11.5,Points,26,22,23,7
Jaime Jaquez Jr.,G,22023,1631170,22300220,"NOV 20, 2023",MIA @ CHI,W,33,8,13,0.615,3,4,0.75,0,0,0.0,2,1,3,4,2,0,0,1,19,24,1,MIA,CHI,MIA,118,4.0,Rebounds,26,22,23,7
Jaime Jaquez Jr.,G,22023,1631170,22300220,"NOV 20, 2023",MIA @ CHI,W,33,8,13,0.615,3,4,0.75,0,0,0.0,2,1,3,4,2,0,0,1,19,24,1,MIA,CHI,MIA,118,18.5,Pts+Rebs+Asts,26,22,23,7
Jaime Jaquez Jr.,G,22023,1631170,22300220,"NOV 20, 2023",MIA @ CHI,W,33,8,13,0.615,3,4,0.75,0,0,0.0,2,1,3,4,2,0,0,1,19,24,1,MIA,CHI,MIA,118,2.5,Assists,26,22,23,7
Jaime Jaquez Jr.,G,22023,1631170,22300220,"NOV 20, 2023",MIA @ CHI,W,33,8,13,0.615,3,4,0.75,0,0,0.0,2,1,3,4,2,0,0,1,19,24,1,MIA,CHI,MIA,118,16.5,Pts+Rebs,26,22,23,7
Jaime Jaquez Jr.,G,22023,1631170,22300220,"NOV 20, 2023",MIA @ CHI,W,33,8,13,0.615,3,4,0.75,0,0,0.0,2,1,3,4,2,0,0,1,19,24,1,MIA,CHI,MIA,118,14.5,Pts+Asts,26,22,23,7
Jaime Jaquez Jr.,G,22023,1631170,22300220,"NOV 20, 2023",MIA @ CHI,W,33,8,13,0.615,3,4,0.75,0,0,0.0,2,1,3,4,2,0,0,1,19,24,1,MIA,CHI,MIA,118,1.5,Turnovers,26,22,23,7
Jaime Jaquez Jr.,G,22023,1631170,22300204,"NOV 18, 2023",MIA @ CHI,L,27,2,4,0.5,1,1,1.0,1,2,0.5,1,2,3,0,0,0,3,4,6,-25,1,MIA,CHI,MIA,97,11.5,Points,9,9,6,3
Jaime Jaquez Jr.,G,22023,1631170,22300204,"NOV 18, 2023",MIA @ CHI,L,27,2,4,0.5,1,1,1.0,1,2,0.5,1,2,3,0,0,0,3,4,6,-25,1,MIA,CHI,MIA,97,4.0,Rebounds,9,9,6,3
Jaime Jaquez Jr.,G,22023,1631170,22300204,"NOV 18, 2023",MIA @ CHI,L,27,2,4,0.5,1,1,1.0,1,2,0.5,1,2,3,0,0,0,3,4,6,-25,1,MIA,CHI,MIA,97,18.5,Pts+Rebs+Asts,9,9,6,3
Jaime Jaquez Jr.,G,22023,1631170,22300204,"NOV 18, 2023",MIA @ CHI,L,27,2,4,0.5,1,1,1.0,1,2,0.5,1,2,3,0,0,0,3,4,6,-25,1,MIA,CHI,MIA,97,2.5,Assists,9,9,6,3
Jaime Jaquez Jr.,G,22023,1631170,22300204,"NOV 18, 2023",MIA @ CHI,L,27,2,4,0.5,1,1,1.0,1,2,0.5,1,2,3,0,0,0,3,4,6,-25,1,MIA,CHI,MIA,97,16.5,Pts+Rebs,9,9,6,3
Jaime Jaquez Jr.,G,22023,1631170,22300204,"NOV 18, 2023",MIA @ CHI,L,27,2,4,0.5,1,1,1.0,1,2,0.5,1,2,3,0,0,0,3,4,6,-25,1,MIA,CHI,MIA,97,14.5,Pts+Asts,9,9,6,3
Jaime Jaquez Jr.,G,22023,1631170,22300204,"NOV 18, 2023",MIA @ CHI,L,27,2,4,0.5,1,1,1.0,1,2,0.5,1,2,3,0,0,0,3,4,6,-25,1,MIA,CHI,MIA,97,1.5,Turnovers,9,9,6,3
Jaime Jaquez Jr.,G,22023,1631170,22300200,"NOV 16, 2023",MIA vs. BKN,W,33,4,9,0.444,2,5,0.4,0,0,0.0,0,4,4,5,0,0,1,3,10,4,1,MIA,MIA,BKN,122,11.5,Points,19,14,15,9
Jaime Jaquez Jr.,G,22023,1631170,22300200,"NOV 16, 2023",MIA vs. BKN,W,33,4,9,0.444,2,5,0.4,0,0,0.0,0,4,4,5,0,0,1,3,10,4,1,MIA,MIA,BKN,122,4.0,Rebounds,19,14,15,9
Jaime Jaquez Jr.,G,22023,1631170,22300200,"NOV 16, 2023",MIA vs. BKN,W,33,4,9,0.444,2,5,0.4,0,0,0.0,0,4,4,5,0,0,1,3,10,4,1,MIA,MIA,BKN,122,18.5,Pts+Rebs+Asts,19,14,15,9
Jaime Jaquez Jr.,G,22023,1631170,22300200,"NOV 16, 2023",MIA vs. BKN,W,33,4,9,0.444,2,5,0.4,0,0,0.0,0,4,4,5,0,0,1,3,10,4,1,MIA,MIA,BKN,122,2.5,Assists,19,14,15,9
Jaime Jaquez Jr.,G,22023,1631170,22300200,"NOV 16, 2023",MIA vs. BKN,W,33,4,9,0.444,2,5,0.4,0,0,0.0,0,4,4,5,0,0,1,3,10,4,1,MIA,MIA,BKN,122,16.5,Pts+Rebs,19,14,15,9
Jaime Jaquez Jr.,G,22023,1631170,22300200,"NOV 16, 2023",MIA vs. BKN,W,33,4,9,0.444,2,5,0.4,0,0,0.0,0,4,4,5,0,0,1,3,10,4,1,MIA,MIA,BKN,122,14.5,Pts+Asts,19,14,15,9
Jaime Jaquez Jr.,G,22023,1631170,22300200,"NOV 16, 2023",MIA vs. BKN,W,33,4,9,0.444,2,5,0.4,0,0,0.0,0,4,4,5,0,0,1,3,10,4,1,MIA,MIA,BKN,122,1.5,Turnovers,19,14,15,9
Jaime Jaquez Jr.,G,22023,1631170,22300017,"NOV 14, 2023",MIA @ CHA,W,33,8,13,0.615,1,3,0.333,0,0,0.0,4,1,5,1,0,0,1,3,17,6,1,MIA,CHA,MIA,111,11.5,Points,23,22,18,6
Jaime Jaquez Jr.,G,22023,1631170,22300017,"NOV 14, 2023",MIA @ CHA,W,33,8,13,0.615,1,3,0.333,0,0,0.0,4,1,5,1,0,0,1,3,17,6,1,MIA,CHA,MIA,111,4.0,Rebounds,23,22,18,6
Jaime Jaquez Jr.,G,22023,1631170,22300017,"NOV 14, 2023",MIA @ CHA,W,33,8,13,0.615,1,3,0.333,0,0,0.0,4,1,5,1,0,0,1,3,17,6,1,MIA,CHA,MIA,111,18.5,Pts+Rebs+Asts,23,22,18,6
Jaime Jaquez Jr.,G,22023,1631170,22300017,"NOV 14, 2023",MIA @ CHA,W,33,8,13,0.615,1,3,0.333,0,0,0.0,4,1,5,1,0,0,1,3,17,6,1,MIA,CHA,MIA,111,2.5,Assists,23,22,18,6
Jaime Jaquez Jr.,G,22023,1631170,22300017,"NOV 14, 2023",MIA @ CHA,W,33,8,13,0.615,1,3,0.333,0,0,0.0,4,1,5,1,0,0,1,3,17,6,1,MIA,CHA,MIA,111,16.5,Pts+Rebs,23,22,18,6
Jaime Jaquez Jr.,G,22023,1631170,22300017,"NOV 14, 2023",MIA @ CHA,W,33,8,13,0.615,1,3,0.333,0,0,0.0,4,1,5,1,0,0,1,3,17,6,1,MIA,CHA,MIA,111,14.5,Pts+Asts,23,22,18,6
Jaime Jaquez Jr.,G,22023,1631170,22300017,"NOV 14, 2023",MIA @ CHA,W,33,8,13,0.615,1,3,0.333,0,0,0.0,4,1,5,1,0,0,1,3,17,6,1,MIA,CHA,MIA,111,1.5,Turnovers,23,22,18,6
Jaime Jaquez Jr.,G,22023,1631170,22300184,"NOV 12, 2023",MIA @ SAS,W,32,4,10,0.4,1,2,0.5,2,2,1.0,1,5,6,3,3,1,1,1,11,10,1,MIA,SAS,MIA,118,11.5,Points,20,17,14,9
Jaime Jaquez Jr.,G,22023,1631170,22300184,"NOV 12, 2023",MIA @ SAS,W,32,4,10,0.4,1,2,0.5,2,2,1.0,1,5,6,3,3,1,1,1,11,10,1,MIA,SAS,MIA,118,4.0,Rebounds,20,17,14,9
Jaime Jaquez Jr.,G,22023,1631170,22300184,"NOV 12, 2023",MIA @ SAS,W,32,4,10,0.4,1,2,0.5,2,2,1.0,1,5,6,3,3,1,1,1,11,10,1,MIA,SAS,MIA,118,18.5,Pts+Rebs+Asts,20,17,14,9
Jaime Jaquez Jr.,G,22023,1631170,22300184,"NOV 12, 2023",MIA @ SAS,W,32,4,10,0.4,1,2,0.5,2,2,1.0,1,5,6,3,3,1,1,1,11,10,1,MIA,SAS,MIA,118,2.5,Assists,20,17,14,9
Jaime Jaquez Jr.,G,22023,1631170,22300184,"NOV 12, 2023",MIA @ SAS,W,32,4,10,0.4,1,2,0.5,2,2,1.0,1,5,6,3,3,1,1,1,11,10,1,MIA,SAS,MIA,118,16.5,Pts+Rebs,20,17,14,9
Jaime Jaquez Jr.,G,22023,1631170,22300184,"NOV 12, 2023",MIA @ SAS,W,32,4,10,0.4,1,2,0.5,2,2,1.0,1,5,6,3,3,1,1,1,11,10,1,MIA,SAS,MIA,118,14.5,Pts+Asts,20,17,14,9
Jaime Jaquez Jr.,G,22023,1631170,22300184,"NOV 12, 2023",MIA @ SAS,W,32,4,10,0.4,1,2,0.5,2,2,1.0,1,5,6,3,3,1,1,1,11,10,1,MIA,SAS,MIA,118,1.5,Turnovers,20,17,14,9
Jaime Jaquez Jr.,G,22023,1631170,22300175,"NOV 11, 2023",MIA @ ATL,W,38,8,17,0.471,2,7,0.286,2,2,1.0,1,2,3,4,1,0,3,3,20,2,1,MIA,ATL,MIA,117,11.5,Points,27,23,24,7
Jaime Jaquez Jr.,G,22023,1631170,22300175,"NOV 11, 2023",MIA @ ATL,W,38,8,17,0.471,2,7,0.286,2,2,1.0,1,2,3,4,1,0,3,3,20,2,1,MIA,ATL,MIA,117,4.0,Rebounds,27,23,24,7
Jaime Jaquez Jr.,G,22023,1631170,22300175,"NOV 11, 2023",MIA @ ATL,W,38,8,17,0.471,2,7,0.286,2,2,1.0,1,2,3,4,1,0,3,3,20,2,1,MIA,ATL,MIA,117,18.5,Pts+Rebs+Asts,27,23,24,7
Jaime Jaquez Jr.,G,22023,1631170,22300175,"NOV 11, 2023",MIA @ ATL,W,38,8,17,0.471,2,7,0.286,2,2,1.0,1,2,3,4,1,0,3,3,20,2,1,MIA,ATL,MIA,117,2.5,Assists,27,23,24,7
Jaime Jaquez Jr.,G,22023,1631170,22300175,"NOV 11, 2023",MIA @ ATL,W,38,8,17,0.471,2,7,0.286,2,2,1.0,1,2,3,4,1,0,3,3,20,2,1,MIA,ATL,MIA,117,16.5,Pts+Rebs,27,23,24,7
Jaime Jaquez Jr.,G,22023,1631170,22300175,"NOV 11, 2023",MIA @ ATL,W,38,8,17,0.471,2,7,0.286,2,2,1.0,1,2,3,4,1,0,3,3,20,2,1,MIA,ATL,MIA,117,14.5,Pts+Asts,27,23,24,7
Jaime Jaquez Jr.,G,22023,1631170,22300175,"NOV 11, 2023",MIA @ ATL,W,38,8,17,0.471,2,7,0.286,2,2,1.0,1,2,3,4,1,0,3,3,20,2,1,MIA,ATL,MIA,117,1.5,Turnovers,27,23,24,7
Jaime Jaquez Jr.,G,22023,1631170,22300164,"NOV 08, 2023",MIA @ MEM,W,21,4,5,0.8,1,1,1.0,2,3,0.667,0,3,3,2,2,0,0,5,11,-6,1,MIA,MEM,MIA,108,11.5,Points,16,14,13,5
Jaime Jaquez Jr.,G,22023,1631170,22300164,"NOV 08, 2023",MIA @ MEM,W,21,4,5,0.8,1,1,1.0,2,3,0.667,0,3,3,2,2,0,0,5,11,-6,1,MIA,MEM,MIA,108,4.0,Rebounds,16,14,13,5
Jaime Jaquez Jr.,G,22023,1631170,22300164,"NOV 08, 2023",MIA @ MEM,W,21,4,5,0.8,1,1,1.0,2,3,0.667,0,3,3,2,2,0,0,5,11,-6,1,MIA,MEM,MIA,108,18.5,Pts+Rebs+Asts,16,14,13,5
Jaime Jaquez Jr.,G,22023,1631170,22300164,"NOV 08, 2023",MIA @ MEM,W,21,4,5,0.8,1,1,1.0,2,3,0.667,0,3,3,2,2,0,0,5,11,-6,1,MIA,MEM,MIA,108,2.5,Assists,16,14,13,5
Jaime Jaquez Jr.,G,22023,1631170,22300164,"NOV 08, 2023",MIA @ MEM,W,21,4,5,0.8,1,1,1.0,2,3,0.667,0,3,3,2,2,0,0,5,11,-6,1,MIA,MEM,MIA,108,16.5,Pts+Rebs,16,14,13,5
Jaime Jaquez Jr.,G,22023,1631170,22300164,"NOV 08, 2023",MIA @ MEM,W,21,4,5,0.8,1,1,1.0,2,3,0.667,0,3,3,2,2,0,0,5,11,-6,1,MIA,MEM,MIA,108,14.5,Pts+Asts,16,14,13,5
Jaime Jaquez Jr.,G,22023,1631170,22300164,"NOV 08, 2023",MIA @ MEM,W,21,4,5,0.8,1,1,1.0,2,3,0.667,0,3,3,2,2,0,0,5,11,-6,1,MIA,MEM,MIA,108,1.5,Turnovers,16,14,13,5
Jaime Jaquez Jr.,G,22023,1631170,22300150,"NOV 06, 2023",MIA vs. LAL,W,18,4,7,0.571,1,4,0.25,0,0,0.0,1,1,2,1,1,0,1,1,9,0,1,MIA,MIA,LAL,108,11.5,Points,12,11,10,3
Jaime Jaquez Jr.,G,22023,1631170,22300150,"NOV 06, 2023",MIA vs. LAL,W,18,4,7,0.571,1,4,0.25,0,0,0.0,1,1,2,1,1,0,1,1,9,0,1,MIA,MIA,LAL,108,4.0,Rebounds,12,11,10,3
Jaime Jaquez Jr.,G,22023,1631170,22300150,"NOV 06, 2023",MIA vs. LAL,W,18,4,7,0.571,1,4,0.25,0,0,0.0,1,1,2,1,1,0,1,1,9,0,1,MIA,MIA,LAL,108,18.5,Pts+Rebs+Asts,12,11,10,3
Jaime Jaquez Jr.,G,22023,1631170,22300150,"NOV 06, 2023",MIA vs. LAL,W,18,4,7,0.571,1,4,0.25,0,0,0.0,1,1,2,1,1,0,1,1,9,0,1,MIA,MIA,LAL,108,2.5,Assists,12,11,10,3
Jaime Jaquez Jr.,G,22023,1631170,22300150,"NOV 06, 2023",MIA vs. LAL,W,18,4,7,0.571,1,4,0.25,0,0,0.0,1,1,2,1,1,0,1,1,9,0,1,MIA,MIA,LAL,108,16.5,Pts+Rebs,12,11,10,3
Jaime Jaquez Jr.,G,22023,1631170,22300150,"NOV 06, 2023",MIA vs. LAL,W,18,4,7,0.571,1,4,0.25,0,0,0.0,1,1,2,1,1,0,1,1,9,0,1,MIA,MIA,LAL,108,14.5,Pts+Asts,12,11,10,3
Jaime Jaquez Jr.,G,22023,1631170,22300150,"NOV 06, 2023",MIA vs. LAL,W,18,4,7,0.571,1,4,0.25,0,0,0.0,1,1,2,1,1,0,1,1,9,0,1,MIA,MIA,LAL,108,1.5,Turnovers,12,11,10,3
Jaime Jaquez Jr.,G,22023,1631170,22300003,"NOV 03, 2023",MIA vs. WAS,W,22,4,5,0.8,0,1,0.0,1,1,1.0,3,2,5,3,1,0,0,1,9,3,1,MIA,MIA,WAS,121,11.5,Points,17,14,12,8
Jaime Jaquez Jr.,G,22023,1631170,22300003,"NOV 03, 2023",MIA vs. WAS,W,22,4,5,0.8,0,1,0.0,1,1,1.0,3,2,5,3,1,0,0,1,9,3,1,MIA,MIA,WAS,121,4.0,Rebounds,17,14,12,8
Jaime Jaquez Jr.,G,22023,1631170,22300003,"NOV 03, 2023",MIA vs. WAS,W,22,4,5,0.8,0,1,0.0,1,1,1.0,3,2,5,3,1,0,0,1,9,3,1,MIA,MIA,WAS,121,18.5,Pts+Rebs+Asts,17,14,12,8
Jaime Jaquez Jr.,G,22023,1631170,22300003,"NOV 03, 2023",MIA vs. WAS,W,22,4,5,0.8,0,1,0.0,1,1,1.0,3,2,5,3,1,0,0,1,9,3,1,MIA,MIA,WAS,121,2.5,Assists,17,14,12,8
Jaime Jaquez Jr.,G,22023,1631170,22300003,"NOV 03, 2023",MIA vs. WAS,W,22,4,5,0.8,0,1,0.0,1,1,1.0,3,2,5,3,1,0,0,1,9,3,1,MIA,MIA,WAS,121,16.5,Pts+Rebs,17,14,12,8
Jaime Jaquez Jr.,G,22023,1631170,22300003,"NOV 03, 2023",MIA vs. WAS,W,22,4,5,0.8,0,1,0.0,1,1,1.0,3,2,5,3,1,0,0,1,9,3,1,MIA,MIA,WAS,121,14.5,Pts+Asts,17,14,12,8
Jaime Jaquez Jr.,G,22023,1631170,22300003,"NOV 03, 2023",MIA vs. WAS,W,22,4,5,0.8,0,1,0.0,1,1,1.0,3,2,5,3,1,0,0,1,9,3,1,MIA,MIA,WAS,121,1.5,Turnovers,17,14,12,8
Jaime Jaquez Jr.,G,22023,1631170,22300119,"NOV 01, 2023",MIA vs. BKN,L,19,1,9,0.111,0,6,0.0,0,0,0.0,2,2,4,1,2,1,2,4,2,7,1,MIA,MIA,BKN,105,11.5,Points,7,6,3,5
Jaime Jaquez Jr.,G,22023,1631170,22300119,"NOV 01, 2023",MIA vs. BKN,L,19,1,9,0.111,0,6,0.0,0,0,0.0,2,2,4,1,2,1,2,4,2,7,1,MIA,MIA,BKN,105,4.0,Rebounds,7,6,3,5
Jaime Jaquez Jr.,G,22023,1631170,22300119,"NOV 01, 2023",MIA vs. BKN,L,19,1,9,0.111,0,6,0.0,0,0,0.0,2,2,4,1,2,1,2,4,2,7,1,MIA,MIA,BKN,105,18.5,Pts+Rebs+Asts,7,6,3,5
Jaime Jaquez Jr.,G,22023,1631170,22300119,"NOV 01, 2023",MIA vs. BKN,L,19,1,9,0.111,0,6,0.0,0,0,0.0,2,2,4,1,2,1,2,4,2,7,1,MIA,MIA,BKN,105,2.5,Assists,7,6,3,5
Jaime Jaquez Jr.,G,22023,1631170,22300119,"NOV 01, 2023",MIA vs. BKN,L,19,1,9,0.111,0,6,0.0,0,0,0.0,2,2,4,1,2,1,2,4,2,7,1,MIA,MIA,BKN,105,16.5,Pts+Rebs,7,6,3,5
Jaime Jaquez Jr.,G,22023,1631170,22300119,"NOV 01, 2023",MIA vs. BKN,L,19,1,9,0.111,0,6,0.0,0,0,0.0,2,2,4,1,2,1,2,4,2,7,1,MIA,MIA,BKN,105,14.5,Pts+Asts,7,6,3,5
Jaime Jaquez Jr.,G,22023,1631170,22300119,"NOV 01, 2023",MIA vs. BKN,L,19,1,9,0.111,0,6,0.0,0,0,0.0,2,2,4,1,2,1,2,4,2,7,1,MIA,MIA,BKN,105,1.5,Turnovers,7,6,3,5
Jaime Jaquez Jr.,G,22023,1631170,22300093,"OCT 28, 2023",MIA @ MIN,L,18,3,4,0.75,1,2,0.5,0,0,0.0,0,3,3,1,0,0,3,0,7,5,1,MIA,MIN,MIA,90,11.5,Points,11,10,8,4
Jaime Jaquez Jr.,G,22023,1631170,22300093,"OCT 28, 2023",MIA @ MIN,L,18,3,4,0.75,1,2,0.5,0,0,0.0,0,3,3,1,0,0,3,0,7,5,1,MIA,MIN,MIA,90,4.0,Rebounds,11,10,8,4
Jaime Jaquez Jr.,G,22023,1631170,22300093,"OCT 28, 2023",MIA @ MIN,L,18,3,4,0.75,1,2,0.5,0,0,0.0,0,3,3,1,0,0,3,0,7,5,1,MIA,MIN,MIA,90,18.5,Pts+Rebs+Asts,11,10,8,4
Jaime Jaquez Jr.,G,22023,1631170,22300093,"OCT 28, 2023",MIA @ MIN,L,18,3,4,0.75,1,2,0.5,0,0,0.0,0,3,3,1,0,0,3,0,7,5,1,MIA,MIN,MIA,90,2.5,Assists,11,10,8,4
Jaime Jaquez Jr.,G,22023,1631170,22300093,"OCT 28, 2023",MIA @ MIN,L,18,3,4,0.75,1,2,0.5,0,0,0.0,0,3,3,1,0,0,3,0,7,5,1,MIA,MIN,MIA,90,16.5,Pts+Rebs,11,10,8,4
Jaime Jaquez Jr.,G,22023,1631170,22300093,"OCT 28, 2023",MIA @ MIN,L,18,3,4,0.75,1,2,0.5,0,0,0.0,0,3,3,1,0,0,3,0,7,5,1,MIA,MIN,MIA,90,14.5,Pts+Asts,11,10,8,4
Jaime Jaquez Jr.,G,22023,1631170,22300093,"OCT 28, 2023",MIA @ MIN,L,18,3,4,0.75,1,2,0.5,0,0,0.0,0,3,3,1,0,0,3,0,7,5,1,MIA,MIN,MIA,90,1.5,Turnovers,11,10,8,4
Jaime Jaquez Jr.,G,22023,1631170,22300080,"OCT 27, 2023",MIA @ BOS,L,14,0,2,0.0,0,1,0.0,0,0,0.0,0,2,2,2,0,0,1,2,0,-8,1,MIA,BOS,MIA,111,11.5,Points,4,2,2,4
Jaime Jaquez Jr.,G,22023,1631170,22300080,"OCT 27, 2023",MIA @ BOS,L,14,0,2,0.0,0,1,0.0,0,0,0.0,0,2,2,2,0,0,1,2,0,-8,1,MIA,BOS,MIA,111,4.0,Rebounds,4,2,2,4
Jaime Jaquez Jr.,G,22023,1631170,22300080,"OCT 27, 2023",MIA @ BOS,L,14,0,2,0.0,0,1,0.0,0,0,0.0,0,2,2,2,0,0,1,2,0,-8,1,MIA,BOS,MIA,111,18.5,Pts+Rebs+Asts,4,2,2,4
Jaime Jaquez Jr.,G,22023,1631170,22300080,"OCT 27, 2023",MIA @ BOS,L,14,0,2,0.0,0,1,0.0,0,0,0.0,0,2,2,2,0,0,1,2,0,-8,1,MIA,BOS,MIA,111,2.5,Assists,4,2,2,4
Jaime Jaquez Jr.,G,22023,1631170,22300080,"OCT 27, 2023",MIA @ BOS,L,14,0,2,0.0,0,1,0.0,0,0,0.0,0,2,2,2,0,0,1,2,0,-8,1,MIA,BOS,MIA,111,16.5,Pts+Rebs,4,2,2,4
Jaime Jaquez Jr.,G,22023,1631170,22300080,"OCT 27, 2023",MIA @ BOS,L,14,0,2,0.0,0,1,0.0,0,0,0.0,0,2,2,2,0,0,1,2,0,-8,1,MIA,BOS,MIA,111,14.5,Pts+Asts,4,2,2,4
Jaime Jaquez Jr.,G,22023,1631170,22300080,"OCT 27, 2023",MIA @ BOS,L,14,0,2,0.0,0,1,0.0,0,0,0.0,0,2,2,2,0,0,1,2,0,-8,1,MIA,BOS,MIA,111,1.5,Turnovers,4,2,2,4
Jaime Jaquez Jr.,G,22023,1631170,22300068,"OCT 25, 2023",MIA vs. DET,W,13,3,3,1.0,0,0,0.0,0,0,0.0,0,2,2,2,2,0,1,2,6,4,1,MIA,MIA,DET,103,11.5,Points,10,8,8,4
Jaime Jaquez Jr.,G,22023,1631170,22300068,"OCT 25, 2023",MIA vs. DET,W,13,3,3,1.0,0,0,0.0,0,0,0.0,0,2,2,2,2,0,1,2,6,4,1,MIA,MIA,DET,103,4.0,Rebounds,10,8,8,4
Jaime Jaquez Jr.,G,22023,1631170,22300068,"OCT 25, 2023",MIA vs. DET,W,13,3,3,1.0,0,0,0.0,0,0,0.0,0,2,2,2,2,0,1,2,6,4,1,MIA,MIA,DET,103,18.5,Pts+Rebs+Asts,10,8,8,4
Jaime Jaquez Jr.,G,22023,1631170,22300068,"OCT 25, 2023",MIA vs. DET,W,13,3,3,1.0,0,0,0.0,0,0,0.0,0,2,2,2,2,0,1,2,6,4,1,MIA,MIA,DET,103,2.5,Assists,10,8,8,4
Jaime Jaquez Jr.,G,22023,1631170,22300068,"OCT 25, 2023",MIA vs. DET,W,13,3,3,1.0,0,0,0.0,0,0,0.0,0,2,2,2,2,0,1,2,6,4,1,MIA,MIA,DET,103,16.5,Pts+Rebs,10,8,8,4
Jaime Jaquez Jr.,G,22023,1631170,22300068,"OCT 25, 2023",MIA vs. DET,W,13,3,3,1.0,0,0,0.0,0,0,0.0,0,2,2,2,2,0,1,2,6,4,1,MIA,MIA,DET,103,14.5,Pts+Asts,10,8,8,4
Jaime Jaquez Jr.,G,22023,1631170,22300068,"OCT 25, 2023",MIA vs. DET,W,13,3,3,1.0,0,0,0.0,0,0,0.0,0,2,2,2,2,0,1,2,6,4,1,MIA,MIA,DET,103,1.5,Turnovers,10,8,8,4
Jaime Jaquez Jr.,G,22023,1631170,22300337,"DEC 16, 2023",MIA vs. CHI,W,35,8,14,0.571,1,3,0.333,1,1,1.0,1,4,5,4,2,0,2,1,18,8,1,MIA,MIA,CHI,118,11.5,Points,27,23,22,9
Jaime Jaquez Jr.,G,22023,1631170,22300337,"DEC 16, 2023",MIA vs. CHI,W,35,8,14,0.571,1,3,0.333,1,1,1.0,1,4,5,4,2,0,2,1,18,8,1,MIA,MIA,CHI,118,4.0,Rebounds,27,23,22,9
Jaime Jaquez Jr.,G,22023,1631170,22300337,"DEC 16, 2023",MIA vs. CHI,W,35,8,14,0.571,1,3,0.333,1,1,1.0,1,4,5,4,2,0,2,1,18,8,1,MIA,MIA,CHI,118,18.5,Pts+Rebs+Asts,27,23,22,9
Jaime Jaquez Jr.,G,22023,1631170,22300337,"DEC 16, 2023",MIA vs. CHI,W,35,8,14,0.571,1,3,0.333,1,1,1.0,1,4,5,4,2,0,2,1,18,8,1,MIA,MIA,CHI,118,2.5,Assists,27,23,22,9
Jaime Jaquez Jr.,G,22023,1631170,22300337,"DEC 16, 2023",MIA vs. CHI,W,35,8,14,0.571,1,3,0.333,1,1,1.0,1,4,5,4,2,0,2,1,18,8,1,MIA,MIA,CHI,118,16.5,Pts+Rebs,27,23,22,9
Jaime Jaquez Jr.,G,22023,1631170,22300337,"DEC 16, 2023",MIA vs. CHI,W,35,8,14,0.571,1,3,0.333,1,1,1.0,1,4,5,4,2,0,2,1,18,8,1,MIA,MIA,CHI,118,14.5,Pts+Asts,27,23,22,9
Jaime Jaquez Jr.,G,22023,1631170,22300337,"DEC 16, 2023",MIA vs. CHI,W,35,8,14,0.571,1,3,0.333,1,1,1.0,1,4,5,4,2,0,2,1,18,8,1,MIA,MIA,CHI,118,1.5,Turnovers,27,23,22,9
Jaime Jaquez Jr.,G,22023,1631170,22300320,"DEC 14, 2023",MIA vs. CHI,L,34,6,14,0.429,1,4,0.25,9,10,0.9,0,4,4,4,0,0,2,4,22,3,1,MIA,MIA,CHI,116,11.5,Points,30,26,26,8
Jaime Jaquez Jr.,G,22023,1631170,22300320,"DEC 14, 2023",MIA vs. CHI,L,34,6,14,0.429,1,4,0.25,9,10,0.9,0,4,4,4,0,0,2,4,22,3,1,MIA,MIA,CHI,116,4.0,Rebounds,30,26,26,8
Jaime Jaquez Jr.,G,22023,1631170,22300320,"DEC 14, 2023",MIA vs. CHI,L,34,6,14,0.429,1,4,0.25,9,10,0.9,0,4,4,4,0,0,2,4,22,3,1,MIA,MIA,CHI,116,18.5,Pts+Rebs+Asts,30,26,26,8
Jaime Jaquez Jr.,G,22023,1631170,22300320,"DEC 14, 2023",MIA vs. CHI,L,34,6,14,0.429,1,4,0.25,9,10,0.9,0,4,4,4,0,0,2,4,22,3,1,MIA,MIA,CHI,116,2.5,Assists,30,26,26,8
Jaime Jaquez Jr.,G,22023,1631170,22300320,"DEC 14, 2023",MIA vs. CHI,L,34,6,14,0.429,1,4,0.25,9,10,0.9,0,4,4,4,0,0,2,4,22,3,1,MIA,MIA,CHI,116,16.5,Pts+Rebs,30,26,26,8
Jaime Jaquez Jr.,G,22023,1631170,22300320,"DEC 14, 2023",MIA vs. CHI,L,34,6,14,0.429,1,4,0.25,9,10,0.9,0,4,4,4,0,0,2,4,22,3,1,MIA,MIA,CHI,116,14.5,Pts+Asts,30,26,26,8
Jaime Jaquez Jr.,G,22023,1631170,22300320,"DEC 14, 2023",MIA vs. CHI,L,34,6,14,0.429,1,4,0.25,9,10,0.9,0,4,4,4,0,0,2,4,22,3,1,MIA,MIA,CHI,116,1.5,Turnovers,30,26,26,8
Jaime Jaquez Jr.,G,22023,1631170,22300312,"DEC 13, 2023",MIA vs. CHA,W,33,7,16,0.438,2,2,1.0,1,1,1.0,2,4,6,8,1,0,2,0,17,-3,1,MIA,MIA,CHA,115,11.5,Points,31,23,25,14
Jaime Jaquez Jr.,G,22023,1631170,22300312,"DEC 13, 2023",MIA vs. CHA,W,33,7,16,0.438,2,2,1.0,1,1,1.0,2,4,6,8,1,0,2,0,17,-3,1,MIA,MIA,CHA,115,4.0,Rebounds,31,23,25,14
Jaime Jaquez Jr.,G,22023,1631170,22300312,"DEC 13, 2023",MIA vs. CHA,W,33,7,16,0.438,2,2,1.0,1,1,1.0,2,4,6,8,1,0,2,0,17,-3,1,MIA,MIA,CHA,115,18.5,Pts+Rebs+Asts,31,23,25,14
Jaime Jaquez Jr.,G,22023,1631170,22300312,"DEC 13, 2023",MIA vs. CHA,W,33,7,16,0.438,2,2,1.0,1,1,1.0,2,4,6,8,1,0,2,0,17,-3,1,MIA,MIA,CHA,115,2.5,Assists,31,23,25,14
Jaime Jaquez Jr.,G,22023,1631170,22300312,"DEC 13, 2023",MIA vs. CHA,W,33,7,16,0.438,2,2,1.0,1,1,1.0,2,4,6,8,1,0,2,0,17,-3,1,MIA,MIA,CHA,115,16.5,Pts+Rebs,31,23,25,14
Jaime Jaquez Jr.,G,22023,1631170,22300312,"DEC 13, 2023",MIA vs. CHA,W,33,7,16,0.438,2,2,1.0,1,1,1.0,2,4,6,8,1,0,2,0,17,-3,1,MIA,MIA,CHA,115,14.5,Pts+Asts,31,23,25,14
Jaime Jaquez Jr.,G,22023,1631170,22300312,"DEC 13, 2023",MIA vs. CHA,W,33,7,16,0.438,2,2,1.0,1,1,1.0,2,4,6,8,1,0,2,0,17,-3,1,MIA,MIA,CHA,115,1.5,Turnovers,31,23,25,14
Jaime Jaquez Jr.,G,22023,1631170,22300292,"DEC 11, 2023",MIA @ CHA,W,24,5,8,0.625,2,3,0.667,6,6,1.0,0,0,0,1,0,0,2,6,18,-2,1,MIA,CHA,MIA,116,11.5,Points,19,18,19,1
Jaime Jaquez Jr.,G,22023,1631170,22300292,"DEC 11, 2023",MIA @ CHA,W,24,5,8,0.625,2,3,0.667,6,6,1.0,0,0,0,1,0,0,2,6,18,-2,1,MIA,CHA,MIA,116,4.0,Rebounds,19,18,19,1
Jaime Jaquez Jr.,G,22023,1631170,22300292,"DEC 11, 2023",MIA @ CHA,W,24,5,8,0.625,2,3,0.667,6,6,1.0,0,0,0,1,0,0,2,6,18,-2,1,MIA,CHA,MIA,116,18.5,Pts+Rebs+Asts,19,18,19,1
Jaime Jaquez Jr.,G,22023,1631170,22300292,"DEC 11, 2023",MIA @ CHA,W,24,5,8,0.625,2,3,0.667,6,6,1.0,0,0,0,1,0,0,2,6,18,-2,1,MIA,CHA,MIA,116,2.5,Assists,19,18,19,1
Jaime Jaquez Jr.,G,22023,1631170,22300292,"DEC 11, 2023",MIA @ CHA,W,24,5,8,0.625,2,3,0.667,6,6,1.0,0,0,0,1,0,0,2,6,18,-2,1,MIA,CHA,MIA,116,16.5,Pts+Rebs,19,18,19,1
Jaime Jaquez Jr.,G,22023,1631170,22300292,"DEC 11, 2023",MIA @ CHA,W,24,5,8,0.625,2,3,0.667,6,6,1.0,0,0,0,1,0,0,2,6,18,-2,1,MIA,CHA,MIA,116,14.5,Pts+Asts,19,18,19,1
Jaime Jaquez Jr.,G,22023,1631170,22300292,"DEC 11, 2023",MIA @ CHA,W,24,5,8,0.625,2,3,0.667,6,6,1.0,0,0,0,1,0,0,2,6,18,-2,1,MIA,CHA,MIA,116,1.5,Turnovers,19,18,19,1
Jaime Jaquez Jr.,G,22023,1631170,22300240,"NOV 25, 2023",MIA @ BKN,L,31,8,15,0.533,2,3,0.667,0,0,0.0,1,4,5,4,1,0,2,1,18,-18,1,MIA,BKN,MIA,97,11.5,Points,27,23,22,9
Jaime Jaquez Jr.,G,22023,1631170,22300240,"NOV 25, 2023",MIA @ BKN,L,31,8,15,0.533,2,3,0.667,0,0,0.0,1,4,5,4,1,0,2,1,18,-18,1,MIA,BKN,MIA,97,4.0,Rebounds,27,23,22,9
Jaime Jaquez Jr.,G,22023,1631170,22300240,"NOV 25, 2023",MIA @ BKN,L,31,8,15,0.533,2,3,0.667,0,0,0.0,1,4,5,4,1,0,2,1,18,-18,1,MIA,BKN,MIA,97,18.5,Pts+Rebs+Asts,27,23,22,9
Jaime Jaquez Jr.,G,22023,1631170,22300240,"NOV 25, 2023",MIA @ BKN,L,31,8,15,0.533,2,3,0.667,0,0,0.0,1,4,5,4,1,0,2,1,18,-18,1,MIA,BKN,MIA,97,2.5,Assists,27,23,22,9
Jaime Jaquez Jr.,G,22023,1631170,22300240,"NOV 25, 2023",MIA @ BKN,L,31,8,15,0.533,2,3,0.667,0,0,0.0,1,4,5,4,1,0,2,1,18,-18,1,MIA,BKN,MIA,97,16.5,Pts+Rebs,27,23,22,9
Jaime Jaquez Jr.,G,22023,1631170,22300240,"NOV 25, 2023",MIA @ BKN,L,31,8,15,0.533,2,3,0.667,0,0,0.0,1,4,5,4,1,0,2,1,18,-18,1,MIA,BKN,MIA,97,14.5,Pts+Asts,27,23,22,9
Jaime Jaquez Jr.,G,22023,1631170,22300240,"NOV 25, 2023",MIA @ BKN,L,31,8,15,0.533,2,3,0.667,0,0,0.0,1,4,5,4,1,0,2,1,18,-18,1,MIA,BKN,MIA,97,1.5,Turnovers,27,23,22,9
Jaime Jaquez Jr.,G,22023,1631170,22300229,"NOV 22, 2023",MIA @ CLE,W,28,7,10,0.7,4,4,1.0,4,5,0.8,2,6,8,1,1,0,6,1,22,16,1,MIA,CLE,MIA,129,11.5,Points,31,30,23,9
Jaime Jaquez Jr.,G,22023,1631170,22300229,"NOV 22, 2023",MIA @ CLE,W,28,7,10,0.7,4,4,1.0,4,5,0.8,2,6,8,1,1,0,6,1,22,16,1,MIA,CLE,MIA,129,4.0,Rebounds,31,30,23,9
Jaime Jaquez Jr.,G,22023,1631170,22300229,"NOV 22, 2023",MIA @ CLE,W,28,7,10,0.7,4,4,1.0,4,5,0.8,2,6,8,1,1,0,6,1,22,16,1,MIA,CLE,MIA,129,18.5,Pts+Rebs+Asts,31,30,23,9
Jaime Jaquez Jr.,G,22023,1631170,22300229,"NOV 22, 2023",MIA @ CLE,W,28,7,10,0.7,4,4,1.0,4,5,0.8,2,6,8,1,1,0,6,1,22,16,1,MIA,CLE,MIA,129,2.5,Assists,31,30,23,9
Jaime Jaquez Jr.,G,22023,1631170,22300229,"NOV 22, 2023",MIA @ CLE,W,28,7,10,0.7,4,4,1.0,4,5,0.8,2,6,8,1,1,0,6,1,22,16,1,MIA,CLE,MIA,129,16.5,Pts+Rebs,31,30,23,9
Jaime Jaquez Jr.,G,22023,1631170,22300229,"NOV 22, 2023",MIA @ CLE,W,28,7,10,0.7,4,4,1.0,4,5,0.8,2,6,8,1,1,0,6,1,22,16,1,MIA,CLE,MIA,129,14.5,Pts+Asts,31,30,23,9
Jaime Jaquez Jr.,G,22023,1631170,22300229,"NOV 22, 2023",MIA @ CLE,W,28,7,10,0.7,4,4,1.0,4,5,0.8,2,6,8,1,1,0,6,1,22,16,1,MIA,CLE,MIA,129,1.5,Turnovers,31,30,23,9
Jaime Jaquez Jr.,G,22023,1631170,22300107,"OCT 30, 2023",MIA @ MIL,L,23,3,9,0.333,2,5,0.4,0,0,0.0,1,1,2,3,1,1,0,2,8,-7,1,MIA,MIL,MIA,114,11.5,Points,13,10,11,5
Jaime Jaquez Jr.,G,22023,1631170,22300107,"OCT 30, 2023",MIA @ MIL,L,23,3,9,0.333,2,5,0.4,0,0,0.0,1,1,2,3,1,1,0,2,8,-7,1,MIA,MIL,MIA,114,4.0,Rebounds,13,10,11,5
Jaime Jaquez Jr.,G,22023,1631170,22300107,"OCT 30, 2023",MIA @ MIL,L,23,3,9,0.333,2,5,0.4,0,0,0.0,1,1,2,3,1,1,0,2,8,-7,1,MIA,MIL,MIA,114,18.5,Pts+Rebs+Asts,13,10,11,5
Jaime Jaquez Jr.,G,22023,1631170,22300107,"OCT 30, 2023",MIA @ MIL,L,23,3,9,0.333,2,5,0.4,0,0,0.0,1,1,2,3,1,1,0,2,8,-7,1,MIA,MIL,MIA,114,2.5,Assists,13,10,11,5
Jaime Jaquez Jr.,G,22023,1631170,22300107,"OCT 30, 2023",MIA @ MIL,L,23,3,9,0.333,2,5,0.4,0,0,0.0,1,1,2,3,1,1,0,2,8,-7,1,MIA,MIL,MIA,114,16.5,Pts+Rebs,13,10,11,5
Jaime Jaquez Jr.,G,22023,1631170,22300107,"OCT 30, 2023",MIA @ MIL,L,23,3,9,0.333,2,5,0.4,0,0,0.0,1,1,2,3,1,1,0,2,8,-7,1,MIA,MIL,MIA,114,14.5,Pts+Asts,13,10,11,5
Jaime Jaquez Jr.,G,22023,1631170,22300107,"OCT 30, 2023",MIA @ MIL,L,23,3,9,0.333,2,5,0.4,0,0,0.0,1,1,2,3,1,1,0,2,8,-7,1,MIA,MIL,MIA,114,1.5,Turnovers,13,10,11,5
Jaime Jaquez Jr.,G,22023,1631170,22301220,"DEC 08, 2023",MIA vs. CLE,L,35,7,13,0.538,0,2,0.0,0,0,0.0,1,2,3,3,0,1,3,3,14,1,1,MIA,MIA,CLE,99,11.5,Points,20,17,17,6
Jaime Jaquez Jr.,G,22023,1631170,22301220,"DEC 08, 2023",MIA vs. CLE,L,35,7,13,0.538,0,2,0.0,0,0,0.0,1,2,3,3,0,1,3,3,14,1,1,MIA,MIA,CLE,99,4.0,Rebounds,20,17,17,6
Jaime Jaquez Jr.,G,22023,1631170,22301220,"DEC 08, 2023",MIA vs. CLE,L,35,7,13,0.538,0,2,0.0,0,0,0.0,1,2,3,3,0,1,3,3,14,1,1,MIA,MIA,CLE,99,18.5,Pts+Rebs+Asts,20,17,17,6
Jaime Jaquez Jr.,G,22023,1631170,22301220,"DEC 08, 2023",MIA vs. CLE,L,35,7,13,0.538,0,2,0.0,0,0,0.0,1,2,3,3,0,1,3,3,14,1,1,MIA,MIA,CLE,99,2.5,Assists,20,17,17,6
Jaime Jaquez Jr.,G,22023,1631170,22301220,"DEC 08, 2023",MIA vs. CLE,L,35,7,13,0.538,0,2,0.0,0,0,0.0,1,2,3,3,0,1,3,3,14,1,1,MIA,MIA,CLE,99,16.5,Pts+Rebs,20,17,17,6
Jaime Jaquez Jr.,G,22023,1631170,22301220,"DEC 08, 2023",MIA vs. CLE,L,35,7,13,0.538,0,2,0.0,0,0,0.0,1,2,3,3,0,1,3,3,14,1,1,MIA,MIA,CLE,99,14.5,Pts+Asts,20,17,17,6
Jaime Jaquez Jr.,G,22023,1631170,22301220,"DEC 08, 2023",MIA vs. CLE,L,35,7,13,0.538,0,2,0.0,0,0,0.0,1,2,3,3,0,1,3,3,14,1,1,MIA,MIA,CLE,99,1.5,Turnovers,20,17,17,6
Jaime Jaquez Jr.,G,22023,1631170,22301207,"DEC 06, 2023",MIA @ TOR,W,32,6,13,0.462,1,4,0.25,2,2,1.0,0,0,0,2,0,0,2,2,15,-16,1,MIA,TOR,MIA,112,11.5,Points,17,15,17,2
Jaime Jaquez Jr.,G,22023,1631170,22301207,"DEC 06, 2023",MIA @ TOR,W,32,6,13,0.462,1,4,0.25,2,2,1.0,0,0,0,2,0,0,2,2,15,-16,1,MIA,TOR,MIA,112,4.0,Rebounds,17,15,17,2
Jaime Jaquez Jr.,G,22023,1631170,22301207,"DEC 06, 2023",MIA @ TOR,W,32,6,13,0.462,1,4,0.25,2,2,1.0,0,0,0,2,0,0,2,2,15,-16,1,MIA,TOR,MIA,112,18.5,Pts+Rebs+Asts,17,15,17,2
Jaime Jaquez Jr.,G,22023,1631170,22301207,"DEC 06, 2023",MIA @ TOR,W,32,6,13,0.462,1,4,0.25,2,2,1.0,0,0,0,2,0,0,2,2,15,-16,1,MIA,TOR,MIA,112,2.5,Assists,17,15,17,2
Jaime Jaquez Jr.,G,22023,1631170,22301207,"DEC 06, 2023",MIA @ TOR,W,32,6,13,0.462,1,4,0.25,2,2,1.0,0,0,0,2,0,0,2,2,15,-16,1,MIA,TOR,MIA,112,16.5,Pts+Rebs,17,15,17,2
Jaime Jaquez Jr.,G,22023,1631170,22301207,"DEC 06, 2023",MIA @ TOR,W,32,6,13,0.462,1,4,0.25,2,2,1.0,0,0,0,2,0,0,2,2,15,-16,1,MIA,TOR,MIA,112,14.5,Pts+Asts,17,15,17,2
Jaime Jaquez Jr.,G,22023,1631170,22301207,"DEC 06, 2023",MIA @ TOR,W,32,6,13,0.462,1,4,0.25,2,2,1.0,0,0,0,2,0,0,2,2,15,-16,1,MIA,TOR,MIA,112,1.5,Turnovers,17,15,17,2
Jaime Jaquez Jr.,G,22023,1631170,22300284,"DEC 02, 2023",MIA vs. IND,L,29,4,9,0.444,1,2,0.5,2,5,0.4,0,3,3,3,2,0,0,1,11,-6,1,MIA,MIA,IND,129,11.5,Points,17,14,14,6
Jaime Jaquez Jr.,G,22023,1631170,22300284,"DEC 02, 2023",MIA vs. IND,L,29,4,9,0.444,1,2,0.5,2,5,0.4,0,3,3,3,2,0,0,1,11,-6,1,MIA,MIA,IND,129,4.0,Rebounds,17,14,14,6
Jaime Jaquez Jr.,G,22023,1631170,22300284,"DEC 02, 2023",MIA vs. IND,L,29,4,9,0.444,1,2,0.5,2,5,0.4,0,3,3,3,2,0,0,1,11,-6,1,MIA,MIA,IND,129,18.5,Pts+Rebs+Asts,17,14,14,6
Jaime Jaquez Jr.,G,22023,1631170,22300284,"DEC 02, 2023",MIA vs. IND,L,29,4,9,0.444,1,2,0.5,2,5,0.4,0,3,3,3,2,0,0,1,11,-6,1,MIA,MIA,IND,129,2.5,Assists,17,14,14,6
Jaime Jaquez Jr.,G,22023,1631170,22300284,"DEC 02, 2023",MIA vs. IND,L,29,4,9,0.444,1,2,0.5,2,5,0.4,0,3,3,3,2,0,0,1,11,-6,1,MIA,MIA,IND,129,16.5,Pts+Rebs,17,14,14,6
Jaime Jaquez Jr.,G,22023,1631170,22300284,"DEC 02, 2023",MIA vs. IND,L,29,4,9,0.444,1,2,0.5,2,5,0.4,0,3,3,3,2,0,0,1,11,-6,1,MIA,MIA,IND,129,14.5,Pts+Asts,17,14,14,6
Jaime Jaquez Jr.,G,22023,1631170,22300284,"DEC 02, 2023",MIA vs. IND,L,29,4,9,0.444,1,2,0.5,2,5,0.4,0,3,3,3,2,0,0,1,11,-6,1,MIA,MIA,IND,129,1.5,Turnovers,17,14,14,6
Brook Lopez,C,22023,201572,22300745,"FEB 09, 2024",MIL vs. CHA,W,27,4,9,0.444,1,5,0.2,2,2,1.0,2,5,7,2,0,3,1,2,11,34,1,MIL,MIL,CHA,120,,,20,18,13,9
Brook Lopez,C,22023,201572,22300738,"FEB 08, 2024",MIL vs. MIN,L,26,5,8,0.625,2,4,0.5,0,0,0.0,1,4,5,2,1,2,0,1,12,-21,1,MIL,MIL,MIN,105,,,19,17,14,7
Brook Lopez,C,22023,201572,22300683,"JAN 31, 2024",MIL @ POR,L,36,7,14,0.5,4,10,0.4,1,1,1.0,0,4,4,3,1,2,0,1,19,1,1,MIL,POR,MIL,116,,,26,23,22,7
Brook Lopez,C,22023,201572,22300667,"JAN 29, 2024",MIL @ DEN,L,34,7,13,0.538,5,9,0.556,0,0,0.0,1,1,2,2,0,2,1,4,19,5,1,MIL,DEN,MIL,107,,,23,21,21,4
Brook Lopez,C,22023,201572,22300648,"JAN 27, 2024",MIL vs. NOP,W,35,8,11,0.727,6,9,0.667,2,2,1.0,0,3,3,0,1,0,2,2,24,29,1,MIL,MIL,NOP,141,,,27,27,24,3
Brook Lopez,C,22023,201572,22300639,"JAN 26, 2024",MIL vs. CLE,L,35,4,14,0.286,0,4,0.0,3,3,1.0,5,7,12,0,1,2,2,3,11,-21,1,MIL,MIL,CLE,100,,,23,23,11,12
Brook Lopez,C,22023,201572,22300624,"JAN 24, 2024",MIL vs. CLE,W,35,3,7,0.429,0,1,0.0,2,2,1.0,5,4,9,3,1,1,1,1,8,13,1,MIL,MIL,CLE,126,,,20,17,11,12
Brook Lopez,C,22023,201572,22300606,"JAN 22, 2024",MIL @ DET,W,35,6,9,0.667,1,2,0.5,2,2,1.0,5,6,11,3,0,4,3,4,15,19,1,MIL,DET,MIL,122,,,29,26,18,14
Brook Lopez,C,22023,201572,22300592,"JAN 20, 2024",MIL @ DET,W,37,7,13,0.538,1,4,0.25,4,5,0.8,2,8,10,4,1,3,0,1,19,14,1,MIL,DET,MIL,141,,,33,29,23,14
Brook Lopez,C,22023,201572,22300552,"JAN 14, 2024",MIL vs. SAC,W,40,7,15,0.467,3,6,0.5,0,0,0.0,1,8,9,3,0,3,0,2,17,5,1,MIL,MIL,SAC,143,,,29,26,20,12
Brook Lopez,C,22023,201572,22300545,"JAN 13, 2024",MIL vs. GSW,W,34,5,9,0.556,1,5,0.2,0,0,0.0,2,6,8,6,0,2,1,1,11,7,1,MIL,MIL,GSW,129,,,25,19,17,14
Brook Lopez,C,22023,201572,22300528,"JAN 11, 2024",MIL vs. BOS,W,28,6,8,0.75,2,4,0.5,1,2,0.5,1,4,5,3,0,2,1,3,15,20,1,MIL,MIL,BOS,135,,,23,20,18,8
Brook Lopez,C,22023,201572,22300510,"JAN 08, 2024",MIL vs. UTA,L,38,5,11,0.455,3,6,0.5,0,0,0.0,1,5,6,3,0,2,0,2,13,-9,1,MIL,MIL,UTA,116,,,22,19,16,9
Brook Lopez,C,22023,201572,22300496,"JAN 06, 2024",MIL @ HOU,L,31,3,9,0.333,1,6,0.167,0,0,0.0,0,5,5,0,1,1,0,2,7,11,1,MIL,HOU,MIL,108,,,12,12,7,5
Brook Lopez,C,22023,201572,22300477,"JAN 04, 2024",MIL @ SAS,W,33,4,10,0.4,1,5,0.2,0,0,0.0,0,4,4,1,0,3,4,4,9,8,1,MIL,SAS,MIL,125,,,14,13,10,5
Brook Lopez,C,22023,201572,22300466,"JAN 03, 2024",MIL @ IND,L,28,6,11,0.545,2,4,0.5,2,3,0.667,3,2,5,1,0,0,2,3,16,-22,1,MIL,IND,MIL,130,,,22,21,17,6
Brook Lopez,C,22023,201572,22300454,"JAN 01, 2024",MIL vs. IND,L,38,8,17,0.471,2,6,0.333,3,4,0.75,1,4,5,1,0,4,0,3,21,6,1,MIL,MIL,IND,113,,,27,26,22,6
Brook Lopez,C,22023,201572,22300433,"DEC 29, 2023",MIL @ CLE,W,36,4,10,0.4,1,3,0.333,0,0,0.0,3,7,10,2,0,6,0,3,9,9,1,MIL,CLE,MIL,119,,,21,19,11,12
Brook Lopez,C,22023,201572,22300417,"DEC 27, 2023",MIL @ BKN,W,25,1,7,0.143,0,6,0.0,0,0,0.0,2,4,6,2,0,3,0,3,2,-3,1,MIL,BKN,MIL,144,,,10,8,4,8
Brook Lopez,C,22023,201572,22300401,"DEC 25, 2023",MIL @ NYK,L,27,5,9,0.556,2,6,0.333,2,2,1.0,2,4,6,1,1,2,0,2,14,-6,1,MIL,NYK,MIL,122,,,21,20,15,7
Brook Lopez,C,22023,201572,22300388,"DEC 23, 2023",MIL @ NYK,W,35,1,7,0.143,0,2,0.0,3,4,0.75,1,2,3,1,0,1,0,3,5,15,1,MIL,NYK,MIL,130,,,9,8,6,4
Brook Lopez,C,22023,201572,22300378,"DEC 21, 2023",MIL vs. ORL,W,37,5,7,0.714,2,4,0.5,2,2,1.0,0,7,7,0,2,2,2,5,14,17,1,MIL,MIL,ORL,118,,,21,21,14,7
Brook Lopez,C,22023,201572,22300361,"DEC 19, 2023",MIL vs. SAS,W,32,6,14,0.429,0,5,0.0,2,2,1.0,5,0,5,1,0,6,0,3,14,13,1,MIL,MIL,SAS,132,,,20,19,15,6
Brook Lopez,C,22023,201572,22300346,"DEC 17, 2023",MIL vs. HOU,W,31,6,13,0.462,3,8,0.375,3,3,1.0,1,5,6,0,0,1,0,2,18,6,1,MIL,MIL,HOU,128,,,24,24,18,6
Brook Lopez,C,22023,201572,22300334,"DEC 16, 2023",MIL vs. DET,W,26,2,3,0.667,1,2,0.5,0,0,0.0,0,1,1,1,0,5,2,3,5,23,1,MIL,MIL,DET,146,,,7,6,6,2
Brook Lopez,C,22023,201572,22300315,"DEC 13, 2023",MIL vs. IND,W,33,1,6,0.167,0,2,0.0,4,4,1.0,2,1,3,1,0,6,1,5,6,1,1,MIL,MIL,IND,140,,,10,9,7,4
Brook Lopez,C,22023,201572,22300300,"DEC 11, 2023",MIL vs. CHI,W,40,6,11,0.545,2,6,0.333,5,6,0.833,2,1,3,3,1,3,1,4,19,-1,1,MIL,MIL,CHI,133,,,25,22,22,6
Brook Lopez,C,22023,201572,22301229,"DEC 07, 2023",MIL vs. IND,L,37,7,17,0.412,3,10,0.3,1,3,0.333,2,4,6,2,0,4,1,5,18,-3,1,MIL,MIL,IND,119,,,26,24,20,8
Brook Lopez,C,22023,201572,22301201,"DEC 05, 2023",MIL vs. NYK,W,34,4,8,0.5,1,4,0.25,0,0,0.0,2,6,8,3,3,3,0,4,9,28,1,MIL,MIL,NYK,146,,,20,17,12,11
Brook Lopez,C,22023,201572,22300286,"DEC 02, 2023",MIL vs. ATL,W,33,3,7,0.429,1,4,0.25,4,6,0.667,1,1,2,4,0,4,2,2,11,2,1,MIL,MIL,ATL,132,,,17,13,15,6
Brook Lopez,C,22023,201572,22300269,"NOV 30, 2023",MIL @ CHI,L,39,7,12,0.583,6,10,0.6,0,0,0.0,0,4,4,0,0,0,1,5,20,2,1,MIL,CHI,MIL,113,,,24,24,20,4
Brook Lopez,C,22023,201572,22300056,"NOV 28, 2023",MIL @ MIA,W,32,5,10,0.5,0,4,0.0,2,2,1.0,1,3,4,4,0,1,2,4,12,9,1,MIL,MIA,MIL,131,,,20,16,16,8
Brook Lopez,C,22023,201572,22300245,"NOV 26, 2023",MIL vs. POR,W,31,4,11,0.364,2,6,0.333,0,0,0.0,1,5,6,3,3,4,0,3,10,3,1,MIL,MIL,POR,108,,,19,16,13,9
Brook Lopez,C,22023,201572,22300049,"NOV 24, 2023",MIL vs. WAS,W,32,14,17,0.824,4,7,0.571,7,7,1.0,0,6,6,1,2,3,1,2,39,8,1,MIL,MIL,WAS,131,,,46,45,40,7
Brook Lopez,C,22023,201572,22300228,"NOV 22, 2023",MIL @ BOS,L,34,12,18,0.667,2,5,0.4,2,3,0.667,5,2,7,1,1,1,0,3,28,7,1,MIL,BOS,MIL,116,,,36,35,29,8
Brook Lopez,C,22023,201572,22300219,"NOV 20, 2023",MIL @ WAS,W,32,7,12,0.583,1,4,0.25,1,1,1.0,4,5,9,1,0,5,1,0,16,13,1,MIL,WAS,MIL,142,,,26,25,17,10
Brook Lopez,C,22023,201572,22300205,"NOV 18, 2023",MIL vs. DAL,W,34,3,8,0.375,1,6,0.167,5,5,1.0,0,3,3,0,1,2,0,1,12,8,1,MIL,MIL,DAL,132,,,15,15,12,3
Brook Lopez,C,22023,201572,22300027,"NOV 17, 2023",MIL @ CHA,W,33,7,8,0.875,1,2,0.5,0,0,0.0,2,5,7,2,0,6,1,3,15,30,1,MIL,CHA,MIL,130,,,24,22,17,9
Brook Lopez,C,22023,201572,22300190,"NOV 13, 2023",MIL vs. CHI,W,29,4,8,0.5,2,6,0.333,1,3,0.333,0,5,5,0,0,3,2,3,11,-10,1,MIL,MIL,CHI,118,,,16,16,11,5
Brook Lopez,C,22023,201572,22300173,"NOV 11, 2023",MIL @ ORL,L,21,3,7,0.429,2,5,0.4,1,2,0.5,0,3,3,1,1,2,1,1,9,-7,1,MIL,ORL,MIL,97,,,13,12,10,4
Brook Lopez,C,22023,201572,22300171,"NOV 09, 2023",MIL @ IND,L,29,1,7,0.143,0,4,0.0,0,0,0.0,0,1,1,0,2,3,0,2,2,-15,1,MIL,IND,MIL,124,,,3,3,2,1
Brook Lopez,C,22023,201572,22300165,"NOV 08, 2023",MIL vs. DET,W,26,5,8,0.625,4,6,0.667,0,0,0.0,0,6,6,0,0,4,3,4,14,4,1,MIL,MIL,DET,120,,,20,20,14,6
Brook Lopez,C,22023,201572,22300149,"NOV 06, 2023",MIL @ BKN,W,27,2,6,0.333,0,3,0.0,0,0,0.0,4,3,7,2,0,0,0,3,4,-15,1,MIL,BKN,MIL,129,,,13,11,6,9
Brook Lopez,C,22023,201572,22300002,"NOV 03, 2023",MIL vs. NYK,W,36,4,15,0.267,4,10,0.4,1,2,0.5,0,5,5,0,1,9,1,2,13,1,1,MIL,MIL,NYK,110,,,18,18,13,5
Brook Lopez,C,22023,201572,22300116,"NOV 01, 2023",MIL @ TOR,L,17,1,8,0.125,0,4,0.0,4,4,1.0,2,1,3,0,2,1,0,0,6,-22,1,MIL,TOR,MIL,111,,,9,9,6,3
Brook Lopez,C,22023,201572,22300107,"OCT 30, 2023",MIL vs. MIA,W,29,5,9,0.556,1,4,0.25,0,0,0.0,3,4,7,3,1,1,2,3,11,-10,1,MIL,MIL,MIA,122,,,21,18,14,10
Brook Lopez,C,22023,201572,22300097,"OCT 29, 2023",MIL vs. ATL,L,20,5,11,0.455,2,5,0.4,1,1,1.0,1,2,3,1,1,0,0,0,13,-22,1,MIL,MIL,ATL,110,,,17,16,14,4
Brook Lopez,C,22023,201572,22300075,"OCT 26, 2023",MIL vs. PHI,W,29,5,7,0.714,3,4,0.75,0,0,0.0,1,1,2,0,0,0,2,4,13,11,1,MIL,MIL,PHI,118,,,15,15,13,2
Brook Lopez,C,22023,201572,22300572,"JAN 17, 2024",MIL @ CLE,L,25,5,7,0.714,1,3,0.333,0,0,0.0,0,4,4,1,1,3,2,2,11,-34,1,MIL,CLE,MIL,95,,,16,15,12,5
Brook Lopez,C,22023,201572,22300195,"NOV 15, 2023",MIL @ TOR,W,33,4,10,0.4,1,3,0.333,1,1,1.0,2,6,8,4,1,7,0,2,10,26,1,MIL,TOR,MIL,128,,,22,18,14,12
Kelly Oubre Jr.,F-G,22023,1626162,22300742,"FEB 09, 2024",PHI vs. ATL,L,40,8,19,0.421,2,8,0.25,10,14,0.714,5,7,12,1,1,1,0,4,28,-2,1,PHI,PHI,ATL,121,,,41,40,29,13
Kelly Oubre Jr.,F-G,22023,1626162,22300727,"FEB 07, 2024",PHI vs. GSW,L,25,5,15,0.333,1,4,0.25,0,0,0.0,1,2,3,0,0,1,1,2,11,-15,1,PHI,PHI,GSW,104,,,14,14,11,3
Kelly Oubre Jr.,F-G,22023,1626162,22300715,"FEB 05, 2024",PHI vs. DAL,L,32,7,17,0.412,2,7,0.286,3,5,0.6,4,2,6,0,1,0,0,3,19,-17,1,PHI,PHI,DAL,102,,,25,25,19,6
Kelly Oubre Jr.,F-G,22023,1626162,22300698,"FEB 03, 2024",PHI vs. BKN,L,25,3,14,0.214,0,5,0.0,10,10,1.0,1,3,4,0,1,0,0,3,16,-11,1,PHI,PHI,BKN,121,,,20,20,16,4
Kelly Oubre Jr.,F-G,22023,1626162,22300686,"FEB 01, 2024",PHI @ UTA,W,40,6,14,0.429,3,6,0.5,1,2,0.5,1,3,4,2,2,3,0,4,16,-1,1,PHI,UTA,PHI,127,,,22,20,18,6
Kelly Oubre Jr.,F-G,22023,1626162,22300668,"JAN 29, 2024",PHI @ POR,L,31,11,20,0.55,0,5,0.0,3,3,1.0,2,4,6,1,0,0,1,3,25,-18,1,PHI,POR,PHI,104,,,32,31,26,7
Kelly Oubre Jr.,F-G,22023,1626162,22300521,"JAN 10, 2024",PHI @ ATL,L,32,3,11,0.273,0,3,0.0,1,2,0.5,0,3,3,2,1,0,1,3,7,-8,1,PHI,ATL,PHI,132,,,12,10,9,5
Kelly Oubre Jr.,F-G,22023,1626162,22300495,"JAN 06, 2024",PHI vs. UTA,L,37,8,18,0.444,1,6,0.167,7,8,0.875,1,3,4,4,1,0,0,5,24,1,1,PHI,PHI,UTA,109,,,32,28,28,8
Kelly Oubre Jr.,F-G,22023,1626162,22300483,"JAN 05, 2024",PHI vs. NYK,L,31,6,12,0.5,3,6,0.5,0,0,0.0,2,5,7,1,0,3,3,2,15,-20,1,PHI,PHI,NYK,92,,,23,22,16,8
Kelly Oubre Jr.,F-G,22023,1626162,22300459,"JAN 02, 2024",PHI vs. CHI,W,27,5,8,0.625,3,5,0.6,3,3,1.0,0,3,3,3,3,0,1,3,16,28,1,PHI,PHI,CHI,110,,,22,19,19,6
Kelly Oubre Jr.,F-G,22023,1626162,22300442,"DEC 30, 2023",PHI @ CHI,L,28,5,13,0.385,0,5,0.0,1,1,1.0,3,2,5,2,2,1,0,2,11,-11,1,PHI,CHI,PHI,92,,,18,16,13,7
Kelly Oubre Jr.,F-G,22023,1626162,22300434,"DEC 29, 2023",PHI @ HOU,W,24,4,7,0.571,3,4,0.75,2,2,1.0,0,1,1,1,0,0,3,1,13,-4,1,PHI,HOU,PHI,131,,,15,14,14,2
Kelly Oubre Jr.,F-G,22023,1626162,22300415,"DEC 27, 2023",PHI @ ORL,W,29,1,7,0.143,1,4,0.25,1,2,0.5,1,3,4,1,2,2,1,1,4,16,1,PHI,ORL,PHI,112,,,9,8,5,5
Kelly Oubre Jr.,F-G,22023,1626162,22300404,"DEC 25, 2023",PHI @ MIA,L,40,9,16,0.563,6,9,0.667,1,3,0.333,1,6,7,3,1,1,1,3,25,10,1,PHI,MIA,PHI,113,,,35,32,28,10
Kelly Oubre Jr.,F-G,22023,1626162,22300367,"DEC 20, 2023",PHI vs. MIN,W,29,3,6,0.5,1,3,0.333,0,1,0.0,0,2,2,0,2,0,1,3,7,-7,1,PHI,PHI,MIN,127,,,9,9,7,2
Kelly Oubre Jr.,F-G,22023,1626162,22300335,"DEC 16, 2023",PHI @ CHA,W,21,5,10,0.5,2,5,0.4,0,0,0.0,2,2,4,0,0,0,1,2,12,27,1,PHI,CHA,PHI,135,,,16,16,12,4
Kelly Oubre Jr.,F-G,22023,1626162,22300327,"DEC 15, 2023",PHI vs. DET,W,17,4,11,0.364,1,5,0.2,2,2,1.0,1,2,3,1,0,0,0,3,11,6,1,PHI,PHI,DET,124,,,15,14,12,4
Kelly Oubre Jr.,F-G,22023,1626162,22300310,"DEC 13, 2023",PHI @ DET,W,23,7,9,0.778,2,4,0.5,1,2,0.5,0,3,3,1,2,0,2,2,17,18,1,PHI,DET,PHI,129,,,21,20,18,4
Kelly Oubre Jr.,F-G,22023,1626162,22300295,"DEC 11, 2023",PHI vs. WAS,W,18,3,8,0.375,1,4,0.25,0,0,0.0,1,4,5,1,1,0,0,3,7,23,1,PHI,PHI,WAS,146,,,13,12,8,6
Kelly Oubre Jr.,F-G,22023,1626162,22301218,"DEC 08, 2023",PHI vs. ATL,W,24,4,9,0.444,1,4,0.25,2,4,0.5,2,1,3,1,2,1,0,1,11,1,1,PHI,PHI,ATL,125,,,15,14,12,4
Kelly Oubre Jr.,F-G,22023,1626162,22300148,"NOV 06, 2023",PHI vs. WAS,W,27,1,5,0.2,0,2,0.0,1,2,0.5,1,4,5,1,1,1,3,2,3,-4,1,PHI,PHI,WAS,146,,,9,8,4,6
Kelly Oubre Jr.,F-G,22023,1626162,22300132,"NOV 04, 2023",PHI vs. PHX,W,35,10,18,0.556,3,7,0.429,2,3,0.667,0,3,3,0,0,1,0,3,25,11,1,PHI,PHI,PHX,112,,,28,28,25,3
Kelly Oubre Jr.,F-G,22023,1626162,22300128,"NOV 02, 2023",PHI vs. TOR,W,30,8,13,0.615,5,6,0.833,2,3,0.667,3,2,5,0,1,0,0,3,23,8,1,PHI,PHI,TOR,114,,,28,28,23,5
Kelly Oubre Jr.,F-G,22023,1626162,22300098,"OCT 29, 2023",PHI vs. POR,W,26,3,10,0.3,0,4,0.0,6,6,1.0,1,2,3,0,2,1,1,1,12,-1,1,PHI,PHI,POR,126,,,15,15,12,3
Kelly Oubre Jr.,F-G,22023,1626162,22300644,"JAN 27, 2024",PHI @ DEN,L,40,9,17,0.529,1,4,0.25,6,7,0.857,2,3,5,4,0,2,1,5,25,-8,1,PHI,DEN,PHI,105,,,34,30,29,9
Kelly Oubre Jr.,F-G,22023,1626162,22300627,"JAN 25, 2024",PHI @ IND,L,22,2,5,0.4,0,2,0.0,0,1,0.0,1,1,2,2,1,3,0,4,4,-14,1,PHI,IND,PHI,122,,,8,6,6,4
Kelly Oubre Jr.,F-G,22023,1626162,22300608,"JAN 22, 2024",PHI vs. SAS,W,25,3,6,0.5,0,1,0.0,2,5,0.4,0,3,3,0,0,0,0,4,8,-5,1,PHI,PHI,SAS,133,,,11,11,8,3
Kelly Oubre Jr.,F-G,22023,1626162,22300593,"JAN 20, 2024",PHI @ CHA,W,27,2,7,0.286,1,5,0.2,0,0,0.0,0,8,8,0,2,0,2,3,5,-5,1,PHI,CHA,PHI,97,,,13,13,5,8
Kelly Oubre Jr.,F-G,22023,1626162,22300585,"JAN 19, 2024",PHI @ ORL,W,32,5,8,0.625,3,4,0.75,2,2,1.0,1,3,4,2,0,1,0,5,15,4,1,PHI,ORL,PHI,124,,,21,19,17,6
Kelly Oubre Jr.,F-G,22023,1626162,22300566,"JAN 16, 2024",PHI vs. DEN,W,27,5,9,0.556,1,4,0.25,0,1,0.0,0,5,5,0,1,0,2,4,11,-3,1,PHI,PHI,DEN,126,,,16,16,11,5
Kelly Oubre Jr.,F-G,22023,1626162,22300555,"JAN 15, 2024",PHI vs. HOU,W,26,3,8,0.375,1,3,0.333,0,0,0.0,0,2,2,0,4,0,1,3,7,-12,1,PHI,PHI,HOU,124,,,9,9,7,2
Kelly Oubre Jr.,F-G,22023,1626162,22300351,"DEC 18, 2023",PHI vs. CHI,L,24,2,10,0.2,1,5,0.2,1,2,0.5,0,3,3,0,1,0,0,3,6,-10,1,PHI,PHI,CHI,104,,,9,9,6,3
Kelly Oubre Jr.,F-G,22023,1626162,22301208,"DEC 06, 2023",PHI @ WAS,W,19,5,8,0.625,1,3,0.333,1,1,1.0,1,2,3,1,0,0,1,1,12,-3,1,PHI,WAS,PHI,131,,,16,15,13,4
Kelly Oubre Jr.,F-G,22023,1626162,22300008,"NOV 10, 2023",PHI @ DET,W,26,3,9,0.333,0,3,0.0,2,3,0.667,2,6,8,1,2,0,0,3,8,7,1,PHI,DET,PHI,114,,,17,16,9,9
Kelly Oubre Jr.,F-G,22023,1626162,22300159,"NOV 08, 2023",PHI vs. BOS,W,27,6,11,0.545,1,3,0.333,1,2,0.5,1,7,8,1,1,0,0,0,14,2,1,PHI,PHI,BOS,106,,,23,22,15,9
Kelly Oubre Jr.,F-G,22023,1626162,22300673,"JAN 30, 2024",PHI @ GSW,L,35,7,14,0.5,0,3,0.0,1,2,0.5,3,3,6,0,1,0,2,2,15,-15,1,PHI,GSW,PHI,107,,,21,21,15,6
Kelly Oubre Jr.,F-G,22023,1626162,22300092,"OCT 28, 2023",PHI @ TOR,W,29,7,17,0.412,0,6,0.0,4,5,0.8,2,3,5,2,3,0,0,3,18,3,1,PHI,TOR,PHI,114,,,25,23,20,7
Kelly Oubre Jr.,F-G,22023,1626162,22300075,"OCT 26, 2023",PHI @ MIL,L,32,9,11,0.818,5,6,0.833,4,4,1.0,1,3,4,0,1,0,3,4,27,14,1,PHI,MIL,PHI,117,,,31,31,27,4
Kelly Oubre Jr.,F-G,22023,1626162,22300753,"FEB 10, 2024",PHI @ WAS,W,39,6,13,0.462,1,5,0.2,3,4,0.75,2,5,7,4,1,1,2,4,16,11,1,PHI,WAS,PHI,119,,,27,23,20,11
Kelly Oubre Jr.,F-G,22023,1626162,22300382,"DEC 22, 2023",PHI vs. TOR,W,26,3,9,0.333,2,6,0.333,0,0,0.0,0,3,3,0,1,0,0,4,8,-5,1,PHI,PHI,TOR,121,,,11,11,8,3
Grayson Allen,G,22023,1628960,22300757,"FEB 10, 2024",PHX @ GSW,L,32,4,11,0.364,2,6,0.333,0,0,0.0,0,4,4,2,0,0,0,0,10,2,1,PHX,GSW,PHX,112,,,16,14,12,6
Grayson Allen,G,22023,1628960,22300739,"FEB 08, 2024",PHX vs. UTA,W,35,2,4,0.5,2,3,0.667,2,2,1.0,0,3,3,14,2,1,0,4,8,14,1,PHX,PHX,UTA,129,,,25,11,22,17
Grayson Allen,G,22023,1628960,22300725,"FEB 06, 2024",PHX vs. MIL,W,34,2,4,0.5,2,4,0.5,2,2,1.0,0,3,3,3,1,1,0,2,8,2,1,PHX,PHX,MIL,114,,,14,11,11,6
Grayson Allen,G,22023,1628960,22300705,"FEB 04, 2024",PHX @ WAS,W,27,2,6,0.333,1,4,0.25,1,2,0.5,0,3,3,4,0,0,1,0,6,30,1,PHX,WAS,PHX,140,,,13,9,10,7
Grayson Allen,G,22023,1628960,22300690,"FEB 02, 2024",PHX @ ATL,L,31,5,7,0.714,1,3,0.333,1,1,1.0,0,2,2,4,1,2,2,4,12,2,1,PHX,ATL,PHX,120,,,18,14,16,6
Grayson Allen,G,22023,1628960,22300661,"JAN 29, 2024",PHX @ MIA,W,13,0,2,0.0,0,0,0.0,3,4,0.75,0,2,2,1,0,0,1,0,3,11,1,PHX,MIA,PHX,118,,,6,5,4,3
Grayson Allen,G,22023,1628960,22300655,"JAN 28, 2024",PHX @ ORL,L,33,3,3,1.0,1,1,1.0,1,2,0.5,0,5,5,1,0,0,1,2,8,-9,1,PHX,ORL,PHX,98,,,14,13,9,6
Grayson Allen,G,22023,1628960,22300636,"JAN 26, 2024",PHX @ IND,L,37,4,5,0.8,2,3,0.667,1,1,1.0,0,3,3,1,0,1,2,5,11,-8,1,PHX,IND,PHX,131,,,15,14,12,4
Grayson Allen,G,22023,1628960,22300625,"JAN 24, 2024",PHX @ DAL,W,34,5,8,0.625,3,5,0.6,2,2,1.0,1,4,5,4,1,0,2,3,15,26,1,PHX,DAL,PHX,132,,,24,20,19,9
Grayson Allen,G,22023,1628960,22300612,"JAN 22, 2024",PHX vs. CHI,W,36,3,6,0.5,3,4,0.75,0,0,0.0,0,4,4,3,1,0,1,1,9,-13,1,PHX,PHX,CHI,115,,,16,13,12,7
Grayson Allen,G,22023,1628960,22300604,"JAN 21, 2024",PHX vs. IND,W,32,5,7,0.714,3,4,0.75,0,0,0.0,1,1,2,2,1,0,0,1,13,3,1,PHX,PHX,IND,117,,,17,15,15,4
Grayson Allen,G,22023,1628960,22300588,"JAN 19, 2024",PHX @ NOP,W,32,4,8,0.5,3,6,0.5,1,2,0.5,0,4,4,6,2,0,0,1,12,19,1,PHX,NOP,PHX,123,,,22,16,18,10
Grayson Allen,G,22023,1628960,22300567,"JAN 16, 2024",PHX vs. SAC,W,37,10,17,0.588,9,14,0.643,0,0,0.0,0,5,5,6,2,2,2,1,29,21,1,PHX,PHX,SAC,119,,,40,34,35,11
Grayson Allen,G,22023,1628960,22300554,"JAN 14, 2024",PHX @ POR,W,33,4,6,0.667,4,6,0.667,8,8,1.0,1,3,4,1,0,2,4,2,20,13,1,PHX,POR,PHX,127,,,25,24,21,5
Grayson Allen,G,22023,1628960,22300531,"JAN 11, 2024",PHX @ LAL,W,30,2,8,0.25,1,6,0.167,0,0,0.0,1,4,5,3,0,0,0,3,5,32,1,PHX,LAL,PHX,127,,,13,10,8,8
Grayson Allen,G,22023,1628960,22300511,"JAN 08, 2024",PHX @ LAC,L,31,1,3,0.333,1,3,0.333,5,5,1.0,0,3,3,2,0,0,1,1,8,-22,1,PHX,LAC,PHX,111,,,13,11,10,5
Grayson Allen,G,22023,1628960,22300503,"JAN 07, 2024",PHX vs. MEM,L,39,6,15,0.4,4,8,0.5,0,0,0.0,0,2,2,3,0,2,3,2,16,0,1,PHX,PHX,MEM,115,,,21,18,19,5
Grayson Allen,G,22023,1628960,22300489,"JAN 05, 2024",PHX vs. MIA,W,37,11,19,0.579,9,14,0.643,0,0,0.0,1,3,4,4,0,2,2,4,31,13,1,PHX,PHX,MIA,113,,,39,35,35,8
Grayson Allen,G,22023,1628960,22300473,"JAN 03, 2024",PHX vs. LAC,L,32,4,9,0.444,2,4,0.5,0,1,0.0,1,3,4,3,2,0,1,2,10,-19,1,PHX,PHX,LAC,122,,,17,14,13,7
Grayson Allen,G,22023,1628960,22300456,"JAN 01, 2024",PHX vs. POR,W,28,4,7,0.571,2,5,0.4,2,2,1.0,0,2,2,4,2,1,1,1,12,16,1,PHX,PHX,POR,109,,,18,14,16,6
Grayson Allen,G,22023,1628960,22300450,"DEC 31, 2023",PHX vs. ORL,W,35,4,8,0.5,2,4,0.5,0,0,0.0,0,2,2,4,2,1,1,0,10,14,1,PHX,PHX,ORL,112,,,16,12,14,6
Grayson Allen,G,22023,1628960,22300436,"DEC 29, 2023",PHX vs. CHA,W,33,6,8,0.75,2,4,0.5,2,2,1.0,1,3,4,3,0,1,1,2,16,15,1,PHX,PHX,CHA,133,,,23,20,19,7
Grayson Allen,G,22023,1628960,22300418,"DEC 27, 2023",PHX @ HOU,W,33,5,7,0.714,2,4,0.5,4,4,1.0,1,3,4,3,0,1,3,1,16,15,1,PHX,HOU,PHX,129,,,23,20,19,7
Grayson Allen,G,22023,1628960,22300405,"DEC 25, 2023",PHX vs. DAL,L,39,12,22,0.545,8,17,0.471,0,0,0.0,1,3,4,4,1,0,2,4,32,-5,1,PHX,PHX,DAL,114,,,40,36,36,8
Grayson Allen,G,22023,1628960,22300387,"DEC 22, 2023",PHX @ SAC,L,30,4,10,0.4,3,6,0.5,0,0,0.0,2,2,4,2,3,1,1,1,11,-20,1,PHX,SAC,PHX,105,,,17,15,13,6
Grayson Allen,G,22023,1628960,22300363,"DEC 19, 2023",PHX @ POR,L,33,5,10,0.5,1,5,0.2,0,1,0.0,2,7,9,0,2,0,0,3,11,-8,1,PHX,POR,PHX,104,,,20,20,11,9
Grayson Allen,G,22023,1628960,22300347,"DEC 17, 2023",PHX vs. WAS,W,33,2,8,0.25,1,6,0.167,6,6,1.0,1,3,4,3,2,2,1,2,11,-4,1,PHX,PHX,WAS,112,,,18,15,14,7
Grayson Allen,G,22023,1628960,22300333,"DEC 15, 2023",PHX vs. NYK,L,36,5,5,1.0,2,2,1.0,1,1,1.0,2,0,2,1,2,1,2,4,13,-14,1,PHX,PHX,NYK,122,,,16,15,14,3
Grayson Allen,G,22023,1628960,22301203,"DEC 05, 2023",PHX @ LAL,L,39,6,14,0.429,4,8,0.5,5,5,1.0,0,2,2,2,2,1,0,2,21,-7,1,PHX,LAL,PHX,103,,,25,23,23,4
Grayson Allen,G,22023,1628960,22300288,"DEC 02, 2023",PHX vs. MEM,W,33,1,4,0.25,1,2,0.5,6,6,1.0,1,1,2,4,1,0,2,1,9,8,1,PHX,PHX,MEM,116,,,15,11,13,6
Grayson Allen,G,22023,1628960,22300279,"DEC 01, 2023",PHX vs. DEN,L,37,5,9,0.556,1,4,0.25,2,2,1.0,0,10,10,3,1,0,0,2,13,-4,1,PHX,PHX,DEN,111,,,26,23,16,13
Grayson Allen,G,22023,1628960,22300044,"NOV 24, 2023",PHX @ MEM,W,37,5,9,0.556,2,4,0.5,2,3,0.667,0,2,2,3,0,1,1,2,14,1,1,PHX,MEM,PHX,110,,,19,16,17,5
Grayson Allen,G,22023,1628960,22300236,"NOV 22, 2023",PHX vs. GSW,W,34,1,4,0.25,1,4,0.25,6,8,0.75,1,2,3,3,1,0,2,5,9,13,1,PHX,PHX,GSW,123,,,15,12,12,6
Grayson Allen,G,22023,1628960,22300041,"NOV 21, 2023",PHX vs. POR,W,35,4,5,0.8,0,1,0.0,0,0,0.0,0,6,6,5,2,0,1,1,8,6,1,PHX,PHX,POR,120,,,19,14,13,11
Grayson Allen,G,22023,1628960,22300214,"NOV 19, 2023",PHX @ UTA,W,43,5,8,0.625,3,6,0.5,1,2,0.5,0,4,4,3,1,1,2,4,14,12,1,PHX,UTA,PHX,140,,,21,18,17,7
Grayson Allen,G,22023,1628960,22300035,"NOV 17, 2023",PHX @ UTA,W,30,3,8,0.375,2,4,0.5,2,2,1.0,0,1,1,1,0,0,0,1,10,-8,1,PHX,UTA,PHX,131,,,12,11,11,2
Grayson Allen,G,22023,1628960,22300197,"NOV 15, 2023",PHX vs. MIN,W,28,5,9,0.556,3,5,0.6,1,1,1.0,0,3,3,2,0,1,2,1,14,22,1,PHX,PHX,MIN,133,,,19,17,16,5
Grayson Allen,G,22023,1628960,22300185,"NOV 12, 2023",PHX vs. OKC,L,32,2,8,0.25,1,3,0.333,2,2,1.0,2,4,6,1,1,1,2,2,7,-19,1,PHX,PHX,OKC,99,,,14,13,8,7
Grayson Allen,G,22023,1628960,22300015,"NOV 10, 2023",PHX vs. LAL,L,32,4,8,0.5,1,4,0.25,0,0,0.0,2,7,9,4,1,0,2,6,9,-5,1,PHX,PHX,LAL,119,,,22,18,13,13
Grayson Allen,G,22023,1628960,22300162,"NOV 08, 2023",PHX @ CHI,W,37,9,16,0.563,8,13,0.615,0,0,0.0,0,8,8,4,1,2,1,3,26,8,1,PHX,CHI,PHX,116,,,38,34,30,12
Grayson Allen,G,22023,1628960,22300140,"NOV 05, 2023",PHX @ DET,W,30,6,12,0.5,1,3,0.333,1,1,1.0,1,3,4,2,0,0,4,1,14,6,1,PHX,DET,PHX,120,,,20,18,16,6
Grayson Allen,G,22023,1628960,22300132,"NOV 04, 2023",PHX @ PHI,L,27,3,7,0.429,2,5,0.4,0,0,0.0,1,2,3,2,0,0,1,3,8,0,1,PHX,PHI,PHX,100,,,13,11,10,5
Grayson Allen,G,22023,1628960,22300131,"NOV 02, 2023",PHX vs. SAS,L,33,6,10,0.6,4,5,0.8,0,0,0.0,1,1,2,4,0,0,2,1,16,-10,1,PHX,PHX,SAS,121,,,22,18,20,6
Grayson Allen,G,22023,1628960,22300113,"OCT 31, 2023",PHX vs. SAS,L,37,5,9,0.556,5,7,0.714,4,4,1.0,1,6,7,3,0,1,2,2,19,-12,1,PHX,PHX,SAS,114,,,29,26,22,10
Grayson Allen,G,22023,1628960,22300094,"OCT 28, 2023",PHX vs. UTA,W,31,6,10,0.6,3,7,0.429,2,2,1.0,0,4,4,3,2,0,3,2,17,22,1,PHX,PHX,UTA,126,,,24,21,20,7
Grayson Allen,G,22023,1628960,22300076,"OCT 26, 2023",PHX @ LAL,L,35,2,6,0.333,2,4,0.5,0,0,0.0,1,5,6,4,0,0,0,3,6,0,1,PHX,LAL,PHX,95,,,16,12,10,10
Grayson Allen,G,22023,1628960,22300062,"OCT 24, 2023",PHX @ GSW,W,21,0,6,0.0,0,5,0.0,0,0,0.0,3,1,4,2,0,0,1,2,0,-4,1,PHX,GSW,PHX,108,,,6,4,2,6
Duncan Robinson,F,22023,1629130,22300730,"FEB 07, 2024",MIA vs. SAS,W,19,1,6,0.167,1,6,0.167,3,3,1.0,0,2,2,2,1,0,2,2,6,-4,1,MIA,MIA,SAS,116,,,10,8,8,4
Duncan Robinson,F,22023,1629130,22300721,"FEB 06, 2024",MIA vs. ORL,W,22,4,7,0.571,1,4,0.25,0,0,0.0,0,1,1,1,0,1,0,2,9,10,1,MIA,MIA,ORL,121,,,11,10,10,2
Duncan Robinson,F,22023,1629130,22300661,"JAN 29, 2024",MIA vs. PHX,L,4,0,1,0.0,0,1,0.0,0,0,0.0,0,0,0,0,0,0,0,2,0,-11,1,MIA,MIA,PHX,105,,,0,0,0,0
Duncan Robinson,F,22023,1629130,22300643,"JAN 27, 2024",MIA @ NYK,L,26,6,14,0.429,5,11,0.455,2,2,1.0,0,1,1,3,1,0,3,4,19,-11,1,MIA,NYK,MIA,109,,,23,20,22,4
Duncan Robinson,F,22023,1629130,22300630,"JAN 25, 2024",MIA vs. BOS,L,20,2,6,0.333,1,5,0.2,0,0,0.0,0,0,0,2,0,0,0,3,5,-13,1,MIA,MIA,BOS,110,,,7,5,7,2
Duncan Robinson,F,22023,1629130,22300621,"JAN 24, 2024",MIA vs. MEM,L,16,3,9,0.333,1,5,0.2,0,0,0.0,0,3,3,0,0,0,2,4,7,3,1,MIA,MIA,MEM,96,,,10,10,7,3
Duncan Robinson,F,22023,1629130,22300601,"JAN 21, 2024",MIA @ ORL,L,21,1,6,0.167,0,3,0.0,4,4,1.0,0,1,1,1,2,0,2,2,6,-12,1,MIA,ORL,MIA,87,,,8,7,7,2
Duncan Robinson,F,22023,1629130,22300587,"JAN 19, 2024",MIA vs. ATL,L,22,5,8,0.625,4,7,0.571,0,0,0.0,0,2,2,1,0,0,2,0,14,6,1,MIA,MIA,ATL,108,,,17,16,15,3
Duncan Robinson,F,22023,1629130,22300574,"JAN 17, 2024",MIA @ TOR,L,21,6,11,0.545,2,5,0.4,0,0,0.0,1,2,3,1,0,0,2,0,14,-18,1,MIA,TOR,MIA,97,,,18,17,15,4
Duncan Robinson,F,22023,1629130,22300562,"JAN 15, 2024",MIA @ BKN,W,22,0,4,0.0,0,3,0.0,0,0,0.0,0,2,2,2,1,1,2,1,0,-11,1,MIA,BKN,MIA,96,,,4,2,2,4
Duncan Robinson,F,22023,1629130,22300551,"JAN 14, 2024",MIA vs. CHA,W,30,7,11,0.636,3,6,0.5,2,2,1.0,0,4,4,5,1,1,2,2,19,12,1,MIA,MIA,CHA,104,,,28,23,24,9
Duncan Robinson,F,22023,1629130,22300535,"JAN 12, 2024",MIA vs. ORL,W,41,9,19,0.474,4,10,0.4,1,1,1.0,1,3,4,3,1,0,3,1,23,13,1,MIA,MIA,ORL,99,,,30,27,26,7
Duncan Robinson,F,22023,1629130,22300522,"JAN 10, 2024",MIA vs. OKC,L,25,1,8,0.125,1,7,0.143,0,0,0.0,0,1,1,1,2,0,1,0,3,-18,1,MIA,MIA,OKC,120,,,5,4,4,2
Duncan Robinson,F,22023,1629130,22300509,"JAN 08, 2024",MIA vs. HOU,W,29,4,12,0.333,3,10,0.3,3,3,1.0,0,3,3,7,1,0,1,6,14,2,1,MIA,MIA,HOU,120,,,24,17,21,10
Duncan Robinson,F,22023,1629130,22300489,"JAN 05, 2024",MIA @ PHX,L,27,1,7,0.143,1,6,0.167,1,2,0.5,0,1,1,3,1,1,3,3,4,-3,1,MIA,PHX,MIA,97,,,8,5,7,4
Duncan Robinson,F,22023,1629130,22300475,"JAN 03, 2024",MIA @ LAL,W,30,5,14,0.357,3,12,0.25,0,0,0.0,0,0,0,2,1,0,1,3,13,0,1,MIA,LAL,MIA,110,,,15,13,15,2
Duncan Robinson,F,22023,1629130,22300458,"JAN 01, 2024",MIA @ LAC,L,26,3,8,0.375,3,7,0.429,6,6,1.0,0,1,1,2,0,0,1,1,15,-3,1,MIA,LAC,MIA,104,,,18,16,17,3
Duncan Robinson,F,22023,1629130,22300439,"DEC 30, 2023",MIA @ UTA,L,32,4,8,0.5,3,5,0.6,0,0,0.0,0,4,4,4,2,2,1,4,11,-10,1,MIA,UTA,MIA,109,,,19,15,15,8
Duncan Robinson,F,22023,1629130,22300426,"DEC 28, 2023",MIA @ GSW,W,30,2,11,0.182,1,6,0.167,0,0,0.0,1,1,2,4,0,0,0,3,5,5,1,MIA,GSW,MIA,114,,,11,7,9,6
Duncan Robinson,F,22023,1629130,22300404,"DEC 25, 2023",MIA vs. PHI,W,34,5,13,0.385,5,10,0.5,1,1,1.0,0,4,4,2,1,0,0,3,16,26,1,MIA,MIA,PHI,119,,,22,20,18,6
Duncan Robinson,F,22023,1629130,22300384,"DEC 22, 2023",MIA vs. ATL,W,25,8,11,0.727,4,7,0.571,7,7,1.0,1,2,3,3,1,0,2,0,27,14,1,MIA,MIA,ATL,122,,,33,30,30,6
Duncan Robinson,F,22023,1629130,22300366,"DEC 20, 2023",MIA @ ORL,W,23,4,5,0.8,1,1,1.0,3,3,1.0,0,3,3,6,0,0,1,3,12,16,1,MIA,ORL,MIA,115,,,21,15,18,9
Duncan Robinson,F,22023,1629130,22300353,"DEC 18, 2023",MIA vs. MIN,L,22,5,9,0.556,4,8,0.5,0,0,0.0,0,5,5,3,1,0,2,2,14,-7,1,MIA,MIA,MIN,108,,,22,19,17,8
Duncan Robinson,F,22023,1629130,22300267,"NOV 30, 2023",MIA vs. IND,W,29,5,9,0.556,4,6,0.667,2,2,1.0,0,1,1,2,1,0,1,3,16,9,1,MIA,MIA,IND,142,,,19,17,18,3
Duncan Robinson,F,22023,1629130,22300056,"NOV 28, 2023",MIA vs. MIL,L,31,5,11,0.455,3,7,0.429,0,2,0.0,0,3,3,3,0,1,2,3,13,-14,1,MIA,MIA,MIL,124,,,19,16,16,6
Duncan Robinson,F,22023,1629130,22300220,"NOV 20, 2023",MIA @ CHI,W,30,7,11,0.636,6,9,0.667,2,2,1.0,0,2,2,2,0,0,0,3,22,7,1,MIA,CHI,MIA,118,,,26,24,24,4
Duncan Robinson,F,22023,1629130,22300204,"NOV 18, 2023",MIA @ CHI,L,35,5,9,0.556,4,5,0.8,3,4,0.75,0,3,3,7,0,0,1,2,17,3,1,MIA,CHI,MIA,97,,,27,20,24,10
Duncan Robinson,F,22023,1629130,22300200,"NOV 16, 2023",MIA vs. BKN,W,38,8,14,0.571,6,10,0.6,4,4,1.0,0,0,0,2,0,0,0,3,26,2,1,MIA,MIA,BKN,122,,,28,26,28,2
Duncan Robinson,F,22023,1629130,22300017,"NOV 14, 2023",MIA @ CHA,W,36,6,13,0.462,4,10,0.4,2,2,1.0,0,8,8,5,1,1,1,2,18,1,1,MIA,CHA,MIA,111,,,31,26,23,13
Duncan Robinson,F,22023,1629130,22300184,"NOV 12, 2023",MIA @ SAS,W,39,8,16,0.5,4,7,0.571,6,6,1.0,1,4,5,4,0,1,0,1,26,22,1,MIA,SAS,MIA,118,,,35,31,30,9
Duncan Robinson,F,22023,1629130,22300175,"NOV 11, 2023",MIA @ ATL,W,30,5,15,0.333,1,10,0.1,0,0,0.0,0,3,3,2,1,0,1,3,11,-1,1,MIA,ATL,MIA,117,,,16,14,13,5
Duncan Robinson,F,22023,1629130,22300164,"NOV 08, 2023",MIA @ MEM,W,35,3,7,0.429,2,5,0.4,1,2,0.5,0,3,3,2,0,0,5,3,9,2,1,MIA,MEM,MIA,108,,,14,12,11,5
Duncan Robinson,F,22023,1629130,22300150,"NOV 06, 2023",MIA vs. LAL,W,26,5,11,0.455,2,6,0.333,0,0,0.0,0,3,3,3,1,0,1,1,12,8,1,MIA,MIA,LAL,108,,,18,15,15,6
Duncan Robinson,F,22023,1629130,22300003,"NOV 03, 2023",MIA vs. WAS,W,30,7,11,0.636,4,8,0.5,0,0,0.0,0,1,1,6,1,0,2,0,18,2,1,MIA,MIA,WAS,121,,,25,19,24,7
Duncan Robinson,F,22023,1629130,22300119,"NOV 01, 2023",MIA vs. BKN,L,21,2,8,0.25,1,6,0.167,0,0,0.0,0,3,3,2,0,0,1,4,5,-4,1,MIA,MIA,BKN,105,,,10,8,7,5
Duncan Robinson,F,22023,1629130,22300093,"OCT 28, 2023",MIA @ MIN,L,29,3,12,0.25,2,10,0.2,0,0,0.0,1,2,3,1,1,0,1,1,8,-18,1,MIA,MIN,MIA,90,,,12,11,9,4
Duncan Robinson,F,22023,1629130,22300080,"OCT 27, 2023",MIA @ BOS,L,24,3,7,0.429,3,6,0.5,0,0,0.0,0,1,1,0,0,0,0,2,9,-12,1,MIA,BOS,MIA,111,,,10,10,9,1
Duncan Robinson,F,22023,1629130,22300068,"OCT 25, 2023",MIA vs. DET,W,22,6,10,0.6,3,5,0.6,0,0,0.0,1,1,2,1,0,0,0,1,15,-3,1,MIA,MIA,DET,103,,,18,17,16,3
Duncan Robinson,F,22023,1629130,22300337,"DEC 16, 2023",MIA vs. CHI,W,24,3,9,0.333,3,9,0.333,0,0,0.0,0,1,1,6,0,0,2,0,9,-15,1,MIA,MIA,CHI,118,,,16,10,15,7
Duncan Robinson,F,22023,1629130,22300320,"DEC 14, 2023",MIA vs. CHI,L,27,4,9,0.444,3,6,0.5,0,2,0.0,0,2,2,3,0,0,1,2,11,-13,1,MIA,MIA,CHI,116,,,16,13,14,5
Duncan Robinson,F,22023,1629130,22300312,"DEC 13, 2023",MIA vs. CHA,W,40,7,11,0.636,6,9,0.667,3,3,1.0,0,2,2,3,2,0,4,2,23,15,1,MIA,MIA,CHA,115,,,28,25,26,5
Duncan Robinson,F,22023,1629130,22300292,"DEC 11, 2023",MIA @ CHA,W,33,8,14,0.571,5,9,0.556,3,3,1.0,1,6,7,4,2,0,0,0,24,1,1,MIA,CHA,MIA,116,,,35,31,28,11
Duncan Robinson,F,22023,1629130,22300229,"NOV 22, 2023",MIA @ CLE,W,24,3,7,0.429,1,3,0.333,0,0,0.0,0,2,2,3,0,0,0,3,7,32,1,MIA,CLE,MIA,129,,,12,9,10,5
Duncan Robinson,F,22023,1629130,22300107,"OCT 30, 2023",MIA @ MIL,L,22,6,10,0.6,3,7,0.429,0,0,0.0,1,0,1,1,0,0,0,5,15,-1,1,MIA,MIL,MIA,114,,,17,16,16,2
Duncan Robinson,F,22023,1629130,22301220,"DEC 08, 2023",MIA vs. CLE,L,23,0,7,0.0,0,6,0.0,1,2,0.5,0,0,0,1,0,0,6,4,1,-25,1,MIA,MIA,CLE,99,,,2,1,2,1
Duncan Robinson,F,22023,1629130,22301207,"DEC 06, 2023",MIA @ TOR,W,32,9,19,0.474,3,10,0.3,0,0,0.0,1,5,6,7,1,0,0,1,21,33,1,MIA,TOR,MIA,112,,,34,27,28,13
Duncan Robinson,F,22023,1629130,22300284,"DEC 02, 2023",MIA vs. IND,L,30,7,11,0.636,2,3,0.667,1,1,1.0,1,1,2,3,0,0,2,6,17,-9,1,MIA,MIA,IND,129,,,22,19,20,5
Saddiq Bey,F,22023,1630180,22300754,"FEB 10, 2024",ATL vs. HOU,W,39,8,15,0.533,4,9,0.444,4,4,1.0,2,4,6,3,1,1,1,1,24,12,1,ATL,ATL,HOU,122,,,33,30,27,9
Saddiq Bey,F,22023,1630180,22300742,"FEB 09, 2024",ATL @ PHI,W,34,4,11,0.364,2,5,0.4,8,8,1.0,5,6,11,1,1,0,0,1,18,8,1,ATL,PHI,ATL,127,,,30,29,19,12
Saddiq Bey,F,22023,1630180,22300729,"FEB 07, 2024",ATL @ BOS,L,36,9,16,0.563,4,7,0.571,3,4,0.75,2,7,9,1,1,0,0,1,25,-1,1,ATL,BOS,ATL,117,,,35,34,26,10
Saddiq Bey,F,22023,1630180,22300716,"FEB 05, 2024",ATL vs. LAC,L,33,5,8,0.625,3,6,0.5,5,5,1.0,3,2,5,0,1,0,1,1,18,-7,1,ATL,ATL,LAC,144,,,23,23,18,5
Saddiq Bey,F,22023,1630180,22300690,"FEB 02, 2024",ATL vs. PHX,W,16,1,7,0.143,0,3,0.0,0,0,0.0,2,1,3,0,0,0,0,0,2,3,1,ATL,ATL,PHX,129,,,5,5,2,3
Saddiq Bey,F,22023,1630180,22300669,"JAN 30, 2024",ATL vs. LAL,W,35,5,10,0.5,1,5,0.2,7,8,0.875,4,4,8,2,1,0,0,3,18,19,1,ATL,ATL,LAL,138,,,28,26,20,10
Saddiq Bey,F,22023,1630180,22300653,"JAN 28, 2024",ATL vs. TOR,W,41,8,18,0.444,0,6,0.0,10,15,0.667,7,6,13,3,0,0,1,1,26,19,1,ATL,ATL,TOR,126,,,42,39,29,16
Saddiq Bey,F,22023,1630180,22300634,"JAN 26, 2024",ATL vs. DAL,L,38,6,13,0.462,2,6,0.333,2,2,1.0,3,4,7,5,0,0,0,3,16,-14,1,ATL,ATL,DAL,143,,,28,23,21,12
Saddiq Bey,F,22023,1630180,22300626,"JAN 24, 2024",ATL @ GSW,L,27,6,12,0.5,3,6,0.5,3,3,1.0,3,4,7,3,1,0,0,0,18,-13,1,ATL,GSW,ATL,112,,,28,25,21,10
Saddiq Bey,F,22023,1630180,22300613,"JAN 22, 2024",ATL @ SAC,L,30,4,11,0.364,2,7,0.286,3,4,0.75,2,5,7,2,0,0,0,1,13,0,1,ATL,SAC,ATL,107,,,22,20,15,9
Saddiq Bey,F,22023,1630180,22300595,"JAN 20, 2024",ATL vs. CLE,L,30,0,12,0.0,0,6,0.0,0,0,0.0,3,4,7,2,0,0,1,3,0,-24,1,ATL,ATL,CLE,95,,,9,7,2,9
Saddiq Bey,F,22023,1630180,22300587,"JAN 19, 2024",ATL @ MIA,W,36,4,12,0.333,0,5,0.0,6,7,0.857,1,1,2,0,0,0,1,2,14,-2,1,ATL,MIA,ATL,109,,,16,16,14,2
Saddiq Bey,F,22023,1630180,22300570,"JAN 17, 2024",ATL vs. ORL,W,35,1,7,0.143,1,5,0.2,4,4,1.0,2,2,4,0,0,0,0,2,7,-10,1,ATL,ATL,ORL,106,,,11,11,7,4
Saddiq Bey,F,22023,1630180,22300559,"JAN 15, 2024",ATL vs. SAS,W,33,3,9,0.333,1,7,0.143,3,4,0.75,4,1,5,2,0,0,0,3,10,0,1,ATL,ATL,SAS,109,,,17,15,12,7
Saddiq Bey,F,22023,1630180,22300543,"JAN 13, 2024",ATL vs. WAS,L,27,5,13,0.385,2,7,0.286,4,4,1.0,6,1,7,0,4,0,1,1,16,-15,1,ATL,ATL,WAS,99,,,23,23,16,7
Saddiq Bey,F,22023,1630180,22300533,"JAN 12, 2024",ATL vs. IND,L,31,3,10,0.3,3,7,0.429,8,9,0.889,1,3,4,2,1,0,0,1,17,1,1,ATL,ATL,IND,108,,,23,21,19,6
Saddiq Bey,F,22023,1630180,22300521,"JAN 10, 2024",ATL vs. PHI,W,37,6,16,0.375,1,6,0.167,2,3,0.667,6,4,10,1,0,0,1,1,15,-4,1,ATL,ATL,PHI,139,,,26,25,16,11
Saddiq Bey,F,22023,1630180,22300499,"JAN 07, 2024",ATL @ ORL,L,38,5,10,0.5,2,4,0.5,4,5,0.8,1,6,7,2,1,0,0,1,16,-17,1,ATL,ORL,ATL,110,,,25,23,18,9
Saddiq Bey,F,22023,1630180,22300480,"JAN 05, 2024",ATL @ IND,L,30,2,7,0.286,1,6,0.167,4,4,1.0,3,1,4,2,0,0,1,1,9,-22,1,ATL,IND,ATL,116,,,15,13,11,6
Saddiq Bey,F,22023,1630180,22300467,"JAN 03, 2024",ATL vs. OKC,W,36,3,12,0.25,2,8,0.25,2,2,1.0,2,6,8,2,0,1,0,2,10,6,1,ATL,ATL,OKC,141,,,20,18,12,10
Saddiq Bey,F,22023,1630180,22300445,"DEC 31, 2023",ATL @ WAS,W,32,4,10,0.4,2,5,0.4,1,3,0.333,3,8,11,0,0,1,1,3,11,-2,1,ATL,WAS,ATL,130,,,22,22,11,11
Saddiq Bey,F,22023,1630180,22300431,"DEC 29, 2023",ATL vs. SAC,L,32,4,14,0.286,3,8,0.375,4,4,1.0,5,2,7,4,1,0,1,2,15,5,1,ATL,ATL,SAC,110,,,26,22,19,11
Saddiq Bey,F,22023,1630180,22300408,"DEC 26, 2023",ATL @ CHI,L,34,5,10,0.5,2,6,0.333,1,1,1.0,4,4,8,0,1,0,0,1,13,-7,1,ATL,CHI,ATL,113,,,21,21,13,8
Saddiq Bey,F,22023,1630180,22300393,"DEC 23, 2023",ATL vs. MEM,L,38,4,11,0.364,3,9,0.333,3,4,0.75,1,5,6,2,2,0,1,2,14,-7,1,ATL,ATL,MEM,119,,,22,20,16,8
Saddiq Bey,F,22023,1630180,22300384,"DEC 22, 2023",ATL @ MIA,L,40,6,14,0.429,2,8,0.25,2,2,1.0,2,8,10,2,2,0,2,2,16,-12,1,ATL,MIA,ATL,113,,,28,26,18,12
Saddiq Bey,F,22023,1630180,22300371,"DEC 20, 2023",ATL @ HOU,W,32,3,11,0.273,2,6,0.333,1,1,1.0,4,5,9,0,0,0,1,1,9,16,1,ATL,HOU,ATL,134,,,18,18,9,9
Saddiq Bey,F,22023,1630180,22300352,"DEC 18, 2023",ATL vs. DET,W,42,8,15,0.533,2,7,0.286,3,5,0.6,2,2,4,1,2,0,1,1,21,9,1,ATL,ATL,DET,130,,,26,25,22,5
Saddiq Bey,F,22023,1630180,22300336,"DEC 16, 2023",ATL @ CLE,L,36,1,9,0.111,1,7,0.143,2,2,1.0,1,5,6,0,2,0,2,0,5,-10,1,ATL,CLE,ATL,119,,,11,11,5,6
Saddiq Bey,F,22023,1630180,22300330,"DEC 15, 2023",ATL @ TOR,W,37,4,12,0.333,2,8,0.25,0,0,0.0,3,7,10,4,0,0,1,3,10,24,1,ATL,TOR,ATL,125,,,24,20,14,14
Saddiq Bey,F,22023,1630180,22300313,"DEC 13, 2023",ATL @ TOR,L,38,5,14,0.357,0,5,0.0,2,3,0.667,3,7,10,2,2,0,1,1,12,-3,1,ATL,TOR,ATL,128,,,24,22,14,12
Saddiq Bey,F,22023,1630180,22300296,"DEC 11, 2023",ATL vs. DEN,L,40,6,11,0.545,1,4,0.25,3,4,0.75,1,3,4,2,1,1,0,2,16,-8,1,ATL,ATL,DEN,122,,,22,20,18,6
Saddiq Bey,F,22023,1630180,22301218,"DEC 08, 2023",ATL @ PHI,L,38,6,20,0.3,3,9,0.333,1,1,1.0,5,3,8,1,0,0,0,1,16,2,1,ATL,PHI,ATL,114,,,25,24,17,9
Saddiq Bey,F,22023,1630180,22301209,"DEC 06, 2023",ATL vs. BKN,L,37,7,13,0.538,3,6,0.5,4,4,1.0,4,3,7,1,1,0,3,1,21,9,1,ATL,ATL,BKN,113,,,29,28,22,8
Saddiq Bey,F,22023,1630180,22300286,"DEC 02, 2023",ATL @ MIL,L,36,5,7,0.714,4,6,0.667,3,4,0.75,3,6,9,1,0,0,0,2,17,-3,1,ATL,MIL,ATL,121,,,27,26,18,10
Saddiq Bey,F,22023,1630180,22300272,"NOV 30, 2023",ATL @ SAS,W,34,5,8,0.625,3,4,0.75,0,0,0.0,2,2,4,0,3,0,1,3,13,0,1,ATL,SAS,ATL,137,,,17,17,13,4
Saddiq Bey,F,22023,1630180,22300055,"NOV 28, 2023",ATL @ CLE,L,32,5,8,0.625,2,4,0.5,2,2,1.0,1,3,4,3,2,0,0,4,14,-22,1,ATL,CLE,ATL,105,,,21,18,17,7
Saddiq Bey,F,22023,1630180,22300246,"NOV 26, 2023",ATL @ BOS,L,29,3,7,0.429,1,5,0.2,0,0,0.0,3,5,8,1,0,0,0,3,7,-16,1,ATL,BOS,ATL,103,,,16,15,8,9
Saddiq Bey,F,22023,1630180,22300241,"NOV 25, 2023",ATL @ WAS,W,32,6,14,0.429,0,4,0.0,1,2,0.5,3,6,9,1,1,0,1,1,13,30,1,ATL,WAS,ATL,136,,,23,22,14,10
Saddiq Bey,F,22023,1630180,22300227,"NOV 22, 2023",ATL vs. BKN,W,25,4,8,0.5,1,3,0.333,3,3,1.0,0,2,2,1,2,0,2,2,12,9,1,ATL,ATL,BKN,147,,,15,14,13,3
Saddiq Bey,F,22023,1630180,22300039,"NOV 21, 2023",ATL vs. IND,L,31,4,7,0.571,2,4,0.5,2,5,0.4,1,9,10,2,0,0,0,0,12,4,1,ATL,ATL,IND,152,,,24,22,14,12
Saddiq Bey,F,22023,1630180,22300029,"NOV 17, 2023",ATL vs. PHI,L,31,6,9,0.667,2,4,0.5,3,4,0.75,3,4,7,1,1,0,2,1,17,-5,1,ATL,ATL,PHI,116,,,25,24,18,8
Saddiq Bey,F,22023,1630180,22300193,"NOV 15, 2023",ATL vs. NYK,L,28,7,10,0.7,2,5,0.4,0,0,0.0,1,1,2,2,2,0,2,3,16,20,1,ATL,ATL,NYK,114,,,20,18,18,4
Saddiq Bey,F,22023,1630180,22300018,"NOV 14, 2023",ATL @ DET,W,27,6,13,0.462,2,7,0.286,5,6,0.833,1,3,4,2,2,1,1,0,19,5,1,ATL,DET,ATL,126,,,25,23,21,6
Saddiq Bey,F,22023,1630180,22300175,"NOV 11, 2023",ATL vs. MIA,L,24,3,9,0.333,2,7,0.286,0,0,0.0,3,5,8,0,0,0,4,0,8,-10,1,ATL,ATL,MIA,109,,,16,16,8,8
Saddiq Bey,F,22023,1630180,22300172,"NOV 09, 2023",ATL @ ORL,W,29,1,4,0.25,0,0,0.0,0,0,0.0,1,2,3,0,1,0,1,3,2,-8,1,ATL,ORL,ATL,120,,,5,5,2,3
Saddiq Bey,F,22023,1630180,22300155,"NOV 06, 2023",ATL @ OKC,L,26,6,11,0.545,3,6,0.5,0,0,0.0,4,4,8,2,0,0,2,1,15,6,1,ATL,OKC,ATL,117,,,25,23,17,10
Saddiq Bey,F,22023,1630180,22300135,"NOV 04, 2023",ATL @ NOP,W,26,5,13,0.385,2,7,0.286,0,0,0.0,4,1,5,2,1,0,0,2,12,4,1,ATL,NOP,ATL,123,,,19,17,14,7
Saddiq Bey,F,22023,1630180,22300117,"NOV 01, 2023",ATL vs. WAS,W,32,4,10,0.4,2,7,0.286,4,4,1.0,1,6,7,0,1,0,1,1,14,10,1,ATL,ATL,WAS,130,,,21,21,14,7
Saddiq Bey,F,22023,1630180,22300104,"OCT 30, 2023",ATL vs. MIN,W,25,4,5,0.8,3,3,1.0,0,0,0.0,0,6,6,1,0,1,1,2,11,17,1,ATL,ATL,MIN,127,,,18,17,12,7
Saddiq Bey,F,22023,1630180,22300097,"OCT 29, 2023",ATL @ MIL,W,31,4,9,0.444,1,3,0.333,4,5,0.8,3,6,9,3,0,0,1,0,13,23,1,ATL,MIL,ATL,127,,,25,22,16,12
Saddiq Bey,F,22023,1630180,22300079,"OCT 27, 2023",ATL vs. NYK,L,26,2,4,0.5,1,2,0.5,0,0,0.0,0,1,1,1,0,1,1,2,5,-6,1,ATL,ATL,NYK,120,,,7,6,6,2
Saddiq Bey,F,22023,1630180,22300063,"OCT 25, 2023",ATL @ CHA,L,29,6,12,0.5,1,4,0.25,2,2,1.0,3,2,5,0,5,0,2,1,15,-2,1,ATL,CHA,ATL,110,,,20,20,15,5
Spencer Dinwiddie,G,22023,203915,22300720,"FEB 06, 2024",BKN vs. DAL,L,35,4,8,0.5,0,4,0.0,1,1,1.0,0,1,1,5,1,0,0,0,9,4,1,BKN,BKN,DAL,107,,,15,10,14,6
Spencer Dinwiddie,G,22023,203915,22300717,"FEB 05, 2024",BKN vs. GSW,L,39,3,12,0.25,2,6,0.333,1,2,0.5,0,3,3,5,0,0,0,3,9,-14,1,BKN,BKN,GSW,98,,,17,12,14,8
Spencer Dinwiddie,G,22023,203915,22300698,"FEB 03, 2024",BKN @ PHI,W,26,1,5,0.2,1,5,0.2,0,0,0.0,0,3,3,6,0,0,0,3,3,16,1,BKN,PHI,BKN,136,,,12,6,9,9
Spencer Dinwiddie,G,22023,203915,22300677,"JAN 31, 2024",BKN vs. PHX,L,30,6,10,0.6,2,4,0.5,2,3,0.667,0,2,2,5,0,0,0,1,16,-13,1,BKN,BKN,PHX,120,,,23,18,21,7
Spencer Dinwiddie,G,22023,203915,22300660,"JAN 29, 2024",BKN vs. UTA,W,26,0,5,0.0,0,2,0.0,2,2,1.0,2,0,2,8,2,0,0,3,2,2,1,BKN,BKN,UTA,147,,,12,4,10,10
Spencer Dinwiddie,G,22023,203915,22300645,"JAN 27, 2024",BKN vs. HOU,W,35,3,11,0.273,0,4,0.0,4,6,0.667,0,2,2,9,1,1,2,3,10,1,1,BKN,BKN,HOU,106,,,21,12,19,11
Spencer Dinwiddie,G,22023,203915,22300629,"JAN 25, 2024",BKN vs. MIN,L,32,5,10,0.5,3,6,0.5,1,1,1.0,0,2,2,2,0,0,0,3,14,1,1,BKN,BKN,MIN,94,,,18,16,16,4
Spencer Dinwiddie,G,22023,203915,22300615,"JAN 23, 2024",BKN vs. NYK,L,19,0,4,0.0,0,4,0.0,0,0,0.0,0,0,0,4,0,0,1,1,0,7,1,BKN,BKN,NYK,103,,,4,0,4,4
Spencer Dinwiddie,G,22023,203915,22300600,"JAN 21, 2024",BKN @ LAC,L,33,6,9,0.667,4,6,0.667,0,0,0.0,1,1,2,7,0,1,1,2,16,-8,1,BKN,LAC,BKN,114,,,25,18,23,9
Spencer Dinwiddie,G,22023,203915,22300591,"JAN 19, 2024",BKN @ LAL,W,33,5,11,0.455,4,8,0.5,5,5,1.0,0,3,3,4,1,0,1,1,19,10,1,BKN,LAL,BKN,130,,,26,22,23,7
Spencer Dinwiddie,G,22023,203915,22300578,"JAN 17, 2024",BKN @ POR,L,32,5,8,0.625,3,4,0.75,6,7,0.857,0,2,2,7,1,0,1,2,19,12,1,BKN,POR,BKN,103,,,28,21,26,9
Spencer Dinwiddie,G,22023,203915,22300562,"JAN 15, 2024",BKN vs. MIA,L,20,1,6,0.167,1,6,0.167,0,0,0.0,0,0,0,1,3,0,1,2,3,-13,1,BKN,BKN,MIA,95,,,4,3,4,1
Spencer Dinwiddie,G,22023,203915,22300527,"JAN 11, 2024",BKN @ CLE,L,16,1,3,0.333,0,2,0.0,0,0,0.0,0,2,2,3,0,0,0,2,2,-20,1,BKN,CLE,BKN,102,,,7,4,5,5
Spencer Dinwiddie,G,22023,203915,22300498,"JAN 07, 2024",BKN vs. POR,L,28,1,6,0.167,1,4,0.25,2,2,1.0,1,2,3,5,0,0,1,0,5,3,1,BKN,BKN,POR,127,,,13,8,10,8
Spencer Dinwiddie,G,22023,203915,22300481,"JAN 05, 2024",BKN vs. OKC,W,33,7,12,0.583,3,7,0.429,6,6,1.0,0,3,3,4,0,1,2,3,23,-7,1,BKN,BKN,OKC,124,,,30,26,27,7
Spencer Dinwiddie,G,22023,203915,22300469,"JAN 03, 2024",BKN @ HOU,L,28,3,5,0.6,2,3,0.667,3,5,0.6,0,1,1,5,2,0,1,1,11,-16,1,BKN,HOU,BKN,101,,,17,12,16,6
Spencer Dinwiddie,G,22023,203915,22300461,"JAN 02, 2024",BKN @ NOP,L,21,0,6,0.0,0,4,0.0,0,0,0.0,0,0,0,5,0,0,1,1,0,-25,1,BKN,NOP,BKN,85,,,5,0,5,5
Spencer Dinwiddie,G,22023,203915,22300447,"DEC 31, 2023",BKN @ OKC,L,37,4,13,0.308,1,6,0.167,4,4,1.0,3,0,3,5,1,0,1,3,13,-12,1,BKN,OKC,BKN,108,,,21,16,18,8
Spencer Dinwiddie,G,22023,203915,22300430,"DEC 29, 2023",BKN @ WAS,L,27,5,16,0.313,3,10,0.3,4,6,0.667,2,6,8,6,1,0,1,2,17,12,1,BKN,WAS,BKN,104,,,31,25,23,14
Spencer Dinwiddie,G,22023,203915,22300406,"DEC 26, 2023",BKN @ DET,W,34,2,11,0.182,0,3,0.0,5,8,0.625,1,4,5,6,1,0,0,4,9,1,1,BKN,DET,BKN,118,,,20,14,15,11
Spencer Dinwiddie,G,22023,203915,22300394,"DEC 23, 2023",BKN vs. DET,W,30,5,12,0.417,2,5,0.4,2,4,0.5,1,3,4,7,1,0,1,1,14,11,1,BKN,BKN,DET,126,,,25,18,21,11
Spencer Dinwiddie,G,22023,203915,22300383,"DEC 22, 2023",BKN vs. DEN,L,33,2,4,0.5,2,4,0.5,0,0,0.0,1,0,1,3,0,0,1,3,6,-11,1,BKN,BKN,DEN,117,,,10,7,9,4
Spencer Dinwiddie,G,22023,203915,22300368,"DEC 20, 2023",BKN vs. NYK,L,31,3,11,0.273,2,8,0.25,2,2,1.0,0,2,2,2,1,0,2,0,10,-27,1,BKN,BKN,NYK,102,,,14,12,12,4
Spencer Dinwiddie,G,22023,203915,22300357,"DEC 18, 2023",BKN @ UTA,L,36,7,15,0.467,1,6,0.167,2,3,0.667,1,7,8,11,0,2,1,0,17,-16,1,BKN,UTA,BKN,108,,,36,25,28,19
Spencer Dinwiddie,G,22023,203915,22300339,"DEC 16, 2023",BKN @ GSW,L,40,6,13,0.462,3,10,0.3,1,2,0.5,1,4,5,14,3,1,2,1,16,-6,1,BKN,GSW,BKN,120,,,35,21,30,19
Spencer Dinwiddie,G,22023,203915,22300322,"DEC 14, 2023",BKN @ DEN,L,24,5,11,0.455,1,4,0.25,6,7,0.857,0,4,4,8,1,0,2,3,17,-10,1,BKN,DEN,BKN,101,,,29,21,25,12
Spencer Dinwiddie,G,22023,203915,22300317,"DEC 13, 2023",BKN @ PHX,W,35,6,11,0.545,2,5,0.4,2,4,0.5,2,6,8,7,2,0,2,4,16,-10,1,BKN,PHX,BKN,116,,,31,24,23,15
Spencer Dinwiddie,G,22023,203915,22300303,"DEC 11, 2023",BKN @ SAC,L,34,5,14,0.357,2,8,0.25,4,5,0.8,0,2,2,8,0,0,3,2,16,-19,1,BKN,SAC,BKN,118,,,26,18,24,10
Spencer Dinwiddie,G,22023,203915,22301219,"DEC 08, 2023",BKN vs. WAS,W,33,6,15,0.4,1,6,0.167,1,1,1.0,0,3,3,9,4,0,2,3,14,19,1,BKN,BKN,WAS,124,,,26,17,23,12
Spencer Dinwiddie,G,22023,203915,22301209,"DEC 06, 2023",BKN @ ATL,W,28,5,19,0.263,1,5,0.2,2,3,0.667,1,1,2,4,1,1,2,0,13,-7,1,BKN,ATL,BKN,114,,,19,15,17,6
Spencer Dinwiddie,G,22023,203915,22300282,"DEC 02, 2023",BKN vs. ORL,W,35,8,15,0.533,3,7,0.429,3,4,0.75,0,4,4,3,0,0,2,2,22,21,1,BKN,BKN,ORL,129,,,29,26,25,7
Spencer Dinwiddie,G,22023,203915,22300266,"NOV 30, 2023",BKN vs. CHA,L,34,3,9,0.333,1,6,0.167,2,2,1.0,0,4,4,8,0,0,1,1,9,2,1,BKN,BKN,CHA,128,,,21,13,17,12
Spencer Dinwiddie,G,22023,203915,22300054,"NOV 28, 2023",BKN vs. TOR,W,38,5,17,0.294,3,11,0.273,10,10,1.0,1,8,9,8,4,0,1,0,23,15,1,BKN,BKN,TOR,115,,,40,32,31,17
Spencer Dinwiddie,G,22023,203915,22300250,"NOV 26, 2023",BKN vs. CHI,W,38,7,17,0.412,3,9,0.333,7,8,0.875,2,3,5,7,1,0,2,4,24,9,1,BKN,BKN,CHI,118,,,36,29,31,12
Spencer Dinwiddie,G,22023,203915,22300240,"NOV 25, 2023",BKN vs. MIA,W,36,4,9,0.444,2,7,0.286,4,4,1.0,0,2,2,11,2,0,3,2,14,17,1,BKN,BKN,MIA,112,,,27,16,25,13
Spencer Dinwiddie,G,22023,203915,22300227,"NOV 22, 2023",BKN @ ATL,L,42,9,23,0.391,3,8,0.375,5,5,1.0,2,4,6,12,0,0,4,3,26,8,1,BKN,ATL,BKN,145,,,44,32,38,18
Spencer Dinwiddie,G,22023,203915,22300208,"NOV 19, 2023",BKN vs. PHI,L,28,3,10,0.3,1,4,0.25,5,6,0.833,0,4,4,5,0,1,2,0,12,-21,1,BKN,BKN,PHI,99,,,21,16,17,9
Spencer Dinwiddie,G,22023,203915,22300200,"NOV 16, 2023",BKN @ MIA,L,33,2,9,0.222,2,7,0.286,4,6,0.667,2,3,5,7,0,0,2,1,10,4,1,BKN,MIA,BKN,115,,,22,15,17,12
Spencer Dinwiddie,G,22023,203915,22300020,"NOV 14, 2023",BKN vs. ORL,W,38,10,18,0.556,5,10,0.5,4,6,0.667,1,4,5,9,0,0,1,3,29,25,1,BKN,BKN,ORL,124,,,43,34,38,14
Spencer Dinwiddie,G,22023,203915,22300178,"NOV 12, 2023",BKN vs. WAS,W,31,3,10,0.3,0,5,0.0,6,7,0.857,0,4,4,3,2,1,0,2,12,13,1,BKN,BKN,WAS,102,,,19,16,15,7
Spencer Dinwiddie,G,22023,203915,22300010,"NOV 10, 2023",BKN @ BOS,L,20,3,7,0.429,3,6,0.5,3,4,0.75,0,4,4,4,0,0,2,2,12,-14,1,BKN,BOS,BKN,107,,,20,16,16,8
Spencer Dinwiddie,G,22023,203915,22300160,"NOV 08, 2023",BKN vs. LAC,W,26,2,8,0.25,2,7,0.286,1,2,0.5,0,3,3,4,0,0,2,0,7,-1,1,BKN,BKN,LAC,100,,,14,10,11,7
Spencer Dinwiddie,G,22023,203915,22300149,"NOV 06, 2023",BKN vs. MIL,L,24,1,4,0.25,1,3,0.333,0,0,0.0,1,2,3,3,0,0,0,0,3,13,1,BKN,BKN,MIL,125,,,9,6,6,6
Spencer Dinwiddie,G,22023,203915,22300136,"NOV 04, 2023",BKN vs. BOS,L,35,8,14,0.571,3,7,0.429,0,3,0.0,0,6,6,6,0,0,1,1,19,-6,1,BKN,BKN,BOS,114,,,31,25,25,12
Spencer Dinwiddie,G,22023,203915,22300004,"NOV 03, 2023",BKN @ CHI,W,31,4,7,0.571,2,4,0.5,0,0,0.0,0,3,3,9,2,0,3,0,10,15,1,BKN,CHI,BKN,109,,,22,13,19,12
Spencer Dinwiddie,G,22023,203915,22300101,"OCT 30, 2023",BKN @ CHA,W,13,2,6,0.333,1,3,0.333,0,0,0.0,0,1,1,3,0,0,1,2,5,14,1,BKN,CHA,BKN,133,,,9,6,8,4
Spencer Dinwiddie,G,22023,203915,22300084,"OCT 27, 2023",BKN @ DAL,L,40,8,17,0.471,6,12,0.5,1,2,0.5,0,3,3,8,0,0,2,4,23,4,1,BKN,DAL,BKN,120,,,34,26,31,11
Spencer Dinwiddie,G,22023,203915,22300067,"OCT 25, 2023",BKN vs. CLE,L,24,1,3,0.333,1,3,0.333,2,2,1.0,0,1,1,3,0,0,1,2,5,-10,1,BKN,BKN,CLE,113,,,9,6,8,4
Trey Murphy III,F,22023,1630530,22300758,"FEB 10, 2024",NOP @ POR,W,30,7,10,0.7,5,8,0.625,5,6,0.833,1,4,5,0,1,2,0,1,24,4,1,NOP,POR,NOP,93,,,29,29,24,5
Trey Murphy III,F,22023,1630530,22300747,"FEB 09, 2024",NOP @ LAL,L,19,2,3,0.667,1,2,0.5,0,0,0.0,0,1,1,0,0,0,0,1,5,-19,1,NOP,LAL,NOP,122,,,6,6,5,1
Trey Murphy III,F,22023,1630530,22300731,"FEB 07, 2024",NOP @ LAC,W,23,5,11,0.455,3,8,0.375,0,0,0.0,0,1,1,2,0,0,1,2,13,15,1,NOP,LAC,NOP,117,,,16,14,15,3
Trey Murphy III,F,22023,1630530,22300718,"FEB 05, 2024",NOP vs. TOR,W,25,4,10,0.4,2,8,0.25,0,0,0.0,1,5,6,0,0,2,0,1,10,23,1,NOP,NOP,TOR,138,,,16,16,10,6
Trey Murphy III,F,22023,1630530,22300696,"FEB 02, 2024",NOP @ SAS,W,27,4,9,0.444,1,2,0.5,0,0,0.0,0,1,1,0,2,0,1,0,9,-18,1,NOP,SAS,NOP,114,,,10,10,9,1
Trey Murphy III,F,22023,1630530,22300679,"JAN 31, 2024",NOP @ HOU,W,27,5,12,0.417,3,10,0.3,0,0,0.0,1,5,6,1,0,0,1,1,13,4,1,NOP,HOU,NOP,110,,,20,19,14,7
Trey Murphy III,F,22023,1630530,22300640,"JAN 26, 2024",NOP vs. OKC,L,28,2,7,0.286,1,6,0.167,1,2,0.5,0,7,7,1,0,0,0,1,6,-16,1,NOP,NOP,OKC,83,,,14,13,7,8
Trey Murphy III,F,22023,1630530,22300616,"JAN 23, 2024",NOP vs. UTA,W,25,6,14,0.429,2,10,0.2,0,1,0.0,1,3,4,2,0,0,0,2,14,23,1,NOP,NOP,UTA,153,,,20,18,16,6
Trey Murphy III,F,22023,1630530,22300588,"JAN 19, 2024",NOP vs. PHX,L,24,2,8,0.25,1,5,0.2,0,0,0.0,1,1,2,1,1,1,0,3,5,-16,1,NOP,NOP,PHX,109,,,8,7,6,3
Trey Murphy III,F,22023,1630530,22300575,"JAN 17, 2024",NOP vs. CHA,W,24,6,13,0.462,5,12,0.417,1,2,0.5,0,5,5,1,1,0,2,2,18,18,1,NOP,NOP,CHA,132,,,24,23,19,6
Trey Murphy III,F,22023,1630530,22300539,"JAN 12, 2024",NOP @ DEN,L,28,2,9,0.222,2,8,0.25,0,0,0.0,0,3,3,4,2,0,0,0,6,-18,1,NOP,DEN,NOP,113,,,13,9,10,7
Trey Murphy III,F,22023,1630530,22300486,"JAN 05, 2024",NOP vs. LAC,L,17,1,9,0.111,1,6,0.167,0,0,0.0,0,2,2,1,0,1,0,0,3,-15,1,NOP,NOP,LAC,95,,,6,5,4,3
Trey Murphy III,F,22023,1630530,22300424,"DEC 28, 2023",NOP vs. UTA,W,23,2,8,0.25,2,7,0.286,0,0,0.0,0,1,1,2,0,0,1,2,6,-1,1,NOP,NOP,UTA,112,,,9,7,8,3
Trey Murphy III,F,22023,1630530,22300410,"DEC 26, 2023",NOP vs. MEM,L,36,3,8,0.375,3,6,0.5,1,2,0.5,2,5,7,1,2,0,2,2,10,10,1,NOP,NOP,MEM,115,,,18,17,11,8
Trey Murphy III,F,22023,1630530,22300392,"DEC 23, 2023",NOP vs. HOU,L,34,4,11,0.364,3,7,0.429,3,3,1.0,1,5,6,0,2,0,1,2,14,4,1,NOP,NOP,HOU,104,,,20,20,14,6
Trey Murphy III,F,22023,1630530,22300375,"DEC 21, 2023",NOP @ CLE,W,28,10,16,0.625,6,10,0.6,2,2,1.0,0,4,4,3,1,1,1,1,28,20,1,NOP,CLE,NOP,123,,,35,32,31,7
Trey Murphy III,F,22023,1630530,22300360,"DEC 19, 2023",NOP vs. MEM,L,21,2,6,0.333,0,1,0.0,3,3,1.0,0,3,3,0,0,0,1,2,7,-6,1,NOP,NOP,MEM,113,,,10,10,7,3
Trey Murphy III,F,22023,1630530,22300345,"DEC 17, 2023",NOP @ SAS,W,25,5,10,0.5,2,5,0.4,2,3,0.667,0,4,4,4,1,0,0,1,14,27,1,NOP,SAS,NOP,146,,,22,18,18,8
Trey Murphy III,F,22023,1630530,22300326,"DEC 15, 2023",NOP @ CHA,W,25,3,7,0.429,1,5,0.2,6,6,1.0,0,6,6,2,0,0,0,2,13,8,1,NOP,CHA,NOP,112,,,21,19,15,8
Trey Murphy III,F,22023,1630530,22300311,"DEC 13, 2023",NOP @ WAS,W,33,7,10,0.7,6,7,0.857,7,8,0.875,0,6,6,4,2,1,0,0,27,43,1,NOP,WAS,NOP,142,,,37,33,31,10
Trey Murphy III,F,22023,1630530,22300301,"DEC 11, 2023",NOP vs. MIN,W,24,4,8,0.5,1,5,0.2,1,2,0.5,0,3,3,1,0,0,2,0,10,-4,1,NOP,NOP,MIN,121,,,14,13,11,4
Trey Murphy III,F,22023,1630530,22301230,"DEC 07, 2023",NOP @ LAL,L,22,5,13,0.385,2,7,0.286,2,2,1.0,0,3,3,1,0,0,0,1,14,-25,1,NOP,LAL,NOP,89,,,18,17,15,4
Trey Murphy III,F,22023,1630530,22301204,"DEC 04, 2023",NOP @ SAC,W,30,6,13,0.462,3,8,0.375,1,2,0.5,0,2,2,1,0,1,0,1,16,24,1,NOP,SAC,NOP,127,,,19,18,17,3
Trey Murphy III,F,22023,1630530,22300659,"JAN 29, 2024",NOP @ BOS,L,28,6,14,0.429,3,10,0.3,0,0,0.0,2,2,4,0,0,0,1,3,15,-7,1,NOP,BOS,NOP,112,,,19,19,15,4
Trey Murphy III,F,22023,1630530,22300556,"JAN 15, 2024",NOP @ DAL,L,22,2,5,0.4,1,4,0.25,9,12,0.75,0,3,3,0,1,0,0,0,14,-10,1,NOP,DAL,NOP,120,,,17,17,14,3
Trey Murphy III,F,22023,1630530,22300525,"JAN 10, 2024",NOP @ GSW,W,24,6,13,0.462,4,11,0.364,0,0,0.0,3,1,4,6,0,1,0,2,16,38,1,NOP,GSW,NOP,141,,,26,20,22,10
Trey Murphy III,F,22023,1630530,22300500,"JAN 07, 2024",NOP @ SAC,W,24,4,7,0.571,3,6,0.5,0,0,0.0,0,2,2,5,1,0,1,1,11,19,1,NOP,SAC,NOP,133,,,18,13,16,7
Trey Murphy III,F,22023,1630530,22300278,"DEC 01, 2023",NOP vs. SAS,W,22,7,13,0.538,4,10,0.4,0,0,0.0,1,2,3,1,1,1,0,0,18,9,1,NOP,NOP,SAS,121,,,22,21,19,4
Eric Gordon,G,22023,201569,22300757,"FEB 10, 2024",PHX @ GSW,L,23,2,5,0.4,1,3,0.333,2,2,1.0,0,1,1,0,1,0,1,1,7,-5,1,PHX,GSW,PHX,112,,,8,8,7,1
Eric Gordon,G,22023,201569,22300739,"FEB 08, 2024",PHX vs. UTA,W,38,7,8,0.875,3,4,0.75,2,2,1.0,0,2,2,4,1,1,1,0,19,13,1,PHX,PHX,UTA,129,,,25,21,23,6
Eric Gordon,G,22023,201569,22300725,"FEB 06, 2024",PHX vs. MIL,W,22,1,4,0.25,1,3,0.333,0,0,0.0,0,4,4,1,0,0,0,2,3,17,1,PHX,PHX,MIL,114,,,8,7,4,5
Eric Gordon,G,22023,201569,22300705,"FEB 04, 2024",PHX @ WAS,W,19,3,6,0.5,1,3,0.333,0,0,0.0,0,0,0,0,1,0,1,1,7,7,1,PHX,WAS,PHX,140,,,7,7,7,0
Eric Gordon,G,22023,201569,22300690,"FEB 02, 2024",PHX @ ATL,L,28,2,5,0.4,2,5,0.4,0,0,0.0,0,3,3,1,1,0,2,1,6,-14,1,PHX,ATL,PHX,120,,,10,9,7,4
Eric Gordon,G,22023,201569,22300661,"JAN 29, 2024",PHX @ MIA,W,34,8,17,0.471,5,12,0.417,2,2,1.0,2,2,4,5,2,2,3,2,23,8,1,PHX,MIA,PHX,118,,,32,27,28,9
Eric Gordon,G,22023,201569,22300655,"JAN 28, 2024",PHX @ ORL,L,22,4,5,0.8,1,2,0.5,0,0,0.0,0,1,1,1,0,0,2,1,9,-14,1,PHX,ORL,PHX,98,,,11,10,10,2
Eric Gordon,G,22023,201569,22300636,"JAN 26, 2024",PHX @ IND,L,30,5,9,0.556,2,6,0.333,2,3,0.667,0,2,2,2,1,0,2,0,14,0,1,PHX,IND,PHX,131,,,18,16,16,4
Eric Gordon,G,22023,201569,22300604,"JAN 21, 2024",PHX vs. IND,W,30,1,6,0.167,0,5,0.0,2,2,1.0,0,3,3,2,0,1,2,2,4,13,1,PHX,PHX,IND,117,,,9,7,6,5
Eric Gordon,G,22023,201569,22300588,"JAN 19, 2024",PHX @ NOP,W,26,2,9,0.222,1,8,0.125,0,0,0.0,0,2,2,0,2,0,0,2,5,9,1,PHX,NOP,PHX,123,,,7,7,5,2
Eric Gordon,G,22023,201569,22300567,"JAN 16, 2024",PHX vs. SAC,W,24,5,10,0.5,3,7,0.429,0,0,0.0,0,3,3,2,2,0,2,0,13,10,1,PHX,PHX,SAC,119,,,18,16,15,5
Eric Gordon,G,22023,201569,22300554,"JAN 14, 2024",PHX @ POR,W,24,1,4,0.25,1,3,0.333,0,0,0.0,0,2,2,4,1,0,0,0,3,-1,1,PHX,POR,PHX,127,,,9,5,7,6
Eric Gordon,G,22023,201569,22300531,"JAN 11, 2024",PHX @ LAL,W,23,2,11,0.182,1,9,0.111,0,0,0.0,2,1,3,0,0,0,0,0,5,1,1,PHX,LAL,PHX,127,,,8,8,5,3
Eric Gordon,G,22023,201569,22300511,"JAN 08, 2024",PHX @ LAC,L,25,3,8,0.375,2,7,0.286,4,4,1.0,0,1,1,2,0,0,1,1,12,-20,1,PHX,LAC,PHX,111,,,15,13,14,3
Eric Gordon,G,22023,201569,22300473,"JAN 03, 2024",PHX vs. LAC,L,28,5,11,0.455,3,6,0.5,3,4,0.75,1,4,5,1,1,0,1,1,16,2,1,PHX,PHX,LAC,122,,,22,21,17,6
Eric Gordon,G,22023,201569,22300456,"JAN 01, 2024",PHX vs. POR,W,20,4,10,0.4,2,6,0.333,2,5,0.4,0,3,3,1,1,0,1,0,12,16,1,PHX,PHX,POR,109,,,16,15,13,4
Eric Gordon,G,22023,201569,22300450,"DEC 31, 2023",PHX vs. ORL,W,30,0,3,0.0,0,2,0.0,0,0,0.0,0,1,1,0,2,0,0,3,0,-3,1,PHX,PHX,ORL,112,,,1,1,0,1
Eric Gordon,G,22023,201569,22300436,"DEC 29, 2023",PHX vs. CHA,W,33,7,12,0.583,7,12,0.583,0,0,0.0,0,2,2,1,0,1,4,1,21,5,1,PHX,PHX,CHA,133,,,24,23,22,3
Eric Gordon,G,22023,201569,22300418,"DEC 27, 2023",PHX @ HOU,W,39,10,15,0.667,7,11,0.636,0,0,0.0,0,0,0,1,0,3,0,1,27,11,1,PHX,HOU,PHX,129,,,28,27,28,1
Eric Gordon,G,22023,201569,22300405,"DEC 25, 2023",PHX vs. DAL,L,37,6,12,0.5,2,7,0.286,0,0,0.0,0,1,1,2,0,0,0,3,14,-17,1,PHX,PHX,DAL,114,,,17,15,16,3
Eric Gordon,G,22023,201569,22300387,"DEC 22, 2023",PHX @ SAC,L,25,0,2,0.0,0,1,0.0,0,0,0.0,0,4,4,2,0,1,0,1,0,-25,1,PHX,SAC,PHX,105,,,6,4,2,6
Eric Gordon,G,22023,201569,22300363,"DEC 19, 2023",PHX @ POR,L,29,1,7,0.143,1,4,0.25,2,2,1.0,1,2,3,4,2,0,0,1,5,7,1,PHX,POR,PHX,104,,,12,8,9,7
Eric Gordon,G,22023,201569,22300347,"DEC 17, 2023",PHX vs. WAS,W,30,5,9,0.556,2,6,0.333,1,2,0.5,0,2,2,1,1,0,1,0,13,12,1,PHX,PHX,WAS,112,,,16,15,14,3
Eric Gordon,G,22023,201569,22301203,"DEC 05, 2023",PHX @ LAL,L,35,3,8,0.375,1,4,0.25,0,0,0.0,0,4,4,4,2,1,1,1,7,7,1,PHX,LAL,PHX,103,,,15,11,11,8
Eric Gordon,G,22023,201569,22300279,"DEC 01, 2023",PHX vs. DEN,L,33,6,11,0.545,4,7,0.571,0,0,0.0,1,2,3,3,1,1,3,1,16,-6,1,PHX,PHX,DEN,111,,,22,19,19,6
Eric Gordon,G,22023,201569,22300044,"NOV 24, 2023",PHX @ MEM,W,34,6,15,0.4,4,11,0.364,4,4,1.0,0,1,1,2,0,0,2,0,20,5,1,PHX,MEM,PHX,110,,,23,21,22,3
Eric Gordon,G,22023,201569,22300236,"NOV 22, 2023",PHX vs. GSW,W,29,4,12,0.333,3,9,0.333,2,3,0.667,0,1,1,4,3,0,2,3,13,9,1,PHX,PHX,GSW,123,,,18,14,17,5
Eric Gordon,G,22023,201569,22300041,"NOV 21, 2023",PHX vs. POR,W,36,4,5,0.8,2,3,0.667,0,0,0.0,0,2,2,4,1,1,2,2,10,13,1,PHX,PHX,POR,120,,,16,12,14,6
Eric Gordon,G,22023,201569,22300214,"NOV 19, 2023",PHX @ UTA,W,41,7,16,0.438,5,12,0.417,1,2,0.5,1,4,5,6,2,2,1,3,20,5,1,PHX,UTA,PHX,140,,,31,25,26,11
Eric Gordon,G,22023,201569,22300035,"NOV 17, 2023",PHX @ UTA,W,33,5,12,0.417,4,8,0.5,0,0,0.0,0,2,2,1,1,1,1,2,14,-2,1,PHX,UTA,PHX,131,,,17,16,15,3
Eric Gordon,G,22023,201569,22300197,"NOV 15, 2023",PHX vs. MIN,W,29,6,9,0.667,3,6,0.5,0,0,0.0,0,1,1,3,0,0,1,2,15,19,1,PHX,PHX,MIN,133,,,19,16,18,4
Eric Gordon,G,22023,201569,22300015,"NOV 10, 2023",PHX vs. LAL,L,28,5,9,0.556,3,4,0.75,0,0,0.0,1,1,2,2,3,0,1,0,13,3,1,PHX,PHX,LAL,119,,,17,15,15,4
Eric Gordon,G,22023,201569,22300162,"NOV 08, 2023",PHX @ CHI,W,25,1,9,0.111,0,8,0.0,0,0,0.0,0,1,1,2,0,0,3,1,2,-16,1,PHX,CHI,PHX,116,,,5,3,4,3
Eric Gordon,G,22023,201569,22300140,"NOV 05, 2023",PHX @ DET,W,31,8,14,0.571,3,5,0.6,2,2,1.0,2,3,5,8,1,0,1,0,21,23,1,PHX,DET,PHX,120,,,34,26,29,13
Eric Gordon,G,22023,201569,22300132,"NOV 04, 2023",PHX @ PHI,L,34,6,15,0.4,1,4,0.25,0,0,0.0,0,1,1,3,2,2,1,1,13,-19,1,PHX,PHI,PHX,100,,,17,14,16,4
Eric Gordon,G,22023,201569,22300131,"NOV 02, 2023",PHX vs. SAS,L,24,3,5,0.6,1,2,0.5,0,0,0.0,0,1,1,1,1,1,0,1,7,-2,1,PHX,PHX,SAS,121,,,9,8,8,2
Eric Gordon,G,22023,201569,22300113,"OCT 31, 2023",PHX vs. SAS,L,36,8,14,0.571,4,9,0.444,0,0,0.0,0,2,2,6,0,0,4,1,20,8,1,PHX,PHX,SAS,114,,,28,22,26,8
Eric Gordon,G,22023,201569,22300094,"OCT 28, 2023",PHX vs. UTA,W,26,9,14,0.643,3,7,0.429,0,0,0.0,0,2,2,4,1,0,0,1,21,23,1,PHX,PHX,UTA,126,,,27,23,25,6
Eric Gordon,G,22023,201569,22300076,"OCT 26, 2023",PHX @ LAL,L,30,6,16,0.375,2,8,0.25,1,1,1.0,1,1,2,0,0,0,2,2,15,-27,1,PHX,LAL,PHX,95,,,17,17,15,2
Eric Gordon,G,22023,201569,22300062,"OCT 24, 2023",PHX @ GSW,W,32,4,16,0.25,2,9,0.222,0,0,0.0,1,3,4,1,1,1,1,2,10,6,1,PHX,GSW,PHX,108,,,15,14,11,5
Eric Gordon,G,22023,201569,22300677,"JAN 31, 2024",PHX @ BKN,W,32,6,10,0.6,5,9,0.556,0,0,0.0,0,2,2,4,1,0,0,1,17,17,1,PHX,BKN,PHX,136,,,23,19,21,6
Eric Gordon,G,22023,201569,22300308,"DEC 12, 2023",PHX vs. GSW,W,32,3,11,0.273,1,6,0.167,1,1,1.0,0,0,0,0,0,0,1,1,8,-12,1,PHX,PHX,GSW,119,,,8,8,8,0
Eric Gordon,G,22023,201569,22301228,"DEC 08, 2023",PHX vs. SAC,L,38,7,13,0.538,3,7,0.429,2,2,1.0,0,0,0,3,2,1,4,3,19,-2,1,PHX,PHX,SAC,106,,,22,19,22,3
Eric Gordon,G,22023,201569,22300260,"NOV 29, 2023",PHX @ TOR,L,34,4,9,0.444,2,5,0.4,0,0,0.0,0,1,1,1,1,0,0,2,10,-9,1,PHX,TOR,PHX,105,,,12,11,11,2
Eric Gordon,G,22023,201569,22300247,"NOV 26, 2023",PHX @ NYK,W,33,9,13,0.692,6,9,0.667,1,2,0.5,0,2,2,2,0,1,2,3,25,0,1,PHX,NYK,PHX,116,,,29,27,27,4
Mark Williams,C,22023,1631109,22300177,"NOV 12, 2023",CHA @ NYK,L,23,4,5,0.8,0,0,0.0,2,2,1.0,2,2,4,2,2,0,1,3,10,-22,1,CHA,NYK,CHA,107,,,16,14,12,6
Mark Williams,C,22023,1631109,22300248,"NOV 26, 2023",CHA @ ORL,L,22,5,6,0.833,0,0,0.0,2,2,1.0,1,5,6,1,1,1,1,4,12,-11,1,CHA,ORL,CHA,117,,,19,18,13,7
Mark Williams,C,22023,1631109,22300225,"NOV 22, 2023",CHA vs. WAS,W,35,4,10,0.4,0,0,0.0,3,6,0.5,5,10,15,0,0,3,0,4,11,6,1,CHA,CHA,WAS,117,,,26,26,11,15
Mark Williams,C,22023,1631109,22300217,"NOV 20, 2023",CHA vs. BOS,W,33,8,14,0.571,0,0,0.0,2,2,1.0,8,8,16,2,1,3,1,4,18,33,1,CHA,CHA,BOS,121,,,36,34,20,18
Mark Williams,C,22023,1631109,22300202,"NOV 18, 2023",CHA vs. NYK,L,30,3,5,0.6,0,0,0.0,1,2,0.5,2,6,8,4,0,1,1,3,7,-1,1,CHA,CHA,NYK,108,,,19,15,11,12
Mark Williams,C,22023,1631109,22300027,"NOV 17, 2023",CHA vs. MIL,L,32,4,7,0.571,0,0,0.0,3,4,0.75,6,10,16,2,1,0,0,1,11,-14,1,CHA,CHA,MIL,99,,,29,27,13,18
Mark Williams,C,22023,1631109,22300017,"NOV 14, 2023",CHA vs. MIA,L,23,5,5,1.0,0,0,0.0,1,4,0.25,4,3,7,0,1,0,0,2,11,-11,1,CHA,CHA,MIA,105,,,18,18,11,7
Mark Williams,C,22023,1631109,22300009,"NOV 10, 2023",CHA @ WAS,W,30,10,21,0.476,0,0,0.0,1,2,0.5,15,9,24,3,0,0,0,0,21,19,1,CHA,WAS,CHA,124,,,48,45,24,27
Mark Williams,C,22023,1631109,22300157,"NOV 08, 2023",CHA vs. WAS,L,18,5,5,1.0,0,0,0.0,4,6,0.667,2,5,7,0,0,1,1,4,14,2,1,CHA,CHA,WAS,116,,,21,21,14,7
Mark Williams,C,22023,1631109,22300143,"NOV 05, 2023",CHA @ DAL,L,27,8,8,1.0,0,0,0.0,3,6,0.5,2,8,10,1,0,0,2,3,19,-1,1,CHA,DAL,CHA,118,,,30,29,20,11
Mark Williams,C,22023,1631109,22300133,"NOV 04, 2023",CHA @ IND,W,30,9,12,0.75,0,0,0.0,9,9,1.0,4,3,7,1,2,2,3,2,27,-3,1,CHA,IND,CHA,125,,,35,34,28,8
Mark Williams,C,22023,1631109,22300122,"NOV 01, 2023",CHA @ HOU,L,25,3,4,0.75,0,0,0.0,3,6,0.5,3,3,6,1,2,2,1,0,9,-1,1,CHA,HOU,CHA,119,,,16,15,10,7
Mark Williams,C,22023,1631109,22300101,"OCT 30, 2023",CHA vs. BKN,L,23,8,8,1.0,0,0,0.0,2,2,1.0,1,6,7,1,0,0,1,1,18,-7,1,CHA,CHA,BKN,121,,,26,25,19,8
Mark Williams,C,22023,1631109,22300077,"OCT 27, 2023",CHA vs. DET,L,21,1,4,0.25,0,0,0.0,0,0,0.0,2,1,3,1,0,1,1,5,2,-17,1,CHA,CHA,DET,99,,,6,5,3,4
Mark Williams,C,22023,1631109,22300063,"OCT 25, 2023",CHA vs. ATL,W,30,5,6,0.833,0,0,0.0,3,3,1.0,4,11,15,1,3,1,2,2,13,19,1,CHA,CHA,ATL,116,,,29,28,14,16
Mark Williams,C,22023,1631109,22300057,"NOV 28, 2023",CHA @ NYK,L,25,5,9,0.556,0,0,0.0,2,2,1.0,6,6,12,0,1,0,0,2,12,-7,1,CHA,NYK,CHA,91,,,24,24,12,12
Mark Williams,C,22023,1631109,22301216,"DEC 08, 2023",CHA vs. TOR,W,20,2,4,0.5,0,0,0.0,0,0,0.0,2,1,3,1,1,2,1,2,4,5,1,CHA,CHA,TOR,119,,,8,7,5,4
Mark Williams,C,22023,1631109,22300281,"DEC 02, 2023",CHA vs. MIN,L,29,4,6,0.667,0,0,0.0,3,4,0.75,2,4,6,0,0,0,1,6,11,-8,1,CHA,CHA,MIN,117,,,17,17,11,6
Mark Williams,C,22023,1631109,22300266,"NOV 30, 2023",CHA @ BKN,W,32,5,12,0.417,0,0,0.0,2,2,1.0,5,7,12,1,1,3,0,2,12,-2,1,CHA,BKN,CHA,129,,,25,24,13,13
Max Strus,F,22023,1629622,22300756,"FEB 10, 2024",CLE @ TOR,W,29,6,11,0.545,2,6,0.333,0,0,0.0,1,1,2,7,0,0,0,2,14,0,1,CLE,TOR,CLE,119,,,23,16,21,9
Max Strus,F,22023,1629622,22300735,"FEB 08, 2024",CLE @ BKN,W,21,3,5,0.6,0,1,0.0,0,0,0.0,1,4,5,2,1,0,1,2,6,20,1,CLE,BKN,CLE,118,,,13,11,8,7
Max Strus,F,22023,1629622,22300728,"FEB 07, 2024",CLE @ WAS,W,28,1,5,0.2,0,4,0.0,0,2,0.0,2,5,7,3,0,1,0,1,2,-8,1,CLE,WAS,CLE,114,,,12,9,5,10
Max Strus,F,22023,1629622,22300714,"FEB 05, 2024",CLE vs. SAC,W,26,8,13,0.615,6,10,0.6,0,0,0.0,1,4,5,2,2,0,0,0,22,20,1,CLE,CLE,SAC,136,,,29,27,24,7
Max Strus,F,22023,1629622,22300703,"FEB 03, 2024",CLE @ SAS,W,29,2,9,0.222,2,7,0.286,0,0,0.0,0,3,3,3,1,1,1,0,6,11,1,CLE,SAS,CLE,117,,,12,9,9,6
Max Strus,F,22023,1629622,22300687,"FEB 01, 2024",CLE @ MEM,W,29,4,8,0.5,2,4,0.5,1,2,0.5,4,6,10,4,1,0,0,1,11,13,1,CLE,MEM,CLE,108,,,25,21,15,14
Max Strus,F,22023,1629622,22300675,"JAN 31, 2024",CLE vs. DET,W,31,1,6,0.167,0,4,0.0,0,0,0.0,0,4,4,1,1,0,2,4,2,5,1,CLE,CLE,DET,128,,,7,6,3,5
Max Strus,F,22023,1629622,22300658,"JAN 29, 2024",CLE vs. LAC,W,35,4,8,0.5,3,7,0.429,3,3,1.0,1,6,7,4,0,0,2,5,14,10,1,CLE,CLE,LAC,118,,,25,21,18,11
Max Strus,F,22023,1629622,22300639,"JAN 26, 2024",CLE @ MIL,W,35,3,10,0.3,2,7,0.286,3,4,0.75,2,5,7,4,2,0,1,2,11,0,1,CLE,MIL,CLE,112,,,22,18,15,11
Max Strus,F,22023,1629622,22300624,"JAN 24, 2024",CLE @ MIL,L,34,6,11,0.545,2,6,0.333,0,0,0.0,0,4,4,2,2,0,1,5,14,-6,1,CLE,MIL,CLE,116,,,20,18,16,6
Max Strus,F,22023,1629622,22300607,"JAN 22, 2024",CLE @ ORL,W,27,4,7,0.571,2,4,0.5,0,0,0.0,1,3,4,4,1,0,1,0,10,16,1,CLE,ORL,CLE,126,,,18,14,14,8
Max Strus,F,22023,1629622,22300595,"JAN 20, 2024",CLE @ ATL,W,20,5,10,0.5,1,4,0.25,2,2,1.0,2,1,3,7,1,0,2,1,13,15,1,CLE,ATL,CLE,116,,,23,16,20,10
Max Strus,F,22023,1629622,22300572,"JAN 17, 2024",CLE vs. MIL,W,22,2,4,0.5,0,1,0.0,2,2,1.0,0,6,6,3,0,1,0,1,6,33,1,CLE,CLE,MIL,135,,,15,12,9,9
Max Strus,F,22023,1629622,22300561,"JAN 15, 2024",CLE vs. CHI,W,35,1,8,0.125,0,6,0.0,0,0,0.0,1,4,5,4,0,1,2,2,2,19,1,CLE,CLE,CHI,109,,,11,7,6,9
Max Strus,F,22023,1629622,22300527,"JAN 11, 2024",CLE vs. BKN,W,7,0,2,0.0,0,2,0.0,0,0,0.0,0,0,0,0,0,0,0,0,0,8,1,CLE,CLE,BKN,111,,,0,0,0,0
Max Strus,F,22023,1629622,22300497,"JAN 07, 2024",CLE vs. SAS,W,37,3,11,0.273,2,9,0.222,0,0,0.0,1,4,5,4,2,0,2,2,8,-9,1,CLE,CLE,SAS,117,,,17,13,12,9
Max Strus,F,22023,1629622,22300482,"JAN 05, 2024",CLE vs. WAS,W,30,4,6,0.667,1,3,0.333,0,0,0.0,0,5,5,3,0,0,3,1,9,10,1,CLE,CLE,WAS,114,,,17,14,12,8
Max Strus,F,22023,1629622,22300465,"JAN 03, 2024",CLE vs. WAS,W,28,9,13,0.692,6,8,0.75,0,0,0.0,2,2,4,3,1,1,1,4,24,32,1,CLE,CLE,WAS,140,,,31,28,27,7
Max Strus,F,22023,1629622,22300452,"JAN 01, 2024",CLE @ TOR,L,37,2,7,0.286,2,5,0.4,0,0,0.0,0,6,6,3,1,1,3,4,6,9,1,CLE,TOR,CLE,121,,,15,12,9,9
Max Strus,F,22023,1629622,22300433,"DEC 29, 2023",CLE vs. MIL,L,36,5,18,0.278,2,11,0.182,0,0,0.0,1,3,4,2,4,2,1,3,12,-5,1,CLE,CLE,MIL,111,,,18,16,14,6
Max Strus,F,22023,1629622,22300420,"DEC 27, 2023",CLE @ DAL,W,34,3,10,0.3,2,8,0.25,0,0,0.0,1,4,5,6,1,1,2,3,8,4,1,CLE,DAL,CLE,113,,,19,13,14,11
Max Strus,F,22023,1629622,22300396,"DEC 23, 2023",CLE @ CHI,W,41,9,22,0.409,5,17,0.294,3,3,1.0,0,1,1,7,2,1,3,2,26,14,1,CLE,CHI,CLE,109,,,34,27,33,8
Max Strus,F,22023,1629622,22300375,"DEC 21, 2023",CLE vs. NOP,L,33,4,16,0.25,2,12,0.167,3,5,0.6,0,3,3,5,0,0,3,2,13,-15,1,CLE,CLE,NOP,104,,,21,16,18,8
Max Strus,F,22023,1629622,22300364,"DEC 20, 2023",CLE vs. UTA,W,33,6,15,0.4,6,12,0.5,0,0,0.0,1,3,4,4,0,0,5,3,18,-5,1,CLE,CLE,UTA,124,,,26,22,22,8
Max Strus,F,22023,1629622,22300349,"DEC 18, 2023",CLE vs. HOU,W,34,5,13,0.385,3,9,0.333,4,5,0.8,0,3,3,2,0,0,0,3,17,2,1,CLE,CLE,HOU,135,,,22,20,19,5
Max Strus,F,22023,1629622,22300336,"DEC 16, 2023",CLE vs. ATL,W,34,4,13,0.308,1,8,0.125,2,2,1.0,1,5,6,5,1,1,1,2,11,12,1,CLE,CLE,ATL,127,,,22,17,16,11
Max Strus,F,22023,1629622,22300319,"DEC 14, 2023",CLE @ BOS,L,31,2,5,0.4,1,4,0.25,0,0,0.0,2,2,4,2,0,0,1,5,5,-4,1,CLE,BOS,CLE,107,,,11,9,7,6
Max Strus,F,22023,1629622,22300305,"DEC 12, 2023",CLE @ BOS,L,37,6,15,0.4,5,11,0.455,0,0,0.0,0,9,9,3,0,0,1,4,17,1,1,CLE,BOS,CLE,113,,,29,26,20,12
Max Strus,F,22023,1629622,22300294,"DEC 11, 2023",CLE @ ORL,L,26,1,9,0.111,0,5,0.0,4,6,0.667,1,1,2,3,1,0,3,4,6,0,1,CLE,ORL,CLE,94,,,11,8,9,5
Max Strus,F,22023,1629622,22301220,"DEC 08, 2023",CLE @ MIA,W,34,4,17,0.235,2,11,0.182,1,1,1.0,2,5,7,1,1,0,0,3,11,18,1,CLE,MIA,CLE,111,,,19,18,12,8
Max Strus,F,22023,1629622,22301205,"DEC 06, 2023",CLE vs. ORL,W,31,5,10,0.5,4,8,0.5,3,4,0.75,1,4,5,6,1,0,1,5,17,4,1,CLE,CLE,ORL,121,,,28,22,23,11
Max Strus,F,22023,1629622,22300283,"DEC 02, 2023",CLE @ DET,W,38,9,16,0.563,4,10,0.4,0,0,0.0,0,5,5,5,1,0,1,4,22,10,1,CLE,DET,CLE,110,,,32,27,27,10
Max Strus,F,22023,1629622,22300265,"NOV 30, 2023",CLE vs. POR,L,36,4,11,0.364,1,6,0.167,0,0,0.0,0,3,3,3,2,0,2,6,9,-10,1,CLE,CLE,POR,95,,,15,12,12,6
Max Strus,F,22023,1629622,22300055,"NOV 28, 2023",CLE vs. ATL,W,35,4,11,0.364,3,7,0.429,0,0,0.0,2,1,3,7,2,2,0,2,11,30,1,CLE,CLE,ATL,128,,,21,14,18,10
Max Strus,F,22023,1629622,22300251,"NOV 26, 2023",CLE vs. TOR,W,37,8,16,0.5,4,9,0.444,0,0,0.0,1,10,11,5,0,1,2,4,20,-4,1,CLE,CLE,TOR,105,,,36,31,25,16
Max Strus,F,22023,1629622,22300242,"NOV 25, 2023",CLE vs. LAL,L,34,5,11,0.455,3,7,0.429,0,0,0.0,0,4,4,2,1,0,3,2,13,-19,1,CLE,CLE,LAL,115,,,19,17,15,6
Max Strus,F,22023,1629622,22300229,"NOV 22, 2023",CLE vs. MIA,L,25,2,6,0.333,2,4,0.5,0,0,0.0,0,3,3,3,0,1,2,0,6,-11,1,CLE,CLE,MIA,96,,,12,9,9,6
Max Strus,F,22023,1629622,22300040,"NOV 21, 2023",CLE @ PHI,W,44,7,15,0.467,5,10,0.5,1,2,0.5,2,3,5,6,2,1,2,5,20,-4,1,CLE,PHI,CLE,122,,,31,25,26,11
Max Strus,F,22023,1629622,22300210,"NOV 19, 2023",CLE vs. DEN,W,32,3,7,0.429,2,6,0.333,3,4,0.75,1,5,6,5,0,1,3,3,11,14,1,CLE,CLE,DEN,121,,,22,17,16,11
Max Strus,F,22023,1629622,22300030,"NOV 17, 2023",CLE vs. DET,W,39,7,15,0.467,4,8,0.5,0,0,0.0,1,6,7,3,4,1,2,1,18,9,1,CLE,CLE,DET,108,,,28,25,21,10
Max Strus,F,22023,1629622,22300199,"NOV 15, 2023",CLE @ POR,W,37,5,12,0.417,1,7,0.143,3,3,1.0,1,2,3,7,1,0,5,3,14,25,1,CLE,POR,CLE,109,,,24,17,21,10
Max Strus,F,22023,1629622,22300191,"NOV 13, 2023",CLE @ SAC,L,34,7,12,0.583,5,9,0.556,0,0,0.0,2,3,5,4,1,0,1,3,19,10,1,CLE,SAC,CLE,120,,,28,24,23,9
Max Strus,F,22023,1629622,22300176,"NOV 11, 2023",CLE @ GSW,W,33,6,9,0.667,2,3,0.667,2,2,1.0,1,7,8,4,1,0,0,2,16,6,1,CLE,GSW,CLE,118,,,28,24,20,12
Max Strus,F,22023,1629622,22300167,"NOV 08, 2023",CLE @ OKC,L,32,4,7,0.571,4,6,0.667,0,0,0.0,2,5,7,3,0,1,0,2,12,-5,1,CLE,OKC,CLE,120,,,22,19,15,10
Max Strus,F,22023,1629622,22300142,"NOV 05, 2023",CLE vs. GSW,W,36,6,13,0.462,3,10,0.3,0,0,0.0,0,4,4,4,1,0,0,3,15,4,1,CLE,CLE,GSW,115,,,23,19,19,8
Max Strus,F,22023,1629622,22300001,"NOV 03, 2023",CLE @ IND,L,28,4,9,0.444,1,6,0.167,1,2,0.5,0,1,1,0,1,1,1,2,10,3,1,CLE,IND,CLE,116,,,11,11,10,1
Max Strus,F,22023,1629622,22300112,"OCT 31, 2023",CLE vs. NYK,L,33,2,9,0.222,1,7,0.143,1,2,0.5,0,3,3,3,0,0,0,2,6,-12,1,CLE,CLE,NYK,91,,,12,9,9,6
Max Strus,F,22023,1629622,22300091,"OCT 28, 2023",CLE vs. IND,L,42,7,20,0.35,4,9,0.444,3,3,1.0,1,10,11,6,0,0,1,2,21,-5,1,CLE,CLE,IND,113,,,38,32,27,17
Max Strus,F,22023,1629622,22300067,"OCT 25, 2023",CLE @ BKN,W,39,9,17,0.529,7,13,0.538,2,2,1.0,0,12,12,2,1,1,0,4,27,13,1,CLE,BKN,CLE,114,,,41,39,29,14
Max Strus,F,22023,1629622,22300081,"OCT 27, 2023",CLE vs. OKC,L,38,3,14,0.214,2,11,0.182,0,0,0.0,0,5,5,4,2,1,2,1,8,8,1,CLE,CLE,OKC,105,,,17,13,12,9
Max Strus,F,22023,1629622,22300120,"NOV 01, 2023",CLE @ NYK,W,35,3,9,0.333,0,5,0.0,3,3,1.0,0,4,4,4,0,2,5,3,9,3,1,CLE,NYK,CLE,95,,,17,13,13,8
Cole Anthony,G,22023,1630175,22300752,"FEB 10, 2024",ORL vs. CHI,W,30,5,11,0.455,1,5,0.2,3,4,0.75,2,9,11,3,0,0,3,2,14,16,1,ORL,ORL,CHI,114,,,28,25,17,14
Cole Anthony,G,22023,1630175,22300734,"FEB 08, 2024",ORL vs. SAS,W,19,5,7,0.714,2,2,1.0,0,0,0.0,1,1,2,2,1,0,3,5,12,-2,1,ORL,ORL,SAS,127,,,16,14,14,4
Cole Anthony,G,22023,1630175,22300721,"FEB 06, 2024",ORL @ MIA,L,14,2,3,0.667,0,1,0.0,0,0,0.0,0,3,3,0,1,0,2,1,4,-1,1,ORL,MIA,ORL,95,,,7,7,4,3
Cole Anthony,G,22023,1630175,22300704,"FEB 04, 2024",ORL @ DET,W,11,0,3,0.0,0,0,0.0,1,2,0.5,0,1,1,0,1,0,1,1,1,-1,1,ORL,DET,ORL,111,,,2,2,1,1
Cole Anthony,G,22023,1630175,22300694,"FEB 02, 2024",ORL @ MIN,W,12,1,3,0.333,0,0,0.0,2,2,1.0,0,3,3,2,2,0,2,0,4,2,1,ORL,MIN,ORL,108,,,9,7,6,5
Cole Anthony,G,22023,1630175,22300681,"JAN 31, 2024",ORL @ SAS,W,16,3,7,0.429,1,3,0.333,4,4,1.0,0,3,3,2,0,0,1,1,11,3,1,ORL,SAS,ORL,108,,,16,14,13,5
Cole Anthony,G,22023,1630175,22300666,"JAN 29, 2024",ORL @ DAL,L,27,2,4,0.5,0,1,0.0,7,7,1.0,0,2,2,9,0,0,2,4,11,2,1,ORL,DAL,ORL,129,,,22,13,20,11
Cole Anthony,G,22023,1630175,22300655,"JAN 28, 2024",ORL vs. PHX,W,10,2,5,0.4,1,2,0.5,0,0,0.0,0,1,1,1,2,0,0,3,5,3,1,ORL,ORL,PHX,113,,,7,6,6,2
Cole Anthony,G,22023,1630175,22300638,"JAN 26, 2024",ORL @ MEM,L,23,2,8,0.25,0,4,0.0,1,2,0.5,0,7,7,4,2,0,0,0,5,10,1,ORL,MEM,ORL,106,,,16,12,9,11
Cole Anthony,G,22023,1630175,22300607,"JAN 22, 2024",ORL vs. CLE,L,13,2,4,0.5,1,1,1.0,0,0,0.0,0,2,2,2,0,0,2,1,5,-9,1,ORL,ORL,CLE,99,,,9,7,7,4
Cole Anthony,G,22023,1630175,22300601,"JAN 21, 2024",ORL vs. MIA,W,16,2,6,0.333,1,2,0.5,0,0,0.0,0,6,6,2,1,1,3,0,5,12,1,ORL,ORL,MIA,105,,,13,11,7,8
Cole Anthony,G,22023,1630175,22300585,"JAN 19, 2024",ORL vs. PHI,L,21,0,5,0.0,0,1,0.0,3,3,1.0,0,1,1,3,0,0,4,3,3,-12,1,ORL,ORL,PHI,109,,,7,4,6,4
Cole Anthony,G,22023,1630175,22300570,"JAN 17, 2024",ORL @ ATL,L,22,3,10,0.3,1,6,0.167,3,4,0.75,0,1,1,1,1,3,1,1,10,2,1,ORL,ATL,ORL,104,,,12,11,11,2
Cole Anthony,G,22023,1630175,22300557,"JAN 15, 2024",ORL @ NYK,W,26,6,12,0.5,0,3,0.0,3,4,0.75,2,2,4,5,2,0,2,2,15,18,1,ORL,NYK,ORL,98,,,24,19,20,9
Cole Anthony,G,22023,1630175,22300546,"JAN 13, 2024",ORL @ OKC,L,25,6,11,0.545,1,3,0.333,1,2,0.5,2,2,4,2,1,1,2,4,14,-6,1,ORL,OKC,ORL,100,,,20,18,16,6
Cole Anthony,G,22023,1630175,22300535,"JAN 12, 2024",ORL @ MIA,L,27,2,8,0.25,0,2,0.0,1,2,0.5,1,2,3,0,2,1,0,1,5,2,1,ORL,MIA,ORL,96,,,8,8,5,3
Cole Anthony,G,22023,1630175,22300513,"JAN 09, 2024",ORL vs. MIN,L,7,1,4,0.25,0,1,0.0,0,0,0.0,1,0,1,0,0,0,0,2,2,2,1,ORL,ORL,MIN,92,,,3,3,2,1
Cole Anthony,G,22023,1630175,22300499,"JAN 07, 2024",ORL vs. ATL,W,31,3,13,0.231,0,3,0.0,4,4,1.0,0,9,9,5,0,0,4,5,10,-17,1,ORL,ORL,ATL,117,,,24,19,15,14
Cole Anthony,G,22023,1630175,22300488,"JAN 05, 2024",ORL @ DEN,W,31,8,15,0.533,3,8,0.375,4,4,1.0,0,2,2,4,1,0,3,2,23,2,1,ORL,DEN,ORL,122,,,29,25,27,6
Cole Anthony,G,22023,1630175,22300463,"JAN 02, 2024",ORL @ GSW,L,26,3,8,0.375,1,2,0.5,1,1,1.0,3,1,4,2,0,1,2,4,8,-4,1,ORL,GSW,ORL,115,,,14,12,10,6
Cole Anthony,G,22023,1630175,22300450,"DEC 31, 2023",ORL @ PHX,L,18,4,7,0.571,2,4,0.5,3,3,1.0,1,4,5,0,1,0,2,0,13,8,1,ORL,PHX,ORL,107,,,18,18,13,5
Cole Anthony,G,22023,1630175,22300429,"DEC 29, 2023",ORL vs. NYK,W,23,3,8,0.375,0,3,0.0,3,4,0.75,0,2,2,5,2,0,1,2,9,6,1,ORL,ORL,NYK,117,,,16,11,14,7
Cole Anthony,G,22023,1630175,22300415,"DEC 27, 2023",ORL vs. PHI,L,23,2,7,0.286,1,4,0.25,0,1,0.0,2,4,6,1,0,1,4,1,5,-14,1,ORL,ORL,PHI,92,,,12,11,6,7
Cole Anthony,G,22023,1630175,22300407,"DEC 26, 2023",ORL @ WAS,W,23,4,11,0.364,1,3,0.333,2,2,1.0,0,3,3,4,1,0,1,2,11,5,1,ORL,WAS,ORL,127,,,18,14,15,7
Cole Anthony,G,22023,1630175,22300391,"DEC 23, 2023",ORL @ IND,W,24,4,11,0.364,2,6,0.333,2,4,0.5,1,5,6,3,1,0,0,3,12,7,1,ORL,IND,ORL,117,,,21,18,15,9
Cole Anthony,G,22023,1630175,22300378,"DEC 21, 2023",ORL @ MIL,L,33,7,17,0.412,1,6,0.167,3,3,1.0,4,7,11,6,2,0,0,2,18,16,1,ORL,MIL,ORL,114,,,35,29,24,17
Cole Anthony,G,22023,1630175,22300366,"DEC 20, 2023",ORL vs. MIA,L,25,8,13,0.615,2,5,0.4,2,2,1.0,1,3,4,3,1,1,3,4,20,-6,1,ORL,ORL,MIA,106,,,27,24,23,7
Cole Anthony,G,22023,1630175,22300344,"DEC 17, 2023",ORL @ BOS,L,19,2,8,0.25,0,2,0.0,2,2,1.0,1,0,1,4,0,0,1,0,6,-14,1,ORL,BOS,ORL,97,,,11,7,10,5
Cole Anthony,G,22023,1630175,22300329,"DEC 15, 2023",ORL @ BOS,L,20,5,8,0.625,2,3,0.667,5,6,0.833,0,0,0,4,1,0,1,3,17,-12,1,ORL,BOS,ORL,111,,,21,17,21,4
Cole Anthony,G,22023,1630175,22300294,"DEC 11, 2023",ORL vs. CLE,W,18,3,6,0.5,1,1,1.0,1,2,0.5,1,1,2,4,0,0,0,3,8,-2,1,ORL,ORL,CLE,104,,,14,10,12,6
Cole Anthony,G,22023,1630175,22301217,"DEC 08, 2023",ORL vs. DET,W,24,6,12,0.5,1,3,0.333,3,3,1.0,0,3,3,6,0,0,1,4,16,23,1,ORL,ORL,DET,123,,,25,19,22,9
Cole Anthony,G,22023,1630175,22301205,"DEC 06, 2023",ORL @ CLE,L,32,8,14,0.571,1,4,0.25,2,3,0.667,1,6,7,2,1,2,2,3,19,-5,1,ORL,CLE,ORL,111,,,28,26,21,9
Cole Anthony,G,22023,1630175,22300282,"DEC 02, 2023",ORL @ BKN,L,31,8,17,0.471,2,6,0.333,2,2,1.0,1,5,6,1,0,1,1,3,20,-32,1,ORL,BKN,ORL,101,,,27,26,21,7
Cole Anthony,G,22023,1630175,22300274,"DEC 01, 2023",ORL vs. WAS,W,17,1,3,0.333,0,0,0.0,2,2,1.0,0,1,1,2,2,1,1,5,4,-4,1,ORL,ORL,WAS,130,,,7,5,6,3
Cole Anthony,G,22023,1630175,22300259,"NOV 29, 2023",ORL vs. WAS,W,26,9,16,0.563,3,5,0.6,4,5,0.8,3,3,6,5,0,2,1,4,25,14,1,ORL,ORL,WAS,139,,,36,31,30,11
Cole Anthony,G,22023,1630175,22300248,"NOV 26, 2023",ORL vs. CHA,W,32,9,16,0.563,1,3,0.333,11,12,0.917,1,6,7,7,2,1,2,3,30,15,1,ORL,ORL,CHA,130,,,44,37,37,14
Cole Anthony,G,22023,1630175,22300043,"NOV 24, 2023",ORL vs. BOS,W,29,6,17,0.353,2,4,0.5,2,4,0.5,1,2,3,6,2,1,3,4,16,17,1,ORL,ORL,BOS,113,,,25,19,22,9
Cole Anthony,G,22023,1630175,22300226,"NOV 22, 2023",ORL vs. DEN,W,29,6,11,0.545,1,4,0.25,7,8,0.875,3,2,5,0,0,0,0,3,20,2,1,ORL,ORL,DEN,124,,,25,25,20,5
Cole Anthony,G,22023,1630175,22300038,"NOV 21, 2023",ORL vs. TOR,W,29,5,10,0.5,2,4,0.5,3,3,1.0,2,3,5,10,0,0,2,3,15,8,1,ORL,ORL,TOR,126,,,30,20,25,15
Cole Anthony,G,22023,1630175,22300209,"NOV 19, 2023",ORL @ IND,W,25,5,12,0.417,1,3,0.333,4,4,1.0,0,5,5,3,0,1,4,4,15,11,1,ORL,IND,ORL,128,,,23,20,18,8
Cole Anthony,G,22023,1630175,22300033,"NOV 17, 2023",ORL @ CHI,W,37,3,12,0.25,1,5,0.2,4,4,1.0,2,6,8,7,1,0,2,4,11,7,1,ORL,CHI,ORL,103,,,26,19,18,15
Cole Anthony,G,22023,1630175,22300196,"NOV 15, 2023",ORL @ CHI,W,22,6,11,0.545,2,3,0.667,2,2,1.0,1,4,5,3,1,0,3,5,16,4,1,ORL,CHI,ORL,96,,,24,21,19,8
Cole Anthony,G,22023,1630175,22300020,"NOV 14, 2023",ORL @ BKN,L,28,2,10,0.2,2,8,0.25,4,4,1.0,3,3,6,2,0,0,4,0,10,1,1,ORL,BKN,ORL,104,,,18,16,12,8
Cole Anthony,G,22023,1630175,22300173,"NOV 11, 2023",ORL vs. MIL,W,14,0,3,0.0,0,1,0.0,4,4,1.0,0,2,2,3,1,0,3,2,4,14,1,ORL,ORL,MIL,112,,,9,6,7,5
Cole Anthony,G,22023,1630175,22300172,"NOV 09, 2023",ORL vs. ATL,L,23,1,7,0.143,0,4,0.0,5,6,0.833,1,1,2,2,0,0,3,3,7,-3,1,ORL,ORL,ATL,119,,,11,9,9,4
Cole Anthony,G,22023,1630175,22300147,"NOV 06, 2023",ORL vs. DAL,L,30,7,13,0.538,2,5,0.4,3,5,0.6,0,2,2,5,1,2,3,3,19,-14,1,ORL,ORL,DAL,102,,,26,21,24,7
Cole Anthony,G,22023,1630175,22300134,"NOV 04, 2023",ORL vs. LAL,W,23,4,9,0.444,3,5,0.6,3,3,1.0,3,2,5,1,0,0,3,1,14,-6,1,ORL,ORL,LAL,120,,,20,19,15,6
Cole Anthony,G,22023,1630175,22300130,"NOV 02, 2023",ORL @ UTA,W,31,5,10,0.5,2,4,0.5,6,6,1.0,0,7,7,7,2,0,3,3,18,-7,1,ORL,UTA,ORL,115,,,32,25,25,14
Cole Anthony,G,22023,1630175,22300114,"OCT 31, 2023",ORL @ LAC,L,18,3,6,0.5,0,2,0.0,4,6,0.667,0,2,2,1,0,0,1,3,10,-18,1,ORL,LAC,ORL,102,,,13,12,11,3
Cole Anthony,G,22023,1630175,22300111,"OCT 30, 2023",ORL @ LAL,L,21,4,12,0.333,1,3,0.333,3,4,0.75,0,3,3,2,3,0,1,2,12,-9,1,ORL,LAL,ORL,103,,,17,15,14,5
Cole Anthony,G,22023,1630175,22300086,"OCT 27, 2023",ORL @ POR,W,28,6,15,0.4,3,7,0.429,3,6,0.5,1,3,4,2,0,1,1,3,18,-9,1,ORL,POR,ORL,102,,,24,22,20,6
Cole Anthony,G,22023,1630175,22300066,"OCT 25, 2023",ORL vs. HOU,W,24,8,12,0.667,1,2,0.5,3,3,1.0,1,7,8,2,0,0,0,2,20,17,1,ORL,ORL,HOU,116,,,30,28,22,10
Alec Burks,G,22023,202692,22300755,"FEB 10, 2024",NYK vs. IND,L,22,7,14,0.5,4,7,0.571,4,4,1.0,0,2,2,1,0,0,3,1,22,-4,1,NYK,NYK,IND,111,,,25,24,23,3
Alec Burks,G,22023,202692,22300534,"JAN 12, 2024",DET vs. HOU,L,30,7,14,0.5,5,9,0.556,0,0,0.0,0,0,0,1,0,2,2,3,19,-11,1,DET,DET,HOU,110,,,20,19,20,1
Alec Burks,G,22023,202692,22300453,"JAN 01, 2024",DET @ HOU,L,23,6,11,0.545,3,6,0.5,6,6,1.0,0,2,2,2,1,1,2,2,21,-10,1,DET,HOU,DET,113,,,25,23,23,4
Alec Burks,G,22023,202692,22300394,"DEC 23, 2023",DET @ BKN,L,16,2,8,0.25,1,5,0.2,0,0,0.0,0,1,1,2,1,0,1,2,5,-20,1,DET,BKN,DET,115,,,8,6,7,3
Alec Burks,G,22023,202692,22300374,"DEC 21, 2023",DET vs. UTA,L,9,1,4,0.25,0,3,0.0,3,3,1.0,0,1,1,0,0,1,0,1,5,-9,1,DET,DET,UTA,111,,,6,6,5,1
Alec Burks,G,22023,202692,22300352,"DEC 18, 2023",DET @ ATL,L,23,2,11,0.182,0,2,0.0,2,2,1.0,1,1,2,2,1,0,0,3,6,-5,1,DET,ATL,DET,124,,,10,8,8,4
Alec Burks,G,22023,202692,22300334,"DEC 16, 2023",DET @ MIL,L,4,0,2,0.0,0,2,0.0,1,2,0.5,0,1,1,0,0,0,0,0,1,-11,1,DET,MIL,DET,114,,,2,2,1,1
Alec Burks,G,22023,202692,22301217,"DEC 08, 2023",DET @ ORL,L,13,4,7,0.571,2,3,0.667,4,4,1.0,1,2,3,0,0,0,1,1,14,-3,1,DET,ORL,DET,91,,,17,17,14,3
Alec Burks,G,22023,202692,22300268,"NOV 30, 2023",DET @ NYK,L,11,0,3,0.0,0,3,0.0,1,1,1.0,0,0,0,1,0,0,0,0,1,3,1,DET,NYK,DET,112,,,2,1,2,1
Alec Burks,G,22023,202692,22300258,"NOV 29, 2023",DET vs. LAL,L,10,2,7,0.286,1,3,0.333,1,1,1.0,1,0,1,0,0,0,0,1,6,-8,1,DET,DET,LAL,107,,,7,7,6,1
Alec Burks,G,22023,202692,22300047,"NOV 24, 2023",DET @ IND,L,14,2,6,0.333,2,3,0.667,0,0,0.0,0,2,2,1,1,1,2,1,6,-8,1,DET,IND,DET,113,,,9,8,7,3
Alec Burks,G,22023,202692,22300218,"NOV 20, 2023",DET vs. DEN,L,17,1,5,0.2,0,4,0.0,1,2,0.5,0,3,3,2,1,0,1,1,3,-13,1,DET,DET,DEN,103,,,8,6,5,5
Alec Burks,G,22023,202692,22300211,"NOV 19, 2023",DET @ TOR,L,22,3,9,0.333,1,3,0.333,7,8,0.875,1,3,4,1,0,0,1,3,14,-29,1,DET,TOR,DET,113,,,19,18,15,5
Alec Burks,G,22023,202692,22300030,"NOV 17, 2023",DET @ CLE,L,24,4,14,0.286,2,9,0.222,0,0,0.0,2,1,3,1,1,0,0,3,10,-15,1,DET,CLE,DET,100,,,14,13,11,4
Alec Burks,G,22023,202692,22300018,"NOV 14, 2023",DET vs. ATL,L,23,4,12,0.333,4,9,0.444,4,4,1.0,1,1,2,5,1,0,1,3,16,-16,1,DET,DET,ATL,120,,,23,18,21,7
Alec Burks,G,22023,202692,22300181,"NOV 12, 2023",DET @ CHI,L,21,3,7,0.429,2,6,0.333,8,9,0.889,1,2,3,4,0,0,0,2,16,6,1,DET,CHI,DET,108,,,23,19,20,7
Alec Burks,G,22023,202692,22300109,"OCT 30, 2023",DET @ OKC,L,21,4,9,0.444,3,4,0.75,0,0,0.0,1,1,2,7,0,0,0,3,11,-9,1,DET,OKC,DET,112,,,20,13,18,9
Alec Burks,G,22023,202692,22300088,"OCT 28, 2023",DET vs. CHI,W,26,6,12,0.5,6,10,0.6,0,1,0.0,0,2,2,0,0,1,0,1,18,19,1,DET,DET,CHI,118,,,20,20,18,2
Alec Burks,G,22023,202692,22300077,"OCT 27, 2023",DET @ CHA,W,31,5,10,0.5,3,7,0.429,11,12,0.917,0,4,4,2,1,1,0,1,24,28,1,DET,CHA,DET,111,,,30,28,26,6
Alec Burks,G,22023,202692,22300068,"OCT 25, 2023",DET @ MIA,L,25,2,8,0.25,2,5,0.4,1,2,0.5,0,5,5,0,0,1,0,1,7,9,1,DET,MIA,DET,102,,,12,12,7,5
Alec Burks,G,22023,202692,22300704,"FEB 04, 2024",DET vs. ORL,L,20,3,7,0.429,1,3,0.333,3,3,1.0,0,3,3,1,1,0,1,0,10,-2,1,DET,DET,ORL,99,,,14,13,11,4
Alec Burks,G,22023,202692,22300688,"FEB 02, 2024",DET vs. LAC,L,21,2,10,0.2,1,7,0.143,1,1,1.0,1,1,2,1,1,1,1,0,6,-13,1,DET,DET,LAC,125,,,9,8,7,3
Alec Burks,G,22023,202692,22300675,"JAN 31, 2024",DET @ CLE,L,30,3,5,0.6,1,3,0.333,4,4,1.0,0,4,4,6,0,1,2,2,11,2,1,DET,CLE,DET,121,,,21,15,17,10
Alec Burks,G,22023,202692,22300654,"JAN 28, 2024",DET vs. OKC,W,26,3,5,0.6,2,3,0.667,2,2,1.0,0,6,6,2,3,0,3,1,10,18,1,DET,DET,OKC,120,,,18,16,12,8
Alec Burks,G,22023,202692,22300642,"JAN 27, 2024",DET vs. WAS,L,18,2,9,0.222,1,5,0.2,3,4,0.75,0,4,4,0,0,0,0,1,8,-11,1,DET,DET,WAS,104,,,12,12,8,4
Alec Burks,G,22023,202692,22300619,"JAN 24, 2024",DET vs. CHA,W,26,4,11,0.364,4,9,0.444,3,4,0.75,0,0,0,1,0,0,0,1,15,5,1,DET,DET,CHA,113,,,16,15,16,1
Alec Burks,G,22023,202692,22300606,"JAN 22, 2024",DET vs. MIL,L,28,3,12,0.25,3,9,0.333,0,0,0.0,0,2,2,3,0,0,1,4,9,0,1,DET,DET,MIL,113,,,14,11,12,5
Alec Burks,G,22023,202692,22300592,"JAN 20, 2024",DET vs. MIL,L,30,9,20,0.45,7,14,0.5,8,8,1.0,0,7,7,6,1,0,0,2,33,24,1,DET,DET,MIL,135,,,46,40,39,13
Alec Burks,G,22023,202692,22300569,"JAN 17, 2024",DET vs. MIN,L,20,3,10,0.3,1,4,0.25,5,5,1.0,1,0,1,1,2,0,0,1,12,-10,1,DET,DET,MIN,117,,,14,13,13,2
Alec Burks,G,22023,202692,22300519,"JAN 10, 2024",DET vs. SAS,L,20,5,13,0.385,1,5,0.2,4,4,1.0,0,2,2,2,0,0,1,1,15,-15,1,DET,DET,SAS,108,,,19,17,17,4
Alec Burks,G,22023,202692,22300512,"JAN 09, 2024",DET vs. SAC,L,20,5,11,0.455,3,7,0.429,3,5,0.6,0,3,3,1,1,0,2,0,16,-15,1,DET,DET,SAC,110,,,20,19,17,4
Alec Burks,G,22023,202692,22300502,"JAN 07, 2024",DET @ DEN,L,20,6,9,0.667,3,3,1.0,3,3,1.0,1,3,4,1,0,0,1,1,18,-16,1,DET,DEN,DET,114,,,23,22,19,5
Alec Burks,G,22023,202692,22300490,"JAN 05, 2024",DET @ GSW,L,21,5,14,0.357,3,10,0.3,0,0,0.0,1,3,4,2,0,1,2,2,13,9,1,DET,GSW,DET,109,,,19,17,15,6
Alec Burks,G,22023,202692,22300474,"JAN 03, 2024",DET @ UTA,L,34,9,17,0.529,5,9,0.556,4,5,0.8,0,4,4,1,0,0,2,4,27,-12,1,DET,UTA,DET,148,,,32,31,28,5
Alec Burks,G,22023,202692,22300440,"DEC 30, 2023",DET vs. TOR,W,19,4,6,0.667,3,3,1.0,5,5,1.0,0,0,0,1,0,0,0,0,16,6,1,DET,DET,TOR,129,,,17,16,17,1
Alec Burks,G,22023,202692,22300421,"DEC 28, 2023",DET @ BOS,L,30,4,13,0.308,4,12,0.333,0,0,0.0,1,1,2,1,2,0,0,2,12,-15,1,DET,BOS,DET,122,,,15,14,13,3
Alec Burks,G,22023,202692,22300406,"DEC 26, 2023",DET vs. BKN,L,26,4,11,0.364,2,6,0.333,5,6,0.833,1,4,5,0,0,0,2,1,15,-25,1,DET,DET,BKN,112,,,20,20,15,5
Alec Burks,G,22023,202692,22300327,"DEC 15, 2023",DET @ PHI,L,17,2,8,0.25,0,4,0.0,0,0,0.0,0,2,2,0,0,0,0,1,4,-17,1,DET,PHI,DET,92,,,6,6,4,2
Alec Burks,G,22023,202692,22300310,"DEC 13, 2023",DET vs. PHI,L,13,1,7,0.143,1,3,0.333,0,0,0.0,1,2,3,0,1,0,0,1,3,-8,1,DET,DET,PHI,111,,,6,6,3,3
Alec Burks,G,22023,202692,22300293,"DEC 11, 2023",DET vs. IND,L,13,4,6,0.667,2,3,0.667,4,4,1.0,0,0,0,0,1,0,1,0,14,-2,1,DET,DET,IND,123,,,14,14,14,0
Alec Burks,G,22023,202692,22301206,"DEC 06, 2023",DET vs. MEM,L,17,1,6,0.167,1,5,0.2,0,0,0.0,0,2,2,2,0,0,1,1,3,-5,1,DET,DET,MEM,102,,,7,5,5,4
Alec Burks,G,22023,202692,22300732,"FEB 07, 2024",DET @ SAC,W,28,7,12,0.583,5,7,0.714,6,6,1.0,0,7,7,2,0,0,0,3,25,12,1,DET,SAC,DET,133,,,34,32,27,9
Alec Burks,G,22023,202692,22300558,"JAN 15, 2024",DET @ WAS,W,29,11,17,0.647,8,12,0.667,4,4,1.0,0,2,2,2,0,0,1,2,34,18,1,DET,WAS,DET,129,,,38,36,36,4
Alec Burks,G,22023,202692,22300253,"NOV 27, 2023",DET vs. WAS,L,13,2,8,0.25,0,5,0.0,4,4,1.0,0,0,0,1,0,0,0,1,8,-12,1,DET,DET,WAS,107,,,9,8,9,1
Andrew Wiggins,F,22023,203952,22300757,"FEB 10, 2024",GSW vs. PHX,W,28,5,13,0.385,1,4,0.25,1,2,0.5,1,4,5,3,2,0,0,3,12,2,1,GSW,GSW,PHX,113,,,20,17,15,8
Andrew Wiggins,F,22023,203952,22300733,"FEB 08, 2024",GSW @ IND,W,26,5,10,0.5,1,3,0.333,0,0,0.0,0,4,4,5,1,0,0,3,11,9,1,GSW,IND,GSW,131,,,20,15,16,9
Andrew Wiggins,F,22023,203952,22300727,"FEB 07, 2024",GSW @ PHI,W,23,9,14,0.643,2,3,0.667,1,2,0.5,4,6,10,1,1,1,0,1,21,17,1,GSW,PHI,GSW,127,,,32,31,22,11
Andrew Wiggins,F,22023,203952,22300699,"FEB 03, 2024",GSW @ ATL,L,19,1,6,0.167,0,2,0.0,0,0,0.0,0,4,4,0,0,2,0,1,2,2,1,GSW,ATL,GSW,134,,,6,6,2,4
Andrew Wiggins,F,22023,203952,22300693,"FEB 02, 2024",GSW @ MEM,W,30,3,8,0.375,1,2,0.5,2,2,1.0,0,2,2,0,1,2,0,0,9,9,1,GSW,MEM,GSW,121,,,11,11,9,2
Andrew Wiggins,F,22023,203952,22300673,"JAN 30, 2024",GSW vs. PHI,W,38,8,10,0.8,1,2,0.5,6,6,1.0,0,5,5,4,3,1,1,2,23,18,1,GSW,GSW,PHI,119,,,32,28,27,9
Andrew Wiggins,F,22023,203952,22300650,"JAN 27, 2024",GSW vs. LAL,L,41,8,12,0.667,3,4,0.75,3,5,0.6,1,4,5,3,2,1,2,6,22,1,1,GSW,GSW,LAL,144,,,30,27,25,8
Andrew Wiggins,F,22023,203952,22300632,"JAN 25, 2024",GSW vs. SAC,L,31,6,8,0.75,2,3,0.667,3,4,0.75,0,4,4,4,0,0,2,2,17,-4,1,GSW,GSW,SAC,133,,,25,21,21,8
Andrew Wiggins,F,22023,203952,22300626,"JAN 24, 2024",GSW vs. ATL,W,29,4,11,0.364,0,4,0.0,4,4,1.0,2,3,5,1,0,2,0,4,12,11,1,GSW,GSW,ATL,134,,,18,17,13,6
Andrew Wiggins,F,22023,203952,22300560,"JAN 15, 2024",GSW @ MEM,L,31,7,13,0.538,1,3,0.333,1,2,0.5,1,4,5,1,0,2,1,1,16,9,1,GSW,MEM,GSW,107,,,22,21,17,6
Andrew Wiggins,F,22023,203952,22300536,"JAN 12, 2024",GSW @ CHI,W,31,8,13,0.615,1,5,0.2,0,0,0.0,3,2,5,8,1,1,0,2,17,4,1,GSW,CHI,GSW,140,,,30,22,25,13
Andrew Wiggins,F,22023,203952,22300525,"JAN 10, 2024",GSW vs. NOP,L,23,2,8,0.25,1,3,0.333,0,0,0.0,0,2,2,2,0,0,1,2,5,-29,1,GSW,GSW,NOP,105,,,9,7,7,4
Andrew Wiggins,F,22023,203952,22300504,"JAN 07, 2024",GSW vs. TOR,L,17,1,6,0.167,0,2,0.0,1,2,0.5,0,2,2,1,0,0,1,0,3,-29,1,GSW,GSW,TOR,118,,,6,5,4,3
Andrew Wiggins,F,22023,203952,22300490,"JAN 05, 2024",GSW vs. DET,W,19,1,5,0.2,1,2,0.5,0,0,0.0,1,1,2,2,0,0,1,2,3,-5,1,GSW,GSW,DET,113,,,7,5,5,4
Andrew Wiggins,F,22023,203952,22300478,"JAN 04, 2024",GSW vs. DEN,L,27,5,10,0.5,1,4,0.25,0,0,0.0,2,1,3,0,0,1,1,2,11,-14,1,GSW,GSW,DEN,127,,,14,14,11,3
Andrew Wiggins,F,22023,203952,22300463,"JAN 02, 2024",GSW vs. ORL,W,21,4,7,0.571,1,3,0.333,1,3,0.333,0,3,3,0,2,0,1,1,10,-3,1,GSW,GSW,ORL,121,,,13,13,10,3
Andrew Wiggins,F,22023,203952,22300444,"DEC 30, 2023",GSW vs. DAL,L,28,5,13,0.385,1,3,0.333,3,3,1.0,3,2,5,4,1,1,0,2,14,-1,1,GSW,GSW,DAL,122,,,23,19,18,9
Andrew Wiggins,F,22023,203952,22300426,"DEC 28, 2023",GSW vs. MIA,L,26,4,11,0.364,0,3,0.0,3,4,0.75,1,1,2,4,0,0,1,2,11,5,1,GSW,GSW,MIA,102,,,17,13,15,6
Andrew Wiggins,F,22023,203952,22300402,"DEC 25, 2023",GSW @ DEN,L,29,7,11,0.636,2,4,0.5,6,6,1.0,1,2,3,2,0,1,2,5,22,18,1,GSW,DEN,GSW,114,,,27,25,24,5
Andrew Wiggins,F,22023,203952,22300362,"DEC 19, 2023",GSW vs. BOS,W,22,2,11,0.182,0,1,0.0,2,2,1.0,5,2,7,1,0,0,0,1,6,-10,1,GSW,GSW,BOS,132,,,14,13,7,8
Andrew Wiggins,F,22023,203952,22300348,"DEC 17, 2023",GSW @ POR,W,29,9,12,0.75,4,6,0.667,3,4,0.75,0,7,7,2,1,1,0,2,25,-3,1,GSW,POR,GSW,118,,,34,32,27,9
Andrew Wiggins,F,22023,203952,22300339,"DEC 16, 2023",GSW vs. BKN,W,27,4,9,0.444,1,1,1.0,5,5,1.0,2,3,5,1,1,0,0,0,14,0,1,GSW,GSW,BKN,124,,,20,19,15,6
Andrew Wiggins,F,22023,203952,22300325,"DEC 14, 2023",GSW @ LAC,L,22,4,9,0.444,0,4,0.0,1,2,0.5,2,1,3,0,0,1,0,5,9,-7,1,GSW,LAC,GSW,113,,,12,12,9,3
Andrew Wiggins,F,22023,203952,22300308,"DEC 12, 2023",GSW @ PHX,L,15,1,7,0.143,1,3,0.333,0,0,0.0,2,2,4,1,0,0,3,1,3,-19,1,GSW,PHX,GSW,116,,,8,7,4,5
Andrew Wiggins,F,22023,203952,22301222,"DEC 08, 2023",GSW @ OKC,L,32,4,11,0.364,2,4,0.5,2,2,1.0,2,4,6,1,0,0,6,3,12,-1,1,GSW,OKC,GSW,136,,,19,18,13,7
Andrew Wiggins,F,22023,203952,22301214,"DEC 06, 2023",GSW vs. POR,W,27,3,12,0.25,0,1,0.0,3,3,1.0,1,2,3,1,0,0,1,1,9,6,1,GSW,GSW,POR,110,,,13,12,10,4
Andrew Wiggins,F,22023,203952,22300060,"NOV 28, 2023",GSW @ SAC,L,36,11,18,0.611,2,5,0.4,5,6,0.833,2,8,10,3,0,0,3,5,29,-1,1,GSW,SAC,GSW,123,,,42,39,32,13
Andrew Wiggins,F,22023,203952,22300051,"NOV 24, 2023",GSW vs. SAS,W,25,4,10,0.4,2,4,0.5,0,0,0.0,0,4,4,0,0,0,3,3,10,-1,1,GSW,GSW,SAS,118,,,14,14,10,4
Andrew Wiggins,F,22023,203952,22300236,"NOV 22, 2023",GSW @ PHX,L,25,4,11,0.364,0,3,0.0,3,4,0.75,2,2,4,1,0,1,2,1,11,-14,1,GSW,PHX,GSW,115,,,16,15,12,5
Andrew Wiggins,F,22023,203952,22300224,"NOV 20, 2023",GSW vs. HOU,W,30,3,10,0.3,2,3,0.667,4,4,1.0,4,3,7,1,0,0,0,2,12,-3,1,GSW,GSW,HOU,121,,,20,19,13,8
Andrew Wiggins,F,22023,203952,22300207,"NOV 18, 2023",GSW vs. OKC,L,35,12,19,0.632,5,8,0.625,2,4,0.5,0,0,0,3,1,1,0,4,31,6,1,GSW,GSW,OKC,123,,,34,31,34,3
Andrew Wiggins,F,22023,203952,22300186,"NOV 12, 2023",GSW vs. MIN,L,25,3,7,0.429,0,2,0.0,0,2,0.0,2,2,4,2,1,0,1,4,6,-13,1,GSW,GSW,MIN,110,,,12,10,8,6
Andrew Wiggins,F,22023,203952,22300176,"NOV 11, 2023",GSW vs. CLE,L,29,6,12,0.5,1,4,0.25,0,2,0.0,3,2,5,3,0,0,3,2,13,-13,1,GSW,GSW,CLE,110,,,21,18,16,8
Andrew Wiggins,F,22023,203952,22300169,"NOV 08, 2023",GSW @ DEN,L,29,4,13,0.308,0,3,0.0,3,4,0.75,3,2,5,0,0,0,1,3,11,-6,1,GSW,DEN,GSW,105,,,16,16,11,5
Andrew Wiggins,F,22023,203952,22300145,"NOV 06, 2023",GSW @ DET,W,22,2,9,0.222,0,2,0.0,0,2,0.0,3,3,6,1,1,1,2,0,4,-4,1,GSW,DET,GSW,120,,,11,10,5,7
Andrew Wiggins,F,22023,203952,22300142,"NOV 05, 2023",GSW @ CLE,L,26,3,9,0.333,1,2,0.5,1,4,0.25,3,2,5,1,0,0,0,1,8,-5,1,GSW,CLE,GSW,104,,,14,13,9,6
Andrew Wiggins,F,22023,203952,22300005,"NOV 03, 2023",GSW @ OKC,W,27,6,11,0.545,0,1,0.0,5,8,0.625,4,1,5,1,0,0,0,1,17,-14,1,GSW,OKC,GSW,141,,,23,22,18,6
Andrew Wiggins,F,22023,203952,22300126,"NOV 01, 2023",GSW vs. SAC,W,25,6,10,0.6,0,1,0.0,2,2,1.0,0,2,2,0,0,0,1,2,14,-5,1,GSW,GSW,SAC,102,,,16,16,14,2
Andrew Wiggins,F,22023,203952,22300108,"OCT 30, 2023",GSW @ NOP,W,20,4,8,0.5,1,2,0.5,0,2,0.0,1,2,3,0,0,0,3,2,9,10,1,GSW,NOP,GSW,130,,,12,12,9,3
Andrew Wiggins,F,22023,203952,22300096,"OCT 29, 2023",GSW @ HOU,W,28,4,10,0.4,1,3,0.333,4,5,0.8,0,0,0,0,0,0,2,2,13,-4,1,GSW,HOU,GSW,106,,,13,13,13,0
Andrew Wiggins,F,22023,203952,22300087,"OCT 27, 2023",GSW @ SAC,W,27,5,13,0.385,0,3,0.0,1,2,0.5,1,4,5,3,0,2,2,4,11,2,1,GSW,SAC,GSW,122,,,19,16,14,8
Andrew Wiggins,F,22023,203952,22300062,"OCT 24, 2023",GSW vs. PHX,L,27,4,12,0.333,0,3,0.0,2,3,0.667,1,0,1,0,0,1,0,3,10,-22,1,GSW,GSW,PHX,104,,,11,11,10,1
Andrew Wiggins,F,22023,203952,22300025,"NOV 14, 2023",GSW vs. MIN,L,28,4,15,0.267,1,7,0.143,0,0,0.0,2,5,7,0,3,1,4,5,9,2,1,GSW,GSW,MIN,101,,,16,16,9,7
Andrew Wiggins,F,22023,203952,22300545,"JAN 13, 2024",GSW @ MIL,L,32,3,13,0.231,1,3,0.333,0,0,0.0,3,1,4,1,0,0,0,3,7,-14,1,GSW,MIL,GSW,118,,,12,11,8,5
Andrew Wiggins,F,22023,203952,22300201,"NOV 16, 2023",GSW vs. OKC,L,26,6,13,0.462,0,4,0.0,0,0,0.0,4,2,6,2,0,0,5,2,12,-2,1,GSW,GSW,OKC,109,,,20,18,14,8
Ivica Zubac,C,22023,1627826,22300099,"OCT 29, 2023",LAC vs. SAS,W,22,6,7,0.857,0,0,0.0,4,6,0.667,2,6,8,0,0,1,1,4,16,23,1,LAC,LAC,SAS,123,,,24,24,16,8
Ivica Zubac,C,22023,1627826,22300085,"OCT 27, 2023",LAC @ UTA,L,19,3,6,0.5,0,0,0.0,0,2,0.0,0,2,2,0,0,2,1,2,6,1,1,LAC,UTA,LAC,118,,,8,8,6,2
Ivica Zubac,C,22023,1627826,22300074,"OCT 25, 2023",LAC vs. POR,W,26,8,10,0.8,0,0,0.0,4,5,0.8,5,7,12,0,0,4,2,3,20,25,1,LAC,LAC,POR,123,,,32,32,20,12
Ivica Zubac,C,22023,1627826,22300731,"FEB 07, 2024",LAC vs. NOP,L,21,5,5,1.0,0,0,0.0,2,3,0.667,1,7,8,1,0,0,0,0,12,6,1,LAC,LAC,NOP,106,,,21,20,13,9
Ivica Zubac,C,22023,1627826,22300537,"JAN 12, 2024",LAC @ MEM,W,22,2,5,0.4,0,0,0.0,2,2,1.0,4,7,11,0,0,2,0,3,6,6,1,LAC,MEM,LAC,128,,,17,17,6,11
Ivica Zubac,C,22023,1627826,22300511,"JAN 08, 2024",LAC vs. PHX,W,28,8,9,0.889,0,0,0.0,3,6,0.5,2,6,8,3,1,1,0,3,19,14,1,LAC,LAC,PHX,138,,,30,27,22,11
Ivica Zubac,C,22023,1627826,22300486,"JAN 05, 2024",LAC @ NOP,W,23,6,7,0.857,0,0,0.0,3,4,0.75,0,8,8,2,0,2,1,3,15,18,1,LAC,NOP,LAC,111,,,25,23,17,10
Ivica Zubac,C,22023,1627826,22300458,"JAN 01, 2024",LAC vs. MIA,W,29,3,4,0.75,0,0,0.0,0,0,0.0,1,11,12,1,0,0,1,4,6,28,1,LAC,LAC,MIA,121,,,19,18,7,13
Ivica Zubac,C,22023,1627826,22300389,"DEC 23, 2023",LAC vs. BOS,L,27,7,9,0.778,0,0,0.0,2,2,1.0,5,5,10,0,0,1,2,3,16,-28,1,LAC,LAC,BOS,108,,,26,26,16,10
Ivica Zubac,C,22023,1627826,22300379,"DEC 21, 2023",LAC @ OKC,L,17,3,4,0.75,0,0,0.0,0,0,0.0,2,1,3,3,0,0,0,2,6,-3,1,LAC,OKC,LAC,115,,,12,9,9,6
Ivica Zubac,C,22023,1627826,22300350,"DEC 18, 2023",LAC @ IND,W,26,7,10,0.7,0,0,0.0,4,5,0.8,4,12,16,3,0,3,0,2,18,27,1,LAC,IND,LAC,151,,,37,34,21,19
Ivica Zubac,C,22023,1627826,22300343,"DEC 16, 2023",LAC vs. NYK,W,28,5,9,0.556,0,0,0.0,3,4,0.75,4,7,11,2,1,2,0,2,13,29,1,LAC,LAC,NYK,144,,,26,24,15,13
Ivica Zubac,C,22023,1627826,22300438,"DEC 29, 2023",LAC vs. MEM,W,33,7,8,0.875,0,0,0.0,1,1,1.0,6,14,20,1,0,1,2,3,15,9,1,LAC,LAC,MEM,117,,,36,35,16,21
Ivica Zubac,C,22023,1627826,22300414,"DEC 26, 2023",LAC vs. CHA,W,31,7,11,0.636,0,0,0.0,4,8,0.5,5,9,14,4,1,1,2,3,18,13,1,LAC,LAC,CHA,113,,,36,32,22,18
Ivica Zubac,C,22023,1627826,22300325,"DEC 14, 2023",LAC vs. GSW,W,30,5,10,0.5,0,0,0.0,0,0,0.0,3,5,8,2,0,2,3,5,10,-3,1,LAC,LAC,GSW,121,,,20,18,12,10
Ivica Zubac,C,22023,1627826,22300309,"DEC 12, 2023",LAC vs. SAC,W,23,3,5,0.6,0,0,0.0,0,1,0.0,0,9,9,0,0,0,1,4,6,17,1,LAC,LAC,SAC,117,,,15,15,6,9
Ivica Zubac,C,22023,1627826,22300304,"DEC 11, 2023",LAC vs. POR,W,33,9,13,0.692,0,0,0.0,0,0,0.0,3,3,6,2,0,2,0,2,18,2,1,LAC,LAC,POR,132,,,26,24,20,8
Ivica Zubac,C,22023,1627826,22301225,"DEC 08, 2023",LAC @ UTA,W,42,9,15,0.6,0,0,0.0,0,0,0.0,5,7,12,3,0,2,1,5,18,13,1,LAC,UTA,LAC,117,,,33,30,21,15
Ivica Zubac,C,22023,1627826,22301215,"DEC 06, 2023",LAC vs. DEN,W,27,4,7,0.571,0,0,0.0,2,6,0.333,2,7,9,0,2,1,0,3,10,-6,1,LAC,LAC,DEN,111,,,19,19,10,9
Ivica Zubac,C,22023,1627826,22300280,"DEC 02, 2023",LAC vs. GSW,W,23,6,6,1.0,0,0,0.0,0,0,0.0,1,6,7,1,0,3,3,4,12,1,1,LAC,LAC,GSW,113,,,20,19,13,8
Ivica Zubac,C,22023,1627826,22300273,"NOV 30, 2023",LAC @ GSW,L,27,7,11,0.636,0,0,0.0,4,5,0.8,4,9,13,0,0,1,0,1,18,7,1,LAC,GSW,LAC,114,,,31,31,18,13
Ivica Zubac,C,22023,1627826,22300264,"NOV 29, 2023",LAC @ SAC,W,30,7,12,0.583,0,0,0.0,0,0,0.0,3,5,8,3,0,3,0,1,14,23,1,LAC,SAC,LAC,131,,,25,22,17,11
Ivica Zubac,C,22023,1627826,22300244,"NOV 25, 2023",LAC vs. DAL,W,23,5,8,0.625,0,0,0.0,1,5,0.2,4,10,14,1,0,0,1,1,11,18,1,LAC,LAC,DAL,107,,,26,25,12,15
Ivica Zubac,C,22023,1627826,22300014,"NOV 10, 2023",LAC @ DAL,L,22,5,9,0.556,0,0,0.0,2,4,0.5,5,3,8,1,0,2,1,3,12,1,1,LAC,DAL,LAC,126,,,21,20,13,9
Ivica Zubac,C,22023,1627826,22300151,"NOV 06, 2023",LAC @ NYK,L,30,3,3,1.0,0,0,0.0,2,4,0.5,4,3,7,0,1,2,5,3,8,-18,1,LAC,NYK,LAC,97,,,15,15,8,7
Ivica Zubac,C,22023,1627826,22300127,"NOV 01, 2023",LAC @ LAL,L,29,3,8,0.375,0,0,0.0,1,2,0.5,2,7,9,0,0,0,1,5,7,-6,1,LAC,LAL,LAC,125,,,16,16,7,9
Ivica Zubac,C,22023,1627826,22300114,"OCT 31, 2023",LAC vs. ORL,W,23,4,8,0.5,0,0,0.0,1,2,0.5,2,7,9,1,0,1,1,1,9,19,1,LAC,LAC,ORL,118,,,19,18,10,10
Ivica Zubac,C,22023,1627826,22300749,"FEB 10, 2024",LAC vs. DET,W,20,2,3,0.667,0,0,0.0,2,2,1.0,0,5,5,1,0,2,0,0,6,-11,1,LAC,LAC,DET,112,,,12,11,7,6
Ivica Zubac,C,22023,1627826,22300708,"FEB 04, 2024",LAC @ MIA,W,18,2,4,0.5,0,0,0.0,0,0,0.0,1,2,3,0,0,0,1,2,4,0,1,LAC,MIA,LAC,103,,,7,7,4,3
Ivica Zubac,C,22023,1627826,22300526,"JAN 10, 2024",LAC vs. TOR,W,31,6,8,0.75,0,0,0.0,0,0,0.0,5,6,11,3,0,1,2,2,12,1,1,LAC,LAC,TOR,126,,,26,23,15,14
Ivica Zubac,C,22023,1627826,22300505,"JAN 07, 2024",LAC @ LAL,L,37,9,13,0.692,0,0,0.0,4,4,1.0,10,9,19,1,0,1,2,4,22,1,1,LAC,LAL,LAC,103,,,42,41,23,20
Ivica Zubac,C,22023,1627826,22300473,"JAN 03, 2024",LAC @ PHX,W,27,2,4,0.5,0,0,0.0,2,2,1.0,1,2,3,2,0,2,0,5,6,1,1,LAC,PHX,LAC,131,,,11,9,8,5
Ivica Zubac,C,22023,1627826,22300372,"DEC 20, 2023",LAC @ DAL,W,25,5,6,0.833,0,0,0.0,2,2,1.0,2,7,9,0,1,0,1,2,12,0,1,LAC,DAL,LAC,120,,,21,21,12,9
Ivica Zubac,C,22023,1627826,22300235,"NOV 22, 2023",LAC @ SAS,W,26,5,7,0.714,0,0,0.0,2,2,1.0,2,6,8,1,0,0,0,2,12,-4,1,LAC,SAS,LAC,109,,,21,20,13,9
Ivica Zubac,C,22023,1627826,22300223,"NOV 20, 2023",LAC @ SAS,W,22,3,5,0.6,0,0,0.0,2,2,1.0,2,9,11,0,0,1,1,0,8,4,1,LAC,SAS,LAC,124,,,19,19,8,11
Ivica Zubac,C,22023,1627826,22300179,"NOV 12, 2023",LAC vs. MEM,L,23,2,4,0.5,0,0,0.0,2,2,1.0,0,6,6,1,1,0,1,3,6,-6,1,LAC,LAC,MEM,101,,,13,12,7,7
Ivica Zubac,C,22023,1627826,22300257,"NOV 27, 2023",LAC vs. DEN,L,32,9,15,0.6,0,0,0.0,5,8,0.625,8,6,14,1,0,1,1,2,23,-6,1,LAC,LAC,DEN,104,,,38,37,24,15
Ivica Zubac,C,22023,1627826,22300052,"NOV 24, 2023",LAC vs. NOP,L,22,5,6,0.833,0,0,0.0,1,1,1.0,3,2,5,0,0,1,4,4,11,-18,1,LAC,LAC,NOP,106,,,16,16,11,5
Ivica Zubac,C,22023,1627826,22300037,"NOV 17, 2023",LAC vs. HOU,W,35,6,8,0.75,0,0,0.0,0,2,0.0,3,4,7,2,0,2,1,2,12,12,1,LAC,LAC,HOU,106,,,21,19,14,9
Ivica Zubac,C,22023,1627826,22300024,"NOV 14, 2023",LAC @ DEN,L,26,2,8,0.25,0,0,0.0,5,6,0.833,7,6,13,3,0,1,0,4,9,-3,1,LAC,DEN,LAC,108,,,25,22,12,16
Ivica Zubac,C,22023,1627826,22300160,"NOV 08, 2023",LAC @ BKN,L,29,5,9,0.556,0,0,0.0,0,0,0.0,3,7,10,1,0,3,1,5,10,-11,1,LAC,BKN,LAC,93,,,21,20,11,11
Nic Claxton,C,22023,1629651,22300750,"FEB 10, 2024",BKN vs. SAS,W,27,10,15,0.667,0,1,0.0,0,0,0.0,3,8,11,0,1,2,0,3,20,12,1,BKN,BKN,SAS,123,,,31,31,20,11
Nic Claxton,C,22023,1629651,22300735,"FEB 08, 2024",BKN vs. CLE,L,25,3,10,0.3,0,0,0.0,0,0,0.0,2,5,7,1,0,1,2,4,6,-18,1,BKN,BKN,CLE,95,,,14,13,7,8
Nic Claxton,C,22023,1629651,22300720,"FEB 06, 2024",BKN vs. DAL,L,35,3,9,0.333,0,0,0.0,3,3,1.0,2,9,11,2,0,5,2,3,9,-15,1,BKN,BKN,DAL,107,,,22,20,11,13
Nic Claxton,C,22023,1629651,22300717,"FEB 05, 2024",BKN vs. GSW,L,32,7,9,0.778,0,0,0.0,1,2,0.5,2,3,5,1,0,7,0,1,15,-8,1,BKN,BKN,GSW,98,,,21,20,16,6
Nic Claxton,C,22023,1629651,22300698,"FEB 03, 2024",BKN @ PHI,W,26,4,4,1.0,0,0,0.0,4,6,0.667,3,12,15,4,0,4,1,1,12,18,1,BKN,PHI,BKN,136,,,31,27,16,19
Nic Claxton,C,22023,1629651,22300677,"JAN 31, 2024",BKN vs. PHX,L,30,6,12,0.5,0,0,0.0,0,0,0.0,1,8,9,4,1,0,1,3,12,-11,1,BKN,BKN,PHX,120,,,25,21,16,13
Nic Claxton,C,22023,1629651,22300660,"JAN 29, 2024",BKN vs. UTA,W,26,5,11,0.455,0,0,0.0,1,1,1.0,4,6,10,2,1,3,2,1,11,2,1,BKN,BKN,UTA,147,,,23,21,13,12
Nic Claxton,C,22023,1629651,22300645,"JAN 27, 2024",BKN vs. HOU,W,37,5,7,0.714,0,1,0.0,0,4,0.0,1,12,13,4,1,1,3,5,10,-7,1,BKN,BKN,HOU,106,,,27,23,14,17
Nic Claxton,C,22023,1629651,22300629,"JAN 25, 2024",BKN vs. MIN,L,39,8,10,0.8,0,0,0.0,0,0,0.0,2,9,11,4,2,2,0,2,16,2,1,BKN,BKN,MIN,94,,,31,27,20,15
Nic Claxton,C,22023,1629651,22300615,"JAN 23, 2024",BKN vs. NYK,L,39,4,9,0.444,0,0,0.0,0,0,0.0,6,11,17,1,2,1,3,1,8,-6,1,BKN,BKN,NYK,103,,,26,25,9,18
Nic Claxton,C,22023,1629651,22300600,"JAN 21, 2024",BKN @ LAC,L,31,7,10,0.7,0,1,0.0,2,4,0.5,2,4,6,3,1,2,0,5,16,-9,1,BKN,LAC,BKN,114,,,25,22,19,9
Nic Claxton,C,22023,1629651,22300591,"JAN 19, 2024",BKN @ LAL,W,33,11,16,0.688,0,0,0.0,0,0,0.0,2,12,14,1,1,2,0,3,22,8,1,BKN,LAL,BKN,130,,,37,36,23,15
Nic Claxton,C,22023,1629651,22300578,"JAN 17, 2024",BKN @ POR,L,32,4,5,0.8,0,0,0.0,4,10,0.4,2,10,12,0,3,1,1,3,12,-4,1,BKN,POR,BKN,103,,,24,24,12,12
Nic Claxton,C,22023,1629651,22300562,"JAN 15, 2024",BKN vs. MIA,L,43,4,9,0.444,0,0,0.0,1,1,1.0,2,11,13,2,0,2,1,1,9,-4,1,BKN,BKN,MIA,95,,,24,22,11,15
Nic Claxton,C,22023,1629651,22300527,"JAN 11, 2024",BKN @ CLE,L,33,6,9,0.667,0,0,0.0,1,2,0.5,3,8,11,1,1,0,4,3,13,0,1,BKN,CLE,BKN,102,,,25,24,14,12
Nic Claxton,C,22023,1629651,22300498,"JAN 07, 2024",BKN vs. POR,L,36,8,8,1.0,0,0,0.0,0,2,0.0,2,9,11,3,2,4,5,5,16,-2,1,BKN,BKN,POR,127,,,30,27,19,14
Nic Claxton,C,22023,1629651,22300481,"JAN 05, 2024",BKN vs. OKC,W,34,8,11,0.727,0,0,0.0,7,10,0.7,8,5,13,3,1,0,3,1,23,5,1,BKN,BKN,OKC,124,,,39,36,26,16
Nic Claxton,C,22023,1629651,22300469,"JAN 03, 2024",BKN @ HOU,L,28,6,8,0.75,0,0,0.0,0,0,0.0,5,8,13,0,1,2,1,5,12,-8,1,BKN,HOU,BKN,101,,,25,25,12,13
Nic Claxton,C,22023,1629651,22300461,"JAN 02, 2024",BKN @ NOP,L,23,4,7,0.571,0,0,0.0,0,0,0.0,0,3,3,1,0,2,0,1,8,-19,1,BKN,NOP,BKN,85,,,12,11,9,4
Nic Claxton,C,22023,1629651,22300447,"DEC 31, 2023",BKN @ OKC,L,37,5,11,0.455,0,0,0.0,5,10,0.5,6,10,16,5,1,1,0,2,15,-21,1,BKN,OKC,BKN,108,,,36,31,20,21
Nic Claxton,C,22023,1629651,22300430,"DEC 29, 2023",BKN @ WAS,L,30,4,10,0.4,0,0,0.0,3,5,0.6,4,8,12,2,0,3,1,0,11,7,1,BKN,WAS,BKN,104,,,25,23,13,14
Nic Claxton,C,22023,1629651,22300406,"DEC 26, 2023",BKN @ DET,W,26,5,5,1.0,0,0,0.0,1,3,0.333,2,9,11,2,0,3,0,2,11,-9,1,BKN,DET,BKN,118,,,24,22,13,13
Nic Claxton,C,22023,1629651,22300394,"DEC 23, 2023",BKN vs. DET,W,30,4,8,0.5,0,0,0.0,3,4,0.75,2,5,7,2,2,2,2,2,11,3,1,BKN,BKN,DET,126,,,20,18,13,9
Nic Claxton,C,22023,1629651,22300383,"DEC 22, 2023",BKN vs. DEN,L,28,4,8,0.5,0,0,0.0,2,4,0.5,1,15,16,6,0,3,1,1,10,-10,1,BKN,BKN,DEN,117,,,32,26,16,22
Nic Claxton,C,22023,1629651,22300368,"DEC 20, 2023",BKN vs. NYK,L,26,3,5,0.6,0,0,0.0,0,0,0.0,4,4,8,2,0,4,0,5,6,-21,1,BKN,BKN,NYK,102,,,16,14,8,10
Nic Claxton,C,22023,1629651,22300357,"DEC 18, 2023",BKN @ UTA,L,26,4,5,0.8,0,0,0.0,3,4,0.75,2,5,7,0,0,4,3,3,11,-18,1,BKN,UTA,BKN,108,,,18,18,11,7
Nic Claxton,C,22023,1629651,22300339,"DEC 16, 2023",BKN @ GSW,L,33,8,12,0.667,0,0,0.0,3,3,1.0,5,7,12,1,0,4,2,1,19,-5,1,BKN,GSW,BKN,120,,,32,31,20,13
Nic Claxton,C,22023,1629651,22300322,"DEC 14, 2023",BKN @ DEN,L,17,5,9,0.556,0,0,0.0,0,0,0.0,1,8,9,2,0,0,2,5,10,-16,1,BKN,DEN,BKN,101,,,21,19,12,11
Nic Claxton,C,22023,1629651,22300317,"DEC 13, 2023",BKN @ PHX,W,33,6,10,0.6,1,1,1.0,1,2,0.5,0,7,7,1,0,1,0,4,14,-6,1,BKN,PHX,BKN,116,,,22,21,15,8
Nic Claxton,C,22023,1629651,22300303,"DEC 11, 2023",BKN @ SAC,L,26,3,6,0.5,0,0,0.0,2,2,1.0,4,6,10,0,0,3,0,2,8,-24,1,BKN,SAC,BKN,118,,,18,18,8,10
Nic Claxton,C,22023,1629651,22301219,"DEC 08, 2023",BKN vs. WAS,W,26,6,8,0.75,0,0,0.0,1,2,0.5,4,11,15,0,0,2,1,3,13,15,1,BKN,BKN,WAS,124,,,28,28,13,15
Nic Claxton,C,22023,1629651,22301209,"DEC 06, 2023",BKN @ ATL,W,28,1,5,0.2,0,0,0.0,2,4,0.5,2,8,10,4,1,1,0,1,4,-5,1,BKN,ATL,BKN,114,,,18,14,8,14
Nic Claxton,C,22023,1629651,22300282,"DEC 02, 2023",BKN vs. ORL,W,24,3,4,0.75,0,0,0.0,0,0,0.0,4,3,7,1,0,1,1,4,6,3,1,BKN,BKN,ORL,129,,,14,13,7,8
Nic Claxton,C,22023,1629651,22300266,"NOV 30, 2023",BKN vs. CHA,L,29,9,13,0.692,0,0,0.0,2,2,1.0,9,5,14,2,1,2,1,1,20,-7,1,BKN,BKN,CHA,128,,,36,34,22,16
Nic Claxton,C,22023,1629651,22300054,"NOV 28, 2023",BKN vs. TOR,W,32,7,10,0.7,0,0,0.0,1,4,0.25,2,6,8,0,0,4,0,1,15,20,1,BKN,BKN,TOR,115,,,23,23,15,8
Nic Claxton,C,22023,1629651,22300240,"NOV 25, 2023",BKN vs. MIA,W,24,5,7,0.714,0,0,0.0,3,4,0.75,2,4,6,0,2,3,0,1,13,3,1,BKN,BKN,MIA,112,,,19,19,13,6
Nic Claxton,C,22023,1629651,22300227,"NOV 22, 2023",BKN @ ATL,L,37,10,15,0.667,0,0,0.0,2,2,1.0,7,4,11,3,1,3,2,6,22,-6,1,BKN,ATL,BKN,145,,,36,33,25,14
Nic Claxton,C,22023,1629651,22300208,"NOV 19, 2023",BKN vs. PHI,L,23,5,6,0.833,0,0,0.0,0,3,0.0,0,9,9,1,0,1,2,3,10,-17,1,BKN,BKN,PHI,99,,,20,19,11,10
Nic Claxton,C,22023,1629651,22300200,"NOV 16, 2023",BKN @ MIA,L,26,7,7,1.0,0,0,0.0,2,4,0.5,1,5,6,2,1,3,1,2,16,-7,1,BKN,MIA,BKN,115,,,24,22,18,8
Nic Claxton,C,22023,1629651,22300020,"NOV 14, 2023",BKN vs. ORL,W,21,3,5,0.6,0,0,0.0,2,2,1.0,2,4,6,0,1,2,1,4,8,20,1,BKN,BKN,ORL,124,,,14,14,8,6
Nic Claxton,C,22023,1629651,22300178,"NOV 12, 2023",BKN vs. WAS,W,28,5,7,0.714,0,0,0.0,0,0,0.0,4,9,13,2,0,4,0,2,10,8,1,BKN,BKN,WAS,102,,,25,23,12,15
Nic Claxton,C,22023,1629651,22300067,"OCT 25, 2023",BKN vs. CLE,L,28,3,10,0.3,0,0,0.0,1,1,1.0,4,3,7,4,0,3,0,1,7,-12,1,BKN,BKN,CLE,113,,,18,14,11,11
Naz Reid,C-F,22023,1629675,22300738,"FEB 08, 2024",MIN @ MIL,W,24,6,11,0.545,2,4,0.5,3,3,1.0,1,3,4,0,1,1,1,1,17,6,1,MIN,MIL,MIN,129,,,21,21,17,4
Naz Reid,C-F,22023,1629675,22300723,"FEB 06, 2024",MIN @ CHI,L,20,4,11,0.364,2,6,0.333,0,0,0.0,0,4,4,2,0,1,0,1,10,3,1,MIN,CHI,MIN,123,,,16,14,12,6
Naz Reid,C-F,22023,1629675,22300709,"FEB 04, 2024",MIN vs. HOU,W,22,5,11,0.455,1,4,0.25,2,3,0.667,0,6,6,0,1,2,1,2,13,4,1,MIN,MIN,HOU,111,,,19,19,13,6
Naz Reid,C-F,22023,1629675,22300694,"FEB 02, 2024",MIN vs. ORL,L,22,4,5,0.8,1,2,0.5,0,0,0.0,0,5,5,1,0,0,2,1,9,4,1,MIN,MIN,ORL,106,,,15,14,10,6
Naz Reid,C-F,22023,1629675,22300680,"JAN 31, 2024",MIN vs. DAL,W,26,4,10,0.4,3,5,0.6,1,4,0.25,1,7,8,2,1,1,0,3,12,23,1,MIN,MIN,DAL,121,,,22,20,14,10
Naz Reid,C-F,22023,1629675,22300664,"JAN 29, 2024",MIN @ OKC,W,21,3,10,0.3,3,5,0.6,0,0,0.0,0,5,5,2,0,0,2,0,9,-7,1,MIN,OKC,MIN,107,,,16,14,11,7
Naz Reid,C-F,22023,1629675,22300649,"JAN 27, 2024",MIN @ SAS,L,22,5,12,0.417,2,5,0.4,1,2,0.5,0,2,2,0,0,3,1,2,13,5,1,MIN,SAS,MIN,112,,,15,15,13,2
Naz Reid,C-F,22023,1629675,22300629,"JAN 25, 2024",MIN @ BKN,W,23,2,7,0.286,1,3,0.333,0,0,0.0,1,3,4,2,0,1,1,3,5,8,1,MIN,BKN,MIN,96,,,11,9,7,6
Naz Reid,C-F,22023,1629675,22300620,"JAN 24, 2024",MIN @ WAS,W,21,2,9,0.222,1,3,0.333,0,0,0.0,0,3,3,2,1,1,0,1,5,4,1,MIN,WAS,MIN,118,,,10,8,7,5
Naz Reid,C-F,22023,1629675,22300610,"JAN 22, 2024",MIN vs. CHA,L,15,2,5,0.4,1,4,0.25,0,0,0.0,0,0,0,0,1,0,1,3,5,6,1,MIN,MIN,CHA,125,,,5,5,5,0
Naz Reid,C-F,22023,1629675,22300599,"JAN 20, 2024",MIN vs. OKC,L,26,7,13,0.538,4,8,0.5,0,0,0.0,0,3,3,0,0,4,4,3,18,17,1,MIN,MIN,OKC,97,,,21,21,18,3
Naz Reid,C-F,22023,1629675,22300582,"JAN 18, 2024",MIN vs. MEM,W,24,8,13,0.615,4,5,0.8,0,0,0.0,0,3,3,1,2,1,0,2,20,16,1,MIN,MIN,MEM,118,,,24,23,21,4
Naz Reid,C-F,22023,1629675,22300569,"JAN 17, 2024",MIN @ DET,W,23,3,9,0.333,1,4,0.25,2,4,0.5,0,4,4,1,3,0,1,0,9,3,1,MIN,DET,MIN,124,,,14,13,10,5
Naz Reid,C-F,22023,1629675,22300553,"JAN 14, 2024",MIN vs. LAC,W,14,3,5,0.6,2,3,0.667,0,0,0.0,0,1,1,1,2,0,1,2,8,6,1,MIN,MIN,LAC,109,,,10,9,9,2
Naz Reid,C-F,22023,1629675,22300538,"JAN 12, 2024",MIN vs. POR,W,21,5,10,0.5,2,6,0.333,2,5,0.4,1,2,3,1,2,0,0,2,14,-4,1,MIN,MIN,POR,116,,,18,17,15,4
Naz Reid,C-F,22023,1629675,22300517,"JAN 10, 2024",MIN @ BOS,L,37,7,15,0.467,3,7,0.429,2,2,1.0,3,7,10,3,0,3,1,4,19,2,1,MIN,BOS,MIN,120,,,32,29,22,13
Naz Reid,C-F,22023,1629675,22300513,"JAN 09, 2024",MIN @ ORL,W,21,5,8,0.625,2,4,0.5,1,2,0.5,2,8,10,2,0,0,3,3,13,1,1,MIN,ORL,MIN,113,,,25,23,15,12
Naz Reid,C-F,22023,1629675,22300501,"JAN 07, 2024",MIN @ DAL,L,27,7,12,0.583,1,4,0.25,0,2,0.0,4,5,9,0,0,0,0,2,15,-1,1,MIN,DAL,MIN,108,,,24,24,15,9
Naz Reid,C-F,22023,1629675,22300485,"JAN 05, 2024",MIN @ HOU,W,25,6,11,0.545,3,6,0.5,1,2,0.5,1,6,7,2,0,1,0,1,16,21,1,MIN,HOU,MIN,122,,,25,23,18,9
Naz Reid,C-F,22023,1629675,22300471,"JAN 03, 2024",MIN vs. NOP,L,25,3,8,0.375,2,5,0.4,0,0,0.0,0,6,6,2,0,2,1,2,8,3,1,MIN,MIN,NOP,106,,,16,14,10,8
Naz Reid,C-F,22023,1629675,22300451,"JAN 01, 2024",MIN @ NYK,L,19,2,6,0.333,1,4,0.25,0,0,0.0,0,2,2,0,0,0,0,5,5,-5,1,MIN,NYK,MIN,106,,,7,7,5,2
Naz Reid,C-F,22023,1629675,22300443,"DEC 30, 2023",MIN vs. LAL,W,27,8,11,0.727,2,5,0.4,3,4,0.75,0,5,5,1,2,2,2,3,21,13,1,MIN,MIN,LAL,108,,,27,26,22,6
Naz Reid,C-F,22023,1629675,22300423,"DEC 28, 2023",MIN vs. DAL,W,18,3,5,0.6,3,5,0.6,0,0,0.0,0,4,4,2,0,0,3,4,9,12,1,MIN,MIN,DAL,118,,,15,13,11,6
Naz Reid,C-F,22023,1629675,22300411,"DEC 26, 2023",MIN @ OKC,L,19,2,4,0.5,2,3,0.667,0,0,0.0,1,6,7,0,0,0,4,1,6,-9,1,MIN,OKC,MIN,106,,,13,13,6,7
Naz Reid,C-F,22023,1629675,22300400,"DEC 23, 2023",MIN @ SAC,W,19,2,4,0.5,0,1,0.0,2,2,1.0,0,2,2,2,2,0,1,0,6,-13,1,MIN,SAC,MIN,110,,,10,8,8,4
Naz Reid,C-F,22023,1629675,22300380,"DEC 21, 2023",MIN vs. LAL,W,21,3,9,0.333,3,6,0.5,0,0,0.0,2,3,5,2,1,1,3,6,9,5,1,MIN,MIN,LAL,118,,,16,14,11,7
Naz Reid,C-F,22023,1629675,22300367,"DEC 20, 2023",MIN @ PHI,L,20,4,9,0.444,2,6,0.333,0,0,0.0,1,1,2,1,0,1,4,3,10,-27,1,MIN,PHI,MIN,113,,,13,12,11,3
Naz Reid,C-F,22023,1629675,22300353,"DEC 18, 2023",MIN @ MIA,W,21,5,13,0.385,1,6,0.167,2,2,1.0,1,3,4,1,1,1,1,2,13,2,1,MIN,MIA,MIN,112,,,18,17,14,5
Naz Reid,C-F,22023,1629675,22300338,"DEC 16, 2023",MIN vs. IND,W,27,6,8,0.75,3,5,0.6,2,2,1.0,0,5,5,0,0,0,1,2,17,25,1,MIN,MIN,IND,127,,,22,22,17,5
Naz Reid,C-F,22023,1629675,22300321,"DEC 14, 2023",MIN @ DAL,W,31,8,14,0.571,7,11,0.636,4,4,1.0,2,4,6,3,1,0,2,2,27,16,1,MIN,DAL,MIN,119,,,36,33,30,9
Naz Reid,C-F,22023,1629675,22300301,"DEC 11, 2023",MIN @ NOP,L,24,7,15,0.467,3,7,0.429,0,0,0.0,3,3,6,2,1,0,0,3,17,0,1,MIN,NOP,MIN,107,,,25,23,19,8
Naz Reid,C-F,22023,1629675,22301221,"DEC 08, 2023",MIN @ MEM,W,24,5,12,0.417,0,5,0.0,0,0,0.0,0,9,9,2,1,1,1,2,10,7,1,MIN,MEM,MIN,127,,,21,19,12,11
Naz Reid,C-F,22023,1629675,22301210,"DEC 06, 2023",MIN vs. SAS,W,29,7,18,0.389,1,7,0.143,0,0,0.0,4,5,9,2,0,1,1,2,15,10,1,MIN,MIN,SAS,102,,,26,24,17,11
Naz Reid,C-F,22023,1629675,22300281,"DEC 02, 2023",MIN @ CHA,W,25,9,14,0.643,3,6,0.5,2,2,1.0,2,3,5,2,1,0,2,0,23,-7,1,MIN,CHA,MIN,123,,,30,28,25,7
Naz Reid,C-F,22023,1629675,22300270,"NOV 30, 2023",MIN vs. UTA,W,22,3,9,0.333,0,4,0.0,0,0,0.0,1,2,3,0,1,1,0,2,6,-2,1,MIN,MIN,UTA,101,,,9,9,6,3
Naz Reid,C-F,22023,1629675,22300058,"NOV 28, 2023",MIN vs. OKC,W,25,6,9,0.667,3,4,0.75,0,0,0.0,1,6,7,2,0,2,1,2,15,1,1,MIN,MIN,OKC,106,,,24,22,17,9
Naz Reid,C-F,22023,1629675,22300249,"NOV 26, 2023",MIN @ MEM,W,22,4,9,0.444,1,2,0.5,3,4,0.75,2,4,6,0,1,0,1,4,12,4,1,MIN,MEM,MIN,119,,,18,18,12,6
Naz Reid,C-F,22023,1629675,22300050,"NOV 24, 2023",MIN vs. SAC,L,18,4,7,0.571,1,3,0.333,0,0,0.0,0,1,1,0,0,2,3,0,9,-19,1,MIN,MIN,SAC,111,,,10,10,9,1
Naz Reid,C-F,22023,1629675,22300232,"NOV 22, 2023",MIN vs. PHI,W,22,6,13,0.462,1,4,0.25,0,1,0.0,1,3,4,0,3,1,0,1,13,4,1,MIN,MIN,PHI,112,,,17,17,13,4
Naz Reid,C-F,22023,1629675,22300221,"NOV 20, 2023",MIN vs. NYK,W,18,3,8,0.375,1,6,0.167,3,3,1.0,0,3,3,1,1,0,3,6,10,3,1,MIN,MIN,NYK,117,,,14,13,11,4
Naz Reid,C-F,22023,1629675,22300203,"NOV 18, 2023",MIN @ NOP,W,18,2,8,0.25,2,6,0.333,2,2,1.0,0,1,1,0,0,1,1,0,8,-8,1,MIN,NOP,MIN,121,,,9,9,8,1
Naz Reid,C-F,22023,1629675,22300197,"NOV 15, 2023",MIN @ PHX,L,19,4,7,0.571,1,2,0.5,4,4,1.0,2,2,4,0,1,0,0,0,13,-5,1,MIN,PHX,MIN,115,,,17,17,13,4
Naz Reid,C-F,22023,1629675,22300025,"NOV 14, 2023",MIN @ GSW,W,16,4,5,0.8,2,3,0.667,0,0,0.0,0,2,2,0,0,0,1,4,10,-8,1,MIN,GSW,MIN,104,,,12,12,10,2
Naz Reid,C-F,22023,1629675,22300186,"NOV 12, 2023",MIN @ GSW,W,19,3,8,0.375,2,5,0.4,2,2,1.0,1,5,6,2,0,0,2,2,10,10,1,MIN,GSW,MIN,116,,,18,16,12,8
Naz Reid,C-F,22023,1629675,22300013,"NOV 10, 2023",MIN @ SAS,W,18,3,7,0.429,1,3,0.333,0,0,0.0,1,2,3,0,0,2,0,1,7,7,1,MIN,SAS,MIN,117,,,10,10,7,3
Naz Reid,C-F,22023,1629675,22300166,"NOV 08, 2023",MIN vs. NOP,W,22,4,8,0.5,1,4,0.25,0,0,0.0,1,3,4,0,1,0,0,2,9,17,1,MIN,MIN,NOP,122,,,13,13,9,4
Naz Reid,C-F,22023,1629675,22300154,"NOV 06, 2023",MIN vs. BOS,W,25,5,9,0.556,2,4,0.5,2,2,1.0,1,3,4,2,2,2,3,0,14,-2,1,MIN,MIN,BOS,114,,,20,18,16,6
Naz Reid,C-F,22023,1629675,22300138,"NOV 04, 2023",MIN vs. UTA,W,22,5,9,0.556,3,5,0.6,3,4,0.75,2,3,5,1,0,0,1,0,16,9,1,MIN,MIN,UTA,123,,,22,21,17,6
Naz Reid,C-F,22023,1629675,22300123,"NOV 01, 2023",MIN vs. DEN,W,19,6,9,0.667,1,3,0.333,3,3,1.0,1,4,5,1,1,0,1,0,16,4,1,MIN,MIN,DEN,110,,,22,21,17,6
Naz Reid,C-F,22023,1629675,22300104,"OCT 30, 2023",MIN @ ATL,L,24,5,12,0.417,3,7,0.429,0,0,0.0,0,1,1,0,0,0,1,1,13,-21,1,MIN,ATL,MIN,113,,,14,14,13,1
Naz Reid,C-F,22023,1629675,22300093,"OCT 28, 2023",MIN vs. MIA,W,28,10,14,0.714,4,7,0.571,1,1,1.0,1,7,8,1,2,0,0,3,25,30,1,MIN,MIN,MIA,106,,,34,33,26,9
Naz Reid,C-F,22023,1629675,22300069,"OCT 25, 2023",MIN @ TOR,L,24,3,8,0.375,0,2,0.0,4,4,1.0,1,3,4,1,0,0,1,0,10,1,1,MIN,TOR,MIN,94,,,15,14,11,5
Deni Avdija,F,22023,1630166,22300753,"FEB 10, 2024",WAS vs. PHI,L,39,9,14,0.643,1,4,0.25,2,2,1.0,0,13,13,5,0,1,5,2,21,-2,1,WAS,WAS,PHI,113,,,39,34,26,18
Deni Avdija,F,22023,1630166,22300743,"FEB 09, 2024",WAS @ BOS,L,42,7,10,0.7,3,5,0.6,7,8,0.875,0,11,11,4,2,0,3,5,24,12,1,WAS,BOS,WAS,129,,,39,35,28,15
Deni Avdija,F,22023,1630166,22300728,"FEB 07, 2024",WAS vs. CLE,L,20,3,10,0.3,1,3,0.333,2,4,0.5,2,6,8,3,0,0,2,0,9,-10,1,WAS,WAS,CLE,106,,,20,17,12,11
Deni Avdija,F,22023,1630166,22300705,"FEB 04, 2024",WAS vs. PHX,L,25,10,13,0.769,3,5,0.6,1,4,0.25,1,2,3,1,1,1,5,3,24,-15,1,WAS,WAS,PHX,109,,,28,27,25,4
Deni Avdija,F,22023,1630166,22300689,"FEB 02, 2024",WAS vs. MIA,L,35,6,8,0.75,1,2,0.5,2,3,0.667,1,7,8,2,0,0,3,5,15,-1,1,WAS,WAS,MIA,102,,,25,23,17,10
Deni Avdija,F,22023,1630166,22300676,"JAN 31, 2024",WAS vs. LAC,L,26,5,11,0.455,1,2,0.5,2,3,0.667,0,5,5,3,1,1,2,2,13,-33,1,WAS,WAS,LAC,107,,,21,18,16,8
Deni Avdija,F,22023,1630166,22300665,"JAN 29, 2024",WAS @ SAS,W,25,3,6,0.5,0,0,0.0,3,5,0.6,2,6,8,5,1,1,3,3,9,-13,1,WAS,SAS,WAS,118,,,22,17,14,13
Deni Avdija,F,22023,1630166,22300642,"JAN 27, 2024",WAS @ DET,W,24,4,8,0.5,1,1,1.0,1,2,0.5,1,4,5,2,0,1,0,3,10,18,1,WAS,DET,WAS,118,,,17,15,12,7
Deni Avdija,F,22023,1630166,22300628,"JAN 25, 2024",WAS vs. UTA,L,27,5,9,0.556,1,1,1.0,2,2,1.0,0,6,6,5,1,1,3,1,13,-1,1,WAS,WAS,UTA,108,,,24,19,18,11
Deni Avdija,F,22023,1630166,22300620,"JAN 24, 2024",WAS vs. MIN,L,38,7,12,0.583,4,5,0.8,6,6,1.0,0,6,6,6,0,0,2,3,24,-16,1,WAS,WAS,MIN,107,,,36,30,30,12
Deni Avdija,F,22023,1630166,22300602,"JAN 21, 2024",WAS vs. DEN,L,18,1,5,0.2,0,1,0.0,2,4,0.5,0,8,8,3,0,1,2,1,4,-2,1,WAS,WAS,DEN,104,,,15,12,7,11
Deni Avdija,F,22023,1630166,22300594,"JAN 20, 2024",WAS vs. SAS,L,32,7,11,0.636,1,3,0.333,1,1,1.0,0,7,7,4,1,0,1,2,16,8,1,WAS,WAS,SAS,127,,,27,23,20,11
Deni Avdija,F,22023,1630166,22300579,"JAN 18, 2024",WAS @ NYK,L,26,5,13,0.385,0,3,0.0,5,5,1.0,2,6,8,1,0,0,2,6,15,-16,1,WAS,NYK,WAS,109,,,24,23,16,9
Deni Avdija,F,22023,1630166,22300558,"JAN 15, 2024",WAS vs. DET,L,28,4,8,0.5,1,2,0.5,3,4,0.75,0,2,2,4,0,2,3,1,12,-2,1,WAS,WAS,DET,117,,,18,14,16,6
Deni Avdija,F,22023,1630166,22300543,"JAN 13, 2024",WAS @ ATL,W,37,7,12,0.583,1,2,0.5,4,5,0.8,1,13,14,9,1,1,3,5,19,11,1,WAS,ATL,WAS,125,,,42,33,28,23
Deni Avdija,F,22023,1630166,22300520,"JAN 10, 2024",WAS @ IND,L,25,4,10,0.4,1,3,0.333,6,7,0.857,0,5,5,1,1,0,1,5,15,2,1,WAS,IND,WAS,104,,,21,20,16,6
Deni Avdija,F,22023,1630166,22300508,"JAN 08, 2024",WAS vs. OKC,L,33,5,8,0.625,2,3,0.667,5,6,0.833,0,4,4,4,1,0,4,4,17,-20,1,WAS,WAS,OKC,128,,,25,21,21,8
Deni Avdija,F,22023,1630166,22300494,"JAN 06, 2024",WAS vs. NYK,L,33,9,13,0.692,2,4,0.5,3,5,0.6,3,7,10,6,2,0,4,5,23,-7,1,WAS,WAS,NYK,105,,,39,33,29,16
Deni Avdija,F,22023,1630166,22300482,"JAN 05, 2024",WAS @ CLE,L,26,5,8,0.625,0,1,0.0,3,4,0.75,0,5,5,4,2,1,3,4,13,-22,1,WAS,CLE,WAS,90,,,22,18,17,9
Deni Avdija,F,22023,1630166,22300465,"JAN 03, 2024",WAS @ CLE,L,21,3,11,0.273,1,3,0.333,0,0,0.0,2,4,6,4,1,0,3,1,7,-17,1,WAS,CLE,WAS,101,,,17,13,11,10
Deni Avdija,F,22023,1630166,22300445,"DEC 31, 2023",WAS vs. ATL,L,31,5,9,0.556,2,6,0.333,5,8,0.625,1,11,12,2,1,1,3,5,17,14,1,WAS,WAS,ATL,126,,,31,29,19,14
Deni Avdija,F,22023,1630166,22300430,"DEC 29, 2023",WAS vs. BKN,W,34,9,18,0.5,3,5,0.6,0,4,0.0,2,11,13,6,1,1,1,2,21,13,1,WAS,WAS,BKN,110,,,40,34,27,19
Deni Avdija,F,22023,1630166,22300416,"DEC 27, 2023",WAS vs. TOR,L,24,5,8,0.625,1,1,1.0,1,2,0.5,0,2,2,1,2,0,0,1,12,-12,1,WAS,WAS,TOR,102,,,15,14,13,3
Deni Avdija,F,22023,1630166,22300407,"DEC 26, 2023",WAS vs. ORL,L,23,1,7,0.143,0,4,0.0,0,0,0.0,0,5,5,3,3,1,2,1,2,-10,1,WAS,WAS,ORL,119,,,10,7,5,8
Deni Avdija,F,22023,1630166,22300386,"DEC 22, 2023",WAS @ GSW,L,20,2,5,0.4,0,0,0.0,3,3,1.0,2,2,4,4,1,0,0,1,7,0,1,WAS,GSW,WAS,118,,,15,11,11,8
Deni Avdija,F,22023,1630166,22300381,"DEC 21, 2023",WAS @ POR,W,35,4,7,0.571,0,1,0.0,5,7,0.714,2,9,11,6,1,0,2,1,13,9,1,WAS,POR,WAS,118,,,30,24,19,17
Deni Avdija,F,22023,1630166,22300358,"DEC 18, 2023",WAS @ SAC,L,23,3,8,0.375,1,3,0.333,2,4,0.5,0,5,5,3,1,0,2,5,9,-23,1,WAS,SAC,WAS,131,,,17,14,12,8
Deni Avdija,F,22023,1630166,22300347,"DEC 17, 2023",WAS @ PHX,L,32,2,6,0.333,0,1,0.0,3,4,0.75,0,6,6,2,0,0,2,5,7,7,1,WAS,PHX,WAS,108,,,15,13,9,8
Deni Avdija,F,22023,1630166,22300328,"DEC 15, 2023",WAS vs. IND,W,25,2,9,0.222,0,0,0.0,2,2,1.0,1,5,6,4,0,0,1,0,6,1,1,WAS,WAS,IND,137,,,16,12,10,10
Deni Avdija,F,22023,1630166,22300311,"DEC 13, 2023",WAS vs. NOP,L,30,4,8,0.5,1,3,0.333,4,4,1.0,0,5,5,7,0,0,2,1,13,-4,1,WAS,WAS,NOP,122,,,25,18,20,12
Deni Avdija,F,22023,1630166,22300295,"DEC 11, 2023",WAS @ PHI,L,26,3,8,0.375,1,3,0.333,2,2,1.0,2,4,6,3,1,0,3,1,9,-31,1,WAS,PHI,WAS,99,,,18,15,12,9
Deni Avdija,F,22023,1630166,22301219,"DEC 08, 2023",WAS @ BKN,L,27,6,9,0.667,1,4,0.25,2,3,0.667,0,7,7,4,1,2,0,1,15,-6,1,WAS,BKN,WAS,97,,,26,22,19,11
Deni Avdija,F,22023,1630166,22301208,"DEC 06, 2023",WAS vs. PHI,L,31,4,10,0.4,0,4,0.0,0,0,0.0,0,8,8,8,0,1,2,2,8,6,1,WAS,WAS,PHI,126,,,24,16,16,16
Deni Avdija,F,22023,1630166,22300274,"DEC 01, 2023",WAS @ ORL,L,20,2,7,0.286,0,2,0.0,2,2,1.0,0,3,3,5,0,0,0,1,6,-5,1,WAS,ORL,WAS,125,,,14,9,11,8
Deni Avdija,F,22023,1630166,22300259,"NOV 29, 2023",WAS @ ORL,L,28,9,12,0.75,1,2,0.5,3,4,0.75,3,1,4,5,2,0,0,1,22,-9,1,WAS,ORL,WAS,120,,,31,26,27,9
Deni Avdija,F,22023,1630166,22300253,"NOV 27, 2023",WAS @ DET,W,26,6,9,0.667,1,3,0.333,3,3,1.0,0,6,6,5,0,0,3,3,16,1,1,WAS,DET,WAS,126,,,27,22,21,11
Deni Avdija,F,22023,1630166,22300241,"NOV 25, 2023",WAS vs. ATL,L,17,3,8,0.375,1,4,0.25,2,2,1.0,1,5,6,2,0,0,3,2,9,-17,1,WAS,WAS,ATL,108,,,17,15,11,8
Deni Avdija,F,22023,1630166,22300049,"NOV 24, 2023",WAS @ MIL,L,28,1,6,0.167,0,0,0.0,0,0,0.0,2,3,5,5,0,0,0,3,2,-2,1,WAS,MIL,WAS,128,,,12,7,7,10
Deni Avdija,F,22023,1630166,22300225,"NOV 22, 2023",WAS @ CHA,L,28,5,9,0.556,1,2,0.5,2,2,1.0,2,3,5,1,0,0,1,0,13,3,1,WAS,CHA,WAS,114,,,19,18,14,6
Deni Avdija,F,22023,1630166,22300219,"NOV 20, 2023",WAS vs. MIL,L,31,3,5,0.6,0,1,0.0,1,2,0.5,1,3,4,2,0,1,0,3,7,-28,1,WAS,WAS,MIL,129,,,13,11,9,6
Deni Avdija,F,22023,1630166,22300028,"NOV 17, 2023",WAS vs. NYK,L,32,7,11,0.636,2,4,0.5,2,2,1.0,0,4,4,2,1,1,3,4,18,-6,1,WAS,WAS,NYK,99,,,24,22,20,6
Deni Avdija,F,22023,1630166,22300192,"NOV 15, 2023",WAS vs. DAL,L,24,5,6,0.833,3,4,0.75,2,2,1.0,1,2,3,4,3,0,0,4,15,1,1,WAS,WAS,DAL,117,,,22,18,19,7
Deni Avdija,F,22023,1630166,22300189,"NOV 13, 2023",WAS @ TOR,L,30,4,7,0.571,1,1,1.0,0,0,0.0,1,7,8,6,0,0,4,2,9,-2,1,WAS,TOR,WAS,107,,,23,17,15,14
Deni Avdija,F,22023,1630166,22300178,"NOV 12, 2023",WAS @ BKN,L,38,6,18,0.333,1,8,0.125,1,2,0.5,2,7,9,3,3,0,2,2,14,-1,1,WAS,BKN,WAS,94,,,26,23,17,12
Deni Avdija,F,22023,1630166,22300009,"NOV 10, 2023",WAS vs. CHA,L,31,5,9,0.556,1,4,0.25,0,0,0.0,1,5,6,5,1,1,3,2,11,9,1,WAS,WAS,CHA,117,,,22,17,16,11
Deni Avdija,F,22023,1630166,22300157,"NOV 08, 2023",WAS @ CHA,W,28,3,10,0.3,0,1,0.0,3,3,1.0,1,2,3,5,0,1,1,4,9,-5,1,WAS,CHA,WAS,132,,,17,12,14,8
Deni Avdija,F,22023,1630166,22300148,"NOV 06, 2023",WAS @ PHI,L,28,5,8,0.625,2,4,0.5,4,4,1.0,1,4,5,6,1,0,1,1,16,-11,1,WAS,PHI,WAS,128,,,27,21,22,11
Deni Avdija,F,22023,1630166,22300003,"NOV 03, 2023",WAS @ MIA,L,24,6,8,0.75,1,2,0.5,1,2,0.5,0,4,4,3,0,0,2,1,14,-14,1,WAS,MIA,WAS,114,,,21,18,17,7
Deni Avdija,F,22023,1630166,22300117,"NOV 01, 2023",WAS @ ATL,L,24,10,16,0.625,2,4,0.5,0,1,0.0,3,2,5,3,2,1,1,5,22,3,1,WAS,ATL,WAS,121,,,30,27,25,8
Deni Avdija,F,22023,1630166,22300103,"OCT 30, 2023",WAS vs. BOS,L,22,4,10,0.4,1,3,0.333,2,2,1.0,2,5,7,1,1,0,0,4,11,-26,1,WAS,WAS,BOS,107,,,19,18,12,8
Deni Avdija,F,22023,1630166,22300089,"OCT 28, 2023",WAS vs. MEM,W,27,4,8,0.5,2,3,0.667,0,0,0.0,2,4,6,2,2,0,1,2,10,9,1,WAS,WAS,MEM,113,,,18,16,12,8
Deni Avdija,F,22023,1630166,22300064,"OCT 25, 2023",WAS @ IND,L,21,4,8,0.5,0,0,0.0,1,2,0.5,2,5,7,5,1,0,2,0,9,-15,1,WAS,IND,WAS,120,,,21,16,14,12
Aaron Nesmith,G-F,22023,1630174,22300533,"JAN 12, 2024",IND @ ATL,W,21,5,6,0.833,3,3,1.0,0,0,0.0,1,3,4,0,1,0,1,3,13,1,1,IND,ATL,IND,126,,,17,17,13,4
Aaron Nesmith,G-F,22023,1630174,22300520,"JAN 10, 2024",IND vs. WAS,W,24,3,9,0.333,2,5,0.4,2,2,1.0,0,3,3,1,0,0,0,1,10,1,1,IND,IND,WAS,112,,,14,13,11,4
Aaron Nesmith,G-F,22023,1630174,22300507,"JAN 08, 2024",IND vs. BOS,W,26,6,10,0.6,3,5,0.6,2,3,0.667,2,2,4,2,0,1,0,2,17,1,1,IND,IND,BOS,133,,,23,21,19,6
Aaron Nesmith,G-F,22023,1630174,22300480,"JAN 05, 2024",IND vs. ATL,W,22,7,11,0.636,1,2,0.5,0,0,0.0,0,2,2,3,1,1,2,3,15,25,1,IND,IND,ATL,148,,,20,17,18,5
Aaron Nesmith,G-F,22023,1630174,22300466,"JAN 03, 2024",IND vs. MIL,W,22,4,4,1.0,1,1,1.0,0,0,0.0,0,4,4,2,3,0,0,2,9,18,1,IND,IND,MIL,142,,,15,13,11,6
Aaron Nesmith,G-F,22023,1630174,22300377,"DEC 21, 2023",IND @ MEM,L,28,5,12,0.417,4,8,0.5,0,0,0.0,1,4,5,0,4,3,2,1,14,-23,1,IND,MEM,IND,103,,,19,19,14,5
Aaron Nesmith,G-F,22023,1630174,22300365,"DEC 20, 2023",IND vs. CHA,W,23,6,6,1.0,4,4,1.0,3,3,1.0,0,2,2,1,1,0,1,1,19,8,1,IND,IND,CHA,142,,,22,21,20,3
Aaron Nesmith,G-F,22023,1630174,22300350,"DEC 18, 2023",IND vs. LAC,L,26,4,7,0.571,2,3,0.667,2,2,1.0,1,5,6,2,2,3,1,3,12,0,1,IND,IND,LAC,127,,,20,18,14,8
Aaron Nesmith,G-F,22023,1630174,22300338,"DEC 16, 2023",IND @ MIN,L,26,7,14,0.5,2,4,0.5,1,1,1.0,3,2,5,0,0,1,0,1,17,-15,1,IND,MIN,IND,109,,,22,22,17,5
Aaron Nesmith,G-F,22023,1630174,22300328,"DEC 15, 2023",IND @ WAS,L,24,4,10,0.4,3,8,0.375,1,3,0.333,2,1,3,1,2,1,0,5,12,-6,1,IND,WAS,IND,123,,,16,15,13,4
Aaron Nesmith,G-F,22023,1630174,22300315,"DEC 13, 2023",IND @ MIL,L,25,5,11,0.455,2,7,0.286,0,0,0.0,1,0,1,1,0,0,2,5,12,-20,1,IND,MIL,IND,126,,,14,13,13,2
Aaron Nesmith,G-F,22023,1630174,22300293,"DEC 11, 2023",IND @ DET,W,27,5,7,0.714,3,4,0.75,0,0,0.0,0,1,1,1,0,0,2,3,13,6,1,IND,DET,IND,131,,,15,14,14,2
Aaron Nesmith,G-F,22023,1630174,22301229,"DEC 07, 2023",IND @ MIL,W,27,2,6,0.333,1,4,0.25,1,1,1.0,0,1,1,1,0,1,0,5,6,16,1,IND,MIL,IND,128,,,8,7,7,2
Aaron Nesmith,G-F,22023,1630174,22301202,"DEC 04, 2023",IND vs. BOS,W,31,6,10,0.6,1,3,0.333,1,2,0.5,0,1,1,1,0,1,1,3,14,2,1,IND,IND,BOS,122,,,16,15,15,2
Aaron Nesmith,G-F,22023,1630174,22300284,"DEC 02, 2023",IND @ MIA,W,29,7,9,0.778,4,6,0.667,4,6,0.667,0,4,4,1,0,1,0,4,22,9,1,IND,MIA,IND,144,,,27,26,23,5
Aaron Nesmith,G-F,22023,1630174,22300267,"NOV 30, 2023",IND @ MIA,L,23,4,5,0.8,0,1,0.0,1,1,1.0,3,2,5,1,4,0,1,6,9,-2,1,IND,MIA,IND,132,,,15,14,10,6
Aaron Nesmith,G-F,22023,1630174,22300254,"NOV 27, 2023",IND vs. POR,L,25,3,6,0.5,1,3,0.333,0,1,0.0,1,2,3,0,3,0,2,4,7,-6,1,IND,IND,POR,110,,,10,10,7,3
Aaron Nesmith,G-F,22023,1630174,22300039,"NOV 21, 2023",IND @ ATL,W,25,6,9,0.667,1,3,0.333,4,5,0.8,1,0,1,1,1,1,0,4,17,4,1,IND,ATL,IND,157,,,19,18,18,2
Aaron Nesmith,G-F,22023,1630174,22300209,"NOV 19, 2023",IND vs. ORL,L,15,0,2,0.0,0,0,0.0,0,0,0.0,0,1,1,0,0,0,0,2,0,-22,1,IND,IND,ORL,116,,,1,1,0,1
Aaron Nesmith,G-F,22023,1630174,22300019,"NOV 14, 2023",IND @ PHI,W,22,2,8,0.25,1,5,0.2,1,2,0.5,0,4,4,2,1,1,1,4,6,-10,1,IND,PHI,IND,132,,,12,10,8,6
Aaron Nesmith,G-F,22023,1630174,22300180,"NOV 12, 2023",IND @ PHI,L,26,3,6,0.5,2,5,0.4,0,0,0.0,1,3,4,3,1,0,0,3,8,2,1,IND,PHI,IND,126,,,15,12,11,7
Aaron Nesmith,G-F,22023,1630174,22300171,"NOV 09, 2023",IND vs. MIL,W,16,2,4,0.5,2,3,0.667,0,0,0.0,0,1,1,0,0,0,1,5,6,-22,1,IND,IND,MIL,126,,,7,7,6,1
Aaron Nesmith,G-F,22023,1630174,22300158,"NOV 08, 2023",IND vs. UTA,W,30,9,13,0.692,4,6,0.667,2,2,1.0,1,1,2,0,2,0,1,4,24,14,1,IND,IND,UTA,134,,,26,26,24,2
Aaron Nesmith,G-F,22023,1630174,22300146,"NOV 06, 2023",IND vs. SAS,W,16,5,8,0.625,3,4,0.75,2,2,1.0,1,1,2,2,2,0,0,0,15,17,1,IND,IND,SAS,152,,,19,17,17,4
Aaron Nesmith,G-F,22023,1630174,22300133,"NOV 04, 2023",IND vs. CHA,L,25,1,5,0.2,1,1,1.0,1,2,0.5,0,2,2,1,1,2,0,0,4,-9,1,IND,IND,CHA,124,,,7,6,5,3
Aaron Nesmith,G-F,22023,1630174,22300001,"NOV 03, 2023",IND vs. CLE,W,27,5,8,0.625,2,4,0.5,1,4,0.25,1,4,5,0,2,1,2,3,13,1,1,IND,IND,CLE,121,,,18,18,13,5
Aaron Nesmith,G-F,22023,1630174,22300118,"NOV 01, 2023",IND @ BOS,L,19,4,9,0.444,1,6,0.167,0,1,0.0,1,0,1,1,0,0,0,4,9,-10,1,IND,BOS,IND,104,,,11,10,10,2
Aaron Nesmith,G-F,22023,1630174,22300102,"OCT 30, 2023",IND vs. CHI,L,27,1,4,0.25,1,4,0.25,2,2,1.0,0,4,4,3,0,2,0,6,5,-15,1,IND,IND,CHI,105,,,12,9,8,7
Aaron Nesmith,G-F,22023,1630174,22300091,"OCT 28, 2023",IND @ CLE,W,30,10,16,0.625,5,9,0.556,1,2,0.5,4,5,9,0,0,0,0,1,26,18,1,IND,CLE,IND,125,,,35,35,26,9
Aaron Nesmith,G-F,22023,1630174,22300064,"OCT 25, 2023",IND vs. WAS,W,23,2,5,0.4,1,3,0.333,2,2,1.0,1,4,5,1,0,1,1,3,7,13,1,IND,IND,WAS,143,,,13,12,8,6
Aaron Nesmith,G-F,22023,1630174,22300707,"FEB 04, 2024",IND @ CHA,W,34,8,11,0.727,3,5,0.6,3,3,1.0,1,7,8,4,1,0,2,3,22,19,1,IND,CHA,IND,115,,,34,30,26,12
Aaron Nesmith,G-F,22023,1630174,22300627,"JAN 25, 2024",IND vs. PHI,W,29,6,8,0.75,3,3,1.0,1,1,1.0,1,7,8,3,0,0,1,2,16,21,1,IND,IND,PHI,134,,,27,24,19,11
Aaron Nesmith,G-F,22023,1630174,22300493,"JAN 06, 2024",IND vs. BOS,L,32,3,13,0.231,0,7,0.0,2,2,1.0,1,3,4,0,3,1,0,2,8,-5,1,IND,IND,BOS,101,,,12,12,8,4
Aaron Nesmith,G-F,22023,1630174,22300755,"FEB 10, 2024",IND @ NYK,W,31,5,12,0.417,3,7,0.429,0,0,0.0,1,2,3,0,0,0,1,4,13,12,1,IND,NYK,IND,125,,,16,16,13,3
Aaron Nesmith,G-F,22023,1630174,22300733,"FEB 08, 2024",IND vs. GSW,L,26,4,7,0.571,1,3,0.333,4,6,0.667,1,3,4,1,5,1,2,2,13,-9,1,IND,IND,GSW,109,,,18,17,14,5
Aaron Nesmith,G-F,22023,1630174,22300719,"FEB 06, 2024",IND vs. HOU,W,33,3,6,0.5,2,4,0.5,2,4,0.5,1,0,1,1,1,1,3,5,10,1,1,IND,IND,HOU,132,,,12,11,11,2
Aaron Nesmith,G-F,22023,1630174,22300691,"FEB 02, 2024",IND vs. SAC,L,27,3,7,0.429,0,2,0.0,0,0,0.0,1,3,4,2,1,1,1,6,6,0,1,IND,IND,SAC,122,,,12,10,8,6
Aaron Nesmith,G-F,22023,1630174,22300685,"FEB 01, 2024",IND @ NYK,L,37,6,13,0.462,3,6,0.5,2,2,1.0,1,5,6,1,1,0,2,6,17,2,1,IND,NYK,IND,105,,,24,23,18,7
Aaron Nesmith,G-F,22023,1630174,22300670,"JAN 30, 2024",IND @ BOS,L,41,11,17,0.647,4,7,0.571,0,0,0.0,3,9,12,7,0,1,0,3,26,-3,1,IND,BOS,IND,124,,,45,38,33,19
Aaron Nesmith,G-F,22023,1630174,22300590,"JAN 19, 2024",IND @ POR,L,28,4,9,0.444,3,4,0.75,1,2,0.5,1,3,4,2,0,0,2,6,12,15,1,IND,POR,IND,115,,,18,16,14,6
Aaron Nesmith,G-F,22023,1630174,22300454,"JAN 01, 2024",IND @ MIL,W,27,1,10,0.1,1,7,0.143,1,2,0.5,1,4,5,0,3,2,0,4,4,-11,1,IND,MIL,IND,122,,,9,9,4,5
Aaron Nesmith,G-F,22023,1630174,22300441,"DEC 30, 2023",IND vs. NYK,W,31,8,13,0.615,7,11,0.636,2,2,1.0,0,1,1,2,1,0,2,2,25,10,1,IND,IND,NYK,140,,,28,26,27,3
Aaron Nesmith,G-F,22023,1630174,22300422,"DEC 28, 2023",IND @ CHI,W,34,4,9,0.444,4,6,0.667,0,0,0.0,0,5,5,1,1,2,1,4,12,25,1,IND,CHI,IND,120,,,18,17,13,6
Aaron Nesmith,G-F,22023,1630174,22300409,"DEC 26, 2023",IND @ HOU,W,30,3,6,0.5,2,4,0.5,2,2,1.0,1,4,5,2,0,0,3,5,10,17,1,IND,HOU,IND,123,,,17,15,12,7
Aaron Nesmith,G-F,22023,1630174,22300391,"DEC 23, 2023",IND vs. ORL,L,28,1,5,0.2,1,4,0.25,0,0,0.0,1,2,3,2,2,0,4,6,3,-20,1,IND,IND,ORL,110,,,8,6,5,5
Aaron Nesmith,G-F,22023,1630174,22300652,"JAN 28, 2024",IND vs. MEM,W,37,6,11,0.545,2,6,0.333,2,3,0.667,1,6,7,6,2,1,1,3,16,-1,1,IND,IND,MEM,116,,,29,23,22,13
Aaron Nesmith,G-F,22023,1630174,22300636,"JAN 26, 2024",IND vs. PHX,W,34,8,13,0.615,3,6,0.5,3,4,0.75,1,5,6,3,1,1,1,4,22,7,1,IND,IND,PHX,133,,,31,28,25,9
Aaron Nesmith,G-F,22023,1630174,22300614,"JAN 23, 2024",IND vs. DEN,L,34,5,13,0.385,1,7,0.143,2,2,1.0,4,5,9,0,0,0,1,3,13,-4,1,IND,IND,DEN,109,,,22,22,13,9
Aaron Nesmith,G-F,22023,1630174,22300604,"JAN 21, 2024",IND @ PHX,L,26,2,7,0.286,1,5,0.2,1,3,0.333,1,2,3,1,1,0,0,4,6,-9,1,IND,PHX,IND,110,,,10,9,7,4
Tyus Jones,G,22023,1626145,22300753,"FEB 10, 2024",WAS vs. PHI,L,31,9,14,0.643,6,9,0.667,1,1,1.0,0,3,3,9,1,0,1,2,25,-5,1,WAS,WAS,PHI,113,,,37,28,34,12
Tyus Jones,G,22023,1626145,22300743,"FEB 09, 2024",WAS @ BOS,L,37,7,13,0.538,3,3,1.0,0,0,0.0,0,2,2,9,0,1,1,1,17,7,1,WAS,BOS,WAS,129,,,28,19,26,11
Tyus Jones,G,22023,1626145,22300728,"FEB 07, 2024",WAS vs. CLE,L,29,6,10,0.6,3,4,0.75,0,0,0.0,0,3,3,8,1,0,1,1,15,-5,1,WAS,WAS,CLE,106,,,26,18,23,11
Tyus Jones,G,22023,1626145,22300705,"FEB 04, 2024",WAS vs. PHX,L,24,7,15,0.467,0,3,0.0,0,0,0.0,0,1,1,8,1,0,2,0,14,-20,1,WAS,WAS,PHX,109,,,23,15,22,9
Tyus Jones,G,22023,1626145,22300689,"FEB 02, 2024",WAS vs. MIA,L,26,2,7,0.286,0,2,0.0,2,2,1.0,0,1,1,6,1,0,1,2,6,-15,1,WAS,WAS,MIA,102,,,13,7,12,7
Tyus Jones,G,22023,1626145,22300676,"JAN 31, 2024",WAS vs. LAC,L,29,2,9,0.222,0,3,0.0,0,0,0.0,0,4,4,7,0,0,3,1,4,-18,1,WAS,WAS,LAC,107,,,15,8,11,11
Tyus Jones,G,22023,1626145,22300665,"JAN 29, 2024",WAS @ SAS,W,32,7,16,0.438,1,4,0.25,0,0,0.0,1,1,2,9,2,1,1,0,15,5,1,WAS,SAS,WAS,118,,,26,17,24,11
Tyus Jones,G,22023,1626145,22300642,"JAN 27, 2024",WAS @ DET,W,30,5,12,0.417,1,4,0.25,1,1,1.0,0,1,1,9,2,1,1,1,12,9,1,WAS,DET,WAS,118,,,22,13,21,10
Tyus Jones,G,22023,1626145,22300628,"JAN 25, 2024",WAS vs. UTA,L,34,5,12,0.417,2,4,0.5,0,0,0.0,0,6,6,14,1,0,0,1,12,-8,1,WAS,WAS,UTA,108,,,32,18,26,20
Tyus Jones,G,22023,1626145,22300620,"JAN 24, 2024",WAS vs. MIN,L,32,2,7,0.286,0,2,0.0,1,2,0.5,0,2,2,6,0,0,0,1,5,-9,1,WAS,WAS,MIN,107,,,13,7,11,8
Tyus Jones,G,22023,1626145,22300602,"JAN 21, 2024",WAS vs. DEN,L,31,6,14,0.429,3,4,0.75,0,0,0.0,1,1,2,13,1,0,1,0,15,-11,1,WAS,WAS,DEN,104,,,30,17,28,15
Tyus Jones,G,22023,1626145,22300594,"JAN 20, 2024",WAS vs. SAS,L,28,5,12,0.417,1,2,0.5,2,2,1.0,0,2,2,6,1,0,1,2,13,-18,1,WAS,WAS,SAS,127,,,21,15,19,8
Tyus Jones,G,22023,1626145,22300579,"JAN 18, 2024",WAS @ NYK,L,37,1,6,0.167,0,3,0.0,0,0,0.0,0,4,4,15,3,0,1,2,2,-2,1,WAS,NYK,WAS,109,,,21,6,17,19
Tyus Jones,G,22023,1626145,22300558,"JAN 15, 2024",WAS vs. DET,L,31,9,19,0.474,4,10,0.4,0,0,0.0,2,4,6,7,1,0,0,0,22,-15,1,WAS,WAS,DET,117,,,35,28,29,13
Tyus Jones,G,22023,1626145,22300543,"JAN 13, 2024",WAS @ ATL,W,26,4,9,0.444,0,3,0.0,0,0,0.0,1,2,3,7,1,1,0,0,8,18,1,WAS,ATL,WAS,125,,,18,11,15,10
Tyus Jones,G,22023,1626145,22300520,"JAN 10, 2024",WAS @ IND,L,34,5,12,0.417,1,5,0.2,0,0,0.0,1,3,4,4,0,1,2,2,11,-5,1,WAS,IND,WAS,104,,,19,15,15,8
Tyus Jones,G,22023,1626145,22300508,"JAN 08, 2024",WAS vs. OKC,L,31,7,10,0.7,3,5,0.6,1,2,0.5,0,0,0,9,3,0,2,1,18,0,1,WAS,WAS,OKC,128,,,27,18,27,9
Tyus Jones,G,22023,1626145,22300494,"JAN 06, 2024",WAS vs. NYK,L,28,4,13,0.308,2,6,0.333,1,2,0.5,0,1,1,8,0,0,2,0,11,-1,1,WAS,WAS,NYK,105,,,20,12,19,9
Tyus Jones,G,22023,1626145,22300482,"JAN 05, 2024",WAS @ CLE,L,26,6,10,0.6,4,6,0.667,0,0,0.0,0,1,1,5,2,0,1,0,16,-17,1,WAS,CLE,WAS,90,,,22,17,21,6
Tyus Jones,G,22023,1626145,22300465,"JAN 03, 2024",WAS @ CLE,L,21,4,11,0.364,1,2,0.5,0,0,0.0,0,2,2,2,1,1,0,0,9,-12,1,WAS,CLE,WAS,101,,,13,11,11,4
Tyus Jones,G,22023,1626145,22300445,"DEC 31, 2023",WAS vs. ATL,L,27,5,11,0.455,3,7,0.429,1,1,1.0,0,0,0,8,1,1,1,1,14,5,1,WAS,WAS,ATL,126,,,22,14,22,8
Tyus Jones,G,22023,1626145,22300430,"DEC 29, 2023",WAS vs. BKN,W,31,6,9,0.667,0,0,0.0,0,0,0.0,1,3,4,6,0,0,0,0,12,-12,1,WAS,WAS,BKN,110,,,22,16,18,10
Tyus Jones,G,22023,1626145,22300416,"DEC 27, 2023",WAS vs. TOR,L,31,5,12,0.417,1,6,0.167,0,0,0.0,1,1,2,5,2,0,1,2,11,-20,1,WAS,WAS,TOR,102,,,18,13,16,7
Tyus Jones,G,22023,1626145,22300407,"DEC 26, 2023",WAS vs. ORL,L,34,8,13,0.615,4,6,0.667,2,2,1.0,0,6,6,6,1,1,2,0,22,0,1,WAS,WAS,ORL,119,,,34,28,28,12
Tyus Jones,G,22023,1626145,22300386,"DEC 22, 2023",WAS @ GSW,L,25,6,8,0.75,2,2,1.0,0,0,0.0,1,2,3,6,1,0,0,0,14,-12,1,WAS,GSW,WAS,118,,,23,17,20,9
Tyus Jones,G,22023,1626145,22300381,"DEC 21, 2023",WAS @ POR,W,36,9,15,0.6,5,7,0.714,1,2,0.5,0,3,3,3,1,0,2,1,24,6,1,WAS,POR,WAS,118,,,30,27,27,6
Tyus Jones,G,22023,1626145,22300358,"DEC 18, 2023",WAS @ SAC,L,28,7,10,0.7,2,2,1.0,0,0,0.0,0,1,1,9,1,0,0,0,16,-20,1,WAS,SAC,WAS,131,,,26,17,25,10
Tyus Jones,G,22023,1626145,22300347,"DEC 17, 2023",WAS @ PHX,L,39,9,15,0.6,4,6,0.667,0,0,0.0,0,4,4,11,6,1,1,0,22,6,1,WAS,PHX,WAS,108,,,37,26,33,15
Tyus Jones,G,22023,1626145,22300328,"DEC 15, 2023",WAS vs. IND,W,29,6,7,0.857,1,2,0.5,0,0,0.0,0,10,10,11,2,2,2,2,13,7,1,WAS,WAS,IND,137,,,34,23,24,21
Tyus Jones,G,22023,1626145,22300311,"DEC 13, 2023",WAS vs. NOP,L,26,2,6,0.333,2,5,0.4,0,0,0.0,0,0,0,4,1,0,1,0,6,1,1,WAS,WAS,NOP,122,,,10,6,10,4
Tyus Jones,G,22023,1626145,22300295,"DEC 11, 2023",WAS @ PHI,L,21,4,9,0.444,1,5,0.2,0,0,0.0,0,5,5,3,1,0,2,0,9,-17,1,WAS,PHI,WAS,99,,,17,14,12,8
Tyus Jones,G,22023,1626145,22301219,"DEC 08, 2023",WAS @ BKN,L,28,6,10,0.6,0,1,0.0,2,2,1.0,0,2,2,3,1,1,1,0,14,-20,1,WAS,BKN,WAS,97,,,19,16,17,5
Tyus Jones,G,22023,1626145,22301208,"DEC 06, 2023",WAS vs. PHI,L,31,8,11,0.727,2,4,0.5,2,2,1.0,0,3,3,8,1,2,1,0,20,-9,1,WAS,WAS,PHI,126,,,31,23,28,11
Tyus Jones,G,22023,1626145,22300274,"DEC 01, 2023",WAS @ ORL,L,26,5,10,0.5,3,5,0.6,0,0,0.0,0,3,3,6,2,0,0,2,13,-4,1,WAS,ORL,WAS,125,,,22,16,19,9
Tyus Jones,G,22023,1626145,22300259,"NOV 29, 2023",WAS @ ORL,L,21,3,10,0.3,0,2,0.0,1,2,0.5,0,3,3,4,2,0,0,1,7,-8,1,WAS,ORL,WAS,120,,,14,10,11,7
Tyus Jones,G,22023,1626145,22300253,"NOV 27, 2023",WAS @ DET,W,26,5,9,0.556,1,3,0.333,1,2,0.5,1,2,3,4,0,0,0,0,12,7,1,WAS,DET,WAS,126,,,19,15,16,7
Tyus Jones,G,22023,1626145,22300241,"NOV 25, 2023",WAS vs. ATL,L,24,2,6,0.333,0,3,0.0,0,0,0.0,1,1,2,4,0,0,2,1,4,-18,1,WAS,WAS,ATL,108,,,10,6,8,6
Tyus Jones,G,22023,1626145,22300049,"NOV 24, 2023",WAS @ MIL,L,31,9,14,0.643,1,4,0.25,3,3,1.0,0,7,7,7,1,0,0,0,22,3,1,WAS,MIL,WAS,128,,,36,29,29,14
Tyus Jones,G,22023,1626145,22300225,"NOV 22, 2023",WAS @ CHA,L,35,6,12,0.5,1,2,0.5,0,0,0.0,0,1,1,7,2,0,0,1,13,10,1,WAS,CHA,WAS,114,,,21,14,20,8
Tyus Jones,G,22023,1626145,22300219,"NOV 20, 2023",WAS vs. MIL,L,26,9,13,0.692,0,1,0.0,0,0,0.0,0,2,2,3,0,0,0,0,18,9,1,WAS,WAS,MIL,129,,,23,20,21,5
Tyus Jones,G,22023,1626145,22300028,"NOV 17, 2023",WAS vs. NYK,L,30,4,7,0.571,1,2,0.5,2,2,1.0,0,3,3,5,1,0,1,0,11,-18,1,WAS,WAS,NYK,99,,,19,14,16,8
Tyus Jones,G,22023,1626145,22300192,"NOV 15, 2023",WAS vs. DAL,L,22,6,7,0.857,0,1,0.0,0,0,0.0,0,3,3,2,0,0,0,1,12,-20,1,WAS,WAS,DAL,117,,,17,15,14,5
Tyus Jones,G,22023,1626145,22300189,"NOV 13, 2023",WAS @ TOR,L,31,4,11,0.364,2,5,0.4,0,0,0.0,0,3,3,8,0,0,0,1,10,9,1,WAS,TOR,WAS,107,,,21,13,18,11
Tyus Jones,G,22023,1626145,22300178,"NOV 12, 2023",WAS @ BKN,L,23,0,5,0.0,0,1,0.0,0,0,0.0,0,1,1,1,2,0,1,1,0,-16,1,WAS,BKN,WAS,94,,,2,1,1,2
Tyus Jones,G,22023,1626145,22300009,"NOV 10, 2023",WAS vs. CHA,L,34,6,12,0.5,2,4,0.5,2,3,0.667,0,4,4,4,0,1,0,2,16,-29,1,WAS,WAS,CHA,117,,,24,20,20,8
Tyus Jones,G,22023,1626145,22300157,"NOV 08, 2023",WAS @ CHA,W,19,1,6,0.167,0,2,0.0,0,0,0.0,1,5,6,4,1,0,1,1,2,-8,1,WAS,CHA,WAS,132,,,12,8,6,10
Tyus Jones,G,22023,1626145,22300148,"NOV 06, 2023",WAS @ PHI,L,33,5,13,0.385,2,4,0.5,0,0,0.0,0,1,1,6,2,0,0,2,12,-3,1,WAS,PHI,WAS,128,,,19,13,18,7
Tyus Jones,G,22023,1626145,22300003,"NOV 03, 2023",WAS @ MIA,L,24,3,5,0.6,1,2,0.5,0,0,0.0,0,2,2,5,0,0,2,1,7,-14,1,WAS,MIA,WAS,114,,,14,9,12,7
Tyus Jones,G,22023,1626145,22300117,"NOV 01, 2023",WAS @ ATL,L,22,3,6,0.5,0,3,0.0,0,0,0.0,0,1,1,3,1,0,1,1,6,-23,1,WAS,ATL,WAS,121,,,10,7,9,4
Tyus Jones,G,22023,1626145,22300103,"OCT 30, 2023",WAS vs. BOS,L,27,5,9,0.556,1,4,0.25,0,0,0.0,0,3,3,7,1,0,2,0,11,-31,1,WAS,WAS,BOS,107,,,21,14,18,10
Tyus Jones,G,22023,1626145,22300089,"OCT 28, 2023",WAS vs. MEM,W,28,5,12,0.417,4,8,0.5,0,0,0.0,2,0,2,7,2,0,0,2,14,5,1,WAS,WAS,MEM,113,,,23,16,21,9
Tyus Jones,G,22023,1626145,22300064,"OCT 25, 2023",WAS @ IND,L,28,7,12,0.583,2,4,0.5,0,1,0.0,1,2,3,6,1,1,2,1,16,-17,1,WAS,IND,WAS,120,,,25,19,22,9
Bobby Portis,F,22023,1626171,22300745,"FEB 09, 2024",MIL vs. CHA,W,21,7,14,0.5,3,4,0.75,1,1,1.0,2,5,7,1,1,0,1,3,18,13,1,MIL,MIL,CHA,120,,,26,25,19,8
Bobby Portis,F,22023,1626171,22300738,"FEB 08, 2024",MIL vs. MIN,L,29,5,12,0.417,0,2,0.0,2,2,1.0,4,5,9,3,1,0,3,3,12,-21,1,MIL,MIL,MIN,105,,,24,21,15,12
Bobby Portis,F,22023,1626171,22300725,"FEB 06, 2024",MIL @ PHX,L,31,2,9,0.222,1,4,0.25,0,0,0.0,3,6,9,2,4,1,1,1,5,3,1,MIL,PHX,MIL,106,,,16,14,7,11
Bobby Portis,F,22023,1626171,22300711,"FEB 04, 2024",MIL @ UTA,L,36,11,20,0.55,4,7,0.571,1,1,1.0,1,6,7,0,3,0,1,2,27,-18,1,MIL,UTA,MIL,108,,,34,34,27,7
Bobby Portis,F,22023,1626171,22300702,"FEB 03, 2024",MIL @ DAL,W,31,4,10,0.4,0,3,0.0,4,5,0.8,3,7,10,2,1,0,0,3,12,-3,1,MIL,DAL,MIL,129,,,24,22,14,12
Bobby Portis,F,22023,1626171,22300683,"JAN 31, 2024",MIL @ POR,L,22,5,7,0.714,1,2,0.5,0,0,0.0,2,4,6,0,0,0,1,0,11,-11,1,MIL,POR,MIL,116,,,17,17,11,6
Bobby Portis,F,22023,1626171,22300667,"JAN 29, 2024",MIL @ DEN,L,25,2,13,0.154,2,6,0.333,3,4,0.75,2,10,12,2,0,0,0,3,9,-14,1,MIL,DEN,MIL,107,,,23,21,11,14
Bobby Portis,F,22023,1626171,22300648,"JAN 27, 2024",MIL vs. NOP,W,22,9,15,0.6,2,5,0.4,0,0,0.0,1,6,7,2,1,0,1,6,20,2,1,MIL,MIL,NOP,141,,,29,27,22,9
Bobby Portis,F,22023,1626171,22300639,"JAN 26, 2024",MIL vs. CLE,L,22,4,8,0.5,3,3,1.0,1,2,0.5,1,7,8,0,1,0,1,3,12,-3,1,MIL,MIL,CLE,100,,,20,20,12,8
Bobby Portis,F,22023,1626171,22300624,"JAN 24, 2024",MIL vs. CLE,W,25,2,6,0.333,0,1,0.0,4,4,1.0,0,6,6,0,0,0,1,1,8,-4,1,MIL,MIL,CLE,126,,,14,14,8,6
Bobby Portis,F,22023,1626171,22300606,"JAN 22, 2024",MIL @ DET,W,25,2,5,0.4,0,3,0.0,3,4,0.75,1,3,4,0,0,1,0,3,7,-13,1,MIL,DET,MIL,122,,,11,11,7,4
Bobby Portis,F,22023,1626171,22300592,"JAN 20, 2024",MIL @ DET,W,17,2,4,0.5,0,0,0.0,0,0,0.0,0,3,3,0,0,0,0,0,4,-12,1,MIL,DET,MIL,141,,,7,7,4,3
Bobby Portis,F,22023,1626171,22300552,"JAN 14, 2024",MIL vs. SAC,W,26,9,11,0.818,2,2,1.0,2,2,1.0,2,8,10,1,0,0,2,1,22,10,1,MIL,MIL,SAC,143,,,33,32,23,11
Bobby Portis,F,22023,1626171,22300545,"JAN 13, 2024",MIL vs. GSW,W,21,4,11,0.364,2,4,0.5,0,0,0.0,0,8,8,0,0,0,1,5,10,7,1,MIL,MIL,GSW,129,,,18,18,10,8
Bobby Portis,F,22023,1626171,22300528,"JAN 11, 2024",MIL vs. BOS,W,22,11,18,0.611,5,6,0.833,1,2,0.5,1,11,12,0,1,0,0,1,28,15,1,MIL,MIL,BOS,135,,,40,40,28,12
Bobby Portis,F,22023,1626171,22300510,"JAN 08, 2024",MIL vs. UTA,L,16,4,11,0.364,0,2,0.0,0,0,0.0,1,2,3,0,0,0,0,4,8,-8,1,MIL,MIL,UTA,116,,,11,11,8,3
Bobby Portis,F,22023,1626171,22300496,"JAN 06, 2024",MIL @ HOU,L,17,2,5,0.4,1,2,0.5,1,2,0.5,0,6,6,0,1,1,2,5,6,-13,1,MIL,HOU,MIL,108,,,12,12,6,6
Bobby Portis,F,22023,1626171,22300477,"JAN 04, 2024",MIL @ SAS,W,21,2,6,0.333,0,2,0.0,1,2,0.5,1,3,4,0,0,1,2,3,5,-8,1,MIL,SAS,MIL,125,,,9,9,5,4
Bobby Portis,F,22023,1626171,22300466,"JAN 03, 2024",MIL @ IND,L,20,4,10,0.4,0,2,0.0,1,2,0.5,3,3,6,1,0,1,0,1,9,-1,1,MIL,IND,MIL,130,,,16,15,10,7
Bobby Portis,F,22023,1626171,22300454,"JAN 01, 2024",MIL vs. IND,L,18,4,12,0.333,0,4,0.0,0,0,0.0,1,4,5,0,0,1,0,4,8,-21,1,MIL,MIL,IND,113,,,13,13,8,5
Bobby Portis,F,22023,1626171,22300433,"DEC 29, 2023",MIL @ CLE,W,23,2,6,0.333,1,2,0.5,4,6,0.667,1,4,5,1,1,0,0,3,9,-5,1,MIL,CLE,MIL,119,,,15,14,10,6
Bobby Portis,F,22023,1626171,22300417,"DEC 27, 2023",MIL @ BKN,W,31,6,9,0.667,2,3,0.667,0,0,0.0,0,6,6,4,2,1,1,1,14,20,1,MIL,BKN,MIL,144,,,24,20,18,10
Bobby Portis,F,22023,1626171,22300401,"DEC 25, 2023",MIL @ NYK,L,31,5,11,0.455,0,4,0.0,2,2,1.0,5,4,9,0,0,0,3,4,12,-3,1,MIL,NYK,MIL,122,,,21,21,12,9
Bobby Portis,F,22023,1626171,22300388,"DEC 23, 2023",MIL @ NYK,W,27,9,14,0.643,3,4,0.75,2,2,1.0,2,9,11,1,2,0,2,4,23,17,1,MIL,NYK,MIL,130,,,35,34,24,12
Bobby Portis,F,22023,1626171,22300378,"DEC 21, 2023",MIL vs. ORL,W,21,3,8,0.375,0,2,0.0,0,0,0.0,5,3,8,1,1,1,0,1,6,-18,1,MIL,MIL,ORL,118,,,15,14,7,9
Bobby Portis,F,22023,1626171,22300361,"DEC 19, 2023",MIL vs. SAS,W,26,10,16,0.625,3,6,0.5,0,0,0.0,1,9,10,2,2,0,0,3,23,4,1,MIL,MIL,SAS,132,,,35,33,25,12
Bobby Portis,F,22023,1626171,22300346,"DEC 17, 2023",MIL vs. HOU,W,25,5,7,0.714,1,2,0.5,0,0,0.0,4,2,6,0,0,0,0,3,11,7,1,MIL,MIL,HOU,128,,,17,17,11,6
Bobby Portis,F,22023,1626171,22300334,"DEC 16, 2023",MIL vs. DET,W,27,11,18,0.611,4,7,0.571,5,5,1.0,3,9,12,1,1,0,4,3,31,24,1,MIL,MIL,DET,146,,,44,43,32,13
Bobby Portis,F,22023,1626171,22300315,"DEC 13, 2023",MIL vs. IND,W,23,8,13,0.615,3,4,0.75,0,0,0.0,1,1,2,2,0,0,0,2,19,16,1,MIL,MIL,IND,140,,,23,21,21,4
Bobby Portis,F,22023,1626171,22300300,"DEC 11, 2023",MIL vs. CHI,W,25,7,11,0.636,1,3,0.333,2,2,1.0,2,5,7,0,0,0,1,3,17,-4,1,MIL,MIL,CHI,133,,,24,24,17,7
Bobby Portis,F,22023,1626171,22301229,"DEC 07, 2023",MIL vs. IND,L,18,2,5,0.4,0,1,0.0,0,0,0.0,4,2,6,1,0,1,1,2,4,-6,1,MIL,MIL,IND,119,,,11,10,5,7
Bobby Portis,F,22023,1626171,22301201,"DEC 05, 2023",MIL vs. NYK,W,24,5,9,0.556,1,3,0.333,2,2,1.0,2,2,4,1,0,2,1,4,13,-7,1,MIL,MIL,NYK,146,,,18,17,14,5
Bobby Portis,F,22023,1626171,22300286,"DEC 02, 2023",MIL vs. ATL,W,23,7,13,0.538,1,4,0.25,0,0,0.0,2,9,11,0,0,0,0,3,15,9,1,MIL,MIL,ATL,132,,,26,26,15,11
Bobby Portis,F,22023,1626171,22300269,"NOV 30, 2023",MIL @ CHI,L,31,2,8,0.25,0,2,0.0,0,0,0.0,1,8,9,2,2,0,0,3,4,-14,1,MIL,CHI,MIL,113,,,15,13,6,11
Bobby Portis,F,22023,1626171,22300056,"NOV 28, 2023",MIL @ MIA,W,23,3,8,0.375,0,2,0.0,0,0,0.0,0,2,2,0,0,0,0,2,6,-12,1,MIL,MIA,MIL,131,,,8,8,6,2
Bobby Portis,F,22023,1626171,22300245,"NOV 26, 2023",MIL vs. POR,W,31,5,12,0.417,2,5,0.4,0,0,0.0,6,2,8,1,2,3,2,3,12,3,1,MIL,MIL,POR,108,,,21,20,13,9
Bobby Portis,F,22023,1626171,22300049,"NOV 24, 2023",MIL vs. WAS,W,25,1,5,0.2,0,1,0.0,0,0,0.0,2,4,6,1,0,1,0,3,2,3,1,MIL,MIL,WAS,131,,,9,8,3,7
Bobby Portis,F,22023,1626171,22300228,"NOV 22, 2023",MIL @ BOS,L,21,2,6,0.333,0,0,0.0,0,0,0.0,1,6,7,0,0,0,0,2,4,-4,1,MIL,BOS,MIL,116,,,11,11,4,7
Bobby Portis,F,22023,1626171,22300219,"NOV 20, 2023",MIL @ WAS,W,23,8,13,0.615,1,3,0.333,0,0,0.0,1,7,8,1,1,0,1,2,17,13,1,MIL,WAS,MIL,142,,,26,25,18,9
Bobby Portis,F,22023,1626171,22300205,"NOV 18, 2023",MIL vs. DAL,W,22,5,10,0.5,1,2,0.5,0,0,0.0,1,6,7,2,0,0,0,0,11,7,1,MIL,MIL,DAL,132,,,20,18,13,9
Bobby Portis,F,22023,1626171,22300027,"NOV 17, 2023",MIL @ CHA,W,30,6,12,0.5,1,3,0.333,0,0,0.0,0,7,7,1,1,0,3,1,13,4,1,MIL,CHA,MIL,130,,,21,20,14,8
Bobby Portis,F,22023,1626171,22300190,"NOV 13, 2023",MIL vs. CHI,W,25,7,10,0.7,3,6,0.5,2,2,1.0,2,8,10,2,0,1,0,3,19,24,1,MIL,MIL,CHI,118,,,31,29,21,12
Bobby Portis,F,22023,1626171,22300173,"NOV 11, 2023",MIL @ ORL,L,28,4,11,0.364,2,5,0.4,3,4,0.75,1,6,7,1,2,0,2,4,13,-6,1,MIL,ORL,MIL,97,,,21,20,14,8
Bobby Portis,F,22023,1626171,22300171,"NOV 09, 2023",MIL @ IND,L,24,5,11,0.455,0,2,0.0,1,1,1.0,0,8,8,2,1,1,3,2,11,6,1,MIL,IND,MIL,124,,,21,19,13,10
Bobby Portis,F,22023,1626171,22300165,"NOV 08, 2023",MIL vs. DET,W,23,7,14,0.5,1,4,0.25,3,3,1.0,2,3,5,2,0,0,2,1,18,-4,1,MIL,MIL,DET,120,,,25,23,20,7
Bobby Portis,F,22023,1626171,22300149,"NOV 06, 2023",MIL @ BKN,W,26,3,8,0.375,1,2,0.5,4,4,1.0,0,6,6,2,2,0,1,2,11,14,1,MIL,BKN,MIL,129,,,19,17,13,8
Bobby Portis,F,22023,1626171,22300002,"NOV 03, 2023",MIL vs. NYK,W,17,2,10,0.2,0,2,0.0,0,0,0.0,0,2,2,0,2,0,0,1,4,-2,1,MIL,MIL,NYK,110,,,6,6,4,2
Bobby Portis,F,22023,1626171,22300116,"NOV 01, 2023",MIL @ TOR,L,19,2,6,0.333,0,1,0.0,6,9,0.667,1,5,6,1,2,0,1,1,10,-7,1,MIL,TOR,MIL,111,,,17,16,11,7
Bobby Portis,F,22023,1626171,22300107,"OCT 30, 2023",MIL vs. MIA,W,19,7,10,0.7,0,2,0.0,2,2,1.0,2,6,8,2,2,1,0,3,16,18,1,MIL,MIL,MIA,122,,,26,24,18,10
Bobby Portis,F,22023,1626171,22300097,"OCT 29, 2023",MIL vs. ATL,L,21,5,10,0.5,0,2,0.0,2,2,1.0,1,3,4,2,0,0,3,2,12,-5,1,MIL,MIL,ATL,110,,,18,16,14,6
Bobby Portis,F,22023,1626171,22300075,"OCT 26, 2023",MIL vs. PHI,W,19,5,8,0.625,0,0,0.0,0,4,0.0,2,4,6,2,0,1,0,3,10,-10,1,MIL,MIL,PHI,118,,,18,16,12,8
Bobby Portis,F,22023,1626171,22300572,"JAN 17, 2024",MIL @ CLE,L,21,6,11,0.545,1,4,0.25,3,4,0.75,2,4,6,3,1,0,1,0,16,-8,1,MIL,CLE,MIL,95,,,25,22,19,9
Bobby Portis,F,22023,1626171,22300195,"NOV 15, 2023",MIL @ TOR,W,31,7,11,0.636,2,3,0.667,2,2,1.0,1,6,7,0,0,2,0,5,18,15,1,MIL,TOR,MIL,128,,,25,25,18,7
Buddy Hield,G,22023,1627741,22300742,"FEB 09, 2024",PHI vs. ATL,L,40,8,21,0.381,4,12,0.333,0,0,0.0,1,3,4,6,0,0,2,3,20,-1,1,PHI,PHI,ATL,121,,,30,24,26,10
Buddy Hield,G,22023,1627741,22300550,"JAN 14, 2024",IND @ DEN,L,28,6,13,0.462,2,9,0.222,2,2,1.0,0,2,2,1,2,0,1,2,16,1,1,IND,DEN,IND,109,,,19,18,17,3
Buddy Hield,G,22023,1627741,22300533,"JAN 12, 2024",IND @ ATL,W,23,7,11,0.636,4,6,0.667,0,0,0.0,0,3,3,2,0,3,2,3,18,14,1,IND,ATL,IND,126,,,23,21,20,5
Buddy Hield,G,22023,1627741,22300520,"JAN 10, 2024",IND vs. WAS,W,19,0,5,0.0,0,3,0.0,0,0,0.0,1,2,3,4,0,0,1,1,0,12,1,IND,IND,WAS,112,,,7,3,4,7
Buddy Hield,G,22023,1627741,22300507,"JAN 08, 2024",IND vs. BOS,W,25,6,11,0.545,3,7,0.429,0,0,0.0,1,3,4,3,1,1,1,3,15,7,1,IND,IND,BOS,133,,,22,19,18,7
Buddy Hield,G,22023,1627741,22300480,"JAN 05, 2024",IND vs. ATL,W,17,4,9,0.444,3,8,0.375,0,0,0.0,0,3,3,1,0,0,1,4,11,9,1,IND,IND,ATL,148,,,15,14,12,4
Buddy Hield,G,22023,1627741,22300466,"JAN 03, 2024",IND vs. MIL,W,13,3,8,0.375,2,4,0.5,2,3,0.667,0,0,0,0,1,0,0,1,10,1,1,IND,IND,MIL,142,,,10,10,10,0
Buddy Hield,G,22023,1627741,22300377,"DEC 21, 2023",IND @ MEM,L,32,5,14,0.357,5,13,0.385,0,0,0.0,2,4,6,4,2,0,2,2,15,4,1,IND,MEM,IND,103,,,25,21,19,10
Buddy Hield,G,22023,1627741,22300365,"DEC 20, 2023",IND vs. CHA,W,26,8,13,0.615,4,8,0.5,5,5,1.0,2,2,4,3,1,3,2,2,25,10,1,IND,IND,CHA,142,,,32,29,28,7
Buddy Hield,G,22023,1627741,22300350,"DEC 18, 2023",IND vs. LAC,L,30,5,9,0.556,3,7,0.429,1,2,0.5,0,0,0,4,0,1,2,2,14,-12,1,IND,IND,LAC,127,,,18,14,18,4
Buddy Hield,G,22023,1627741,22300338,"DEC 16, 2023",IND @ MIN,L,18,0,4,0.0,0,3,0.0,0,0,0.0,0,1,1,2,0,0,3,1,0,-11,1,IND,MIN,IND,109,,,3,1,2,3
Buddy Hield,G,22023,1627741,22300328,"DEC 15, 2023",IND @ WAS,L,27,4,14,0.286,3,11,0.273,0,0,0.0,0,3,3,3,2,3,2,1,11,-15,1,IND,WAS,IND,123,,,17,14,14,6
Buddy Hield,G,22023,1627741,22300315,"DEC 13, 2023",IND @ MIL,L,27,3,9,0.333,1,6,0.167,0,0,0.0,2,1,3,2,0,0,1,1,7,-10,1,IND,MIL,IND,126,,,12,10,9,5
Buddy Hield,G,22023,1627741,22300293,"DEC 11, 2023",IND @ DET,W,31,6,9,0.667,4,7,0.571,0,0,0.0,0,3,3,2,1,0,0,1,16,2,1,IND,DET,IND,131,,,21,19,18,5
Buddy Hield,G,22023,1627741,22301229,"DEC 07, 2023",IND @ MIL,W,30,3,11,0.273,0,6,0.0,2,2,1.0,4,7,11,2,2,1,2,3,8,0,1,IND,MIL,IND,128,,,21,19,10,13
Buddy Hield,G,22023,1627741,22301202,"DEC 04, 2023",IND vs. BOS,W,32,7,11,0.636,4,6,0.667,3,4,0.75,2,0,2,2,2,0,1,2,21,29,1,IND,IND,BOS,122,,,25,23,23,4
Buddy Hield,G,22023,1627741,22300284,"DEC 02, 2023",IND @ MIA,W,24,3,7,0.429,1,4,0.25,0,0,0.0,0,1,1,2,2,0,1,3,7,20,1,IND,MIA,IND,144,,,10,8,9,3
Buddy Hield,G,22023,1627741,22300267,"NOV 30, 2023",IND @ MIA,L,31,5,16,0.313,2,11,0.182,0,0,0.0,1,4,5,5,1,2,1,6,12,-13,1,IND,MIA,IND,132,,,22,17,17,10
Buddy Hield,G,22023,1627741,22300254,"NOV 27, 2023",IND vs. POR,L,24,3,10,0.3,1,6,0.167,2,2,1.0,0,1,1,3,1,1,2,1,9,4,1,IND,IND,POR,110,,,13,10,12,4
Buddy Hield,G,22023,1627741,22300047,"NOV 24, 2023",IND vs. DET,W,28,6,11,0.545,3,6,0.5,3,3,1.0,0,4,4,0,0,0,0,2,18,-7,1,IND,IND,DET,136,,,22,22,18,4
Buddy Hield,G,22023,1627741,22300230,"NOV 22, 2023",IND vs. TOR,L,35,12,17,0.706,7,12,0.583,0,0,0.0,0,2,2,5,2,1,1,2,31,10,1,IND,IND,TOR,131,,,38,33,36,7
Buddy Hield,G,22023,1627741,22300039,"NOV 21, 2023",IND @ ATL,W,31,9,11,0.818,6,6,1.0,0,0,0.0,1,1,2,1,0,0,1,3,24,20,1,IND,ATL,IND,157,,,27,26,25,3
Buddy Hield,G,22023,1627741,22300209,"NOV 19, 2023",IND vs. ORL,L,15,1,4,0.25,1,4,0.25,0,0,0.0,0,1,1,2,0,0,1,4,3,-15,1,IND,IND,ORL,116,,,6,4,5,3
Buddy Hield,G,22023,1627741,22300019,"NOV 14, 2023",IND @ PHI,W,29,1,5,0.2,0,3,0.0,0,0,0.0,0,2,2,1,1,0,5,2,2,10,1,IND,PHI,IND,132,,,5,4,3,3
Buddy Hield,G,22023,1627741,22300180,"NOV 12, 2023",IND @ PHI,L,21,6,14,0.429,4,8,0.5,0,0,0.0,1,3,4,3,1,1,0,0,16,-1,1,IND,PHI,IND,126,,,23,20,19,7
Buddy Hield,G,22023,1627741,22300171,"NOV 09, 2023",IND vs. MIL,W,22,4,14,0.286,2,11,0.182,1,1,1.0,0,2,2,2,1,0,2,3,11,-21,1,IND,IND,MIL,126,,,15,13,13,4
Buddy Hield,G,22023,1627741,22300158,"NOV 08, 2023",IND vs. UTA,W,22,4,16,0.25,2,12,0.167,0,0,0.0,0,3,3,1,1,1,1,2,10,10,1,IND,IND,UTA,134,,,14,13,11,4
Buddy Hield,G,22023,1627741,22300146,"NOV 06, 2023",IND vs. SAS,W,21,7,8,0.875,5,6,0.833,0,0,0.0,0,2,2,2,1,0,4,1,19,22,1,IND,IND,SAS,152,,,23,21,21,4
Buddy Hield,G,22023,1627741,22300133,"NOV 04, 2023",IND vs. CHA,L,26,7,15,0.467,5,13,0.385,0,1,0.0,2,4,6,2,0,2,2,1,19,-1,1,IND,IND,CHA,124,,,27,25,21,8
Buddy Hield,G,22023,1627741,22300001,"NOV 03, 2023",IND vs. CLE,W,30,5,9,0.556,4,7,0.571,0,0,0.0,0,5,5,2,0,1,1,2,14,16,1,IND,IND,CLE,121,,,21,19,16,7
Buddy Hield,G,22023,1627741,22300118,"NOV 01, 2023",IND @ BOS,L,24,3,8,0.375,1,4,0.25,0,0,0.0,1,3,4,5,1,0,1,3,7,-16,1,IND,BOS,IND,104,,,16,11,12,9
Buddy Hield,G,22023,1627741,22300102,"OCT 30, 2023",IND vs. CHI,L,19,4,12,0.333,3,8,0.375,0,0,0.0,3,2,5,4,0,0,2,0,11,-2,1,IND,IND,CHI,105,,,20,16,15,9
Buddy Hield,G,22023,1627741,22300091,"OCT 28, 2023",IND @ CLE,W,19,4,12,0.333,2,7,0.286,0,0,0.0,0,1,1,4,0,1,1,1,10,6,1,IND,CLE,IND,125,,,15,11,14,5
Buddy Hield,G,22023,1627741,22300064,"OCT 25, 2023",IND vs. WAS,W,25,5,9,0.556,4,7,0.571,0,0,0.0,0,2,2,5,1,1,1,0,14,15,1,IND,IND,WAS,143,,,21,16,19,7
Buddy Hield,G,22023,1627741,22300707,"FEB 04, 2024",IND @ CHA,W,12,1,4,0.25,1,3,0.333,0,0,0.0,0,1,1,0,0,0,0,1,3,-6,1,IND,CHA,IND,115,,,4,4,3,1
Buddy Hield,G,22023,1627741,22300627,"JAN 25, 2024",IND vs. PHI,W,26,4,6,0.667,3,5,0.6,0,0,0.0,0,3,3,2,2,0,1,1,11,23,1,IND,IND,PHI,134,,,16,14,13,5
Buddy Hield,G,22023,1627741,22300564,"JAN 15, 2024",IND @ UTA,L,23,5,8,0.625,3,5,0.6,1,1,1.0,1,1,2,1,0,0,1,1,14,-24,1,IND,UTA,IND,105,,,17,16,15,3
Buddy Hield,G,22023,1627741,22300493,"JAN 06, 2024",IND vs. BOS,L,31,6,16,0.375,3,10,0.3,0,0,0.0,0,2,2,3,0,0,0,3,15,-5,1,IND,IND,BOS,101,,,20,17,18,5
Buddy Hield,G,22023,1627741,22300753,"FEB 10, 2024",PHI @ WAS,W,36,9,16,0.563,4,9,0.444,1,2,0.5,1,4,5,6,4,0,2,3,23,-2,1,PHI,WAS,PHI,119,,,34,28,29,11
Buddy Hield,G,22023,1627741,22300719,"FEB 06, 2024",IND vs. HOU,W,24,5,7,0.714,2,4,0.5,0,0,0.0,0,3,3,6,0,0,1,2,12,11,1,IND,IND,HOU,132,,,21,15,18,9
Buddy Hield,G,22023,1627741,22300691,"FEB 02, 2024",IND vs. SAC,L,28,7,13,0.538,3,8,0.375,0,0,0.0,0,4,4,4,2,0,0,3,17,-10,1,IND,IND,SAC,122,,,25,21,21,8
Buddy Hield,G,22023,1627741,22300685,"FEB 01, 2024",IND @ NYK,L,28,1,8,0.125,1,7,0.143,0,0,0.0,1,1,2,0,1,2,0,2,3,-10,1,IND,NYK,IND,105,,,5,5,3,2
Buddy Hield,G,22023,1627741,22300670,"JAN 30, 2024",IND @ BOS,L,36,5,9,0.556,2,5,0.4,0,0,0.0,2,4,6,4,3,0,1,2,12,7,1,IND,BOS,IND,124,,,22,18,16,10
Buddy Hield,G,22023,1627741,22300590,"JAN 19, 2024",IND @ POR,L,36,6,13,0.462,6,11,0.545,0,0,0.0,1,5,6,7,1,1,1,4,18,11,1,IND,POR,IND,115,,,31,24,25,13
Buddy Hield,G,22023,1627741,22300454,"JAN 01, 2024",IND @ MIL,W,21,0,6,0.0,0,4,0.0,0,0,0.0,2,1,3,0,0,0,0,2,0,4,1,IND,MIL,IND,122,,,3,3,0,3
Buddy Hield,G,22023,1627741,22300441,"DEC 30, 2023",IND vs. NYK,W,18,2,3,0.667,1,2,0.5,1,1,1.0,0,2,2,1,1,0,1,1,6,4,1,IND,IND,NYK,140,,,9,8,7,3
Buddy Hield,G,22023,1627741,22300422,"DEC 28, 2023",IND @ CHI,W,33,7,13,0.538,5,10,0.5,0,0,0.0,0,6,6,2,1,1,3,3,19,22,1,IND,CHI,IND,120,,,27,25,21,8
Buddy Hield,G,22023,1627741,22300409,"DEC 26, 2023",IND @ HOU,W,33,4,14,0.286,3,11,0.273,0,0,0.0,1,4,5,5,0,0,0,1,11,-10,1,IND,HOU,IND,123,,,21,16,16,10
Buddy Hield,G,22023,1627741,22300391,"DEC 23, 2023",IND vs. ORL,L,38,7,15,0.467,5,11,0.455,1,1,1.0,1,6,7,1,1,1,2,4,20,11,1,IND,IND,ORL,110,,,28,27,21,8
Buddy Hield,G,22023,1627741,22300652,"JAN 28, 2024",IND vs. MEM,W,19,1,8,0.125,1,4,0.25,0,0,0.0,0,3,3,3,0,1,1,1,3,0,1,IND,IND,MEM,116,,,9,6,6,6
Buddy Hield,G,22023,1627741,22300636,"JAN 26, 2024",IND vs. PHX,W,14,1,3,0.333,0,2,0.0,0,0,0.0,1,1,2,4,0,0,1,2,2,-5,1,IND,IND,PHX,133,,,8,4,6,6
Buddy Hield,G,22023,1627741,22300614,"JAN 23, 2024",IND vs. DEN,L,22,1,3,0.333,0,2,0.0,1,1,1.0,0,1,1,1,2,1,0,1,3,-15,1,IND,IND,DEN,109,,,5,4,4,2
Buddy Hield,G,22023,1627741,22300604,"JAN 21, 2024",IND @ PHX,L,31,6,10,0.6,5,8,0.625,1,2,0.5,1,3,4,3,1,0,0,2,18,-20,1,IND,PHX,IND,110,,,25,22,21,7
Buddy Hield,G,22023,1627741,22300583,"JAN 18, 2024",IND @ SAC,W,36,4,9,0.444,2,6,0.333,2,2,1.0,0,5,5,8,1,1,1,2,12,5,1,IND,SAC,IND,126,,,25,17,20,13
Jalen Suggs,G,22023,1630591,22300752,"FEB 10, 2024",ORL vs. CHI,W,26,5,9,0.556,3,5,0.6,0,0,0.0,0,1,1,1,1,0,3,1,13,-8,1,ORL,ORL,CHI,114,,,15,14,14,2
Jalen Suggs,G,22023,1630591,22300734,"FEB 08, 2024",ORL vs. SAS,W,29,6,11,0.545,3,6,0.5,2,4,0.5,1,2,3,2,2,0,2,4,17,18,1,ORL,ORL,SAS,127,,,22,20,19,5
Jalen Suggs,G,22023,1630591,22300721,"FEB 06, 2024",ORL @ MIA,L,28,1,7,0.143,1,6,0.167,0,0,0.0,0,3,3,4,0,0,0,2,3,-9,1,ORL,MIA,ORL,95,,,10,6,7,7
Jalen Suggs,G,22023,1630591,22300704,"FEB 04, 2024",ORL @ DET,W,28,4,8,0.5,1,3,0.333,0,0,0.0,1,4,5,2,2,1,0,2,9,14,1,ORL,DET,ORL,111,,,16,14,11,7
Jalen Suggs,G,22023,1630591,22300694,"FEB 02, 2024",ORL @ MIN,W,36,4,12,0.333,4,9,0.444,3,4,0.75,2,4,6,2,2,1,3,2,15,0,1,ORL,MIN,ORL,108,,,23,21,17,8
Jalen Suggs,G,22023,1630591,22300681,"JAN 31, 2024",ORL @ SAS,W,33,3,9,0.333,1,4,0.25,0,0,0.0,0,1,1,5,4,0,1,3,7,10,1,ORL,SAS,ORL,108,,,13,8,12,6
Jalen Suggs,G,22023,1630591,22300666,"JAN 29, 2024",ORL @ DAL,L,26,4,8,0.5,3,6,0.5,0,0,0.0,0,2,2,1,3,0,2,4,11,-14,1,ORL,DAL,ORL,129,,,14,13,12,3
Jalen Suggs,G,22023,1630591,22300655,"JAN 28, 2024",ORL vs. PHX,W,32,4,11,0.364,2,8,0.25,0,0,0.0,1,3,4,5,2,1,2,4,10,4,1,ORL,ORL,PHX,113,,,19,14,15,9
Jalen Suggs,G,22023,1630591,22300638,"JAN 26, 2024",ORL @ MEM,L,4,0,2,0.0,0,2,0.0,0,0,0.0,0,0,0,0,0,0,0,0,0,-8,1,ORL,MEM,ORL,106,,,0,0,0,0
Jalen Suggs,G,22023,1630591,22300607,"JAN 22, 2024",ORL vs. CLE,L,26,2,5,0.4,2,4,0.5,0,0,0.0,0,2,2,3,2,0,3,2,6,-24,1,ORL,ORL,CLE,99,,,11,8,9,5
Jalen Suggs,G,22023,1630591,22300601,"JAN 21, 2024",ORL vs. MIA,W,29,4,11,0.364,1,6,0.167,2,2,1.0,4,0,4,1,1,0,2,4,11,10,1,ORL,ORL,MIA,105,,,16,15,12,5
Jalen Suggs,G,22023,1630591,22300585,"JAN 19, 2024",ORL vs. PHI,L,25,5,13,0.385,2,5,0.4,4,4,1.0,0,2,2,2,1,1,1,1,16,-11,1,ORL,ORL,PHI,109,,,20,18,18,4
Jalen Suggs,G,22023,1630591,22300570,"JAN 17, 2024",ORL @ ATL,L,28,6,7,0.857,3,3,1.0,1,2,0.5,2,2,4,1,0,0,2,3,16,-1,1,ORL,ATL,ORL,104,,,21,20,17,5
Jalen Suggs,G,22023,1630591,22300557,"JAN 15, 2024",ORL @ NYK,W,27,1,8,0.125,1,6,0.167,1,2,0.5,0,5,5,4,0,0,2,3,4,-6,1,ORL,NYK,ORL,98,,,13,9,8,9
Jalen Suggs,G,22023,1630591,22300546,"JAN 13, 2024",ORL @ OKC,L,20,4,8,0.5,1,3,0.333,0,0,0.0,1,3,4,0,0,0,1,3,9,-9,1,ORL,OKC,ORL,100,,,13,13,9,4
Jalen Suggs,G,22023,1630591,22300535,"JAN 12, 2024",ORL @ MIA,L,14,1,5,0.2,0,4,0.0,0,0,0.0,0,0,0,0,0,3,0,3,2,-11,1,ORL,MIA,ORL,96,,,2,2,2,0
Jalen Suggs,G,22023,1630591,22300513,"JAN 09, 2024",ORL vs. MIN,L,27,8,14,0.571,4,8,0.5,0,1,0.0,1,4,5,2,3,0,2,2,20,-16,1,ORL,ORL,MIN,92,,,27,25,22,7
Jalen Suggs,G,22023,1630591,22300499,"JAN 07, 2024",ORL vs. ATL,W,29,6,13,0.462,4,7,0.571,0,0,0.0,1,4,5,3,1,0,1,6,16,16,1,ORL,ORL,ATL,117,,,24,21,19,8
Jalen Suggs,G,22023,1630591,22300488,"JAN 05, 2024",ORL @ DEN,W,34,9,15,0.6,7,9,0.778,2,4,0.5,2,2,4,1,0,1,2,3,27,1,1,ORL,DEN,ORL,122,,,32,31,28,5
Jalen Suggs,G,22023,1630591,22300463,"JAN 02, 2024",ORL @ GSW,L,31,3,14,0.214,3,7,0.429,1,2,0.5,1,1,2,3,0,0,4,2,10,-9,1,ORL,GSW,ORL,115,,,15,12,13,5
Jalen Suggs,G,22023,1630591,22300450,"DEC 31, 2023",ORL @ PHX,L,29,1,10,0.1,1,7,0.143,1,2,0.5,0,4,4,3,0,1,1,4,4,-10,1,ORL,PHX,ORL,107,,,11,8,7,7
Jalen Suggs,G,22023,1630591,22300429,"DEC 29, 2023",ORL vs. NYK,W,31,8,15,0.533,2,7,0.286,3,6,0.5,0,2,2,6,0,1,3,4,21,9,1,ORL,ORL,NYK,117,,,29,23,27,8
Jalen Suggs,G,22023,1630591,22300415,"DEC 27, 2023",ORL vs. PHI,L,28,8,12,0.667,1,2,0.5,3,3,1.0,1,1,2,1,1,1,3,5,20,-17,1,ORL,ORL,PHI,92,,,23,22,21,3
Jalen Suggs,G,22023,1630591,22300407,"DEC 26, 2023",ORL @ WAS,W,29,4,11,0.364,3,10,0.3,0,0,0.0,1,2,3,1,3,1,2,1,11,-1,1,ORL,WAS,ORL,127,,,15,14,12,4
Jalen Suggs,G,22023,1630591,22300366,"DEC 20, 2023",ORL vs. MIA,L,21,5,9,0.556,1,5,0.2,0,0,0.0,0,1,1,3,0,1,1,0,11,-23,1,ORL,ORL,MIA,106,,,15,12,14,4
Jalen Suggs,G,22023,1630591,22300344,"DEC 17, 2023",ORL @ BOS,L,28,5,9,0.556,1,4,0.25,2,2,1.0,0,5,5,0,1,0,2,4,13,-9,1,ORL,BOS,ORL,97,,,18,18,13,5
Jalen Suggs,G,22023,1630591,22300329,"DEC 15, 2023",ORL @ BOS,L,26,7,12,0.583,5,9,0.556,0,0,0.0,0,4,4,1,0,1,1,2,19,-9,1,ORL,BOS,ORL,111,,,24,23,20,5
Jalen Suggs,G,22023,1630591,22300294,"DEC 11, 2023",ORL vs. CLE,W,28,4,6,0.667,2,4,0.5,2,2,1.0,1,3,4,3,0,1,1,2,12,10,1,ORL,ORL,CLE,104,,,19,16,15,7
Jalen Suggs,G,22023,1630591,22301205,"DEC 06, 2023",ORL @ CLE,L,9,0,2,0.0,0,1,0.0,0,0,0.0,0,0,0,1,2,1,1,0,0,-6,1,ORL,CLE,ORL,111,,,1,0,1,1
Jalen Suggs,G,22023,1630591,22300282,"DEC 02, 2023",ORL @ BKN,L,22,3,7,0.429,1,3,0.333,0,0,0.0,0,0,0,2,1,1,4,5,7,-14,1,ORL,BKN,ORL,101,,,9,7,9,2
Jalen Suggs,G,22023,1630591,22300274,"DEC 01, 2023",ORL vs. WAS,W,27,5,9,0.556,2,6,0.333,3,5,0.6,0,2,2,4,3,2,3,4,15,10,1,ORL,ORL,WAS,130,,,21,17,19,6
Jalen Suggs,G,22023,1630591,22300259,"NOV 29, 2023",ORL vs. WAS,W,29,9,15,0.6,3,6,0.5,1,1,1.0,1,2,3,3,2,0,2,4,22,4,1,ORL,ORL,WAS,139,,,28,25,25,6
Jalen Suggs,G,22023,1630591,22300248,"NOV 26, 2023",ORL vs. CHA,W,32,5,9,0.556,2,5,0.4,0,0,0.0,0,5,5,1,1,2,1,2,12,6,1,ORL,ORL,CHA,130,,,18,17,13,6
Jalen Suggs,G,22023,1630591,22300043,"NOV 24, 2023",ORL vs. BOS,W,28,3,8,0.375,3,4,0.75,1,2,0.5,0,4,4,1,1,0,3,2,10,0,1,ORL,ORL,BOS,113,,,15,14,11,5
Jalen Suggs,G,22023,1630591,22300226,"NOV 22, 2023",ORL vs. DEN,W,29,4,8,0.5,0,3,0.0,2,2,1.0,0,4,4,4,1,0,2,5,10,3,1,ORL,ORL,DEN,124,,,18,14,14,8
Jalen Suggs,G,22023,1630591,22300038,"NOV 21, 2023",ORL vs. TOR,W,21,6,10,0.6,2,4,0.5,4,4,1.0,1,2,3,4,2,0,2,3,18,5,1,ORL,ORL,TOR,126,,,25,21,22,7
Jalen Suggs,G,22023,1630591,22300209,"NOV 19, 2023",ORL @ IND,W,18,6,8,0.75,1,2,0.5,5,6,0.833,1,2,3,1,1,0,0,1,18,20,1,ORL,IND,ORL,128,,,22,21,19,4
Jalen Suggs,G,22023,1630591,22300196,"NOV 15, 2023",ORL @ CHI,W,27,2,8,0.25,2,7,0.286,4,4,1.0,0,2,2,5,3,0,4,4,10,-2,1,ORL,CHI,ORL,96,,,17,12,15,7
Jalen Suggs,G,22023,1630591,22300020,"NOV 14, 2023",ORL @ BKN,L,32,4,13,0.308,2,7,0.286,0,0,0.0,0,2,2,2,2,1,3,2,10,-27,1,ORL,BKN,ORL,104,,,14,12,12,4
Jalen Suggs,G,22023,1630591,22300173,"NOV 11, 2023",ORL vs. MIL,W,38,5,11,0.455,2,4,0.5,8,10,0.8,0,2,2,2,1,0,1,0,20,10,1,ORL,ORL,MIL,112,,,24,22,22,4
Jalen Suggs,G,22023,1630591,22300172,"NOV 09, 2023",ORL vs. ATL,L,31,7,10,0.7,4,5,0.8,3,6,0.5,0,2,2,1,6,0,2,5,21,1,1,ORL,ORL,ATL,119,,,24,23,22,3
Jalen Suggs,G,22023,1630591,22300147,"NOV 06, 2023",ORL vs. DAL,L,24,4,12,0.333,1,6,0.167,1,2,0.5,1,3,4,7,1,1,4,3,10,-6,1,ORL,ORL,DAL,102,,,21,14,17,11
Jalen Suggs,G,22023,1630591,22300134,"NOV 04, 2023",ORL vs. LAL,W,27,4,11,0.364,0,2,0.0,1,1,1.0,1,5,6,5,1,1,2,1,9,26,1,ORL,ORL,LAL,120,,,20,15,14,11
Jalen Suggs,G,22023,1630591,22300130,"NOV 02, 2023",ORL @ UTA,W,21,1,7,0.143,0,0,0.0,4,4,1.0,2,2,4,3,4,0,3,4,6,-4,1,ORL,UTA,ORL,115,,,13,10,9,7
Jalen Suggs,G,22023,1630591,22300114,"OCT 31, 2023",ORL @ LAC,L,32,5,10,0.5,1,5,0.2,0,0,0.0,2,4,6,3,1,1,3,5,11,-12,1,ORL,LAC,ORL,102,,,20,17,14,9
Jalen Suggs,G,22023,1630591,22300111,"OCT 30, 2023",ORL @ LAL,L,26,4,12,0.333,3,7,0.429,4,4,1.0,3,5,8,2,1,0,0,2,15,10,1,ORL,LAL,ORL,103,,,25,23,17,10
Jalen Suggs,G,22023,1630591,22300086,"OCT 27, 2023",ORL @ POR,W,27,4,5,0.8,0,1,0.0,3,3,1.0,0,5,5,2,4,2,1,3,11,3,1,ORL,POR,ORL,102,,,18,16,13,7
Jalen Suggs,G,22023,1630591,22300066,"OCT 25, 2023",ORL vs. HOU,W,21,3,12,0.25,2,7,0.286,0,0,0.0,1,3,4,0,0,0,0,2,8,5,1,ORL,ORL,HOU,116,,,12,12,8,4
Jalen Suggs,G,22023,1630591,22300476,"JAN 03, 2024",ORL @ SAC,L,39,8,18,0.444,6,12,0.5,2,2,1.0,1,2,3,4,2,2,4,4,24,-13,1,ORL,SAC,ORL,135,,,31,27,28,7
Scoot Henderson,G,22023,1630703,22300712,"FEB 04, 2024",POR @ DEN,L,33,3,16,0.188,2,6,0.333,6,6,1.0,4,4,8,9,0,0,3,4,14,-7,1,POR,DEN,POR,103,,,31,22,23,17
Scoot Henderson,G,22023,1630703,22300697,"FEB 02, 2024",POR @ DEN,L,37,8,15,0.533,3,7,0.429,11,12,0.917,2,3,5,2,0,0,2,3,30,7,1,POR,DEN,POR,108,,,37,35,32,7
Scoot Henderson,G,22023,1630703,22300683,"JAN 31, 2024",POR vs. MIL,W,22,6,11,0.545,1,2,0.5,2,2,1.0,0,0,0,4,0,0,2,1,15,5,1,POR,POR,MIL,119,,,19,15,19,4
Scoot Henderson,G,22023,1630703,22300668,"JAN 29, 2024",POR vs. PHI,W,22,5,9,0.556,3,4,0.75,9,9,1.0,1,1,2,4,2,1,2,4,22,5,1,POR,POR,PHI,128,,,28,24,26,6
Scoot Henderson,G,22023,1630703,22300656,"JAN 28, 2024",POR vs. CHI,L,22,2,4,0.5,0,1,0.0,0,0,0.0,1,3,4,4,0,1,2,3,4,-5,1,POR,POR,CHI,96,,,12,8,8,8
Scoot Henderson,G,22023,1630703,22300641,"JAN 26, 2024",POR @ SAS,L,6,1,2,0.5,1,1,1.0,3,3,1.0,0,1,1,0,0,0,0,0,6,8,1,POR,SAS,POR,98,,,7,7,6,1
Scoot Henderson,G,22023,1630703,22300623,"JAN 24, 2024",POR @ HOU,W,24,4,12,0.333,1,5,0.2,2,2,1.0,0,1,1,3,0,0,2,0,11,-5,1,POR,HOU,POR,137,,,15,12,14,4
Scoot Henderson,G,22023,1630703,22300617,"JAN 23, 2024",POR @ OKC,L,26,7,18,0.389,2,6,0.333,3,3,1.0,0,4,4,7,1,0,1,5,19,17,1,POR,OKC,POR,109,,,30,23,26,11
Scoot Henderson,G,22023,1630703,22300605,"JAN 21, 2024",POR @ LAL,L,23,1,6,0.167,0,3,0.0,2,2,1.0,0,1,1,2,0,0,3,1,4,-8,1,POR,LAL,POR,108,,,7,5,6,3
Scoot Henderson,G,22023,1630703,22300590,"JAN 19, 2024",POR vs. IND,W,8,4,4,1.0,0,0,0.0,2,2,1.0,0,2,2,1,0,1,2,2,10,8,1,POR,POR,IND,118,,,13,12,11,3
Scoot Henderson,G,22023,1630703,22300399,"DEC 23, 2023",POR @ GSW,L,23,4,9,0.444,2,4,0.5,2,4,0.5,0,1,1,2,3,0,2,4,12,-12,1,POR,GSW,POR,106,,,15,13,14,3
Scoot Henderson,G,22023,1630703,22300381,"DEC 21, 2023",POR vs. WAS,L,26,0,5,0.0,0,0,0.0,4,4,1.0,0,4,4,2,0,0,1,3,4,7,1,POR,POR,WAS,117,,,10,8,6,6
Scoot Henderson,G,22023,1630703,22300363,"DEC 19, 2023",POR vs. PHX,W,30,3,9,0.333,0,2,0.0,3,3,1.0,1,3,4,5,0,0,5,4,9,-5,1,POR,POR,PHX,109,,,18,13,14,9
Scoot Henderson,G,22023,1630703,22300348,"DEC 17, 2023",POR vs. GSW,L,22,4,9,0.444,1,4,0.25,5,5,1.0,0,1,1,2,1,0,1,2,14,0,1,POR,POR,GSW,114,,,17,15,16,3
Scoot Henderson,G,22023,1630703,22300341,"DEC 16, 2023",POR vs. DAL,L,24,5,10,0.5,1,1,1.0,2,2,1.0,0,3,3,2,0,1,3,3,13,-8,1,POR,POR,DAL,120,,,18,16,15,5
Scoot Henderson,G,22023,1630703,22300323,"DEC 14, 2023",POR vs. UTA,L,35,9,21,0.429,2,7,0.286,3,3,1.0,0,2,2,10,1,0,4,1,23,0,1,POR,POR,UTA,114,,,35,25,33,12
Scoot Henderson,G,22023,1630703,22300289,"DEC 02, 2023",POR @ UTA,L,21,6,15,0.4,2,5,0.4,3,4,0.75,2,3,5,3,1,0,2,5,17,-5,1,POR,UTA,POR,113,,,25,22,20,8
Scoot Henderson,G,22023,1630703,22300265,"NOV 30, 2023",POR @ CLE,W,22,1,8,0.125,0,5,0.0,0,0,0.0,0,1,1,7,0,0,3,2,2,12,1,POR,CLE,POR,103,,,10,3,9,8
Scoot Henderson,G,22023,1630703,22300254,"NOV 27, 2023",POR @ IND,W,22,4,10,0.4,2,3,0.667,3,6,0.5,1,2,3,1,1,0,4,5,13,10,1,POR,IND,POR,114,,,17,16,14,4
Scoot Henderson,G,22023,1630703,22300245,"NOV 26, 2023",POR @ MIL,L,27,5,10,0.5,3,4,0.75,0,0,0.0,1,3,4,1,0,0,2,5,13,2,1,POR,MIL,POR,102,,,18,17,14,5
Scoot Henderson,G,22023,1630703,22300115,"NOV 01, 2023",POR @ DET,W,20,4,10,0.4,1,3,0.333,2,2,1.0,0,0,0,7,0,0,3,2,11,-11,1,POR,DET,POR,110,,,18,11,18,7
Scoot Henderson,G,22023,1630703,22300105,"OCT 30, 2023",POR @ TOR,W,34,4,12,0.333,0,6,0.0,3,4,0.75,0,4,4,7,2,0,4,6,11,1,1,POR,TOR,POR,99,,,22,15,18,11
Scoot Henderson,G,22023,1630703,22300098,"OCT 29, 2023",POR @ PHI,L,27,2,7,0.286,0,4,0.0,0,0,0.0,0,1,1,3,0,1,4,5,4,-17,1,POR,PHI,POR,98,,,8,5,7,4
Scoot Henderson,G,22023,1630703,22300086,"OCT 27, 2023",POR vs. ORL,L,25,3,12,0.25,1,5,0.2,0,0,0.0,2,1,3,2,1,0,5,5,7,-3,1,POR,POR,ORL,97,,,12,10,9,5
Scoot Henderson,G,22023,1630703,22300074,"OCT 25, 2023",POR @ LAC,L,36,5,11,0.455,0,3,0.0,1,1,1.0,1,2,3,4,0,0,4,2,11,-16,1,POR,LAC,POR,111,,,18,14,15,7
Scoot Henderson,G,22023,1630703,22300578,"JAN 17, 2024",POR vs. BKN,W,23,1,6,0.167,0,2,0.0,5,5,1.0,1,2,3,3,0,0,5,0,7,-13,1,POR,POR,BKN,103,,,13,10,10,6
Scoot Henderson,G,22023,1630703,22300538,"JAN 12, 2024",POR @ MIN,L,25,3,4,0.75,0,0,0.0,2,7,0.286,0,2,2,4,0,0,6,2,8,-27,1,POR,MIN,POR,91,,,14,10,12,6
Scoot Henderson,G,22023,1630703,22300514,"JAN 09, 2024",POR @ NYK,L,25,3,8,0.375,1,3,0.333,1,2,0.5,0,3,3,4,1,0,3,2,8,-26,1,POR,NYK,POR,80,,,15,11,12,7
Scoot Henderson,G,22023,1630703,22300498,"JAN 07, 2024",POR @ BKN,W,30,3,8,0.375,2,3,0.667,2,2,1.0,1,2,3,4,0,0,2,2,10,-12,1,POR,BKN,POR,134,,,17,13,14,7
Scoot Henderson,G,22023,1630703,22300487,"JAN 05, 2024",POR @ DAL,L,33,7,15,0.467,3,7,0.429,0,0,0.0,1,2,3,10,1,0,1,0,17,-26,1,POR,DAL,POR,103,,,30,20,27,13
Scoot Henderson,G,22023,1630703,22300472,"JAN 03, 2024",POR @ DAL,L,33,2,11,0.182,1,4,0.25,2,4,0.5,1,4,5,7,0,0,6,4,7,-28,1,POR,DAL,POR,97,,,19,12,14,12
Scoot Henderson,G,22023,1630703,22300456,"JAN 01, 2024",POR @ PHX,L,34,7,18,0.389,1,3,0.333,2,4,0.5,0,3,3,6,1,2,5,1,17,-18,1,POR,PHX,POR,84,,,26,20,23,9
Scoot Henderson,G,22023,1630703,22300437,"DEC 29, 2023",POR vs. SAS,W,37,9,21,0.429,3,5,0.6,1,2,0.5,4,3,7,11,1,1,4,5,22,-2,1,POR,POR,SAS,132,,,40,29,33,18
Scoot Henderson,G,22023,1630703,22300427,"DEC 28, 2023",POR vs. SAS,L,36,8,23,0.348,3,7,0.429,6,6,1.0,2,1,3,4,1,0,6,5,25,-6,1,POR,POR,SAS,98,,,32,28,29,7
Scoot Henderson,G,22023,1630703,22300413,"DEC 26, 2023",POR vs. SAC,W,28,6,15,0.4,1,3,0.333,4,4,1.0,1,0,1,11,0,0,1,2,17,21,1,POR,POR,SAC,130,,,29,18,28,12
Scoot Henderson,G,22023,1630703,22301214,"DEC 06, 2023",POR @ GSW,L,26,4,9,0.444,0,3,0.0,1,2,0.5,2,0,2,4,1,0,1,5,9,-15,1,POR,GSW,POR,106,,,15,11,13,6
Scoot Henderson,G,22023,1630703,22300237,"NOV 22, 2023",POR vs. UTA,W,17,1,7,0.143,0,3,0.0,1,2,0.5,1,2,3,7,0,0,3,4,3,15,1,POR,POR,UTA,121,,,13,6,10,10
Scoot Henderson,G,22023,1630703,22300304,"DEC 11, 2023",POR @ LAC,L,30,8,16,0.5,3,4,0.75,0,0,0.0,1,3,4,6,0,2,3,5,19,11,1,POR,LAC,POR,127,,,29,23,25,10
Scoot Henderson,G,22023,1630703,22300554,"JAN 14, 2024",POR vs. PHX,L,40,11,31,0.355,4,9,0.444,7,9,0.778,4,3,7,9,3,0,3,3,33,-12,1,POR,POR,PHX,116,,,49,40,42,16
Scoot Henderson,G,22023,1630703,22300529,"JAN 11, 2024",POR @ OKC,L,31,4,21,0.19,1,9,0.111,4,6,0.667,2,4,6,2,1,0,3,3,13,-56,1,POR,OKC,POR,77,,,21,19,15,8
Scoot Henderson,G,22023,1630703,22301226,"DEC 08, 2023",POR vs. DAL,L,30,4,17,0.235,0,6,0.0,2,3,0.667,1,2,3,3,0,0,4,4,10,-19,1,POR,POR,DAL,112,,,16,13,13,6
Danilo Gallinari,F,22023,201568,22300416,"DEC 27, 2023",WAS vs. TOR,L,5,0,2,0.0,0,1,0.0,0,0,0.0,0,1,1,0,0,0,0,0,0,-8,1,WAS,WAS,TOR,102,,,1,1,0,1
Danilo Gallinari,F,22023,201568,22300407,"DEC 26, 2023",WAS vs. ORL,L,16,2,5,0.4,1,3,0.333,4,5,0.8,1,2,3,1,0,0,1,2,9,-7,1,WAS,WAS,ORL,119,,,13,12,10,4
Danilo Gallinari,F,22023,201568,22300381,"DEC 21, 2023",WAS @ POR,W,13,1,3,0.333,1,2,0.5,1,2,0.5,0,2,2,0,0,0,0,0,4,-6,1,WAS,POR,WAS,118,,,6,6,4,2
Danilo Gallinari,F,22023,201568,22300347,"DEC 17, 2023",WAS @ PHX,L,12,1,2,0.5,1,2,0.5,3,3,1.0,0,1,1,0,1,0,0,0,6,-10,1,WAS,PHX,WAS,108,,,7,7,6,1
Danilo Gallinari,F,22023,201568,22300328,"DEC 15, 2023",WAS vs. IND,W,10,1,2,0.5,0,1,0.0,2,2,1.0,1,4,5,1,0,0,0,0,4,14,1,WAS,WAS,IND,137,,,10,9,5,6
Danilo Gallinari,F,22023,201568,22300311,"DEC 13, 2023",WAS vs. NOP,L,16,2,6,0.333,1,3,0.333,4,4,1.0,0,1,1,1,0,0,1,0,9,-20,1,WAS,WAS,NOP,122,,,11,10,10,2
Danilo Gallinari,F,22023,201568,22300295,"DEC 11, 2023",WAS @ PHI,L,11,0,0,0.0,0,0,0.0,2,2,1.0,0,1,1,0,0,0,2,2,2,-8,1,WAS,PHI,WAS,99,,,3,3,2,1
Danilo Gallinari,F,22023,201568,22301219,"DEC 08, 2023",WAS @ BKN,L,19,2,9,0.222,0,5,0.0,0,0,0.0,0,2,2,1,0,0,0,3,4,1,1,WAS,BKN,WAS,97,,,7,6,5,3
Danilo Gallinari,F,22023,201568,22301208,"DEC 06, 2023",WAS vs. PHI,L,17,2,6,0.333,2,5,0.4,1,1,1.0,0,6,6,2,1,0,0,1,7,-1,1,WAS,WAS,PHI,126,,,15,13,9,8
Danilo Gallinari,F,22023,201568,22300274,"DEC 01, 2023",WAS @ ORL,L,21,3,4,0.75,1,1,1.0,0,0,0.0,1,5,6,1,1,0,1,2,7,-4,1,WAS,ORL,WAS,125,,,14,13,8,7
Danilo Gallinari,F,22023,201568,22300259,"NOV 29, 2023",WAS @ ORL,L,12,1,4,0.25,0,1,0.0,4,5,0.8,0,1,1,0,0,0,0,1,6,-12,1,WAS,ORL,WAS,120,,,7,7,6,1
Danilo Gallinari,F,22023,201568,22300253,"NOV 27, 2023",WAS @ DET,W,19,5,8,0.625,3,6,0.5,3,3,1.0,0,2,2,2,0,0,1,2,16,9,1,WAS,DET,WAS,126,,,20,18,18,4
Danilo Gallinari,F,22023,201568,22300049,"NOV 24, 2023",WAS @ MIL,L,18,2,5,0.4,1,2,0.5,2,2,1.0,0,4,4,1,0,0,0,2,7,1,1,WAS,MIL,WAS,128,,,12,11,8,5
Danilo Gallinari,F,22023,201568,22300225,"NOV 22, 2023",WAS @ CHA,L,14,0,5,0.0,0,2,0.0,1,2,0.5,0,5,5,1,0,0,0,0,1,-18,1,WAS,CHA,WAS,114,,,7,6,2,6
Danilo Gallinari,F,22023,201568,22300219,"NOV 20, 2023",WAS vs. MIL,L,18,2,6,0.333,0,3,0.0,0,0,0.0,1,1,2,3,0,0,0,1,4,-14,1,WAS,WAS,MIL,129,,,9,6,7,5
Danilo Gallinari,F,22023,201568,22300028,"NOV 17, 2023",WAS vs. NYK,L,17,3,7,0.429,1,3,0.333,0,0,0.0,1,5,6,1,0,2,0,3,7,-3,1,WAS,WAS,NYK,99,,,14,13,8,7
Danilo Gallinari,F,22023,201568,22300192,"NOV 15, 2023",WAS vs. DAL,L,18,3,6,0.5,0,2,0.0,4,4,1.0,2,4,6,1,0,0,2,0,10,-8,1,WAS,WAS,DAL,117,,,17,16,11,7
Danilo Gallinari,F,22023,201568,22300178,"NOV 12, 2023",WAS @ BKN,L,20,3,7,0.429,1,3,0.333,5,5,1.0,0,3,3,3,1,0,0,1,12,14,1,WAS,BKN,WAS,94,,,18,15,15,6
Danilo Gallinari,F,22023,201568,22300009,"NOV 10, 2023",WAS vs. CHA,L,18,3,6,0.5,1,4,0.25,2,2,1.0,1,0,1,4,0,0,1,1,9,9,1,WAS,WAS,CHA,117,,,14,10,13,5
Danilo Gallinari,F,22023,201568,22300157,"NOV 08, 2023",WAS @ CHA,W,20,7,11,0.636,4,7,0.571,0,2,0.0,0,4,4,2,0,1,1,3,18,18,1,WAS,CHA,WAS,132,,,24,22,20,6
Danilo Gallinari,F,22023,201568,22300148,"NOV 06, 2023",WAS @ PHI,L,4,0,2,0.0,0,2,0.0,1,1,1.0,0,1,1,0,0,0,0,0,1,-9,1,WAS,PHI,WAS,128,,,2,2,1,1
Danilo Gallinari,F,22023,201568,22300003,"NOV 03, 2023",WAS @ MIA,L,9,3,5,0.6,0,1,0.0,0,2,0.0,1,2,3,3,0,0,1,0,6,-4,1,WAS,MIA,WAS,114,,,12,9,9,6
Danilo Gallinari,F,22023,201568,22300117,"NOV 01, 2023",WAS @ ATL,L,19,4,5,0.8,0,0,0.0,0,0,0.0,1,4,5,0,0,0,0,1,8,-4,1,WAS,ATL,WAS,121,,,13,13,8,5
Danilo Gallinari,F,22023,201568,22300103,"OCT 30, 2023",WAS vs. BOS,L,16,1,5,0.2,0,2,0.0,1,2,0.5,0,2,2,2,1,0,1,0,3,-14,1,WAS,WAS,BOS,107,,,7,5,5,4
Danilo Gallinari,F,22023,201568,22300089,"OCT 28, 2023",WAS vs. MEM,W,8,2,3,0.667,0,1,0.0,1,1,1.0,0,0,0,1,1,0,0,0,5,2,1,WAS,WAS,MEM,113,,,6,5,6,1
Danilo Gallinari,F,22023,201568,22300064,"OCT 25, 2023",WAS @ IND,L,17,4,7,0.571,2,2,1.0,6,6,1.0,2,1,3,0,0,0,0,1,16,5,1,WAS,IND,WAS,120,,,19,19,16,3
Danilo Gallinari,F,22023,201568,22300704,"FEB 04, 2024",DET vs. ORL,L,16,0,5,0.0,0,4,0.0,2,2,1.0,0,2,2,1,1,0,1,2,2,-7,1,DET,DET,ORL,99,,,5,4,3,3
Danilo Gallinari,F,22023,201568,22300688,"FEB 02, 2024",DET vs. LAC,L,15,1,3,0.333,1,2,0.5,8,9,0.889,1,0,1,2,0,1,0,3,11,-10,1,DET,DET,LAC,125,,,14,12,13,3
Danilo Gallinari,F,22023,201568,22300675,"JAN 31, 2024",DET @ CLE,L,23,6,8,0.75,4,4,1.0,4,5,0.8,0,3,3,2,1,0,0,1,20,13,1,DET,CLE,DET,121,,,25,23,22,5
Danilo Gallinari,F,22023,201568,22300606,"JAN 22, 2024",DET vs. MIL,L,10,3,4,0.75,1,1,1.0,2,3,0.667,0,3,3,2,0,0,0,2,9,8,1,DET,DET,MIL,113,,,14,12,11,5
Danilo Gallinari,F,22023,201568,22300592,"JAN 20, 2024",DET vs. MIL,L,16,1,1,1.0,1,1,1.0,5,5,1.0,0,1,1,3,0,0,0,0,8,20,1,DET,DET,MIL,135,,,12,9,11,4
Danilo Gallinari,F,22023,201568,22300732,"FEB 07, 2024",DET @ SAC,W,11,1,1,1.0,0,0,0.0,0,0,0.0,1,3,4,2,0,1,0,1,2,2,1,DET,SAC,DET,133,,,8,6,4,6
Danilo Gallinari,F,22023,201568,22300416,"DEC 27, 2023",WAS vs. TOR,L,5,0,2,0.0,0,1,0.0,0,0,0.0,0,1,1,0,0,0,0,0,0,-8,1,WAS,WAS,TOR,102,,,1,1,0,1
Danilo Gallinari,F,22023,201568,22300407,"DEC 26, 2023",WAS vs. ORL,L,16,2,5,0.4,1,3,0.333,4,5,0.8,1,2,3,1,0,0,1,2,9,-7,1,WAS,WAS,ORL,119,,,13,12,10,4
Danilo Gallinari,F,22023,201568,22300381,"DEC 21, 2023",WAS @ POR,W,13,1,3,0.333,1,2,0.5,1,2,0.5,0,2,2,0,0,0,0,0,4,-6,1,WAS,POR,WAS,118,,,6,6,4,2
Danilo Gallinari,F,22023,201568,22300347,"DEC 17, 2023",WAS @ PHX,L,12,1,2,0.5,1,2,0.5,3,3,1.0,0,1,1,0,1,0,0,0,6,-10,1,WAS,PHX,WAS,108,,,7,7,6,1
Danilo Gallinari,F,22023,201568,22300328,"DEC 15, 2023",WAS vs. IND,W,10,1,2,0.5,0,1,0.0,2,2,1.0,1,4,5,1,0,0,0,0,4,14,1,WAS,WAS,IND,137,,,10,9,5,6
Danilo Gallinari,F,22023,201568,22300311,"DEC 13, 2023",WAS vs. NOP,L,16,2,6,0.333,1,3,0.333,4,4,1.0,0,1,1,1,0,0,1,0,9,-20,1,WAS,WAS,NOP,122,,,11,10,10,2
Danilo Gallinari,F,22023,201568,22300295,"DEC 11, 2023",WAS @ PHI,L,11,0,0,0.0,0,0,0.0,2,2,1.0,0,1,1,0,0,0,2,2,2,-8,1,WAS,PHI,WAS,99,,,3,3,2,1
Danilo Gallinari,F,22023,201568,22301219,"DEC 08, 2023",WAS @ BKN,L,19,2,9,0.222,0,5,0.0,0,0,0.0,0,2,2,1,0,0,0,3,4,1,1,WAS,BKN,WAS,97,,,7,6,5,3
Danilo Gallinari,F,22023,201568,22301208,"DEC 06, 2023",WAS vs. PHI,L,17,2,6,0.333,2,5,0.4,1,1,1.0,0,6,6,2,1,0,0,1,7,-1,1,WAS,WAS,PHI,126,,,15,13,9,8
Danilo Gallinari,F,22023,201568,22300274,"DEC 01, 2023",WAS @ ORL,L,21,3,4,0.75,1,1,1.0,0,0,0.0,1,5,6,1,1,0,1,2,7,-4,1,WAS,ORL,WAS,125,,,14,13,8,7
Danilo Gallinari,F,22023,201568,22300259,"NOV 29, 2023",WAS @ ORL,L,12,1,4,0.25,0,1,0.0,4,5,0.8,0,1,1,0,0,0,0,1,6,-12,1,WAS,ORL,WAS,120,,,7,7,6,1
Danilo Gallinari,F,22023,201568,22300253,"NOV 27, 2023",WAS @ DET,W,19,5,8,0.625,3,6,0.5,3,3,1.0,0,2,2,2,0,0,1,2,16,9,1,WAS,DET,WAS,126,,,20,18,18,4
Danilo Gallinari,F,22023,201568,22300049,"NOV 24, 2023",WAS @ MIL,L,18,2,5,0.4,1,2,0.5,2,2,1.0,0,4,4,1,0,0,0,2,7,1,1,WAS,MIL,WAS,128,,,12,11,8,5
Danilo Gallinari,F,22023,201568,22300225,"NOV 22, 2023",WAS @ CHA,L,14,0,5,0.0,0,2,0.0,1,2,0.5,0,5,5,1,0,0,0,0,1,-18,1,WAS,CHA,WAS,114,,,7,6,2,6
Danilo Gallinari,F,22023,201568,22300219,"NOV 20, 2023",WAS vs. MIL,L,18,2,6,0.333,0,3,0.0,0,0,0.0,1,1,2,3,0,0,0,1,4,-14,1,WAS,WAS,MIL,129,,,9,6,7,5
Danilo Gallinari,F,22023,201568,22300028,"NOV 17, 2023",WAS vs. NYK,L,17,3,7,0.429,1,3,0.333,0,0,0.0,1,5,6,1,0,2,0,3,7,-3,1,WAS,WAS,NYK,99,,,14,13,8,7
Danilo Gallinari,F,22023,201568,22300192,"NOV 15, 2023",WAS vs. DAL,L,18,3,6,0.5,0,2,0.0,4,4,1.0,2,4,6,1,0,0,2,0,10,-8,1,WAS,WAS,DAL,117,,,17,16,11,7
Danilo Gallinari,F,22023,201568,22300178,"NOV 12, 2023",WAS @ BKN,L,20,3,7,0.429,1,3,0.333,5,5,1.0,0,3,3,3,1,0,0,1,12,14,1,WAS,BKN,WAS,94,,,18,15,15,6
Danilo Gallinari,F,22023,201568,22300009,"NOV 10, 2023",WAS vs. CHA,L,18,3,6,0.5,1,4,0.25,2,2,1.0,1,0,1,4,0,0,1,1,9,9,1,WAS,WAS,CHA,117,,,14,10,13,5
Danilo Gallinari,F,22023,201568,22300157,"NOV 08, 2023",WAS @ CHA,W,20,7,11,0.636,4,7,0.571,0,2,0.0,0,4,4,2,0,1,1,3,18,18,1,WAS,CHA,WAS,132,,,24,22,20,6
Danilo Gallinari,F,22023,201568,22300148,"NOV 06, 2023",WAS @ PHI,L,4,0,2,0.0,0,2,0.0,1,1,1.0,0,1,1,0,0,0,0,0,1,-9,1,WAS,PHI,WAS,128,,,2,2,1,1
Danilo Gallinari,F,22023,201568,22300003,"NOV 03, 2023",WAS @ MIA,L,9,3,5,0.6,0,1,0.0,0,2,0.0,1,2,3,3,0,0,1,0,6,-4,1,WAS,MIA,WAS,114,,,12,9,9,6
Danilo Gallinari,F,22023,201568,22300117,"NOV 01, 2023",WAS @ ATL,L,19,4,5,0.8,0,0,0.0,0,0,0.0,1,4,5,0,0,0,0,1,8,-4,1,WAS,ATL,WAS,121,,,13,13,8,5
Danilo Gallinari,F,22023,201568,22300103,"OCT 30, 2023",WAS vs. BOS,L,16,1,5,0.2,0,2,0.0,1,2,0.5,0,2,2,2,1,0,1,0,3,-14,1,WAS,WAS,BOS,107,,,7,5,5,4
Danilo Gallinari,F,22023,201568,22300089,"OCT 28, 2023",WAS vs. MEM,W,8,2,3,0.667,0,1,0.0,1,1,1.0,0,0,0,1,1,0,0,0,5,2,1,WAS,WAS,MEM,113,,,6,5,6,1
Danilo Gallinari,F,22023,201568,22300064,"OCT 25, 2023",WAS @ IND,L,17,4,7,0.571,2,2,1.0,6,6,1.0,2,1,3,0,0,0,0,1,16,5,1,WAS,IND,WAS,120,,,19,19,16,3
Danilo Gallinari,F,22023,201568,22300704,"FEB 04, 2024",DET vs. ORL,L,16,0,5,0.0,0,4,0.0,2,2,1.0,0,2,2,1,1,0,1,2,2,-7,1,DET,DET,ORL,99,,,5,4,3,3
Danilo Gallinari,F,22023,201568,22300688,"FEB 02, 2024",DET vs. LAC,L,15,1,3,0.333,1,2,0.5,8,9,0.889,1,0,1,2,0,1,0,3,11,-10,1,DET,DET,LAC,125,,,14,12,13,3
Danilo Gallinari,F,22023,201568,22300675,"JAN 31, 2024",DET @ CLE,L,23,6,8,0.75,4,4,1.0,4,5,0.8,0,3,3,2,1,0,0,1,20,13,1,DET,CLE,DET,121,,,25,23,22,5
Danilo Gallinari,F,22023,201568,22300606,"JAN 22, 2024",DET vs. MIL,L,10,3,4,0.75,1,1,1.0,2,3,0.667,0,3,3,2,0,0,0,2,9,8,1,DET,DET,MIL,113,,,14,12,11,5
Danilo Gallinari,F,22023,201568,22300592,"JAN 20, 2024",DET vs. MIL,L,16,1,1,1.0,1,1,1.0,5,5,1.0,0,1,1,3,0,0,0,0,8,20,1,DET,DET,MIL,135,,,12,9,11,4
Danilo Gallinari,F,22023,201568,22300732,"FEB 07, 2024",DET @ SAC,W,11,1,1,1.0,0,0,0.0,0,0,0.0,1,3,4,2,0,1,0,1,2,2,1,DET,SAC,DET,133,,,8,6,4,6
Zach Collins,C,22023,1628380,22300750,"FEB 10, 2024",SAS @ BKN,L,7,0,2,0.0,0,1,0.0,2,2,1.0,0,1,1,1,0,0,2,3,2,-1,1,SAS,BKN,SAS,103,,,4,3,3,2
Zach Collins,C,22023,1628380,22300584,"JAN 19, 2024",SAS @ CHA,L,26,6,10,0.6,1,3,0.333,3,6,0.5,2,2,4,4,1,0,4,5,16,3,1,SAS,CHA,SAS,120,,,24,20,20,8
Zach Collins,C,22023,1628380,22300437,"DEC 29, 2023",SAS @ POR,L,18,8,10,0.8,0,1,0.0,1,3,0.333,1,2,3,2,0,1,1,3,17,-13,1,SAS,POR,SAS,128,,,22,20,19,5
Zach Collins,C,22023,1628380,22300361,"DEC 19, 2023",SAS @ MIL,L,29,9,16,0.563,4,7,0.571,0,0,0.0,2,6,8,2,1,2,4,3,22,-9,1,SAS,MIL,SAS,119,,,32,30,24,10
Zach Collins,C,22023,1628380,22300278,"DEC 01, 2023",SAS @ NOP,L,24,3,11,0.273,1,5,0.2,5,6,0.833,3,2,5,3,2,1,3,2,12,-18,1,SAS,NOP,SAS,106,,,20,17,15,8
Zach Collins,C,22023,1628380,22300235,"NOV 22, 2023",SAS vs. LAC,L,28,6,13,0.462,2,5,0.4,2,2,1.0,2,7,9,3,0,1,1,6,16,5,1,SAS,SAS,LAC,102,,,28,25,19,12
Zach Collins,C,22023,1628380,22300206,"NOV 18, 2023",SAS vs. MEM,L,26,4,8,0.5,1,3,0.333,7,8,0.875,4,3,7,6,0,0,3,6,16,1,1,SAS,SAS,MEM,108,,,29,23,22,13
Zach Collins,C,22023,1628380,22300021,"NOV 14, 2023",SAS @ OKC,L,31,6,11,0.545,1,4,0.25,0,0,0.0,5,3,8,1,0,0,4,3,13,-33,1,SAS,OKC,SAS,87,,,22,21,14,9
Zach Collins,C,22023,1628380,22300161,"NOV 08, 2023",SAS @ NYK,L,25,4,6,0.667,1,2,0.5,2,2,1.0,2,5,7,3,0,3,2,4,11,-12,1,SAS,NYK,SAS,105,,,21,18,14,10
Zach Collins,C,22023,1628380,22300146,"NOV 06, 2023",SAS @ IND,L,20,6,8,0.75,1,2,0.5,1,3,0.333,2,3,5,2,0,0,2,2,14,-12,1,SAS,IND,SAS,111,,,21,19,16,7
Zach Collins,C,22023,1628380,22300099,"OCT 29, 2023",SAS @ LAC,L,25,4,11,0.364,1,4,0.25,0,0,0.0,1,5,6,4,0,0,5,2,9,-36,1,SAS,LAC,SAS,83,,,19,15,13,10
Zach Collins,C,22023,1628380,22300272,"NOV 30, 2023",SAS vs. ATL,L,34,3,5,0.6,1,2,0.5,4,4,1.0,0,2,2,7,0,0,3,3,11,0,1,SAS,SAS,ATL,135,,,20,13,18,9
Zach Collins,C,22023,1628380,22300252,"NOV 26, 2023",SAS @ DEN,L,21,4,9,0.444,1,4,0.25,0,0,0.0,2,2,4,3,1,0,4,4,9,-14,1,SAS,DEN,SAS,120,,,16,13,12,7
Zach Collins,C,22023,1628380,22300051,"NOV 24, 2023",SAS @ GSW,L,31,2,12,0.167,0,7,0.0,2,2,1.0,3,5,8,6,0,0,3,3,6,-7,1,SAS,GSW,SAS,112,,,20,14,12,14
Zach Collins,C,22023,1628380,22300223,"NOV 20, 2023",SAS vs. LAC,L,28,4,11,0.364,1,5,0.2,3,4,0.75,0,3,3,0,2,0,3,1,12,-25,1,SAS,SAS,LAC,99,,,15,15,12,3
Zach Collins,C,22023,1628380,22300032,"NOV 17, 2023",SAS vs. SAC,L,34,10,14,0.714,3,5,0.6,5,6,0.833,2,6,8,5,3,1,3,5,28,19,1,SAS,SAS,SAC,120,,,41,36,33,13
Zach Collins,C,22023,1628380,22300184,"NOV 12, 2023",SAS vs. MIA,L,33,6,14,0.429,1,4,0.25,5,6,0.833,2,3,5,2,0,1,3,4,18,5,1,SAS,SAS,MIA,113,,,25,23,20,7
Zach Collins,C,22023,1628380,22300013,"NOV 10, 2023",SAS vs. MIN,L,24,5,6,0.833,1,2,0.5,0,0,0.0,1,1,2,5,0,1,1,5,11,-2,1,SAS,SAS,MIN,110,,,18,13,16,7
Zach Collins,C,22023,1628380,22300141,"NOV 05, 2023",SAS vs. TOR,L,38,8,17,0.471,1,6,0.167,4,6,0.667,2,9,11,5,0,1,1,3,21,-6,1,SAS,SAS,TOR,116,,,37,32,26,16
Zach Collins,C,22023,1628380,22300131,"NOV 02, 2023",SAS @ PHX,W,35,7,10,0.7,3,3,1.0,2,2,1.0,4,4,8,4,0,0,3,2,19,8,1,SAS,PHX,SAS,132,,,31,27,23,12
Zach Collins,C,22023,1628380,22300113,"OCT 31, 2023",SAS @ PHX,W,27,6,11,0.545,1,3,0.333,1,1,1.0,1,4,5,4,1,3,2,3,14,8,1,SAS,PHX,SAS,115,,,23,19,18,9
Zach Collins,C,22023,1628380,22300083,"OCT 27, 2023",SAS vs. HOU,W,39,4,12,0.333,0,7,0.0,1,3,0.333,0,6,6,8,4,0,4,5,9,-4,1,SAS,SAS,HOU,126,,,23,15,17,14
Zach Collins,C,22023,1628380,22300073,"OCT 25, 2023",SAS vs. DAL,L,32,6,10,0.6,0,4,0.0,2,2,1.0,1,4,5,3,1,2,3,4,14,-4,1,SAS,SAS,DAL,119,,,22,19,17,8
Zach Collins,C,22023,1628380,22300734,"FEB 08, 2024",SAS @ ORL,L,25,5,6,0.833,0,1,0.0,2,2,1.0,0,3,3,3,0,2,1,4,12,-5,1,SAS,ORL,SAS,111,,,18,15,15,6
Zach Collins,C,22023,1628380,22300730,"FEB 07, 2024",SAS @ MIA,L,17,3,6,0.5,0,1,0.0,2,2,1.0,0,4,4,3,0,0,1,5,8,-4,1,SAS,MIA,SAS,104,,,15,12,11,7
Zach Collins,C,22023,1628380,22300703,"FEB 03, 2024",SAS vs. CLE,L,20,5,12,0.417,0,3,0.0,0,0,0.0,3,6,9,1,1,0,2,3,10,-28,1,SAS,SAS,CLE,101,,,20,19,11,10
Zach Collins,C,22023,1628380,22300696,"FEB 02, 2024",SAS vs. NOP,L,20,4,9,0.444,0,0,0.0,1,2,0.5,1,1,2,3,0,0,1,3,9,8,1,SAS,SAS,NOP,113,,,14,11,12,5
Zach Collins,C,22023,1628380,22300622,"JAN 24, 2024",SAS vs. OKC,L,17,3,8,0.375,1,2,0.5,3,4,0.75,2,1,3,2,1,2,2,1,10,-18,1,SAS,SAS,OKC,114,,,15,13,12,5
Zach Collins,C,22023,1628380,22300594,"JAN 20, 2024",SAS @ WAS,W,20,4,9,0.444,0,1,0.0,0,0,0.0,1,2,3,3,0,0,1,2,8,0,1,SAS,WAS,SAS,131,,,14,11,11,6
Zach Collins,C,22023,1628380,22300427,"DEC 28, 2023",SAS @ POR,W,17,4,9,0.444,0,2,0.0,3,4,0.75,1,6,7,2,0,0,1,6,11,7,1,SAS,POR,SAS,118,,,20,18,13,9
Zach Collins,C,22023,1628380,22300412,"DEC 26, 2023",SAS vs. UTA,L,18,3,6,0.5,0,0,0.0,0,0,0.0,1,3,4,4,0,2,1,4,6,-9,1,SAS,SAS,UTA,118,,,14,10,10,8
Zach Collins,C,22023,1628380,22300398,"DEC 23, 2023",SAS @ DAL,L,28,6,10,0.6,2,4,0.5,0,0,0.0,1,4,5,4,2,2,2,3,14,-27,1,SAS,DAL,SAS,119,,,23,19,18,9
Zach Collins,C,22023,1628380,22300376,"DEC 21, 2023",SAS @ CHI,L,28,5,10,0.5,2,4,0.5,2,2,1.0,3,6,9,2,0,3,1,2,14,-20,1,SAS,CHI,SAS,95,,,25,23,16,11
Zach Collins,C,22023,1628380,22300345,"DEC 17, 2023",SAS vs. NOP,L,16,1,3,0.333,0,1,0.0,0,0,0.0,1,4,5,2,0,0,0,2,2,-18,1,SAS,SAS,NOP,110,,,9,7,4,7
Zach Collins,C,22023,1628380,22300331,"DEC 15, 2023",SAS vs. LAL,W,19,5,9,0.556,1,2,0.5,5,6,0.833,4,2,6,1,0,0,1,4,16,-1,1,SAS,SAS,LAL,129,,,23,22,17,7
Zach Collins,C,22023,1628380,22300316,"DEC 13, 2023",SAS vs. LAL,L,19,3,8,0.375,2,3,0.667,2,2,1.0,1,1,2,0,0,0,1,3,10,-2,1,SAS,SAS,LAL,119,,,12,12,10,2
Zach Collins,C,22023,1628380,22300298,"DEC 11, 2023",SAS @ HOU,L,14,1,4,0.25,0,0,0.0,0,0,0.0,0,4,4,0,0,0,2,3,2,3,1,SAS,HOU,SAS,82,,,6,6,2,4
Zach Collins,C,22023,1628380,22301223,"DEC 08, 2023",SAS vs. CHI,L,23,4,5,0.8,2,2,1.0,2,3,0.667,3,7,10,5,1,0,1,1,12,13,1,SAS,SAS,CHI,112,,,27,22,17,15
Zach Collins,C,22023,1628380,22301210,"DEC 06, 2023",SAS @ MIN,L,28,6,20,0.3,0,6,0.0,0,0,0.0,4,4,8,4,0,0,3,3,12,-13,1,SAS,MIN,SAS,94,,,24,20,16,12
Zach Collins,C,22023,1628380,22300641,"JAN 26, 2024",SAS vs. POR,W,18,1,6,0.167,0,4,0.0,2,2,1.0,2,1,3,0,0,0,1,4,4,-8,1,SAS,SAS,POR,116,,,7,7,4,3
Zach Collins,C,22023,1628380,22300608,"JAN 22, 2024",SAS @ PHI,L,20,0,7,0.0,0,5,0.0,1,2,0.5,2,4,6,4,0,0,1,2,1,-10,1,SAS,PHI,SAS,123,,,11,7,5,10
Donte DiVincenzo,G,22023,1628978,22300755,"FEB 10, 2024",NYK vs. IND,L,39,6,15,0.4,2,9,0.222,0,1,0.0,0,3,3,4,1,1,1,2,14,-9,1,NYK,NYK,IND,111,,,21,17,18,7
Donte DiVincenzo,G,22023,1628978,22300736,"FEB 08, 2024",NYK vs. DAL,L,43,13,26,0.5,7,12,0.583,3,4,0.75,0,2,2,3,0,0,4,0,36,-19,1,NYK,NYK,DAL,108,,,41,38,39,5
Donte DiVincenzo,G,22023,1628978,22300722,"FEB 06, 2024",NYK vs. MEM,W,40,12,18,0.667,4,9,0.444,4,5,0.8,0,5,5,5,3,1,2,1,32,9,1,NYK,NYK,MEM,121,,,42,37,37,10
Donte DiVincenzo,G,22023,1628978,22300701,"FEB 03, 2024",NYK vs. LAL,L,40,10,22,0.455,6,16,0.375,0,0,0.0,1,5,6,4,0,1,0,6,26,1,1,NYK,NYK,LAL,105,,,36,32,30,10
Donte DiVincenzo,G,22023,1628978,22300685,"FEB 01, 2024",NYK vs. IND,W,38,8,26,0.308,4,16,0.25,0,0,0.0,0,2,2,3,2,0,1,1,20,-4,1,NYK,NYK,IND,109,,,25,22,23,5
Donte DiVincenzo,G,22023,1628978,22300671,"JAN 30, 2024",NYK vs. UTA,W,39,11,22,0.5,9,15,0.6,2,2,1.0,2,3,5,4,4,1,0,3,33,23,1,NYK,NYK,UTA,118,,,42,38,37,9
Donte DiVincenzo,G,22023,1628978,22300657,"JAN 29, 2024",NYK @ CHA,W,42,10,22,0.455,5,15,0.333,3,4,0.75,0,6,6,5,0,1,2,3,28,24,1,NYK,CHA,NYK,113,,,39,34,33,11
Donte DiVincenzo,G,22023,1628978,22300643,"JAN 27, 2024",NYK vs. MIA,W,20,4,10,0.4,3,6,0.5,0,0,0.0,1,0,1,2,1,0,0,1,11,0,1,NYK,NYK,MIA,125,,,14,12,13,3
Donte DiVincenzo,G,22023,1628978,22300631,"JAN 25, 2024",NYK vs. DEN,W,26,5,10,0.5,4,9,0.444,2,2,1.0,2,1,3,6,1,0,0,2,16,27,1,NYK,NYK,DEN,122,,,25,19,22,9
Donte DiVincenzo,G,22023,1628978,22300615,"JAN 23, 2024",NYK @ BKN,W,25,4,10,0.4,3,8,0.375,0,0,0.0,1,4,5,0,1,0,3,0,11,-7,1,NYK,BKN,NYK,108,,,16,16,11,5
Donte DiVincenzo,G,22023,1628978,22300596,"JAN 20, 2024",NYK vs. TOR,W,20,7,12,0.583,2,7,0.286,1,3,0.333,1,2,3,1,1,0,0,1,17,5,1,NYK,NYK,TOR,126,,,21,20,18,4
Donte DiVincenzo,G,22023,1628978,22300579,"JAN 18, 2024",NYK vs. WAS,W,38,6,15,0.4,5,12,0.417,2,2,1.0,0,3,3,3,0,1,3,4,19,15,1,NYK,NYK,WAS,113,,,25,22,22,6
Donte DiVincenzo,G,22023,1628978,22300573,"JAN 17, 2024",NYK vs. HOU,W,19,2,7,0.286,1,4,0.25,0,0,0.0,0,2,2,5,0,0,2,1,5,7,1,NYK,NYK,HOU,109,,,12,7,10,7
Donte DiVincenzo,G,22023,1628978,22300557,"JAN 15, 2024",NYK vs. ORL,L,24,5,12,0.417,2,8,0.25,3,6,0.5,2,4,6,4,0,1,0,2,15,9,1,NYK,NYK,ORL,94,,,25,21,19,10
Donte DiVincenzo,G,22023,1628978,22300544,"JAN 13, 2024",NYK @ MEM,W,33,4,14,0.286,3,11,0.273,2,3,0.667,0,3,3,4,4,0,2,2,13,8,1,NYK,MEM,NYK,106,,,20,16,17,7
Donte DiVincenzo,G,22023,1628978,22300530,"JAN 11, 2024",NYK @ DAL,L,30,7,13,0.538,5,10,0.5,0,0,0.0,1,3,4,3,2,0,2,4,19,-6,1,NYK,DAL,NYK,124,,,26,23,22,7
Donte DiVincenzo,G,22023,1628978,22300514,"JAN 09, 2024",NYK vs. POR,W,19,4,9,0.444,3,8,0.375,2,2,1.0,0,4,4,2,1,0,0,2,13,14,1,NYK,NYK,POR,112,,,19,17,15,6
Donte DiVincenzo,G,22023,1628978,22300494,"JAN 06, 2024",NYK @ WAS,W,26,4,10,0.4,2,7,0.286,0,0,0.0,1,4,5,3,1,0,1,1,10,3,1,NYK,WAS,NYK,121,,,18,15,13,8
Donte DiVincenzo,G,22023,1628978,22300483,"JAN 05, 2024",NYK @ PHI,W,17,4,6,0.667,4,6,0.667,2,2,1.0,1,1,2,3,1,0,2,4,14,-7,1,NYK,PHI,NYK,128,,,19,16,17,5
Donte DiVincenzo,G,22023,1628978,22300468,"JAN 03, 2024",NYK vs. CHI,W,25,4,10,0.4,3,8,0.375,0,0,0.0,1,4,5,5,1,0,3,2,11,18,1,NYK,NYK,CHI,116,,,21,16,16,10
Donte DiVincenzo,G,22023,1628978,22300451,"JAN 01, 2024",NYK vs. MIN,W,26,5,11,0.455,2,6,0.333,3,4,0.75,1,3,4,2,1,1,1,0,15,15,1,NYK,NYK,MIN,112,,,21,19,17,6
Donte DiVincenzo,G,22023,1628978,22300441,"DEC 30, 2023",NYK @ IND,L,36,15,21,0.714,7,11,0.636,1,1,1.0,2,4,6,2,4,1,1,2,38,-17,1,NYK,IND,NYK,124,,,46,44,40,8
Donte DiVincenzo,G,22023,1628978,22300388,"DEC 23, 2023",NYK vs. MIL,L,24,4,7,0.571,3,6,0.5,0,0,0.0,1,1,2,2,1,0,1,3,11,-2,1,NYK,NYK,MIL,109,,,15,13,13,4
Donte DiVincenzo,G,22023,1628978,22300368,"DEC 20, 2023",NYK @ BKN,W,23,9,15,0.6,5,10,0.5,0,0,0.0,2,6,8,1,3,0,2,2,23,13,1,NYK,BKN,NYK,119,,,32,31,24,9
Donte DiVincenzo,G,22023,1628978,22300343,"DEC 16, 2023",NYK @ LAC,L,22,5,8,0.625,5,8,0.625,3,3,1.0,0,1,1,1,1,0,0,3,18,-22,1,NYK,LAC,NYK,120,,,20,19,19,2
Donte DiVincenzo,G,22023,1628978,22300333,"DEC 15, 2023",NYK @ PHX,W,19,2,3,0.667,1,2,0.5,0,0,0.0,0,1,1,1,1,0,0,4,5,-13,1,NYK,PHX,NYK,139,,,7,6,6,2
Donte DiVincenzo,G,22023,1628978,22301201,"DEC 05, 2023",NYK @ MIL,L,17,2,5,0.4,1,4,0.25,2,2,1.0,0,1,1,2,0,0,0,2,7,-12,1,NYK,MIL,NYK,122,,,10,8,9,3
Donte DiVincenzo,G,22023,1628978,22300221,"NOV 20, 2023",NYK @ MIN,L,26,2,8,0.25,1,6,0.167,2,2,1.0,2,1,3,5,1,0,0,3,7,3,1,NYK,MIN,NYK,100,,,15,10,12,8
Donte DiVincenzo,G,22023,1628978,22300028,"NOV 17, 2023",NYK @ WAS,W,25,5,9,0.556,4,8,0.5,0,0,0.0,2,2,4,1,0,0,1,1,14,2,1,NYK,WAS,NYK,120,,,19,18,15,5
Donte DiVincenzo,G,22023,1628978,22300177,"NOV 12, 2023",NYK vs. CHA,W,23,3,8,0.375,1,6,0.167,2,3,0.667,1,0,1,2,0,1,1,2,9,16,1,NYK,NYK,CHA,129,,,12,10,11,3
Donte DiVincenzo,G,22023,1628978,22300161,"NOV 08, 2023",NYK vs. SAS,W,20,1,6,0.167,1,3,0.333,0,0,0.0,1,3,4,2,1,0,0,1,3,-12,1,NYK,NYK,SAS,126,,,9,7,5,6
Donte DiVincenzo,G,22023,1628978,22300112,"OCT 31, 2023",NYK @ CLE,W,15,1,3,0.333,1,3,0.333,0,0,0.0,0,2,2,6,1,0,1,3,3,9,1,NYK,CLE,NYK,109,,,11,5,9,8
Donte DiVincenzo,G,22023,1628978,22300429,"DEC 29, 2023",NYK @ ORL,L,20,1,7,0.143,0,5,0.0,0,0,0.0,0,1,1,2,3,1,1,4,2,-12,1,NYK,ORL,NYK,106,,,5,3,4,3
Donte DiVincenzo,G,22023,1628978,22300419,"DEC 27, 2023",NYK @ OKC,L,21,6,10,0.6,5,9,0.556,0,0,0.0,0,2,2,0,0,0,1,2,17,-1,1,NYK,OKC,NYK,116,,,19,19,17,2
Donte DiVincenzo,G,22023,1628978,22300401,"DEC 25, 2023",NYK vs. MIL,W,21,1,6,0.167,1,5,0.2,0,0,0.0,0,1,1,4,1,0,1,4,3,2,1,NYK,NYK,MIL,129,,,8,4,7,5
Donte DiVincenzo,G,22023,1628978,22300359,"DEC 18, 2023",NYK @ LAL,W,19,3,5,0.6,2,4,0.5,0,0,0.0,0,1,1,3,0,1,1,1,8,-2,1,NYK,LAL,NYK,114,,,12,9,11,4
Donte DiVincenzo,G,22023,1628978,22300318,"DEC 13, 2023",NYK @ UTA,L,27,6,13,0.462,4,9,0.444,5,7,0.714,3,4,7,1,4,0,0,2,21,12,1,NYK,UTA,NYK,113,,,29,28,22,8
Donte DiVincenzo,G,22023,1628978,22300297,"DEC 11, 2023",NYK vs. TOR,W,19,1,2,0.5,1,2,0.5,0,0,0.0,0,4,4,5,0,1,1,3,3,1,1,NYK,NYK,TOR,136,,,12,7,8,9
Donte DiVincenzo,G,22023,1628978,22301227,"DEC 08, 2023",NYK @ BOS,L,22,2,6,0.333,2,5,0.4,0,0,0.0,0,4,4,2,0,0,1,2,6,-21,1,NYK,BOS,NYK,123,,,12,10,8,6
Donte DiVincenzo,G,22023,1628978,22300276,"DEC 01, 2023",NYK @ TOR,W,22,7,10,0.7,7,9,0.778,0,0,0.0,0,1,1,1,0,0,0,0,21,0,1,NYK,TOR,NYK,119,,,23,22,22,2
Donte DiVincenzo,G,22023,1628978,22300268,"NOV 30, 2023",NYK vs. DET,W,23,4,8,0.5,4,8,0.5,0,0,0.0,0,3,3,2,0,1,0,1,12,0,1,NYK,NYK,DET,118,,,17,15,14,5
Donte DiVincenzo,G,22023,1628978,22300057,"NOV 28, 2023",NYK vs. CHA,W,19,2,8,0.25,2,6,0.333,0,0,0.0,0,2,2,0,1,0,2,0,6,3,1,NYK,NYK,CHA,115,,,8,8,6,2
Donte DiVincenzo,G,22023,1628978,22300247,"NOV 26, 2023",NYK vs. PHX,L,14,2,6,0.333,2,3,0.667,0,0,0.0,0,1,1,0,2,0,0,1,6,-1,1,NYK,NYK,PHX,113,,,7,7,6,1
Donte DiVincenzo,G,22023,1628978,22300045,"NOV 24, 2023",NYK vs. MIA,W,16,1,4,0.25,1,2,0.5,2,3,0.667,1,3,4,1,1,0,3,1,5,7,1,NYK,NYK,MIA,100,,,10,9,6,5
Donte DiVincenzo,G,22023,1628978,22300202,"NOV 18, 2023",NYK @ CHA,W,28,9,12,0.75,7,10,0.7,0,0,0.0,0,3,3,3,3,1,0,1,25,11,1,NYK,CHA,NYK,122,,,31,28,28,6
Donte DiVincenzo,G,22023,1628978,22300151,"NOV 06, 2023",NYK vs. LAC,W,16,4,6,0.667,3,5,0.6,1,2,0.5,2,4,6,1,1,1,1,1,12,13,1,NYK,NYK,LAC,111,,,19,18,13,7
Donte DiVincenzo,G,22023,1628978,22300090,"OCT 28, 2023",NYK @ NOP,L,20,2,7,0.286,1,5,0.2,0,0,0.0,2,2,4,1,2,0,2,3,5,-8,1,NYK,NOP,NYK,87,,,10,9,6,5
Donte DiVincenzo,G,22023,1628978,22300079,"OCT 27, 2023",NYK @ ATL,W,20,6,10,0.6,3,5,0.6,1,2,0.5,1,1,2,1,1,1,2,2,16,-5,1,NYK,ATL,NYK,126,,,19,18,17,3
Donte DiVincenzo,G,22023,1628978,22300065,"OCT 25, 2023",NYK vs. BOS,L,15,0,4,0.0,0,3,0.0,0,0,0.0,0,3,3,2,0,0,0,1,0,5,1,NYK,NYK,BOS,104,,,5,3,2,5
Donte DiVincenzo,G,22023,1628978,22300193,"NOV 15, 2023",NYK @ ATL,W,22,3,8,0.375,0,2,0.0,0,0,0.0,1,3,4,3,2,0,4,1,6,-8,1,NYK,ATL,NYK,116,,,13,10,9,7
Donte DiVincenzo,G,22023,1628978,22300188,"NOV 13, 2023",NYK @ BOS,L,16,2,6,0.333,1,4,0.25,0,0,0.0,1,0,1,1,0,0,0,1,5,-3,1,NYK,BOS,NYK,98,,,7,6,6,2
Donte DiVincenzo,G,22023,1628978,22300002,"NOV 03, 2023",NYK @ MIL,L,18,1,8,0.125,1,4,0.25,0,0,0.0,1,3,4,0,0,0,1,0,3,-10,1,NYK,MIL,NYK,105,,,7,7,3,4
Donte DiVincenzo,G,22023,1628978,22300120,"NOV 01, 2023",NYK vs. CLE,L,30,5,10,0.5,3,7,0.429,3,5,0.6,0,2,2,0,2,1,3,3,16,1,1,NYK,NYK,CLE,89,,,18,18,16,2
Bruce Brown,G,22023,1628971,22300756,"FEB 10, 2024",TOR vs. CLE,L,20,1,5,0.2,0,2,0.0,0,0,0.0,0,2,2,0,0,0,1,1,2,-21,1,TOR,TOR,CLE,95,,,4,4,2,2
Bruce Brown,G,22023,1628971,22300744,"FEB 09, 2024",TOR vs. HOU,W,22,5,13,0.385,0,2,0.0,1,1,1.0,2,1,3,0,1,0,1,2,11,-13,1,TOR,TOR,HOU,100,,,14,14,11,3
Bruce Brown,G,22023,1628971,22300726,"FEB 07, 2024",TOR @ CHA,W,22,4,5,0.8,0,0,0.0,4,4,1.0,0,3,3,4,1,0,0,3,12,8,1,TOR,CHA,TOR,123,,,19,15,16,7
Bruce Brown,G,22023,1628971,22300718,"FEB 05, 2024",TOR @ NOP,L,26,4,7,0.571,1,3,0.333,0,0,0.0,1,2,3,3,0,0,1,0,9,-31,1,TOR,NOP,TOR,100,,,15,12,12,6
Bruce Brown,G,22023,1628971,22300710,"FEB 04, 2024",TOR @ OKC,L,18,0,4,0.0,0,1,0.0,2,2,1.0,0,0,0,2,0,0,0,0,2,2,1,TOR,OKC,TOR,127,,,4,2,4,2
Bruce Brown,G,22023,1628971,22300692,"FEB 02, 2024",TOR @ HOU,L,26,2,9,0.222,1,2,0.5,0,0,0.0,1,4,5,4,2,2,1,1,5,-13,1,TOR,HOU,TOR,106,,,14,10,9,9
Bruce Brown,G,22023,1628971,22300672,"JAN 30, 2024",TOR @ CHI,W,38,7,13,0.538,1,3,0.333,4,4,1.0,1,6,7,3,3,2,2,3,19,18,1,TOR,CHI,TOR,118,,,29,26,22,10
Bruce Brown,G,22023,1628971,22300653,"JAN 28, 2024",TOR @ ATL,L,37,4,12,0.333,1,2,0.5,2,2,1.0,4,5,9,2,2,1,0,4,11,-22,1,TOR,ATL,TOR,113,,,22,20,13,11
Bruce Brown,G,22023,1628971,22300637,"JAN 26, 2024",TOR vs. LAC,L,32,4,8,0.5,1,2,0.5,0,0,0.0,2,7,9,2,0,1,3,3,9,-9,1,TOR,TOR,LAC,107,,,20,18,11,11
Bruce Brown,G,22023,1628971,22300609,"JAN 22, 2024",TOR vs. MEM,L,21,3,5,0.6,1,2,0.5,0,0,0.0,0,3,3,2,0,0,2,3,7,-1,1,TOR,TOR,MEM,100,,,12,10,9,5
Bruce Brown,G,22023,1628971,22300596,"JAN 20, 2024",TOR @ NYK,L,22,3,8,0.375,0,2,0.0,2,2,1.0,1,2,3,0,1,1,2,2,8,-15,1,TOR,NYK,TOR,94,,,11,11,8,3
Bruce Brown,G,22023,1628971,22300580,"JAN 18, 2024",TOR vs. CHI,L,25,7,10,0.7,1,3,0.333,0,0,0.0,2,5,7,1,1,0,0,4,15,11,1,TOR,TOR,CHI,100,,,23,22,16,8
Bruce Brown,G,22023,1628971,22300550,"JAN 14, 2024",IND @ DEN,L,33,8,16,0.5,1,2,0.5,1,3,0.333,5,5,10,6,3,0,2,3,18,-13,1,IND,DEN,IND,109,,,34,28,24,16
Bruce Brown,G,22023,1628971,22300533,"JAN 12, 2024",IND @ ATL,W,21,5,9,0.556,2,3,0.667,0,0,0.0,0,1,1,4,0,0,2,0,12,8,1,IND,ATL,IND,126,,,17,13,16,5
Bruce Brown,G,22023,1628971,22300520,"JAN 10, 2024",IND vs. WAS,W,27,5,11,0.455,1,2,0.5,5,5,1.0,0,9,9,6,1,1,0,2,16,-3,1,IND,IND,WAS,112,,,31,25,22,15
Bruce Brown,G,22023,1628971,22300507,"JAN 08, 2024",IND vs. BOS,W,21,1,6,0.167,1,1,1.0,4,4,1.0,0,2,2,2,1,0,0,1,7,1,1,IND,IND,BOS,133,,,11,9,9,4
Bruce Brown,G,22023,1628971,22300480,"JAN 05, 2024",IND vs. ATL,W,22,8,9,0.889,1,1,1.0,0,0,0.0,0,3,3,2,0,0,2,1,17,25,1,IND,IND,ATL,148,,,22,20,19,5
Bruce Brown,G,22023,1628971,22300466,"JAN 03, 2024",IND vs. MIL,W,28,5,7,0.714,0,1,0.0,5,6,0.833,0,5,5,2,0,0,4,6,15,4,1,IND,IND,MIL,142,,,22,20,17,7
Bruce Brown,G,22023,1628971,22300377,"DEC 21, 2023",IND @ MEM,L,28,1,4,0.25,0,1,0.0,2,2,1.0,1,3,4,2,0,1,0,4,4,-6,1,IND,MEM,IND,103,,,10,8,6,6
Bruce Brown,G,22023,1628971,22300365,"DEC 20, 2023",IND vs. CHA,W,28,3,6,0.5,0,1,0.0,0,0,0.0,0,5,5,6,0,0,0,3,6,34,1,IND,IND,CHA,142,,,17,11,12,11
Bruce Brown,G,22023,1628971,22300350,"DEC 18, 2023",IND vs. LAC,L,20,4,11,0.364,0,4,0.0,3,3,1.0,3,1,4,3,1,0,2,4,11,-26,1,IND,IND,LAC,127,,,18,15,14,7
Bruce Brown,G,22023,1628971,22300338,"DEC 16, 2023",IND @ MIN,L,27,8,14,0.571,1,3,0.333,0,0,0.0,1,4,5,2,0,1,3,1,17,-20,1,IND,MIN,IND,109,,,24,22,19,7
Bruce Brown,G,22023,1628971,22300328,"DEC 15, 2023",IND @ WAS,L,23,2,7,0.286,0,2,0.0,0,0,0.0,0,2,2,1,1,0,1,4,4,-5,1,IND,WAS,IND,123,,,7,6,5,3
Bruce Brown,G,22023,1628971,22300315,"DEC 13, 2023",IND @ MIL,L,27,4,10,0.4,0,3,0.0,1,4,0.25,3,5,8,9,2,0,1,2,9,2,1,IND,MIL,IND,126,,,26,17,18,17
Bruce Brown,G,22023,1628971,22300293,"DEC 11, 2023",IND @ DET,W,37,4,11,0.364,0,4,0.0,3,4,0.75,3,6,9,0,2,0,1,3,11,8,1,IND,DET,IND,131,,,20,20,11,9
Bruce Brown,G,22023,1628971,22301229,"DEC 07, 2023",IND @ MIL,W,28,3,9,0.333,0,1,0.0,4,4,1.0,0,3,3,1,1,0,1,2,10,-5,1,IND,MIL,IND,128,,,14,13,11,4
Bruce Brown,G,22023,1628971,22301202,"DEC 04, 2023",IND vs. BOS,W,36,3,10,0.3,1,3,0.333,6,7,0.857,0,8,8,4,3,0,3,4,13,2,1,IND,IND,BOS,122,,,25,21,17,12
Bruce Brown,G,22023,1628971,22300284,"DEC 02, 2023",IND @ MIA,W,37,11,16,0.688,4,6,0.667,4,5,0.8,0,4,4,2,0,0,1,0,30,20,1,IND,MIA,IND,144,,,36,34,32,6
Bruce Brown,G,22023,1628971,22300267,"NOV 30, 2023",IND @ MIA,L,32,5,9,0.556,0,2,0.0,5,7,0.714,1,5,6,3,0,0,0,1,15,-6,1,IND,MIA,IND,132,,,24,21,18,9
Bruce Brown,G,22023,1628971,22300254,"NOV 27, 2023",IND vs. POR,L,33,5,10,0.5,1,5,0.2,0,0,0.0,0,3,3,3,2,0,2,4,11,2,1,IND,IND,POR,110,,,17,14,14,6
Bruce Brown,G,22023,1628971,22300047,"NOV 24, 2023",IND vs. DET,W,37,3,10,0.3,0,3,0.0,4,5,0.8,0,4,4,5,3,0,0,3,10,26,1,IND,IND,DET,136,,,19,14,15,9
Bruce Brown,G,22023,1628971,22300230,"NOV 22, 2023",IND vs. TOR,L,34,5,9,0.556,1,4,0.25,3,3,1.0,0,4,4,3,2,0,3,4,14,8,1,IND,IND,TOR,131,,,21,18,17,7
Bruce Brown,G,22023,1628971,22300039,"NOV 21, 2023",IND @ ATL,W,30,5,10,0.5,2,5,0.4,1,2,0.5,0,0,0,3,2,0,2,4,13,-1,1,IND,ATL,IND,157,,,16,13,16,3
Bruce Brown,G,22023,1628971,22300209,"NOV 19, 2023",IND vs. ORL,L,22,4,7,0.571,1,2,0.5,2,2,1.0,0,5,5,1,0,1,1,3,11,-20,1,IND,IND,ORL,116,,,17,16,12,6
Bruce Brown,G,22023,1628971,22300019,"NOV 14, 2023",IND @ PHI,W,36,5,11,0.455,0,2,0.0,4,4,1.0,0,5,5,3,1,0,0,4,14,9,1,IND,PHI,IND,132,,,22,19,17,8
Bruce Brown,G,22023,1628971,22300180,"NOV 12, 2023",IND @ PHI,L,31,3,5,0.6,0,1,0.0,3,4,0.75,2,2,4,3,0,2,0,1,9,-6,1,IND,PHI,IND,126,,,16,13,12,7
Bruce Brown,G,22023,1628971,22300171,"NOV 09, 2023",IND vs. MIL,W,38,3,9,0.333,1,4,0.25,4,4,1.0,2,7,9,7,2,1,2,0,11,15,1,IND,IND,MIL,126,,,27,20,18,16
Bruce Brown,G,22023,1628971,22300158,"NOV 08, 2023",IND vs. UTA,W,32,4,11,0.364,1,4,0.25,0,0,0.0,0,4,4,0,2,1,2,2,9,13,1,IND,IND,UTA,134,,,13,13,9,4
Bruce Brown,G,22023,1628971,22300146,"NOV 06, 2023",IND vs. SAS,W,24,3,7,0.429,1,3,0.333,0,0,0.0,0,5,5,4,0,0,0,1,7,21,1,IND,IND,SAS,152,,,16,12,11,9
Bruce Brown,G,22023,1628971,22300133,"NOV 04, 2023",IND vs. CHA,L,32,3,8,0.375,1,4,0.25,0,0,0.0,0,1,1,6,2,0,0,3,7,7,1,IND,IND,CHA,124,,,14,8,13,7
Bruce Brown,G,22023,1628971,22300001,"NOV 03, 2023",IND vs. CLE,W,37,8,15,0.533,3,6,0.5,0,0,0.0,1,6,7,2,0,0,2,2,19,9,1,IND,IND,CLE,121,,,28,26,21,9
Bruce Brown,G,22023,1628971,22300118,"NOV 01, 2023",IND @ BOS,L,21,1,6,0.167,0,3,0.0,1,2,0.5,0,1,1,1,1,0,0,1,3,-25,1,IND,BOS,IND,104,,,5,4,4,2
Bruce Brown,G,22023,1628971,22300102,"OCT 30, 2023",IND vs. CHI,L,37,6,12,0.5,3,6,0.5,0,0,0.0,2,5,7,1,1,0,3,2,15,-13,1,IND,IND,CHI,105,,,23,22,16,8
Bruce Brown,G,22023,1628971,22300091,"OCT 28, 2023",IND @ CLE,W,32,3,8,0.375,0,1,0.0,0,0,0.0,0,4,4,2,1,0,0,3,6,0,1,IND,CLE,IND,125,,,12,10,8,6
Bruce Brown,G,22023,1628971,22300064,"OCT 25, 2023",IND vs. WAS,W,27,8,11,0.727,6,8,0.75,2,2,1.0,1,2,3,1,1,0,1,3,24,15,1,IND,IND,WAS,143,,,28,27,25,4
Bruce Brown,G-F,22023,1628971,22300756,"FEB 10, 2024",TOR vs. CLE,L,20,1,5,0.2,0,2,0.0,0,0,0.0,0,2,2,0,0,0,1,1,2,-21,1,TOR,TOR,CLE,95,,,4,4,2,2
Bruce Brown,G-F,22023,1628971,22300744,"FEB 09, 2024",TOR vs. HOU,W,22,5,13,0.385,0,2,0.0,1,1,1.0,2,1,3,0,1,0,1,2,11,-13,1,TOR,TOR,HOU,100,,,14,14,11,3
Bruce Brown,G-F,22023,1628971,22300726,"FEB 07, 2024",TOR @ CHA,W,22,4,5,0.8,0,0,0.0,4,4,1.0,0,3,3,4,1,0,0,3,12,8,1,TOR,CHA,TOR,123,,,19,15,16,7
Bruce Brown,G-F,22023,1628971,22300718,"FEB 05, 2024",TOR @ NOP,L,26,4,7,0.571,1,3,0.333,0,0,0.0,1,2,3,3,0,0,1,0,9,-31,1,TOR,NOP,TOR,100,,,15,12,12,6
Bruce Brown,G-F,22023,1628971,22300710,"FEB 04, 2024",TOR @ OKC,L,18,0,4,0.0,0,1,0.0,2,2,1.0,0,0,0,2,0,0,0,0,2,2,1,TOR,OKC,TOR,127,,,4,2,4,2
Bruce Brown,G-F,22023,1628971,22300692,"FEB 02, 2024",TOR @ HOU,L,26,2,9,0.222,1,2,0.5,0,0,0.0,1,4,5,4,2,2,1,1,5,-13,1,TOR,HOU,TOR,106,,,14,10,9,9
Bruce Brown,G-F,22023,1628971,22300672,"JAN 30, 2024",TOR @ CHI,W,38,7,13,0.538,1,3,0.333,4,4,1.0,1,6,7,3,3,2,2,3,19,18,1,TOR,CHI,TOR,118,,,29,26,22,10
Bruce Brown,G-F,22023,1628971,22300653,"JAN 28, 2024",TOR @ ATL,L,37,4,12,0.333,1,2,0.5,2,2,1.0,4,5,9,2,2,1,0,4,11,-22,1,TOR,ATL,TOR,113,,,22,20,13,11
Bruce Brown,G-F,22023,1628971,22300637,"JAN 26, 2024",TOR vs. LAC,L,32,4,8,0.5,1,2,0.5,0,0,0.0,2,7,9,2,0,1,3,3,9,-9,1,TOR,TOR,LAC,107,,,20,18,11,11
Bruce Brown,G-F,22023,1628971,22300609,"JAN 22, 2024",TOR vs. MEM,L,21,3,5,0.6,1,2,0.5,0,0,0.0,0,3,3,2,0,0,2,3,7,-1,1,TOR,TOR,MEM,100,,,12,10,9,5
Bruce Brown,G-F,22023,1628971,22300596,"JAN 20, 2024",TOR @ NYK,L,22,3,8,0.375,0,2,0.0,2,2,1.0,1,2,3,0,1,1,2,2,8,-15,1,TOR,NYK,TOR,94,,,11,11,8,3
Bruce Brown,G-F,22023,1628971,22300580,"JAN 18, 2024",TOR vs. CHI,L,25,7,10,0.7,1,3,0.333,0,0,0.0,2,5,7,1,1,0,0,4,15,11,1,TOR,TOR,CHI,100,,,23,22,16,8
Bruce Brown,G-F,22023,1628971,22300550,"JAN 14, 2024",IND @ DEN,L,33,8,16,0.5,1,2,0.5,1,3,0.333,5,5,10,6,3,0,2,3,18,-13,1,IND,DEN,IND,109,,,34,28,24,16
Bruce Brown,G-F,22023,1628971,22300533,"JAN 12, 2024",IND @ ATL,W,21,5,9,0.556,2,3,0.667,0,0,0.0,0,1,1,4,0,0,2,0,12,8,1,IND,ATL,IND,126,,,17,13,16,5
Bruce Brown,G-F,22023,1628971,22300520,"JAN 10, 2024",IND vs. WAS,W,27,5,11,0.455,1,2,0.5,5,5,1.0,0,9,9,6,1,1,0,2,16,-3,1,IND,IND,WAS,112,,,31,25,22,15
Bruce Brown,G-F,22023,1628971,22300507,"JAN 08, 2024",IND vs. BOS,W,21,1,6,0.167,1,1,1.0,4,4,1.0,0,2,2,2,1,0,0,1,7,1,1,IND,IND,BOS,133,,,11,9,9,4
Bruce Brown,G-F,22023,1628971,22300480,"JAN 05, 2024",IND vs. ATL,W,22,8,9,0.889,1,1,1.0,0,0,0.0,0,3,3,2,0,0,2,1,17,25,1,IND,IND,ATL,148,,,22,20,19,5
Bruce Brown,G-F,22023,1628971,22300466,"JAN 03, 2024",IND vs. MIL,W,28,5,7,0.714,0,1,0.0,5,6,0.833,0,5,5,2,0,0,4,6,15,4,1,IND,IND,MIL,142,,,22,20,17,7
Bruce Brown,G-F,22023,1628971,22300377,"DEC 21, 2023",IND @ MEM,L,28,1,4,0.25,0,1,0.0,2,2,1.0,1,3,4,2,0,1,0,4,4,-6,1,IND,MEM,IND,103,,,10,8,6,6
Bruce Brown,G-F,22023,1628971,22300365,"DEC 20, 2023",IND vs. CHA,W,28,3,6,0.5,0,1,0.0,0,0,0.0,0,5,5,6,0,0,0,3,6,34,1,IND,IND,CHA,142,,,17,11,12,11
Bruce Brown,G-F,22023,1628971,22300350,"DEC 18, 2023",IND vs. LAC,L,20,4,11,0.364,0,4,0.0,3,3,1.0,3,1,4,3,1,0,2,4,11,-26,1,IND,IND,LAC,127,,,18,15,14,7
Bruce Brown,G-F,22023,1628971,22300338,"DEC 16, 2023",IND @ MIN,L,27,8,14,0.571,1,3,0.333,0,0,0.0,1,4,5,2,0,1,3,1,17,-20,1,IND,MIN,IND,109,,,24,22,19,7
Bruce Brown,G-F,22023,1628971,22300328,"DEC 15, 2023",IND @ WAS,L,23,2,7,0.286,0,2,0.0,0,0,0.0,0,2,2,1,1,0,1,4,4,-5,1,IND,WAS,IND,123,,,7,6,5,3
Bruce Brown,G-F,22023,1628971,22300315,"DEC 13, 2023",IND @ MIL,L,27,4,10,0.4,0,3,0.0,1,4,0.25,3,5,8,9,2,0,1,2,9,2,1,IND,MIL,IND,126,,,26,17,18,17
Bruce Brown,G-F,22023,1628971,22300293,"DEC 11, 2023",IND @ DET,W,37,4,11,0.364,0,4,0.0,3,4,0.75,3,6,9,0,2,0,1,3,11,8,1,IND,DET,IND,131,,,20,20,11,9
Bruce Brown,G-F,22023,1628971,22301229,"DEC 07, 2023",IND @ MIL,W,28,3,9,0.333,0,1,0.0,4,4,1.0,0,3,3,1,1,0,1,2,10,-5,1,IND,MIL,IND,128,,,14,13,11,4
Bruce Brown,G-F,22023,1628971,22301202,"DEC 04, 2023",IND vs. BOS,W,36,3,10,0.3,1,3,0.333,6,7,0.857,0,8,8,4,3,0,3,4,13,2,1,IND,IND,BOS,122,,,25,21,17,12
Bruce Brown,G-F,22023,1628971,22300284,"DEC 02, 2023",IND @ MIA,W,37,11,16,0.688,4,6,0.667,4,5,0.8,0,4,4,2,0,0,1,0,30,20,1,IND,MIA,IND,144,,,36,34,32,6
Bruce Brown,G-F,22023,1628971,22300267,"NOV 30, 2023",IND @ MIA,L,32,5,9,0.556,0,2,0.0,5,7,0.714,1,5,6,3,0,0,0,1,15,-6,1,IND,MIA,IND,132,,,24,21,18,9
Bruce Brown,G-F,22023,1628971,22300254,"NOV 27, 2023",IND vs. POR,L,33,5,10,0.5,1,5,0.2,0,0,0.0,0,3,3,3,2,0,2,4,11,2,1,IND,IND,POR,110,,,17,14,14,6
Bruce Brown,G-F,22023,1628971,22300047,"NOV 24, 2023",IND vs. DET,W,37,3,10,0.3,0,3,0.0,4,5,0.8,0,4,4,5,3,0,0,3,10,26,1,IND,IND,DET,136,,,19,14,15,9
Bruce Brown,G-F,22023,1628971,22300230,"NOV 22, 2023",IND vs. TOR,L,34,5,9,0.556,1,4,0.25,3,3,1.0,0,4,4,3,2,0,3,4,14,8,1,IND,IND,TOR,131,,,21,18,17,7
Bruce Brown,G-F,22023,1628971,22300039,"NOV 21, 2023",IND @ ATL,W,30,5,10,0.5,2,5,0.4,1,2,0.5,0,0,0,3,2,0,2,4,13,-1,1,IND,ATL,IND,157,,,16,13,16,3
Bruce Brown,G-F,22023,1628971,22300209,"NOV 19, 2023",IND vs. ORL,L,22,4,7,0.571,1,2,0.5,2,2,1.0,0,5,5,1,0,1,1,3,11,-20,1,IND,IND,ORL,116,,,17,16,12,6
Bruce Brown,G-F,22023,1628971,22300019,"NOV 14, 2023",IND @ PHI,W,36,5,11,0.455,0,2,0.0,4,4,1.0,0,5,5,3,1,0,0,4,14,9,1,IND,PHI,IND,132,,,22,19,17,8
Bruce Brown,G-F,22023,1628971,22300180,"NOV 12, 2023",IND @ PHI,L,31,3,5,0.6,0,1,0.0,3,4,0.75,2,2,4,3,0,2,0,1,9,-6,1,IND,PHI,IND,126,,,16,13,12,7
Bruce Brown,G-F,22023,1628971,22300171,"NOV 09, 2023",IND vs. MIL,W,38,3,9,0.333,1,4,0.25,4,4,1.0,2,7,9,7,2,1,2,0,11,15,1,IND,IND,MIL,126,,,27,20,18,16
Bruce Brown,G-F,22023,1628971,22300158,"NOV 08, 2023",IND vs. UTA,W,32,4,11,0.364,1,4,0.25,0,0,0.0,0,4,4,0,2,1,2,2,9,13,1,IND,IND,UTA,134,,,13,13,9,4
Bruce Brown,G-F,22023,1628971,22300146,"NOV 06, 2023",IND vs. SAS,W,24,3,7,0.429,1,3,0.333,0,0,0.0,0,5,5,4,0,0,0,1,7,21,1,IND,IND,SAS,152,,,16,12,11,9
Bruce Brown,G-F,22023,1628971,22300133,"NOV 04, 2023",IND vs. CHA,L,32,3,8,0.375,1,4,0.25,0,0,0.0,0,1,1,6,2,0,0,3,7,7,1,IND,IND,CHA,124,,,14,8,13,7
Bruce Brown,G-F,22023,1628971,22300001,"NOV 03, 2023",IND vs. CLE,W,37,8,15,0.533,3,6,0.5,0,0,0.0,1,6,7,2,0,0,2,2,19,9,1,IND,IND,CLE,121,,,28,26,21,9
Bruce Brown,G-F,22023,1628971,22300118,"NOV 01, 2023",IND @ BOS,L,21,1,6,0.167,0,3,0.0,1,2,0.5,0,1,1,1,1,0,0,1,3,-25,1,IND,BOS,IND,104,,,5,4,4,2
Bruce Brown,G-F,22023,1628971,22300102,"OCT 30, 2023",IND vs. CHI,L,37,6,12,0.5,3,6,0.5,0,0,0.0,2,5,7,1,1,0,3,2,15,-13,1,IND,IND,CHI,105,,,23,22,16,8
Bruce Brown,G-F,22023,1628971,22300091,"OCT 28, 2023",IND @ CLE,W,32,3,8,0.375,0,1,0.0,0,0,0.0,0,4,4,2,1,0,0,3,6,0,1,IND,CLE,IND,125,,,12,10,8,6
Bruce Brown,G-F,22023,1628971,22300064,"OCT 25, 2023",IND vs. WAS,W,27,8,11,0.727,6,8,0.75,2,2,1.0,1,2,3,1,1,0,1,3,24,15,1,IND,IND,WAS,143,,,28,27,25,4
Lonnie Walker IV,G-F,22023,1629022,22300750,"FEB 10, 2024",BKN vs. SAS,W,6,0,1,0.0,0,1,0.0,0,0,0.0,0,0,0,0,0,0,1,0,0,1,1,BKN,BKN,SAS,123,,,0,0,0,0
Lonnie Walker IV,G-F,22023,1629022,22300717,"FEB 05, 2024",BKN vs. GSW,L,5,1,2,0.5,1,2,0.5,0,0,0.0,0,0,0,0,0,0,0,0,3,4,1,BKN,BKN,GSW,98,,,3,3,3,0
Lonnie Walker IV,G-F,22023,1629022,22300698,"FEB 03, 2024",BKN @ PHI,W,30,8,16,0.5,3,8,0.375,1,1,1.0,1,1,2,3,0,0,0,3,20,12,1,BKN,PHI,BKN,136,,,25,22,23,5
Lonnie Walker IV,G-F,22023,1629022,22300677,"JAN 31, 2024",BKN vs. PHX,L,31,7,16,0.438,3,8,0.375,2,2,1.0,1,2,3,7,4,0,2,4,19,-14,1,BKN,BKN,PHX,120,,,29,22,26,10
Lonnie Walker IV,G-F,22023,1629022,22300660,"JAN 29, 2024",BKN vs. UTA,W,27,7,14,0.5,4,9,0.444,1,2,0.5,1,1,2,4,1,1,0,2,19,17,1,BKN,BKN,UTA,147,,,25,21,23,6
Lonnie Walker IV,G-F,22023,1629022,22300645,"JAN 27, 2024",BKN vs. HOU,W,14,0,4,0.0,0,3,0.0,0,0,0.0,0,1,1,0,1,0,0,1,0,-1,1,BKN,BKN,HOU,106,,,1,1,0,1
Lonnie Walker IV,G-F,22023,1629022,22300629,"JAN 25, 2024",BKN vs. MIN,L,14,1,5,0.2,0,3,0.0,0,0,0.0,0,0,0,1,1,0,2,2,2,-12,1,BKN,BKN,MIN,94,,,3,2,3,1
Lonnie Walker IV,G-F,22023,1629022,22300615,"JAN 23, 2024",BKN vs. NYK,L,12,2,8,0.25,1,5,0.2,0,0,0.0,1,0,1,0,0,0,0,0,5,-9,1,BKN,BKN,NYK,103,,,6,6,5,1
Lonnie Walker IV,G-F,22023,1629022,22300600,"JAN 21, 2024",BKN @ LAC,L,10,3,4,0.75,2,2,1.0,0,0,0.0,0,2,2,0,2,0,0,3,8,1,1,BKN,LAC,BKN,114,,,10,10,8,2
Lonnie Walker IV,G-F,22023,1629022,22300591,"JAN 19, 2024",BKN @ LAL,W,13,6,7,0.857,3,4,0.75,0,0,0.0,0,1,1,3,0,0,1,2,15,4,1,BKN,LAL,BKN,130,,,19,16,18,4
Lonnie Walker IV,G-F,22023,1629022,22300578,"JAN 17, 2024",BKN @ POR,L,19,5,10,0.5,3,7,0.429,0,0,0.0,0,1,1,0,1,0,1,0,13,10,1,BKN,POR,BKN,103,,,14,14,13,1
Lonnie Walker IV,G-F,22023,1629022,22300562,"JAN 15, 2024",BKN vs. MIA,L,9,0,3,0.0,0,2,0.0,0,0,0.0,0,2,2,1,0,1,1,1,0,0,1,BKN,BKN,MIA,95,,,3,2,1,3
Lonnie Walker IV,G-F,22023,1629022,22300527,"JAN 11, 2024",BKN @ CLE,L,25,8,12,0.667,4,5,0.8,0,0,0.0,1,2,3,2,1,1,1,3,20,2,1,BKN,CLE,BKN,102,,,25,23,22,5
Lonnie Walker IV,G-F,22023,1629022,22300498,"JAN 07, 2024",BKN vs. POR,L,6,0,3,0.0,0,2,0.0,0,0,0.0,0,1,1,0,0,0,0,2,0,1,1,BKN,BKN,POR,127,,,1,1,0,1
Lonnie Walker IV,G-F,22023,1629022,22300481,"JAN 05, 2024",BKN vs. OKC,W,6,0,2,0.0,0,1,0.0,0,0,0.0,0,1,1,0,1,0,0,0,0,7,1,BKN,BKN,OKC,124,,,1,1,0,1
Lonnie Walker IV,G-F,22023,1629022,22300266,"NOV 30, 2023",BKN vs. CHA,L,14,2,5,0.4,2,4,0.5,1,2,0.5,1,1,2,1,0,0,1,1,7,-6,1,BKN,BKN,CHA,128,,,10,9,8,3
Lonnie Walker IV,G-F,22023,1629022,22300054,"NOV 28, 2023",BKN vs. TOR,W,23,2,6,0.333,1,4,0.25,2,3,0.667,0,1,1,2,0,1,3,0,7,-2,1,BKN,BKN,TOR,115,,,10,8,9,3
Lonnie Walker IV,G-F,22023,1629022,22300250,"NOV 26, 2023",BKN vs. CHI,W,25,6,13,0.462,6,10,0.6,2,2,1.0,0,1,1,0,2,0,2,1,20,23,1,BKN,BKN,CHI,118,,,21,21,20,1
Lonnie Walker IV,G-F,22023,1629022,22300240,"NOV 25, 2023",BKN vs. MIA,W,14,2,6,0.333,2,5,0.4,2,2,1.0,0,1,1,0,0,0,2,1,8,-5,1,BKN,BKN,MIA,112,,,9,9,8,1
Lonnie Walker IV,G-F,22023,1629022,22300227,"NOV 22, 2023",BKN @ ATL,L,16,3,7,0.429,2,4,0.5,0,1,0.0,0,2,2,1,0,1,1,1,8,0,1,BKN,ATL,BKN,145,,,11,10,9,3
Lonnie Walker IV,G-F,22023,1629022,22300208,"NOV 19, 2023",BKN vs. PHI,L,32,9,17,0.529,6,11,0.545,2,2,1.0,0,6,6,2,0,0,2,1,26,-2,1,BKN,BKN,PHI,99,,,34,32,28,8
Lonnie Walker IV,G-F,22023,1629022,22300200,"NOV 16, 2023",BKN @ MIA,L,26,9,18,0.5,2,7,0.286,3,4,0.75,1,2,3,1,1,0,2,2,23,-7,1,BKN,MIA,BKN,115,,,27,26,24,4
Lonnie Walker IV,G-F,22023,1629022,22300020,"NOV 14, 2023",BKN vs. ORL,W,20,4,9,0.444,3,6,0.5,0,0,0.0,0,2,2,1,2,0,2,0,11,6,1,BKN,BKN,ORL,124,,,14,13,12,3
Lonnie Walker IV,G-F,22023,1629022,22300178,"NOV 12, 2023",BKN vs. WAS,W,14,2,8,0.25,1,3,0.333,0,0,0.0,0,2,2,2,0,0,1,1,5,-1,1,BKN,BKN,WAS,102,,,9,7,7,4
Lonnie Walker IV,G-F,22023,1629022,22300010,"NOV 10, 2023",BKN @ BOS,L,20,8,12,0.667,3,4,0.75,1,1,1.0,0,7,7,4,0,1,0,0,20,0,1,BKN,BOS,BKN,107,,,31,27,24,11
Lonnie Walker IV,G-F,22023,1629022,22300160,"NOV 08, 2023",BKN vs. LAC,W,28,8,16,0.5,3,7,0.429,2,2,1.0,0,1,1,0,1,1,0,0,21,10,1,BKN,BKN,LAC,100,,,22,22,21,1
Lonnie Walker IV,G-F,22023,1629022,22300149,"NOV 06, 2023",BKN vs. MIL,L,23,8,14,0.571,3,7,0.429,0,0,0.0,0,4,4,2,0,0,3,1,19,-5,1,BKN,BKN,MIL,125,,,25,23,21,6
Lonnie Walker IV,G-F,22023,1629022,22300136,"NOV 04, 2023",BKN vs. BOS,L,17,5,8,0.625,1,2,0.5,2,2,1.0,0,3,3,1,0,0,1,0,13,-2,1,BKN,BKN,BOS,114,,,17,16,14,4
Lonnie Walker IV,G-F,22023,1629022,22300004,"NOV 03, 2023",BKN @ CHI,W,16,5,10,0.5,1,4,0.25,0,0,0.0,0,1,1,1,0,1,0,2,11,9,1,BKN,CHI,BKN,109,,,13,12,12,2
Lonnie Walker IV,G-F,22023,1629022,22300119,"NOV 01, 2023",BKN @ MIA,W,25,4,9,0.444,1,4,0.25,8,11,0.727,1,2,3,4,3,0,3,1,17,15,1,BKN,MIA,BKN,109,,,24,20,21,7
Lonnie Walker IV,G-F,22023,1629022,22300101,"OCT 30, 2023",BKN @ CHA,W,29,6,13,0.462,3,7,0.429,4,6,0.667,0,5,5,4,1,1,0,1,19,11,1,BKN,CHA,BKN,133,,,28,24,23,9
Lonnie Walker IV,G-F,22023,1629022,22300084,"OCT 27, 2023",BKN @ DAL,L,21,5,9,0.556,4,6,0.667,0,0,0.0,0,1,1,2,0,1,2,3,14,8,1,BKN,DAL,BKN,120,,,17,15,16,3
Gary Trent Jr.,G-F,22023,1629018,22300432,"DEC 29, 2023",TOR @ BOS,L,29,2,10,0.2,1,4,0.25,1,2,0.5,0,4,4,1,2,0,0,0,6,-10,1,TOR,BOS,TOR,118,,,11,10,7,5
Gary Trent Jr.,G-F,22023,1629018,22300416,"DEC 27, 2023",TOR @ WAS,W,26,4,10,0.4,3,8,0.375,1,2,0.5,0,2,2,4,2,0,1,1,12,8,1,TOR,WAS,TOR,132,,,18,14,16,6
Gary Trent Jr.,G-F,22023,1629018,22300395,"DEC 23, 2023",TOR vs. UTA,L,28,6,12,0.5,4,9,0.444,0,0,0.0,0,0,0,0,0,0,2,0,16,-10,1,TOR,TOR,UTA,119,,,16,16,16,0
Gary Trent Jr.,G-F,22023,1629018,22300382,"DEC 22, 2023",TOR @ PHI,L,26,6,11,0.545,5,8,0.625,0,0,0.0,1,3,4,1,1,0,0,3,17,-10,1,TOR,PHI,TOR,111,,,22,21,18,5
Gary Trent Jr.,G-F,22023,1629018,22300369,"DEC 20, 2023",TOR vs. DEN,L,29,4,9,0.444,1,5,0.2,3,3,1.0,0,3,3,4,0,0,1,0,12,-11,1,TOR,TOR,DEN,104,,,19,15,16,7
Gary Trent Jr.,G-F,22023,1629018,22300354,"DEC 18, 2023",TOR vs. CHA,W,35,9,17,0.529,4,10,0.4,0,0,0.0,0,10,10,3,1,0,1,1,22,25,1,TOR,TOR,CHA,114,,,35,32,25,13
Gary Trent Jr.,G-F,22023,1629018,22300330,"DEC 15, 2023",TOR vs. ATL,L,20,3,8,0.375,2,5,0.4,0,0,0.0,0,2,2,3,0,0,1,1,8,-11,1,TOR,TOR,ATL,104,,,13,10,11,5
Gary Trent Jr.,G-F,22023,1629018,22300313,"DEC 13, 2023",TOR vs. ATL,W,20,4,11,0.364,4,8,0.5,0,0,0.0,0,0,0,1,0,0,0,0,12,-8,1,TOR,TOR,ATL,135,,,13,12,13,1
Gary Trent Jr.,G-F,22023,1629018,22300297,"DEC 11, 2023",TOR @ NYK,L,19,2,8,0.25,0,4,0.0,0,0,0.0,1,0,1,2,0,0,0,0,4,3,1,TOR,NYK,TOR,130,,,7,5,6,3
Gary Trent Jr.,G-F,22023,1629018,22301216,"DEC 08, 2023",TOR @ CHA,L,20,0,7,0.0,0,3,0.0,0,0,0.0,0,2,2,2,0,0,0,0,0,-7,1,TOR,CHA,TOR,116,,,4,2,2,4
Gary Trent Jr.,G-F,22023,1629018,22301207,"DEC 06, 2023",TOR vs. MIA,L,25,5,11,0.455,3,7,0.429,2,2,1.0,0,2,2,2,0,0,1,3,15,7,1,TOR,TOR,MIA,103,,,19,17,17,4
Gary Trent Jr.,G-F,22023,1629018,22300276,"DEC 01, 2023",TOR vs. NYK,L,23,2,6,0.333,0,1,0.0,0,1,0.0,0,1,1,4,0,0,0,0,4,-18,1,TOR,TOR,NYK,106,,,9,5,8,5
Gary Trent Jr.,G-F,22023,1629018,22300260,"NOV 29, 2023",TOR vs. PHX,W,25,5,13,0.385,3,7,0.429,0,0,0.0,0,5,5,2,0,0,0,1,13,0,1,TOR,TOR,PHX,112,,,20,18,15,7
Gary Trent Jr.,G-F,22023,1629018,22300054,"NOV 28, 2023",TOR @ BKN,L,25,7,12,0.583,1,4,0.25,0,0,0.0,0,2,2,1,1,0,0,1,15,-6,1,TOR,BKN,TOR,103,,,18,17,16,3
Gary Trent Jr.,G-F,22023,1629018,22300251,"NOV 26, 2023",TOR @ CLE,L,26,5,13,0.385,1,7,0.143,2,2,1.0,0,1,1,0,1,0,1,0,13,10,1,TOR,CLE,TOR,102,,,14,14,13,1
Gary Trent Jr.,G-F,22023,1629018,22300046,"NOV 24, 2023",TOR vs. CHI,W,21,6,13,0.462,4,9,0.444,0,0,0.0,0,1,1,2,1,0,0,3,16,-4,1,TOR,TOR,CHI,121,,,19,17,18,3
Gary Trent Jr.,G-F,22023,1629018,22300038,"NOV 21, 2023",TOR @ ORL,L,21,1,6,0.167,1,2,0.5,0,0,0.0,0,0,0,1,0,0,0,1,3,-3,1,TOR,ORL,TOR,107,,,4,3,4,1
Gary Trent Jr.,G-F,22023,1629018,22300211,"NOV 19, 2023",TOR vs. DET,W,26,6,12,0.5,2,7,0.286,4,4,1.0,0,1,1,3,1,1,0,1,18,20,1,TOR,TOR,DET,142,,,22,19,21,4
Gary Trent Jr.,G-F,22023,1629018,22300031,"NOV 17, 2023",TOR vs. BOS,L,31,4,9,0.444,3,5,0.6,3,4,0.75,0,2,2,1,1,0,0,0,14,14,1,TOR,TOR,BOS,105,,,17,16,15,3
Gary Trent Jr.,G-F,22023,1629018,22300092,"OCT 28, 2023",TOR vs. PHI,L,33,6,16,0.375,3,5,0.6,2,4,0.5,1,1,2,0,1,0,1,0,17,3,1,TOR,TOR,PHI,107,,,19,19,17,2
Gary Trent Jr.,G-F,22023,1629018,22300082,"OCT 27, 2023",TOR @ CHI,L,36,6,15,0.4,3,10,0.3,1,4,0.25,2,3,5,1,2,0,1,1,16,-15,1,TOR,CHI,TOR,103,,,22,21,17,6
Gary Trent Jr.,G-F,22023,1629018,22300069,"OCT 25, 2023",TOR vs. MIN,W,27,2,8,0.25,1,4,0.25,0,0,0.0,0,2,2,2,1,1,0,3,5,3,1,TOR,TOR,MIN,97,,,9,7,7,4
Gary Trent Jr.,G-F,22023,1629018,22300756,"FEB 10, 2024",TOR vs. CLE,L,23,2,7,0.286,2,5,0.4,0,0,0.0,0,2,2,2,1,0,1,1,6,-2,1,TOR,TOR,CLE,95,,,10,8,8,4
Gary Trent Jr.,G-F,22023,1629018,22300230,"NOV 22, 2023",TOR @ IND,W,25,2,5,0.4,2,4,0.5,2,4,0.5,0,1,1,1,1,0,2,1,8,14,1,TOR,IND,TOR,132,,,10,9,9,2
Gary Trent Jr.,G-F,22023,1629018,22300168,"NOV 08, 2023",TOR @ DAL,W,26,6,11,0.545,4,8,0.5,0,0,0.0,0,2,2,1,1,0,0,0,16,9,1,TOR,DAL,TOR,127,,,19,18,17,3
Gary Trent Jr.,G-F,22023,1629018,22300141,"NOV 05, 2023",TOR @ SAS,W,29,4,8,0.5,2,4,0.5,0,0,0.0,0,0,0,0,1,0,2,1,10,-1,1,TOR,SAS,TOR,123,,,10,10,10,0
Gary Trent Jr.,G-F,22023,1629018,22300128,"NOV 02, 2023",TOR @ PHI,L,23,2,8,0.25,2,5,0.4,2,4,0.5,0,5,5,0,1,0,3,1,8,-15,1,TOR,PHI,TOR,99,,,13,13,8,5
Gary Trent Jr.,G-F,22023,1629018,22300116,"NOV 01, 2023",TOR vs. MIL,W,23,4,11,0.364,0,5,0.0,0,0,0.0,1,2,3,1,0,0,1,2,8,8,1,TOR,TOR,MIL,130,,,12,11,9,4
Gary Trent Jr.,G-F,22023,1629018,22300105,"OCT 30, 2023",TOR vs. POR,L,19,1,7,0.143,0,1,0.0,1,3,0.333,0,1,1,2,1,0,0,2,3,-10,1,TOR,TOR,POR,91,,,6,4,5,3
Gary Trent Jr.,G-F,22023,1629018,22300744,"FEB 09, 2024",TOR vs. HOU,W,34,2,11,0.182,2,8,0.25,2,2,1.0,0,1,1,3,4,0,1,1,8,17,1,TOR,TOR,HOU,100,,,12,9,11,4
Gary Trent Jr.,G-F,22023,1629018,22300726,"FEB 07, 2024",TOR @ CHA,W,28,5,13,0.385,4,8,0.5,0,0,0.0,0,0,0,1,3,0,1,1,14,-2,1,TOR,CHA,TOR,123,,,15,14,15,1
Gary Trent Jr.,G-F,22023,1629018,22300718,"FEB 05, 2024",TOR @ NOP,L,15,1,5,0.2,0,2,0.0,0,0,0.0,0,1,1,0,0,0,0,0,2,-16,1,TOR,NOP,TOR,100,,,3,3,2,1
Gary Trent Jr.,G-F,22023,1629018,22300710,"FEB 04, 2024",TOR @ OKC,L,40,6,15,0.4,4,8,0.5,0,0,0.0,0,6,6,0,2,0,1,2,16,-9,1,TOR,OKC,TOR,127,,,22,22,16,6
Gary Trent Jr.,G-F,22023,1629018,22300692,"FEB 02, 2024",TOR @ HOU,L,26,5,12,0.417,2,5,0.4,0,0,0.0,2,2,4,0,2,0,1,1,12,-17,1,TOR,HOU,TOR,106,,,16,16,12,4
Gary Trent Jr.,G-F,22023,1629018,22300672,"JAN 30, 2024",TOR @ CHI,W,32,9,15,0.6,6,11,0.545,0,0,0.0,0,5,5,1,1,0,2,1,24,12,1,TOR,CHI,TOR,118,,,30,29,25,6
Gary Trent Jr.,G-F,22023,1629018,22300653,"JAN 28, 2024",TOR @ ATL,L,26,6,12,0.5,4,8,0.5,0,0,0.0,0,1,1,0,2,0,1,5,16,-19,1,TOR,ATL,TOR,113,,,17,17,16,1
Gary Trent Jr.,G-F,22023,1629018,22300637,"JAN 26, 2024",TOR vs. LAC,L,29,5,13,0.385,3,8,0.375,0,0,0.0,0,1,1,3,0,0,0,1,13,-12,1,TOR,TOR,LAC,107,,,17,14,16,4
Gary Trent Jr.,G-F,22023,1629018,22300609,"JAN 22, 2024",TOR vs. MEM,L,24,2,6,0.333,2,4,0.5,0,0,0.0,0,0,0,2,1,0,1,1,6,-2,1,TOR,TOR,MEM,100,,,8,6,8,2
Gary Trent Jr.,G-F,22023,1629018,22300596,"JAN 20, 2024",TOR @ NYK,L,26,6,10,0.6,4,8,0.5,0,0,0.0,0,1,1,0,1,1,1,4,16,-13,1,TOR,NYK,TOR,94,,,17,17,16,1
Gary Trent Jr.,G-F,22023,1629018,22300580,"JAN 18, 2024",TOR vs. CHI,L,30,3,8,0.375,0,4,0.0,0,0,0.0,0,2,2,2,0,0,2,3,6,-21,1,TOR,TOR,CHI,100,,,10,8,8,4
Gary Trent Jr.,G-F,22023,1629018,22300574,"JAN 17, 2024",TOR vs. MIA,W,31,10,13,0.769,8,9,0.889,0,0,0.0,0,2,2,0,1,0,0,1,28,14,1,TOR,TOR,MIA,115,,,30,30,28,2
Gary Trent Jr.,G-F,22023,1629018,22300540,"JAN 12, 2024",TOR @ UTA,L,22,2,6,0.333,1,2,0.5,0,0,0.0,1,0,1,2,0,0,1,1,5,-6,1,TOR,UTA,TOR,104,,,8,6,7,3
Gary Trent Jr.,G-F,22023,1629018,22300526,"JAN 10, 2024",TOR @ LAC,L,24,5,9,0.556,2,4,0.5,0,0,0.0,1,2,3,2,0,0,0,1,12,-9,1,TOR,LAC,TOR,111,,,17,15,14,5
Gary Trent Jr.,G-F,22023,1629018,22300516,"JAN 09, 2024",TOR @ LAL,L,24,5,10,0.5,4,6,0.667,0,0,0.0,0,1,1,1,0,0,0,1,14,-6,1,TOR,LAL,TOR,131,,,16,15,15,2
Gary Trent Jr.,G-F,22023,1629018,22300504,"JAN 07, 2024",TOR @ GSW,W,26,6,11,0.545,2,5,0.4,0,0,0.0,0,1,1,1,2,1,0,1,14,10,1,TOR,GSW,TOR,131,,,16,15,15,2
Gary Trent Jr.,G-F,22023,1629018,22300470,"JAN 03, 2024",TOR @ MEM,W,21,2,5,0.4,1,1,1.0,0,0,0.0,0,1,1,0,1,0,2,2,5,2,1,TOR,MEM,TOR,116,,,6,6,5,1
Gary Trent Jr.,G-F,22023,1629018,22300452,"JAN 01, 2024",TOR vs. CLE,W,26,3,10,0.3,1,5,0.2,2,2,1.0,2,4,6,2,1,0,0,1,9,-1,1,TOR,TOR,CLE,124,,,17,15,11,8
Gary Trent Jr.,G-F,22023,1629018,22300440,"DEC 30, 2023",TOR @ DET,L,39,8,16,0.5,6,9,0.667,2,2,1.0,0,1,1,4,4,1,0,3,24,4,1,TOR,DET,TOR,127,,,29,25,28,5
Keon Johnson,G,22023,1630553,22300735,"FEB 08, 2024",BKN vs. CLE,L,14,1,3,0.333,1,1,1.0,0,0,0.0,2,0,2,0,2,0,1,2,3,-5,1,BKN,BKN,CLE,95,,,5,5,3,2
Keon Johnson,G,22023,1630553,22300417,"DEC 27, 2023",BKN vs. MIL,L,21,3,8,0.375,2,4,0.5,4,4,1.0,0,1,1,1,1,1,1,1,12,-18,1,BKN,BKN,MIL,122,,,14,13,13,2
Harrison Barnes,F,22023,203084,22300746,"FEB 09, 2024",SAC vs. DEN,W,21,3,6,0.5,2,4,0.5,1,1,1.0,1,1,2,2,1,0,0,0,9,10,1,SAC,SAC,DEN,135,13.0,Points,13,11,11,4
Harrison Barnes,F,22023,203084,22300746,"FEB 09, 2024",SAC vs. DEN,W,21,3,6,0.5,2,4,0.5,1,1,1.0,1,1,2,2,1,0,0,0,9,10,1,SAC,SAC,DEN,135,17.5,Pts+Rebs+Asts,13,11,11,4
Harrison Barnes,F,22023,203084,22300746,"FEB 09, 2024",SAC vs. DEN,W,21,3,6,0.5,2,4,0.5,1,1,1.0,1,1,2,2,1,0,0,0,9,10,1,SAC,SAC,DEN,135,20.5,Fantasy Score,13,11,11,4
Harrison Barnes,F,22023,203084,22300746,"FEB 09, 2024",SAC vs. DEN,W,21,3,6,0.5,2,4,0.5,1,1,1.0,1,1,2,2,1,0,0,0,9,10,1,SAC,SAC,DEN,135,0.5,Offensive Rebounds,13,11,11,4
Harrison Barnes,F,22023,203084,22300746,"FEB 09, 2024",SAC vs. DEN,W,21,3,6,0.5,2,4,0.5,1,1,1.0,1,1,2,2,1,0,0,0,9,10,1,SAC,SAC,DEN,135,4.5,3-PT Attempted,13,11,11,4
Harrison Barnes,F,22023,203084,22300746,"FEB 09, 2024",SAC vs. DEN,W,21,3,6,0.5,2,4,0.5,1,1,1.0,1,1,2,2,1,0,0,0,9,10,1,SAC,SAC,DEN,135,16.5,Pts+Rebs,13,11,11,4
Harrison Barnes,F,22023,203084,22300746,"FEB 09, 2024",SAC vs. DEN,W,21,3,6,0.5,2,4,0.5,1,1,1.0,1,1,2,2,1,0,0,0,9,10,1,SAC,SAC,DEN,135,14.5,Pts+Asts,13,11,11,4
Harrison Barnes,F,22023,203084,22300732,"FEB 07, 2024",SAC vs. DET,L,24,4,10,0.4,0,4,0.0,0,0,0.0,0,4,4,0,1,0,0,0,8,-17,1,SAC,SAC,DET,120,13.0,Points,12,12,8,4
Harrison Barnes,F,22023,203084,22300732,"FEB 07, 2024",SAC vs. DET,L,24,4,10,0.4,0,4,0.0,0,0,0.0,0,4,4,0,1,0,0,0,8,-17,1,SAC,SAC,DET,120,17.5,Pts+Rebs+Asts,12,12,8,4
Harrison Barnes,F,22023,203084,22300732,"FEB 07, 2024",SAC vs. DET,L,24,4,10,0.4,0,4,0.0,0,0,0.0,0,4,4,0,1,0,0,0,8,-17,1,SAC,SAC,DET,120,20.5,Fantasy Score,12,12,8,4
Harrison Barnes,F,22023,203084,22300732,"FEB 07, 2024",SAC vs. DET,L,24,4,10,0.4,0,4,0.0,0,0,0.0,0,4,4,0,1,0,0,0,8,-17,1,SAC,SAC,DET,120,0.5,Offensive Rebounds,12,12,8,4
Harrison Barnes,F,22023,203084,22300732,"FEB 07, 2024",SAC vs. DET,L,24,4,10,0.4,0,4,0.0,0,0,0.0,0,4,4,0,1,0,0,0,8,-17,1,SAC,SAC,DET,120,4.5,3-PT Attempted,12,12,8,4
Harrison Barnes,F,22023,203084,22300732,"FEB 07, 2024",SAC vs. DET,L,24,4,10,0.4,0,4,0.0,0,0,0.0,0,4,4,0,1,0,0,0,8,-17,1,SAC,SAC,DET,120,16.5,Pts+Rebs,12,12,8,4
Harrison Barnes,F,22023,203084,22300732,"FEB 07, 2024",SAC vs. DET,L,24,4,10,0.4,0,4,0.0,0,0,0.0,0,4,4,0,1,0,0,0,8,-17,1,SAC,SAC,DET,120,14.5,Pts+Asts,12,12,8,4
Harrison Barnes,F,22023,203084,22300714,"FEB 05, 2024",SAC @ CLE,L,30,8,15,0.533,6,10,0.6,0,0,0.0,0,1,1,0,1,0,0,1,22,-9,1,SAC,CLE,SAC,110,13.0,Points,23,23,22,1
Harrison Barnes,F,22023,203084,22300714,"FEB 05, 2024",SAC @ CLE,L,30,8,15,0.533,6,10,0.6,0,0,0.0,0,1,1,0,1,0,0,1,22,-9,1,SAC,CLE,SAC,110,17.5,Pts+Rebs+Asts,23,23,22,1
Harrison Barnes,F,22023,203084,22300714,"FEB 05, 2024",SAC @ CLE,L,30,8,15,0.533,6,10,0.6,0,0,0.0,0,1,1,0,1,0,0,1,22,-9,1,SAC,CLE,SAC,110,20.5,Fantasy Score,23,23,22,1
Harrison Barnes,F,22023,203084,22300714,"FEB 05, 2024",SAC @ CLE,L,30,8,15,0.533,6,10,0.6,0,0,0.0,0,1,1,0,1,0,0,1,22,-9,1,SAC,CLE,SAC,110,0.5,Offensive Rebounds,23,23,22,1
Harrison Barnes,F,22023,203084,22300714,"FEB 05, 2024",SAC @ CLE,L,30,8,15,0.533,6,10,0.6,0,0,0.0,0,1,1,0,1,0,0,1,22,-9,1,SAC,CLE,SAC,110,4.5,3-PT Attempted,23,23,22,1
Harrison Barnes,F,22023,203084,22300714,"FEB 05, 2024",SAC @ CLE,L,30,8,15,0.533,6,10,0.6,0,0,0.0,0,1,1,0,1,0,0,1,22,-9,1,SAC,CLE,SAC,110,16.5,Pts+Rebs,23,23,22,1
Harrison Barnes,F,22023,203084,22300714,"FEB 05, 2024",SAC @ CLE,L,30,8,15,0.533,6,10,0.6,0,0,0.0,0,1,1,0,1,0,0,1,22,-9,1,SAC,CLE,SAC,110,14.5,Pts+Asts,23,23,22,1
Harrison Barnes,F,22023,203084,22300700,"FEB 03, 2024",SAC @ CHI,W,35,4,10,0.4,1,5,0.2,2,2,1.0,0,1,1,0,1,0,1,1,11,8,1,SAC,CHI,SAC,123,13.0,Points,12,12,11,1
Harrison Barnes,F,22023,203084,22300700,"FEB 03, 2024",SAC @ CHI,W,35,4,10,0.4,1,5,0.2,2,2,1.0,0,1,1,0,1,0,1,1,11,8,1,SAC,CHI,SAC,123,17.5,Pts+Rebs+Asts,12,12,11,1
Harrison Barnes,F,22023,203084,22300700,"FEB 03, 2024",SAC @ CHI,W,35,4,10,0.4,1,5,0.2,2,2,1.0,0,1,1,0,1,0,1,1,11,8,1,SAC,CHI,SAC,123,20.5,Fantasy Score,12,12,11,1
Harrison Barnes,F,22023,203084,22300700,"FEB 03, 2024",SAC @ CHI,W,35,4,10,0.4,1,5,0.2,2,2,1.0,0,1,1,0,1,0,1,1,11,8,1,SAC,CHI,SAC,123,0.5,Offensive Rebounds,12,12,11,1
Harrison Barnes,F,22023,203084,22300700,"FEB 03, 2024",SAC @ CHI,W,35,4,10,0.4,1,5,0.2,2,2,1.0,0,1,1,0,1,0,1,1,11,8,1,SAC,CHI,SAC,123,4.5,3-PT Attempted,12,12,11,1
Harrison Barnes,F,22023,203084,22300700,"FEB 03, 2024",SAC @ CHI,W,35,4,10,0.4,1,5,0.2,2,2,1.0,0,1,1,0,1,0,1,1,11,8,1,SAC,CHI,SAC,123,16.5,Pts+Rebs,12,12,11,1
Harrison Barnes,F,22023,203084,22300700,"FEB 03, 2024",SAC @ CHI,W,35,4,10,0.4,1,5,0.2,2,2,1.0,0,1,1,0,1,0,1,1,11,8,1,SAC,CHI,SAC,123,14.5,Pts+Asts,12,12,11,1
Harrison Barnes,F,22023,203084,22300691,"FEB 02, 2024",SAC @ IND,W,37,9,14,0.643,4,7,0.571,0,2,0.0,1,3,4,1,3,0,3,2,22,7,1,SAC,IND,SAC,133,13.0,Points,27,26,23,5
Harrison Barnes,F,22023,203084,22300691,"FEB 02, 2024",SAC @ IND,W,37,9,14,0.643,4,7,0.571,0,2,0.0,1,3,4,1,3,0,3,2,22,7,1,SAC,IND,SAC,133,17.5,Pts+Rebs+Asts,27,26,23,5
Harrison Barnes,F,22023,203084,22300691,"FEB 02, 2024",SAC @ IND,W,37,9,14,0.643,4,7,0.571,0,2,0.0,1,3,4,1,3,0,3,2,22,7,1,SAC,IND,SAC,133,20.5,Fantasy Score,27,26,23,5
Harrison Barnes,F,22023,203084,22300691,"FEB 02, 2024",SAC @ IND,W,37,9,14,0.643,4,7,0.571,0,2,0.0,1,3,4,1,3,0,3,2,22,7,1,SAC,IND,SAC,133,0.5,Offensive Rebounds,27,26,23,5
Harrison Barnes,F,22023,203084,22300691,"FEB 02, 2024",SAC @ IND,W,37,9,14,0.643,4,7,0.571,0,2,0.0,1,3,4,1,3,0,3,2,22,7,1,SAC,IND,SAC,133,4.5,3-PT Attempted,27,26,23,5
Harrison Barnes,F,22023,203084,22300691,"FEB 02, 2024",SAC @ IND,W,37,9,14,0.643,4,7,0.571,0,2,0.0,1,3,4,1,3,0,3,2,22,7,1,SAC,IND,SAC,133,16.5,Pts+Rebs,27,26,23,5
Harrison Barnes,F,22023,203084,22300691,"FEB 02, 2024",SAC @ IND,W,37,9,14,0.643,4,7,0.571,0,2,0.0,1,3,4,1,3,0,3,2,22,7,1,SAC,IND,SAC,133,14.5,Pts+Asts,27,26,23,5
Harrison Barnes,F,22023,203084,22300678,"JAN 31, 2024",SAC @ MIA,L,37,4,13,0.308,0,6,0.0,1,2,0.5,2,3,5,1,0,0,1,1,9,1,1,SAC,MIA,SAC,106,13.0,Points,15,14,10,6
Harrison Barnes,F,22023,203084,22300678,"JAN 31, 2024",SAC @ MIA,L,37,4,13,0.308,0,6,0.0,1,2,0.5,2,3,5,1,0,0,1,1,9,1,1,SAC,MIA,SAC,106,17.5,Pts+Rebs+Asts,15,14,10,6
Harrison Barnes,F,22023,203084,22300678,"JAN 31, 2024",SAC @ MIA,L,37,4,13,0.308,0,6,0.0,1,2,0.5,2,3,5,1,0,0,1,1,9,1,1,SAC,MIA,SAC,106,20.5,Fantasy Score,15,14,10,6
Harrison Barnes,F,22023,203084,22300678,"JAN 31, 2024",SAC @ MIA,L,37,4,13,0.308,0,6,0.0,1,2,0.5,2,3,5,1,0,0,1,1,9,1,1,SAC,MIA,SAC,106,0.5,Offensive Rebounds,15,14,10,6
Harrison Barnes,F,22023,203084,22300678,"JAN 31, 2024",SAC @ MIA,L,37,4,13,0.308,0,6,0.0,1,2,0.5,2,3,5,1,0,0,1,1,9,1,1,SAC,MIA,SAC,106,4.5,3-PT Attempted,15,14,10,6
Harrison Barnes,F,22023,203084,22300678,"JAN 31, 2024",SAC @ MIA,L,37,4,13,0.308,0,6,0.0,1,2,0.5,2,3,5,1,0,0,1,1,9,1,1,SAC,MIA,SAC,106,16.5,Pts+Rebs,15,14,10,6
Harrison Barnes,F,22023,203084,22300678,"JAN 31, 2024",SAC @ MIA,L,37,4,13,0.308,0,6,0.0,1,2,0.5,2,3,5,1,0,0,1,1,9,1,1,SAC,MIA,SAC,106,14.5,Pts+Asts,15,14,10,6
Harrison Barnes,F,22023,203084,22300663,"JAN 29, 2024",SAC @ MEM,W,35,5,15,0.333,2,10,0.2,0,0,0.0,0,3,3,4,0,0,1,1,12,15,1,SAC,MEM,SAC,103,13.0,Points,19,15,16,7
Harrison Barnes,F,22023,203084,22300663,"JAN 29, 2024",SAC @ MEM,W,35,5,15,0.333,2,10,0.2,0,0,0.0,0,3,3,4,0,0,1,1,12,15,1,SAC,MEM,SAC,103,17.5,Pts+Rebs+Asts,19,15,16,7
Harrison Barnes,F,22023,203084,22300663,"JAN 29, 2024",SAC @ MEM,W,35,5,15,0.333,2,10,0.2,0,0,0.0,0,3,3,4,0,0,1,1,12,15,1,SAC,MEM,SAC,103,20.5,Fantasy Score,19,15,16,7
Harrison Barnes,F,22023,203084,22300663,"JAN 29, 2024",SAC @ MEM,W,35,5,15,0.333,2,10,0.2,0,0,0.0,0,3,3,4,0,0,1,1,12,15,1,SAC,MEM,SAC,103,0.5,Offensive Rebounds,19,15,16,7
Harrison Barnes,F,22023,203084,22300663,"JAN 29, 2024",SAC @ MEM,W,35,5,15,0.333,2,10,0.2,0,0,0.0,0,3,3,4,0,0,1,1,12,15,1,SAC,MEM,SAC,103,4.5,3-PT Attempted,19,15,16,7
Harrison Barnes,F,22023,203084,22300663,"JAN 29, 2024",SAC @ MEM,W,35,5,15,0.333,2,10,0.2,0,0,0.0,0,3,3,4,0,0,1,1,12,15,1,SAC,MEM,SAC,103,16.5,Pts+Rebs,19,15,16,7
Harrison Barnes,F,22023,203084,22300663,"JAN 29, 2024",SAC @ MEM,W,35,5,15,0.333,2,10,0.2,0,0,0.0,0,3,3,4,0,0,1,1,12,15,1,SAC,MEM,SAC,103,14.5,Pts+Asts,19,15,16,7
Harrison Barnes,F,22023,203084,22300651,"JAN 27, 2024",SAC @ DAL,W,38,6,11,0.545,4,7,0.571,4,5,0.8,1,5,6,3,1,1,0,1,20,-10,1,SAC,DAL,SAC,120,13.0,Points,29,26,23,9
Harrison Barnes,F,22023,203084,22300651,"JAN 27, 2024",SAC @ DAL,W,38,6,11,0.545,4,7,0.571,4,5,0.8,1,5,6,3,1,1,0,1,20,-10,1,SAC,DAL,SAC,120,17.5,Pts+Rebs+Asts,29,26,23,9
Harrison Barnes,F,22023,203084,22300651,"JAN 27, 2024",SAC @ DAL,W,38,6,11,0.545,4,7,0.571,4,5,0.8,1,5,6,3,1,1,0,1,20,-10,1,SAC,DAL,SAC,120,20.5,Fantasy Score,29,26,23,9
Harrison Barnes,F,22023,203084,22300651,"JAN 27, 2024",SAC @ DAL,W,38,6,11,0.545,4,7,0.571,4,5,0.8,1,5,6,3,1,1,0,1,20,-10,1,SAC,DAL,SAC,120,0.5,Offensive Rebounds,29,26,23,9
Harrison Barnes,F,22023,203084,22300651,"JAN 27, 2024",SAC @ DAL,W,38,6,11,0.545,4,7,0.571,4,5,0.8,1,5,6,3,1,1,0,1,20,-10,1,SAC,DAL,SAC,120,4.5,3-PT Attempted,29,26,23,9
Harrison Barnes,F,22023,203084,22300651,"JAN 27, 2024",SAC @ DAL,W,38,6,11,0.545,4,7,0.571,4,5,0.8,1,5,6,3,1,1,0,1,20,-10,1,SAC,DAL,SAC,120,16.5,Pts+Rebs,29,26,23,9
Harrison Barnes,F,22023,203084,22300651,"JAN 27, 2024",SAC @ DAL,W,38,6,11,0.545,4,7,0.571,4,5,0.8,1,5,6,3,1,1,0,1,20,-10,1,SAC,DAL,SAC,120,14.5,Pts+Asts,29,26,23,9
Harrison Barnes,F,22023,203084,22300632,"JAN 25, 2024",SAC @ GSW,W,40,14,24,0.583,7,12,0.583,4,4,1.0,1,3,4,0,2,1,1,0,39,2,1,SAC,GSW,SAC,134,13.0,Points,43,43,39,4
Harrison Barnes,F,22023,203084,22300632,"JAN 25, 2024",SAC @ GSW,W,40,14,24,0.583,7,12,0.583,4,4,1.0,1,3,4,0,2,1,1,0,39,2,1,SAC,GSW,SAC,134,17.5,Pts+Rebs+Asts,43,43,39,4
Harrison Barnes,F,22023,203084,22300632,"JAN 25, 2024",SAC @ GSW,W,40,14,24,0.583,7,12,0.583,4,4,1.0,1,3,4,0,2,1,1,0,39,2,1,SAC,GSW,SAC,134,20.5,Fantasy Score,43,43,39,4
Harrison Barnes,F,22023,203084,22300632,"JAN 25, 2024",SAC @ GSW,W,40,14,24,0.583,7,12,0.583,4,4,1.0,1,3,4,0,2,1,1,0,39,2,1,SAC,GSW,SAC,134,0.5,Offensive Rebounds,43,43,39,4
Harrison Barnes,F,22023,203084,22300632,"JAN 25, 2024",SAC @ GSW,W,40,14,24,0.583,7,12,0.583,4,4,1.0,1,3,4,0,2,1,1,0,39,2,1,SAC,GSW,SAC,134,4.5,3-PT Attempted,43,43,39,4
Harrison Barnes,F,22023,203084,22300632,"JAN 25, 2024",SAC @ GSW,W,40,14,24,0.583,7,12,0.583,4,4,1.0,1,3,4,0,2,1,1,0,39,2,1,SAC,GSW,SAC,134,16.5,Pts+Rebs,43,43,39,4
Harrison Barnes,F,22023,203084,22300632,"JAN 25, 2024",SAC @ GSW,W,40,14,24,0.583,7,12,0.583,4,4,1.0,1,3,4,0,2,1,1,0,39,2,1,SAC,GSW,SAC,134,14.5,Pts+Asts,43,43,39,4
Harrison Barnes,F,22023,203084,22300613,"JAN 22, 2024",SAC vs. ATL,W,30,10,20,0.5,4,8,0.5,8,8,1.0,2,2,4,0,1,0,0,2,32,9,1,SAC,SAC,ATL,122,13.0,Points,36,36,32,4
Harrison Barnes,F,22023,203084,22300613,"JAN 22, 2024",SAC vs. ATL,W,30,10,20,0.5,4,8,0.5,8,8,1.0,2,2,4,0,1,0,0,2,32,9,1,SAC,SAC,ATL,122,17.5,Pts+Rebs+Asts,36,36,32,4
Harrison Barnes,F,22023,203084,22300613,"JAN 22, 2024",SAC vs. ATL,W,30,10,20,0.5,4,8,0.5,8,8,1.0,2,2,4,0,1,0,0,2,32,9,1,SAC,SAC,ATL,122,20.5,Fantasy Score,36,36,32,4
Harrison Barnes,F,22023,203084,22300613,"JAN 22, 2024",SAC vs. ATL,W,30,10,20,0.5,4,8,0.5,8,8,1.0,2,2,4,0,1,0,0,2,32,9,1,SAC,SAC,ATL,122,0.5,Offensive Rebounds,36,36,32,4
Harrison Barnes,F,22023,203084,22300613,"JAN 22, 2024",SAC vs. ATL,W,30,10,20,0.5,4,8,0.5,8,8,1.0,2,2,4,0,1,0,0,2,32,9,1,SAC,SAC,ATL,122,4.5,3-PT Attempted,36,36,32,4
Harrison Barnes,F,22023,203084,22300613,"JAN 22, 2024",SAC vs. ATL,W,30,10,20,0.5,4,8,0.5,8,8,1.0,2,2,4,0,1,0,0,2,32,9,1,SAC,SAC,ATL,122,16.5,Pts+Rebs,36,36,32,4
Harrison Barnes,F,22023,203084,22300613,"JAN 22, 2024",SAC vs. ATL,W,30,10,20,0.5,4,8,0.5,8,8,1.0,2,2,4,0,1,0,0,2,32,9,1,SAC,SAC,ATL,122,14.5,Pts+Asts,36,36,32,4
Harrison Barnes,F,22023,203084,22300583,"JAN 18, 2024",SAC vs. IND,L,22,1,2,0.5,0,1,0.0,0,0,0.0,0,1,1,1,0,0,1,1,2,0,1,SAC,SAC,IND,121,13.0,Points,4,3,3,2
Harrison Barnes,F,22023,203084,22300583,"JAN 18, 2024",SAC vs. IND,L,22,1,2,0.5,0,1,0.0,0,0,0.0,0,1,1,1,0,0,1,1,2,0,1,SAC,SAC,IND,121,17.5,Pts+Rebs+Asts,4,3,3,2
Harrison Barnes,F,22023,203084,22300583,"JAN 18, 2024",SAC vs. IND,L,22,1,2,0.5,0,1,0.0,0,0,0.0,0,1,1,1,0,0,1,1,2,0,1,SAC,SAC,IND,121,20.5,Fantasy Score,4,3,3,2
Harrison Barnes,F,22023,203084,22300583,"JAN 18, 2024",SAC vs. IND,L,22,1,2,0.5,0,1,0.0,0,0,0.0,0,1,1,1,0,0,1,1,2,0,1,SAC,SAC,IND,121,0.5,Offensive Rebounds,4,3,3,2
Harrison Barnes,F,22023,203084,22300583,"JAN 18, 2024",SAC vs. IND,L,22,1,2,0.5,0,1,0.0,0,0,0.0,0,1,1,1,0,0,1,1,2,0,1,SAC,SAC,IND,121,4.5,3-PT Attempted,4,3,3,2
Harrison Barnes,F,22023,203084,22300583,"JAN 18, 2024",SAC vs. IND,L,22,1,2,0.5,0,1,0.0,0,0,0.0,0,1,1,1,0,0,1,1,2,0,1,SAC,SAC,IND,121,16.5,Pts+Rebs,4,3,3,2
Harrison Barnes,F,22023,203084,22300583,"JAN 18, 2024",SAC vs. IND,L,22,1,2,0.5,0,1,0.0,0,0,0.0,0,1,1,1,0,0,1,1,2,0,1,SAC,SAC,IND,121,14.5,Pts+Asts,4,3,3,2
Harrison Barnes,F,22023,203084,22300567,"JAN 16, 2024",SAC @ PHX,L,34,3,9,0.333,2,6,0.333,0,0,0.0,0,3,3,3,0,0,2,2,8,-11,1,SAC,PHX,SAC,117,13.0,Points,14,11,11,6
Harrison Barnes,F,22023,203084,22300567,"JAN 16, 2024",SAC @ PHX,L,34,3,9,0.333,2,6,0.333,0,0,0.0,0,3,3,3,0,0,2,2,8,-11,1,SAC,PHX,SAC,117,17.5,Pts+Rebs+Asts,14,11,11,6
Harrison Barnes,F,22023,203084,22300567,"JAN 16, 2024",SAC @ PHX,L,34,3,9,0.333,2,6,0.333,0,0,0.0,0,3,3,3,0,0,2,2,8,-11,1,SAC,PHX,SAC,117,20.5,Fantasy Score,14,11,11,6
Harrison Barnes,F,22023,203084,22300567,"JAN 16, 2024",SAC @ PHX,L,34,3,9,0.333,2,6,0.333,0,0,0.0,0,3,3,3,0,0,2,2,8,-11,1,SAC,PHX,SAC,117,0.5,Offensive Rebounds,14,11,11,6
Harrison Barnes,F,22023,203084,22300567,"JAN 16, 2024",SAC @ PHX,L,34,3,9,0.333,2,6,0.333,0,0,0.0,0,3,3,3,0,0,2,2,8,-11,1,SAC,PHX,SAC,117,4.5,3-PT Attempted,14,11,11,6
Harrison Barnes,F,22023,203084,22300567,"JAN 16, 2024",SAC @ PHX,L,34,3,9,0.333,2,6,0.333,0,0,0.0,0,3,3,3,0,0,2,2,8,-11,1,SAC,PHX,SAC,117,16.5,Pts+Rebs,14,11,11,6
Harrison Barnes,F,22023,203084,22300567,"JAN 16, 2024",SAC @ PHX,L,34,3,9,0.333,2,6,0.333,0,0,0.0,0,3,3,3,0,0,2,2,8,-11,1,SAC,PHX,SAC,117,14.5,Pts+Asts,14,11,11,6
Harrison Barnes,F,22023,203084,22300552,"JAN 14, 2024",SAC @ MIL,L,32,6,9,0.667,1,4,0.25,1,1,1.0,0,1,1,1,1,0,0,0,14,-1,1,SAC,MIL,SAC,142,13.0,Points,16,15,15,2
Harrison Barnes,F,22023,203084,22300552,"JAN 14, 2024",SAC @ MIL,L,32,6,9,0.667,1,4,0.25,1,1,1.0,0,1,1,1,1,0,0,0,14,-1,1,SAC,MIL,SAC,142,17.5,Pts+Rebs+Asts,16,15,15,2
Harrison Barnes,F,22023,203084,22300552,"JAN 14, 2024",SAC @ MIL,L,32,6,9,0.667,1,4,0.25,1,1,1.0,0,1,1,1,1,0,0,0,14,-1,1,SAC,MIL,SAC,142,20.5,Fantasy Score,16,15,15,2
Harrison Barnes,F,22023,203084,22300552,"JAN 14, 2024",SAC @ MIL,L,32,6,9,0.667,1,4,0.25,1,1,1.0,0,1,1,1,1,0,0,0,14,-1,1,SAC,MIL,SAC,142,0.5,Offensive Rebounds,16,15,15,2
Harrison Barnes,F,22023,203084,22300552,"JAN 14, 2024",SAC @ MIL,L,32,6,9,0.667,1,4,0.25,1,1,1.0,0,1,1,1,1,0,0,0,14,-1,1,SAC,MIL,SAC,142,4.5,3-PT Attempted,16,15,15,2
Harrison Barnes,F,22023,203084,22300552,"JAN 14, 2024",SAC @ MIL,L,32,6,9,0.667,1,4,0.25,1,1,1.0,0,1,1,1,1,0,0,0,14,-1,1,SAC,MIL,SAC,142,16.5,Pts+Rebs,16,15,15,2
Harrison Barnes,F,22023,203084,22300552,"JAN 14, 2024",SAC @ MIL,L,32,6,9,0.667,1,4,0.25,1,1,1.0,0,1,1,1,1,0,0,0,14,-1,1,SAC,MIL,SAC,142,14.5,Pts+Asts,16,15,15,2
Harrison Barnes,F,22023,203084,22300532,"JAN 12, 2024",SAC @ PHI,L,21,1,5,0.2,0,4,0.0,2,2,1.0,2,0,2,0,1,0,1,1,4,-11,1,SAC,PHI,SAC,90,13.0,Points,6,6,4,2
Harrison Barnes,F,22023,203084,22300532,"JAN 12, 2024",SAC @ PHI,L,21,1,5,0.2,0,4,0.0,2,2,1.0,2,0,2,0,1,0,1,1,4,-11,1,SAC,PHI,SAC,90,17.5,Pts+Rebs+Asts,6,6,4,2
Harrison Barnes,F,22023,203084,22300532,"JAN 12, 2024",SAC @ PHI,L,21,1,5,0.2,0,4,0.0,2,2,1.0,2,0,2,0,1,0,1,1,4,-11,1,SAC,PHI,SAC,90,20.5,Fantasy Score,6,6,4,2
Harrison Barnes,F,22023,203084,22300532,"JAN 12, 2024",SAC @ PHI,L,21,1,5,0.2,0,4,0.0,2,2,1.0,2,0,2,0,1,0,1,1,4,-11,1,SAC,PHI,SAC,90,0.5,Offensive Rebounds,6,6,4,2
Harrison Barnes,F,22023,203084,22300532,"JAN 12, 2024",SAC @ PHI,L,21,1,5,0.2,0,4,0.0,2,2,1.0,2,0,2,0,1,0,1,1,4,-11,1,SAC,PHI,SAC,90,4.5,3-PT Attempted,6,6,4,2
Harrison Barnes,F,22023,203084,22300532,"JAN 12, 2024",SAC @ PHI,L,21,1,5,0.2,0,4,0.0,2,2,1.0,2,0,2,0,1,0,1,1,4,-11,1,SAC,PHI,SAC,90,16.5,Pts+Rebs,6,6,4,2
Harrison Barnes,F,22023,203084,22300532,"JAN 12, 2024",SAC @ PHI,L,21,1,5,0.2,0,4,0.0,2,2,1.0,2,0,2,0,1,0,1,1,4,-11,1,SAC,PHI,SAC,90,14.5,Pts+Asts,6,6,4,2
Harrison Barnes,F,22023,203084,22300518,"JAN 10, 2024",SAC @ CHA,W,22,2,4,0.5,2,4,0.5,0,0,0.0,1,1,2,1,0,0,1,0,6,-3,1,SAC,CHA,SAC,121,13.0,Points,9,8,7,3
Harrison Barnes,F,22023,203084,22300518,"JAN 10, 2024",SAC @ CHA,W,22,2,4,0.5,2,4,0.5,0,0,0.0,1,1,2,1,0,0,1,0,6,-3,1,SAC,CHA,SAC,121,17.5,Pts+Rebs+Asts,9,8,7,3
Harrison Barnes,F,22023,203084,22300518,"JAN 10, 2024",SAC @ CHA,W,22,2,4,0.5,2,4,0.5,0,0,0.0,1,1,2,1,0,0,1,0,6,-3,1,SAC,CHA,SAC,121,20.5,Fantasy Score,9,8,7,3
Harrison Barnes,F,22023,203084,22300518,"JAN 10, 2024",SAC @ CHA,W,22,2,4,0.5,2,4,0.5,0,0,0.0,1,1,2,1,0,0,1,0,6,-3,1,SAC,CHA,SAC,121,0.5,Offensive Rebounds,9,8,7,3
Harrison Barnes,F,22023,203084,22300518,"JAN 10, 2024",SAC @ CHA,W,22,2,4,0.5,2,4,0.5,0,0,0.0,1,1,2,1,0,0,1,0,6,-3,1,SAC,CHA,SAC,121,4.5,3-PT Attempted,9,8,7,3
Harrison Barnes,F,22023,203084,22300518,"JAN 10, 2024",SAC @ CHA,W,22,2,4,0.5,2,4,0.5,0,0,0.0,1,1,2,1,0,0,1,0,6,-3,1,SAC,CHA,SAC,121,16.5,Pts+Rebs,9,8,7,3
Harrison Barnes,F,22023,203084,22300518,"JAN 10, 2024",SAC @ CHA,W,22,2,4,0.5,2,4,0.5,0,0,0.0,1,1,2,1,0,0,1,0,6,-3,1,SAC,CHA,SAC,121,14.5,Pts+Asts,9,8,7,3
Harrison Barnes,F,22023,203084,22300512,"JAN 09, 2024",SAC @ DET,W,14,0,1,0.0,0,0,0.0,0,2,0.0,0,1,1,1,0,0,0,0,0,-9,1,SAC,DET,SAC,131,13.0,Points,2,1,1,2
Harrison Barnes,F,22023,203084,22300512,"JAN 09, 2024",SAC @ DET,W,14,0,1,0.0,0,0,0.0,0,2,0.0,0,1,1,1,0,0,0,0,0,-9,1,SAC,DET,SAC,131,17.5,Pts+Rebs+Asts,2,1,1,2
Harrison Barnes,F,22023,203084,22300512,"JAN 09, 2024",SAC @ DET,W,14,0,1,0.0,0,0,0.0,0,2,0.0,0,1,1,1,0,0,0,0,0,-9,1,SAC,DET,SAC,131,20.5,Fantasy Score,2,1,1,2
Harrison Barnes,F,22023,203084,22300512,"JAN 09, 2024",SAC @ DET,W,14,0,1,0.0,0,0,0.0,0,2,0.0,0,1,1,1,0,0,0,0,0,-9,1,SAC,DET,SAC,131,0.5,Offensive Rebounds,2,1,1,2
Harrison Barnes,F,22023,203084,22300512,"JAN 09, 2024",SAC @ DET,W,14,0,1,0.0,0,0,0.0,0,2,0.0,0,1,1,1,0,0,0,0,0,-9,1,SAC,DET,SAC,131,4.5,3-PT Attempted,2,1,1,2
Harrison Barnes,F,22023,203084,22300512,"JAN 09, 2024",SAC @ DET,W,14,0,1,0.0,0,0,0.0,0,2,0.0,0,1,1,1,0,0,0,0,0,-9,1,SAC,DET,SAC,131,16.5,Pts+Rebs,2,1,1,2
Harrison Barnes,F,22023,203084,22300512,"JAN 09, 2024",SAC @ DET,W,14,0,1,0.0,0,0,0.0,0,2,0.0,0,1,1,1,0,0,0,0,0,-9,1,SAC,DET,SAC,131,14.5,Pts+Asts,2,1,1,2
Harrison Barnes,F,22023,203084,22300500,"JAN 07, 2024",SAC vs. NOP,L,22,4,9,0.444,2,5,0.4,0,0,0.0,1,0,1,0,1,0,0,1,10,-13,1,SAC,SAC,NOP,100,13.0,Points,11,11,10,1
Harrison Barnes,F,22023,203084,22300500,"JAN 07, 2024",SAC vs. NOP,L,22,4,9,0.444,2,5,0.4,0,0,0.0,1,0,1,0,1,0,0,1,10,-13,1,SAC,SAC,NOP,100,17.5,Pts+Rebs+Asts,11,11,10,1
Harrison Barnes,F,22023,203084,22300500,"JAN 07, 2024",SAC vs. NOP,L,22,4,9,0.444,2,5,0.4,0,0,0.0,1,0,1,0,1,0,0,1,10,-13,1,SAC,SAC,NOP,100,20.5,Fantasy Score,11,11,10,1
Harrison Barnes,F,22023,203084,22300500,"JAN 07, 2024",SAC vs. NOP,L,22,4,9,0.444,2,5,0.4,0,0,0.0,1,0,1,0,1,0,0,1,10,-13,1,SAC,SAC,NOP,100,0.5,Offensive Rebounds,11,11,10,1
Harrison Barnes,F,22023,203084,22300500,"JAN 07, 2024",SAC vs. NOP,L,22,4,9,0.444,2,5,0.4,0,0,0.0,1,0,1,0,1,0,0,1,10,-13,1,SAC,SAC,NOP,100,4.5,3-PT Attempted,11,11,10,1
Harrison Barnes,F,22023,203084,22300500,"JAN 07, 2024",SAC vs. NOP,L,22,4,9,0.444,2,5,0.4,0,0,0.0,1,0,1,0,1,0,0,1,10,-13,1,SAC,SAC,NOP,100,16.5,Pts+Rebs,11,11,10,1
Harrison Barnes,F,22023,203084,22300500,"JAN 07, 2024",SAC vs. NOP,L,22,4,9,0.444,2,5,0.4,0,0,0.0,1,0,1,0,1,0,0,1,10,-13,1,SAC,SAC,NOP,100,14.5,Pts+Asts,11,11,10,1
Harrison Barnes,F,22023,203084,22300492,"JAN 05, 2024",SAC vs. TOR,W,34,5,12,0.417,5,8,0.625,1,2,0.5,3,1,4,2,0,0,1,3,16,2,1,SAC,SAC,TOR,135,13.0,Points,22,20,18,6
Harrison Barnes,F,22023,203084,22300492,"JAN 05, 2024",SAC vs. TOR,W,34,5,12,0.417,5,8,0.625,1,2,0.5,3,1,4,2,0,0,1,3,16,2,1,SAC,SAC,TOR,135,17.5,Pts+Rebs+Asts,22,20,18,6
Harrison Barnes,F,22023,203084,22300492,"JAN 05, 2024",SAC vs. TOR,W,34,5,12,0.417,5,8,0.625,1,2,0.5,3,1,4,2,0,0,1,3,16,2,1,SAC,SAC,TOR,135,20.5,Fantasy Score,22,20,18,6
Harrison Barnes,F,22023,203084,22300492,"JAN 05, 2024",SAC vs. TOR,W,34,5,12,0.417,5,8,0.625,1,2,0.5,3,1,4,2,0,0,1,3,16,2,1,SAC,SAC,TOR,135,0.5,Offensive Rebounds,22,20,18,6
Harrison Barnes,F,22023,203084,22300492,"JAN 05, 2024",SAC vs. TOR,W,34,5,12,0.417,5,8,0.625,1,2,0.5,3,1,4,2,0,0,1,3,16,2,1,SAC,SAC,TOR,135,4.5,3-PT Attempted,22,20,18,6
Harrison Barnes,F,22023,203084,22300492,"JAN 05, 2024",SAC vs. TOR,W,34,5,12,0.417,5,8,0.625,1,2,0.5,3,1,4,2,0,0,1,3,16,2,1,SAC,SAC,TOR,135,16.5,Pts+Rebs,22,20,18,6
Harrison Barnes,F,22023,203084,22300492,"JAN 05, 2024",SAC vs. TOR,W,34,5,12,0.417,5,8,0.625,1,2,0.5,3,1,4,2,0,0,1,3,16,2,1,SAC,SAC,TOR,135,14.5,Pts+Asts,22,20,18,6
Harrison Barnes,F,22023,203084,22300476,"JAN 03, 2024",SAC vs. ORL,W,36,5,9,0.556,4,6,0.667,3,5,0.6,1,2,3,1,1,0,0,4,17,1,1,SAC,SAC,ORL,138,13.0,Points,21,20,18,4
Harrison Barnes,F,22023,203084,22300476,"JAN 03, 2024",SAC vs. ORL,W,36,5,9,0.556,4,6,0.667,3,5,0.6,1,2,3,1,1,0,0,4,17,1,1,SAC,SAC,ORL,138,17.5,Pts+Rebs+Asts,21,20,18,4
Harrison Barnes,F,22023,203084,22300476,"JAN 03, 2024",SAC vs. ORL,W,36,5,9,0.556,4,6,0.667,3,5,0.6,1,2,3,1,1,0,0,4,17,1,1,SAC,SAC,ORL,138,20.5,Fantasy Score,21,20,18,4
Harrison Barnes,F,22023,203084,22300476,"JAN 03, 2024",SAC vs. ORL,W,36,5,9,0.556,4,6,0.667,3,5,0.6,1,2,3,1,1,0,0,4,17,1,1,SAC,SAC,ORL,138,0.5,Offensive Rebounds,21,20,18,4
Harrison Barnes,F,22023,203084,22300476,"JAN 03, 2024",SAC vs. ORL,W,36,5,9,0.556,4,6,0.667,3,5,0.6,1,2,3,1,1,0,0,4,17,1,1,SAC,SAC,ORL,138,4.5,3-PT Attempted,21,20,18,4
Harrison Barnes,F,22023,203084,22300476,"JAN 03, 2024",SAC vs. ORL,W,36,5,9,0.556,4,6,0.667,3,5,0.6,1,2,3,1,1,0,0,4,17,1,1,SAC,SAC,ORL,138,16.5,Pts+Rebs,21,20,18,4
Harrison Barnes,F,22023,203084,22300476,"JAN 03, 2024",SAC vs. ORL,W,36,5,9,0.556,4,6,0.667,3,5,0.6,1,2,3,1,1,0,0,4,17,1,1,SAC,SAC,ORL,138,14.5,Pts+Asts,21,20,18,4
Harrison Barnes,F,22023,203084,22300464,"JAN 02, 2024",SAC vs. CHA,L,24,1,2,0.5,1,2,0.5,0,0,0.0,0,1,1,1,2,0,1,2,3,1,1,SAC,SAC,CHA,104,13.0,Points,5,4,4,2
Harrison Barnes,F,22023,203084,22300464,"JAN 02, 2024",SAC vs. CHA,L,24,1,2,0.5,1,2,0.5,0,0,0.0,0,1,1,1,2,0,1,2,3,1,1,SAC,SAC,CHA,104,17.5,Pts+Rebs+Asts,5,4,4,2
Harrison Barnes,F,22023,203084,22300464,"JAN 02, 2024",SAC vs. CHA,L,24,1,2,0.5,1,2,0.5,0,0,0.0,0,1,1,1,2,0,1,2,3,1,1,SAC,SAC,CHA,104,20.5,Fantasy Score,5,4,4,2
Harrison Barnes,F,22023,203084,22300464,"JAN 02, 2024",SAC vs. CHA,L,24,1,2,0.5,1,2,0.5,0,0,0.0,0,1,1,1,2,0,1,2,3,1,1,SAC,SAC,CHA,104,0.5,Offensive Rebounds,5,4,4,2
Harrison Barnes,F,22023,203084,22300464,"JAN 02, 2024",SAC vs. CHA,L,24,1,2,0.5,1,2,0.5,0,0,0.0,0,1,1,1,2,0,1,2,3,1,1,SAC,SAC,CHA,104,4.5,3-PT Attempted,5,4,4,2
Harrison Barnes,F,22023,203084,22300464,"JAN 02, 2024",SAC vs. CHA,L,24,1,2,0.5,1,2,0.5,0,0,0.0,0,1,1,1,2,0,1,2,3,1,1,SAC,SAC,CHA,104,16.5,Pts+Rebs,5,4,4,2
Harrison Barnes,F,22023,203084,22300464,"JAN 02, 2024",SAC vs. CHA,L,24,1,2,0.5,1,2,0.5,0,0,0.0,0,1,1,1,2,0,1,2,3,1,1,SAC,SAC,CHA,104,14.5,Pts+Asts,5,4,4,2
Harrison Barnes,F,22023,203084,22300449,"DEC 31, 2023",SAC @ MEM,W,20,4,8,0.5,2,5,0.4,1,1,1.0,0,2,2,0,0,1,1,2,11,8,1,SAC,MEM,SAC,123,13.0,Points,13,13,11,2
Harrison Barnes,F,22023,203084,22300449,"DEC 31, 2023",SAC @ MEM,W,20,4,8,0.5,2,5,0.4,1,1,1.0,0,2,2,0,0,1,1,2,11,8,1,SAC,MEM,SAC,123,17.5,Pts+Rebs+Asts,13,13,11,2
Harrison Barnes,F,22023,203084,22300449,"DEC 31, 2023",SAC @ MEM,W,20,4,8,0.5,2,5,0.4,1,1,1.0,0,2,2,0,0,1,1,2,11,8,1,SAC,MEM,SAC,123,20.5,Fantasy Score,13,13,11,2
Harrison Barnes,F,22023,203084,22300449,"DEC 31, 2023",SAC @ MEM,W,20,4,8,0.5,2,5,0.4,1,1,1.0,0,2,2,0,0,1,1,2,11,8,1,SAC,MEM,SAC,123,0.5,Offensive Rebounds,13,13,11,2
Harrison Barnes,F,22023,203084,22300449,"DEC 31, 2023",SAC @ MEM,W,20,4,8,0.5,2,5,0.4,1,1,1.0,0,2,2,0,0,1,1,2,11,8,1,SAC,MEM,SAC,123,4.5,3-PT Attempted,13,13,11,2
Harrison Barnes,F,22023,203084,22300449,"DEC 31, 2023",SAC @ MEM,W,20,4,8,0.5,2,5,0.4,1,1,1.0,0,2,2,0,0,1,1,2,11,8,1,SAC,MEM,SAC,123,16.5,Pts+Rebs,13,13,11,2
Harrison Barnes,F,22023,203084,22300449,"DEC 31, 2023",SAC @ MEM,W,20,4,8,0.5,2,5,0.4,1,1,1.0,0,2,2,0,0,1,1,2,11,8,1,SAC,MEM,SAC,123,14.5,Pts+Asts,13,13,11,2
Harrison Barnes,F,22023,203084,22300431,"DEC 29, 2023",SAC @ ATL,W,12,0,2,0.0,0,2,0.0,2,2,1.0,0,0,0,0,0,0,0,1,2,-4,1,SAC,ATL,SAC,117,13.0,Points,2,2,2,0
Harrison Barnes,F,22023,203084,22300431,"DEC 29, 2023",SAC @ ATL,W,12,0,2,0.0,0,2,0.0,2,2,1.0,0,0,0,0,0,0,0,1,2,-4,1,SAC,ATL,SAC,117,17.5,Pts+Rebs+Asts,2,2,2,0
Harrison Barnes,F,22023,203084,22300431,"DEC 29, 2023",SAC @ ATL,W,12,0,2,0.0,0,2,0.0,2,2,1.0,0,0,0,0,0,0,0,1,2,-4,1,SAC,ATL,SAC,117,20.5,Fantasy Score,2,2,2,0
Harrison Barnes,F,22023,203084,22300431,"DEC 29, 2023",SAC @ ATL,W,12,0,2,0.0,0,2,0.0,2,2,1.0,0,0,0,0,0,0,0,1,2,-4,1,SAC,ATL,SAC,117,0.5,Offensive Rebounds,2,2,2,0
Harrison Barnes,F,22023,203084,22300431,"DEC 29, 2023",SAC @ ATL,W,12,0,2,0.0,0,2,0.0,2,2,1.0,0,0,0,0,0,0,0,1,2,-4,1,SAC,ATL,SAC,117,4.5,3-PT Attempted,2,2,2,0
Harrison Barnes,F,22023,203084,22300431,"DEC 29, 2023",SAC @ ATL,W,12,0,2,0.0,0,2,0.0,2,2,1.0,0,0,0,0,0,0,0,1,2,-4,1,SAC,ATL,SAC,117,16.5,Pts+Rebs,2,2,2,0
Harrison Barnes,F,22023,203084,22300431,"DEC 29, 2023",SAC @ ATL,W,12,0,2,0.0,0,2,0.0,2,2,1.0,0,0,0,0,0,0,0,1,2,-4,1,SAC,ATL,SAC,117,14.5,Pts+Asts,2,2,2,0
Harrison Barnes,F,22023,203084,22300413,"DEC 26, 2023",SAC @ POR,L,36,3,8,0.375,0,3,0.0,3,3,1.0,2,3,5,1,1,0,2,2,9,-9,1,SAC,POR,SAC,113,13.0,Points,15,14,10,6
Harrison Barnes,F,22023,203084,22300413,"DEC 26, 2023",SAC @ POR,L,36,3,8,0.375,0,3,0.0,3,3,1.0,2,3,5,1,1,0,2,2,9,-9,1,SAC,POR,SAC,113,17.5,Pts+Rebs+Asts,15,14,10,6
Harrison Barnes,F,22023,203084,22300413,"DEC 26, 2023",SAC @ POR,L,36,3,8,0.375,0,3,0.0,3,3,1.0,2,3,5,1,1,0,2,2,9,-9,1,SAC,POR,SAC,113,20.5,Fantasy Score,15,14,10,6
Harrison Barnes,F,22023,203084,22300413,"DEC 26, 2023",SAC @ POR,L,36,3,8,0.375,0,3,0.0,3,3,1.0,2,3,5,1,1,0,2,2,9,-9,1,SAC,POR,SAC,113,0.5,Offensive Rebounds,15,14,10,6
Harrison Barnes,F,22023,203084,22300413,"DEC 26, 2023",SAC @ POR,L,36,3,8,0.375,0,3,0.0,3,3,1.0,2,3,5,1,1,0,2,2,9,-9,1,SAC,POR,SAC,113,4.5,3-PT Attempted,15,14,10,6
Harrison Barnes,F,22023,203084,22300413,"DEC 26, 2023",SAC @ POR,L,36,3,8,0.375,0,3,0.0,3,3,1.0,2,3,5,1,1,0,2,2,9,-9,1,SAC,POR,SAC,113,16.5,Pts+Rebs,15,14,10,6
Harrison Barnes,F,22023,203084,22300413,"DEC 26, 2023",SAC @ POR,L,36,3,8,0.375,0,3,0.0,3,3,1.0,2,3,5,1,1,0,2,2,9,-9,1,SAC,POR,SAC,113,14.5,Pts+Asts,15,14,10,6
Harrison Barnes,F,22023,203084,22300400,"DEC 23, 2023",SAC vs. MIN,L,31,3,6,0.5,0,2,0.0,6,6,1.0,0,3,3,1,0,0,0,3,12,-12,1,SAC,SAC,MIN,98,13.0,Points,16,15,13,4
Harrison Barnes,F,22023,203084,22300400,"DEC 23, 2023",SAC vs. MIN,L,31,3,6,0.5,0,2,0.0,6,6,1.0,0,3,3,1,0,0,0,3,12,-12,1,SAC,SAC,MIN,98,17.5,Pts+Rebs+Asts,16,15,13,4
Harrison Barnes,F,22023,203084,22300400,"DEC 23, 2023",SAC vs. MIN,L,31,3,6,0.5,0,2,0.0,6,6,1.0,0,3,3,1,0,0,0,3,12,-12,1,SAC,SAC,MIN,98,20.5,Fantasy Score,16,15,13,4
Harrison Barnes,F,22023,203084,22300400,"DEC 23, 2023",SAC vs. MIN,L,31,3,6,0.5,0,2,0.0,6,6,1.0,0,3,3,1,0,0,0,3,12,-12,1,SAC,SAC,MIN,98,0.5,Offensive Rebounds,16,15,13,4
Harrison Barnes,F,22023,203084,22300400,"DEC 23, 2023",SAC vs. MIN,L,31,3,6,0.5,0,2,0.0,6,6,1.0,0,3,3,1,0,0,0,3,12,-12,1,SAC,SAC,MIN,98,4.5,3-PT Attempted,16,15,13,4
Harrison Barnes,F,22023,203084,22300400,"DEC 23, 2023",SAC vs. MIN,L,31,3,6,0.5,0,2,0.0,6,6,1.0,0,3,3,1,0,0,0,3,12,-12,1,SAC,SAC,MIN,98,16.5,Pts+Rebs,16,15,13,4
Harrison Barnes,F,22023,203084,22300400,"DEC 23, 2023",SAC vs. MIN,L,31,3,6,0.5,0,2,0.0,6,6,1.0,0,3,3,1,0,0,0,3,12,-12,1,SAC,SAC,MIN,98,14.5,Pts+Asts,16,15,13,4
Harrison Barnes,F,22023,203084,22300387,"DEC 22, 2023",SAC vs. PHX,W,37,5,10,0.5,4,8,0.5,5,6,0.833,0,1,1,0,2,1,0,2,19,16,1,SAC,SAC,PHX,120,13.0,Points,20,20,19,1
Harrison Barnes,F,22023,203084,22300387,"DEC 22, 2023",SAC vs. PHX,W,37,5,10,0.5,4,8,0.5,5,6,0.833,0,1,1,0,2,1,0,2,19,16,1,SAC,SAC,PHX,120,17.5,Pts+Rebs+Asts,20,20,19,1
Harrison Barnes,F,22023,203084,22300387,"DEC 22, 2023",SAC vs. PHX,W,37,5,10,0.5,4,8,0.5,5,6,0.833,0,1,1,0,2,1,0,2,19,16,1,SAC,SAC,PHX,120,20.5,Fantasy Score,20,20,19,1
Harrison Barnes,F,22023,203084,22300387,"DEC 22, 2023",SAC vs. PHX,W,37,5,10,0.5,4,8,0.5,5,6,0.833,0,1,1,0,2,1,0,2,19,16,1,SAC,SAC,PHX,120,0.5,Offensive Rebounds,20,20,19,1
Harrison Barnes,F,22023,203084,22300387,"DEC 22, 2023",SAC vs. PHX,W,37,5,10,0.5,4,8,0.5,5,6,0.833,0,1,1,0,2,1,0,2,19,16,1,SAC,SAC,PHX,120,4.5,3-PT Attempted,20,20,19,1
Harrison Barnes,F,22023,203084,22300387,"DEC 22, 2023",SAC vs. PHX,W,37,5,10,0.5,4,8,0.5,5,6,0.833,0,1,1,0,2,1,0,2,19,16,1,SAC,SAC,PHX,120,16.5,Pts+Rebs,20,20,19,1
Harrison Barnes,F,22023,203084,22300387,"DEC 22, 2023",SAC vs. PHX,W,37,5,10,0.5,4,8,0.5,5,6,0.833,0,1,1,0,2,1,0,2,19,16,1,SAC,SAC,PHX,120,14.5,Pts+Asts,20,20,19,1
Harrison Barnes,F,22023,203084,22300373,"DEC 20, 2023",SAC vs. BOS,L,30,3,5,0.6,2,2,1.0,2,4,0.5,1,3,4,3,0,0,0,1,10,-21,1,SAC,SAC,BOS,119,13.0,Points,17,14,13,7
Harrison Barnes,F,22023,203084,22300373,"DEC 20, 2023",SAC vs. BOS,L,30,3,5,0.6,2,2,1.0,2,4,0.5,1,3,4,3,0,0,0,1,10,-21,1,SAC,SAC,BOS,119,17.5,Pts+Rebs+Asts,17,14,13,7
Harrison Barnes,F,22023,203084,22300373,"DEC 20, 2023",SAC vs. BOS,L,30,3,5,0.6,2,2,1.0,2,4,0.5,1,3,4,3,0,0,0,1,10,-21,1,SAC,SAC,BOS,119,20.5,Fantasy Score,17,14,13,7
Harrison Barnes,F,22023,203084,22300373,"DEC 20, 2023",SAC vs. BOS,L,30,3,5,0.6,2,2,1.0,2,4,0.5,1,3,4,3,0,0,0,1,10,-21,1,SAC,SAC,BOS,119,0.5,Offensive Rebounds,17,14,13,7
Harrison Barnes,F,22023,203084,22300373,"DEC 20, 2023",SAC vs. BOS,L,30,3,5,0.6,2,2,1.0,2,4,0.5,1,3,4,3,0,0,0,1,10,-21,1,SAC,SAC,BOS,119,4.5,3-PT Attempted,17,14,13,7
Harrison Barnes,F,22023,203084,22300373,"DEC 20, 2023",SAC vs. BOS,L,30,3,5,0.6,2,2,1.0,2,4,0.5,1,3,4,3,0,0,0,1,10,-21,1,SAC,SAC,BOS,119,16.5,Pts+Rebs,17,14,13,7
Harrison Barnes,F,22023,203084,22300373,"DEC 20, 2023",SAC vs. BOS,L,30,3,5,0.6,2,2,1.0,2,4,0.5,1,3,4,3,0,0,0,1,10,-21,1,SAC,SAC,BOS,119,14.5,Pts+Asts,17,14,13,7
Harrison Barnes,F,22023,203084,22300358,"DEC 18, 2023",SAC vs. WAS,W,34,8,11,0.727,2,4,0.5,1,1,1.0,0,0,0,0,1,0,1,1,19,22,1,SAC,SAC,WAS,141,13.0,Points,19,19,19,0
Harrison Barnes,F,22023,203084,22300358,"DEC 18, 2023",SAC vs. WAS,W,34,8,11,0.727,2,4,0.5,1,1,1.0,0,0,0,0,1,0,1,1,19,22,1,SAC,SAC,WAS,141,17.5,Pts+Rebs+Asts,19,19,19,0
Harrison Barnes,F,22023,203084,22300358,"DEC 18, 2023",SAC vs. WAS,W,34,8,11,0.727,2,4,0.5,1,1,1.0,0,0,0,0,1,0,1,1,19,22,1,SAC,SAC,WAS,141,20.5,Fantasy Score,19,19,19,0
Harrison Barnes,F,22023,203084,22300358,"DEC 18, 2023",SAC vs. WAS,W,34,8,11,0.727,2,4,0.5,1,1,1.0,0,0,0,0,1,0,1,1,19,22,1,SAC,SAC,WAS,141,0.5,Offensive Rebounds,19,19,19,0
Harrison Barnes,F,22023,203084,22300358,"DEC 18, 2023",SAC vs. WAS,W,34,8,11,0.727,2,4,0.5,1,1,1.0,0,0,0,0,1,0,1,1,19,22,1,SAC,SAC,WAS,141,4.5,3-PT Attempted,19,19,19,0
Harrison Barnes,F,22023,203084,22300358,"DEC 18, 2023",SAC vs. WAS,W,34,8,11,0.727,2,4,0.5,1,1,1.0,0,0,0,0,1,0,1,1,19,22,1,SAC,SAC,WAS,141,16.5,Pts+Rebs,19,19,19,0
Harrison Barnes,F,22023,203084,22300358,"DEC 18, 2023",SAC vs. WAS,W,34,8,11,0.727,2,4,0.5,1,1,1.0,0,0,0,0,1,0,1,1,19,22,1,SAC,SAC,WAS,141,14.5,Pts+Asts,19,19,19,0
Harrison Barnes,F,22023,203084,22300342,"DEC 16, 2023",SAC vs. UTA,W,33,6,11,0.545,3,5,0.6,1,1,1.0,2,2,4,2,1,0,0,1,16,5,1,SAC,SAC,UTA,125,13.0,Points,22,20,18,6
Harrison Barnes,F,22023,203084,22300342,"DEC 16, 2023",SAC vs. UTA,W,33,6,11,0.545,3,5,0.6,1,1,1.0,2,2,4,2,1,0,0,1,16,5,1,SAC,SAC,UTA,125,17.5,Pts+Rebs+Asts,22,20,18,6
Harrison Barnes,F,22023,203084,22300342,"DEC 16, 2023",SAC vs. UTA,W,33,6,11,0.545,3,5,0.6,1,1,1.0,2,2,4,2,1,0,0,1,16,5,1,SAC,SAC,UTA,125,20.5,Fantasy Score,22,20,18,6
Harrison Barnes,F,22023,203084,22300342,"DEC 16, 2023",SAC vs. UTA,W,33,6,11,0.545,3,5,0.6,1,1,1.0,2,2,4,2,1,0,0,1,16,5,1,SAC,SAC,UTA,125,0.5,Offensive Rebounds,22,20,18,6
Harrison Barnes,F,22023,203084,22300342,"DEC 16, 2023",SAC vs. UTA,W,33,6,11,0.545,3,5,0.6,1,1,1.0,2,2,4,2,1,0,0,1,16,5,1,SAC,SAC,UTA,125,4.5,3-PT Attempted,22,20,18,6
Harrison Barnes,F,22023,203084,22300342,"DEC 16, 2023",SAC vs. UTA,W,33,6,11,0.545,3,5,0.6,1,1,1.0,2,2,4,2,1,0,0,1,16,5,1,SAC,SAC,UTA,125,16.5,Pts+Rebs,22,20,18,6
Harrison Barnes,F,22023,203084,22300342,"DEC 16, 2023",SAC vs. UTA,W,33,6,11,0.545,3,5,0.6,1,1,1.0,2,2,4,2,1,0,0,1,16,5,1,SAC,SAC,UTA,125,14.5,Pts+Asts,22,20,18,6
Harrison Barnes,F,22023,203084,22300324,"DEC 14, 2023",SAC vs. OKC,W,21,2,7,0.286,1,4,0.25,0,0,0.0,2,1,3,2,0,0,2,1,5,-9,1,SAC,SAC,OKC,128,13.0,Points,10,8,7,5
Harrison Barnes,F,22023,203084,22300324,"DEC 14, 2023",SAC vs. OKC,W,21,2,7,0.286,1,4,0.25,0,0,0.0,2,1,3,2,0,0,2,1,5,-9,1,SAC,SAC,OKC,128,17.5,Pts+Rebs+Asts,10,8,7,5
Harrison Barnes,F,22023,203084,22300324,"DEC 14, 2023",SAC vs. OKC,W,21,2,7,0.286,1,4,0.25,0,0,0.0,2,1,3,2,0,0,2,1,5,-9,1,SAC,SAC,OKC,128,20.5,Fantasy Score,10,8,7,5
Harrison Barnes,F,22023,203084,22300324,"DEC 14, 2023",SAC vs. OKC,W,21,2,7,0.286,1,4,0.25,0,0,0.0,2,1,3,2,0,0,2,1,5,-9,1,SAC,SAC,OKC,128,0.5,Offensive Rebounds,10,8,7,5
Harrison Barnes,F,22023,203084,22300324,"DEC 14, 2023",SAC vs. OKC,W,21,2,7,0.286,1,4,0.25,0,0,0.0,2,1,3,2,0,0,2,1,5,-9,1,SAC,SAC,OKC,128,4.5,3-PT Attempted,10,8,7,5
Harrison Barnes,F,22023,203084,22300324,"DEC 14, 2023",SAC vs. OKC,W,21,2,7,0.286,1,4,0.25,0,0,0.0,2,1,3,2,0,0,2,1,5,-9,1,SAC,SAC,OKC,128,16.5,Pts+Rebs,10,8,7,5
Harrison Barnes,F,22023,203084,22300324,"DEC 14, 2023",SAC vs. OKC,W,21,2,7,0.286,1,4,0.25,0,0,0.0,2,1,3,2,0,0,2,1,5,-9,1,SAC,SAC,OKC,128,14.5,Pts+Asts,10,8,7,5
Harrison Barnes,F,22023,203084,22300309,"DEC 12, 2023",SAC @ LAC,L,19,1,3,0.333,0,2,0.0,0,0,0.0,0,1,1,1,0,0,0,2,2,-13,1,SAC,LAC,SAC,99,13.0,Points,4,3,3,2
Harrison Barnes,F,22023,203084,22300309,"DEC 12, 2023",SAC @ LAC,L,19,1,3,0.333,0,2,0.0,0,0,0.0,0,1,1,1,0,0,0,2,2,-13,1,SAC,LAC,SAC,99,17.5,Pts+Rebs+Asts,4,3,3,2
Harrison Barnes,F,22023,203084,22300309,"DEC 12, 2023",SAC @ LAC,L,19,1,3,0.333,0,2,0.0,0,0,0.0,0,1,1,1,0,0,0,2,2,-13,1,SAC,LAC,SAC,99,20.5,Fantasy Score,4,3,3,2
Harrison Barnes,F,22023,203084,22300309,"DEC 12, 2023",SAC @ LAC,L,19,1,3,0.333,0,2,0.0,0,0,0.0,0,1,1,1,0,0,0,2,2,-13,1,SAC,LAC,SAC,99,0.5,Offensive Rebounds,4,3,3,2
Harrison Barnes,F,22023,203084,22300309,"DEC 12, 2023",SAC @ LAC,L,19,1,3,0.333,0,2,0.0,0,0,0.0,0,1,1,1,0,0,0,2,2,-13,1,SAC,LAC,SAC,99,4.5,3-PT Attempted,4,3,3,2
Harrison Barnes,F,22023,203084,22300309,"DEC 12, 2023",SAC @ LAC,L,19,1,3,0.333,0,2,0.0,0,0,0.0,0,1,1,1,0,0,0,2,2,-13,1,SAC,LAC,SAC,99,16.5,Pts+Rebs,4,3,3,2
Harrison Barnes,F,22023,203084,22300309,"DEC 12, 2023",SAC @ LAC,L,19,1,3,0.333,0,2,0.0,0,0,0.0,0,1,1,1,0,0,0,2,2,-13,1,SAC,LAC,SAC,99,14.5,Pts+Asts,4,3,3,2
Harrison Barnes,F,22023,203084,22300303,"DEC 11, 2023",SAC vs. BKN,W,27,5,7,0.714,3,4,0.75,1,1,1.0,0,2,2,1,0,1,1,1,14,22,1,SAC,SAC,BKN,131,13.0,Points,17,16,15,3
Harrison Barnes,F,22023,203084,22300303,"DEC 11, 2023",SAC vs. BKN,W,27,5,7,0.714,3,4,0.75,1,1,1.0,0,2,2,1,0,1,1,1,14,22,1,SAC,SAC,BKN,131,17.5,Pts+Rebs+Asts,17,16,15,3
Harrison Barnes,F,22023,203084,22300303,"DEC 11, 2023",SAC vs. BKN,W,27,5,7,0.714,3,4,0.75,1,1,1.0,0,2,2,1,0,1,1,1,14,22,1,SAC,SAC,BKN,131,20.5,Fantasy Score,17,16,15,3
Harrison Barnes,F,22023,203084,22300303,"DEC 11, 2023",SAC vs. BKN,W,27,5,7,0.714,3,4,0.75,1,1,1.0,0,2,2,1,0,1,1,1,14,22,1,SAC,SAC,BKN,131,0.5,Offensive Rebounds,17,16,15,3
Harrison Barnes,F,22023,203084,22300303,"DEC 11, 2023",SAC vs. BKN,W,27,5,7,0.714,3,4,0.75,1,1,1.0,0,2,2,1,0,1,1,1,14,22,1,SAC,SAC,BKN,131,4.5,3-PT Attempted,17,16,15,3
Harrison Barnes,F,22023,203084,22300303,"DEC 11, 2023",SAC vs. BKN,W,27,5,7,0.714,3,4,0.75,1,1,1.0,0,2,2,1,0,1,1,1,14,22,1,SAC,SAC,BKN,131,16.5,Pts+Rebs,17,16,15,3
Harrison Barnes,F,22023,203084,22300303,"DEC 11, 2023",SAC vs. BKN,W,27,5,7,0.714,3,4,0.75,1,1,1.0,0,2,2,1,0,1,1,1,14,22,1,SAC,SAC,BKN,131,14.5,Pts+Asts,17,16,15,3
Harrison Barnes,F,22023,203084,22301228,"DEC 08, 2023",SAC @ PHX,W,32,3,11,0.273,1,4,0.25,2,3,0.667,4,4,8,2,1,0,0,0,9,8,1,SAC,PHX,SAC,114,13.0,Points,19,17,11,10
Harrison Barnes,F,22023,203084,22301228,"DEC 08, 2023",SAC @ PHX,W,32,3,11,0.273,1,4,0.25,2,3,0.667,4,4,8,2,1,0,0,0,9,8,1,SAC,PHX,SAC,114,17.5,Pts+Rebs+Asts,19,17,11,10
Harrison Barnes,F,22023,203084,22301228,"DEC 08, 2023",SAC @ PHX,W,32,3,11,0.273,1,4,0.25,2,3,0.667,4,4,8,2,1,0,0,0,9,8,1,SAC,PHX,SAC,114,20.5,Fantasy Score,19,17,11,10
Harrison Barnes,F,22023,203084,22301228,"DEC 08, 2023",SAC @ PHX,W,32,3,11,0.273,1,4,0.25,2,3,0.667,4,4,8,2,1,0,0,0,9,8,1,SAC,PHX,SAC,114,0.5,Offensive Rebounds,19,17,11,10
Harrison Barnes,F,22023,203084,22301228,"DEC 08, 2023",SAC @ PHX,W,32,3,11,0.273,1,4,0.25,2,3,0.667,4,4,8,2,1,0,0,0,9,8,1,SAC,PHX,SAC,114,4.5,3-PT Attempted,19,17,11,10
Harrison Barnes,F,22023,203084,22301228,"DEC 08, 2023",SAC @ PHX,W,32,3,11,0.273,1,4,0.25,2,3,0.667,4,4,8,2,1,0,0,0,9,8,1,SAC,PHX,SAC,114,16.5,Pts+Rebs,19,17,11,10
Harrison Barnes,F,22023,203084,22301228,"DEC 08, 2023",SAC @ PHX,W,32,3,11,0.273,1,4,0.25,2,3,0.667,4,4,8,2,1,0,0,0,9,8,1,SAC,PHX,SAC,114,14.5,Pts+Asts,19,17,11,10
Harrison Barnes,F,22023,203084,22301204,"DEC 04, 2023",SAC vs. NOP,L,34,1,3,0.333,1,3,0.333,1,2,0.5,1,3,4,1,1,1,2,0,4,-11,1,SAC,SAC,NOP,117,13.0,Points,9,8,5,5
Harrison Barnes,F,22023,203084,22301204,"DEC 04, 2023",SAC vs. NOP,L,34,1,3,0.333,1,3,0.333,1,2,0.5,1,3,4,1,1,1,2,0,4,-11,1,SAC,SAC,NOP,117,17.5,Pts+Rebs+Asts,9,8,5,5
Harrison Barnes,F,22023,203084,22301204,"DEC 04, 2023",SAC vs. NOP,L,34,1,3,0.333,1,3,0.333,1,2,0.5,1,3,4,1,1,1,2,0,4,-11,1,SAC,SAC,NOP,117,20.5,Fantasy Score,9,8,5,5
Harrison Barnes,F,22023,203084,22301204,"DEC 04, 2023",SAC vs. NOP,L,34,1,3,0.333,1,3,0.333,1,2,0.5,1,3,4,1,1,1,2,0,4,-11,1,SAC,SAC,NOP,117,0.5,Offensive Rebounds,9,8,5,5
Harrison Barnes,F,22023,203084,22301204,"DEC 04, 2023",SAC vs. NOP,L,34,1,3,0.333,1,3,0.333,1,2,0.5,1,3,4,1,1,1,2,0,4,-11,1,SAC,SAC,NOP,117,4.5,3-PT Attempted,9,8,5,5
Harrison Barnes,F,22023,203084,22301204,"DEC 04, 2023",SAC vs. NOP,L,34,1,3,0.333,1,3,0.333,1,2,0.5,1,3,4,1,1,1,2,0,4,-11,1,SAC,SAC,NOP,117,16.5,Pts+Rebs,9,8,5,5
Harrison Barnes,F,22023,203084,22301204,"DEC 04, 2023",SAC vs. NOP,L,34,1,3,0.333,1,3,0.333,1,2,0.5,1,3,4,1,1,1,2,0,4,-11,1,SAC,SAC,NOP,117,14.5,Pts+Asts,9,8,5,5
Harrison Barnes,F,22023,203084,22300290,"DEC 02, 2023",SAC vs. DEN,W,33,5,9,0.556,1,2,0.5,0,0,0.0,2,1,3,0,0,0,0,1,11,11,1,SAC,SAC,DEN,123,13.0,Points,14,14,11,3
Harrison Barnes,F,22023,203084,22300290,"DEC 02, 2023",SAC vs. DEN,W,33,5,9,0.556,1,2,0.5,0,0,0.0,2,1,3,0,0,0,0,1,11,11,1,SAC,SAC,DEN,123,17.5,Pts+Rebs+Asts,14,14,11,3
Harrison Barnes,F,22023,203084,22300290,"DEC 02, 2023",SAC vs. DEN,W,33,5,9,0.556,1,2,0.5,0,0,0.0,2,1,3,0,0,0,0,1,11,11,1,SAC,SAC,DEN,123,20.5,Fantasy Score,14,14,11,3
Harrison Barnes,F,22023,203084,22300290,"DEC 02, 2023",SAC vs. DEN,W,33,5,9,0.556,1,2,0.5,0,0,0.0,2,1,3,0,0,0,0,1,11,11,1,SAC,SAC,DEN,123,0.5,Offensive Rebounds,14,14,11,3
Harrison Barnes,F,22023,203084,22300290,"DEC 02, 2023",SAC vs. DEN,W,33,5,9,0.556,1,2,0.5,0,0,0.0,2,1,3,0,0,0,0,1,11,11,1,SAC,SAC,DEN,123,4.5,3-PT Attempted,14,14,11,3
Harrison Barnes,F,22023,203084,22300290,"DEC 02, 2023",SAC vs. DEN,W,33,5,9,0.556,1,2,0.5,0,0,0.0,2,1,3,0,0,0,0,1,11,11,1,SAC,SAC,DEN,123,16.5,Pts+Rebs,14,14,11,3
Harrison Barnes,F,22023,203084,22300290,"DEC 02, 2023",SAC vs. DEN,W,33,5,9,0.556,1,2,0.5,0,0,0.0,2,1,3,0,0,0,0,1,11,11,1,SAC,SAC,DEN,123,14.5,Pts+Asts,14,14,11,3
Harrison Barnes,F,22023,203084,22300264,"NOV 29, 2023",SAC vs. LAC,L,34,3,7,0.429,1,3,0.333,2,2,1.0,1,4,5,4,1,0,0,3,9,-9,1,SAC,SAC,LAC,117,13.0,Points,18,14,13,9
Harrison Barnes,F,22023,203084,22300264,"NOV 29, 2023",SAC vs. LAC,L,34,3,7,0.429,1,3,0.333,2,2,1.0,1,4,5,4,1,0,0,3,9,-9,1,SAC,SAC,LAC,117,17.5,Pts+Rebs+Asts,18,14,13,9
Harrison Barnes,F,22023,203084,22300264,"NOV 29, 2023",SAC vs. LAC,L,34,3,7,0.429,1,3,0.333,2,2,1.0,1,4,5,4,1,0,0,3,9,-9,1,SAC,SAC,LAC,117,20.5,Fantasy Score,18,14,13,9
Harrison Barnes,F,22023,203084,22300264,"NOV 29, 2023",SAC vs. LAC,L,34,3,7,0.429,1,3,0.333,2,2,1.0,1,4,5,4,1,0,0,3,9,-9,1,SAC,SAC,LAC,117,0.5,Offensive Rebounds,18,14,13,9
Harrison Barnes,F,22023,203084,22300264,"NOV 29, 2023",SAC vs. LAC,L,34,3,7,0.429,1,3,0.333,2,2,1.0,1,4,5,4,1,0,0,3,9,-9,1,SAC,SAC,LAC,117,4.5,3-PT Attempted,18,14,13,9
Harrison Barnes,F,22023,203084,22300264,"NOV 29, 2023",SAC vs. LAC,L,34,3,7,0.429,1,3,0.333,2,2,1.0,1,4,5,4,1,0,0,3,9,-9,1,SAC,SAC,LAC,117,16.5,Pts+Rebs,18,14,13,9
Harrison Barnes,F,22023,203084,22300264,"NOV 29, 2023",SAC vs. LAC,L,34,3,7,0.429,1,3,0.333,2,2,1.0,1,4,5,4,1,0,0,3,9,-9,1,SAC,SAC,LAC,117,14.5,Pts+Asts,18,14,13,9
Harrison Barnes,F,22023,203084,22300060,"NOV 28, 2023",SAC vs. GSW,W,26,5,8,0.625,2,5,0.4,0,0,0.0,0,4,4,1,1,1,1,1,12,-10,1,SAC,SAC,GSW,124,13.0,Points,17,16,13,5
Harrison Barnes,F,22023,203084,22300060,"NOV 28, 2023",SAC vs. GSW,W,26,5,8,0.625,2,5,0.4,0,0,0.0,0,4,4,1,1,1,1,1,12,-10,1,SAC,SAC,GSW,124,17.5,Pts+Rebs+Asts,17,16,13,5
Harrison Barnes,F,22023,203084,22300060,"NOV 28, 2023",SAC vs. GSW,W,26,5,8,0.625,2,5,0.4,0,0,0.0,0,4,4,1,1,1,1,1,12,-10,1,SAC,SAC,GSW,124,20.5,Fantasy Score,17,16,13,5
Harrison Barnes,F,22023,203084,22300060,"NOV 28, 2023",SAC vs. GSW,W,26,5,8,0.625,2,5,0.4,0,0,0.0,0,4,4,1,1,1,1,1,12,-10,1,SAC,SAC,GSW,124,0.5,Offensive Rebounds,17,16,13,5
Harrison Barnes,F,22023,203084,22300060,"NOV 28, 2023",SAC vs. GSW,W,26,5,8,0.625,2,5,0.4,0,0,0.0,0,4,4,1,1,1,1,1,12,-10,1,SAC,SAC,GSW,124,4.5,3-PT Attempted,17,16,13,5
Harrison Barnes,F,22023,203084,22300060,"NOV 28, 2023",SAC vs. GSW,W,26,5,8,0.625,2,5,0.4,0,0,0.0,0,4,4,1,1,1,1,1,12,-10,1,SAC,SAC,GSW,124,16.5,Pts+Rebs,17,16,13,5
Harrison Barnes,F,22023,203084,22300060,"NOV 28, 2023",SAC vs. GSW,W,26,5,8,0.625,2,5,0.4,0,0,0.0,0,4,4,1,1,1,1,1,12,-10,1,SAC,SAC,GSW,124,14.5,Pts+Asts,17,16,13,5
Harrison Barnes,F,22023,203084,22300050,"NOV 24, 2023",SAC @ MIN,W,33,7,11,0.636,2,4,0.5,2,2,1.0,0,4,4,2,1,0,2,0,18,5,1,SAC,MIN,SAC,124,13.0,Points,24,22,20,6
Harrison Barnes,F,22023,203084,22300050,"NOV 24, 2023",SAC @ MIN,W,33,7,11,0.636,2,4,0.5,2,2,1.0,0,4,4,2,1,0,2,0,18,5,1,SAC,MIN,SAC,124,17.5,Pts+Rebs+Asts,24,22,20,6
Harrison Barnes,F,22023,203084,22300050,"NOV 24, 2023",SAC @ MIN,W,33,7,11,0.636,2,4,0.5,2,2,1.0,0,4,4,2,1,0,2,0,18,5,1,SAC,MIN,SAC,124,20.5,Fantasy Score,24,22,20,6
Harrison Barnes,F,22023,203084,22300050,"NOV 24, 2023",SAC @ MIN,W,33,7,11,0.636,2,4,0.5,2,2,1.0,0,4,4,2,1,0,2,0,18,5,1,SAC,MIN,SAC,124,0.5,Offensive Rebounds,24,22,20,6
Harrison Barnes,F,22023,203084,22300050,"NOV 24, 2023",SAC @ MIN,W,33,7,11,0.636,2,4,0.5,2,2,1.0,0,4,4,2,1,0,2,0,18,5,1,SAC,MIN,SAC,124,4.5,3-PT Attempted,24,22,20,6
Harrison Barnes,F,22023,203084,22300050,"NOV 24, 2023",SAC @ MIN,W,33,7,11,0.636,2,4,0.5,2,2,1.0,0,4,4,2,1,0,2,0,18,5,1,SAC,MIN,SAC,124,16.5,Pts+Rebs,24,22,20,6
Harrison Barnes,F,22023,203084,22300050,"NOV 24, 2023",SAC @ MIN,W,33,7,11,0.636,2,4,0.5,2,2,1.0,0,4,4,2,1,0,2,0,18,5,1,SAC,MIN,SAC,124,14.5,Pts+Asts,24,22,20,6
Harrison Barnes,F,22023,203084,22300233,"NOV 22, 2023",SAC @ NOP,L,41,6,13,0.462,4,9,0.444,6,6,1.0,2,1,3,0,0,0,0,2,22,-6,1,SAC,NOP,SAC,112,13.0,Points,25,25,22,3
Harrison Barnes,F,22023,203084,22300233,"NOV 22, 2023",SAC @ NOP,L,41,6,13,0.462,4,9,0.444,6,6,1.0,2,1,3,0,0,0,0,2,22,-6,1,SAC,NOP,SAC,112,17.5,Pts+Rebs+Asts,25,25,22,3
Harrison Barnes,F,22023,203084,22300233,"NOV 22, 2023",SAC @ NOP,L,41,6,13,0.462,4,9,0.444,6,6,1.0,2,1,3,0,0,0,0,2,22,-6,1,SAC,NOP,SAC,112,20.5,Fantasy Score,25,25,22,3
Harrison Barnes,F,22023,203084,22300233,"NOV 22, 2023",SAC @ NOP,L,41,6,13,0.462,4,9,0.444,6,6,1.0,2,1,3,0,0,0,0,2,22,-6,1,SAC,NOP,SAC,112,0.5,Offensive Rebounds,25,25,22,3
Harrison Barnes,F,22023,203084,22300233,"NOV 22, 2023",SAC @ NOP,L,41,6,13,0.462,4,9,0.444,6,6,1.0,2,1,3,0,0,0,0,2,22,-6,1,SAC,NOP,SAC,112,4.5,3-PT Attempted,25,25,22,3
Harrison Barnes,F,22023,203084,22300233,"NOV 22, 2023",SAC @ NOP,L,41,6,13,0.462,4,9,0.444,6,6,1.0,2,1,3,0,0,0,0,2,22,-6,1,SAC,NOP,SAC,112,16.5,Pts+Rebs,25,25,22,3
Harrison Barnes,F,22023,203084,22300233,"NOV 22, 2023",SAC @ NOP,L,41,6,13,0.462,4,9,0.444,6,6,1.0,2,1,3,0,0,0,0,2,22,-6,1,SAC,NOP,SAC,112,14.5,Pts+Asts,25,25,22,3
Harrison Barnes,F,22023,203084,22300222,"NOV 20, 2023",SAC @ NOP,L,30,4,9,0.444,3,6,0.5,5,6,0.833,0,4,4,0,1,0,0,0,16,-23,1,SAC,NOP,SAC,93,13.0,Points,20,20,16,4
Harrison Barnes,F,22023,203084,22300222,"NOV 20, 2023",SAC @ NOP,L,30,4,9,0.444,3,6,0.5,5,6,0.833,0,4,4,0,1,0,0,0,16,-23,1,SAC,NOP,SAC,93,17.5,Pts+Rebs+Asts,20,20,16,4
Harrison Barnes,F,22023,203084,22300222,"NOV 20, 2023",SAC @ NOP,L,30,4,9,0.444,3,6,0.5,5,6,0.833,0,4,4,0,1,0,0,0,16,-23,1,SAC,NOP,SAC,93,20.5,Fantasy Score,20,20,16,4
Harrison Barnes,F,22023,203084,22300222,"NOV 20, 2023",SAC @ NOP,L,30,4,9,0.444,3,6,0.5,5,6,0.833,0,4,4,0,1,0,0,0,16,-23,1,SAC,NOP,SAC,93,0.5,Offensive Rebounds,20,20,16,4
Harrison Barnes,F,22023,203084,22300222,"NOV 20, 2023",SAC @ NOP,L,30,4,9,0.444,3,6,0.5,5,6,0.833,0,4,4,0,1,0,0,0,16,-23,1,SAC,NOP,SAC,93,4.5,3-PT Attempted,20,20,16,4
Harrison Barnes,F,22023,203084,22300222,"NOV 20, 2023",SAC @ NOP,L,30,4,9,0.444,3,6,0.5,5,6,0.833,0,4,4,0,1,0,0,0,16,-23,1,SAC,NOP,SAC,93,16.5,Pts+Rebs,20,20,16,4
Harrison Barnes,F,22023,203084,22300222,"NOV 20, 2023",SAC @ NOP,L,30,4,9,0.444,3,6,0.5,5,6,0.833,0,4,4,0,1,0,0,0,16,-23,1,SAC,NOP,SAC,93,14.5,Pts+Asts,20,20,16,4
Harrison Barnes,F,22023,203084,22300212,"NOV 19, 2023",SAC @ DAL,W,34,4,11,0.364,1,7,0.143,3,3,1.0,2,2,4,6,1,0,3,1,12,17,1,SAC,DAL,SAC,129,13.0,Points,22,16,18,10
Harrison Barnes,F,22023,203084,22300212,"NOV 19, 2023",SAC @ DAL,W,34,4,11,0.364,1,7,0.143,3,3,1.0,2,2,4,6,1,0,3,1,12,17,1,SAC,DAL,SAC,129,17.5,Pts+Rebs+Asts,22,16,18,10
Harrison Barnes,F,22023,203084,22300212,"NOV 19, 2023",SAC @ DAL,W,34,4,11,0.364,1,7,0.143,3,3,1.0,2,2,4,6,1,0,3,1,12,17,1,SAC,DAL,SAC,129,20.5,Fantasy Score,22,16,18,10
Harrison Barnes,F,22023,203084,22300212,"NOV 19, 2023",SAC @ DAL,W,34,4,11,0.364,1,7,0.143,3,3,1.0,2,2,4,6,1,0,3,1,12,17,1,SAC,DAL,SAC,129,0.5,Offensive Rebounds,22,16,18,10
Harrison Barnes,F,22023,203084,22300212,"NOV 19, 2023",SAC @ DAL,W,34,4,11,0.364,1,7,0.143,3,3,1.0,2,2,4,6,1,0,3,1,12,17,1,SAC,DAL,SAC,129,4.5,3-PT Attempted,22,16,18,10
Harrison Barnes,F,22023,203084,22300212,"NOV 19, 2023",SAC @ DAL,W,34,4,11,0.364,1,7,0.143,3,3,1.0,2,2,4,6,1,0,3,1,12,17,1,SAC,DAL,SAC,129,16.5,Pts+Rebs,22,16,18,10
Harrison Barnes,F,22023,203084,22300212,"NOV 19, 2023",SAC @ DAL,W,34,4,11,0.364,1,7,0.143,3,3,1.0,2,2,4,6,1,0,3,1,12,17,1,SAC,DAL,SAC,129,14.5,Pts+Asts,22,16,18,10
Harrison Barnes,F,22023,203084,22300032,"NOV 17, 2023",SAC @ SAS,W,26,2,7,0.286,1,6,0.167,2,3,0.667,0,2,2,1,1,0,1,2,7,5,1,SAC,SAS,SAC,129,13.0,Points,10,9,8,3
Harrison Barnes,F,22023,203084,22300032,"NOV 17, 2023",SAC @ SAS,W,26,2,7,0.286,1,6,0.167,2,3,0.667,0,2,2,1,1,0,1,2,7,5,1,SAC,SAS,SAC,129,17.5,Pts+Rebs+Asts,10,9,8,3
Harrison Barnes,F,22023,203084,22300032,"NOV 17, 2023",SAC @ SAS,W,26,2,7,0.286,1,6,0.167,2,3,0.667,0,2,2,1,1,0,1,2,7,5,1,SAC,SAS,SAC,129,20.5,Fantasy Score,10,9,8,3
Harrison Barnes,F,22023,203084,22300032,"NOV 17, 2023",SAC @ SAS,W,26,2,7,0.286,1,6,0.167,2,3,0.667,0,2,2,1,1,0,1,2,7,5,1,SAC,SAS,SAC,129,0.5,Offensive Rebounds,10,9,8,3
Harrison Barnes,F,22023,203084,22300032,"NOV 17, 2023",SAC @ SAS,W,26,2,7,0.286,1,6,0.167,2,3,0.667,0,2,2,1,1,0,1,2,7,5,1,SAC,SAS,SAC,129,4.5,3-PT Attempted,10,9,8,3
Harrison Barnes,F,22023,203084,22300032,"NOV 17, 2023",SAC @ SAS,W,26,2,7,0.286,1,6,0.167,2,3,0.667,0,2,2,1,1,0,1,2,7,5,1,SAC,SAS,SAC,129,16.5,Pts+Rebs,10,9,8,3
Harrison Barnes,F,22023,203084,22300032,"NOV 17, 2023",SAC @ SAS,W,26,2,7,0.286,1,6,0.167,2,3,0.667,0,2,2,1,1,0,1,2,7,5,1,SAC,SAS,SAC,129,14.5,Pts+Asts,10,9,8,3
Harrison Barnes,F,22023,203084,22300198,"NOV 15, 2023",SAC @ LAL,W,39,5,10,0.5,3,6,0.5,0,0,0.0,0,1,1,2,4,0,2,3,13,16,1,SAC,LAL,SAC,125,13.0,Points,16,14,15,3
Harrison Barnes,F,22023,203084,22300198,"NOV 15, 2023",SAC @ LAL,W,39,5,10,0.5,3,6,0.5,0,0,0.0,0,1,1,2,4,0,2,3,13,16,1,SAC,LAL,SAC,125,17.5,Pts+Rebs+Asts,16,14,15,3
Harrison Barnes,F,22023,203084,22300198,"NOV 15, 2023",SAC @ LAL,W,39,5,10,0.5,3,6,0.5,0,0,0.0,0,1,1,2,4,0,2,3,13,16,1,SAC,LAL,SAC,125,20.5,Fantasy Score,16,14,15,3
Harrison Barnes,F,22023,203084,22300198,"NOV 15, 2023",SAC @ LAL,W,39,5,10,0.5,3,6,0.5,0,0,0.0,0,1,1,2,4,0,2,3,13,16,1,SAC,LAL,SAC,125,0.5,Offensive Rebounds,16,14,15,3
Harrison Barnes,F,22023,203084,22300198,"NOV 15, 2023",SAC @ LAL,W,39,5,10,0.5,3,6,0.5,0,0,0.0,0,1,1,2,4,0,2,3,13,16,1,SAC,LAL,SAC,125,4.5,3-PT Attempted,16,14,15,3
Harrison Barnes,F,22023,203084,22300198,"NOV 15, 2023",SAC @ LAL,W,39,5,10,0.5,3,6,0.5,0,0,0.0,0,1,1,2,4,0,2,3,13,16,1,SAC,LAL,SAC,125,16.5,Pts+Rebs,16,14,15,3
Harrison Barnes,F,22023,203084,22300198,"NOV 15, 2023",SAC @ LAL,W,39,5,10,0.5,3,6,0.5,0,0,0.0,0,1,1,2,4,0,2,3,13,16,1,SAC,LAL,SAC,125,14.5,Pts+Asts,16,14,15,3
Harrison Barnes,F,22023,203084,22300191,"NOV 13, 2023",SAC vs. CLE,W,22,2,4,0.5,0,2,0.0,0,0,0.0,2,3,5,3,0,0,1,0,4,8,1,SAC,SAC,CLE,132,13.0,Points,12,9,7,8
Harrison Barnes,F,22023,203084,22300191,"NOV 13, 2023",SAC vs. CLE,W,22,2,4,0.5,0,2,0.0,0,0,0.0,2,3,5,3,0,0,1,0,4,8,1,SAC,SAC,CLE,132,17.5,Pts+Rebs+Asts,12,9,7,8
Harrison Barnes,F,22023,203084,22300191,"NOV 13, 2023",SAC vs. CLE,W,22,2,4,0.5,0,2,0.0,0,0,0.0,2,3,5,3,0,0,1,0,4,8,1,SAC,SAC,CLE,132,20.5,Fantasy Score,12,9,7,8
Harrison Barnes,F,22023,203084,22300191,"NOV 13, 2023",SAC vs. CLE,W,22,2,4,0.5,0,2,0.0,0,0,0.0,2,3,5,3,0,0,1,0,4,8,1,SAC,SAC,CLE,132,0.5,Offensive Rebounds,12,9,7,8
Harrison Barnes,F,22023,203084,22300191,"NOV 13, 2023",SAC vs. CLE,W,22,2,4,0.5,0,2,0.0,0,0,0.0,2,3,5,3,0,0,1,0,4,8,1,SAC,SAC,CLE,132,4.5,3-PT Attempted,12,9,7,8
Harrison Barnes,F,22023,203084,22300191,"NOV 13, 2023",SAC vs. CLE,W,22,2,4,0.5,0,2,0.0,0,0,0.0,2,3,5,3,0,0,1,0,4,8,1,SAC,SAC,CLE,132,16.5,Pts+Rebs,12,9,7,8
Harrison Barnes,F,22023,203084,22300191,"NOV 13, 2023",SAC vs. CLE,W,22,2,4,0.5,0,2,0.0,0,0,0.0,2,3,5,3,0,0,1,0,4,8,1,SAC,SAC,CLE,132,14.5,Pts+Asts,12,9,7,8
Harrison Barnes,F,22023,203084,22300016,"NOV 10, 2023",SAC vs. OKC,W,26,1,8,0.125,0,4,0.0,2,2,1.0,2,2,4,1,0,0,1,1,4,7,1,SAC,SAC,OKC,105,13.0,Points,9,8,5,5
Harrison Barnes,F,22023,203084,22300016,"NOV 10, 2023",SAC vs. OKC,W,26,1,8,0.125,0,4,0.0,2,2,1.0,2,2,4,1,0,0,1,1,4,7,1,SAC,SAC,OKC,105,17.5,Pts+Rebs+Asts,9,8,5,5
Harrison Barnes,F,22023,203084,22300016,"NOV 10, 2023",SAC vs. OKC,W,26,1,8,0.125,0,4,0.0,2,2,1.0,2,2,4,1,0,0,1,1,4,7,1,SAC,SAC,OKC,105,20.5,Fantasy Score,9,8,5,5
Harrison Barnes,F,22023,203084,22300016,"NOV 10, 2023",SAC vs. OKC,W,26,1,8,0.125,0,4,0.0,2,2,1.0,2,2,4,1,0,0,1,1,4,7,1,SAC,SAC,OKC,105,0.5,Offensive Rebounds,9,8,5,5
Harrison Barnes,F,22023,203084,22300016,"NOV 10, 2023",SAC vs. OKC,W,26,1,8,0.125,0,4,0.0,2,2,1.0,2,2,4,1,0,0,1,1,4,7,1,SAC,SAC,OKC,105,4.5,3-PT Attempted,9,8,5,5
Harrison Barnes,F,22023,203084,22300016,"NOV 10, 2023",SAC vs. OKC,W,26,1,8,0.125,0,4,0.0,2,2,1.0,2,2,4,1,0,0,1,1,4,7,1,SAC,SAC,OKC,105,16.5,Pts+Rebs,9,8,5,5
Harrison Barnes,F,22023,203084,22300016,"NOV 10, 2023",SAC vs. OKC,W,26,1,8,0.125,0,4,0.0,2,2,1.0,2,2,4,1,0,0,1,1,4,7,1,SAC,SAC,OKC,105,14.5,Pts+Asts,9,8,5,5
Harrison Barnes,F,22023,203084,22300170,"NOV 08, 2023",SAC vs. POR,W,36,5,8,0.625,2,5,0.4,0,0,0.0,1,4,5,0,1,0,1,3,12,-1,1,SAC,SAC,POR,121,13.0,Points,17,17,12,5
Harrison Barnes,F,22023,203084,22300170,"NOV 08, 2023",SAC vs. POR,W,36,5,8,0.625,2,5,0.4,0,0,0.0,1,4,5,0,1,0,1,3,12,-1,1,SAC,SAC,POR,121,17.5,Pts+Rebs+Asts,17,17,12,5
Harrison Barnes,F,22023,203084,22300170,"NOV 08, 2023",SAC vs. POR,W,36,5,8,0.625,2,5,0.4,0,0,0.0,1,4,5,0,1,0,1,3,12,-1,1,SAC,SAC,POR,121,20.5,Fantasy Score,17,17,12,5
Harrison Barnes,F,22023,203084,22300170,"NOV 08, 2023",SAC vs. POR,W,36,5,8,0.625,2,5,0.4,0,0,0.0,1,4,5,0,1,0,1,3,12,-1,1,SAC,SAC,POR,121,0.5,Offensive Rebounds,17,17,12,5
Harrison Barnes,F,22023,203084,22300170,"NOV 08, 2023",SAC vs. POR,W,36,5,8,0.625,2,5,0.4,0,0,0.0,1,4,5,0,1,0,1,3,12,-1,1,SAC,SAC,POR,121,4.5,3-PT Attempted,17,17,12,5
Harrison Barnes,F,22023,203084,22300170,"NOV 08, 2023",SAC vs. POR,W,36,5,8,0.625,2,5,0.4,0,0,0.0,1,4,5,0,1,0,1,3,12,-1,1,SAC,SAC,POR,121,16.5,Pts+Rebs,17,17,12,5
Harrison Barnes,F,22023,203084,22300170,"NOV 08, 2023",SAC vs. POR,W,36,5,8,0.625,2,5,0.4,0,0,0.0,1,4,5,0,1,0,1,3,12,-1,1,SAC,SAC,POR,121,14.5,Pts+Asts,17,17,12,5
Harrison Barnes,F,22023,203084,22300153,"NOV 06, 2023",SAC @ HOU,L,22,1,6,0.167,0,4,0.0,1,2,0.5,0,0,0,1,0,0,0,0,3,-21,1,SAC,HOU,SAC,97,13.0,Points,4,3,4,1
Harrison Barnes,F,22023,203084,22300153,"NOV 06, 2023",SAC @ HOU,L,22,1,6,0.167,0,4,0.0,1,2,0.5,0,0,0,1,0,0,0,0,3,-21,1,SAC,HOU,SAC,97,17.5,Pts+Rebs+Asts,4,3,4,1
Harrison Barnes,F,22023,203084,22300153,"NOV 06, 2023",SAC @ HOU,L,22,1,6,0.167,0,4,0.0,1,2,0.5,0,0,0,1,0,0,0,0,3,-21,1,SAC,HOU,SAC,97,20.5,Fantasy Score,4,3,4,1
Harrison Barnes,F,22023,203084,22300153,"NOV 06, 2023",SAC @ HOU,L,22,1,6,0.167,0,4,0.0,1,2,0.5,0,0,0,1,0,0,0,0,3,-21,1,SAC,HOU,SAC,97,0.5,Offensive Rebounds,4,3,4,1
Harrison Barnes,F,22023,203084,22300153,"NOV 06, 2023",SAC @ HOU,L,22,1,6,0.167,0,4,0.0,1,2,0.5,0,0,0,1,0,0,0,0,3,-21,1,SAC,HOU,SAC,97,4.5,3-PT Attempted,4,3,4,1
Harrison Barnes,F,22023,203084,22300153,"NOV 06, 2023",SAC @ HOU,L,22,1,6,0.167,0,4,0.0,1,2,0.5,0,0,0,1,0,0,0,0,3,-21,1,SAC,HOU,SAC,97,16.5,Pts+Rebs,4,3,4,1
Harrison Barnes,F,22023,203084,22300153,"NOV 06, 2023",SAC @ HOU,L,22,1,6,0.167,0,4,0.0,1,2,0.5,0,0,0,1,0,0,0,0,3,-21,1,SAC,HOU,SAC,97,14.5,Pts+Asts,4,3,4,1
Harrison Barnes,F,22023,203084,22300137,"NOV 04, 2023",SAC @ HOU,L,32,3,7,0.429,3,4,0.75,4,5,0.8,0,3,3,0,0,0,0,0,13,-19,1,SAC,HOU,SAC,89,13.0,Points,16,16,13,3
Harrison Barnes,F,22023,203084,22300137,"NOV 04, 2023",SAC @ HOU,L,32,3,7,0.429,3,4,0.75,4,5,0.8,0,3,3,0,0,0,0,0,13,-19,1,SAC,HOU,SAC,89,17.5,Pts+Rebs+Asts,16,16,13,3
Harrison Barnes,F,22023,203084,22300137,"NOV 04, 2023",SAC @ HOU,L,32,3,7,0.429,3,4,0.75,4,5,0.8,0,3,3,0,0,0,0,0,13,-19,1,SAC,HOU,SAC,89,20.5,Fantasy Score,16,16,13,3
Harrison Barnes,F,22023,203084,22300137,"NOV 04, 2023",SAC @ HOU,L,32,3,7,0.429,3,4,0.75,4,5,0.8,0,3,3,0,0,0,0,0,13,-19,1,SAC,HOU,SAC,89,0.5,Offensive Rebounds,16,16,13,3
Harrison Barnes,F,22023,203084,22300137,"NOV 04, 2023",SAC @ HOU,L,32,3,7,0.429,3,4,0.75,4,5,0.8,0,3,3,0,0,0,0,0,13,-19,1,SAC,HOU,SAC,89,4.5,3-PT Attempted,16,16,13,3
Harrison Barnes,F,22023,203084,22300137,"NOV 04, 2023",SAC @ HOU,L,32,3,7,0.429,3,4,0.75,4,5,0.8,0,3,3,0,0,0,0,0,13,-19,1,SAC,HOU,SAC,89,16.5,Pts+Rebs,16,16,13,3
Harrison Barnes,F,22023,203084,22300137,"NOV 04, 2023",SAC @ HOU,L,32,3,7,0.429,3,4,0.75,4,5,0.8,0,3,3,0,0,0,0,0,13,-19,1,SAC,HOU,SAC,89,14.5,Pts+Asts,16,16,13,3
Harrison Barnes,F,22023,203084,22300126,"NOV 01, 2023",SAC @ GSW,L,31,4,8,0.5,4,7,0.571,2,2,1.0,1,0,1,1,1,0,1,0,14,2,1,SAC,GSW,SAC,101,13.0,Points,16,15,15,2
Harrison Barnes,F,22023,203084,22300126,"NOV 01, 2023",SAC @ GSW,L,31,4,8,0.5,4,7,0.571,2,2,1.0,1,0,1,1,1,0,1,0,14,2,1,SAC,GSW,SAC,101,17.5,Pts+Rebs+Asts,16,15,15,2
Harrison Barnes,F,22023,203084,22300126,"NOV 01, 2023",SAC @ GSW,L,31,4,8,0.5,4,7,0.571,2,2,1.0,1,0,1,1,1,0,1,0,14,2,1,SAC,GSW,SAC,101,20.5,Fantasy Score,16,15,15,2
Harrison Barnes,F,22023,203084,22300126,"NOV 01, 2023",SAC @ GSW,L,31,4,8,0.5,4,7,0.571,2,2,1.0,1,0,1,1,1,0,1,0,14,2,1,SAC,GSW,SAC,101,0.5,Offensive Rebounds,16,15,15,2
Harrison Barnes,F,22023,203084,22300126,"NOV 01, 2023",SAC @ GSW,L,31,4,8,0.5,4,7,0.571,2,2,1.0,1,0,1,1,1,0,1,0,14,2,1,SAC,GSW,SAC,101,4.5,3-PT Attempted,16,15,15,2
Harrison Barnes,F,22023,203084,22300126,"NOV 01, 2023",SAC @ GSW,L,31,4,8,0.5,4,7,0.571,2,2,1.0,1,0,1,1,1,0,1,0,14,2,1,SAC,GSW,SAC,101,16.5,Pts+Rebs,16,15,15,2
Harrison Barnes,F,22023,203084,22300126,"NOV 01, 2023",SAC @ GSW,L,31,4,8,0.5,4,7,0.571,2,2,1.0,1,0,1,1,1,0,1,0,14,2,1,SAC,GSW,SAC,101,14.5,Pts+Asts,16,15,15,2
Harrison Barnes,F,22023,203084,22300100,"OCT 29, 2023",SAC vs. LAL,W,39,3,9,0.333,0,4,0.0,2,2,1.0,0,2,2,2,0,1,0,1,8,-4,1,SAC,SAC,LAL,132,13.0,Points,12,10,10,4
Harrison Barnes,F,22023,203084,22300100,"OCT 29, 2023",SAC vs. LAL,W,39,3,9,0.333,0,4,0.0,2,2,1.0,0,2,2,2,0,1,0,1,8,-4,1,SAC,SAC,LAL,132,17.5,Pts+Rebs+Asts,12,10,10,4
Harrison Barnes,F,22023,203084,22300100,"OCT 29, 2023",SAC vs. LAL,W,39,3,9,0.333,0,4,0.0,2,2,1.0,0,2,2,2,0,1,0,1,8,-4,1,SAC,SAC,LAL,132,20.5,Fantasy Score,12,10,10,4
Harrison Barnes,F,22023,203084,22300100,"OCT 29, 2023",SAC vs. LAL,W,39,3,9,0.333,0,4,0.0,2,2,1.0,0,2,2,2,0,1,0,1,8,-4,1,SAC,SAC,LAL,132,0.5,Offensive Rebounds,12,10,10,4
Harrison Barnes,F,22023,203084,22300100,"OCT 29, 2023",SAC vs. LAL,W,39,3,9,0.333,0,4,0.0,2,2,1.0,0,2,2,2,0,1,0,1,8,-4,1,SAC,SAC,LAL,132,4.5,3-PT Attempted,12,10,10,4
Harrison Barnes,F,22023,203084,22300100,"OCT 29, 2023",SAC vs. LAL,W,39,3,9,0.333,0,4,0.0,2,2,1.0,0,2,2,2,0,1,0,1,8,-4,1,SAC,SAC,LAL,132,16.5,Pts+Rebs,12,10,10,4
Harrison Barnes,F,22023,203084,22300100,"OCT 29, 2023",SAC vs. LAL,W,39,3,9,0.333,0,4,0.0,2,2,1.0,0,2,2,2,0,1,0,1,8,-4,1,SAC,SAC,LAL,132,14.5,Pts+Asts,12,10,10,4
Harrison Barnes,F,22023,203084,22300087,"OCT 27, 2023",SAC vs. GSW,L,30,4,5,0.8,1,2,0.5,1,4,0.25,1,3,4,1,1,0,0,1,10,-9,1,SAC,SAC,GSW,114,13.0,Points,15,14,11,5
Harrison Barnes,F,22023,203084,22300087,"OCT 27, 2023",SAC vs. GSW,L,30,4,5,0.8,1,2,0.5,1,4,0.25,1,3,4,1,1,0,0,1,10,-9,1,SAC,SAC,GSW,114,17.5,Pts+Rebs+Asts,15,14,11,5
Harrison Barnes,F,22023,203084,22300087,"OCT 27, 2023",SAC vs. GSW,L,30,4,5,0.8,1,2,0.5,1,4,0.25,1,3,4,1,1,0,0,1,10,-9,1,SAC,SAC,GSW,114,20.5,Fantasy Score,15,14,11,5
Harrison Barnes,F,22023,203084,22300087,"OCT 27, 2023",SAC vs. GSW,L,30,4,5,0.8,1,2,0.5,1,4,0.25,1,3,4,1,1,0,0,1,10,-9,1,SAC,SAC,GSW,114,0.5,Offensive Rebounds,15,14,11,5
Harrison Barnes,F,22023,203084,22300087,"OCT 27, 2023",SAC vs. GSW,L,30,4,5,0.8,1,2,0.5,1,4,0.25,1,3,4,1,1,0,0,1,10,-9,1,SAC,SAC,GSW,114,4.5,3-PT Attempted,15,14,11,5
Harrison Barnes,F,22023,203084,22300087,"OCT 27, 2023",SAC vs. GSW,L,30,4,5,0.8,1,2,0.5,1,4,0.25,1,3,4,1,1,0,0,1,10,-9,1,SAC,SAC,GSW,114,16.5,Pts+Rebs,15,14,11,5
Harrison Barnes,F,22023,203084,22300087,"OCT 27, 2023",SAC vs. GSW,L,30,4,5,0.8,1,2,0.5,1,4,0.25,1,3,4,1,1,0,0,1,10,-9,1,SAC,SAC,GSW,114,14.5,Pts+Asts,15,14,11,5
Harrison Barnes,F,22023,203084,22300072,"OCT 25, 2023",SAC @ UTA,W,33,11,16,0.688,5,7,0.714,6,6,1.0,0,4,4,2,1,0,1,2,33,10,1,SAC,UTA,SAC,130,13.0,Points,39,37,35,6
Harrison Barnes,F,22023,203084,22300072,"OCT 25, 2023",SAC @ UTA,W,33,11,16,0.688,5,7,0.714,6,6,1.0,0,4,4,2,1,0,1,2,33,10,1,SAC,UTA,SAC,130,17.5,Pts+Rebs+Asts,39,37,35,6
Harrison Barnes,F,22023,203084,22300072,"OCT 25, 2023",SAC @ UTA,W,33,11,16,0.688,5,7,0.714,6,6,1.0,0,4,4,2,1,0,1,2,33,10,1,SAC,UTA,SAC,130,20.5,Fantasy Score,39,37,35,6
Harrison Barnes,F,22023,203084,22300072,"OCT 25, 2023",SAC @ UTA,W,33,11,16,0.688,5,7,0.714,6,6,1.0,0,4,4,2,1,0,1,2,33,10,1,SAC,UTA,SAC,130,0.5,Offensive Rebounds,39,37,35,6
Harrison Barnes,F,22023,203084,22300072,"OCT 25, 2023",SAC @ UTA,W,33,11,16,0.688,5,7,0.714,6,6,1.0,0,4,4,2,1,0,1,2,33,10,1,SAC,UTA,SAC,130,4.5,3-PT Attempted,39,37,35,6
Harrison Barnes,F,22023,203084,22300072,"OCT 25, 2023",SAC @ UTA,W,33,11,16,0.688,5,7,0.714,6,6,1.0,0,4,4,2,1,0,1,2,33,10,1,SAC,UTA,SAC,130,16.5,Pts+Rebs,39,37,35,6
Harrison Barnes,F,22023,203084,22300072,"OCT 25, 2023",SAC @ UTA,W,33,11,16,0.688,5,7,0.714,6,6,1.0,0,4,4,2,1,0,1,2,33,10,1,SAC,UTA,SAC,130,14.5,Pts+Asts,39,37,35,6
Jusuf Nurkic,C,22023,203994,22300757,"FEB 10, 2024",PHX @ GSW,L,26,3,7,0.429,0,1,0.0,0,0,0.0,1,5,6,4,0,1,2,3,6,-4,1,PHX,GSW,PHX,112,,,16,12,10,10
Jusuf Nurkic,C,22023,203994,22300739,"FEB 08, 2024",PHX vs. UTA,W,28,7,11,0.636,0,2,0.0,2,5,0.4,1,7,8,3,1,0,2,5,16,8,1,PHX,PHX,UTA,129,,,27,24,19,11
Jusuf Nurkic,C,22023,203994,22300725,"FEB 06, 2024",PHX vs. MIL,W,32,5,9,0.556,0,1,0.0,0,1,0.0,5,5,10,4,2,0,2,4,10,10,1,PHX,PHX,MIL,114,,,24,20,14,14
Jusuf Nurkic,C,22023,203994,22300705,"FEB 04, 2024",PHX @ WAS,W,25,7,11,0.636,0,1,0.0,4,6,0.667,4,9,13,8,1,0,1,3,18,20,1,PHX,WAS,PHX,140,,,39,31,26,21
Jusuf Nurkic,C,22023,203994,22300690,"FEB 02, 2024",PHX @ ATL,L,23,7,9,0.778,0,0,0.0,0,1,0.0,1,8,9,3,1,1,1,2,14,-3,1,PHX,ATL,PHX,120,,,26,23,17,12
Jusuf Nurkic,C,22023,203994,22300661,"JAN 29, 2024",PHX @ MIA,W,27,3,5,0.6,0,1,0.0,0,1,0.0,0,8,8,2,2,0,1,6,6,-11,1,PHX,MIA,PHX,118,,,16,14,8,10
Jusuf Nurkic,C,22023,203994,22300636,"JAN 26, 2024",PHX @ IND,L,20,1,3,0.333,0,0,0.0,0,0,0.0,0,4,4,5,3,0,2,2,2,-3,1,PHX,IND,PHX,131,,,11,6,7,9
Jusuf Nurkic,C,22023,203994,22300625,"JAN 24, 2024",PHX @ DAL,W,21,3,5,0.6,0,1,0.0,2,2,1.0,3,2,5,3,2,0,4,4,8,23,1,PHX,DAL,PHX,132,,,16,13,11,8
Jusuf Nurkic,C,22023,203994,22300612,"JAN 22, 2024",PHX vs. CHI,W,26,4,7,0.571,0,0,0.0,0,0,0.0,1,6,7,4,0,2,1,3,8,-15,1,PHX,PHX,CHI,115,,,19,15,12,11
Jusuf Nurkic,C,22023,203994,22300604,"JAN 21, 2024",PHX vs. IND,W,19,2,2,1.0,0,0,0.0,0,0,0.0,0,13,13,4,0,1,6,6,4,11,1,PHX,PHX,IND,117,,,21,17,8,17
Jusuf Nurkic,C,22023,203994,22300588,"JAN 19, 2024",PHX @ NOP,W,35,2,5,0.4,0,0,0.0,1,2,0.5,1,14,15,9,1,0,3,3,5,30,1,PHX,NOP,PHX,123,,,29,20,14,24
Jusuf Nurkic,C,22023,203994,22300567,"JAN 16, 2024",PHX vs. SAC,W,27,4,5,0.8,0,0,0.0,2,2,1.0,3,12,15,3,0,1,1,3,10,-8,1,PHX,PHX,SAC,119,,,28,25,13,18
Jusuf Nurkic,C,22023,203994,22300554,"JAN 14, 2024",PHX @ POR,W,27,5,8,0.625,0,0,0.0,4,6,0.667,4,9,13,1,3,1,1,3,14,18,1,PHX,POR,PHX,127,,,28,27,15,14
Jusuf Nurkic,C,22023,203994,22300531,"JAN 11, 2024",PHX @ LAL,W,28,3,6,0.5,0,0,0.0,3,4,0.75,4,8,12,2,1,0,2,2,9,29,1,PHX,LAL,PHX,127,,,23,21,11,14
Jusuf Nurkic,C,22023,203994,22300511,"JAN 08, 2024",PHX @ LAC,L,21,3,8,0.375,1,2,0.5,1,2,0.5,1,2,3,2,1,0,0,1,8,-14,1,PHX,LAC,PHX,111,,,13,11,10,5
Jusuf Nurkic,C,22023,203994,22300503,"JAN 07, 2024",PHX vs. MEM,L,32,8,17,0.471,1,2,0.5,1,3,0.333,6,13,19,5,0,1,2,4,18,2,1,PHX,PHX,MEM,115,,,42,37,23,24
Jusuf Nurkic,C,22023,203994,22300489,"JAN 05, 2024",PHX vs. MIA,W,26,3,6,0.5,0,1,0.0,0,0,0.0,1,8,9,2,1,0,0,2,6,21,1,PHX,PHX,MIA,113,,,17,15,8,11
Jusuf Nurkic,C,22023,203994,22300473,"JAN 03, 2024",PHX vs. LAC,L,25,3,5,0.6,0,1,0.0,3,3,1.0,1,5,6,1,1,0,1,3,9,-15,1,PHX,PHX,LAC,122,,,16,15,10,7
Jusuf Nurkic,C,22023,203994,22300456,"JAN 01, 2024",PHX vs. POR,W,25,6,8,0.75,1,2,0.5,5,6,0.833,1,6,7,5,1,2,2,3,18,17,1,PHX,PHX,POR,109,,,30,25,23,12
Jusuf Nurkic,C,22023,203994,22300450,"DEC 31, 2023",PHX vs. ORL,W,33,8,17,0.471,0,3,0.0,3,5,0.6,3,10,13,3,0,0,1,3,19,18,1,PHX,PHX,ORL,112,,,35,32,22,16
Jusuf Nurkic,C,22023,203994,22300436,"DEC 29, 2023",PHX vs. CHA,W,28,10,13,0.769,0,1,0.0,4,4,1.0,3,12,15,1,0,2,3,1,24,9,1,PHX,PHX,CHA,133,,,40,39,25,16
Jusuf Nurkic,C,22023,203994,22300418,"DEC 27, 2023",PHX @ HOU,W,14,3,6,0.5,1,1,1.0,1,2,0.5,1,9,10,0,0,2,3,4,8,2,1,PHX,HOU,PHX,129,,,18,18,8,10
Jusuf Nurkic,C,22023,203994,22300363,"DEC 19, 2023",PHX @ POR,L,31,4,11,0.364,0,2,0.0,1,2,0.5,5,8,13,3,2,2,4,3,9,-5,1,PHX,POR,PHX,104,,,25,22,12,16
Jusuf Nurkic,C,22023,203994,22300347,"DEC 17, 2023",PHX vs. WAS,W,30,2,7,0.286,0,1,0.0,2,4,0.5,3,14,17,5,1,1,2,5,6,-6,1,PHX,PHX,WAS,112,,,28,23,11,22
Jusuf Nurkic,C,22023,203994,22300333,"DEC 15, 2023",PHX vs. NYK,L,30,9,13,0.692,1,2,0.5,2,2,1.0,4,8,12,2,1,0,3,2,21,5,1,PHX,PHX,NYK,122,,,35,33,23,14
Jusuf Nurkic,C,22023,203994,22301203,"DEC 05, 2023",PHX @ LAL,L,29,1,3,0.333,0,0,0.0,1,4,0.25,0,8,8,4,1,0,2,4,3,12,1,PHX,LAL,PHX,103,,,15,11,7,12
Jusuf Nurkic,C,22023,203994,22300288,"DEC 02, 2023",PHX vs. MEM,W,26,6,18,0.333,0,3,0.0,2,2,1.0,3,6,9,3,2,1,3,6,14,10,1,PHX,PHX,MEM,116,,,26,23,17,12
Jusuf Nurkic,C,22023,203994,22300279,"DEC 01, 2023",PHX vs. DEN,L,33,13,22,0.591,2,6,0.333,3,5,0.6,3,3,6,2,0,2,6,6,31,3,1,PHX,PHX,DEN,111,,,39,37,33,8
Jusuf Nurkic,C,22023,203994,22300044,"NOV 24, 2023",PHX @ MEM,W,33,2,5,0.4,0,2,0.0,2,4,0.5,2,9,11,6,2,2,2,2,6,14,1,PHX,MEM,PHX,110,,,23,17,12,17
Jusuf Nurkic,C,22023,203994,22300236,"NOV 22, 2023",PHX vs. GSW,W,17,4,8,0.5,0,1,0.0,1,2,0.5,3,2,5,0,0,0,0,4,9,11,1,PHX,PHX,GSW,123,,,14,14,9,5
Jusuf Nurkic,C,22023,203994,22300041,"NOV 21, 2023",PHX vs. POR,W,29,7,11,0.636,2,4,0.5,2,2,1.0,6,6,12,0,1,4,3,4,18,17,1,PHX,PHX,POR,120,,,30,30,18,12
Jusuf Nurkic,C,22023,203994,22300214,"NOV 19, 2023",PHX @ UTA,W,35,7,11,0.636,0,0,0.0,4,4,1.0,4,8,12,2,1,2,2,5,18,9,1,PHX,UTA,PHX,140,,,32,30,20,14
Jusuf Nurkic,C,22023,203994,22300035,"NOV 17, 2023",PHX @ UTA,W,23,4,7,0.571,0,1,0.0,7,7,1.0,2,5,7,4,1,0,4,4,15,-2,1,PHX,UTA,PHX,131,,,26,22,19,11
Jusuf Nurkic,C,22023,203994,22300197,"NOV 15, 2023",PHX vs. MIN,W,24,1,3,0.333,1,1,1.0,0,0,0.0,1,4,5,4,0,0,0,3,3,10,1,PHX,PHX,MIN,133,,,12,8,7,9
Jusuf Nurkic,C,22023,203994,22300185,"NOV 12, 2023",PHX vs. OKC,L,26,1,6,0.167,0,3,0.0,1,2,0.5,3,5,8,1,1,2,2,3,3,-15,1,PHX,PHX,OKC,99,,,12,11,4,9
Jusuf Nurkic,C,22023,203994,22300015,"NOV 10, 2023",PHX vs. LAL,L,33,4,8,0.5,2,3,0.667,4,7,0.571,3,6,9,7,1,0,2,3,14,5,1,PHX,PHX,LAL,119,,,30,23,21,16
Jusuf Nurkic,C,22023,203994,22300162,"NOV 08, 2023",PHX @ CHI,W,38,8,16,0.5,0,2,0.0,4,6,0.667,8,9,17,8,2,0,6,4,20,12,1,PHX,CHI,PHX,116,,,45,37,28,25
Jusuf Nurkic,C,22023,203994,22300140,"NOV 05, 2023",PHX @ DET,W,28,1,4,0.25,0,1,0.0,4,6,0.667,3,1,4,7,2,3,2,2,6,13,1,PHX,DET,PHX,120,,,17,10,13,11
Jusuf Nurkic,C,22023,203994,22300132,"NOV 04, 2023",PHX @ PHI,L,23,4,14,0.286,1,6,0.167,2,4,0.5,3,6,9,5,1,1,0,2,11,-3,1,PHX,PHI,PHX,100,,,25,20,16,14
Jusuf Nurkic,C,22023,203994,22300131,"NOV 02, 2023",PHX vs. SAS,L,19,2,5,0.4,1,3,0.333,2,2,1.0,1,2,3,2,1,0,2,3,7,-5,1,PHX,PHX,SAS,121,,,12,10,9,5
Jusuf Nurkic,C,22023,203994,22300113,"OCT 31, 2023",PHX vs. SAS,L,30,4,10,0.4,2,5,0.4,2,2,1.0,0,12,12,4,1,2,0,4,12,-8,1,PHX,PHX,SAS,114,,,28,24,16,16
Jusuf Nurkic,C,22023,203994,22300094,"OCT 28, 2023",PHX vs. UTA,W,23,3,8,0.375,0,2,0.0,4,6,0.667,2,5,7,6,2,1,2,3,10,15,1,PHX,PHX,UTA,126,,,23,17,16,13
Jusuf Nurkic,C,22023,203994,22300076,"OCT 26, 2023",PHX @ LAL,L,28,1,5,0.2,0,2,0.0,2,2,1.0,3,6,9,3,3,0,4,5,4,-3,1,PHX,LAL,PHX,95,,,16,13,7,12
Jusuf Nurkic,C,22023,203994,22300062,"OCT 24, 2023",PHX @ GSW,W,28,5,8,0.625,1,2,0.5,3,3,1.0,3,11,14,3,0,1,1,5,14,2,1,PHX,GSW,PHX,108,,,31,28,17,17
Jusuf Nurkic,C,22023,203994,22300677,"JAN 31, 2024",PHX @ BKN,W,30,11,15,0.733,0,0,0.0,6,9,0.667,5,6,11,6,1,2,6,2,28,16,1,PHX,BKN,PHX,136,,,45,39,34,17
Jusuf Nurkic,C,22023,203994,22300317,"DEC 13, 2023",PHX vs. BKN,L,31,7,15,0.467,0,2,0.0,1,2,0.5,6,16,22,3,0,2,0,3,15,15,1,PHX,PHX,BKN,112,,,40,37,18,25
Jusuf Nurkic,C,22023,203994,22300308,"DEC 12, 2023",PHX vs. GSW,W,31,3,9,0.333,1,3,0.333,10,11,0.909,3,10,13,7,1,0,1,3,17,10,1,PHX,PHX,GSW,119,,,37,30,24,20
Jusuf Nurkic,C,22023,203994,22301228,"DEC 08, 2023",PHX vs. SAC,L,30,6,13,0.462,2,4,0.5,1,4,0.25,1,8,9,3,1,0,0,3,15,2,1,PHX,PHX,SAC,106,,,27,24,18,12
Jusuf Nurkic,C,22023,203994,22300260,"NOV 29, 2023",PHX @ TOR,L,30,8,12,0.667,1,1,1.0,2,2,1.0,1,13,14,6,0,2,2,3,19,2,1,PHX,TOR,PHX,105,,,39,33,25,20
Jusuf Nurkic,C,22023,203994,22300247,"NOV 26, 2023",PHX @ NYK,W,33,4,9,0.444,0,2,0.0,0,0,0.0,4,6,10,4,0,4,1,2,8,1,1,PHX,NYK,PHX,116,,,22,18,12,14
De'Anthony Melton,G,22023,1629001,22300532,"JAN 12, 2024",PHI vs. SAC,W,25,2,9,0.222,2,8,0.25,0,0,0.0,1,3,4,3,1,0,1,3,6,9,1,PHI,PHI,SAC,112,,,13,10,9,7
De'Anthony Melton,G,22023,1629001,22300521,"JAN 10, 2024",PHI @ ATL,L,21,3,7,0.429,2,4,0.5,2,2,1.0,1,2,3,2,0,0,1,0,10,1,1,PHI,ATL,PHI,132,,,15,13,12,5
De'Anthony Melton,G,22023,1629001,22300442,"DEC 30, 2023",PHI @ CHI,L,26,3,9,0.333,3,9,0.333,0,0,0.0,0,3,3,0,4,0,0,4,9,-17,1,PHI,CHI,PHI,92,,,12,12,9,3
De'Anthony Melton,G,22023,1629001,22300434,"DEC 29, 2023",PHI @ HOU,W,36,5,12,0.417,2,7,0.286,3,4,0.75,0,3,3,2,1,0,2,1,15,3,1,PHI,HOU,PHI,131,,,20,18,17,5
De'Anthony Melton,G,22023,1629001,22300415,"DEC 27, 2023",PHI @ ORL,W,37,8,13,0.615,4,7,0.571,2,2,1.0,1,4,5,1,2,0,1,3,22,24,1,PHI,ORL,PHI,112,,,28,27,23,6
De'Anthony Melton,G,22023,1629001,22300404,"DEC 25, 2023",PHI @ MIA,L,37,5,17,0.294,2,9,0.222,3,3,1.0,2,5,7,5,4,1,0,2,15,12,1,PHI,MIA,PHI,113,,,27,22,20,12
De'Anthony Melton,G,22023,1629001,22300367,"DEC 20, 2023",PHI vs. MIN,W,16,1,2,0.5,0,1,0.0,2,2,1.0,0,3,3,2,0,0,1,1,4,7,1,PHI,PHI,MIN,127,,,9,7,6,5
De'Anthony Melton,G,22023,1629001,22300335,"DEC 16, 2023",PHI @ CHA,W,25,2,6,0.333,2,6,0.333,0,0,0.0,0,2,2,2,4,0,1,2,6,20,1,PHI,CHA,PHI,135,,,10,8,8,4
De'Anthony Melton,G,22023,1629001,22300327,"DEC 15, 2023",PHI vs. DET,W,23,1,6,0.167,0,3,0.0,2,2,1.0,2,1,3,1,1,1,0,4,4,24,1,PHI,PHI,DET,124,,,8,7,5,4
De'Anthony Melton,G,22023,1629001,22300310,"DEC 13, 2023",PHI @ DET,W,21,4,9,0.444,2,4,0.5,0,0,0.0,1,5,6,1,1,2,0,4,10,18,1,PHI,DET,PHI,129,,,17,16,11,7
De'Anthony Melton,G,22023,1629001,22300295,"DEC 11, 2023",PHI vs. WAS,W,27,2,11,0.182,1,7,0.143,0,0,0.0,1,1,2,5,5,0,2,3,5,17,1,PHI,PHI,WAS,146,,,12,7,10,7
De'Anthony Melton,G,22023,1629001,22301218,"DEC 08, 2023",PHI vs. ATL,W,34,6,13,0.462,2,7,0.286,1,2,0.5,0,6,6,5,1,1,1,0,15,25,1,PHI,PHI,ATL,125,,,26,21,20,11
De'Anthony Melton,G,22023,1629001,22300275,"DEC 01, 2023",PHI @ BOS,L,37,7,19,0.368,4,12,0.333,3,4,0.75,1,3,4,2,1,1,4,6,21,-3,1,PHI,BOS,PHI,119,,,27,25,23,6
De'Anthony Melton,G,22023,1629001,22300262,"NOV 29, 2023",PHI @ NOP,L,30,5,14,0.357,4,10,0.4,3,4,0.75,0,3,3,6,3,1,4,2,17,-17,1,PHI,NOP,PHI,114,,,26,20,23,9
De'Anthony Melton,G,22023,1629001,22300255,"NOV 27, 2023",PHI vs. LAL,W,25,3,6,0.5,3,6,0.5,0,0,0.0,0,0,0,2,1,0,0,2,9,11,1,PHI,PHI,LAL,138,,,11,9,11,2
De'Anthony Melton,G,22023,1629001,22300232,"NOV 22, 2023",PHI @ MIN,L,30,3,11,0.273,1,5,0.2,9,9,1.0,1,5,6,3,0,1,1,2,16,-6,1,PHI,MIN,PHI,99,,,25,22,19,9
De'Anthony Melton,G,22023,1629001,22300208,"NOV 19, 2023",PHI @ BKN,W,27,8,10,0.8,4,6,0.667,1,1,1.0,0,5,5,1,3,0,1,3,21,23,1,PHI,BKN,PHI,121,,,27,26,22,6
De'Anthony Melton,G,22023,1629001,22300148,"NOV 06, 2023",PHI vs. WAS,W,26,5,10,0.5,4,5,0.8,0,0,0.0,0,3,3,4,1,0,1,1,14,1,1,PHI,PHI,WAS,146,,,21,17,18,7
De'Anthony Melton,G,22023,1629001,22300132,"NOV 04, 2023",PHI vs. PHX,W,25,3,10,0.3,2,7,0.286,0,2,0.0,2,0,2,4,1,1,2,3,8,0,1,PHI,PHI,PHX,112,,,14,10,12,6
De'Anthony Melton,G,22023,1629001,22300128,"NOV 02, 2023",PHI vs. TOR,W,21,1,6,0.167,1,3,0.333,1,2,0.5,0,5,5,5,1,0,1,4,4,10,1,PHI,PHI,TOR,114,,,14,9,9,10
De'Anthony Melton,G,22023,1629001,22300098,"OCT 29, 2023",PHI vs. POR,W,31,4,9,0.444,1,2,0.5,3,3,1.0,0,2,2,8,2,0,1,2,12,27,1,PHI,PHI,POR,126,,,22,14,20,10
De'Anthony Melton,G,22023,1629001,22300351,"DEC 18, 2023",PHI vs. CHI,L,29,3,5,0.6,0,1,0.0,0,0,0.0,2,2,4,2,3,1,0,0,6,8,1,PHI,PHI,CHI,104,,,12,10,8,6
De'Anthony Melton,G,22023,1629001,22301208,"DEC 06, 2023",PHI @ WAS,W,27,5,10,0.5,2,5,0.4,7,7,1.0,0,5,5,4,2,1,1,1,19,12,1,PHI,WAS,PHI,131,,,28,24,23,9
De'Anthony Melton,G,22023,1629001,22300239,"NOV 25, 2023",PHI @ OKC,W,30,5,12,0.417,3,8,0.375,1,2,0.5,3,4,7,5,0,1,0,3,14,4,1,PHI,OKC,PHI,127,,,26,21,19,12
De'Anthony Melton,G,22023,1629001,22300040,"NOV 21, 2023",PHI vs. CLE,L,41,5,14,0.357,1,6,0.167,2,3,0.667,4,2,6,3,2,0,1,3,13,1,1,PHI,PHI,CLE,119,,,22,19,16,9
De'Anthony Melton,G,22023,1629001,22300180,"NOV 12, 2023",PHI vs. IND,W,30,4,7,0.571,1,3,0.333,1,1,1.0,1,3,4,6,0,0,2,1,10,-1,1,PHI,PHI,IND,137,,,20,14,16,10
De'Anthony Melton,G,22023,1629001,22300008,"NOV 10, 2023",PHI @ DET,W,30,3,9,0.333,2,6,0.333,2,4,0.5,0,3,3,2,3,1,0,3,10,15,1,PHI,DET,PHI,114,,,15,13,12,5
De'Anthony Melton,G,22023,1629001,22300159,"NOV 08, 2023",PHI vs. BOS,W,29,1,9,0.111,1,7,0.143,0,0,0.0,0,4,4,2,1,0,1,2,3,-3,1,PHI,PHI,BOS,106,,,9,7,5,6
De'Anthony Melton,G,22023,1629001,22300029,"NOV 17, 2023",PHI @ ATL,W,36,5,13,0.385,3,7,0.429,1,2,0.5,1,3,4,5,2,1,3,2,14,12,1,PHI,ATL,PHI,126,,,23,18,19,9
De'Anthony Melton,G,22023,1629001,22300194,"NOV 15, 2023",PHI vs. BOS,L,34,5,10,0.5,5,6,0.833,1,2,0.5,1,6,7,1,0,0,0,3,16,-9,1,PHI,PHI,BOS,107,,,24,23,17,8
De'Anthony Melton,G,22023,1629001,22300019,"NOV 14, 2023",PHI vs. IND,L,35,8,13,0.615,4,6,0.667,10,10,1.0,1,3,4,3,1,0,2,5,30,-9,1,PHI,PHI,IND,126,,,37,34,33,7
De'Anthony Melton,G,22023,1629001,22300092,"OCT 28, 2023",PHI @ TOR,W,32,1,7,0.143,0,4,0.0,0,0,0.0,0,5,5,4,1,1,2,2,2,0,1,PHI,TOR,PHI,114,,,11,7,6,9
De'Anthony Melton,G,22023,1629001,22300075,"OCT 26, 2023",PHI @ MIL,L,25,3,10,0.3,2,6,0.333,2,2,1.0,1,1,2,4,2,0,1,2,10,-4,1,PHI,MIL,PHI,117,,,16,12,14,6
Jeremy Sochan,G,22023,1631110,22300750,"FEB 10, 2024",SAS @ BKN,L,29,4,9,0.444,0,2,0.0,0,0,0.0,1,4,5,3,1,0,0,0,8,-4,1,SAS,BKN,SAS,103,,,16,13,11,8
Jeremy Sochan,G,22023,1631110,22300681,"JAN 31, 2024",SAS vs. ORL,L,33,8,13,0.615,1,3,0.333,1,1,1.0,4,8,12,2,0,2,5,5,18,1,1,SAS,SAS,ORL,98,,,32,30,20,14
Jeremy Sochan,G,22023,1631110,22300665,"JAN 29, 2024",SAS vs. WAS,L,26,1,7,0.143,0,2,0.0,0,0,0.0,2,3,5,1,1,0,0,2,2,-4,1,SAS,SAS,WAS,113,,,8,7,3,6
Jeremy Sochan,G,22023,1631110,22300649,"JAN 27, 2024",SAS vs. MIN,W,31,5,9,0.556,0,1,0.0,3,4,0.75,2,2,4,2,0,1,2,0,13,-3,1,SAS,SAS,MIN,113,,,19,17,15,6
Jeremy Sochan,G,22023,1631110,22300584,"JAN 19, 2024",SAS @ CHA,L,34,5,10,0.5,1,2,0.5,0,1,0.0,2,6,8,8,1,1,3,2,11,-8,1,SAS,CHA,SAS,120,,,27,19,19,16
Jeremy Sochan,G,22023,1631110,22300571,"JAN 17, 2024",SAS @ BOS,L,31,2,9,0.222,1,4,0.25,0,0,0.0,3,4,7,4,3,1,0,2,5,-9,1,SAS,BOS,SAS,95,,,16,12,9,11
Jeremy Sochan,G,22023,1631110,22300559,"JAN 15, 2024",SAS @ ATL,L,38,8,16,0.5,2,4,0.5,5,5,1.0,3,5,8,4,2,2,4,4,23,-4,1,SAS,ATL,SAS,99,,,35,31,27,12
Jeremy Sochan,G,22023,1631110,22300548,"JAN 13, 2024",SAS vs. CHI,L,31,4,15,0.267,2,6,0.333,1,1,1.0,4,3,7,2,0,0,1,3,11,-10,1,SAS,SAS,CHI,116,,,20,18,13,9
Jeremy Sochan,G,22023,1631110,22300541,"JAN 12, 2024",SAS vs. CHA,W,26,5,7,0.714,1,2,0.5,2,3,0.667,0,6,6,4,2,1,1,0,13,35,1,SAS,SAS,CHA,127,,,23,19,17,10
Jeremy Sochan,G,22023,1631110,22300519,"JAN 10, 2024",SAS @ DET,W,28,7,15,0.467,1,2,0.5,0,0,0.0,1,3,4,2,0,0,1,1,15,12,1,SAS,DET,SAS,129,,,21,19,17,6
Jeremy Sochan,G,22023,1631110,22300497,"JAN 07, 2024",SAS @ CLE,L,28,4,9,0.444,2,5,0.4,1,1,1.0,1,4,5,4,0,0,1,2,11,16,1,SAS,CLE,SAS,115,,,20,16,15,9
Jeremy Sochan,G,22023,1631110,22300477,"JAN 04, 2024",SAS vs. MIL,L,33,3,11,0.273,1,5,0.2,2,2,1.0,2,6,8,5,2,1,1,1,9,-14,1,SAS,SAS,MIL,121,,,22,17,14,13
Jeremy Sochan,G,22023,1631110,22300460,"JAN 02, 2024",SAS @ MEM,L,28,4,6,0.667,1,2,0.5,3,4,0.75,0,2,2,1,0,2,1,1,12,1,1,SAS,MEM,SAS,98,,,15,14,13,3
Jeremy Sochan,G,22023,1631110,22300448,"DEC 31, 2023",SAS vs. BOS,L,24,4,11,0.364,1,4,0.25,0,0,0.0,0,3,3,5,0,0,1,1,9,-25,1,SAS,SAS,BOS,101,,,17,12,14,8
Jeremy Sochan,G,22023,1631110,22300437,"DEC 29, 2023",SAS @ POR,L,29,0,3,0.0,0,0,0.0,2,2,1.0,1,3,4,4,1,0,3,2,2,-15,1,SAS,POR,SAS,128,,,10,6,6,8
Jeremy Sochan,G,22023,1631110,22300361,"DEC 19, 2023",SAS @ MIL,L,33,4,11,0.364,0,2,0.0,1,2,0.5,3,8,11,8,1,0,0,3,9,-13,1,SAS,MIL,SAS,119,,,28,20,17,19
Jeremy Sochan,G,22023,1631110,22300278,"DEC 01, 2023",SAS @ NOP,L,31,4,13,0.308,2,4,0.5,3,4,0.75,0,3,3,4,0,0,2,2,13,-9,1,SAS,NOP,SAS,106,,,20,16,17,7
Jeremy Sochan,G,22023,1631110,22300235,"NOV 22, 2023",SAS vs. LAC,L,32,6,15,0.4,2,5,0.4,5,6,0.833,2,3,5,7,0,0,1,3,19,5,1,SAS,SAS,LAC,102,,,31,24,26,12
Jeremy Sochan,G,22023,1631110,22300206,"NOV 18, 2023",SAS vs. MEM,L,32,5,8,0.625,1,2,0.5,5,6,0.833,2,3,5,3,2,0,3,3,16,-6,1,SAS,SAS,MEM,108,,,24,21,19,8
Jeremy Sochan,G,22023,1631110,22300021,"NOV 14, 2023",SAS @ OKC,L,28,4,11,0.364,1,1,1.0,0,0,0.0,1,2,3,5,0,0,3,2,9,-31,1,SAS,OKC,SAS,87,,,17,12,14,8
Jeremy Sochan,G,22023,1631110,22300161,"NOV 08, 2023",SAS @ NYK,L,29,7,12,0.583,2,4,0.5,0,0,0.0,0,6,6,5,0,0,0,5,16,-19,1,SAS,NYK,SAS,105,,,27,22,21,11
Jeremy Sochan,G,22023,1631110,22300146,"NOV 06, 2023",SAS @ IND,L,21,3,9,0.333,0,1,0.0,0,0,0.0,1,2,3,1,0,0,2,2,6,-18,1,SAS,IND,SAS,111,,,10,9,7,4
Jeremy Sochan,G,22023,1631110,22300099,"OCT 29, 2023",SAS @ LAC,L,22,0,2,0.0,0,2,0.0,0,0,0.0,2,2,4,3,1,1,4,3,0,-30,1,SAS,LAC,SAS,83,,,7,4,3,7
Jeremy Sochan,G,22023,1631110,22300272,"NOV 30, 2023",SAS vs. ATL,L,36,12,14,0.857,3,3,1.0,6,6,1.0,3,5,8,6,1,0,5,5,33,-4,1,SAS,SAS,ATL,135,,,47,41,39,14
Jeremy Sochan,G,22023,1631110,22300252,"NOV 26, 2023",SAS @ DEN,L,17,2,6,0.333,0,1,0.0,0,0,0.0,0,2,2,3,0,0,3,0,4,-14,1,SAS,DEN,SAS,120,,,9,6,7,5
Jeremy Sochan,G,22023,1631110,22300051,"NOV 24, 2023",SAS @ GSW,L,33,3,7,0.429,1,2,0.5,0,0,0.0,3,3,6,4,0,0,2,2,7,1,1,SAS,GSW,SAS,112,,,17,13,11,10
Jeremy Sochan,G,22023,1631110,22300223,"NOV 20, 2023",SAS vs. LAC,L,29,3,12,0.25,0,3,0.0,2,2,1.0,2,6,8,1,0,0,1,1,8,-12,1,SAS,SAS,LAC,99,,,17,16,9,9
Jeremy Sochan,G,22023,1631110,22300032,"NOV 17, 2023",SAS vs. SAC,L,37,3,11,0.273,1,3,0.333,1,2,0.5,1,7,8,6,1,0,2,4,8,-3,1,SAS,SAS,SAC,120,,,22,16,14,14
Jeremy Sochan,G,22023,1631110,22300184,"NOV 12, 2023",SAS vs. MIA,L,34,6,9,0.667,2,3,0.667,2,2,1.0,1,4,5,3,0,2,3,4,16,-5,1,SAS,SAS,MIA,113,,,24,21,19,8
Jeremy Sochan,G,22023,1631110,22300013,"NOV 10, 2023",SAS vs. MIN,L,30,6,11,0.545,1,1,1.0,1,2,0.5,3,4,7,5,3,0,6,3,14,-8,1,SAS,SAS,MIN,110,,,26,21,19,12
Jeremy Sochan,G,22023,1631110,22300141,"NOV 05, 2023",SAS vs. TOR,L,29,2,8,0.25,0,1,0.0,0,0,0.0,1,3,4,5,3,0,3,1,4,-7,1,SAS,SAS,TOR,116,,,13,8,9,9
Jeremy Sochan,G,22023,1631110,22300131,"NOV 02, 2023",SAS @ PHX,W,26,7,13,0.538,0,0,0.0,0,0,0.0,1,4,5,9,0,1,1,4,14,0,1,SAS,PHX,SAS,132,,,28,19,23,14
Jeremy Sochan,G,22023,1631110,22300113,"OCT 31, 2023",SAS @ PHX,W,30,3,8,0.375,0,1,0.0,2,3,0.667,1,6,7,5,0,0,0,5,8,-7,1,SAS,PHX,SAS,115,,,20,15,13,12
Jeremy Sochan,G,22023,1631110,22300083,"OCT 27, 2023",SAS vs. HOU,W,26,5,9,0.556,0,1,0.0,4,4,1.0,1,4,5,4,2,0,2,3,14,-8,1,SAS,SAS,HOU,126,,,23,19,18,9
Jeremy Sochan,G,22023,1631110,22300073,"OCT 25, 2023",SAS vs. DAL,L,29,4,12,0.333,2,4,0.5,3,6,0.5,3,5,8,5,1,0,3,4,13,-10,1,SAS,SAS,DAL,119,,,26,21,18,13
Jeremy Sochan,G,22023,1631110,22300734,"FEB 08, 2024",SAS @ ORL,L,28,4,9,0.444,1,4,0.25,0,0,0.0,0,2,2,1,0,0,2,1,9,-26,1,SAS,ORL,SAS,111,,,12,11,10,3
Jeremy Sochan,G,22023,1631110,22300730,"FEB 07, 2024",SAS @ MIA,L,29,3,7,0.429,0,2,0.0,0,0,0.0,0,5,5,3,1,0,2,2,6,-11,1,SAS,MIA,SAS,104,,,14,11,9,8
Jeremy Sochan,G,22023,1631110,22300703,"FEB 03, 2024",SAS vs. CLE,L,29,1,9,0.111,0,5,0.0,0,0,0.0,4,5,9,2,0,1,1,1,2,-13,1,SAS,SAS,CLE,101,,,13,11,4,11
Jeremy Sochan,G,22023,1631110,22300696,"FEB 02, 2024",SAS vs. NOP,L,31,6,12,0.5,0,4,0.0,3,6,0.5,7,9,16,3,2,0,3,4,15,11,1,SAS,SAS,NOP,113,,,34,31,18,19
Jeremy Sochan,G,22023,1631110,22300622,"JAN 24, 2024",SAS vs. OKC,L,24,1,7,0.143,0,3,0.0,0,0,0.0,2,3,5,4,0,0,2,3,2,-11,1,SAS,SAS,OKC,114,,,11,7,6,9
Jeremy Sochan,G,22023,1631110,22300594,"JAN 20, 2024",SAS @ WAS,W,28,8,11,0.727,1,2,0.5,6,6,1.0,2,2,4,3,1,2,0,4,23,27,1,SAS,WAS,SAS,131,,,30,27,26,7
Jeremy Sochan,G,22023,1631110,22300427,"DEC 28, 2023",SAS @ POR,W,31,6,10,0.6,0,2,0.0,4,5,0.8,1,6,7,3,0,1,2,4,16,17,1,SAS,POR,SAS,118,,,26,23,19,10
Jeremy Sochan,G,22023,1631110,22300412,"DEC 26, 2023",SAS vs. UTA,L,27,7,10,0.7,3,4,0.75,2,2,1.0,2,3,5,3,0,0,0,2,19,-15,1,SAS,SAS,UTA,118,,,27,24,22,8
Jeremy Sochan,G,22023,1631110,22300398,"DEC 23, 2023",SAS @ DAL,L,30,9,16,0.563,4,6,0.667,1,2,0.5,2,7,9,4,0,0,3,2,23,-23,1,SAS,DAL,SAS,119,,,36,32,27,13
Jeremy Sochan,G,22023,1631110,22300376,"DEC 21, 2023",SAS @ CHI,L,34,4,8,0.5,1,2,0.5,0,0,0.0,3,4,7,2,1,0,1,0,9,-12,1,SAS,CHI,SAS,95,,,18,16,11,9
Jeremy Sochan,G,22023,1631110,22300345,"DEC 17, 2023",SAS vs. NOP,L,25,1,7,0.143,0,0,0.0,3,4,0.75,1,2,3,4,1,0,0,1,5,-15,1,SAS,SAS,NOP,110,,,12,8,9,7
Jeremy Sochan,G,22023,1631110,22300331,"DEC 15, 2023",SAS vs. LAL,W,27,5,10,0.5,0,3,0.0,1,1,1.0,1,7,8,2,1,1,1,3,11,21,1,SAS,SAS,LAL,129,,,21,19,13,10
Jeremy Sochan,G,22023,1631110,22300316,"DEC 13, 2023",SAS vs. LAL,L,29,2,9,0.222,1,4,0.25,0,2,0.0,4,4,8,5,0,0,3,3,5,-4,1,SAS,SAS,LAL,119,,,18,13,10,13
Jeremy Sochan,G,22023,1631110,22300298,"DEC 11, 2023",SAS @ HOU,L,35,3,11,0.273,1,5,0.2,0,0,0.0,2,4,6,2,1,0,2,2,7,-8,1,SAS,HOU,SAS,82,,,15,13,9,8
Jeremy Sochan,G,22023,1631110,22301223,"DEC 08, 2023",SAS vs. CHI,L,34,2,6,0.333,0,2,0.0,0,0,0.0,0,3,3,4,0,1,5,3,4,-9,1,SAS,SAS,CHI,112,,,11,7,8,7
Jeremy Sochan,G,22023,1631110,22301210,"DEC 06, 2023",SAS @ MIN,L,22,3,10,0.3,0,2,0.0,0,0,0.0,1,1,2,0,0,1,1,1,6,-5,1,SAS,MIN,SAS,94,,,8,8,6,2
Jeremy Sochan,G,22023,1631110,22300641,"JAN 26, 2024",SAS vs. POR,W,32,12,20,0.6,4,7,0.571,3,3,1.0,4,10,14,2,2,0,2,0,31,8,1,SAS,SAS,POR,116,,,47,45,33,16
Jeremy Sochan,G,22023,1631110,22300608,"JAN 22, 2024",SAS @ PHI,L,33,5,12,0.417,3,6,0.5,1,2,0.5,3,5,8,4,0,1,2,2,14,-6,1,SAS,PHI,SAS,123,,,26,22,18,12
Moritz Wagner,F-C,22023,1629021,22300752,"FEB 10, 2024",ORL vs. CHI,W,9,3,3,1.0,1,1,1.0,0,0,0.0,0,1,1,0,0,0,2,0,7,2,1,ORL,ORL,CHI,114,,,8,8,7,1
Moritz Wagner,F-C,22023,1629021,22300734,"FEB 08, 2024",ORL vs. SAS,W,16,4,9,0.444,0,1,0.0,3,3,1.0,1,1,2,1,0,0,3,3,11,-2,1,ORL,ORL,SAS,127,,,14,13,12,3
Moritz Wagner,F-C,22023,1629021,22300721,"FEB 06, 2024",ORL @ MIA,L,16,1,4,0.25,0,1,0.0,1,2,0.5,3,0,3,0,0,1,1,2,3,-4,1,ORL,MIA,ORL,95,,,6,6,3,3
Moritz Wagner,F-C,22023,1629021,22300704,"FEB 04, 2024",ORL @ DET,W,20,5,5,1.0,0,0,0.0,0,0,0.0,1,4,5,4,0,0,1,1,10,3,1,ORL,DET,ORL,111,,,19,15,14,9
Moritz Wagner,F-C,22023,1629021,22300694,"FEB 02, 2024",ORL @ MIN,W,11,2,3,0.667,0,0,0.0,4,4,1.0,0,3,3,0,0,0,2,3,8,4,1,ORL,MIN,ORL,108,,,11,11,8,3
Moritz Wagner,F-C,22023,1629021,22300681,"JAN 31, 2024",ORL @ SAS,W,16,5,9,0.556,0,0,0.0,0,0,0.0,1,3,4,1,0,1,2,2,10,2,1,ORL,SAS,ORL,108,,,15,14,11,5
Moritz Wagner,F-C,22023,1629021,22300666,"JAN 29, 2024",ORL @ DAL,L,25,7,12,0.583,2,4,0.5,0,0,0.0,0,3,3,1,1,0,0,4,16,-3,1,ORL,DAL,ORL,129,,,20,19,17,4
Moritz Wagner,F-C,22023,1629021,22300655,"JAN 28, 2024",ORL vs. PHX,W,23,5,13,0.385,0,0,0.0,6,8,0.75,5,7,12,1,1,1,0,1,16,20,1,ORL,ORL,PHX,113,,,29,28,17,13
Moritz Wagner,F-C,22023,1629021,22300638,"JAN 26, 2024",ORL @ MEM,L,13,4,6,0.667,1,1,1.0,3,4,0.75,0,3,3,0,1,0,0,1,12,4,1,ORL,MEM,ORL,106,,,15,15,12,3
Moritz Wagner,F-C,22023,1629021,22300607,"JAN 22, 2024",ORL vs. CLE,L,18,4,8,0.5,1,1,1.0,6,8,0.75,1,3,4,1,0,0,0,2,15,-10,1,ORL,ORL,CLE,99,,,20,19,16,5
Moritz Wagner,F-C,22023,1629021,22300601,"JAN 21, 2024",ORL vs. MIA,W,11,1,3,0.333,0,0,0.0,6,8,0.75,3,1,4,0,0,0,0,1,8,1,1,ORL,ORL,MIA,105,,,12,12,8,4
Moritz Wagner,F-C,22023,1629021,22300585,"JAN 19, 2024",ORL vs. PHI,L,6,1,1,1.0,0,0,0.0,2,2,1.0,0,0,0,2,0,0,0,0,4,-5,1,ORL,ORL,PHI,109,,,6,4,6,2
Moritz Wagner,F-C,22023,1629021,22300546,"JAN 13, 2024",ORL @ OKC,L,18,2,6,0.333,0,3,0.0,0,0,0.0,0,4,4,2,0,1,3,1,4,-9,1,ORL,OKC,ORL,100,,,10,8,6,6
Moritz Wagner,F-C,22023,1629021,22300535,"JAN 12, 2024",ORL @ MIA,L,29,7,9,0.778,0,1,0.0,5,5,1.0,1,4,5,4,1,1,1,5,19,7,1,ORL,MIA,ORL,96,,,28,24,23,9
Moritz Wagner,F-C,22023,1629021,22300513,"JAN 09, 2024",ORL vs. MIN,L,31,6,9,0.667,1,4,0.25,8,11,0.727,3,5,8,2,2,0,1,3,21,-13,1,ORL,ORL,MIN,92,,,31,29,23,10
Moritz Wagner,F-C,22023,1629021,22300499,"JAN 07, 2024",ORL vs. ATL,W,25,6,12,0.5,1,4,0.25,2,2,1.0,2,5,7,0,1,0,0,2,15,-7,1,ORL,ORL,ATL,117,,,22,22,15,7
Moritz Wagner,F-C,22023,1629021,22300488,"JAN 05, 2024",ORL @ DEN,W,38,8,14,0.571,2,4,0.5,1,2,0.5,3,8,11,3,2,0,0,4,19,1,1,ORL,DEN,ORL,122,,,33,30,22,14
Moritz Wagner,F-C,22023,1629021,22300463,"JAN 02, 2024",ORL @ GSW,L,16,5,8,0.625,1,2,0.5,1,1,1.0,3,2,5,1,1,0,1,2,12,7,1,ORL,GSW,ORL,115,,,18,17,13,6
Moritz Wagner,F-C,22023,1629021,22300450,"DEC 31, 2023",ORL @ PHX,L,10,2,3,0.667,1,2,0.5,0,0,0.0,1,3,4,1,1,0,0,0,5,-2,1,ORL,PHX,ORL,107,,,10,9,6,5
Moritz Wagner,F-C,22023,1629021,22300429,"DEC 29, 2023",ORL vs. NYK,W,18,2,8,0.25,0,3,0.0,3,3,1.0,4,7,11,1,0,1,1,1,7,-7,1,ORL,ORL,NYK,117,,,19,18,8,12
Moritz Wagner,F-C,22023,1629021,22300415,"DEC 27, 2023",ORL vs. PHI,L,16,0,3,0.0,0,1,0.0,2,2,1.0,0,2,2,1,0,0,1,2,2,-2,1,ORL,ORL,PHI,92,,,5,4,3,3
Moritz Wagner,F-C,22023,1629021,22300407,"DEC 26, 2023",ORL @ WAS,W,15,5,9,0.556,0,0,0.0,1,2,0.5,0,5,5,1,0,0,0,1,11,-3,1,ORL,WAS,ORL,127,,,17,16,12,6
Moritz Wagner,F-C,22023,1629021,22300391,"DEC 23, 2023",ORL @ IND,W,20,3,3,1.0,0,0,0.0,3,4,0.75,2,1,3,3,0,0,0,1,9,12,1,ORL,IND,ORL,117,,,15,12,12,6
Moritz Wagner,F-C,22023,1629021,22300378,"DEC 21, 2023",ORL @ MIL,L,27,10,15,0.667,1,4,0.25,0,0,0.0,3,5,8,2,1,1,1,1,21,23,1,ORL,MIL,ORL,114,,,31,29,23,10
Moritz Wagner,F-C,22023,1629021,22300366,"DEC 20, 2023",ORL vs. MIA,L,18,5,8,0.625,0,0,0.0,1,1,1.0,5,2,7,1,0,0,2,5,11,2,1,ORL,ORL,MIA,106,,,19,18,12,8
Moritz Wagner,F-C,22023,1629021,22300344,"DEC 17, 2023",ORL @ BOS,L,12,1,3,0.333,1,2,0.5,3,4,0.75,0,2,2,0,0,0,0,3,6,-15,1,ORL,BOS,ORL,97,,,8,8,6,2
Moritz Wagner,F-C,22023,1629021,22300329,"DEC 15, 2023",ORL @ BOS,L,13,1,3,0.333,0,1,0.0,0,0,0.0,1,0,1,2,0,0,3,3,2,-9,1,ORL,BOS,ORL,111,,,5,3,4,3
Moritz Wagner,F-C,22023,1629021,22300294,"DEC 11, 2023",ORL vs. CLE,W,18,4,9,0.444,0,2,0.0,0,1,0.0,0,2,2,0,1,0,0,3,8,-2,1,ORL,ORL,CLE,104,,,10,10,8,2
Moritz Wagner,F-C,22023,1629021,22301217,"DEC 08, 2023",ORL vs. DET,W,16,2,4,0.5,0,0,0.0,0,0,0.0,1,4,5,2,0,0,2,1,4,5,1,ORL,ORL,DET,123,,,11,9,6,7
Moritz Wagner,F-C,22023,1629021,22301205,"DEC 06, 2023",ORL @ CLE,L,21,5,7,0.714,0,1,0.0,1,4,0.25,1,3,4,0,2,0,3,2,11,-11,1,ORL,CLE,ORL,111,,,15,15,11,4
Moritz Wagner,F-C,22023,1629021,22300282,"DEC 02, 2023",ORL @ BKN,L,22,6,9,0.667,2,2,1.0,4,5,0.8,1,1,2,2,0,1,2,2,18,-12,1,ORL,BKN,ORL,101,,,22,20,20,4
Moritz Wagner,F-C,22023,1629021,22300274,"DEC 01, 2023",ORL vs. WAS,W,23,8,13,0.615,0,2,0.0,2,3,0.667,4,2,6,0,1,1,3,1,18,9,1,ORL,ORL,WAS,130,,,24,24,18,6
Moritz Wagner,F-C,22023,1629021,22300259,"NOV 29, 2023",ORL vs. WAS,W,19,5,7,0.714,0,1,0.0,1,1,1.0,0,4,4,1,0,1,2,1,11,18,1,ORL,ORL,WAS,139,,,16,15,12,5
Moritz Wagner,F-C,22023,1629021,22300248,"NOV 26, 2023",ORL vs. CHA,W,18,4,7,0.571,1,2,0.5,2,2,1.0,2,5,7,2,0,0,2,3,11,7,1,ORL,ORL,CHA,130,,,20,18,13,9
Moritz Wagner,F-C,22023,1629021,22300043,"NOV 24, 2023",ORL vs. BOS,W,24,9,13,0.692,1,3,0.333,8,9,0.889,2,1,3,0,0,0,1,5,27,16,1,ORL,ORL,BOS,113,,,30,30,27,3
Moritz Wagner,F-C,22023,1629021,22300226,"NOV 22, 2023",ORL vs. DEN,W,15,4,7,0.571,1,3,0.333,3,4,0.75,1,2,3,1,1,0,1,1,12,6,1,ORL,ORL,DEN,124,,,16,15,13,4
Moritz Wagner,F-C,22023,1629021,22300038,"NOV 21, 2023",ORL vs. TOR,W,15,5,9,0.556,0,0,0.0,0,0,0.0,2,2,4,2,1,0,1,0,10,8,1,ORL,ORL,TOR,126,,,16,14,12,6
Moritz Wagner,F-C,22023,1629021,22300209,"NOV 19, 2023",ORL @ IND,W,21,6,10,0.6,1,1,1.0,3,4,0.75,3,0,3,2,0,0,1,3,16,3,1,ORL,IND,ORL,128,,,21,19,18,5
Moritz Wagner,F-C,22023,1629021,22300033,"NOV 17, 2023",ORL @ CHI,W,23,4,5,0.8,0,1,0.0,2,2,1.0,0,4,4,3,0,1,0,3,10,0,1,ORL,CHI,ORL,103,,,17,14,13,7
Moritz Wagner,F-C,22023,1629021,22300196,"NOV 15, 2023",ORL @ CHI,W,20,2,6,0.333,0,1,0.0,1,1,1.0,1,3,4,1,1,0,1,3,5,2,1,ORL,CHI,ORL,96,,,10,9,6,5
Moritz Wagner,F-C,22023,1629021,22300020,"NOV 14, 2023",ORL @ BKN,L,21,3,4,0.75,0,0,0.0,5,6,0.833,1,5,6,4,0,0,1,3,11,-7,1,ORL,BKN,ORL,104,,,21,17,15,10
Moritz Wagner,F-C,22023,1629021,22300173,"NOV 11, 2023",ORL vs. MIL,W,21,7,9,0.778,1,1,1.0,4,5,0.8,3,1,4,1,1,0,1,2,19,11,1,ORL,ORL,MIL,112,,,24,23,20,5
Moritz Wagner,F-C,22023,1629021,22300172,"NOV 09, 2023",ORL vs. ATL,L,20,5,9,0.556,2,4,0.5,1,1,1.0,1,6,7,0,0,0,2,2,13,-8,1,ORL,ORL,ATL,119,,,20,20,13,7
Moritz Wagner,F-C,22023,1629021,22300147,"NOV 06, 2023",ORL vs. DAL,L,26,8,13,0.615,1,4,0.25,2,2,1.0,0,5,5,0,1,0,2,3,19,-15,1,ORL,ORL,DAL,102,,,24,24,19,5
Moritz Wagner,F-C,22023,1629021,22300134,"NOV 04, 2023",ORL vs. LAL,W,19,6,10,0.6,1,3,0.333,0,0,0.0,5,3,8,2,1,0,2,5,13,-11,1,ORL,ORL,LAL,120,,,23,21,15,10
Moritz Wagner,F-C,22023,1629021,22300130,"NOV 02, 2023",ORL @ UTA,W,19,4,6,0.667,1,2,0.5,1,1,1.0,0,1,1,1,0,2,0,2,10,0,1,ORL,UTA,ORL,115,,,12,11,11,2
Moritz Wagner,F-C,22023,1629021,22300114,"OCT 31, 2023",ORL @ LAC,L,14,4,7,0.571,0,2,0.0,5,6,0.833,0,1,1,1,1,1,1,2,13,1,1,ORL,LAC,ORL,102,,,15,14,14,2
Moritz Wagner,F-C,22023,1629021,22300111,"OCT 30, 2023",ORL @ LAL,L,11,2,5,0.4,0,1,0.0,1,2,0.5,1,0,1,0,0,0,1,2,5,-10,1,ORL,LAL,ORL,103,,,6,6,5,1
Moritz Wagner,F-C,22023,1629021,22300086,"OCT 27, 2023",ORL @ POR,W,22,8,8,1.0,1,1,1.0,0,1,0.0,4,5,9,1,1,1,1,2,17,-1,1,ORL,POR,ORL,102,,,27,26,18,10
Moritz Wagner,F-C,22023,1629021,22300066,"OCT 25, 2023",ORL vs. HOU,W,15,0,1,0.0,0,1,0.0,2,2,1.0,0,4,4,0,0,1,3,4,2,13,1,ORL,ORL,HOU,116,,,6,6,2,4
Moritz Wagner,F-C,22023,1629021,22300476,"JAN 03, 2024",ORL @ SAC,L,13,0,2,0.0,0,1,0.0,2,2,1.0,1,2,3,2,0,0,3,2,2,0,1,ORL,SAC,ORL,135,,,7,5,4,5
Josh Giddey,G,22023,1630581,22300682,"JAN 31, 2024",OKC vs. DEN,W,25,2,11,0.182,0,2,0.0,4,4,1.0,3,6,9,5,0,1,2,0,8,-2,1,OKC,OKC,DEN,105,11.5,Points,22,17,13,14
Josh Giddey,G,22023,1630581,22300682,"JAN 31, 2024",OKC vs. DEN,W,25,2,11,0.182,0,2,0.0,4,4,1.0,3,6,9,5,0,1,2,0,8,-2,1,OKC,OKC,DEN,105,6.0,Rebounds,22,17,13,14
Josh Giddey,G,22023,1630581,22300682,"JAN 31, 2024",OKC vs. DEN,W,25,2,11,0.182,0,2,0.0,4,4,1.0,3,6,9,5,0,1,2,0,8,-2,1,OKC,OKC,DEN,105,21.5,Pts+Rebs+Asts,22,17,13,14
Josh Giddey,G,22023,1630581,22300682,"JAN 31, 2024",OKC vs. DEN,W,25,2,11,0.182,0,2,0.0,4,4,1.0,3,6,9,5,0,1,2,0,8,-2,1,OKC,OKC,DEN,105,4.0,Assists,22,17,13,14
Josh Giddey,G,22023,1630581,22300682,"JAN 31, 2024",OKC vs. DEN,W,25,2,11,0.182,0,2,0.0,4,4,1.0,3,6,9,5,0,1,2,0,8,-2,1,OKC,OKC,DEN,105,26.0,Fantasy Score,22,17,13,14
Josh Giddey,G,22023,1630581,22300682,"JAN 31, 2024",OKC vs. DEN,W,25,2,11,0.182,0,2,0.0,4,4,1.0,3,6,9,5,0,1,2,0,8,-2,1,OKC,OKC,DEN,105,17.5,Pts+Rebs,22,17,13,14
Josh Giddey,G,22023,1630581,22300682,"JAN 31, 2024",OKC vs. DEN,W,25,2,11,0.182,0,2,0.0,4,4,1.0,3,6,9,5,0,1,2,0,8,-2,1,OKC,OKC,DEN,105,15.5,Pts+Asts,22,17,13,14
Josh Giddey,G,22023,1630581,22300682,"JAN 31, 2024",OKC vs. DEN,W,25,2,11,0.182,0,2,0.0,4,4,1.0,3,6,9,5,0,1,2,0,8,-2,1,OKC,OKC,DEN,105,0.5,Steals,22,17,13,14
Josh Giddey,G,22023,1630581,22300682,"JAN 31, 2024",OKC vs. DEN,W,25,2,11,0.182,0,2,0.0,4,4,1.0,3,6,9,5,0,1,2,0,8,-2,1,OKC,OKC,DEN,105,10.5,Rebs+Asts,22,17,13,14
Josh Giddey,G,22023,1630581,22300682,"JAN 31, 2024",OKC vs. DEN,W,25,2,11,0.182,0,2,0.0,4,4,1.0,3,6,9,5,0,1,2,0,8,-2,1,OKC,OKC,DEN,105,1.5,Turnovers,22,17,13,14
Josh Giddey,G,22023,1630581,22300622,"JAN 24, 2024",OKC @ SAS,W,22,6,13,0.462,0,3,0.0,0,0,0.0,5,3,8,4,0,0,2,1,12,1,1,OKC,SAS,OKC,140,11.5,Points,24,20,16,12
Josh Giddey,G,22023,1630581,22300622,"JAN 24, 2024",OKC @ SAS,W,22,6,13,0.462,0,3,0.0,0,0,0.0,5,3,8,4,0,0,2,1,12,1,1,OKC,SAS,OKC,140,6.0,Rebounds,24,20,16,12
Josh Giddey,G,22023,1630581,22300622,"JAN 24, 2024",OKC @ SAS,W,22,6,13,0.462,0,3,0.0,0,0,0.0,5,3,8,4,0,0,2,1,12,1,1,OKC,SAS,OKC,140,21.5,Pts+Rebs+Asts,24,20,16,12
Josh Giddey,G,22023,1630581,22300622,"JAN 24, 2024",OKC @ SAS,W,22,6,13,0.462,0,3,0.0,0,0,0.0,5,3,8,4,0,0,2,1,12,1,1,OKC,SAS,OKC,140,4.0,Assists,24,20,16,12
Josh Giddey,G,22023,1630581,22300622,"JAN 24, 2024",OKC @ SAS,W,22,6,13,0.462,0,3,0.0,0,0,0.0,5,3,8,4,0,0,2,1,12,1,1,OKC,SAS,OKC,140,26.0,Fantasy Score,24,20,16,12
Josh Giddey,G,22023,1630581,22300622,"JAN 24, 2024",OKC @ SAS,W,22,6,13,0.462,0,3,0.0,0,0,0.0,5,3,8,4,0,0,2,1,12,1,1,OKC,SAS,OKC,140,17.5,Pts+Rebs,24,20,16,12
Josh Giddey,G,22023,1630581,22300622,"JAN 24, 2024",OKC @ SAS,W,22,6,13,0.462,0,3,0.0,0,0,0.0,5,3,8,4,0,0,2,1,12,1,1,OKC,SAS,OKC,140,15.5,Pts+Asts,24,20,16,12
Josh Giddey,G,22023,1630581,22300622,"JAN 24, 2024",OKC @ SAS,W,22,6,13,0.462,0,3,0.0,0,0,0.0,5,3,8,4,0,0,2,1,12,1,1,OKC,SAS,OKC,140,0.5,Steals,24,20,16,12
Josh Giddey,G,22023,1630581,22300622,"JAN 24, 2024",OKC @ SAS,W,22,6,13,0.462,0,3,0.0,0,0,0.0,5,3,8,4,0,0,2,1,12,1,1,OKC,SAS,OKC,140,10.5,Rebs+Asts,24,20,16,12
Josh Giddey,G,22023,1630581,22300622,"JAN 24, 2024",OKC @ SAS,W,22,6,13,0.462,0,3,0.0,0,0,0.0,5,3,8,4,0,0,2,1,12,1,1,OKC,SAS,OKC,140,1.5,Turnovers,24,20,16,12
Josh Giddey,G,22023,1630581,22300617,"JAN 23, 2024",OKC vs. POR,W,25,3,6,0.5,0,0,0.0,1,2,0.5,2,3,5,3,0,0,0,2,7,-2,1,OKC,OKC,POR,111,11.5,Points,15,12,10,8
Josh Giddey,G,22023,1630581,22300617,"JAN 23, 2024",OKC vs. POR,W,25,3,6,0.5,0,0,0.0,1,2,0.5,2,3,5,3,0,0,0,2,7,-2,1,OKC,OKC,POR,111,6.0,Rebounds,15,12,10,8
Josh Giddey,G,22023,1630581,22300617,"JAN 23, 2024",OKC vs. POR,W,25,3,6,0.5,0,0,0.0,1,2,0.5,2,3,5,3,0,0,0,2,7,-2,1,OKC,OKC,POR,111,21.5,Pts+Rebs+Asts,15,12,10,8
Josh Giddey,G,22023,1630581,22300617,"JAN 23, 2024",OKC vs. POR,W,25,3,6,0.5,0,0,0.0,1,2,0.5,2,3,5,3,0,0,0,2,7,-2,1,OKC,OKC,POR,111,4.0,Assists,15,12,10,8
Josh Giddey,G,22023,1630581,22300617,"JAN 23, 2024",OKC vs. POR,W,25,3,6,0.5,0,0,0.0,1,2,0.5,2,3,5,3,0,0,0,2,7,-2,1,OKC,OKC,POR,111,26.0,Fantasy Score,15,12,10,8
Josh Giddey,G,22023,1630581,22300617,"JAN 23, 2024",OKC vs. POR,W,25,3,6,0.5,0,0,0.0,1,2,0.5,2,3,5,3,0,0,0,2,7,-2,1,OKC,OKC,POR,111,17.5,Pts+Rebs,15,12,10,8
Josh Giddey,G,22023,1630581,22300617,"JAN 23, 2024",OKC vs. POR,W,25,3,6,0.5,0,0,0.0,1,2,0.5,2,3,5,3,0,0,0,2,7,-2,1,OKC,OKC,POR,111,15.5,Pts+Asts,15,12,10,8
Josh Giddey,G,22023,1630581,22300617,"JAN 23, 2024",OKC vs. POR,W,25,3,6,0.5,0,0,0.0,1,2,0.5,2,3,5,3,0,0,0,2,7,-2,1,OKC,OKC,POR,111,0.5,Steals,15,12,10,8
Josh Giddey,G,22023,1630581,22300617,"JAN 23, 2024",OKC vs. POR,W,25,3,6,0.5,0,0,0.0,1,2,0.5,2,3,5,3,0,0,0,2,7,-2,1,OKC,OKC,POR,111,10.5,Rebs+Asts,15,12,10,8
Josh Giddey,G,22023,1630581,22300617,"JAN 23, 2024",OKC vs. POR,W,25,3,6,0.5,0,0,0.0,1,2,0.5,2,3,5,3,0,0,0,2,7,-2,1,OKC,OKC,POR,111,1.5,Turnovers,15,12,10,8
Josh Giddey,G,22023,1630581,22300481,"JAN 05, 2024",OKC @ BKN,L,24,5,9,0.556,0,1,0.0,3,4,0.75,0,8,8,5,1,1,2,3,13,-7,1,OKC,BKN,OKC,115,11.5,Points,26,21,18,13
Josh Giddey,G,22023,1630581,22300481,"JAN 05, 2024",OKC @ BKN,L,24,5,9,0.556,0,1,0.0,3,4,0.75,0,8,8,5,1,1,2,3,13,-7,1,OKC,BKN,OKC,115,6.0,Rebounds,26,21,18,13
Josh Giddey,G,22023,1630581,22300481,"JAN 05, 2024",OKC @ BKN,L,24,5,9,0.556,0,1,0.0,3,4,0.75,0,8,8,5,1,1,2,3,13,-7,1,OKC,BKN,OKC,115,21.5,Pts+Rebs+Asts,26,21,18,13
Josh Giddey,G,22023,1630581,22300481,"JAN 05, 2024",OKC @ BKN,L,24,5,9,0.556,0,1,0.0,3,4,0.75,0,8,8,5,1,1,2,3,13,-7,1,OKC,BKN,OKC,115,4.0,Assists,26,21,18,13
Josh Giddey,G,22023,1630581,22300481,"JAN 05, 2024",OKC @ BKN,L,24,5,9,0.556,0,1,0.0,3,4,0.75,0,8,8,5,1,1,2,3,13,-7,1,OKC,BKN,OKC,115,26.0,Fantasy Score,26,21,18,13
Josh Giddey,G,22023,1630581,22300481,"JAN 05, 2024",OKC @ BKN,L,24,5,9,0.556,0,1,0.0,3,4,0.75,0,8,8,5,1,1,2,3,13,-7,1,OKC,BKN,OKC,115,17.5,Pts+Rebs,26,21,18,13
Josh Giddey,G,22023,1630581,22300481,"JAN 05, 2024",OKC @ BKN,L,24,5,9,0.556,0,1,0.0,3,4,0.75,0,8,8,5,1,1,2,3,13,-7,1,OKC,BKN,OKC,115,15.5,Pts+Asts,26,21,18,13
Josh Giddey,G,22023,1630581,22300481,"JAN 05, 2024",OKC @ BKN,L,24,5,9,0.556,0,1,0.0,3,4,0.75,0,8,8,5,1,1,2,3,13,-7,1,OKC,BKN,OKC,115,0.5,Steals,26,21,18,13
Josh Giddey,G,22023,1630581,22300481,"JAN 05, 2024",OKC @ BKN,L,24,5,9,0.556,0,1,0.0,3,4,0.75,0,8,8,5,1,1,2,3,13,-7,1,OKC,BKN,OKC,115,10.5,Rebs+Asts,26,21,18,13
Josh Giddey,G,22023,1630581,22300481,"JAN 05, 2024",OKC @ BKN,L,24,5,9,0.556,0,1,0.0,3,4,0.75,0,8,8,5,1,1,2,3,13,-7,1,OKC,BKN,OKC,115,1.5,Turnovers,26,21,18,13
Josh Giddey,G,22023,1630581,22300419,"DEC 27, 2023",OKC vs. NYK,W,29,3,4,0.75,0,0,0.0,1,2,0.5,0,6,6,2,0,2,2,1,7,11,1,OKC,OKC,NYK,129,11.5,Points,15,13,9,8
Josh Giddey,G,22023,1630581,22300419,"DEC 27, 2023",OKC vs. NYK,W,29,3,4,0.75,0,0,0.0,1,2,0.5,0,6,6,2,0,2,2,1,7,11,1,OKC,OKC,NYK,129,6.0,Rebounds,15,13,9,8
Josh Giddey,G,22023,1630581,22300419,"DEC 27, 2023",OKC vs. NYK,W,29,3,4,0.75,0,0,0.0,1,2,0.5,0,6,6,2,0,2,2,1,7,11,1,OKC,OKC,NYK,129,21.5,Pts+Rebs+Asts,15,13,9,8
Josh Giddey,G,22023,1630581,22300419,"DEC 27, 2023",OKC vs. NYK,W,29,3,4,0.75,0,0,0.0,1,2,0.5,0,6,6,2,0,2,2,1,7,11,1,OKC,OKC,NYK,129,4.0,Assists,15,13,9,8
Josh Giddey,G,22023,1630581,22300419,"DEC 27, 2023",OKC vs. NYK,W,29,3,4,0.75,0,0,0.0,1,2,0.5,0,6,6,2,0,2,2,1,7,11,1,OKC,OKC,NYK,129,26.0,Fantasy Score,15,13,9,8
Josh Giddey,G,22023,1630581,22300419,"DEC 27, 2023",OKC vs. NYK,W,29,3,4,0.75,0,0,0.0,1,2,0.5,0,6,6,2,0,2,2,1,7,11,1,OKC,OKC,NYK,129,17.5,Pts+Rebs,15,13,9,8
Josh Giddey,G,22023,1630581,22300419,"DEC 27, 2023",OKC vs. NYK,W,29,3,4,0.75,0,0,0.0,1,2,0.5,0,6,6,2,0,2,2,1,7,11,1,OKC,OKC,NYK,129,15.5,Pts+Asts,15,13,9,8
Josh Giddey,G,22023,1630581,22300419,"DEC 27, 2023",OKC vs. NYK,W,29,3,4,0.75,0,0,0.0,1,2,0.5,0,6,6,2,0,2,2,1,7,11,1,OKC,OKC,NYK,129,0.5,Steals,15,13,9,8
Josh Giddey,G,22023,1630581,22300419,"DEC 27, 2023",OKC vs. NYK,W,29,3,4,0.75,0,0,0.0,1,2,0.5,0,6,6,2,0,2,2,1,7,11,1,OKC,OKC,NYK,129,10.5,Rebs+Asts,15,13,9,8
Josh Giddey,G,22023,1630581,22300419,"DEC 27, 2023",OKC vs. NYK,W,29,3,4,0.75,0,0,0.0,1,2,0.5,0,6,6,2,0,2,2,1,7,11,1,OKC,OKC,NYK,129,1.5,Turnovers,15,13,9,8
Josh Giddey,G,22023,1630581,22300324,"DEC 14, 2023",OKC @ SAC,L,29,8,14,0.571,2,3,0.667,0,0,0.0,5,3,8,4,2,1,4,4,18,10,1,OKC,SAC,OKC,123,11.5,Points,30,26,22,12
Josh Giddey,G,22023,1630581,22300324,"DEC 14, 2023",OKC @ SAC,L,29,8,14,0.571,2,3,0.667,0,0,0.0,5,3,8,4,2,1,4,4,18,10,1,OKC,SAC,OKC,123,6.0,Rebounds,30,26,22,12
Josh Giddey,G,22023,1630581,22300324,"DEC 14, 2023",OKC @ SAC,L,29,8,14,0.571,2,3,0.667,0,0,0.0,5,3,8,4,2,1,4,4,18,10,1,OKC,SAC,OKC,123,21.5,Pts+Rebs+Asts,30,26,22,12
Josh Giddey,G,22023,1630581,22300324,"DEC 14, 2023",OKC @ SAC,L,29,8,14,0.571,2,3,0.667,0,0,0.0,5,3,8,4,2,1,4,4,18,10,1,OKC,SAC,OKC,123,4.0,Assists,30,26,22,12
Josh Giddey,G,22023,1630581,22300324,"DEC 14, 2023",OKC @ SAC,L,29,8,14,0.571,2,3,0.667,0,0,0.0,5,3,8,4,2,1,4,4,18,10,1,OKC,SAC,OKC,123,26.0,Fantasy Score,30,26,22,12
Josh Giddey,G,22023,1630581,22300324,"DEC 14, 2023",OKC @ SAC,L,29,8,14,0.571,2,3,0.667,0,0,0.0,5,3,8,4,2,1,4,4,18,10,1,OKC,SAC,OKC,123,17.5,Pts+Rebs,30,26,22,12
Josh Giddey,G,22023,1630581,22300324,"DEC 14, 2023",OKC @ SAC,L,29,8,14,0.571,2,3,0.667,0,0,0.0,5,3,8,4,2,1,4,4,18,10,1,OKC,SAC,OKC,123,15.5,Pts+Asts,30,26,22,12
Josh Giddey,G,22023,1630581,22300324,"DEC 14, 2023",OKC @ SAC,L,29,8,14,0.571,2,3,0.667,0,0,0.0,5,3,8,4,2,1,4,4,18,10,1,OKC,SAC,OKC,123,0.5,Steals,30,26,22,12
Josh Giddey,G,22023,1630581,22300324,"DEC 14, 2023",OKC @ SAC,L,29,8,14,0.571,2,3,0.667,0,0,0.0,5,3,8,4,2,1,4,4,18,10,1,OKC,SAC,OKC,123,10.5,Rebs+Asts,30,26,22,12
Josh Giddey,G,22023,1630581,22300324,"DEC 14, 2023",OKC @ SAC,L,29,8,14,0.571,2,3,0.667,0,0,0.0,5,3,8,4,2,1,4,4,18,10,1,OKC,SAC,OKC,123,1.5,Turnovers,30,26,22,12
Josh Giddey,G,22023,1630581,22300302,"DEC 11, 2023",OKC vs. UTA,W,24,5,11,0.455,2,3,0.667,0,0,0.0,2,8,10,8,1,1,3,1,12,17,1,OKC,OKC,UTA,134,11.5,Points,30,22,20,18
Josh Giddey,G,22023,1630581,22300302,"DEC 11, 2023",OKC vs. UTA,W,24,5,11,0.455,2,3,0.667,0,0,0.0,2,8,10,8,1,1,3,1,12,17,1,OKC,OKC,UTA,134,6.0,Rebounds,30,22,20,18
Josh Giddey,G,22023,1630581,22300302,"DEC 11, 2023",OKC vs. UTA,W,24,5,11,0.455,2,3,0.667,0,0,0.0,2,8,10,8,1,1,3,1,12,17,1,OKC,OKC,UTA,134,21.5,Pts+Rebs+Asts,30,22,20,18
Josh Giddey,G,22023,1630581,22300302,"DEC 11, 2023",OKC vs. UTA,W,24,5,11,0.455,2,3,0.667,0,0,0.0,2,8,10,8,1,1,3,1,12,17,1,OKC,OKC,UTA,134,4.0,Assists,30,22,20,18
Josh Giddey,G,22023,1630581,22300302,"DEC 11, 2023",OKC vs. UTA,W,24,5,11,0.455,2,3,0.667,0,0,0.0,2,8,10,8,1,1,3,1,12,17,1,OKC,OKC,UTA,134,26.0,Fantasy Score,30,22,20,18
Josh Giddey,G,22023,1630581,22300302,"DEC 11, 2023",OKC vs. UTA,W,24,5,11,0.455,2,3,0.667,0,0,0.0,2,8,10,8,1,1,3,1,12,17,1,OKC,OKC,UTA,134,17.5,Pts+Rebs,30,22,20,18
Josh Giddey,G,22023,1630581,22300302,"DEC 11, 2023",OKC vs. UTA,W,24,5,11,0.455,2,3,0.667,0,0,0.0,2,8,10,8,1,1,3,1,12,17,1,OKC,OKC,UTA,134,15.5,Pts+Asts,30,22,20,18
Josh Giddey,G,22023,1630581,22300302,"DEC 11, 2023",OKC vs. UTA,W,24,5,11,0.455,2,3,0.667,0,0,0.0,2,8,10,8,1,1,3,1,12,17,1,OKC,OKC,UTA,134,0.5,Steals,30,22,20,18
Josh Giddey,G,22023,1630581,22300302,"DEC 11, 2023",OKC vs. UTA,W,24,5,11,0.455,2,3,0.667,0,0,0.0,2,8,10,8,1,1,3,1,12,17,1,OKC,OKC,UTA,134,10.5,Rebs+Asts,30,22,20,18
Josh Giddey,G,22023,1630581,22300302,"DEC 11, 2023",OKC vs. UTA,W,24,5,11,0.455,2,3,0.667,0,0,0.0,2,8,10,8,1,1,3,1,12,17,1,OKC,OKC,UTA,134,1.5,Turnovers,30,22,20,18
Josh Giddey,G,22023,1630581,22301222,"DEC 08, 2023",OKC vs. GSW,W,25,4,12,0.333,1,6,0.167,0,0,0.0,1,8,9,4,3,0,1,2,9,-10,1,OKC,OKC,GSW,138,11.5,Points,22,18,13,13
Josh Giddey,G,22023,1630581,22301222,"DEC 08, 2023",OKC vs. GSW,W,25,4,12,0.333,1,6,0.167,0,0,0.0,1,8,9,4,3,0,1,2,9,-10,1,OKC,OKC,GSW,138,6.0,Rebounds,22,18,13,13
Josh Giddey,G,22023,1630581,22301222,"DEC 08, 2023",OKC vs. GSW,W,25,4,12,0.333,1,6,0.167,0,0,0.0,1,8,9,4,3,0,1,2,9,-10,1,OKC,OKC,GSW,138,21.5,Pts+Rebs+Asts,22,18,13,13
Josh Giddey,G,22023,1630581,22301222,"DEC 08, 2023",OKC vs. GSW,W,25,4,12,0.333,1,6,0.167,0,0,0.0,1,8,9,4,3,0,1,2,9,-10,1,OKC,OKC,GSW,138,4.0,Assists,22,18,13,13
Josh Giddey,G,22023,1630581,22301222,"DEC 08, 2023",OKC vs. GSW,W,25,4,12,0.333,1,6,0.167,0,0,0.0,1,8,9,4,3,0,1,2,9,-10,1,OKC,OKC,GSW,138,26.0,Fantasy Score,22,18,13,13
Josh Giddey,G,22023,1630581,22301222,"DEC 08, 2023",OKC vs. GSW,W,25,4,12,0.333,1,6,0.167,0,0,0.0,1,8,9,4,3,0,1,2,9,-10,1,OKC,OKC,GSW,138,17.5,Pts+Rebs,22,18,13,13
Josh Giddey,G,22023,1630581,22301222,"DEC 08, 2023",OKC vs. GSW,W,25,4,12,0.333,1,6,0.167,0,0,0.0,1,8,9,4,3,0,1,2,9,-10,1,OKC,OKC,GSW,138,15.5,Pts+Asts,22,18,13,13
Josh Giddey,G,22023,1630581,22301222,"DEC 08, 2023",OKC vs. GSW,W,25,4,12,0.333,1,6,0.167,0,0,0.0,1,8,9,4,3,0,1,2,9,-10,1,OKC,OKC,GSW,138,0.5,Steals,22,18,13,13
Josh Giddey,G,22023,1630581,22301222,"DEC 08, 2023",OKC vs. GSW,W,25,4,12,0.333,1,6,0.167,0,0,0.0,1,8,9,4,3,0,1,2,9,-10,1,OKC,OKC,GSW,138,10.5,Rebs+Asts,22,18,13,13
Josh Giddey,G,22023,1630581,22301222,"DEC 08, 2023",OKC vs. GSW,W,25,4,12,0.333,1,6,0.167,0,0,0.0,1,8,9,4,3,0,1,2,9,-10,1,OKC,OKC,GSW,138,1.5,Turnovers,22,18,13,13
Josh Giddey,G,22023,1630581,22300287,"DEC 02, 2023",OKC @ DAL,W,17,4,13,0.308,2,6,0.333,0,0,0.0,2,1,3,1,0,0,2,1,10,1,1,OKC,DAL,OKC,126,11.5,Points,14,13,11,4
Josh Giddey,G,22023,1630581,22300287,"DEC 02, 2023",OKC @ DAL,W,17,4,13,0.308,2,6,0.333,0,0,0.0,2,1,3,1,0,0,2,1,10,1,1,OKC,DAL,OKC,126,6.0,Rebounds,14,13,11,4
Josh Giddey,G,22023,1630581,22300287,"DEC 02, 2023",OKC @ DAL,W,17,4,13,0.308,2,6,0.333,0,0,0.0,2,1,3,1,0,0,2,1,10,1,1,OKC,DAL,OKC,126,21.5,Pts+Rebs+Asts,14,13,11,4
Josh Giddey,G,22023,1630581,22300287,"DEC 02, 2023",OKC @ DAL,W,17,4,13,0.308,2,6,0.333,0,0,0.0,2,1,3,1,0,0,2,1,10,1,1,OKC,DAL,OKC,126,4.0,Assists,14,13,11,4
Josh Giddey,G,22023,1630581,22300287,"DEC 02, 2023",OKC @ DAL,W,17,4,13,0.308,2,6,0.333,0,0,0.0,2,1,3,1,0,0,2,1,10,1,1,OKC,DAL,OKC,126,26.0,Fantasy Score,14,13,11,4
Josh Giddey,G,22023,1630581,22300287,"DEC 02, 2023",OKC @ DAL,W,17,4,13,0.308,2,6,0.333,0,0,0.0,2,1,3,1,0,0,2,1,10,1,1,OKC,DAL,OKC,126,17.5,Pts+Rebs,14,13,11,4
Josh Giddey,G,22023,1630581,22300287,"DEC 02, 2023",OKC @ DAL,W,17,4,13,0.308,2,6,0.333,0,0,0.0,2,1,3,1,0,0,2,1,10,1,1,OKC,DAL,OKC,126,15.5,Pts+Asts,14,13,11,4
Josh Giddey,G,22023,1630581,22300287,"DEC 02, 2023",OKC @ DAL,W,17,4,13,0.308,2,6,0.333,0,0,0.0,2,1,3,1,0,0,2,1,10,1,1,OKC,DAL,OKC,126,0.5,Steals,14,13,11,4
Josh Giddey,G,22023,1630581,22300287,"DEC 02, 2023",OKC @ DAL,W,17,4,13,0.308,2,6,0.333,0,0,0.0,2,1,3,1,0,0,2,1,10,1,1,OKC,DAL,OKC,126,10.5,Rebs+Asts,14,13,11,4
Josh Giddey,G,22023,1630581,22300287,"DEC 02, 2023",OKC @ DAL,W,17,4,13,0.308,2,6,0.333,0,0,0.0,2,1,3,1,0,0,2,1,10,1,1,OKC,DAL,OKC,126,1.5,Turnovers,14,13,11,4
Josh Giddey,G,22023,1630581,22300239,"NOV 25, 2023",OKC vs. PHI,L,26,4,12,0.333,0,1,0.0,2,2,1.0,3,4,7,8,0,0,1,4,10,-13,1,OKC,OKC,PHI,123,11.5,Points,25,17,18,15
Josh Giddey,G,22023,1630581,22300239,"NOV 25, 2023",OKC vs. PHI,L,26,4,12,0.333,0,1,0.0,2,2,1.0,3,4,7,8,0,0,1,4,10,-13,1,OKC,OKC,PHI,123,6.0,Rebounds,25,17,18,15
Josh Giddey,G,22023,1630581,22300239,"NOV 25, 2023",OKC vs. PHI,L,26,4,12,0.333,0,1,0.0,2,2,1.0,3,4,7,8,0,0,1,4,10,-13,1,OKC,OKC,PHI,123,21.5,Pts+Rebs+Asts,25,17,18,15
Josh Giddey,G,22023,1630581,22300239,"NOV 25, 2023",OKC vs. PHI,L,26,4,12,0.333,0,1,0.0,2,2,1.0,3,4,7,8,0,0,1,4,10,-13,1,OKC,OKC,PHI,123,4.0,Assists,25,17,18,15
Josh Giddey,G,22023,1630581,22300239,"NOV 25, 2023",OKC vs. PHI,L,26,4,12,0.333,0,1,0.0,2,2,1.0,3,4,7,8,0,0,1,4,10,-13,1,OKC,OKC,PHI,123,26.0,Fantasy Score,25,17,18,15
Josh Giddey,G,22023,1630581,22300239,"NOV 25, 2023",OKC vs. PHI,L,26,4,12,0.333,0,1,0.0,2,2,1.0,3,4,7,8,0,0,1,4,10,-13,1,OKC,OKC,PHI,123,17.5,Pts+Rebs,25,17,18,15
Josh Giddey,G,22023,1630581,22300239,"NOV 25, 2023",OKC vs. PHI,L,26,4,12,0.333,0,1,0.0,2,2,1.0,3,4,7,8,0,0,1,4,10,-13,1,OKC,OKC,PHI,123,15.5,Pts+Asts,25,17,18,15
Josh Giddey,G,22023,1630581,22300239,"NOV 25, 2023",OKC vs. PHI,L,26,4,12,0.333,0,1,0.0,2,2,1.0,3,4,7,8,0,0,1,4,10,-13,1,OKC,OKC,PHI,123,0.5,Steals,25,17,18,15
Josh Giddey,G,22023,1630581,22300239,"NOV 25, 2023",OKC vs. PHI,L,26,4,12,0.333,0,1,0.0,2,2,1.0,3,4,7,8,0,0,1,4,10,-13,1,OKC,OKC,PHI,123,10.5,Rebs+Asts,25,17,18,15
Josh Giddey,G,22023,1630581,22300239,"NOV 25, 2023",OKC vs. PHI,L,26,4,12,0.333,0,1,0.0,2,2,1.0,3,4,7,8,0,0,1,4,10,-13,1,OKC,OKC,PHI,123,1.5,Turnovers,25,17,18,15
Josh Giddey,G,22023,1630581,22300215,"NOV 19, 2023",OKC @ POR,W,23,3,6,0.5,0,0,0.0,0,0,0.0,0,4,4,5,1,0,4,1,6,12,1,OKC,POR,OKC,134,11.5,Points,15,10,11,9
Josh Giddey,G,22023,1630581,22300215,"NOV 19, 2023",OKC @ POR,W,23,3,6,0.5,0,0,0.0,0,0,0.0,0,4,4,5,1,0,4,1,6,12,1,OKC,POR,OKC,134,6.0,Rebounds,15,10,11,9
Josh Giddey,G,22023,1630581,22300215,"NOV 19, 2023",OKC @ POR,W,23,3,6,0.5,0,0,0.0,0,0,0.0,0,4,4,5,1,0,4,1,6,12,1,OKC,POR,OKC,134,21.5,Pts+Rebs+Asts,15,10,11,9
Josh Giddey,G,22023,1630581,22300215,"NOV 19, 2023",OKC @ POR,W,23,3,6,0.5,0,0,0.0,0,0,0.0,0,4,4,5,1,0,4,1,6,12,1,OKC,POR,OKC,134,4.0,Assists,15,10,11,9
Josh Giddey,G,22023,1630581,22300215,"NOV 19, 2023",OKC @ POR,W,23,3,6,0.5,0,0,0.0,0,0,0.0,0,4,4,5,1,0,4,1,6,12,1,OKC,POR,OKC,134,26.0,Fantasy Score,15,10,11,9
Josh Giddey,G,22023,1630581,22300215,"NOV 19, 2023",OKC @ POR,W,23,3,6,0.5,0,0,0.0,0,0,0.0,0,4,4,5,1,0,4,1,6,12,1,OKC,POR,OKC,134,17.5,Pts+Rebs,15,10,11,9
Josh Giddey,G,22023,1630581,22300215,"NOV 19, 2023",OKC @ POR,W,23,3,6,0.5,0,0,0.0,0,0,0.0,0,4,4,5,1,0,4,1,6,12,1,OKC,POR,OKC,134,15.5,Pts+Asts,15,10,11,9
Josh Giddey,G,22023,1630581,22300215,"NOV 19, 2023",OKC @ POR,W,23,3,6,0.5,0,0,0.0,0,0,0.0,0,4,4,5,1,0,4,1,6,12,1,OKC,POR,OKC,134,0.5,Steals,15,10,11,9
Josh Giddey,G,22023,1630581,22300215,"NOV 19, 2023",OKC @ POR,W,23,3,6,0.5,0,0,0.0,0,0,0.0,0,4,4,5,1,0,4,1,6,12,1,OKC,POR,OKC,134,10.5,Rebs+Asts,15,10,11,9
Josh Giddey,G,22023,1630581,22300215,"NOV 19, 2023",OKC @ POR,W,23,3,6,0.5,0,0,0.0,0,0,0.0,0,4,4,5,1,0,4,1,6,12,1,OKC,POR,OKC,134,1.5,Turnovers,15,10,11,9
Josh Giddey,G,22023,1630581,22300185,"NOV 12, 2023",OKC @ PHX,W,32,5,12,0.417,0,1,0.0,0,0,0.0,3,3,6,10,2,2,4,1,10,17,1,OKC,PHX,OKC,111,11.5,Points,26,16,20,16
Josh Giddey,G,22023,1630581,22300185,"NOV 12, 2023",OKC @ PHX,W,32,5,12,0.417,0,1,0.0,0,0,0.0,3,3,6,10,2,2,4,1,10,17,1,OKC,PHX,OKC,111,6.0,Rebounds,26,16,20,16
Josh Giddey,G,22023,1630581,22300185,"NOV 12, 2023",OKC @ PHX,W,32,5,12,0.417,0,1,0.0,0,0,0.0,3,3,6,10,2,2,4,1,10,17,1,OKC,PHX,OKC,111,21.5,Pts+Rebs+Asts,26,16,20,16
Josh Giddey,G,22023,1630581,22300185,"NOV 12, 2023",OKC @ PHX,W,32,5,12,0.417,0,1,0.0,0,0,0.0,3,3,6,10,2,2,4,1,10,17,1,OKC,PHX,OKC,111,4.0,Assists,26,16,20,16
Josh Giddey,G,22023,1630581,22300185,"NOV 12, 2023",OKC @ PHX,W,32,5,12,0.417,0,1,0.0,0,0,0.0,3,3,6,10,2,2,4,1,10,17,1,OKC,PHX,OKC,111,26.0,Fantasy Score,26,16,20,16
Josh Giddey,G,22023,1630581,22300185,"NOV 12, 2023",OKC @ PHX,W,32,5,12,0.417,0,1,0.0,0,0,0.0,3,3,6,10,2,2,4,1,10,17,1,OKC,PHX,OKC,111,17.5,Pts+Rebs,26,16,20,16
Josh Giddey,G,22023,1630581,22300185,"NOV 12, 2023",OKC @ PHX,W,32,5,12,0.417,0,1,0.0,0,0,0.0,3,3,6,10,2,2,4,1,10,17,1,OKC,PHX,OKC,111,15.5,Pts+Asts,26,16,20,16
Josh Giddey,G,22023,1630581,22300185,"NOV 12, 2023",OKC @ PHX,W,32,5,12,0.417,0,1,0.0,0,0,0.0,3,3,6,10,2,2,4,1,10,17,1,OKC,PHX,OKC,111,0.5,Steals,26,16,20,16
Josh Giddey,G,22023,1630581,22300185,"NOV 12, 2023",OKC @ PHX,W,32,5,12,0.417,0,1,0.0,0,0,0.0,3,3,6,10,2,2,4,1,10,17,1,OKC,PHX,OKC,111,10.5,Rebs+Asts,26,16,20,16
Josh Giddey,G,22023,1630581,22300185,"NOV 12, 2023",OKC @ PHX,W,32,5,12,0.417,0,1,0.0,0,0,0.0,3,3,6,10,2,2,4,1,10,17,1,OKC,PHX,OKC,111,1.5,Turnovers,26,16,20,16
Josh Giddey,G,22023,1630581,22300167,"NOV 08, 2023",OKC vs. CLE,W,25,4,11,0.364,0,2,0.0,0,0,0.0,1,4,5,6,2,1,1,0,8,2,1,OKC,OKC,CLE,128,11.5,Points,19,13,14,11
Josh Giddey,G,22023,1630581,22300167,"NOV 08, 2023",OKC vs. CLE,W,25,4,11,0.364,0,2,0.0,0,0,0.0,1,4,5,6,2,1,1,0,8,2,1,OKC,OKC,CLE,128,6.0,Rebounds,19,13,14,11
Josh Giddey,G,22023,1630581,22300167,"NOV 08, 2023",OKC vs. CLE,W,25,4,11,0.364,0,2,0.0,0,0,0.0,1,4,5,6,2,1,1,0,8,2,1,OKC,OKC,CLE,128,21.5,Pts+Rebs+Asts,19,13,14,11
Josh Giddey,G,22023,1630581,22300167,"NOV 08, 2023",OKC vs. CLE,W,25,4,11,0.364,0,2,0.0,0,0,0.0,1,4,5,6,2,1,1,0,8,2,1,OKC,OKC,CLE,128,4.0,Assists,19,13,14,11
Josh Giddey,G,22023,1630581,22300167,"NOV 08, 2023",OKC vs. CLE,W,25,4,11,0.364,0,2,0.0,0,0,0.0,1,4,5,6,2,1,1,0,8,2,1,OKC,OKC,CLE,128,26.0,Fantasy Score,19,13,14,11
Josh Giddey,G,22023,1630581,22300167,"NOV 08, 2023",OKC vs. CLE,W,25,4,11,0.364,0,2,0.0,0,0,0.0,1,4,5,6,2,1,1,0,8,2,1,OKC,OKC,CLE,128,17.5,Pts+Rebs,19,13,14,11
Josh Giddey,G,22023,1630581,22300167,"NOV 08, 2023",OKC vs. CLE,W,25,4,11,0.364,0,2,0.0,0,0,0.0,1,4,5,6,2,1,1,0,8,2,1,OKC,OKC,CLE,128,15.5,Pts+Asts,19,13,14,11
Josh Giddey,G,22023,1630581,22300167,"NOV 08, 2023",OKC vs. CLE,W,25,4,11,0.364,0,2,0.0,0,0,0.0,1,4,5,6,2,1,1,0,8,2,1,OKC,OKC,CLE,128,0.5,Steals,19,13,14,11
Josh Giddey,G,22023,1630581,22300167,"NOV 08, 2023",OKC vs. CLE,W,25,4,11,0.364,0,2,0.0,0,0,0.0,1,4,5,6,2,1,1,0,8,2,1,OKC,OKC,CLE,128,10.5,Rebs+Asts,19,13,14,11
Josh Giddey,G,22023,1630581,22300167,"NOV 08, 2023",OKC vs. CLE,W,25,4,11,0.364,0,2,0.0,0,0,0.0,1,4,5,6,2,1,1,0,8,2,1,OKC,OKC,CLE,128,1.5,Turnovers,19,13,14,11
Josh Giddey,G,22023,1630581,22300109,"OCT 30, 2023",OKC vs. DET,W,28,9,18,0.5,0,2,0.0,3,5,0.6,3,4,7,3,1,1,1,1,21,10,1,OKC,OKC,DET,124,11.5,Points,31,28,24,10
Josh Giddey,G,22023,1630581,22300109,"OCT 30, 2023",OKC vs. DET,W,28,9,18,0.5,0,2,0.0,3,5,0.6,3,4,7,3,1,1,1,1,21,10,1,OKC,OKC,DET,124,6.0,Rebounds,31,28,24,10
Josh Giddey,G,22023,1630581,22300109,"OCT 30, 2023",OKC vs. DET,W,28,9,18,0.5,0,2,0.0,3,5,0.6,3,4,7,3,1,1,1,1,21,10,1,OKC,OKC,DET,124,21.5,Pts+Rebs+Asts,31,28,24,10
Josh Giddey,G,22023,1630581,22300109,"OCT 30, 2023",OKC vs. DET,W,28,9,18,0.5,0,2,0.0,3,5,0.6,3,4,7,3,1,1,1,1,21,10,1,OKC,OKC,DET,124,4.0,Assists,31,28,24,10
Josh Giddey,G,22023,1630581,22300109,"OCT 30, 2023",OKC vs. DET,W,28,9,18,0.5,0,2,0.0,3,5,0.6,3,4,7,3,1,1,1,1,21,10,1,OKC,OKC,DET,124,26.0,Fantasy Score,31,28,24,10
Josh Giddey,G,22023,1630581,22300109,"OCT 30, 2023",OKC vs. DET,W,28,9,18,0.5,0,2,0.0,3,5,0.6,3,4,7,3,1,1,1,1,21,10,1,OKC,OKC,DET,124,17.5,Pts+Rebs,31,28,24,10
Josh Giddey,G,22023,1630581,22300109,"OCT 30, 2023",OKC vs. DET,W,28,9,18,0.5,0,2,0.0,3,5,0.6,3,4,7,3,1,1,1,1,21,10,1,OKC,OKC,DET,124,15.5,Pts+Asts,31,28,24,10
Josh Giddey,G,22023,1630581,22300109,"OCT 30, 2023",OKC vs. DET,W,28,9,18,0.5,0,2,0.0,3,5,0.6,3,4,7,3,1,1,1,1,21,10,1,OKC,OKC,DET,124,0.5,Steals,31,28,24,10
Josh Giddey,G,22023,1630581,22300109,"OCT 30, 2023",OKC vs. DET,W,28,9,18,0.5,0,2,0.0,3,5,0.6,3,4,7,3,1,1,1,1,21,10,1,OKC,OKC,DET,124,10.5,Rebs+Asts,31,28,24,10
Josh Giddey,G,22023,1630581,22300109,"OCT 30, 2023",OKC vs. DET,W,28,9,18,0.5,0,2,0.0,3,5,0.6,3,4,7,3,1,1,1,1,21,10,1,OKC,OKC,DET,124,1.5,Turnovers,31,28,24,10
Josh Giddey,G,22023,1630581,22300748,"FEB 10, 2024",OKC @ DAL,L,23,3,14,0.214,3,9,0.333,2,2,1.0,1,2,3,3,1,0,1,1,11,-23,1,OKC,DAL,OKC,111,11.5,Points,17,14,14,6
Josh Giddey,G,22023,1630581,22300748,"FEB 10, 2024",OKC @ DAL,L,23,3,14,0.214,3,9,0.333,2,2,1.0,1,2,3,3,1,0,1,1,11,-23,1,OKC,DAL,OKC,111,6.0,Rebounds,17,14,14,6
Josh Giddey,G,22023,1630581,22300748,"FEB 10, 2024",OKC @ DAL,L,23,3,14,0.214,3,9,0.333,2,2,1.0,1,2,3,3,1,0,1,1,11,-23,1,OKC,DAL,OKC,111,21.5,Pts+Rebs+Asts,17,14,14,6
Josh Giddey,G,22023,1630581,22300748,"FEB 10, 2024",OKC @ DAL,L,23,3,14,0.214,3,9,0.333,2,2,1.0,1,2,3,3,1,0,1,1,11,-23,1,OKC,DAL,OKC,111,4.0,Assists,17,14,14,6
Josh Giddey,G,22023,1630581,22300748,"FEB 10, 2024",OKC @ DAL,L,23,3,14,0.214,3,9,0.333,2,2,1.0,1,2,3,3,1,0,1,1,11,-23,1,OKC,DAL,OKC,111,26.0,Fantasy Score,17,14,14,6
Josh Giddey,G,22023,1630581,22300748,"FEB 10, 2024",OKC @ DAL,L,23,3,14,0.214,3,9,0.333,2,2,1.0,1,2,3,3,1,0,1,1,11,-23,1,OKC,DAL,OKC,111,17.5,Pts+Rebs,17,14,14,6
Josh Giddey,G,22023,1630581,22300748,"FEB 10, 2024",OKC @ DAL,L,23,3,14,0.214,3,9,0.333,2,2,1.0,1,2,3,3,1,0,1,1,11,-23,1,OKC,DAL,OKC,111,15.5,Pts+Asts,17,14,14,6
Josh Giddey,G,22023,1630581,22300748,"FEB 10, 2024",OKC @ DAL,L,23,3,14,0.214,3,9,0.333,2,2,1.0,1,2,3,3,1,0,1,1,11,-23,1,OKC,DAL,OKC,111,0.5,Steals,17,14,14,6
Josh Giddey,G,22023,1630581,22300748,"FEB 10, 2024",OKC @ DAL,L,23,3,14,0.214,3,9,0.333,2,2,1.0,1,2,3,3,1,0,1,1,11,-23,1,OKC,DAL,OKC,111,10.5,Rebs+Asts,17,14,14,6
Josh Giddey,G,22023,1630581,22300748,"FEB 10, 2024",OKC @ DAL,L,23,3,14,0.214,3,9,0.333,2,2,1.0,1,2,3,3,1,0,1,1,11,-23,1,OKC,DAL,OKC,111,1.5,Turnovers,17,14,14,6
Josh Giddey,G,22023,1630581,22300724,"FEB 06, 2024",OKC @ UTA,L,26,3,8,0.375,2,4,0.5,0,0,0.0,0,3,3,2,0,1,1,3,8,-5,1,OKC,UTA,OKC,117,11.5,Points,13,11,10,5
Josh Giddey,G,22023,1630581,22300724,"FEB 06, 2024",OKC @ UTA,L,26,3,8,0.375,2,4,0.5,0,0,0.0,0,3,3,2,0,1,1,3,8,-5,1,OKC,UTA,OKC,117,6.0,Rebounds,13,11,10,5
Josh Giddey,G,22023,1630581,22300724,"FEB 06, 2024",OKC @ UTA,L,26,3,8,0.375,2,4,0.5,0,0,0.0,0,3,3,2,0,1,1,3,8,-5,1,OKC,UTA,OKC,117,21.5,Pts+Rebs+Asts,13,11,10,5
Josh Giddey,G,22023,1630581,22300724,"FEB 06, 2024",OKC @ UTA,L,26,3,8,0.375,2,4,0.5,0,0,0.0,0,3,3,2,0,1,1,3,8,-5,1,OKC,UTA,OKC,117,4.0,Assists,13,11,10,5
Josh Giddey,G,22023,1630581,22300724,"FEB 06, 2024",OKC @ UTA,L,26,3,8,0.375,2,4,0.5,0,0,0.0,0,3,3,2,0,1,1,3,8,-5,1,OKC,UTA,OKC,117,26.0,Fantasy Score,13,11,10,5
Josh Giddey,G,22023,1630581,22300724,"FEB 06, 2024",OKC @ UTA,L,26,3,8,0.375,2,4,0.5,0,0,0.0,0,3,3,2,0,1,1,3,8,-5,1,OKC,UTA,OKC,117,17.5,Pts+Rebs,13,11,10,5
Josh Giddey,G,22023,1630581,22300724,"FEB 06, 2024",OKC @ UTA,L,26,3,8,0.375,2,4,0.5,0,0,0.0,0,3,3,2,0,1,1,3,8,-5,1,OKC,UTA,OKC,117,15.5,Pts+Asts,13,11,10,5
Josh Giddey,G,22023,1630581,22300724,"FEB 06, 2024",OKC @ UTA,L,26,3,8,0.375,2,4,0.5,0,0,0.0,0,3,3,2,0,1,1,3,8,-5,1,OKC,UTA,OKC,117,0.5,Steals,13,11,10,5
Josh Giddey,G,22023,1630581,22300724,"FEB 06, 2024",OKC @ UTA,L,26,3,8,0.375,2,4,0.5,0,0,0.0,0,3,3,2,0,1,1,3,8,-5,1,OKC,UTA,OKC,117,10.5,Rebs+Asts,13,11,10,5
Josh Giddey,G,22023,1630581,22300724,"FEB 06, 2024",OKC @ UTA,L,26,3,8,0.375,2,4,0.5,0,0,0.0,0,3,3,2,0,1,1,3,8,-5,1,OKC,UTA,OKC,117,1.5,Turnovers,13,11,10,5
Josh Giddey,G,22023,1630581,22300710,"FEB 04, 2024",OKC vs. TOR,W,41,9,15,0.6,2,6,0.333,4,4,1.0,2,4,6,6,0,2,2,1,24,17,1,OKC,OKC,TOR,135,11.5,Points,36,30,30,12
Josh Giddey,G,22023,1630581,22300710,"FEB 04, 2024",OKC vs. TOR,W,41,9,15,0.6,2,6,0.333,4,4,1.0,2,4,6,6,0,2,2,1,24,17,1,OKC,OKC,TOR,135,6.0,Rebounds,36,30,30,12
Josh Giddey,G,22023,1630581,22300710,"FEB 04, 2024",OKC vs. TOR,W,41,9,15,0.6,2,6,0.333,4,4,1.0,2,4,6,6,0,2,2,1,24,17,1,OKC,OKC,TOR,135,21.5,Pts+Rebs+Asts,36,30,30,12
Josh Giddey,G,22023,1630581,22300710,"FEB 04, 2024",OKC vs. TOR,W,41,9,15,0.6,2,6,0.333,4,4,1.0,2,4,6,6,0,2,2,1,24,17,1,OKC,OKC,TOR,135,4.0,Assists,36,30,30,12
Josh Giddey,G,22023,1630581,22300710,"FEB 04, 2024",OKC vs. TOR,W,41,9,15,0.6,2,6,0.333,4,4,1.0,2,4,6,6,0,2,2,1,24,17,1,OKC,OKC,TOR,135,26.0,Fantasy Score,36,30,30,12
Josh Giddey,G,22023,1630581,22300710,"FEB 04, 2024",OKC vs. TOR,W,41,9,15,0.6,2,6,0.333,4,4,1.0,2,4,6,6,0,2,2,1,24,17,1,OKC,OKC,TOR,135,17.5,Pts+Rebs,36,30,30,12
Josh Giddey,G,22023,1630581,22300710,"FEB 04, 2024",OKC vs. TOR,W,41,9,15,0.6,2,6,0.333,4,4,1.0,2,4,6,6,0,2,2,1,24,17,1,OKC,OKC,TOR,135,15.5,Pts+Asts,36,30,30,12
Josh Giddey,G,22023,1630581,22300710,"FEB 04, 2024",OKC vs. TOR,W,41,9,15,0.6,2,6,0.333,4,4,1.0,2,4,6,6,0,2,2,1,24,17,1,OKC,OKC,TOR,135,0.5,Steals,36,30,30,12
Josh Giddey,G,22023,1630581,22300710,"FEB 04, 2024",OKC vs. TOR,W,41,9,15,0.6,2,6,0.333,4,4,1.0,2,4,6,6,0,2,2,1,24,17,1,OKC,OKC,TOR,135,10.5,Rebs+Asts,36,30,30,12
Josh Giddey,G,22023,1630581,22300710,"FEB 04, 2024",OKC vs. TOR,W,41,9,15,0.6,2,6,0.333,4,4,1.0,2,4,6,6,0,2,2,1,24,17,1,OKC,OKC,TOR,135,1.5,Turnovers,36,30,30,12
Josh Giddey,G,22023,1630581,22300695,"FEB 02, 2024",OKC vs. CHA,W,19,3,8,0.375,0,2,0.0,2,2,1.0,0,6,6,4,1,1,2,0,8,16,1,OKC,OKC,CHA,126,11.5,Points,18,14,12,10
Josh Giddey,G,22023,1630581,22300695,"FEB 02, 2024",OKC vs. CHA,W,19,3,8,0.375,0,2,0.0,2,2,1.0,0,6,6,4,1,1,2,0,8,16,1,OKC,OKC,CHA,126,6.0,Rebounds,18,14,12,10
Josh Giddey,G,22023,1630581,22300695,"FEB 02, 2024",OKC vs. CHA,W,19,3,8,0.375,0,2,0.0,2,2,1.0,0,6,6,4,1,1,2,0,8,16,1,OKC,OKC,CHA,126,21.5,Pts+Rebs+Asts,18,14,12,10
Josh Giddey,G,22023,1630581,22300695,"FEB 02, 2024",OKC vs. CHA,W,19,3,8,0.375,0,2,0.0,2,2,1.0,0,6,6,4,1,1,2,0,8,16,1,OKC,OKC,CHA,126,4.0,Assists,18,14,12,10
Josh Giddey,G,22023,1630581,22300695,"FEB 02, 2024",OKC vs. CHA,W,19,3,8,0.375,0,2,0.0,2,2,1.0,0,6,6,4,1,1,2,0,8,16,1,OKC,OKC,CHA,126,26.0,Fantasy Score,18,14,12,10
Josh Giddey,G,22023,1630581,22300695,"FEB 02, 2024",OKC vs. CHA,W,19,3,8,0.375,0,2,0.0,2,2,1.0,0,6,6,4,1,1,2,0,8,16,1,OKC,OKC,CHA,126,17.5,Pts+Rebs,18,14,12,10
Josh Giddey,G,22023,1630581,22300695,"FEB 02, 2024",OKC vs. CHA,W,19,3,8,0.375,0,2,0.0,2,2,1.0,0,6,6,4,1,1,2,0,8,16,1,OKC,OKC,CHA,126,15.5,Pts+Asts,18,14,12,10
Josh Giddey,G,22023,1630581,22300695,"FEB 02, 2024",OKC vs. CHA,W,19,3,8,0.375,0,2,0.0,2,2,1.0,0,6,6,4,1,1,2,0,8,16,1,OKC,OKC,CHA,126,0.5,Steals,18,14,12,10
Josh Giddey,G,22023,1630581,22300695,"FEB 02, 2024",OKC vs. CHA,W,19,3,8,0.375,0,2,0.0,2,2,1.0,0,6,6,4,1,1,2,0,8,16,1,OKC,OKC,CHA,126,10.5,Rebs+Asts,18,14,12,10
Josh Giddey,G,22023,1630581,22300695,"FEB 02, 2024",OKC vs. CHA,W,19,3,8,0.375,0,2,0.0,2,2,1.0,0,6,6,4,1,1,2,0,8,16,1,OKC,OKC,CHA,126,1.5,Turnovers,18,14,12,10
Josh Giddey,G,22023,1630581,22300568,"JAN 16, 2024",OKC @ LAC,L,19,4,9,0.444,1,3,0.333,0,0,0.0,1,3,4,4,0,0,0,0,9,-2,1,OKC,LAC,OKC,117,11.5,Points,17,13,13,8
Josh Giddey,G,22023,1630581,22300568,"JAN 16, 2024",OKC @ LAC,L,19,4,9,0.444,1,3,0.333,0,0,0.0,1,3,4,4,0,0,0,0,9,-2,1,OKC,LAC,OKC,117,6.0,Rebounds,17,13,13,8
Josh Giddey,G,22023,1630581,22300568,"JAN 16, 2024",OKC @ LAC,L,19,4,9,0.444,1,3,0.333,0,0,0.0,1,3,4,4,0,0,0,0,9,-2,1,OKC,LAC,OKC,117,21.5,Pts+Rebs+Asts,17,13,13,8
Josh Giddey,G,22023,1630581,22300568,"JAN 16, 2024",OKC @ LAC,L,19,4,9,0.444,1,3,0.333,0,0,0.0,1,3,4,4,0,0,0,0,9,-2,1,OKC,LAC,OKC,117,4.0,Assists,17,13,13,8
Josh Giddey,G,22023,1630581,22300568,"JAN 16, 2024",OKC @ LAC,L,19,4,9,0.444,1,3,0.333,0,0,0.0,1,3,4,4,0,0,0,0,9,-2,1,OKC,LAC,OKC,117,26.0,Fantasy Score,17,13,13,8
Josh Giddey,G,22023,1630581,22300568,"JAN 16, 2024",OKC @ LAC,L,19,4,9,0.444,1,3,0.333,0,0,0.0,1,3,4,4,0,0,0,0,9,-2,1,OKC,LAC,OKC,117,17.5,Pts+Rebs,17,13,13,8
Josh Giddey,G,22023,1630581,22300568,"JAN 16, 2024",OKC @ LAC,L,19,4,9,0.444,1,3,0.333,0,0,0.0,1,3,4,4,0,0,0,0,9,-2,1,OKC,LAC,OKC,117,15.5,Pts+Asts,17,13,13,8
Josh Giddey,G,22023,1630581,22300568,"JAN 16, 2024",OKC @ LAC,L,19,4,9,0.444,1,3,0.333,0,0,0.0,1,3,4,4,0,0,0,0,9,-2,1,OKC,LAC,OKC,117,0.5,Steals,17,13,13,8
Josh Giddey,G,22023,1630581,22300568,"JAN 16, 2024",OKC @ LAC,L,19,4,9,0.444,1,3,0.333,0,0,0.0,1,3,4,4,0,0,0,0,9,-2,1,OKC,LAC,OKC,117,10.5,Rebs+Asts,17,13,13,8
Josh Giddey,G,22023,1630581,22300568,"JAN 16, 2024",OKC @ LAC,L,19,4,9,0.444,1,3,0.333,0,0,0.0,1,3,4,4,0,0,0,0,9,-2,1,OKC,LAC,OKC,117,1.5,Turnovers,17,13,13,8
Josh Giddey,G,22023,1630581,22300565,"JAN 15, 2024",OKC @ LAL,L,22,2,8,0.25,2,5,0.4,2,2,1.0,2,3,5,3,0,1,0,1,8,-6,1,OKC,LAL,OKC,105,11.5,Points,16,13,11,8
Josh Giddey,G,22023,1630581,22300565,"JAN 15, 2024",OKC @ LAL,L,22,2,8,0.25,2,5,0.4,2,2,1.0,2,3,5,3,0,1,0,1,8,-6,1,OKC,LAL,OKC,105,6.0,Rebounds,16,13,11,8
Josh Giddey,G,22023,1630581,22300565,"JAN 15, 2024",OKC @ LAL,L,22,2,8,0.25,2,5,0.4,2,2,1.0,2,3,5,3,0,1,0,1,8,-6,1,OKC,LAL,OKC,105,21.5,Pts+Rebs+Asts,16,13,11,8
Josh Giddey,G,22023,1630581,22300565,"JAN 15, 2024",OKC @ LAL,L,22,2,8,0.25,2,5,0.4,2,2,1.0,2,3,5,3,0,1,0,1,8,-6,1,OKC,LAL,OKC,105,4.0,Assists,16,13,11,8
Josh Giddey,G,22023,1630581,22300565,"JAN 15, 2024",OKC @ LAL,L,22,2,8,0.25,2,5,0.4,2,2,1.0,2,3,5,3,0,1,0,1,8,-6,1,OKC,LAL,OKC,105,26.0,Fantasy Score,16,13,11,8
Josh Giddey,G,22023,1630581,22300565,"JAN 15, 2024",OKC @ LAL,L,22,2,8,0.25,2,5,0.4,2,2,1.0,2,3,5,3,0,1,0,1,8,-6,1,OKC,LAL,OKC,105,17.5,Pts+Rebs,16,13,11,8
Josh Giddey,G,22023,1630581,22300565,"JAN 15, 2024",OKC @ LAL,L,22,2,8,0.25,2,5,0.4,2,2,1.0,2,3,5,3,0,1,0,1,8,-6,1,OKC,LAL,OKC,105,15.5,Pts+Asts,16,13,11,8
Josh Giddey,G,22023,1630581,22300565,"JAN 15, 2024",OKC @ LAL,L,22,2,8,0.25,2,5,0.4,2,2,1.0,2,3,5,3,0,1,0,1,8,-6,1,OKC,LAL,OKC,105,0.5,Steals,16,13,11,8
Josh Giddey,G,22023,1630581,22300565,"JAN 15, 2024",OKC @ LAL,L,22,2,8,0.25,2,5,0.4,2,2,1.0,2,3,5,3,0,1,0,1,8,-6,1,OKC,LAL,OKC,105,10.5,Rebs+Asts,16,13,11,8
Josh Giddey,G,22023,1630581,22300565,"JAN 15, 2024",OKC @ LAL,L,22,2,8,0.25,2,5,0.4,2,2,1.0,2,3,5,3,0,1,0,1,8,-6,1,OKC,LAL,OKC,105,1.5,Turnovers,16,13,11,8
Josh Giddey,G,22023,1630581,22300546,"JAN 13, 2024",OKC vs. ORL,W,27,4,12,0.333,1,5,0.2,3,4,0.75,1,7,8,4,1,0,0,1,12,15,1,OKC,OKC,ORL,112,11.5,Points,24,20,16,12
Josh Giddey,G,22023,1630581,22300546,"JAN 13, 2024",OKC vs. ORL,W,27,4,12,0.333,1,5,0.2,3,4,0.75,1,7,8,4,1,0,0,1,12,15,1,OKC,OKC,ORL,112,6.0,Rebounds,24,20,16,12
Josh Giddey,G,22023,1630581,22300546,"JAN 13, 2024",OKC vs. ORL,W,27,4,12,0.333,1,5,0.2,3,4,0.75,1,7,8,4,1,0,0,1,12,15,1,OKC,OKC,ORL,112,21.5,Pts+Rebs+Asts,24,20,16,12
Josh Giddey,G,22023,1630581,22300546,"JAN 13, 2024",OKC vs. ORL,W,27,4,12,0.333,1,5,0.2,3,4,0.75,1,7,8,4,1,0,0,1,12,15,1,OKC,OKC,ORL,112,4.0,Assists,24,20,16,12
Josh Giddey,G,22023,1630581,22300546,"JAN 13, 2024",OKC vs. ORL,W,27,4,12,0.333,1,5,0.2,3,4,0.75,1,7,8,4,1,0,0,1,12,15,1,OKC,OKC,ORL,112,26.0,Fantasy Score,24,20,16,12
Josh Giddey,G,22023,1630581,22300546,"JAN 13, 2024",OKC vs. ORL,W,27,4,12,0.333,1,5,0.2,3,4,0.75,1,7,8,4,1,0,0,1,12,15,1,OKC,OKC,ORL,112,17.5,Pts+Rebs,24,20,16,12
Josh Giddey,G,22023,1630581,22300546,"JAN 13, 2024",OKC vs. ORL,W,27,4,12,0.333,1,5,0.2,3,4,0.75,1,7,8,4,1,0,0,1,12,15,1,OKC,OKC,ORL,112,15.5,Pts+Asts,24,20,16,12
Josh Giddey,G,22023,1630581,22300546,"JAN 13, 2024",OKC vs. ORL,W,27,4,12,0.333,1,5,0.2,3,4,0.75,1,7,8,4,1,0,0,1,12,15,1,OKC,OKC,ORL,112,0.5,Steals,24,20,16,12
Josh Giddey,G,22023,1630581,22300546,"JAN 13, 2024",OKC vs. ORL,W,27,4,12,0.333,1,5,0.2,3,4,0.75,1,7,8,4,1,0,0,1,12,15,1,OKC,OKC,ORL,112,10.5,Rebs+Asts,24,20,16,12
Josh Giddey,G,22023,1630581,22300546,"JAN 13, 2024",OKC vs. ORL,W,27,4,12,0.333,1,5,0.2,3,4,0.75,1,7,8,4,1,0,0,1,12,15,1,OKC,OKC,ORL,112,1.5,Turnovers,24,20,16,12
Josh Giddey,G,22023,1630581,22300529,"JAN 11, 2024",OKC vs. POR,W,23,5,5,1.0,0,0,0.0,3,3,1.0,0,10,10,12,0,3,1,0,13,46,1,OKC,OKC,POR,139,11.5,Points,35,23,25,22
Josh Giddey,G,22023,1630581,22300529,"JAN 11, 2024",OKC vs. POR,W,23,5,5,1.0,0,0,0.0,3,3,1.0,0,10,10,12,0,3,1,0,13,46,1,OKC,OKC,POR,139,6.0,Rebounds,35,23,25,22
Josh Giddey,G,22023,1630581,22300529,"JAN 11, 2024",OKC vs. POR,W,23,5,5,1.0,0,0,0.0,3,3,1.0,0,10,10,12,0,3,1,0,13,46,1,OKC,OKC,POR,139,21.5,Pts+Rebs+Asts,35,23,25,22
Josh Giddey,G,22023,1630581,22300529,"JAN 11, 2024",OKC vs. POR,W,23,5,5,1.0,0,0,0.0,3,3,1.0,0,10,10,12,0,3,1,0,13,46,1,OKC,OKC,POR,139,4.0,Assists,35,23,25,22
Josh Giddey,G,22023,1630581,22300529,"JAN 11, 2024",OKC vs. POR,W,23,5,5,1.0,0,0,0.0,3,3,1.0,0,10,10,12,0,3,1,0,13,46,1,OKC,OKC,POR,139,26.0,Fantasy Score,35,23,25,22
Josh Giddey,G,22023,1630581,22300529,"JAN 11, 2024",OKC vs. POR,W,23,5,5,1.0,0,0,0.0,3,3,1.0,0,10,10,12,0,3,1,0,13,46,1,OKC,OKC,POR,139,17.5,Pts+Rebs,35,23,25,22
Josh Giddey,G,22023,1630581,22300529,"JAN 11, 2024",OKC vs. POR,W,23,5,5,1.0,0,0,0.0,3,3,1.0,0,10,10,12,0,3,1,0,13,46,1,OKC,OKC,POR,139,15.5,Pts+Asts,35,23,25,22
Josh Giddey,G,22023,1630581,22300529,"JAN 11, 2024",OKC vs. POR,W,23,5,5,1.0,0,0,0.0,3,3,1.0,0,10,10,12,0,3,1,0,13,46,1,OKC,OKC,POR,139,0.5,Steals,35,23,25,22
Josh Giddey,G,22023,1630581,22300529,"JAN 11, 2024",OKC vs. POR,W,23,5,5,1.0,0,0,0.0,3,3,1.0,0,10,10,12,0,3,1,0,13,46,1,OKC,OKC,POR,139,10.5,Rebs+Asts,35,23,25,22
Josh Giddey,G,22023,1630581,22300529,"JAN 11, 2024",OKC vs. POR,W,23,5,5,1.0,0,0,0.0,3,3,1.0,0,10,10,12,0,3,1,0,13,46,1,OKC,OKC,POR,139,1.5,Turnovers,35,23,25,22
Josh Giddey,G,22023,1630581,22300379,"DEC 21, 2023",OKC vs. LAC,W,14,4,5,0.8,3,3,1.0,0,0,0.0,1,2,3,4,0,0,5,0,11,2,1,OKC,OKC,LAC,134,11.5,Points,18,14,15,7
Josh Giddey,G,22023,1630581,22300379,"DEC 21, 2023",OKC vs. LAC,W,14,4,5,0.8,3,3,1.0,0,0,0.0,1,2,3,4,0,0,5,0,11,2,1,OKC,OKC,LAC,134,6.0,Rebounds,18,14,15,7
Josh Giddey,G,22023,1630581,22300379,"DEC 21, 2023",OKC vs. LAC,W,14,4,5,0.8,3,3,1.0,0,0,0.0,1,2,3,4,0,0,5,0,11,2,1,OKC,OKC,LAC,134,21.5,Pts+Rebs+Asts,18,14,15,7
Josh Giddey,G,22023,1630581,22300379,"DEC 21, 2023",OKC vs. LAC,W,14,4,5,0.8,3,3,1.0,0,0,0.0,1,2,3,4,0,0,5,0,11,2,1,OKC,OKC,LAC,134,4.0,Assists,18,14,15,7
Josh Giddey,G,22023,1630581,22300379,"DEC 21, 2023",OKC vs. LAC,W,14,4,5,0.8,3,3,1.0,0,0,0.0,1,2,3,4,0,0,5,0,11,2,1,OKC,OKC,LAC,134,26.0,Fantasy Score,18,14,15,7
Josh Giddey,G,22023,1630581,22300379,"DEC 21, 2023",OKC vs. LAC,W,14,4,5,0.8,3,3,1.0,0,0,0.0,1,2,3,4,0,0,5,0,11,2,1,OKC,OKC,LAC,134,17.5,Pts+Rebs,18,14,15,7
Josh Giddey,G,22023,1630581,22300379,"DEC 21, 2023",OKC vs. LAC,W,14,4,5,0.8,3,3,1.0,0,0,0.0,1,2,3,4,0,0,5,0,11,2,1,OKC,OKC,LAC,134,15.5,Pts+Asts,18,14,15,7
Josh Giddey,G,22023,1630581,22300379,"DEC 21, 2023",OKC vs. LAC,W,14,4,5,0.8,3,3,1.0,0,0,0.0,1,2,3,4,0,0,5,0,11,2,1,OKC,OKC,LAC,134,0.5,Steals,18,14,15,7
Josh Giddey,G,22023,1630581,22300379,"DEC 21, 2023",OKC vs. LAC,W,14,4,5,0.8,3,3,1.0,0,0,0.0,1,2,3,4,0,0,5,0,11,2,1,OKC,OKC,LAC,134,10.5,Rebs+Asts,18,14,15,7
Josh Giddey,G,22023,1630581,22300379,"DEC 21, 2023",OKC vs. LAC,W,14,4,5,0.8,3,3,1.0,0,0,0.0,1,2,3,4,0,0,5,0,11,2,1,OKC,OKC,LAC,134,1.5,Turnovers,18,14,15,7
Josh Giddey,G,22023,1630581,22300355,"DEC 18, 2023",OKC vs. MEM,W,24,6,12,0.5,0,4,0.0,4,4,1.0,3,9,12,4,1,0,1,0,16,16,1,OKC,OKC,MEM,116,11.5,Points,32,28,20,16
Josh Giddey,G,22023,1630581,22300355,"DEC 18, 2023",OKC vs. MEM,W,24,6,12,0.5,0,4,0.0,4,4,1.0,3,9,12,4,1,0,1,0,16,16,1,OKC,OKC,MEM,116,6.0,Rebounds,32,28,20,16
Josh Giddey,G,22023,1630581,22300355,"DEC 18, 2023",OKC vs. MEM,W,24,6,12,0.5,0,4,0.0,4,4,1.0,3,9,12,4,1,0,1,0,16,16,1,OKC,OKC,MEM,116,21.5,Pts+Rebs+Asts,32,28,20,16
Josh Giddey,G,22023,1630581,22300355,"DEC 18, 2023",OKC vs. MEM,W,24,6,12,0.5,0,4,0.0,4,4,1.0,3,9,12,4,1,0,1,0,16,16,1,OKC,OKC,MEM,116,4.0,Assists,32,28,20,16
Josh Giddey,G,22023,1630581,22300355,"DEC 18, 2023",OKC vs. MEM,W,24,6,12,0.5,0,4,0.0,4,4,1.0,3,9,12,4,1,0,1,0,16,16,1,OKC,OKC,MEM,116,26.0,Fantasy Score,32,28,20,16
Josh Giddey,G,22023,1630581,22300355,"DEC 18, 2023",OKC vs. MEM,W,24,6,12,0.5,0,4,0.0,4,4,1.0,3,9,12,4,1,0,1,0,16,16,1,OKC,OKC,MEM,116,17.5,Pts+Rebs,32,28,20,16
Josh Giddey,G,22023,1630581,22300355,"DEC 18, 2023",OKC vs. MEM,W,24,6,12,0.5,0,4,0.0,4,4,1.0,3,9,12,4,1,0,1,0,16,16,1,OKC,OKC,MEM,116,15.5,Pts+Asts,32,28,20,16
Josh Giddey,G,22023,1630581,22300355,"DEC 18, 2023",OKC vs. MEM,W,24,6,12,0.5,0,4,0.0,4,4,1.0,3,9,12,4,1,0,1,0,16,16,1,OKC,OKC,MEM,116,0.5,Steals,32,28,20,16
Josh Giddey,G,22023,1630581,22300355,"DEC 18, 2023",OKC vs. MEM,W,24,6,12,0.5,0,4,0.0,4,4,1.0,3,9,12,4,1,0,1,0,16,16,1,OKC,OKC,MEM,116,10.5,Rebs+Asts,32,28,20,16
Josh Giddey,G,22023,1630581,22300355,"DEC 18, 2023",OKC vs. MEM,W,24,6,12,0.5,0,4,0.0,4,4,1.0,3,9,12,4,1,0,1,0,16,16,1,OKC,OKC,MEM,116,1.5,Turnovers,32,28,20,16
Josh Giddey,G,22023,1630581,22300340,"DEC 16, 2023",OKC @ DEN,W,15,2,4,0.5,0,1,0.0,0,0,0.0,0,2,2,4,0,0,1,0,4,-7,1,OKC,DEN,OKC,118,11.5,Points,10,6,8,6
Josh Giddey,G,22023,1630581,22300340,"DEC 16, 2023",OKC @ DEN,W,15,2,4,0.5,0,1,0.0,0,0,0.0,0,2,2,4,0,0,1,0,4,-7,1,OKC,DEN,OKC,118,6.0,Rebounds,10,6,8,6
Josh Giddey,G,22023,1630581,22300340,"DEC 16, 2023",OKC @ DEN,W,15,2,4,0.5,0,1,0.0,0,0,0.0,0,2,2,4,0,0,1,0,4,-7,1,OKC,DEN,OKC,118,21.5,Pts+Rebs+Asts,10,6,8,6
Josh Giddey,G,22023,1630581,22300340,"DEC 16, 2023",OKC @ DEN,W,15,2,4,0.5,0,1,0.0,0,0,0.0,0,2,2,4,0,0,1,0,4,-7,1,OKC,DEN,OKC,118,4.0,Assists,10,6,8,6
Josh Giddey,G,22023,1630581,22300340,"DEC 16, 2023",OKC @ DEN,W,15,2,4,0.5,0,1,0.0,0,0,0.0,0,2,2,4,0,0,1,0,4,-7,1,OKC,DEN,OKC,118,26.0,Fantasy Score,10,6,8,6
Josh Giddey,G,22023,1630581,22300340,"DEC 16, 2023",OKC @ DEN,W,15,2,4,0.5,0,1,0.0,0,0,0.0,0,2,2,4,0,0,1,0,4,-7,1,OKC,DEN,OKC,118,17.5,Pts+Rebs,10,6,8,6
Josh Giddey,G,22023,1630581,22300340,"DEC 16, 2023",OKC @ DEN,W,15,2,4,0.5,0,1,0.0,0,0,0.0,0,2,2,4,0,0,1,0,4,-7,1,OKC,DEN,OKC,118,15.5,Pts+Asts,10,6,8,6
Josh Giddey,G,22023,1630581,22300340,"DEC 16, 2023",OKC @ DEN,W,15,2,4,0.5,0,1,0.0,0,0,0.0,0,2,2,4,0,0,1,0,4,-7,1,OKC,DEN,OKC,118,0.5,Steals,10,6,8,6
Josh Giddey,G,22023,1630581,22300340,"DEC 16, 2023",OKC @ DEN,W,15,2,4,0.5,0,1,0.0,0,0,0.0,0,2,2,4,0,0,1,0,4,-7,1,OKC,DEN,OKC,118,10.5,Rebs+Asts,10,6,8,6
Josh Giddey,G,22023,1630581,22300340,"DEC 16, 2023",OKC @ DEN,W,15,2,4,0.5,0,1,0.0,0,0,0.0,0,2,2,4,0,0,1,0,4,-7,1,OKC,DEN,OKC,118,1.5,Turnovers,10,6,8,6
Josh Giddey,G,22023,1630581,22300058,"NOV 28, 2023",OKC @ MIN,L,28,4,8,0.5,0,1,0.0,2,4,0.5,3,3,6,1,0,0,2,1,10,-10,1,OKC,MIN,OKC,103,11.5,Points,17,16,11,7
Josh Giddey,G,22023,1630581,22300058,"NOV 28, 2023",OKC @ MIN,L,28,4,8,0.5,0,1,0.0,2,4,0.5,3,3,6,1,0,0,2,1,10,-10,1,OKC,MIN,OKC,103,6.0,Rebounds,17,16,11,7
Josh Giddey,G,22023,1630581,22300058,"NOV 28, 2023",OKC @ MIN,L,28,4,8,0.5,0,1,0.0,2,4,0.5,3,3,6,1,0,0,2,1,10,-10,1,OKC,MIN,OKC,103,21.5,Pts+Rebs+Asts,17,16,11,7
Josh Giddey,G,22023,1630581,22300058,"NOV 28, 2023",OKC @ MIN,L,28,4,8,0.5,0,1,0.0,2,4,0.5,3,3,6,1,0,0,2,1,10,-10,1,OKC,MIN,OKC,103,4.0,Assists,17,16,11,7
Josh Giddey,G,22023,1630581,22300058,"NOV 28, 2023",OKC @ MIN,L,28,4,8,0.5,0,1,0.0,2,4,0.5,3,3,6,1,0,0,2,1,10,-10,1,OKC,MIN,OKC,103,26.0,Fantasy Score,17,16,11,7
Josh Giddey,G,22023,1630581,22300058,"NOV 28, 2023",OKC @ MIN,L,28,4,8,0.5,0,1,0.0,2,4,0.5,3,3,6,1,0,0,2,1,10,-10,1,OKC,MIN,OKC,103,17.5,Pts+Rebs,17,16,11,7
Josh Giddey,G,22023,1630581,22300058,"NOV 28, 2023",OKC @ MIN,L,28,4,8,0.5,0,1,0.0,2,4,0.5,3,3,6,1,0,0,2,1,10,-10,1,OKC,MIN,OKC,103,15.5,Pts+Asts,17,16,11,7
Josh Giddey,G,22023,1630581,22300058,"NOV 28, 2023",OKC @ MIN,L,28,4,8,0.5,0,1,0.0,2,4,0.5,3,3,6,1,0,0,2,1,10,-10,1,OKC,MIN,OKC,103,0.5,Steals,17,16,11,7
Josh Giddey,G,22023,1630581,22300058,"NOV 28, 2023",OKC @ MIN,L,28,4,8,0.5,0,1,0.0,2,4,0.5,3,3,6,1,0,0,2,1,10,-10,1,OKC,MIN,OKC,103,10.5,Rebs+Asts,17,16,11,7
Josh Giddey,G,22023,1630581,22300058,"NOV 28, 2023",OKC @ MIN,L,28,4,8,0.5,0,1,0.0,2,4,0.5,3,3,6,1,0,0,2,1,10,-10,1,OKC,MIN,OKC,103,1.5,Turnovers,17,16,11,7
Josh Giddey,G,22023,1630581,22300016,"NOV 10, 2023",OKC @ SAC,L,27,6,10,0.6,0,1,0.0,1,1,1.0,1,3,4,5,0,0,4,1,13,-19,1,OKC,SAC,OKC,98,11.5,Points,22,17,18,9
Josh Giddey,G,22023,1630581,22300016,"NOV 10, 2023",OKC @ SAC,L,27,6,10,0.6,0,1,0.0,1,1,1.0,1,3,4,5,0,0,4,1,13,-19,1,OKC,SAC,OKC,98,6.0,Rebounds,22,17,18,9
Josh Giddey,G,22023,1630581,22300016,"NOV 10, 2023",OKC @ SAC,L,27,6,10,0.6,0,1,0.0,1,1,1.0,1,3,4,5,0,0,4,1,13,-19,1,OKC,SAC,OKC,98,21.5,Pts+Rebs+Asts,22,17,18,9
Josh Giddey,G,22023,1630581,22300016,"NOV 10, 2023",OKC @ SAC,L,27,6,10,0.6,0,1,0.0,1,1,1.0,1,3,4,5,0,0,4,1,13,-19,1,OKC,SAC,OKC,98,4.0,Assists,22,17,18,9
Josh Giddey,G,22023,1630581,22300016,"NOV 10, 2023",OKC @ SAC,L,27,6,10,0.6,0,1,0.0,1,1,1.0,1,3,4,5,0,0,4,1,13,-19,1,OKC,SAC,OKC,98,26.0,Fantasy Score,22,17,18,9
Josh Giddey,G,22023,1630581,22300016,"NOV 10, 2023",OKC @ SAC,L,27,6,10,0.6,0,1,0.0,1,1,1.0,1,3,4,5,0,0,4,1,13,-19,1,OKC,SAC,OKC,98,17.5,Pts+Rebs,22,17,18,9
Josh Giddey,G,22023,1630581,22300016,"NOV 10, 2023",OKC @ SAC,L,27,6,10,0.6,0,1,0.0,1,1,1.0,1,3,4,5,0,0,4,1,13,-19,1,OKC,SAC,OKC,98,15.5,Pts+Asts,22,17,18,9
Josh Giddey,G,22023,1630581,22300016,"NOV 10, 2023",OKC @ SAC,L,27,6,10,0.6,0,1,0.0,1,1,1.0,1,3,4,5,0,0,4,1,13,-19,1,OKC,SAC,OKC,98,0.5,Steals,22,17,18,9
Josh Giddey,G,22023,1630581,22300016,"NOV 10, 2023",OKC @ SAC,L,27,6,10,0.6,0,1,0.0,1,1,1.0,1,3,4,5,0,0,4,1,13,-19,1,OKC,SAC,OKC,98,10.5,Rebs+Asts,22,17,18,9
Josh Giddey,G,22023,1630581,22300016,"NOV 10, 2023",OKC @ SAC,L,27,6,10,0.6,0,1,0.0,1,1,1.0,1,3,4,5,0,0,4,1,13,-19,1,OKC,SAC,OKC,98,1.5,Turnovers,22,17,18,9
Josh Giddey,G,22023,1630581,22300155,"NOV 06, 2023",OKC vs. ATL,W,27,4,13,0.308,0,0,0.0,0,0,0.0,3,4,7,4,0,0,4,3,8,8,1,OKC,OKC,ATL,126,11.5,Points,19,15,12,11
Josh Giddey,G,22023,1630581,22300155,"NOV 06, 2023",OKC vs. ATL,W,27,4,13,0.308,0,0,0.0,0,0,0.0,3,4,7,4,0,0,4,3,8,8,1,OKC,OKC,ATL,126,6.0,Rebounds,19,15,12,11
Josh Giddey,G,22023,1630581,22300155,"NOV 06, 2023",OKC vs. ATL,W,27,4,13,0.308,0,0,0.0,0,0,0.0,3,4,7,4,0,0,4,3,8,8,1,OKC,OKC,ATL,126,21.5,Pts+Rebs+Asts,19,15,12,11
Josh Giddey,G,22023,1630581,22300155,"NOV 06, 2023",OKC vs. ATL,W,27,4,13,0.308,0,0,0.0,0,0,0.0,3,4,7,4,0,0,4,3,8,8,1,OKC,OKC,ATL,126,4.0,Assists,19,15,12,11
Josh Giddey,G,22023,1630581,22300155,"NOV 06, 2023",OKC vs. ATL,W,27,4,13,0.308,0,0,0.0,0,0,0.0,3,4,7,4,0,0,4,3,8,8,1,OKC,OKC,ATL,126,26.0,Fantasy Score,19,15,12,11
Josh Giddey,G,22023,1630581,22300155,"NOV 06, 2023",OKC vs. ATL,W,27,4,13,0.308,0,0,0.0,0,0,0.0,3,4,7,4,0,0,4,3,8,8,1,OKC,OKC,ATL,126,17.5,Pts+Rebs,19,15,12,11
Josh Giddey,G,22023,1630581,22300155,"NOV 06, 2023",OKC vs. ATL,W,27,4,13,0.308,0,0,0.0,0,0,0.0,3,4,7,4,0,0,4,3,8,8,1,OKC,OKC,ATL,126,15.5,Pts+Asts,19,15,12,11
Josh Giddey,G,22023,1630581,22300155,"NOV 06, 2023",OKC vs. ATL,W,27,4,13,0.308,0,0,0.0,0,0,0.0,3,4,7,4,0,0,4,3,8,8,1,OKC,OKC,ATL,126,0.5,Steals,19,15,12,11
Josh Giddey,G,22023,1630581,22300155,"NOV 06, 2023",OKC vs. ATL,W,27,4,13,0.308,0,0,0.0,0,0,0.0,3,4,7,4,0,0,4,3,8,8,1,OKC,OKC,ATL,126,10.5,Rebs+Asts,19,15,12,11
Josh Giddey,G,22023,1630581,22300155,"NOV 06, 2023",OKC vs. ATL,W,27,4,13,0.308,0,0,0.0,0,0,0.0,3,4,7,4,0,0,4,3,8,8,1,OKC,OKC,ATL,126,1.5,Turnovers,19,15,12,11
Josh Giddey,G,22023,1630581,22300005,"NOV 03, 2023",OKC vs. GSW,L,31,8,15,0.533,0,3,0.0,2,2,1.0,0,5,5,4,0,0,6,2,18,4,1,OKC,OKC,GSW,139,11.5,Points,27,23,22,9
Josh Giddey,G,22023,1630581,22300005,"NOV 03, 2023",OKC vs. GSW,L,31,8,15,0.533,0,3,0.0,2,2,1.0,0,5,5,4,0,0,6,2,18,4,1,OKC,OKC,GSW,139,6.0,Rebounds,27,23,22,9
Josh Giddey,G,22023,1630581,22300005,"NOV 03, 2023",OKC vs. GSW,L,31,8,15,0.533,0,3,0.0,2,2,1.0,0,5,5,4,0,0,6,2,18,4,1,OKC,OKC,GSW,139,21.5,Pts+Rebs+Asts,27,23,22,9
Josh Giddey,G,22023,1630581,22300005,"NOV 03, 2023",OKC vs. GSW,L,31,8,15,0.533,0,3,0.0,2,2,1.0,0,5,5,4,0,0,6,2,18,4,1,OKC,OKC,GSW,139,4.0,Assists,27,23,22,9
Josh Giddey,G,22023,1630581,22300005,"NOV 03, 2023",OKC vs. GSW,L,31,8,15,0.533,0,3,0.0,2,2,1.0,0,5,5,4,0,0,6,2,18,4,1,OKC,OKC,GSW,139,26.0,Fantasy Score,27,23,22,9
Josh Giddey,G,22023,1630581,22300005,"NOV 03, 2023",OKC vs. GSW,L,31,8,15,0.533,0,3,0.0,2,2,1.0,0,5,5,4,0,0,6,2,18,4,1,OKC,OKC,GSW,139,17.5,Pts+Rebs,27,23,22,9
Josh Giddey,G,22023,1630581,22300005,"NOV 03, 2023",OKC vs. GSW,L,31,8,15,0.533,0,3,0.0,2,2,1.0,0,5,5,4,0,0,6,2,18,4,1,OKC,OKC,GSW,139,15.5,Pts+Asts,27,23,22,9
Josh Giddey,G,22023,1630581,22300005,"NOV 03, 2023",OKC vs. GSW,L,31,8,15,0.533,0,3,0.0,2,2,1.0,0,5,5,4,0,0,6,2,18,4,1,OKC,OKC,GSW,139,0.5,Steals,27,23,22,9
Josh Giddey,G,22023,1630581,22300005,"NOV 03, 2023",OKC vs. GSW,L,31,8,15,0.533,0,3,0.0,2,2,1.0,0,5,5,4,0,0,6,2,18,4,1,OKC,OKC,GSW,139,10.5,Rebs+Asts,27,23,22,9
Josh Giddey,G,22023,1630581,22300005,"NOV 03, 2023",OKC vs. GSW,L,31,8,15,0.533,0,3,0.0,2,2,1.0,0,5,5,4,0,0,6,2,18,4,1,OKC,OKC,GSW,139,1.5,Turnovers,27,23,22,9
Josh Giddey,G,22023,1630581,22300121,"NOV 01, 2023",OKC vs. NOP,L,31,6,16,0.375,1,4,0.25,2,2,1.0,0,9,9,4,1,1,2,1,15,-6,1,OKC,OKC,NOP,106,11.5,Points,28,24,19,13
Josh Giddey,G,22023,1630581,22300121,"NOV 01, 2023",OKC vs. NOP,L,31,6,16,0.375,1,4,0.25,2,2,1.0,0,9,9,4,1,1,2,1,15,-6,1,OKC,OKC,NOP,106,6.0,Rebounds,28,24,19,13
Josh Giddey,G,22023,1630581,22300121,"NOV 01, 2023",OKC vs. NOP,L,31,6,16,0.375,1,4,0.25,2,2,1.0,0,9,9,4,1,1,2,1,15,-6,1,OKC,OKC,NOP,106,21.5,Pts+Rebs+Asts,28,24,19,13
Josh Giddey,G,22023,1630581,22300121,"NOV 01, 2023",OKC vs. NOP,L,31,6,16,0.375,1,4,0.25,2,2,1.0,0,9,9,4,1,1,2,1,15,-6,1,OKC,OKC,NOP,106,4.0,Assists,28,24,19,13
Josh Giddey,G,22023,1630581,22300121,"NOV 01, 2023",OKC vs. NOP,L,31,6,16,0.375,1,4,0.25,2,2,1.0,0,9,9,4,1,1,2,1,15,-6,1,OKC,OKC,NOP,106,26.0,Fantasy Score,28,24,19,13
Josh Giddey,G,22023,1630581,22300121,"NOV 01, 2023",OKC vs. NOP,L,31,6,16,0.375,1,4,0.25,2,2,1.0,0,9,9,4,1,1,2,1,15,-6,1,OKC,OKC,NOP,106,17.5,Pts+Rebs,28,24,19,13
Josh Giddey,G,22023,1630581,22300121,"NOV 01, 2023",OKC vs. NOP,L,31,6,16,0.375,1,4,0.25,2,2,1.0,0,9,9,4,1,1,2,1,15,-6,1,OKC,OKC,NOP,106,15.5,Pts+Asts,28,24,19,13
Josh Giddey,G,22023,1630581,22300121,"NOV 01, 2023",OKC vs. NOP,L,31,6,16,0.375,1,4,0.25,2,2,1.0,0,9,9,4,1,1,2,1,15,-6,1,OKC,OKC,NOP,106,0.5,Steals,28,24,19,13
Josh Giddey,G,22023,1630581,22300121,"NOV 01, 2023",OKC vs. NOP,L,31,6,16,0.375,1,4,0.25,2,2,1.0,0,9,9,4,1,1,2,1,15,-6,1,OKC,OKC,NOP,106,10.5,Rebs+Asts,28,24,19,13
Josh Giddey,G,22023,1630581,22300121,"NOV 01, 2023",OKC vs. NOP,L,31,6,16,0.375,1,4,0.25,2,2,1.0,0,9,9,4,1,1,2,1,15,-6,1,OKC,OKC,NOP,106,1.5,Turnovers,28,24,19,13
Josh Giddey,G,22023,1630581,22300095,"OCT 29, 2023",OKC vs. DEN,L,22,4,13,0.308,1,2,0.5,0,0,0.0,1,1,2,3,1,0,2,0,9,-18,1,OKC,OKC,DEN,95,11.5,Points,14,11,12,5
Josh Giddey,G,22023,1630581,22300095,"OCT 29, 2023",OKC vs. DEN,L,22,4,13,0.308,1,2,0.5,0,0,0.0,1,1,2,3,1,0,2,0,9,-18,1,OKC,OKC,DEN,95,6.0,Rebounds,14,11,12,5
Josh Giddey,G,22023,1630581,22300095,"OCT 29, 2023",OKC vs. DEN,L,22,4,13,0.308,1,2,0.5,0,0,0.0,1,1,2,3,1,0,2,0,9,-18,1,OKC,OKC,DEN,95,21.5,Pts+Rebs+Asts,14,11,12,5
Josh Giddey,G,22023,1630581,22300095,"OCT 29, 2023",OKC vs. DEN,L,22,4,13,0.308,1,2,0.5,0,0,0.0,1,1,2,3,1,0,2,0,9,-18,1,OKC,OKC,DEN,95,4.0,Assists,14,11,12,5
Josh Giddey,G,22023,1630581,22300095,"OCT 29, 2023",OKC vs. DEN,L,22,4,13,0.308,1,2,0.5,0,0,0.0,1,1,2,3,1,0,2,0,9,-18,1,OKC,OKC,DEN,95,26.0,Fantasy Score,14,11,12,5
Josh Giddey,G,22023,1630581,22300095,"OCT 29, 2023",OKC vs. DEN,L,22,4,13,0.308,1,2,0.5,0,0,0.0,1,1,2,3,1,0,2,0,9,-18,1,OKC,OKC,DEN,95,17.5,Pts+Rebs,14,11,12,5
Josh Giddey,G,22023,1630581,22300095,"OCT 29, 2023",OKC vs. DEN,L,22,4,13,0.308,1,2,0.5,0,0,0.0,1,1,2,3,1,0,2,0,9,-18,1,OKC,OKC,DEN,95,15.5,Pts+Asts,14,11,12,5
Josh Giddey,G,22023,1630581,22300095,"OCT 29, 2023",OKC vs. DEN,L,22,4,13,0.308,1,2,0.5,0,0,0.0,1,1,2,3,1,0,2,0,9,-18,1,OKC,OKC,DEN,95,0.5,Steals,14,11,12,5
Josh Giddey,G,22023,1630581,22300095,"OCT 29, 2023",OKC vs. DEN,L,22,4,13,0.308,1,2,0.5,0,0,0.0,1,1,2,3,1,0,2,0,9,-18,1,OKC,OKC,DEN,95,10.5,Rebs+Asts,14,11,12,5
Josh Giddey,G,22023,1630581,22300095,"OCT 29, 2023",OKC vs. DEN,L,22,4,13,0.308,1,2,0.5,0,0,0.0,1,1,2,3,1,0,2,0,9,-18,1,OKC,OKC,DEN,95,1.5,Turnovers,14,11,12,5
Josh Giddey,G,22023,1630581,22300081,"OCT 27, 2023",OKC @ CLE,W,28,1,8,0.125,0,1,0.0,0,0,0.0,0,6,6,6,0,0,3,1,2,-12,1,OKC,CLE,OKC,108,11.5,Points,14,8,8,12
Josh Giddey,G,22023,1630581,22300081,"OCT 27, 2023",OKC @ CLE,W,28,1,8,0.125,0,1,0.0,0,0,0.0,0,6,6,6,0,0,3,1,2,-12,1,OKC,CLE,OKC,108,6.0,Rebounds,14,8,8,12
Josh Giddey,G,22023,1630581,22300081,"OCT 27, 2023",OKC @ CLE,W,28,1,8,0.125,0,1,0.0,0,0,0.0,0,6,6,6,0,0,3,1,2,-12,1,OKC,CLE,OKC,108,21.5,Pts+Rebs+Asts,14,8,8,12
Josh Giddey,G,22023,1630581,22300081,"OCT 27, 2023",OKC @ CLE,W,28,1,8,0.125,0,1,0.0,0,0,0.0,0,6,6,6,0,0,3,1,2,-12,1,OKC,CLE,OKC,108,4.0,Assists,14,8,8,12
Josh Giddey,G,22023,1630581,22300081,"OCT 27, 2023",OKC @ CLE,W,28,1,8,0.125,0,1,0.0,0,0,0.0,0,6,6,6,0,0,3,1,2,-12,1,OKC,CLE,OKC,108,26.0,Fantasy Score,14,8,8,12
Josh Giddey,G,22023,1630581,22300081,"OCT 27, 2023",OKC @ CLE,W,28,1,8,0.125,0,1,0.0,0,0,0.0,0,6,6,6,0,0,3,1,2,-12,1,OKC,CLE,OKC,108,17.5,Pts+Rebs,14,8,8,12
Josh Giddey,G,22023,1630581,22300081,"OCT 27, 2023",OKC @ CLE,W,28,1,8,0.125,0,1,0.0,0,0,0.0,0,6,6,6,0,0,3,1,2,-12,1,OKC,CLE,OKC,108,15.5,Pts+Asts,14,8,8,12
Josh Giddey,G,22023,1630581,22300081,"OCT 27, 2023",OKC @ CLE,W,28,1,8,0.125,0,1,0.0,0,0,0.0,0,6,6,6,0,0,3,1,2,-12,1,OKC,CLE,OKC,108,0.5,Steals,14,8,8,12
Josh Giddey,G,22023,1630581,22300081,"OCT 27, 2023",OKC @ CLE,W,28,1,8,0.125,0,1,0.0,0,0,0.0,0,6,6,6,0,0,3,1,2,-12,1,OKC,CLE,OKC,108,10.5,Rebs+Asts,14,8,8,12
Josh Giddey,G,22023,1630581,22300081,"OCT 27, 2023",OKC @ CLE,W,28,1,8,0.125,0,1,0.0,0,0,0.0,0,6,6,6,0,0,3,1,2,-12,1,OKC,CLE,OKC,108,1.5,Turnovers,14,8,8,12
Josh Giddey,G,22023,1630581,22300070,"OCT 25, 2023",OKC @ CHI,W,32,7,14,0.5,2,3,0.667,0,0,0.0,1,5,6,6,0,0,3,1,16,19,1,OKC,CHI,OKC,124,11.5,Points,28,22,22,12
Josh Giddey,G,22023,1630581,22300070,"OCT 25, 2023",OKC @ CHI,W,32,7,14,0.5,2,3,0.667,0,0,0.0,1,5,6,6,0,0,3,1,16,19,1,OKC,CHI,OKC,124,6.0,Rebounds,28,22,22,12
Josh Giddey,G,22023,1630581,22300070,"OCT 25, 2023",OKC @ CHI,W,32,7,14,0.5,2,3,0.667,0,0,0.0,1,5,6,6,0,0,3,1,16,19,1,OKC,CHI,OKC,124,21.5,Pts+Rebs+Asts,28,22,22,12
Josh Giddey,G,22023,1630581,22300070,"OCT 25, 2023",OKC @ CHI,W,32,7,14,0.5,2,3,0.667,0,0,0.0,1,5,6,6,0,0,3,1,16,19,1,OKC,CHI,OKC,124,4.0,Assists,28,22,22,12
Josh Giddey,G,22023,1630581,22300070,"OCT 25, 2023",OKC @ CHI,W,32,7,14,0.5,2,3,0.667,0,0,0.0,1,5,6,6,0,0,3,1,16,19,1,OKC,CHI,OKC,124,26.0,Fantasy Score,28,22,22,12
Josh Giddey,G,22023,1630581,22300070,"OCT 25, 2023",OKC @ CHI,W,32,7,14,0.5,2,3,0.667,0,0,0.0,1,5,6,6,0,0,3,1,16,19,1,OKC,CHI,OKC,124,17.5,Pts+Rebs,28,22,22,12
Josh Giddey,G,22023,1630581,22300070,"OCT 25, 2023",OKC @ CHI,W,32,7,14,0.5,2,3,0.667,0,0,0.0,1,5,6,6,0,0,3,1,16,19,1,OKC,CHI,OKC,124,15.5,Pts+Asts,28,22,22,12
Josh Giddey,G,22023,1630581,22300070,"OCT 25, 2023",OKC @ CHI,W,32,7,14,0.5,2,3,0.667,0,0,0.0,1,5,6,6,0,0,3,1,16,19,1,OKC,CHI,OKC,124,0.5,Steals,28,22,22,12
Josh Giddey,G,22023,1630581,22300070,"OCT 25, 2023",OKC @ CHI,W,32,7,14,0.5,2,3,0.667,0,0,0.0,1,5,6,6,0,0,3,1,16,19,1,OKC,CHI,OKC,124,10.5,Rebs+Asts,28,22,22,12
Josh Giddey,G,22023,1630581,22300070,"OCT 25, 2023",OKC @ CHI,W,32,7,14,0.5,2,3,0.667,0,0,0.0,1,5,6,6,0,0,3,1,16,19,1,OKC,CHI,OKC,124,1.5,Turnovers,28,22,22,12
Josh Giddey,G,22023,1630581,22300664,"JAN 29, 2024",OKC vs. MIN,L,19,5,10,0.5,3,7,0.429,0,1,0.0,1,3,4,2,0,1,1,1,13,-17,1,OKC,OKC,MIN,101,11.5,Points,19,17,15,6
Josh Giddey,G,22023,1630581,22300664,"JAN 29, 2024",OKC vs. MIN,L,19,5,10,0.5,3,7,0.429,0,1,0.0,1,3,4,2,0,1,1,1,13,-17,1,OKC,OKC,MIN,101,6.0,Rebounds,19,17,15,6
Josh Giddey,G,22023,1630581,22300664,"JAN 29, 2024",OKC vs. MIN,L,19,5,10,0.5,3,7,0.429,0,1,0.0,1,3,4,2,0,1,1,1,13,-17,1,OKC,OKC,MIN,101,21.5,Pts+Rebs+Asts,19,17,15,6
Josh Giddey,G,22023,1630581,22300664,"JAN 29, 2024",OKC vs. MIN,L,19,5,10,0.5,3,7,0.429,0,1,0.0,1,3,4,2,0,1,1,1,13,-17,1,OKC,OKC,MIN,101,4.0,Assists,19,17,15,6
Josh Giddey,G,22023,1630581,22300664,"JAN 29, 2024",OKC vs. MIN,L,19,5,10,0.5,3,7,0.429,0,1,0.0,1,3,4,2,0,1,1,1,13,-17,1,OKC,OKC,MIN,101,26.0,Fantasy Score,19,17,15,6
Josh Giddey,G,22023,1630581,22300664,"JAN 29, 2024",OKC vs. MIN,L,19,5,10,0.5,3,7,0.429,0,1,0.0,1,3,4,2,0,1,1,1,13,-17,1,OKC,OKC,MIN,101,17.5,Pts+Rebs,19,17,15,6
Josh Giddey,G,22023,1630581,22300664,"JAN 29, 2024",OKC vs. MIN,L,19,5,10,0.5,3,7,0.429,0,1,0.0,1,3,4,2,0,1,1,1,13,-17,1,OKC,OKC,MIN,101,15.5,Pts+Asts,19,17,15,6
Josh Giddey,G,22023,1630581,22300664,"JAN 29, 2024",OKC vs. MIN,L,19,5,10,0.5,3,7,0.429,0,1,0.0,1,3,4,2,0,1,1,1,13,-17,1,OKC,OKC,MIN,101,0.5,Steals,19,17,15,6
Josh Giddey,G,22023,1630581,22300664,"JAN 29, 2024",OKC vs. MIN,L,19,5,10,0.5,3,7,0.429,0,1,0.0,1,3,4,2,0,1,1,1,13,-17,1,OKC,OKC,MIN,101,10.5,Rebs+Asts,19,17,15,6
Josh Giddey,G,22023,1630581,22300664,"JAN 29, 2024",OKC vs. MIN,L,19,5,10,0.5,3,7,0.429,0,1,0.0,1,3,4,2,0,1,1,1,13,-17,1,OKC,OKC,MIN,101,1.5,Turnovers,19,17,15,6
Josh Giddey,G,22023,1630581,22300654,"JAN 28, 2024",OKC @ DET,L,27,5,10,0.5,0,1,0.0,2,2,1.0,2,7,9,5,0,1,2,0,12,-15,1,OKC,DET,OKC,104,11.5,Points,26,21,17,14
Josh Giddey,G,22023,1630581,22300654,"JAN 28, 2024",OKC @ DET,L,27,5,10,0.5,0,1,0.0,2,2,1.0,2,7,9,5,0,1,2,0,12,-15,1,OKC,DET,OKC,104,6.0,Rebounds,26,21,17,14
Josh Giddey,G,22023,1630581,22300654,"JAN 28, 2024",OKC @ DET,L,27,5,10,0.5,0,1,0.0,2,2,1.0,2,7,9,5,0,1,2,0,12,-15,1,OKC,DET,OKC,104,21.5,Pts+Rebs+Asts,26,21,17,14
Josh Giddey,G,22023,1630581,22300654,"JAN 28, 2024",OKC @ DET,L,27,5,10,0.5,0,1,0.0,2,2,1.0,2,7,9,5,0,1,2,0,12,-15,1,OKC,DET,OKC,104,4.0,Assists,26,21,17,14
Josh Giddey,G,22023,1630581,22300654,"JAN 28, 2024",OKC @ DET,L,27,5,10,0.5,0,1,0.0,2,2,1.0,2,7,9,5,0,1,2,0,12,-15,1,OKC,DET,OKC,104,26.0,Fantasy Score,26,21,17,14
Josh Giddey,G,22023,1630581,22300654,"JAN 28, 2024",OKC @ DET,L,27,5,10,0.5,0,1,0.0,2,2,1.0,2,7,9,5,0,1,2,0,12,-15,1,OKC,DET,OKC,104,17.5,Pts+Rebs,26,21,17,14
Josh Giddey,G,22023,1630581,22300654,"JAN 28, 2024",OKC @ DET,L,27,5,10,0.5,0,1,0.0,2,2,1.0,2,7,9,5,0,1,2,0,12,-15,1,OKC,DET,OKC,104,15.5,Pts+Asts,26,21,17,14
Josh Giddey,G,22023,1630581,22300654,"JAN 28, 2024",OKC @ DET,L,27,5,10,0.5,0,1,0.0,2,2,1.0,2,7,9,5,0,1,2,0,12,-15,1,OKC,DET,OKC,104,0.5,Steals,26,21,17,14
Josh Giddey,G,22023,1630581,22300654,"JAN 28, 2024",OKC @ DET,L,27,5,10,0.5,0,1,0.0,2,2,1.0,2,7,9,5,0,1,2,0,12,-15,1,OKC,DET,OKC,104,10.5,Rebs+Asts,26,21,17,14
Josh Giddey,G,22023,1630581,22300654,"JAN 28, 2024",OKC @ DET,L,27,5,10,0.5,0,1,0.0,2,2,1.0,2,7,9,5,0,1,2,0,12,-15,1,OKC,DET,OKC,104,1.5,Turnovers,26,21,17,14
Josh Giddey,G,22023,1630581,22300640,"JAN 26, 2024",OKC @ NOP,W,23,2,4,0.5,0,1,0.0,0,0,0.0,0,5,5,6,1,1,1,0,4,13,1,OKC,NOP,OKC,107,11.5,Points,15,9,10,11
Josh Giddey,G,22023,1630581,22300640,"JAN 26, 2024",OKC @ NOP,W,23,2,4,0.5,0,1,0.0,0,0,0.0,0,5,5,6,1,1,1,0,4,13,1,OKC,NOP,OKC,107,6.0,Rebounds,15,9,10,11
Josh Giddey,G,22023,1630581,22300640,"JAN 26, 2024",OKC @ NOP,W,23,2,4,0.5,0,1,0.0,0,0,0.0,0,5,5,6,1,1,1,0,4,13,1,OKC,NOP,OKC,107,21.5,Pts+Rebs+Asts,15,9,10,11
Josh Giddey,G,22023,1630581,22300640,"JAN 26, 2024",OKC @ NOP,W,23,2,4,0.5,0,1,0.0,0,0,0.0,0,5,5,6,1,1,1,0,4,13,1,OKC,NOP,OKC,107,4.0,Assists,15,9,10,11
Josh Giddey,G,22023,1630581,22300640,"JAN 26, 2024",OKC @ NOP,W,23,2,4,0.5,0,1,0.0,0,0,0.0,0,5,5,6,1,1,1,0,4,13,1,OKC,NOP,OKC,107,26.0,Fantasy Score,15,9,10,11
Josh Giddey,G,22023,1630581,22300640,"JAN 26, 2024",OKC @ NOP,W,23,2,4,0.5,0,1,0.0,0,0,0.0,0,5,5,6,1,1,1,0,4,13,1,OKC,NOP,OKC,107,17.5,Pts+Rebs,15,9,10,11
Josh Giddey,G,22023,1630581,22300640,"JAN 26, 2024",OKC @ NOP,W,23,2,4,0.5,0,1,0.0,0,0,0.0,0,5,5,6,1,1,1,0,4,13,1,OKC,NOP,OKC,107,15.5,Pts+Asts,15,9,10,11
Josh Giddey,G,22023,1630581,22300640,"JAN 26, 2024",OKC @ NOP,W,23,2,4,0.5,0,1,0.0,0,0,0.0,0,5,5,6,1,1,1,0,4,13,1,OKC,NOP,OKC,107,0.5,Steals,15,9,10,11
Josh Giddey,G,22023,1630581,22300640,"JAN 26, 2024",OKC @ NOP,W,23,2,4,0.5,0,1,0.0,0,0,0.0,0,5,5,6,1,1,1,0,4,13,1,OKC,NOP,OKC,107,10.5,Rebs+Asts,15,9,10,11
Josh Giddey,G,22023,1630581,22300640,"JAN 26, 2024",OKC @ NOP,W,23,2,4,0.5,0,1,0.0,0,0,0.0,0,5,5,6,1,1,1,0,4,13,1,OKC,NOP,OKC,107,1.5,Turnovers,15,9,10,11
Josh Giddey,G,22023,1630581,22300599,"JAN 20, 2024",OKC @ MIN,W,25,2,8,0.25,0,4,0.0,1,2,0.5,1,7,8,4,1,0,1,0,5,1,1,OKC,MIN,OKC,102,11.5,Points,17,13,9,12
Josh Giddey,G,22023,1630581,22300599,"JAN 20, 2024",OKC @ MIN,W,25,2,8,0.25,0,4,0.0,1,2,0.5,1,7,8,4,1,0,1,0,5,1,1,OKC,MIN,OKC,102,6.0,Rebounds,17,13,9,12
Josh Giddey,G,22023,1630581,22300599,"JAN 20, 2024",OKC @ MIN,W,25,2,8,0.25,0,4,0.0,1,2,0.5,1,7,8,4,1,0,1,0,5,1,1,OKC,MIN,OKC,102,21.5,Pts+Rebs+Asts,17,13,9,12
Josh Giddey,G,22023,1630581,22300599,"JAN 20, 2024",OKC @ MIN,W,25,2,8,0.25,0,4,0.0,1,2,0.5,1,7,8,4,1,0,1,0,5,1,1,OKC,MIN,OKC,102,4.0,Assists,17,13,9,12
Josh Giddey,G,22023,1630581,22300599,"JAN 20, 2024",OKC @ MIN,W,25,2,8,0.25,0,4,0.0,1,2,0.5,1,7,8,4,1,0,1,0,5,1,1,OKC,MIN,OKC,102,26.0,Fantasy Score,17,13,9,12
Josh Giddey,G,22023,1630581,22300599,"JAN 20, 2024",OKC @ MIN,W,25,2,8,0.25,0,4,0.0,1,2,0.5,1,7,8,4,1,0,1,0,5,1,1,OKC,MIN,OKC,102,17.5,Pts+Rebs,17,13,9,12
Josh Giddey,G,22023,1630581,22300599,"JAN 20, 2024",OKC @ MIN,W,25,2,8,0.25,0,4,0.0,1,2,0.5,1,7,8,4,1,0,1,0,5,1,1,OKC,MIN,OKC,102,15.5,Pts+Asts,17,13,9,12
Josh Giddey,G,22023,1630581,22300599,"JAN 20, 2024",OKC @ MIN,W,25,2,8,0.25,0,4,0.0,1,2,0.5,1,7,8,4,1,0,1,0,5,1,1,OKC,MIN,OKC,102,0.5,Steals,17,13,9,12
Josh Giddey,G,22023,1630581,22300599,"JAN 20, 2024",OKC @ MIN,W,25,2,8,0.25,0,4,0.0,1,2,0.5,1,7,8,4,1,0,1,0,5,1,1,OKC,MIN,OKC,102,10.5,Rebs+Asts,17,13,9,12
Josh Giddey,G,22023,1630581,22300599,"JAN 20, 2024",OKC @ MIN,W,25,2,8,0.25,0,4,0.0,1,2,0.5,1,7,8,4,1,0,1,0,5,1,1,OKC,MIN,OKC,102,1.5,Turnovers,17,13,9,12
Josh Giddey,G,22023,1630581,22300522,"JAN 10, 2024",OKC @ MIA,W,20,3,5,0.6,1,2,0.5,2,2,1.0,0,7,7,2,1,0,2,0,9,7,1,OKC,MIA,OKC,128,11.5,Points,18,16,11,9
Josh Giddey,G,22023,1630581,22300522,"JAN 10, 2024",OKC @ MIA,W,20,3,5,0.6,1,2,0.5,2,2,1.0,0,7,7,2,1,0,2,0,9,7,1,OKC,MIA,OKC,128,6.0,Rebounds,18,16,11,9
Josh Giddey,G,22023,1630581,22300522,"JAN 10, 2024",OKC @ MIA,W,20,3,5,0.6,1,2,0.5,2,2,1.0,0,7,7,2,1,0,2,0,9,7,1,OKC,MIA,OKC,128,21.5,Pts+Rebs+Asts,18,16,11,9
Josh Giddey,G,22023,1630581,22300522,"JAN 10, 2024",OKC @ MIA,W,20,3,5,0.6,1,2,0.5,2,2,1.0,0,7,7,2,1,0,2,0,9,7,1,OKC,MIA,OKC,128,4.0,Assists,18,16,11,9
Josh Giddey,G,22023,1630581,22300522,"JAN 10, 2024",OKC @ MIA,W,20,3,5,0.6,1,2,0.5,2,2,1.0,0,7,7,2,1,0,2,0,9,7,1,OKC,MIA,OKC,128,26.0,Fantasy Score,18,16,11,9
Josh Giddey,G,22023,1630581,22300522,"JAN 10, 2024",OKC @ MIA,W,20,3,5,0.6,1,2,0.5,2,2,1.0,0,7,7,2,1,0,2,0,9,7,1,OKC,MIA,OKC,128,17.5,Pts+Rebs,18,16,11,9
Josh Giddey,G,22023,1630581,22300522,"JAN 10, 2024",OKC @ MIA,W,20,3,5,0.6,1,2,0.5,2,2,1.0,0,7,7,2,1,0,2,0,9,7,1,OKC,MIA,OKC,128,15.5,Pts+Asts,18,16,11,9
Josh Giddey,G,22023,1630581,22300522,"JAN 10, 2024",OKC @ MIA,W,20,3,5,0.6,1,2,0.5,2,2,1.0,0,7,7,2,1,0,2,0,9,7,1,OKC,MIA,OKC,128,0.5,Steals,18,16,11,9
Josh Giddey,G,22023,1630581,22300522,"JAN 10, 2024",OKC @ MIA,W,20,3,5,0.6,1,2,0.5,2,2,1.0,0,7,7,2,1,0,2,0,9,7,1,OKC,MIA,OKC,128,10.5,Rebs+Asts,18,16,11,9
Josh Giddey,G,22023,1630581,22300522,"JAN 10, 2024",OKC @ MIA,W,20,3,5,0.6,1,2,0.5,2,2,1.0,0,7,7,2,1,0,2,0,9,7,1,OKC,MIA,OKC,128,1.5,Turnovers,18,16,11,9
Josh Giddey,G,22023,1630581,22300508,"JAN 08, 2024",OKC @ WAS,W,26,4,11,0.364,1,3,0.333,0,0,0.0,1,5,6,9,2,0,1,2,9,22,1,OKC,WAS,OKC,136,11.5,Points,24,15,18,15
Josh Giddey,G,22023,1630581,22300508,"JAN 08, 2024",OKC @ WAS,W,26,4,11,0.364,1,3,0.333,0,0,0.0,1,5,6,9,2,0,1,2,9,22,1,OKC,WAS,OKC,136,6.0,Rebounds,24,15,18,15
Josh Giddey,G,22023,1630581,22300508,"JAN 08, 2024",OKC @ WAS,W,26,4,11,0.364,1,3,0.333,0,0,0.0,1,5,6,9,2,0,1,2,9,22,1,OKC,WAS,OKC,136,21.5,Pts+Rebs+Asts,24,15,18,15
Josh Giddey,G,22023,1630581,22300508,"JAN 08, 2024",OKC @ WAS,W,26,4,11,0.364,1,3,0.333,0,0,0.0,1,5,6,9,2,0,1,2,9,22,1,OKC,WAS,OKC,136,4.0,Assists,24,15,18,15
Josh Giddey,G,22023,1630581,22300508,"JAN 08, 2024",OKC @ WAS,W,26,4,11,0.364,1,3,0.333,0,0,0.0,1,5,6,9,2,0,1,2,9,22,1,OKC,WAS,OKC,136,26.0,Fantasy Score,24,15,18,15
Josh Giddey,G,22023,1630581,22300508,"JAN 08, 2024",OKC @ WAS,W,26,4,11,0.364,1,3,0.333,0,0,0.0,1,5,6,9,2,0,1,2,9,22,1,OKC,WAS,OKC,136,17.5,Pts+Rebs,24,15,18,15
Josh Giddey,G,22023,1630581,22300508,"JAN 08, 2024",OKC @ WAS,W,26,4,11,0.364,1,3,0.333,0,0,0.0,1,5,6,9,2,0,1,2,9,22,1,OKC,WAS,OKC,136,15.5,Pts+Asts,24,15,18,15
Josh Giddey,G,22023,1630581,22300508,"JAN 08, 2024",OKC @ WAS,W,26,4,11,0.364,1,3,0.333,0,0,0.0,1,5,6,9,2,0,1,2,9,22,1,OKC,WAS,OKC,136,0.5,Steals,24,15,18,15
Josh Giddey,G,22023,1630581,22300508,"JAN 08, 2024",OKC @ WAS,W,26,4,11,0.364,1,3,0.333,0,0,0.0,1,5,6,9,2,0,1,2,9,22,1,OKC,WAS,OKC,136,10.5,Rebs+Asts,24,15,18,15
Josh Giddey,G,22023,1630581,22300508,"JAN 08, 2024",OKC @ WAS,W,26,4,11,0.364,1,3,0.333,0,0,0.0,1,5,6,9,2,0,1,2,9,22,1,OKC,WAS,OKC,136,1.5,Turnovers,24,15,18,15
Josh Giddey,G,22023,1630581,22300467,"JAN 03, 2024",OKC @ ATL,L,22,3,7,0.429,2,3,0.667,1,2,0.5,2,1,3,4,1,0,2,1,9,1,1,OKC,ATL,OKC,138,11.5,Points,16,12,13,7
Josh Giddey,G,22023,1630581,22300467,"JAN 03, 2024",OKC @ ATL,L,22,3,7,0.429,2,3,0.667,1,2,0.5,2,1,3,4,1,0,2,1,9,1,1,OKC,ATL,OKC,138,6.0,Rebounds,16,12,13,7
Josh Giddey,G,22023,1630581,22300467,"JAN 03, 2024",OKC @ ATL,L,22,3,7,0.429,2,3,0.667,1,2,0.5,2,1,3,4,1,0,2,1,9,1,1,OKC,ATL,OKC,138,21.5,Pts+Rebs+Asts,16,12,13,7
Josh Giddey,G,22023,1630581,22300467,"JAN 03, 2024",OKC @ ATL,L,22,3,7,0.429,2,3,0.667,1,2,0.5,2,1,3,4,1,0,2,1,9,1,1,OKC,ATL,OKC,138,4.0,Assists,16,12,13,7
Josh Giddey,G,22023,1630581,22300467,"JAN 03, 2024",OKC @ ATL,L,22,3,7,0.429,2,3,0.667,1,2,0.5,2,1,3,4,1,0,2,1,9,1,1,OKC,ATL,OKC,138,26.0,Fantasy Score,16,12,13,7
Josh Giddey,G,22023,1630581,22300467,"JAN 03, 2024",OKC @ ATL,L,22,3,7,0.429,2,3,0.667,1,2,0.5,2,1,3,4,1,0,2,1,9,1,1,OKC,ATL,OKC,138,17.5,Pts+Rebs,16,12,13,7
Josh Giddey,G,22023,1630581,22300467,"JAN 03, 2024",OKC @ ATL,L,22,3,7,0.429,2,3,0.667,1,2,0.5,2,1,3,4,1,0,2,1,9,1,1,OKC,ATL,OKC,138,15.5,Pts+Asts,16,12,13,7
Josh Giddey,G,22023,1630581,22300467,"JAN 03, 2024",OKC @ ATL,L,22,3,7,0.429,2,3,0.667,1,2,0.5,2,1,3,4,1,0,2,1,9,1,1,OKC,ATL,OKC,138,0.5,Steals,16,12,13,7
Josh Giddey,G,22023,1630581,22300467,"JAN 03, 2024",OKC @ ATL,L,22,3,7,0.429,2,3,0.667,1,2,0.5,2,1,3,4,1,0,2,1,9,1,1,OKC,ATL,OKC,138,10.5,Rebs+Asts,16,12,13,7
Josh Giddey,G,22023,1630581,22300467,"JAN 03, 2024",OKC @ ATL,L,22,3,7,0.429,2,3,0.667,1,2,0.5,2,1,3,4,1,0,2,1,9,1,1,OKC,ATL,OKC,138,1.5,Turnovers,16,12,13,7
Josh Giddey,G,22023,1630581,22300462,"JAN 02, 2024",OKC vs. BOS,W,27,8,14,0.571,4,7,0.571,3,3,1.0,1,7,8,6,0,0,3,0,23,10,1,OKC,OKC,BOS,127,11.5,Points,37,31,29,14
Josh Giddey,G,22023,1630581,22300462,"JAN 02, 2024",OKC vs. BOS,W,27,8,14,0.571,4,7,0.571,3,3,1.0,1,7,8,6,0,0,3,0,23,10,1,OKC,OKC,BOS,127,6.0,Rebounds,37,31,29,14
Josh Giddey,G,22023,1630581,22300462,"JAN 02, 2024",OKC vs. BOS,W,27,8,14,0.571,4,7,0.571,3,3,1.0,1,7,8,6,0,0,3,0,23,10,1,OKC,OKC,BOS,127,21.5,Pts+Rebs+Asts,37,31,29,14
Josh Giddey,G,22023,1630581,22300462,"JAN 02, 2024",OKC vs. BOS,W,27,8,14,0.571,4,7,0.571,3,3,1.0,1,7,8,6,0,0,3,0,23,10,1,OKC,OKC,BOS,127,4.0,Assists,37,31,29,14
Josh Giddey,G,22023,1630581,22300462,"JAN 02, 2024",OKC vs. BOS,W,27,8,14,0.571,4,7,0.571,3,3,1.0,1,7,8,6,0,0,3,0,23,10,1,OKC,OKC,BOS,127,26.0,Fantasy Score,37,31,29,14
Josh Giddey,G,22023,1630581,22300462,"JAN 02, 2024",OKC vs. BOS,W,27,8,14,0.571,4,7,0.571,3,3,1.0,1,7,8,6,0,0,3,0,23,10,1,OKC,OKC,BOS,127,17.5,Pts+Rebs,37,31,29,14
Josh Giddey,G,22023,1630581,22300462,"JAN 02, 2024",OKC vs. BOS,W,27,8,14,0.571,4,7,0.571,3,3,1.0,1,7,8,6,0,0,3,0,23,10,1,OKC,OKC,BOS,127,15.5,Pts+Asts,37,31,29,14
Josh Giddey,G,22023,1630581,22300462,"JAN 02, 2024",OKC vs. BOS,W,27,8,14,0.571,4,7,0.571,3,3,1.0,1,7,8,6,0,0,3,0,23,10,1,OKC,OKC,BOS,127,0.5,Steals,37,31,29,14
Josh Giddey,G,22023,1630581,22300462,"JAN 02, 2024",OKC vs. BOS,W,27,8,14,0.571,4,7,0.571,3,3,1.0,1,7,8,6,0,0,3,0,23,10,1,OKC,OKC,BOS,127,10.5,Rebs+Asts,37,31,29,14
Josh Giddey,G,22023,1630581,22300462,"JAN 02, 2024",OKC vs. BOS,W,27,8,14,0.571,4,7,0.571,3,3,1.0,1,7,8,6,0,0,3,0,23,10,1,OKC,OKC,BOS,127,1.5,Turnovers,37,31,29,14
Josh Giddey,G,22023,1630581,22300447,"DEC 31, 2023",OKC vs. BKN,W,27,8,16,0.5,4,8,0.5,0,0,0.0,1,5,6,5,0,0,2,3,20,4,1,OKC,OKC,BKN,124,11.5,Points,31,26,25,11
Josh Giddey,G,22023,1630581,22300447,"DEC 31, 2023",OKC vs. BKN,W,27,8,16,0.5,4,8,0.5,0,0,0.0,1,5,6,5,0,0,2,3,20,4,1,OKC,OKC,BKN,124,6.0,Rebounds,31,26,25,11
Josh Giddey,G,22023,1630581,22300447,"DEC 31, 2023",OKC vs. BKN,W,27,8,16,0.5,4,8,0.5,0,0,0.0,1,5,6,5,0,0,2,3,20,4,1,OKC,OKC,BKN,124,21.5,Pts+Rebs+Asts,31,26,25,11
Josh Giddey,G,22023,1630581,22300447,"DEC 31, 2023",OKC vs. BKN,W,27,8,16,0.5,4,8,0.5,0,0,0.0,1,5,6,5,0,0,2,3,20,4,1,OKC,OKC,BKN,124,4.0,Assists,31,26,25,11
Josh Giddey,G,22023,1630581,22300447,"DEC 31, 2023",OKC vs. BKN,W,27,8,16,0.5,4,8,0.5,0,0,0.0,1,5,6,5,0,0,2,3,20,4,1,OKC,OKC,BKN,124,26.0,Fantasy Score,31,26,25,11
Josh Giddey,G,22023,1630581,22300447,"DEC 31, 2023",OKC vs. BKN,W,27,8,16,0.5,4,8,0.5,0,0,0.0,1,5,6,5,0,0,2,3,20,4,1,OKC,OKC,BKN,124,17.5,Pts+Rebs,31,26,25,11
Josh Giddey,G,22023,1630581,22300447,"DEC 31, 2023",OKC vs. BKN,W,27,8,16,0.5,4,8,0.5,0,0,0.0,1,5,6,5,0,0,2,3,20,4,1,OKC,OKC,BKN,124,15.5,Pts+Asts,31,26,25,11
Josh Giddey,G,22023,1630581,22300447,"DEC 31, 2023",OKC vs. BKN,W,27,8,16,0.5,4,8,0.5,0,0,0.0,1,5,6,5,0,0,2,3,20,4,1,OKC,OKC,BKN,124,0.5,Steals,31,26,25,11
Josh Giddey,G,22023,1630581,22300447,"DEC 31, 2023",OKC vs. BKN,W,27,8,16,0.5,4,8,0.5,0,0,0.0,1,5,6,5,0,0,2,3,20,4,1,OKC,OKC,BKN,124,10.5,Rebs+Asts,31,26,25,11
Josh Giddey,G,22023,1630581,22300447,"DEC 31, 2023",OKC vs. BKN,W,27,8,16,0.5,4,8,0.5,0,0,0.0,1,5,6,5,0,0,2,3,20,4,1,OKC,OKC,BKN,124,1.5,Turnovers,31,26,25,11
Josh Giddey,G,22023,1630581,22300435,"DEC 29, 2023",OKC @ DEN,W,21,6,10,0.6,0,1,0.0,0,0,0.0,2,6,8,4,1,0,3,1,12,16,1,OKC,DEN,OKC,119,11.5,Points,24,20,16,12
Josh Giddey,G,22023,1630581,22300435,"DEC 29, 2023",OKC @ DEN,W,21,6,10,0.6,0,1,0.0,0,0,0.0,2,6,8,4,1,0,3,1,12,16,1,OKC,DEN,OKC,119,6.0,Rebounds,24,20,16,12
Josh Giddey,G,22023,1630581,22300435,"DEC 29, 2023",OKC @ DEN,W,21,6,10,0.6,0,1,0.0,0,0,0.0,2,6,8,4,1,0,3,1,12,16,1,OKC,DEN,OKC,119,21.5,Pts+Rebs+Asts,24,20,16,12
Josh Giddey,G,22023,1630581,22300435,"DEC 29, 2023",OKC @ DEN,W,21,6,10,0.6,0,1,0.0,0,0,0.0,2,6,8,4,1,0,3,1,12,16,1,OKC,DEN,OKC,119,4.0,Assists,24,20,16,12
Josh Giddey,G,22023,1630581,22300435,"DEC 29, 2023",OKC @ DEN,W,21,6,10,0.6,0,1,0.0,0,0,0.0,2,6,8,4,1,0,3,1,12,16,1,OKC,DEN,OKC,119,26.0,Fantasy Score,24,20,16,12
Josh Giddey,G,22023,1630581,22300435,"DEC 29, 2023",OKC @ DEN,W,21,6,10,0.6,0,1,0.0,0,0,0.0,2,6,8,4,1,0,3,1,12,16,1,OKC,DEN,OKC,119,17.5,Pts+Rebs,24,20,16,12
Josh Giddey,G,22023,1630581,22300435,"DEC 29, 2023",OKC @ DEN,W,21,6,10,0.6,0,1,0.0,0,0,0.0,2,6,8,4,1,0,3,1,12,16,1,OKC,DEN,OKC,119,15.5,Pts+Asts,24,20,16,12
Josh Giddey,G,22023,1630581,22300435,"DEC 29, 2023",OKC @ DEN,W,21,6,10,0.6,0,1,0.0,0,0,0.0,2,6,8,4,1,0,3,1,12,16,1,OKC,DEN,OKC,119,0.5,Steals,24,20,16,12
Josh Giddey,G,22023,1630581,22300435,"DEC 29, 2023",OKC @ DEN,W,21,6,10,0.6,0,1,0.0,0,0,0.0,2,6,8,4,1,0,3,1,12,16,1,OKC,DEN,OKC,119,10.5,Rebs+Asts,24,20,16,12
Josh Giddey,G,22023,1630581,22300435,"DEC 29, 2023",OKC @ DEN,W,21,6,10,0.6,0,1,0.0,0,0,0.0,2,6,8,4,1,0,3,1,12,16,1,OKC,DEN,OKC,119,1.5,Turnovers,24,20,16,12
Josh Giddey,G,22023,1630581,22300411,"DEC 26, 2023",OKC vs. MIN,W,25,4,7,0.571,0,2,0.0,2,2,1.0,0,2,2,7,0,0,2,3,10,21,1,OKC,OKC,MIN,129,11.5,Points,19,12,17,9
Josh Giddey,G,22023,1630581,22300411,"DEC 26, 2023",OKC vs. MIN,W,25,4,7,0.571,0,2,0.0,2,2,1.0,0,2,2,7,0,0,2,3,10,21,1,OKC,OKC,MIN,129,6.0,Rebounds,19,12,17,9
Josh Giddey,G,22023,1630581,22300411,"DEC 26, 2023",OKC vs. MIN,W,25,4,7,0.571,0,2,0.0,2,2,1.0,0,2,2,7,0,0,2,3,10,21,1,OKC,OKC,MIN,129,21.5,Pts+Rebs+Asts,19,12,17,9
Josh Giddey,G,22023,1630581,22300411,"DEC 26, 2023",OKC vs. MIN,W,25,4,7,0.571,0,2,0.0,2,2,1.0,0,2,2,7,0,0,2,3,10,21,1,OKC,OKC,MIN,129,4.0,Assists,19,12,17,9
Josh Giddey,G,22023,1630581,22300411,"DEC 26, 2023",OKC vs. MIN,W,25,4,7,0.571,0,2,0.0,2,2,1.0,0,2,2,7,0,0,2,3,10,21,1,OKC,OKC,MIN,129,26.0,Fantasy Score,19,12,17,9
Josh Giddey,G,22023,1630581,22300411,"DEC 26, 2023",OKC vs. MIN,W,25,4,7,0.571,0,2,0.0,2,2,1.0,0,2,2,7,0,0,2,3,10,21,1,OKC,OKC,MIN,129,17.5,Pts+Rebs,19,12,17,9
Josh Giddey,G,22023,1630581,22300411,"DEC 26, 2023",OKC vs. MIN,W,25,4,7,0.571,0,2,0.0,2,2,1.0,0,2,2,7,0,0,2,3,10,21,1,OKC,OKC,MIN,129,15.5,Pts+Asts,19,12,17,9
Josh Giddey,G,22023,1630581,22300411,"DEC 26, 2023",OKC vs. MIN,W,25,4,7,0.571,0,2,0.0,2,2,1.0,0,2,2,7,0,0,2,3,10,21,1,OKC,OKC,MIN,129,0.5,Steals,19,12,17,9
Josh Giddey,G,22023,1630581,22300411,"DEC 26, 2023",OKC vs. MIN,W,25,4,7,0.571,0,2,0.0,2,2,1.0,0,2,2,7,0,0,2,3,10,21,1,OKC,OKC,MIN,129,10.5,Rebs+Asts,19,12,17,9
Josh Giddey,G,22023,1630581,22300411,"DEC 26, 2023",OKC vs. MIN,W,25,4,7,0.571,0,2,0.0,2,2,1.0,0,2,2,7,0,0,2,3,10,21,1,OKC,OKC,MIN,129,1.5,Turnovers,19,12,17,9
Josh Giddey,G,22023,1630581,22301212,"DEC 06, 2023",OKC @ HOU,L,25,3,11,0.273,2,5,0.4,0,0,0.0,1,3,4,6,1,0,0,3,8,-11,1,OKC,HOU,OKC,101,11.5,Points,18,12,14,10
Josh Giddey,G,22023,1630581,22301212,"DEC 06, 2023",OKC @ HOU,L,25,3,11,0.273,2,5,0.4,0,0,0.0,1,3,4,6,1,0,0,3,8,-11,1,OKC,HOU,OKC,101,6.0,Rebounds,18,12,14,10
Josh Giddey,G,22023,1630581,22301212,"DEC 06, 2023",OKC @ HOU,L,25,3,11,0.273,2,5,0.4,0,0,0.0,1,3,4,6,1,0,0,3,8,-11,1,OKC,HOU,OKC,101,21.5,Pts+Rebs+Asts,18,12,14,10
Josh Giddey,G,22023,1630581,22301212,"DEC 06, 2023",OKC @ HOU,L,25,3,11,0.273,2,5,0.4,0,0,0.0,1,3,4,6,1,0,0,3,8,-11,1,OKC,HOU,OKC,101,4.0,Assists,18,12,14,10
Josh Giddey,G,22023,1630581,22301212,"DEC 06, 2023",OKC @ HOU,L,25,3,11,0.273,2,5,0.4,0,0,0.0,1,3,4,6,1,0,0,3,8,-11,1,OKC,HOU,OKC,101,26.0,Fantasy Score,18,12,14,10
Josh Giddey,G,22023,1630581,22301212,"DEC 06, 2023",OKC @ HOU,L,25,3,11,0.273,2,5,0.4,0,0,0.0,1,3,4,6,1,0,0,3,8,-11,1,OKC,HOU,OKC,101,17.5,Pts+Rebs,18,12,14,10
Josh Giddey,G,22023,1630581,22301212,"DEC 06, 2023",OKC @ HOU,L,25,3,11,0.273,2,5,0.4,0,0,0.0,1,3,4,6,1,0,0,3,8,-11,1,OKC,HOU,OKC,101,15.5,Pts+Asts,18,12,14,10
Josh Giddey,G,22023,1630581,22301212,"DEC 06, 2023",OKC @ HOU,L,25,3,11,0.273,2,5,0.4,0,0,0.0,1,3,4,6,1,0,0,3,8,-11,1,OKC,HOU,OKC,101,0.5,Steals,18,12,14,10
Josh Giddey,G,22023,1630581,22301212,"DEC 06, 2023",OKC @ HOU,L,25,3,11,0.273,2,5,0.4,0,0,0.0,1,3,4,6,1,0,0,3,8,-11,1,OKC,HOU,OKC,101,10.5,Rebs+Asts,18,12,14,10
Josh Giddey,G,22023,1630581,22301212,"DEC 06, 2023",OKC @ HOU,L,25,3,11,0.273,2,5,0.4,0,0,0.0,1,3,4,6,1,0,0,3,8,-11,1,OKC,HOU,OKC,101,1.5,Turnovers,18,12,14,10
Josh Giddey,G,22023,1630581,22300271,"NOV 30, 2023",OKC vs. LAL,W,21,5,10,0.5,2,5,0.4,2,2,1.0,2,6,8,1,1,0,4,2,14,6,1,OKC,OKC,LAL,133,11.5,Points,23,22,15,9
Josh Giddey,G,22023,1630581,22300271,"NOV 30, 2023",OKC vs. LAL,W,21,5,10,0.5,2,5,0.4,2,2,1.0,2,6,8,1,1,0,4,2,14,6,1,OKC,OKC,LAL,133,6.0,Rebounds,23,22,15,9
Josh Giddey,G,22023,1630581,22300271,"NOV 30, 2023",OKC vs. LAL,W,21,5,10,0.5,2,5,0.4,2,2,1.0,2,6,8,1,1,0,4,2,14,6,1,OKC,OKC,LAL,133,21.5,Pts+Rebs+Asts,23,22,15,9
Josh Giddey,G,22023,1630581,22300271,"NOV 30, 2023",OKC vs. LAL,W,21,5,10,0.5,2,5,0.4,2,2,1.0,2,6,8,1,1,0,4,2,14,6,1,OKC,OKC,LAL,133,4.0,Assists,23,22,15,9
Josh Giddey,G,22023,1630581,22300271,"NOV 30, 2023",OKC vs. LAL,W,21,5,10,0.5,2,5,0.4,2,2,1.0,2,6,8,1,1,0,4,2,14,6,1,OKC,OKC,LAL,133,26.0,Fantasy Score,23,22,15,9
Josh Giddey,G,22023,1630581,22300271,"NOV 30, 2023",OKC vs. LAL,W,21,5,10,0.5,2,5,0.4,2,2,1.0,2,6,8,1,1,0,4,2,14,6,1,OKC,OKC,LAL,133,17.5,Pts+Rebs,23,22,15,9
Josh Giddey,G,22023,1630581,22300271,"NOV 30, 2023",OKC vs. LAL,W,21,5,10,0.5,2,5,0.4,2,2,1.0,2,6,8,1,1,0,4,2,14,6,1,OKC,OKC,LAL,133,15.5,Pts+Asts,23,22,15,9
Josh Giddey,G,22023,1630581,22300271,"NOV 30, 2023",OKC vs. LAL,W,21,5,10,0.5,2,5,0.4,2,2,1.0,2,6,8,1,1,0,4,2,14,6,1,OKC,OKC,LAL,133,0.5,Steals,23,22,15,9
Josh Giddey,G,22023,1630581,22300271,"NOV 30, 2023",OKC vs. LAL,W,21,5,10,0.5,2,5,0.4,2,2,1.0,2,6,8,1,1,0,4,2,14,6,1,OKC,OKC,LAL,133,10.5,Rebs+Asts,23,22,15,9
Josh Giddey,G,22023,1630581,22300271,"NOV 30, 2023",OKC vs. LAL,W,21,5,10,0.5,2,5,0.4,2,2,1.0,2,6,8,1,1,0,4,2,14,6,1,OKC,OKC,LAL,133,1.5,Turnovers,23,22,15,9
Josh Giddey,G,22023,1630581,22300234,"NOV 22, 2023",OKC vs. CHI,W,29,4,13,0.308,1,3,0.333,1,2,0.5,1,5,6,2,2,0,2,1,10,3,1,OKC,OKC,CHI,116,11.5,Points,18,16,12,8
Josh Giddey,G,22023,1630581,22300234,"NOV 22, 2023",OKC vs. CHI,W,29,4,13,0.308,1,3,0.333,1,2,0.5,1,5,6,2,2,0,2,1,10,3,1,OKC,OKC,CHI,116,6.0,Rebounds,18,16,12,8
Josh Giddey,G,22023,1630581,22300234,"NOV 22, 2023",OKC vs. CHI,W,29,4,13,0.308,1,3,0.333,1,2,0.5,1,5,6,2,2,0,2,1,10,3,1,OKC,OKC,CHI,116,21.5,Pts+Rebs+Asts,18,16,12,8
Josh Giddey,G,22023,1630581,22300234,"NOV 22, 2023",OKC vs. CHI,W,29,4,13,0.308,1,3,0.333,1,2,0.5,1,5,6,2,2,0,2,1,10,3,1,OKC,OKC,CHI,116,4.0,Assists,18,16,12,8
Josh Giddey,G,22023,1630581,22300234,"NOV 22, 2023",OKC vs. CHI,W,29,4,13,0.308,1,3,0.333,1,2,0.5,1,5,6,2,2,0,2,1,10,3,1,OKC,OKC,CHI,116,26.0,Fantasy Score,18,16,12,8
Josh Giddey,G,22023,1630581,22300234,"NOV 22, 2023",OKC vs. CHI,W,29,4,13,0.308,1,3,0.333,1,2,0.5,1,5,6,2,2,0,2,1,10,3,1,OKC,OKC,CHI,116,17.5,Pts+Rebs,18,16,12,8
Josh Giddey,G,22023,1630581,22300234,"NOV 22, 2023",OKC vs. CHI,W,29,4,13,0.308,1,3,0.333,1,2,0.5,1,5,6,2,2,0,2,1,10,3,1,OKC,OKC,CHI,116,15.5,Pts+Asts,18,16,12,8
Josh Giddey,G,22023,1630581,22300234,"NOV 22, 2023",OKC vs. CHI,W,29,4,13,0.308,1,3,0.333,1,2,0.5,1,5,6,2,2,0,2,1,10,3,1,OKC,OKC,CHI,116,0.5,Steals,18,16,12,8
Josh Giddey,G,22023,1630581,22300234,"NOV 22, 2023",OKC vs. CHI,W,29,4,13,0.308,1,3,0.333,1,2,0.5,1,5,6,2,2,0,2,1,10,3,1,OKC,OKC,CHI,116,10.5,Rebs+Asts,18,16,12,8
Josh Giddey,G,22023,1630581,22300234,"NOV 22, 2023",OKC vs. CHI,W,29,4,13,0.308,1,3,0.333,1,2,0.5,1,5,6,2,2,0,2,1,10,3,1,OKC,OKC,CHI,116,1.5,Turnovers,18,16,12,8
Josh Giddey,G,22023,1630581,22300207,"NOV 18, 2023",OKC @ GSW,W,22,4,10,0.4,1,2,0.5,2,2,1.0,2,3,5,2,1,2,0,2,11,4,1,OKC,GSW,OKC,130,11.5,Points,18,16,13,7
Josh Giddey,G,22023,1630581,22300207,"NOV 18, 2023",OKC @ GSW,W,22,4,10,0.4,1,2,0.5,2,2,1.0,2,3,5,2,1,2,0,2,11,4,1,OKC,GSW,OKC,130,6.0,Rebounds,18,16,13,7
Josh Giddey,G,22023,1630581,22300207,"NOV 18, 2023",OKC @ GSW,W,22,4,10,0.4,1,2,0.5,2,2,1.0,2,3,5,2,1,2,0,2,11,4,1,OKC,GSW,OKC,130,21.5,Pts+Rebs+Asts,18,16,13,7
Josh Giddey,G,22023,1630581,22300207,"NOV 18, 2023",OKC @ GSW,W,22,4,10,0.4,1,2,0.5,2,2,1.0,2,3,5,2,1,2,0,2,11,4,1,OKC,GSW,OKC,130,4.0,Assists,18,16,13,7
Josh Giddey,G,22023,1630581,22300207,"NOV 18, 2023",OKC @ GSW,W,22,4,10,0.4,1,2,0.5,2,2,1.0,2,3,5,2,1,2,0,2,11,4,1,OKC,GSW,OKC,130,26.0,Fantasy Score,18,16,13,7
Josh Giddey,G,22023,1630581,22300207,"NOV 18, 2023",OKC @ GSW,W,22,4,10,0.4,1,2,0.5,2,2,1.0,2,3,5,2,1,2,0,2,11,4,1,OKC,GSW,OKC,130,17.5,Pts+Rebs,18,16,13,7
Josh Giddey,G,22023,1630581,22300207,"NOV 18, 2023",OKC @ GSW,W,22,4,10,0.4,1,2,0.5,2,2,1.0,2,3,5,2,1,2,0,2,11,4,1,OKC,GSW,OKC,130,15.5,Pts+Asts,18,16,13,7
Josh Giddey,G,22023,1630581,22300207,"NOV 18, 2023",OKC @ GSW,W,22,4,10,0.4,1,2,0.5,2,2,1.0,2,3,5,2,1,2,0,2,11,4,1,OKC,GSW,OKC,130,0.5,Steals,18,16,13,7
Josh Giddey,G,22023,1630581,22300207,"NOV 18, 2023",OKC @ GSW,W,22,4,10,0.4,1,2,0.5,2,2,1.0,2,3,5,2,1,2,0,2,11,4,1,OKC,GSW,OKC,130,10.5,Rebs+Asts,18,16,13,7
Josh Giddey,G,22023,1630581,22300207,"NOV 18, 2023",OKC @ GSW,W,22,4,10,0.4,1,2,0.5,2,2,1.0,2,3,5,2,1,2,0,2,11,4,1,OKC,GSW,OKC,130,1.5,Turnovers,18,16,13,7
Josh Giddey,G,22023,1630581,22300201,"NOV 16, 2023",OKC @ GSW,W,26,8,14,0.571,3,3,1.0,0,0,0.0,2,4,6,1,2,0,3,1,19,-3,1,OKC,GSW,OKC,128,11.5,Points,26,25,20,7
Josh Giddey,G,22023,1630581,22300201,"NOV 16, 2023",OKC @ GSW,W,26,8,14,0.571,3,3,1.0,0,0,0.0,2,4,6,1,2,0,3,1,19,-3,1,OKC,GSW,OKC,128,6.0,Rebounds,26,25,20,7
Josh Giddey,G,22023,1630581,22300201,"NOV 16, 2023",OKC @ GSW,W,26,8,14,0.571,3,3,1.0,0,0,0.0,2,4,6,1,2,0,3,1,19,-3,1,OKC,GSW,OKC,128,21.5,Pts+Rebs+Asts,26,25,20,7
Josh Giddey,G,22023,1630581,22300201,"NOV 16, 2023",OKC @ GSW,W,26,8,14,0.571,3,3,1.0,0,0,0.0,2,4,6,1,2,0,3,1,19,-3,1,OKC,GSW,OKC,128,4.0,Assists,26,25,20,7
Josh Giddey,G,22023,1630581,22300201,"NOV 16, 2023",OKC @ GSW,W,26,8,14,0.571,3,3,1.0,0,0,0.0,2,4,6,1,2,0,3,1,19,-3,1,OKC,GSW,OKC,128,26.0,Fantasy Score,26,25,20,7
Josh Giddey,G,22023,1630581,22300201,"NOV 16, 2023",OKC @ GSW,W,26,8,14,0.571,3,3,1.0,0,0,0.0,2,4,6,1,2,0,3,1,19,-3,1,OKC,GSW,OKC,128,17.5,Pts+Rebs,26,25,20,7
Josh Giddey,G,22023,1630581,22300201,"NOV 16, 2023",OKC @ GSW,W,26,8,14,0.571,3,3,1.0,0,0,0.0,2,4,6,1,2,0,3,1,19,-3,1,OKC,GSW,OKC,128,15.5,Pts+Asts,26,25,20,7
Josh Giddey,G,22023,1630581,22300201,"NOV 16, 2023",OKC @ GSW,W,26,8,14,0.571,3,3,1.0,0,0,0.0,2,4,6,1,2,0,3,1,19,-3,1,OKC,GSW,OKC,128,0.5,Steals,26,25,20,7
Josh Giddey,G,22023,1630581,22300201,"NOV 16, 2023",OKC @ GSW,W,26,8,14,0.571,3,3,1.0,0,0,0.0,2,4,6,1,2,0,3,1,19,-3,1,OKC,GSW,OKC,128,10.5,Rebs+Asts,26,25,20,7
Josh Giddey,G,22023,1630581,22300201,"NOV 16, 2023",OKC @ GSW,W,26,8,14,0.571,3,3,1.0,0,0,0.0,2,4,6,1,2,0,3,1,19,-3,1,OKC,GSW,OKC,128,1.5,Turnovers,26,25,20,7
Josh Giddey,G,22023,1630581,22300021,"NOV 14, 2023",OKC vs. SAS,W,25,7,11,0.636,0,2,0.0,4,5,0.8,1,6,7,7,0,2,3,0,18,20,1,OKC,OKC,SAS,123,11.5,Points,32,25,25,14
Josh Giddey,G,22023,1630581,22300021,"NOV 14, 2023",OKC vs. SAS,W,25,7,11,0.636,0,2,0.0,4,5,0.8,1,6,7,7,0,2,3,0,18,20,1,OKC,OKC,SAS,123,6.0,Rebounds,32,25,25,14
Josh Giddey,G,22023,1630581,22300021,"NOV 14, 2023",OKC vs. SAS,W,25,7,11,0.636,0,2,0.0,4,5,0.8,1,6,7,7,0,2,3,0,18,20,1,OKC,OKC,SAS,123,21.5,Pts+Rebs+Asts,32,25,25,14
Josh Giddey,G,22023,1630581,22300021,"NOV 14, 2023",OKC vs. SAS,W,25,7,11,0.636,0,2,0.0,4,5,0.8,1,6,7,7,0,2,3,0,18,20,1,OKC,OKC,SAS,123,4.0,Assists,32,25,25,14
Josh Giddey,G,22023,1630581,22300021,"NOV 14, 2023",OKC vs. SAS,W,25,7,11,0.636,0,2,0.0,4,5,0.8,1,6,7,7,0,2,3,0,18,20,1,OKC,OKC,SAS,123,26.0,Fantasy Score,32,25,25,14
Josh Giddey,G,22023,1630581,22300021,"NOV 14, 2023",OKC vs. SAS,W,25,7,11,0.636,0,2,0.0,4,5,0.8,1,6,7,7,0,2,3,0,18,20,1,OKC,OKC,SAS,123,17.5,Pts+Rebs,32,25,25,14
Josh Giddey,G,22023,1630581,22300021,"NOV 14, 2023",OKC vs. SAS,W,25,7,11,0.636,0,2,0.0,4,5,0.8,1,6,7,7,0,2,3,0,18,20,1,OKC,OKC,SAS,123,15.5,Pts+Asts,32,25,25,14
Josh Giddey,G,22023,1630581,22300021,"NOV 14, 2023",OKC vs. SAS,W,25,7,11,0.636,0,2,0.0,4,5,0.8,1,6,7,7,0,2,3,0,18,20,1,OKC,OKC,SAS,123,0.5,Steals,32,25,25,14
Josh Giddey,G,22023,1630581,22300021,"NOV 14, 2023",OKC vs. SAS,W,25,7,11,0.636,0,2,0.0,4,5,0.8,1,6,7,7,0,2,3,0,18,20,1,OKC,OKC,SAS,123,10.5,Rebs+Asts,32,25,25,14
Josh Giddey,G,22023,1630581,22300021,"NOV 14, 2023",OKC vs. SAS,W,25,7,11,0.636,0,2,0.0,4,5,0.8,1,6,7,7,0,2,3,0,18,20,1,OKC,OKC,SAS,123,1.5,Turnovers,32,25,25,14
Josh Giddey,G,22023,1630581,22300581,"JAN 18, 2024",OKC @ UTA,W,30,8,16,0.5,1,5,0.2,3,3,1.0,1,9,10,6,1,0,2,3,20,10,1,OKC,UTA,OKC,134,11.5,Points,36,30,26,16
Josh Giddey,G,22023,1630581,22300581,"JAN 18, 2024",OKC @ UTA,W,30,8,16,0.5,1,5,0.2,3,3,1.0,1,9,10,6,1,0,2,3,20,10,1,OKC,UTA,OKC,134,6.0,Rebounds,36,30,26,16
Josh Giddey,G,22023,1630581,22300581,"JAN 18, 2024",OKC @ UTA,W,30,8,16,0.5,1,5,0.2,3,3,1.0,1,9,10,6,1,0,2,3,20,10,1,OKC,UTA,OKC,134,21.5,Pts+Rebs+Asts,36,30,26,16
Josh Giddey,G,22023,1630581,22300581,"JAN 18, 2024",OKC @ UTA,W,30,8,16,0.5,1,5,0.2,3,3,1.0,1,9,10,6,1,0,2,3,20,10,1,OKC,UTA,OKC,134,4.0,Assists,36,30,26,16
Josh Giddey,G,22023,1630581,22300581,"JAN 18, 2024",OKC @ UTA,W,30,8,16,0.5,1,5,0.2,3,3,1.0,1,9,10,6,1,0,2,3,20,10,1,OKC,UTA,OKC,134,26.0,Fantasy Score,36,30,26,16
Josh Giddey,G,22023,1630581,22300581,"JAN 18, 2024",OKC @ UTA,W,30,8,16,0.5,1,5,0.2,3,3,1.0,1,9,10,6,1,0,2,3,20,10,1,OKC,UTA,OKC,134,17.5,Pts+Rebs,36,30,26,16
Josh Giddey,G,22023,1630581,22300581,"JAN 18, 2024",OKC @ UTA,W,30,8,16,0.5,1,5,0.2,3,3,1.0,1,9,10,6,1,0,2,3,20,10,1,OKC,UTA,OKC,134,15.5,Pts+Asts,36,30,26,16
Josh Giddey,G,22023,1630581,22300581,"JAN 18, 2024",OKC @ UTA,W,30,8,16,0.5,1,5,0.2,3,3,1.0,1,9,10,6,1,0,2,3,20,10,1,OKC,UTA,OKC,134,0.5,Steals,36,30,26,16
Josh Giddey,G,22023,1630581,22300581,"JAN 18, 2024",OKC @ UTA,W,30,8,16,0.5,1,5,0.2,3,3,1.0,1,9,10,6,1,0,2,3,20,10,1,OKC,UTA,OKC,134,10.5,Rebs+Asts,36,30,26,16
Josh Giddey,G,22023,1630581,22300581,"JAN 18, 2024",OKC @ UTA,W,30,8,16,0.5,1,5,0.2,3,3,1.0,1,9,10,6,1,0,2,3,20,10,1,OKC,UTA,OKC,134,1.5,Turnovers,36,30,26,16
Clint Capela,C,22023,203991,22300690,"FEB 02, 2024",ATL vs. PHX,W,21,5,10,0.5,0,0,0.0,1,2,0.5,6,4,10,0,0,0,0,2,11,-14,1,ATL,ATL,PHX,129,,,21,21,11,10
Clint Capela,C,22023,203991,22300669,"JAN 30, 2024",ATL vs. LAL,W,24,6,10,0.6,0,0,0.0,1,2,0.5,5,7,12,1,1,1,1,3,13,11,1,ATL,ATL,LAL,138,,,26,25,14,13
Clint Capela,C,22023,203991,22300653,"JAN 28, 2024",ATL vs. TOR,W,28,9,13,0.692,0,0,0.0,1,2,0.5,6,8,14,0,0,1,0,2,19,19,1,ATL,ATL,TOR,126,,,33,33,19,14
Clint Capela,C,22023,203991,22300634,"JAN 26, 2024",ATL vs. DAL,L,25,4,7,0.571,0,0,0.0,2,3,0.667,3,5,8,2,0,1,1,2,10,-7,1,ATL,ATL,DAL,143,,,20,18,12,10
Clint Capela,C,22023,203991,22300626,"JAN 24, 2024",ATL @ GSW,L,25,3,9,0.333,0,0,0.0,5,7,0.714,3,8,11,1,0,1,0,2,11,-4,1,ATL,GSW,ATL,112,,,23,22,12,12
Clint Capela,C,22023,203991,22300613,"JAN 22, 2024",ATL @ SAC,L,22,4,10,0.4,0,0,0.0,3,4,0.75,6,6,12,1,0,2,1,0,11,-8,1,ATL,SAC,ATL,107,,,24,23,12,13
Clint Capela,C,22023,203991,22300595,"JAN 20, 2024",ATL vs. CLE,L,22,3,8,0.375,0,0,0.0,0,0,0.0,5,4,9,0,1,2,2,2,6,-14,1,ATL,ATL,CLE,95,,,15,15,6,9
Clint Capela,C,22023,203991,22300587,"JAN 19, 2024",ATL @ MIA,W,22,2,4,0.5,0,0,0.0,5,7,0.714,5,6,11,0,0,1,0,2,9,-12,1,ATL,MIA,ATL,109,,,20,20,9,11
Clint Capela,C,22023,203991,22300570,"JAN 17, 2024",ATL vs. ORL,W,27,6,6,1.0,0,0,0.0,0,0,0.0,0,3,3,0,1,0,1,3,12,-4,1,ATL,ATL,ORL,106,,,15,15,12,3
Clint Capela,C,22023,203991,22300559,"JAN 15, 2024",ATL vs. SAS,W,25,5,7,0.714,0,0,0.0,3,6,0.5,6,6,12,0,0,4,1,2,13,8,1,ATL,ATL,SAS,109,,,25,25,13,12
Clint Capela,C,22023,203991,22300543,"JAN 13, 2024",ATL vs. WAS,L,24,2,8,0.25,0,0,0.0,0,0,0.0,2,6,8,0,0,1,0,1,4,-10,1,ATL,ATL,WAS,99,,,12,12,4,8
Clint Capela,C,22023,203991,22300533,"JAN 12, 2024",ATL vs. IND,L,22,3,5,0.6,0,0,0.0,1,4,0.25,3,2,5,1,1,1,0,1,7,-1,1,ATL,ATL,IND,108,,,13,12,8,6
Clint Capela,C,22023,203991,22300499,"JAN 07, 2024",ATL @ ORL,L,36,2,6,0.333,0,0,0.0,0,2,0.0,4,8,12,0,3,2,1,3,4,-16,1,ATL,ORL,ATL,110,,,16,16,4,12
Clint Capela,C,22023,203991,22300480,"JAN 05, 2024",ATL @ IND,L,19,4,9,0.444,0,0,0.0,1,2,0.5,5,2,7,0,0,1,1,2,9,-22,1,ATL,IND,ATL,116,,,16,16,9,7
Clint Capela,C,22023,203991,22300467,"JAN 03, 2024",ATL vs. OKC,W,25,5,8,0.625,0,0,0.0,2,2,1.0,7,7,14,0,0,3,0,2,12,-9,1,ATL,ATL,OKC,141,,,26,26,12,14
Clint Capela,C,22023,203991,22300445,"DEC 31, 2023",ATL @ WAS,W,33,5,11,0.455,0,0,0.0,1,4,0.25,7,10,17,3,1,1,3,4,11,-4,1,ATL,WAS,ATL,130,,,31,28,14,20
Clint Capela,C,22023,203991,22300431,"DEC 29, 2023",ATL vs. SAC,L,28,5,7,0.714,0,0,0.0,2,4,0.5,6,6,12,3,1,2,2,1,12,2,1,ATL,ATL,SAC,110,,,27,24,15,15
Clint Capela,C,22023,203991,22300408,"DEC 26, 2023",ATL @ CHI,L,27,5,9,0.556,0,0,0.0,3,4,0.75,3,2,5,1,0,1,1,3,13,-7,1,ATL,CHI,ATL,113,,,19,18,14,6
Clint Capela,C,22023,203991,22300393,"DEC 23, 2023",ATL vs. MEM,L,30,8,11,0.727,0,0,0.0,4,4,1.0,5,7,12,1,0,2,1,2,20,2,1,ATL,ATL,MEM,119,,,33,32,21,13
Clint Capela,C,22023,203991,22300384,"DEC 22, 2023",ATL @ MIA,L,28,3,3,1.0,0,0,0.0,2,2,1.0,3,7,10,0,0,0,2,5,8,6,1,ATL,MIA,ATL,113,,,18,18,8,10
Clint Capela,C,22023,203991,22300371,"DEC 20, 2023",ATL @ HOU,W,21,4,6,0.667,0,0,0.0,7,7,1.0,5,4,9,2,2,1,0,3,15,-9,1,ATL,HOU,ATL,134,,,26,24,17,11
Clint Capela,C,22023,203991,22300352,"DEC 18, 2023",ATL vs. DET,W,28,7,11,0.636,0,0,0.0,3,3,1.0,7,8,15,2,1,3,1,3,17,10,1,ATL,ATL,DET,130,,,34,32,19,17
Clint Capela,C,22023,203991,22300330,"DEC 15, 2023",ATL @ TOR,W,35,9,12,0.75,0,0,0.0,0,0,0.0,6,9,15,0,0,3,1,2,18,20,1,ATL,TOR,ATL,125,,,33,33,18,15
Clint Capela,C,22023,203991,22300313,"DEC 13, 2023",ATL @ TOR,L,34,7,12,0.583,0,0,0.0,3,4,0.75,6,4,10,1,0,3,0,3,17,-17,1,ATL,TOR,ATL,128,,,28,27,18,11
Clint Capela,C,22023,203991,22300296,"DEC 11, 2023",ATL vs. DEN,L,28,6,11,0.545,0,0,0.0,2,2,1.0,4,4,8,2,1,0,0,5,14,-3,1,ATL,ATL,DEN,122,,,24,22,16,10
Clint Capela,C,22023,203991,22301218,"DEC 08, 2023",ATL @ PHI,L,30,6,12,0.5,0,0,0.0,3,4,0.75,10,6,16,2,0,1,2,5,15,-10,1,ATL,PHI,ATL,114,,,33,31,17,18
Clint Capela,C,22023,203991,22301209,"DEC 06, 2023",ATL vs. BKN,L,29,4,6,0.667,0,0,0.0,1,2,0.5,4,8,12,1,0,2,1,5,9,3,1,ATL,ATL,BKN,113,,,22,21,10,13
Clint Capela,C,22023,203991,22300286,"DEC 02, 2023",ATL @ MIL,L,30,4,13,0.308,0,0,0.0,2,2,1.0,8,9,17,4,1,3,2,4,10,1,1,ATL,MIL,ATL,121,,,31,27,14,21
Clint Capela,C,22023,203991,22300272,"NOV 30, 2023",ATL @ SAS,W,23,6,9,0.667,0,0,0.0,0,0,0.0,4,5,9,1,0,1,2,4,12,8,1,ATL,SAS,ATL,137,,,22,21,13,10
Clint Capela,C,22023,203991,22300055,"NOV 28, 2023",ATL @ CLE,L,22,6,10,0.6,0,0,0.0,2,2,1.0,6,3,9,0,2,2,2,1,14,-24,1,ATL,CLE,ATL,105,,,23,23,14,9
Clint Capela,C,22023,203991,22300246,"NOV 26, 2023",ATL @ BOS,L,21,1,5,0.2,0,0,0.0,2,6,0.333,4,4,8,1,1,2,1,0,4,-8,1,ATL,BOS,ATL,103,,,13,12,5,9
Clint Capela,C,22023,203991,22300241,"NOV 25, 2023",ATL @ WAS,W,18,6,14,0.429,0,0,0.0,0,2,0.0,7,4,11,1,0,0,0,2,12,21,1,ATL,WAS,ATL,136,,,24,23,13,12
Clint Capela,C,22023,203991,22300227,"NOV 22, 2023",ATL vs. BKN,W,27,7,8,0.875,0,0,0.0,0,0,0.0,9,6,15,0,0,3,0,1,14,-13,1,ATL,ATL,BKN,147,,,29,29,14,15
Clint Capela,C,22023,203991,22300039,"NOV 21, 2023",ATL vs. IND,L,19,6,9,0.667,0,0,0.0,2,3,0.667,3,2,5,1,0,2,1,4,14,-10,1,ATL,ATL,IND,152,,,20,19,15,6
Clint Capela,C,22023,203991,22300029,"NOV 17, 2023",ATL vs. PHI,L,29,7,11,0.636,0,0,0.0,3,5,0.6,8,3,11,2,1,1,0,3,17,-4,1,ATL,ATL,PHI,116,,,30,28,19,13
Clint Capela,C,22023,203991,22300193,"NOV 15, 2023",ATL vs. NYK,L,26,4,5,0.8,0,0,0.0,0,2,0.0,0,3,3,1,2,2,0,2,8,-21,1,ATL,ATL,NYK,114,,,12,11,9,4
Clint Capela,C,22023,203991,22300018,"NOV 14, 2023",ATL @ DET,W,27,3,4,0.75,0,0,0.0,2,2,1.0,2,6,8,1,2,3,3,5,8,8,1,ATL,DET,ATL,126,,,17,16,9,9
Clint Capela,C,22023,203991,22300175,"NOV 11, 2023",ATL vs. MIA,L,24,4,6,0.667,0,0,0.0,0,0,0.0,7,5,12,0,1,2,0,3,8,7,1,ATL,ATL,MIA,109,,,20,20,8,12
Clint Capela,C,22023,203991,22300172,"NOV 09, 2023",ATL @ ORL,W,26,2,4,0.5,0,0,0.0,2,4,0.5,2,9,11,4,0,1,0,2,6,12,1,ATL,ORL,ATL,120,,,21,17,10,15
Clint Capela,C,22023,203991,22300155,"NOV 06, 2023",ATL @ OKC,L,21,2,5,0.4,0,0,0.0,2,4,0.5,6,6,12,0,1,2,1,2,6,-10,1,ATL,OKC,ATL,117,,,18,18,6,12
Clint Capela,C,22023,203991,22300135,"NOV 04, 2023",ATL @ NOP,W,28,8,9,0.889,0,0,0.0,1,2,0.5,2,5,7,0,0,2,0,2,17,19,1,ATL,NOP,ATL,123,,,24,24,17,7
Clint Capela,C,22023,203991,22300117,"NOV 01, 2023",ATL vs. WAS,W,21,4,6,0.667,0,0,0.0,2,2,1.0,4,7,11,0,1,0,0,0,10,17,1,ATL,ATL,WAS,130,,,21,21,10,11
Clint Capela,C,22023,203991,22300104,"OCT 30, 2023",ATL vs. MIN,W,23,0,3,0.0,0,0,0.0,2,2,1.0,1,4,5,1,0,5,1,3,2,-4,1,ATL,ATL,MIN,127,,,8,7,3,6
Clint Capela,C,22023,203991,22300097,"OCT 29, 2023",ATL @ MIL,W,23,5,10,0.5,0,0,0.0,2,2,1.0,2,10,12,1,1,0,0,1,12,15,1,ATL,MIL,ATL,127,,,25,24,13,13
Clint Capela,C,22023,203991,22300079,"OCT 27, 2023",ATL vs. NYK,L,28,6,12,0.5,0,0,0.0,1,2,0.5,6,7,13,2,0,1,1,3,13,-9,1,ATL,ATL,NYK,120,,,28,26,15,15
Clint Capela,C,22023,203991,22300063,"OCT 25, 2023",ATL @ CHA,L,29,6,10,0.6,0,0,0.0,3,4,0.75,6,7,13,0,1,0,2,1,15,-19,1,ATL,CHA,ATL,110,,,28,28,15,13
Clint Capela,C,22023,203991,22300699,"FEB 03, 2024",ATL vs. GSW,W,25,8,11,0.727,0,0,0.0,1,2,0.5,6,9,15,2,0,0,1,0,17,4,1,ATL,ATL,GSW,141,,,34,32,19,17
Rui Hachimura,F,22023,1629060,22300605,"JAN 21, 2024",LAL vs. POR,W,23,2,7,0.286,1,3,0.333,4,5,0.8,1,1,2,2,1,0,1,2,9,15,1,LAL,LAL,POR,134,,,13,11,11,4
Rui Hachimura,F,22023,1629060,22300331,"DEC 15, 2023",LAL @ SAS,L,34,8,15,0.533,0,5,0.0,4,5,0.8,0,5,5,4,0,1,0,1,20,1,1,LAL,SAS,LAL,115,,,29,25,24,9
Rui Hachimura,F,22023,1629060,22300163,"NOV 08, 2023",LAL @ HOU,L,26,10,15,0.667,2,3,0.667,2,5,0.4,1,7,8,2,2,1,0,0,24,-13,1,LAL,HOU,LAL,94,,,34,32,26,10
Rui Hachimura,F,22023,1629060,22300740,"FEB 08, 2024",LAL vs. DEN,L,38,1,5,0.2,0,2,0.0,0,0,0.0,1,3,4,0,0,1,1,2,2,-12,1,LAL,LAL,DEN,106,,,6,6,2,4
Rui Hachimura,F,22023,1629060,22300713,"FEB 05, 2024",LAL @ CHA,W,29,4,6,0.667,1,3,0.333,0,0,0.0,1,4,5,0,1,0,0,1,9,6,1,LAL,CHA,LAL,124,,,14,14,9,5
Rui Hachimura,F,22023,1629060,22300701,"FEB 03, 2024",LAL @ NYK,W,19,3,5,0.6,0,2,0.0,1,2,0.5,0,4,4,1,0,0,1,2,7,3,1,LAL,NYK,LAL,113,,,12,11,8,5
Rui Hachimura,F,22023,1629060,22300684,"FEB 01, 2024",LAL @ BOS,W,33,5,14,0.357,3,6,0.5,2,2,1.0,2,6,8,4,0,1,2,3,15,4,1,LAL,BOS,LAL,114,,,27,23,19,12
Rui Hachimura,F,22023,1629060,22300669,"JAN 30, 2024",LAL @ ATL,L,23,7,11,0.636,2,4,0.5,0,2,0.0,2,2,4,0,2,0,1,0,16,-9,1,LAL,ATL,LAL,122,,,20,20,16,4
Rui Hachimura,F,22023,1629060,22300662,"JAN 29, 2024",LAL @ HOU,L,22,4,5,0.8,2,3,0.667,6,8,0.75,0,5,5,1,1,0,0,0,16,0,1,LAL,HOU,LAL,119,,,22,21,17,6
Rui Hachimura,F,22023,1629060,22300650,"JAN 27, 2024",LAL @ GSW,W,18,4,4,1.0,1,1,1.0,2,2,1.0,0,4,4,0,0,0,1,1,11,6,1,LAL,GSW,LAL,145,,,15,15,11,4
Rui Hachimura,F,22023,1629060,22300633,"JAN 25, 2024",LAL vs. CHI,W,19,3,3,1.0,2,2,1.0,2,2,1.0,0,3,3,2,1,0,1,3,10,4,1,LAL,LAL,CHI,141,,,15,13,12,5
Rui Hachimura,F,22023,1629060,22300618,"JAN 23, 2024",LAL @ LAC,L,30,5,8,0.625,1,1,1.0,0,0,0.0,1,2,3,2,1,1,0,1,11,-8,1,LAL,LAC,LAL,116,,,16,14,13,5
Rui Hachimura,F,22023,1629060,22300591,"JAN 19, 2024",LAL vs. BKN,L,15,0,6,0.0,0,3,0.0,0,0,0.0,1,1,2,1,0,0,1,0,0,-1,1,LAL,LAL,BKN,112,,,3,2,1,3
Rui Hachimura,F,22023,1629060,22300577,"JAN 17, 2024",LAL vs. DAL,W,22,2,6,0.333,1,4,0.25,1,2,0.5,1,3,4,1,2,0,0,1,6,-1,1,LAL,LAL,DAL,127,,,11,10,7,5
Rui Hachimura,F,22023,1629060,22300565,"JAN 15, 2024",LAL vs. OKC,W,20,5,8,0.625,2,3,0.667,0,0,0.0,1,2,3,0,0,2,1,1,12,6,1,LAL,LAL,OKC,112,,,15,15,12,3
Rui Hachimura,F,22023,1629060,22300549,"JAN 13, 2024",LAL @ UTA,L,19,6,12,0.5,0,2,0.0,5,6,0.833,1,2,3,1,1,0,0,0,17,12,1,LAL,UTA,LAL,125,,,21,20,18,4
Rui Hachimura,F,22023,1629060,22300446,"DEC 31, 2023",LAL @ NOP,L,8,1,1,1.0,0,0,0.0,2,2,1.0,0,1,1,1,1,0,1,0,4,-4,1,LAL,NOP,LAL,109,,,6,5,5,2
Rui Hachimura,F,22023,1629060,22300428,"DEC 28, 2023",LAL vs. CHA,W,28,7,12,0.583,0,1,0.0,3,3,1.0,0,4,4,1,1,0,0,2,17,34,1,LAL,LAL,CHA,133,,,22,21,18,5
Rui Hachimura,F,22023,1629060,22300370,"DEC 20, 2023",LAL @ CHI,L,16,2,9,0.222,1,2,0.5,0,0,0.0,3,2,5,1,0,0,0,0,5,-12,1,LAL,CHI,LAL,108,,,11,10,6,6
Rui Hachimura,F,22023,1629060,22300316,"DEC 13, 2023",LAL @ SAS,W,24,6,10,0.6,1,2,0.5,0,0,0.0,0,7,7,1,0,1,3,2,13,15,1,LAL,SAS,LAL,122,,,21,20,14,8
Rui Hachimura,F,22023,1629060,22300306,"DEC 12, 2023",LAL @ DAL,L,29,3,9,0.333,1,2,0.5,0,0,0.0,0,3,3,2,1,0,1,3,7,-3,1,LAL,DAL,LAL,125,,,12,10,9,5
Rui Hachimura,F,22023,1629060,22301230,"DEC 07, 2023",LAL vs. NOP,W,21,5,9,0.556,1,3,0.333,1,2,0.5,0,1,1,2,0,0,0,3,12,9,1,LAL,LAL,NOP,133,,,15,13,14,3
Rui Hachimura,F,22023,1629060,22301203,"DEC 05, 2023",LAL vs. PHX,W,21,3,8,0.375,1,4,0.25,0,0,0.0,0,2,2,1,0,0,0,1,7,5,1,LAL,LAL,PHX,106,,,10,9,8,3
Rui Hachimura,F,22023,1629060,22300238,"NOV 22, 2023",LAL vs. DAL,L,26,4,11,0.364,1,2,0.5,0,0,0.0,2,1,3,1,0,0,1,3,9,-8,1,LAL,LAL,DAL,101,,,13,12,10,4
Rui Hachimura,F,22023,1629060,22300042,"NOV 21, 2023",LAL vs. UTA,W,28,4,13,0.308,2,5,0.4,2,2,1.0,2,4,6,1,0,0,1,3,12,21,1,LAL,LAL,UTA,131,,,19,18,13,7
Rui Hachimura,F,22023,1629060,22300036,"NOV 17, 2023",LAL @ POR,W,28,3,5,0.6,1,2,0.5,0,0,0.0,1,4,5,2,0,0,0,1,7,9,1,LAL,POR,LAL,107,,,14,12,9,7
Rui Hachimura,F,22023,1629060,22300198,"NOV 15, 2023",LAL vs. SAC,L,18,2,5,0.4,1,1,1.0,0,0,0.0,0,0,0,0,0,0,0,0,5,-5,1,LAL,LAL,SAC,110,,,5,5,5,0
Rui Hachimura,F,22023,1629060,22300026,"NOV 14, 2023",LAL vs. MEM,W,24,8,10,0.8,3,3,1.0,4,4,1.0,0,3,3,0,0,0,5,2,23,6,1,LAL,LAL,MEM,134,,,26,26,23,3
Rui Hachimura,F,22023,1629060,22300187,"NOV 12, 2023",LAL vs. POR,W,33,6,10,0.6,1,3,0.333,6,6,1.0,1,4,5,2,2,0,1,1,19,17,1,LAL,LAL,POR,116,,,26,24,21,7
Rui Hachimura,F,22023,1629060,22300061,"OCT 24, 2023",LAL @ DEN,L,15,3,10,0.3,0,3,0.0,0,0,0.0,2,1,3,0,0,0,0,2,6,-8,1,LAL,DEN,LAL,107,,,9,9,6,3
Rui Hachimura,F,22023,1629060,22300747,"FEB 09, 2024",LAL vs. NOP,W,37,9,13,0.692,2,5,0.4,1,2,0.5,0,5,5,1,0,1,0,3,21,21,1,LAL,LAL,NOP,139,,,27,26,22,6
Rui Hachimura,F,22023,1629060,22300443,"DEC 30, 2023",LAL @ MIN,L,17,2,8,0.25,0,1,0.0,1,1,1.0,1,0,1,0,0,0,0,0,5,-11,1,LAL,MIN,LAL,106,,,6,6,5,1
Rui Hachimura,F,22023,1629060,22300403,"DEC 25, 2023",LAL vs. BOS,L,29,5,14,0.357,2,9,0.222,0,0,0.0,0,3,3,0,0,0,1,2,12,5,1,LAL,LAL,BOS,115,,,15,15,12,3
Rui Hachimura,F,22023,1629060,22300397,"DEC 23, 2023",LAL @ OKC,W,30,8,14,0.571,3,5,0.6,2,2,1.0,0,6,6,2,1,0,0,0,21,1,1,LAL,OKC,LAL,129,,,29,27,23,8
Rui Hachimura,F,22023,1629060,22300380,"DEC 21, 2023",LAL @ MIN,L,34,7,12,0.583,2,5,0.4,2,6,0.333,1,3,4,0,1,0,2,3,18,-6,1,LAL,MIN,LAL,111,,,22,22,18,4
Rui Hachimura,F,22023,1629060,22300359,"DEC 18, 2023",LAL vs. NYK,L,17,3,6,0.5,1,2,0.5,1,1,1.0,2,0,2,0,2,0,0,1,8,-9,1,LAL,LAL,NYK,109,,,10,10,8,2
Rui Hachimura,F,22023,1629060,22300216,"NOV 19, 2023",LAL vs. HOU,W,32,4,10,0.4,0,4,0.0,3,4,0.75,1,3,4,2,2,0,2,0,11,-2,1,LAL,LAL,HOU,105,,,17,15,13,6
Rui Hachimura,F,22023,1629060,22300015,"NOV 10, 2023",LAL @ PHX,W,20,3,6,0.5,1,3,0.333,0,1,0.0,0,3,3,1,4,1,1,3,7,6,1,LAL,PHX,LAL,122,,,11,10,8,4
Rui Hachimura,F,22023,1629060,22300100,"OCT 29, 2023",LAL @ SAC,L,17,3,6,0.5,2,4,0.5,3,4,0.75,2,4,6,1,0,0,0,1,11,9,1,LAL,SAC,LAL,127,,,18,17,12,7
Rui Hachimura,F,22023,1629060,22300076,"OCT 26, 2023",LAL vs. PHX,W,12,2,3,0.667,1,2,0.5,2,2,1.0,0,0,0,0,1,1,1,2,7,-13,1,LAL,LAL,PHX,100,,,7,7,7,0
Russell Westbrook,G,22023,201566,22300099,"OCT 29, 2023",LAC vs. SAS,W,27,8,13,0.615,3,5,0.6,0,3,0.0,1,7,8,3,1,1,2,3,19,30,1,LAC,LAC,SAS,123,,,30,27,22,11
Russell Westbrook,G,22023,201566,22300085,"OCT 27, 2023",LAC @ UTA,L,37,2,4,0.5,0,1,0.0,0,0,0.0,1,8,9,4,1,1,5,4,4,-4,1,LAC,UTA,LAC,118,,,17,13,8,13
Russell Westbrook,G,22023,201566,22300074,"OCT 25, 2023",LAC vs. POR,W,29,5,8,0.625,1,2,0.5,0,0,0.0,2,3,5,13,0,0,3,3,11,30,1,LAC,LAC,POR,123,,,29,16,24,18
Russell Westbrook,G,22023,201566,22300731,"FEB 07, 2024",LAC vs. NOP,L,18,2,7,0.286,0,2,0.0,0,0,0.0,2,1,3,4,1,0,3,2,4,-12,1,LAC,LAC,NOP,106,,,11,7,8,7
Russell Westbrook,G,22023,201566,22300688,"FEB 02, 2024",LAC @ DET,W,25,10,13,0.769,2,3,0.667,1,2,0.5,1,2,3,9,2,0,2,2,23,15,1,LAC,DET,LAC,136,,,35,26,32,12
Russell Westbrook,G,22023,201566,22300676,"JAN 31, 2024",LAC @ WAS,W,21,4,11,0.364,0,1,0.0,1,2,0.5,2,1,3,7,0,0,0,0,9,10,1,LAC,WAS,LAC,125,,,19,12,16,10
Russell Westbrook,G,22023,201566,22300658,"JAN 29, 2024",LAC @ CLE,L,22,5,8,0.625,0,2,0.0,3,4,0.75,0,4,4,3,0,0,4,1,13,-5,1,LAC,CLE,LAC,108,,,20,17,16,7
Russell Westbrook,G,22023,201566,22300646,"JAN 27, 2024",LAC @ BOS,W,15,2,9,0.222,0,2,0.0,0,0,0.0,1,3,4,5,0,0,1,0,4,3,1,LAC,BOS,LAC,115,,,13,8,9,9
Russell Westbrook,G,22023,201566,22300637,"JAN 26, 2024",LAC @ TOR,W,26,7,14,0.5,0,2,0.0,6,6,1.0,3,2,5,3,2,2,0,3,20,-2,1,LAC,TOR,LAC,127,,,28,25,23,8
Russell Westbrook,G,22023,201566,22300537,"JAN 12, 2024",LAC @ MEM,W,16,5,11,0.455,1,3,0.333,1,3,0.333,1,1,2,2,0,0,1,1,12,0,1,LAC,MEM,LAC,128,,,16,14,14,4
Russell Westbrook,G,22023,201566,22300511,"JAN 08, 2024",LAC vs. PHX,W,15,3,6,0.5,0,1,0.0,3,3,1.0,2,0,2,7,2,0,1,2,9,-3,1,LAC,LAC,PHX,138,,,18,11,16,9
Russell Westbrook,G,22023,201566,22300486,"JAN 05, 2024",LAC @ NOP,W,22,3,6,0.5,1,3,0.333,1,2,0.5,2,3,5,5,2,2,4,2,8,7,1,LAC,NOP,LAC,111,,,18,13,13,10
Russell Westbrook,G,22023,201566,22300458,"JAN 01, 2024",LAC vs. MIA,W,18,4,10,0.4,0,1,0.0,0,0,0.0,2,2,4,3,2,0,2,0,8,-4,1,LAC,LAC,MIA,121,,,15,12,11,7
Russell Westbrook,G,22023,201566,22300389,"DEC 23, 2023",LAC vs. BOS,L,21,4,11,0.364,0,2,0.0,4,4,1.0,1,4,5,5,0,1,1,3,12,0,1,LAC,LAC,BOS,108,,,22,17,17,10
Russell Westbrook,G,22023,201566,22300379,"DEC 21, 2023",LAC @ OKC,L,30,7,12,0.583,0,2,0.0,1,1,1.0,4,9,13,4,0,0,5,3,15,-5,1,LAC,OKC,LAC,115,,,32,28,19,17
Russell Westbrook,G,22023,201566,22300350,"DEC 18, 2023",LAC @ IND,W,17,4,6,0.667,0,0,0.0,2,4,0.5,3,1,4,5,1,1,1,2,10,-2,1,LAC,IND,LAC,151,,,19,14,15,9
Russell Westbrook,G,22023,201566,22300343,"DEC 16, 2023",LAC vs. NYK,W,15,4,7,0.571,0,1,0.0,2,4,0.5,3,3,6,4,1,0,0,1,10,2,1,LAC,LAC,NYK,144,,,20,16,14,10
Russell Westbrook,G,22023,201566,22300618,"JAN 23, 2024",LAC vs. LAL,W,18,6,11,0.545,3,3,1.0,1,1,1.0,0,6,6,3,2,0,3,1,16,1,1,LAC,LAC,LAL,127,,,25,22,19,9
Russell Westbrook,G,22023,201566,22300438,"DEC 29, 2023",LAC vs. MEM,W,20,6,9,0.667,2,4,0.5,0,0,0.0,1,5,6,6,0,0,4,1,14,2,1,LAC,LAC,MEM,117,,,26,20,20,12
Russell Westbrook,G,22023,201566,22300414,"DEC 26, 2023",LAC vs. CHA,W,28,5,8,0.625,2,2,1.0,2,3,0.667,1,10,11,6,2,1,2,2,14,4,1,LAC,LAC,CHA,113,,,31,25,20,17
Russell Westbrook,G,22023,201566,22300325,"DEC 14, 2023",LAC vs. GSW,W,19,4,7,0.571,1,2,0.5,0,0,0.0,0,4,4,2,0,1,2,0,9,7,1,LAC,LAC,GSW,121,,,15,13,11,6
Russell Westbrook,G,22023,201566,22300309,"DEC 12, 2023",LAC vs. SAC,W,20,4,8,0.5,0,1,0.0,0,0,0.0,2,5,7,3,0,0,4,0,8,12,1,LAC,LAC,SAC,117,,,18,15,11,10
Russell Westbrook,G,22023,201566,22300304,"DEC 11, 2023",LAC vs. POR,W,16,5,7,0.714,1,2,0.5,1,2,0.5,1,1,2,6,0,1,4,1,12,0,1,LAC,LAC,POR,132,,,20,14,18,8
Russell Westbrook,G,22023,201566,22301225,"DEC 08, 2023",LAC @ UTA,W,17,2,7,0.286,1,2,0.5,0,0,0.0,0,5,5,2,1,2,3,2,5,-5,1,LAC,UTA,LAC,117,,,12,10,7,7
Russell Westbrook,G,22023,201566,22301215,"DEC 06, 2023",LAC vs. DEN,W,16,4,8,0.5,0,2,0.0,1,2,0.5,4,4,8,1,0,2,1,1,9,3,1,LAC,LAC,DEN,111,,,18,17,10,9
Russell Westbrook,G,22023,201566,22300280,"DEC 02, 2023",LAC vs. GSW,W,19,2,5,0.4,2,4,0.5,2,4,0.5,0,6,6,2,0,1,0,0,8,-11,1,LAC,LAC,GSW,113,,,16,14,10,8
Russell Westbrook,G,22023,201566,22300273,"NOV 30, 2023",LAC @ GSW,L,26,5,13,0.385,0,3,0.0,4,6,0.667,6,5,11,6,0,0,0,1,14,-10,1,LAC,GSW,LAC,114,,,31,25,20,17
Russell Westbrook,G,22023,201566,22300264,"NOV 29, 2023",LAC @ SAC,W,19,2,6,0.333,0,1,0.0,5,6,0.833,1,4,5,8,1,0,1,2,9,-3,1,LAC,SAC,LAC,131,,,22,14,17,13
Russell Westbrook,G,22023,201566,22300244,"NOV 25, 2023",LAC vs. DAL,W,25,6,9,0.667,0,1,0.0,2,3,0.667,4,4,8,7,0,0,2,2,14,1,1,LAC,LAC,DAL,107,,,29,22,21,15
Russell Westbrook,G,22023,201566,22300014,"NOV 10, 2023",LAC @ DAL,L,20,5,11,0.455,0,1,0.0,4,5,0.8,2,3,5,2,3,0,2,1,14,-26,1,LAC,DAL,LAC,126,,,21,19,16,7
Russell Westbrook,G,22023,201566,22300151,"NOV 06, 2023",LAC @ NYK,L,31,8,13,0.615,1,3,0.333,0,0,0.0,0,4,4,4,0,0,4,2,17,-7,1,LAC,NYK,LAC,97,,,25,21,21,8
Russell Westbrook,G,22023,201566,22300127,"NOV 01, 2023",LAC @ LAL,L,44,9,21,0.429,3,6,0.5,3,5,0.6,4,7,11,8,4,0,6,5,24,-8,1,LAC,LAL,LAC,125,,,43,35,32,19
Russell Westbrook,G,22023,201566,22300114,"OCT 31, 2023",LAC vs. ORL,W,33,8,16,0.5,0,4,0.0,2,2,1.0,0,6,6,7,5,1,3,4,18,16,1,LAC,LAC,ORL,118,,,31,24,25,13
Russell Westbrook,G,22023,201566,22300749,"FEB 10, 2024",LAC vs. DET,W,28,5,10,0.5,2,4,0.5,1,2,0.5,0,3,3,2,1,0,1,1,13,10,1,LAC,LAC,DET,112,,,18,16,15,5
Russell Westbrook,G,22023,201566,22300716,"FEB 05, 2024",LAC @ ATL,W,26,6,10,0.6,0,2,0.0,1,3,0.333,0,5,5,3,2,1,2,1,13,-3,1,LAC,ATL,LAC,149,,,21,18,16,8
Russell Westbrook,G,22023,201566,22300708,"FEB 04, 2024",LAC @ MIA,W,15,2,9,0.222,1,4,0.25,0,0,0.0,0,1,1,2,1,0,3,0,5,1,1,LAC,MIA,LAC,103,,,8,6,7,3
Russell Westbrook,G,22023,201566,22300600,"JAN 21, 2024",LAC vs. BKN,W,31,10,16,0.625,1,2,0.5,2,4,0.5,3,6,9,6,1,1,2,3,23,22,1,LAC,LAC,BKN,125,,,38,32,29,15
Russell Westbrook,G,22023,201566,22300568,"JAN 16, 2024",LAC vs. OKC,W,22,4,8,0.5,0,3,0.0,3,4,0.75,1,1,2,4,1,0,2,0,11,6,1,LAC,LAC,OKC,128,,,17,13,15,6
Russell Westbrook,G,22023,201566,22300553,"JAN 14, 2024",LAC @ MIN,L,29,3,8,0.375,2,2,1.0,4,5,0.8,3,5,8,13,2,0,3,4,12,2,1,LAC,MIN,LAC,105,,,33,20,25,21
Russell Westbrook,G,22023,201566,22300526,"JAN 10, 2024",LAC vs. TOR,W,14,3,9,0.333,0,1,0.0,0,0,0.0,0,0,0,3,0,0,0,0,6,-2,1,LAC,LAC,TOR,126,,,9,6,9,3
Russell Westbrook,G,22023,201566,22300505,"JAN 07, 2024",LAC @ LAL,L,19,3,9,0.333,1,4,0.25,0,0,0.0,0,1,1,3,1,0,0,1,7,-12,1,LAC,LAL,LAC,103,,,11,8,10,4
Russell Westbrook,G,22023,201566,22300473,"JAN 03, 2024",LAC @ PHX,W,18,2,7,0.286,0,2,0.0,2,2,1.0,2,3,5,2,2,0,2,1,6,6,1,LAC,PHX,LAC,131,,,13,11,8,7
Russell Westbrook,G,22023,201566,22300372,"DEC 20, 2023",LAC @ DAL,W,23,5,9,0.556,0,2,0.0,0,0,0.0,0,6,6,3,2,0,2,3,10,15,1,LAC,DAL,LAC,120,,,19,16,13,9
Russell Westbrook,G,22023,201566,22300235,"NOV 22, 2023",LAC @ SAS,W,27,3,8,0.375,0,1,0.0,2,2,1.0,1,5,6,7,2,0,4,4,8,3,1,LAC,SAS,LAC,109,,,21,14,15,13
Russell Westbrook,G,22023,201566,22300223,"NOV 20, 2023",LAC @ SAS,W,25,4,11,0.364,0,1,0.0,2,4,0.5,0,2,2,6,3,0,0,1,10,7,1,LAC,SAS,LAC,124,,,18,12,16,8
Russell Westbrook,G,22023,201566,22300179,"NOV 12, 2023",LAC vs. MEM,L,31,5,13,0.385,1,4,0.25,1,2,0.5,1,8,9,5,3,0,4,3,12,10,1,LAC,LAC,MEM,101,,,26,21,17,14
Russell Westbrook,G,22023,201566,22300257,"NOV 27, 2023",LAC vs. DEN,L,27,5,9,0.556,0,0,0.0,4,6,0.667,1,10,11,3,0,1,2,4,14,-11,1,LAC,LAC,DEN,104,,,28,25,17,14
Russell Westbrook,G,22023,201566,22300052,"NOV 24, 2023",LAC vs. NOP,L,14,1,8,0.125,0,2,0.0,1,2,0.5,1,3,4,2,0,1,0,2,3,-8,1,LAC,LAC,NOP,106,,,9,7,5,6
Russell Westbrook,G,22023,201566,22300037,"NOV 17, 2023",LAC vs. HOU,W,17,2,9,0.222,2,6,0.333,2,4,0.5,0,3,3,2,0,0,2,1,8,-9,1,LAC,LAC,HOU,106,,,13,11,10,5
Russell Westbrook,G,22023,201566,22300024,"NOV 14, 2023",LAC @ DEN,L,24,4,12,0.333,0,1,0.0,0,0,0.0,1,5,6,3,2,0,3,3,8,1,1,LAC,DEN,LAC,108,,,17,14,11,9
Russell Westbrook,G,22023,201566,22300160,"NOV 08, 2023",LAC @ BKN,L,31,6,18,0.333,1,5,0.2,0,0,0.0,3,4,7,8,0,0,1,1,13,-5,1,LAC,BKN,LAC,93,,,28,20,21,15
Obi Toppin,F,22023,1630167,22300550,"JAN 14, 2024",IND @ DEN,L,25,4,5,0.8,3,3,1.0,0,0,0.0,0,3,3,1,1,0,0,2,11,8,1,IND,DEN,IND,109,,,15,14,12,4
Obi Toppin,F,22023,1630167,22300533,"JAN 12, 2024",IND @ ATL,W,21,7,7,1.0,0,0,0.0,4,4,1.0,2,5,7,4,0,0,1,4,18,10,1,IND,ATL,IND,126,,,29,25,22,11
Obi Toppin,F,22023,1630167,22300520,"JAN 10, 2024",IND vs. WAS,W,28,6,10,0.6,3,6,0.5,0,0,0.0,1,6,7,3,0,0,2,2,15,3,1,IND,IND,WAS,112,,,25,22,18,10
Obi Toppin,F,22023,1630167,22300507,"JAN 08, 2024",IND vs. BOS,W,20,4,5,0.8,3,4,0.75,2,2,1.0,0,0,0,1,0,0,0,2,13,3,1,IND,IND,BOS,133,,,14,13,14,1
Obi Toppin,F,22023,1630167,22300480,"JAN 05, 2024",IND vs. ATL,W,22,3,6,0.5,3,5,0.6,0,0,0.0,0,3,3,2,1,0,1,2,9,23,1,IND,IND,ATL,148,,,14,12,11,5
Obi Toppin,F,22023,1630167,22300466,"JAN 03, 2024",IND vs. MIL,W,27,5,12,0.417,2,6,0.333,3,4,0.75,3,5,8,4,1,0,0,3,15,-6,1,IND,IND,MIL,142,,,27,23,19,12
Obi Toppin,F,22023,1630167,22300377,"DEC 21, 2023",IND @ MEM,L,28,8,14,0.571,5,9,0.556,1,2,0.5,2,3,5,1,2,0,1,3,22,9,1,IND,MEM,IND,103,,,28,27,23,6
Obi Toppin,F,22023,1630167,22300365,"DEC 20, 2023",IND vs. CHA,W,23,2,5,0.4,0,3,0.0,2,2,1.0,0,4,4,0,0,0,1,1,6,25,1,IND,IND,CHA,142,,,10,10,6,4
Obi Toppin,F,22023,1630167,22300350,"DEC 18, 2023",IND vs. LAC,L,30,6,8,0.75,2,3,0.667,0,0,0.0,1,2,3,4,0,2,0,3,14,-26,1,IND,IND,LAC,127,,,21,17,18,7
Obi Toppin,F,22023,1630167,22300338,"DEC 16, 2023",IND @ MIN,L,17,3,4,0.75,1,2,0.5,0,0,0.0,2,2,4,1,0,0,1,2,7,-17,1,IND,MIN,IND,109,,,12,11,8,5
Obi Toppin,F,22023,1630167,22300328,"DEC 15, 2023",IND @ WAS,L,26,6,8,0.75,2,3,0.667,2,3,0.667,1,4,5,2,0,0,1,2,16,-11,1,IND,WAS,IND,123,,,23,21,18,7
Obi Toppin,F,22023,1630167,22300315,"DEC 13, 2023",IND @ MIL,L,20,2,7,0.286,1,3,0.333,0,0,0.0,3,4,7,1,0,1,0,6,5,-6,1,IND,MIL,IND,126,,,13,12,6,8
Obi Toppin,F,22023,1630167,22300293,"DEC 11, 2023",IND @ DET,W,12,3,5,0.6,0,2,0.0,0,0,0.0,0,3,3,0,0,0,2,1,6,0,1,IND,DET,IND,131,,,9,9,6,3
Obi Toppin,F,22023,1630167,22301229,"DEC 07, 2023",IND @ MIL,W,21,6,8,0.75,1,3,0.333,1,2,0.5,3,3,6,2,0,0,0,3,14,-7,1,IND,MIL,IND,128,,,22,20,16,8
Obi Toppin,F,22023,1630167,22301202,"DEC 04, 2023",IND vs. BOS,W,26,4,8,0.5,2,4,0.5,2,2,1.0,0,2,2,1,0,2,0,1,12,-2,1,IND,IND,BOS,122,,,15,14,13,3
Obi Toppin,F,22023,1630167,22300284,"DEC 02, 2023",IND @ MIA,W,35,7,8,0.875,4,5,0.8,2,2,1.0,0,2,2,2,1,4,0,5,20,18,1,IND,MIA,IND,144,,,24,22,22,4
Obi Toppin,F,22023,1630167,22300267,"NOV 30, 2023",IND @ MIA,L,33,10,15,0.667,3,7,0.429,2,5,0.4,1,1,2,3,0,1,2,5,25,6,1,IND,MIA,IND,132,,,30,27,28,5
Obi Toppin,F,22023,1630167,22300254,"NOV 27, 2023",IND vs. POR,L,19,3,9,0.333,1,4,0.25,2,2,1.0,2,2,4,2,0,1,1,0,9,0,1,IND,IND,POR,110,,,15,13,11,6
Obi Toppin,F,22023,1630167,22300047,"NOV 24, 2023",IND vs. DET,W,24,6,8,0.75,3,5,0.6,0,0,0.0,1,2,3,2,0,0,0,1,15,5,1,IND,IND,DET,136,,,20,18,17,5
Obi Toppin,F,22023,1630167,22300230,"NOV 22, 2023",IND vs. TOR,L,36,6,9,0.667,2,5,0.4,2,2,1.0,0,3,3,1,2,0,3,1,16,5,1,IND,IND,TOR,131,,,20,19,17,4
Obi Toppin,F,22023,1630167,22300039,"NOV 21, 2023",IND @ ATL,W,34,9,16,0.563,1,6,0.167,2,2,1.0,0,1,1,6,1,1,2,3,21,-3,1,IND,ATL,IND,157,,,28,22,27,7
Obi Toppin,F,22023,1630167,22300209,"NOV 19, 2023",IND vs. ORL,L,16,3,8,0.375,0,3,0.0,0,0,0.0,2,2,4,2,0,0,2,2,6,-14,1,IND,IND,ORL,116,,,12,10,8,6
Obi Toppin,F,22023,1630167,22300019,"NOV 14, 2023",IND @ PHI,W,37,12,15,0.8,1,3,0.333,2,4,0.5,1,5,6,1,0,1,0,1,27,13,1,IND,PHI,IND,132,,,34,33,28,7
Obi Toppin,F,22023,1630167,22300180,"NOV 12, 2023",IND @ PHI,L,21,6,7,0.857,2,3,0.667,0,0,0.0,0,1,1,1,0,0,0,2,14,-14,1,IND,PHI,IND,126,,,16,15,15,2
Obi Toppin,F,22023,1630167,22300171,"NOV 09, 2023",IND vs. MIL,W,13,2,3,0.667,1,2,0.5,2,2,1.0,0,0,0,0,0,0,1,4,7,6,1,IND,IND,MIL,126,,,7,7,7,0
Obi Toppin,F,22023,1630167,22300158,"NOV 08, 2023",IND vs. UTA,W,19,3,7,0.429,0,3,0.0,0,0,0.0,0,1,1,0,3,1,1,2,6,-5,1,IND,IND,UTA,134,,,7,7,6,1
Obi Toppin,F,22023,1630167,22300146,"NOV 06, 2023",IND vs. SAS,W,27,6,11,0.545,1,3,0.333,6,6,1.0,0,2,2,1,2,0,1,3,19,25,1,IND,IND,SAS,152,,,22,21,20,3
Obi Toppin,F,22023,1630167,22300133,"NOV 04, 2023",IND vs. CHA,L,26,5,7,0.714,1,2,0.5,0,0,0.0,1,3,4,0,0,0,0,2,11,1,1,IND,IND,CHA,124,,,15,15,11,4
Obi Toppin,F,22023,1630167,22300001,"NOV 03, 2023",IND vs. CLE,W,21,3,6,0.5,0,1,0.0,0,0,0.0,1,3,4,1,0,0,0,2,6,0,1,IND,IND,CLE,121,,,11,10,7,5
Obi Toppin,F,22023,1630167,22300118,"NOV 01, 2023",IND @ BOS,L,25,5,6,0.833,0,1,0.0,1,2,0.5,2,0,2,1,2,0,1,1,11,-41,1,IND,BOS,IND,104,,,14,13,12,3
Obi Toppin,F,22023,1630167,22300102,"OCT 30, 2023",IND vs. CHI,L,24,2,5,0.4,0,2,0.0,2,2,1.0,2,6,8,0,1,0,0,1,6,9,1,IND,IND,CHI,105,,,14,14,6,8
Obi Toppin,F,22023,1630167,22300091,"OCT 28, 2023",IND @ CLE,W,18,2,5,0.4,0,1,0.0,0,0,0.0,2,2,4,0,0,1,1,1,4,-6,1,IND,CLE,IND,125,,,8,8,4,4
Obi Toppin,F,22023,1630167,22300064,"OCT 25, 2023",IND vs. WAS,W,19,4,9,0.444,2,5,0.4,1,1,1.0,1,3,4,1,1,0,0,0,11,7,1,IND,IND,WAS,143,,,16,15,12,5
Obi Toppin,F,22023,1630167,22300707,"FEB 04, 2024",IND @ CHA,W,11,0,1,0.0,0,1,0.0,0,0,0.0,0,1,1,2,0,0,3,1,0,-14,1,IND,CHA,IND,115,,,3,1,2,3
Obi Toppin,F,22023,1630167,22300627,"JAN 25, 2024",IND vs. PHI,W,19,6,11,0.545,1,4,0.25,0,0,0.0,2,3,5,0,0,1,3,2,13,-19,1,IND,IND,PHI,134,,,18,18,13,5
Obi Toppin,F,22023,1630167,22300564,"JAN 15, 2024",IND @ UTA,L,13,1,3,0.333,0,0,0.0,0,0,0.0,1,2,3,2,1,0,0,1,2,5,1,IND,UTA,IND,105,,,7,5,4,5
Obi Toppin,F,22023,1630167,22300493,"JAN 06, 2024",IND vs. BOS,L,23,4,8,0.5,2,4,0.5,0,0,0.0,1,2,3,1,0,0,0,1,10,-8,1,IND,IND,BOS,101,,,14,13,11,4
Obi Toppin,F,22023,1630167,22300755,"FEB 10, 2024",IND @ NYK,W,17,3,5,0.6,2,2,1.0,1,2,0.5,0,2,2,0,1,0,2,0,9,7,1,IND,NYK,IND,125,,,11,11,9,2
Obi Toppin,F,22023,1630167,22300733,"FEB 08, 2024",IND vs. GSW,L,20,3,5,0.6,1,3,0.333,0,0,0.0,0,1,1,2,0,0,1,1,7,-8,1,IND,IND,GSW,109,,,10,8,9,3
Obi Toppin,F,22023,1630167,22300719,"FEB 06, 2024",IND vs. HOU,W,16,1,1,1.0,1,1,1.0,0,0,0.0,0,4,4,4,1,0,0,0,3,2,1,IND,IND,HOU,132,,,11,7,7,8
Obi Toppin,F,22023,1630167,22300691,"FEB 02, 2024",IND vs. SAC,L,18,2,6,0.333,1,4,0.25,1,2,0.5,0,4,4,1,1,1,1,2,6,-1,1,IND,IND,SAC,122,,,11,10,7,5
Obi Toppin,F,22023,1630167,22300685,"FEB 01, 2024",IND @ NYK,L,22,4,10,0.4,2,2,1.0,2,2,1.0,2,1,3,2,1,2,1,0,12,3,1,IND,NYK,IND,105,,,17,15,14,5
Obi Toppin,F,22023,1630167,22300670,"JAN 30, 2024",IND @ BOS,L,22,5,11,0.455,1,4,0.25,0,0,0.0,3,5,8,2,0,0,2,1,11,-10,1,IND,BOS,IND,124,,,21,19,13,10
Obi Toppin,F,22023,1630167,22300590,"JAN 19, 2024",IND @ POR,L,11,0,3,0.0,0,3,0.0,0,0,0.0,0,0,0,2,0,0,2,2,0,-16,1,IND,POR,IND,115,,,2,0,2,2
Obi Toppin,F,22023,1630167,22300454,"JAN 01, 2024",IND @ MIL,W,29,4,9,0.444,1,3,0.333,2,2,1.0,2,1,3,2,1,0,0,4,11,35,1,IND,MIL,IND,122,,,16,14,13,5
Obi Toppin,F,22023,1630167,22300441,"DEC 30, 2023",IND vs. NYK,W,20,4,6,0.667,1,1,1.0,0,1,0.0,2,6,8,2,0,3,0,4,9,2,1,IND,IND,NYK,140,,,19,17,11,10
Obi Toppin,F,22023,1630167,22300422,"DEC 28, 2023",IND @ CHI,W,25,1,4,0.25,1,3,0.333,0,0,0.0,1,11,12,0,0,1,1,0,3,-11,1,IND,CHI,IND,120,,,15,15,3,12
Obi Toppin,F,22023,1630167,22300409,"DEC 26, 2023",IND @ HOU,W,15,2,3,0.667,1,2,0.5,2,3,0.667,1,1,2,3,1,0,3,2,7,-14,1,IND,HOU,IND,123,,,12,9,10,5
Obi Toppin,F,22023,1630167,22300391,"DEC 23, 2023",IND vs. ORL,L,24,1,6,0.167,0,3,0.0,1,2,0.5,0,6,6,0,0,1,0,2,3,2,1,IND,IND,ORL,110,,,9,9,3,6
Obi Toppin,F,22023,1630167,22300652,"JAN 28, 2024",IND vs. MEM,W,17,1,5,0.2,0,2,0.0,1,1,1.0,0,0,0,2,1,0,2,2,3,6,1,IND,IND,MEM,116,,,5,3,5,2
Obi Toppin,F,22023,1630167,22300636,"JAN 26, 2024",IND vs. PHX,W,33,10,15,0.667,0,2,0.0,3,5,0.6,6,5,11,3,1,1,1,2,23,7,1,IND,IND,PHX,133,,,37,34,26,14
Obi Toppin,F,22023,1630167,22300614,"JAN 23, 2024",IND vs. DEN,L,17,2,4,0.5,0,0,0.0,0,0,0.0,0,2,2,0,0,0,0,0,4,4,1,IND,IND,DEN,109,,,6,6,4,2
Obi Toppin,F,22023,1630167,22300604,"JAN 21, 2024",IND @ PHX,L,26,6,12,0.5,0,2,0.0,1,2,0.5,2,4,6,1,0,0,0,1,13,4,1,IND,PHX,IND,110,,,20,19,14,7
Obi Toppin,F,22023,1630167,22300583,"JAN 18, 2024",IND @ SAC,W,24,4,6,0.667,2,4,0.5,0,0,0.0,0,3,3,4,0,1,0,1,10,21,1,IND,SAC,IND,126,,,17,13,14,7
Corey Kispert,F,22023,1630557,22300753,"FEB 10, 2024",WAS vs. PHI,L,24,2,6,0.333,1,4,0.25,0,0,0.0,0,2,2,0,0,0,0,1,5,-6,1,WAS,WAS,PHI,113,,,7,7,5,2
Corey Kispert,F,22023,1630557,22300743,"FEB 09, 2024",WAS @ BOS,L,24,9,14,0.643,3,6,0.5,3,3,1.0,0,6,6,4,3,0,0,1,24,-14,1,WAS,BOS,WAS,129,,,34,30,28,10
Corey Kispert,F,22023,1630557,22300728,"FEB 07, 2024",WAS vs. CLE,L,33,9,15,0.6,4,9,0.444,1,1,1.0,1,6,7,2,0,0,1,2,23,2,1,WAS,WAS,CLE,106,,,32,30,25,9
Corey Kispert,F,22023,1630557,22300705,"FEB 04, 2024",WAS vs. PHX,L,25,6,13,0.462,0,7,0.0,3,3,1.0,1,1,2,4,1,0,3,4,15,-18,1,WAS,WAS,PHX,109,,,21,17,19,6
Corey Kispert,F,22023,1630557,22300689,"FEB 02, 2024",WAS vs. MIA,L,31,10,18,0.556,6,14,0.429,0,1,0.0,0,4,4,2,0,0,0,3,26,-6,1,WAS,WAS,MIA,102,,,32,30,28,6
Corey Kispert,F,22023,1630557,22300676,"JAN 31, 2024",WAS vs. LAC,L,27,6,11,0.545,3,8,0.375,1,2,0.5,0,2,2,1,0,0,1,1,16,-13,1,WAS,WAS,LAC,107,,,19,18,17,3
Corey Kispert,F,22023,1630557,22300665,"JAN 29, 2024",WAS @ SAS,W,20,3,6,0.5,2,5,0.4,0,0,0.0,0,4,4,3,0,1,1,1,8,-3,1,WAS,SAS,WAS,118,,,15,12,11,7
Corey Kispert,F,22023,1630557,22300642,"JAN 27, 2024",WAS @ DET,W,22,3,7,0.429,2,5,0.4,0,0,0.0,0,2,2,1,0,0,2,2,8,6,1,WAS,DET,WAS,118,,,11,10,9,3
Corey Kispert,F,22023,1630557,22300628,"JAN 25, 2024",WAS vs. UTA,L,20,4,9,0.444,0,4,0.0,0,0,0.0,0,0,0,1,3,0,0,0,8,-20,1,WAS,WAS,UTA,108,,,9,8,9,1
Corey Kispert,F,22023,1630557,22300620,"JAN 24, 2024",WAS vs. MIN,L,16,3,6,0.5,0,0,0.0,1,1,1.0,0,4,4,0,0,0,3,0,7,-6,1,WAS,WAS,MIN,107,,,11,11,7,4
Corey Kispert,F,22023,1630557,22300602,"JAN 21, 2024",WAS vs. DEN,L,18,1,9,0.111,0,6,0.0,4,4,1.0,0,3,3,1,0,0,1,0,6,5,1,WAS,WAS,DEN,104,,,10,9,7,4
Corey Kispert,F,22023,1630557,22300594,"JAN 20, 2024",WAS vs. SAS,L,25,4,10,0.4,1,6,0.167,7,7,1.0,0,2,2,2,1,0,2,1,16,7,1,WAS,WAS,SAS,127,,,20,18,18,4
Corey Kispert,F,22023,1630557,22300579,"JAN 18, 2024",WAS @ NYK,L,17,4,5,0.8,2,3,0.667,0,0,0.0,0,4,4,0,0,0,0,0,10,6,1,WAS,NYK,WAS,109,,,14,14,10,4
Corey Kispert,F,22023,1630557,22300558,"JAN 15, 2024",WAS vs. DET,L,15,3,5,0.6,2,3,0.667,0,0,0.0,0,2,2,3,0,0,1,3,8,-6,1,WAS,WAS,DET,117,,,13,10,11,5
Corey Kispert,F,22023,1630557,22300543,"JAN 13, 2024",WAS @ ATL,W,18,4,8,0.5,3,5,0.6,0,0,0.0,1,3,4,2,0,0,1,3,11,8,1,WAS,ATL,WAS,125,,,17,15,13,6
Corey Kispert,F,22023,1630557,22300520,"JAN 10, 2024",WAS @ IND,L,30,6,11,0.545,3,8,0.375,0,0,0.0,2,1,3,2,0,0,1,0,15,-11,1,WAS,IND,WAS,104,,,20,18,17,5
Corey Kispert,F,22023,1630557,22300508,"JAN 08, 2024",WAS vs. OKC,L,18,4,5,0.8,3,4,0.75,0,0,0.0,0,1,1,2,0,0,1,1,11,-7,1,WAS,WAS,OKC,128,,,14,12,13,3
Corey Kispert,F,22023,1630557,22300494,"JAN 06, 2024",WAS vs. NYK,L,15,3,4,0.75,1,2,0.5,1,1,1.0,0,2,2,1,0,1,4,0,8,-20,1,WAS,WAS,NYK,105,,,11,10,9,3
Corey Kispert,F,22023,1630557,22300482,"JAN 05, 2024",WAS @ CLE,L,20,6,12,0.5,1,6,0.167,0,0,0.0,0,1,1,1,0,1,2,2,13,-7,1,WAS,CLE,WAS,90,,,15,14,14,2
Corey Kispert,F,22023,1630557,22300465,"JAN 03, 2024",WAS @ CLE,L,20,4,9,0.444,0,5,0.0,4,6,0.667,0,1,1,0,0,0,0,0,12,-21,1,WAS,CLE,WAS,101,,,13,13,12,1
Corey Kispert,F,22023,1630557,22300445,"DEC 31, 2023",WAS vs. ATL,L,18,5,10,0.5,1,5,0.2,4,5,0.8,0,0,0,4,0,0,0,0,15,-4,1,WAS,WAS,ATL,126,,,19,15,19,4
Corey Kispert,F,22023,1630557,22300430,"DEC 29, 2023",WAS vs. BKN,W,17,6,10,0.6,3,7,0.429,0,0,0.0,0,0,0,0,0,0,0,2,15,15,1,WAS,WAS,BKN,110,,,15,15,15,0
Corey Kispert,F,22023,1630557,22300416,"DEC 27, 2023",WAS vs. TOR,L,21,5,8,0.625,2,5,0.4,1,1,1.0,1,1,2,2,1,0,2,2,13,-13,1,WAS,WAS,TOR,102,,,17,15,15,4
Corey Kispert,F,22023,1630557,22300407,"DEC 26, 2023",WAS vs. ORL,L,19,6,8,0.75,3,5,0.6,0,2,0.0,0,4,4,1,0,0,0,1,15,6,1,WAS,WAS,ORL,119,,,20,19,16,5
Corey Kispert,F,22023,1630557,22300386,"DEC 22, 2023",WAS @ GSW,L,25,7,15,0.467,2,7,0.286,2,2,1.0,0,1,1,0,0,1,1,3,18,-20,1,WAS,GSW,WAS,118,,,19,19,18,1
Corey Kispert,F,22023,1630557,22300381,"DEC 21, 2023",WAS @ POR,W,22,3,8,0.375,2,6,0.333,1,1,1.0,0,0,0,2,0,0,0,0,9,0,1,WAS,POR,WAS,118,,,11,9,11,2
Corey Kispert,F,22023,1630557,22300358,"DEC 18, 2023",WAS @ SAC,L,21,2,6,0.333,2,5,0.4,1,2,0.5,0,3,3,3,0,0,2,1,7,4,1,WAS,SAC,WAS,131,,,13,10,10,6
Corey Kispert,F,22023,1630557,22300347,"DEC 17, 2023",WAS @ PHX,L,25,2,9,0.222,2,7,0.286,0,0,0.0,0,0,0,1,0,1,0,2,6,-16,1,WAS,PHX,WAS,108,,,7,6,7,1
Corey Kispert,F,22023,1630557,22300328,"DEC 15, 2023",WAS vs. IND,W,28,9,14,0.643,3,7,0.429,2,3,0.667,0,1,1,1,1,1,1,2,23,21,1,WAS,WAS,IND,137,,,25,24,24,2
Corey Kispert,F,22023,1630557,22300311,"DEC 13, 2023",WAS vs. NOP,L,21,4,7,0.571,3,6,0.5,1,2,0.5,0,3,3,0,0,1,1,2,12,-35,1,WAS,WAS,NOP,122,,,15,15,12,3
Corey Kispert,F,22023,1630557,22300295,"DEC 11, 2023",WAS @ PHI,L,23,3,6,0.5,1,3,0.333,2,4,0.5,1,1,2,1,0,0,3,4,9,-21,1,WAS,PHI,WAS,99,,,12,11,10,3
Corey Kispert,F,22023,1630557,22301219,"DEC 08, 2023",WAS @ BKN,L,21,3,11,0.273,1,7,0.143,0,0,0.0,0,2,2,2,0,1,0,2,7,-11,1,WAS,BKN,WAS,97,,,11,9,9,4
Corey Kispert,F,22023,1630557,22301208,"DEC 06, 2023",WAS vs. PHI,L,25,5,7,0.714,4,5,0.8,2,2,1.0,0,3,3,1,1,0,1,1,16,6,1,WAS,WAS,PHI,126,,,20,19,17,4
Corey Kispert,F,22023,1630557,22300274,"DEC 01, 2023",WAS @ ORL,L,23,4,11,0.364,4,6,0.667,3,4,0.75,0,1,1,3,0,0,0,2,15,-2,1,WAS,ORL,WAS,125,,,19,16,18,4
Corey Kispert,F,22023,1630557,22300259,"NOV 29, 2023",WAS @ ORL,L,20,4,7,0.571,2,5,0.4,3,5,0.6,0,1,1,2,2,0,1,1,13,-18,1,WAS,ORL,WAS,120,,,16,14,15,3
Corey Kispert,F,22023,1630557,22300253,"NOV 27, 2023",WAS @ DET,W,19,4,7,0.571,0,1,0.0,0,0,0.0,0,5,5,1,1,0,0,4,8,13,1,WAS,DET,WAS,126,,,14,13,9,6
Corey Kispert,F,22023,1630557,22300241,"NOV 25, 2023",WAS vs. ATL,L,28,3,14,0.214,1,10,0.1,3,3,1.0,0,1,1,2,0,0,0,2,10,-28,1,WAS,WAS,ATL,108,,,13,11,12,3
Corey Kispert,F,22023,1630557,22300049,"NOV 24, 2023",WAS @ MIL,L,33,7,12,0.583,6,10,0.6,0,0,0.0,0,5,5,1,0,0,3,3,20,-2,1,WAS,MIL,WAS,128,,,26,25,21,6
Corey Kispert,F,22023,1630557,22300225,"NOV 22, 2023",WAS @ CHA,L,18,2,7,0.286,1,4,0.25,1,1,1.0,1,3,4,1,0,0,1,1,6,-3,1,WAS,CHA,WAS,114,,,11,10,7,5
Corey Kispert,F,22023,1630557,22300219,"NOV 20, 2023",WAS vs. MIL,L,21,5,9,0.556,1,4,0.25,1,2,0.5,1,1,2,1,1,0,0,1,12,-7,1,WAS,WAS,MIL,129,,,15,14,13,3
Corey Kispert,F,22023,1630557,22300028,"NOV 17, 2023",WAS vs. NYK,L,26,3,5,0.6,1,3,0.333,1,1,1.0,2,1,3,1,1,0,0,1,8,1,1,WAS,WAS,NYK,99,,,12,11,9,4
Corey Kispert,F,22023,1630557,22300192,"NOV 15, 2023",WAS vs. DAL,L,26,3,8,0.375,3,7,0.429,3,4,0.75,0,1,1,4,0,0,0,3,12,2,1,WAS,WAS,DAL,117,,,17,13,16,5
Corey Kispert,F,22023,1630557,22300189,"NOV 13, 2023",WAS @ TOR,L,24,3,7,0.429,2,5,0.4,2,2,1.0,1,1,2,3,1,0,2,2,10,-7,1,WAS,TOR,WAS,107,,,15,12,13,5
Corey Kispert,F,22023,1630557,22300178,"NOV 12, 2023",WAS @ BKN,L,27,2,8,0.25,0,5,0.0,4,4,1.0,1,2,3,4,1,0,1,1,8,4,1,WAS,BKN,WAS,94,,,15,11,12,7
Corey Kispert,F,22023,1630557,22300009,"NOV 10, 2023",WAS vs. CHA,L,16,5,6,0.833,3,3,1.0,2,2,1.0,0,4,4,0,0,0,0,2,15,-6,1,WAS,WAS,CHA,117,,,19,19,15,4
Corey Kispert,F,22023,1630557,22300157,"NOV 08, 2023",WAS @ CHA,W,23,5,9,0.556,2,4,0.5,0,0,0.0,1,2,3,3,1,0,2,2,12,6,1,WAS,CHA,WAS,132,,,18,15,15,6
Corey Kispert,F,22023,1630557,22300148,"NOV 06, 2023",WAS @ PHI,L,14,0,2,0.0,0,2,0.0,3,4,0.75,0,1,1,0,0,0,2,2,3,-22,1,WAS,PHI,WAS,128,,,4,4,3,1
Corey Kispert,F,22023,1630557,22300117,"NOV 01, 2023",WAS @ ATL,L,14,1,5,0.2,0,4,0.0,0,0,0.0,0,0,0,1,0,0,0,1,2,0,1,WAS,ATL,WAS,121,,,3,2,3,1
Corey Kispert,F,22023,1630557,22300103,"OCT 30, 2023",WAS vs. BOS,L,24,3,6,0.5,3,6,0.5,0,2,0.0,0,2,2,0,0,0,2,1,9,-13,1,WAS,WAS,BOS,107,,,11,11,9,2
Corey Kispert,F,22023,1630557,22300089,"OCT 28, 2023",WAS vs. MEM,W,32,8,14,0.571,5,10,0.5,1,1,1.0,0,3,3,1,0,0,2,2,22,5,1,WAS,WAS,MEM,113,,,26,25,23,4
Corey Kispert,F,22023,1630557,22300064,"OCT 25, 2023",WAS @ IND,L,24,4,11,0.364,1,5,0.2,2,2,1.0,2,3,5,1,0,0,1,1,11,-8,1,WAS,IND,WAS,120,,,17,16,12,6
Cam Whitmore,F,22023,1641715,22300744,"FEB 09, 2024",HOU @ TOR,L,18,5,9,0.556,3,5,0.6,4,4,1.0,0,3,3,1,0,0,2,1,17,-1,1,HOU,TOR,HOU,104,,,21,20,18,4
Cam Whitmore,F,22023,1641715,22300719,"FEB 06, 2024",HOU @ IND,L,21,4,11,0.364,1,3,0.333,0,0,0.0,0,1,1,1,0,0,1,3,9,-14,1,HOU,IND,HOU,129,,,11,10,10,2
Cam Whitmore,F,22023,1641715,22300709,"FEB 04, 2024",HOU @ MIN,L,19,4,13,0.308,3,8,0.375,3,6,0.5,0,2,2,1,1,0,2,2,14,-16,1,HOU,MIN,HOU,90,,,17,16,15,3
Cam Whitmore,F,22023,1641715,22300692,"FEB 02, 2024",HOU vs. TOR,W,21,10,17,0.588,3,7,0.429,2,2,1.0,3,3,6,1,2,0,2,1,25,22,1,HOU,HOU,TOR,135,,,32,31,26,7
Cam Whitmore,F,22023,1641715,22300679,"JAN 31, 2024",HOU vs. NOP,L,20,6,12,0.5,3,7,0.429,2,3,0.667,0,0,0,0,1,0,0,1,17,-13,1,HOU,HOU,NOP,99,,,17,17,17,0
Cam Whitmore,F,22023,1641715,22300662,"JAN 29, 2024",HOU vs. LAL,W,18,7,12,0.583,2,6,0.333,4,6,0.667,1,5,6,0,0,0,0,0,20,11,1,HOU,HOU,LAL,135,,,26,26,20,6
Cam Whitmore,F,22023,1641715,22300645,"JAN 27, 2024",HOU @ BKN,L,29,6,16,0.375,3,7,0.429,4,4,1.0,3,6,9,1,0,1,0,1,19,3,1,HOU,BKN,HOU,104,,,29,28,20,10
Cam Whitmore,F,22023,1641715,22300635,"JAN 26, 2024",HOU @ CHA,W,20,9,18,0.5,4,9,0.444,2,2,1.0,2,9,11,2,0,0,0,2,24,26,1,HOU,CHA,HOU,138,,,37,35,26,13
Cam Whitmore,F,22023,1641715,22300623,"JAN 24, 2024",HOU vs. POR,L,14,5,10,0.5,2,6,0.333,0,0,0.0,0,4,4,0,0,0,0,2,12,-5,1,HOU,HOU,POR,131,,,16,16,12,4
Cam Whitmore,F,22023,1641715,22300603,"JAN 21, 2024",HOU vs. BOS,L,27,2,7,0.286,1,4,0.25,0,2,0.0,0,4,4,0,1,1,1,1,5,-15,1,HOU,HOU,BOS,107,,,9,9,5,4
Cam Whitmore,F,22023,1641715,22300598,"JAN 20, 2024",HOU vs. UTA,W,27,6,13,0.462,4,6,0.667,1,3,0.333,1,4,5,1,0,2,2,1,17,8,1,HOU,HOU,UTA,127,,,23,22,18,6
Cam Whitmore,F,22023,1641715,22300573,"JAN 17, 2024",HOU @ NYK,L,9,0,3,0.0,0,1,0.0,0,0,0.0,0,2,2,0,0,0,0,1,0,-7,1,HOU,NYK,HOU,94,,,2,2,0,2
Cam Whitmore,F,22023,1641715,22300555,"JAN 15, 2024",HOU @ PHI,L,23,6,12,0.5,2,5,0.4,0,1,0.0,2,4,6,1,1,0,0,3,14,0,1,HOU,PHI,HOU,115,,,21,20,15,7
Cam Whitmore,F,22023,1641715,22300542,"JAN 13, 2024",HOU @ BOS,L,28,7,13,0.538,2,7,0.286,6,8,0.75,1,6,7,0,1,1,1,2,22,-15,1,HOU,BOS,HOU,113,,,29,29,22,7
Cam Whitmore,F,22023,1641715,22300385,"DEC 22, 2023",HOU vs. DAL,W,14,6,12,0.5,1,6,0.167,1,2,0.5,2,2,4,0,2,0,0,2,14,-10,1,HOU,HOU,DAL,122,,,18,18,14,4
Cam Whitmore,F,22023,1641715,22300291,"DEC 02, 2023",HOU @ LAL,L,3,1,2,0.5,0,0,0.0,3,6,0.5,1,2,3,1,0,0,0,0,5,8,1,HOU,LAL,HOU,97,,,9,8,6,4
Cam Whitmore,F,22023,1641715,22300263,"NOV 29, 2023",HOU @ DEN,L,6,3,4,0.75,1,2,0.5,1,2,0.5,0,2,2,0,0,0,0,1,8,6,1,HOU,DEN,HOU,124,,,10,10,8,2
Cam Whitmore,F,22023,1641715,22300153,"NOV 06, 2023",HOU vs. SAC,W,12,3,5,0.6,0,1,0.0,1,2,0.5,0,1,1,1,1,0,0,1,7,-12,1,HOU,HOU,SAC,122,,,9,8,8,2
Cam Whitmore,F,22023,1641715,22300137,"NOV 04, 2023",HOU vs. SAC,W,1,0,0,0.0,0,0,0.0,0,0,0.0,0,1,1,0,0,0,1,0,0,0,1,HOU,HOU,SAC,107,,,1,1,0,1
Cam Whitmore,F,22023,1641715,22300066,"OCT 25, 2023",HOU @ ORL,L,10,0,4,0.0,0,2,0.0,0,0,0.0,0,1,1,0,0,0,1,0,0,-12,1,HOU,ORL,HOU,86,,,1,1,0,1
Cam Whitmore,F,22023,1641715,22300534,"JAN 12, 2024",HOU @ DET,W,15,1,7,0.143,1,5,0.2,0,0,0.0,0,1,1,0,0,0,0,2,3,6,1,HOU,DET,HOU,112,,,4,4,3,1
Cam Whitmore,F,22023,1641715,22300485,"JAN 05, 2024",HOU vs. MIN,L,15,4,10,0.4,1,4,0.25,2,2,1.0,0,2,2,0,2,0,4,1,11,-9,1,HOU,HOU,MIN,95,,,13,13,11,2
Cam Whitmore,F,22023,1641715,22300469,"JAN 03, 2024",HOU vs. BKN,W,17,4,7,0.571,3,5,0.6,0,0,0.0,0,2,2,1,2,0,1,3,11,-6,1,HOU,HOU,BKN,112,,,14,13,12,3
Cam Whitmore,F,22023,1641715,22300453,"JAN 01, 2024",HOU vs. DET,W,8,4,5,0.8,1,1,1.0,0,0,0.0,1,3,4,0,0,0,0,0,9,-2,1,HOU,HOU,DET,136,,,13,13,9,4
Cam Whitmore,F,22023,1641715,22300418,"DEC 27, 2023",HOU vs. PHX,L,18,4,7,0.571,3,4,0.75,1,2,0.5,0,1,1,0,0,1,1,2,12,1,1,HOU,HOU,PHX,113,,,13,13,12,1
Cam Whitmore,F,22023,1641715,22300523,"JAN 10, 2024",HOU @ CHI,L,33,6,12,0.5,2,5,0.4,2,2,1.0,1,4,5,1,2,0,1,1,16,-3,1,HOU,CHI,HOU,119,,,22,21,17,6
Cam Whitmore,F,22023,1641715,22300509,"JAN 08, 2024",HOU @ MIA,L,17,5,8,0.625,1,2,0.5,0,0,0.0,1,5,6,0,1,0,1,4,11,8,1,HOU,MIA,HOU,113,,,17,17,11,6
Cam Whitmore,F,22023,1641715,22300496,"JAN 06, 2024",HOU vs. MIL,W,13,4,6,0.667,1,1,1.0,3,3,1.0,0,3,3,0,1,0,0,0,12,4,1,HOU,HOU,MIL,112,,,15,15,12,3
Reggie Jackson,G,22023,202704,22300746,"FEB 09, 2024",DEN @ SAC,L,16,3,5,0.6,0,0,0.0,2,2,1.0,0,1,1,4,1,0,3,2,8,-9,1,DEN,SAC,DEN,106,,,13,9,12,5
Reggie Jackson,G,22023,202704,22300740,"FEB 08, 2024",DEN @ LAL,W,26,3,8,0.375,1,4,0.25,0,0,0.0,3,1,4,3,0,0,0,1,7,-10,1,DEN,LAL,DEN,114,,,14,11,10,7
Reggie Jackson,G,22023,202704,22300712,"FEB 04, 2024",DEN vs. POR,W,21,3,11,0.273,1,4,0.25,0,0,0.0,0,4,4,1,1,0,0,2,7,6,1,DEN,DEN,POR,112,,,12,11,8,5
Reggie Jackson,G,22023,202704,22300697,"FEB 02, 2024",DEN vs. POR,W,24,5,9,0.556,1,3,0.333,2,3,0.667,0,0,0,3,0,0,0,3,13,-9,1,DEN,DEN,POR,120,,,16,13,16,3
Reggie Jackson,G,22023,202704,22300682,"JAN 31, 2024",DEN @ OKC,L,30,5,12,0.417,2,3,0.667,4,4,1.0,0,4,4,3,0,1,1,2,16,-12,1,DEN,OKC,DEN,100,,,23,20,19,7
Reggie Jackson,G,22023,202704,22300667,"JAN 29, 2024",DEN vs. MIL,W,20,3,7,0.429,1,2,0.5,2,2,1.0,1,1,2,5,0,0,0,4,9,15,1,DEN,DEN,MIL,113,,,16,11,14,7
Reggie Jackson,G,22023,202704,22300644,"JAN 27, 2024",DEN vs. PHI,W,18,1,6,0.167,1,4,0.25,0,0,0.0,0,3,3,0,0,0,0,0,3,-14,1,DEN,DEN,PHI,111,,,6,6,3,3
Reggie Jackson,G,22023,202704,22300631,"JAN 25, 2024",DEN @ NYK,L,24,1,7,0.143,0,1,0.0,0,0,0.0,1,0,1,3,0,0,0,2,2,-16,1,DEN,NYK,DEN,84,,,6,3,5,4
Reggie Jackson,G,22023,202704,22300614,"JAN 23, 2024",DEN @ IND,W,24,6,11,0.545,1,4,0.25,0,0,0.0,0,2,2,2,2,1,2,3,13,-14,1,DEN,IND,DEN,114,,,17,15,15,4
Reggie Jackson,G,22023,202704,22300602,"JAN 21, 2024",DEN @ WAS,W,21,1,4,0.25,1,2,0.5,0,0,0.0,0,1,1,3,0,0,0,1,3,5,1,DEN,WAS,DEN,113,,,7,4,6,4
Reggie Jackson,G,22023,202704,22300586,"JAN 19, 2024",DEN @ BOS,W,21,2,4,0.5,0,2,0.0,0,0,0.0,1,1,2,2,0,0,2,0,4,10,1,DEN,BOS,DEN,102,,,8,6,6,4
Reggie Jackson,G,22023,202704,22300566,"JAN 16, 2024",DEN @ PHI,L,20,3,6,0.5,2,3,0.667,2,2,1.0,0,2,2,2,1,0,1,0,10,4,1,DEN,PHI,DEN,121,,,14,12,12,4
Reggie Jackson,G,22023,202704,22300550,"JAN 14, 2024",DEN vs. IND,W,23,3,3,1.0,0,0,0.0,3,4,0.75,0,0,0,4,1,0,3,1,9,4,1,DEN,DEN,IND,117,,,13,9,13,4
Reggie Jackson,G,22023,202704,22300539,"JAN 12, 2024",DEN vs. NOP,W,24,5,10,0.5,2,5,0.4,0,0,0.0,0,2,2,0,1,0,3,1,12,4,1,DEN,DEN,NOP,125,,,14,14,12,2
Reggie Jackson,G,22023,202704,22300524,"JAN 10, 2024",DEN @ UTA,L,20,2,7,0.286,1,4,0.25,0,0,0.0,0,0,0,2,0,0,0,2,5,3,1,DEN,UTA,DEN,111,,,7,5,7,2
Reggie Jackson,G,22023,202704,22300502,"JAN 07, 2024",DEN vs. DET,W,21,5,7,0.714,1,1,1.0,2,2,1.0,2,1,3,9,1,0,1,5,13,14,1,DEN,DEN,DET,131,,,25,16,22,12
Reggie Jackson,G,22023,202704,22300488,"JAN 05, 2024",DEN vs. ORL,L,17,5,12,0.417,1,5,0.2,0,0,0.0,1,2,3,3,0,0,1,0,11,1,1,DEN,DEN,ORL,120,,,17,14,14,6
Reggie Jackson,G,22023,202704,22300478,"JAN 04, 2024",DEN @ GSW,W,16,1,6,0.167,0,0,0.0,0,0,0.0,0,0,0,3,0,0,1,0,2,-6,1,DEN,GSW,DEN,130,,,5,2,5,3
Reggie Jackson,G,22023,202704,22300455,"JAN 01, 2024",DEN vs. CHA,W,17,6,11,0.545,2,3,0.667,1,2,0.5,0,4,4,4,1,0,0,2,15,-2,1,DEN,DEN,CHA,111,,,23,19,19,8
Reggie Jackson,G,22023,202704,22300435,"DEC 29, 2023",DEN vs. OKC,L,15,3,10,0.3,2,5,0.4,0,0,0.0,0,2,2,3,1,0,0,0,8,1,1,DEN,DEN,OKC,93,,,13,10,11,5
Reggie Jackson,G,22023,202704,22300425,"DEC 28, 2023",DEN vs. MEM,W,17,3,7,0.429,1,1,1.0,2,2,1.0,1,1,2,7,1,0,3,1,9,15,1,DEN,DEN,MEM,142,,,18,11,16,9
Reggie Jackson,G,22023,202704,22300402,"DEC 25, 2023",DEN vs. GSW,W,15,0,2,0.0,0,0,0.0,2,2,1.0,0,0,0,3,0,0,4,1,2,-14,1,DEN,DEN,GSW,120,,,5,2,5,3
Reggie Jackson,G,22023,202704,22300390,"DEC 23, 2023",DEN @ CHA,W,15,1,9,0.111,0,3,0.0,0,0,0.0,0,3,3,4,1,0,2,3,2,0,1,DEN,CHA,DEN,102,,,9,5,6,7
Reggie Jackson,G,22023,202704,22300383,"DEC 22, 2023",DEN @ BKN,W,16,4,13,0.308,0,5,0.0,0,0,0.0,0,2,2,3,0,0,1,4,8,-15,1,DEN,BKN,DEN,122,,,13,10,11,5
Reggie Jackson,G,22023,202704,22300369,"DEC 20, 2023",DEN @ TOR,W,17,3,7,0.429,0,3,0.0,1,2,0.5,1,1,2,4,0,0,1,1,7,-5,1,DEN,TOR,DEN,113,,,13,9,11,6
Reggie Jackson,G,22023,202704,22300356,"DEC 18, 2023",DEN vs. DAL,W,19,9,12,0.75,1,3,0.333,1,1,1.0,0,1,1,4,0,0,0,2,20,14,1,DEN,DEN,DAL,130,,,25,21,24,5
Reggie Jackson,G,22023,202704,22300340,"DEC 16, 2023",DEN vs. OKC,L,22,3,10,0.3,1,4,0.25,0,0,0.0,1,2,3,3,0,0,1,4,7,4,1,DEN,DEN,OKC,117,,,13,10,10,6
Reggie Jackson,G,22023,202704,22300322,"DEC 14, 2023",DEN vs. BKN,W,23,4,13,0.308,2,4,0.5,2,2,1.0,0,0,0,4,2,0,1,3,12,8,1,DEN,DEN,BKN,124,,,16,12,16,4
Reggie Jackson,G,22023,202704,22300307,"DEC 12, 2023",DEN @ CHI,W,32,9,16,0.563,5,8,0.625,2,2,1.0,0,2,2,6,0,0,2,4,25,13,1,DEN,CHI,DEN,114,,,33,27,31,8
Reggie Jackson,G,22023,202704,22300296,"DEC 11, 2023",DEN @ ATL,W,19,5,10,0.5,1,5,0.2,1,1,1.0,0,1,1,6,0,0,1,0,12,-5,1,DEN,ATL,DEN,129,,,19,13,18,7
Reggie Jackson,G,22023,202704,22301224,"DEC 08, 2023",DEN vs. HOU,L,25,2,8,0.25,0,4,0.0,2,2,1.0,1,2,3,6,0,0,0,2,6,4,1,DEN,DEN,HOU,106,,,15,9,12,9
Reggie Jackson,G,22023,202704,22301215,"DEC 06, 2023",DEN @ LAC,L,19,4,10,0.4,3,4,0.75,3,4,0.75,0,1,1,3,1,0,2,1,14,-11,1,DEN,LAC,DEN,102,,,18,15,17,4
Reggie Jackson,G,22023,202704,22300290,"DEC 02, 2023",DEN @ SAC,L,33,9,18,0.5,2,6,0.333,0,0,0.0,0,1,1,8,1,0,2,3,20,-14,1,DEN,SAC,DEN,117,,,29,21,28,9
Reggie Jackson,G,22023,202704,22300279,"DEC 01, 2023",DEN @ PHX,W,29,8,11,0.727,3,4,0.75,1,2,0.5,0,2,2,4,0,0,1,3,20,0,1,DEN,PHX,DEN,119,,,26,22,24,6
Reggie Jackson,G,22023,202704,22300263,"NOV 29, 2023",DEN vs. HOU,W,24,6,14,0.429,2,7,0.286,0,0,0.0,0,2,2,2,0,1,0,3,14,-1,1,DEN,DEN,HOU,134,,,18,16,16,4
Reggie Jackson,G,22023,202704,22300257,"NOV 27, 2023",DEN @ LAC,W,40,15,19,0.789,3,4,0.75,2,4,0.5,1,4,5,13,2,0,2,3,35,25,1,DEN,LAC,DEN,113,,,53,40,48,18
Reggie Jackson,G,22023,202704,22300252,"NOV 26, 2023",DEN vs. SAS,W,28,7,10,0.7,3,3,1.0,3,3,1.0,2,5,7,6,1,0,4,5,20,15,1,DEN,DEN,SAS,132,,,33,27,26,13
Reggie Jackson,G,22023,202704,22300048,"NOV 24, 2023",DEN @ HOU,L,25,1,7,0.143,0,2,0.0,0,0,0.0,2,2,4,3,0,1,6,0,2,-26,1,DEN,HOU,DEN,86,,,9,6,5,7
Reggie Jackson,G,22023,202704,22300226,"NOV 22, 2023",DEN @ ORL,L,34,5,15,0.333,3,7,0.429,1,1,1.0,1,3,4,9,0,0,1,1,14,-8,1,DEN,ORL,DEN,119,,,27,18,23,13
Reggie Jackson,G,22023,202704,22300218,"NOV 20, 2023",DEN @ DET,W,32,9,15,0.6,1,3,0.333,2,3,0.667,0,3,3,6,1,1,0,2,21,3,1,DEN,DET,DEN,107,,,30,24,27,9
Reggie Jackson,G,22023,202704,22300210,"NOV 19, 2023",DEN @ CLE,L,21,3,5,0.6,1,1,1.0,0,0,0.0,0,0,0,1,2,0,2,2,7,-28,1,DEN,CLE,DEN,109,,,8,7,8,1
Reggie Jackson,G,22023,202704,22300034,"NOV 17, 2023",DEN @ NOP,L,33,6,12,0.5,2,7,0.286,0,0,0.0,1,1,2,3,0,0,4,2,14,-4,1,DEN,NOP,DEN,110,,,19,16,17,5
Reggie Jackson,G,22023,202704,22300024,"NOV 14, 2023",DEN vs. LAC,W,30,7,11,0.636,0,1,0.0,4,6,0.667,0,3,3,4,0,1,2,3,18,9,1,DEN,DEN,LAC,111,,,25,21,22,7
Reggie Jackson,G,22023,202704,22300182,"NOV 12, 2023",DEN @ HOU,L,28,6,12,0.5,2,5,0.4,0,0,0.0,0,4,4,2,0,0,1,2,14,-3,1,DEN,HOU,DEN,104,,,20,18,16,6
Reggie Jackson,G,22023,202704,22300169,"NOV 08, 2023",DEN vs. GSW,W,32,8,17,0.471,3,7,0.429,1,2,0.5,0,2,2,6,0,0,0,5,20,13,1,DEN,DEN,GSW,108,,,28,22,26,8
Reggie Jackson,G,22023,202704,22300156,"NOV 06, 2023",DEN vs. NOP,W,24,2,8,0.25,1,4,0.25,2,2,1.0,0,1,1,4,0,0,0,1,7,16,1,DEN,DEN,NOP,134,,,12,8,11,5
Reggie Jackson,G,22023,202704,22300139,"NOV 04, 2023",DEN vs. CHI,W,25,6,10,0.6,3,5,0.6,1,2,0.5,0,1,1,3,0,1,1,0,16,14,1,DEN,DEN,CHI,123,,,20,17,19,4
Reggie Jackson,G,22023,202704,22300006,"NOV 03, 2023",DEN vs. DAL,W,20,3,10,0.3,1,4,0.25,1,2,0.5,0,1,1,2,4,0,3,1,8,5,1,DEN,DEN,DAL,125,,,11,9,10,3
Reggie Jackson,G,22023,202704,22300123,"NOV 01, 2023",DEN @ MIN,L,19,1,4,0.25,0,1,0.0,0,0,0.0,0,0,0,5,2,1,1,0,2,-4,1,DEN,MIN,DEN,89,,,7,2,7,5
Reggie Jackson,G,22023,202704,22300110,"OCT 30, 2023",DEN vs. UTA,W,19,2,6,0.333,0,3,0.0,0,1,0.0,1,3,4,1,0,0,1,2,4,9,1,DEN,DEN,UTA,110,,,9,8,5,5
Reggie Jackson,G,22023,202704,22300095,"OCT 29, 2023",DEN @ OKC,W,22,2,3,0.667,1,2,0.5,0,0,0.0,0,0,0,6,2,0,2,4,5,13,1,DEN,OKC,DEN,128,,,11,5,11,6
Reggie Jackson,G,22023,202704,22300078,"OCT 27, 2023",DEN @ MEM,W,22,7,13,0.538,2,5,0.4,0,0,0.0,0,2,2,6,0,1,0,0,16,-4,1,DEN,MEM,DEN,108,,,24,18,22,8
Reggie Jackson,G,22023,202704,22300061,"OCT 24, 2023",DEN vs. LAL,W,24,3,8,0.375,2,5,0.4,0,0,0.0,0,3,3,1,1,0,2,0,8,11,1,DEN,DEN,LAL,119,,,12,11,9,4
Malik Beasley,G,22023,1627736,22300745,"FEB 09, 2024",MIL vs. CHA,W,24,7,9,0.778,7,9,0.778,0,1,0.0,1,1,2,2,1,0,0,2,21,31,1,MIL,MIL,CHA,120,,,25,23,23,4
Malik Beasley,G,22023,1627736,22300738,"FEB 08, 2024",MIL vs. MIN,L,33,1,13,0.077,0,9,0.0,1,2,0.5,2,2,4,3,1,0,1,0,3,-13,1,MIL,MIL,MIN,105,,,10,7,6,7
Malik Beasley,G,22023,1627736,22300725,"FEB 06, 2024",MIL @ PHX,L,36,7,17,0.412,6,14,0.429,2,2,1.0,2,2,4,2,0,0,3,1,22,0,1,MIL,PHX,MIL,106,,,28,26,24,6
Malik Beasley,G,22023,1627736,22300711,"FEB 04, 2024",MIL @ UTA,L,30,6,8,0.75,4,6,0.667,0,0,0.0,1,2,3,2,1,0,0,4,16,-21,1,MIL,UTA,MIL,108,,,21,19,18,5
Malik Beasley,G,22023,1627736,22300702,"FEB 03, 2024",MIL @ DAL,W,33,3,9,0.333,3,8,0.375,0,2,0.0,0,7,7,0,2,0,1,1,9,25,1,MIL,DAL,MIL,129,,,16,16,9,7
Malik Beasley,G,22023,1627736,22300683,"JAN 31, 2024",MIL @ POR,L,29,3,8,0.375,1,6,0.167,0,0,0.0,0,6,6,1,1,0,0,3,7,6,1,MIL,POR,MIL,116,,,14,13,8,7
Malik Beasley,G,22023,1627736,22300667,"JAN 29, 2024",MIL @ DEN,L,31,2,9,0.222,1,7,0.143,0,0,0.0,0,1,1,2,0,1,0,1,5,6,1,MIL,DEN,MIL,107,,,8,6,7,3
Malik Beasley,G,22023,1627736,22300648,"JAN 27, 2024",MIL vs. NOP,W,28,3,10,0.3,1,7,0.143,1,2,0.5,1,3,4,2,2,0,2,2,8,26,1,MIL,MIL,NOP,141,,,14,12,10,6
Malik Beasley,G,22023,1627736,22300639,"JAN 26, 2024",MIL vs. CLE,L,27,1,2,0.5,1,2,0.5,0,0,0.0,1,2,3,1,0,0,2,4,3,-9,1,MIL,MIL,CLE,100,,,7,6,4,4
Malik Beasley,G,22023,1627736,22300624,"JAN 24, 2024",MIL vs. CLE,W,28,3,5,0.6,3,5,0.6,0,0,0.0,0,1,1,1,1,0,1,3,9,10,1,MIL,MIL,CLE,126,,,11,10,10,2
Malik Beasley,G,22023,1627736,22300606,"JAN 22, 2024",MIL @ DET,W,35,5,14,0.357,3,8,0.375,0,0,0.0,1,5,6,2,0,0,0,2,13,21,1,MIL,DET,MIL,122,,,21,19,15,8
Malik Beasley,G,22023,1627736,22300592,"JAN 20, 2024",MIL @ DET,W,34,5,9,0.556,1,4,0.25,0,0,0.0,0,2,2,1,0,0,2,4,11,22,1,MIL,DET,MIL,141,,,14,13,12,3
Malik Beasley,G,22023,1627736,22300552,"JAN 14, 2024",MIL vs. SAC,W,45,7,12,0.583,5,9,0.556,4,4,1.0,0,4,4,5,1,0,1,5,23,-1,1,MIL,MIL,SAC,143,,,32,27,28,9
Malik Beasley,G,22023,1627736,22300545,"JAN 13, 2024",MIL vs. GSW,W,29,4,8,0.5,3,6,0.5,0,0,0.0,2,2,4,1,2,0,1,1,11,14,1,MIL,MIL,GSW,129,,,16,15,12,5
Malik Beasley,G,22023,1627736,22300528,"JAN 11, 2024",MIL vs. BOS,W,27,6,11,0.545,4,8,0.5,0,0,0.0,1,3,4,0,0,0,0,0,16,18,1,MIL,MIL,BOS,135,,,20,20,16,4
Malik Beasley,G,22023,1627736,22300510,"JAN 08, 2024",MIL vs. UTA,L,24,6,12,0.5,5,8,0.625,0,0,0.0,1,3,4,2,1,1,0,1,17,-12,1,MIL,MIL,UTA,116,,,23,21,19,6
Malik Beasley,G,22023,1627736,22300496,"JAN 06, 2024",MIL @ HOU,L,16,1,1,1.0,1,1,1.0,0,0,0.0,0,1,1,0,0,0,2,2,3,-10,1,MIL,HOU,MIL,108,,,4,4,3,1
Malik Beasley,G,22023,1627736,22300477,"JAN 04, 2024",MIL @ SAS,W,27,4,6,0.667,2,4,0.5,0,0,0.0,0,2,2,0,0,0,2,0,10,4,1,MIL,SAS,MIL,125,,,12,12,10,2
Malik Beasley,G,22023,1627736,22300466,"JAN 03, 2024",MIL @ IND,L,23,3,8,0.375,2,5,0.4,0,0,0.0,0,1,1,1,0,0,0,4,8,-17,1,MIL,IND,MIL,130,,,10,9,9,2
Malik Beasley,G,22023,1627736,22300454,"JAN 01, 2024",MIL vs. IND,L,37,4,8,0.5,4,8,0.5,0,0,0.0,0,4,4,0,0,0,0,5,12,5,1,MIL,MIL,IND,113,,,16,16,12,4
Malik Beasley,G,22023,1627736,22300433,"DEC 29, 2023",MIL @ CLE,W,35,5,9,0.556,5,8,0.625,0,0,0.0,0,5,5,0,0,0,3,1,15,12,1,MIL,CLE,MIL,119,,,20,20,15,5
Malik Beasley,G,22023,1627736,22300417,"DEC 27, 2023",MIL @ BKN,W,22,6,9,0.667,5,8,0.625,0,0,0.0,1,0,1,1,1,0,0,0,17,-7,1,MIL,BKN,MIL,144,,,19,18,18,2
Malik Beasley,G,22023,1627736,22300401,"DEC 25, 2023",MIL @ NYK,L,19,0,2,0.0,0,1,0.0,0,0,0.0,0,3,3,2,0,0,0,2,0,-10,1,MIL,NYK,MIL,122,,,5,3,2,5
Malik Beasley,G,22023,1627736,22300388,"DEC 23, 2023",MIL @ NYK,W,31,7,13,0.538,5,9,0.556,0,0,0.0,1,5,6,1,0,0,0,3,19,19,1,MIL,NYK,MIL,130,,,26,25,20,7
Malik Beasley,G,22023,1627736,22300378,"DEC 21, 2023",MIL vs. ORL,W,28,3,8,0.375,2,4,0.5,0,0,0.0,1,4,5,2,0,0,0,1,8,15,1,MIL,MIL,ORL,118,,,15,13,10,7
Malik Beasley,G,22023,1627736,22300361,"DEC 19, 2023",MIL vs. SAS,W,28,3,7,0.429,1,5,0.2,0,0,0.0,1,3,4,2,1,0,0,1,7,14,1,MIL,MIL,SAS,132,,,13,11,9,6
Malik Beasley,G,22023,1627736,22300315,"DEC 13, 2023",MIL vs. IND,W,36,3,7,0.429,1,4,0.25,0,0,0.0,4,2,6,2,2,1,0,3,7,20,1,MIL,MIL,IND,140,,,15,13,9,8
Malik Beasley,G,22023,1627736,22300300,"DEC 11, 2023",MIL vs. CHI,W,40,7,11,0.636,5,8,0.625,0,0,0.0,0,4,4,2,1,0,0,2,19,6,1,MIL,MIL,CHI,133,,,25,23,21,6
Malik Beasley,G,22023,1627736,22301229,"DEC 07, 2023",MIL vs. IND,L,36,3,9,0.333,1,4,0.25,0,0,0.0,1,2,3,1,0,0,0,2,7,6,1,MIL,MIL,IND,119,,,11,10,8,4
Malik Beasley,G,22023,1627736,22301201,"DEC 05, 2023",MIL vs. NYK,W,33,6,11,0.545,6,10,0.6,0,0,0.0,0,3,3,0,0,0,0,4,18,16,1,MIL,MIL,NYK,146,,,21,21,18,3
Malik Beasley,G,22023,1627736,22300286,"DEC 02, 2023",MIL vs. ATL,W,39,6,11,0.545,4,7,0.571,0,0,0.0,1,3,4,3,1,0,2,1,16,2,1,MIL,MIL,ATL,132,,,23,20,19,7
Malik Beasley,G,22023,1627736,22300269,"NOV 30, 2023",MIL @ CHI,L,41,7,19,0.368,5,15,0.333,0,0,0.0,0,3,3,3,2,0,1,2,19,1,1,MIL,CHI,MIL,113,,,25,22,22,6
Malik Beasley,G,22023,1627736,22300056,"NOV 28, 2023",MIL @ MIA,W,38,6,11,0.545,4,8,0.5,0,0,0.0,0,10,10,1,0,2,0,1,16,15,1,MIL,MIA,MIL,131,,,27,26,17,11
Malik Beasley,G,22023,1627736,22300245,"NOV 26, 2023",MIL vs. POR,W,36,5,14,0.357,4,11,0.364,0,0,0.0,1,5,6,0,3,0,2,1,14,16,1,MIL,MIL,POR,108,,,20,20,14,6
Malik Beasley,G,22023,1627736,22300049,"NOV 24, 2023",MIL vs. WAS,W,27,4,8,0.5,1,4,0.25,0,0,0.0,4,7,11,1,0,1,2,3,9,4,1,MIL,MIL,WAS,131,,,21,20,10,12
Malik Beasley,G,22023,1627736,22300228,"NOV 22, 2023",MIL @ BOS,L,23,2,3,0.667,2,3,0.667,0,0,0.0,0,3,3,3,2,0,1,1,6,3,1,MIL,BOS,MIL,116,,,12,9,9,6
Malik Beasley,G,22023,1627736,22300219,"NOV 20, 2023",MIL @ WAS,W,33,5,9,0.556,3,5,0.6,3,3,1.0,1,4,5,2,0,0,0,0,16,20,1,MIL,WAS,MIL,142,,,23,21,18,7
Malik Beasley,G,22023,1627736,22300205,"NOV 18, 2023",MIL vs. DAL,W,34,3,9,0.333,1,6,0.167,0,0,0.0,0,6,6,0,1,0,0,3,7,5,1,MIL,MIL,DAL,132,,,13,13,7,6
Malik Beasley,G,22023,1627736,22300027,"NOV 17, 2023",MIL @ CHA,W,30,7,12,0.583,6,10,0.6,0,0,0.0,0,2,2,3,0,0,0,4,20,31,1,MIL,CHA,MIL,130,,,25,22,23,5
Malik Beasley,G,22023,1627736,22300190,"NOV 13, 2023",MIL vs. CHI,W,21,3,6,0.5,3,6,0.5,0,0,0.0,1,1,2,0,0,0,0,3,9,-9,1,MIL,MIL,CHI,118,,,11,11,9,2
Malik Beasley,G,22023,1627736,22300173,"NOV 11, 2023",MIL @ ORL,L,20,0,4,0.0,0,3,0.0,0,0,0.0,0,2,2,1,0,0,1,3,0,-6,1,MIL,ORL,MIL,97,,,3,2,1,3
Malik Beasley,G,22023,1627736,22300171,"NOV 09, 2023",MIL @ IND,L,29,4,10,0.4,3,6,0.5,2,2,1.0,1,3,4,2,1,0,0,2,13,-10,1,MIL,IND,MIL,124,,,19,17,15,6
Malik Beasley,G,22023,1627736,22300165,"NOV 08, 2023",MIL vs. DET,W,25,4,6,0.667,1,2,0.5,1,1,1.0,2,4,6,2,1,0,0,0,10,24,1,MIL,MIL,DET,120,,,18,16,12,8
Malik Beasley,G,22023,1627736,22300149,"NOV 06, 2023",MIL @ BKN,W,14,1,5,0.2,1,5,0.2,0,0,0.0,0,6,6,0,0,0,1,2,3,-9,1,MIL,BKN,MIL,129,,,9,9,3,6
Malik Beasley,G,22023,1627736,22300002,"NOV 03, 2023",MIL vs. NYK,W,22,0,2,0.0,0,1,0.0,0,0,0.0,0,3,3,3,0,0,0,2,0,6,1,MIL,MIL,NYK,110,,,6,3,3,6
Malik Beasley,G,22023,1627736,22300116,"NOV 01, 2023",MIL @ TOR,L,25,7,10,0.7,6,9,0.667,0,0,0.0,0,2,2,0,2,0,0,2,20,-23,1,MIL,TOR,MIL,111,,,22,22,20,2
Malik Beasley,G,22023,1627736,22300107,"OCT 30, 2023",MIL vs. MIA,W,32,2,8,0.25,1,6,0.167,0,2,0.0,0,3,3,2,2,0,2,3,5,-10,1,MIL,MIL,MIA,122,,,10,8,7,5
Malik Beasley,G,22023,1627736,22300097,"OCT 29, 2023",MIL vs. ATL,L,32,6,12,0.5,4,10,0.4,2,4,0.5,1,3,4,1,2,0,2,3,18,-26,1,MIL,MIL,ATL,110,,,23,22,19,5
Malik Beasley,G,22023,1627736,22300075,"OCT 26, 2023",MIL vs. PHI,W,31,2,4,0.5,1,1,1.0,0,0,0.0,0,4,4,3,2,0,2,1,5,-5,1,MIL,MIL,PHI,118,,,12,9,8,7
Malik Beasley,G,22023,1627736,22300572,"JAN 17, 2024",MIL @ CLE,L,22,1,6,0.167,0,3,0.0,0,0,0.0,1,4,5,1,0,0,0,3,2,-27,1,MIL,CLE,MIL,95,,,8,7,3,6
Malik Beasley,G,22023,1627736,22300195,"NOV 15, 2023",MIL @ TOR,W,31,11,14,0.786,8,11,0.727,0,0,0.0,0,4,4,0,1,0,0,2,30,34,1,MIL,TOR,MIL,128,,,34,34,30,4
Wendell Carter Jr.,C,22023,1628976,22300752,"FEB 10, 2024",ORL vs. CHI,W,26,3,6,0.5,0,2,0.0,0,0,0.0,0,3,3,1,0,1,1,2,6,-7,1,ORL,ORL,CHI,114,,,10,9,7,4
Wendell Carter Jr.,C,22023,1628976,22300734,"FEB 08, 2024",ORL vs. SAS,W,26,3,7,0.429,3,4,0.75,1,2,0.5,1,5,6,1,1,0,3,0,10,19,1,ORL,ORL,SAS,127,,,17,16,11,7
Wendell Carter Jr.,C,22023,1628976,22300721,"FEB 06, 2024",ORL @ MIA,L,28,6,9,0.667,2,4,0.5,1,2,0.5,1,5,6,3,0,0,0,5,15,-22,1,ORL,MIA,ORL,95,,,24,21,18,9
Wendell Carter Jr.,C,22023,1628976,22300704,"FEB 04, 2024",ORL @ DET,W,28,3,4,0.75,0,1,0.0,1,3,0.333,1,3,4,2,1,0,3,2,7,9,1,ORL,DET,ORL,111,,,13,11,9,6
Wendell Carter Jr.,C,22023,1628976,22300694,"FEB 02, 2024",ORL @ MIN,W,37,6,12,0.5,2,6,0.333,4,6,0.667,3,9,12,1,0,0,0,3,18,-2,1,ORL,MIN,ORL,108,,,31,30,19,13
Wendell Carter Jr.,C,22023,1628976,22300681,"JAN 31, 2024",ORL @ SAS,W,26,3,7,0.429,1,3,0.333,7,8,0.875,3,2,5,2,0,0,1,4,14,4,1,ORL,SAS,ORL,108,,,21,19,16,7
Wendell Carter Jr.,C,22023,1628976,22300666,"JAN 29, 2024",ORL @ DAL,L,29,2,7,0.286,1,4,0.25,4,5,0.8,5,3,8,2,0,0,1,6,9,-1,1,ORL,DAL,ORL,129,,,19,17,11,10
Wendell Carter Jr.,C,22023,1628976,22300655,"JAN 28, 2024",ORL vs. PHX,W,23,4,8,0.5,1,4,0.25,0,0,0.0,0,3,3,1,0,1,0,1,9,-6,1,ORL,ORL,PHX,113,,,13,12,10,4
Wendell Carter Jr.,C,22023,1628976,22300638,"JAN 26, 2024",ORL @ MEM,L,35,8,9,0.889,2,3,0.667,2,3,0.667,3,6,9,2,2,2,1,3,20,-5,1,ORL,MEM,ORL,106,,,31,29,22,11
Wendell Carter Jr.,C,22023,1628976,22300607,"JAN 22, 2024",ORL vs. CLE,L,27,4,9,0.444,1,2,0.5,1,2,0.5,2,7,9,1,2,0,1,2,10,-22,1,ORL,ORL,CLE,99,,,20,19,11,10
Wendell Carter Jr.,C,22023,1628976,22300601,"JAN 21, 2024",ORL vs. MIA,W,34,7,11,0.636,1,3,0.333,2,2,1.0,2,7,9,2,1,0,1,1,17,21,1,ORL,ORL,MIA,105,,,28,26,19,11
Wendell Carter Jr.,C,22023,1628976,22300585,"JAN 19, 2024",ORL vs. PHI,L,26,9,13,0.692,1,2,0.5,6,7,0.857,6,5,11,0,0,0,3,4,25,2,1,ORL,ORL,PHI,109,,,36,36,25,11
Wendell Carter Jr.,C,22023,1628976,22300570,"JAN 17, 2024",ORL @ ATL,L,24,6,7,0.857,3,4,0.75,3,4,0.75,2,3,5,2,2,1,0,1,18,0,1,ORL,ATL,ORL,104,,,25,23,20,7
Wendell Carter Jr.,C,22023,1628976,22300557,"JAN 15, 2024",ORL @ NYK,W,19,7,11,0.636,1,3,0.333,2,2,1.0,1,2,3,0,0,1,0,1,17,14,1,ORL,NYK,ORL,98,,,20,20,17,3
Wendell Carter Jr.,C,22023,1628976,22300463,"JAN 02, 2024",ORL @ GSW,L,20,1,5,0.2,0,1,0.0,4,4,1.0,0,2,2,1,1,1,0,1,6,4,1,ORL,GSW,ORL,115,,,9,8,7,3
Wendell Carter Jr.,C,22023,1628976,22300450,"DEC 31, 2023",ORL @ PHX,L,24,6,7,0.857,3,3,1.0,2,2,1.0,1,4,5,2,0,0,3,2,17,14,1,ORL,PHX,ORL,107,,,24,22,19,7
Wendell Carter Jr.,C,22023,1628976,22300415,"DEC 27, 2023",ORL vs. PHI,L,22,1,4,0.25,0,2,0.0,2,2,1.0,2,2,4,1,0,2,1,0,4,-8,1,ORL,ORL,PHI,92,,,9,8,5,5
Wendell Carter Jr.,C,22023,1628976,22300407,"DEC 26, 2023",ORL @ WAS,W,21,2,3,0.667,1,1,1.0,1,2,0.5,0,4,4,2,0,1,2,1,6,12,1,ORL,WAS,ORL,127,,,12,10,8,6
Wendell Carter Jr.,C,22023,1628976,22300391,"DEC 23, 2023",ORL @ IND,W,16,2,6,0.333,0,1,0.0,0,0,0.0,3,5,8,4,0,0,1,1,4,-16,1,ORL,IND,ORL,117,,,16,12,8,12
Wendell Carter Jr.,C,22023,1628976,22300378,"DEC 21, 2023",ORL @ MIL,L,21,2,6,0.333,0,3,0.0,0,0,0.0,1,3,4,2,0,1,0,2,4,-27,1,ORL,MIL,ORL,114,,,10,8,6,6
Wendell Carter Jr.,C,22023,1628976,22300366,"DEC 20, 2023",ORL vs. MIA,L,23,3,4,0.75,1,2,0.5,1,2,0.5,1,5,6,1,0,0,0,3,8,3,1,ORL,ORL,MIA,106,,,15,14,9,7
Wendell Carter Jr.,C,22023,1628976,22300130,"NOV 02, 2023",ORL @ UTA,W,29,5,12,0.417,3,6,0.5,1,2,0.5,2,8,10,2,0,1,2,4,14,2,1,ORL,UTA,ORL,115,,,26,24,16,12
Wendell Carter Jr.,C,22023,1628976,22300114,"OCT 31, 2023",ORL @ LAC,L,30,2,8,0.25,0,2,0.0,3,6,0.5,1,7,8,3,1,0,2,2,7,-16,1,ORL,LAC,ORL,102,,,18,15,10,11
Wendell Carter Jr.,C,22023,1628976,22300111,"OCT 30, 2023",ORL @ LAL,L,35,4,8,0.5,1,3,0.333,1,2,0.5,2,6,8,1,0,1,0,4,10,2,1,ORL,LAL,ORL,103,,,19,18,11,9
Wendell Carter Jr.,C,22023,1628976,22300086,"OCT 27, 2023",ORL @ POR,W,26,2,7,0.286,1,3,0.333,3,4,0.75,2,7,9,1,0,0,2,1,8,6,1,ORL,POR,ORL,102,,,18,17,9,10
Wendell Carter Jr.,C,22023,1628976,22300066,"OCT 25, 2023",ORL vs. HOU,W,27,4,10,0.4,0,2,0.0,0,0,0.0,4,4,8,1,2,0,2,3,8,8,1,ORL,ORL,HOU,116,,,17,16,9,9
Wendell Carter Jr.,C,22023,1628976,22300476,"JAN 03, 2024",ORL @ SAC,L,21,3,7,0.429,3,3,1.0,0,0,0.0,1,6,7,3,0,0,1,4,9,9,1,ORL,SAC,ORL,135,,,19,16,12,10
Isaiah Stewart,F,22023,1630191,22300534,"JAN 12, 2024",DET vs. HOU,L,29,6,13,0.462,3,8,0.375,1,2,0.5,0,7,7,1,0,0,3,1,16,-10,1,DET,DET,HOU,110,,,24,23,17,8
Isaiah Stewart,F,22023,1630191,22300394,"DEC 23, 2023",DET @ BKN,L,33,8,9,0.889,4,5,0.8,0,0,0.0,1,4,5,5,1,1,0,5,20,-2,1,DET,BKN,DET,115,,,30,25,25,10
Isaiah Stewart,F,22023,1630191,22300374,"DEC 21, 2023",DET vs. UTA,L,32,3,4,0.75,1,1,1.0,0,1,0.0,2,8,10,4,0,1,0,0,7,12,1,DET,DET,UTA,111,,,21,17,11,14
Isaiah Stewart,F,22023,1630191,22301217,"DEC 08, 2023",DET @ ORL,L,29,1,3,0.333,1,3,0.333,0,0,0.0,0,6,6,2,0,0,1,3,3,-19,1,DET,ORL,DET,91,,,11,9,5,8
Isaiah Stewart,F,22023,1630191,22300283,"DEC 02, 2023",DET vs. CLE,L,30,4,9,0.444,1,5,0.2,2,2,1.0,1,6,7,5,2,0,3,0,11,6,1,DET,DET,CLE,101,,,23,18,16,12
Isaiah Stewart,F,22023,1630191,22300268,"NOV 30, 2023",DET @ NYK,L,32,2,6,0.333,1,4,0.25,0,0,0.0,2,5,7,0,0,0,2,2,5,-4,1,DET,NYK,DET,112,,,12,12,5,7
Isaiah Stewart,F,22023,1630191,22300258,"NOV 29, 2023",DET vs. LAL,L,25,4,9,0.444,3,7,0.429,1,1,1.0,2,1,3,0,0,1,2,3,12,-20,1,DET,DET,LAL,107,,,15,15,12,3
Isaiah Stewart,F,22023,1630191,22300047,"NOV 24, 2023",DET @ IND,L,27,4,8,0.5,0,0,0.0,2,2,1.0,3,3,6,1,2,1,0,1,10,-11,1,DET,IND,DET,113,,,17,16,11,7
Isaiah Stewart,F,22023,1630191,22300218,"NOV 20, 2023",DET vs. DEN,L,35,4,8,0.5,1,2,0.5,2,2,1.0,1,10,11,1,0,2,1,3,11,-1,1,DET,DET,DEN,103,,,23,22,12,12
Isaiah Stewart,F,22023,1630191,22300211,"NOV 19, 2023",DET @ TOR,L,21,3,7,0.429,1,2,0.5,1,1,1.0,1,4,5,1,0,0,0,1,8,-11,1,DET,TOR,DET,113,,,14,13,9,6
Isaiah Stewart,F,22023,1630191,22300030,"NOV 17, 2023",DET @ CLE,L,31,4,11,0.364,1,4,0.25,2,2,1.0,4,6,10,2,1,2,1,0,11,1,1,DET,CLE,DET,100,,,23,21,13,12
Isaiah Stewart,F,22023,1630191,22300018,"NOV 14, 2023",DET vs. ATL,L,19,4,9,0.444,1,5,0.2,1,1,1.0,0,1,1,0,0,1,0,1,10,0,1,DET,DET,ATL,120,,,11,11,10,1
Isaiah Stewart,F,22023,1630191,22300181,"NOV 12, 2023",DET @ CHI,L,31,6,13,0.462,3,5,0.6,2,4,0.5,6,5,11,2,0,0,3,3,17,-10,1,DET,CHI,DET,108,,,30,28,19,13
Isaiah Stewart,F,22023,1630191,22300008,"NOV 10, 2023",DET vs. PHI,L,32,4,10,0.4,2,5,0.4,0,0,0.0,1,5,6,2,0,1,3,5,10,-16,1,DET,DET,PHI,106,,,18,16,12,8
Isaiah Stewart,F,22023,1630191,22300165,"NOV 08, 2023",DET @ MIL,L,37,3,9,0.333,2,7,0.286,0,0,0.0,1,3,4,1,0,2,1,4,8,-5,1,DET,MIL,DET,118,,,13,12,9,5
Isaiah Stewart,F,22023,1630191,22300145,"NOV 06, 2023",DET vs. GSW,L,39,5,9,0.556,3,5,0.6,4,4,1.0,2,9,11,4,0,1,3,3,17,-1,1,DET,DET,GSW,109,,,32,28,21,15
Isaiah Stewart,F,22023,1630191,22300140,"NOV 05, 2023",DET vs. PHX,L,34,3,6,0.5,1,2,0.5,1,2,0.5,0,2,2,1,0,0,3,0,8,-10,1,DET,DET,PHX,106,,,11,10,9,3
Isaiah Stewart,F,22023,1630191,22300129,"NOV 02, 2023",DET @ NOP,L,35,3,7,0.429,1,3,0.333,4,6,0.667,2,6,8,0,0,2,2,3,11,-18,1,DET,NOP,DET,116,,,19,19,11,8
Isaiah Stewart,F,22023,1630191,22300115,"NOV 01, 2023",DET vs. POR,L,33,5,8,0.625,2,4,0.5,0,0,0.0,2,4,6,4,1,0,2,5,12,3,1,DET,DET,POR,101,,,22,18,16,10
Isaiah Stewart,F,22023,1630191,22300109,"OCT 30, 2023",DET @ OKC,L,31,4,9,0.444,2,3,0.667,2,2,1.0,0,7,7,1,0,0,2,2,12,-7,1,DET,OKC,DET,112,,,20,19,13,8
Isaiah Stewart,F,22023,1630191,22300088,"OCT 28, 2023",DET vs. CHI,W,34,6,14,0.429,0,3,0.0,2,3,0.667,2,7,9,0,0,0,2,4,14,17,1,DET,DET,CHI,118,,,23,23,14,9
Isaiah Stewart,F,22023,1630191,22300077,"OCT 27, 2023",DET @ CHA,W,36,6,11,0.545,2,5,0.4,1,2,0.5,1,6,7,1,0,1,4,3,15,6,1,DET,CHA,DET,111,,,23,22,16,8
Isaiah Stewart,F,22023,1630191,22300068,"OCT 25, 2023",DET @ MIA,L,35,6,11,0.545,2,3,0.667,0,0,0.0,6,8,14,2,0,0,1,3,14,7,1,DET,MIA,DET,102,,,30,28,16,16
Isaiah Stewart,F,22023,1630191,22300654,"JAN 28, 2024",DET vs. OKC,W,25,5,10,0.5,1,4,0.25,0,0,0.0,0,1,1,0,0,0,0,1,11,-2,1,DET,DET,OKC,120,,,12,12,11,1
Isaiah Stewart,F,22023,1630191,22300642,"JAN 27, 2024",DET vs. WAS,L,32,3,7,0.429,0,2,0.0,5,6,0.833,4,3,7,2,0,0,0,2,11,-4,1,DET,DET,WAS,104,,,20,18,13,9
Isaiah Stewart,F,22023,1630191,22300619,"JAN 24, 2024",DET vs. CHA,W,34,4,8,0.5,1,2,0.5,2,4,0.5,1,7,8,2,1,0,2,3,11,10,1,DET,DET,CHA,113,,,21,19,13,10
Isaiah Stewart,F,22023,1630191,22300606,"JAN 22, 2024",DET vs. MIL,L,28,5,9,0.556,2,6,0.333,7,8,0.875,1,7,8,2,2,5,1,2,19,-6,1,DET,DET,MIL,113,,,29,27,21,10
Isaiah Stewart,F,22023,1630191,22300569,"JAN 17, 2024",DET vs. MIN,L,25,4,9,0.444,2,5,0.4,2,2,1.0,1,3,4,2,1,3,2,0,12,2,1,DET,DET,MIN,117,,,18,16,14,6
Isaiah Stewart,F,22023,1630191,22300406,"DEC 26, 2023",DET vs. BKN,L,36,2,7,0.286,1,2,0.5,2,4,0.5,4,7,11,4,0,0,0,2,7,12,1,DET,DET,BKN,112,,,22,18,11,15
Isaiah Stewart,F,22023,1630191,22300327,"DEC 15, 2023",DET @ PHI,L,20,2,6,0.333,0,1,0.0,0,0,0.0,1,3,4,0,0,1,2,4,4,-27,1,DET,PHI,DET,92,,,8,8,4,4
Isaiah Stewart,F,22023,1630191,22300310,"DEC 13, 2023",DET vs. PHI,L,22,1,3,0.333,0,1,0.0,2,2,1.0,2,2,4,2,0,0,2,3,4,-5,1,DET,DET,PHI,111,,,10,8,6,6
Isaiah Stewart,F,22023,1630191,22300293,"DEC 11, 2023",DET vs. IND,L,34,5,5,1.0,1,1,1.0,2,4,0.5,1,6,7,2,0,0,2,3,13,-10,1,DET,DET,IND,123,,,22,20,15,9
Isaiah Stewart,F,22023,1630191,22301206,"DEC 06, 2023",DET vs. MEM,L,28,3,7,0.429,1,3,0.333,2,2,1.0,2,5,7,1,0,0,1,5,9,-4,1,DET,DET,MEM,102,,,17,16,10,8
Isaiah Stewart,F,22023,1630191,22300558,"JAN 15, 2024",DET @ WAS,W,38,7,17,0.412,1,6,0.167,1,2,0.5,4,2,6,4,1,2,3,4,16,19,1,DET,WAS,DET,129,,,26,22,20,10
Isaiah Stewart,F,22023,1630191,22300253,"NOV 27, 2023",DET vs. WAS,L,29,3,11,0.273,1,7,0.143,0,0,0.0,2,6,8,0,1,0,0,2,7,-2,1,DET,DET,WAS,107,,,15,15,7,8
Keyonte George,G,22023,1641718,22300711,"FEB 04, 2024",UTA vs. MIL,W,25,7,13,0.538,5,9,0.556,0,0,0.0,0,10,10,2,0,0,3,2,19,16,1,UTA,UTA,MIL,123,,,31,29,21,12
Keyonte George,G,22023,1641718,22300686,"FEB 01, 2024",UTA vs. PHI,L,21,5,9,0.556,1,4,0.25,0,0,0.0,0,3,3,3,0,0,2,1,11,-1,1,UTA,UTA,PHI,124,,,17,14,14,6
Keyonte George,G,22023,1641718,22300671,"JAN 30, 2024",UTA @ NYK,L,23,6,12,0.5,1,5,0.2,2,2,1.0,0,2,2,1,0,0,2,2,15,-6,1,UTA,NYK,UTA,103,,,18,17,16,3
Keyonte George,G,22023,1641718,22300660,"JAN 29, 2024",UTA @ BKN,L,27,6,11,0.545,3,7,0.429,6,7,0.857,0,4,4,3,0,0,1,1,21,-26,1,UTA,BKN,UTA,114,,,28,25,24,7
Keyonte George,G,22023,1641718,22300647,"JAN 27, 2024",UTA @ CHA,W,13,2,5,0.4,1,4,0.25,5,5,1.0,0,0,0,1,0,0,1,1,10,-7,1,UTA,CHA,UTA,134,,,11,10,11,1
Keyonte George,G,22023,1641718,22300628,"JAN 25, 2024",UTA @ WAS,W,31,1,6,0.167,0,2,0.0,3,4,0.75,0,4,4,7,0,0,3,0,5,13,1,UTA,WAS,UTA,123,,,16,9,12,11
Keyonte George,G,22023,1641718,22300616,"JAN 23, 2024",UTA @ NOP,L,25,1,8,0.125,1,4,0.25,9,10,0.9,0,1,1,5,1,0,0,2,12,-18,1,UTA,NOP,UTA,124,,,18,13,17,6
Keyonte George,G,22023,1641718,22300598,"JAN 20, 2024",UTA @ HOU,L,10,1,3,0.333,1,2,0.5,0,0,0.0,0,1,1,2,0,0,3,1,3,-13,1,UTA,HOU,UTA,126,,,6,4,5,3
Keyonte George,G,22023,1641718,22300581,"JAN 18, 2024",UTA vs. OKC,L,14,1,5,0.2,1,2,0.5,0,0,0.0,0,1,1,2,0,0,2,0,3,-9,1,UTA,UTA,OKC,129,,,6,4,5,3
Keyonte George,G,22023,1641718,22300564,"JAN 15, 2024",UTA vs. IND,W,24,6,11,0.545,3,7,0.429,4,5,0.8,0,0,0,5,1,0,2,1,19,13,1,UTA,UTA,IND,132,,,24,19,24,5
Keyonte George,G,22023,1641718,22300549,"JAN 13, 2024",UTA vs. LAL,W,27,5,11,0.455,3,9,0.333,6,6,1.0,0,3,3,3,1,0,1,0,19,-6,1,UTA,UTA,LAL,132,,,25,22,22,6
Keyonte George,G,22023,1641718,22300540,"JAN 12, 2024",UTA vs. TOR,W,24,3,10,0.3,0,5,0.0,3,3,1.0,0,3,3,6,0,0,3,0,9,12,1,UTA,UTA,TOR,145,,,18,12,15,9
Keyonte George,G,22023,1641718,22300524,"JAN 10, 2024",UTA vs. DEN,W,22,2,7,0.286,1,4,0.25,1,2,0.5,0,1,1,3,1,0,1,0,6,7,1,UTA,UTA,DEN,124,,,10,7,9,4
Keyonte George,G,22023,1641718,22300510,"JAN 08, 2024",UTA @ MIL,W,22,7,13,0.538,4,9,0.444,1,1,1.0,0,6,6,4,0,0,2,0,19,7,1,UTA,MIL,UTA,132,,,29,25,23,10
Keyonte George,G,22023,1641718,22300495,"JAN 06, 2024",UTA @ PHI,W,16,2,4,0.5,0,2,0.0,2,2,1.0,0,2,2,3,0,0,2,2,6,5,1,UTA,PHI,UTA,120,,,11,8,9,5
Keyonte George,G,22023,1641718,22300479,"JAN 05, 2024",UTA @ BOS,L,20,4,10,0.4,2,7,0.286,2,2,1.0,1,3,4,1,0,0,1,0,12,-16,1,UTA,BOS,UTA,97,,,17,16,13,5
Keyonte George,G,22023,1641718,22300474,"JAN 03, 2024",UTA vs. DET,W,23,2,9,0.222,1,4,0.25,0,0,0.0,0,2,2,2,1,0,1,1,5,4,1,UTA,UTA,DET,154,,,9,7,7,4
Keyonte George,G,22023,1641718,22300457,"JAN 01, 2024",UTA vs. DAL,W,29,3,8,0.375,2,6,0.333,6,6,1.0,0,3,3,3,0,0,0,1,14,38,1,UTA,UTA,DAL,127,,,20,17,17,6
Keyonte George,G,22023,1641718,22300439,"DEC 30, 2023",UTA vs. MIA,W,28,6,10,0.6,5,8,0.625,4,5,0.8,0,6,6,2,0,0,2,3,21,14,1,UTA,UTA,MIA,117,,,29,27,23,8
Keyonte George,G,22023,1641718,22300424,"DEC 28, 2023",UTA @ NOP,L,22,1,7,0.143,1,5,0.2,1,2,0.5,0,3,3,5,0,0,2,1,4,-13,1,UTA,NOP,UTA,105,,,12,7,9,8
Keyonte George,G,22023,1641718,22300412,"DEC 26, 2023",UTA @ SAS,W,24,4,11,0.364,2,5,0.4,0,1,0.0,0,0,0,4,1,0,2,3,10,8,1,UTA,SAS,UTA,130,,,14,10,14,4
Keyonte George,G,22023,1641718,22300318,"DEC 13, 2023",UTA vs. NYK,W,4,0,1,0.0,0,1,0.0,0,0,0.0,0,0,0,0,0,0,2,1,0,0,1,UTA,UTA,NYK,117,,,0,0,0,0
Keyonte George,G,22023,1641718,22300302,"DEC 11, 2023",UTA @ OKC,L,33,10,17,0.588,5,9,0.556,5,5,1.0,0,3,3,7,1,0,3,0,30,5,1,UTA,OKC,UTA,120,,,40,33,37,10
Keyonte George,G,22023,1641718,22301225,"DEC 08, 2023",UTA vs. LAC,L,28,5,11,0.455,2,5,0.4,3,5,0.6,0,0,0,3,1,0,1,1,15,-25,1,UTA,UTA,LAC,103,,,18,15,18,3
Keyonte George,G,22023,1641718,22301213,"DEC 06, 2023",UTA @ DAL,L,32,2,11,0.182,0,4,0.0,3,4,0.75,0,4,4,11,0,1,5,0,7,-48,1,UTA,DAL,UTA,97,,,22,11,18,15
Keyonte George,G,22023,1641718,22300289,"DEC 02, 2023",UTA vs. POR,W,36,7,17,0.412,1,8,0.125,6,10,0.6,2,4,6,6,0,0,4,2,21,1,1,UTA,UTA,POR,118,,,33,27,27,12
Keyonte George,G,22023,1641718,22300270,"NOV 30, 2023",UTA @ MIN,L,33,4,19,0.211,1,6,0.167,3,3,1.0,1,3,4,4,0,0,2,2,12,-11,1,UTA,MIN,UTA,90,,,20,16,16,8
Keyonte George,G,22023,1641718,22300261,"NOV 29, 2023",UTA @ MEM,L,24,2,6,0.333,2,4,0.5,2,2,1.0,1,2,3,2,0,0,2,0,8,-7,1,UTA,MEM,UTA,91,,,13,11,10,5
Keyonte George,G,22023,1641718,22300256,"NOV 27, 2023",UTA vs. NOP,W,31,6,14,0.429,3,8,0.375,4,6,0.667,1,4,5,3,2,0,2,0,19,-1,1,UTA,UTA,NOP,114,,,27,24,22,8
Keyonte George,G,22023,1641718,22300243,"NOV 25, 2023",UTA vs. NOP,W,27,4,13,0.308,4,9,0.444,3,5,0.6,0,6,6,5,0,0,5,1,15,-2,1,UTA,UTA,NOP,105,,,26,21,20,11
Keyonte George,G,22023,1641718,22300237,"NOV 22, 2023",UTA @ POR,L,34,3,9,0.333,3,6,0.5,7,7,1.0,0,3,3,7,1,0,0,2,16,-1,1,UTA,POR,UTA,105,,,26,19,23,10
Keyonte George,G,22023,1641718,22300042,"NOV 21, 2023",UTA @ LAL,L,21,3,11,0.273,1,5,0.2,2,2,1.0,1,2,3,2,1,0,2,2,9,-21,1,UTA,LAL,UTA,99,,,14,12,11,5
Keyonte George,G,22023,1641718,22300214,"NOV 19, 2023",UTA vs. PHX,L,34,2,12,0.167,0,5,0.0,3,4,0.75,2,3,5,11,1,0,5,2,7,-9,1,UTA,UTA,PHX,137,,,23,12,18,16
Keyonte George,G,22023,1641718,22300035,"NOV 17, 2023",UTA vs. PHX,L,29,5,11,0.455,3,6,0.5,2,3,0.667,0,3,3,6,1,0,3,2,15,2,1,UTA,UTA,PHX,128,,,24,18,21,9
Keyonte George,G,22023,1641718,22300023,"NOV 14, 2023",UTA vs. POR,W,26,4,9,0.444,2,7,0.286,5,5,1.0,0,4,4,7,1,0,2,2,15,8,1,UTA,UTA,POR,115,,,26,19,22,11
Keyonte George,G,22023,1641718,22300012,"NOV 10, 2023",UTA @ MEM,W,30,2,12,0.167,1,6,0.167,2,2,1.0,0,3,3,11,0,1,2,1,7,1,1,UTA,MEM,UTA,127,,,21,10,18,14
Keyonte George,G,22023,1641718,22300158,"NOV 08, 2023",UTA @ IND,L,31,3,8,0.375,1,3,0.333,0,0,0.0,0,2,2,9,0,0,1,2,7,-11,1,UTA,IND,UTA,118,,,18,9,16,11
Keyonte George,G,22023,1641718,22300152,"NOV 06, 2023",UTA @ CHI,L,21,2,5,0.4,1,3,0.333,0,0,0.0,0,2,2,4,0,0,2,1,5,-15,1,UTA,CHI,UTA,113,,,11,7,9,6
Keyonte George,G,22023,1641718,22300138,"NOV 04, 2023",UTA @ MIN,L,27,3,6,0.5,1,4,0.25,1,2,0.5,0,0,0,4,0,0,3,2,8,-15,1,UTA,MIN,UTA,95,,,12,8,12,4
Keyonte George,G,22023,1641718,22300130,"NOV 02, 2023",UTA vs. ORL,L,17,1,2,0.5,1,1,1.0,3,5,0.6,0,2,2,3,0,0,2,1,6,-5,1,UTA,UTA,ORL,113,,,11,8,9,5
Keyonte George,G,22023,1641718,22300125,"NOV 01, 2023",UTA vs. MEM,W,23,4,8,0.5,1,4,0.25,0,0,0.0,0,1,1,3,1,1,3,0,9,10,1,UTA,UTA,MEM,133,,,13,10,12,4
Keyonte George,G,22023,1641718,22300110,"OCT 30, 2023",UTA @ DEN,L,20,1,6,0.167,1,4,0.25,0,0,0.0,1,0,1,2,1,0,0,0,3,-12,1,UTA,DEN,UTA,102,,,6,4,5,3
Keyonte George,G,22023,1641718,22300094,"OCT 28, 2023",UTA @ PHX,L,27,4,12,0.333,2,8,0.25,2,2,1.0,2,5,7,6,1,0,2,0,12,-8,1,UTA,PHX,UTA,104,,,25,19,18,13
Keyonte George,G,22023,1641718,22300085,"OCT 27, 2023",UTA vs. LAC,W,12,3,5,0.6,2,3,0.667,0,0,0.0,1,2,3,2,0,0,1,2,8,-3,1,UTA,UTA,LAC,120,,,13,11,10,5
Keyonte George,G,22023,1641718,22300072,"OCT 25, 2023",UTA vs. SAC,L,19,3,5,0.6,1,3,0.333,1,1,1.0,0,2,2,2,0,0,1,0,8,-9,1,UTA,UTA,SAC,114,,,12,10,10,4
Keyonte George,G,22023,1641718,22300739,"FEB 08, 2024",UTA @ PHX,L,30,4,11,0.364,0,5,0.0,3,4,0.75,0,0,0,6,1,0,1,0,11,-1,1,UTA,PHX,UTA,115,,,17,11,17,6
Keyonte George,G,22023,1641718,22300724,"FEB 06, 2024",UTA vs. OKC,W,27,6,11,0.545,4,6,0.667,0,0,0.0,1,1,2,5,1,1,1,0,16,6,1,UTA,UTA,OKC,124,,,23,18,21,7
Jordan Nwora,F,22023,1629670,22300756,"FEB 10, 2024",TOR vs. CLE,L,3,0,1,0.0,0,1,0.0,0,0,0.0,0,0,0,0,0,0,0,1,0,-3,1,TOR,TOR,CLE,95,,,0,0,0,0
Jordan Nwora,F,22023,1629670,22300744,"FEB 09, 2024",TOR vs. HOU,W,7,0,2,0.0,0,1,0.0,0,0,0.0,0,1,1,0,0,0,1,0,0,-12,1,TOR,TOR,HOU,100,,,1,1,0,1
Jordan Nwora,F,22023,1629670,22300718,"FEB 05, 2024",TOR @ NOP,L,24,3,7,0.429,1,2,0.5,0,0,0.0,1,2,3,5,1,0,3,1,7,-6,1,TOR,NOP,TOR,100,,,15,10,12,8
Jordan Nwora,F,22023,1629670,22300692,"FEB 02, 2024",TOR @ HOU,L,16,3,5,0.6,0,1,0.0,2,2,1.0,0,1,1,0,2,1,0,2,8,-21,1,TOR,HOU,TOR,106,,,9,9,8,1
Jordan Nwora,F,22023,1629670,22300672,"JAN 30, 2024",TOR @ CHI,W,19,5,7,0.714,4,5,0.8,3,3,1.0,0,2,2,0,0,1,0,2,17,-6,1,TOR,CHI,TOR,118,,,19,19,17,2
Jordan Nwora,F,22023,1629670,22300653,"JAN 28, 2024",TOR @ ATL,L,31,7,16,0.438,3,7,0.429,7,8,0.875,3,6,9,6,1,0,1,4,24,11,1,TOR,ATL,TOR,113,,,39,33,30,15
Jordan Nwora,F,22023,1629670,22300637,"JAN 26, 2024",TOR vs. LAC,L,8,0,3,0.0,0,3,0.0,0,0,0.0,1,0,1,1,0,0,2,1,0,-2,1,TOR,TOR,LAC,107,,,2,1,1,2
Jordan Nwora,F,22023,1629670,22300596,"JAN 20, 2024",TOR @ NYK,L,4,1,1,1.0,1,1,1.0,0,0,0.0,0,0,0,0,0,0,0,0,3,-2,1,TOR,NYK,TOR,94,,,3,3,3,0
Jordan Nwora,F,22023,1629670,22300550,"JAN 14, 2024",IND @ DEN,L,13,1,5,0.2,1,4,0.25,0,0,0.0,0,1,1,1,1,0,0,1,3,3,1,IND,DEN,IND,109,,,5,4,4,2
Jordan Nwora,F,22023,1629670,22300533,"JAN 12, 2024",IND @ ATL,W,4,0,1,0.0,0,0,0.0,0,0,0.0,0,1,1,2,0,0,0,0,0,-2,1,IND,ATL,IND,126,,,3,1,2,3
Jordan Nwora,F,22023,1629670,22300520,"JAN 10, 2024",IND vs. WAS,W,17,4,7,0.571,1,2,0.5,0,0,0.0,0,5,5,0,0,0,0,3,9,5,1,IND,IND,WAS,112,,,14,14,9,5
Jordan Nwora,F,22023,1629670,22300480,"JAN 05, 2024",IND vs. ATL,W,10,2,3,0.667,1,2,0.5,2,2,1.0,0,1,1,2,0,0,1,1,7,4,1,IND,IND,ATL,148,,,10,8,9,3
Jordan Nwora,F,22023,1629670,22300466,"JAN 03, 2024",IND vs. MIL,W,1,0,0,0.0,0,0,0.0,0,0,0.0,0,0,0,0,0,0,0,0,0,-3,1,IND,IND,MIL,142,,,0,0,0,0
Jordan Nwora,F,22023,1629670,22300365,"DEC 20, 2023",IND vs. CHA,W,9,2,5,0.4,0,1,0.0,2,2,1.0,0,0,0,1,0,0,0,3,6,1,1,IND,IND,CHA,142,,,7,6,7,1
Jordan Nwora,F,22023,1629670,22300350,"DEC 18, 2023",IND vs. LAC,L,16,4,8,0.5,1,4,0.25,0,0,0.0,0,3,3,0,0,0,0,1,9,-5,1,IND,IND,LAC,127,,,12,12,9,3
Jordan Nwora,F,22023,1629670,22300338,"DEC 16, 2023",IND @ MIN,L,10,3,4,0.75,0,1,0.0,1,1,1.0,0,1,1,3,0,0,1,0,7,7,1,IND,MIN,IND,109,,,11,8,10,4
Jordan Nwora,F,22023,1629670,22300328,"DEC 15, 2023",IND @ WAS,L,4,2,3,0.667,2,2,1.0,0,0,0.0,0,1,1,0,0,0,1,0,6,3,1,IND,WAS,IND,123,,,7,7,6,1
Jordan Nwora,F,22023,1629670,22300315,"DEC 13, 2023",IND @ MIL,L,6,2,2,1.0,1,1,1.0,0,0,0.0,1,1,2,1,1,0,1,0,5,4,1,IND,MIL,IND,126,,,8,7,6,3
Jordan Nwora,F,22023,1629670,22300230,"NOV 22, 2023",IND vs. TOR,L,14,0,5,0.0,0,2,0.0,0,0,0.0,3,1,4,1,1,0,1,3,0,-16,1,IND,IND,TOR,131,,,5,4,1,5
Jordan Nwora,F,22023,1629670,22300209,"NOV 19, 2023",IND vs. ORL,L,23,8,11,0.727,2,5,0.4,1,1,1.0,2,3,5,1,3,0,1,3,19,18,1,IND,IND,ORL,116,,,25,24,20,6
Jordan Nwora,F,22023,1629670,22300146,"NOV 06, 2023",IND vs. SAS,W,9,2,3,0.667,1,2,0.5,1,2,0.5,0,4,4,0,0,0,2,0,6,6,1,IND,IND,SAS,152,,,10,10,6,4
Jordan Nwora,F,22023,1629670,22300118,"NOV 01, 2023",IND @ BOS,L,21,2,8,0.25,0,4,0.0,1,1,1.0,0,1,1,3,0,0,3,2,5,-22,1,IND,BOS,IND,104,,,9,6,8,4
Jordan Nwora,F,22023,1629670,22300064,"OCT 25, 2023",IND vs. WAS,W,6,2,7,0.286,1,2,0.5,0,0,0.0,1,0,1,1,0,1,0,0,5,3,1,IND,IND,WAS,143,,,7,6,6,2
Jordan Nwora,F,22023,1629670,22300564,"JAN 15, 2024",IND @ UTA,L,17,3,10,0.3,0,4,0.0,1,2,0.5,1,2,3,2,0,0,1,2,7,-19,1,IND,UTA,IND,105,,,12,10,9,5
Jordan Nwora,F,22023,1629670,22300493,"JAN 06, 2024",IND vs. BOS,L,1,0,0,0.0,0,0,0.0,0,0,0.0,0,0,0,0,0,0,0,0,0,0,1,IND,IND,BOS,101,,,0,0,0,0
Jordan Nwora,F,22023,1629670,22300441,"DEC 30, 2023",IND vs. NYK,W,1,0,0,0.0,0,0,0.0,0,0,0.0,0,0,0,0,0,0,0,0,0,-3,1,IND,IND,NYK,140,,,0,0,0,0
Jordan Nwora,F,22023,1629670,22300756,"FEB 10, 2024",TOR vs. CLE,L,3,0,1,0.0,0,1,0.0,0,0,0.0,0,0,0,0,0,0,0,1,0,-3,1,TOR,TOR,CLE,95,,,0,0,0,0
Jordan Nwora,F,22023,1629670,22300744,"FEB 09, 2024",TOR vs. HOU,W,7,0,2,0.0,0,1,0.0,0,0,0.0,0,1,1,0,0,0,1,0,0,-12,1,TOR,TOR,HOU,100,,,1,1,0,1
Jordan Nwora,F,22023,1629670,22300718,"FEB 05, 2024",TOR @ NOP,L,24,3,7,0.429,1,2,0.5,0,0,0.0,1,2,3,5,1,0,3,1,7,-6,1,TOR,NOP,TOR,100,,,15,10,12,8
Jordan Nwora,F,22023,1629670,22300692,"FEB 02, 2024",TOR @ HOU,L,16,3,5,0.6,0,1,0.0,2,2,1.0,0,1,1,0,2,1,0,2,8,-21,1,TOR,HOU,TOR,106,,,9,9,8,1
Jordan Nwora,F,22023,1629670,22300672,"JAN 30, 2024",TOR @ CHI,W,19,5,7,0.714,4,5,0.8,3,3,1.0,0,2,2,0,0,1,0,2,17,-6,1,TOR,CHI,TOR,118,,,19,19,17,2
Jordan Nwora,F,22023,1629670,22300653,"JAN 28, 2024",TOR @ ATL,L,31,7,16,0.438,3,7,0.429,7,8,0.875,3,6,9,6,1,0,1,4,24,11,1,TOR,ATL,TOR,113,,,39,33,30,15
Jordan Nwora,F,22023,1629670,22300637,"JAN 26, 2024",TOR vs. LAC,L,8,0,3,0.0,0,3,0.0,0,0,0.0,1,0,1,1,0,0,2,1,0,-2,1,TOR,TOR,LAC,107,,,2,1,1,2
Jordan Nwora,F,22023,1629670,22300596,"JAN 20, 2024",TOR @ NYK,L,4,1,1,1.0,1,1,1.0,0,0,0.0,0,0,0,0,0,0,0,0,3,-2,1,TOR,NYK,TOR,94,,,3,3,3,0
Jordan Nwora,F,22023,1629670,22300550,"JAN 14, 2024",IND @ DEN,L,13,1,5,0.2,1,4,0.25,0,0,0.0,0,1,1,1,1,0,0,1,3,3,1,IND,DEN,IND,109,,,5,4,4,2
Jordan Nwora,F,22023,1629670,22300533,"JAN 12, 2024",IND @ ATL,W,4,0,1,0.0,0,0,0.0,0,0,0.0,0,1,1,2,0,0,0,0,0,-2,1,IND,ATL,IND,126,,,3,1,2,3
Jordan Nwora,F,22023,1629670,22300520,"JAN 10, 2024",IND vs. WAS,W,17,4,7,0.571,1,2,0.5,0,0,0.0,0,5,5,0,0,0,0,3,9,5,1,IND,IND,WAS,112,,,14,14,9,5
Jordan Nwora,F,22023,1629670,22300480,"JAN 05, 2024",IND vs. ATL,W,10,2,3,0.667,1,2,0.5,2,2,1.0,0,1,1,2,0,0,1,1,7,4,1,IND,IND,ATL,148,,,10,8,9,3
Jordan Nwora,F,22023,1629670,22300466,"JAN 03, 2024",IND vs. MIL,W,1,0,0,0.0,0,0,0.0,0,0,0.0,0,0,0,0,0,0,0,0,0,-3,1,IND,IND,MIL,142,,,0,0,0,0
Jordan Nwora,F,22023,1629670,22300365,"DEC 20, 2023",IND vs. CHA,W,9,2,5,0.4,0,1,0.0,2,2,1.0,0,0,0,1,0,0,0,3,6,1,1,IND,IND,CHA,142,,,7,6,7,1
Jordan Nwora,F,22023,1629670,22300350,"DEC 18, 2023",IND vs. LAC,L,16,4,8,0.5,1,4,0.25,0,0,0.0,0,3,3,0,0,0,0,1,9,-5,1,IND,IND,LAC,127,,,12,12,9,3
Jordan Nwora,F,22023,1629670,22300338,"DEC 16, 2023",IND @ MIN,L,10,3,4,0.75,0,1,0.0,1,1,1.0,0,1,1,3,0,0,1,0,7,7,1,IND,MIN,IND,109,,,11,8,10,4
Jordan Nwora,F,22023,1629670,22300328,"DEC 15, 2023",IND @ WAS,L,4,2,3,0.667,2,2,1.0,0,0,0.0,0,1,1,0,0,0,1,0,6,3,1,IND,WAS,IND,123,,,7,7,6,1
Jordan Nwora,F,22023,1629670,22300315,"DEC 13, 2023",IND @ MIL,L,6,2,2,1.0,1,1,1.0,0,0,0.0,1,1,2,1,1,0,1,0,5,4,1,IND,MIL,IND,126,,,8,7,6,3
Jordan Nwora,F,22023,1629670,22300230,"NOV 22, 2023",IND vs. TOR,L,14,0,5,0.0,0,2,0.0,0,0,0.0,3,1,4,1,1,0,1,3,0,-16,1,IND,IND,TOR,131,,,5,4,1,5
Jordan Nwora,F,22023,1629670,22300209,"NOV 19, 2023",IND vs. ORL,L,23,8,11,0.727,2,5,0.4,1,1,1.0,2,3,5,1,3,0,1,3,19,18,1,IND,IND,ORL,116,,,25,24,20,6
Jordan Nwora,F,22023,1629670,22300146,"NOV 06, 2023",IND vs. SAS,W,9,2,3,0.667,1,2,0.5,1,2,0.5,0,4,4,0,0,0,2,0,6,6,1,IND,IND,SAS,152,,,10,10,6,4
Jordan Nwora,F,22023,1629670,22300118,"NOV 01, 2023",IND @ BOS,L,21,2,8,0.25,0,4,0.0,1,1,1.0,0,1,1,3,0,0,3,2,5,-22,1,IND,BOS,IND,104,,,9,6,8,4
Jordan Nwora,F,22023,1629670,22300064,"OCT 25, 2023",IND vs. WAS,W,6,2,7,0.286,1,2,0.5,0,0,0.0,1,0,1,1,0,1,0,0,5,3,1,IND,IND,WAS,143,,,7,6,6,2
Jordan Nwora,F,22023,1629670,22300564,"JAN 15, 2024",IND @ UTA,L,17,3,10,0.3,0,4,0.0,1,2,0.5,1,2,3,2,0,0,1,2,7,-19,1,IND,UTA,IND,105,,,12,10,9,5
Jordan Nwora,F,22023,1629670,22300493,"JAN 06, 2024",IND vs. BOS,L,1,0,0,0.0,0,0,0.0,0,0,0.0,0,0,0,0,0,0,0,0,0,0,1,IND,IND,BOS,101,,,0,0,0,0
Jordan Nwora,F,22023,1629670,22300441,"DEC 30, 2023",IND vs. NYK,W,1,0,0,0.0,0,0,0.0,0,0,0.0,0,0,0,0,0,0,0,0,0,-3,1,IND,IND,NYK,140,,,0,0,0,0
Kevin Huerter,G,22023,1628989,22300746,"FEB 09, 2024",SAC vs. DEN,W,21,4,6,0.667,2,4,0.5,2,2,1.0,1,1,2,0,0,0,2,1,12,15,1,SAC,SAC,DEN,135,11.5,Points,14,14,12,2
Kevin Huerter,G,22023,1628989,22300746,"FEB 09, 2024",SAC vs. DEN,W,21,4,6,0.667,2,4,0.5,2,2,1.0,1,1,2,0,0,0,2,1,12,15,1,SAC,SAC,DEN,135,4.0,Rebounds,14,14,12,2
Kevin Huerter,G,22023,1628989,22300746,"FEB 09, 2024",SAC vs. DEN,W,21,4,6,0.667,2,4,0.5,2,2,1.0,1,1,2,0,0,0,2,1,12,15,1,SAC,SAC,DEN,135,18.5,Pts+Rebs+Asts,14,14,12,2
Kevin Huerter,G,22023,1628989,22300746,"FEB 09, 2024",SAC vs. DEN,W,21,4,6,0.667,2,4,0.5,2,2,1.0,1,1,2,0,0,0,2,1,12,15,1,SAC,SAC,DEN,135,2.5,Assists,14,14,12,2
Kevin Huerter,G,22023,1628989,22300746,"FEB 09, 2024",SAC vs. DEN,W,21,4,6,0.667,2,4,0.5,2,2,1.0,1,1,2,0,0,0,2,1,12,15,1,SAC,SAC,DEN,135,6.0,3-PT Attempted,14,14,12,2
Kevin Huerter,G,22023,1628989,22300746,"FEB 09, 2024",SAC vs. DEN,W,21,4,6,0.667,2,4,0.5,2,2,1.0,1,1,2,0,0,0,2,1,12,15,1,SAC,SAC,DEN,135,15.5,Pts+Rebs,14,14,12,2
Kevin Huerter,G,22023,1628989,22300746,"FEB 09, 2024",SAC vs. DEN,W,21,4,6,0.667,2,4,0.5,2,2,1.0,1,1,2,0,0,0,2,1,12,15,1,SAC,SAC,DEN,135,14.5,Pts+Asts,14,14,12,2
Kevin Huerter,G,22023,1628989,22300732,"FEB 07, 2024",SAC vs. DET,L,34,6,11,0.545,4,9,0.444,0,0,0.0,1,0,1,1,1,1,0,2,16,-10,1,SAC,SAC,DET,120,11.5,Points,18,17,17,2
Kevin Huerter,G,22023,1628989,22300732,"FEB 07, 2024",SAC vs. DET,L,34,6,11,0.545,4,9,0.444,0,0,0.0,1,0,1,1,1,1,0,2,16,-10,1,SAC,SAC,DET,120,4.0,Rebounds,18,17,17,2
Kevin Huerter,G,22023,1628989,22300732,"FEB 07, 2024",SAC vs. DET,L,34,6,11,0.545,4,9,0.444,0,0,0.0,1,0,1,1,1,1,0,2,16,-10,1,SAC,SAC,DET,120,18.5,Pts+Rebs+Asts,18,17,17,2
Kevin Huerter,G,22023,1628989,22300732,"FEB 07, 2024",SAC vs. DET,L,34,6,11,0.545,4,9,0.444,0,0,0.0,1,0,1,1,1,1,0,2,16,-10,1,SAC,SAC,DET,120,2.5,Assists,18,17,17,2
Kevin Huerter,G,22023,1628989,22300732,"FEB 07, 2024",SAC vs. DET,L,34,6,11,0.545,4,9,0.444,0,0,0.0,1,0,1,1,1,1,0,2,16,-10,1,SAC,SAC,DET,120,6.0,3-PT Attempted,18,17,17,2
Kevin Huerter,G,22023,1628989,22300732,"FEB 07, 2024",SAC vs. DET,L,34,6,11,0.545,4,9,0.444,0,0,0.0,1,0,1,1,1,1,0,2,16,-10,1,SAC,SAC,DET,120,15.5,Pts+Rebs,18,17,17,2
Kevin Huerter,G,22023,1628989,22300732,"FEB 07, 2024",SAC vs. DET,L,34,6,11,0.545,4,9,0.444,0,0,0.0,1,0,1,1,1,1,0,2,16,-10,1,SAC,SAC,DET,120,14.5,Pts+Asts,18,17,17,2
Kevin Huerter,G,22023,1628989,22300714,"FEB 05, 2024",SAC @ CLE,L,31,4,9,0.444,2,5,0.4,0,0,0.0,2,1,3,4,1,0,1,0,10,-13,1,SAC,CLE,SAC,110,11.5,Points,17,13,14,7
Kevin Huerter,G,22023,1628989,22300714,"FEB 05, 2024",SAC @ CLE,L,31,4,9,0.444,2,5,0.4,0,0,0.0,2,1,3,4,1,0,1,0,10,-13,1,SAC,CLE,SAC,110,4.0,Rebounds,17,13,14,7
Kevin Huerter,G,22023,1628989,22300714,"FEB 05, 2024",SAC @ CLE,L,31,4,9,0.444,2,5,0.4,0,0,0.0,2,1,3,4,1,0,1,0,10,-13,1,SAC,CLE,SAC,110,18.5,Pts+Rebs+Asts,17,13,14,7
Kevin Huerter,G,22023,1628989,22300714,"FEB 05, 2024",SAC @ CLE,L,31,4,9,0.444,2,5,0.4,0,0,0.0,2,1,3,4,1,0,1,0,10,-13,1,SAC,CLE,SAC,110,2.5,Assists,17,13,14,7
Kevin Huerter,G,22023,1628989,22300714,"FEB 05, 2024",SAC @ CLE,L,31,4,9,0.444,2,5,0.4,0,0,0.0,2,1,3,4,1,0,1,0,10,-13,1,SAC,CLE,SAC,110,6.0,3-PT Attempted,17,13,14,7
Kevin Huerter,G,22023,1628989,22300714,"FEB 05, 2024",SAC @ CLE,L,31,4,9,0.444,2,5,0.4,0,0,0.0,2,1,3,4,1,0,1,0,10,-13,1,SAC,CLE,SAC,110,15.5,Pts+Rebs,17,13,14,7
Kevin Huerter,G,22023,1628989,22300714,"FEB 05, 2024",SAC @ CLE,L,31,4,9,0.444,2,5,0.4,0,0,0.0,2,1,3,4,1,0,1,0,10,-13,1,SAC,CLE,SAC,110,14.5,Pts+Asts,17,13,14,7
Kevin Huerter,G,22023,1628989,22300700,"FEB 03, 2024",SAC @ CHI,W,21,3,9,0.333,1,5,0.2,2,2,1.0,1,1,2,2,1,0,2,1,9,2,1,SAC,CHI,SAC,123,11.5,Points,13,11,11,4
Kevin Huerter,G,22023,1628989,22300700,"FEB 03, 2024",SAC @ CHI,W,21,3,9,0.333,1,5,0.2,2,2,1.0,1,1,2,2,1,0,2,1,9,2,1,SAC,CHI,SAC,123,4.0,Rebounds,13,11,11,4
Kevin Huerter,G,22023,1628989,22300700,"FEB 03, 2024",SAC @ CHI,W,21,3,9,0.333,1,5,0.2,2,2,1.0,1,1,2,2,1,0,2,1,9,2,1,SAC,CHI,SAC,123,18.5,Pts+Rebs+Asts,13,11,11,4
Kevin Huerter,G,22023,1628989,22300700,"FEB 03, 2024",SAC @ CHI,W,21,3,9,0.333,1,5,0.2,2,2,1.0,1,1,2,2,1,0,2,1,9,2,1,SAC,CHI,SAC,123,2.5,Assists,13,11,11,4
Kevin Huerter,G,22023,1628989,22300700,"FEB 03, 2024",SAC @ CHI,W,21,3,9,0.333,1,5,0.2,2,2,1.0,1,1,2,2,1,0,2,1,9,2,1,SAC,CHI,SAC,123,6.0,3-PT Attempted,13,11,11,4
Kevin Huerter,G,22023,1628989,22300700,"FEB 03, 2024",SAC @ CHI,W,21,3,9,0.333,1,5,0.2,2,2,1.0,1,1,2,2,1,0,2,1,9,2,1,SAC,CHI,SAC,123,15.5,Pts+Rebs,13,11,11,4
Kevin Huerter,G,22023,1628989,22300700,"FEB 03, 2024",SAC @ CHI,W,21,3,9,0.333,1,5,0.2,2,2,1.0,1,1,2,2,1,0,2,1,9,2,1,SAC,CHI,SAC,123,14.5,Pts+Asts,13,11,11,4
Kevin Huerter,G,22023,1628989,22300691,"FEB 02, 2024",SAC @ IND,W,30,5,10,0.5,3,6,0.5,2,3,0.667,2,3,5,6,0,0,4,5,15,5,1,SAC,IND,SAC,133,11.5,Points,26,20,21,11
Kevin Huerter,G,22023,1628989,22300691,"FEB 02, 2024",SAC @ IND,W,30,5,10,0.5,3,6,0.5,2,3,0.667,2,3,5,6,0,0,4,5,15,5,1,SAC,IND,SAC,133,4.0,Rebounds,26,20,21,11
Kevin Huerter,G,22023,1628989,22300691,"FEB 02, 2024",SAC @ IND,W,30,5,10,0.5,3,6,0.5,2,3,0.667,2,3,5,6,0,0,4,5,15,5,1,SAC,IND,SAC,133,18.5,Pts+Rebs+Asts,26,20,21,11
Kevin Huerter,G,22023,1628989,22300691,"FEB 02, 2024",SAC @ IND,W,30,5,10,0.5,3,6,0.5,2,3,0.667,2,3,5,6,0,0,4,5,15,5,1,SAC,IND,SAC,133,2.5,Assists,26,20,21,11
Kevin Huerter,G,22023,1628989,22300691,"FEB 02, 2024",SAC @ IND,W,30,5,10,0.5,3,6,0.5,2,3,0.667,2,3,5,6,0,0,4,5,15,5,1,SAC,IND,SAC,133,6.0,3-PT Attempted,26,20,21,11
Kevin Huerter,G,22023,1628989,22300691,"FEB 02, 2024",SAC @ IND,W,30,5,10,0.5,3,6,0.5,2,3,0.667,2,3,5,6,0,0,4,5,15,5,1,SAC,IND,SAC,133,15.5,Pts+Rebs,26,20,21,11
Kevin Huerter,G,22023,1628989,22300691,"FEB 02, 2024",SAC @ IND,W,30,5,10,0.5,3,6,0.5,2,3,0.667,2,3,5,6,0,0,4,5,15,5,1,SAC,IND,SAC,133,14.5,Pts+Asts,26,20,21,11
Kevin Huerter,G,22023,1628989,22300678,"JAN 31, 2024",SAC @ MIA,L,39,6,12,0.5,2,6,0.333,0,0,0.0,1,2,3,4,1,0,1,4,14,-1,1,SAC,MIA,SAC,106,11.5,Points,21,17,18,7
Kevin Huerter,G,22023,1628989,22300678,"JAN 31, 2024",SAC @ MIA,L,39,6,12,0.5,2,6,0.333,0,0,0.0,1,2,3,4,1,0,1,4,14,-1,1,SAC,MIA,SAC,106,4.0,Rebounds,21,17,18,7
Kevin Huerter,G,22023,1628989,22300678,"JAN 31, 2024",SAC @ MIA,L,39,6,12,0.5,2,6,0.333,0,0,0.0,1,2,3,4,1,0,1,4,14,-1,1,SAC,MIA,SAC,106,18.5,Pts+Rebs+Asts,21,17,18,7
Kevin Huerter,G,22023,1628989,22300678,"JAN 31, 2024",SAC @ MIA,L,39,6,12,0.5,2,6,0.333,0,0,0.0,1,2,3,4,1,0,1,4,14,-1,1,SAC,MIA,SAC,106,2.5,Assists,21,17,18,7
Kevin Huerter,G,22023,1628989,22300678,"JAN 31, 2024",SAC @ MIA,L,39,6,12,0.5,2,6,0.333,0,0,0.0,1,2,3,4,1,0,1,4,14,-1,1,SAC,MIA,SAC,106,6.0,3-PT Attempted,21,17,18,7
Kevin Huerter,G,22023,1628989,22300678,"JAN 31, 2024",SAC @ MIA,L,39,6,12,0.5,2,6,0.333,0,0,0.0,1,2,3,4,1,0,1,4,14,-1,1,SAC,MIA,SAC,106,15.5,Pts+Rebs,21,17,18,7
Kevin Huerter,G,22023,1628989,22300678,"JAN 31, 2024",SAC @ MIA,L,39,6,12,0.5,2,6,0.333,0,0,0.0,1,2,3,4,1,0,1,4,14,-1,1,SAC,MIA,SAC,106,14.5,Pts+Asts,21,17,18,7
Kevin Huerter,G,22023,1628989,22300663,"JAN 29, 2024",SAC @ MEM,W,37,7,15,0.467,3,8,0.375,0,0,0.0,0,4,4,3,2,1,1,1,17,11,1,SAC,MEM,SAC,103,11.5,Points,24,21,20,7
Kevin Huerter,G,22023,1628989,22300663,"JAN 29, 2024",SAC @ MEM,W,37,7,15,0.467,3,8,0.375,0,0,0.0,0,4,4,3,2,1,1,1,17,11,1,SAC,MEM,SAC,103,4.0,Rebounds,24,21,20,7
Kevin Huerter,G,22023,1628989,22300663,"JAN 29, 2024",SAC @ MEM,W,37,7,15,0.467,3,8,0.375,0,0,0.0,0,4,4,3,2,1,1,1,17,11,1,SAC,MEM,SAC,103,18.5,Pts+Rebs+Asts,24,21,20,7
Kevin Huerter,G,22023,1628989,22300663,"JAN 29, 2024",SAC @ MEM,W,37,7,15,0.467,3,8,0.375,0,0,0.0,0,4,4,3,2,1,1,1,17,11,1,SAC,MEM,SAC,103,2.5,Assists,24,21,20,7
Kevin Huerter,G,22023,1628989,22300663,"JAN 29, 2024",SAC @ MEM,W,37,7,15,0.467,3,8,0.375,0,0,0.0,0,4,4,3,2,1,1,1,17,11,1,SAC,MEM,SAC,103,6.0,3-PT Attempted,24,21,20,7
Kevin Huerter,G,22023,1628989,22300663,"JAN 29, 2024",SAC @ MEM,W,37,7,15,0.467,3,8,0.375,0,0,0.0,0,4,4,3,2,1,1,1,17,11,1,SAC,MEM,SAC,103,15.5,Pts+Rebs,24,21,20,7
Kevin Huerter,G,22023,1628989,22300663,"JAN 29, 2024",SAC @ MEM,W,37,7,15,0.467,3,8,0.375,0,0,0.0,0,4,4,3,2,1,1,1,17,11,1,SAC,MEM,SAC,103,14.5,Pts+Asts,24,21,20,7
Kevin Huerter,G,22023,1628989,22300651,"JAN 27, 2024",SAC @ DAL,W,30,7,11,0.636,4,8,0.5,0,0,0.0,0,4,4,5,0,2,0,2,18,4,1,SAC,DAL,SAC,120,11.5,Points,27,22,23,9
Kevin Huerter,G,22023,1628989,22300651,"JAN 27, 2024",SAC @ DAL,W,30,7,11,0.636,4,8,0.5,0,0,0.0,0,4,4,5,0,2,0,2,18,4,1,SAC,DAL,SAC,120,4.0,Rebounds,27,22,23,9
Kevin Huerter,G,22023,1628989,22300651,"JAN 27, 2024",SAC @ DAL,W,30,7,11,0.636,4,8,0.5,0,0,0.0,0,4,4,5,0,2,0,2,18,4,1,SAC,DAL,SAC,120,18.5,Pts+Rebs+Asts,27,22,23,9
Kevin Huerter,G,22023,1628989,22300651,"JAN 27, 2024",SAC @ DAL,W,30,7,11,0.636,4,8,0.5,0,0,0.0,0,4,4,5,0,2,0,2,18,4,1,SAC,DAL,SAC,120,2.5,Assists,27,22,23,9
Kevin Huerter,G,22023,1628989,22300651,"JAN 27, 2024",SAC @ DAL,W,30,7,11,0.636,4,8,0.5,0,0,0.0,0,4,4,5,0,2,0,2,18,4,1,SAC,DAL,SAC,120,6.0,3-PT Attempted,27,22,23,9
Kevin Huerter,G,22023,1628989,22300651,"JAN 27, 2024",SAC @ DAL,W,30,7,11,0.636,4,8,0.5,0,0,0.0,0,4,4,5,0,2,0,2,18,4,1,SAC,DAL,SAC,120,15.5,Pts+Rebs,27,22,23,9
Kevin Huerter,G,22023,1628989,22300651,"JAN 27, 2024",SAC @ DAL,W,30,7,11,0.636,4,8,0.5,0,0,0.0,0,4,4,5,0,2,0,2,18,4,1,SAC,DAL,SAC,120,14.5,Pts+Asts,27,22,23,9
Kevin Huerter,G,22023,1628989,22300632,"JAN 25, 2024",SAC @ GSW,W,33,4,10,0.4,3,8,0.375,1,3,0.333,3,7,10,4,3,0,2,4,12,8,1,SAC,GSW,SAC,134,11.5,Points,26,22,16,14
Kevin Huerter,G,22023,1628989,22300632,"JAN 25, 2024",SAC @ GSW,W,33,4,10,0.4,3,8,0.375,1,3,0.333,3,7,10,4,3,0,2,4,12,8,1,SAC,GSW,SAC,134,4.0,Rebounds,26,22,16,14
Kevin Huerter,G,22023,1628989,22300632,"JAN 25, 2024",SAC @ GSW,W,33,4,10,0.4,3,8,0.375,1,3,0.333,3,7,10,4,3,0,2,4,12,8,1,SAC,GSW,SAC,134,18.5,Pts+Rebs+Asts,26,22,16,14
Kevin Huerter,G,22023,1628989,22300632,"JAN 25, 2024",SAC @ GSW,W,33,4,10,0.4,3,8,0.375,1,3,0.333,3,7,10,4,3,0,2,4,12,8,1,SAC,GSW,SAC,134,2.5,Assists,26,22,16,14
Kevin Huerter,G,22023,1628989,22300632,"JAN 25, 2024",SAC @ GSW,W,33,4,10,0.4,3,8,0.375,1,3,0.333,3,7,10,4,3,0,2,4,12,8,1,SAC,GSW,SAC,134,6.0,3-PT Attempted,26,22,16,14
Kevin Huerter,G,22023,1628989,22300632,"JAN 25, 2024",SAC @ GSW,W,33,4,10,0.4,3,8,0.375,1,3,0.333,3,7,10,4,3,0,2,4,12,8,1,SAC,GSW,SAC,134,15.5,Pts+Rebs,26,22,16,14
Kevin Huerter,G,22023,1628989,22300632,"JAN 25, 2024",SAC @ GSW,W,33,4,10,0.4,3,8,0.375,1,3,0.333,3,7,10,4,3,0,2,4,12,8,1,SAC,GSW,SAC,134,14.5,Pts+Asts,26,22,16,14
Kevin Huerter,G,22023,1628989,22300613,"JAN 22, 2024",SAC vs. ATL,W,26,3,6,0.5,2,5,0.4,0,0,0.0,0,2,2,3,0,1,1,4,8,-3,1,SAC,SAC,ATL,122,11.5,Points,13,10,11,5
Kevin Huerter,G,22023,1628989,22300613,"JAN 22, 2024",SAC vs. ATL,W,26,3,6,0.5,2,5,0.4,0,0,0.0,0,2,2,3,0,1,1,4,8,-3,1,SAC,SAC,ATL,122,4.0,Rebounds,13,10,11,5
Kevin Huerter,G,22023,1628989,22300613,"JAN 22, 2024",SAC vs. ATL,W,26,3,6,0.5,2,5,0.4,0,0,0.0,0,2,2,3,0,1,1,4,8,-3,1,SAC,SAC,ATL,122,18.5,Pts+Rebs+Asts,13,10,11,5
Kevin Huerter,G,22023,1628989,22300613,"JAN 22, 2024",SAC vs. ATL,W,26,3,6,0.5,2,5,0.4,0,0,0.0,0,2,2,3,0,1,1,4,8,-3,1,SAC,SAC,ATL,122,2.5,Assists,13,10,11,5
Kevin Huerter,G,22023,1628989,22300613,"JAN 22, 2024",SAC vs. ATL,W,26,3,6,0.5,2,5,0.4,0,0,0.0,0,2,2,3,0,1,1,4,8,-3,1,SAC,SAC,ATL,122,6.0,3-PT Attempted,13,10,11,5
Kevin Huerter,G,22023,1628989,22300613,"JAN 22, 2024",SAC vs. ATL,W,26,3,6,0.5,2,5,0.4,0,0,0.0,0,2,2,3,0,1,1,4,8,-3,1,SAC,SAC,ATL,122,15.5,Pts+Rebs,13,10,11,5
Kevin Huerter,G,22023,1628989,22300613,"JAN 22, 2024",SAC vs. ATL,W,26,3,6,0.5,2,5,0.4,0,0,0.0,0,2,2,3,0,1,1,4,8,-3,1,SAC,SAC,ATL,122,14.5,Pts+Asts,13,10,11,5
Kevin Huerter,G,22023,1628989,22300583,"JAN 18, 2024",SAC vs. IND,L,39,11,17,0.647,7,12,0.583,2,2,1.0,0,2,2,4,1,1,2,4,31,-3,1,SAC,SAC,IND,121,11.5,Points,37,33,35,6
Kevin Huerter,G,22023,1628989,22300583,"JAN 18, 2024",SAC vs. IND,L,39,11,17,0.647,7,12,0.583,2,2,1.0,0,2,2,4,1,1,2,4,31,-3,1,SAC,SAC,IND,121,4.0,Rebounds,37,33,35,6
Kevin Huerter,G,22023,1628989,22300583,"JAN 18, 2024",SAC vs. IND,L,39,11,17,0.647,7,12,0.583,2,2,1.0,0,2,2,4,1,1,2,4,31,-3,1,SAC,SAC,IND,121,18.5,Pts+Rebs+Asts,37,33,35,6
Kevin Huerter,G,22023,1628989,22300583,"JAN 18, 2024",SAC vs. IND,L,39,11,17,0.647,7,12,0.583,2,2,1.0,0,2,2,4,1,1,2,4,31,-3,1,SAC,SAC,IND,121,2.5,Assists,37,33,35,6
Kevin Huerter,G,22023,1628989,22300583,"JAN 18, 2024",SAC vs. IND,L,39,11,17,0.647,7,12,0.583,2,2,1.0,0,2,2,4,1,1,2,4,31,-3,1,SAC,SAC,IND,121,6.0,3-PT Attempted,37,33,35,6
Kevin Huerter,G,22023,1628989,22300583,"JAN 18, 2024",SAC vs. IND,L,39,11,17,0.647,7,12,0.583,2,2,1.0,0,2,2,4,1,1,2,4,31,-3,1,SAC,SAC,IND,121,15.5,Pts+Rebs,37,33,35,6
Kevin Huerter,G,22023,1628989,22300583,"JAN 18, 2024",SAC vs. IND,L,39,11,17,0.647,7,12,0.583,2,2,1.0,0,2,2,4,1,1,2,4,31,-3,1,SAC,SAC,IND,121,14.5,Pts+Asts,37,33,35,6
Kevin Huerter,G,22023,1628989,22300567,"JAN 16, 2024",SAC @ PHX,L,26,4,9,0.444,2,6,0.333,0,0,0.0,0,3,3,2,2,1,0,4,10,-1,1,SAC,PHX,SAC,117,11.5,Points,15,13,12,5
Kevin Huerter,G,22023,1628989,22300567,"JAN 16, 2024",SAC @ PHX,L,26,4,9,0.444,2,6,0.333,0,0,0.0,0,3,3,2,2,1,0,4,10,-1,1,SAC,PHX,SAC,117,4.0,Rebounds,15,13,12,5
Kevin Huerter,G,22023,1628989,22300567,"JAN 16, 2024",SAC @ PHX,L,26,4,9,0.444,2,6,0.333,0,0,0.0,0,3,3,2,2,1,0,4,10,-1,1,SAC,PHX,SAC,117,18.5,Pts+Rebs+Asts,15,13,12,5
Kevin Huerter,G,22023,1628989,22300567,"JAN 16, 2024",SAC @ PHX,L,26,4,9,0.444,2,6,0.333,0,0,0.0,0,3,3,2,2,1,0,4,10,-1,1,SAC,PHX,SAC,117,2.5,Assists,15,13,12,5
Kevin Huerter,G,22023,1628989,22300567,"JAN 16, 2024",SAC @ PHX,L,26,4,9,0.444,2,6,0.333,0,0,0.0,0,3,3,2,2,1,0,4,10,-1,1,SAC,PHX,SAC,117,6.0,3-PT Attempted,15,13,12,5
Kevin Huerter,G,22023,1628989,22300567,"JAN 16, 2024",SAC @ PHX,L,26,4,9,0.444,2,6,0.333,0,0,0.0,0,3,3,2,2,1,0,4,10,-1,1,SAC,PHX,SAC,117,15.5,Pts+Rebs,15,13,12,5
Kevin Huerter,G,22023,1628989,22300567,"JAN 16, 2024",SAC @ PHX,L,26,4,9,0.444,2,6,0.333,0,0,0.0,0,3,3,2,2,1,0,4,10,-1,1,SAC,PHX,SAC,117,14.5,Pts+Asts,15,13,12,5
Kevin Huerter,G,22023,1628989,22300552,"JAN 14, 2024",SAC @ MIL,L,39,10,14,0.714,6,9,0.667,0,0,0.0,0,10,10,3,1,0,1,4,26,4,1,SAC,MIL,SAC,142,11.5,Points,39,36,29,13
Kevin Huerter,G,22023,1628989,22300552,"JAN 14, 2024",SAC @ MIL,L,39,10,14,0.714,6,9,0.667,0,0,0.0,0,10,10,3,1,0,1,4,26,4,1,SAC,MIL,SAC,142,4.0,Rebounds,39,36,29,13
Kevin Huerter,G,22023,1628989,22300552,"JAN 14, 2024",SAC @ MIL,L,39,10,14,0.714,6,9,0.667,0,0,0.0,0,10,10,3,1,0,1,4,26,4,1,SAC,MIL,SAC,142,18.5,Pts+Rebs+Asts,39,36,29,13
Kevin Huerter,G,22023,1628989,22300552,"JAN 14, 2024",SAC @ MIL,L,39,10,14,0.714,6,9,0.667,0,0,0.0,0,10,10,3,1,0,1,4,26,4,1,SAC,MIL,SAC,142,2.5,Assists,39,36,29,13
Kevin Huerter,G,22023,1628989,22300552,"JAN 14, 2024",SAC @ MIL,L,39,10,14,0.714,6,9,0.667,0,0,0.0,0,10,10,3,1,0,1,4,26,4,1,SAC,MIL,SAC,142,6.0,3-PT Attempted,39,36,29,13
Kevin Huerter,G,22023,1628989,22300552,"JAN 14, 2024",SAC @ MIL,L,39,10,14,0.714,6,9,0.667,0,0,0.0,0,10,10,3,1,0,1,4,26,4,1,SAC,MIL,SAC,142,15.5,Pts+Rebs,39,36,29,13
Kevin Huerter,G,22023,1628989,22300552,"JAN 14, 2024",SAC @ MIL,L,39,10,14,0.714,6,9,0.667,0,0,0.0,0,10,10,3,1,0,1,4,26,4,1,SAC,MIL,SAC,142,14.5,Pts+Asts,39,36,29,13
Kevin Huerter,G,22023,1628989,22300518,"JAN 10, 2024",SAC @ CHA,W,1,0,0,0.0,0,0,0.0,0,0,0.0,0,0,0,0,0,0,0,1,0,-2,1,SAC,CHA,SAC,121,11.5,Points,0,0,0,0
Kevin Huerter,G,22023,1628989,22300518,"JAN 10, 2024",SAC @ CHA,W,1,0,0,0.0,0,0,0.0,0,0,0.0,0,0,0,0,0,0,0,1,0,-2,1,SAC,CHA,SAC,121,4.0,Rebounds,0,0,0,0
Kevin Huerter,G,22023,1628989,22300518,"JAN 10, 2024",SAC @ CHA,W,1,0,0,0.0,0,0,0.0,0,0,0.0,0,0,0,0,0,0,0,1,0,-2,1,SAC,CHA,SAC,121,18.5,Pts+Rebs+Asts,0,0,0,0
Kevin Huerter,G,22023,1628989,22300518,"JAN 10, 2024",SAC @ CHA,W,1,0,0,0.0,0,0,0.0,0,0,0.0,0,0,0,0,0,0,0,1,0,-2,1,SAC,CHA,SAC,121,2.5,Assists,0,0,0,0
Kevin Huerter,G,22023,1628989,22300518,"JAN 10, 2024",SAC @ CHA,W,1,0,0,0.0,0,0,0.0,0,0,0.0,0,0,0,0,0,0,0,1,0,-2,1,SAC,CHA,SAC,121,6.0,3-PT Attempted,0,0,0,0
Kevin Huerter,G,22023,1628989,22300518,"JAN 10, 2024",SAC @ CHA,W,1,0,0,0.0,0,0,0.0,0,0,0.0,0,0,0,0,0,0,0,1,0,-2,1,SAC,CHA,SAC,121,15.5,Pts+Rebs,0,0,0,0
Kevin Huerter,G,22023,1628989,22300518,"JAN 10, 2024",SAC @ CHA,W,1,0,0,0.0,0,0,0.0,0,0,0.0,0,0,0,0,0,0,0,1,0,-2,1,SAC,CHA,SAC,121,14.5,Pts+Asts,0,0,0,0
Kevin Huerter,G,22023,1628989,22300512,"JAN 09, 2024",SAC @ DET,W,29,2,11,0.182,0,6,0.0,0,0,0.0,0,5,5,5,1,1,0,1,4,16,1,SAC,DET,SAC,131,11.5,Points,14,9,9,10
Kevin Huerter,G,22023,1628989,22300512,"JAN 09, 2024",SAC @ DET,W,29,2,11,0.182,0,6,0.0,0,0,0.0,0,5,5,5,1,1,0,1,4,16,1,SAC,DET,SAC,131,4.0,Rebounds,14,9,9,10
Kevin Huerter,G,22023,1628989,22300512,"JAN 09, 2024",SAC @ DET,W,29,2,11,0.182,0,6,0.0,0,0,0.0,0,5,5,5,1,1,0,1,4,16,1,SAC,DET,SAC,131,18.5,Pts+Rebs+Asts,14,9,9,10
Kevin Huerter,G,22023,1628989,22300512,"JAN 09, 2024",SAC @ DET,W,29,2,11,0.182,0,6,0.0,0,0,0.0,0,5,5,5,1,1,0,1,4,16,1,SAC,DET,SAC,131,2.5,Assists,14,9,9,10
Kevin Huerter,G,22023,1628989,22300512,"JAN 09, 2024",SAC @ DET,W,29,2,11,0.182,0,6,0.0,0,0,0.0,0,5,5,5,1,1,0,1,4,16,1,SAC,DET,SAC,131,6.0,3-PT Attempted,14,9,9,10
Kevin Huerter,G,22023,1628989,22300512,"JAN 09, 2024",SAC @ DET,W,29,2,11,0.182,0,6,0.0,0,0,0.0,0,5,5,5,1,1,0,1,4,16,1,SAC,DET,SAC,131,15.5,Pts+Rebs,14,9,9,10
Kevin Huerter,G,22023,1628989,22300512,"JAN 09, 2024",SAC @ DET,W,29,2,11,0.182,0,6,0.0,0,0,0.0,0,5,5,5,1,1,0,1,4,16,1,SAC,DET,SAC,131,14.5,Pts+Asts,14,9,9,10
Kevin Huerter,G,22023,1628989,22300500,"JAN 07, 2024",SAC vs. NOP,L,24,6,10,0.6,2,6,0.333,3,4,0.75,1,0,1,3,1,1,0,0,17,-3,1,SAC,SAC,NOP,100,11.5,Points,21,18,20,4
Kevin Huerter,G,22023,1628989,22300500,"JAN 07, 2024",SAC vs. NOP,L,24,6,10,0.6,2,6,0.333,3,4,0.75,1,0,1,3,1,1,0,0,17,-3,1,SAC,SAC,NOP,100,4.0,Rebounds,21,18,20,4
Kevin Huerter,G,22023,1628989,22300500,"JAN 07, 2024",SAC vs. NOP,L,24,6,10,0.6,2,6,0.333,3,4,0.75,1,0,1,3,1,1,0,0,17,-3,1,SAC,SAC,NOP,100,18.5,Pts+Rebs+Asts,21,18,20,4
Kevin Huerter,G,22023,1628989,22300500,"JAN 07, 2024",SAC vs. NOP,L,24,6,10,0.6,2,6,0.333,3,4,0.75,1,0,1,3,1,1,0,0,17,-3,1,SAC,SAC,NOP,100,2.5,Assists,21,18,20,4
Kevin Huerter,G,22023,1628989,22300500,"JAN 07, 2024",SAC vs. NOP,L,24,6,10,0.6,2,6,0.333,3,4,0.75,1,0,1,3,1,1,0,0,17,-3,1,SAC,SAC,NOP,100,6.0,3-PT Attempted,21,18,20,4
Kevin Huerter,G,22023,1628989,22300500,"JAN 07, 2024",SAC vs. NOP,L,24,6,10,0.6,2,6,0.333,3,4,0.75,1,0,1,3,1,1,0,0,17,-3,1,SAC,SAC,NOP,100,15.5,Pts+Rebs,21,18,20,4
Kevin Huerter,G,22023,1628989,22300500,"JAN 07, 2024",SAC vs. NOP,L,24,6,10,0.6,2,6,0.333,3,4,0.75,1,0,1,3,1,1,0,0,17,-3,1,SAC,SAC,NOP,100,14.5,Pts+Asts,21,18,20,4
Kevin Huerter,G,22023,1628989,22300492,"JAN 05, 2024",SAC vs. TOR,W,14,1,2,0.5,1,2,0.5,0,0,0.0,0,2,2,3,0,0,0,1,3,3,1,SAC,SAC,TOR,135,11.5,Points,8,5,6,5
Kevin Huerter,G,22023,1628989,22300492,"JAN 05, 2024",SAC vs. TOR,W,14,1,2,0.5,1,2,0.5,0,0,0.0,0,2,2,3,0,0,0,1,3,3,1,SAC,SAC,TOR,135,4.0,Rebounds,8,5,6,5
Kevin Huerter,G,22023,1628989,22300492,"JAN 05, 2024",SAC vs. TOR,W,14,1,2,0.5,1,2,0.5,0,0,0.0,0,2,2,3,0,0,0,1,3,3,1,SAC,SAC,TOR,135,18.5,Pts+Rebs+Asts,8,5,6,5
Kevin Huerter,G,22023,1628989,22300492,"JAN 05, 2024",SAC vs. TOR,W,14,1,2,0.5,1,2,0.5,0,0,0.0,0,2,2,3,0,0,0,1,3,3,1,SAC,SAC,TOR,135,2.5,Assists,8,5,6,5
Kevin Huerter,G,22023,1628989,22300492,"JAN 05, 2024",SAC vs. TOR,W,14,1,2,0.5,1,2,0.5,0,0,0.0,0,2,2,3,0,0,0,1,3,3,1,SAC,SAC,TOR,135,6.0,3-PT Attempted,8,5,6,5
Kevin Huerter,G,22023,1628989,22300492,"JAN 05, 2024",SAC vs. TOR,W,14,1,2,0.5,1,2,0.5,0,0,0.0,0,2,2,3,0,0,0,1,3,3,1,SAC,SAC,TOR,135,15.5,Pts+Rebs,8,5,6,5
Kevin Huerter,G,22023,1628989,22300492,"JAN 05, 2024",SAC vs. TOR,W,14,1,2,0.5,1,2,0.5,0,0,0.0,0,2,2,3,0,0,0,1,3,3,1,SAC,SAC,TOR,135,14.5,Pts+Asts,8,5,6,5
Kevin Huerter,G,22023,1628989,22300476,"JAN 03, 2024",SAC vs. ORL,W,18,0,5,0.0,0,4,0.0,2,2,1.0,1,6,7,2,0,0,1,1,2,4,1,SAC,SAC,ORL,138,11.5,Points,11,9,4,9
Kevin Huerter,G,22023,1628989,22300476,"JAN 03, 2024",SAC vs. ORL,W,18,0,5,0.0,0,4,0.0,2,2,1.0,1,6,7,2,0,0,1,1,2,4,1,SAC,SAC,ORL,138,4.0,Rebounds,11,9,4,9
Kevin Huerter,G,22023,1628989,22300476,"JAN 03, 2024",SAC vs. ORL,W,18,0,5,0.0,0,4,0.0,2,2,1.0,1,6,7,2,0,0,1,1,2,4,1,SAC,SAC,ORL,138,18.5,Pts+Rebs+Asts,11,9,4,9
Kevin Huerter,G,22023,1628989,22300476,"JAN 03, 2024",SAC vs. ORL,W,18,0,5,0.0,0,4,0.0,2,2,1.0,1,6,7,2,0,0,1,1,2,4,1,SAC,SAC,ORL,138,2.5,Assists,11,9,4,9
Kevin Huerter,G,22023,1628989,22300476,"JAN 03, 2024",SAC vs. ORL,W,18,0,5,0.0,0,4,0.0,2,2,1.0,1,6,7,2,0,0,1,1,2,4,1,SAC,SAC,ORL,138,6.0,3-PT Attempted,11,9,4,9
Kevin Huerter,G,22023,1628989,22300476,"JAN 03, 2024",SAC vs. ORL,W,18,0,5,0.0,0,4,0.0,2,2,1.0,1,6,7,2,0,0,1,1,2,4,1,SAC,SAC,ORL,138,15.5,Pts+Rebs,11,9,4,9
Kevin Huerter,G,22023,1628989,22300476,"JAN 03, 2024",SAC vs. ORL,W,18,0,5,0.0,0,4,0.0,2,2,1.0,1,6,7,2,0,0,1,1,2,4,1,SAC,SAC,ORL,138,14.5,Pts+Asts,11,9,4,9
Kevin Huerter,G,22023,1628989,22300464,"JAN 02, 2024",SAC vs. CHA,L,12,1,4,0.25,0,2,0.0,2,2,1.0,0,2,2,0,0,0,0,3,4,-1,1,SAC,SAC,CHA,104,11.5,Points,6,6,4,2
Kevin Huerter,G,22023,1628989,22300464,"JAN 02, 2024",SAC vs. CHA,L,12,1,4,0.25,0,2,0.0,2,2,1.0,0,2,2,0,0,0,0,3,4,-1,1,SAC,SAC,CHA,104,4.0,Rebounds,6,6,4,2
Kevin Huerter,G,22023,1628989,22300464,"JAN 02, 2024",SAC vs. CHA,L,12,1,4,0.25,0,2,0.0,2,2,1.0,0,2,2,0,0,0,0,3,4,-1,1,SAC,SAC,CHA,104,18.5,Pts+Rebs+Asts,6,6,4,2
Kevin Huerter,G,22023,1628989,22300464,"JAN 02, 2024",SAC vs. CHA,L,12,1,4,0.25,0,2,0.0,2,2,1.0,0,2,2,0,0,0,0,3,4,-1,1,SAC,SAC,CHA,104,2.5,Assists,6,6,4,2
Kevin Huerter,G,22023,1628989,22300464,"JAN 02, 2024",SAC vs. CHA,L,12,1,4,0.25,0,2,0.0,2,2,1.0,0,2,2,0,0,0,0,3,4,-1,1,SAC,SAC,CHA,104,6.0,3-PT Attempted,6,6,4,2
Kevin Huerter,G,22023,1628989,22300464,"JAN 02, 2024",SAC vs. CHA,L,12,1,4,0.25,0,2,0.0,2,2,1.0,0,2,2,0,0,0,0,3,4,-1,1,SAC,SAC,CHA,104,15.5,Pts+Rebs,6,6,4,2
Kevin Huerter,G,22023,1628989,22300464,"JAN 02, 2024",SAC vs. CHA,L,12,1,4,0.25,0,2,0.0,2,2,1.0,0,2,2,0,0,0,0,3,4,-1,1,SAC,SAC,CHA,104,14.5,Pts+Asts,6,6,4,2
Kevin Huerter,G,22023,1628989,22300449,"DEC 31, 2023",SAC @ MEM,W,17,4,9,0.444,1,3,0.333,0,0,0.0,0,0,0,0,0,0,0,1,9,16,1,SAC,MEM,SAC,123,11.5,Points,9,9,9,0
Kevin Huerter,G,22023,1628989,22300449,"DEC 31, 2023",SAC @ MEM,W,17,4,9,0.444,1,3,0.333,0,0,0.0,0,0,0,0,0,0,0,1,9,16,1,SAC,MEM,SAC,123,4.0,Rebounds,9,9,9,0
Kevin Huerter,G,22023,1628989,22300449,"DEC 31, 2023",SAC @ MEM,W,17,4,9,0.444,1,3,0.333,0,0,0.0,0,0,0,0,0,0,0,1,9,16,1,SAC,MEM,SAC,123,18.5,Pts+Rebs+Asts,9,9,9,0
Kevin Huerter,G,22023,1628989,22300449,"DEC 31, 2023",SAC @ MEM,W,17,4,9,0.444,1,3,0.333,0,0,0.0,0,0,0,0,0,0,0,1,9,16,1,SAC,MEM,SAC,123,2.5,Assists,9,9,9,0
Kevin Huerter,G,22023,1628989,22300449,"DEC 31, 2023",SAC @ MEM,W,17,4,9,0.444,1,3,0.333,0,0,0.0,0,0,0,0,0,0,0,1,9,16,1,SAC,MEM,SAC,123,6.0,3-PT Attempted,9,9,9,0
Kevin Huerter,G,22023,1628989,22300449,"DEC 31, 2023",SAC @ MEM,W,17,4,9,0.444,1,3,0.333,0,0,0.0,0,0,0,0,0,0,0,1,9,16,1,SAC,MEM,SAC,123,15.5,Pts+Rebs,9,9,9,0
Kevin Huerter,G,22023,1628989,22300449,"DEC 31, 2023",SAC @ MEM,W,17,4,9,0.444,1,3,0.333,0,0,0.0,0,0,0,0,0,0,0,1,9,16,1,SAC,MEM,SAC,123,14.5,Pts+Asts,9,9,9,0
Kevin Huerter,G,22023,1628989,22300431,"DEC 29, 2023",SAC @ ATL,W,10,3,6,0.5,1,3,0.333,0,0,0.0,0,3,3,1,0,0,0,0,7,-5,1,SAC,ATL,SAC,117,11.5,Points,11,10,8,4
Kevin Huerter,G,22023,1628989,22300431,"DEC 29, 2023",SAC @ ATL,W,10,3,6,0.5,1,3,0.333,0,0,0.0,0,3,3,1,0,0,0,0,7,-5,1,SAC,ATL,SAC,117,4.0,Rebounds,11,10,8,4
Kevin Huerter,G,22023,1628989,22300431,"DEC 29, 2023",SAC @ ATL,W,10,3,6,0.5,1,3,0.333,0,0,0.0,0,3,3,1,0,0,0,0,7,-5,1,SAC,ATL,SAC,117,18.5,Pts+Rebs+Asts,11,10,8,4
Kevin Huerter,G,22023,1628989,22300431,"DEC 29, 2023",SAC @ ATL,W,10,3,6,0.5,1,3,0.333,0,0,0.0,0,3,3,1,0,0,0,0,7,-5,1,SAC,ATL,SAC,117,2.5,Assists,11,10,8,4
Kevin Huerter,G,22023,1628989,22300431,"DEC 29, 2023",SAC @ ATL,W,10,3,6,0.5,1,3,0.333,0,0,0.0,0,3,3,1,0,0,0,0,7,-5,1,SAC,ATL,SAC,117,6.0,3-PT Attempted,11,10,8,4
Kevin Huerter,G,22023,1628989,22300431,"DEC 29, 2023",SAC @ ATL,W,10,3,6,0.5,1,3,0.333,0,0,0.0,0,3,3,1,0,0,0,0,7,-5,1,SAC,ATL,SAC,117,15.5,Pts+Rebs,11,10,8,4
Kevin Huerter,G,22023,1628989,22300431,"DEC 29, 2023",SAC @ ATL,W,10,3,6,0.5,1,3,0.333,0,0,0.0,0,3,3,1,0,0,0,0,7,-5,1,SAC,ATL,SAC,117,14.5,Pts+Asts,11,10,8,4
Kevin Huerter,G,22023,1628989,22300413,"DEC 26, 2023",SAC @ POR,L,22,2,8,0.25,1,5,0.2,0,0,0.0,1,1,2,2,0,1,0,1,5,5,1,SAC,POR,SAC,113,11.5,Points,9,7,7,4
Kevin Huerter,G,22023,1628989,22300413,"DEC 26, 2023",SAC @ POR,L,22,2,8,0.25,1,5,0.2,0,0,0.0,1,1,2,2,0,1,0,1,5,5,1,SAC,POR,SAC,113,4.0,Rebounds,9,7,7,4
Kevin Huerter,G,22023,1628989,22300413,"DEC 26, 2023",SAC @ POR,L,22,2,8,0.25,1,5,0.2,0,0,0.0,1,1,2,2,0,1,0,1,5,5,1,SAC,POR,SAC,113,18.5,Pts+Rebs+Asts,9,7,7,4
Kevin Huerter,G,22023,1628989,22300413,"DEC 26, 2023",SAC @ POR,L,22,2,8,0.25,1,5,0.2,0,0,0.0,1,1,2,2,0,1,0,1,5,5,1,SAC,POR,SAC,113,2.5,Assists,9,7,7,4
Kevin Huerter,G,22023,1628989,22300413,"DEC 26, 2023",SAC @ POR,L,22,2,8,0.25,1,5,0.2,0,0,0.0,1,1,2,2,0,1,0,1,5,5,1,SAC,POR,SAC,113,6.0,3-PT Attempted,9,7,7,4
Kevin Huerter,G,22023,1628989,22300413,"DEC 26, 2023",SAC @ POR,L,22,2,8,0.25,1,5,0.2,0,0,0.0,1,1,2,2,0,1,0,1,5,5,1,SAC,POR,SAC,113,15.5,Pts+Rebs,9,7,7,4
Kevin Huerter,G,22023,1628989,22300413,"DEC 26, 2023",SAC @ POR,L,22,2,8,0.25,1,5,0.2,0,0,0.0,1,1,2,2,0,1,0,1,5,5,1,SAC,POR,SAC,113,14.5,Pts+Asts,9,7,7,4
Kevin Huerter,G,22023,1628989,22300400,"DEC 23, 2023",SAC vs. MIN,L,15,1,7,0.143,0,2,0.0,0,0,0.0,0,1,1,1,0,0,1,3,2,-19,1,SAC,SAC,MIN,98,11.5,Points,4,3,3,2
Kevin Huerter,G,22023,1628989,22300400,"DEC 23, 2023",SAC vs. MIN,L,15,1,7,0.143,0,2,0.0,0,0,0.0,0,1,1,1,0,0,1,3,2,-19,1,SAC,SAC,MIN,98,4.0,Rebounds,4,3,3,2
Kevin Huerter,G,22023,1628989,22300400,"DEC 23, 2023",SAC vs. MIN,L,15,1,7,0.143,0,2,0.0,0,0,0.0,0,1,1,1,0,0,1,3,2,-19,1,SAC,SAC,MIN,98,18.5,Pts+Rebs+Asts,4,3,3,2
Kevin Huerter,G,22023,1628989,22300400,"DEC 23, 2023",SAC vs. MIN,L,15,1,7,0.143,0,2,0.0,0,0,0.0,0,1,1,1,0,0,1,3,2,-19,1,SAC,SAC,MIN,98,2.5,Assists,4,3,3,2
Kevin Huerter,G,22023,1628989,22300400,"DEC 23, 2023",SAC vs. MIN,L,15,1,7,0.143,0,2,0.0,0,0,0.0,0,1,1,1,0,0,1,3,2,-19,1,SAC,SAC,MIN,98,6.0,3-PT Attempted,4,3,3,2
Kevin Huerter,G,22023,1628989,22300400,"DEC 23, 2023",SAC vs. MIN,L,15,1,7,0.143,0,2,0.0,0,0,0.0,0,1,1,1,0,0,1,3,2,-19,1,SAC,SAC,MIN,98,15.5,Pts+Rebs,4,3,3,2
Kevin Huerter,G,22023,1628989,22300400,"DEC 23, 2023",SAC vs. MIN,L,15,1,7,0.143,0,2,0.0,0,0,0.0,0,1,1,1,0,0,1,3,2,-19,1,SAC,SAC,MIN,98,14.5,Pts+Asts,4,3,3,2
Kevin Huerter,G,22023,1628989,22300387,"DEC 22, 2023",SAC vs. PHX,W,27,5,9,0.556,2,6,0.333,1,1,1.0,1,1,2,5,1,0,1,1,13,22,1,SAC,SAC,PHX,120,11.5,Points,20,15,18,7
Kevin Huerter,G,22023,1628989,22300387,"DEC 22, 2023",SAC vs. PHX,W,27,5,9,0.556,2,6,0.333,1,1,1.0,1,1,2,5,1,0,1,1,13,22,1,SAC,SAC,PHX,120,4.0,Rebounds,20,15,18,7
Kevin Huerter,G,22023,1628989,22300387,"DEC 22, 2023",SAC vs. PHX,W,27,5,9,0.556,2,6,0.333,1,1,1.0,1,1,2,5,1,0,1,1,13,22,1,SAC,SAC,PHX,120,18.5,Pts+Rebs+Asts,20,15,18,7
Kevin Huerter,G,22023,1628989,22300387,"DEC 22, 2023",SAC vs. PHX,W,27,5,9,0.556,2,6,0.333,1,1,1.0,1,1,2,5,1,0,1,1,13,22,1,SAC,SAC,PHX,120,2.5,Assists,20,15,18,7
Kevin Huerter,G,22023,1628989,22300387,"DEC 22, 2023",SAC vs. PHX,W,27,5,9,0.556,2,6,0.333,1,1,1.0,1,1,2,5,1,0,1,1,13,22,1,SAC,SAC,PHX,120,6.0,3-PT Attempted,20,15,18,7
Kevin Huerter,G,22023,1628989,22300387,"DEC 22, 2023",SAC vs. PHX,W,27,5,9,0.556,2,6,0.333,1,1,1.0,1,1,2,5,1,0,1,1,13,22,1,SAC,SAC,PHX,120,15.5,Pts+Rebs,20,15,18,7
Kevin Huerter,G,22023,1628989,22300387,"DEC 22, 2023",SAC vs. PHX,W,27,5,9,0.556,2,6,0.333,1,1,1.0,1,1,2,5,1,0,1,1,13,22,1,SAC,SAC,PHX,120,14.5,Pts+Asts,20,15,18,7
Kevin Huerter,G,22023,1628989,22300373,"DEC 20, 2023",SAC vs. BOS,L,16,3,5,0.6,1,2,0.5,0,1,0.0,0,1,1,0,0,0,0,1,7,-7,1,SAC,SAC,BOS,119,11.5,Points,8,8,7,1
Kevin Huerter,G,22023,1628989,22300373,"DEC 20, 2023",SAC vs. BOS,L,16,3,5,0.6,1,2,0.5,0,1,0.0,0,1,1,0,0,0,0,1,7,-7,1,SAC,SAC,BOS,119,4.0,Rebounds,8,8,7,1
Kevin Huerter,G,22023,1628989,22300373,"DEC 20, 2023",SAC vs. BOS,L,16,3,5,0.6,1,2,0.5,0,1,0.0,0,1,1,0,0,0,0,1,7,-7,1,SAC,SAC,BOS,119,18.5,Pts+Rebs+Asts,8,8,7,1
Kevin Huerter,G,22023,1628989,22300373,"DEC 20, 2023",SAC vs. BOS,L,16,3,5,0.6,1,2,0.5,0,1,0.0,0,1,1,0,0,0,0,1,7,-7,1,SAC,SAC,BOS,119,2.5,Assists,8,8,7,1
Kevin Huerter,G,22023,1628989,22300373,"DEC 20, 2023",SAC vs. BOS,L,16,3,5,0.6,1,2,0.5,0,1,0.0,0,1,1,0,0,0,0,1,7,-7,1,SAC,SAC,BOS,119,6.0,3-PT Attempted,8,8,7,1
Kevin Huerter,G,22023,1628989,22300373,"DEC 20, 2023",SAC vs. BOS,L,16,3,5,0.6,1,2,0.5,0,1,0.0,0,1,1,0,0,0,0,1,7,-7,1,SAC,SAC,BOS,119,15.5,Pts+Rebs,8,8,7,1
Kevin Huerter,G,22023,1628989,22300373,"DEC 20, 2023",SAC vs. BOS,L,16,3,5,0.6,1,2,0.5,0,1,0.0,0,1,1,0,0,0,0,1,7,-7,1,SAC,SAC,BOS,119,14.5,Pts+Asts,8,8,7,1
Kevin Huerter,G,22023,1628989,22300358,"DEC 18, 2023",SAC vs. WAS,W,23,4,8,0.5,1,4,0.25,2,2,1.0,0,4,4,2,0,1,0,4,11,14,1,SAC,SAC,WAS,141,11.5,Points,17,15,13,6
Kevin Huerter,G,22023,1628989,22300358,"DEC 18, 2023",SAC vs. WAS,W,23,4,8,0.5,1,4,0.25,2,2,1.0,0,4,4,2,0,1,0,4,11,14,1,SAC,SAC,WAS,141,4.0,Rebounds,17,15,13,6
Kevin Huerter,G,22023,1628989,22300358,"DEC 18, 2023",SAC vs. WAS,W,23,4,8,0.5,1,4,0.25,2,2,1.0,0,4,4,2,0,1,0,4,11,14,1,SAC,SAC,WAS,141,18.5,Pts+Rebs+Asts,17,15,13,6
Kevin Huerter,G,22023,1628989,22300358,"DEC 18, 2023",SAC vs. WAS,W,23,4,8,0.5,1,4,0.25,2,2,1.0,0,4,4,2,0,1,0,4,11,14,1,SAC,SAC,WAS,141,2.5,Assists,17,15,13,6
Kevin Huerter,G,22023,1628989,22300358,"DEC 18, 2023",SAC vs. WAS,W,23,4,8,0.5,1,4,0.25,2,2,1.0,0,4,4,2,0,1,0,4,11,14,1,SAC,SAC,WAS,141,6.0,3-PT Attempted,17,15,13,6
Kevin Huerter,G,22023,1628989,22300358,"DEC 18, 2023",SAC vs. WAS,W,23,4,8,0.5,1,4,0.25,2,2,1.0,0,4,4,2,0,1,0,4,11,14,1,SAC,SAC,WAS,141,15.5,Pts+Rebs,17,15,13,6
Kevin Huerter,G,22023,1628989,22300358,"DEC 18, 2023",SAC vs. WAS,W,23,4,8,0.5,1,4,0.25,2,2,1.0,0,4,4,2,0,1,0,4,11,14,1,SAC,SAC,WAS,141,14.5,Pts+Asts,17,15,13,6
Kevin Huerter,G,22023,1628989,22300342,"DEC 16, 2023",SAC vs. UTA,W,25,4,6,0.667,2,4,0.5,1,2,0.5,1,2,3,5,0,0,0,4,11,26,1,SAC,SAC,UTA,125,11.5,Points,19,14,16,8
Kevin Huerter,G,22023,1628989,22300342,"DEC 16, 2023",SAC vs. UTA,W,25,4,6,0.667,2,4,0.5,1,2,0.5,1,2,3,5,0,0,0,4,11,26,1,SAC,SAC,UTA,125,4.0,Rebounds,19,14,16,8
Kevin Huerter,G,22023,1628989,22300342,"DEC 16, 2023",SAC vs. UTA,W,25,4,6,0.667,2,4,0.5,1,2,0.5,1,2,3,5,0,0,0,4,11,26,1,SAC,SAC,UTA,125,18.5,Pts+Rebs+Asts,19,14,16,8
Kevin Huerter,G,22023,1628989,22300342,"DEC 16, 2023",SAC vs. UTA,W,25,4,6,0.667,2,4,0.5,1,2,0.5,1,2,3,5,0,0,0,4,11,26,1,SAC,SAC,UTA,125,2.5,Assists,19,14,16,8
Kevin Huerter,G,22023,1628989,22300342,"DEC 16, 2023",SAC vs. UTA,W,25,4,6,0.667,2,4,0.5,1,2,0.5,1,2,3,5,0,0,0,4,11,26,1,SAC,SAC,UTA,125,6.0,3-PT Attempted,19,14,16,8
Kevin Huerter,G,22023,1628989,22300342,"DEC 16, 2023",SAC vs. UTA,W,25,4,6,0.667,2,4,0.5,1,2,0.5,1,2,3,5,0,0,0,4,11,26,1,SAC,SAC,UTA,125,15.5,Pts+Rebs,19,14,16,8
Kevin Huerter,G,22023,1628989,22300342,"DEC 16, 2023",SAC vs. UTA,W,25,4,6,0.667,2,4,0.5,1,2,0.5,1,2,3,5,0,0,0,4,11,26,1,SAC,SAC,UTA,125,14.5,Pts+Asts,19,14,16,8
Kevin Huerter,G,22023,1628989,22300324,"DEC 14, 2023",SAC vs. OKC,W,20,2,8,0.25,0,3,0.0,0,0,0.0,1,1,2,2,2,1,1,1,4,-10,1,SAC,SAC,OKC,128,11.5,Points,8,6,6,4
Kevin Huerter,G,22023,1628989,22300324,"DEC 14, 2023",SAC vs. OKC,W,20,2,8,0.25,0,3,0.0,0,0,0.0,1,1,2,2,2,1,1,1,4,-10,1,SAC,SAC,OKC,128,4.0,Rebounds,8,6,6,4
Kevin Huerter,G,22023,1628989,22300324,"DEC 14, 2023",SAC vs. OKC,W,20,2,8,0.25,0,3,0.0,0,0,0.0,1,1,2,2,2,1,1,1,4,-10,1,SAC,SAC,OKC,128,18.5,Pts+Rebs+Asts,8,6,6,4
Kevin Huerter,G,22023,1628989,22300324,"DEC 14, 2023",SAC vs. OKC,W,20,2,8,0.25,0,3,0.0,0,0,0.0,1,1,2,2,2,1,1,1,4,-10,1,SAC,SAC,OKC,128,2.5,Assists,8,6,6,4
Kevin Huerter,G,22023,1628989,22300324,"DEC 14, 2023",SAC vs. OKC,W,20,2,8,0.25,0,3,0.0,0,0,0.0,1,1,2,2,2,1,1,1,4,-10,1,SAC,SAC,OKC,128,6.0,3-PT Attempted,8,6,6,4
Kevin Huerter,G,22023,1628989,22300324,"DEC 14, 2023",SAC vs. OKC,W,20,2,8,0.25,0,3,0.0,0,0,0.0,1,1,2,2,2,1,1,1,4,-10,1,SAC,SAC,OKC,128,15.5,Pts+Rebs,8,6,6,4
Kevin Huerter,G,22023,1628989,22300324,"DEC 14, 2023",SAC vs. OKC,W,20,2,8,0.25,0,3,0.0,0,0,0.0,1,1,2,2,2,1,1,1,4,-10,1,SAC,SAC,OKC,128,14.5,Pts+Asts,8,6,6,4
Kevin Huerter,G,22023,1628989,22300309,"DEC 12, 2023",SAC @ LAC,L,17,1,8,0.125,1,4,0.25,0,0,0.0,0,4,4,3,1,0,0,1,3,-8,1,SAC,LAC,SAC,99,11.5,Points,10,7,6,7
Kevin Huerter,G,22023,1628989,22300309,"DEC 12, 2023",SAC @ LAC,L,17,1,8,0.125,1,4,0.25,0,0,0.0,0,4,4,3,1,0,0,1,3,-8,1,SAC,LAC,SAC,99,4.0,Rebounds,10,7,6,7
Kevin Huerter,G,22023,1628989,22300309,"DEC 12, 2023",SAC @ LAC,L,17,1,8,0.125,1,4,0.25,0,0,0.0,0,4,4,3,1,0,0,1,3,-8,1,SAC,LAC,SAC,99,18.5,Pts+Rebs+Asts,10,7,6,7
Kevin Huerter,G,22023,1628989,22300309,"DEC 12, 2023",SAC @ LAC,L,17,1,8,0.125,1,4,0.25,0,0,0.0,0,4,4,3,1,0,0,1,3,-8,1,SAC,LAC,SAC,99,2.5,Assists,10,7,6,7
Kevin Huerter,G,22023,1628989,22300309,"DEC 12, 2023",SAC @ LAC,L,17,1,8,0.125,1,4,0.25,0,0,0.0,0,4,4,3,1,0,0,1,3,-8,1,SAC,LAC,SAC,99,6.0,3-PT Attempted,10,7,6,7
Kevin Huerter,G,22023,1628989,22300309,"DEC 12, 2023",SAC @ LAC,L,17,1,8,0.125,1,4,0.25,0,0,0.0,0,4,4,3,1,0,0,1,3,-8,1,SAC,LAC,SAC,99,15.5,Pts+Rebs,10,7,6,7
Kevin Huerter,G,22023,1628989,22300309,"DEC 12, 2023",SAC @ LAC,L,17,1,8,0.125,1,4,0.25,0,0,0.0,0,4,4,3,1,0,0,1,3,-8,1,SAC,LAC,SAC,99,14.5,Pts+Asts,10,7,6,7
Kevin Huerter,G,22023,1628989,22300303,"DEC 11, 2023",SAC vs. BKN,W,17,2,6,0.333,2,5,0.4,0,0,0.0,0,1,1,1,0,0,0,4,6,2,1,SAC,SAC,BKN,131,11.5,Points,8,7,7,2
Kevin Huerter,G,22023,1628989,22300303,"DEC 11, 2023",SAC vs. BKN,W,17,2,6,0.333,2,5,0.4,0,0,0.0,0,1,1,1,0,0,0,4,6,2,1,SAC,SAC,BKN,131,4.0,Rebounds,8,7,7,2
Kevin Huerter,G,22023,1628989,22300303,"DEC 11, 2023",SAC vs. BKN,W,17,2,6,0.333,2,5,0.4,0,0,0.0,0,1,1,1,0,0,0,4,6,2,1,SAC,SAC,BKN,131,18.5,Pts+Rebs+Asts,8,7,7,2
Kevin Huerter,G,22023,1628989,22300303,"DEC 11, 2023",SAC vs. BKN,W,17,2,6,0.333,2,5,0.4,0,0,0.0,0,1,1,1,0,0,0,4,6,2,1,SAC,SAC,BKN,131,2.5,Assists,8,7,7,2
Kevin Huerter,G,22023,1628989,22300303,"DEC 11, 2023",SAC vs. BKN,W,17,2,6,0.333,2,5,0.4,0,0,0.0,0,1,1,1,0,0,0,4,6,2,1,SAC,SAC,BKN,131,6.0,3-PT Attempted,8,7,7,2
Kevin Huerter,G,22023,1628989,22300303,"DEC 11, 2023",SAC vs. BKN,W,17,2,6,0.333,2,5,0.4,0,0,0.0,0,1,1,1,0,0,0,4,6,2,1,SAC,SAC,BKN,131,15.5,Pts+Rebs,8,7,7,2
Kevin Huerter,G,22023,1628989,22300303,"DEC 11, 2023",SAC vs. BKN,W,17,2,6,0.333,2,5,0.4,0,0,0.0,0,1,1,1,0,0,0,4,6,2,1,SAC,SAC,BKN,131,14.5,Pts+Asts,8,7,7,2
Kevin Huerter,G,22023,1628989,22301228,"DEC 08, 2023",SAC @ PHX,W,17,0,4,0.0,0,3,0.0,1,1,1.0,0,3,3,1,1,0,0,3,1,-1,1,SAC,PHX,SAC,114,11.5,Points,5,4,2,4
Kevin Huerter,G,22023,1628989,22301228,"DEC 08, 2023",SAC @ PHX,W,17,0,4,0.0,0,3,0.0,1,1,1.0,0,3,3,1,1,0,0,3,1,-1,1,SAC,PHX,SAC,114,4.0,Rebounds,5,4,2,4
Kevin Huerter,G,22023,1628989,22301228,"DEC 08, 2023",SAC @ PHX,W,17,0,4,0.0,0,3,0.0,1,1,1.0,0,3,3,1,1,0,0,3,1,-1,1,SAC,PHX,SAC,114,18.5,Pts+Rebs+Asts,5,4,2,4
Kevin Huerter,G,22023,1628989,22301228,"DEC 08, 2023",SAC @ PHX,W,17,0,4,0.0,0,3,0.0,1,1,1.0,0,3,3,1,1,0,0,3,1,-1,1,SAC,PHX,SAC,114,2.5,Assists,5,4,2,4
Kevin Huerter,G,22023,1628989,22301228,"DEC 08, 2023",SAC @ PHX,W,17,0,4,0.0,0,3,0.0,1,1,1.0,0,3,3,1,1,0,0,3,1,-1,1,SAC,PHX,SAC,114,6.0,3-PT Attempted,5,4,2,4
Kevin Huerter,G,22023,1628989,22301228,"DEC 08, 2023",SAC @ PHX,W,17,0,4,0.0,0,3,0.0,1,1,1.0,0,3,3,1,1,0,0,3,1,-1,1,SAC,PHX,SAC,114,15.5,Pts+Rebs,5,4,2,4
Kevin Huerter,G,22023,1628989,22301228,"DEC 08, 2023",SAC @ PHX,W,17,0,4,0.0,0,3,0.0,1,1,1.0,0,3,3,1,1,0,0,3,1,-1,1,SAC,PHX,SAC,114,14.5,Pts+Asts,5,4,2,4
Kevin Huerter,G,22023,1628989,22301204,"DEC 04, 2023",SAC vs. NOP,L,32,5,10,0.5,2,7,0.286,0,0,0.0,1,4,5,2,0,0,0,2,12,11,1,SAC,SAC,NOP,117,11.5,Points,19,17,14,7
Kevin Huerter,G,22023,1628989,22301204,"DEC 04, 2023",SAC vs. NOP,L,32,5,10,0.5,2,7,0.286,0,0,0.0,1,4,5,2,0,0,0,2,12,11,1,SAC,SAC,NOP,117,4.0,Rebounds,19,17,14,7
Kevin Huerter,G,22023,1628989,22301204,"DEC 04, 2023",SAC vs. NOP,L,32,5,10,0.5,2,7,0.286,0,0,0.0,1,4,5,2,0,0,0,2,12,11,1,SAC,SAC,NOP,117,18.5,Pts+Rebs+Asts,19,17,14,7
Kevin Huerter,G,22023,1628989,22301204,"DEC 04, 2023",SAC vs. NOP,L,32,5,10,0.5,2,7,0.286,0,0,0.0,1,4,5,2,0,0,0,2,12,11,1,SAC,SAC,NOP,117,2.5,Assists,19,17,14,7
Kevin Huerter,G,22023,1628989,22301204,"DEC 04, 2023",SAC vs. NOP,L,32,5,10,0.5,2,7,0.286,0,0,0.0,1,4,5,2,0,0,0,2,12,11,1,SAC,SAC,NOP,117,6.0,3-PT Attempted,19,17,14,7
Kevin Huerter,G,22023,1628989,22301204,"DEC 04, 2023",SAC vs. NOP,L,32,5,10,0.5,2,7,0.286,0,0,0.0,1,4,5,2,0,0,0,2,12,11,1,SAC,SAC,NOP,117,15.5,Pts+Rebs,19,17,14,7
Kevin Huerter,G,22023,1628989,22301204,"DEC 04, 2023",SAC vs. NOP,L,32,5,10,0.5,2,7,0.286,0,0,0.0,1,4,5,2,0,0,0,2,12,11,1,SAC,SAC,NOP,117,14.5,Pts+Asts,19,17,14,7
Kevin Huerter,G,22023,1628989,22300290,"DEC 02, 2023",SAC vs. DEN,W,29,6,10,0.6,4,6,0.667,0,0,0.0,0,6,6,2,1,1,2,0,16,-4,1,SAC,SAC,DEN,123,11.5,Points,24,22,18,8
Kevin Huerter,G,22023,1628989,22300290,"DEC 02, 2023",SAC vs. DEN,W,29,6,10,0.6,4,6,0.667,0,0,0.0,0,6,6,2,1,1,2,0,16,-4,1,SAC,SAC,DEN,123,4.0,Rebounds,24,22,18,8
Kevin Huerter,G,22023,1628989,22300290,"DEC 02, 2023",SAC vs. DEN,W,29,6,10,0.6,4,6,0.667,0,0,0.0,0,6,6,2,1,1,2,0,16,-4,1,SAC,SAC,DEN,123,18.5,Pts+Rebs+Asts,24,22,18,8
Kevin Huerter,G,22023,1628989,22300290,"DEC 02, 2023",SAC vs. DEN,W,29,6,10,0.6,4,6,0.667,0,0,0.0,0,6,6,2,1,1,2,0,16,-4,1,SAC,SAC,DEN,123,2.5,Assists,24,22,18,8
Kevin Huerter,G,22023,1628989,22300290,"DEC 02, 2023",SAC vs. DEN,W,29,6,10,0.6,4,6,0.667,0,0,0.0,0,6,6,2,1,1,2,0,16,-4,1,SAC,SAC,DEN,123,6.0,3-PT Attempted,24,22,18,8
Kevin Huerter,G,22023,1628989,22300290,"DEC 02, 2023",SAC vs. DEN,W,29,6,10,0.6,4,6,0.667,0,0,0.0,0,6,6,2,1,1,2,0,16,-4,1,SAC,SAC,DEN,123,15.5,Pts+Rebs,24,22,18,8
Kevin Huerter,G,22023,1628989,22300290,"DEC 02, 2023",SAC vs. DEN,W,29,6,10,0.6,4,6,0.667,0,0,0.0,0,6,6,2,1,1,2,0,16,-4,1,SAC,SAC,DEN,123,14.5,Pts+Asts,24,22,18,8
Kevin Huerter,G,22023,1628989,22300264,"NOV 29, 2023",SAC vs. LAC,L,26,3,7,0.429,1,5,0.2,0,0,0.0,1,4,5,5,0,0,2,3,7,3,1,SAC,SAC,LAC,117,11.5,Points,17,12,12,10
Kevin Huerter,G,22023,1628989,22300264,"NOV 29, 2023",SAC vs. LAC,L,26,3,7,0.429,1,5,0.2,0,0,0.0,1,4,5,5,0,0,2,3,7,3,1,SAC,SAC,LAC,117,4.0,Rebounds,17,12,12,10
Kevin Huerter,G,22023,1628989,22300264,"NOV 29, 2023",SAC vs. LAC,L,26,3,7,0.429,1,5,0.2,0,0,0.0,1,4,5,5,0,0,2,3,7,3,1,SAC,SAC,LAC,117,18.5,Pts+Rebs+Asts,17,12,12,10
Kevin Huerter,G,22023,1628989,22300264,"NOV 29, 2023",SAC vs. LAC,L,26,3,7,0.429,1,5,0.2,0,0,0.0,1,4,5,5,0,0,2,3,7,3,1,SAC,SAC,LAC,117,2.5,Assists,17,12,12,10
Kevin Huerter,G,22023,1628989,22300264,"NOV 29, 2023",SAC vs. LAC,L,26,3,7,0.429,1,5,0.2,0,0,0.0,1,4,5,5,0,0,2,3,7,3,1,SAC,SAC,LAC,117,6.0,3-PT Attempted,17,12,12,10
Kevin Huerter,G,22023,1628989,22300264,"NOV 29, 2023",SAC vs. LAC,L,26,3,7,0.429,1,5,0.2,0,0,0.0,1,4,5,5,0,0,2,3,7,3,1,SAC,SAC,LAC,117,15.5,Pts+Rebs,17,12,12,10
Kevin Huerter,G,22023,1628989,22300264,"NOV 29, 2023",SAC vs. LAC,L,26,3,7,0.429,1,5,0.2,0,0,0.0,1,4,5,5,0,0,2,3,7,3,1,SAC,SAC,LAC,117,14.5,Pts+Asts,17,12,12,10
Kevin Huerter,G,22023,1628989,22300060,"NOV 28, 2023",SAC vs. GSW,W,33,8,14,0.571,4,7,0.571,1,2,0.5,3,6,9,5,0,0,1,5,21,2,1,SAC,SAC,GSW,124,11.5,Points,35,30,26,14
Kevin Huerter,G,22023,1628989,22300060,"NOV 28, 2023",SAC vs. GSW,W,33,8,14,0.571,4,7,0.571,1,2,0.5,3,6,9,5,0,0,1,5,21,2,1,SAC,SAC,GSW,124,4.0,Rebounds,35,30,26,14
Kevin Huerter,G,22023,1628989,22300060,"NOV 28, 2023",SAC vs. GSW,W,33,8,14,0.571,4,7,0.571,1,2,0.5,3,6,9,5,0,0,1,5,21,2,1,SAC,SAC,GSW,124,18.5,Pts+Rebs+Asts,35,30,26,14
Kevin Huerter,G,22023,1628989,22300060,"NOV 28, 2023",SAC vs. GSW,W,33,8,14,0.571,4,7,0.571,1,2,0.5,3,6,9,5,0,0,1,5,21,2,1,SAC,SAC,GSW,124,2.5,Assists,35,30,26,14
Kevin Huerter,G,22023,1628989,22300060,"NOV 28, 2023",SAC vs. GSW,W,33,8,14,0.571,4,7,0.571,1,2,0.5,3,6,9,5,0,0,1,5,21,2,1,SAC,SAC,GSW,124,6.0,3-PT Attempted,35,30,26,14
Kevin Huerter,G,22023,1628989,22300060,"NOV 28, 2023",SAC vs. GSW,W,33,8,14,0.571,4,7,0.571,1,2,0.5,3,6,9,5,0,0,1,5,21,2,1,SAC,SAC,GSW,124,15.5,Pts+Rebs,35,30,26,14
Kevin Huerter,G,22023,1628989,22300060,"NOV 28, 2023",SAC vs. GSW,W,33,8,14,0.571,4,7,0.571,1,2,0.5,3,6,9,5,0,0,1,5,21,2,1,SAC,SAC,GSW,124,14.5,Pts+Asts,35,30,26,14
Kevin Huerter,G,22023,1628989,22300050,"NOV 24, 2023",SAC @ MIN,W,24,4,8,0.5,2,5,0.4,0,0,0.0,1,1,2,3,0,1,0,1,10,17,1,SAC,MIN,SAC,124,11.5,Points,15,12,13,5
Kevin Huerter,G,22023,1628989,22300050,"NOV 24, 2023",SAC @ MIN,W,24,4,8,0.5,2,5,0.4,0,0,0.0,1,1,2,3,0,1,0,1,10,17,1,SAC,MIN,SAC,124,4.0,Rebounds,15,12,13,5
Kevin Huerter,G,22023,1628989,22300050,"NOV 24, 2023",SAC @ MIN,W,24,4,8,0.5,2,5,0.4,0,0,0.0,1,1,2,3,0,1,0,1,10,17,1,SAC,MIN,SAC,124,18.5,Pts+Rebs+Asts,15,12,13,5
Kevin Huerter,G,22023,1628989,22300050,"NOV 24, 2023",SAC @ MIN,W,24,4,8,0.5,2,5,0.4,0,0,0.0,1,1,2,3,0,1,0,1,10,17,1,SAC,MIN,SAC,124,2.5,Assists,15,12,13,5
Kevin Huerter,G,22023,1628989,22300050,"NOV 24, 2023",SAC @ MIN,W,24,4,8,0.5,2,5,0.4,0,0,0.0,1,1,2,3,0,1,0,1,10,17,1,SAC,MIN,SAC,124,6.0,3-PT Attempted,15,12,13,5
Kevin Huerter,G,22023,1628989,22300050,"NOV 24, 2023",SAC @ MIN,W,24,4,8,0.5,2,5,0.4,0,0,0.0,1,1,2,3,0,1,0,1,10,17,1,SAC,MIN,SAC,124,15.5,Pts+Rebs,15,12,13,5
Kevin Huerter,G,22023,1628989,22300050,"NOV 24, 2023",SAC @ MIN,W,24,4,8,0.5,2,5,0.4,0,0,0.0,1,1,2,3,0,1,0,1,10,17,1,SAC,MIN,SAC,124,14.5,Pts+Asts,15,12,13,5
Kevin Huerter,G,22023,1628989,22300233,"NOV 22, 2023",SAC @ NOP,L,27,2,10,0.2,2,7,0.286,2,2,1.0,0,7,7,2,0,0,0,3,8,-7,1,SAC,NOP,SAC,112,11.5,Points,17,15,10,9
Kevin Huerter,G,22023,1628989,22300233,"NOV 22, 2023",SAC @ NOP,L,27,2,10,0.2,2,7,0.286,2,2,1.0,0,7,7,2,0,0,0,3,8,-7,1,SAC,NOP,SAC,112,4.0,Rebounds,17,15,10,9
Kevin Huerter,G,22023,1628989,22300233,"NOV 22, 2023",SAC @ NOP,L,27,2,10,0.2,2,7,0.286,2,2,1.0,0,7,7,2,0,0,0,3,8,-7,1,SAC,NOP,SAC,112,18.5,Pts+Rebs+Asts,17,15,10,9
Kevin Huerter,G,22023,1628989,22300233,"NOV 22, 2023",SAC @ NOP,L,27,2,10,0.2,2,7,0.286,2,2,1.0,0,7,7,2,0,0,0,3,8,-7,1,SAC,NOP,SAC,112,2.5,Assists,17,15,10,9
Kevin Huerter,G,22023,1628989,22300233,"NOV 22, 2023",SAC @ NOP,L,27,2,10,0.2,2,7,0.286,2,2,1.0,0,7,7,2,0,0,0,3,8,-7,1,SAC,NOP,SAC,112,6.0,3-PT Attempted,17,15,10,9
Kevin Huerter,G,22023,1628989,22300233,"NOV 22, 2023",SAC @ NOP,L,27,2,10,0.2,2,7,0.286,2,2,1.0,0,7,7,2,0,0,0,3,8,-7,1,SAC,NOP,SAC,112,15.5,Pts+Rebs,17,15,10,9
Kevin Huerter,G,22023,1628989,22300233,"NOV 22, 2023",SAC @ NOP,L,27,2,10,0.2,2,7,0.286,2,2,1.0,0,7,7,2,0,0,0,3,8,-7,1,SAC,NOP,SAC,112,14.5,Pts+Asts,17,15,10,9
Kevin Huerter,G,22023,1628989,22300222,"NOV 20, 2023",SAC @ NOP,L,23,4,10,0.4,2,8,0.25,0,0,0.0,0,0,0,3,0,0,0,1,10,-25,1,SAC,NOP,SAC,93,11.5,Points,13,10,13,3
Kevin Huerter,G,22023,1628989,22300222,"NOV 20, 2023",SAC @ NOP,L,23,4,10,0.4,2,8,0.25,0,0,0.0,0,0,0,3,0,0,0,1,10,-25,1,SAC,NOP,SAC,93,4.0,Rebounds,13,10,13,3
Kevin Huerter,G,22023,1628989,22300222,"NOV 20, 2023",SAC @ NOP,L,23,4,10,0.4,2,8,0.25,0,0,0.0,0,0,0,3,0,0,0,1,10,-25,1,SAC,NOP,SAC,93,18.5,Pts+Rebs+Asts,13,10,13,3
Kevin Huerter,G,22023,1628989,22300222,"NOV 20, 2023",SAC @ NOP,L,23,4,10,0.4,2,8,0.25,0,0,0.0,0,0,0,3,0,0,0,1,10,-25,1,SAC,NOP,SAC,93,2.5,Assists,13,10,13,3
Kevin Huerter,G,22023,1628989,22300222,"NOV 20, 2023",SAC @ NOP,L,23,4,10,0.4,2,8,0.25,0,0,0.0,0,0,0,3,0,0,0,1,10,-25,1,SAC,NOP,SAC,93,6.0,3-PT Attempted,13,10,13,3
Kevin Huerter,G,22023,1628989,22300222,"NOV 20, 2023",SAC @ NOP,L,23,4,10,0.4,2,8,0.25,0,0,0.0,0,0,0,3,0,0,0,1,10,-25,1,SAC,NOP,SAC,93,15.5,Pts+Rebs,13,10,13,3
Kevin Huerter,G,22023,1628989,22300222,"NOV 20, 2023",SAC @ NOP,L,23,4,10,0.4,2,8,0.25,0,0,0.0,0,0,0,3,0,0,0,1,10,-25,1,SAC,NOP,SAC,93,14.5,Pts+Asts,13,10,13,3
Kevin Huerter,G,22023,1628989,22300032,"NOV 17, 2023",SAC @ SAS,W,25,4,9,0.444,1,4,0.25,0,0,0.0,0,1,1,2,3,0,0,2,9,-1,1,SAC,SAS,SAC,129,11.5,Points,12,10,11,3
Kevin Huerter,G,22023,1628989,22300032,"NOV 17, 2023",SAC @ SAS,W,25,4,9,0.444,1,4,0.25,0,0,0.0,0,1,1,2,3,0,0,2,9,-1,1,SAC,SAS,SAC,129,4.0,Rebounds,12,10,11,3
Kevin Huerter,G,22023,1628989,22300032,"NOV 17, 2023",SAC @ SAS,W,25,4,9,0.444,1,4,0.25,0,0,0.0,0,1,1,2,3,0,0,2,9,-1,1,SAC,SAS,SAC,129,18.5,Pts+Rebs+Asts,12,10,11,3
Kevin Huerter,G,22023,1628989,22300032,"NOV 17, 2023",SAC @ SAS,W,25,4,9,0.444,1,4,0.25,0,0,0.0,0,1,1,2,3,0,0,2,9,-1,1,SAC,SAS,SAC,129,2.5,Assists,12,10,11,3
Kevin Huerter,G,22023,1628989,22300032,"NOV 17, 2023",SAC @ SAS,W,25,4,9,0.444,1,4,0.25,0,0,0.0,0,1,1,2,3,0,0,2,9,-1,1,SAC,SAS,SAC,129,6.0,3-PT Attempted,12,10,11,3
Kevin Huerter,G,22023,1628989,22300032,"NOV 17, 2023",SAC @ SAS,W,25,4,9,0.444,1,4,0.25,0,0,0.0,0,1,1,2,3,0,0,2,9,-1,1,SAC,SAS,SAC,129,15.5,Pts+Rebs,12,10,11,3
Kevin Huerter,G,22023,1628989,22300032,"NOV 17, 2023",SAC @ SAS,W,25,4,9,0.444,1,4,0.25,0,0,0.0,0,1,1,2,3,0,0,2,9,-1,1,SAC,SAS,SAC,129,14.5,Pts+Asts,12,10,11,3
Kevin Huerter,G,22023,1628989,22300198,"NOV 15, 2023",SAC @ LAL,W,38,10,16,0.625,6,11,0.545,2,2,1.0,0,4,4,7,2,0,0,2,28,21,1,SAC,LAL,SAC,125,11.5,Points,39,32,35,11
Kevin Huerter,G,22023,1628989,22300198,"NOV 15, 2023",SAC @ LAL,W,38,10,16,0.625,6,11,0.545,2,2,1.0,0,4,4,7,2,0,0,2,28,21,1,SAC,LAL,SAC,125,4.0,Rebounds,39,32,35,11
Kevin Huerter,G,22023,1628989,22300198,"NOV 15, 2023",SAC @ LAL,W,38,10,16,0.625,6,11,0.545,2,2,1.0,0,4,4,7,2,0,0,2,28,21,1,SAC,LAL,SAC,125,18.5,Pts+Rebs+Asts,39,32,35,11
Kevin Huerter,G,22023,1628989,22300198,"NOV 15, 2023",SAC @ LAL,W,38,10,16,0.625,6,11,0.545,2,2,1.0,0,4,4,7,2,0,0,2,28,21,1,SAC,LAL,SAC,125,2.5,Assists,39,32,35,11
Kevin Huerter,G,22023,1628989,22300198,"NOV 15, 2023",SAC @ LAL,W,38,10,16,0.625,6,11,0.545,2,2,1.0,0,4,4,7,2,0,0,2,28,21,1,SAC,LAL,SAC,125,6.0,3-PT Attempted,39,32,35,11
Kevin Huerter,G,22023,1628989,22300198,"NOV 15, 2023",SAC @ LAL,W,38,10,16,0.625,6,11,0.545,2,2,1.0,0,4,4,7,2,0,0,2,28,21,1,SAC,LAL,SAC,125,15.5,Pts+Rebs,39,32,35,11
Kevin Huerter,G,22023,1628989,22300198,"NOV 15, 2023",SAC @ LAL,W,38,10,16,0.625,6,11,0.545,2,2,1.0,0,4,4,7,2,0,0,2,28,21,1,SAC,LAL,SAC,125,14.5,Pts+Asts,39,32,35,11
Kevin Huerter,G,22023,1628989,22300191,"NOV 13, 2023",SAC vs. CLE,W,29,7,11,0.636,6,9,0.667,0,0,0.0,1,1,2,2,0,0,0,4,20,5,1,SAC,SAC,CLE,132,11.5,Points,24,22,22,4
Kevin Huerter,G,22023,1628989,22300191,"NOV 13, 2023",SAC vs. CLE,W,29,7,11,0.636,6,9,0.667,0,0,0.0,1,1,2,2,0,0,0,4,20,5,1,SAC,SAC,CLE,132,4.0,Rebounds,24,22,22,4
Kevin Huerter,G,22023,1628989,22300191,"NOV 13, 2023",SAC vs. CLE,W,29,7,11,0.636,6,9,0.667,0,0,0.0,1,1,2,2,0,0,0,4,20,5,1,SAC,SAC,CLE,132,18.5,Pts+Rebs+Asts,24,22,22,4
Kevin Huerter,G,22023,1628989,22300191,"NOV 13, 2023",SAC vs. CLE,W,29,7,11,0.636,6,9,0.667,0,0,0.0,1,1,2,2,0,0,0,4,20,5,1,SAC,SAC,CLE,132,2.5,Assists,24,22,22,4
Kevin Huerter,G,22023,1628989,22300191,"NOV 13, 2023",SAC vs. CLE,W,29,7,11,0.636,6,9,0.667,0,0,0.0,1,1,2,2,0,0,0,4,20,5,1,SAC,SAC,CLE,132,6.0,3-PT Attempted,24,22,22,4
Kevin Huerter,G,22023,1628989,22300191,"NOV 13, 2023",SAC vs. CLE,W,29,7,11,0.636,6,9,0.667,0,0,0.0,1,1,2,2,0,0,0,4,20,5,1,SAC,SAC,CLE,132,15.5,Pts+Rebs,24,22,22,4
Kevin Huerter,G,22023,1628989,22300191,"NOV 13, 2023",SAC vs. CLE,W,29,7,11,0.636,6,9,0.667,0,0,0.0,1,1,2,2,0,0,0,4,20,5,1,SAC,SAC,CLE,132,14.5,Pts+Asts,24,22,22,4
Kevin Huerter,G,22023,1628989,22300016,"NOV 10, 2023",SAC vs. OKC,W,34,11,19,0.579,4,10,0.4,2,2,1.0,0,9,9,2,3,1,2,4,28,8,1,SAC,SAC,OKC,105,11.5,Points,39,37,30,11
Kevin Huerter,G,22023,1628989,22300016,"NOV 10, 2023",SAC vs. OKC,W,34,11,19,0.579,4,10,0.4,2,2,1.0,0,9,9,2,3,1,2,4,28,8,1,SAC,SAC,OKC,105,4.0,Rebounds,39,37,30,11
Kevin Huerter,G,22023,1628989,22300016,"NOV 10, 2023",SAC vs. OKC,W,34,11,19,0.579,4,10,0.4,2,2,1.0,0,9,9,2,3,1,2,4,28,8,1,SAC,SAC,OKC,105,18.5,Pts+Rebs+Asts,39,37,30,11
Kevin Huerter,G,22023,1628989,22300016,"NOV 10, 2023",SAC vs. OKC,W,34,11,19,0.579,4,10,0.4,2,2,1.0,0,9,9,2,3,1,2,4,28,8,1,SAC,SAC,OKC,105,2.5,Assists,39,37,30,11
Kevin Huerter,G,22023,1628989,22300016,"NOV 10, 2023",SAC vs. OKC,W,34,11,19,0.579,4,10,0.4,2,2,1.0,0,9,9,2,3,1,2,4,28,8,1,SAC,SAC,OKC,105,6.0,3-PT Attempted,39,37,30,11
Kevin Huerter,G,22023,1628989,22300016,"NOV 10, 2023",SAC vs. OKC,W,34,11,19,0.579,4,10,0.4,2,2,1.0,0,9,9,2,3,1,2,4,28,8,1,SAC,SAC,OKC,105,15.5,Pts+Rebs,39,37,30,11
Kevin Huerter,G,22023,1628989,22300016,"NOV 10, 2023",SAC vs. OKC,W,34,11,19,0.579,4,10,0.4,2,2,1.0,0,9,9,2,3,1,2,4,28,8,1,SAC,SAC,OKC,105,14.5,Pts+Asts,39,37,30,11
Kevin Huerter,G,22023,1628989,22300170,"NOV 08, 2023",SAC vs. POR,W,39,5,13,0.385,4,9,0.444,3,3,1.0,0,5,5,4,2,0,3,2,17,2,1,SAC,SAC,POR,121,11.5,Points,26,22,21,9
Kevin Huerter,G,22023,1628989,22300170,"NOV 08, 2023",SAC vs. POR,W,39,5,13,0.385,4,9,0.444,3,3,1.0,0,5,5,4,2,0,3,2,17,2,1,SAC,SAC,POR,121,4.0,Rebounds,26,22,21,9
Kevin Huerter,G,22023,1628989,22300170,"NOV 08, 2023",SAC vs. POR,W,39,5,13,0.385,4,9,0.444,3,3,1.0,0,5,5,4,2,0,3,2,17,2,1,SAC,SAC,POR,121,18.5,Pts+Rebs+Asts,26,22,21,9
Kevin Huerter,G,22023,1628989,22300170,"NOV 08, 2023",SAC vs. POR,W,39,5,13,0.385,4,9,0.444,3,3,1.0,0,5,5,4,2,0,3,2,17,2,1,SAC,SAC,POR,121,2.5,Assists,26,22,21,9
Kevin Huerter,G,22023,1628989,22300170,"NOV 08, 2023",SAC vs. POR,W,39,5,13,0.385,4,9,0.444,3,3,1.0,0,5,5,4,2,0,3,2,17,2,1,SAC,SAC,POR,121,6.0,3-PT Attempted,26,22,21,9
Kevin Huerter,G,22023,1628989,22300170,"NOV 08, 2023",SAC vs. POR,W,39,5,13,0.385,4,9,0.444,3,3,1.0,0,5,5,4,2,0,3,2,17,2,1,SAC,SAC,POR,121,15.5,Pts+Rebs,26,22,21,9
Kevin Huerter,G,22023,1628989,22300170,"NOV 08, 2023",SAC vs. POR,W,39,5,13,0.385,4,9,0.444,3,3,1.0,0,5,5,4,2,0,3,2,17,2,1,SAC,SAC,POR,121,14.5,Pts+Asts,26,22,21,9
Kevin Huerter,G,22023,1628989,22300153,"NOV 06, 2023",SAC @ HOU,L,25,5,10,0.5,3,8,0.375,0,1,0.0,0,3,3,2,1,0,3,0,13,-26,1,SAC,HOU,SAC,97,11.5,Points,18,16,15,5
Kevin Huerter,G,22023,1628989,22300153,"NOV 06, 2023",SAC @ HOU,L,25,5,10,0.5,3,8,0.375,0,1,0.0,0,3,3,2,1,0,3,0,13,-26,1,SAC,HOU,SAC,97,4.0,Rebounds,18,16,15,5
Kevin Huerter,G,22023,1628989,22300153,"NOV 06, 2023",SAC @ HOU,L,25,5,10,0.5,3,8,0.375,0,1,0.0,0,3,3,2,1,0,3,0,13,-26,1,SAC,HOU,SAC,97,18.5,Pts+Rebs+Asts,18,16,15,5
Kevin Huerter,G,22023,1628989,22300153,"NOV 06, 2023",SAC @ HOU,L,25,5,10,0.5,3,8,0.375,0,1,0.0,0,3,3,2,1,0,3,0,13,-26,1,SAC,HOU,SAC,97,2.5,Assists,18,16,15,5
Kevin Huerter,G,22023,1628989,22300153,"NOV 06, 2023",SAC @ HOU,L,25,5,10,0.5,3,8,0.375,0,1,0.0,0,3,3,2,1,0,3,0,13,-26,1,SAC,HOU,SAC,97,6.0,3-PT Attempted,18,16,15,5
Kevin Huerter,G,22023,1628989,22300153,"NOV 06, 2023",SAC @ HOU,L,25,5,10,0.5,3,8,0.375,0,1,0.0,0,3,3,2,1,0,3,0,13,-26,1,SAC,HOU,SAC,97,15.5,Pts+Rebs,18,16,15,5
Kevin Huerter,G,22023,1628989,22300153,"NOV 06, 2023",SAC @ HOU,L,25,5,10,0.5,3,8,0.375,0,1,0.0,0,3,3,2,1,0,3,0,13,-26,1,SAC,HOU,SAC,97,14.5,Pts+Asts,18,16,15,5
Kevin Huerter,G,22023,1628989,22300137,"NOV 04, 2023",SAC @ HOU,L,16,2,8,0.25,0,3,0.0,0,0,0.0,2,2,4,2,1,0,1,3,4,-13,1,SAC,HOU,SAC,89,11.5,Points,10,8,6,6
Kevin Huerter,G,22023,1628989,22300137,"NOV 04, 2023",SAC @ HOU,L,16,2,8,0.25,0,3,0.0,0,0,0.0,2,2,4,2,1,0,1,3,4,-13,1,SAC,HOU,SAC,89,4.0,Rebounds,10,8,6,6
Kevin Huerter,G,22023,1628989,22300137,"NOV 04, 2023",SAC @ HOU,L,16,2,8,0.25,0,3,0.0,0,0,0.0,2,2,4,2,1,0,1,3,4,-13,1,SAC,HOU,SAC,89,18.5,Pts+Rebs+Asts,10,8,6,6
Kevin Huerter,G,22023,1628989,22300137,"NOV 04, 2023",SAC @ HOU,L,16,2,8,0.25,0,3,0.0,0,0,0.0,2,2,4,2,1,0,1,3,4,-13,1,SAC,HOU,SAC,89,2.5,Assists,10,8,6,6
Kevin Huerter,G,22023,1628989,22300137,"NOV 04, 2023",SAC @ HOU,L,16,2,8,0.25,0,3,0.0,0,0,0.0,2,2,4,2,1,0,1,3,4,-13,1,SAC,HOU,SAC,89,6.0,3-PT Attempted,10,8,6,6
Kevin Huerter,G,22023,1628989,22300137,"NOV 04, 2023",SAC @ HOU,L,16,2,8,0.25,0,3,0.0,0,0,0.0,2,2,4,2,1,0,1,3,4,-13,1,SAC,HOU,SAC,89,15.5,Pts+Rebs,10,8,6,6
Kevin Huerter,G,22023,1628989,22300137,"NOV 04, 2023",SAC @ HOU,L,16,2,8,0.25,0,3,0.0,0,0,0.0,2,2,4,2,1,0,1,3,4,-13,1,SAC,HOU,SAC,89,14.5,Pts+Asts,10,8,6,6
Kevin Huerter,G,22023,1628989,22300126,"NOV 01, 2023",SAC @ GSW,L,27,4,11,0.364,1,5,0.2,2,2,1.0,2,7,9,3,1,0,1,3,11,2,1,SAC,GSW,SAC,101,11.5,Points,23,20,14,12
Kevin Huerter,G,22023,1628989,22300126,"NOV 01, 2023",SAC @ GSW,L,27,4,11,0.364,1,5,0.2,2,2,1.0,2,7,9,3,1,0,1,3,11,2,1,SAC,GSW,SAC,101,4.0,Rebounds,23,20,14,12
Kevin Huerter,G,22023,1628989,22300126,"NOV 01, 2023",SAC @ GSW,L,27,4,11,0.364,1,5,0.2,2,2,1.0,2,7,9,3,1,0,1,3,11,2,1,SAC,GSW,SAC,101,18.5,Pts+Rebs+Asts,23,20,14,12
Kevin Huerter,G,22023,1628989,22300126,"NOV 01, 2023",SAC @ GSW,L,27,4,11,0.364,1,5,0.2,2,2,1.0,2,7,9,3,1,0,1,3,11,2,1,SAC,GSW,SAC,101,2.5,Assists,23,20,14,12
Kevin Huerter,G,22023,1628989,22300126,"NOV 01, 2023",SAC @ GSW,L,27,4,11,0.364,1,5,0.2,2,2,1.0,2,7,9,3,1,0,1,3,11,2,1,SAC,GSW,SAC,101,6.0,3-PT Attempted,23,20,14,12
Kevin Huerter,G,22023,1628989,22300126,"NOV 01, 2023",SAC @ GSW,L,27,4,11,0.364,1,5,0.2,2,2,1.0,2,7,9,3,1,0,1,3,11,2,1,SAC,GSW,SAC,101,15.5,Pts+Rebs,23,20,14,12
Kevin Huerter,G,22023,1628989,22300126,"NOV 01, 2023",SAC @ GSW,L,27,4,11,0.364,1,5,0.2,2,2,1.0,2,7,9,3,1,0,1,3,11,2,1,SAC,GSW,SAC,101,14.5,Pts+Asts,23,20,14,12
Kevin Huerter,G,22023,1628989,22300100,"OCT 29, 2023",SAC vs. LAL,W,37,4,12,0.333,3,7,0.429,1,2,0.5,0,7,7,4,0,2,0,3,12,11,1,SAC,SAC,LAL,132,11.5,Points,23,19,16,11
Kevin Huerter,G,22023,1628989,22300100,"OCT 29, 2023",SAC vs. LAL,W,37,4,12,0.333,3,7,0.429,1,2,0.5,0,7,7,4,0,2,0,3,12,11,1,SAC,SAC,LAL,132,4.0,Rebounds,23,19,16,11
Kevin Huerter,G,22023,1628989,22300100,"OCT 29, 2023",SAC vs. LAL,W,37,4,12,0.333,3,7,0.429,1,2,0.5,0,7,7,4,0,2,0,3,12,11,1,SAC,SAC,LAL,132,18.5,Pts+Rebs+Asts,23,19,16,11
Kevin Huerter,G,22023,1628989,22300100,"OCT 29, 2023",SAC vs. LAL,W,37,4,12,0.333,3,7,0.429,1,2,0.5,0,7,7,4,0,2,0,3,12,11,1,SAC,SAC,LAL,132,2.5,Assists,23,19,16,11
Kevin Huerter,G,22023,1628989,22300100,"OCT 29, 2023",SAC vs. LAL,W,37,4,12,0.333,3,7,0.429,1,2,0.5,0,7,7,4,0,2,0,3,12,11,1,SAC,SAC,LAL,132,6.0,3-PT Attempted,23,19,16,11
Kevin Huerter,G,22023,1628989,22300100,"OCT 29, 2023",SAC vs. LAL,W,37,4,12,0.333,3,7,0.429,1,2,0.5,0,7,7,4,0,2,0,3,12,11,1,SAC,SAC,LAL,132,15.5,Pts+Rebs,23,19,16,11
Kevin Huerter,G,22023,1628989,22300100,"OCT 29, 2023",SAC vs. LAL,W,37,4,12,0.333,3,7,0.429,1,2,0.5,0,7,7,4,0,2,0,3,12,11,1,SAC,SAC,LAL,132,14.5,Pts+Asts,23,19,16,11
Kevin Huerter,G,22023,1628989,22300087,"OCT 27, 2023",SAC vs. GSW,L,16,0,5,0.0,0,5,0.0,0,0,0.0,0,2,2,2,0,1,0,0,0,-2,1,SAC,SAC,GSW,114,11.5,Points,4,2,2,4
Kevin Huerter,G,22023,1628989,22300087,"OCT 27, 2023",SAC vs. GSW,L,16,0,5,0.0,0,5,0.0,0,0,0.0,0,2,2,2,0,1,0,0,0,-2,1,SAC,SAC,GSW,114,4.0,Rebounds,4,2,2,4
Kevin Huerter,G,22023,1628989,22300087,"OCT 27, 2023",SAC vs. GSW,L,16,0,5,0.0,0,5,0.0,0,0,0.0,0,2,2,2,0,1,0,0,0,-2,1,SAC,SAC,GSW,114,18.5,Pts+Rebs+Asts,4,2,2,4
Kevin Huerter,G,22023,1628989,22300087,"OCT 27, 2023",SAC vs. GSW,L,16,0,5,0.0,0,5,0.0,0,0,0.0,0,2,2,2,0,1,0,0,0,-2,1,SAC,SAC,GSW,114,2.5,Assists,4,2,2,4
Kevin Huerter,G,22023,1628989,22300087,"OCT 27, 2023",SAC vs. GSW,L,16,0,5,0.0,0,5,0.0,0,0,0.0,0,2,2,2,0,1,0,0,0,-2,1,SAC,SAC,GSW,114,6.0,3-PT Attempted,4,2,2,4
Kevin Huerter,G,22023,1628989,22300087,"OCT 27, 2023",SAC vs. GSW,L,16,0,5,0.0,0,5,0.0,0,0,0.0,0,2,2,2,0,1,0,0,0,-2,1,SAC,SAC,GSW,114,15.5,Pts+Rebs,4,2,2,4
Kevin Huerter,G,22023,1628989,22300087,"OCT 27, 2023",SAC vs. GSW,L,16,0,5,0.0,0,5,0.0,0,0,0.0,0,2,2,2,0,1,0,0,0,-2,1,SAC,SAC,GSW,114,14.5,Pts+Asts,4,2,2,4
Kevin Huerter,G,22023,1628989,22300072,"OCT 25, 2023",SAC @ UTA,W,24,3,9,0.333,1,5,0.2,0,0,0.0,2,3,5,2,0,0,1,3,7,6,1,SAC,UTA,SAC,130,11.5,Points,14,12,9,7
Kevin Huerter,G,22023,1628989,22300072,"OCT 25, 2023",SAC @ UTA,W,24,3,9,0.333,1,5,0.2,0,0,0.0,2,3,5,2,0,0,1,3,7,6,1,SAC,UTA,SAC,130,4.0,Rebounds,14,12,9,7
Kevin Huerter,G,22023,1628989,22300072,"OCT 25, 2023",SAC @ UTA,W,24,3,9,0.333,1,5,0.2,0,0,0.0,2,3,5,2,0,0,1,3,7,6,1,SAC,UTA,SAC,130,18.5,Pts+Rebs+Asts,14,12,9,7
Kevin Huerter,G,22023,1628989,22300072,"OCT 25, 2023",SAC @ UTA,W,24,3,9,0.333,1,5,0.2,0,0,0.0,2,3,5,2,0,0,1,3,7,6,1,SAC,UTA,SAC,130,2.5,Assists,14,12,9,7
Kevin Huerter,G,22023,1628989,22300072,"OCT 25, 2023",SAC @ UTA,W,24,3,9,0.333,1,5,0.2,0,0,0.0,2,3,5,2,0,0,1,3,7,6,1,SAC,UTA,SAC,130,6.0,3-PT Attempted,14,12,9,7
Kevin Huerter,G,22023,1628989,22300072,"OCT 25, 2023",SAC @ UTA,W,24,3,9,0.333,1,5,0.2,0,0,0.0,2,3,5,2,0,0,1,3,7,6,1,SAC,UTA,SAC,130,15.5,Pts+Rebs,14,12,9,7
Kevin Huerter,G,22023,1628989,22300072,"OCT 25, 2023",SAC @ UTA,W,24,3,9,0.333,1,5,0.2,0,0,0.0,2,3,5,2,0,0,1,3,7,6,1,SAC,UTA,SAC,130,14.5,Pts+Asts,14,12,9,7
Jaden McDaniels,F,22023,1630183,22300738,"FEB 08, 2024",MIN @ MIL,W,19,3,5,0.6,2,4,0.5,0,0,0.0,0,3,3,0,0,2,1,3,8,16,1,MIN,MIL,MIN,129,,,11,11,8,3
Jaden McDaniels,F,22023,1630183,22300723,"FEB 06, 2024",MIN @ CHI,L,40,6,11,0.545,1,3,0.333,0,0,0.0,1,0,1,3,1,0,4,4,13,1,1,MIN,CHI,MIN,123,,,17,14,16,4
Jaden McDaniels,F,22023,1630183,22300709,"FEB 04, 2024",MIN vs. HOU,W,29,2,7,0.286,1,3,0.333,0,0,0.0,2,2,4,2,0,1,2,1,5,27,1,MIN,MIN,HOU,111,,,11,9,7,6
Jaden McDaniels,F,22023,1630183,22300694,"FEB 02, 2024",MIN vs. ORL,L,32,4,10,0.4,2,6,0.333,0,0,0.0,2,2,4,1,1,0,3,5,10,-12,1,MIN,MIN,ORL,106,,,15,14,11,5
Jaden McDaniels,F,22023,1630183,22300680,"JAN 31, 2024",MIN vs. DAL,W,24,5,10,0.5,0,4,0.0,1,1,1.0,1,1,2,4,0,0,1,4,11,12,1,MIN,MIN,DAL,121,,,17,13,15,6
Jaden McDaniels,F,22023,1630183,22300664,"JAN 29, 2024",MIN @ OKC,W,31,6,11,0.545,2,5,0.4,0,0,0.0,3,0,3,1,1,0,0,5,14,10,1,MIN,OKC,MIN,107,,,18,17,15,4
Jaden McDaniels,F,22023,1630183,22300649,"JAN 27, 2024",MIN @ SAS,L,33,2,5,0.4,1,3,0.333,2,2,1.0,0,3,3,2,4,0,0,2,7,11,1,MIN,SAS,MIN,112,,,12,10,9,5
Jaden McDaniels,F,22023,1630183,22300629,"JAN 25, 2024",MIN @ BKN,W,33,4,6,0.667,1,1,1.0,0,0,0.0,1,3,4,1,0,0,0,2,9,2,1,MIN,BKN,MIN,96,,,14,13,10,5
Jaden McDaniels,F,22023,1630183,22300620,"JAN 24, 2024",MIN @ WAS,W,30,5,11,0.455,1,4,0.25,2,2,1.0,2,3,5,0,2,0,1,4,13,10,1,MIN,WAS,MIN,118,,,18,18,13,5
Jaden McDaniels,F,22023,1630183,22300610,"JAN 22, 2024",MIN vs. CHA,L,35,3,9,0.333,2,7,0.286,1,2,0.5,0,5,5,4,1,0,1,2,9,-4,1,MIN,MIN,CHA,125,,,18,14,13,9
Jaden McDaniels,F,22023,1630183,22300599,"JAN 20, 2024",MIN vs. OKC,L,27,6,11,0.545,3,5,0.6,0,1,0.0,1,1,2,0,0,0,2,4,15,-12,1,MIN,MIN,OKC,97,,,17,17,15,2
Jaden McDaniels,F,22023,1630183,22300582,"JAN 18, 2024",MIN vs. MEM,W,36,5,9,0.556,1,2,0.5,0,0,0.0,1,2,3,0,1,1,2,0,11,5,1,MIN,MIN,MEM,118,,,14,14,11,3
Jaden McDaniels,F,22023,1630183,22300569,"JAN 17, 2024",MIN @ DET,W,30,8,11,0.727,3,4,0.75,4,4,1.0,2,1,3,0,1,0,1,0,23,4,1,MIN,DET,MIN,124,,,26,26,23,3
Jaden McDaniels,F,22023,1630183,22300553,"JAN 14, 2024",MIN vs. LAC,W,35,6,10,0.6,2,3,0.667,0,0,0.0,1,3,4,4,2,0,4,2,14,4,1,MIN,MIN,LAC,109,,,22,18,18,8
Jaden McDaniels,F,22023,1630183,22300538,"JAN 12, 2024",MIN vs. POR,W,24,4,8,0.5,1,3,0.333,0,0,0.0,0,2,2,3,2,0,4,1,9,36,1,MIN,MIN,POR,116,,,14,11,12,5
Jaden McDaniels,F,22023,1630183,22300517,"JAN 10, 2024",MIN @ BOS,L,24,2,8,0.25,1,4,0.25,0,0,0.0,0,1,1,1,0,0,1,6,5,-12,1,MIN,BOS,MIN,120,,,7,6,6,2
Jaden McDaniels,F,22023,1630183,22300513,"JAN 09, 2024",MIN @ ORL,W,35,6,10,0.6,2,5,0.4,1,1,1.0,0,9,9,1,1,0,2,1,15,35,1,MIN,ORL,MIN,113,,,25,24,16,10
Jaden McDaniels,F,22023,1630183,22300501,"JAN 07, 2024",MIN @ DAL,L,37,1,10,0.1,0,5,0.0,0,0,0.0,1,2,3,4,0,0,0,4,2,-7,1,MIN,DAL,MIN,108,,,9,5,6,7
Jaden McDaniels,F,22023,1630183,22300485,"JAN 05, 2024",MIN @ HOU,W,30,7,10,0.7,2,3,0.667,0,0,0.0,0,3,3,0,1,0,0,1,16,14,1,MIN,HOU,MIN,122,,,19,19,16,3
Jaden McDaniels,F,22023,1630183,22300471,"JAN 03, 2024",MIN vs. NOP,L,33,5,10,0.5,1,3,0.333,0,0,0.0,0,0,0,2,2,1,1,3,11,-19,1,MIN,MIN,NOP,106,,,13,11,13,2
Jaden McDaniels,F,22023,1630183,22300451,"JAN 01, 2024",MIN @ NYK,L,33,2,8,0.25,1,5,0.2,3,4,0.75,1,0,1,0,1,1,1,4,8,-9,1,MIN,NYK,MIN,106,,,9,9,8,1
Jaden McDaniels,F,22023,1630183,22300443,"DEC 30, 2023",MIN vs. LAL,W,26,2,6,0.333,0,1,0.0,2,2,1.0,0,3,3,2,1,1,1,6,6,-3,1,MIN,MIN,LAL,108,,,11,9,8,5
Jaden McDaniels,F,22023,1630183,22300423,"DEC 28, 2023",MIN vs. DAL,W,34,5,8,0.625,2,3,0.667,0,1,0.0,0,0,0,0,1,4,2,3,12,4,1,MIN,MIN,DAL,118,,,12,12,12,0
Jaden McDaniels,F,22023,1630183,22300411,"DEC 26, 2023",MIN @ OKC,L,27,3,10,0.3,0,3,0.0,2,2,1.0,1,0,1,1,1,1,2,5,8,-16,1,MIN,OKC,MIN,106,,,10,9,9,2
Jaden McDaniels,F,22023,1630183,22300400,"DEC 23, 2023",MIN @ SAC,W,41,8,16,0.5,3,9,0.333,1,2,0.5,0,5,5,1,4,1,0,4,20,12,1,MIN,SAC,MIN,110,,,26,25,21,6
Jaden McDaniels,F,22023,1630183,22300380,"DEC 21, 2023",MIN vs. LAL,W,36,5,8,0.625,2,4,0.5,2,2,1.0,0,1,1,3,1,0,1,2,14,-3,1,MIN,MIN,LAL,118,,,18,15,17,4
Jaden McDaniels,F,22023,1630183,22300367,"DEC 20, 2023",MIN @ PHI,L,38,8,12,0.667,2,3,0.667,3,5,0.6,1,2,3,0,1,0,0,3,21,-3,1,MIN,PHI,MIN,113,,,24,24,21,3
Jaden McDaniels,F,22023,1630183,22300353,"DEC 18, 2023",MIN @ MIA,W,30,5,10,0.5,0,0,0.0,0,0,0.0,3,2,5,2,0,3,3,6,10,1,1,MIN,MIA,MIN,112,,,17,15,12,7
Jaden McDaniels,F,22023,1630183,22300338,"DEC 16, 2023",MIN vs. IND,W,18,2,4,0.5,1,1,1.0,0,0,0.0,0,1,1,0,1,0,1,2,5,8,1,MIN,MIN,IND,127,,,6,6,5,1
Jaden McDaniels,F,22023,1630183,22300321,"DEC 14, 2023",MIN @ DAL,W,24,5,9,0.556,0,2,0.0,1,1,1.0,1,1,2,1,0,1,0,3,11,7,1,MIN,DAL,MIN,119,,,14,13,12,3
Jaden McDaniels,F,22023,1630183,22300301,"DEC 11, 2023",MIN @ NOP,L,27,5,12,0.417,2,6,0.333,0,1,0.0,0,3,3,0,0,0,1,4,12,-3,1,MIN,NOP,MIN,107,,,15,15,12,3
Jaden McDaniels,F,22023,1630183,22300221,"NOV 20, 2023",MIN vs. NYK,W,5,2,2,1.0,0,0,0.0,0,0,0.0,0,1,1,0,0,0,1,0,4,1,1,MIN,MIN,NYK,117,,,5,5,4,1
Jaden McDaniels,F,22023,1630183,22300203,"NOV 18, 2023",MIN @ NOP,W,34,5,7,0.714,1,2,0.5,1,1,1.0,0,2,2,1,0,0,2,3,12,8,1,MIN,NOP,MIN,121,,,15,14,13,3
Jaden McDaniels,F,22023,1630183,22300197,"NOV 15, 2023",MIN @ PHX,L,23,6,10,0.6,0,3,0.0,1,1,1.0,1,1,2,3,2,0,1,4,13,-5,1,MIN,PHX,MIN,115,,,18,15,16,5
Jaden McDaniels,F,22023,1630183,22300025,"NOV 14, 2023",MIN @ GSW,W,2,0,1,0.0,0,1,0.0,0,0,0.0,0,0,0,0,0,0,0,0,0,2,1,MIN,GSW,MIN,104,,,0,0,0,0
Jaden McDaniels,F,22023,1630183,22300186,"NOV 12, 2023",MIN @ GSW,W,35,6,8,0.75,1,2,0.5,0,0,0.0,0,0,0,1,0,0,0,5,13,8,1,MIN,GSW,MIN,116,,,14,13,14,1
Jaden McDaniels,F,22023,1630183,22300013,"NOV 10, 2023",MIN @ SAS,W,26,5,11,0.455,0,2,0.0,0,0,0.0,2,3,5,0,2,0,0,6,10,-1,1,MIN,SAS,MIN,117,,,15,15,10,5
Jaden McDaniels,F,22023,1630183,22300166,"NOV 08, 2023",MIN vs. NOP,W,26,4,7,0.571,2,5,0.4,0,0,0.0,0,0,0,3,0,0,0,2,10,18,1,MIN,MIN,NOP,122,,,13,10,13,3
Jaden McDaniels,F,22023,1630183,22300154,"NOV 06, 2023",MIN vs. BOS,W,45,8,18,0.444,4,9,0.444,0,0,0.0,1,1,2,1,1,0,3,3,20,-6,1,MIN,MIN,BOS,114,,,23,22,21,3
Jaden McDaniels,F,22023,1630183,22300138,"NOV 04, 2023",MIN vs. UTA,W,20,2,4,0.5,1,2,0.5,0,0,0.0,0,0,0,1,1,1,0,6,5,10,1,MIN,MIN,UTA,123,,,6,5,6,1
Jaden McDaniels,F,22023,1630183,22300123,"NOV 01, 2023",MIN vs. DEN,W,21,3,5,0.6,0,1,0.0,0,0,0.0,3,6,9,2,0,2,4,5,6,19,1,MIN,MIN,DEN,110,,,17,15,8,11
Jaden McDaniels,F,22023,1630183,22300104,"OCT 30, 2023",MIN @ ATL,L,24,5,6,0.833,2,2,1.0,0,0,0.0,0,3,3,2,0,1,0,2,12,-8,1,MIN,ATL,MIN,113,,,17,15,14,5
Herbert Jones,G,22023,1630529,22300758,"FEB 10, 2024",NOP @ POR,W,37,6,7,0.857,2,3,0.667,0,0,0.0,2,2,4,5,3,0,1,2,14,21,1,NOP,POR,NOP,93,,,23,18,19,9
Herbert Jones,G,22023,1630529,22300747,"FEB 09, 2024",NOP @ LAL,L,29,4,8,0.5,3,5,0.6,2,2,1.0,0,0,0,2,2,0,2,4,13,2,1,NOP,LAL,NOP,122,,,15,13,15,2
Herbert Jones,G,22023,1630529,22300731,"FEB 07, 2024",NOP @ LAC,W,30,5,11,0.455,2,3,0.667,1,2,0.5,2,5,7,2,0,0,1,2,13,7,1,NOP,LAC,NOP,117,,,22,20,15,9
Herbert Jones,G,22023,1630529,22300718,"FEB 05, 2024",NOP vs. TOR,W,22,3,7,0.429,1,4,0.25,0,0,0.0,2,0,2,2,1,0,1,1,7,15,1,NOP,NOP,TOR,138,,,11,9,9,4
Herbert Jones,G,22023,1630529,22300648,"JAN 27, 2024",NOP @ MIL,L,20,4,9,0.444,1,4,0.25,0,0,0.0,0,0,0,0,0,1,0,3,9,-14,1,NOP,MIL,NOP,117,,,9,9,9,0
Herbert Jones,G,22023,1630529,22300640,"JAN 26, 2024",NOP vs. OKC,L,29,6,12,0.5,2,7,0.286,0,0,0.0,0,4,4,1,0,1,2,4,14,-17,1,NOP,NOP,OKC,83,,,19,18,15,5
Herbert Jones,G,22023,1630529,22300616,"JAN 23, 2024",NOP vs. UTA,W,26,8,9,0.889,4,4,1.0,2,2,1.0,2,3,5,5,1,1,0,4,22,13,1,NOP,NOP,UTA,153,,,32,27,27,10
Herbert Jones,G,22023,1630529,22300588,"JAN 19, 2024",NOP vs. PHX,L,23,4,9,0.444,1,6,0.167,0,0,0.0,1,2,3,2,0,0,1,1,9,-9,1,NOP,NOP,PHX,109,,,14,12,11,5
Herbert Jones,G,22023,1630529,22300575,"JAN 17, 2024",NOP vs. CHA,W,24,3,5,0.6,2,3,0.667,1,2,0.5,0,1,1,1,2,0,0,0,9,15,1,NOP,NOP,CHA,132,,,11,10,10,2
Herbert Jones,G,22023,1630529,22300547,"JAN 13, 2024",NOP @ DAL,W,32,5,13,0.385,1,3,0.333,4,6,0.667,2,3,5,3,0,2,1,5,15,4,1,NOP,DAL,NOP,118,,,23,20,18,8
Herbert Jones,G,22023,1630529,22300539,"JAN 12, 2024",NOP @ DEN,L,19,3,4,0.75,2,2,1.0,0,0,0.0,0,1,1,1,0,1,1,1,8,-2,1,NOP,DEN,NOP,113,,,10,9,9,2
Herbert Jones,G,22023,1630529,22300486,"JAN 05, 2024",NOP vs. LAC,L,25,3,6,0.5,1,2,0.5,2,2,1.0,0,0,0,2,1,1,0,1,9,-10,1,NOP,NOP,LAC,95,,,11,9,11,2
Herbert Jones,G,22023,1630529,22300471,"JAN 03, 2024",NOP @ MIN,W,37,6,11,0.545,4,5,0.8,0,0,0.0,0,3,3,2,1,1,3,3,16,10,1,NOP,MIN,NOP,117,,,21,19,18,5
Herbert Jones,G,22023,1630529,22300461,"JAN 02, 2024",NOP vs. BKN,W,24,5,10,0.5,2,4,0.5,2,2,1.0,2,2,4,1,2,1,3,1,14,19,1,NOP,NOP,BKN,112,,,19,18,15,5
Herbert Jones,G,22023,1630529,22300446,"DEC 31, 2023",NOP vs. LAL,W,29,5,9,0.556,3,5,0.6,0,0,0.0,3,1,4,1,0,0,0,3,13,8,1,NOP,NOP,LAL,129,,,18,17,14,5
Herbert Jones,G,22023,1630529,22300424,"DEC 28, 2023",NOP vs. UTA,W,29,3,4,0.75,0,1,0.0,0,0,0.0,0,3,3,1,0,1,1,4,6,6,1,NOP,NOP,UTA,112,,,10,9,7,4
Herbert Jones,G,22023,1630529,22300410,"DEC 26, 2023",NOP vs. MEM,L,32,2,8,0.25,0,4,0.0,0,0,0.0,0,3,3,3,1,0,0,1,4,0,1,NOP,NOP,MEM,115,,,10,7,7,6
Herbert Jones,G,22023,1630529,22300392,"DEC 23, 2023",NOP vs. HOU,L,18,2,8,0.25,2,4,0.5,0,0,0.0,3,0,3,1,0,0,0,1,6,-13,1,NOP,NOP,HOU,104,,,10,9,7,4
Herbert Jones,G,22023,1630529,22300375,"DEC 21, 2023",NOP @ CLE,W,30,3,7,0.429,0,1,0.0,1,1,1.0,1,0,1,4,0,1,0,1,7,5,1,NOP,CLE,NOP,123,,,12,8,11,5
Herbert Jones,G,22023,1630529,22300360,"DEC 19, 2023",NOP vs. MEM,L,30,3,10,0.3,1,5,0.2,0,0,0.0,0,1,1,2,0,0,1,3,7,0,1,NOP,NOP,MEM,113,,,10,8,9,3
Herbert Jones,G,22023,1630529,22300345,"DEC 17, 2023",NOP @ SAS,W,19,0,5,0.0,0,3,0.0,2,2,1.0,1,0,1,3,1,0,2,3,2,2,1,NOP,SAS,NOP,146,,,6,3,5,4
Herbert Jones,G,22023,1630529,22300326,"DEC 15, 2023",NOP @ CHA,W,28,3,4,0.75,1,2,0.5,4,6,0.667,1,1,2,1,1,1,0,1,11,2,1,NOP,CHA,NOP,112,,,14,13,12,3
Herbert Jones,G,22023,1630529,22300311,"DEC 13, 2023",NOP @ WAS,W,20,3,9,0.333,0,1,0.0,0,0,0.0,1,1,2,1,2,0,1,3,6,-17,1,NOP,WAS,NOP,142,,,9,8,7,3
Herbert Jones,G,22023,1630529,22300301,"DEC 11, 2023",NOP vs. MIN,W,32,2,7,0.286,1,3,0.333,2,3,0.667,3,7,10,5,0,0,0,4,7,20,1,NOP,NOP,MIN,121,,,22,17,12,15
Herbert Jones,G,22023,1630529,22301230,"DEC 07, 2023",NOP @ LAL,L,26,4,10,0.4,0,3,0.0,2,2,1.0,4,3,7,1,2,1,1,4,10,-22,1,NOP,LAL,NOP,89,,,18,17,11,8
Herbert Jones,G,22023,1630529,22301204,"DEC 04, 2023",NOP @ SAC,W,35,8,13,0.615,3,5,0.6,4,4,1.0,3,2,5,5,0,2,1,5,23,-3,1,NOP,SAC,NOP,127,,,33,28,28,10
Herbert Jones,G,22023,1630529,22300285,"DEC 02, 2023",NOP @ CHI,L,36,4,11,0.364,0,4,0.0,9,10,0.9,4,3,7,4,3,1,2,1,17,5,1,NOP,CHI,NOP,118,,,28,24,21,11
Herbert Jones,G,22023,1630529,22300262,"NOV 29, 2023",NOP vs. PHI,W,33,3,8,0.375,0,3,0.0,1,1,1.0,1,2,3,6,0,0,5,2,7,14,1,NOP,NOP,PHI,124,,,16,10,13,9
Herbert Jones,G,22023,1630529,22300256,"NOV 27, 2023",NOP @ UTA,L,32,4,7,0.571,2,5,0.4,0,0,0.0,0,4,4,0,1,0,3,4,10,-10,1,NOP,UTA,NOP,112,,,14,14,10,4
Herbert Jones,G,22023,1630529,22300243,"NOV 25, 2023",NOP @ UTA,L,26,6,11,0.545,1,4,0.25,0,0,0.0,1,0,1,1,1,1,1,3,13,-18,1,NOP,UTA,NOP,100,,,15,14,14,2
Herbert Jones,G,22023,1630529,22300052,"NOV 24, 2023",NOP @ LAC,W,24,5,7,0.714,3,4,0.75,1,2,0.5,2,2,4,4,1,1,3,5,14,22,1,NOP,LAC,NOP,116,,,22,18,18,8
Herbert Jones,G,22023,1630529,22300233,"NOV 22, 2023",NOP vs. SAC,W,39,1,6,0.167,0,4,0.0,5,6,0.833,0,5,5,3,3,1,2,4,7,-8,1,NOP,NOP,SAC,117,,,15,12,10,8
Herbert Jones,G,22023,1630529,22300222,"NOV 20, 2023",NOP vs. SAC,W,27,7,9,0.778,1,2,0.5,3,4,0.75,1,6,7,4,1,2,1,4,18,39,1,NOP,NOP,SAC,129,,,29,25,22,11
Herbert Jones,G,22023,1630529,22300659,"JAN 29, 2024",NOP @ BOS,L,27,3,4,0.75,3,4,0.75,0,0,0.0,2,1,3,4,0,0,2,4,9,-7,1,NOP,BOS,NOP,112,,,16,12,13,7
Herbert Jones,G,22023,1630529,22300556,"JAN 15, 2024",NOP @ DAL,L,29,4,5,0.8,1,1,1.0,1,1,1.0,1,2,3,3,0,0,0,2,10,-14,1,NOP,DAL,NOP,120,,,16,13,13,6
Herbert Jones,G,22023,1630529,22300525,"JAN 10, 2024",NOP @ GSW,W,23,4,7,0.571,4,7,0.571,0,0,0.0,1,4,5,4,1,2,1,1,12,10,1,NOP,GSW,NOP,141,,,21,17,16,9
Herbert Jones,G,22023,1630529,22300500,"JAN 07, 2024",NOP @ SAC,W,26,3,7,0.429,1,3,0.333,2,2,1.0,1,2,3,2,0,1,1,1,9,34,1,NOP,SAC,NOP,133,,,14,12,11,5
Herbert Jones,G,22023,1630529,22300278,"DEC 01, 2023",NOP vs. SAS,W,31,6,8,0.75,3,4,0.75,2,2,1.0,2,2,4,0,3,1,1,1,17,14,1,NOP,NOP,SAS,121,,,21,21,17,4
Herbert Jones,G,22023,1630529,22300203,"NOV 18, 2023",NOP vs. MIN,L,28,3,7,0.429,3,4,0.75,4,4,1.0,1,3,4,8,2,2,0,6,13,11,1,NOP,NOP,MIN,120,,,25,17,21,12
Herbert Jones,G,22023,1630529,22300034,"NOV 17, 2023",NOP vs. DEN,W,37,3,8,0.375,0,1,0.0,2,2,1.0,0,5,5,4,3,1,1,2,8,-2,1,NOP,NOP,DEN,115,,,17,13,12,9
Herbert Jones,G,22023,1630529,22300022,"NOV 14, 2023",NOP vs. DAL,W,31,6,8,0.75,2,4,0.5,5,6,0.833,1,3,4,4,5,2,2,5,19,8,1,NOP,NOP,DAL,131,,,27,23,23,8
Herbert Jones,G,22023,1630529,22300156,"NOV 06, 2023",NOP @ DEN,L,31,1,3,0.333,0,2,0.0,2,2,1.0,0,2,2,2,2,0,1,2,4,-23,1,NOP,DEN,NOP,116,,,8,6,6,4
Herbert Jones,G,22023,1630529,22300135,"NOV 04, 2023",NOP vs. ATL,L,33,6,13,0.462,1,5,0.2,0,0,0.0,1,1,2,1,3,1,3,1,13,-26,1,NOP,NOP,ATL,105,,,16,15,14,3
Herbert Jones,G,22023,1630529,22300129,"NOV 02, 2023",NOP vs. DET,W,34,6,7,0.857,0,1,0.0,9,9,1.0,0,5,5,3,3,4,0,4,21,10,1,NOP,NOP,DET,125,,,29,26,24,8
Herbert Jones,G,22023,1630529,22300121,"NOV 01, 2023",NOP @ OKC,W,31,2,9,0.222,1,6,0.167,0,0,0.0,0,6,6,1,0,1,1,5,5,10,1,NOP,OKC,NOP,110,,,12,11,6,7
Herbert Jones,G,22023,1630529,22300108,"OCT 30, 2023",NOP vs. GSW,L,22,1,5,0.2,0,4,0.0,2,2,1.0,0,2,2,1,2,1,0,4,4,-22,1,NOP,NOP,GSW,102,,,7,6,5,3
Herbert Jones,G,22023,1630529,22300090,"OCT 28, 2023",NOP vs. NYK,W,28,4,6,0.667,2,2,1.0,0,0,0.0,0,2,2,1,0,3,1,5,10,6,1,NOP,NOP,NYK,96,,,13,12,11,3
Herbert Jones,G,22023,1630529,22300071,"OCT 25, 2023",NOP @ MEM,W,38,4,8,0.5,2,3,0.667,3,5,0.6,3,5,8,3,1,1,3,3,13,2,1,NOP,MEM,NOP,111,,,24,21,16,11
Mike Conley,G,22023,201144,22300738,"FEB 08, 2024",MIN @ MIL,W,31,6,8,0.75,6,7,0.857,0,0,0.0,0,5,5,9,0,0,1,2,18,6,1,MIN,MIL,MIN,129,,,32,23,27,14
Mike Conley,G,22023,201144,22300723,"FEB 06, 2024",MIN @ CHI,L,36,3,7,0.429,3,7,0.429,0,0,0.0,0,0,0,8,0,0,0,2,9,-9,1,MIN,CHI,MIN,123,,,17,9,17,8
Mike Conley,G,22023,201144,22300709,"FEB 04, 2024",MIN vs. HOU,W,24,2,6,0.333,1,2,0.5,3,4,0.75,0,3,3,9,1,0,2,2,8,17,1,MIN,MIN,HOU,111,,,20,11,17,12
Mike Conley,G,22023,201144,22300694,"FEB 02, 2024",MIN vs. ORL,L,28,1,9,0.111,1,6,0.167,1,1,1.0,0,5,5,9,3,0,1,3,4,-13,1,MIN,MIN,ORL,106,,,18,9,13,14
Mike Conley,G,22023,201144,22300680,"JAN 31, 2024",MIN vs. DAL,W,25,4,6,0.667,2,3,0.667,0,0,0.0,0,4,4,3,1,1,1,2,10,25,1,MIN,MIN,DAL,121,,,17,14,13,7
Mike Conley,G,22023,201144,22300629,"JAN 25, 2024",MIN @ BKN,W,33,3,6,0.5,2,4,0.5,2,2,1.0,0,2,2,4,2,1,1,1,10,1,1,MIN,BKN,MIN,96,,,16,12,14,6
Mike Conley,G,22023,201144,22300599,"JAN 20, 2024",MIN vs. OKC,L,29,1,11,0.091,1,9,0.111,0,0,0.0,0,3,3,4,0,1,3,3,3,-22,1,MIN,MIN,OKC,97,,,10,6,7,7
Mike Conley,G,22023,201144,22300582,"JAN 18, 2024",MIN vs. MEM,W,30,7,11,0.636,3,6,0.5,0,0,0.0,2,2,4,10,2,0,0,1,17,11,1,MIN,MIN,MEM,118,,,31,21,27,14
Mike Conley,G,22023,201144,22300569,"JAN 17, 2024",MIN @ DET,W,29,3,8,0.375,2,6,0.333,0,1,0.0,0,3,3,7,1,1,1,0,8,20,1,MIN,DET,MIN,124,,,18,11,15,10
Mike Conley,G,22023,201144,22300553,"JAN 14, 2024",MIN vs. LAC,W,32,2,7,0.286,2,6,0.333,0,0,0.0,1,1,2,5,1,0,2,2,6,-4,1,MIN,MIN,LAC,109,,,13,8,11,7
Mike Conley,G,22023,201144,22300538,"JAN 12, 2024",MIN vs. POR,W,20,3,7,0.429,3,5,0.6,0,0,0.0,0,4,4,10,0,0,0,1,9,34,1,MIN,MIN,POR,116,,,23,13,19,14
Mike Conley,G,22023,201144,22300513,"JAN 09, 2024",MIN @ ORL,W,31,3,8,0.375,3,6,0.5,2,2,1.0,0,3,3,10,2,0,1,3,11,23,1,MIN,ORL,MIN,113,,,24,14,21,13
Mike Conley,G,22023,201144,22300501,"JAN 07, 2024",MIN @ DAL,L,32,3,7,0.429,3,6,0.5,0,0,0.0,0,1,1,7,0,0,2,1,9,-1,1,MIN,DAL,MIN,108,,,17,10,16,8
Mike Conley,G,22023,201144,22300485,"JAN 05, 2024",MIN @ HOU,W,25,3,8,0.375,2,5,0.4,0,0,0.0,0,2,2,5,0,0,0,3,8,13,1,MIN,HOU,MIN,122,,,15,10,13,7
Mike Conley,G,22023,201144,22300471,"JAN 03, 2024",MIN vs. NOP,L,26,3,5,0.6,1,3,0.333,0,0,0.0,0,0,0,9,1,0,0,1,7,-14,1,MIN,MIN,NOP,106,,,16,7,16,9
Mike Conley,G,22023,201144,22300451,"JAN 01, 2024",MIN @ NYK,L,29,2,6,0.333,0,1,0.0,1,1,1.0,0,2,2,5,1,1,0,1,5,-11,1,MIN,NYK,MIN,106,,,12,7,10,7
Mike Conley,G,22023,201144,22300443,"DEC 30, 2023",MIN vs. LAL,W,33,4,11,0.364,4,9,0.444,3,4,0.75,1,3,4,7,1,0,1,2,15,3,1,MIN,MIN,LAL,108,,,26,19,22,11
Mike Conley,G,22023,201144,22300423,"DEC 28, 2023",MIN vs. DAL,W,28,3,7,0.429,2,4,0.5,2,2,1.0,1,1,2,6,0,1,1,5,10,15,1,MIN,MIN,DAL,118,,,18,12,16,8
Mike Conley,G,22023,201144,22300411,"DEC 26, 2023",MIN @ OKC,L,25,6,10,0.6,5,7,0.714,0,0,0.0,0,2,2,4,2,0,0,0,17,-10,1,MIN,OKC,MIN,106,,,23,19,21,6
Mike Conley,G,22023,201144,22300400,"DEC 23, 2023",MIN @ SAC,W,32,4,10,0.4,3,7,0.429,1,1,1.0,0,7,7,9,2,0,2,1,12,28,1,MIN,SAC,MIN,110,,,28,19,21,16
Mike Conley,G,22023,201144,22300380,"DEC 21, 2023",MIN vs. LAL,W,30,6,9,0.667,4,6,0.667,0,0,0.0,0,1,1,8,2,1,1,1,16,3,1,MIN,MIN,LAL,118,,,25,17,24,9
Mike Conley,G,22023,201144,22300367,"DEC 20, 2023",MIN @ PHI,L,26,3,7,0.429,1,4,0.25,2,2,1.0,0,0,0,4,0,0,2,1,9,1,1,MIN,PHI,MIN,113,,,13,9,13,4
Mike Conley,G,22023,201144,22300353,"DEC 18, 2023",MIN @ MIA,W,33,4,5,0.8,4,5,0.8,2,2,1.0,0,1,1,6,1,0,4,1,14,4,1,MIN,MIA,MIN,112,,,21,15,20,7
Mike Conley,G,22023,201144,22300338,"DEC 16, 2023",MIN vs. IND,W,24,2,5,0.4,1,3,0.333,0,0,0.0,0,2,2,9,1,0,0,0,5,21,1,MIN,MIN,IND,127,,,16,7,14,11
Mike Conley,G,22023,201144,22300321,"DEC 14, 2023",MIN @ DAL,W,29,5,9,0.556,2,4,0.5,2,2,1.0,0,2,2,3,1,0,1,2,14,7,1,MIN,DAL,MIN,119,,,19,16,17,5
Mike Conley,G,22023,201144,22300301,"DEC 11, 2023",MIN @ NOP,L,27,6,11,0.545,4,7,0.571,1,2,0.5,1,4,5,7,0,0,3,1,17,-19,1,MIN,NOP,MIN,107,,,29,22,24,12
Mike Conley,G,22023,201144,22301221,"DEC 08, 2023",MIN @ MEM,W,32,6,11,0.545,2,3,0.667,5,5,1.0,0,4,4,7,0,0,2,1,19,25,1,MIN,MEM,MIN,127,,,30,23,26,11
Mike Conley,G,22023,201144,22301210,"DEC 06, 2023",MIN vs. SAS,W,33,5,13,0.385,4,10,0.4,4,4,1.0,0,4,4,4,3,0,1,3,18,9,1,MIN,MIN,SAS,102,,,26,22,22,8
Mike Conley,G,22023,201144,22300281,"DEC 02, 2023",MIN @ CHA,W,34,3,9,0.333,1,7,0.143,7,8,0.875,0,5,5,10,0,0,1,2,14,10,1,MIN,CHA,MIN,123,,,29,19,24,15
Mike Conley,G,22023,201144,22300270,"NOV 30, 2023",MIN vs. UTA,W,29,2,6,0.333,2,6,0.333,2,2,1.0,0,3,3,7,2,0,2,3,8,4,1,MIN,MIN,UTA,101,,,18,11,15,10
Mike Conley,G,22023,201144,22300058,"NOV 28, 2023",MIN vs. OKC,W,37,3,14,0.214,3,10,0.3,0,0,0.0,0,2,2,8,1,0,0,2,9,17,1,MIN,MIN,OKC,106,,,19,11,17,10
Mike Conley,G,22023,201144,22300249,"NOV 26, 2023",MIN @ MEM,W,32,6,11,0.545,6,9,0.667,0,0,0.0,0,4,4,10,1,0,2,1,18,8,1,MIN,MEM,MIN,119,,,32,22,28,14
Mike Conley,G,22023,201144,22300050,"NOV 24, 2023",MIN vs. SAC,L,30,2,7,0.286,2,3,0.667,0,0,0.0,1,2,3,9,1,0,1,1,6,-10,1,MIN,MIN,SAC,111,,,18,9,15,12
Mike Conley,G,22023,201144,22300232,"NOV 22, 2023",MIN vs. PHI,W,23,2,5,0.4,1,2,0.5,0,0,0.0,0,0,0,8,3,0,1,1,5,6,1,MIN,MIN,PHI,112,,,13,5,13,8
Mike Conley,G,22023,201144,22300221,"NOV 20, 2023",MIN vs. NYK,W,28,3,9,0.333,3,8,0.375,2,2,1.0,0,1,1,5,0,1,0,3,11,20,1,MIN,MIN,NYK,117,,,17,12,16,6
Mike Conley,G,22023,201144,22300203,"NOV 18, 2023",MIN @ NOP,W,30,2,8,0.25,1,5,0.2,0,0,0.0,0,3,3,5,1,0,3,1,5,-5,1,MIN,NOP,MIN,121,,,13,8,10,8
Mike Conley,G,22023,201144,22300197,"NOV 15, 2023",MIN @ PHX,L,22,5,8,0.625,1,3,0.333,3,3,1.0,1,1,2,3,0,0,0,0,14,-16,1,MIN,PHX,MIN,115,,,19,16,17,5
Mike Conley,G,22023,201144,22300025,"NOV 14, 2023",MIN @ GSW,W,31,4,6,0.667,3,4,0.75,2,2,1.0,0,2,2,8,2,0,1,1,13,12,1,MIN,GSW,MIN,104,,,23,15,21,10
Mike Conley,G,22023,201144,22300186,"NOV 12, 2023",MIN @ GSW,W,31,3,7,0.429,1,5,0.2,1,1,1.0,1,4,5,9,0,0,1,4,8,6,1,MIN,GSW,MIN,116,,,22,13,17,14
Mike Conley,G,22023,201144,22300013,"NOV 10, 2023",MIN @ SAS,W,31,3,7,0.429,1,3,0.333,4,4,1.0,2,1,3,6,0,0,4,3,11,4,1,MIN,SAS,MIN,117,,,20,14,17,9
Mike Conley,G,22023,201144,22300166,"NOV 08, 2023",MIN vs. NOP,W,21,4,5,0.8,4,5,0.8,0,0,0.0,0,4,4,4,1,0,0,2,12,16,1,MIN,MIN,NOP,122,,,20,16,16,8
Mike Conley,G,22023,201144,22300154,"NOV 06, 2023",MIN vs. BOS,W,36,3,5,0.6,2,3,0.667,0,0,0.0,0,2,2,3,2,0,0,1,8,-18,1,MIN,MIN,BOS,114,,,13,10,11,5
Mike Conley,G,22023,201144,22300138,"NOV 04, 2023",MIN vs. UTA,W,28,3,9,0.333,1,4,0.25,0,0,0.0,0,3,3,6,1,0,0,4,7,23,1,MIN,MIN,UTA,123,,,16,10,13,9
Mike Conley,G,22023,201144,22300123,"NOV 01, 2023",MIN vs. DEN,W,27,7,9,0.778,3,4,0.75,0,0,0.0,0,3,3,6,1,0,0,1,17,19,1,MIN,MIN,DEN,110,,,26,20,23,9
Mike Conley,G,22023,201144,22300104,"OCT 30, 2023",MIN @ ATL,L,28,2,9,0.222,2,6,0.333,0,0,0.0,1,1,2,3,0,0,0,3,6,-12,1,MIN,ATL,MIN,113,,,11,8,9,5
Mike Conley,G,22023,201144,22300093,"OCT 28, 2023",MIN vs. MIA,W,29,6,10,0.6,2,6,0.333,0,0,0.0,2,2,4,5,1,0,0,1,14,21,1,MIN,MIN,MIA,106,,,23,18,19,9
Mike Conley,G,22023,201144,22300069,"OCT 25, 2023",MIN @ TOR,L,31,4,9,0.444,1,4,0.25,2,2,1.0,1,3,4,3,1,1,1,1,11,-6,1,MIN,TOR,MIN,94,,,18,15,14,7
Talen Horton-Tucker,G,22023,1629659,22300660,"JAN 29, 2024",UTA @ BKN,L,8,2,3,0.667,1,1,1.0,0,0,0.0,0,0,0,2,0,0,0,0,5,-11,1,UTA,BKN,UTA,114,,,7,5,7,2
Talen Horton-Tucker,G,22023,1629659,22300616,"JAN 23, 2024",UTA @ NOP,L,8,2,7,0.286,0,2,0.0,4,4,1.0,0,3,3,2,1,0,0,0,8,-5,1,UTA,NOP,UTA,124,,,13,11,10,5
Talen Horton-Tucker,G,22023,1629659,22300479,"JAN 05, 2024",UTA @ BOS,L,12,4,10,0.4,0,1,0.0,3,6,0.5,0,1,1,0,2,0,0,1,11,3,1,UTA,BOS,UTA,97,,,12,12,11,1
Talen Horton-Tucker,G,22023,1629659,22300424,"DEC 28, 2023",UTA @ NOP,L,6,0,3,0.0,0,1,0.0,2,2,1.0,0,0,0,0,0,0,0,0,2,0,1,UTA,NOP,UTA,105,,,2,2,2,0
Talen Horton-Tucker,G,22023,1629659,22300364,"DEC 20, 2023",UTA @ CLE,L,30,6,13,0.462,0,1,0.0,7,8,0.875,0,1,1,11,1,0,1,3,19,5,1,UTA,CLE,UTA,116,,,31,20,30,12
Talen Horton-Tucker,G,22023,1629659,22300357,"DEC 18, 2023",UTA vs. BKN,W,31,11,19,0.579,5,7,0.714,0,0,0.0,0,3,3,6,2,0,1,2,27,18,1,UTA,UTA,BKN,125,,,36,30,33,9
Talen Horton-Tucker,G,22023,1629659,22300342,"DEC 16, 2023",UTA @ SAC,L,26,4,11,0.364,2,4,0.5,2,3,0.667,1,2,3,5,3,0,1,0,12,-2,1,UTA,SAC,UTA,104,,,20,15,17,8
Talen Horton-Tucker,G,22023,1629659,22300323,"DEC 14, 2023",UTA @ POR,W,30,9,19,0.474,0,6,0.0,5,6,0.833,1,1,2,4,4,0,3,2,23,31,1,UTA,POR,UTA,122,,,29,25,27,6
Talen Horton-Tucker,G,22023,1629659,22300318,"DEC 13, 2023",UTA vs. NYK,W,24,7,14,0.5,1,3,0.333,0,2,0.0,0,4,4,3,0,0,2,2,15,-8,1,UTA,UTA,NYK,117,,,22,19,18,7
Talen Horton-Tucker,G,22023,1629659,22300302,"DEC 11, 2023",UTA @ OKC,L,15,3,7,0.429,1,3,0.333,4,4,1.0,0,1,1,2,0,1,2,5,11,-19,1,UTA,OKC,UTA,120,,,14,12,13,3
Talen Horton-Tucker,G,22023,1629659,22301225,"DEC 08, 2023",UTA vs. LAC,L,22,6,11,0.545,1,4,0.25,2,3,0.667,0,1,1,5,1,1,2,0,15,4,1,UTA,UTA,LAC,103,,,21,16,20,6
Talen Horton-Tucker,G,22023,1629659,22301213,"DEC 06, 2023",UTA @ DAL,L,16,4,9,0.444,3,3,1.0,0,0,0.0,0,2,2,1,0,0,1,1,11,-2,1,UTA,DAL,UTA,97,,,14,13,12,3
Talen Horton-Tucker,G,22023,1629659,22300289,"DEC 02, 2023",UTA vs. POR,W,21,5,8,0.625,3,5,0.6,1,2,0.5,0,2,2,4,3,0,1,3,14,5,1,UTA,UTA,POR,118,,,20,16,18,6
Talen Horton-Tucker,G,22023,1629659,22300270,"NOV 30, 2023",UTA @ MIN,L,19,3,7,0.429,1,3,0.333,0,0,0.0,0,1,1,1,0,0,0,1,7,1,1,UTA,MIN,UTA,90,,,9,8,8,2
Talen Horton-Tucker,G,22023,1629659,22300261,"NOV 29, 2023",UTA @ MEM,L,24,2,12,0.167,1,5,0.2,0,0,0.0,1,3,4,3,1,1,2,2,5,-7,1,UTA,MEM,UTA,91,,,12,9,8,7
Talen Horton-Tucker,G,22023,1629659,22300256,"NOV 27, 2023",UTA vs. NOP,W,19,2,9,0.222,0,3,0.0,1,1,1.0,0,3,3,7,0,0,0,2,5,0,1,UTA,UTA,NOP,114,,,15,8,12,10
Talen Horton-Tucker,G,22023,1629659,22300243,"NOV 25, 2023",UTA vs. NOP,W,22,2,5,0.4,1,3,0.333,0,0,0.0,0,3,3,4,0,0,2,1,5,9,1,UTA,UTA,NOP,105,,,12,8,9,7
Talen Horton-Tucker,G,22023,1629659,22300237,"NOV 22, 2023",UTA @ POR,L,14,1,4,0.25,0,2,0.0,3,4,0.75,0,0,0,1,0,0,3,4,5,-15,1,UTA,POR,UTA,105,,,6,5,6,1
Talen Horton-Tucker,G,22023,1629659,22300042,"NOV 21, 2023",UTA @ LAL,L,23,1,10,0.1,0,5,0.0,4,4,1.0,0,3,3,7,2,1,1,1,6,-16,1,UTA,LAL,UTA,99,,,16,9,13,10
Talen Horton-Tucker,G,22023,1629659,22300214,"NOV 19, 2023",UTA vs. PHX,L,29,9,18,0.5,4,10,0.4,3,3,1.0,2,2,4,3,2,0,1,4,25,1,1,UTA,UTA,PHX,137,,,32,29,28,7
Talen Horton-Tucker,G,22023,1629659,22300035,"NOV 17, 2023",UTA vs. PHX,L,19,2,5,0.4,1,4,0.25,4,4,1.0,0,3,3,4,0,1,3,4,9,-5,1,UTA,UTA,PHX,128,,,16,12,13,7
Talen Horton-Tucker,G,22023,1629659,22300023,"NOV 14, 2023",UTA vs. POR,W,21,2,5,0.4,0,1,0.0,0,0,0.0,1,2,3,3,1,0,2,3,4,8,1,UTA,UTA,POR,115,,,10,7,7,6
Talen Horton-Tucker,G,22023,1629659,22300012,"NOV 10, 2023",UTA @ MEM,W,18,4,7,0.571,3,5,0.6,2,2,1.0,1,2,3,2,1,1,1,2,13,5,1,UTA,MEM,UTA,127,,,18,16,15,5
Talen Horton-Tucker,G,22023,1629659,22300158,"NOV 08, 2023",UTA @ IND,L,20,3,8,0.375,0,1,0.0,0,0,0.0,2,2,4,5,0,1,4,1,6,2,1,UTA,IND,UTA,118,,,15,10,11,9
Talen Horton-Tucker,G,22023,1629659,22300152,"NOV 06, 2023",UTA @ CHI,L,23,2,5,0.4,1,3,0.333,0,0,0.0,0,6,6,4,0,0,5,0,5,-7,1,UTA,CHI,UTA,113,,,15,11,9,10
Talen Horton-Tucker,G,22023,1629659,22300138,"NOV 04, 2023",UTA @ MIN,L,24,6,20,0.3,2,6,0.333,0,0,0.0,2,2,4,5,2,1,2,1,14,-10,1,UTA,MIN,UTA,95,,,23,18,19,9
Talen Horton-Tucker,G,22023,1629659,22300130,"NOV 02, 2023",UTA vs. ORL,L,31,7,14,0.5,1,4,0.25,0,0,0.0,0,3,3,8,3,1,2,4,15,3,1,UTA,UTA,ORL,113,,,26,18,23,11
Talen Horton-Tucker,G,22023,1629659,22300125,"NOV 01, 2023",UTA vs. MEM,W,23,4,8,0.5,0,3,0.0,1,1,1.0,1,4,5,7,0,0,5,3,9,2,1,UTA,UTA,MEM,133,,,21,14,16,12
Talen Horton-Tucker,G,22023,1629659,22300110,"OCT 30, 2023",UTA @ DEN,L,30,7,12,0.583,2,3,0.667,0,0,0.0,0,3,3,8,0,0,1,4,16,2,1,UTA,DEN,UTA,102,,,27,19,24,11
Talen Horton-Tucker,G,22023,1629659,22300094,"OCT 28, 2023",UTA @ PHX,L,16,1,7,0.143,0,3,0.0,2,4,0.5,0,0,0,1,1,0,0,4,4,-13,1,UTA,PHX,UTA,104,,,5,4,5,1
Talen Horton-Tucker,G,22023,1629659,22300085,"OCT 27, 2023",UTA vs. LAC,W,27,3,10,0.3,2,5,0.4,2,2,1.0,0,3,3,8,3,1,2,1,10,4,1,UTA,UTA,LAC,120,,,21,13,18,11
Talen Horton-Tucker,G,22023,1629659,22300072,"OCT 25, 2023",UTA vs. SAC,L,22,3,9,0.333,2,4,0.5,0,0,0.0,0,1,1,4,0,1,1,1,8,-5,1,UTA,UTA,SAC,114,,,13,9,12,5
Talen Horton-Tucker,G,22023,1629659,22300739,"FEB 08, 2024",UTA @ PHX,L,14,1,6,0.167,0,2,0.0,5,9,0.556,3,1,4,2,0,0,0,2,7,-6,1,UTA,PHX,UTA,115,,,13,11,9,6
Daniel Gafford,C,22023,1629655,22300728,"FEB 07, 2024",WAS vs. CLE,L,35,7,12,0.583,0,0,0.0,0,0,0.0,4,9,13,0,1,4,1,2,14,11,1,WAS,WAS,CLE,106,,,27,27,14,13
Daniel Gafford,C,22023,1629655,22300705,"FEB 04, 2024",WAS vs. PHX,L,25,7,7,1.0,0,0,0.0,1,2,0.5,4,3,7,1,0,2,0,4,15,-22,1,WAS,WAS,PHX,109,,,23,22,16,8
Daniel Gafford,C,22023,1629655,22300689,"FEB 02, 2024",WAS vs. MIA,L,32,4,8,0.5,0,0,0.0,3,4,0.75,4,10,14,2,1,1,1,4,11,14,1,WAS,WAS,MIA,102,,,27,25,13,16
Daniel Gafford,C,22023,1629655,22300676,"JAN 31, 2024",WAS vs. LAC,L,22,2,5,0.4,0,0,0.0,2,2,1.0,4,4,8,2,1,5,1,3,6,-16,1,WAS,WAS,LAC,107,,,16,14,8,10
Daniel Gafford,C,22023,1629655,22300665,"JAN 29, 2024",WAS @ SAS,W,28,6,8,0.75,0,0,0.0,4,8,0.5,8,5,13,2,2,1,1,2,16,3,1,WAS,SAS,WAS,118,,,31,29,18,15
Daniel Gafford,C,22023,1629655,22300642,"JAN 27, 2024",WAS @ DET,W,28,7,10,0.7,0,0,0.0,1,2,0.5,6,7,13,1,3,0,0,2,15,5,1,WAS,DET,WAS,118,,,29,28,16,14
Daniel Gafford,C,22023,1629655,22300628,"JAN 25, 2024",WAS vs. UTA,L,31,6,7,0.857,0,0,0.0,1,2,0.5,2,7,9,1,1,4,0,2,13,0,1,WAS,WAS,UTA,108,,,23,22,14,10
Daniel Gafford,C,22023,1629655,22300620,"JAN 24, 2024",WAS vs. MIN,L,21,5,5,1.0,0,0,0.0,0,0,0.0,1,3,4,1,1,2,2,6,10,-13,1,WAS,WAS,MIN,107,,,15,14,11,5
Daniel Gafford,C,22023,1629655,22300602,"JAN 21, 2024",WAS vs. DEN,L,30,7,10,0.7,0,0,0.0,1,2,0.5,3,4,7,2,2,1,2,5,15,-8,1,WAS,WAS,DEN,104,,,24,22,17,9
Daniel Gafford,C,22023,1629655,22300558,"JAN 15, 2024",WAS vs. DET,L,26,4,6,0.667,0,0,0.0,0,0,0.0,3,3,6,3,1,2,2,3,8,-12,1,WAS,WAS,DET,117,,,17,14,11,9
Daniel Gafford,C,22023,1629655,22300543,"JAN 13, 2024",WAS @ ATL,W,30,4,4,1.0,0,0,0.0,2,2,1.0,0,6,6,0,1,2,1,0,10,26,1,WAS,ATL,WAS,125,,,16,16,10,6
Daniel Gafford,C,22023,1629655,22300520,"JAN 10, 2024",WAS @ IND,L,37,4,6,0.667,0,0,0.0,4,6,0.667,1,7,8,2,2,6,3,4,12,-3,1,WAS,IND,WAS,104,,,22,20,14,10
Daniel Gafford,C,22023,1629655,22300508,"JAN 08, 2024",WAS vs. OKC,L,26,3,7,0.429,0,0,0.0,3,3,1.0,4,5,9,1,0,1,0,2,9,1,1,WAS,WAS,OKC,128,,,19,18,10,10
Daniel Gafford,C,22023,1629655,22300494,"JAN 06, 2024",WAS vs. NYK,L,31,2,2,1.0,0,0,0.0,2,4,0.5,4,8,12,3,1,1,1,5,6,-8,1,WAS,WAS,NYK,105,,,21,18,9,15
Daniel Gafford,C,22023,1629655,22300482,"JAN 05, 2024",WAS @ CLE,L,24,1,2,0.5,0,0,0.0,2,2,1.0,0,4,4,1,0,1,0,2,4,-18,1,WAS,CLE,WAS,90,,,9,8,5,5
Daniel Gafford,C,22023,1629655,22300465,"JAN 03, 2024",WAS @ CLE,L,20,6,8,0.75,0,0,0.0,0,1,0.0,3,2,5,1,0,1,0,2,12,-13,1,WAS,CLE,WAS,101,,,18,17,13,6
Daniel Gafford,C,22023,1629655,22300445,"DEC 31, 2023",WAS vs. ATL,L,28,3,4,0.75,0,0,0.0,4,4,1.0,2,7,9,0,2,4,0,2,10,13,1,WAS,WAS,ATL,126,,,19,19,10,9
Daniel Gafford,C,22023,1629655,22300430,"DEC 29, 2023",WAS vs. BKN,W,17,1,4,0.25,0,0,0.0,2,2,1.0,1,4,5,0,1,0,1,4,4,-15,1,WAS,WAS,BKN,110,,,9,9,4,5
Daniel Gafford,C,22023,1629655,22300416,"DEC 27, 2023",WAS vs. TOR,L,30,5,9,0.556,0,0,0.0,2,2,1.0,2,6,8,1,4,1,0,2,12,-21,1,WAS,WAS,TOR,102,,,21,20,13,9
Daniel Gafford,C,22023,1629655,22300407,"DEC 26, 2023",WAS vs. ORL,L,32,6,7,0.857,0,0,0.0,1,2,0.5,6,7,13,3,2,3,3,4,13,-1,1,WAS,WAS,ORL,119,,,29,26,16,16
Daniel Gafford,C,22023,1629655,22300386,"DEC 22, 2023",WAS @ GSW,L,23,5,7,0.714,0,0,0.0,5,6,0.833,1,3,4,1,1,0,1,1,15,-3,1,WAS,GSW,WAS,118,,,20,19,16,5
Daniel Gafford,C,22023,1629655,22300381,"DEC 21, 2023",WAS @ POR,W,31,7,10,0.7,0,0,0.0,2,3,0.667,3,5,8,0,4,6,1,6,16,9,1,WAS,POR,WAS,118,,,24,24,16,8
Daniel Gafford,C,22023,1629655,22300358,"DEC 18, 2023",WAS @ SAC,L,25,3,5,0.6,0,0,0.0,2,2,1.0,2,3,5,1,0,3,0,4,8,-27,1,WAS,SAC,WAS,131,,,14,13,9,6
Daniel Gafford,C,22023,1629655,22300347,"DEC 17, 2023",WAS @ PHX,L,35,10,13,0.769,0,0,0.0,6,7,0.857,7,10,17,3,0,2,1,4,26,4,1,WAS,PHX,WAS,108,,,46,43,29,20
Daniel Gafford,C,22023,1629655,22300328,"DEC 15, 2023",WAS vs. IND,W,28,3,6,0.5,0,0,0.0,3,4,0.75,5,5,10,4,0,3,2,4,9,19,1,WAS,WAS,IND,137,,,23,19,13,14
Daniel Gafford,C,22023,1629655,22300311,"DEC 13, 2023",WAS vs. NOP,L,24,5,6,0.833,0,0,0.0,3,4,0.75,2,5,7,0,1,2,1,3,13,-4,1,WAS,WAS,NOP,122,,,20,20,13,7
Daniel Gafford,C,22023,1629655,22301219,"DEC 08, 2023",WAS @ BKN,L,22,1,5,0.2,0,0,0.0,1,2,0.5,2,0,2,2,0,2,1,1,3,-23,1,WAS,BKN,WAS,97,,,7,5,5,4
Daniel Gafford,C,22023,1629655,22301208,"DEC 06, 2023",WAS vs. PHI,L,23,8,10,0.8,0,0,0.0,2,2,1.0,2,4,6,4,1,2,0,6,18,-8,1,WAS,WAS,PHI,126,,,28,24,22,10
Daniel Gafford,C,22023,1629655,22300274,"DEC 01, 2023",WAS @ ORL,L,27,7,10,0.7,0,0,0.0,4,7,0.571,4,7,11,3,0,3,1,5,18,-1,1,WAS,ORL,WAS,125,,,32,29,21,14
Daniel Gafford,C,22023,1629655,22300259,"NOV 29, 2023",WAS @ ORL,L,26,2,2,1.0,0,0,0.0,0,0,0.0,1,2,3,4,1,2,0,3,4,-6,1,WAS,ORL,WAS,120,,,11,7,8,7
Daniel Gafford,C,22023,1629655,22300253,"NOV 27, 2023",WAS @ DET,W,27,4,5,0.8,0,0,0.0,2,2,1.0,3,6,9,2,2,4,2,3,10,10,1,WAS,DET,WAS,126,,,21,19,12,11
Daniel Gafford,C,22023,1629655,22300241,"NOV 25, 2023",WAS vs. ATL,L,18,6,8,0.75,0,0,0.0,0,0,0.0,1,3,4,0,0,2,0,2,12,-18,1,WAS,WAS,ATL,108,,,16,16,12,4
Daniel Gafford,C,22023,1629655,22300049,"NOV 24, 2023",WAS @ MIL,L,29,3,6,0.5,0,0,0.0,2,3,0.667,5,4,9,4,1,2,1,5,8,-6,1,WAS,MIL,WAS,128,,,21,17,12,13
Daniel Gafford,C,22023,1629655,22300225,"NOV 22, 2023",WAS @ CHA,L,34,7,9,0.778,0,0,0.0,1,2,0.5,5,11,16,1,1,0,2,4,15,15,1,WAS,CHA,WAS,114,,,32,31,16,17
Daniel Gafford,C,22023,1629655,22300219,"NOV 20, 2023",WAS vs. MIL,L,29,7,13,0.538,0,0,0.0,0,0,0.0,1,4,5,2,0,2,0,3,14,-1,1,WAS,WAS,MIL,129,,,21,19,16,7
Daniel Gafford,C,22023,1629655,22300028,"NOV 17, 2023",WAS vs. NYK,L,28,4,8,0.5,0,0,0.0,2,2,1.0,4,3,7,0,1,0,1,4,10,-15,1,WAS,WAS,NYK,99,,,17,17,10,7
Daniel Gafford,C,22023,1629655,22300192,"NOV 15, 2023",WAS vs. DAL,L,24,5,6,0.833,0,0,0.0,0,1,0.0,2,7,9,2,0,0,0,1,10,-16,1,WAS,WAS,DAL,117,,,21,19,12,11
Daniel Gafford,C,22023,1629655,22300189,"NOV 13, 2023",WAS @ TOR,L,26,6,7,0.857,0,0,0.0,2,2,1.0,1,8,9,3,1,3,2,2,14,7,1,WAS,TOR,WAS,107,,,26,23,17,12
Daniel Gafford,C,22023,1629655,22300178,"NOV 12, 2023",WAS @ BKN,L,16,2,3,0.667,0,0,0.0,1,2,0.5,2,3,5,0,2,0,1,1,5,-4,1,WAS,BKN,WAS,94,,,10,10,5,5
Daniel Gafford,C,22023,1629655,22300009,"NOV 10, 2023",WAS vs. CHA,L,30,4,7,0.571,0,0,0.0,2,3,0.667,4,5,9,1,2,4,2,4,10,-16,1,WAS,WAS,CHA,117,,,20,19,11,10
Daniel Gafford,C,22023,1629655,22300157,"NOV 08, 2023",WAS @ CHA,W,13,2,3,0.667,0,0,0.0,1,2,0.5,3,2,5,1,0,2,1,4,5,3,1,WAS,CHA,WAS,132,,,11,10,6,6
Daniel Gafford,C,22023,1629655,22300148,"NOV 06, 2023",WAS @ PHI,L,30,6,7,0.857,0,0,0.0,0,0,0.0,3,4,7,3,0,5,4,5,12,-3,1,WAS,PHI,WAS,128,,,22,19,15,10
Daniel Gafford,C,22023,1629655,22300003,"NOV 03, 2023",WAS @ MIA,L,20,1,1,1.0,0,0,0.0,2,3,0.667,1,4,5,1,0,2,2,5,4,-10,1,WAS,MIA,WAS,114,,,10,9,5,6
Daniel Gafford,C,22023,1629655,22300089,"OCT 28, 2023",WAS vs. MEM,W,28,3,4,0.75,0,0,0.0,4,6,0.667,4,7,11,0,0,2,1,2,10,8,1,WAS,WAS,MEM,113,,,21,21,10,11
Daniel Gafford,C,22023,1629655,22300064,"OCT 25, 2023",WAS @ IND,L,21,2,2,1.0,0,0,0.0,2,4,0.5,1,4,5,0,0,2,0,5,6,-23,1,WAS,IND,WAS,120,,,11,11,6,5
Daniel Gafford,C,22023,1629655,22300748,"FEB 10, 2024",DAL vs. OKC,W,17,7,11,0.636,0,0,0.0,5,6,0.833,4,5,9,0,0,1,0,2,19,9,1,DAL,DAL,OKC,146,,,28,28,19,9
Jakob Poeltl,C,22023,1627751,22300432,"DEC 29, 2023",TOR @ BOS,L,22,5,8,0.625,0,0,0.0,2,2,1.0,4,6,10,3,0,2,0,3,12,-9,1,TOR,BOS,TOR,118,,,25,22,15,13
Jakob Poeltl,C,22023,1627751,22300416,"DEC 27, 2023",TOR @ WAS,W,21,4,6,0.667,0,0,0.0,2,4,0.5,3,5,8,2,2,1,2,4,10,16,1,TOR,WAS,TOR,132,,,20,18,12,10
Jakob Poeltl,C,22023,1627751,22300395,"DEC 23, 2023",TOR vs. UTA,L,21,1,4,0.25,0,0,0.0,0,0,0.0,2,2,4,3,0,2,0,2,2,3,1,TOR,TOR,UTA,119,,,9,6,5,7
Jakob Poeltl,C,22023,1627751,22300382,"DEC 22, 2023",TOR @ PHI,L,29,9,15,0.6,0,0,0.0,1,2,0.5,2,6,8,2,1,0,1,3,19,-14,1,TOR,PHI,TOR,111,,,29,27,21,10
Jakob Poeltl,C,22023,1627751,22300369,"DEC 20, 2023",TOR vs. DEN,L,19,2,5,0.4,0,0,0.0,0,0,0.0,2,3,5,3,0,2,1,2,4,-12,1,TOR,TOR,DEN,104,,,12,9,7,8
Jakob Poeltl,C,22023,1627751,22300354,"DEC 18, 2023",TOR vs. CHA,W,15,2,2,1.0,0,0,0.0,0,0,0.0,0,1,1,2,0,0,4,3,4,-12,1,TOR,TOR,CHA,114,,,7,5,6,3
Jakob Poeltl,C,22023,1627751,22300330,"DEC 15, 2023",TOR vs. ATL,L,25,7,7,1.0,0,0,0.0,1,2,0.5,2,6,8,0,2,1,3,4,15,-12,1,TOR,TOR,ATL,104,,,23,23,15,8
Jakob Poeltl,C,22023,1627751,22300313,"DEC 13, 2023",TOR vs. ATL,W,32,5,8,0.625,0,0,0.0,5,8,0.625,4,9,13,6,0,3,1,4,15,12,1,TOR,TOR,ATL,135,,,34,28,21,19
Jakob Poeltl,C,22023,1627751,22300297,"DEC 11, 2023",TOR @ NYK,L,24,3,6,0.5,0,0,0.0,5,8,0.625,6,2,8,2,0,0,1,2,11,-6,1,TOR,NYK,TOR,130,,,21,19,13,10
Jakob Poeltl,C,22023,1627751,22301216,"DEC 08, 2023",TOR @ CHA,L,26,4,4,1.0,0,0,0.0,0,0,0.0,4,4,8,1,0,0,0,2,8,-8,1,TOR,CHA,TOR,116,,,17,16,9,9
Jakob Poeltl,C,22023,1627751,22301207,"DEC 06, 2023",TOR vs. MIA,L,28,1,2,0.5,0,0,0.0,0,2,0.0,1,5,6,1,0,4,0,2,2,-12,1,TOR,TOR,MIA,103,,,9,8,3,7
Jakob Poeltl,C,22023,1627751,22300276,"DEC 01, 2023",TOR vs. NYK,L,28,6,9,0.667,0,0,0.0,0,0,0.0,4,8,12,1,0,2,1,4,12,0,1,TOR,TOR,NYK,106,,,25,24,13,13
Jakob Poeltl,C,22023,1627751,22300260,"NOV 29, 2023",TOR vs. PHX,W,30,8,9,0.889,0,0,0.0,1,2,0.5,2,2,4,1,0,1,2,4,17,1,1,TOR,TOR,PHX,112,,,22,21,18,5
Jakob Poeltl,C,22023,1627751,22300054,"NOV 28, 2023",TOR @ BKN,L,25,3,5,0.6,0,0,0.0,0,0,0.0,3,6,9,4,1,2,1,2,6,0,1,TOR,BKN,TOR,103,,,19,15,10,13
Jakob Poeltl,C,22023,1627751,22300251,"NOV 26, 2023",TOR @ CLE,L,35,8,9,0.889,0,0,0.0,2,2,1.0,4,9,13,2,2,0,1,3,18,9,1,TOR,CLE,TOR,102,,,33,31,20,15
Jakob Poeltl,C,22023,1627751,22300046,"NOV 24, 2023",TOR vs. CHI,W,31,7,8,0.875,0,0,0.0,1,5,0.2,4,6,10,3,2,1,1,1,15,15,1,TOR,TOR,CHI,121,,,28,25,18,13
Jakob Poeltl,C,22023,1627751,22300038,"NOV 21, 2023",TOR @ ORL,L,23,5,7,0.714,0,0,0.0,0,0,0.0,1,9,10,1,0,1,4,6,10,-13,1,TOR,ORL,TOR,107,,,21,20,11,11
Jakob Poeltl,C,22023,1627751,22300211,"NOV 19, 2023",TOR vs. DET,W,25,6,6,1.0,0,0,0.0,4,5,0.8,2,8,10,4,1,3,1,3,16,21,1,TOR,TOR,DET,142,,,30,26,20,14
Jakob Poeltl,C,22023,1627751,22300031,"NOV 17, 2023",TOR vs. BOS,L,34,5,5,1.0,0,0,0.0,1,2,0.5,2,6,8,4,1,0,3,0,11,1,1,TOR,TOR,BOS,105,,,23,19,15,12
Jakob Poeltl,C,22023,1627751,22300195,"NOV 15, 2023",TOR vs. MIL,L,27,6,10,0.6,0,0,0.0,1,2,0.5,7,4,11,1,4,2,0,4,13,-17,1,TOR,TOR,MIL,112,,,25,24,14,12
Jakob Poeltl,C,22023,1627751,22300189,"NOV 13, 2023",TOR vs. WAS,W,24,6,8,0.75,0,0,0.0,1,3,0.333,3,3,6,5,0,0,1,1,13,-14,1,TOR,TOR,WAS,111,,,24,19,18,11
Jakob Poeltl,C,22023,1627751,22300174,"NOV 11, 2023",TOR @ BOS,L,21,6,10,0.6,0,0,0.0,0,0,0.0,2,1,3,2,0,0,1,3,12,-9,1,TOR,BOS,TOR,94,,,17,15,14,5
Jakob Poeltl,C,22023,1627751,22300092,"OCT 28, 2023",TOR vs. PHI,L,25,2,5,0.4,0,0,0.0,2,3,0.667,1,6,7,3,0,1,2,2,6,-19,1,TOR,TOR,PHI,107,,,16,13,9,10
Jakob Poeltl,C,22023,1627751,22300082,"OCT 27, 2023",TOR @ CHI,L,19,4,5,0.8,0,0,0.0,0,0,0.0,0,6,6,0,0,0,3,6,8,20,1,TOR,CHI,TOR,103,,,14,14,8,6
Jakob Poeltl,C,22023,1627751,22300069,"OCT 25, 2023",TOR vs. MIN,W,24,3,3,1.0,0,0,0.0,1,4,0.25,3,8,11,1,1,1,0,1,7,8,1,TOR,TOR,MIN,97,,,19,18,8,12
Jakob Poeltl,C,22023,1627751,22300756,"FEB 10, 2024",TOR vs. CLE,L,21,3,7,0.429,0,0,0.0,0,2,0.0,3,4,7,1,0,1,0,2,6,-14,1,TOR,TOR,CLE,95,,,14,13,7,8
Jakob Poeltl,C,22023,1627751,22300230,"NOV 22, 2023",TOR @ IND,W,29,3,4,0.75,0,0,0.0,0,0,0.0,1,3,4,6,0,1,3,0,6,-2,1,TOR,IND,TOR,132,,,16,10,12,10
Jakob Poeltl,C,22023,1627751,22300168,"NOV 08, 2023",TOR @ DAL,W,21,2,5,0.4,0,0,0.0,0,1,0.0,3,3,6,3,2,0,1,4,4,0,1,TOR,DAL,TOR,127,,,13,10,7,9
Jakob Poeltl,C,22023,1627751,22300141,"NOV 05, 2023",TOR @ SAS,W,28,8,10,0.8,0,0,0.0,0,2,0.0,3,7,10,0,3,1,1,2,16,-5,1,TOR,SAS,TOR,123,,,26,26,16,10
Jakob Poeltl,C,22023,1627751,22300128,"NOV 02, 2023",TOR @ PHI,L,28,4,8,0.5,0,0,0.0,1,1,1.0,2,7,9,2,0,1,4,2,9,-9,1,TOR,PHI,TOR,99,,,20,18,11,11
Jakob Poeltl,C,22023,1627751,22300116,"NOV 01, 2023",TOR vs. MIL,W,29,7,10,0.7,0,0,0.0,0,0,0.0,4,7,11,2,0,3,2,4,14,22,1,TOR,TOR,MIL,130,,,27,25,16,13
Jakob Poeltl,C,22023,1627751,22300105,"OCT 30, 2023",TOR vs. POR,L,28,6,8,0.75,0,0,0.0,2,3,0.667,5,5,10,1,0,1,2,3,14,-5,1,TOR,TOR,POR,91,,,25,24,15,11
Jakob Poeltl,C,22023,1627751,22300744,"FEB 09, 2024",TOR vs. HOU,W,37,7,11,0.636,0,0,0.0,2,2,1.0,5,8,13,3,3,6,4,4,16,14,1,TOR,TOR,HOU,100,,,32,29,19,16
Jakob Poeltl,C,22023,1627751,22300726,"FEB 07, 2024",TOR @ CHA,W,33,5,7,0.714,0,0,0.0,2,2,1.0,4,8,12,2,0,1,1,2,12,6,1,TOR,CHA,TOR,123,,,26,24,14,14
Jakob Poeltl,C,22023,1627751,22300718,"FEB 05, 2024",TOR @ NOP,L,28,7,8,0.875,0,0,0.0,0,2,0.0,1,8,9,1,1,2,3,2,14,-21,1,TOR,NOP,TOR,100,,,24,23,15,10
Jakob Poeltl,C,22023,1627751,22300710,"FEB 04, 2024",TOR @ OKC,L,33,8,9,0.889,0,0,0.0,3,4,0.75,3,9,12,3,0,2,2,5,19,-6,1,TOR,OKC,TOR,127,,,34,31,22,15
Jakob Poeltl,C,22023,1627751,22300692,"FEB 02, 2024",TOR @ HOU,L,20,3,5,0.6,0,0,0.0,0,0,0.0,0,5,5,1,0,2,3,6,6,-17,1,TOR,HOU,TOR,106,,,12,11,7,6
Jakob Poeltl,C,22023,1627751,22300504,"JAN 07, 2024",TOR @ GSW,W,31,6,8,0.75,0,0,0.0,2,5,0.4,3,8,11,5,0,0,2,3,14,21,1,TOR,GSW,TOR,131,,,30,25,19,16
Jakob Poeltl,C,22023,1627751,22300492,"JAN 05, 2024",TOR @ SAC,L,23,7,10,0.7,0,0,0.0,0,0,0.0,1,5,6,2,0,3,3,6,14,12,1,TOR,SAC,TOR,120,,,22,20,16,8
Jakob Poeltl,C,22023,1627751,22300470,"JAN 03, 2024",TOR @ MEM,W,33,2,7,0.286,0,0,0.0,3,4,0.75,3,5,8,2,1,5,1,3,7,-9,1,TOR,MEM,TOR,116,,,17,15,9,10
Jakob Poeltl,C,22023,1627751,22300452,"JAN 01, 2024",TOR vs. CLE,W,37,5,8,0.625,0,0,0.0,4,7,0.571,4,7,11,4,0,3,4,4,14,3,1,TOR,TOR,CLE,124,,,29,25,18,15
Jakob Poeltl,C,22023,1627751,22300440,"DEC 30, 2023",TOR @ DET,L,35,2,4,0.5,0,0,0.0,0,0,0.0,2,12,14,5,1,3,0,4,4,8,1,TOR,DET,TOR,127,,,23,18,9,19
Luke Kennard,G,22023,1628379,22300751,"FEB 10, 2024",MEM @ CHA,L,24,3,7,0.429,2,5,0.4,3,3,1.0,0,0,0,4,0,0,1,1,11,-6,1,MEM,CHA,MEM,105,,,15,11,15,4
Luke Kennard,G,22023,1628379,22300722,"FEB 06, 2024",MEM @ NYK,L,24,4,8,0.5,3,5,0.6,1,2,0.5,0,3,3,4,1,0,0,1,12,-1,1,MEM,NYK,MEM,97,,,19,15,16,7
Luke Kennard,G,22023,1628379,22300693,"FEB 02, 2024",MEM vs. GSW,L,18,2,5,0.4,2,3,0.667,0,0,0.0,1,1,2,2,0,0,1,1,6,-12,1,MEM,MEM,GSW,98,,,10,8,8,4
Luke Kennard,G,22023,1628379,22300638,"JAN 26, 2024",MEM vs. ORL,W,30,5,11,0.455,5,10,0.5,0,0,0.0,0,5,5,6,1,0,3,1,15,-8,1,MEM,MEM,ORL,107,,,26,20,21,11
Luke Kennard,G,22023,1628379,22300609,"JAN 22, 2024",MEM @ TOR,W,35,7,18,0.389,5,13,0.385,0,1,0.0,0,3,3,7,0,0,3,1,19,10,1,MEM,TOR,MEM,108,,,29,22,26,10
Luke Kennard,G,22023,1628379,22300597,"JAN 20, 2024",MEM @ CHI,L,30,5,9,0.556,4,7,0.571,0,1,0.0,0,2,2,6,0,0,3,0,14,-15,1,MEM,CHI,MEM,93,,,22,16,20,8
Luke Kennard,G,22023,1628379,22300582,"JAN 18, 2024",MEM @ MIN,L,31,6,9,0.667,5,7,0.714,1,1,1.0,0,2,2,2,1,0,1,1,18,4,1,MEM,MIN,MEM,103,,,22,20,20,4
Luke Kennard,G,22023,1628379,22300560,"JAN 15, 2024",MEM vs. GSW,W,32,2,9,0.222,2,7,0.286,5,5,1.0,1,1,2,5,1,0,1,1,11,15,1,MEM,MEM,GSW,116,,,18,13,16,7
Luke Kennard,G,22023,1628379,22300503,"JAN 07, 2024",MEM @ PHX,W,22,3,5,0.6,3,3,1.0,0,0,0.0,0,3,3,3,0,0,0,2,9,2,1,MEM,PHX,MEM,121,,,15,12,12,6
Luke Kennard,G,22023,1628379,22300491,"JAN 05, 2024",MEM @ LAL,W,20,0,4,0.0,0,3,0.0,0,0,0.0,1,2,3,4,1,0,0,0,0,0,1,MEM,LAL,MEM,127,,,7,3,4,7
Luke Kennard,G,22023,1628379,22300470,"JAN 03, 2024",MEM vs. TOR,L,19,1,5,0.2,0,4,0.0,0,0,0.0,0,1,1,0,0,0,0,1,2,-17,1,MEM,MEM,TOR,111,,,3,3,2,1
Luke Kennard,G,22023,1628379,22300460,"JAN 02, 2024",MEM vs. SAS,W,21,3,7,0.429,3,7,0.429,3,3,1.0,1,4,5,3,0,0,0,2,12,16,1,MEM,MEM,SAS,106,,,20,17,15,8
Luke Kennard,G,22023,1628379,22300449,"DEC 31, 2023",MEM vs. SAC,L,20,6,9,0.667,5,8,0.625,0,0,0.0,0,3,3,2,0,0,1,2,17,-7,1,MEM,MEM,SAC,92,,,22,20,19,5
Luke Kennard,G,22023,1628379,22300026,"NOV 14, 2023",MEM @ LAL,L,6,0,5,0.0,0,3,0.0,0,0,0.0,1,2,3,0,0,0,0,0,0,-6,1,MEM,LAL,MEM,107,,,3,3,0,3
Luke Kennard,G,22023,1628379,22300179,"NOV 12, 2023",MEM @ LAC,W,24,4,5,0.8,4,5,0.8,1,1,1.0,0,1,1,2,1,0,0,1,13,-1,1,MEM,LAC,MEM,105,,,16,14,15,3
Luke Kennard,G,22023,1628379,22300012,"NOV 10, 2023",MEM vs. UTA,L,21,5,11,0.455,4,9,0.444,0,0,0.0,0,1,1,1,0,1,0,1,14,-13,1,MEM,MEM,UTA,121,,,16,15,15,2
Luke Kennard,G,22023,1628379,22300164,"NOV 08, 2023",MEM vs. MIA,L,27,4,7,0.571,3,6,0.5,2,2,1.0,0,2,2,3,1,0,3,1,13,7,1,MEM,MEM,MIA,102,,,18,15,16,5
Luke Kennard,G,22023,1628379,22300144,"NOV 05, 2023",MEM @ POR,W,32,5,9,0.556,4,6,0.667,1,1,1.0,0,5,5,2,1,0,1,0,15,30,1,MEM,POR,MEM,112,,,22,20,17,7
Luke Kennard,G,22023,1628379,22300537,"JAN 12, 2024",MEM vs. LAC,L,29,4,7,0.571,3,5,0.6,0,0,0.0,1,6,7,6,0,0,1,2,11,-13,1,MEM,MEM,LAC,119,,,24,18,17,13
Luke Kennard,G,22023,1628379,22300515,"JAN 09, 2024",MEM @ DAL,W,23,5,7,0.714,3,4,0.75,1,1,1.0,1,4,5,4,1,0,2,2,14,-3,1,MEM,DAL,MEM,120,,,23,19,18,9
Luke Kennard,G,22023,1628379,22300007,"NOV 03, 2023",MEM @ POR,L,27,2,7,0.286,1,4,0.25,0,0,0.0,1,7,8,3,0,0,0,1,5,-10,1,MEM,POR,MEM,113,,,16,13,8,11
Luke Kennard,G,22023,1628379,22300125,"NOV 01, 2023",MEM @ UTA,L,21,1,9,0.111,1,8,0.125,0,0,0.0,0,1,1,3,2,0,0,0,3,-19,1,MEM,UTA,MEM,109,,,7,4,6,4
Luke Kennard,G,22023,1628379,22300071,"OCT 25, 2023",MEM vs. NOP,L,15,0,5,0.0,0,5,0.0,3,3,1.0,1,1,2,2,0,0,1,0,3,-14,1,MEM,MEM,NOP,104,,,7,5,5,4
Luke Kennard,G,22023,1628379,22300706,"FEB 04, 2024",MEM @ BOS,L,25,4,8,0.5,3,5,0.6,0,0,0.0,0,2,2,2,0,0,3,3,11,-22,1,MEM,BOS,MEM,56,,,15,13,13,4
Luke Kennard,G,22023,1628379,22300544,"JAN 13, 2024",MEM vs. NYK,L,33,6,13,0.462,2,8,0.25,0,0,0.0,0,3,3,2,0,0,0,2,14,-1,1,MEM,MEM,NYK,94,,,19,17,16,5
Santi Aldama,F-C,22023,1630583,22300751,"FEB 10, 2024",MEM @ CHA,L,32,5,14,0.357,1,7,0.143,0,2,0.0,1,5,6,3,2,0,0,1,11,-3,1,MEM,CHA,MEM,105,,,20,17,14,9
Santi Aldama,F-C,22023,1630583,22300737,"FEB 08, 2024",MEM vs. CHI,L,37,6,13,0.462,3,8,0.375,0,0,0.0,1,4,5,2,0,0,2,2,15,-7,1,MEM,MEM,CHI,95,,,22,20,17,7
Santi Aldama,F-C,22023,1630583,22300722,"FEB 06, 2024",MEM @ NYK,L,23,4,6,0.667,3,4,0.75,0,0,0.0,0,4,4,5,0,0,2,0,11,-28,1,MEM,NYK,MEM,97,,,20,15,16,9
Santi Aldama,F-C,22023,1630583,22300693,"FEB 02, 2024",MEM vs. GSW,L,21,1,8,0.125,0,6,0.0,0,0,0.0,1,4,5,2,2,0,0,2,2,-3,1,MEM,MEM,GSW,98,,,9,7,4,7
Santi Aldama,F-C,22023,1630583,22300687,"FEB 01, 2024",MEM vs. CLE,L,38,7,12,0.583,4,7,0.571,0,0,0.0,1,8,9,3,0,2,1,0,18,-13,1,MEM,MEM,CLE,86,,,30,27,21,12
Santi Aldama,F-C,22023,1630583,22300663,"JAN 29, 2024",MEM vs. SAC,L,34,5,14,0.357,5,8,0.625,1,1,1.0,2,5,7,2,2,0,2,2,16,-6,1,MEM,MEM,SAC,72,,,25,23,18,9
Santi Aldama,F-C,22023,1630583,22300652,"JAN 28, 2024",MEM @ IND,L,28,4,11,0.364,2,5,0.4,0,0,0.0,1,5,6,1,0,0,1,0,10,-1,1,MEM,IND,MEM,106,,,17,16,11,7
Santi Aldama,F-C,22023,1630583,22300638,"JAN 26, 2024",MEM vs. ORL,W,29,6,9,0.667,2,5,0.4,0,0,0.0,2,5,7,5,0,0,1,2,14,-2,1,MEM,MEM,ORL,107,,,26,21,19,12
Santi Aldama,F-C,22023,1630583,22300609,"JAN 22, 2024",MEM @ TOR,W,23,4,9,0.444,1,4,0.25,1,1,1.0,1,3,4,4,1,0,1,0,10,12,1,MEM,TOR,MEM,108,,,18,14,14,8
Santi Aldama,F-C,22023,1630583,22300597,"JAN 20, 2024",MEM @ CHI,L,28,2,7,0.286,1,5,0.2,0,0,0.0,0,8,8,3,1,2,2,0,5,-25,1,MEM,CHI,MEM,93,,,16,13,8,11
Santi Aldama,F-C,22023,1630583,22300582,"JAN 18, 2024",MEM @ MIN,L,25,5,14,0.357,2,5,0.4,1,3,0.333,0,5,5,0,1,1,2,4,13,-2,1,MEM,MIN,MEM,103,,,18,18,13,5
Santi Aldama,F-C,22023,1630583,22300560,"JAN 15, 2024",MEM vs. GSW,W,17,3,6,0.5,1,4,0.25,4,5,0.8,0,6,6,1,0,3,1,2,11,-6,1,MEM,MEM,GSW,116,,,18,17,12,7
Santi Aldama,F-C,22023,1630583,22300503,"JAN 07, 2024",MEM @ PHX,W,16,2,11,0.182,1,7,0.143,2,3,0.667,2,5,7,1,1,1,4,2,7,-5,1,MEM,PHX,MEM,121,,,15,14,8,8
Santi Aldama,F-C,22023,1630583,22300491,"JAN 05, 2024",MEM @ LAL,W,9,0,0,0.0,0,0,0.0,0,0,0.0,0,0,0,0,1,0,1,0,0,-3,1,MEM,LAL,MEM,127,,,0,0,0,0
Santi Aldama,F-C,22023,1630583,22300470,"JAN 03, 2024",MEM vs. TOR,L,22,2,6,0.333,2,4,0.5,1,2,0.5,1,7,8,3,1,0,1,4,7,2,1,MEM,MEM,TOR,111,,,18,15,10,11
Santi Aldama,F-C,22023,1630583,22300460,"JAN 02, 2024",MEM vs. SAS,W,28,5,6,0.833,1,2,0.5,2,2,1.0,2,9,11,0,0,1,0,1,13,12,1,MEM,MEM,SAS,106,,,24,24,13,11
Santi Aldama,F-C,22023,1630583,22300449,"DEC 31, 2023",MEM vs. SAC,L,14,2,6,0.333,1,5,0.2,0,2,0.0,0,2,2,1,0,0,0,0,5,-13,1,MEM,MEM,SAC,92,,,8,7,6,3
Santi Aldama,F-C,22023,1630583,22300438,"DEC 29, 2023",MEM @ LAC,L,22,5,7,0.714,2,3,0.667,0,0,0.0,1,4,5,1,1,0,0,1,12,0,1,MEM,LAC,MEM,106,,,18,17,13,6
Santi Aldama,F-C,22023,1630583,22300410,"DEC 26, 2023",MEM @ NOP,W,9,0,2,0.0,0,2,0.0,0,0,0.0,0,2,2,0,0,1,0,2,0,-8,1,MEM,NOP,MEM,116,,,2,2,0,2
Santi Aldama,F-C,22023,1630583,22300393,"DEC 23, 2023",MEM @ ATL,W,27,2,7,0.286,1,4,0.25,1,2,0.5,0,4,4,3,0,1,1,0,6,3,1,MEM,ATL,MEM,125,,,13,10,9,7
Santi Aldama,F-C,22023,1630583,22300377,"DEC 21, 2023",MEM vs. IND,W,25,5,7,0.714,3,5,0.6,0,0,0.0,0,3,3,2,1,0,2,0,13,24,1,MEM,MEM,IND,116,,,18,16,15,5
Santi Aldama,F-C,22023,1630583,22300360,"DEC 19, 2023",MEM @ NOP,W,16,3,4,0.75,2,2,1.0,0,0,0.0,2,1,3,0,1,1,0,1,8,-5,1,MEM,NOP,MEM,115,,,11,11,8,3
Santi Aldama,F-C,22023,1630583,22300355,"DEC 18, 2023",MEM @ OKC,L,20,2,10,0.2,2,7,0.286,3,4,0.75,2,7,9,1,0,0,1,1,9,-21,1,MEM,OKC,MEM,97,,,19,18,10,10
Santi Aldama,F-C,22023,1630583,22300332,"DEC 15, 2023",MEM vs. HOU,L,26,4,8,0.5,2,4,0.5,1,2,0.5,2,2,4,0,0,0,2,3,11,-12,1,MEM,MEM,HOU,96,,,15,15,11,4
Santi Aldama,F-C,22023,1630583,22300314,"DEC 13, 2023",MEM @ HOU,L,16,3,4,0.75,1,2,0.5,0,0,0.0,0,5,5,1,0,2,1,4,7,-11,1,MEM,HOU,MEM,104,,,13,12,8,6
Santi Aldama,F-C,22023,1630583,22300299,"DEC 11, 2023",MEM vs. DAL,L,20,2,6,0.333,2,5,0.4,0,0,0.0,0,2,2,3,2,1,1,2,6,-1,1,MEM,MEM,DAL,113,,,11,8,9,5
Santi Aldama,F-C,22023,1630583,22301221,"DEC 08, 2023",MEM vs. MIN,L,24,2,8,0.25,1,3,0.333,4,6,0.667,4,6,10,6,0,1,0,1,9,-11,1,MEM,MEM,MIN,95,,,25,19,15,16
Santi Aldama,F-C,22023,1630583,22301206,"DEC 06, 2023",MEM @ DET,W,26,3,9,0.333,1,3,0.333,0,0,0.0,3,0,3,3,1,1,1,0,7,14,1,MEM,DET,MEM,104,,,13,10,10,6
Santi Aldama,F-C,22023,1630583,22300288,"DEC 02, 2023",MEM @ PHX,L,31,3,10,0.3,1,6,0.167,0,0,0.0,0,7,7,1,3,1,1,5,7,-5,1,MEM,PHX,MEM,101,,,15,14,8,8
Santi Aldama,F-C,22023,1630583,22300277,"DEC 01, 2023",MEM @ DAL,W,33,7,10,0.7,1,4,0.25,2,2,1.0,5,7,12,3,1,1,1,1,17,17,1,MEM,DAL,MEM,89,,,32,29,20,15
Santi Aldama,F-C,22023,1630583,22300261,"NOV 29, 2023",MEM vs. UTA,W,25,4,9,0.444,1,4,0.25,2,4,0.5,2,2,4,1,1,1,1,1,11,7,1,MEM,MEM,UTA,105,,,16,15,12,5
Santi Aldama,F-C,22023,1630583,22300249,"NOV 26, 2023",MEM vs. MIN,L,27,6,15,0.4,1,7,0.143,1,2,0.5,2,5,7,2,0,0,1,0,14,-15,1,MEM,MEM,MIN,91,,,23,21,16,9
Santi Aldama,F-C,22023,1630583,22300044,"NOV 24, 2023",MEM vs. PHX,L,36,9,20,0.45,3,10,0.3,0,0,0.0,1,4,5,0,0,0,0,2,21,-18,1,MEM,MEM,PHX,89,,,26,26,21,5
Santi Aldama,F-C,22023,1630583,22300231,"NOV 22, 2023",MEM @ HOU,L,22,2,5,0.4,1,3,0.333,3,3,1.0,0,2,2,0,0,1,0,5,8,-4,1,MEM,HOU,MEM,91,,,10,10,8,2
Santi Aldama,F-C,22023,1630583,22300213,"NOV 19, 2023",MEM vs. BOS,L,39,11,27,0.407,6,15,0.4,0,0,0.0,4,8,12,6,2,0,1,2,28,4,1,MEM,MEM,BOS,100,,,46,40,34,18
Santi Aldama,F-C,22023,1630583,22300206,"NOV 18, 2023",MEM @ SAS,W,36,7,15,0.467,1,5,0.2,2,3,0.667,2,8,10,3,1,1,3,2,17,19,1,MEM,SAS,MEM,120,,,30,27,20,13
Santi Aldama,F-C,22023,1630583,22300026,"NOV 14, 2023",MEM @ LAL,L,25,9,15,0.6,3,8,0.375,3,5,0.6,0,5,5,4,0,2,3,0,24,-12,1,MEM,LAL,MEM,107,,,33,29,28,9
Santi Aldama,F-C,22023,1630583,22300179,"NOV 12, 2023",MEM @ LAC,W,21,4,8,0.5,1,4,0.25,0,0,0.0,0,3,3,2,0,1,2,1,9,-3,1,MEM,LAC,MEM,105,,,14,12,11,5
Santi Aldama,F-C,22023,1630583,22300012,"NOV 10, 2023",MEM vs. UTA,L,13,2,3,0.667,1,1,1.0,1,2,0.5,0,2,2,0,0,0,0,1,6,2,1,MEM,MEM,UTA,121,,,8,8,6,2
Santi Aldama,F-C,22023,1630583,22300164,"NOV 08, 2023",MEM vs. MIA,L,26,5,14,0.357,2,4,0.5,0,2,0.0,2,6,8,0,2,1,1,4,12,8,1,MEM,MEM,MIA,102,,,20,20,12,8
Santi Aldama,F-C,22023,1630583,22300144,"NOV 05, 2023",MEM @ POR,W,20,3,8,0.375,1,3,0.333,0,0,0.0,1,4,5,3,0,0,2,0,7,-4,1,MEM,POR,MEM,112,,,15,12,10,8
Luguentz Dort,F,22023,1629652,22300682,"JAN 31, 2024",OKC vs. DEN,W,36,3,11,0.273,1,6,0.167,0,1,0.0,0,7,7,1,1,0,1,2,7,3,1,OKC,OKC,DEN,105,10.5,Points,15,14,8,8
Luguentz Dort,F,22023,1629652,22300682,"JAN 31, 2024",OKC vs. DEN,W,36,3,11,0.273,1,6,0.167,0,1,0.0,0,7,7,1,1,0,1,2,7,3,1,OKC,OKC,DEN,105,3.5,Rebounds,15,14,8,8
Luguentz Dort,F,22023,1629652,22300682,"JAN 31, 2024",OKC vs. DEN,W,36,3,11,0.273,1,6,0.167,0,1,0.0,0,7,7,1,1,0,1,2,7,3,1,OKC,OKC,DEN,105,5.0,3-PT Attempted,15,14,8,8
Luguentz Dort,F,22023,1629652,22300682,"JAN 31, 2024",OKC vs. DEN,W,36,3,11,0.273,1,6,0.167,0,1,0.0,0,7,7,1,1,0,1,2,7,3,1,OKC,OKC,DEN,105,14.5,Pts+Rebs,15,14,8,8
Luguentz Dort,F,22023,1629652,22300682,"JAN 31, 2024",OKC vs. DEN,W,36,3,11,0.273,1,6,0.167,0,1,0.0,0,7,7,1,1,0,1,2,7,3,1,OKC,OKC,DEN,105,12.5,Pts+Asts,15,14,8,8
Luguentz Dort,F,22023,1629652,22300622,"JAN 24, 2024",OKC @ SAS,W,25,1,6,0.167,0,5,0.0,0,0,0.0,1,2,3,1,2,1,1,2,2,12,1,OKC,SAS,OKC,140,10.5,Points,6,5,3,4
Luguentz Dort,F,22023,1629652,22300622,"JAN 24, 2024",OKC @ SAS,W,25,1,6,0.167,0,5,0.0,0,0,0.0,1,2,3,1,2,1,1,2,2,12,1,OKC,SAS,OKC,140,3.5,Rebounds,6,5,3,4
Luguentz Dort,F,22023,1629652,22300622,"JAN 24, 2024",OKC @ SAS,W,25,1,6,0.167,0,5,0.0,0,0,0.0,1,2,3,1,2,1,1,2,2,12,1,OKC,SAS,OKC,140,5.0,3-PT Attempted,6,5,3,4
Luguentz Dort,F,22023,1629652,22300622,"JAN 24, 2024",OKC @ SAS,W,25,1,6,0.167,0,5,0.0,0,0,0.0,1,2,3,1,2,1,1,2,2,12,1,OKC,SAS,OKC,140,14.5,Pts+Rebs,6,5,3,4
Luguentz Dort,F,22023,1629652,22300622,"JAN 24, 2024",OKC @ SAS,W,25,1,6,0.167,0,5,0.0,0,0,0.0,1,2,3,1,2,1,1,2,2,12,1,OKC,SAS,OKC,140,12.5,Pts+Asts,6,5,3,4
Luguentz Dort,F,22023,1629652,22300617,"JAN 23, 2024",OKC vs. POR,W,24,2,6,0.333,1,5,0.2,1,2,0.5,1,2,3,1,0,0,3,4,6,15,1,OKC,OKC,POR,111,10.5,Points,10,9,7,4
Luguentz Dort,F,22023,1629652,22300617,"JAN 23, 2024",OKC vs. POR,W,24,2,6,0.333,1,5,0.2,1,2,0.5,1,2,3,1,0,0,3,4,6,15,1,OKC,OKC,POR,111,3.5,Rebounds,10,9,7,4
Luguentz Dort,F,22023,1629652,22300617,"JAN 23, 2024",OKC vs. POR,W,24,2,6,0.333,1,5,0.2,1,2,0.5,1,2,3,1,0,0,3,4,6,15,1,OKC,OKC,POR,111,5.0,3-PT Attempted,10,9,7,4
Luguentz Dort,F,22023,1629652,22300617,"JAN 23, 2024",OKC vs. POR,W,24,2,6,0.333,1,5,0.2,1,2,0.5,1,2,3,1,0,0,3,4,6,15,1,OKC,OKC,POR,111,14.5,Pts+Rebs,10,9,7,4
Luguentz Dort,F,22023,1629652,22300617,"JAN 23, 2024",OKC vs. POR,W,24,2,6,0.333,1,5,0.2,1,2,0.5,1,2,3,1,0,0,3,4,6,15,1,OKC,OKC,POR,111,12.5,Pts+Asts,10,9,7,4
Luguentz Dort,F,22023,1629652,22300481,"JAN 05, 2024",OKC @ BKN,L,28,5,8,0.625,2,5,0.4,0,0,0.0,2,2,4,3,3,0,1,4,12,-5,1,OKC,BKN,OKC,115,10.5,Points,19,16,15,7
Luguentz Dort,F,22023,1629652,22300481,"JAN 05, 2024",OKC @ BKN,L,28,5,8,0.625,2,5,0.4,0,0,0.0,2,2,4,3,3,0,1,4,12,-5,1,OKC,BKN,OKC,115,3.5,Rebounds,19,16,15,7
Luguentz Dort,F,22023,1629652,22300481,"JAN 05, 2024",OKC @ BKN,L,28,5,8,0.625,2,5,0.4,0,0,0.0,2,2,4,3,3,0,1,4,12,-5,1,OKC,BKN,OKC,115,5.0,3-PT Attempted,19,16,15,7
Luguentz Dort,F,22023,1629652,22300481,"JAN 05, 2024",OKC @ BKN,L,28,5,8,0.625,2,5,0.4,0,0,0.0,2,2,4,3,3,0,1,4,12,-5,1,OKC,BKN,OKC,115,14.5,Pts+Rebs,19,16,15,7
Luguentz Dort,F,22023,1629652,22300481,"JAN 05, 2024",OKC @ BKN,L,28,5,8,0.625,2,5,0.4,0,0,0.0,2,2,4,3,3,0,1,4,12,-5,1,OKC,BKN,OKC,115,12.5,Pts+Asts,19,16,15,7
Luguentz Dort,F,22023,1629652,22300419,"DEC 27, 2023",OKC vs. NYK,W,27,2,9,0.222,1,4,0.25,0,0,0.0,0,2,2,2,0,0,0,4,5,13,1,OKC,OKC,NYK,129,10.5,Points,9,7,7,4
Luguentz Dort,F,22023,1629652,22300419,"DEC 27, 2023",OKC vs. NYK,W,27,2,9,0.222,1,4,0.25,0,0,0.0,0,2,2,2,0,0,0,4,5,13,1,OKC,OKC,NYK,129,3.5,Rebounds,9,7,7,4
Luguentz Dort,F,22023,1629652,22300419,"DEC 27, 2023",OKC vs. NYK,W,27,2,9,0.222,1,4,0.25,0,0,0.0,0,2,2,2,0,0,0,4,5,13,1,OKC,OKC,NYK,129,5.0,3-PT Attempted,9,7,7,4
Luguentz Dort,F,22023,1629652,22300419,"DEC 27, 2023",OKC vs. NYK,W,27,2,9,0.222,1,4,0.25,0,0,0.0,0,2,2,2,0,0,0,4,5,13,1,OKC,OKC,NYK,129,14.5,Pts+Rebs,9,7,7,4
Luguentz Dort,F,22023,1629652,22300419,"DEC 27, 2023",OKC vs. NYK,W,27,2,9,0.222,1,4,0.25,0,0,0.0,0,2,2,2,0,0,0,4,5,13,1,OKC,OKC,NYK,129,12.5,Pts+Asts,9,7,7,4
Luguentz Dort,F,22023,1629652,22300397,"DEC 23, 2023",OKC vs. LAL,L,30,3,9,0.333,2,6,0.333,0,0,0.0,1,4,5,0,0,1,2,2,8,-18,1,OKC,OKC,LAL,120,10.5,Points,13,13,8,5
Luguentz Dort,F,22023,1629652,22300397,"DEC 23, 2023",OKC vs. LAL,L,30,3,9,0.333,2,6,0.333,0,0,0.0,1,4,5,0,0,1,2,2,8,-18,1,OKC,OKC,LAL,120,3.5,Rebounds,13,13,8,5
Luguentz Dort,F,22023,1629652,22300397,"DEC 23, 2023",OKC vs. LAL,L,30,3,9,0.333,2,6,0.333,0,0,0.0,1,4,5,0,0,1,2,2,8,-18,1,OKC,OKC,LAL,120,5.0,3-PT Attempted,13,13,8,5
Luguentz Dort,F,22023,1629652,22300397,"DEC 23, 2023",OKC vs. LAL,L,30,3,9,0.333,2,6,0.333,0,0,0.0,1,4,5,0,0,1,2,2,8,-18,1,OKC,OKC,LAL,120,14.5,Pts+Rebs,13,13,8,5
Luguentz Dort,F,22023,1629652,22300397,"DEC 23, 2023",OKC vs. LAL,L,30,3,9,0.333,2,6,0.333,0,0,0.0,1,4,5,0,0,1,2,2,8,-18,1,OKC,OKC,LAL,120,12.5,Pts+Asts,13,13,8,5
Luguentz Dort,F,22023,1629652,22300324,"DEC 14, 2023",OKC @ SAC,L,32,5,8,0.625,3,5,0.6,4,5,0.8,2,2,4,0,3,2,1,4,17,3,1,OKC,SAC,OKC,123,10.5,Points,21,21,17,4
Luguentz Dort,F,22023,1629652,22300324,"DEC 14, 2023",OKC @ SAC,L,32,5,8,0.625,3,5,0.6,4,5,0.8,2,2,4,0,3,2,1,4,17,3,1,OKC,SAC,OKC,123,3.5,Rebounds,21,21,17,4
Luguentz Dort,F,22023,1629652,22300324,"DEC 14, 2023",OKC @ SAC,L,32,5,8,0.625,3,5,0.6,4,5,0.8,2,2,4,0,3,2,1,4,17,3,1,OKC,SAC,OKC,123,5.0,3-PT Attempted,21,21,17,4
Luguentz Dort,F,22023,1629652,22300324,"DEC 14, 2023",OKC @ SAC,L,32,5,8,0.625,3,5,0.6,4,5,0.8,2,2,4,0,3,2,1,4,17,3,1,OKC,SAC,OKC,123,14.5,Pts+Rebs,21,21,17,4
Luguentz Dort,F,22023,1629652,22300324,"DEC 14, 2023",OKC @ SAC,L,32,5,8,0.625,3,5,0.6,4,5,0.8,2,2,4,0,3,2,1,4,17,3,1,OKC,SAC,OKC,123,12.5,Pts+Asts,21,21,17,4
Luguentz Dort,F,22023,1629652,22301222,"DEC 08, 2023",OKC vs. GSW,W,39,4,9,0.444,0,3,0.0,8,8,1.0,4,1,5,1,0,1,1,4,16,6,1,OKC,OKC,GSW,138,10.5,Points,22,21,17,6
Luguentz Dort,F,22023,1629652,22301222,"DEC 08, 2023",OKC vs. GSW,W,39,4,9,0.444,0,3,0.0,8,8,1.0,4,1,5,1,0,1,1,4,16,6,1,OKC,OKC,GSW,138,3.5,Rebounds,22,21,17,6
Luguentz Dort,F,22023,1629652,22301222,"DEC 08, 2023",OKC vs. GSW,W,39,4,9,0.444,0,3,0.0,8,8,1.0,4,1,5,1,0,1,1,4,16,6,1,OKC,OKC,GSW,138,5.0,3-PT Attempted,22,21,17,6
Luguentz Dort,F,22023,1629652,22301222,"DEC 08, 2023",OKC vs. GSW,W,39,4,9,0.444,0,3,0.0,8,8,1.0,4,1,5,1,0,1,1,4,16,6,1,OKC,OKC,GSW,138,14.5,Pts+Rebs,22,21,17,6
Luguentz Dort,F,22023,1629652,22301222,"DEC 08, 2023",OKC vs. GSW,W,39,4,9,0.444,0,3,0.0,8,8,1.0,4,1,5,1,0,1,1,4,16,6,1,OKC,OKC,GSW,138,12.5,Pts+Asts,22,21,17,6
Luguentz Dort,F,22023,1629652,22300287,"DEC 02, 2023",OKC @ DAL,W,33,4,13,0.308,1,6,0.167,1,2,0.5,1,4,5,3,0,0,2,4,10,-10,1,OKC,DAL,OKC,126,10.5,Points,18,15,13,8
Luguentz Dort,F,22023,1629652,22300287,"DEC 02, 2023",OKC @ DAL,W,33,4,13,0.308,1,6,0.167,1,2,0.5,1,4,5,3,0,0,2,4,10,-10,1,OKC,DAL,OKC,126,3.5,Rebounds,18,15,13,8
Luguentz Dort,F,22023,1629652,22300287,"DEC 02, 2023",OKC @ DAL,W,33,4,13,0.308,1,6,0.167,1,2,0.5,1,4,5,3,0,0,2,4,10,-10,1,OKC,DAL,OKC,126,5.0,3-PT Attempted,18,15,13,8
Luguentz Dort,F,22023,1629652,22300287,"DEC 02, 2023",OKC @ DAL,W,33,4,13,0.308,1,6,0.167,1,2,0.5,1,4,5,3,0,0,2,4,10,-10,1,OKC,DAL,OKC,126,14.5,Pts+Rebs,18,15,13,8
Luguentz Dort,F,22023,1629652,22300287,"DEC 02, 2023",OKC @ DAL,W,33,4,13,0.308,1,6,0.167,1,2,0.5,1,4,5,3,0,0,2,4,10,-10,1,OKC,DAL,OKC,126,12.5,Pts+Asts,18,15,13,8
Luguentz Dort,F,22023,1629652,22300239,"NOV 25, 2023",OKC vs. PHI,L,25,2,5,0.4,1,3,0.333,0,1,0.0,1,1,2,0,0,0,1,3,5,-13,1,OKC,OKC,PHI,123,10.5,Points,7,7,5,2
Luguentz Dort,F,22023,1629652,22300239,"NOV 25, 2023",OKC vs. PHI,L,25,2,5,0.4,1,3,0.333,0,1,0.0,1,1,2,0,0,0,1,3,5,-13,1,OKC,OKC,PHI,123,3.5,Rebounds,7,7,5,2
Luguentz Dort,F,22023,1629652,22300239,"NOV 25, 2023",OKC vs. PHI,L,25,2,5,0.4,1,3,0.333,0,1,0.0,1,1,2,0,0,0,1,3,5,-13,1,OKC,OKC,PHI,123,5.0,3-PT Attempted,7,7,5,2
Luguentz Dort,F,22023,1629652,22300239,"NOV 25, 2023",OKC vs. PHI,L,25,2,5,0.4,1,3,0.333,0,1,0.0,1,1,2,0,0,0,1,3,5,-13,1,OKC,OKC,PHI,123,14.5,Pts+Rebs,7,7,5,2
Luguentz Dort,F,22023,1629652,22300239,"NOV 25, 2023",OKC vs. PHI,L,25,2,5,0.4,1,3,0.333,0,1,0.0,1,1,2,0,0,0,1,3,5,-13,1,OKC,OKC,PHI,123,12.5,Pts+Asts,7,7,5,2
Luguentz Dort,F,22023,1629652,22300215,"NOV 19, 2023",OKC @ POR,W,23,4,6,0.667,2,3,0.667,2,2,1.0,0,0,0,1,0,0,0,1,12,27,1,OKC,POR,OKC,134,10.5,Points,13,12,13,1
Luguentz Dort,F,22023,1629652,22300215,"NOV 19, 2023",OKC @ POR,W,23,4,6,0.667,2,3,0.667,2,2,1.0,0,0,0,1,0,0,0,1,12,27,1,OKC,POR,OKC,134,3.5,Rebounds,13,12,13,1
Luguentz Dort,F,22023,1629652,22300215,"NOV 19, 2023",OKC @ POR,W,23,4,6,0.667,2,3,0.667,2,2,1.0,0,0,0,1,0,0,0,1,12,27,1,OKC,POR,OKC,134,5.0,3-PT Attempted,13,12,13,1
Luguentz Dort,F,22023,1629652,22300215,"NOV 19, 2023",OKC @ POR,W,23,4,6,0.667,2,3,0.667,2,2,1.0,0,0,0,1,0,0,0,1,12,27,1,OKC,POR,OKC,134,14.5,Pts+Rebs,13,12,13,1
Luguentz Dort,F,22023,1629652,22300215,"NOV 19, 2023",OKC @ POR,W,23,4,6,0.667,2,3,0.667,2,2,1.0,0,0,0,1,0,0,0,1,12,27,1,OKC,POR,OKC,134,12.5,Pts+Asts,13,12,13,1
Luguentz Dort,F,22023,1629652,22300185,"NOV 12, 2023",OKC @ PHX,W,33,3,10,0.3,0,5,0.0,3,4,0.75,2,4,6,1,2,1,0,5,9,8,1,OKC,PHX,OKC,111,10.5,Points,16,15,10,7
Luguentz Dort,F,22023,1629652,22300185,"NOV 12, 2023",OKC @ PHX,W,33,3,10,0.3,0,5,0.0,3,4,0.75,2,4,6,1,2,1,0,5,9,8,1,OKC,PHX,OKC,111,3.5,Rebounds,16,15,10,7
Luguentz Dort,F,22023,1629652,22300185,"NOV 12, 2023",OKC @ PHX,W,33,3,10,0.3,0,5,0.0,3,4,0.75,2,4,6,1,2,1,0,5,9,8,1,OKC,PHX,OKC,111,5.0,3-PT Attempted,16,15,10,7
Luguentz Dort,F,22023,1629652,22300185,"NOV 12, 2023",OKC @ PHX,W,33,3,10,0.3,0,5,0.0,3,4,0.75,2,4,6,1,2,1,0,5,9,8,1,OKC,PHX,OKC,111,14.5,Pts+Rebs,16,15,10,7
Luguentz Dort,F,22023,1629652,22300185,"NOV 12, 2023",OKC @ PHX,W,33,3,10,0.3,0,5,0.0,3,4,0.75,2,4,6,1,2,1,0,5,9,8,1,OKC,PHX,OKC,111,12.5,Pts+Asts,16,15,10,7
Luguentz Dort,F,22023,1629652,22300167,"NOV 08, 2023",OKC vs. CLE,W,36,3,9,0.333,3,5,0.6,5,6,0.833,1,3,4,3,2,3,3,3,14,-5,1,OKC,OKC,CLE,128,10.5,Points,21,18,17,7
Luguentz Dort,F,22023,1629652,22300167,"NOV 08, 2023",OKC vs. CLE,W,36,3,9,0.333,3,5,0.6,5,6,0.833,1,3,4,3,2,3,3,3,14,-5,1,OKC,OKC,CLE,128,3.5,Rebounds,21,18,17,7
Luguentz Dort,F,22023,1629652,22300167,"NOV 08, 2023",OKC vs. CLE,W,36,3,9,0.333,3,5,0.6,5,6,0.833,1,3,4,3,2,3,3,3,14,-5,1,OKC,OKC,CLE,128,5.0,3-PT Attempted,21,18,17,7
Luguentz Dort,F,22023,1629652,22300167,"NOV 08, 2023",OKC vs. CLE,W,36,3,9,0.333,3,5,0.6,5,6,0.833,1,3,4,3,2,3,3,3,14,-5,1,OKC,OKC,CLE,128,14.5,Pts+Rebs,21,18,17,7
Luguentz Dort,F,22023,1629652,22300167,"NOV 08, 2023",OKC vs. CLE,W,36,3,9,0.333,3,5,0.6,5,6,0.833,1,3,4,3,2,3,3,3,14,-5,1,OKC,OKC,CLE,128,12.5,Pts+Asts,21,18,17,7
Luguentz Dort,F,22023,1629652,22300109,"OCT 30, 2023",OKC vs. DET,W,26,3,7,0.429,1,4,0.25,0,0,0.0,0,2,2,0,2,1,0,1,7,12,1,OKC,OKC,DET,124,10.5,Points,9,9,7,2
Luguentz Dort,F,22023,1629652,22300109,"OCT 30, 2023",OKC vs. DET,W,26,3,7,0.429,1,4,0.25,0,0,0.0,0,2,2,0,2,1,0,1,7,12,1,OKC,OKC,DET,124,3.5,Rebounds,9,9,7,2
Luguentz Dort,F,22023,1629652,22300109,"OCT 30, 2023",OKC vs. DET,W,26,3,7,0.429,1,4,0.25,0,0,0.0,0,2,2,0,2,1,0,1,7,12,1,OKC,OKC,DET,124,5.0,3-PT Attempted,9,9,7,2
Luguentz Dort,F,22023,1629652,22300109,"OCT 30, 2023",OKC vs. DET,W,26,3,7,0.429,1,4,0.25,0,0,0.0,0,2,2,0,2,1,0,1,7,12,1,OKC,OKC,DET,124,14.5,Pts+Rebs,9,9,7,2
Luguentz Dort,F,22023,1629652,22300109,"OCT 30, 2023",OKC vs. DET,W,26,3,7,0.429,1,4,0.25,0,0,0.0,0,2,2,0,2,1,0,1,7,12,1,OKC,OKC,DET,124,12.5,Pts+Asts,9,9,7,2
Luguentz Dort,F,22023,1629652,22300748,"FEB 10, 2024",OKC @ DAL,L,18,2,7,0.286,1,6,0.167,0,0,0.0,0,0,0,2,0,0,2,3,5,-8,1,OKC,DAL,OKC,111,10.5,Points,7,5,7,2
Luguentz Dort,F,22023,1629652,22300748,"FEB 10, 2024",OKC @ DAL,L,18,2,7,0.286,1,6,0.167,0,0,0.0,0,0,0,2,0,0,2,3,5,-8,1,OKC,DAL,OKC,111,3.5,Rebounds,7,5,7,2
Luguentz Dort,F,22023,1629652,22300748,"FEB 10, 2024",OKC @ DAL,L,18,2,7,0.286,1,6,0.167,0,0,0.0,0,0,0,2,0,0,2,3,5,-8,1,OKC,DAL,OKC,111,5.0,3-PT Attempted,7,5,7,2
Luguentz Dort,F,22023,1629652,22300748,"FEB 10, 2024",OKC @ DAL,L,18,2,7,0.286,1,6,0.167,0,0,0.0,0,0,0,2,0,0,2,3,5,-8,1,OKC,DAL,OKC,111,14.5,Pts+Rebs,7,5,7,2
Luguentz Dort,F,22023,1629652,22300748,"FEB 10, 2024",OKC @ DAL,L,18,2,7,0.286,1,6,0.167,0,0,0.0,0,0,0,2,0,0,2,3,5,-8,1,OKC,DAL,OKC,111,12.5,Pts+Asts,7,5,7,2
Luguentz Dort,F,22023,1629652,22300724,"FEB 06, 2024",OKC @ UTA,L,30,3,8,0.375,2,5,0.4,2,3,0.667,0,1,1,1,1,1,0,5,10,-12,1,OKC,UTA,OKC,117,10.5,Points,12,11,11,2
Luguentz Dort,F,22023,1629652,22300724,"FEB 06, 2024",OKC @ UTA,L,30,3,8,0.375,2,5,0.4,2,3,0.667,0,1,1,1,1,1,0,5,10,-12,1,OKC,UTA,OKC,117,3.5,Rebounds,12,11,11,2
Luguentz Dort,F,22023,1629652,22300724,"FEB 06, 2024",OKC @ UTA,L,30,3,8,0.375,2,5,0.4,2,3,0.667,0,1,1,1,1,1,0,5,10,-12,1,OKC,UTA,OKC,117,5.0,3-PT Attempted,12,11,11,2
Luguentz Dort,F,22023,1629652,22300724,"FEB 06, 2024",OKC @ UTA,L,30,3,8,0.375,2,5,0.4,2,3,0.667,0,1,1,1,1,1,0,5,10,-12,1,OKC,UTA,OKC,117,14.5,Pts+Rebs,12,11,11,2
Luguentz Dort,F,22023,1629652,22300724,"FEB 06, 2024",OKC @ UTA,L,30,3,8,0.375,2,5,0.4,2,3,0.667,0,1,1,1,1,1,0,5,10,-12,1,OKC,UTA,OKC,117,12.5,Pts+Asts,12,11,11,2
Luguentz Dort,F,22023,1629652,22300710,"FEB 04, 2024",OKC vs. TOR,W,41,8,19,0.421,5,12,0.417,1,1,1.0,2,5,7,4,1,0,2,2,22,7,1,OKC,OKC,TOR,135,10.5,Points,33,29,26,11
Luguentz Dort,F,22023,1629652,22300710,"FEB 04, 2024",OKC vs. TOR,W,41,8,19,0.421,5,12,0.417,1,1,1.0,2,5,7,4,1,0,2,2,22,7,1,OKC,OKC,TOR,135,3.5,Rebounds,33,29,26,11
Luguentz Dort,F,22023,1629652,22300710,"FEB 04, 2024",OKC vs. TOR,W,41,8,19,0.421,5,12,0.417,1,1,1.0,2,5,7,4,1,0,2,2,22,7,1,OKC,OKC,TOR,135,5.0,3-PT Attempted,33,29,26,11
Luguentz Dort,F,22023,1629652,22300710,"FEB 04, 2024",OKC vs. TOR,W,41,8,19,0.421,5,12,0.417,1,1,1.0,2,5,7,4,1,0,2,2,22,7,1,OKC,OKC,TOR,135,14.5,Pts+Rebs,33,29,26,11
Luguentz Dort,F,22023,1629652,22300710,"FEB 04, 2024",OKC vs. TOR,W,41,8,19,0.421,5,12,0.417,1,1,1.0,2,5,7,4,1,0,2,2,22,7,1,OKC,OKC,TOR,135,12.5,Pts+Asts,33,29,26,11
Luguentz Dort,F,22023,1629652,22300695,"FEB 02, 2024",OKC vs. CHA,W,19,3,4,0.75,2,3,0.667,0,0,0.0,1,1,2,1,0,1,0,3,8,16,1,OKC,OKC,CHA,126,10.5,Points,11,10,9,3
Luguentz Dort,F,22023,1629652,22300695,"FEB 02, 2024",OKC vs. CHA,W,19,3,4,0.75,2,3,0.667,0,0,0.0,1,1,2,1,0,1,0,3,8,16,1,OKC,OKC,CHA,126,3.5,Rebounds,11,10,9,3
Luguentz Dort,F,22023,1629652,22300695,"FEB 02, 2024",OKC vs. CHA,W,19,3,4,0.75,2,3,0.667,0,0,0.0,1,1,2,1,0,1,0,3,8,16,1,OKC,OKC,CHA,126,5.0,3-PT Attempted,11,10,9,3
Luguentz Dort,F,22023,1629652,22300695,"FEB 02, 2024",OKC vs. CHA,W,19,3,4,0.75,2,3,0.667,0,0,0.0,1,1,2,1,0,1,0,3,8,16,1,OKC,OKC,CHA,126,14.5,Pts+Rebs,11,10,9,3
Luguentz Dort,F,22023,1629652,22300695,"FEB 02, 2024",OKC vs. CHA,W,19,3,4,0.75,2,3,0.667,0,0,0.0,1,1,2,1,0,1,0,3,8,16,1,OKC,OKC,CHA,126,12.5,Pts+Asts,11,10,9,3
Luguentz Dort,F,22023,1629652,22300568,"JAN 16, 2024",OKC @ LAC,L,33,6,10,0.6,5,8,0.625,2,2,1.0,0,1,1,1,0,0,3,2,19,-15,1,OKC,LAC,OKC,117,10.5,Points,21,20,20,2
Luguentz Dort,F,22023,1629652,22300568,"JAN 16, 2024",OKC @ LAC,L,33,6,10,0.6,5,8,0.625,2,2,1.0,0,1,1,1,0,0,3,2,19,-15,1,OKC,LAC,OKC,117,3.5,Rebounds,21,20,20,2
Luguentz Dort,F,22023,1629652,22300568,"JAN 16, 2024",OKC @ LAC,L,33,6,10,0.6,5,8,0.625,2,2,1.0,0,1,1,1,0,0,3,2,19,-15,1,OKC,LAC,OKC,117,5.0,3-PT Attempted,21,20,20,2
Luguentz Dort,F,22023,1629652,22300568,"JAN 16, 2024",OKC @ LAC,L,33,6,10,0.6,5,8,0.625,2,2,1.0,0,1,1,1,0,0,3,2,19,-15,1,OKC,LAC,OKC,117,14.5,Pts+Rebs,21,20,20,2
Luguentz Dort,F,22023,1629652,22300568,"JAN 16, 2024",OKC @ LAC,L,33,6,10,0.6,5,8,0.625,2,2,1.0,0,1,1,1,0,0,3,2,19,-15,1,OKC,LAC,OKC,117,12.5,Pts+Asts,21,20,20,2
Luguentz Dort,F,22023,1629652,22300565,"JAN 15, 2024",OKC @ LAL,L,29,4,9,0.444,3,8,0.375,0,0,0.0,4,3,7,1,1,0,1,2,11,-2,1,OKC,LAL,OKC,105,10.5,Points,19,18,12,8
Luguentz Dort,F,22023,1629652,22300565,"JAN 15, 2024",OKC @ LAL,L,29,4,9,0.444,3,8,0.375,0,0,0.0,4,3,7,1,1,0,1,2,11,-2,1,OKC,LAL,OKC,105,3.5,Rebounds,19,18,12,8
Luguentz Dort,F,22023,1629652,22300565,"JAN 15, 2024",OKC @ LAL,L,29,4,9,0.444,3,8,0.375,0,0,0.0,4,3,7,1,1,0,1,2,11,-2,1,OKC,LAL,OKC,105,5.0,3-PT Attempted,19,18,12,8
Luguentz Dort,F,22023,1629652,22300565,"JAN 15, 2024",OKC @ LAL,L,29,4,9,0.444,3,8,0.375,0,0,0.0,4,3,7,1,1,0,1,2,11,-2,1,OKC,LAL,OKC,105,14.5,Pts+Rebs,19,18,12,8
Luguentz Dort,F,22023,1629652,22300565,"JAN 15, 2024",OKC @ LAL,L,29,4,9,0.444,3,8,0.375,0,0,0.0,4,3,7,1,1,0,1,2,11,-2,1,OKC,LAL,OKC,105,12.5,Pts+Asts,19,18,12,8
Luguentz Dort,F,22023,1629652,22300546,"JAN 13, 2024",OKC vs. ORL,W,32,4,8,0.5,2,5,0.4,2,2,1.0,1,2,3,2,1,1,1,5,12,0,1,OKC,OKC,ORL,112,10.5,Points,17,15,14,5
Luguentz Dort,F,22023,1629652,22300546,"JAN 13, 2024",OKC vs. ORL,W,32,4,8,0.5,2,5,0.4,2,2,1.0,1,2,3,2,1,1,1,5,12,0,1,OKC,OKC,ORL,112,3.5,Rebounds,17,15,14,5
Luguentz Dort,F,22023,1629652,22300546,"JAN 13, 2024",OKC vs. ORL,W,32,4,8,0.5,2,5,0.4,2,2,1.0,1,2,3,2,1,1,1,5,12,0,1,OKC,OKC,ORL,112,5.0,3-PT Attempted,17,15,14,5
Luguentz Dort,F,22023,1629652,22300546,"JAN 13, 2024",OKC vs. ORL,W,32,4,8,0.5,2,5,0.4,2,2,1.0,1,2,3,2,1,1,1,5,12,0,1,OKC,OKC,ORL,112,14.5,Pts+Rebs,17,15,14,5
Luguentz Dort,F,22023,1629652,22300546,"JAN 13, 2024",OKC vs. ORL,W,32,4,8,0.5,2,5,0.4,2,2,1.0,1,2,3,2,1,1,1,5,12,0,1,OKC,OKC,ORL,112,12.5,Pts+Asts,17,15,14,5
Luguentz Dort,F,22023,1629652,22300529,"JAN 11, 2024",OKC vs. POR,W,19,3,7,0.429,3,5,0.6,2,2,1.0,0,3,3,1,1,1,1,2,11,45,1,OKC,OKC,POR,139,10.5,Points,15,14,12,4
Luguentz Dort,F,22023,1629652,22300529,"JAN 11, 2024",OKC vs. POR,W,19,3,7,0.429,3,5,0.6,2,2,1.0,0,3,3,1,1,1,1,2,11,45,1,OKC,OKC,POR,139,3.5,Rebounds,15,14,12,4
Luguentz Dort,F,22023,1629652,22300529,"JAN 11, 2024",OKC vs. POR,W,19,3,7,0.429,3,5,0.6,2,2,1.0,0,3,3,1,1,1,1,2,11,45,1,OKC,OKC,POR,139,5.0,3-PT Attempted,15,14,12,4
Luguentz Dort,F,22023,1629652,22300529,"JAN 11, 2024",OKC vs. POR,W,19,3,7,0.429,3,5,0.6,2,2,1.0,0,3,3,1,1,1,1,2,11,45,1,OKC,OKC,POR,139,14.5,Pts+Rebs,15,14,12,4
Luguentz Dort,F,22023,1629652,22300529,"JAN 11, 2024",OKC vs. POR,W,19,3,7,0.429,3,5,0.6,2,2,1.0,0,3,3,1,1,1,1,2,11,45,1,OKC,OKC,POR,139,12.5,Pts+Asts,15,14,12,4
Luguentz Dort,F,22023,1629652,22300379,"DEC 21, 2023",OKC vs. LAC,W,31,8,12,0.667,3,6,0.5,2,2,1.0,1,2,3,4,0,1,0,2,21,20,1,OKC,OKC,LAC,134,10.5,Points,28,24,25,7
Luguentz Dort,F,22023,1629652,22300379,"DEC 21, 2023",OKC vs. LAC,W,31,8,12,0.667,3,6,0.5,2,2,1.0,1,2,3,4,0,1,0,2,21,20,1,OKC,OKC,LAC,134,3.5,Rebounds,28,24,25,7
Luguentz Dort,F,22023,1629652,22300379,"DEC 21, 2023",OKC vs. LAC,W,31,8,12,0.667,3,6,0.5,2,2,1.0,1,2,3,4,0,1,0,2,21,20,1,OKC,OKC,LAC,134,5.0,3-PT Attempted,28,24,25,7
Luguentz Dort,F,22023,1629652,22300379,"DEC 21, 2023",OKC vs. LAC,W,31,8,12,0.667,3,6,0.5,2,2,1.0,1,2,3,4,0,1,0,2,21,20,1,OKC,OKC,LAC,134,14.5,Pts+Rebs,28,24,25,7
Luguentz Dort,F,22023,1629652,22300379,"DEC 21, 2023",OKC vs. LAC,W,31,8,12,0.667,3,6,0.5,2,2,1.0,1,2,3,4,0,1,0,2,21,20,1,OKC,OKC,LAC,134,12.5,Pts+Asts,28,24,25,7
Luguentz Dort,F,22023,1629652,22300355,"DEC 18, 2023",OKC vs. MEM,W,21,4,7,0.571,3,6,0.5,0,0,0.0,0,2,2,2,0,1,0,2,11,24,1,OKC,OKC,MEM,116,10.5,Points,15,13,13,4
Luguentz Dort,F,22023,1629652,22300355,"DEC 18, 2023",OKC vs. MEM,W,21,4,7,0.571,3,6,0.5,0,0,0.0,0,2,2,2,0,1,0,2,11,24,1,OKC,OKC,MEM,116,3.5,Rebounds,15,13,13,4
Luguentz Dort,F,22023,1629652,22300355,"DEC 18, 2023",OKC vs. MEM,W,21,4,7,0.571,3,6,0.5,0,0,0.0,0,2,2,2,0,1,0,2,11,24,1,OKC,OKC,MEM,116,5.0,3-PT Attempted,15,13,13,4
Luguentz Dort,F,22023,1629652,22300355,"DEC 18, 2023",OKC vs. MEM,W,21,4,7,0.571,3,6,0.5,0,0,0.0,0,2,2,2,0,1,0,2,11,24,1,OKC,OKC,MEM,116,14.5,Pts+Rebs,15,13,13,4
Luguentz Dort,F,22023,1629652,22300355,"DEC 18, 2023",OKC vs. MEM,W,21,4,7,0.571,3,6,0.5,0,0,0.0,0,2,2,2,0,1,0,2,11,24,1,OKC,OKC,MEM,116,12.5,Pts+Asts,15,13,13,4
Luguentz Dort,F,22023,1629652,22300340,"DEC 16, 2023",OKC @ DEN,W,26,4,8,0.5,2,3,0.667,3,4,0.75,2,2,4,2,0,0,0,4,13,5,1,OKC,DEN,OKC,118,10.5,Points,19,17,15,6
Luguentz Dort,F,22023,1629652,22300340,"DEC 16, 2023",OKC @ DEN,W,26,4,8,0.5,2,3,0.667,3,4,0.75,2,2,4,2,0,0,0,4,13,5,1,OKC,DEN,OKC,118,3.5,Rebounds,19,17,15,6
Luguentz Dort,F,22023,1629652,22300340,"DEC 16, 2023",OKC @ DEN,W,26,4,8,0.5,2,3,0.667,3,4,0.75,2,2,4,2,0,0,0,4,13,5,1,OKC,DEN,OKC,118,5.0,3-PT Attempted,19,17,15,6
Luguentz Dort,F,22023,1629652,22300340,"DEC 16, 2023",OKC @ DEN,W,26,4,8,0.5,2,3,0.667,3,4,0.75,2,2,4,2,0,0,0,4,13,5,1,OKC,DEN,OKC,118,14.5,Pts+Rebs,19,17,15,6
Luguentz Dort,F,22023,1629652,22300340,"DEC 16, 2023",OKC @ DEN,W,26,4,8,0.5,2,3,0.667,3,4,0.75,2,2,4,2,0,0,0,4,13,5,1,OKC,DEN,OKC,118,12.5,Pts+Asts,19,17,15,6
Luguentz Dort,F,22023,1629652,22300058,"NOV 28, 2023",OKC @ MIN,L,25,1,5,0.2,1,2,0.5,0,0,0.0,0,3,3,1,0,0,1,5,3,-6,1,OKC,MIN,OKC,103,10.5,Points,7,6,4,4
Luguentz Dort,F,22023,1629652,22300058,"NOV 28, 2023",OKC @ MIN,L,25,1,5,0.2,1,2,0.5,0,0,0.0,0,3,3,1,0,0,1,5,3,-6,1,OKC,MIN,OKC,103,3.5,Rebounds,7,6,4,4
Luguentz Dort,F,22023,1629652,22300058,"NOV 28, 2023",OKC @ MIN,L,25,1,5,0.2,1,2,0.5,0,0,0.0,0,3,3,1,0,0,1,5,3,-6,1,OKC,MIN,OKC,103,5.0,3-PT Attempted,7,6,4,4
Luguentz Dort,F,22023,1629652,22300058,"NOV 28, 2023",OKC @ MIN,L,25,1,5,0.2,1,2,0.5,0,0,0.0,0,3,3,1,0,0,1,5,3,-6,1,OKC,MIN,OKC,103,14.5,Pts+Rebs,7,6,4,4
Luguentz Dort,F,22023,1629652,22300058,"NOV 28, 2023",OKC @ MIN,L,25,1,5,0.2,1,2,0.5,0,0,0.0,0,3,3,1,0,0,1,5,3,-6,1,OKC,MIN,OKC,103,12.5,Pts+Asts,7,6,4,4
Luguentz Dort,F,22023,1629652,22300016,"NOV 10, 2023",OKC @ SAC,L,25,2,5,0.4,2,3,0.667,2,2,1.0,2,4,6,2,3,1,2,4,8,-11,1,OKC,SAC,OKC,98,10.5,Points,16,14,10,8
Luguentz Dort,F,22023,1629652,22300016,"NOV 10, 2023",OKC @ SAC,L,25,2,5,0.4,2,3,0.667,2,2,1.0,2,4,6,2,3,1,2,4,8,-11,1,OKC,SAC,OKC,98,3.5,Rebounds,16,14,10,8
Luguentz Dort,F,22023,1629652,22300016,"NOV 10, 2023",OKC @ SAC,L,25,2,5,0.4,2,3,0.667,2,2,1.0,2,4,6,2,3,1,2,4,8,-11,1,OKC,SAC,OKC,98,5.0,3-PT Attempted,16,14,10,8
Luguentz Dort,F,22023,1629652,22300016,"NOV 10, 2023",OKC @ SAC,L,25,2,5,0.4,2,3,0.667,2,2,1.0,2,4,6,2,3,1,2,4,8,-11,1,OKC,SAC,OKC,98,14.5,Pts+Rebs,16,14,10,8
Luguentz Dort,F,22023,1629652,22300016,"NOV 10, 2023",OKC @ SAC,L,25,2,5,0.4,2,3,0.667,2,2,1.0,2,4,6,2,3,1,2,4,8,-11,1,OKC,SAC,OKC,98,12.5,Pts+Asts,16,14,10,8
Luguentz Dort,F,22023,1629652,22300155,"NOV 06, 2023",OKC vs. ATL,W,32,6,10,0.6,2,5,0.4,5,5,1.0,2,7,9,3,0,2,2,1,19,7,1,OKC,OKC,ATL,126,10.5,Points,31,28,22,12
Luguentz Dort,F,22023,1629652,22300155,"NOV 06, 2023",OKC vs. ATL,W,32,6,10,0.6,2,5,0.4,5,5,1.0,2,7,9,3,0,2,2,1,19,7,1,OKC,OKC,ATL,126,3.5,Rebounds,31,28,22,12
Luguentz Dort,F,22023,1629652,22300155,"NOV 06, 2023",OKC vs. ATL,W,32,6,10,0.6,2,5,0.4,5,5,1.0,2,7,9,3,0,2,2,1,19,7,1,OKC,OKC,ATL,126,5.0,3-PT Attempted,31,28,22,12
Luguentz Dort,F,22023,1629652,22300155,"NOV 06, 2023",OKC vs. ATL,W,32,6,10,0.6,2,5,0.4,5,5,1.0,2,7,9,3,0,2,2,1,19,7,1,OKC,OKC,ATL,126,14.5,Pts+Rebs,31,28,22,12
Luguentz Dort,F,22023,1629652,22300155,"NOV 06, 2023",OKC vs. ATL,W,32,6,10,0.6,2,5,0.4,5,5,1.0,2,7,9,3,0,2,2,1,19,7,1,OKC,OKC,ATL,126,12.5,Pts+Asts,31,28,22,12
Luguentz Dort,F,22023,1629652,22300005,"NOV 03, 2023",OKC vs. GSW,L,30,9,12,0.75,6,6,1.0,5,7,0.714,2,3,5,0,0,0,1,4,29,-5,1,OKC,OKC,GSW,139,10.5,Points,34,34,29,5
Luguentz Dort,F,22023,1629652,22300005,"NOV 03, 2023",OKC vs. GSW,L,30,9,12,0.75,6,6,1.0,5,7,0.714,2,3,5,0,0,0,1,4,29,-5,1,OKC,OKC,GSW,139,3.5,Rebounds,34,34,29,5
Luguentz Dort,F,22023,1629652,22300005,"NOV 03, 2023",OKC vs. GSW,L,30,9,12,0.75,6,6,1.0,5,7,0.714,2,3,5,0,0,0,1,4,29,-5,1,OKC,OKC,GSW,139,5.0,3-PT Attempted,34,34,29,5
Luguentz Dort,F,22023,1629652,22300005,"NOV 03, 2023",OKC vs. GSW,L,30,9,12,0.75,6,6,1.0,5,7,0.714,2,3,5,0,0,0,1,4,29,-5,1,OKC,OKC,GSW,139,14.5,Pts+Rebs,34,34,29,5
Luguentz Dort,F,22023,1629652,22300005,"NOV 03, 2023",OKC vs. GSW,L,30,9,12,0.75,6,6,1.0,5,7,0.714,2,3,5,0,0,0,1,4,29,-5,1,OKC,OKC,GSW,139,12.5,Pts+Asts,34,34,29,5
Luguentz Dort,F,22023,1629652,22300121,"NOV 01, 2023",OKC vs. NOP,L,30,3,7,0.429,3,6,0.5,0,0,0.0,1,1,2,0,1,0,1,4,9,-3,1,OKC,OKC,NOP,106,10.5,Points,11,11,9,2
Luguentz Dort,F,22023,1629652,22300121,"NOV 01, 2023",OKC vs. NOP,L,30,3,7,0.429,3,6,0.5,0,0,0.0,1,1,2,0,1,0,1,4,9,-3,1,OKC,OKC,NOP,106,3.5,Rebounds,11,11,9,2
Luguentz Dort,F,22023,1629652,22300121,"NOV 01, 2023",OKC vs. NOP,L,30,3,7,0.429,3,6,0.5,0,0,0.0,1,1,2,0,1,0,1,4,9,-3,1,OKC,OKC,NOP,106,5.0,3-PT Attempted,11,11,9,2
Luguentz Dort,F,22023,1629652,22300121,"NOV 01, 2023",OKC vs. NOP,L,30,3,7,0.429,3,6,0.5,0,0,0.0,1,1,2,0,1,0,1,4,9,-3,1,OKC,OKC,NOP,106,14.5,Pts+Rebs,11,11,9,2
Luguentz Dort,F,22023,1629652,22300121,"NOV 01, 2023",OKC vs. NOP,L,30,3,7,0.429,3,6,0.5,0,0,0.0,1,1,2,0,1,0,1,4,9,-3,1,OKC,OKC,NOP,106,12.5,Pts+Asts,11,11,9,2
Luguentz Dort,F,22023,1629652,22300095,"OCT 29, 2023",OKC vs. DEN,L,21,3,7,0.429,1,5,0.2,3,3,1.0,1,0,1,0,1,1,0,2,10,-18,1,OKC,OKC,DEN,95,10.5,Points,11,11,10,1
Luguentz Dort,F,22023,1629652,22300095,"OCT 29, 2023",OKC vs. DEN,L,21,3,7,0.429,1,5,0.2,3,3,1.0,1,0,1,0,1,1,0,2,10,-18,1,OKC,OKC,DEN,95,3.5,Rebounds,11,11,10,1
Luguentz Dort,F,22023,1629652,22300095,"OCT 29, 2023",OKC vs. DEN,L,21,3,7,0.429,1,5,0.2,3,3,1.0,1,0,1,0,1,1,0,2,10,-18,1,OKC,OKC,DEN,95,5.0,3-PT Attempted,11,11,10,1
Luguentz Dort,F,22023,1629652,22300095,"OCT 29, 2023",OKC vs. DEN,L,21,3,7,0.429,1,5,0.2,3,3,1.0,1,0,1,0,1,1,0,2,10,-18,1,OKC,OKC,DEN,95,14.5,Pts+Rebs,11,11,10,1
Luguentz Dort,F,22023,1629652,22300095,"OCT 29, 2023",OKC vs. DEN,L,21,3,7,0.429,1,5,0.2,3,3,1.0,1,0,1,0,1,1,0,2,10,-18,1,OKC,OKC,DEN,95,12.5,Pts+Asts,11,11,10,1
Luguentz Dort,F,22023,1629652,22300081,"OCT 27, 2023",OKC @ CLE,W,39,9,13,0.692,3,4,0.75,4,6,0.667,3,3,6,2,1,1,1,5,25,-6,1,OKC,CLE,OKC,108,10.5,Points,33,31,27,8
Luguentz Dort,F,22023,1629652,22300081,"OCT 27, 2023",OKC @ CLE,W,39,9,13,0.692,3,4,0.75,4,6,0.667,3,3,6,2,1,1,1,5,25,-6,1,OKC,CLE,OKC,108,3.5,Rebounds,33,31,27,8
Luguentz Dort,F,22023,1629652,22300081,"OCT 27, 2023",OKC @ CLE,W,39,9,13,0.692,3,4,0.75,4,6,0.667,3,3,6,2,1,1,1,5,25,-6,1,OKC,CLE,OKC,108,5.0,3-PT Attempted,33,31,27,8
Luguentz Dort,F,22023,1629652,22300081,"OCT 27, 2023",OKC @ CLE,W,39,9,13,0.692,3,4,0.75,4,6,0.667,3,3,6,2,1,1,1,5,25,-6,1,OKC,CLE,OKC,108,14.5,Pts+Rebs,33,31,27,8
Luguentz Dort,F,22023,1629652,22300081,"OCT 27, 2023",OKC @ CLE,W,39,9,13,0.692,3,4,0.75,4,6,0.667,3,3,6,2,1,1,1,5,25,-6,1,OKC,CLE,OKC,108,12.5,Pts+Asts,33,31,27,8
Luguentz Dort,F,22023,1629652,22300070,"OCT 25, 2023",OKC @ CHI,W,33,3,8,0.375,2,5,0.4,0,0,0.0,0,7,7,2,2,1,2,1,8,13,1,OKC,CHI,OKC,124,10.5,Points,17,15,10,9
Luguentz Dort,F,22023,1629652,22300070,"OCT 25, 2023",OKC @ CHI,W,33,3,8,0.375,2,5,0.4,0,0,0.0,0,7,7,2,2,1,2,1,8,13,1,OKC,CHI,OKC,124,3.5,Rebounds,17,15,10,9
Luguentz Dort,F,22023,1629652,22300070,"OCT 25, 2023",OKC @ CHI,W,33,3,8,0.375,2,5,0.4,0,0,0.0,0,7,7,2,2,1,2,1,8,13,1,OKC,CHI,OKC,124,5.0,3-PT Attempted,17,15,10,9
Luguentz Dort,F,22023,1629652,22300070,"OCT 25, 2023",OKC @ CHI,W,33,3,8,0.375,2,5,0.4,0,0,0.0,0,7,7,2,2,1,2,1,8,13,1,OKC,CHI,OKC,124,14.5,Pts+Rebs,17,15,10,9
Luguentz Dort,F,22023,1629652,22300070,"OCT 25, 2023",OKC @ CHI,W,33,3,8,0.375,2,5,0.4,0,0,0.0,0,7,7,2,2,1,2,1,8,13,1,OKC,CHI,OKC,124,12.5,Pts+Asts,17,15,10,9
Luguentz Dort,F,22023,1629652,22300664,"JAN 29, 2024",OKC vs. MIN,L,25,0,7,0.0,0,6,0.0,2,2,1.0,0,3,3,1,0,0,0,2,2,0,1,OKC,OKC,MIN,101,10.5,Points,6,5,3,4
Luguentz Dort,F,22023,1629652,22300664,"JAN 29, 2024",OKC vs. MIN,L,25,0,7,0.0,0,6,0.0,2,2,1.0,0,3,3,1,0,0,0,2,2,0,1,OKC,OKC,MIN,101,3.5,Rebounds,6,5,3,4
Luguentz Dort,F,22023,1629652,22300664,"JAN 29, 2024",OKC vs. MIN,L,25,0,7,0.0,0,6,0.0,2,2,1.0,0,3,3,1,0,0,0,2,2,0,1,OKC,OKC,MIN,101,5.0,3-PT Attempted,6,5,3,4
Luguentz Dort,F,22023,1629652,22300664,"JAN 29, 2024",OKC vs. MIN,L,25,0,7,0.0,0,6,0.0,2,2,1.0,0,3,3,1,0,0,0,2,2,0,1,OKC,OKC,MIN,101,14.5,Pts+Rebs,6,5,3,4
Luguentz Dort,F,22023,1629652,22300664,"JAN 29, 2024",OKC vs. MIN,L,25,0,7,0.0,0,6,0.0,2,2,1.0,0,3,3,1,0,0,0,2,2,0,1,OKC,OKC,MIN,101,12.5,Pts+Asts,6,5,3,4
Luguentz Dort,F,22023,1629652,22300654,"JAN 28, 2024",OKC @ DET,L,23,2,5,0.4,2,5,0.4,0,0,0.0,0,1,1,1,0,1,0,3,6,0,1,OKC,DET,OKC,104,10.5,Points,8,7,7,2
Luguentz Dort,F,22023,1629652,22300654,"JAN 28, 2024",OKC @ DET,L,23,2,5,0.4,2,5,0.4,0,0,0.0,0,1,1,1,0,1,0,3,6,0,1,OKC,DET,OKC,104,3.5,Rebounds,8,7,7,2
Luguentz Dort,F,22023,1629652,22300654,"JAN 28, 2024",OKC @ DET,L,23,2,5,0.4,2,5,0.4,0,0,0.0,0,1,1,1,0,1,0,3,6,0,1,OKC,DET,OKC,104,5.0,3-PT Attempted,8,7,7,2
Luguentz Dort,F,22023,1629652,22300654,"JAN 28, 2024",OKC @ DET,L,23,2,5,0.4,2,5,0.4,0,0,0.0,0,1,1,1,0,1,0,3,6,0,1,OKC,DET,OKC,104,14.5,Pts+Rebs,8,7,7,2
Luguentz Dort,F,22023,1629652,22300654,"JAN 28, 2024",OKC @ DET,L,23,2,5,0.4,2,5,0.4,0,0,0.0,0,1,1,1,0,1,0,3,6,0,1,OKC,DET,OKC,104,12.5,Pts+Asts,8,7,7,2
Luguentz Dort,F,22023,1629652,22300640,"JAN 26, 2024",OKC @ NOP,W,26,1,6,0.167,0,3,0.0,2,2,1.0,0,2,2,0,0,1,0,3,4,9,1,OKC,NOP,OKC,107,10.5,Points,6,6,4,2
Luguentz Dort,F,22023,1629652,22300640,"JAN 26, 2024",OKC @ NOP,W,26,1,6,0.167,0,3,0.0,2,2,1.0,0,2,2,0,0,1,0,3,4,9,1,OKC,NOP,OKC,107,3.5,Rebounds,6,6,4,2
Luguentz Dort,F,22023,1629652,22300640,"JAN 26, 2024",OKC @ NOP,W,26,1,6,0.167,0,3,0.0,2,2,1.0,0,2,2,0,0,1,0,3,4,9,1,OKC,NOP,OKC,107,5.0,3-PT Attempted,6,6,4,2
Luguentz Dort,F,22023,1629652,22300640,"JAN 26, 2024",OKC @ NOP,W,26,1,6,0.167,0,3,0.0,2,2,1.0,0,2,2,0,0,1,0,3,4,9,1,OKC,NOP,OKC,107,14.5,Pts+Rebs,6,6,4,2
Luguentz Dort,F,22023,1629652,22300640,"JAN 26, 2024",OKC @ NOP,W,26,1,6,0.167,0,3,0.0,2,2,1.0,0,2,2,0,0,1,0,3,4,9,1,OKC,NOP,OKC,107,12.5,Pts+Asts,6,6,4,2
Luguentz Dort,F,22023,1629652,22300599,"JAN 20, 2024",OKC @ MIN,W,33,5,12,0.417,3,7,0.429,1,2,0.5,2,3,5,1,2,0,1,4,14,11,1,OKC,MIN,OKC,102,10.5,Points,20,19,15,6
Luguentz Dort,F,22023,1629652,22300599,"JAN 20, 2024",OKC @ MIN,W,33,5,12,0.417,3,7,0.429,1,2,0.5,2,3,5,1,2,0,1,4,14,11,1,OKC,MIN,OKC,102,3.5,Rebounds,20,19,15,6
Luguentz Dort,F,22023,1629652,22300599,"JAN 20, 2024",OKC @ MIN,W,33,5,12,0.417,3,7,0.429,1,2,0.5,2,3,5,1,2,0,1,4,14,11,1,OKC,MIN,OKC,102,5.0,3-PT Attempted,20,19,15,6
Luguentz Dort,F,22023,1629652,22300599,"JAN 20, 2024",OKC @ MIN,W,33,5,12,0.417,3,7,0.429,1,2,0.5,2,3,5,1,2,0,1,4,14,11,1,OKC,MIN,OKC,102,14.5,Pts+Rebs,20,19,15,6
Luguentz Dort,F,22023,1629652,22300599,"JAN 20, 2024",OKC @ MIN,W,33,5,12,0.417,3,7,0.429,1,2,0.5,2,3,5,1,2,0,1,4,14,11,1,OKC,MIN,OKC,102,12.5,Pts+Asts,20,19,15,6
Luguentz Dort,F,22023,1629652,22300522,"JAN 10, 2024",OKC @ MIA,W,26,5,10,0.5,2,4,0.5,2,4,0.5,0,2,2,0,0,0,0,3,14,-3,1,OKC,MIA,OKC,128,10.5,Points,16,16,14,2
Luguentz Dort,F,22023,1629652,22300522,"JAN 10, 2024",OKC @ MIA,W,26,5,10,0.5,2,4,0.5,2,4,0.5,0,2,2,0,0,0,0,3,14,-3,1,OKC,MIA,OKC,128,3.5,Rebounds,16,16,14,2
Luguentz Dort,F,22023,1629652,22300522,"JAN 10, 2024",OKC @ MIA,W,26,5,10,0.5,2,4,0.5,2,4,0.5,0,2,2,0,0,0,0,3,14,-3,1,OKC,MIA,OKC,128,5.0,3-PT Attempted,16,16,14,2
Luguentz Dort,F,22023,1629652,22300522,"JAN 10, 2024",OKC @ MIA,W,26,5,10,0.5,2,4,0.5,2,4,0.5,0,2,2,0,0,0,0,3,14,-3,1,OKC,MIA,OKC,128,14.5,Pts+Rebs,16,16,14,2
Luguentz Dort,F,22023,1629652,22300522,"JAN 10, 2024",OKC @ MIA,W,26,5,10,0.5,2,4,0.5,2,4,0.5,0,2,2,0,0,0,0,3,14,-3,1,OKC,MIA,OKC,128,12.5,Pts+Asts,16,16,14,2
Luguentz Dort,F,22023,1629652,22300508,"JAN 08, 2024",OKC @ WAS,W,27,2,5,0.4,0,3,0.0,3,4,0.75,0,3,3,1,0,1,2,4,7,0,1,OKC,WAS,OKC,136,10.5,Points,11,10,8,4
Luguentz Dort,F,22023,1629652,22300508,"JAN 08, 2024",OKC @ WAS,W,27,2,5,0.4,0,3,0.0,3,4,0.75,0,3,3,1,0,1,2,4,7,0,1,OKC,WAS,OKC,136,3.5,Rebounds,11,10,8,4
Luguentz Dort,F,22023,1629652,22300508,"JAN 08, 2024",OKC @ WAS,W,27,2,5,0.4,0,3,0.0,3,4,0.75,0,3,3,1,0,1,2,4,7,0,1,OKC,WAS,OKC,136,5.0,3-PT Attempted,11,10,8,4
Luguentz Dort,F,22023,1629652,22300508,"JAN 08, 2024",OKC @ WAS,W,27,2,5,0.4,0,3,0.0,3,4,0.75,0,3,3,1,0,1,2,4,7,0,1,OKC,WAS,OKC,136,14.5,Pts+Rebs,11,10,8,4
Luguentz Dort,F,22023,1629652,22300508,"JAN 08, 2024",OKC @ WAS,W,27,2,5,0.4,0,3,0.0,3,4,0.75,0,3,3,1,0,1,2,4,7,0,1,OKC,WAS,OKC,136,12.5,Pts+Asts,11,10,8,4
Luguentz Dort,F,22023,1629652,22300467,"JAN 03, 2024",OKC @ ATL,L,29,3,7,0.429,2,3,0.667,6,6,1.0,3,1,4,3,0,0,0,4,14,11,1,OKC,ATL,OKC,138,10.5,Points,21,18,17,7
Luguentz Dort,F,22023,1629652,22300467,"JAN 03, 2024",OKC @ ATL,L,29,3,7,0.429,2,3,0.667,6,6,1.0,3,1,4,3,0,0,0,4,14,11,1,OKC,ATL,OKC,138,3.5,Rebounds,21,18,17,7
Luguentz Dort,F,22023,1629652,22300467,"JAN 03, 2024",OKC @ ATL,L,29,3,7,0.429,2,3,0.667,6,6,1.0,3,1,4,3,0,0,0,4,14,11,1,OKC,ATL,OKC,138,5.0,3-PT Attempted,21,18,17,7
Luguentz Dort,F,22023,1629652,22300467,"JAN 03, 2024",OKC @ ATL,L,29,3,7,0.429,2,3,0.667,6,6,1.0,3,1,4,3,0,0,0,4,14,11,1,OKC,ATL,OKC,138,14.5,Pts+Rebs,21,18,17,7
Luguentz Dort,F,22023,1629652,22300467,"JAN 03, 2024",OKC @ ATL,L,29,3,7,0.429,2,3,0.667,6,6,1.0,3,1,4,3,0,0,0,4,14,11,1,OKC,ATL,OKC,138,12.5,Pts+Asts,21,18,17,7
Luguentz Dort,F,22023,1629652,22300462,"JAN 02, 2024",OKC vs. BOS,W,37,4,14,0.286,1,7,0.143,0,0,0.0,5,3,8,1,1,3,0,2,9,8,1,OKC,OKC,BOS,127,10.5,Points,18,17,10,9
Luguentz Dort,F,22023,1629652,22300462,"JAN 02, 2024",OKC vs. BOS,W,37,4,14,0.286,1,7,0.143,0,0,0.0,5,3,8,1,1,3,0,2,9,8,1,OKC,OKC,BOS,127,3.5,Rebounds,18,17,10,9
Luguentz Dort,F,22023,1629652,22300462,"JAN 02, 2024",OKC vs. BOS,W,37,4,14,0.286,1,7,0.143,0,0,0.0,5,3,8,1,1,3,0,2,9,8,1,OKC,OKC,BOS,127,5.0,3-PT Attempted,18,17,10,9
Luguentz Dort,F,22023,1629652,22300462,"JAN 02, 2024",OKC vs. BOS,W,37,4,14,0.286,1,7,0.143,0,0,0.0,5,3,8,1,1,3,0,2,9,8,1,OKC,OKC,BOS,127,14.5,Pts+Rebs,18,17,10,9
Luguentz Dort,F,22023,1629652,22300462,"JAN 02, 2024",OKC vs. BOS,W,37,4,14,0.286,1,7,0.143,0,0,0.0,5,3,8,1,1,3,0,2,9,8,1,OKC,OKC,BOS,127,12.5,Pts+Asts,18,17,10,9
Luguentz Dort,F,22023,1629652,22300447,"DEC 31, 2023",OKC vs. BKN,W,30,7,10,0.7,4,5,0.8,0,0,0.0,0,4,4,3,0,1,0,4,18,15,1,OKC,OKC,BKN,124,10.5,Points,25,22,21,7
Luguentz Dort,F,22023,1629652,22300447,"DEC 31, 2023",OKC vs. BKN,W,30,7,10,0.7,4,5,0.8,0,0,0.0,0,4,4,3,0,1,0,4,18,15,1,OKC,OKC,BKN,124,3.5,Rebounds,25,22,21,7
Luguentz Dort,F,22023,1629652,22300447,"DEC 31, 2023",OKC vs. BKN,W,30,7,10,0.7,4,5,0.8,0,0,0.0,0,4,4,3,0,1,0,4,18,15,1,OKC,OKC,BKN,124,5.0,3-PT Attempted,25,22,21,7
Luguentz Dort,F,22023,1629652,22300447,"DEC 31, 2023",OKC vs. BKN,W,30,7,10,0.7,4,5,0.8,0,0,0.0,0,4,4,3,0,1,0,4,18,15,1,OKC,OKC,BKN,124,14.5,Pts+Rebs,25,22,21,7
Luguentz Dort,F,22023,1629652,22300447,"DEC 31, 2023",OKC vs. BKN,W,30,7,10,0.7,4,5,0.8,0,0,0.0,0,4,4,3,0,1,0,4,18,15,1,OKC,OKC,BKN,124,12.5,Pts+Asts,25,22,21,7
Luguentz Dort,F,22023,1629652,22300435,"DEC 29, 2023",OKC @ DEN,W,32,2,6,0.333,0,3,0.0,0,0,0.0,1,3,4,1,3,1,1,3,4,24,1,OKC,DEN,OKC,119,10.5,Points,9,8,5,5
Luguentz Dort,F,22023,1629652,22300435,"DEC 29, 2023",OKC @ DEN,W,32,2,6,0.333,0,3,0.0,0,0,0.0,1,3,4,1,3,1,1,3,4,24,1,OKC,DEN,OKC,119,3.5,Rebounds,9,8,5,5
Luguentz Dort,F,22023,1629652,22300435,"DEC 29, 2023",OKC @ DEN,W,32,2,6,0.333,0,3,0.0,0,0,0.0,1,3,4,1,3,1,1,3,4,24,1,OKC,DEN,OKC,119,5.0,3-PT Attempted,9,8,5,5
Luguentz Dort,F,22023,1629652,22300435,"DEC 29, 2023",OKC @ DEN,W,32,2,6,0.333,0,3,0.0,0,0,0.0,1,3,4,1,3,1,1,3,4,24,1,OKC,DEN,OKC,119,14.5,Pts+Rebs,9,8,5,5
Luguentz Dort,F,22023,1629652,22300435,"DEC 29, 2023",OKC @ DEN,W,32,2,6,0.333,0,3,0.0,0,0,0.0,1,3,4,1,3,1,1,3,4,24,1,OKC,DEN,OKC,119,12.5,Pts+Asts,9,8,5,5
Luguentz Dort,F,22023,1629652,22300411,"DEC 26, 2023",OKC vs. MIN,W,33,7,9,0.778,5,6,0.833,1,2,0.5,0,4,4,0,2,2,2,4,20,14,1,OKC,OKC,MIN,129,10.5,Points,24,24,20,4
Luguentz Dort,F,22023,1629652,22300411,"DEC 26, 2023",OKC vs. MIN,W,33,7,9,0.778,5,6,0.833,1,2,0.5,0,4,4,0,2,2,2,4,20,14,1,OKC,OKC,MIN,129,3.5,Rebounds,24,24,20,4
Luguentz Dort,F,22023,1629652,22300411,"DEC 26, 2023",OKC vs. MIN,W,33,7,9,0.778,5,6,0.833,1,2,0.5,0,4,4,0,2,2,2,4,20,14,1,OKC,OKC,MIN,129,5.0,3-PT Attempted,24,24,20,4
Luguentz Dort,F,22023,1629652,22300411,"DEC 26, 2023",OKC vs. MIN,W,33,7,9,0.778,5,6,0.833,1,2,0.5,0,4,4,0,2,2,2,4,20,14,1,OKC,OKC,MIN,129,14.5,Pts+Rebs,24,24,20,4
Luguentz Dort,F,22023,1629652,22300411,"DEC 26, 2023",OKC vs. MIN,W,33,7,9,0.778,5,6,0.833,1,2,0.5,0,4,4,0,2,2,2,4,20,14,1,OKC,OKC,MIN,129,12.5,Pts+Asts,24,24,20,4
Luguentz Dort,F,22023,1629652,22301212,"DEC 06, 2023",OKC @ HOU,L,15,0,5,0.0,0,3,0.0,4,4,1.0,2,1,3,0,0,0,1,1,4,-27,1,OKC,HOU,OKC,101,10.5,Points,7,7,4,3
Luguentz Dort,F,22023,1629652,22301212,"DEC 06, 2023",OKC @ HOU,L,15,0,5,0.0,0,3,0.0,4,4,1.0,2,1,3,0,0,0,1,1,4,-27,1,OKC,HOU,OKC,101,3.5,Rebounds,7,7,4,3
Luguentz Dort,F,22023,1629652,22301212,"DEC 06, 2023",OKC @ HOU,L,15,0,5,0.0,0,3,0.0,4,4,1.0,2,1,3,0,0,0,1,1,4,-27,1,OKC,HOU,OKC,101,5.0,3-PT Attempted,7,7,4,3
Luguentz Dort,F,22023,1629652,22301212,"DEC 06, 2023",OKC @ HOU,L,15,0,5,0.0,0,3,0.0,4,4,1.0,2,1,3,0,0,0,1,1,4,-27,1,OKC,HOU,OKC,101,14.5,Pts+Rebs,7,7,4,3
Luguentz Dort,F,22023,1629652,22301212,"DEC 06, 2023",OKC @ HOU,L,15,0,5,0.0,0,3,0.0,4,4,1.0,2,1,3,0,0,0,1,1,4,-27,1,OKC,HOU,OKC,101,12.5,Pts+Asts,7,7,4,3
Luguentz Dort,F,22023,1629652,22300271,"NOV 30, 2023",OKC vs. LAL,W,28,5,9,0.556,2,5,0.4,0,0,0.0,3,4,7,3,2,1,0,2,12,11,1,OKC,OKC,LAL,133,10.5,Points,22,19,15,10
Luguentz Dort,F,22023,1629652,22300271,"NOV 30, 2023",OKC vs. LAL,W,28,5,9,0.556,2,5,0.4,0,0,0.0,3,4,7,3,2,1,0,2,12,11,1,OKC,OKC,LAL,133,3.5,Rebounds,22,19,15,10
Luguentz Dort,F,22023,1629652,22300271,"NOV 30, 2023",OKC vs. LAL,W,28,5,9,0.556,2,5,0.4,0,0,0.0,3,4,7,3,2,1,0,2,12,11,1,OKC,OKC,LAL,133,5.0,3-PT Attempted,22,19,15,10
Luguentz Dort,F,22023,1629652,22300271,"NOV 30, 2023",OKC vs. LAL,W,28,5,9,0.556,2,5,0.4,0,0,0.0,3,4,7,3,2,1,0,2,12,11,1,OKC,OKC,LAL,133,14.5,Pts+Rebs,22,19,15,10
Luguentz Dort,F,22023,1629652,22300271,"NOV 30, 2023",OKC vs. LAL,W,28,5,9,0.556,2,5,0.4,0,0,0.0,3,4,7,3,2,1,0,2,12,11,1,OKC,OKC,LAL,133,12.5,Pts+Asts,22,19,15,10
Luguentz Dort,F,22023,1629652,22300234,"NOV 22, 2023",OKC vs. CHI,W,27,1,6,0.167,0,4,0.0,0,0,0.0,0,2,2,2,0,2,2,6,2,9,1,OKC,OKC,CHI,116,10.5,Points,6,4,4,4
Luguentz Dort,F,22023,1629652,22300234,"NOV 22, 2023",OKC vs. CHI,W,27,1,6,0.167,0,4,0.0,0,0,0.0,0,2,2,2,0,2,2,6,2,9,1,OKC,OKC,CHI,116,3.5,Rebounds,6,4,4,4
Luguentz Dort,F,22023,1629652,22300234,"NOV 22, 2023",OKC vs. CHI,W,27,1,6,0.167,0,4,0.0,0,0,0.0,0,2,2,2,0,2,2,6,2,9,1,OKC,OKC,CHI,116,5.0,3-PT Attempted,6,4,4,4
Luguentz Dort,F,22023,1629652,22300234,"NOV 22, 2023",OKC vs. CHI,W,27,1,6,0.167,0,4,0.0,0,0,0.0,0,2,2,2,0,2,2,6,2,9,1,OKC,OKC,CHI,116,14.5,Pts+Rebs,6,4,4,4
Luguentz Dort,F,22023,1629652,22300234,"NOV 22, 2023",OKC vs. CHI,W,27,1,6,0.167,0,4,0.0,0,0,0.0,0,2,2,2,0,2,2,6,2,9,1,OKC,OKC,CHI,116,12.5,Pts+Asts,6,4,4,4
Luguentz Dort,F,22023,1629652,22300207,"NOV 18, 2023",OKC @ GSW,W,27,1,6,0.167,1,4,0.25,0,0,0.0,1,5,6,2,0,0,0,2,3,-11,1,OKC,GSW,OKC,130,10.5,Points,11,9,5,8
Luguentz Dort,F,22023,1629652,22300207,"NOV 18, 2023",OKC @ GSW,W,27,1,6,0.167,1,4,0.25,0,0,0.0,1,5,6,2,0,0,0,2,3,-11,1,OKC,GSW,OKC,130,3.5,Rebounds,11,9,5,8
Luguentz Dort,F,22023,1629652,22300207,"NOV 18, 2023",OKC @ GSW,W,27,1,6,0.167,1,4,0.25,0,0,0.0,1,5,6,2,0,0,0,2,3,-11,1,OKC,GSW,OKC,130,5.0,3-PT Attempted,11,9,5,8
Luguentz Dort,F,22023,1629652,22300207,"NOV 18, 2023",OKC @ GSW,W,27,1,6,0.167,1,4,0.25,0,0,0.0,1,5,6,2,0,0,0,2,3,-11,1,OKC,GSW,OKC,130,14.5,Pts+Rebs,11,9,5,8
Luguentz Dort,F,22023,1629652,22300207,"NOV 18, 2023",OKC @ GSW,W,27,1,6,0.167,1,4,0.25,0,0,0.0,1,5,6,2,0,0,0,2,3,-11,1,OKC,GSW,OKC,130,12.5,Pts+Asts,11,9,5,8
Luguentz Dort,F,22023,1629652,22300201,"NOV 16, 2023",OKC @ GSW,W,24,2,5,0.4,1,3,0.333,0,0,0.0,0,2,2,0,1,0,1,2,5,-1,1,OKC,GSW,OKC,128,10.5,Points,7,7,5,2
Luguentz Dort,F,22023,1629652,22300201,"NOV 16, 2023",OKC @ GSW,W,24,2,5,0.4,1,3,0.333,0,0,0.0,0,2,2,0,1,0,1,2,5,-1,1,OKC,GSW,OKC,128,3.5,Rebounds,7,7,5,2
Luguentz Dort,F,22023,1629652,22300201,"NOV 16, 2023",OKC @ GSW,W,24,2,5,0.4,1,3,0.333,0,0,0.0,0,2,2,0,1,0,1,2,5,-1,1,OKC,GSW,OKC,128,5.0,3-PT Attempted,7,7,5,2
Luguentz Dort,F,22023,1629652,22300201,"NOV 16, 2023",OKC @ GSW,W,24,2,5,0.4,1,3,0.333,0,0,0.0,0,2,2,0,1,0,1,2,5,-1,1,OKC,GSW,OKC,128,14.5,Pts+Rebs,7,7,5,2
Luguentz Dort,F,22023,1629652,22300201,"NOV 16, 2023",OKC @ GSW,W,24,2,5,0.4,1,3,0.333,0,0,0.0,0,2,2,0,1,0,1,2,5,-1,1,OKC,GSW,OKC,128,12.5,Pts+Asts,7,7,5,2
Luguentz Dort,F,22023,1629652,22300021,"NOV 14, 2023",OKC vs. SAS,W,24,2,6,0.333,1,3,0.333,1,2,0.5,1,2,3,0,1,1,0,2,6,22,1,OKC,OKC,SAS,123,10.5,Points,9,9,6,3
Luguentz Dort,F,22023,1629652,22300021,"NOV 14, 2023",OKC vs. SAS,W,24,2,6,0.333,1,3,0.333,1,2,0.5,1,2,3,0,1,1,0,2,6,22,1,OKC,OKC,SAS,123,3.5,Rebounds,9,9,6,3
Luguentz Dort,F,22023,1629652,22300021,"NOV 14, 2023",OKC vs. SAS,W,24,2,6,0.333,1,3,0.333,1,2,0.5,1,2,3,0,1,1,0,2,6,22,1,OKC,OKC,SAS,123,5.0,3-PT Attempted,9,9,6,3
Luguentz Dort,F,22023,1629652,22300021,"NOV 14, 2023",OKC vs. SAS,W,24,2,6,0.333,1,3,0.333,1,2,0.5,1,2,3,0,1,1,0,2,6,22,1,OKC,OKC,SAS,123,14.5,Pts+Rebs,9,9,6,3
Luguentz Dort,F,22023,1629652,22300021,"NOV 14, 2023",OKC vs. SAS,W,24,2,6,0.333,1,3,0.333,1,2,0.5,1,2,3,0,1,1,0,2,6,22,1,OKC,OKC,SAS,123,12.5,Pts+Asts,9,9,6,3
Jalen Smith,F-C,22023,1630188,22300550,"JAN 14, 2024",IND @ DEN,L,25,4,7,0.571,0,1,0.0,0,1,0.0,2,1,3,3,0,0,0,2,8,-16,1,IND,DEN,IND,109,,,14,11,11,6
Jalen Smith,F-C,22023,1630188,22300533,"JAN 12, 2024",IND @ ATL,W,19,3,7,0.429,0,0,0.0,0,0,0.0,3,4,7,0,0,0,0,1,6,11,1,IND,ATL,IND,126,,,13,13,6,7
Jalen Smith,F-C,22023,1630188,22300507,"JAN 08, 2024",IND vs. BOS,W,27,3,8,0.375,1,4,0.25,4,4,1.0,2,7,9,1,0,3,2,1,11,5,1,IND,IND,BOS,133,,,21,20,12,10
Jalen Smith,F-C,22023,1630188,22300480,"JAN 05, 2024",IND vs. ATL,W,23,5,7,0.714,1,3,0.333,0,0,0.0,0,2,2,2,0,0,0,2,11,4,1,IND,IND,ATL,148,,,15,13,13,4
Jalen Smith,F-C,22023,1630188,22300466,"JAN 03, 2024",IND vs. MIL,W,19,5,8,0.625,1,4,0.25,2,2,1.0,2,5,7,3,0,0,1,2,13,23,1,IND,IND,MIL,142,,,23,20,16,10
Jalen Smith,F-C,22023,1630188,22300365,"DEC 20, 2023",IND vs. CHA,W,8,4,4,1.0,2,2,1.0,0,0,0.0,2,2,4,0,0,0,0,2,10,3,1,IND,IND,CHA,142,,,14,14,10,4
Jalen Smith,F-C,22023,1630188,22300254,"NOV 27, 2023",IND vs. POR,L,12,3,5,0.6,1,2,0.5,2,2,1.0,0,5,5,1,0,0,1,1,9,-8,1,IND,IND,POR,110,,,15,14,10,6
Jalen Smith,F-C,22023,1630188,22300047,"NOV 24, 2023",IND vs. DET,W,21,2,3,0.667,2,2,1.0,2,2,1.0,1,5,6,0,1,0,1,1,8,0,1,IND,IND,DET,136,,,14,14,8,6
Jalen Smith,F-C,22023,1630188,22300230,"NOV 22, 2023",IND vs. TOR,L,19,3,5,0.6,0,1,0.0,2,2,1.0,0,5,5,0,0,1,1,2,8,-14,1,IND,IND,TOR,131,,,13,13,8,5
Jalen Smith,F-C,22023,1630188,22300039,"NOV 21, 2023",IND @ ATL,W,5,2,2,1.0,0,0,0.0,2,4,0.5,2,1,3,0,0,0,0,0,6,-10,1,IND,ATL,IND,157,,,9,9,6,3
Jalen Smith,F-C,22023,1630188,22300209,"NOV 19, 2023",IND vs. ORL,L,13,4,5,0.8,1,1,1.0,1,2,0.5,2,2,4,0,0,0,2,3,10,-9,1,IND,IND,ORL,116,,,14,14,10,4
Jalen Smith,F-C,22023,1630188,22300019,"NOV 14, 2023",IND @ PHI,W,3,2,2,1.0,1,1,1.0,0,1,0.0,0,0,0,1,0,0,0,2,5,-2,1,IND,PHI,IND,132,,,6,5,6,1
Jalen Smith,F-C,22023,1630188,22300180,"NOV 12, 2023",IND @ PHI,L,19,4,7,0.571,1,2,0.5,2,2,1.0,1,5,6,1,0,0,2,2,11,-5,1,IND,PHI,IND,126,,,18,17,12,7
Jalen Smith,F-C,22023,1630188,22300158,"NOV 08, 2023",IND vs. UTA,W,25,5,8,0.625,0,0,0.0,6,7,0.857,3,8,11,1,2,1,1,0,16,12,1,IND,IND,UTA,134,,,28,27,17,12
Jalen Smith,F-C,22023,1630188,22300146,"NOV 06, 2023",IND vs. SAS,W,12,4,4,1.0,1,1,1.0,0,0,0.0,1,6,7,2,0,0,1,3,9,10,1,IND,IND,SAS,152,,,18,16,11,9
Jalen Smith,F-C,22023,1630188,22300133,"NOV 04, 2023",IND vs. CHA,L,21,4,6,0.667,2,3,0.667,1,2,0.5,3,6,9,1,0,0,1,4,11,-13,1,IND,IND,CHA,124,,,21,20,12,10
Jalen Smith,F-C,22023,1630188,22300001,"NOV 03, 2023",IND vs. CLE,W,17,6,8,0.75,1,1,1.0,0,0,0.0,2,3,5,2,0,1,3,2,13,-4,1,IND,IND,CLE,121,,,20,18,15,7
Jalen Smith,F-C,22023,1630188,22300102,"OCT 30, 2023",IND vs. CHI,L,16,4,7,0.571,0,2,0.0,0,0,0.0,0,2,2,0,1,1,1,3,8,2,1,IND,IND,CHI,105,,,10,10,8,2
Jalen Smith,F-C,22023,1630188,22300091,"OCT 28, 2023",IND @ CLE,W,19,5,7,0.714,2,3,0.667,1,2,0.5,2,4,6,3,0,0,1,2,13,17,1,IND,CLE,IND,125,,,22,19,16,9
Jalen Smith,F-C,22023,1630188,22300064,"OCT 25, 2023",IND vs. WAS,W,13,5,6,0.833,2,2,1.0,1,1,1.0,3,5,8,0,1,0,0,4,13,6,1,IND,IND,WAS,143,,,21,21,13,8
Jalen Smith,F-C,22023,1630188,22300707,"FEB 04, 2024",IND @ CHA,W,20,4,9,0.444,1,3,0.333,1,1,1.0,1,4,5,0,0,1,0,0,10,0,1,IND,CHA,IND,115,,,15,15,10,5
Jalen Smith,F-C,22023,1630188,22300627,"JAN 25, 2024",IND vs. PHI,W,9,3,4,0.75,0,1,0.0,0,1,0.0,1,0,1,0,0,2,0,6,6,-4,1,IND,IND,PHI,134,,,7,7,6,1
Jalen Smith,F-C,22023,1630188,22300564,"JAN 15, 2024",IND @ UTA,L,19,5,10,0.5,2,5,0.4,0,0,0.0,1,5,6,3,0,1,2,5,12,-28,1,IND,UTA,IND,105,,,21,18,15,9
Jalen Smith,F-C,22023,1630188,22300493,"JAN 06, 2024",IND vs. BOS,L,26,2,6,0.333,1,4,0.25,2,2,1.0,1,6,7,2,0,0,0,2,7,-7,1,IND,IND,BOS,101,,,16,14,9,9
Jalen Smith,F-C,22023,1630188,22300733,"FEB 08, 2024",IND vs. GSW,L,13,6,6,1.0,2,2,1.0,0,0,0.0,3,2,5,0,1,0,0,1,14,3,1,IND,IND,GSW,109,,,19,19,14,5
Jalen Smith,F-C,22023,1630188,22300719,"FEB 06, 2024",IND vs. HOU,W,17,4,6,0.667,1,2,0.5,0,0,0.0,1,2,3,2,0,2,1,3,9,3,1,IND,IND,HOU,132,,,14,12,11,5
Jalen Smith,F-C,22023,1630188,22300685,"FEB 01, 2024",IND @ NYK,L,24,9,11,0.818,2,3,0.667,0,1,0.0,1,8,9,0,2,2,1,0,20,2,1,IND,NYK,IND,105,,,29,29,20,9
Jalen Smith,F-C,22023,1630188,22300670,"JAN 30, 2024",IND @ BOS,L,21,2,6,0.333,0,3,0.0,3,3,1.0,2,2,4,2,0,0,0,2,7,-17,1,IND,BOS,IND,124,,,13,11,9,6
Jalen Smith,F-C,22023,1630188,22300590,"JAN 19, 2024",IND @ POR,L,14,2,5,0.4,1,1,1.0,2,2,1.0,2,1,3,0,0,0,1,2,7,-9,1,IND,POR,IND,115,,,10,10,7,3
Jalen Smith,F-C,22023,1630188,22300454,"JAN 01, 2024",IND @ MIL,W,12,3,10,0.3,1,6,0.167,0,0,0.0,1,1,2,0,0,0,0,1,7,-19,1,IND,MIL,IND,122,,,9,9,7,2
Jalen Smith,F-C,22023,1630188,22300441,"DEC 30, 2023",IND vs. NYK,W,21,3,5,0.6,1,2,0.5,2,4,0.5,0,4,4,2,0,2,1,5,9,3,1,IND,IND,NYK,140,,,15,13,11,6
Jalen Smith,F-C,22023,1630188,22300422,"DEC 28, 2023",IND @ CHI,W,25,6,7,0.857,1,2,0.5,2,5,0.4,2,5,7,1,0,0,0,3,15,4,1,IND,CHI,IND,120,,,23,22,16,8
Jalen Smith,F-C,22023,1630188,22300409,"DEC 26, 2023",IND @ HOU,W,23,5,11,0.455,1,4,0.25,1,1,1.0,2,6,8,1,1,2,1,3,12,11,1,IND,HOU,IND,123,,,21,20,13,9
Jalen Smith,F-C,22023,1630188,22300391,"DEC 23, 2023",IND vs. ORL,L,15,4,5,0.8,3,4,0.75,0,1,0.0,1,1,2,1,0,0,2,5,11,-19,1,IND,IND,ORL,110,,,14,13,12,3
Jalen Smith,F-C,22023,1630188,22300652,"JAN 28, 2024",IND vs. MEM,W,30,8,13,0.615,3,6,0.5,0,0,0.0,3,7,10,2,0,2,1,4,19,-2,1,IND,IND,MEM,116,,,31,29,21,12
Jalen Smith,F-C,22023,1630188,22300636,"JAN 26, 2024",IND vs. PHX,W,20,6,11,0.545,1,3,0.333,0,1,0.0,5,5,10,0,1,1,2,2,13,-5,1,IND,IND,PHX,133,,,23,23,13,10
Jalen Smith,F-C,22023,1630188,22300604,"JAN 21, 2024",IND @ PHX,L,19,5,5,1.0,3,3,1.0,2,4,0.5,2,2,4,1,1,2,1,0,15,11,1,IND,PHX,IND,110,,,20,19,16,5
Jalen Smith,F-C,22023,1630188,22300583,"JAN 18, 2024",IND @ SAC,W,25,6,7,0.857,1,2,0.5,4,4,1.0,1,12,13,1,0,1,0,3,17,8,1,IND,SAC,IND,126,,,31,30,18,14
Caleb Martin,F,22023,1628997,22300730,"FEB 07, 2024",MIA vs. SAS,W,25,4,6,0.667,1,3,0.333,0,0,0.0,2,3,5,2,2,0,1,2,9,13,1,MIA,MIA,SAS,116,9.5,Points,16,14,11,7
Caleb Martin,F,22023,1628997,22300730,"FEB 07, 2024",MIA vs. SAS,W,25,4,6,0.667,1,3,0.333,0,0,0.0,2,3,5,2,2,0,1,2,9,13,1,MIA,MIA,SAS,116,4.5,Rebounds,16,14,11,7
Caleb Martin,F,22023,1628997,22300730,"FEB 07, 2024",MIA vs. SAS,W,25,4,6,0.667,1,3,0.333,0,0,0.0,2,3,5,2,2,0,1,2,9,13,1,MIA,MIA,SAS,116,16.5,Pts+Rebs+Asts,16,14,11,7
Caleb Martin,F,22023,1628997,22300730,"FEB 07, 2024",MIA vs. SAS,W,25,4,6,0.667,1,3,0.333,0,0,0.0,2,3,5,2,2,0,1,2,9,13,1,MIA,MIA,SAS,116,14.5,Pts+Rebs,16,14,11,7
Caleb Martin,F,22023,1628997,22300730,"FEB 07, 2024",MIA vs. SAS,W,25,4,6,0.667,1,3,0.333,0,0,0.0,2,3,5,2,2,0,1,2,9,13,1,MIA,MIA,SAS,116,11.5,Pts+Asts,16,14,11,7
Caleb Martin,F,22023,1628997,22300721,"FEB 06, 2024",MIA vs. ORL,W,25,5,9,0.556,1,3,0.333,0,0,0.0,1,2,3,1,1,1,0,2,11,14,1,MIA,MIA,ORL,121,9.5,Points,15,14,12,4
Caleb Martin,F,22023,1628997,22300721,"FEB 06, 2024",MIA vs. ORL,W,25,5,9,0.556,1,3,0.333,0,0,0.0,1,2,3,1,1,1,0,2,11,14,1,MIA,MIA,ORL,121,4.5,Rebounds,15,14,12,4
Caleb Martin,F,22023,1628997,22300721,"FEB 06, 2024",MIA vs. ORL,W,25,5,9,0.556,1,3,0.333,0,0,0.0,1,2,3,1,1,1,0,2,11,14,1,MIA,MIA,ORL,121,16.5,Pts+Rebs+Asts,15,14,12,4
Caleb Martin,F,22023,1628997,22300721,"FEB 06, 2024",MIA vs. ORL,W,25,5,9,0.556,1,3,0.333,0,0,0.0,1,2,3,1,1,1,0,2,11,14,1,MIA,MIA,ORL,121,14.5,Pts+Rebs,15,14,12,4
Caleb Martin,F,22023,1628997,22300721,"FEB 06, 2024",MIA vs. ORL,W,25,5,9,0.556,1,3,0.333,0,0,0.0,1,2,3,1,1,1,0,2,11,14,1,MIA,MIA,ORL,121,11.5,Pts+Asts,15,14,12,4
Caleb Martin,F,22023,1628997,22300708,"FEB 04, 2024",MIA vs. LAC,L,31,5,9,0.556,0,2,0.0,1,2,0.5,1,3,4,2,1,0,0,3,11,-7,1,MIA,MIA,LAC,95,9.5,Points,17,15,13,6
Caleb Martin,F,22023,1628997,22300708,"FEB 04, 2024",MIA vs. LAC,L,31,5,9,0.556,0,2,0.0,1,2,0.5,1,3,4,2,1,0,0,3,11,-7,1,MIA,MIA,LAC,95,4.5,Rebounds,17,15,13,6
Caleb Martin,F,22023,1628997,22300708,"FEB 04, 2024",MIA vs. LAC,L,31,5,9,0.556,0,2,0.0,1,2,0.5,1,3,4,2,1,0,0,3,11,-7,1,MIA,MIA,LAC,95,16.5,Pts+Rebs+Asts,17,15,13,6
Caleb Martin,F,22023,1628997,22300708,"FEB 04, 2024",MIA vs. LAC,L,31,5,9,0.556,0,2,0.0,1,2,0.5,1,3,4,2,1,0,0,3,11,-7,1,MIA,MIA,LAC,95,14.5,Pts+Rebs,17,15,13,6
Caleb Martin,F,22023,1628997,22300708,"FEB 04, 2024",MIA vs. LAC,L,31,5,9,0.556,0,2,0.0,1,2,0.5,1,3,4,2,1,0,0,3,11,-7,1,MIA,MIA,LAC,95,11.5,Pts+Asts,17,15,13,6
Caleb Martin,F,22023,1628997,22300689,"FEB 02, 2024",MIA @ WAS,W,29,2,6,0.333,0,2,0.0,0,0,0.0,2,2,4,4,1,0,1,3,4,7,1,MIA,WAS,MIA,110,9.5,Points,12,8,8,8
Caleb Martin,F,22023,1628997,22300689,"FEB 02, 2024",MIA @ WAS,W,29,2,6,0.333,0,2,0.0,0,0,0.0,2,2,4,4,1,0,1,3,4,7,1,MIA,WAS,MIA,110,4.5,Rebounds,12,8,8,8
Caleb Martin,F,22023,1628997,22300689,"FEB 02, 2024",MIA @ WAS,W,29,2,6,0.333,0,2,0.0,0,0,0.0,2,2,4,4,1,0,1,3,4,7,1,MIA,WAS,MIA,110,16.5,Pts+Rebs+Asts,12,8,8,8
Caleb Martin,F,22023,1628997,22300689,"FEB 02, 2024",MIA @ WAS,W,29,2,6,0.333,0,2,0.0,0,0,0.0,2,2,4,4,1,0,1,3,4,7,1,MIA,WAS,MIA,110,14.5,Pts+Rebs,12,8,8,8
Caleb Martin,F,22023,1628997,22300689,"FEB 02, 2024",MIA @ WAS,W,29,2,6,0.333,0,2,0.0,0,0,0.0,2,2,4,4,1,0,1,3,4,7,1,MIA,WAS,MIA,110,11.5,Pts+Asts,12,8,8,8
Caleb Martin,F,22023,1628997,22300678,"JAN 31, 2024",MIA vs. SAC,W,28,3,7,0.429,0,2,0.0,1,1,1.0,0,3,3,2,0,0,1,3,7,12,1,MIA,MIA,SAC,115,9.5,Points,12,10,9,5
Caleb Martin,F,22023,1628997,22300678,"JAN 31, 2024",MIA vs. SAC,W,28,3,7,0.429,0,2,0.0,1,1,1.0,0,3,3,2,0,0,1,3,7,12,1,MIA,MIA,SAC,115,4.5,Rebounds,12,10,9,5
Caleb Martin,F,22023,1628997,22300678,"JAN 31, 2024",MIA vs. SAC,W,28,3,7,0.429,0,2,0.0,1,1,1.0,0,3,3,2,0,0,1,3,7,12,1,MIA,MIA,SAC,115,16.5,Pts+Rebs+Asts,12,10,9,5
Caleb Martin,F,22023,1628997,22300678,"JAN 31, 2024",MIA vs. SAC,W,28,3,7,0.429,0,2,0.0,1,1,1.0,0,3,3,2,0,0,1,3,7,12,1,MIA,MIA,SAC,115,14.5,Pts+Rebs,12,10,9,5
Caleb Martin,F,22023,1628997,22300678,"JAN 31, 2024",MIA vs. SAC,W,28,3,7,0.429,0,2,0.0,1,1,1.0,0,3,3,2,0,0,1,3,7,12,1,MIA,MIA,SAC,115,11.5,Pts+Asts,12,10,9,5
Caleb Martin,F,22023,1628997,22300661,"JAN 29, 2024",MIA vs. PHX,L,25,5,9,0.556,1,1,1.0,1,1,1.0,2,4,6,1,0,0,2,3,12,-4,1,MIA,MIA,PHX,105,9.5,Points,19,18,13,7
Caleb Martin,F,22023,1628997,22300661,"JAN 29, 2024",MIA vs. PHX,L,25,5,9,0.556,1,1,1.0,1,1,1.0,2,4,6,1,0,0,2,3,12,-4,1,MIA,MIA,PHX,105,4.5,Rebounds,19,18,13,7
Caleb Martin,F,22023,1628997,22300661,"JAN 29, 2024",MIA vs. PHX,L,25,5,9,0.556,1,1,1.0,1,1,1.0,2,4,6,1,0,0,2,3,12,-4,1,MIA,MIA,PHX,105,16.5,Pts+Rebs+Asts,19,18,13,7
Caleb Martin,F,22023,1628997,22300661,"JAN 29, 2024",MIA vs. PHX,L,25,5,9,0.556,1,1,1.0,1,1,1.0,2,4,6,1,0,0,2,3,12,-4,1,MIA,MIA,PHX,105,14.5,Pts+Rebs,19,18,13,7
Caleb Martin,F,22023,1628997,22300661,"JAN 29, 2024",MIA vs. PHX,L,25,5,9,0.556,1,1,1.0,1,1,1.0,2,4,6,1,0,0,2,3,12,-4,1,MIA,MIA,PHX,105,11.5,Pts+Asts,19,18,13,7
Caleb Martin,F,22023,1628997,22300643,"JAN 27, 2024",MIA @ NYK,L,16,2,4,0.5,1,3,0.333,1,2,0.5,0,3,3,0,0,1,0,2,6,-2,1,MIA,NYK,MIA,109,9.5,Points,9,9,6,3
Caleb Martin,F,22023,1628997,22300643,"JAN 27, 2024",MIA @ NYK,L,16,2,4,0.5,1,3,0.333,1,2,0.5,0,3,3,0,0,1,0,2,6,-2,1,MIA,NYK,MIA,109,4.5,Rebounds,9,9,6,3
Caleb Martin,F,22023,1628997,22300643,"JAN 27, 2024",MIA @ NYK,L,16,2,4,0.5,1,3,0.333,1,2,0.5,0,3,3,0,0,1,0,2,6,-2,1,MIA,NYK,MIA,109,16.5,Pts+Rebs+Asts,9,9,6,3
Caleb Martin,F,22023,1628997,22300643,"JAN 27, 2024",MIA @ NYK,L,16,2,4,0.5,1,3,0.333,1,2,0.5,0,3,3,0,0,1,0,2,6,-2,1,MIA,NYK,MIA,109,14.5,Pts+Rebs,9,9,6,3
Caleb Martin,F,22023,1628997,22300643,"JAN 27, 2024",MIA @ NYK,L,16,2,4,0.5,1,3,0.333,1,2,0.5,0,3,3,0,0,1,0,2,6,-2,1,MIA,NYK,MIA,109,11.5,Pts+Asts,9,9,6,3
Caleb Martin,F,22023,1628997,22300630,"JAN 25, 2024",MIA vs. BOS,L,22,2,12,0.167,2,8,0.25,2,2,1.0,1,2,3,2,1,0,0,0,8,-25,1,MIA,MIA,BOS,110,9.5,Points,13,11,10,5
Caleb Martin,F,22023,1628997,22300630,"JAN 25, 2024",MIA vs. BOS,L,22,2,12,0.167,2,8,0.25,2,2,1.0,1,2,3,2,1,0,0,0,8,-25,1,MIA,MIA,BOS,110,4.5,Rebounds,13,11,10,5
Caleb Martin,F,22023,1628997,22300630,"JAN 25, 2024",MIA vs. BOS,L,22,2,12,0.167,2,8,0.25,2,2,1.0,1,2,3,2,1,0,0,0,8,-25,1,MIA,MIA,BOS,110,16.5,Pts+Rebs+Asts,13,11,10,5
Caleb Martin,F,22023,1628997,22300630,"JAN 25, 2024",MIA vs. BOS,L,22,2,12,0.167,2,8,0.25,2,2,1.0,1,2,3,2,1,0,0,0,8,-25,1,MIA,MIA,BOS,110,14.5,Pts+Rebs,13,11,10,5
Caleb Martin,F,22023,1628997,22300630,"JAN 25, 2024",MIA vs. BOS,L,22,2,12,0.167,2,8,0.25,2,2,1.0,1,2,3,2,1,0,0,0,8,-25,1,MIA,MIA,BOS,110,11.5,Pts+Asts,13,11,10,5
Caleb Martin,F,22023,1628997,22300621,"JAN 24, 2024",MIA vs. MEM,L,29,4,8,0.5,3,5,0.6,4,4,1.0,2,2,4,1,2,1,2,2,15,-8,1,MIA,MIA,MEM,96,9.5,Points,20,19,16,5
Caleb Martin,F,22023,1628997,22300621,"JAN 24, 2024",MIA vs. MEM,L,29,4,8,0.5,3,5,0.6,4,4,1.0,2,2,4,1,2,1,2,2,15,-8,1,MIA,MIA,MEM,96,4.5,Rebounds,20,19,16,5
Caleb Martin,F,22023,1628997,22300621,"JAN 24, 2024",MIA vs. MEM,L,29,4,8,0.5,3,5,0.6,4,4,1.0,2,2,4,1,2,1,2,2,15,-8,1,MIA,MIA,MEM,96,16.5,Pts+Rebs+Asts,20,19,16,5
Caleb Martin,F,22023,1628997,22300621,"JAN 24, 2024",MIA vs. MEM,L,29,4,8,0.5,3,5,0.6,4,4,1.0,2,2,4,1,2,1,2,2,15,-8,1,MIA,MIA,MEM,96,14.5,Pts+Rebs,20,19,16,5
Caleb Martin,F,22023,1628997,22300621,"JAN 24, 2024",MIA vs. MEM,L,29,4,8,0.5,3,5,0.6,4,4,1.0,2,2,4,1,2,1,2,2,15,-8,1,MIA,MIA,MEM,96,11.5,Pts+Asts,20,19,16,5
Caleb Martin,F,22023,1628997,22300601,"JAN 21, 2024",MIA @ ORL,L,31,5,7,0.714,1,1,1.0,0,0,0.0,1,3,4,4,0,0,2,2,11,-11,1,MIA,ORL,MIA,87,9.5,Points,19,15,15,8
Caleb Martin,F,22023,1628997,22300601,"JAN 21, 2024",MIA @ ORL,L,31,5,7,0.714,1,1,1.0,0,0,0.0,1,3,4,4,0,0,2,2,11,-11,1,MIA,ORL,MIA,87,4.5,Rebounds,19,15,15,8
Caleb Martin,F,22023,1628997,22300601,"JAN 21, 2024",MIA @ ORL,L,31,5,7,0.714,1,1,1.0,0,0,0.0,1,3,4,4,0,0,2,2,11,-11,1,MIA,ORL,MIA,87,16.5,Pts+Rebs+Asts,19,15,15,8
Caleb Martin,F,22023,1628997,22300601,"JAN 21, 2024",MIA @ ORL,L,31,5,7,0.714,1,1,1.0,0,0,0.0,1,3,4,4,0,0,2,2,11,-11,1,MIA,ORL,MIA,87,14.5,Pts+Rebs,19,15,15,8
Caleb Martin,F,22023,1628997,22300601,"JAN 21, 2024",MIA @ ORL,L,31,5,7,0.714,1,1,1.0,0,0,0.0,1,3,4,4,0,0,2,2,11,-11,1,MIA,ORL,MIA,87,11.5,Pts+Asts,19,15,15,8
Caleb Martin,F,22023,1628997,22300587,"JAN 19, 2024",MIA vs. ATL,L,27,4,9,0.444,2,3,0.667,0,0,0.0,3,5,8,1,0,1,1,1,10,3,1,MIA,MIA,ATL,108,9.5,Points,19,18,11,9
Caleb Martin,F,22023,1628997,22300587,"JAN 19, 2024",MIA vs. ATL,L,27,4,9,0.444,2,3,0.667,0,0,0.0,3,5,8,1,0,1,1,1,10,3,1,MIA,MIA,ATL,108,4.5,Rebounds,19,18,11,9
Caleb Martin,F,22023,1628997,22300587,"JAN 19, 2024",MIA vs. ATL,L,27,4,9,0.444,2,3,0.667,0,0,0.0,3,5,8,1,0,1,1,1,10,3,1,MIA,MIA,ATL,108,16.5,Pts+Rebs+Asts,19,18,11,9
Caleb Martin,F,22023,1628997,22300587,"JAN 19, 2024",MIA vs. ATL,L,27,4,9,0.444,2,3,0.667,0,0,0.0,3,5,8,1,0,1,1,1,10,3,1,MIA,MIA,ATL,108,14.5,Pts+Rebs,19,18,11,9
Caleb Martin,F,22023,1628997,22300587,"JAN 19, 2024",MIA vs. ATL,L,27,4,9,0.444,2,3,0.667,0,0,0.0,3,5,8,1,0,1,1,1,10,3,1,MIA,MIA,ATL,108,11.5,Pts+Asts,19,18,11,9
Caleb Martin,F,22023,1628997,22300574,"JAN 17, 2024",MIA @ TOR,L,26,4,5,0.8,0,0,0.0,2,2,1.0,1,2,3,5,0,0,1,1,10,-22,1,MIA,TOR,MIA,97,9.5,Points,18,13,15,8
Caleb Martin,F,22023,1628997,22300574,"JAN 17, 2024",MIA @ TOR,L,26,4,5,0.8,0,0,0.0,2,2,1.0,1,2,3,5,0,0,1,1,10,-22,1,MIA,TOR,MIA,97,4.5,Rebounds,18,13,15,8
Caleb Martin,F,22023,1628997,22300574,"JAN 17, 2024",MIA @ TOR,L,26,4,5,0.8,0,0,0.0,2,2,1.0,1,2,3,5,0,0,1,1,10,-22,1,MIA,TOR,MIA,97,16.5,Pts+Rebs+Asts,18,13,15,8
Caleb Martin,F,22023,1628997,22300574,"JAN 17, 2024",MIA @ TOR,L,26,4,5,0.8,0,0,0.0,2,2,1.0,1,2,3,5,0,0,1,1,10,-22,1,MIA,TOR,MIA,97,14.5,Pts+Rebs,18,13,15,8
Caleb Martin,F,22023,1628997,22300574,"JAN 17, 2024",MIA @ TOR,L,26,4,5,0.8,0,0,0.0,2,2,1.0,1,2,3,5,0,0,1,1,10,-22,1,MIA,TOR,MIA,97,11.5,Pts+Asts,18,13,15,8
Caleb Martin,F,22023,1628997,22300562,"JAN 15, 2024",MIA @ BKN,W,34,3,8,0.375,1,4,0.25,2,2,1.0,0,3,3,1,1,1,1,1,9,-9,1,MIA,BKN,MIA,96,9.5,Points,13,12,10,4
Caleb Martin,F,22023,1628997,22300562,"JAN 15, 2024",MIA @ BKN,W,34,3,8,0.375,1,4,0.25,2,2,1.0,0,3,3,1,1,1,1,1,9,-9,1,MIA,BKN,MIA,96,4.5,Rebounds,13,12,10,4
Caleb Martin,F,22023,1628997,22300562,"JAN 15, 2024",MIA @ BKN,W,34,3,8,0.375,1,4,0.25,2,2,1.0,0,3,3,1,1,1,1,1,9,-9,1,MIA,BKN,MIA,96,16.5,Pts+Rebs+Asts,13,12,10,4
Caleb Martin,F,22023,1628997,22300562,"JAN 15, 2024",MIA @ BKN,W,34,3,8,0.375,1,4,0.25,2,2,1.0,0,3,3,1,1,1,1,1,9,-9,1,MIA,BKN,MIA,96,14.5,Pts+Rebs,13,12,10,4
Caleb Martin,F,22023,1628997,22300562,"JAN 15, 2024",MIA @ BKN,W,34,3,8,0.375,1,4,0.25,2,2,1.0,0,3,3,1,1,1,1,1,9,-9,1,MIA,BKN,MIA,96,11.5,Pts+Asts,13,12,10,4
Caleb Martin,F,22023,1628997,22300551,"JAN 14, 2024",MIA vs. CHA,W,25,1,5,0.2,0,2,0.0,0,0,0.0,0,3,3,2,1,0,1,2,2,13,1,MIA,MIA,CHA,104,9.5,Points,7,5,4,5
Caleb Martin,F,22023,1628997,22300551,"JAN 14, 2024",MIA vs. CHA,W,25,1,5,0.2,0,2,0.0,0,0,0.0,0,3,3,2,1,0,1,2,2,13,1,MIA,MIA,CHA,104,4.5,Rebounds,7,5,4,5
Caleb Martin,F,22023,1628997,22300551,"JAN 14, 2024",MIA vs. CHA,W,25,1,5,0.2,0,2,0.0,0,0,0.0,0,3,3,2,1,0,1,2,2,13,1,MIA,MIA,CHA,104,16.5,Pts+Rebs+Asts,7,5,4,5
Caleb Martin,F,22023,1628997,22300551,"JAN 14, 2024",MIA vs. CHA,W,25,1,5,0.2,0,2,0.0,0,0,0.0,0,3,3,2,1,0,1,2,2,13,1,MIA,MIA,CHA,104,14.5,Pts+Rebs,7,5,4,5
Caleb Martin,F,22023,1628997,22300551,"JAN 14, 2024",MIA vs. CHA,W,25,1,5,0.2,0,2,0.0,0,0,0.0,0,3,3,2,1,0,1,2,2,13,1,MIA,MIA,CHA,104,11.5,Pts+Asts,7,5,4,5
Caleb Martin,F,22023,1628997,22300535,"JAN 12, 2024",MIA vs. ORL,W,24,3,6,0.5,1,2,0.5,4,4,1.0,0,4,4,2,1,0,0,1,11,3,1,MIA,MIA,ORL,99,9.5,Points,17,15,13,6
Caleb Martin,F,22023,1628997,22300535,"JAN 12, 2024",MIA vs. ORL,W,24,3,6,0.5,1,2,0.5,4,4,1.0,0,4,4,2,1,0,0,1,11,3,1,MIA,MIA,ORL,99,4.5,Rebounds,17,15,13,6
Caleb Martin,F,22023,1628997,22300535,"JAN 12, 2024",MIA vs. ORL,W,24,3,6,0.5,1,2,0.5,4,4,1.0,0,4,4,2,1,0,0,1,11,3,1,MIA,MIA,ORL,99,16.5,Pts+Rebs+Asts,17,15,13,6
Caleb Martin,F,22023,1628997,22300535,"JAN 12, 2024",MIA vs. ORL,W,24,3,6,0.5,1,2,0.5,4,4,1.0,0,4,4,2,1,0,0,1,11,3,1,MIA,MIA,ORL,99,14.5,Pts+Rebs,17,15,13,6
Caleb Martin,F,22023,1628997,22300535,"JAN 12, 2024",MIA vs. ORL,W,24,3,6,0.5,1,2,0.5,4,4,1.0,0,4,4,2,1,0,0,1,11,3,1,MIA,MIA,ORL,99,11.5,Pts+Asts,17,15,13,6
Caleb Martin,F,22023,1628997,22300404,"DEC 25, 2023",MIA vs. PHI,W,9,0,0,0.0,0,0,0.0,1,2,0.5,1,4,5,1,0,0,2,1,1,-5,1,MIA,MIA,PHI,119,9.5,Points,7,6,2,6
Caleb Martin,F,22023,1628997,22300404,"DEC 25, 2023",MIA vs. PHI,W,9,0,0,0.0,0,0,0.0,1,2,0.5,1,4,5,1,0,0,2,1,1,-5,1,MIA,MIA,PHI,119,4.5,Rebounds,7,6,2,6
Caleb Martin,F,22023,1628997,22300404,"DEC 25, 2023",MIA vs. PHI,W,9,0,0,0.0,0,0,0.0,1,2,0.5,1,4,5,1,0,0,2,1,1,-5,1,MIA,MIA,PHI,119,16.5,Pts+Rebs+Asts,7,6,2,6
Caleb Martin,F,22023,1628997,22300404,"DEC 25, 2023",MIA vs. PHI,W,9,0,0,0.0,0,0,0.0,1,2,0.5,1,4,5,1,0,0,2,1,1,-5,1,MIA,MIA,PHI,119,14.5,Pts+Rebs,7,6,2,6
Caleb Martin,F,22023,1628997,22300404,"DEC 25, 2023",MIA vs. PHI,W,9,0,0,0.0,0,0,0.0,1,2,0.5,1,4,5,1,0,0,2,1,1,-5,1,MIA,MIA,PHI,119,11.5,Pts+Asts,7,6,2,6
Caleb Martin,F,22023,1628997,22300384,"DEC 22, 2023",MIA vs. ATL,W,35,4,9,0.444,2,4,0.5,1,1,1.0,2,6,8,2,1,1,0,4,11,-1,1,MIA,MIA,ATL,122,9.5,Points,21,19,13,10
Caleb Martin,F,22023,1628997,22300384,"DEC 22, 2023",MIA vs. ATL,W,35,4,9,0.444,2,4,0.5,1,1,1.0,2,6,8,2,1,1,0,4,11,-1,1,MIA,MIA,ATL,122,4.5,Rebounds,21,19,13,10
Caleb Martin,F,22023,1628997,22300384,"DEC 22, 2023",MIA vs. ATL,W,35,4,9,0.444,2,4,0.5,1,1,1.0,2,6,8,2,1,1,0,4,11,-1,1,MIA,MIA,ATL,122,16.5,Pts+Rebs+Asts,21,19,13,10
Caleb Martin,F,22023,1628997,22300384,"DEC 22, 2023",MIA vs. ATL,W,35,4,9,0.444,2,4,0.5,1,1,1.0,2,6,8,2,1,1,0,4,11,-1,1,MIA,MIA,ATL,122,14.5,Pts+Rebs,21,19,13,10
Caleb Martin,F,22023,1628997,22300384,"DEC 22, 2023",MIA vs. ATL,W,35,4,9,0.444,2,4,0.5,1,1,1.0,2,6,8,2,1,1,0,4,11,-1,1,MIA,MIA,ATL,122,11.5,Pts+Asts,21,19,13,10
Caleb Martin,F,22023,1628997,22300366,"DEC 20, 2023",MIA @ ORL,W,18,1,3,0.333,1,1,1.0,2,2,1.0,0,5,5,0,1,0,1,2,5,3,1,MIA,ORL,MIA,115,9.5,Points,10,10,5,5
Caleb Martin,F,22023,1628997,22300366,"DEC 20, 2023",MIA @ ORL,W,18,1,3,0.333,1,1,1.0,2,2,1.0,0,5,5,0,1,0,1,2,5,3,1,MIA,ORL,MIA,115,4.5,Rebounds,10,10,5,5
Caleb Martin,F,22023,1628997,22300366,"DEC 20, 2023",MIA @ ORL,W,18,1,3,0.333,1,1,1.0,2,2,1.0,0,5,5,0,1,0,1,2,5,3,1,MIA,ORL,MIA,115,16.5,Pts+Rebs+Asts,10,10,5,5
Caleb Martin,F,22023,1628997,22300366,"DEC 20, 2023",MIA @ ORL,W,18,1,3,0.333,1,1,1.0,2,2,1.0,0,5,5,0,1,0,1,2,5,3,1,MIA,ORL,MIA,115,14.5,Pts+Rebs,10,10,5,5
Caleb Martin,F,22023,1628997,22300366,"DEC 20, 2023",MIA @ ORL,W,18,1,3,0.333,1,1,1.0,2,2,1.0,0,5,5,0,1,0,1,2,5,3,1,MIA,ORL,MIA,115,11.5,Pts+Asts,10,10,5,5
Caleb Martin,F,22023,1628997,22300353,"DEC 18, 2023",MIA vs. MIN,L,22,1,5,0.2,0,1,0.0,0,0,0.0,1,2,3,3,2,0,1,1,2,3,1,MIA,MIA,MIN,108,9.5,Points,8,5,5,6
Caleb Martin,F,22023,1628997,22300353,"DEC 18, 2023",MIA vs. MIN,L,22,1,5,0.2,0,1,0.0,0,0,0.0,1,2,3,3,2,0,1,1,2,3,1,MIA,MIA,MIN,108,4.5,Rebounds,8,5,5,6
Caleb Martin,F,22023,1628997,22300353,"DEC 18, 2023",MIA vs. MIN,L,22,1,5,0.2,0,1,0.0,0,0,0.0,1,2,3,3,2,0,1,1,2,3,1,MIA,MIA,MIN,108,16.5,Pts+Rebs+Asts,8,5,5,6
Caleb Martin,F,22023,1628997,22300353,"DEC 18, 2023",MIA vs. MIN,L,22,1,5,0.2,0,1,0.0,0,0,0.0,1,2,3,3,2,0,1,1,2,3,1,MIA,MIA,MIN,108,14.5,Pts+Rebs,8,5,5,6
Caleb Martin,F,22023,1628997,22300353,"DEC 18, 2023",MIA vs. MIN,L,22,1,5,0.2,0,1,0.0,0,0,0.0,1,2,3,3,2,0,1,1,2,3,1,MIA,MIA,MIN,108,11.5,Pts+Asts,8,5,5,6
Caleb Martin,F,22023,1628997,22300267,"NOV 30, 2023",MIA vs. IND,W,25,5,9,0.556,0,2,0.0,4,6,0.667,2,3,5,3,1,0,4,4,14,15,1,MIA,MIA,IND,142,9.5,Points,22,19,17,8
Caleb Martin,F,22023,1628997,22300267,"NOV 30, 2023",MIA vs. IND,W,25,5,9,0.556,0,2,0.0,4,6,0.667,2,3,5,3,1,0,4,4,14,15,1,MIA,MIA,IND,142,4.5,Rebounds,22,19,17,8
Caleb Martin,F,22023,1628997,22300267,"NOV 30, 2023",MIA vs. IND,W,25,5,9,0.556,0,2,0.0,4,6,0.667,2,3,5,3,1,0,4,4,14,15,1,MIA,MIA,IND,142,16.5,Pts+Rebs+Asts,22,19,17,8
Caleb Martin,F,22023,1628997,22300267,"NOV 30, 2023",MIA vs. IND,W,25,5,9,0.556,0,2,0.0,4,6,0.667,2,3,5,3,1,0,4,4,14,15,1,MIA,MIA,IND,142,14.5,Pts+Rebs,22,19,17,8
Caleb Martin,F,22023,1628997,22300267,"NOV 30, 2023",MIA vs. IND,W,25,5,9,0.556,0,2,0.0,4,6,0.667,2,3,5,3,1,0,4,4,14,15,1,MIA,MIA,IND,142,11.5,Pts+Asts,22,19,17,8
Caleb Martin,F,22023,1628997,22300056,"NOV 28, 2023",MIA vs. MIL,L,26,6,11,0.545,2,3,0.667,0,0,0.0,0,1,1,1,1,0,0,2,14,5,1,MIA,MIA,MIL,124,9.5,Points,16,15,15,2
Caleb Martin,F,22023,1628997,22300056,"NOV 28, 2023",MIA vs. MIL,L,26,6,11,0.545,2,3,0.667,0,0,0.0,0,1,1,1,1,0,0,2,14,5,1,MIA,MIA,MIL,124,4.5,Rebounds,16,15,15,2
Caleb Martin,F,22023,1628997,22300056,"NOV 28, 2023",MIA vs. MIL,L,26,6,11,0.545,2,3,0.667,0,0,0.0,0,1,1,1,1,0,0,2,14,5,1,MIA,MIA,MIL,124,16.5,Pts+Rebs+Asts,16,15,15,2
Caleb Martin,F,22023,1628997,22300056,"NOV 28, 2023",MIA vs. MIL,L,26,6,11,0.545,2,3,0.667,0,0,0.0,0,1,1,1,1,0,0,2,14,5,1,MIA,MIA,MIL,124,14.5,Pts+Rebs,16,15,15,2
Caleb Martin,F,22023,1628997,22300056,"NOV 28, 2023",MIA vs. MIL,L,26,6,11,0.545,2,3,0.667,0,0,0.0,0,1,1,1,1,0,0,2,14,5,1,MIA,MIA,MIL,124,11.5,Pts+Asts,16,15,15,2
Caleb Martin,F,22023,1628997,22300045,"NOV 24, 2023",MIA @ NYK,L,18,1,5,0.2,0,3,0.0,0,0,0.0,0,3,3,1,1,0,0,3,2,-1,1,MIA,NYK,MIA,98,9.5,Points,6,5,3,4
Caleb Martin,F,22023,1628997,22300045,"NOV 24, 2023",MIA @ NYK,L,18,1,5,0.2,0,3,0.0,0,0,0.0,0,3,3,1,1,0,0,3,2,-1,1,MIA,NYK,MIA,98,4.5,Rebounds,6,5,3,4
Caleb Martin,F,22023,1628997,22300045,"NOV 24, 2023",MIA @ NYK,L,18,1,5,0.2,0,3,0.0,0,0,0.0,0,3,3,1,1,0,0,3,2,-1,1,MIA,NYK,MIA,98,16.5,Pts+Rebs+Asts,6,5,3,4
Caleb Martin,F,22023,1628997,22300045,"NOV 24, 2023",MIA @ NYK,L,18,1,5,0.2,0,3,0.0,0,0,0.0,0,3,3,1,1,0,0,3,2,-1,1,MIA,NYK,MIA,98,14.5,Pts+Rebs,6,5,3,4
Caleb Martin,F,22023,1628997,22300045,"NOV 24, 2023",MIA @ NYK,L,18,1,5,0.2,0,3,0.0,0,0,0.0,0,3,3,1,1,0,0,3,2,-1,1,MIA,NYK,MIA,98,11.5,Pts+Asts,6,5,3,4
Caleb Martin,F,22023,1628997,22300220,"NOV 20, 2023",MIA @ CHI,W,21,1,6,0.167,0,3,0.0,0,0,0.0,0,4,4,2,1,0,0,1,2,3,1,MIA,CHI,MIA,118,9.5,Points,8,6,4,6
Caleb Martin,F,22023,1628997,22300220,"NOV 20, 2023",MIA @ CHI,W,21,1,6,0.167,0,3,0.0,0,0,0.0,0,4,4,2,1,0,0,1,2,3,1,MIA,CHI,MIA,118,4.5,Rebounds,8,6,4,6
Caleb Martin,F,22023,1628997,22300220,"NOV 20, 2023",MIA @ CHI,W,21,1,6,0.167,0,3,0.0,0,0,0.0,0,4,4,2,1,0,0,1,2,3,1,MIA,CHI,MIA,118,16.5,Pts+Rebs+Asts,8,6,4,6
Caleb Martin,F,22023,1628997,22300220,"NOV 20, 2023",MIA @ CHI,W,21,1,6,0.167,0,3,0.0,0,0,0.0,0,4,4,2,1,0,0,1,2,3,1,MIA,CHI,MIA,118,14.5,Pts+Rebs,8,6,4,6
Caleb Martin,F,22023,1628997,22300220,"NOV 20, 2023",MIA @ CHI,W,21,1,6,0.167,0,3,0.0,0,0,0.0,0,4,4,2,1,0,0,1,2,3,1,MIA,CHI,MIA,118,11.5,Pts+Asts,8,6,4,6
Caleb Martin,F,22023,1628997,22300204,"NOV 18, 2023",MIA @ CHI,L,15,2,9,0.222,1,4,0.25,0,0,0.0,1,1,2,0,1,0,1,1,5,-14,1,MIA,CHI,MIA,97,9.5,Points,7,7,5,2
Caleb Martin,F,22023,1628997,22300204,"NOV 18, 2023",MIA @ CHI,L,15,2,9,0.222,1,4,0.25,0,0,0.0,1,1,2,0,1,0,1,1,5,-14,1,MIA,CHI,MIA,97,4.5,Rebounds,7,7,5,2
Caleb Martin,F,22023,1628997,22300204,"NOV 18, 2023",MIA @ CHI,L,15,2,9,0.222,1,4,0.25,0,0,0.0,1,1,2,0,1,0,1,1,5,-14,1,MIA,CHI,MIA,97,16.5,Pts+Rebs+Asts,7,7,5,2
Caleb Martin,F,22023,1628997,22300204,"NOV 18, 2023",MIA @ CHI,L,15,2,9,0.222,1,4,0.25,0,0,0.0,1,1,2,0,1,0,1,1,5,-14,1,MIA,CHI,MIA,97,14.5,Pts+Rebs,7,7,5,2
Caleb Martin,F,22023,1628997,22300204,"NOV 18, 2023",MIA @ CHI,L,15,2,9,0.222,1,4,0.25,0,0,0.0,1,1,2,0,1,0,1,1,5,-14,1,MIA,CHI,MIA,97,11.5,Pts+Asts,7,7,5,2
Caleb Martin,F,22023,1628997,22300200,"NOV 16, 2023",MIA vs. BKN,W,12,2,4,0.5,2,3,0.667,0,0,0.0,1,0,1,2,0,0,1,2,6,-5,1,MIA,MIA,BKN,122,9.5,Points,9,7,8,3
Caleb Martin,F,22023,1628997,22300200,"NOV 16, 2023",MIA vs. BKN,W,12,2,4,0.5,2,3,0.667,0,0,0.0,1,0,1,2,0,0,1,2,6,-5,1,MIA,MIA,BKN,122,4.5,Rebounds,9,7,8,3
Caleb Martin,F,22023,1628997,22300200,"NOV 16, 2023",MIA vs. BKN,W,12,2,4,0.5,2,3,0.667,0,0,0.0,1,0,1,2,0,0,1,2,6,-5,1,MIA,MIA,BKN,122,16.5,Pts+Rebs+Asts,9,7,8,3
Caleb Martin,F,22023,1628997,22300200,"NOV 16, 2023",MIA vs. BKN,W,12,2,4,0.5,2,3,0.667,0,0,0.0,1,0,1,2,0,0,1,2,6,-5,1,MIA,MIA,BKN,122,14.5,Pts+Rebs,9,7,8,3
Caleb Martin,F,22023,1628997,22300200,"NOV 16, 2023",MIA vs. BKN,W,12,2,4,0.5,2,3,0.667,0,0,0.0,1,0,1,2,0,0,1,2,6,-5,1,MIA,MIA,BKN,122,11.5,Pts+Asts,9,7,8,3
Caleb Martin,F,22023,1628997,22300068,"OCT 25, 2023",MIA vs. DET,W,20,1,7,0.143,0,3,0.0,0,0,0.0,1,2,3,1,1,0,0,1,2,-5,1,MIA,MIA,DET,103,9.5,Points,6,5,3,4
Caleb Martin,F,22023,1628997,22300068,"OCT 25, 2023",MIA vs. DET,W,20,1,7,0.143,0,3,0.0,0,0,0.0,1,2,3,1,1,0,0,1,2,-5,1,MIA,MIA,DET,103,4.5,Rebounds,6,5,3,4
Caleb Martin,F,22023,1628997,22300068,"OCT 25, 2023",MIA vs. DET,W,20,1,7,0.143,0,3,0.0,0,0,0.0,1,2,3,1,1,0,0,1,2,-5,1,MIA,MIA,DET,103,16.5,Pts+Rebs+Asts,6,5,3,4
Caleb Martin,F,22023,1628997,22300068,"OCT 25, 2023",MIA vs. DET,W,20,1,7,0.143,0,3,0.0,0,0,0.0,1,2,3,1,1,0,0,1,2,-5,1,MIA,MIA,DET,103,14.5,Pts+Rebs,6,5,3,4
Caleb Martin,F,22023,1628997,22300068,"OCT 25, 2023",MIA vs. DET,W,20,1,7,0.143,0,3,0.0,0,0,0.0,1,2,3,1,1,0,0,1,2,-5,1,MIA,MIA,DET,103,11.5,Pts+Asts,6,5,3,4
Caleb Martin,F,22023,1628997,22300337,"DEC 16, 2023",MIA vs. CHI,W,37,6,8,0.75,0,0,0.0,5,8,0.625,2,2,4,2,2,0,2,4,17,9,1,MIA,MIA,CHI,118,9.5,Points,23,21,19,6
Caleb Martin,F,22023,1628997,22300337,"DEC 16, 2023",MIA vs. CHI,W,37,6,8,0.75,0,0,0.0,5,8,0.625,2,2,4,2,2,0,2,4,17,9,1,MIA,MIA,CHI,118,4.5,Rebounds,23,21,19,6
Caleb Martin,F,22023,1628997,22300337,"DEC 16, 2023",MIA vs. CHI,W,37,6,8,0.75,0,0,0.0,5,8,0.625,2,2,4,2,2,0,2,4,17,9,1,MIA,MIA,CHI,118,16.5,Pts+Rebs+Asts,23,21,19,6
Caleb Martin,F,22023,1628997,22300337,"DEC 16, 2023",MIA vs. CHI,W,37,6,8,0.75,0,0,0.0,5,8,0.625,2,2,4,2,2,0,2,4,17,9,1,MIA,MIA,CHI,118,14.5,Pts+Rebs,23,21,19,6
Caleb Martin,F,22023,1628997,22300337,"DEC 16, 2023",MIA vs. CHI,W,37,6,8,0.75,0,0,0.0,5,8,0.625,2,2,4,2,2,0,2,4,17,9,1,MIA,MIA,CHI,118,11.5,Pts+Asts,23,21,19,6
Caleb Martin,F,22023,1628997,22300320,"DEC 14, 2023",MIA vs. CHI,L,39,7,13,0.538,3,4,0.75,0,0,0.0,2,10,12,4,0,0,1,3,17,-9,1,MIA,MIA,CHI,116,9.5,Points,33,29,21,16
Caleb Martin,F,22023,1628997,22300320,"DEC 14, 2023",MIA vs. CHI,L,39,7,13,0.538,3,4,0.75,0,0,0.0,2,10,12,4,0,0,1,3,17,-9,1,MIA,MIA,CHI,116,4.5,Rebounds,33,29,21,16
Caleb Martin,F,22023,1628997,22300320,"DEC 14, 2023",MIA vs. CHI,L,39,7,13,0.538,3,4,0.75,0,0,0.0,2,10,12,4,0,0,1,3,17,-9,1,MIA,MIA,CHI,116,16.5,Pts+Rebs+Asts,33,29,21,16
Caleb Martin,F,22023,1628997,22300320,"DEC 14, 2023",MIA vs. CHI,L,39,7,13,0.538,3,4,0.75,0,0,0.0,2,10,12,4,0,0,1,3,17,-9,1,MIA,MIA,CHI,116,14.5,Pts+Rebs,33,29,21,16
Caleb Martin,F,22023,1628997,22300320,"DEC 14, 2023",MIA vs. CHI,L,39,7,13,0.538,3,4,0.75,0,0,0.0,2,10,12,4,0,0,1,3,17,-9,1,MIA,MIA,CHI,116,11.5,Pts+Asts,33,29,21,16
Caleb Martin,F,22023,1628997,22300312,"DEC 13, 2023",MIA vs. CHA,W,36,4,13,0.308,1,3,0.333,0,0,0.0,3,3,6,4,0,1,4,2,9,5,1,MIA,MIA,CHA,115,9.5,Points,19,15,13,10
Caleb Martin,F,22023,1628997,22300312,"DEC 13, 2023",MIA vs. CHA,W,36,4,13,0.308,1,3,0.333,0,0,0.0,3,3,6,4,0,1,4,2,9,5,1,MIA,MIA,CHA,115,4.5,Rebounds,19,15,13,10
Caleb Martin,F,22023,1628997,22300312,"DEC 13, 2023",MIA vs. CHA,W,36,4,13,0.308,1,3,0.333,0,0,0.0,3,3,6,4,0,1,4,2,9,5,1,MIA,MIA,CHA,115,16.5,Pts+Rebs+Asts,19,15,13,10
Caleb Martin,F,22023,1628997,22300312,"DEC 13, 2023",MIA vs. CHA,W,36,4,13,0.308,1,3,0.333,0,0,0.0,3,3,6,4,0,1,4,2,9,5,1,MIA,MIA,CHA,115,14.5,Pts+Rebs,19,15,13,10
Caleb Martin,F,22023,1628997,22300312,"DEC 13, 2023",MIA vs. CHA,W,36,4,13,0.308,1,3,0.333,0,0,0.0,3,3,6,4,0,1,4,2,9,5,1,MIA,MIA,CHA,115,11.5,Pts+Asts,19,15,13,10
Caleb Martin,F,22023,1628997,22300292,"DEC 11, 2023",MIA @ CHA,W,39,7,14,0.5,1,4,0.25,5,7,0.714,2,7,9,5,0,0,3,3,20,0,1,MIA,CHA,MIA,116,9.5,Points,34,29,25,14
Caleb Martin,F,22023,1628997,22300292,"DEC 11, 2023",MIA @ CHA,W,39,7,14,0.5,1,4,0.25,5,7,0.714,2,7,9,5,0,0,3,3,20,0,1,MIA,CHA,MIA,116,4.5,Rebounds,34,29,25,14
Caleb Martin,F,22023,1628997,22300292,"DEC 11, 2023",MIA @ CHA,W,39,7,14,0.5,1,4,0.25,5,7,0.714,2,7,9,5,0,0,3,3,20,0,1,MIA,CHA,MIA,116,16.5,Pts+Rebs+Asts,34,29,25,14
Caleb Martin,F,22023,1628997,22300292,"DEC 11, 2023",MIA @ CHA,W,39,7,14,0.5,1,4,0.25,5,7,0.714,2,7,9,5,0,0,3,3,20,0,1,MIA,CHA,MIA,116,14.5,Pts+Rebs,34,29,25,14
Caleb Martin,F,22023,1628997,22300292,"DEC 11, 2023",MIA @ CHA,W,39,7,14,0.5,1,4,0.25,5,7,0.714,2,7,9,5,0,0,3,3,20,0,1,MIA,CHA,MIA,116,11.5,Pts+Asts,34,29,25,14
Caleb Martin,F,22023,1628997,22300240,"NOV 25, 2023",MIA @ BKN,L,31,9,18,0.5,1,4,0.25,3,3,1.0,4,3,7,3,0,0,2,2,22,8,1,MIA,BKN,MIA,97,9.5,Points,32,29,25,10
Caleb Martin,F,22023,1628997,22300240,"NOV 25, 2023",MIA @ BKN,L,31,9,18,0.5,1,4,0.25,3,3,1.0,4,3,7,3,0,0,2,2,22,8,1,MIA,BKN,MIA,97,4.5,Rebounds,32,29,25,10
Caleb Martin,F,22023,1628997,22300240,"NOV 25, 2023",MIA @ BKN,L,31,9,18,0.5,1,4,0.25,3,3,1.0,4,3,7,3,0,0,2,2,22,8,1,MIA,BKN,MIA,97,16.5,Pts+Rebs+Asts,32,29,25,10
Caleb Martin,F,22023,1628997,22300240,"NOV 25, 2023",MIA @ BKN,L,31,9,18,0.5,1,4,0.25,3,3,1.0,4,3,7,3,0,0,2,2,22,8,1,MIA,BKN,MIA,97,14.5,Pts+Rebs,32,29,25,10
Caleb Martin,F,22023,1628997,22300240,"NOV 25, 2023",MIA @ BKN,L,31,9,18,0.5,1,4,0.25,3,3,1.0,4,3,7,3,0,0,2,2,22,8,1,MIA,BKN,MIA,97,11.5,Pts+Asts,32,29,25,10
Caleb Martin,F,22023,1628997,22300229,"NOV 22, 2023",MIA @ CLE,W,26,5,12,0.417,2,5,0.4,2,2,1.0,0,3,3,1,3,0,1,0,14,12,1,MIA,CLE,MIA,129,9.5,Points,18,17,15,4
Caleb Martin,F,22023,1628997,22300229,"NOV 22, 2023",MIA @ CLE,W,26,5,12,0.417,2,5,0.4,2,2,1.0,0,3,3,1,3,0,1,0,14,12,1,MIA,CLE,MIA,129,4.5,Rebounds,18,17,15,4
Caleb Martin,F,22023,1628997,22300229,"NOV 22, 2023",MIA @ CLE,W,26,5,12,0.417,2,5,0.4,2,2,1.0,0,3,3,1,3,0,1,0,14,12,1,MIA,CLE,MIA,129,16.5,Pts+Rebs+Asts,18,17,15,4
Caleb Martin,F,22023,1628997,22300229,"NOV 22, 2023",MIA @ CLE,W,26,5,12,0.417,2,5,0.4,2,2,1.0,0,3,3,1,3,0,1,0,14,12,1,MIA,CLE,MIA,129,14.5,Pts+Rebs,18,17,15,4
Caleb Martin,F,22023,1628997,22300229,"NOV 22, 2023",MIA @ CLE,W,26,5,12,0.417,2,5,0.4,2,2,1.0,0,3,3,1,3,0,1,0,14,12,1,MIA,CLE,MIA,129,11.5,Pts+Asts,18,17,15,4
Caleb Martin,F,22023,1628997,22301220,"DEC 08, 2023",MIA vs. CLE,L,34,6,15,0.4,3,8,0.375,0,2,0.0,1,5,6,4,0,2,1,5,15,-18,1,MIA,MIA,CLE,99,9.5,Points,25,21,19,10
Caleb Martin,F,22023,1628997,22301220,"DEC 08, 2023",MIA vs. CLE,L,34,6,15,0.4,3,8,0.375,0,2,0.0,1,5,6,4,0,2,1,5,15,-18,1,MIA,MIA,CLE,99,4.5,Rebounds,25,21,19,10
Caleb Martin,F,22023,1628997,22301220,"DEC 08, 2023",MIA vs. CLE,L,34,6,15,0.4,3,8,0.375,0,2,0.0,1,5,6,4,0,2,1,5,15,-18,1,MIA,MIA,CLE,99,16.5,Pts+Rebs+Asts,25,21,19,10
Caleb Martin,F,22023,1628997,22301220,"DEC 08, 2023",MIA vs. CLE,L,34,6,15,0.4,3,8,0.375,0,2,0.0,1,5,6,4,0,2,1,5,15,-18,1,MIA,MIA,CLE,99,14.5,Pts+Rebs,25,21,19,10
Caleb Martin,F,22023,1628997,22301220,"DEC 08, 2023",MIA vs. CLE,L,34,6,15,0.4,3,8,0.375,0,2,0.0,1,5,6,4,0,2,1,5,15,-18,1,MIA,MIA,CLE,99,11.5,Pts+Asts,25,21,19,10
Caleb Martin,F,22023,1628997,22301207,"DEC 06, 2023",MIA @ TOR,W,31,9,16,0.563,4,7,0.571,2,4,0.5,2,10,12,3,0,1,0,1,24,17,1,MIA,TOR,MIA,112,9.5,Points,39,36,27,15
Caleb Martin,F,22023,1628997,22301207,"DEC 06, 2023",MIA @ TOR,W,31,9,16,0.563,4,7,0.571,2,4,0.5,2,10,12,3,0,1,0,1,24,17,1,MIA,TOR,MIA,112,4.5,Rebounds,39,36,27,15
Caleb Martin,F,22023,1628997,22301207,"DEC 06, 2023",MIA @ TOR,W,31,9,16,0.563,4,7,0.571,2,4,0.5,2,10,12,3,0,1,0,1,24,17,1,MIA,TOR,MIA,112,16.5,Pts+Rebs+Asts,39,36,27,15
Caleb Martin,F,22023,1628997,22301207,"DEC 06, 2023",MIA @ TOR,W,31,9,16,0.563,4,7,0.571,2,4,0.5,2,10,12,3,0,1,0,1,24,17,1,MIA,TOR,MIA,112,14.5,Pts+Rebs,39,36,27,15
Caleb Martin,F,22023,1628997,22301207,"DEC 06, 2023",MIA @ TOR,W,31,9,16,0.563,4,7,0.571,2,4,0.5,2,10,12,3,0,1,0,1,24,17,1,MIA,TOR,MIA,112,11.5,Pts+Asts,39,36,27,15
Caleb Martin,F,22023,1628997,22300284,"DEC 02, 2023",MIA vs. IND,L,35,8,15,0.533,2,4,0.5,0,0,0.0,1,1,2,3,1,0,3,3,18,-8,1,MIA,MIA,IND,129,9.5,Points,23,20,21,5
Caleb Martin,F,22023,1628997,22300284,"DEC 02, 2023",MIA vs. IND,L,35,8,15,0.533,2,4,0.5,0,0,0.0,1,1,2,3,1,0,3,3,18,-8,1,MIA,MIA,IND,129,4.5,Rebounds,23,20,21,5
Caleb Martin,F,22023,1628997,22300284,"DEC 02, 2023",MIA vs. IND,L,35,8,15,0.533,2,4,0.5,0,0,0.0,1,1,2,3,1,0,3,3,18,-8,1,MIA,MIA,IND,129,16.5,Pts+Rebs+Asts,23,20,21,5
Caleb Martin,F,22023,1628997,22300284,"DEC 02, 2023",MIA vs. IND,L,35,8,15,0.533,2,4,0.5,0,0,0.0,1,1,2,3,1,0,3,3,18,-8,1,MIA,MIA,IND,129,14.5,Pts+Rebs,23,20,21,5
Caleb Martin,F,22023,1628997,22300284,"DEC 02, 2023",MIA vs. IND,L,35,8,15,0.533,2,4,0.5,0,0,0.0,1,1,2,3,1,0,3,3,18,-8,1,MIA,MIA,IND,129,11.5,Pts+Asts,23,20,21,5
Jordan Hawkins,G,22023,1641722,22300758,"FEB 10, 2024",NOP @ POR,W,14,0,3,0.0,0,2,0.0,0,0,0.0,1,2,3,1,0,0,0,0,0,2,1,NOP,POR,NOP,93,,,4,3,1,4
Jordan Hawkins,G,22023,1641722,22300747,"FEB 09, 2024",NOP @ LAL,L,3,2,3,0.667,1,2,0.5,0,0,0.0,0,0,0,0,1,0,1,0,5,-2,1,NOP,LAL,NOP,122,,,5,5,5,0
Jordan Hawkins,G,22023,1641722,22300731,"FEB 07, 2024",NOP @ LAC,W,2,1,3,0.333,1,1,1.0,0,0,0.0,0,0,0,0,0,0,0,0,3,-2,1,NOP,LAC,NOP,117,,,3,3,3,0
Jordan Hawkins,G,22023,1641722,22300718,"FEB 05, 2024",NOP vs. TOR,W,7,2,3,0.667,0,1,0.0,0,0,0.0,0,0,0,0,1,0,0,0,4,-2,1,NOP,NOP,TOR,138,,,4,4,4,0
Jordan Hawkins,G,22023,1641722,22300696,"FEB 02, 2024",NOP @ SAS,W,11,1,5,0.2,0,4,0.0,0,0,0.0,0,0,0,0,0,0,0,0,2,0,1,NOP,SAS,NOP,114,,,2,2,2,0
Jordan Hawkins,G,22023,1641722,22300679,"JAN 31, 2024",NOP @ HOU,W,23,1,5,0.2,1,4,0.25,0,0,0.0,2,4,6,2,0,0,1,1,3,17,1,NOP,HOU,NOP,110,,,11,9,5,8
Jordan Hawkins,G,22023,1641722,22300648,"JAN 27, 2024",NOP @ MIL,L,29,2,10,0.2,2,6,0.333,2,2,1.0,1,6,7,1,0,0,3,0,8,-11,1,NOP,MIL,NOP,117,,,16,15,9,8
Jordan Hawkins,G,22023,1641722,22300640,"JAN 26, 2024",NOP vs. OKC,L,20,2,5,0.4,2,4,0.5,3,3,1.0,0,1,1,4,0,0,1,1,9,-8,1,NOP,NOP,OKC,83,,,14,10,13,5
Jordan Hawkins,G,22023,1641722,22300616,"JAN 23, 2024",NOP vs. UTA,W,16,2,4,0.5,2,4,0.5,0,0,0.0,0,2,2,0,0,1,0,1,6,9,1,NOP,NOP,UTA,153,,,8,8,6,2
Jordan Hawkins,G,22023,1641722,22300588,"JAN 19, 2024",NOP vs. PHX,L,17,5,11,0.455,3,8,0.375,0,0,0.0,0,2,2,1,0,0,1,0,13,-4,1,NOP,NOP,PHX,109,,,16,15,14,3
Jordan Hawkins,G,22023,1641722,22300575,"JAN 17, 2024",NOP vs. CHA,W,24,7,12,0.583,6,9,0.667,1,2,0.5,2,4,6,1,1,0,2,1,21,5,1,NOP,NOP,CHA,132,,,28,27,22,7
Jordan Hawkins,G,22023,1641722,22300547,"JAN 13, 2024",NOP @ DAL,W,37,11,19,0.579,6,12,0.5,6,8,0.75,3,2,5,4,2,0,3,3,34,10,1,NOP,DAL,NOP,118,,,43,39,38,9
Jordan Hawkins,G,22023,1641722,22300539,"JAN 12, 2024",NOP @ DEN,L,2,0,0,0.0,0,0,0.0,0,0,0.0,0,0,0,0,0,0,0,0,0,6,1,NOP,DEN,NOP,113,,,0,0,0,0
Jordan Hawkins,G,22023,1641722,22300486,"JAN 05, 2024",NOP vs. LAC,L,6,4,7,0.571,3,3,1.0,2,2,1.0,0,1,1,0,0,0,0,0,13,12,1,NOP,NOP,LAC,95,,,14,14,13,1
Jordan Hawkins,G,22023,1641722,22300471,"JAN 03, 2024",NOP @ MIN,W,3,1,2,0.5,0,1,0.0,0,0,0.0,0,0,0,0,0,0,0,0,2,-1,1,NOP,MIN,NOP,117,,,2,2,2,0
Jordan Hawkins,G,22023,1641722,22300461,"JAN 02, 2024",NOP vs. BKN,W,26,3,13,0.231,2,8,0.25,3,4,0.75,0,0,0,1,0,2,0,0,11,14,1,NOP,NOP,BKN,112,,,12,11,12,1
Jordan Hawkins,G,22023,1641722,22300446,"DEC 31, 2023",NOP vs. LAL,W,8,0,1,0.0,0,1,0.0,1,1,1.0,0,2,2,1,0,0,0,1,1,4,1,NOP,NOP,LAL,129,,,4,3,2,3
Jordan Hawkins,G,22023,1641722,22300375,"DEC 21, 2023",NOP @ CLE,W,12,2,5,0.4,2,3,0.667,0,0,0.0,0,0,0,2,0,0,0,1,6,-4,1,NOP,CLE,NOP,123,,,8,6,8,2
Jordan Hawkins,G,22023,1641722,22300345,"DEC 17, 2023",NOP @ SAS,W,12,3,6,0.5,1,4,0.25,0,0,0.0,0,2,2,0,0,0,0,0,7,-1,1,NOP,SAS,NOP,146,,,9,9,7,2
Jordan Hawkins,G,22023,1641722,22300326,"DEC 15, 2023",NOP @ CHA,W,4,0,1,0.0,0,1,0.0,0,0,0.0,0,0,0,0,0,0,0,0,0,-3,1,NOP,CHA,NOP,112,,,0,0,0,0
Jordan Hawkins,G,22023,1641722,22300311,"DEC 13, 2023",NOP @ WAS,W,19,1,7,0.143,0,2,0.0,0,0,0.0,1,1,2,1,0,0,0,1,2,15,1,NOP,WAS,NOP,142,,,5,4,3,3
Jordan Hawkins,G,22023,1641722,22300301,"DEC 11, 2023",NOP vs. MIN,W,1,0,1,0.0,0,0,0.0,0,0,0.0,0,0,0,0,0,0,0,0,0,-3,1,NOP,NOP,MIN,121,,,0,0,0,0
Jordan Hawkins,G,22023,1641722,22301230,"DEC 07, 2023",NOP @ LAL,L,12,2,8,0.25,0,3,0.0,0,0,0.0,0,2,2,0,0,0,0,1,4,-5,1,NOP,LAL,NOP,89,,,6,6,4,2
Jordan Hawkins,G,22023,1641722,22300285,"DEC 02, 2023",NOP @ CHI,L,25,2,6,0.333,2,5,0.4,4,4,1.0,0,1,1,0,0,0,0,2,10,-9,1,NOP,CHI,NOP,118,,,11,11,10,1
Jordan Hawkins,G,22023,1641722,22300262,"NOV 29, 2023",NOP vs. PHI,W,24,4,10,0.4,3,8,0.375,5,6,0.833,2,3,5,2,0,0,2,2,16,-7,1,NOP,NOP,PHI,124,,,23,21,18,7
Jordan Hawkins,G,22023,1641722,22300256,"NOV 27, 2023",NOP @ UTA,L,25,5,11,0.455,3,6,0.5,0,0,0.0,1,4,5,0,0,0,0,1,13,-8,1,NOP,UTA,NOP,112,,,18,18,13,5
Jordan Hawkins,G,22023,1641722,22300243,"NOV 25, 2023",NOP @ UTA,L,40,8,17,0.471,5,12,0.417,4,5,0.8,1,5,6,3,1,0,4,1,25,4,1,NOP,UTA,NOP,100,,,34,31,28,9
Jordan Hawkins,G,22023,1641722,22300052,"NOV 24, 2023",NOP @ LAC,W,20,3,5,0.6,2,4,0.5,0,0,0.0,0,4,4,1,0,0,0,1,8,3,1,NOP,LAC,NOP,116,,,13,12,9,5
Jordan Hawkins,G,22023,1641722,22300233,"NOV 22, 2023",NOP vs. SAC,W,21,3,9,0.333,2,8,0.25,5,5,1.0,1,1,2,3,0,0,0,3,13,2,1,NOP,NOP,SAC,117,,,18,15,16,5
Jordan Hawkins,G,22023,1641722,22300222,"NOV 20, 2023",NOP vs. SAC,W,29,3,11,0.273,2,5,0.4,1,1,1.0,1,4,5,2,0,0,1,2,9,8,1,NOP,NOP,SAC,129,,,16,14,11,7
Jordan Hawkins,G,22023,1641722,22300659,"JAN 29, 2024",NOP @ BOS,L,9,0,2,0.0,0,2,0.0,0,0,0.0,0,3,3,0,1,0,0,1,0,-5,1,NOP,BOS,NOP,112,,,3,3,0,3
Jordan Hawkins,G,22023,1641722,22300556,"JAN 15, 2024",NOP @ DAL,L,21,3,4,0.75,1,2,0.5,2,2,1.0,0,1,1,0,1,0,0,3,9,8,1,NOP,DAL,NOP,120,,,10,10,9,1
Jordan Hawkins,G,22023,1641722,22300525,"JAN 10, 2024",NOP @ GSW,W,21,5,9,0.556,4,5,0.8,0,0,0.0,0,1,1,2,0,0,0,1,14,25,1,NOP,GSW,NOP,141,,,17,15,16,3
Jordan Hawkins,G,22023,1641722,22300500,"JAN 07, 2024",NOP @ SAC,W,24,5,9,0.556,1,5,0.2,1,2,0.5,0,3,3,2,0,1,2,2,12,3,1,NOP,SAC,NOP,133,,,17,15,14,5
Jordan Hawkins,G,22023,1641722,22300278,"DEC 01, 2023",NOP vs. SAS,W,15,1,3,0.333,1,2,0.5,0,0,0.0,0,0,0,0,0,0,1,1,3,-9,1,NOP,NOP,SAS,121,,,3,3,3,0
Jordan Hawkins,G,22023,1641722,22300203,"NOV 18, 2023",NOP vs. MIN,L,37,6,12,0.5,3,8,0.375,0,0,0.0,1,1,2,4,1,0,1,4,15,-7,1,NOP,NOP,MIN,120,,,21,17,19,6
Jordan Hawkins,G,22023,1641722,22300034,"NOV 17, 2023",NOP vs. DEN,W,26,3,7,0.429,1,3,0.333,0,0,0.0,0,5,5,4,0,0,0,0,7,-3,1,NOP,NOP,DEN,115,,,16,12,11,9
Jordan Hawkins,G,22023,1641722,22300022,"NOV 14, 2023",NOP vs. DAL,W,33,8,17,0.471,5,12,0.417,4,4,1.0,2,4,6,3,0,0,0,3,25,13,1,NOP,NOP,DAL,131,,,34,31,28,9
Jordan Hawkins,G,22023,1641722,22300183,"NOV 12, 2023",NOP vs. DAL,L,28,3,13,0.231,2,9,0.222,2,2,1.0,0,2,2,2,0,0,2,1,10,-28,1,NOP,NOP,DAL,124,,,14,12,12,4
Jordan Hawkins,G,22023,1641722,22300011,"NOV 10, 2023",NOP @ HOU,L,41,4,11,0.364,3,8,0.375,3,4,0.75,0,7,7,1,2,0,3,6,14,1,1,NOP,HOU,NOP,101,,,22,21,15,8
Jordan Hawkins,G,22023,1641722,22300166,"NOV 08, 2023",NOP @ MIN,L,30,4,11,0.364,2,5,0.4,4,4,1.0,0,1,1,1,0,0,2,5,14,-19,1,NOP,MIN,NOP,101,,,16,15,15,2
Jordan Hawkins,G,22023,1641722,22300156,"NOV 06, 2023",NOP @ DEN,L,38,10,19,0.526,7,14,0.5,4,5,0.8,1,6,7,3,1,0,1,2,31,-15,1,NOP,DEN,NOP,116,,,41,38,34,10
Jordan Hawkins,G,22023,1641722,22300135,"NOV 04, 2023",NOP vs. ATL,L,24,5,11,0.455,4,8,0.5,1,1,1.0,0,5,5,0,1,0,1,3,15,-3,1,NOP,NOP,ATL,105,,,20,20,15,5
Jordan Hawkins,G,22023,1641722,22300129,"NOV 02, 2023",NOP vs. DET,W,29,1,7,0.143,1,5,0.2,3,3,1.0,0,1,1,0,0,0,1,0,6,-8,1,NOP,NOP,DET,125,,,7,7,6,1
Jordan Hawkins,G,22023,1641722,22300121,"NOV 01, 2023",NOP @ OKC,W,37,4,19,0.211,2,13,0.154,0,0,0.0,4,2,6,4,2,0,1,2,10,17,1,NOP,OKC,NOP,110,,,20,16,14,10
Jordan Hawkins,G,22023,1641722,22300108,"OCT 30, 2023",NOP vs. GSW,L,35,6,13,0.462,2,7,0.286,0,2,0.0,2,3,5,2,2,0,1,1,14,-14,1,NOP,NOP,GSW,102,,,21,19,16,7
Jordan Hawkins,G,22023,1641722,22300090,"OCT 28, 2023",NOP vs. NYK,W,18,3,7,0.429,3,6,0.5,0,0,0.0,0,4,4,1,0,0,1,0,9,1,1,NOP,NOP,NYK,96,,,14,13,10,5
Jordan Hawkins,G,22023,1641722,22300071,"OCT 25, 2023",NOP @ MEM,W,9,1,2,0.5,1,2,0.5,0,0,0.0,0,0,0,2,0,0,0,2,3,14,1,NOP,MEM,NOP,111,,,5,3,5,2
Dario Saric,F-C,22023,203967,22300757,"FEB 10, 2024",GSW vs. PHX,W,11,0,3,0.0,0,1,0.0,0,0,0.0,0,1,1,2,1,0,0,1,0,-10,1,GSW,GSW,PHX,113,,,3,1,2,3
Dario Saric,F-C,22023,203967,22300733,"FEB 08, 2024",GSW @ IND,W,18,4,6,0.667,2,3,0.667,1,1,1.0,2,5,7,3,0,0,2,1,11,12,1,GSW,IND,GSW,131,,,21,18,14,10
Dario Saric,F-C,22023,203967,22300727,"FEB 07, 2024",GSW @ PHI,W,14,3,5,0.6,1,2,0.5,2,2,1.0,0,3,3,2,1,0,2,2,9,-4,1,GSW,PHI,GSW,127,,,14,12,11,5
Dario Saric,F-C,22023,203967,22300717,"FEB 05, 2024",GSW @ BKN,W,4,1,3,0.333,0,1,0.0,1,1,1.0,0,0,0,0,1,0,0,0,3,-3,1,GSW,BKN,GSW,109,,,3,3,3,0
Dario Saric,F-C,22023,203967,22300673,"JAN 30, 2024",GSW vs. PHI,W,17,0,2,0.0,0,1,0.0,2,2,1.0,0,2,2,7,0,1,1,3,2,-4,1,GSW,GSW,PHI,119,,,11,4,9,9
Dario Saric,F-C,22023,203967,22300650,"JAN 27, 2024",GSW vs. LAL,L,15,2,8,0.25,1,3,0.333,0,0,0.0,2,2,4,2,1,0,2,3,5,-1,1,GSW,GSW,LAL,144,,,11,9,7,6
Dario Saric,F-C,22023,203967,22300632,"JAN 25, 2024",GSW vs. SAC,L,20,5,6,0.833,4,4,1.0,0,0,0.0,2,2,4,5,0,0,2,2,14,-15,1,GSW,GSW,SAC,133,,,23,18,19,9
Dario Saric,F-C,22023,203967,22300626,"JAN 24, 2024",GSW vs. ATL,W,16,4,6,0.667,2,3,0.667,0,0,0.0,1,2,3,3,1,0,0,0,10,2,1,GSW,GSW,ATL,134,,,16,13,13,6
Dario Saric,F-C,22023,203967,22300560,"JAN 15, 2024",GSW @ MEM,L,23,3,6,0.5,3,5,0.6,4,4,1.0,0,7,7,3,0,1,4,5,13,-6,1,GSW,MEM,GSW,107,,,23,20,16,10
Dario Saric,F-C,22023,203967,22300536,"JAN 12, 2024",GSW @ CHI,W,28,4,6,0.667,2,3,0.667,2,4,0.5,1,6,7,6,2,0,0,2,12,6,1,GSW,CHI,GSW,140,,,25,19,18,13
Dario Saric,F-C,22023,203967,22300525,"JAN 10, 2024",GSW vs. NOP,L,13,1,3,0.333,0,2,0.0,2,2,1.0,1,2,3,3,1,0,2,2,4,-24,1,GSW,GSW,NOP,105,,,10,7,7,6
Dario Saric,F-C,22023,203967,22300504,"JAN 07, 2024",GSW vs. TOR,L,18,4,10,0.4,2,5,0.4,1,1,1.0,2,3,5,4,2,0,0,1,11,-4,1,GSW,GSW,TOR,118,,,20,16,15,9
Dario Saric,F-C,22023,203967,22300490,"JAN 05, 2024",GSW vs. DET,W,22,6,10,0.6,3,5,0.6,2,2,1.0,0,3,3,1,0,0,1,3,17,-7,1,GSW,GSW,DET,113,,,21,20,18,4
Dario Saric,F-C,22023,203967,22300478,"JAN 04, 2024",GSW vs. DEN,L,23,5,7,0.714,1,2,0.5,2,2,1.0,1,6,7,6,1,0,2,1,13,3,1,GSW,GSW,DEN,127,,,26,20,19,13
Dario Saric,F-C,22023,203967,22300463,"JAN 02, 2024",GSW vs. ORL,W,14,1,3,0.333,0,1,0.0,0,0,0.0,1,2,3,1,0,0,2,0,2,-8,1,GSW,GSW,ORL,121,,,6,5,3,4
Dario Saric,F-C,22023,203967,22300444,"DEC 30, 2023",GSW vs. DAL,L,15,1,4,0.25,1,4,0.25,0,0,0.0,2,7,9,4,1,0,2,1,3,-1,1,GSW,GSW,DAL,122,,,16,12,7,13
Dario Saric,F-C,22023,203967,22300426,"DEC 28, 2023",GSW vs. MIA,L,20,4,5,0.8,1,1,1.0,1,1,1.0,1,5,6,1,0,0,0,1,10,-10,1,GSW,GSW,MIA,102,,,17,16,11,7
Dario Saric,F-C,22023,203967,22300402,"DEC 25, 2023",GSW @ DEN,L,20,5,11,0.455,0,3,0.0,4,4,1.0,2,3,5,2,0,0,0,2,14,11,1,GSW,DEN,GSW,114,,,21,19,16,7
Dario Saric,F-C,22023,203967,22300399,"DEC 23, 2023",GSW vs. POR,W,19,3,7,0.429,0,2,0.0,2,2,1.0,2,3,5,1,1,0,1,2,8,6,1,GSW,GSW,POR,126,,,14,13,9,6
Dario Saric,F-C,22023,203967,22300386,"DEC 22, 2023",GSW vs. WAS,W,20,5,11,0.455,1,4,0.25,2,2,1.0,0,3,3,1,0,0,0,1,13,17,1,GSW,GSW,WAS,129,,,17,16,14,4
Dario Saric,F-C,22023,203967,22300362,"DEC 19, 2023",GSW vs. BOS,W,15,3,6,0.5,3,4,0.75,2,2,1.0,2,4,6,0,0,0,1,2,11,0,1,GSW,GSW,BOS,132,,,17,17,11,6
Dario Saric,F-C,22023,203967,22300348,"DEC 17, 2023",GSW @ POR,W,15,2,4,0.5,2,3,0.667,2,2,1.0,0,1,1,1,0,0,2,3,8,-2,1,GSW,POR,GSW,118,,,10,9,9,2
Dario Saric,F-C,22023,203967,22300339,"DEC 16, 2023",GSW vs. BKN,W,21,5,8,0.625,2,3,0.667,0,0,0.0,3,3,6,2,1,0,2,3,12,-4,1,GSW,GSW,BKN,124,,,20,18,14,8
Dario Saric,F-C,22023,203967,22300325,"DEC 14, 2023",GSW @ LAC,L,17,2,5,0.4,1,4,0.25,0,0,0.0,0,6,6,1,0,0,1,2,5,3,1,GSW,LAC,GSW,113,,,12,11,6,7
Dario Saric,F-C,22023,203967,22300308,"DEC 12, 2023",GSW @ PHX,L,20,5,9,0.556,2,4,0.5,3,4,0.75,1,3,4,1,0,0,0,5,15,21,1,GSW,PHX,GSW,116,,,20,19,16,5
Dario Saric,F-C,22023,203967,22301222,"DEC 08, 2023",GSW @ OKC,L,23,3,8,0.375,2,6,0.333,3,4,0.75,6,6,12,3,1,0,3,2,11,4,1,GSW,OKC,GSW,136,,,26,23,14,15
Dario Saric,F-C,22023,203967,22301214,"DEC 06, 2023",GSW vs. POR,W,20,4,7,0.571,2,3,0.667,3,4,0.75,2,4,6,0,0,0,4,3,13,7,1,GSW,GSW,POR,110,,,19,19,13,6
Dario Saric,F-C,22023,203967,22300280,"DEC 02, 2023",GSW @ LAC,L,20,3,7,0.429,0,2,0.0,0,0,0.0,0,2,2,3,1,0,3,2,6,-8,1,GSW,LAC,GSW,112,,,11,8,9,5
Dario Saric,F-C,22023,203967,22300273,"NOV 30, 2023",GSW vs. LAC,W,27,4,7,0.571,2,4,0.5,3,4,0.75,0,5,5,5,1,0,0,2,13,15,1,GSW,GSW,LAC,120,,,23,18,18,10
Dario Saric,F-C,22023,203967,22300060,"NOV 28, 2023",GSW @ SAC,L,17,3,7,0.429,2,4,0.5,2,2,1.0,1,1,2,3,0,0,0,3,10,-10,1,GSW,SAC,GSW,123,,,15,12,13,5
Dario Saric,F-C,22023,203967,22300051,"NOV 24, 2023",GSW vs. SAS,W,26,7,11,0.636,4,7,0.571,2,2,1.0,2,5,7,4,2,0,3,3,20,13,1,GSW,GSW,SAS,118,,,31,27,24,11
Dario Saric,F-C,22023,203967,22300236,"NOV 22, 2023",GSW @ PHX,L,22,6,9,0.667,2,3,0.667,3,5,0.6,2,4,6,4,2,0,1,4,17,12,1,GSW,PHX,GSW,115,,,27,23,21,10
Dario Saric,F-C,22023,203967,22300224,"NOV 20, 2023",GSW vs. HOU,W,26,5,10,0.5,3,7,0.429,5,6,0.833,0,5,5,2,1,1,1,2,18,5,1,GSW,GSW,HOU,121,,,25,23,20,7
Dario Saric,F-C,22023,203967,22300207,"NOV 18, 2023",GSW vs. OKC,L,18,3,9,0.333,0,2,0.0,0,0,0.0,2,6,8,1,0,0,1,1,6,-6,1,GSW,GSW,OKC,123,,,15,14,7,9
Dario Saric,F-C,22023,203967,22300186,"NOV 12, 2023",GSW vs. MIN,L,27,5,10,0.5,1,4,0.25,0,0,0.0,3,7,10,1,1,0,1,4,11,2,1,GSW,GSW,MIN,110,,,22,21,12,11
Dario Saric,F-C,22023,203967,22300176,"NOV 11, 2023",GSW vs. CLE,L,16,2,5,0.4,0,3,0.0,1,1,1.0,0,5,5,1,0,1,0,3,5,0,1,GSW,GSW,CLE,110,,,11,10,6,6
Dario Saric,F-C,22023,203967,22300169,"NOV 08, 2023",GSW @ DEN,L,26,2,5,0.4,0,3,0.0,0,0,0.0,1,7,8,2,0,0,0,0,4,-12,1,GSW,DEN,GSW,105,,,14,12,6,10
Dario Saric,F-C,22023,203967,22300145,"NOV 06, 2023",GSW @ DET,W,21,4,8,0.5,2,5,0.4,2,2,1.0,3,3,6,1,1,0,0,1,12,1,1,GSW,DET,GSW,120,,,19,18,13,7
Dario Saric,F-C,22023,203967,22300142,"NOV 05, 2023",GSW @ CLE,L,13,0,3,0.0,0,1,0.0,0,0,0.0,1,4,5,0,0,0,1,2,0,-4,1,GSW,CLE,GSW,104,,,5,5,0,5
Dario Saric,F-C,22023,203967,22300005,"NOV 03, 2023",GSW @ OKC,W,20,6,9,0.667,4,7,0.571,4,4,1.0,1,5,6,3,1,0,1,2,20,3,1,GSW,OKC,GSW,141,,,29,26,23,9
Dario Saric,F-C,22023,203967,22300126,"NOV 01, 2023",GSW vs. SAC,W,20,6,9,0.667,3,5,0.6,0,0,0.0,0,6,6,2,0,0,4,1,15,3,1,GSW,GSW,SAC,102,,,23,21,17,8
Dario Saric,F-C,22023,203967,22300108,"OCT 30, 2023",GSW @ NOP,W,21,2,7,0.286,1,4,0.25,1,2,0.5,4,6,10,2,0,1,0,2,6,14,1,GSW,NOP,GSW,130,,,18,16,8,12
Dario Saric,F-C,22023,203967,22300096,"OCT 29, 2023",GSW @ HOU,W,21,1,6,0.167,1,3,0.333,1,2,0.5,3,5,8,5,0,1,1,0,4,6,1,GSW,HOU,GSW,106,,,17,12,9,13
Dario Saric,F-C,22023,203967,22300087,"OCT 27, 2023",GSW @ SAC,W,14,2,5,0.4,1,4,0.25,0,0,0.0,1,3,4,1,1,0,1,4,5,-6,1,GSW,SAC,GSW,122,,,10,9,6,5
Dario Saric,F-C,22023,203967,22300062,"OCT 24, 2023",GSW vs. PHX,L,20,3,11,0.273,1,3,0.333,0,0,0.0,4,3,7,1,0,2,0,3,7,7,1,GSW,GSW,PHX,104,,,15,14,8,8
Dario Saric,F-C,22023,203967,22300025,"NOV 14, 2023",GSW vs. MIN,L,32,6,15,0.4,3,11,0.273,6,6,1.0,1,3,4,4,2,0,2,4,21,-5,1,GSW,GSW,MIN,101,,,29,25,25,8
Dario Saric,F-C,22023,203967,22300545,"JAN 13, 2024",GSW @ MIL,L,34,5,9,0.556,1,5,0.2,1,2,0.5,0,6,6,6,1,0,3,1,12,-6,1,GSW,MIL,GSW,118,,,24,18,18,12
Dario Saric,F-C,22023,203967,22300201,"NOV 16, 2023",GSW vs. OKC,L,24,4,10,0.4,2,3,0.667,2,2,1.0,1,2,3,4,1,0,1,4,12,-3,1,GSW,GSW,OKC,109,,,19,15,16,7
Kentavious Caldwell-Pope,G,22023,203484,22300712,"FEB 04, 2024",DEN vs. POR,W,31,3,9,0.333,2,5,0.4,3,3,1.0,0,3,3,0,1,0,1,0,11,-5,1,DEN,DEN,POR,112,,,14,14,11,3
Kentavious Caldwell-Pope,G,22023,203484,22300697,"FEB 02, 2024",DEN vs. POR,W,34,4,8,0.5,1,2,0.5,7,7,1.0,0,1,1,2,0,1,0,3,16,22,1,DEN,DEN,POR,120,,,19,17,18,3
Kentavious Caldwell-Pope,G,22023,203484,22300682,"JAN 31, 2024",DEN @ OKC,L,36,3,10,0.3,3,9,0.333,2,2,1.0,1,5,6,3,1,0,3,4,11,13,1,DEN,OKC,DEN,100,,,20,17,14,9
Kentavious Caldwell-Pope,G,22023,203484,22300667,"JAN 29, 2024",DEN vs. MIL,W,34,5,9,0.556,0,3,0.0,2,2,1.0,0,1,1,2,1,0,0,1,12,-3,1,DEN,DEN,MIL,113,,,15,13,14,3
Kentavious Caldwell-Pope,G,22023,203484,22300644,"JAN 27, 2024",DEN vs. PHI,W,33,2,8,0.25,0,3,0.0,4,4,1.0,0,1,1,2,0,0,0,3,8,7,1,DEN,DEN,PHI,111,,,11,9,10,3
Kentavious Caldwell-Pope,G,22023,203484,22300631,"JAN 25, 2024",DEN @ NYK,L,22,2,6,0.333,1,3,0.333,0,0,0.0,0,0,0,0,0,0,1,4,5,-21,1,DEN,NYK,DEN,84,,,5,5,5,0
Kentavious Caldwell-Pope,G,22023,203484,22300614,"JAN 23, 2024",DEN @ IND,W,35,5,12,0.417,2,6,0.333,2,2,1.0,2,3,5,0,1,0,1,3,14,7,1,DEN,IND,DEN,114,,,19,19,14,5
Kentavious Caldwell-Pope,G,22023,203484,22300602,"JAN 21, 2024",DEN @ WAS,W,35,4,9,0.444,1,5,0.2,1,2,0.5,0,3,3,3,3,0,2,2,10,10,1,DEN,WAS,DEN,113,,,16,13,13,6
Kentavious Caldwell-Pope,G,22023,203484,22300586,"JAN 19, 2024",DEN @ BOS,W,37,2,6,0.333,1,3,0.333,0,0,0.0,1,4,5,1,0,0,0,1,5,0,1,DEN,BOS,DEN,102,,,11,10,6,6
Kentavious Caldwell-Pope,G,22023,203484,22300566,"JAN 16, 2024",DEN @ PHI,L,33,5,13,0.385,2,7,0.286,1,1,1.0,0,5,5,2,1,0,0,2,13,-3,1,DEN,PHI,DEN,121,,,20,18,15,7
Kentavious Caldwell-Pope,G,22023,203484,22300550,"JAN 14, 2024",DEN vs. IND,W,37,3,4,0.75,2,3,0.667,3,3,1.0,0,2,2,1,2,0,1,2,11,11,1,DEN,DEN,IND,117,,,14,13,12,3
Kentavious Caldwell-Pope,G,22023,203484,22300539,"JAN 12, 2024",DEN vs. NOP,W,31,4,9,0.444,3,6,0.5,0,0,0.0,0,2,2,3,2,0,0,0,11,9,1,DEN,DEN,NOP,125,,,16,13,14,5
Kentavious Caldwell-Pope,G,22023,203484,22300524,"JAN 10, 2024",DEN @ UTA,L,28,4,9,0.444,2,5,0.4,2,2,1.0,0,1,1,1,4,1,1,2,12,-20,1,DEN,UTA,DEN,111,,,14,13,13,2
Kentavious Caldwell-Pope,G,22023,203484,22300502,"JAN 07, 2024",DEN vs. DET,W,36,6,10,0.6,3,6,0.5,3,3,1.0,0,4,4,0,2,1,3,2,18,12,1,DEN,DEN,DET,131,,,22,22,18,4
Kentavious Caldwell-Pope,G,22023,203484,22300488,"JAN 05, 2024",DEN vs. ORL,L,29,1,4,0.25,0,3,0.0,4,4,1.0,1,2,3,2,1,1,3,1,6,2,1,DEN,DEN,ORL,120,,,11,9,8,5
Kentavious Caldwell-Pope,G,22023,203484,22300478,"JAN 04, 2024",DEN @ GSW,W,35,4,8,0.5,0,2,0.0,0,0,0.0,1,2,3,4,1,1,1,0,8,4,1,DEN,GSW,DEN,130,,,15,11,12,7
Kentavious Caldwell-Pope,G,22023,203484,22300455,"JAN 01, 2024",DEN vs. CHA,W,29,2,6,0.333,0,3,0.0,1,1,1.0,0,3,3,4,1,0,0,3,5,28,1,DEN,DEN,CHA,111,,,12,8,9,7
Kentavious Caldwell-Pope,G,22023,203484,22300435,"DEC 29, 2023",DEN vs. OKC,L,27,3,5,0.6,2,3,0.667,0,1,0.0,0,0,0,2,1,0,1,3,8,-16,1,DEN,DEN,OKC,93,,,10,8,10,2
Kentavious Caldwell-Pope,G,22023,203484,22300425,"DEC 28, 2023",DEN vs. MEM,W,25,5,10,0.5,2,5,0.4,0,0,0.0,2,0,2,3,0,1,0,2,12,27,1,DEN,DEN,MEM,142,,,17,14,15,5
Kentavious Caldwell-Pope,G,22023,203484,22300402,"DEC 25, 2023",DEN vs. GSW,W,37,6,13,0.462,4,9,0.444,0,0,0.0,1,3,4,5,2,0,0,1,16,15,1,DEN,DEN,GSW,120,,,25,20,21,9
Kentavious Caldwell-Pope,G,22023,203484,22300390,"DEC 23, 2023",DEN @ CHA,W,32,1,3,0.333,1,2,0.5,0,0,0.0,0,3,3,2,2,4,0,1,3,11,1,DEN,CHA,DEN,102,,,8,6,5,5
Kentavious Caldwell-Pope,G,22023,203484,22300383,"DEC 22, 2023",DEN @ BKN,W,30,1,6,0.167,1,2,0.5,0,0,0.0,1,4,5,4,2,0,1,3,3,15,1,DEN,BKN,DEN,122,,,12,8,7,9
Kentavious Caldwell-Pope,G,22023,203484,22300369,"DEC 20, 2023",DEN @ TOR,W,32,4,5,0.8,2,3,0.667,0,0,0.0,0,2,2,3,2,2,0,2,10,15,1,DEN,TOR,DEN,113,,,15,12,13,5
Kentavious Caldwell-Pope,G,22023,203484,22300356,"DEC 18, 2023",DEN vs. DAL,W,26,4,6,0.667,1,2,0.5,0,0,0.0,1,2,3,2,0,0,0,0,9,17,1,DEN,DEN,DAL,130,,,14,12,11,5
Kentavious Caldwell-Pope,G,22023,203484,22300307,"DEC 12, 2023",DEN @ CHI,W,13,2,4,0.5,0,0,0.0,0,0,0.0,0,1,1,0,0,0,0,2,4,10,1,DEN,CHI,DEN,114,,,5,5,4,1
Kentavious Caldwell-Pope,G,22023,203484,22300296,"DEC 11, 2023",DEN @ ATL,W,30,1,6,0.167,0,2,0.0,6,8,0.75,0,3,3,2,0,1,2,2,8,9,1,DEN,ATL,DEN,129,,,13,11,10,5
Kentavious Caldwell-Pope,G,22023,203484,22301224,"DEC 08, 2023",DEN vs. HOU,L,25,5,6,0.833,2,3,0.667,2,2,1.0,0,0,0,0,0,1,0,1,14,-16,1,DEN,DEN,HOU,106,,,14,14,14,0
Kentavious Caldwell-Pope,G,22023,203484,22301215,"DEC 06, 2023",DEN @ LAC,L,34,1,4,0.25,1,3,0.333,0,0,0.0,0,1,1,3,1,0,0,1,3,2,1,DEN,LAC,DEN,102,,,7,4,6,4
Kentavious Caldwell-Pope,G,22023,203484,22300290,"DEC 02, 2023",DEN @ SAC,L,38,4,12,0.333,0,3,0.0,1,2,0.5,0,5,5,3,4,0,4,1,9,9,1,DEN,SAC,DEN,117,,,17,14,12,8
Kentavious Caldwell-Pope,G,22023,203484,22300279,"DEC 01, 2023",DEN @ PHX,W,35,6,10,0.6,3,6,0.5,0,0,0.0,0,1,1,6,3,0,0,2,15,6,1,DEN,PHX,DEN,119,,,22,16,21,7
Kentavious Caldwell-Pope,G,22023,203484,22300263,"NOV 29, 2023",DEN vs. HOU,W,32,4,6,0.667,2,3,0.667,0,0,0.0,0,1,1,2,0,0,0,0,10,21,1,DEN,DEN,HOU,134,,,13,11,12,3
Kentavious Caldwell-Pope,G,22023,203484,22300257,"NOV 27, 2023",DEN @ LAC,W,38,3,14,0.214,0,1,0.0,6,6,1.0,2,1,3,2,1,0,0,2,12,15,1,DEN,LAC,DEN,113,,,17,15,14,5
Kentavious Caldwell-Pope,G,22023,203484,22300252,"NOV 26, 2023",DEN vs. SAS,W,31,5,7,0.714,2,4,0.5,4,4,1.0,0,1,1,6,1,0,3,3,16,6,1,DEN,DEN,SAS,132,,,23,17,22,7
Kentavious Caldwell-Pope,G,22023,203484,22300048,"NOV 24, 2023",DEN @ HOU,L,39,7,15,0.467,1,5,0.2,5,5,1.0,3,2,5,3,3,0,2,4,20,-7,1,DEN,HOU,DEN,86,,,28,25,23,8
Kentavious Caldwell-Pope,G,22023,203484,22300226,"NOV 22, 2023",DEN @ ORL,L,34,3,8,0.375,2,5,0.4,2,2,1.0,0,1,1,2,0,0,2,2,10,5,1,DEN,ORL,DEN,119,,,13,11,12,3
Kentavious Caldwell-Pope,G,22023,203484,22300218,"NOV 20, 2023",DEN @ DET,W,36,8,17,0.471,2,5,0.4,2,2,1.0,1,2,3,3,2,1,3,2,20,3,1,DEN,DET,DEN,107,,,26,23,23,6
Kentavious Caldwell-Pope,G,22023,203484,22300210,"NOV 19, 2023",DEN @ CLE,L,31,2,9,0.222,1,5,0.2,4,4,1.0,2,0,2,2,1,1,1,1,9,-13,1,DEN,CLE,DEN,109,,,13,11,11,4
Kentavious Caldwell-Pope,G,22023,203484,22300034,"NOV 17, 2023",DEN @ NOP,L,35,3,7,0.429,2,4,0.5,0,0,0.0,0,1,1,8,1,2,0,0,8,4,1,DEN,NOP,DEN,110,,,17,9,16,9
Kentavious Caldwell-Pope,G,22023,203484,22300024,"NOV 14, 2023",DEN vs. LAC,W,39,2,3,0.667,2,3,0.667,3,5,0.6,0,1,1,4,1,0,1,3,9,3,1,DEN,DEN,LAC,111,,,14,10,13,5
Kentavious Caldwell-Pope,G,22023,203484,22300182,"NOV 12, 2023",DEN @ HOU,L,38,2,5,0.4,1,2,0.5,0,0,0.0,0,0,0,1,1,0,1,3,5,6,1,DEN,HOU,DEN,104,,,6,5,6,1
Kentavious Caldwell-Pope,G,22023,203484,22300169,"NOV 08, 2023",DEN vs. GSW,W,35,3,8,0.375,0,3,0.0,4,4,1.0,1,2,3,3,1,0,0,3,10,13,1,DEN,DEN,GSW,108,,,16,13,13,6
Kentavious Caldwell-Pope,G,22023,203484,22300156,"NOV 06, 2023",DEN vs. NOP,W,33,5,10,0.5,3,7,0.429,2,2,1.0,0,1,1,7,1,0,2,4,15,23,1,DEN,DEN,NOP,134,,,23,16,22,8
Kentavious Caldwell-Pope,G,22023,203484,22300139,"NOV 04, 2023",DEN vs. CHI,W,30,4,8,0.5,2,4,0.5,0,0,0.0,0,0,0,2,1,0,1,1,10,29,1,DEN,DEN,CHI,123,,,12,10,12,2
Kentavious Caldwell-Pope,G,22023,203484,22300006,"NOV 03, 2023",DEN vs. DAL,W,37,3,7,0.429,2,3,0.667,0,0,0.0,0,5,5,1,2,0,1,0,8,15,1,DEN,DEN,DAL,125,,,14,13,9,6
Kentavious Caldwell-Pope,G,22023,203484,22300123,"NOV 01, 2023",DEN @ MIN,L,26,2,4,0.5,1,1,1.0,1,1,1.0,0,0,0,0,1,1,1,2,6,-20,1,DEN,MIN,DEN,89,,,6,6,6,0
Kentavious Caldwell-Pope,G,22023,203484,22300110,"OCT 30, 2023",DEN vs. UTA,W,33,3,5,0.6,2,4,0.5,0,0,0.0,0,3,3,0,1,2,2,4,8,11,1,DEN,DEN,UTA,110,,,11,11,8,3
Kentavious Caldwell-Pope,G,22023,203484,22300095,"OCT 29, 2023",DEN @ OKC,W,30,2,5,0.4,1,4,0.25,2,2,1.0,0,3,3,1,2,0,1,2,7,21,1,DEN,OKC,DEN,128,,,11,10,8,4
Kentavious Caldwell-Pope,G,22023,203484,22300078,"OCT 27, 2023",DEN @ MEM,W,35,3,10,0.3,2,6,0.333,0,0,0.0,0,2,2,1,5,1,0,1,8,6,1,DEN,MEM,DEN,108,,,11,10,9,3
Kentavious Caldwell-Pope,G,22023,203484,22300061,"OCT 24, 2023",DEN vs. LAL,W,36,8,12,0.667,2,3,0.667,2,2,1.0,1,1,2,1,3,1,3,5,20,10,1,DEN,DEN,LAL,119,,,23,22,21,3
Derrick Jones Jr.,F,22023,1627884,22300487,"JAN 05, 2024",DAL vs. POR,W,20,5,6,0.833,2,3,0.667,0,0,0.0,0,3,3,0,3,0,3,4,12,18,1,DAL,DAL,POR,132,,,15,15,12,3
Derrick Jones Jr.,F,22023,1627884,22300398,"DEC 23, 2023",DAL vs. SAS,W,24,4,7,0.571,3,5,0.6,0,0,0.0,2,2,4,1,0,0,0,2,11,5,1,DAL,DAL,SAS,144,,,16,15,12,5
Derrick Jones Jr.,F,22023,1627884,22300385,"DEC 22, 2023",DAL @ HOU,L,22,1,4,0.25,0,1,0.0,1,2,0.5,2,2,4,1,0,0,1,3,3,-21,1,DAL,HOU,DAL,96,,,8,7,4,5
Derrick Jones Jr.,F,22023,1627884,22300356,"DEC 18, 2023",DAL @ DEN,L,24,3,9,0.333,0,5,0.0,0,0,0.0,0,1,1,1,2,0,1,0,6,-11,1,DAL,DEN,DAL,104,,,8,7,7,2
Derrick Jones Jr.,F,22023,1627884,22300341,"DEC 16, 2023",DAL @ POR,W,33,6,11,0.545,2,6,0.333,4,5,0.8,1,0,1,4,2,0,1,1,18,-3,1,DAL,POR,DAL,131,,,23,19,22,5
Derrick Jones Jr.,F,22023,1627884,22300321,"DEC 14, 2023",DAL vs. MIN,L,30,1,8,0.125,1,6,0.167,0,0,0.0,0,4,4,0,2,0,0,3,3,-25,1,DAL,DAL,MIN,101,,,7,7,3,4
Derrick Jones Jr.,F,22023,1627884,22300577,"JAN 17, 2024",DAL @ LAL,L,27,3,3,1.0,2,2,1.0,0,0,0.0,1,0,1,0,0,1,0,2,8,-25,1,DAL,LAL,DAL,105,,,9,9,8,1
Derrick Jones Jr.,F,22023,1627884,22300547,"JAN 13, 2024",DAL vs. NOP,L,28,8,10,0.8,3,5,0.6,5,5,1.0,0,4,4,1,0,0,1,4,24,-20,1,DAL,DAL,NOP,108,,,29,28,25,5
Derrick Jones Jr.,F,22023,1627884,22300530,"JAN 11, 2024",DAL vs. NYK,W,35,4,10,0.4,1,5,0.2,0,2,0.0,1,3,4,1,0,1,1,2,9,-6,1,DAL,DAL,NYK,128,,,14,13,10,5
Derrick Jones Jr.,F,22023,1627884,22300515,"JAN 09, 2024",DAL vs. MEM,L,36,5,9,0.556,0,1,0.0,1,1,1.0,0,4,4,2,0,1,0,1,11,-10,1,DAL,DAL,MEM,103,,,17,15,13,6
Derrick Jones Jr.,F,22023,1627884,22300501,"JAN 07, 2024",DAL vs. MIN,W,35,5,12,0.417,1,6,0.167,1,2,0.5,5,5,10,1,1,3,1,2,12,2,1,DAL,DAL,MIN,115,,,23,22,13,11
Derrick Jones Jr.,F,22023,1627884,22300472,"JAN 03, 2024",DAL vs. POR,W,23,2,3,0.667,0,0,0.0,1,2,0.5,0,0,0,1,2,2,1,2,5,23,1,DAL,DAL,POR,126,,,6,5,6,1
Derrick Jones Jr.,F,22023,1627884,22300423,"DEC 28, 2023",DAL @ MIN,L,30,3,9,0.333,1,3,0.333,8,8,1.0,3,6,9,0,3,1,1,5,15,3,1,DAL,MIN,DAL,110,,,24,24,15,9
Derrick Jones Jr.,F,22023,1627884,22300420,"DEC 27, 2023",DAL vs. CLE,L,36,5,13,0.385,0,4,0.0,2,2,1.0,2,3,5,1,1,3,2,3,12,-8,1,DAL,DAL,CLE,110,,,18,17,13,6
Derrick Jones Jr.,F,22023,1627884,22300405,"DEC 25, 2023",DAL @ PHX,W,35,9,18,0.5,3,8,0.375,2,4,0.5,2,1,3,1,1,0,0,3,23,15,1,DAL,PHX,DAL,128,,,27,26,24,4
Derrick Jones Jr.,F,22023,1627884,22300299,"DEC 11, 2023",DAL @ MEM,W,6,2,4,0.5,0,2,0.0,1,1,1.0,0,2,2,0,0,3,0,0,5,6,1,DAL,MEM,DAL,120,,,7,7,5,2
Derrick Jones Jr.,F,22023,1627884,22301226,"DEC 08, 2023",DAL @ POR,W,39,6,12,0.5,1,7,0.143,1,2,0.5,4,4,8,1,2,2,1,2,14,21,1,DAL,POR,DAL,125,,,23,22,15,9
Derrick Jones Jr.,F,22023,1627884,22301213,"DEC 06, 2023",DAL vs. UTA,W,25,4,5,0.8,1,2,0.5,3,5,0.6,1,3,4,1,1,2,0,3,12,28,1,DAL,DAL,UTA,147,,,17,16,13,5
Derrick Jones Jr.,F,22023,1627884,22300287,"DEC 02, 2023",DAL vs. OKC,L,33,8,15,0.533,6,12,0.5,2,2,1.0,1,3,4,1,1,1,3,3,24,-1,1,DAL,DAL,OKC,120,,,29,28,25,5
Derrick Jones Jr.,F,22023,1627884,22300277,"DEC 01, 2023",DAL vs. MEM,L,31,6,14,0.429,4,7,0.571,0,0,0.0,3,1,4,1,1,0,1,1,16,-23,1,DAL,DAL,MEM,94,,,21,20,17,5
Derrick Jones Jr.,F,22023,1627884,22300059,"NOV 28, 2023",DAL vs. HOU,W,34,5,7,0.714,2,3,0.667,3,3,1.0,3,3,6,1,1,0,0,4,15,11,1,DAL,DAL,HOU,121,,,22,21,16,7
Derrick Jones Jr.,F,22023,1627884,22300244,"NOV 25, 2023",DAL @ LAC,L,20,1,5,0.2,1,3,0.333,1,2,0.5,0,1,1,1,1,1,0,1,4,-26,1,DAL,LAC,DAL,88,,,6,5,5,2
Derrick Jones Jr.,F,22023,1627884,22300238,"NOV 22, 2023",DAL @ LAL,W,19,2,4,0.5,2,4,0.5,0,0,0.0,1,1,2,0,0,2,0,4,6,-10,1,DAL,LAL,DAL,104,,,8,8,6,2
Derrick Jones Jr.,F,22023,1627884,22300205,"NOV 18, 2023",DAL @ MIL,L,19,0,7,0.0,0,2,0.0,0,0,0.0,2,6,8,1,0,0,2,1,0,0,1,DAL,MIL,DAL,125,,,9,8,1,9
Derrick Jones Jr.,F,22023,1627884,22300192,"NOV 15, 2023",DAL @ WAS,W,26,8,11,0.727,2,5,0.4,2,3,0.667,1,6,7,1,1,2,2,4,20,5,1,DAL,WAS,DAL,130,,,28,27,21,8
Derrick Jones Jr.,F,22023,1627884,22300022,"NOV 14, 2023",DAL @ NOP,L,18,2,4,0.5,1,3,0.333,2,2,1.0,2,1,3,2,0,1,1,1,7,-10,1,DAL,NOP,DAL,110,,,12,10,9,5
Derrick Jones Jr.,F,22023,1627884,22300183,"NOV 12, 2023",DAL @ NOP,W,22,2,6,0.333,2,6,0.333,1,2,0.5,0,1,1,2,0,0,1,0,7,8,1,DAL,NOP,DAL,136,,,10,8,9,3
Derrick Jones Jr.,F,22023,1627884,22300014,"NOV 10, 2023",DAL vs. LAC,W,29,4,10,0.4,1,4,0.25,2,2,1.0,4,6,10,3,3,0,0,1,11,36,1,DAL,DAL,LAC,144,,,24,21,14,13
Derrick Jones Jr.,F,22023,1627884,22300006,"NOV 03, 2023",DAL @ DEN,L,17,3,5,0.6,1,3,0.333,0,0,0.0,1,0,1,1,2,0,0,0,7,-16,1,DAL,DEN,DAL,114,,,9,8,8,2
Derrick Jones Jr.,F,22023,1627884,22300124,"NOV 01, 2023",DAL vs. CHI,W,31,7,13,0.538,3,9,0.333,0,0,0.0,1,4,5,1,0,0,0,2,17,11,1,DAL,DAL,CHI,114,,,23,22,18,6
Derrick Jones Jr.,F,22023,1627884,22300106,"OCT 30, 2023",DAL @ MEM,W,27,7,10,0.7,4,6,0.667,4,6,0.667,0,4,4,0,0,0,1,0,22,12,1,DAL,MEM,DAL,125,,,26,26,22,4
Derrick Jones Jr.,F,22023,1627884,22300084,"OCT 27, 2023",DAL vs. BKN,W,14,2,5,0.4,0,2,0.0,0,0,0.0,0,1,1,1,0,0,1,1,4,1,1,DAL,DAL,BKN,125,,,6,5,5,2
Derrick Jones Jr.,F,22023,1627884,22300073,"OCT 25, 2023",DAL @ SAS,W,12,0,3,0.0,0,2,0.0,1,2,0.5,0,1,1,0,0,0,1,0,1,-1,1,DAL,SAS,DAL,126,,,2,2,1,1
Derrick Jones Jr.,F,22023,1627884,22300748,"FEB 10, 2024",DAL vs. OKC,W,23,3,4,0.75,1,2,0.5,1,2,0.5,0,4,4,1,1,0,3,3,8,23,1,DAL,DAL,OKC,146,,,13,12,9,5
Derrick Jones Jr.,F,22023,1627884,22300736,"FEB 08, 2024",DAL @ NYK,W,30,5,7,0.714,1,3,0.333,7,7,1.0,1,4,5,3,0,0,0,1,18,15,1,DAL,NYK,DAL,121,,,26,23,21,8
Derrick Jones Jr.,F,22023,1627884,22300720,"FEB 06, 2024",DAL @ BKN,W,22,1,3,0.333,0,0,0.0,0,0,0.0,1,6,7,1,1,0,0,0,2,8,1,DAL,BKN,DAL,119,,,10,9,3,8
Derrick Jones Jr.,F,22023,1627884,22300715,"FEB 05, 2024",DAL @ PHI,W,15,2,7,0.286,0,4,0.0,1,2,0.5,0,2,2,1,0,0,0,1,5,4,1,DAL,PHI,DAL,118,,,8,7,6,3
Derrick Jones Jr.,F,22023,1627884,22300702,"FEB 03, 2024",DAL vs. MIL,L,35,3,6,0.5,0,0,0.0,2,3,0.667,1,3,4,1,2,0,1,1,8,-12,1,DAL,DAL,MIL,117,,,13,12,9,5
Derrick Jones Jr.,F,22023,1627884,22300634,"JAN 26, 2024",DAL @ ATL,W,18,1,1,1.0,0,0,0.0,0,0,0.0,0,1,1,1,0,0,1,3,2,-2,1,DAL,ATL,DAL,148,,,4,3,3,2
Derrick Jones Jr.,F,22023,1627884,22300625,"JAN 24, 2024",DAL vs. PHX,L,24,3,8,0.375,0,3,0.0,0,1,0.0,1,1,2,1,0,0,3,3,6,-35,1,DAL,DAL,PHX,107,,,9,8,7,3
Derrick Jones Jr.,F,22023,1627884,22300611,"JAN 22, 2024",DAL vs. BOS,L,25,2,7,0.286,1,3,0.333,0,0,0.0,0,2,2,3,0,0,1,1,5,-6,1,DAL,DAL,BOS,110,,,10,7,8,5
Derrick Jones Jr.,F,22023,1627884,22300457,"JAN 01, 2024",DAL @ UTA,L,24,2,4,0.5,1,3,0.333,1,2,0.5,1,2,3,0,1,1,2,1,6,-18,1,DAL,UTA,DAL,86,,,9,9,6,3
Derrick Jones Jr.,F,22023,1627884,22300444,"DEC 30, 2023",DAL @ GSW,W,24,3,7,0.429,0,3,0.0,1,2,0.5,2,3,5,1,2,1,1,1,7,-5,1,DAL,GSW,DAL,132,,,13,12,8,6
Derrick Jones Jr.,F,22023,1627884,22300372,"DEC 20, 2023",DAL vs. LAC,L,39,6,11,0.545,2,4,0.5,5,5,1.0,3,0,3,2,1,2,0,2,19,1,1,DAL,DAL,LAC,111,,,24,22,21,5
Derrick Jones Jr.,F,22023,1627884,22300212,"NOV 19, 2023",DAL vs. SAC,L,19,2,4,0.5,1,2,0.5,1,1,1.0,0,2,2,0,0,0,1,0,6,-20,1,DAL,DAL,SAC,113,,,8,8,6,2
Derrick Jones Jr.,F,22023,1627884,22300168,"NOV 08, 2023",DAL vs. TOR,L,29,6,8,0.75,3,5,0.6,0,0,0.0,1,4,5,1,0,3,3,3,15,11,1,DAL,DAL,TOR,116,,,21,20,16,6
Derrick Jones Jr.,F,22023,1627884,22300147,"NOV 06, 2023",DAL @ ORL,W,28,2,5,0.4,1,3,0.333,0,0,0.0,1,3,4,1,0,2,1,3,5,2,1,DAL,ORL,DAL,117,,,10,9,6,5
Derrick Jones Jr.,F,22023,1627884,22300143,"NOV 05, 2023",DAL vs. CHA,W,17,0,2,0.0,0,1,0.0,0,0,0.0,0,0,0,1,1,1,1,1,0,3,1,DAL,DAL,CHA,124,,,1,0,1,1
Alex Caruso,G,22023,1627936,22300139,"NOV 04, 2023",CHI @ DEN,L,14,1,3,0.333,0,2,0.0,1,1,1.0,0,0,0,2,1,0,2,3,3,-8,1,CHI,DEN,CHI,101,,,5,3,5,2
Alex Caruso,G,22023,1627936,22300737,"FEB 08, 2024",CHI @ MEM,W,29,1,4,0.25,0,3,0.0,5,5,1.0,0,4,4,4,2,0,0,5,7,1,1,CHI,MEM,CHI,118,,,15,11,11,8
Alex Caruso,G,22023,1627936,22300723,"FEB 06, 2024",CHI vs. MIN,W,35,1,5,0.2,1,3,0.333,0,0,0.0,1,8,9,6,2,4,4,1,3,19,1,CHI,CHI,MIN,129,,,18,12,9,15
Alex Caruso,G,22023,1627936,22300700,"FEB 03, 2024",CHI vs. SAC,L,37,3,7,0.429,1,4,0.25,0,0,0.0,2,3,5,6,3,2,4,5,7,1,1,CHI,CHI,SAC,115,,,18,12,13,11
Alex Caruso,G,22023,1627936,22300674,"JAN 31, 2024",CHI @ CHA,W,34,4,7,0.571,2,4,0.5,0,0,0.0,2,3,5,3,0,3,0,2,10,11,1,CHI,CHA,CHI,117,,,18,15,13,8
Alex Caruso,G,22023,1627936,22300672,"JAN 30, 2024",CHI vs. TOR,L,33,3,9,0.333,1,6,0.167,4,6,0.667,0,3,3,2,1,2,3,2,11,7,1,CHI,CHI,TOR,107,,,16,14,13,5
Alex Caruso,G,22023,1627936,22300656,"JAN 28, 2024",CHI @ POR,W,32,3,7,0.429,2,5,0.4,1,2,0.5,0,5,5,3,1,1,0,5,9,5,1,CHI,POR,CHI,104,,,17,14,12,8
Alex Caruso,G,22023,1627936,22300633,"JAN 25, 2024",CHI @ LAL,L,35,6,12,0.5,3,9,0.333,2,2,1.0,1,3,4,6,2,2,2,4,17,-6,1,CHI,LAL,CHI,132,,,27,21,23,10
Alex Caruso,G,22023,1627936,22300612,"JAN 22, 2024",CHI @ PHX,L,33,5,12,0.417,5,11,0.455,0,0,0.0,1,3,4,3,0,3,2,5,15,14,1,CHI,PHX,CHI,113,,,22,19,18,7
Alex Caruso,G,22023,1627936,22300597,"JAN 20, 2024",CHI vs. MEM,W,25,3,6,0.5,2,5,0.4,0,0,0.0,0,3,3,1,2,1,0,3,8,18,1,CHI,CHI,MEM,125,,,12,11,9,4
Alex Caruso,G,22023,1627936,22300580,"JAN 18, 2024",CHI @ TOR,W,28,4,6,0.667,2,4,0.5,0,0,0.0,0,3,3,4,2,2,1,4,10,3,1,CHI,TOR,CHI,116,,,17,13,14,7
Alex Caruso,G,22023,1627936,22300561,"JAN 15, 2024",CHI @ CLE,L,31,4,9,0.444,2,5,0.4,0,0,0.0,0,3,3,3,3,1,2,1,10,-6,1,CHI,CLE,CHI,91,,,16,13,13,6
Alex Caruso,G,22023,1627936,22300548,"JAN 13, 2024",CHI @ SAS,W,33,3,5,0.6,3,4,0.75,2,2,1.0,0,6,6,6,2,3,1,1,11,17,1,CHI,SAS,CHI,122,,,23,17,17,12
Alex Caruso,G,22023,1627936,22300506,"JAN 08, 2024",CHI @ CHA,W,34,2,7,0.286,1,3,0.333,0,0,0.0,0,2,2,3,2,1,0,4,5,17,1,CHI,CHA,CHI,119,,,10,7,8,5
Alex Caruso,G,22023,1627936,22300468,"JAN 03, 2024",CHI @ NYK,L,33,5,13,0.385,2,8,0.25,1,1,1.0,0,4,4,3,4,1,1,4,13,-11,1,CHI,NYK,CHI,100,,,20,17,16,7
Alex Caruso,G,22023,1627936,22300459,"JAN 02, 2024",CHI @ PHI,L,21,3,10,0.3,1,6,0.167,1,2,0.5,1,1,2,2,0,1,2,0,8,-12,1,CHI,PHI,CHI,97,,,12,10,10,4
Alex Caruso,G,22023,1627936,22300442,"DEC 30, 2023",CHI vs. PHI,W,28,4,7,0.571,3,5,0.6,3,5,0.6,0,2,2,5,1,1,3,2,14,19,1,CHI,CHI,PHI,105,,,21,16,19,7
Alex Caruso,G,22023,1627936,22300422,"DEC 28, 2023",CHI vs. IND,L,32,6,11,0.545,3,7,0.429,0,0,0.0,2,5,7,2,1,0,1,1,15,-15,1,CHI,CHI,IND,104,,,24,22,17,9
Alex Caruso,G,22023,1627936,22300408,"DEC 26, 2023",CHI vs. ATL,W,29,2,10,0.2,1,5,0.2,6,6,1.0,2,3,5,5,2,0,1,2,11,3,1,CHI,CHI,ATL,118,,,21,16,16,10
Alex Caruso,G,22023,1627936,22300396,"DEC 23, 2023",CHI vs. CLE,L,32,4,9,0.444,2,5,0.4,0,0,0.0,1,3,4,1,0,1,0,3,10,-10,1,CHI,CHI,CLE,95,,,15,14,11,5
Alex Caruso,G,22023,1627936,22300376,"DEC 21, 2023",CHI vs. SAS,W,22,4,6,0.667,0,0,0.0,0,0,0.0,0,3,3,3,3,0,2,5,8,10,1,CHI,CHI,SAS,114,,,14,11,11,6
Alex Caruso,G,22023,1627936,22300370,"DEC 20, 2023",CHI vs. LAL,W,28,5,7,0.714,3,4,0.75,2,2,1.0,2,4,6,2,0,1,4,2,15,15,1,CHI,CHI,LAL,124,,,23,21,17,8
Alex Caruso,G,22023,1627936,22300351,"DEC 18, 2023",CHI @ PHI,W,31,5,8,0.625,0,3,0.0,0,1,0.0,0,4,4,4,1,2,2,5,10,18,1,CHI,PHI,CHI,108,,,18,14,14,8
Alex Caruso,G,22023,1627936,22300320,"DEC 14, 2023",CHI @ MIA,W,5,2,4,0.5,2,3,0.667,0,0,0.0,0,0,0,1,0,0,0,0,6,11,1,CHI,MIA,CHI,124,,,7,6,7,1
Alex Caruso,G,22023,1627936,22301223,"DEC 08, 2023",CHI @ SAS,W,18,2,5,0.4,0,2,0.0,0,0,0.0,1,2,3,2,1,0,2,2,4,-3,1,CHI,SAS,CHI,121,,,9,7,6,5
Alex Caruso,G,22023,1627936,22301211,"DEC 06, 2023",CHI vs. CHA,W,30,4,7,0.571,1,2,0.5,3,4,0.75,4,2,6,2,0,2,1,2,12,-4,1,CHI,CHI,CHA,111,,,20,18,14,8
Alex Caruso,G,22023,1627936,22300285,"DEC 02, 2023",CHI vs. NOP,W,13,3,5,0.6,2,4,0.5,0,0,0.0,0,2,2,2,0,1,1,2,8,-3,1,CHI,CHI,NOP,124,,,12,10,10,4
Alex Caruso,G,22023,1627936,22300269,"NOV 30, 2023",CHI vs. MIL,W,29,4,9,0.444,3,5,0.6,0,0,0.0,0,1,1,5,2,1,7,1,11,-9,1,CHI,CHI,MIL,120,,,17,12,16,6
Alex Caruso,G,22023,1627936,22300053,"NOV 28, 2023",CHI @ BOS,L,19,3,9,0.333,2,6,0.333,0,0,0.0,1,1,2,2,3,0,1,2,8,-16,1,CHI,BOS,CHI,97,,,12,10,10,4
Alex Caruso,G,22023,1627936,22300046,"NOV 24, 2023",CHI @ TOR,L,18,2,3,0.667,1,2,0.5,2,2,1.0,1,1,2,1,0,0,0,0,7,-13,1,CHI,TOR,CHI,108,,,10,9,8,3
Alex Caruso,G,22023,1627936,22300234,"NOV 22, 2023",CHI @ OKC,L,27,5,12,0.417,2,6,0.333,0,0,0.0,1,5,6,1,1,0,0,1,12,-5,1,CHI,OKC,CHI,102,,,19,18,13,7
Alex Caruso,G,22023,1627936,22300220,"NOV 20, 2023",CHI vs. MIA,L,27,4,10,0.4,2,4,0.5,3,4,0.75,2,2,4,3,1,1,2,1,13,-21,1,CHI,CHI,MIA,100,,,20,17,16,7
Alex Caruso,G,22023,1627936,22300204,"NOV 18, 2023",CHI vs. MIA,W,29,4,8,0.5,2,4,0.5,1,2,0.5,1,0,1,3,1,1,1,2,11,-16,1,CHI,CHI,MIA,102,,,15,12,14,4
Alex Caruso,G,22023,1627936,22300033,"NOV 17, 2023",CHI vs. ORL,L,23,5,6,0.833,4,5,0.8,4,4,1.0,0,1,1,0,3,2,1,4,18,7,1,CHI,CHI,ORL,97,,,19,19,18,1
Alex Caruso,G,22023,1627936,22300196,"NOV 15, 2023",CHI vs. ORL,L,24,5,7,0.714,2,4,0.5,4,4,1.0,1,4,5,3,0,1,2,5,16,7,1,CHI,CHI,ORL,94,,,24,21,19,8
Alex Caruso,G,22023,1627936,22300162,"NOV 08, 2023",CHI vs. PHX,L,31,7,9,0.778,4,5,0.8,1,2,0.5,1,3,4,2,3,2,1,3,19,24,1,CHI,CHI,PHX,115,,,25,23,21,6
Alex Caruso,G,22023,1627936,22300152,"NOV 06, 2023",CHI vs. UTA,W,20,3,3,1.0,2,2,1.0,2,2,1.0,1,0,1,3,1,0,0,1,10,16,1,CHI,CHI,UTA,130,,,14,11,13,4
Alex Caruso,G,22023,1627936,22300004,"NOV 03, 2023",CHI vs. BKN,L,26,1,2,0.5,1,2,0.5,0,0,0.0,0,2,2,2,0,1,0,2,3,-9,1,CHI,CHI,BKN,107,,,7,5,5,4
Alex Caruso,G,22023,1627936,22300124,"NOV 01, 2023",CHI @ DAL,L,22,3,6,0.5,0,3,0.0,0,0,0.0,2,2,4,1,1,1,2,4,6,-5,1,CHI,DAL,CHI,105,,,11,10,7,5
Alex Caruso,G,22023,1627936,22300102,"OCT 30, 2023",CHI @ IND,W,26,3,5,0.6,1,2,0.5,1,2,0.5,1,3,4,3,0,1,3,1,8,6,1,CHI,IND,CHI,112,,,15,12,11,7
Alex Caruso,G,22023,1627936,22300088,"OCT 28, 2023",CHI @ DET,L,21,1,2,0.5,0,0,0.0,0,0,0.0,2,3,5,4,4,1,0,3,2,-16,1,CHI,DET,CHI,102,,,11,7,6,9
Alex Caruso,G,22023,1627936,22300082,"OCT 27, 2023",CHI vs. TOR,W,32,5,9,0.556,2,5,0.4,1,2,0.5,6,7,13,2,2,1,0,5,13,29,1,CHI,CHI,TOR,104,,,28,26,15,15
Alex Caruso,G,22023,1627936,22300070,"OCT 25, 2023",CHI vs. OKC,L,20,2,5,0.4,1,4,0.25,1,2,0.5,0,2,2,3,2,0,1,1,6,-19,1,CHI,CHI,OKC,104,,,11,8,9,5
Alex Caruso,G,22023,1627936,22300752,"FEB 10, 2024",CHI @ ORL,L,36,4,6,0.667,1,2,0.5,0,0,0.0,3,5,8,1,1,4,2,3,9,-2,1,CHI,ORL,CHI,108,,,18,17,10,9
Alex Caruso,G,22023,1627936,22300536,"JAN 12, 2024",CHI vs. GSW,L,29,2,6,0.333,2,6,0.333,0,0,0.0,1,1,2,2,0,1,0,0,6,-12,1,CHI,CHI,GSW,131,,,10,8,8,4
Alex Caruso,G,22023,1627936,22300523,"JAN 10, 2024",CHI vs. HOU,W,32,3,10,0.3,2,9,0.222,4,6,0.667,2,4,6,3,1,1,0,3,12,-9,1,CHI,CHI,HOU,124,,,21,18,15,9
Josh Richardson,G,22023,1626196,22300730,"FEB 07, 2024",MIA vs. SAS,W,26,2,6,0.333,1,4,0.25,4,4,1.0,0,4,4,0,0,0,0,2,9,-3,1,MIA,MIA,SAS,116,,,13,13,9,4
Josh Richardson,G,22023,1626196,22300721,"FEB 06, 2024",MIA vs. ORL,W,27,5,7,0.714,3,3,1.0,0,0,0.0,2,3,5,1,2,0,0,4,13,16,1,MIA,MIA,ORL,121,,,19,18,14,6
Josh Richardson,G,22023,1626196,22300708,"FEB 04, 2024",MIA vs. LAC,L,33,6,13,0.462,2,8,0.25,0,0,0.0,0,3,3,4,0,0,0,2,14,-8,1,MIA,MIA,LAC,95,,,21,17,18,7
Josh Richardson,G,22023,1626196,22300689,"FEB 02, 2024",MIA @ WAS,W,25,3,8,0.375,1,6,0.167,0,0,0.0,0,4,4,2,0,0,1,2,7,-6,1,MIA,WAS,MIA,110,,,13,11,9,6
Josh Richardson,G,22023,1626196,22300678,"JAN 31, 2024",MIA vs. SAC,W,27,9,15,0.6,6,10,0.6,0,0,0.0,0,5,5,3,0,1,0,2,24,5,1,MIA,MIA,SAC,115,,,32,29,27,8
Josh Richardson,G,22023,1626196,22300661,"JAN 29, 2024",MIA vs. PHX,L,24,4,8,0.5,2,4,0.5,2,2,1.0,1,3,4,2,2,0,1,1,12,7,1,MIA,MIA,PHX,105,,,18,16,14,6
Josh Richardson,G,22023,1626196,22300630,"JAN 25, 2024",MIA vs. BOS,L,24,4,9,0.444,0,4,0.0,0,0,0.0,1,1,2,3,1,0,0,1,8,-8,1,MIA,MIA,BOS,110,,,13,10,11,5
Josh Richardson,G,22023,1626196,22300621,"JAN 24, 2024",MIA vs. MEM,L,18,4,7,0.571,1,4,0.25,0,0,0.0,0,3,3,2,0,1,1,2,9,6,1,MIA,MIA,MEM,96,,,14,12,11,5
Josh Richardson,G,22023,1626196,22300601,"JAN 21, 2024",MIA @ ORL,L,9,1,4,0.25,1,3,0.333,0,0,0.0,0,2,2,0,0,0,1,1,3,-2,1,MIA,ORL,MIA,87,,,5,5,3,2
Josh Richardson,G,22023,1626196,22300587,"JAN 19, 2024",MIA vs. ATL,L,21,2,5,0.4,2,4,0.5,3,3,1.0,0,3,3,0,0,1,0,1,9,-9,1,MIA,MIA,ATL,108,,,12,12,9,3
Josh Richardson,G,22023,1626196,22300574,"JAN 17, 2024",MIA @ TOR,L,23,2,7,0.286,1,4,0.25,0,0,0.0,0,1,1,0,1,2,1,3,5,-24,1,MIA,TOR,MIA,97,,,6,6,5,1
Josh Richardson,G,22023,1626196,22300562,"JAN 15, 2024",MIA @ BKN,W,28,3,13,0.231,2,6,0.333,1,1,1.0,1,4,5,1,0,1,1,2,9,-11,1,MIA,BKN,MIA,96,,,15,14,10,6
Josh Richardson,G,22023,1626196,22300551,"JAN 14, 2024",MIA vs. CHA,W,20,4,8,0.5,2,3,0.667,1,1,1.0,1,1,2,0,0,0,1,1,11,5,1,MIA,MIA,CHA,104,,,13,13,11,2
Josh Richardson,G,22023,1626196,22300535,"JAN 12, 2024",MIA vs. ORL,W,25,4,6,0.667,0,1,0.0,1,1,1.0,0,1,1,2,1,0,2,2,9,-5,1,MIA,MIA,ORL,99,,,12,10,11,3
Josh Richardson,G,22023,1626196,22300522,"JAN 10, 2024",MIA vs. OKC,L,21,3,7,0.429,2,5,0.4,0,0,0.0,0,1,1,2,1,0,2,2,8,-19,1,MIA,MIA,OKC,120,,,11,9,10,3
Josh Richardson,G,22023,1626196,22300509,"JAN 08, 2024",MIA vs. HOU,W,29,4,6,0.667,2,3,0.667,2,2,1.0,0,2,2,2,0,1,0,2,12,1,1,MIA,MIA,HOU,120,,,16,14,14,4
Josh Richardson,G,22023,1626196,22300489,"JAN 05, 2024",MIA @ PHX,L,29,2,9,0.222,1,6,0.167,5,5,1.0,1,7,8,7,2,0,0,3,10,-4,1,MIA,PHX,MIA,97,,,25,18,17,15
Josh Richardson,G,22023,1626196,22300475,"JAN 03, 2024",MIA @ LAL,W,21,4,7,0.571,2,3,0.667,0,0,0.0,0,1,1,1,0,1,0,3,10,9,1,MIA,LAL,MIA,110,,,12,11,11,2
Josh Richardson,G,22023,1626196,22300384,"DEC 22, 2023",MIA vs. ATL,W,29,1,5,0.2,0,4,0.0,1,1,1.0,0,3,3,1,1,0,1,0,3,0,1,MIA,MIA,ATL,122,,,7,6,4,4
Josh Richardson,G,22023,1626196,22300366,"DEC 20, 2023",MIA @ ORL,W,34,4,12,0.333,4,8,0.5,0,0,0.0,0,2,2,4,1,1,0,1,12,7,1,MIA,ORL,MIA,115,,,18,14,16,6
Josh Richardson,G,22023,1626196,22300353,"DEC 18, 2023",MIA vs. MIN,L,26,4,6,0.667,2,4,0.5,3,3,1.0,0,4,4,3,0,0,1,2,13,-7,1,MIA,MIA,MIN,108,,,20,17,16,7
Josh Richardson,G,22023,1626196,22300267,"NOV 30, 2023",MIA vs. IND,W,32,8,11,0.727,0,2,0.0,3,4,0.75,1,3,4,3,0,0,2,3,19,22,1,MIA,MIA,IND,142,,,26,23,22,7
Josh Richardson,G,22023,1626196,22300056,"NOV 28, 2023",MIA vs. MIL,L,37,7,13,0.538,3,7,0.429,3,4,0.75,1,2,3,7,0,0,0,2,20,-10,1,MIA,MIA,MIL,124,,,30,23,27,10
Josh Richardson,G,22023,1626196,22300045,"NOV 24, 2023",MIA @ NYK,L,34,5,10,0.5,2,4,0.5,3,3,1.0,1,1,2,2,2,0,2,3,15,-7,1,MIA,NYK,MIA,98,,,19,17,17,4
Josh Richardson,G,22023,1626196,22300220,"NOV 20, 2023",MIA @ CHI,W,30,4,12,0.333,2,6,0.333,0,0,0.0,2,2,4,1,0,1,3,2,10,11,1,MIA,CHI,MIA,118,,,15,14,11,5
Josh Richardson,G,22023,1626196,22300204,"NOV 18, 2023",MIA @ CHI,L,26,3,6,0.5,1,4,0.25,0,0,0.0,0,1,1,2,1,0,0,0,7,-25,1,MIA,CHI,MIA,97,,,10,8,9,3
Josh Richardson,G,22023,1626196,22300200,"NOV 16, 2023",MIA vs. BKN,W,26,3,7,0.429,1,5,0.2,1,1,1.0,0,2,2,3,2,0,0,2,8,5,1,MIA,MIA,BKN,122,,,13,10,11,5
Josh Richardson,G,22023,1626196,22300017,"NOV 14, 2023",MIA @ CHA,W,33,2,10,0.2,0,6,0.0,2,2,1.0,1,4,5,6,1,1,1,2,6,11,1,MIA,CHA,MIA,111,,,17,11,12,11
Josh Richardson,G,22023,1626196,22300184,"NOV 12, 2023",MIA @ SAS,W,26,4,7,0.571,2,4,0.5,2,2,1.0,0,3,3,4,1,0,0,2,12,1,1,MIA,SAS,MIA,118,,,19,15,16,7
Josh Richardson,G,22023,1626196,22300175,"NOV 11, 2023",MIA @ ATL,W,23,6,7,0.857,3,4,0.75,1,1,1.0,0,2,2,0,0,0,1,0,16,15,1,MIA,ATL,MIA,117,,,18,18,16,2
Josh Richardson,G,22023,1626196,22300164,"NOV 08, 2023",MIA @ MEM,W,17,1,9,0.111,0,5,0.0,0,0,0.0,0,0,0,2,0,1,4,1,2,-19,1,MIA,MEM,MIA,108,,,4,2,4,2
Josh Richardson,G,22023,1626196,22300150,"NOV 06, 2023",MIA vs. LAL,W,21,1,2,0.5,1,2,0.5,0,0,0.0,0,2,2,0,0,0,1,4,3,-6,1,MIA,MIA,LAL,108,,,5,5,3,2
Josh Richardson,G,22023,1626196,22300003,"NOV 03, 2023",MIA vs. WAS,W,26,4,6,0.667,1,2,0.5,1,1,1.0,0,3,3,5,0,0,2,2,10,-2,1,MIA,MIA,WAS,121,,,18,13,15,8
Josh Richardson,G,22023,1626196,22300119,"NOV 01, 2023",MIA vs. BKN,L,30,1,9,0.111,1,5,0.2,1,2,0.5,0,3,3,3,1,0,0,2,4,-13,1,MIA,MIA,BKN,105,,,10,7,7,6
Josh Richardson,G,22023,1626196,22300337,"DEC 16, 2023",MIA vs. CHI,W,20,3,7,0.429,2,5,0.4,0,0,0.0,1,1,2,2,0,0,1,1,8,-12,1,MIA,MIA,CHI,118,,,12,10,10,4
Josh Richardson,G,22023,1626196,22300292,"DEC 11, 2023",MIA @ CHA,W,25,0,7,0.0,0,4,0.0,2,2,1.0,0,4,4,4,1,0,0,0,2,-11,1,MIA,CHA,MIA,116,,,10,6,6,8
Josh Richardson,G,22023,1626196,22300240,"NOV 25, 2023",MIA @ BKN,L,37,4,11,0.364,0,5,0.0,3,3,1.0,2,3,5,5,0,1,2,1,11,-16,1,MIA,BKN,MIA,97,,,21,16,16,10
Josh Richardson,G,22023,1626196,22300229,"NOV 22, 2023",MIA @ CLE,W,27,5,9,0.556,2,4,0.5,2,2,1.0,1,0,1,5,2,0,0,0,14,13,1,MIA,CLE,MIA,129,,,20,15,19,6
Josh Richardson,G,22023,1626196,22300107,"OCT 30, 2023",MIA @ MIL,L,23,3,7,0.429,0,2,0.0,0,0,0.0,0,3,3,2,0,0,0,3,6,4,1,MIA,MIL,MIA,114,,,11,9,8,5
Josh Richardson,G,22023,1626196,22301220,"DEC 08, 2023",MIA vs. CLE,L,31,6,11,0.545,5,7,0.714,0,0,0.0,0,1,1,2,1,0,1,3,17,7,1,MIA,MIA,CLE,99,,,20,18,19,3
Josh Richardson,G,22023,1626196,22301207,"DEC 06, 2023",MIA @ TOR,W,30,2,6,0.333,1,4,0.25,2,2,1.0,1,3,4,2,0,0,1,3,7,-7,1,MIA,TOR,MIA,112,,,13,11,9,6
Josh Richardson,G,22023,1626196,22300284,"DEC 02, 2023",MIA vs. IND,L,24,6,9,0.667,2,4,0.5,2,2,1.0,0,2,2,3,0,1,2,1,16,-11,1,MIA,MIA,IND,129,,,21,18,19,5
Patrick Williams,F,22023,1630172,22300139,"NOV 04, 2023",CHI @ DEN,L,28,2,7,0.286,0,5,0.0,3,4,0.75,1,2,3,3,1,2,1,0,7,3,1,CHI,DEN,CHI,101,,,13,10,10,6
Patrick Williams,F,22023,1630172,22300633,"JAN 25, 2024",CHI @ LAL,L,24,2,9,0.222,0,5,0.0,2,2,1.0,0,6,6,2,0,2,2,5,6,-11,1,CHI,LAL,CHI,132,,,14,12,8,8
Patrick Williams,F,22023,1630172,22300612,"JAN 22, 2024",CHI @ PHX,L,32,5,12,0.417,3,8,0.375,0,0,0.0,1,3,4,2,1,0,2,2,13,-10,1,CHI,PHX,CHI,113,,,19,17,15,6
Patrick Williams,F,22023,1630172,22300597,"JAN 20, 2024",CHI vs. MEM,W,27,4,11,0.364,3,7,0.429,4,4,1.0,2,3,5,0,2,1,2,4,15,-7,1,CHI,CHI,MEM,125,,,20,20,15,5
Patrick Williams,F,22023,1630172,22300580,"JAN 18, 2024",CHI @ TOR,W,23,5,9,0.556,2,3,0.667,0,0,0.0,0,0,0,1,0,0,0,3,12,-2,1,CHI,TOR,CHI,116,,,13,12,13,1
Patrick Williams,F,22023,1630172,22300506,"JAN 08, 2024",CHI @ CHA,W,23,2,6,0.333,1,2,0.5,3,4,0.75,1,4,5,0,1,1,2,1,8,2,1,CHI,CHA,CHI,119,,,13,13,8,5
Patrick Williams,F,22023,1630172,22300468,"JAN 03, 2024",CHI @ NYK,L,27,2,8,0.25,1,2,0.5,0,0,0.0,1,3,4,2,1,0,5,3,5,-14,1,CHI,NYK,CHI,100,,,11,9,7,6
Patrick Williams,F,22023,1630172,22300459,"JAN 02, 2024",CHI @ PHI,L,11,1,3,0.333,1,2,0.5,0,0,0.0,1,0,1,0,0,0,1,1,3,-20,1,CHI,PHI,CHI,97,,,4,4,3,1
Patrick Williams,F,22023,1630172,22300442,"DEC 30, 2023",CHI vs. PHI,W,33,6,11,0.545,1,3,0.333,0,0,0.0,2,1,3,3,0,0,2,0,13,13,1,CHI,CHI,PHI,105,,,19,16,16,6
Patrick Williams,F,22023,1630172,22300422,"DEC 28, 2023",CHI vs. IND,L,38,9,14,0.643,2,5,0.4,2,2,1.0,1,4,5,3,2,0,0,3,22,-23,1,CHI,CHI,IND,104,,,30,27,25,8
Patrick Williams,F,22023,1630172,22300408,"DEC 26, 2023",CHI vs. ATL,W,25,2,7,0.286,0,1,0.0,2,2,1.0,1,0,1,0,1,0,1,2,6,-4,1,CHI,CHI,ATL,118,,,7,7,6,1
Patrick Williams,F,22023,1630172,22300396,"DEC 23, 2023",CHI vs. CLE,L,35,5,11,0.455,2,5,0.4,1,1,1.0,0,2,2,2,0,1,2,3,13,0,1,CHI,CHI,CLE,95,,,17,15,15,4
Patrick Williams,F,22023,1630172,22300376,"DEC 21, 2023",CHI vs. SAS,W,31,7,11,0.636,2,4,0.5,2,2,1.0,0,4,4,2,1,1,2,2,18,15,1,CHI,CHI,SAS,114,,,24,22,20,6
Patrick Williams,F,22023,1630172,22300370,"DEC 20, 2023",CHI vs. LAL,W,34,6,10,0.6,3,3,1.0,0,0,0.0,2,1,3,2,1,1,0,2,15,8,1,CHI,CHI,LAL,124,,,20,18,17,5
Patrick Williams,F,22023,1630172,22300351,"DEC 18, 2023",CHI @ PHI,W,37,5,13,0.385,3,4,0.75,0,0,0.0,0,6,6,0,0,1,0,1,13,-2,1,CHI,PHI,CHI,108,,,19,19,13,6
Patrick Williams,F,22023,1630172,22300337,"DEC 16, 2023",CHI @ MIA,L,33,8,10,0.8,4,5,0.8,5,5,1.0,1,6,7,4,0,0,3,3,25,12,1,CHI,MIA,CHI,116,,,36,32,29,11
Patrick Williams,F,22023,1630172,22300320,"DEC 14, 2023",CHI @ MIA,W,32,3,9,0.333,2,5,0.4,1,2,0.5,2,0,2,3,2,2,0,5,9,8,1,CHI,MIA,CHI,124,,,14,11,12,5
Patrick Williams,F,22023,1630172,22300307,"DEC 12, 2023",CHI vs. DEN,L,31,2,8,0.25,2,5,0.4,1,2,0.5,0,2,2,0,0,1,1,1,7,-7,1,CHI,CHI,DEN,106,,,9,9,7,2
Patrick Williams,F,22023,1630172,22300300,"DEC 11, 2023",CHI @ MIL,L,41,6,14,0.429,1,2,0.5,2,2,1.0,4,3,7,2,0,0,1,4,15,-3,1,CHI,MIL,CHI,129,,,24,22,17,9
Patrick Williams,F,22023,1630172,22301223,"DEC 08, 2023",CHI @ SAS,W,34,8,11,0.727,2,3,0.667,2,4,0.5,1,5,6,3,1,1,0,3,20,20,1,CHI,SAS,CHI,121,,,29,26,23,9
Patrick Williams,F,22023,1630172,22301211,"DEC 06, 2023",CHI vs. CHA,W,29,3,6,0.5,1,2,0.5,1,2,0.5,3,6,9,1,2,2,3,2,8,5,1,CHI,CHI,CHA,111,,,18,17,9,10
Patrick Williams,F,22023,1630172,22300285,"DEC 02, 2023",CHI vs. NOP,W,29,6,11,0.545,1,5,0.2,1,4,0.25,1,3,4,2,2,2,1,3,14,-10,1,CHI,CHI,NOP,124,,,20,18,16,6
Patrick Williams,F,22023,1630172,22300269,"NOV 30, 2023",CHI vs. MIL,W,36,6,14,0.429,0,4,0.0,0,0,0.0,1,1,2,1,2,1,1,1,12,-7,1,CHI,CHI,MIL,120,,,15,14,13,3
Patrick Williams,F,22023,1630172,22300053,"NOV 28, 2023",CHI @ BOS,L,28,6,10,0.6,1,3,0.333,1,2,0.5,4,3,7,2,1,2,2,2,14,-7,1,CHI,BOS,CHI,97,,,23,21,16,9
Patrick Williams,F,22023,1630172,22300250,"NOV 26, 2023",CHI @ BKN,L,35,7,9,0.778,4,5,0.8,2,2,1.0,1,3,4,0,0,0,1,2,20,14,1,CHI,BKN,CHI,109,,,24,24,20,4
Patrick Williams,F,22023,1630172,22300046,"NOV 24, 2023",CHI @ TOR,L,22,4,8,0.5,2,2,1.0,2,2,1.0,2,3,5,1,1,0,0,0,12,2,1,CHI,TOR,CHI,108,,,18,17,13,6
Patrick Williams,F,22023,1630172,22300234,"NOV 22, 2023",CHI @ OKC,L,37,3,9,0.333,2,5,0.4,2,2,1.0,3,4,7,2,0,0,2,1,10,-3,1,CHI,OKC,CHI,102,,,19,17,12,9
Patrick Williams,F,22023,1630172,22300220,"NOV 20, 2023",CHI vs. MIA,L,17,4,7,0.571,1,3,0.333,0,0,0.0,0,3,3,0,0,2,2,0,9,0,1,CHI,CHI,MIA,100,,,12,12,9,3
Patrick Williams,F,22023,1630172,22300204,"NOV 18, 2023",CHI vs. MIA,W,15,1,5,0.2,0,1,0.0,0,0,0.0,3,1,4,1,1,1,0,2,2,15,1,CHI,CHI,MIA,102,,,7,6,3,5
Patrick Williams,F,22023,1630172,22300033,"NOV 17, 2023",CHI vs. ORL,L,13,0,3,0.0,0,1,0.0,0,0,0.0,0,2,2,1,1,0,3,1,0,-9,1,CHI,CHI,ORL,97,,,3,2,1,3
Patrick Williams,F,22023,1630172,22300196,"NOV 15, 2023",CHI vs. ORL,L,32,2,7,0.286,0,2,0.0,5,6,0.833,1,8,9,2,1,2,1,2,9,-2,1,CHI,CHI,ORL,94,,,20,18,11,11
Patrick Williams,F,22023,1630172,22300190,"NOV 13, 2023",CHI @ MIL,L,27,4,7,0.571,3,4,0.75,2,2,1.0,0,3,3,2,2,3,0,3,13,-6,1,CHI,MIL,CHI,109,,,18,16,15,5
Patrick Williams,F,22023,1630172,22300181,"NOV 12, 2023",CHI vs. DET,W,19,0,2,0.0,0,1,0.0,4,6,0.667,0,0,0,0,1,1,1,1,4,-4,1,CHI,CHI,DET,119,,,4,4,4,0
Patrick Williams,F,22023,1630172,22300162,"NOV 08, 2023",CHI vs. PHX,L,21,1,7,0.143,1,2,0.5,0,0,0.0,1,3,4,1,1,0,1,0,3,18,1,CHI,CHI,PHX,115,,,8,7,4,5
Patrick Williams,F,22023,1630172,22300152,"NOV 06, 2023",CHI vs. UTA,W,25,4,10,0.4,2,4,0.5,0,0,0.0,0,3,3,0,0,0,0,1,10,6,1,CHI,CHI,UTA,130,,,13,13,10,3
Patrick Williams,F,22023,1630172,22300004,"NOV 03, 2023",CHI vs. BKN,L,21,4,6,0.667,2,3,0.667,0,0,0.0,0,5,5,1,0,1,2,1,10,10,1,CHI,CHI,BKN,107,,,16,15,11,6
Patrick Williams,F,22023,1630172,22300124,"NOV 01, 2023",CHI @ DAL,L,25,0,6,0.0,0,5,0.0,0,0,0.0,1,2,3,1,1,1,2,3,0,-8,1,CHI,DAL,CHI,105,,,4,3,1,4
Patrick Williams,F,22023,1630172,22300102,"OCT 30, 2023",CHI @ IND,W,22,3,6,0.5,1,2,0.5,2,2,1.0,0,4,4,0,1,1,1,0,9,-7,1,CHI,IND,CHI,112,,,13,13,9,4
Patrick Williams,F,22023,1630172,22300088,"OCT 28, 2023",CHI @ DET,L,21,0,3,0.0,0,1,0.0,0,0,0.0,1,2,3,1,1,0,1,3,0,4,1,CHI,DET,CHI,102,,,4,3,1,4
Patrick Williams,F,22023,1630172,22300082,"OCT 27, 2023",CHI vs. TOR,W,13,1,5,0.2,1,4,0.25,0,0,0.0,0,3,3,1,2,0,2,3,3,-7,1,CHI,CHI,TOR,104,,,7,6,4,4
Patrick Williams,F,22023,1630172,22300070,"OCT 25, 2023",CHI vs. OKC,L,30,4,10,0.4,0,4,0.0,0,0,0.0,2,1,3,4,2,0,0,3,8,-3,1,CHI,CHI,OKC,104,,,15,11,12,7
Patrick Williams,F,22023,1630172,22300536,"JAN 12, 2024",CHI vs. GSW,L,29,4,8,0.5,1,3,0.333,0,0,0.0,1,2,3,7,1,0,2,3,9,-2,1,CHI,CHI,GSW,131,,,19,12,16,10
Patrick Williams,F,22023,1630172,22300523,"JAN 10, 2024",CHI vs. HOU,W,29,2,6,0.333,1,3,0.333,0,0,0.0,0,0,0,1,3,0,2,2,5,9,1,CHI,CHI,HOU,124,,,6,5,6,1
Tari Eason,F,22023,1631106,22300409,"DEC 26, 2023",HOU vs. IND,L,26,7,13,0.538,1,2,0.5,1,2,0.5,3,5,8,1,2,0,0,3,16,9,1,HOU,HOU,IND,117,,,25,24,17,9
Tari Eason,F,22023,1631106,22300392,"DEC 23, 2023",HOU @ NOP,W,20,4,11,0.364,0,2,0.0,0,0,0.0,2,2,4,0,2,0,0,5,8,-6,1,HOU,NOP,HOU,106,,,12,12,8,4
Tari Eason,F,22023,1631106,22300349,"DEC 18, 2023",HOU @ CLE,L,33,5,13,0.385,0,2,0.0,4,5,0.8,4,4,8,2,4,1,2,4,14,-1,1,HOU,CLE,HOU,130,,,24,22,16,10
Tari Eason,F,22023,1631106,22300346,"DEC 17, 2023",HOU @ MIL,L,30,5,8,0.625,1,2,0.5,0,0,0.0,0,6,6,1,2,0,0,2,11,-4,1,HOU,MIL,HOU,119,,,18,17,12,7
Tari Eason,F,22023,1631106,22300332,"DEC 15, 2023",HOU @ MEM,W,23,4,8,0.5,1,1,1.0,2,2,1.0,1,7,8,1,2,1,2,2,11,11,1,HOU,MEM,HOU,103,,,20,19,12,9
Tari Eason,F,22023,1631106,22300314,"DEC 13, 2023",HOU vs. MEM,W,27,10,16,0.625,3,4,0.75,2,4,0.5,6,8,14,1,1,1,3,2,25,19,1,HOU,HOU,MEM,117,,,40,39,26,15
Tari Eason,F,22023,1631106,22300298,"DEC 11, 2023",HOU vs. SAS,W,27,8,16,0.5,2,5,0.4,0,1,0.0,4,10,14,1,2,0,2,2,18,12,1,HOU,HOU,SAS,93,,,33,32,19,15
Tari Eason,F,22023,1631106,22301224,"DEC 08, 2023",HOU @ DEN,W,17,0,4,0.0,0,2,0.0,3,4,0.75,1,7,8,2,0,0,0,1,3,-2,1,HOU,DEN,HOU,114,,,13,11,5,10
Tari Eason,F,22023,1631106,22301212,"DEC 06, 2023",HOU vs. OKC,W,22,2,6,0.333,2,4,0.5,3,4,0.75,2,6,8,4,0,2,1,2,9,8,1,HOU,HOU,OKC,110,,,21,17,13,12
Tari Eason,F,22023,1631106,22300291,"DEC 02, 2023",HOU @ LAL,L,20,2,5,0.4,0,1,0.0,2,2,1.0,2,5,7,2,1,1,1,2,6,-4,1,HOU,LAL,HOU,97,,,15,13,8,9
Tari Eason,F,22023,1631106,22300263,"NOV 29, 2023",HOU @ DEN,L,17,2,5,0.4,0,1,0.0,0,0,0.0,2,0,2,0,0,2,0,0,4,8,1,HOU,DEN,HOU,124,,,6,6,4,2
Tari Eason,F,22023,1631106,22300059,"NOV 28, 2023",HOU @ DAL,L,21,4,7,0.571,0,0,0.0,3,5,0.6,2,6,8,0,0,2,2,4,11,9,1,HOU,DAL,HOU,115,,,19,19,11,8
Tari Eason,F,22023,1631106,22300048,"NOV 24, 2023",HOU vs. DEN,W,16,3,6,0.5,1,2,0.5,0,0,0.0,1,3,4,1,1,0,0,2,7,9,1,HOU,HOU,DEN,105,,,12,11,8,5
Tari Eason,F,22023,1631106,22300231,"NOV 22, 2023",HOU vs. MEM,W,19,2,4,0.5,2,3,0.667,0,0,0.0,1,4,5,2,1,1,1,2,6,24,1,HOU,HOU,MEM,111,,,13,11,8,7
Tari Eason,F,22023,1631106,22300216,"NOV 19, 2023",HOU @ LAL,L,17,1,2,0.5,0,1,0.0,0,0,0.0,0,5,5,0,0,1,0,2,2,-18,1,HOU,LAL,HOU,104,,,7,7,2,5
Tari Eason,F,22023,1631106,22300037,"NOV 17, 2023",HOU @ LAC,L,20,6,9,0.667,0,1,0.0,0,2,0.0,2,4,6,0,1,2,1,3,12,11,1,HOU,LAC,HOU,100,,,18,18,12,6
Tari Eason,F,22023,1631106,22300182,"NOV 12, 2023",HOU vs. DEN,W,16,3,4,0.75,2,3,0.667,0,0,0.0,1,2,3,2,1,0,0,1,8,12,1,HOU,HOU,DEN,107,,,13,11,10,5
Tari Eason,F,22023,1631106,22300011,"NOV 10, 2023",HOU vs. NOP,W,19,1,8,0.125,0,2,0.0,0,0,0.0,1,7,8,0,0,2,0,3,2,-2,1,HOU,HOU,NOP,104,,,10,10,2,8
Tari Eason,F,22023,1631106,22300163,"NOV 08, 2023",HOU vs. LAL,W,14,4,10,0.4,1,2,0.5,0,0,0.0,4,5,9,2,0,1,2,1,9,5,1,HOU,HOU,LAL,128,,,20,18,11,11
Tari Eason,F,22023,1631106,22300453,"JAN 01, 2024",HOU vs. DET,W,24,8,15,0.533,1,4,0.25,0,0,0.0,2,2,4,1,3,0,0,3,17,16,1,HOU,HOU,DET,136,,,22,21,18,5
Tari Eason,F,22023,1631106,22300418,"DEC 27, 2023",HOU vs. PHX,L,25,2,6,0.333,1,4,0.25,1,2,0.5,0,3,3,2,5,0,1,2,6,-20,1,HOU,HOU,PHX,113,,,11,9,8,5
Tari Eason,F,22023,1631106,22300434,"DEC 29, 2023",HOU vs. PHI,L,27,5,13,0.385,0,2,0.0,0,0,0.0,5,6,11,2,3,2,2,3,10,-8,1,HOU,HOU,PHI,127,,,23,21,12,13
Nick Richards,C,22023,1630208,22300745,"FEB 09, 2024",CHA @ MIL,L,30,7,9,0.778,0,0,0.0,2,3,0.667,2,9,11,0,0,1,2,2,16,-25,1,CHA,MIL,CHA,80,,,27,27,16,11
Nick Richards,C,22023,1630208,22300335,"DEC 16, 2023",CHA vs. PHI,L,19,4,6,0.667,0,0,0.0,0,0,0.0,2,2,4,1,1,2,1,3,8,-8,1,CHA,CHA,PHI,80,,,13,12,9,5
Nick Richards,C,22023,1630208,22300177,"NOV 12, 2023",CHA @ NYK,L,22,7,9,0.778,0,0,0.0,2,2,1.0,1,3,4,0,0,0,2,4,16,-6,1,CHA,NYK,CHA,107,,,20,20,16,4
Nick Richards,C,22023,1630208,22300635,"JAN 26, 2024",CHA vs. HOU,L,27,3,6,0.5,0,0,0.0,8,11,0.727,2,5,7,1,0,3,0,1,14,-18,1,CHA,CHA,HOU,104,,,22,21,15,8
Nick Richards,C,22023,1630208,22300619,"JAN 24, 2024",CHA @ DET,L,27,9,13,0.692,0,0,0.0,3,4,0.75,5,5,10,0,0,1,0,1,21,-7,1,CHA,DET,CHA,106,,,31,31,21,10
Nick Richards,C,22023,1630208,22300575,"JAN 17, 2024",CHA @ NOP,L,31,4,5,0.8,0,0,0.0,2,2,1.0,5,7,12,2,0,2,0,2,10,-5,1,CHA,NOP,CHA,108,,,24,22,12,14
Nick Richards,C,22023,1630208,22300551,"JAN 14, 2024",CHA @ MIA,L,27,1,5,0.2,0,0,0.0,0,0,0.0,0,8,8,0,0,0,1,4,2,-15,1,CHA,MIA,CHA,85,,,10,10,2,8
Nick Richards,C,22023,1630208,22300541,"JAN 12, 2024",CHA @ SAS,L,22,5,8,0.625,0,0,0.0,2,2,1.0,5,3,8,1,0,1,0,3,12,-19,1,CHA,SAS,CHA,99,,,21,20,13,9
Nick Richards,C,22023,1630208,22300027,"NOV 17, 2023",CHA vs. MIL,L,7,1,2,0.5,0,0,0.0,0,0,0.0,0,1,1,0,0,0,0,0,2,-5,1,CHA,CHA,MIL,99,,,3,3,2,1
Nick Richards,C,22023,1630208,22300017,"NOV 14, 2023",CHA vs. MIA,L,25,2,2,1.0,0,0,0.0,6,6,1.0,1,11,12,1,1,0,3,5,10,5,1,CHA,CHA,MIA,105,,,23,22,11,13
Nick Richards,C,22023,1630208,22300009,"NOV 10, 2023",CHA @ WAS,W,18,5,5,1.0,0,0,0.0,5,8,0.625,3,4,7,0,1,1,1,4,15,-12,1,CHA,WAS,CHA,124,,,22,22,15,7
Nick Richards,C,22023,1630208,22300157,"NOV 08, 2023",CHA vs. WAS,L,16,2,3,0.667,0,0,0.0,3,4,0.75,0,6,6,0,0,0,0,2,7,-9,1,CHA,CHA,WAS,116,,,13,13,7,6
Nick Richards,C,22023,1630208,22300143,"NOV 05, 2023",CHA @ DAL,L,21,6,7,0.857,0,0,0.0,0,0,0.0,3,6,9,1,0,1,0,4,12,-5,1,CHA,DAL,CHA,118,,,22,21,13,10
Nick Richards,C,22023,1630208,22300133,"NOV 04, 2023",CHA @ IND,W,18,4,4,1.0,0,0,0.0,2,2,1.0,3,7,10,0,0,2,1,1,10,4,1,CHA,IND,CHA,125,,,20,20,10,10
Nick Richards,C,22023,1630208,22300122,"NOV 01, 2023",CHA @ HOU,L,19,3,6,0.5,0,0,0.0,4,4,1.0,4,4,8,0,0,4,1,3,10,-9,1,CHA,HOU,CHA,119,,,18,18,10,8
Nick Richards,C,22023,1630208,22300101,"OCT 30, 2023",CHA vs. BKN,L,13,1,1,1.0,0,0,0.0,2,2,1.0,0,2,2,1,1,2,1,2,4,-7,1,CHA,CHA,BKN,121,,,7,6,5,3
Nick Richards,C,22023,1630208,22300077,"OCT 27, 2023",CHA vs. DET,L,16,0,1,0.0,0,0,0.0,0,2,0.0,1,1,2,0,1,2,2,4,0,1,1,CHA,CHA,DET,99,,,2,2,0,2
Nick Richards,C,22023,1630208,22300063,"OCT 25, 2023",CHA vs. ATL,W,18,2,2,1.0,0,0,0.0,3,4,0.75,1,3,4,1,0,1,2,3,7,-14,1,CHA,CHA,ATL,116,,,12,11,8,5
Nick Richards,C,22023,1630208,22300751,"FEB 10, 2024",CHA vs. MEM,W,25,6,10,0.6,0,0,0.0,1,2,0.5,2,5,7,1,0,2,1,2,13,-8,1,CHA,CHA,MEM,115,,,21,20,14,8
Nick Richards,C,22023,1630208,22300726,"FEB 07, 2024",CHA vs. TOR,L,28,1,2,0.5,0,0,0.0,3,4,0.75,2,4,6,1,1,0,1,3,5,1,1,CHA,CHA,TOR,117,,,12,11,6,7
Nick Richards,C,22023,1630208,22300713,"FEB 05, 2024",CHA vs. LAL,L,32,1,4,0.25,0,0,0.0,2,2,1.0,1,8,9,1,0,1,1,3,4,-7,1,CHA,CHA,LAL,118,,,14,13,5,10
Nick Richards,C,22023,1630208,22300707,"FEB 04, 2024",CHA vs. IND,L,33,5,7,0.714,0,0,0.0,2,2,1.0,3,7,10,2,0,0,5,3,12,-10,1,CHA,CHA,IND,99,,,24,22,14,12
Nick Richards,C,22023,1630208,22300695,"FEB 02, 2024",CHA @ OKC,L,31,3,5,0.6,0,0,0.0,2,4,0.5,3,8,11,1,0,1,0,1,8,-12,1,CHA,OKC,CHA,106,,,20,19,9,12
Nick Richards,C,22023,1630208,22300674,"JAN 31, 2024",CHA vs. CHI,L,25,3,4,0.75,0,0,0.0,4,4,1.0,3,3,6,1,0,1,0,5,10,-12,1,CHA,CHA,CHI,110,,,17,16,11,7
Nick Richards,C,22023,1630208,22300657,"JAN 29, 2024",CHA vs. NYK,L,37,2,2,1.0,0,0,0.0,1,4,0.25,4,4,8,1,0,2,3,3,5,-13,1,CHA,CHA,NYK,92,,,14,13,6,9
Nick Richards,C,22023,1630208,22300647,"JAN 27, 2024",CHA vs. UTA,L,36,10,11,0.909,0,0,0.0,6,8,0.75,7,6,13,1,0,4,4,4,26,-3,1,CHA,CHA,UTA,122,,,40,39,27,14
Nick Richards,C,22023,1630208,22300518,"JAN 10, 2024",CHA vs. SAC,L,26,3,5,0.6,0,0,0.0,2,2,1.0,4,5,9,3,0,1,1,3,8,1,1,CHA,CHA,SAC,96,,,20,17,11,12
Nick Richards,C,22023,1630208,22300365,"DEC 20, 2023",CHA @ IND,L,19,2,4,0.5,0,0,0.0,0,0,0.0,6,2,8,0,0,0,0,3,4,-12,1,CHA,IND,CHA,109,,,12,12,4,8
Nick Richards,C,22023,1630208,22300354,"DEC 18, 2023",CHA @ TOR,L,32,4,5,0.8,0,0,0.0,2,2,1.0,4,6,10,3,0,0,0,2,10,-3,1,CHA,TOR,CHA,99,,,23,20,13,13
Nick Richards,C,22023,1630208,22300506,"JAN 08, 2024",CHA vs. CHI,L,39,5,6,0.833,0,0,0.0,0,0,0.0,1,7,8,1,0,3,0,4,10,-8,1,CHA,CHA,CHI,109,,,19,18,11,9
Nick Richards,C,22023,1630208,22300455,"JAN 01, 2024",CHA @ DEN,L,30,7,12,0.583,0,0,0.0,1,2,0.5,2,6,8,1,1,1,0,2,15,-29,1,CHA,DEN,CHA,91,,,24,23,16,9
Nick Richards,C,22023,1630208,22300428,"DEC 28, 2023",CHA @ LAL,L,26,5,5,1.0,0,0,0.0,1,3,0.333,3,7,10,1,2,2,0,3,11,-6,1,CHA,LAL,CHA,110,,,22,21,12,11
Nick Richards,C,22023,1630208,22300484,"JAN 05, 2024",CHA @ CHI,L,27,2,6,0.333,0,0,0.0,0,2,0.0,5,7,12,1,0,0,2,4,4,-4,1,CHA,CHI,CHA,87,,,17,16,5,13
Nick Richards,C,22023,1630208,22300464,"JAN 02, 2024",CHA @ SAC,W,26,3,4,0.75,0,0,0.0,1,2,0.5,1,9,10,1,1,2,2,2,7,2,1,CHA,SAC,CHA,111,,,18,17,8,11
Nick Richards,C,22023,1630208,22300436,"DEC 29, 2023",CHA @ PHX,L,31,3,4,0.75,0,0,0.0,0,0,0.0,1,1,2,0,0,0,0,4,6,-21,1,CHA,PHX,CHA,119,,,8,8,6,2
Nick Richards,C,22023,1630208,22300414,"DEC 26, 2023",CHA @ LAC,L,33,5,6,0.833,0,0,0.0,3,4,0.75,2,8,10,2,0,1,1,2,13,-21,1,CHA,LAC,CHA,104,,,25,23,15,12
Nick Richards,C,22023,1630208,22300390,"DEC 23, 2023",CHA vs. DEN,L,38,4,8,0.5,0,0,0.0,4,6,0.667,6,9,15,3,1,3,3,1,12,-4,1,CHA,CHA,DEN,95,,,30,27,15,18
Nick Richards,C,22023,1630208,22300326,"DEC 15, 2023",CHA vs. NOP,L,30,7,7,1.0,0,0,0.0,2,2,1.0,1,5,6,1,0,1,0,5,16,6,1,CHA,CHA,NOP,105,,,23,22,17,7
Nick Richards,C,22023,1630208,22300312,"DEC 13, 2023",CHA @ MIA,L,40,3,5,0.6,0,0,0.0,0,1,0.0,1,9,10,0,0,4,2,1,6,-8,1,CHA,MIA,CHA,104,,,16,16,6,10
Nick Richards,C,22023,1630208,22300292,"DEC 11, 2023",CHA vs. MIA,L,26,2,6,0.333,0,0,0.0,2,2,1.0,3,3,6,1,0,0,0,1,6,-14,1,CHA,CHA,MIA,114,,,13,12,7,7
Nick Richards,C,22023,1630208,22301216,"DEC 08, 2023",CHA vs. TOR,W,26,5,7,0.714,0,0,0.0,5,6,0.833,2,6,8,0,1,0,1,2,15,7,1,CHA,CHA,TOR,119,,,23,23,15,8
Nick Richards,C,22023,1630208,22301211,"DEC 06, 2023",CHA @ CHI,L,28,2,4,0.5,0,0,0.0,2,2,1.0,6,5,11,0,0,3,2,3,6,-11,1,CHA,CHI,CHA,100,,,17,17,6,11
Nick Richards,C,22023,1630208,22300281,"DEC 02, 2023",CHA vs. MIN,L,9,1,3,0.333,0,0,0.0,2,2,1.0,1,2,3,1,1,1,0,1,4,-3,1,CHA,CHA,MIN,117,,,8,7,5,4
Taurean Prince,F,22023,1627752,22300331,"DEC 15, 2023",LAL @ SAS,L,36,5,10,0.5,2,6,0.333,0,0,0.0,0,3,3,1,1,1,1,2,12,-19,1,LAL,SAS,LAL,115,,,16,15,13,4
Taurean Prince,F,22023,1627752,22300271,"NOV 30, 2023",LAL @ OKC,L,32,2,7,0.286,2,5,0.4,0,0,0.0,0,1,1,2,0,0,1,5,6,-10,1,LAL,OKC,LAL,110,,,9,7,8,3
Taurean Prince,F,22023,1627752,22300163,"NOV 08, 2023",LAL @ HOU,L,27,3,6,0.5,1,2,0.5,0,0,0.0,0,1,1,1,0,0,1,3,7,-16,1,LAL,HOU,LAL,94,,,9,8,8,2
Taurean Prince,F,22023,1627752,22300740,"FEB 08, 2024",LAL vs. DEN,L,34,4,6,0.667,2,3,0.667,3,3,1.0,0,3,3,2,2,1,1,2,13,1,1,LAL,LAL,DEN,106,,,18,16,15,5
Taurean Prince,F,22023,1627752,22300713,"FEB 05, 2024",LAL @ CHA,W,19,4,7,0.571,1,4,0.25,0,2,0.0,1,3,4,1,0,0,2,0,9,2,1,LAL,CHA,LAL,124,,,14,13,10,5
Taurean Prince,F,22023,1627752,22300701,"FEB 03, 2024",LAL @ NYK,W,33,6,10,0.6,3,6,0.5,1,1,1.0,0,2,2,2,0,1,2,3,16,7,1,LAL,NYK,LAL,113,,,20,18,18,4
Taurean Prince,F,22023,1627752,22300684,"FEB 01, 2024",LAL @ BOS,W,38,5,10,0.5,1,2,0.5,0,0,0.0,0,8,8,2,1,1,0,2,11,-9,1,LAL,BOS,LAL,114,,,21,19,13,10
Taurean Prince,F,22023,1627752,22300669,"JAN 30, 2024",LAL @ ATL,L,25,3,7,0.429,1,4,0.25,0,0,0.0,0,2,2,0,1,0,1,1,7,-18,1,LAL,ATL,LAL,122,,,9,9,7,2
Taurean Prince,F,22023,1627752,22300662,"JAN 29, 2024",LAL @ HOU,L,25,2,6,0.333,1,4,0.25,0,0,0.0,0,3,3,1,0,1,2,1,5,-18,1,LAL,HOU,LAL,119,,,9,8,6,4
Taurean Prince,F,22023,1627752,22300650,"JAN 27, 2024",LAL @ GSW,W,24,0,2,0.0,0,1,0.0,0,0,0.0,0,3,3,1,1,0,1,4,0,-22,1,LAL,GSW,LAL,145,,,4,3,1,4
Taurean Prince,F,22023,1627752,22300633,"JAN 25, 2024",LAL vs. CHI,W,30,5,8,0.625,4,7,0.571,0,0,0.0,0,4,4,2,2,0,0,3,14,-2,1,LAL,LAL,CHI,141,,,20,18,16,6
Taurean Prince,F,22023,1627752,22300618,"JAN 23, 2024",LAL @ LAC,L,33,4,10,0.4,2,6,0.333,1,1,1.0,0,3,3,2,2,1,1,2,11,-5,1,LAL,LAC,LAL,116,,,16,14,13,5
Taurean Prince,F,22023,1627752,22300591,"JAN 19, 2024",LAL vs. BKN,L,29,3,7,0.429,2,4,0.5,2,2,1.0,0,3,3,2,1,0,3,1,10,-12,1,LAL,LAL,BKN,112,,,15,13,12,5
Taurean Prince,F,22023,1627752,22300577,"JAN 17, 2024",LAL vs. DAL,W,21,3,8,0.375,0,3,0.0,3,5,0.6,0,1,1,1,0,0,0,4,9,13,1,LAL,LAL,DAL,127,,,11,10,10,2
Taurean Prince,F,22023,1627752,22300565,"JAN 15, 2024",LAL vs. OKC,W,31,1,6,0.167,1,5,0.2,0,0,0.0,0,2,2,3,0,1,0,2,3,-1,1,LAL,LAL,OKC,112,,,8,5,6,5
Taurean Prince,F,22023,1627752,22300549,"JAN 13, 2024",LAL @ UTA,L,30,5,8,0.625,2,4,0.5,0,0,0.0,0,1,1,1,0,1,0,3,12,-19,1,LAL,UTA,LAL,125,,,14,13,13,2
Taurean Prince,F,22023,1627752,22300531,"JAN 11, 2024",LAL vs. PHX,L,28,4,10,0.4,3,8,0.375,0,0,0.0,1,5,6,2,0,0,0,0,11,-30,1,LAL,LAL,PHX,109,,,19,17,13,8
Taurean Prince,F,22023,1627752,22300516,"JAN 09, 2024",LAL vs. TOR,W,34,4,8,0.5,2,6,0.333,1,2,0.5,0,4,4,0,2,0,0,2,11,-7,1,LAL,LAL,TOR,132,,,15,15,11,4
Taurean Prince,F,22023,1627752,22300505,"JAN 07, 2024",LAL vs. LAC,W,30,4,8,0.5,3,6,0.5,2,2,1.0,0,1,1,2,1,0,0,3,13,-2,1,LAL,LAL,LAC,106,,,16,14,15,3
Taurean Prince,F,22023,1627752,22300491,"JAN 05, 2024",LAL vs. MEM,L,35,3,9,0.333,3,7,0.429,1,2,0.5,1,1,2,2,2,1,1,3,10,-19,1,LAL,LAL,MEM,113,,,14,12,12,4
Taurean Prince,F,22023,1627752,22300475,"JAN 03, 2024",LAL vs. MIA,L,29,0,6,0.0,0,5,0.0,0,0,0.0,0,5,5,2,0,0,1,2,0,-14,1,LAL,LAL,MIA,96,,,7,5,2,7
Taurean Prince,F,22023,1627752,22300446,"DEC 31, 2023",LAL @ NOP,L,34,5,9,0.556,4,7,0.571,1,1,1.0,0,1,1,4,2,2,2,2,15,-12,1,LAL,NOP,LAL,109,,,20,16,19,5
Taurean Prince,F,22023,1627752,22300428,"DEC 28, 2023",LAL vs. CHA,W,23,1,7,0.143,1,4,0.25,0,0,0.0,0,3,3,3,3,0,1,2,3,2,1,LAL,LAL,CHA,133,,,9,6,6,6
Taurean Prince,F,22023,1627752,22300370,"DEC 20, 2023",LAL @ CHI,L,34,5,10,0.5,4,8,0.5,2,2,1.0,0,4,4,4,1,1,1,3,16,-7,1,LAL,CHI,LAL,108,,,24,20,20,8
Taurean Prince,F,22023,1627752,22300316,"DEC 13, 2023",LAL @ SAS,W,32,6,12,0.5,4,10,0.4,1,2,0.5,1,4,5,5,2,1,3,1,17,3,1,LAL,SAS,LAL,122,,,27,22,22,10
Taurean Prince,F,22023,1627752,22300306,"DEC 12, 2023",LAL @ DAL,L,37,5,6,0.833,5,6,0.833,0,0,0.0,0,4,4,4,0,0,1,0,15,5,1,LAL,DAL,LAL,125,,,23,19,19,8
Taurean Prince,F,22023,1627752,22301230,"DEC 07, 2023",LAL vs. NOP,W,23,5,9,0.556,5,8,0.625,0,0,0.0,0,3,3,1,1,0,0,3,15,23,1,LAL,LAL,NOP,133,,,19,18,16,4
Taurean Prince,F,22023,1627752,22301203,"DEC 05, 2023",LAL vs. PHX,W,27,2,6,0.333,0,2,0.0,1,2,0.5,0,3,3,0,3,0,3,1,5,-12,1,LAL,LAL,PHX,106,,,8,8,5,3
Taurean Prince,F,22023,1627752,22300291,"DEC 02, 2023",LAL vs. HOU,W,29,4,7,0.571,3,5,0.6,0,0,0.0,0,6,6,1,2,0,1,0,11,6,1,LAL,LAL,HOU,107,,,18,17,12,7
Taurean Prince,F,22023,1627752,22300258,"NOV 29, 2023",LAL @ DET,W,23,3,4,0.75,3,4,0.75,0,0,0.0,0,1,1,1,1,0,1,0,9,26,1,LAL,DET,LAL,133,,,11,10,10,2
Taurean Prince,F,22023,1627752,22300255,"NOV 27, 2023",LAL @ PHI,L,29,4,8,0.5,3,6,0.5,0,0,0.0,0,4,4,1,0,0,1,3,11,-26,1,LAL,PHI,LAL,94,,,16,15,12,5
Taurean Prince,F,22023,1627752,22300242,"NOV 25, 2023",LAL @ CLE,W,32,3,8,0.375,1,3,0.333,0,0,0.0,0,4,4,6,1,2,0,0,7,12,1,LAL,CLE,LAL,121,,,17,11,13,10
Taurean Prince,F,22023,1627752,22300238,"NOV 22, 2023",LAL vs. DAL,L,37,6,10,0.6,2,5,0.4,0,0,0.0,1,5,6,2,0,0,1,3,14,15,1,LAL,LAL,DAL,101,,,22,20,16,8
Taurean Prince,F,22023,1627752,22300042,"NOV 21, 2023",LAL vs. UTA,W,31,1,8,0.125,0,4,0.0,2,3,0.667,0,0,0,1,0,1,2,0,4,26,1,LAL,LAL,UTA,131,,,5,4,5,1
Taurean Prince,F,22023,1627752,22300036,"NOV 17, 2023",LAL @ POR,W,35,3,7,0.429,1,5,0.2,3,3,1.0,1,0,1,3,2,0,0,5,10,11,1,LAL,POR,LAL,107,,,14,11,13,4
Taurean Prince,F,22023,1627752,22300198,"NOV 15, 2023",LAL vs. SAC,L,25,3,7,0.429,1,4,0.25,0,0,0.0,0,2,2,0,1,0,0,2,7,-24,1,LAL,LAL,SAC,110,,,9,9,7,2
Taurean Prince,F,22023,1627752,22300026,"NOV 14, 2023",LAL vs. MEM,W,29,3,6,0.5,2,5,0.4,0,0,0.0,0,3,3,1,1,0,0,3,8,9,1,LAL,LAL,MEM,134,,,12,11,9,4
Taurean Prince,F,22023,1627752,22300187,"NOV 12, 2023",LAL vs. POR,W,33,5,9,0.556,0,3,0.0,1,1,1.0,0,3,3,1,1,0,1,2,11,1,1,LAL,LAL,POR,116,,,15,14,12,4
Taurean Prince,F,22023,1627752,22300150,"NOV 06, 2023",LAL @ MIA,L,34,4,9,0.444,1,4,0.25,0,0,0.0,0,3,3,2,2,0,0,4,9,13,1,LAL,MIA,LAL,107,,,14,12,11,5
Taurean Prince,F,22023,1627752,22300061,"OCT 24, 2023",LAL @ DEN,L,30,6,8,0.75,4,6,0.667,2,2,1.0,1,2,3,1,0,1,1,0,18,-14,1,LAL,DEN,LAL,107,,,22,21,19,4
Taurean Prince,F,22023,1627752,22300747,"FEB 09, 2024",LAL vs. NOP,W,21,0,2,0.0,0,2,0.0,3,4,0.75,0,2,2,1,0,0,1,3,3,10,1,LAL,LAL,NOP,139,,,6,5,4,3
Taurean Prince,F,22023,1627752,22300443,"DEC 30, 2023",LAL @ MIN,L,33,3,9,0.333,3,6,0.5,0,0,0.0,0,2,2,1,3,0,3,1,9,15,1,LAL,MIN,LAL,106,,,12,11,10,3
Taurean Prince,F,22023,1627752,22300403,"DEC 25, 2023",LAL vs. BOS,L,39,6,13,0.462,5,12,0.417,0,0,0.0,0,4,4,3,1,0,0,4,17,-12,1,LAL,LAL,BOS,115,,,24,21,20,7
Taurean Prince,F,22023,1627752,22300397,"DEC 23, 2023",LAL @ OKC,W,28,3,7,0.429,2,5,0.4,2,2,1.0,1,5,6,1,1,2,0,5,10,9,1,LAL,OKC,LAL,129,,,17,16,11,7
Taurean Prince,F,22023,1627752,22300380,"DEC 21, 2023",LAL @ MIN,L,37,5,6,0.833,4,5,0.8,0,0,0.0,0,5,5,1,0,0,3,4,14,6,1,LAL,MIN,LAL,111,,,20,19,15,6
Taurean Prince,F,22023,1627752,22300359,"DEC 18, 2023",LAL vs. NYK,L,39,3,13,0.231,3,13,0.231,0,0,0.0,1,1,2,3,0,1,1,1,9,-1,1,LAL,LAL,NYK,109,,,14,11,12,5
Taurean Prince,F,22023,1627752,22300216,"NOV 19, 2023",LAL vs. HOU,W,24,1,11,0.091,0,4,0.0,0,1,0.0,3,1,4,2,0,0,2,0,2,-6,1,LAL,LAL,HOU,105,,,8,6,4,6
Taurean Prince,F,22023,1627752,22300015,"NOV 10, 2023",LAL @ PHX,W,33,3,8,0.375,0,4,0.0,1,2,0.5,0,1,1,0,0,2,0,4,7,3,1,LAL,PHX,LAL,122,,,8,8,7,1
Taurean Prince,F,22023,1627752,22300111,"OCT 30, 2023",LAL vs. ORL,W,26,1,4,0.25,0,2,0.0,2,2,1.0,0,0,0,1,0,1,0,3,4,-5,1,LAL,LAL,ORL,106,,,5,4,5,1
Taurean Prince,F,22023,1627752,22300100,"OCT 29, 2023",LAL @ SAC,L,41,7,17,0.412,5,13,0.385,1,2,0.5,0,3,3,2,0,1,1,3,20,-10,1,LAL,SAC,LAL,127,,,25,23,22,5
Taurean Prince,F,22023,1627752,22300076,"OCT 26, 2023",LAL vs. PHX,W,18,0,5,0.0,0,1,0.0,0,0,0.0,0,0,0,0,1,0,0,3,0,-15,1,LAL,LAL,PHX,100,,,0,0,0,0
Tre Jones,G,22023,1630200,22300750,"FEB 10, 2024",SAS @ BKN,L,28,2,3,0.667,0,1,0.0,2,2,1.0,1,1,2,2,2,0,2,0,6,-22,1,SAS,BKN,SAS,103,,,10,8,8,4
Tre Jones,G,22023,1630200,22300681,"JAN 31, 2024",SAS vs. ORL,L,35,2,5,0.4,1,1,1.0,3,4,0.75,1,2,3,8,3,0,1,4,8,-2,1,SAS,SAS,ORL,98,,,19,11,16,11
Tre Jones,G,22023,1630200,22300665,"JAN 29, 2024",SAS vs. WAS,L,33,5,12,0.417,1,2,0.5,0,0,0.0,0,2,2,8,0,0,0,0,11,-6,1,SAS,SAS,WAS,113,,,21,13,19,10
Tre Jones,G,22023,1630200,22300649,"JAN 27, 2024",SAS vs. MIN,W,29,5,7,0.714,2,3,0.667,0,0,0.0,3,0,3,11,0,0,2,3,12,18,1,SAS,SAS,MIN,113,,,26,15,23,14
Tre Jones,G,22023,1630200,22300584,"JAN 19, 2024",SAS @ CHA,L,32,6,11,0.545,2,3,0.667,2,2,1.0,0,2,2,4,3,0,1,2,16,-2,1,SAS,CHA,SAS,120,,,22,18,20,6
Tre Jones,G,22023,1630200,22300571,"JAN 17, 2024",SAS @ BOS,L,27,4,9,0.444,1,5,0.2,0,0,0.0,0,4,4,11,0,0,2,2,9,-1,1,SAS,BOS,SAS,95,,,24,13,20,15
Tre Jones,G,22023,1630200,22300559,"JAN 15, 2024",SAS @ ATL,L,30,3,8,0.375,0,1,0.0,0,0,0.0,0,1,1,12,3,0,3,0,6,5,1,SAS,ATL,SAS,99,,,19,7,18,13
Tre Jones,G,22023,1630200,22300548,"JAN 13, 2024",SAS vs. CHI,L,32,10,13,0.769,4,6,0.667,6,6,1.0,1,8,9,4,0,0,1,2,30,-14,1,SAS,SAS,CHI,116,,,43,39,34,13
Tre Jones,G,22023,1630200,22300541,"JAN 12, 2024",SAS vs. CHA,W,22,2,4,0.5,0,1,0.0,2,2,1.0,0,3,3,7,1,0,0,3,6,19,1,SAS,SAS,CHA,127,,,16,9,13,10
Tre Jones,G,22023,1630200,22300519,"JAN 10, 2024",SAS @ DET,W,27,5,9,0.556,0,1,0.0,1,1,1.0,0,2,2,5,0,1,2,2,11,17,1,SAS,DET,SAS,129,,,18,13,16,7
Tre Jones,G,22023,1630200,22300497,"JAN 07, 2024",SAS @ CLE,L,34,7,8,0.875,2,2,1.0,2,2,1.0,0,2,2,4,2,0,2,1,18,11,1,SAS,CLE,SAS,115,,,24,20,22,6
Tre Jones,G,22023,1630200,22300477,"JAN 04, 2024",SAS vs. MIL,L,35,7,13,0.538,0,2,0.0,4,4,1.0,2,3,5,6,1,0,3,2,18,-9,1,SAS,SAS,MIL,121,,,29,23,24,11
Tre Jones,G,22023,1630200,22300460,"JAN 02, 2024",SAS @ MEM,L,25,1,6,0.167,0,3,0.0,0,0,0.0,0,4,4,4,1,0,0,2,2,8,1,SAS,MEM,SAS,98,,,10,6,6,8
Tre Jones,G,22023,1630200,22300448,"DEC 31, 2023",SAS vs. BOS,L,22,4,10,0.4,0,5,0.0,0,0,0.0,1,3,4,2,0,0,1,3,8,-11,1,SAS,SAS,BOS,101,,,14,12,10,6
Tre Jones,G,22023,1630200,22300437,"DEC 29, 2023",SAS @ POR,L,27,7,9,0.778,0,0,0.0,0,0,0.0,3,5,8,5,0,0,3,2,14,14,1,SAS,POR,SAS,128,,,27,22,19,13
Tre Jones,G,22023,1630200,22300361,"DEC 19, 2023",SAS @ MIL,L,24,7,11,0.636,0,1,0.0,0,0,0.0,0,1,1,5,1,0,2,1,14,-12,1,SAS,MIL,SAS,119,,,20,15,19,6
Tre Jones,G,22023,1630200,22300278,"DEC 01, 2023",SAS @ NOP,L,23,4,9,0.444,2,4,0.5,0,0,0.0,1,2,3,3,0,0,2,1,10,-10,1,SAS,NOP,SAS,106,,,16,13,13,6
Tre Jones,G,22023,1630200,22300235,"NOV 22, 2023",SAS vs. LAC,L,20,2,7,0.286,0,2,0.0,0,0,0.0,0,2,2,1,3,0,1,1,4,-6,1,SAS,SAS,LAC,102,,,7,6,5,3
Tre Jones,G,22023,1630200,22300206,"NOV 18, 2023",SAS vs. MEM,L,21,1,4,0.25,0,1,0.0,0,1,0.0,0,0,0,3,0,0,1,1,2,-18,1,SAS,SAS,MEM,108,,,5,2,5,3
Tre Jones,G,22023,1630200,22300161,"NOV 08, 2023",SAS @ NYK,L,25,6,11,0.545,0,2,0.0,0,1,0.0,0,1,1,5,1,1,0,0,12,-2,1,SAS,NYK,SAS,105,,,18,13,17,6
Tre Jones,G,22023,1630200,22300146,"NOV 06, 2023",SAS @ IND,L,19,1,5,0.2,0,2,0.0,2,2,1.0,1,0,1,8,0,0,1,1,4,-21,1,SAS,IND,SAS,111,,,13,5,12,9
Tre Jones,G,22023,1630200,22300099,"OCT 29, 2023",SAS @ LAC,L,20,1,4,0.25,1,2,0.5,2,2,1.0,0,2,2,4,1,0,4,3,5,0,1,SAS,LAC,SAS,83,,,11,7,9,6
Tre Jones,G,22023,1630200,22300272,"NOV 30, 2023",SAS vs. ATL,L,24,1,5,0.2,1,3,0.333,0,1,0.0,0,2,2,7,0,0,2,1,3,-2,1,SAS,SAS,ATL,135,,,12,5,10,9
Tre Jones,G,22023,1630200,22300252,"NOV 26, 2023",SAS @ DEN,L,22,4,8,0.5,0,1,0.0,2,2,1.0,0,4,4,6,0,0,1,2,10,14,1,SAS,DEN,SAS,120,,,20,14,16,10
Tre Jones,G,22023,1630200,22300051,"NOV 24, 2023",SAS @ GSW,L,17,3,5,0.6,1,1,1.0,0,0,0.0,0,5,5,2,2,0,1,1,7,-10,1,SAS,GSW,SAS,112,,,14,12,9,7
Tre Jones,G,22023,1630200,22300223,"NOV 20, 2023",SAS vs. LAC,L,23,4,10,0.4,1,3,0.333,2,2,1.0,2,0,2,5,0,0,3,1,11,-12,1,SAS,SAS,LAC,99,,,18,13,16,7
Tre Jones,G,22023,1630200,22300013,"NOV 10, 2023",SAS vs. MIN,L,26,4,8,0.5,0,1,0.0,0,0,0.0,0,4,4,4,1,1,2,1,8,7,1,SAS,SAS,MIN,110,,,16,12,12,8
Tre Jones,G,22023,1630200,22300141,"NOV 05, 2023",SAS vs. TOR,L,32,3,10,0.3,0,2,0.0,0,0,0.0,1,2,3,6,0,1,4,4,6,-7,1,SAS,SAS,TOR,116,,,15,9,12,9
Tre Jones,G,22023,1630200,22300131,"NOV 02, 2023",SAS @ PHX,W,28,3,8,0.375,2,4,0.5,4,4,1.0,1,4,5,10,1,0,1,3,12,19,1,SAS,PHX,SAS,132,,,27,17,22,15
Tre Jones,G,22023,1630200,22300113,"OCT 31, 2023",SAS @ PHX,W,24,3,4,0.75,0,1,0.0,4,4,1.0,0,2,2,3,1,1,0,0,10,13,1,SAS,PHX,SAS,115,,,15,12,13,5
Tre Jones,G,22023,1630200,22300083,"OCT 27, 2023",SAS vs. HOU,W,33,3,8,0.375,0,3,0.0,0,0,0.0,3,3,6,8,2,0,0,0,6,14,1,SAS,SAS,HOU,126,,,20,12,14,14
Tre Jones,G,22023,1630200,22300073,"OCT 25, 2023",SAS vs. DAL,L,25,5,7,0.714,2,3,0.667,4,4,1.0,1,4,5,6,0,0,1,0,16,1,1,SAS,SAS,DAL,119,,,27,21,22,11
Tre Jones,G,22023,1630200,22300734,"FEB 08, 2024",SAS @ ORL,L,23,3,8,0.375,0,2,0.0,4,4,1.0,1,0,1,6,3,0,1,1,10,-17,1,SAS,ORL,SAS,111,,,17,11,16,7
Tre Jones,G,22023,1630200,22300730,"FEB 07, 2024",SAS @ MIA,L,31,7,11,0.636,2,4,0.5,3,5,0.6,0,2,2,6,0,0,3,0,19,-15,1,SAS,MIA,SAS,104,,,27,21,25,8
Tre Jones,G,22023,1630200,22300703,"FEB 03, 2024",SAS vs. CLE,L,28,3,10,0.3,0,3,0.0,1,1,1.0,0,5,5,8,1,0,0,0,7,6,1,SAS,SAS,CLE,101,,,20,12,15,13
Tre Jones,G,22023,1630200,22300696,"FEB 02, 2024",SAS vs. NOP,L,35,8,15,0.533,1,5,0.2,3,4,0.75,1,6,7,7,0,1,4,0,20,-4,1,SAS,SAS,NOP,113,,,34,27,27,14
Tre Jones,G,22023,1630200,22300594,"JAN 20, 2024",SAS @ WAS,W,32,4,9,0.444,0,3,0.0,3,3,1.0,3,5,8,12,3,0,1,0,11,6,1,SAS,WAS,SAS,131,,,31,19,23,20
Tre Jones,G,22023,1630200,22300427,"DEC 28, 2023",SAS @ POR,W,26,2,6,0.333,0,2,0.0,4,4,1.0,3,2,5,6,1,0,1,0,8,1,1,SAS,POR,SAS,118,,,19,13,14,11
Tre Jones,G,22023,1630200,22300412,"DEC 26, 2023",SAS vs. UTA,L,27,3,7,0.429,0,1,0.0,0,1,0.0,3,1,4,7,2,0,0,1,6,-7,1,SAS,SAS,UTA,118,,,17,10,13,11
Tre Jones,G,22023,1630200,22300398,"DEC 23, 2023",SAS @ DAL,L,18,4,8,0.5,1,4,0.25,0,0,0.0,0,1,1,4,0,0,1,1,9,-23,1,SAS,DAL,SAS,119,,,14,10,13,5
Tre Jones,G,22023,1630200,22300376,"DEC 21, 2023",SAS @ CHI,L,21,4,6,0.667,1,1,1.0,0,0,0.0,0,1,1,3,1,0,5,0,9,-11,1,SAS,CHI,SAS,95,,,13,10,12,4
Tre Jones,G,22023,1630200,22300345,"DEC 17, 2023",SAS vs. NOP,L,16,2,5,0.4,0,2,0.0,0,0,0.0,0,0,0,5,0,0,0,1,4,-14,1,SAS,SAS,NOP,110,,,9,4,9,5
Tre Jones,G,22023,1630200,22300316,"DEC 13, 2023",SAS vs. LAL,L,22,3,5,0.6,0,2,0.0,0,0,0.0,0,1,1,5,0,0,2,0,6,-11,1,SAS,SAS,LAL,119,,,12,7,11,6
Tre Jones,G,22023,1630200,22300298,"DEC 11, 2023",SAS @ HOU,L,16,0,1,0.0,0,1,0.0,3,5,0.6,0,0,0,2,2,0,0,1,3,-4,1,SAS,HOU,SAS,82,,,5,3,5,2
Tre Jones,G,22023,1630200,22301223,"DEC 08, 2023",SAS vs. CHI,L,28,6,7,0.857,2,2,1.0,4,4,1.0,0,5,5,8,1,0,1,2,18,12,1,SAS,SAS,CHI,112,,,31,23,26,13
Tre Jones,G,22023,1630200,22301210,"DEC 06, 2023",SAS @ MIN,L,26,2,8,0.25,0,3,0.0,0,0,0.0,0,2,2,5,1,0,0,2,4,-11,1,SAS,MIN,SAS,94,,,11,6,9,7
Tre Jones,G,22023,1630200,22300641,"JAN 26, 2024",SAS vs. POR,W,24,3,4,0.75,1,1,1.0,2,2,1.0,0,1,1,7,3,0,1,0,9,24,1,SAS,SAS,POR,116,,,17,10,16,8
Tre Jones,G,22023,1630200,22300608,"JAN 22, 2024",SAS @ PHI,L,33,5,7,0.714,0,1,0.0,2,2,1.0,1,3,4,6,2,0,0,1,12,-13,1,SAS,PHI,SAS,123,,,22,16,18,10
Georges Niang,F,22023,1627777,22300756,"FEB 10, 2024",CLE @ TOR,W,18,5,8,0.625,3,5,0.6,0,0,0.0,0,1,1,0,0,1,0,4,13,4,1,CLE,TOR,CLE,119,,,14,14,13,1
Georges Niang,F,22023,1627777,22300735,"FEB 08, 2024",CLE @ BKN,W,23,5,9,0.556,3,6,0.5,0,0,0.0,1,2,3,1,1,0,0,1,13,1,1,CLE,BKN,CLE,118,,,17,16,14,4
Georges Niang,F,22023,1627777,22300728,"FEB 07, 2024",CLE @ WAS,W,17,3,4,0.75,1,1,1.0,0,0,0.0,0,3,3,0,0,0,1,2,7,2,1,CLE,WAS,CLE,114,,,10,10,7,3
Georges Niang,F,22023,1627777,22300714,"FEB 05, 2024",CLE vs. SAC,W,15,1,4,0.25,0,3,0.0,0,0,0.0,0,3,3,2,0,0,2,4,2,2,1,CLE,CLE,SAC,136,,,7,5,4,5
Georges Niang,F,22023,1627777,22300703,"FEB 03, 2024",CLE @ SAS,W,18,0,9,0.0,0,8,0.0,2,2,1.0,0,2,2,2,0,0,0,2,2,5,1,CLE,SAS,CLE,117,,,6,4,4,4
Georges Niang,F,22023,1627777,22300687,"FEB 01, 2024",CLE @ MEM,W,22,2,7,0.286,1,4,0.25,0,0,0.0,1,4,5,0,0,0,0,4,5,-7,1,CLE,MEM,CLE,108,,,10,10,5,5
Georges Niang,F,22023,1627777,22300675,"JAN 31, 2024",CLE vs. DET,W,17,2,4,0.5,0,0,0.0,0,0,0.0,0,2,2,5,0,0,0,0,4,0,1,CLE,CLE,DET,128,,,11,6,9,7
Georges Niang,F,22023,1627777,22300658,"JAN 29, 2024",CLE vs. LAC,W,20,3,10,0.3,2,7,0.286,2,2,1.0,0,2,2,1,0,1,0,1,10,12,1,CLE,CLE,LAC,118,,,13,12,11,3
Georges Niang,F,22023,1627777,22300639,"JAN 26, 2024",CLE @ MIL,W,27,3,5,0.6,0,2,0.0,4,4,1.0,0,5,5,2,0,0,1,2,10,10,1,CLE,MIL,CLE,112,,,17,15,12,7
Georges Niang,F,22023,1627777,22300624,"JAN 24, 2024",CLE @ MIL,L,21,5,7,0.714,2,3,0.667,2,2,1.0,1,3,4,2,0,0,0,2,14,6,1,CLE,MIL,CLE,116,,,20,18,16,6
Georges Niang,F,22023,1627777,22300607,"JAN 22, 2024",CLE @ ORL,W,28,3,9,0.333,2,7,0.286,3,4,0.75,0,5,5,1,0,1,0,3,11,12,1,CLE,ORL,CLE,126,,,17,16,12,6
Georges Niang,F,22023,1627777,22300595,"JAN 20, 2024",CLE @ ATL,W,21,5,9,0.556,4,8,0.5,0,0,0.0,0,5,5,2,0,1,0,2,14,11,1,CLE,ATL,CLE,116,,,21,19,16,7
Georges Niang,F,22023,1627777,22300572,"JAN 17, 2024",CLE vs. MIL,W,27,13,14,0.929,5,6,0.833,2,3,0.667,0,5,5,2,0,0,1,2,33,0,1,CLE,CLE,MIL,135,,,40,38,35,7
Georges Niang,F,22023,1627777,22300561,"JAN 15, 2024",CLE vs. CHI,W,19,3,11,0.273,3,9,0.333,0,0,0.0,0,2,2,0,0,1,1,2,9,-7,1,CLE,CLE,CHI,109,,,11,11,9,2
Georges Niang,F,22023,1627777,22300527,"JAN 11, 2024",CLE vs. BKN,W,16,3,6,0.5,2,4,0.5,2,2,1.0,1,3,4,2,0,0,0,3,10,1,1,CLE,CLE,BKN,111,,,16,14,12,6
Georges Niang,F,22023,1627777,22300497,"JAN 07, 2024",CLE vs. SAS,W,27,4,7,0.571,3,6,0.5,0,0,0.0,0,4,4,1,0,1,1,2,11,27,1,CLE,CLE,SAS,117,,,16,15,12,5
Georges Niang,F,22023,1627777,22300482,"JAN 05, 2024",CLE vs. WAS,W,25,5,9,0.556,4,8,0.5,0,0,0.0,0,9,9,1,0,0,1,2,14,3,1,CLE,CLE,WAS,114,,,24,23,15,10
Georges Niang,F,22023,1627777,22300465,"JAN 03, 2024",CLE vs. WAS,W,28,5,11,0.455,3,7,0.429,2,2,1.0,1,7,8,1,0,0,0,2,15,24,1,CLE,CLE,WAS,140,,,24,23,16,9
Georges Niang,F,22023,1627777,22300452,"JAN 01, 2024",CLE @ TOR,L,16,4,5,0.8,0,1,0.0,0,0,0.0,0,4,4,2,0,0,1,5,8,-3,1,CLE,TOR,CLE,121,,,14,12,10,6
Georges Niang,F,22023,1627777,22300433,"DEC 29, 2023",CLE vs. MIL,L,14,1,7,0.143,0,6,0.0,0,0,0.0,0,0,0,0,1,1,0,2,2,-8,1,CLE,CLE,MIL,111,,,2,2,2,0
Georges Niang,F,22023,1627777,22300420,"DEC 27, 2023",CLE @ DAL,W,24,6,11,0.545,4,8,0.5,0,2,0.0,0,2,2,3,1,1,2,0,16,-15,1,CLE,DAL,CLE,113,,,21,18,19,5
Georges Niang,F,22023,1627777,22300396,"DEC 23, 2023",CLE @ CHI,W,21,3,12,0.25,1,5,0.2,0,0,0.0,1,4,5,0,0,0,2,4,7,-4,1,CLE,CHI,CLE,109,,,12,12,7,5
Georges Niang,F,22023,1627777,22300375,"DEC 21, 2023",CLE vs. NOP,L,19,4,8,0.5,3,7,0.429,0,0,0.0,0,2,2,1,0,1,3,1,11,-13,1,CLE,CLE,NOP,104,,,14,13,12,3
Georges Niang,F,22023,1627777,22300364,"DEC 20, 2023",CLE vs. UTA,W,23,6,13,0.462,3,10,0.3,0,0,0.0,0,1,1,1,0,0,1,4,15,11,1,CLE,CLE,UTA,124,,,17,16,16,2
Georges Niang,F,22023,1627777,22300349,"DEC 18, 2023",CLE vs. HOU,W,25,4,10,0.4,2,6,0.333,0,0,0.0,1,1,2,0,2,0,3,5,10,10,1,CLE,CLE,HOU,135,,,12,12,10,2
Georges Niang,F,22023,1627777,22300336,"DEC 16, 2023",CLE vs. ATL,W,15,0,4,0.0,0,3,0.0,0,0,0.0,1,2,3,2,0,0,0,2,0,-1,1,CLE,CLE,ATL,127,,,5,3,2,5
Georges Niang,F,22023,1627777,22300319,"DEC 14, 2023",CLE @ BOS,L,22,1,4,0.25,0,2,0.0,2,2,1.0,0,2,2,0,0,0,1,2,4,-7,1,CLE,BOS,CLE,107,,,6,6,4,2
Georges Niang,F,22023,1627777,22300305,"DEC 12, 2023",CLE @ BOS,L,23,1,1,1.0,1,1,1.0,0,0,0.0,0,2,2,1,0,0,1,1,3,-14,1,CLE,BOS,CLE,113,,,6,5,4,3
Georges Niang,F,22023,1627777,22300294,"DEC 11, 2023",CLE @ ORL,L,22,0,10,0.0,0,5,0.0,0,0,0.0,1,3,4,0,0,0,0,3,0,1,1,CLE,ORL,CLE,94,,,4,4,0,4
Georges Niang,F,22023,1627777,22301220,"DEC 08, 2023",CLE @ MIA,W,20,5,9,0.556,3,4,0.75,0,0,0.0,1,2,3,2,0,0,2,1,13,-10,1,CLE,MIA,CLE,111,,,18,16,15,5
Georges Niang,F,22023,1627777,22301205,"DEC 06, 2023",CLE vs. ORL,W,28,4,7,0.571,2,5,0.4,0,0,0.0,1,4,5,3,0,0,2,4,10,14,1,CLE,CLE,ORL,121,,,18,15,13,8
Georges Niang,F,22023,1627777,22300283,"DEC 02, 2023",CLE @ DET,W,22,5,8,0.625,1,4,0.25,1,2,0.5,0,3,3,2,0,0,0,1,12,15,1,CLE,DET,CLE,110,,,17,15,14,5
Georges Niang,F,22023,1627777,22300265,"NOV 30, 2023",CLE vs. POR,L,19,3,6,0.5,1,3,0.333,1,1,1.0,1,0,1,2,2,0,0,0,8,-4,1,CLE,CLE,POR,95,,,11,9,10,3
Georges Niang,F,22023,1627777,22300055,"NOV 28, 2023",CLE vs. ATL,W,19,4,9,0.444,2,6,0.333,2,2,1.0,0,7,7,1,0,0,1,3,12,-10,1,CLE,CLE,ATL,128,,,20,19,13,8
Georges Niang,F,22023,1627777,22300251,"NOV 26, 2023",CLE vs. TOR,W,23,3,9,0.333,2,5,0.4,0,0,0.0,0,6,6,3,1,0,0,4,8,13,1,CLE,CLE,TOR,105,,,17,14,11,9
Georges Niang,F,22023,1627777,22300242,"NOV 25, 2023",CLE vs. LAL,L,23,5,13,0.385,3,9,0.333,0,0,0.0,0,2,2,1,2,0,1,2,13,7,1,CLE,CLE,LAL,115,,,16,15,14,3
Georges Niang,F,22023,1627777,22300229,"NOV 22, 2023",CLE vs. MIA,L,20,4,9,0.444,3,5,0.6,0,0,0.0,1,2,3,1,0,0,0,5,11,-17,1,CLE,CLE,MIA,96,,,15,14,12,4
Georges Niang,F,22023,1627777,22300040,"NOV 21, 2023",CLE @ PHI,W,26,5,9,0.556,2,4,0.5,0,0,0.0,0,7,7,0,0,0,1,2,12,12,1,CLE,PHI,CLE,122,,,19,19,12,7
Georges Niang,F,22023,1627777,22300210,"NOV 19, 2023",CLE vs. DEN,W,23,4,9,0.444,2,3,0.667,2,2,1.0,0,3,3,2,0,0,1,1,12,11,1,CLE,CLE,DEN,121,,,17,15,14,5
Georges Niang,F,22023,1627777,22300030,"NOV 17, 2023",CLE vs. DET,W,27,3,4,0.75,1,1,1.0,2,2,1.0,0,7,7,2,1,0,0,1,9,21,1,CLE,CLE,DET,108,,,18,16,11,9
Georges Niang,F,22023,1627777,22300199,"NOV 15, 2023",CLE @ POR,W,22,3,6,0.5,2,4,0.5,0,0,0.0,0,2,2,0,0,1,2,1,8,-8,1,CLE,POR,CLE,109,,,10,10,8,2
Georges Niang,F,22023,1627777,22300191,"NOV 13, 2023",CLE @ SAC,L,22,5,7,0.714,2,4,0.5,0,0,0.0,0,1,1,1,0,0,0,1,12,-12,1,CLE,SAC,CLE,120,,,14,13,13,2
Georges Niang,F,22023,1627777,22300176,"NOV 11, 2023",CLE @ GSW,W,19,0,4,0.0,0,4,0.0,0,0,0.0,1,1,2,1,0,0,1,1,0,-10,1,CLE,GSW,CLE,118,,,3,2,1,3
Georges Niang,F,22023,1627777,22300167,"NOV 08, 2023",CLE @ OKC,L,18,3,5,0.6,1,3,0.333,0,0,0.0,0,2,2,0,0,0,1,3,7,-11,1,CLE,OKC,CLE,120,,,9,9,7,2
Georges Niang,F,22023,1627777,22300142,"NOV 05, 2023",CLE vs. GSW,W,25,2,6,0.333,2,4,0.5,0,0,0.0,0,6,6,1,0,0,0,4,6,1,1,CLE,CLE,GSW,115,,,13,12,7,7
Georges Niang,F,22023,1627777,22300001,"NOV 03, 2023",CLE @ IND,L,27,4,9,0.444,2,6,0.333,2,2,1.0,0,5,5,1,0,0,0,2,12,9,1,CLE,IND,CLE,116,,,18,17,13,6
Georges Niang,F,22023,1627777,22300112,"OCT 31, 2023",CLE vs. NYK,L,24,4,12,0.333,3,9,0.333,0,0,0.0,0,3,3,1,0,0,2,3,11,-12,1,CLE,CLE,NYK,91,,,15,14,12,4
Georges Niang,F,22023,1627777,22300091,"OCT 28, 2023",CLE vs. IND,L,19,3,10,0.3,1,4,0.25,0,0,0.0,1,2,3,2,0,1,1,3,7,-16,1,CLE,CLE,IND,113,,,12,10,9,5
Georges Niang,F,22023,1627777,22300067,"OCT 25, 2023",CLE @ BKN,W,20,0,3,0.0,0,3,0.0,0,0,0.0,2,2,4,0,0,0,0,3,0,-9,1,CLE,BKN,CLE,114,,,4,4,0,4
Georges Niang,F,22023,1627777,22300081,"OCT 27, 2023",CLE vs. OKC,L,21,1,6,0.167,0,5,0.0,0,0,0.0,0,2,2,1,0,0,0,2,2,0,1,CLE,CLE,OKC,105,,,5,4,3,3
Georges Niang,F,22023,1627777,22300120,"NOV 01, 2023",CLE @ NYK,W,28,1,6,0.167,1,3,0.333,2,2,1.0,0,10,10,2,1,0,0,4,5,7,1,CLE,NYK,CLE,95,,,17,15,7,12
Andrew Nembhard,G-F,22023,1629614,22300550,"JAN 14, 2024",IND @ DEN,L,29,4,8,0.5,0,1,0.0,4,6,0.667,1,1,2,7,0,0,2,0,12,-16,1,IND,DEN,IND,109,,,21,14,19,9
Andrew Nembhard,G-F,22023,1629614,22300533,"JAN 12, 2024",IND @ ATL,W,23,4,6,0.667,2,2,1.0,0,0,0.0,0,4,4,6,2,0,4,2,10,4,1,IND,ATL,IND,126,,,20,14,16,10
Andrew Nembhard,G-F,22023,1629614,22300520,"JAN 10, 2024",IND vs. WAS,W,26,1,8,0.125,0,1,0.0,0,0,0.0,2,0,2,5,2,0,5,3,2,1,1,IND,IND,WAS,112,,,9,4,7,7
Andrew Nembhard,G-F,22023,1629614,22300507,"JAN 08, 2024",IND vs. BOS,W,12,4,6,0.667,1,2,0.5,0,0,0.0,0,0,0,3,0,0,2,5,9,-8,1,IND,IND,BOS,133,,,12,9,12,3
Andrew Nembhard,G-F,22023,1629614,22300377,"DEC 21, 2023",IND @ MEM,L,16,2,4,0.5,2,3,0.667,0,0,0.0,0,1,1,1,2,0,1,2,6,-10,1,IND,MEM,IND,103,,,8,7,7,2
Andrew Nembhard,G-F,22023,1629614,22301229,"DEC 07, 2023",IND @ MIL,W,14,4,5,0.8,0,0,0.0,0,0,0.0,0,0,0,2,1,1,0,0,8,6,1,IND,MIL,IND,128,,,10,8,10,2
Andrew Nembhard,G-F,22023,1629614,22301202,"DEC 04, 2023",IND vs. BOS,W,5,0,2,0.0,0,0,0.0,1,2,0.5,0,1,1,1,0,0,0,1,1,-7,1,IND,IND,BOS,122,,,3,2,2,2
Andrew Nembhard,G-F,22023,1629614,22300284,"DEC 02, 2023",IND @ MIA,W,23,1,9,0.111,0,4,0.0,2,2,1.0,0,1,1,11,1,0,0,1,4,10,1,IND,MIA,IND,144,,,16,5,15,12
Andrew Nembhard,G-F,22023,1629614,22300267,"NOV 30, 2023",IND @ MIA,L,22,1,4,0.25,0,1,0.0,0,0,0.0,0,1,1,5,2,0,2,6,2,0,1,IND,MIA,IND,132,,,8,3,7,6
Andrew Nembhard,G-F,22023,1629614,22300254,"NOV 27, 2023",IND vs. POR,L,21,4,6,0.667,0,1,0.0,0,0,0.0,2,1,3,3,1,0,2,3,8,-4,1,IND,IND,POR,110,,,14,11,11,6
Andrew Nembhard,G-F,22023,1629614,22300047,"NOV 24, 2023",IND vs. DET,W,20,6,13,0.462,1,3,0.333,0,1,0.0,3,0,3,4,1,0,2,1,13,25,1,IND,IND,DET,136,,,20,16,17,7
Andrew Nembhard,G-F,22023,1629614,22300019,"NOV 14, 2023",IND @ PHI,W,10,1,3,0.333,0,1,0.0,0,0,0.0,1,1,2,4,1,0,0,1,2,-8,1,IND,PHI,IND,132,,,8,4,6,6
Andrew Nembhard,G-F,22023,1629614,22300180,"NOV 12, 2023",IND @ PHI,L,14,2,4,0.5,0,2,0.0,0,0,0.0,0,0,0,1,0,0,3,0,4,-15,1,IND,PHI,IND,126,,,5,4,5,1
Andrew Nembhard,G-F,22023,1629614,22300171,"NOV 09, 2023",IND vs. MIL,W,20,4,5,0.8,2,2,1.0,0,0,0.0,0,2,2,2,1,0,1,3,10,2,1,IND,IND,MIL,126,,,14,12,12,4
Andrew Nembhard,G-F,22023,1629614,22300158,"NOV 08, 2023",IND vs. UTA,W,19,4,4,1.0,1,1,1.0,0,0,0.0,1,3,4,7,1,0,0,2,9,16,1,IND,IND,UTA,134,,,20,13,16,11
Andrew Nembhard,G-F,22023,1629614,22300146,"NOV 06, 2023",IND vs. SAS,W,16,3,7,0.429,3,5,0.6,0,0,0.0,0,2,2,8,0,0,2,3,9,11,1,IND,IND,SAS,152,,,19,11,17,10
Andrew Nembhard,G-F,22023,1629614,22300133,"NOV 04, 2023",IND vs. CHA,L,18,3,9,0.333,1,3,0.333,0,0,0.0,1,0,1,2,2,0,0,0,7,-7,1,IND,IND,CHA,124,,,10,8,9,3
Andrew Nembhard,G-F,22023,1629614,22300001,"NOV 03, 2023",IND vs. CLE,W,18,2,5,0.4,0,0,0.0,2,2,1.0,0,0,0,3,0,0,2,0,6,-7,1,IND,IND,CLE,121,,,9,6,9,3
Andrew Nembhard,G-F,22023,1629614,22300118,"NOV 01, 2023",IND @ BOS,L,20,6,17,0.353,1,7,0.143,1,2,0.5,0,2,2,1,0,0,1,0,14,-22,1,IND,BOS,IND,104,,,17,16,15,3
Andrew Nembhard,G-F,22023,1629614,22300102,"OCT 30, 2023",IND vs. CHI,L,21,3,7,0.429,0,4,0.0,0,0,0.0,0,1,1,2,2,0,4,4,6,-2,1,IND,IND,CHI,105,,,9,7,8,3
Andrew Nembhard,G-F,22023,1629614,22300091,"OCT 28, 2023",IND @ CLE,W,25,2,5,0.4,0,2,0.0,0,0,0.0,0,2,2,4,2,0,1,4,4,21,1,IND,CLE,IND,125,,,10,6,8,6
Andrew Nembhard,G-F,22023,1629614,22300064,"OCT 25, 2023",IND vs. WAS,W,22,6,9,0.667,0,1,0.0,0,0,0.0,1,3,4,10,0,0,2,4,12,12,1,IND,IND,WAS,143,,,26,16,22,14
Andrew Nembhard,G-F,22023,1629614,22300707,"FEB 04, 2024",IND @ CHA,W,27,0,4,0.0,0,4,0.0,0,0,0.0,0,2,2,3,1,0,1,1,0,19,1,IND,CHA,IND,115,,,5,2,3,5
Andrew Nembhard,G-F,22023,1629614,22300627,"JAN 25, 2024",IND vs. PHI,W,29,8,15,0.533,1,3,0.333,2,2,1.0,0,2,2,8,1,1,6,3,19,18,1,IND,IND,PHI,134,,,29,21,27,10
Andrew Nembhard,G-F,22023,1629614,22300564,"JAN 15, 2024",IND @ UTA,L,23,5,10,0.5,1,3,0.333,3,3,1.0,0,0,0,4,1,0,2,2,14,-20,1,IND,UTA,IND,105,,,18,14,18,4
Andrew Nembhard,G-F,22023,1629614,22300755,"FEB 10, 2024",IND @ NYK,W,34,3,6,0.5,1,1,1.0,0,0,0.0,1,0,1,4,0,0,0,3,7,14,1,IND,NYK,IND,125,,,12,8,11,5
Andrew Nembhard,G-F,22023,1629614,22300733,"FEB 08, 2024",IND vs. GSW,L,25,4,8,0.5,2,4,0.5,0,0,0.0,0,1,1,3,1,1,2,1,10,-9,1,IND,IND,GSW,109,,,14,11,13,4
Andrew Nembhard,G-F,22023,1629614,22300719,"FEB 06, 2024",IND vs. HOU,W,31,4,5,0.8,1,1,1.0,0,0,0.0,1,1,2,5,1,0,1,1,9,-2,1,IND,IND,HOU,132,,,16,11,14,7
Andrew Nembhard,G-F,22023,1629614,22300691,"FEB 02, 2024",IND vs. SAC,L,0,0,0,0.0,0,0,0.0,0,0,0.0,0,0,0,0,0,0,0,0,0,-2,1,IND,IND,SAC,122,,,0,0,0,0
Andrew Nembhard,G-F,22023,1629614,22300685,"FEB 01, 2024",IND @ NYK,L,26,4,12,0.333,1,3,0.333,1,2,0.5,0,3,3,6,0,0,0,2,10,-9,1,IND,NYK,IND,105,,,19,13,16,9
Andrew Nembhard,G-F,22023,1629614,22300670,"JAN 30, 2024",IND @ BOS,L,28,6,13,0.462,1,5,0.2,2,2,1.0,1,3,4,5,0,0,0,2,15,-3,1,IND,BOS,IND,124,,,24,19,20,9
Andrew Nembhard,G-F,22023,1629614,22300454,"JAN 01, 2024",IND @ MIL,W,8,1,2,0.5,0,0,0.0,0,0,0.0,0,0,0,0,0,0,2,0,2,-21,1,IND,MIL,IND,122,,,2,2,2,0
Andrew Nembhard,G-F,22023,1629614,22300441,"DEC 30, 2023",IND vs. NYK,W,33,5,10,0.5,2,4,0.5,2,2,1.0,3,2,5,5,2,0,4,4,14,20,1,IND,IND,NYK,140,,,24,19,19,10
Andrew Nembhard,G-F,22023,1629614,22300422,"DEC 28, 2023",IND @ CHI,W,24,4,13,0.308,0,3,0.0,0,0,0.0,1,2,3,4,1,0,1,3,8,-19,1,IND,CHI,IND,120,,,15,11,12,7
Andrew Nembhard,G-F,22023,1629614,22300409,"DEC 26, 2023",IND @ HOU,W,34,5,6,0.833,1,1,1.0,0,0,0.0,0,2,2,6,0,0,6,1,11,10,1,IND,HOU,IND,123,,,19,13,17,8
Andrew Nembhard,G-F,22023,1629614,22300391,"DEC 23, 2023",IND vs. ORL,L,36,8,10,0.8,1,1,1.0,0,0,0.0,1,0,1,5,0,0,1,2,17,14,1,IND,IND,ORL,110,,,23,18,22,6
Andrew Nembhard,G-F,22023,1629614,22300652,"JAN 28, 2024",IND vs. MEM,W,37,5,14,0.357,2,5,0.4,4,4,1.0,2,2,4,9,1,0,1,3,16,5,1,IND,IND,MEM,116,,,29,20,25,13
Andrew Nembhard,G-F,22023,1629614,22300636,"JAN 26, 2024",IND vs. PHX,W,30,10,16,0.625,1,2,0.5,1,1,1.0,1,0,1,8,1,0,1,1,22,7,1,IND,IND,PHX,133,,,31,23,30,9
Andrew Nembhard,G-F,22023,1629614,22300614,"JAN 23, 2024",IND vs. DEN,L,27,7,9,0.778,1,3,0.333,0,0,0.0,0,1,1,7,0,0,2,1,15,-15,1,IND,IND,DEN,109,,,23,16,22,8
Andrew Nembhard,G-F,22023,1629614,22300604,"JAN 21, 2024",IND @ PHX,L,25,3,9,0.333,0,0,0.0,3,4,0.75,0,0,0,6,1,0,4,3,9,2,1,IND,PHX,IND,110,,,15,9,15,6
Ayo Dosunmu,G,22023,1630245,22300737,"FEB 08, 2024",CHI @ MEM,W,27,4,5,0.8,2,2,1.0,0,0,0.0,0,0,0,2,0,0,2,2,10,-1,1,CHI,MEM,CHI,118,,,12,10,12,2
Ayo Dosunmu,G,22023,1630245,22300723,"FEB 06, 2024",CHI vs. MIN,W,29,3,6,0.5,0,1,0.0,0,1,0.0,0,1,1,3,1,2,2,3,6,-9,1,CHI,CHI,MIN,129,,,10,7,9,4
Ayo Dosunmu,G,22023,1630245,22300700,"FEB 03, 2024",CHI vs. SAC,L,39,7,16,0.438,3,9,0.333,1,2,0.5,1,3,4,5,2,0,2,3,18,-15,1,CHI,CHI,SAC,115,,,27,22,23,9
Ayo Dosunmu,G,22023,1630245,22300674,"JAN 31, 2024",CHI @ CHA,W,39,7,10,0.7,2,5,0.4,0,0,0.0,0,1,1,6,3,1,1,3,16,18,1,CHI,CHA,CHI,117,,,23,17,22,7
Ayo Dosunmu,G,22023,1630245,22300672,"JAN 30, 2024",CHI vs. TOR,L,39,8,11,0.727,4,5,0.8,1,2,0.5,1,4,5,2,0,1,4,4,21,-10,1,CHI,CHI,TOR,107,,,28,26,23,7
Ayo Dosunmu,G,22023,1630245,22300656,"JAN 28, 2024",CHI @ POR,W,33,5,12,0.417,1,4,0.25,0,0,0.0,0,5,5,3,0,3,1,1,11,1,1,CHI,POR,CHI,104,,,19,16,14,8
Ayo Dosunmu,G,22023,1630245,22300633,"JAN 25, 2024",CHI @ LAL,L,30,6,11,0.545,2,5,0.4,4,4,1.0,1,1,2,1,2,1,2,2,18,-11,1,CHI,LAL,CHI,132,,,21,20,19,3
Ayo Dosunmu,G,22023,1630245,22300612,"JAN 22, 2024",CHI @ PHX,L,30,6,11,0.545,0,2,0.0,1,2,0.5,1,0,1,0,2,1,1,2,13,-10,1,CHI,PHX,CHI,113,,,14,14,13,1
Ayo Dosunmu,G,22023,1630245,22300597,"JAN 20, 2024",CHI vs. MEM,W,28,7,10,0.7,3,5,0.6,3,3,1.0,0,6,6,4,1,1,3,1,20,28,1,CHI,CHI,MEM,125,,,30,26,24,10
Ayo Dosunmu,G,22023,1630245,22300580,"JAN 18, 2024",CHI @ TOR,W,32,4,9,0.444,0,1,0.0,2,2,1.0,0,1,1,5,0,1,0,2,10,10,1,CHI,TOR,CHI,116,,,16,11,15,6
Ayo Dosunmu,G,22023,1630245,22300561,"JAN 15, 2024",CHI @ CLE,L,19,3,7,0.429,1,2,0.5,3,3,1.0,1,2,3,3,0,0,0,3,10,6,1,CHI,CLE,CHI,91,,,16,13,13,6
Ayo Dosunmu,G,22023,1630245,22300548,"JAN 13, 2024",CHI @ SAS,W,29,8,9,0.889,3,3,1.0,2,2,1.0,0,2,2,4,1,0,2,4,21,7,1,CHI,SAS,CHI,122,,,27,23,25,6
Ayo Dosunmu,G,22023,1630245,22300506,"JAN 08, 2024",CHI @ CHA,W,18,2,3,0.667,0,0,0.0,2,2,1.0,1,0,1,2,0,1,1,3,6,-3,1,CHI,CHA,CHI,119,,,9,7,8,3
Ayo Dosunmu,G,22023,1630245,22300484,"JAN 05, 2024",CHI vs. CHA,W,40,5,9,0.556,2,3,0.667,0,0,0.0,0,5,5,4,1,2,0,2,12,14,1,CHI,CHI,CHA,104,,,21,17,16,9
Ayo Dosunmu,G,22023,1630245,22300468,"JAN 03, 2024",CHI @ NYK,L,31,2,12,0.167,1,6,0.167,2,2,1.0,0,4,4,4,0,2,0,1,7,-11,1,CHI,NYK,CHI,100,,,15,11,11,8
Ayo Dosunmu,G,22023,1630245,22300459,"JAN 02, 2024",CHI @ PHI,L,32,7,14,0.5,1,4,0.25,0,0,0.0,0,3,3,0,1,0,3,2,15,-19,1,CHI,PHI,CHI,97,,,18,18,15,3
Ayo Dosunmu,G,22023,1630245,22300442,"DEC 30, 2023",CHI vs. PHI,W,29,3,11,0.273,0,4,0.0,0,0,0.0,2,1,3,2,0,1,0,2,6,0,1,CHI,CHI,PHI,105,,,11,9,8,5
Ayo Dosunmu,G,22023,1630245,22300422,"DEC 28, 2023",CHI vs. IND,L,33,7,15,0.467,0,2,0.0,1,2,0.5,1,4,5,3,0,0,0,3,15,-9,1,CHI,CHI,IND,104,,,23,20,18,8
Ayo Dosunmu,G,22023,1630245,22300408,"DEC 26, 2023",CHI vs. ATL,W,35,6,14,0.429,2,4,0.5,5,6,0.833,4,3,7,4,3,0,0,1,19,11,1,CHI,CHI,ATL,118,,,30,26,23,11
Ayo Dosunmu,G,22023,1630245,22300396,"DEC 23, 2023",CHI vs. CLE,L,20,2,6,0.333,0,3,0.0,0,0,0.0,1,2,3,1,0,0,1,3,4,-8,1,CHI,CHI,CLE,95,,,8,7,5,4
Ayo Dosunmu,G,22023,1630245,22300376,"DEC 21, 2023",CHI vs. SAS,W,26,5,8,0.625,1,4,0.25,0,0,0.0,0,2,2,0,1,0,0,2,11,13,1,CHI,CHI,SAS,114,,,13,13,11,2
Ayo Dosunmu,G,22023,1630245,22300370,"DEC 20, 2023",CHI vs. LAL,W,22,5,8,0.625,4,6,0.667,0,0,0.0,1,1,2,1,2,2,1,1,14,0,1,CHI,CHI,LAL,124,,,17,16,15,3
Ayo Dosunmu,G,22023,1630245,22300351,"DEC 18, 2023",CHI @ PHI,W,19,1,3,0.333,0,1,0.0,2,2,1.0,3,1,4,1,1,1,2,1,4,-23,1,CHI,PHI,CHI,108,,,9,8,5,5
Ayo Dosunmu,G,22023,1630245,22300337,"DEC 16, 2023",CHI @ MIA,L,41,3,11,0.273,2,7,0.286,0,0,0.0,1,3,4,3,2,1,2,4,8,6,1,CHI,MIA,CHI,116,,,15,12,11,7
Ayo Dosunmu,G,22023,1630245,22300320,"DEC 14, 2023",CHI @ MIA,W,35,10,12,0.833,3,4,0.75,1,4,0.25,2,6,8,5,1,0,0,3,24,-1,1,CHI,MIA,CHI,124,,,37,32,29,13
Ayo Dosunmu,G,22023,1630245,22300307,"DEC 12, 2023",CHI vs. DEN,L,38,3,7,0.429,1,4,0.25,2,2,1.0,0,3,3,3,0,1,2,4,9,-6,1,CHI,CHI,DEN,106,,,15,12,12,6
Ayo Dosunmu,G,22023,1630245,22300300,"DEC 11, 2023",CHI @ MIL,L,26,0,6,0.0,0,2,0.0,0,0,0.0,0,0,0,0,0,0,0,1,0,2,1,CHI,MIL,CHI,129,,,0,0,0,0
Ayo Dosunmu,G,22023,1630245,22301223,"DEC 08, 2023",CHI @ SAS,W,26,2,5,0.4,0,2,0.0,0,0,0.0,0,3,3,3,1,0,0,1,4,-2,1,CHI,SAS,CHI,121,,,10,7,7,6
Ayo Dosunmu,G,22023,1630245,22301211,"DEC 06, 2023",CHI vs. CHA,W,22,3,9,0.333,2,4,0.5,0,0,0.0,0,2,2,2,1,0,4,2,8,11,1,CHI,CHI,CHA,111,,,12,10,10,4
Ayo Dosunmu,G,22023,1630245,22300285,"DEC 02, 2023",CHI vs. NOP,W,33,6,9,0.667,1,4,0.25,2,2,1.0,0,0,0,3,2,0,2,2,15,8,1,CHI,CHI,NOP,124,,,18,15,18,3
Ayo Dosunmu,G,22023,1630245,22300269,"NOV 30, 2023",CHI vs. MIL,W,39,6,8,0.75,1,3,0.333,1,2,0.5,1,5,6,6,3,0,2,2,14,-8,1,CHI,CHI,MIL,120,,,26,20,20,12
Ayo Dosunmu,G,22023,1630245,22300053,"NOV 28, 2023",CHI @ BOS,L,24,4,10,0.4,1,3,0.333,1,2,0.5,0,0,0,2,1,0,0,3,10,-16,1,CHI,BOS,CHI,97,,,12,10,12,2
Ayo Dosunmu,G,22023,1630245,22300250,"NOV 26, 2023",CHI @ BKN,L,14,2,3,0.667,0,1,0.0,1,2,0.5,1,1,2,2,0,0,1,2,5,-21,1,CHI,BKN,CHI,109,,,9,7,7,4
Ayo Dosunmu,G,22023,1630245,22300046,"NOV 24, 2023",CHI @ TOR,L,13,1,4,0.25,0,2,0.0,0,0,0.0,0,1,1,1,1,0,0,1,2,-5,1,CHI,TOR,CHI,108,,,4,3,3,2
Ayo Dosunmu,G,22023,1630245,22300234,"NOV 22, 2023",CHI @ OKC,L,21,4,7,0.571,3,5,0.6,0,0,0.0,0,2,2,2,1,1,2,4,11,-9,1,CHI,OKC,CHI,102,,,15,13,13,4
Ayo Dosunmu,G,22023,1630245,22300220,"NOV 20, 2023",CHI vs. MIA,L,12,1,3,0.333,0,1,0.0,4,4,1.0,1,1,2,1,0,0,0,2,6,2,1,CHI,CHI,MIA,100,,,9,8,7,3
Ayo Dosunmu,G,22023,1630245,22300204,"NOV 18, 2023",CHI vs. MIA,W,13,0,2,0.0,0,2,0.0,2,2,1.0,0,1,1,2,0,0,1,2,2,16,1,CHI,CHI,MIA,102,,,5,3,4,3
Ayo Dosunmu,G,22023,1630245,22300033,"NOV 17, 2023",CHI vs. ORL,L,14,0,3,0.0,0,1,0.0,0,0,0.0,0,2,2,1,0,0,0,1,0,-12,1,CHI,CHI,ORL,97,,,3,2,1,3
Ayo Dosunmu,G,22023,1630245,22300196,"NOV 15, 2023",CHI vs. ORL,L,18,2,4,0.5,1,3,0.333,0,0,0.0,1,1,2,2,0,0,1,1,5,-6,1,CHI,CHI,ORL,94,,,9,7,7,4
Ayo Dosunmu,G,22023,1630245,22300190,"NOV 13, 2023",CHI @ MIL,L,26,2,4,0.5,1,2,0.5,0,0,0.0,1,1,2,1,0,0,1,4,5,-13,1,CHI,MIL,CHI,109,,,8,7,6,3
Ayo Dosunmu,G,22023,1630245,22300181,"NOV 12, 2023",CHI vs. DET,W,27,6,7,0.857,0,1,0.0,1,2,0.5,0,1,1,3,3,0,0,3,13,19,1,CHI,CHI,DET,119,,,17,14,16,4
Ayo Dosunmu,G,22023,1630245,22300162,"NOV 08, 2023",CHI vs. PHX,L,10,1,2,0.5,0,0,0.0,0,0,0.0,2,1,3,1,0,0,1,0,2,-4,1,CHI,CHI,PHX,115,,,6,5,3,4
Ayo Dosunmu,G,22023,1630245,22300152,"NOV 06, 2023",CHI vs. UTA,W,16,2,5,0.4,2,3,0.667,2,2,1.0,0,1,1,0,0,0,1,0,8,6,1,CHI,CHI,UTA,130,,,9,9,8,1
Ayo Dosunmu,G,22023,1630245,22300124,"NOV 01, 2023",CHI @ DAL,L,11,3,4,0.75,2,3,0.667,0,0,0.0,0,1,1,1,0,0,0,1,8,8,1,CHI,DAL,CHI,105,,,10,9,9,2
Ayo Dosunmu,G,22023,1630245,22300102,"OCT 30, 2023",CHI @ IND,W,10,0,1,0.0,0,1,0.0,0,0,0.0,0,1,1,0,1,1,0,2,0,-2,1,CHI,IND,CHI,112,,,1,1,0,1
Ayo Dosunmu,G,22023,1630245,22300088,"OCT 28, 2023",CHI @ DET,L,15,2,7,0.286,1,2,0.5,0,0,0.0,2,1,3,3,0,0,0,0,5,-6,1,CHI,DET,CHI,102,,,11,8,8,6
Ayo Dosunmu,G,22023,1630245,22300082,"OCT 27, 2023",CHI vs. TOR,W,11,2,4,0.5,0,1,0.0,0,0,0.0,0,1,1,0,0,0,0,0,4,10,1,CHI,CHI,TOR,104,,,5,5,4,1
Ayo Dosunmu,G,22023,1630245,22300070,"OCT 25, 2023",CHI vs. OKC,L,9,3,5,0.6,2,4,0.5,0,0,0.0,0,0,0,1,1,0,1,0,8,3,1,CHI,CHI,OKC,104,,,9,8,9,1
Ayo Dosunmu,G,22023,1630245,22300752,"FEB 10, 2024",CHI @ ORL,L,39,7,12,0.583,5,8,0.625,0,0,0.0,0,2,2,2,1,0,1,5,19,1,1,CHI,ORL,CHI,108,,,23,21,21,4
Ayo Dosunmu,G,22023,1630245,22300536,"JAN 12, 2024",CHI vs. GSW,L,17,2,4,0.5,2,3,0.667,0,0,0.0,0,0,0,0,0,0,3,4,6,-23,1,CHI,CHI,GSW,131,,,6,6,6,0
Ayo Dosunmu,G,22023,1630245,22300523,"JAN 10, 2024",CHI vs. HOU,W,18,3,8,0.375,2,4,0.5,0,0,0.0,2,2,4,3,0,0,0,0,8,-5,1,CHI,CHI,HOU,124,,,15,12,11,7
Draymond Green,F,22023,203110,22300757,"FEB 10, 2024",GSW vs. PHX,W,29,7,9,0.778,1,3,0.333,0,0,0.0,2,5,7,9,0,0,4,4,15,3,1,GSW,GSW,PHX,113,,,31,22,24,16
Draymond Green,F,22023,203110,22300733,"FEB 08, 2024",GSW @ IND,W,28,4,8,0.5,0,1,0.0,0,0,0.0,2,6,8,5,2,0,5,3,8,13,1,GSW,IND,GSW,131,,,21,16,13,13
Draymond Green,F,22023,203110,22300727,"FEB 07, 2024",GSW @ PHI,W,18,2,4,0.5,0,1,0.0,0,1,0.0,1,5,6,3,1,1,2,3,4,14,1,GSW,PHI,GSW,127,,,13,10,7,9
Draymond Green,F,22023,203110,22300717,"FEB 05, 2024",GSW @ BKN,W,30,4,6,0.667,0,0,0.0,0,0,0.0,2,8,10,7,0,2,3,2,8,11,1,GSW,BKN,GSW,109,,,25,18,15,17
Draymond Green,F,22023,203110,22300699,"FEB 03, 2024",GSW @ ATL,L,35,3,9,0.333,1,3,0.333,0,0,0.0,1,5,6,8,0,1,3,2,7,-7,1,GSW,ATL,GSW,134,,,21,13,15,14
Draymond Green,F,22023,203110,22300693,"FEB 02, 2024",GSW @ MEM,W,28,4,7,0.571,1,2,0.5,0,0,0.0,2,10,12,6,0,3,4,4,9,10,1,GSW,MEM,GSW,121,,,27,21,15,18
Draymond Green,F,22023,203110,22300673,"JAN 30, 2024",GSW vs. PHI,W,29,3,8,0.375,2,4,0.5,1,1,1.0,1,5,6,6,0,1,2,3,9,18,1,GSW,GSW,PHI,119,,,21,15,15,12
Draymond Green,F,22023,203110,22300650,"JAN 27, 2024",GSW vs. LAL,L,46,4,9,0.444,0,4,0.0,0,0,0.0,0,14,14,11,3,2,2,5,8,31,1,GSW,GSW,LAL,144,,,33,22,19,25
Draymond Green,F,22023,203110,22300632,"JAN 25, 2024",GSW vs. SAC,L,31,0,3,0.0,0,1,0.0,5,8,0.625,0,4,4,11,3,1,2,3,5,14,1,GSW,GSW,SAC,133,,,20,9,16,15
Draymond Green,F,22023,203110,22300626,"JAN 24, 2024",GSW vs. ATL,W,23,5,6,0.833,2,3,0.667,0,0,0.0,1,4,5,3,2,1,2,3,12,19,1,GSW,GSW,ATL,134,,,20,17,15,8
Draymond Green,F,22023,203110,22300560,"JAN 15, 2024",GSW @ MEM,L,24,2,4,0.5,1,1,1.0,2,2,1.0,0,7,7,4,1,0,3,4,7,1,1,GSW,MEM,GSW,107,,,18,14,11,11
Draymond Green,F,22023,203110,22300308,"DEC 12, 2023",GSW @ PHX,L,17,1,3,0.333,0,2,0.0,0,0,0.0,0,2,2,2,0,0,3,3,2,-15,1,GSW,PHX,GSW,116,,,6,4,4,4
Draymond Green,F,22023,203110,22301222,"DEC 08, 2023",GSW @ OKC,L,35,5,7,0.714,1,2,0.5,1,2,0.5,1,4,5,13,0,1,4,6,12,-2,1,GSW,OKC,GSW,136,,,30,17,25,18
Draymond Green,F,22023,203110,22301214,"DEC 06, 2023",GSW vs. POR,W,31,3,7,0.429,0,2,0.0,4,4,1.0,6,4,10,9,0,2,4,3,10,-1,1,GSW,GSW,POR,110,,,29,20,19,19
Draymond Green,F,22023,203110,22300280,"DEC 02, 2023",GSW @ LAC,L,32,8,15,0.533,4,8,0.5,1,2,0.5,1,8,9,4,0,1,3,2,21,-6,1,GSW,LAC,GSW,112,,,34,30,25,13
Draymond Green,F,22023,203110,22300273,"NOV 30, 2023",GSW vs. LAC,W,29,4,8,0.5,2,4,0.5,3,4,0.75,1,4,5,5,0,0,2,5,13,-11,1,GSW,GSW,LAC,120,,,23,18,18,10
Draymond Green,F,22023,203110,22300060,"NOV 28, 2023",GSW @ SAC,L,33,3,8,0.375,2,4,0.5,0,0,0.0,0,6,6,3,0,2,4,4,8,5,1,GSW,SAC,GSW,123,,,17,14,11,9
Draymond Green,F,22023,203110,22300186,"NOV 12, 2023",GSW vs. MIN,L,24,3,7,0.429,1,3,0.333,2,2,1.0,2,7,9,7,1,0,2,5,9,-11,1,GSW,GSW,MIN,110,,,25,18,16,16
Draymond Green,F,22023,203110,22300176,"NOV 11, 2023",GSW vs. CLE,L,18,3,4,0.75,2,3,0.667,0,0,0.0,2,3,5,4,0,0,1,3,8,-1,1,GSW,GSW,CLE,110,,,17,13,12,9
Draymond Green,F,22023,203110,22300145,"NOV 06, 2023",GSW @ DET,W,28,2,4,0.5,0,1,0.0,2,2,1.0,3,6,9,8,0,0,1,2,6,1,1,GSW,DET,GSW,120,,,23,15,14,17
Draymond Green,F,22023,203110,22300142,"NOV 05, 2023",GSW @ CLE,L,29,5,11,0.455,2,3,0.667,6,6,1.0,0,3,3,8,3,1,1,0,18,-6,1,GSW,CLE,GSW,104,,,29,21,26,11
Draymond Green,F,22023,203110,22300005,"NOV 03, 2023",GSW @ OKC,W,29,5,11,0.455,2,4,0.5,3,3,1.0,2,3,5,3,0,1,3,5,15,-1,1,GSW,OKC,GSW,141,,,23,20,18,8
Draymond Green,F,22023,203110,22300126,"NOV 01, 2023",GSW vs. SAC,W,28,4,7,0.571,2,4,0.5,3,4,0.75,2,0,2,9,2,2,2,1,13,-5,1,GSW,GSW,SAC,102,,,24,15,22,11
Draymond Green,F,22023,203110,22300108,"OCT 30, 2023",GSW @ NOP,W,22,3,8,0.375,0,2,0.0,0,0,0.0,1,5,6,7,0,1,1,2,6,6,1,GSW,NOP,GSW,130,,,19,12,13,13
Draymond Green,F,22023,203110,22300096,"OCT 29, 2023",GSW @ HOU,W,21,2,4,0.5,0,0,0.0,0,1,0.0,1,4,5,5,0,0,4,3,4,2,1,GSW,HOU,GSW,106,,,14,9,9,10
Draymond Green,F,22023,203110,22300025,"NOV 14, 2023",GSW vs. MIN,L,2,0,0,0.0,0,0,0.0,0,0,0.0,0,2,2,0,0,0,1,1,0,-2,1,GSW,GSW,MIN,101,,,2,2,0,2
Matt Ryan,F,22023,1630346,22300758,"FEB 10, 2024",NOP @ POR,W,5,0,2,0.0,0,0,0.0,0,0,0.0,0,1,1,0,0,0,0,0,0,-6,1,NOP,POR,NOP,93,,,1,1,0,1
Matt Ryan,F,22023,1630346,22300203,"NOV 18, 2023",NOP vs. MIN,L,27,3,5,0.6,3,4,0.75,1,1,1.0,0,3,3,1,1,0,3,1,10,1,1,NOP,NOP,MIN,120,,,14,13,11,4
Matt Ryan,F,22023,1630346,22300034,"NOV 17, 2023",NOP vs. DEN,W,19,3,7,0.429,3,5,0.6,0,1,0.0,0,0,0,0,0,0,0,0,9,8,1,NOP,NOP,DEN,115,,,9,9,9,0
Matt Ryan,F,22023,1630346,22300022,"NOV 14, 2023",NOP vs. DAL,W,20,2,7,0.286,2,5,0.4,0,0,0.0,0,2,2,0,1,0,0,0,6,17,1,NOP,NOP,DAL,131,,,8,8,6,2
Matt Ryan,F,22023,1630346,22300183,"NOV 12, 2023",NOP vs. DAL,L,27,5,7,0.714,4,6,0.667,0,0,0.0,3,3,6,2,0,0,0,3,14,0,1,NOP,NOP,DAL,124,,,22,20,16,8
Matt Ryan,F,22023,1630346,22300011,"NOV 10, 2023",NOP @ HOU,L,16,0,1,0.0,0,1,0.0,0,0,0.0,0,2,2,0,1,0,1,2,0,-9,1,NOP,HOU,NOP,101,,,2,2,0,2
Matt Ryan,F,22023,1630346,22300166,"NOV 08, 2023",NOP @ MIN,L,26,2,5,0.4,2,4,0.5,6,6,1.0,0,4,4,1,0,0,5,4,12,-4,1,NOP,MIN,NOP,101,,,17,16,13,5
Matt Ryan,F,22023,1630346,22300156,"NOV 06, 2023",NOP @ DEN,L,25,5,8,0.625,4,6,0.667,3,3,1.0,0,0,0,1,0,0,0,3,17,-4,1,NOP,DEN,NOP,116,,,18,17,18,1
Matt Ryan,F,22023,1630346,22300135,"NOV 04, 2023",NOP vs. ATL,L,17,1,4,0.25,0,3,0.0,2,2,1.0,1,1,2,1,0,0,1,2,4,-5,1,NOP,NOP,ATL,105,,,7,6,5,3
Matt Ryan,F,22023,1630346,22300129,"NOV 02, 2023",NOP vs. DET,W,35,7,10,0.7,6,8,0.75,0,0,0.0,0,2,2,2,0,0,3,0,20,16,1,NOP,NOP,DET,125,,,24,22,22,4
Matt Ryan,F,22023,1630346,22300121,"NOV 01, 2023",NOP @ OKC,W,20,2,6,0.333,1,5,0.2,0,0,0.0,0,3,3,0,0,0,1,2,5,-3,1,NOP,OKC,NOP,110,,,8,8,5,3
Matt Ryan,F,22023,1630346,22300108,"OCT 30, 2023",NOP vs. GSW,L,27,4,9,0.444,3,7,0.429,1,1,1.0,1,1,2,2,1,0,2,2,12,-17,1,NOP,NOP,GSW,102,,,16,14,14,4
Matt Ryan,F,22023,1630346,22300090,"OCT 28, 2023",NOP vs. NYK,W,26,1,8,0.125,1,8,0.125,0,0,0.0,0,3,3,3,1,1,0,3,3,8,1,NOP,NOP,NYK,96,,,9,6,6,6
Matt Ryan,F,22023,1630346,22300071,"OCT 25, 2023",NOP @ MEM,W,14,3,6,0.5,3,6,0.5,0,0,0.0,0,1,1,1,0,0,0,2,9,20,1,NOP,MEM,NOP,111,,,11,10,10,2
Dante Exum,G,22023,203957,22300398,"DEC 23, 2023",DAL vs. SAS,W,32,8,10,0.8,2,2,1.0,2,2,1.0,2,5,7,4,0,1,3,1,20,18,1,DAL,DAL,SAS,144,,,31,27,24,11
Dante Exum,G,22023,203957,22300356,"DEC 18, 2023",DAL @ DEN,L,23,5,5,1.0,1,1,1.0,0,0,0.0,0,1,1,2,0,0,1,3,11,-14,1,DAL,DEN,DAL,104,,,14,12,13,3
Dante Exum,G,22023,203957,22300341,"DEC 16, 2023",DAL @ POR,W,27,8,11,0.727,1,2,0.5,1,1,1.0,0,2,2,3,1,0,2,3,18,14,1,DAL,POR,DAL,131,,,23,20,21,5
Dante Exum,G,22023,203957,22300321,"DEC 14, 2023",DAL vs. MIN,L,28,5,6,0.833,2,3,0.667,2,2,1.0,0,4,4,4,0,0,2,2,14,7,1,DAL,DAL,MIN,101,,,22,18,18,8
Dante Exum,G,22023,203957,22300423,"DEC 28, 2023",DAL @ MIN,L,24,5,11,0.455,1,1,1.0,0,0,0.0,0,2,2,6,0,0,4,4,11,-9,1,DAL,MIN,DAL,110,,,19,13,17,8
Dante Exum,G,22023,203957,22300420,"DEC 27, 2023",DAL vs. CLE,L,33,4,8,0.5,1,3,0.333,4,4,1.0,0,4,4,6,3,0,0,4,13,2,1,DAL,DAL,CLE,110,,,23,17,19,10
Dante Exum,G,22023,203957,22300405,"DEC 25, 2023",DAL @ PHX,W,33,3,7,0.429,1,4,0.25,0,0,0.0,1,3,4,5,1,0,3,3,7,14,1,DAL,PHX,DAL,128,,,16,11,12,9
Dante Exum,G,22023,203957,22300306,"DEC 12, 2023",DAL vs. LAL,W,36,8,10,0.8,7,9,0.778,3,4,0.75,2,2,4,3,1,1,1,2,26,7,1,DAL,DAL,LAL,127,,,33,30,29,7
Dante Exum,G,22023,203957,22300299,"DEC 11, 2023",DAL @ MEM,W,35,6,11,0.545,1,4,0.25,3,4,0.75,1,3,4,6,2,1,3,3,16,2,1,DAL,MEM,DAL,120,,,26,20,22,10
Dante Exum,G,22023,203957,22301226,"DEC 08, 2023",DAL @ POR,W,33,9,15,0.6,2,2,1.0,3,4,0.75,2,4,6,7,0,0,1,3,23,2,1,DAL,POR,DAL,125,,,36,29,30,13
Dante Exum,G,22023,203957,22301213,"DEC 06, 2023",DAL vs. UTA,W,26,2,9,0.222,1,5,0.2,0,0,0.0,0,6,6,7,2,0,0,1,5,40,1,DAL,DAL,UTA,147,,,18,11,12,13
Dante Exum,G,22023,203957,22300059,"NOV 28, 2023",DAL vs. HOU,W,15,3,4,0.75,1,2,0.5,5,8,0.625,1,0,1,3,1,0,2,0,12,2,1,DAL,DAL,HOU,121,,,16,13,15,4
Dante Exum,G,22023,203957,22300244,"NOV 25, 2023",DAL @ LAC,L,18,1,4,0.25,0,1,0.0,0,0,0.0,3,5,8,2,1,0,1,1,2,4,1,DAL,LAC,DAL,88,,,12,10,4,10
Dante Exum,G,22023,203957,22300238,"NOV 22, 2023",DAL @ LAL,W,9,2,5,0.4,0,2,0.0,0,0,0.0,0,0,0,0,0,0,0,2,4,7,1,DAL,LAL,DAL,104,,,4,4,4,0
Dante Exum,G,22023,203957,22300205,"NOV 18, 2023",DAL @ MIL,L,11,3,5,0.6,0,2,0.0,0,0,0.0,0,1,1,1,0,0,0,0,6,5,1,DAL,MIL,DAL,125,,,8,7,7,2
Dante Exum,G,22023,203957,22300192,"NOV 15, 2023",DAL @ WAS,W,19,2,6,0.333,0,1,0.0,1,2,0.5,0,7,7,3,0,0,0,3,5,0,1,DAL,WAS,DAL,130,,,15,12,8,10
Dante Exum,G,22023,203957,22300022,"NOV 14, 2023",DAL @ NOP,L,12,4,6,0.667,0,2,0.0,1,1,1.0,1,0,1,2,0,0,1,2,9,3,1,DAL,NOP,DAL,110,,,12,10,11,3
Dante Exum,G,22023,203957,22300183,"NOV 12, 2023",DAL @ NOP,W,13,3,6,0.5,0,0,0.0,0,0,0.0,0,1,1,1,1,1,0,2,6,6,1,DAL,NOP,DAL,136,,,8,7,7,2
Dante Exum,G,22023,203957,22300014,"NOV 10, 2023",DAL vs. LAC,W,18,3,7,0.429,2,3,0.667,0,0,0.0,1,1,2,6,0,0,0,3,8,7,1,DAL,DAL,LAC,144,,,16,10,14,8
Dante Exum,G,22023,203957,22300006,"NOV 03, 2023",DAL @ DEN,L,1,0,0,0.0,0,0,0.0,0,0,0.0,0,0,0,0,0,0,0,0,0,2,1,DAL,DEN,DAL,114,,,0,0,0,0
Dante Exum,G,22023,203957,22300124,"NOV 01, 2023",DAL vs. CHI,W,10,1,3,0.333,0,0,0.0,0,0,0.0,0,2,2,0,1,0,1,0,2,-5,1,DAL,DAL,CHI,114,,,4,4,2,2
Dante Exum,G,22023,203957,22300106,"OCT 30, 2023",DAL @ MEM,W,6,1,3,0.333,0,0,0.0,0,0,0.0,0,4,4,2,0,0,0,0,2,7,1,DAL,MEM,DAL,125,,,8,6,4,6
Dante Exum,G,22023,203957,22300084,"OCT 27, 2023",DAL vs. BKN,W,4,1,2,0.5,0,1,0.0,0,0,0.0,0,0,0,0,1,1,0,0,2,-1,1,DAL,DAL,BKN,125,,,2,2,2,0
Dante Exum,G,22023,203957,22300073,"OCT 25, 2023",DAL @ SAS,W,8,1,2,0.5,0,1,0.0,1,1,1.0,0,1,1,0,0,0,0,1,3,4,1,DAL,SAS,DAL,126,,,4,4,3,1
Dante Exum,G,22023,203957,22300634,"JAN 26, 2024",DAL @ ATL,W,27,3,6,0.5,2,2,1.0,1,2,0.5,0,0,0,3,0,0,1,2,9,2,1,DAL,ATL,DAL,148,,,12,9,12,3
Dante Exum,G,22023,203957,22300625,"JAN 24, 2024",DAL vs. PHX,L,19,2,4,0.5,1,1,1.0,1,2,0.5,0,2,2,2,0,0,0,1,6,-14,1,DAL,DAL,PHX,107,,,10,8,8,4
Dante Exum,G,22023,203957,22300457,"JAN 01, 2024",DAL @ UTA,L,12,2,3,0.667,0,0,0.0,0,0,0.0,1,0,1,3,0,0,0,0,4,-4,1,DAL,UTA,DAL,86,,,8,5,7,4
Dante Exum,G,22023,203957,22300444,"DEC 30, 2023",DAL @ GSW,W,34,8,12,0.667,3,5,0.6,0,0,0.0,0,0,0,5,1,0,1,1,19,16,1,DAL,GSW,DAL,132,,,24,19,24,5
Dante Exum,G,22023,203957,22300372,"DEC 20, 2023",DAL vs. LAC,L,40,6,12,0.5,1,4,0.25,3,4,0.75,1,5,6,1,2,0,0,2,16,-7,1,DAL,DAL,LAC,111,,,23,22,17,7
Dante Exum,G,22023,203957,22300212,"NOV 19, 2023",DAL vs. SAC,L,15,4,5,0.8,0,1,0.0,0,0,0.0,0,2,2,4,0,0,0,0,8,-3,1,DAL,DAL,SAC,113,,,14,10,12,6
Dante Exum,G,22023,203957,22300168,"NOV 08, 2023",DAL vs. TOR,L,8,2,3,0.667,0,0,0.0,1,3,0.333,2,3,5,0,0,0,0,1,5,2,1,DAL,DAL,TOR,116,,,10,10,5,5
Dante Exum,G,22023,203957,22300143,"NOV 05, 2023",DAL vs. CHA,W,3,1,2,0.5,1,1,1.0,0,0,0.0,0,1,1,0,0,0,0,1,3,-1,1,DAL,DAL,CHA,124,,,4,4,3,1
Onyeka Okongwu,F-C,22023,1630168,22300754,"FEB 10, 2024",ATL vs. HOU,W,32,4,10,0.4,0,1,0.0,3,7,0.429,3,4,7,1,0,3,1,5,11,2,1,ATL,ATL,HOU,122,,,19,18,12,8
Onyeka Okongwu,F-C,22023,1630168,22300742,"FEB 09, 2024",ATL @ PHI,W,34,9,12,0.75,1,2,0.5,2,2,1.0,2,6,8,2,1,2,1,3,21,8,1,ATL,PHI,ATL,127,,,31,29,23,10
Onyeka Okongwu,F-C,22023,1630168,22300729,"FEB 07, 2024",ATL @ BOS,L,36,7,11,0.636,1,3,0.333,4,4,1.0,6,4,10,3,0,2,1,3,19,4,1,ATL,BOS,ATL,117,,,32,29,22,13
Onyeka Okongwu,F-C,22023,1630168,22300716,"FEB 05, 2024",ATL vs. LAC,L,34,8,10,0.8,2,2,1.0,0,0,0.0,4,1,5,0,0,1,2,4,18,-7,1,ATL,ATL,LAC,144,,,23,23,18,5
Onyeka Okongwu,F-C,22023,1630168,22300690,"FEB 02, 2024",ATL vs. PHX,W,27,7,8,0.875,1,1,1.0,0,0,0.0,3,4,7,0,1,2,0,1,15,23,1,ATL,ATL,PHX,129,,,22,22,15,7
Onyeka Okongwu,F-C,22023,1630168,22300669,"JAN 30, 2024",ATL vs. LAL,W,26,4,4,1.0,1,1,1.0,2,2,1.0,1,3,4,1,2,1,0,1,11,9,1,ATL,ATL,LAL,138,,,16,15,12,5
Onyeka Okongwu,F-C,22023,1630168,22300653,"JAN 28, 2024",ATL vs. TOR,W,20,5,7,0.714,0,1,0.0,0,0,0.0,2,1,3,1,0,1,0,3,10,-18,1,ATL,ATL,TOR,126,,,14,13,11,4
Onyeka Okongwu,F-C,22023,1630168,22300634,"JAN 26, 2024",ATL vs. DAL,L,23,2,5,0.4,0,0,0.0,4,4,1.0,2,4,6,2,1,0,1,4,8,2,1,ATL,ATL,DAL,143,,,16,14,10,8
Onyeka Okongwu,F-C,22023,1630168,22300626,"JAN 24, 2024",ATL @ GSW,L,25,3,5,0.6,0,1,0.0,0,0,0.0,2,5,7,1,0,1,3,3,6,-17,1,ATL,GSW,ATL,112,,,14,13,7,8
Onyeka Okongwu,F-C,22023,1630168,22300613,"JAN 22, 2024",ATL @ SAC,L,29,4,6,0.667,0,1,0.0,0,1,0.0,3,6,9,3,0,2,2,6,8,-7,1,ATL,SAC,ATL,107,,,20,17,11,12
Onyeka Okongwu,F-C,22023,1630168,22300595,"JAN 20, 2024",ATL vs. CLE,L,23,0,3,0.0,0,0,0.0,1,2,0.5,2,4,6,2,0,0,0,3,1,-10,1,ATL,ATL,CLE,95,,,9,7,3,8
Onyeka Okongwu,F-C,22023,1630168,22300587,"JAN 19, 2024",ATL @ MIA,W,26,4,5,0.8,1,1,1.0,0,0,0.0,1,4,5,1,1,1,2,5,9,13,1,ATL,MIA,ATL,109,,,15,14,10,6
Onyeka Okongwu,F-C,22023,1630168,22300570,"JAN 17, 2024",ATL vs. ORL,W,27,7,12,0.583,0,1,0.0,1,1,1.0,3,6,9,0,0,1,2,3,15,7,1,ATL,ATL,ORL,106,,,24,24,15,9
Onyeka Okongwu,F-C,22023,1630168,22300559,"JAN 15, 2024",ATL vs. SAS,W,23,3,8,0.375,0,1,0.0,1,1,1.0,2,4,6,1,0,0,2,4,7,2,1,ATL,ATL,SAS,109,,,14,13,8,7
Onyeka Okongwu,F-C,22023,1630168,22300543,"JAN 13, 2024",ATL vs. WAS,L,19,3,5,0.6,0,0,0.0,3,5,0.6,6,4,10,1,0,3,2,4,9,-19,1,ATL,ATL,WAS,99,,,20,19,10,11
Onyeka Okongwu,F-C,22023,1630168,22300533,"JAN 12, 2024",ATL vs. IND,L,23,3,4,0.75,0,0,0.0,0,0,0.0,1,0,1,1,0,0,0,2,6,-19,1,ATL,ATL,IND,108,,,8,7,7,2
Onyeka Okongwu,F-C,22023,1630168,22300521,"JAN 10, 2024",ATL vs. PHI,W,36,7,10,0.7,0,0,0.0,5,5,1.0,6,5,11,1,0,2,2,5,19,-1,1,ATL,ATL,PHI,139,,,31,30,20,12
Onyeka Okongwu,F-C,22023,1630168,22300499,"JAN 07, 2024",ATL @ ORL,L,32,2,3,0.667,1,2,0.5,0,2,0.0,1,5,6,3,0,5,0,3,5,19,1,ATL,ORL,ATL,110,,,14,11,8,9
Onyeka Okongwu,F-C,22023,1630168,22300480,"JAN 05, 2024",ATL @ IND,L,21,1,1,1.0,0,0,0.0,1,2,0.5,4,2,6,1,0,1,0,1,3,-8,1,ATL,IND,ATL,116,,,10,9,4,7
Onyeka Okongwu,F-C,22023,1630168,22300467,"JAN 03, 2024",ATL vs. OKC,W,22,3,4,0.75,0,0,0.0,5,5,1.0,3,4,7,0,1,0,0,2,11,14,1,ATL,ATL,OKC,141,,,18,18,11,7
Onyeka Okongwu,F-C,22023,1630168,22300431,"DEC 29, 2023",ATL vs. SAC,L,23,3,6,0.5,0,0,0.0,1,2,0.5,1,2,3,1,1,1,0,2,7,-11,1,ATL,ATL,SAC,110,,,11,10,8,4
Onyeka Okongwu,F-C,22023,1630168,22300408,"DEC 26, 2023",ATL @ CHI,L,21,4,6,0.667,1,2,0.5,2,2,1.0,1,5,6,0,1,0,1,3,11,2,1,ATL,CHI,ATL,113,,,17,17,11,6
Onyeka Okongwu,F-C,22023,1630168,22300393,"DEC 23, 2023",ATL vs. MEM,L,28,5,10,0.5,0,2,0.0,0,0,0.0,4,3,7,4,2,2,3,4,10,-7,1,ATL,ATL,MEM,119,,,21,17,14,11
Onyeka Okongwu,F-C,22023,1630168,22300384,"DEC 22, 2023",ATL @ MIA,L,26,4,7,0.571,0,1,0.0,1,2,0.5,4,3,7,1,1,2,0,3,9,-10,1,ATL,MIA,ATL,113,,,17,16,10,8
Onyeka Okongwu,F-C,22023,1630168,22300371,"DEC 20, 2023",ATL @ HOU,W,33,8,11,0.727,0,1,0.0,3,4,0.75,1,10,11,2,0,0,0,1,19,12,1,ATL,HOU,ATL,134,,,32,30,21,13
Onyeka Okongwu,F-C,22023,1630168,22300352,"DEC 18, 2023",ATL vs. DET,W,23,5,6,0.833,0,0,0.0,4,4,1.0,0,2,2,1,0,1,2,2,14,0,1,ATL,ATL,DET,130,,,17,16,15,3
Onyeka Okongwu,F-C,22023,1630168,22300336,"DEC 16, 2023",ATL @ CLE,L,32,7,12,0.583,2,4,0.5,0,0,0.0,2,2,4,1,0,1,1,4,16,-15,1,ATL,CLE,ATL,119,,,21,20,17,5
Onyeka Okongwu,F-C,22023,1630168,22300330,"DEC 15, 2023",ATL @ TOR,W,33,6,7,0.857,1,2,0.5,1,1,1.0,4,7,11,0,0,1,1,3,14,14,1,ATL,TOR,ATL,125,,,25,25,14,11
Onyeka Okongwu,F-C,22023,1630168,22300313,"DEC 13, 2023",ATL @ TOR,L,30,5,9,0.556,3,5,0.6,0,0,0.0,2,6,8,1,0,2,0,0,13,5,1,ATL,TOR,ATL,128,,,22,21,14,9
Onyeka Okongwu,F-C,22023,1630168,22300296,"DEC 11, 2023",ATL vs. DEN,L,28,3,5,0.6,0,0,0.0,1,1,1.0,2,4,6,3,0,1,0,3,7,4,1,ATL,ATL,DEN,122,,,16,13,10,9
Onyeka Okongwu,F-C,22023,1630168,22301218,"DEC 08, 2023",ATL @ PHI,L,18,3,7,0.429,0,2,0.0,1,2,0.5,4,4,8,2,0,2,0,5,7,-1,1,ATL,PHI,ATL,114,,,17,15,9,10
Onyeka Okongwu,F-C,22023,1630168,22301209,"DEC 06, 2023",ATL vs. BKN,L,24,1,5,0.2,0,2,0.0,0,0,0.0,2,7,9,2,1,0,1,4,2,-8,1,ATL,ATL,BKN,113,,,13,11,4,11
Onyeka Okongwu,F-C,22023,1630168,22300286,"DEC 02, 2023",ATL @ MIL,L,27,2,4,0.5,0,2,0.0,1,3,0.333,1,3,4,3,0,0,0,3,5,-19,1,ATL,MIL,ATL,121,,,12,9,8,7
Onyeka Okongwu,F-C,22023,1630168,22300272,"NOV 30, 2023",ATL @ SAS,W,28,3,6,0.5,1,3,0.333,4,5,0.8,2,6,8,0,0,0,1,4,11,-4,1,ATL,SAS,ATL,137,,,19,19,11,8
Onyeka Okongwu,F-C,22023,1630168,22300055,"NOV 28, 2023",ATL @ CLE,L,22,4,8,0.5,1,1,1.0,4,5,0.8,2,7,9,2,0,0,0,0,13,1,1,ATL,CLE,ATL,105,,,24,22,15,11
Onyeka Okongwu,F-C,22023,1630168,22300246,"NOV 26, 2023",ATL @ BOS,L,27,2,2,1.0,0,0,0.0,0,0,0.0,0,3,3,0,2,1,0,2,4,-2,1,ATL,BOS,ATL,103,,,7,7,4,3
Onyeka Okongwu,F-C,22023,1630168,22300241,"NOV 25, 2023",ATL @ WAS,W,25,3,6,0.5,0,1,0.0,3,4,0.75,3,3,6,1,1,1,0,2,9,9,1,ATL,WAS,ATL,136,,,16,15,10,7
Onyeka Okongwu,F-C,22023,1630168,22300227,"NOV 22, 2023",ATL vs. BKN,W,25,6,10,0.6,0,2,0.0,0,0,0.0,4,6,10,0,0,1,0,1,12,16,1,ATL,ATL,BKN,147,,,22,22,12,10
Onyeka Okongwu,F-C,22023,1630168,22300039,"NOV 21, 2023",ATL vs. IND,L,22,3,7,0.429,0,2,0.0,1,1,1.0,4,2,6,4,0,1,1,2,7,6,1,ATL,ATL,IND,152,,,17,13,11,10
Onyeka Okongwu,F-C,22023,1630168,22300029,"NOV 17, 2023",ATL vs. PHI,L,19,2,6,0.333,1,2,0.5,0,0,0.0,2,3,5,0,0,0,1,3,5,-6,1,ATL,ATL,PHI,116,,,10,10,5,5
Onyeka Okongwu,F-C,22023,1630168,22300193,"NOV 15, 2023",ATL vs. NYK,L,22,2,4,0.5,0,0,0.0,4,4,1.0,2,4,6,1,1,1,4,4,8,18,1,ATL,ATL,NYK,114,,,15,14,9,7
Onyeka Okongwu,F-C,22023,1630168,22300018,"NOV 14, 2023",ATL @ DET,W,21,4,4,1.0,0,0,0.0,0,0,0.0,3,6,9,2,0,1,2,5,8,-2,1,ATL,DET,ATL,126,,,19,17,10,11
Onyeka Okongwu,F-C,22023,1630168,22300175,"NOV 11, 2023",ATL vs. MIA,L,24,0,3,0.0,0,0,0.0,2,2,1.0,4,3,7,2,0,2,0,2,2,-15,1,ATL,ATL,MIA,109,,,11,9,4,9
Onyeka Okongwu,F-C,22023,1630168,22300172,"NOV 09, 2023",ATL @ ORL,W,21,3,4,0.75,0,1,0.0,1,2,0.5,1,1,2,2,3,4,1,4,7,-18,1,ATL,ORL,ATL,120,,,11,9,9,4
Onyeka Okongwu,F-C,22023,1630168,22300155,"NOV 06, 2023",ATL @ OKC,L,25,3,8,0.375,0,1,0.0,1,1,1.0,6,8,14,0,0,0,2,3,7,1,1,ATL,OKC,ATL,117,,,21,21,7,14
Onyeka Okongwu,F-C,22023,1630168,22300135,"NOV 04, 2023",ATL @ NOP,W,20,4,6,0.667,2,3,0.667,7,8,0.875,2,4,6,0,1,1,0,0,17,-1,1,ATL,NOP,ATL,123,,,23,23,17,6
Onyeka Okongwu,F-C,22023,1630168,22300117,"NOV 01, 2023",ATL vs. WAS,W,27,6,8,0.75,0,1,0.0,4,4,1.0,5,6,11,2,0,1,1,3,16,-8,1,ATL,ATL,WAS,130,,,29,27,18,13
Onyeka Okongwu,F-C,22023,1630168,22300104,"OCT 30, 2023",ATL vs. MIN,W,24,3,3,1.0,0,0,0.0,4,4,1.0,2,5,7,3,0,0,0,1,10,22,1,ATL,ATL,MIN,127,,,20,17,13,10
Onyeka Okongwu,F-C,22023,1630168,22300097,"OCT 29, 2023",ATL @ MIL,W,23,7,11,0.636,0,2,0.0,0,0,0.0,4,3,7,2,1,0,1,4,14,5,1,ATL,MIL,ATL,127,,,23,21,16,9
Onyeka Okongwu,F-C,22023,1630168,22300079,"OCT 27, 2023",ATL vs. NYK,L,20,1,2,0.5,0,0,0.0,4,4,1.0,0,2,2,1,1,1,0,4,6,2,1,ATL,ATL,NYK,120,,,9,8,7,3
Onyeka Okongwu,F-C,22023,1630168,22300063,"OCT 25, 2023",ATL @ CHA,L,19,3,5,0.6,0,0,0.0,1,1,1.0,1,3,4,2,0,0,1,5,7,14,1,ATL,CHA,ATL,110,,,13,11,9,6
Onyeka Okongwu,F-C,22023,1630168,22300699,"FEB 03, 2024",ATL vs. GSW,W,36,8,12,0.667,2,4,0.5,4,4,1.0,6,10,16,0,0,2,0,4,22,9,1,ATL,ATL,GSW,141,,,38,38,22,16
Dereck Lively II,C,22023,1641726,22300341,"DEC 16, 2023",DAL @ POR,W,6,0,1,0.0,0,0,0.0,0,0,0.0,1,1,2,0,0,0,0,0,0,-4,1,DAL,POR,DAL,131,,,2,2,0,2
Dereck Lively II,C,22023,1641726,22300321,"DEC 14, 2023",DAL vs. MIN,L,32,7,9,0.778,0,0,0.0,1,2,0.5,3,3,6,0,1,2,2,3,15,-12,1,DAL,DAL,MIN,101,,,21,21,15,6
Dereck Lively II,C,22023,1641726,22300666,"JAN 29, 2024",DAL vs. ORL,W,41,8,9,0.889,0,0,0.0,4,9,0.444,3,8,11,1,1,1,2,5,20,13,1,DAL,DAL,ORL,131,,,32,31,21,12
Dereck Lively II,C,22023,1641726,22300651,"JAN 27, 2024",DAL vs. SAC,L,31,6,9,0.667,0,0,0.0,1,2,0.5,4,5,9,0,1,0,1,5,13,11,1,DAL,DAL,SAC,115,,,22,22,13,9
Dereck Lively II,C,22023,1641726,22300577,"JAN 17, 2024",DAL @ LAL,L,28,8,9,0.889,0,0,0.0,0,0,0.0,5,6,11,2,1,0,2,2,16,-5,1,DAL,LAL,DAL,105,,,29,27,18,13
Dereck Lively II,C,22023,1641726,22300556,"JAN 15, 2024",DAL vs. NOP,W,26,2,2,1.0,0,0,0.0,2,2,1.0,7,5,12,1,0,0,2,4,6,-2,1,DAL,DAL,NOP,125,,,19,18,7,13
Dereck Lively II,C,22023,1641726,22300472,"JAN 03, 2024",DAL vs. POR,W,19,0,1,0.0,0,0,0.0,0,0,0.0,1,3,4,4,2,3,0,1,0,23,1,DAL,DAL,POR,126,,,8,4,4,8
Dereck Lively II,C,22023,1641726,22300423,"DEC 28, 2023",DAL @ MIN,L,15,1,4,0.25,0,0,0.0,0,0,0.0,3,1,4,2,0,0,2,5,2,-16,1,DAL,MIN,DAL,110,,,8,6,4,6
Dereck Lively II,C,22023,1641726,22300420,"DEC 27, 2023",DAL vs. CLE,L,25,2,2,1.0,0,0,0.0,0,1,0.0,2,2,4,1,0,2,1,4,4,-7,1,DAL,DAL,CLE,110,,,9,8,5,5
Dereck Lively II,C,22023,1641726,22300405,"DEC 25, 2023",DAL @ PHX,W,32,8,9,0.889,0,0,0.0,4,9,0.444,3,7,10,1,0,0,1,3,20,18,1,DAL,PHX,DAL,128,,,31,30,21,11
Dereck Lively II,C,22023,1641726,22300306,"DEC 12, 2023",DAL vs. LAL,W,30,4,7,0.571,0,0,0.0,0,0,0.0,4,4,8,0,2,3,1,4,8,8,1,DAL,DAL,LAL,127,,,16,16,8,8
Dereck Lively II,C,22023,1641726,22300299,"DEC 11, 2023",DAL @ MEM,W,35,8,9,0.889,0,0,0.0,0,0,0.0,5,11,16,2,0,1,4,3,16,5,1,DAL,MEM,DAL,120,,,34,32,18,18
Dereck Lively II,C,22023,1641726,22301226,"DEC 08, 2023",DAL @ POR,W,28,5,6,0.833,0,0,0.0,0,0,0.0,1,8,9,2,1,2,2,4,10,6,1,DAL,POR,DAL,125,,,21,19,12,11
Dereck Lively II,C,22023,1641726,22301213,"DEC 06, 2023",DAL vs. UTA,W,24,5,6,0.833,0,0,0.0,0,0,0.0,1,3,4,1,1,2,0,2,10,26,1,DAL,DAL,UTA,147,,,15,14,11,5
Dereck Lively II,C,22023,1641726,22300287,"DEC 02, 2023",DAL vs. OKC,L,39,9,9,1.0,0,0,0.0,2,5,0.4,6,10,16,0,1,7,2,2,20,12,1,DAL,DAL,OKC,120,,,36,36,20,16
Dereck Lively II,C,22023,1641726,22300277,"DEC 01, 2023",DAL vs. MEM,L,23,2,5,0.4,0,0,0.0,0,0,0.0,1,4,5,1,1,2,2,1,4,-8,1,DAL,DAL,MEM,94,,,10,9,5,6
Dereck Lively II,C,22023,1641726,22300059,"NOV 28, 2023",DAL vs. HOU,W,28,4,4,1.0,0,0,0.0,0,0,0.0,2,3,5,2,0,2,0,5,8,-2,1,DAL,DAL,HOU,121,,,15,13,10,7
Dereck Lively II,C,22023,1641726,22300238,"NOV 22, 2023",DAL @ LAL,W,19,1,3,0.333,0,0,0.0,0,0,0.0,4,6,10,3,0,0,1,0,2,1,1,DAL,LAL,DAL,104,,,15,12,5,13
Dereck Lively II,C,22023,1641726,22300205,"NOV 18, 2023",DAL @ MIL,L,24,3,4,0.75,0,0,0.0,0,0,0.0,3,7,10,2,0,1,3,5,6,-1,1,DAL,MIL,DAL,125,,,18,16,8,12
Dereck Lively II,C,22023,1641726,22300192,"NOV 15, 2023",DAL @ WAS,W,24,7,8,0.875,0,0,0.0,3,3,1.0,4,5,9,2,1,2,1,2,17,16,1,DAL,WAS,DAL,130,,,28,26,19,11
Dereck Lively II,C,22023,1641726,22300022,"NOV 14, 2023",DAL @ NOP,L,21,1,2,0.5,0,1,0.0,2,2,1.0,3,6,9,2,0,0,0,2,4,-8,1,DAL,NOP,DAL,110,,,15,13,6,11
Dereck Lively II,C,22023,1641726,22300183,"NOV 12, 2023",DAL @ NOP,W,26,4,5,0.8,0,0,0.0,2,4,0.5,1,1,2,0,1,2,1,5,10,13,1,DAL,NOP,DAL,136,,,12,12,10,2
Dereck Lively II,C,22023,1641726,22300014,"NOV 10, 2023",DAL vs. LAC,W,26,3,8,0.375,0,0,0.0,0,0,0.0,2,2,4,1,0,1,1,6,6,15,1,DAL,DAL,LAC,144,,,11,10,7,5
Dereck Lively II,C,22023,1641726,22300006,"NOV 03, 2023",DAL @ DEN,L,25,2,3,0.667,0,1,0.0,0,0,0.0,1,3,4,0,1,1,0,2,4,-10,1,DAL,DEN,DAL,114,,,8,8,4,4
Dereck Lively II,C,22023,1641726,22300124,"NOV 01, 2023",DAL vs. CHI,W,33,3,5,0.6,0,0,0.0,1,4,0.25,7,6,13,6,2,1,1,3,7,15,1,DAL,DAL,CHI,114,,,26,20,13,19
Dereck Lively II,C,22023,1641726,22300106,"OCT 30, 2023",DAL @ MEM,W,14,1,2,0.5,0,0,0.0,0,0,0.0,1,5,6,0,0,1,0,5,2,-2,1,DAL,MEM,DAL,125,,,8,8,2,6
Dereck Lively II,C,22023,1641726,22300084,"OCT 27, 2023",DAL vs. BKN,W,17,4,4,1.0,0,0,0.0,1,2,0.5,1,1,2,0,0,1,1,0,9,1,1,DAL,DAL,BKN,125,,,11,11,9,2
Dereck Lively II,C,22023,1641726,22300073,"OCT 25, 2023",DAL @ SAS,W,31,7,8,0.875,0,0,0.0,2,3,0.667,5,5,10,1,1,1,1,4,16,20,1,DAL,SAS,DAL,126,,,27,26,17,11
Dereck Lively II,C,22023,1641726,22300634,"JAN 26, 2024",DAL @ ATL,W,28,4,7,0.571,0,0,0.0,1,2,0.5,2,9,11,4,1,4,1,5,9,16,1,DAL,ATL,DAL,148,,,24,20,13,15
Dereck Lively II,C,22023,1641726,22300625,"JAN 24, 2024",DAL vs. PHX,L,25,4,5,0.8,0,0,0.0,0,0,0.0,1,1,2,1,1,1,0,2,8,-20,1,DAL,DAL,PHX,107,,,11,10,9,3
Dereck Lively II,C,22023,1641726,22300611,"JAN 22, 2024",DAL vs. BOS,L,25,3,3,1.0,0,0,0.0,0,0,0.0,4,4,8,1,0,2,1,2,6,-7,1,DAL,DAL,BOS,110,,,15,14,7,9
Dereck Lively II,C,22023,1641726,22300457,"JAN 01, 2024",DAL @ UTA,L,25,5,8,0.625,0,0,0.0,0,0,0.0,2,4,6,2,1,1,0,1,10,-3,1,DAL,UTA,DAL,86,,,18,16,12,8
Dereck Lively II,C,22023,1641726,22300444,"DEC 30, 2023",DAL @ GSW,W,35,5,7,0.714,0,0,0.0,2,3,0.667,1,13,14,1,0,0,1,2,12,12,1,DAL,GSW,DAL,132,,,27,26,13,15
Dereck Lively II,C,22023,1641726,22300212,"NOV 19, 2023",DAL vs. SAC,L,29,3,6,0.5,0,0,0.0,0,0,0.0,5,4,9,0,1,2,1,3,6,-16,1,DAL,DAL,SAC,113,,,15,15,6,9
Dereck Lively II,C,22023,1641726,22300147,"NOV 06, 2023",DAL @ ORL,W,16,4,5,0.8,0,0,0.0,2,2,1.0,2,3,5,0,1,1,2,5,10,1,1,DAL,ORL,DAL,117,,,15,15,10,5
Dereck Lively II,C,22023,1641726,22300143,"NOV 05, 2023",DAL vs. CHA,W,32,7,9,0.778,0,0,0.0,1,2,0.5,3,11,14,1,0,1,2,4,15,1,1,DAL,DAL,CHA,124,,,30,29,16,15
Brandin Podziemski,G,22023,1641764,22300757,"FEB 10, 2024",GSW vs. PHX,W,35,4,12,0.333,2,4,0.5,0,0,0.0,1,7,8,7,0,0,2,1,10,5,1,GSW,GSW,PHX,113,,,25,18,17,15
Brandin Podziemski,G,22023,1641764,22300733,"FEB 08, 2024",GSW @ IND,W,34,3,9,0.333,0,1,0.0,3,4,0.75,1,6,7,7,2,1,2,3,9,23,1,GSW,IND,GSW,131,,,23,16,16,14
Brandin Podziemski,G,22023,1641764,22300727,"FEB 07, 2024",GSW @ PHI,W,25,3,8,0.375,0,2,0.0,0,0,0.0,1,4,5,5,2,0,0,2,6,5,1,GSW,PHI,GSW,127,,,16,11,11,10
Brandin Podziemski,G,22023,1641764,22300717,"FEB 05, 2024",GSW @ BKN,W,38,6,14,0.429,0,4,0.0,3,4,0.75,3,8,11,3,0,0,0,3,15,11,1,GSW,BKN,GSW,109,,,29,26,18,14
Brandin Podziemski,G,22023,1641764,22300699,"FEB 03, 2024",GSW @ ATL,L,39,6,12,0.5,0,2,0.0,3,5,0.6,2,9,11,5,0,1,0,4,15,-13,1,GSW,ATL,GSW,134,,,31,26,20,16
Brandin Podziemski,G,22023,1641764,22300693,"FEB 02, 2024",GSW @ MEM,W,34,5,8,0.625,0,2,0.0,2,2,1.0,1,6,7,14,2,1,0,2,12,18,1,GSW,MEM,GSW,121,,,33,19,26,21
Brandin Podziemski,G,22023,1641764,22300673,"JAN 30, 2024",GSW vs. PHI,W,37,5,11,0.455,1,5,0.2,0,1,0.0,1,5,6,3,0,0,3,2,11,15,1,GSW,GSW,PHI,119,,,20,17,14,9
Brandin Podziemski,G,22023,1641764,22300650,"JAN 27, 2024",GSW vs. LAL,L,28,4,9,0.444,1,3,0.333,1,1,1.0,4,3,7,5,1,0,1,1,10,-7,1,GSW,GSW,LAL,144,,,22,17,15,12
Brandin Podziemski,G,22023,1641764,22300632,"JAN 25, 2024",GSW vs. SAC,L,27,3,5,0.6,1,2,0.5,0,0,0.0,1,2,3,2,0,0,1,2,7,5,1,GSW,GSW,SAC,133,,,12,10,9,5
Brandin Podziemski,G,22023,1641764,22300626,"JAN 24, 2024",GSW vs. ATL,W,27,5,9,0.556,0,1,0.0,0,0,0.0,0,3,3,2,0,0,2,1,10,19,1,GSW,GSW,ATL,134,,,15,13,12,5
Brandin Podziemski,G,22023,1641764,22300560,"JAN 15, 2024",GSW @ MEM,L,27,4,12,0.333,0,3,0.0,0,0,0.0,2,2,4,4,0,0,2,4,8,-3,1,GSW,MEM,GSW,107,,,16,12,12,8
Brandin Podziemski,G,22023,1641764,22300536,"JAN 12, 2024",GSW @ CHI,W,27,2,8,0.25,0,4,0.0,1,1,1.0,1,2,3,4,0,0,0,3,5,12,1,GSW,CHI,GSW,140,,,12,8,9,7
Brandin Podziemski,G,22023,1641764,22300525,"JAN 10, 2024",GSW vs. NOP,L,25,1,6,0.167,0,2,0.0,0,0,0.0,3,6,9,2,0,0,2,1,2,-31,1,GSW,GSW,NOP,105,,,13,11,4,11
Brandin Podziemski,G,22023,1641764,22300504,"JAN 07, 2024",GSW vs. TOR,L,29,2,11,0.182,1,8,0.125,0,0,0.0,2,6,8,4,0,0,0,1,5,-9,1,GSW,GSW,TOR,118,,,17,13,9,12
Brandin Podziemski,G,22023,1641764,22300490,"JAN 05, 2024",GSW vs. DET,W,25,4,7,0.571,2,2,1.0,1,3,0.333,2,3,5,5,1,0,1,2,11,-3,1,GSW,GSW,DET,113,,,21,16,16,10
Brandin Podziemski,G,22023,1641764,22300478,"JAN 04, 2024",GSW vs. DEN,L,28,5,10,0.5,3,4,0.75,0,0,0.0,0,2,2,5,1,0,0,2,13,-2,1,GSW,GSW,DEN,127,,,20,15,18,7
Brandin Podziemski,G,22023,1641764,22300463,"JAN 02, 2024",GSW vs. ORL,W,28,4,7,0.571,1,3,0.333,1,4,0.25,1,3,4,2,2,0,0,2,10,4,1,GSW,GSW,ORL,121,,,16,14,12,6
Brandin Podziemski,G,22023,1641764,22300444,"DEC 30, 2023",GSW vs. DAL,L,29,5,8,0.625,3,5,0.6,0,0,0.0,1,8,9,4,1,0,2,1,13,-4,1,GSW,GSW,DAL,122,,,26,22,17,13
Brandin Podziemski,G,22023,1641764,22300426,"DEC 28, 2023",GSW vs. MIA,L,28,4,9,0.444,2,5,0.4,0,0,0.0,1,2,3,6,0,0,1,2,10,1,1,GSW,GSW,MIA,102,,,19,13,16,9
Brandin Podziemski,G,22023,1641764,22300402,"DEC 25, 2023",GSW @ DEN,L,34,4,7,0.571,3,4,0.75,2,2,1.0,4,5,9,6,5,0,2,1,13,1,1,GSW,DEN,GSW,114,,,28,22,19,15
Brandin Podziemski,G,22023,1641764,22300399,"DEC 23, 2023",GSW vs. POR,W,32,7,12,0.583,1,5,0.2,0,0,0.0,1,9,10,7,1,1,2,1,15,25,1,GSW,GSW,POR,126,,,32,25,22,17
Brandin Podziemski,G,22023,1641764,22300386,"DEC 22, 2023",GSW vs. WAS,W,29,3,9,0.333,2,5,0.4,2,2,1.0,3,4,7,5,1,0,1,2,10,16,1,GSW,GSW,WAS,129,,,22,17,15,12
Brandin Podziemski,G,22023,1641764,22300362,"DEC 19, 2023",GSW vs. BOS,W,16,2,4,0.5,1,3,0.333,0,0,0.0,1,4,5,1,1,0,1,2,5,2,1,GSW,GSW,BOS,132,,,11,10,6,6
Brandin Podziemski,G,22023,1641764,22300348,"DEC 17, 2023",GSW @ POR,W,33,4,8,0.5,0,2,0.0,2,2,1.0,0,5,5,5,1,0,1,3,10,1,1,GSW,POR,GSW,118,,,20,15,15,10
Brandin Podziemski,G,22023,1641764,22300339,"DEC 16, 2023",GSW vs. BKN,W,32,7,15,0.467,4,9,0.444,1,2,0.5,1,4,5,5,3,1,5,4,19,0,1,GSW,GSW,BKN,124,,,29,24,24,10
Brandin Podziemski,G,22023,1641764,22300325,"DEC 14, 2023",GSW @ LAC,L,35,2,11,0.182,0,3,0.0,0,0,0.0,4,3,7,2,3,1,3,2,4,-8,1,GSW,LAC,GSW,113,,,13,11,6,9
Brandin Podziemski,G,22023,1641764,22300308,"DEC 12, 2023",GSW @ PHX,L,29,9,14,0.643,2,4,0.5,0,1,0.0,5,6,11,5,1,0,3,2,20,18,1,GSW,PHX,GSW,116,,,36,31,25,16
Brandin Podziemski,G,22023,1641764,22301222,"DEC 08, 2023",GSW @ OKC,L,23,5,11,0.455,1,4,0.25,1,1,1.0,5,1,6,4,1,0,1,2,12,-1,1,GSW,OKC,GSW,136,,,22,18,16,10
Brandin Podziemski,G,22023,1641764,22301214,"DEC 06, 2023",GSW vs. POR,W,21,1,3,0.333,1,1,1.0,0,2,0.0,1,4,5,1,0,0,1,2,3,5,1,GSW,GSW,POR,110,,,9,8,4,6
Brandin Podziemski,G,22023,1641764,22300280,"DEC 02, 2023",GSW @ LAC,L,37,5,9,0.556,2,3,0.667,0,0,0.0,0,6,6,3,1,2,1,2,12,1,1,GSW,LAC,GSW,112,,,21,18,15,9
Brandin Podziemski,G,22023,1641764,22300273,"NOV 30, 2023",GSW vs. LAC,W,31,5,10,0.5,2,4,0.5,1,2,0.5,2,6,8,2,0,0,0,2,13,12,1,GSW,GSW,LAC,120,,,23,21,15,10
Brandin Podziemski,G,22023,1641764,22300051,"NOV 24, 2023",GSW vs. SAS,W,12,0,5,0.0,0,2,0.0,0,0,0.0,1,2,3,2,0,0,1,0,0,0,1,GSW,GSW,SAS,118,,,5,3,2,5
Brandin Podziemski,G,22023,1641764,22300236,"NOV 22, 2023",GSW @ PHX,L,23,4,9,0.444,1,3,0.333,1,2,0.5,2,2,4,2,3,0,0,1,10,20,1,GSW,PHX,GSW,115,,,16,14,12,6
Brandin Podziemski,G,22023,1641764,22300224,"NOV 20, 2023",GSW vs. HOU,W,18,1,2,0.5,1,2,0.5,0,0,0.0,0,5,5,3,0,0,0,2,3,3,1,GSW,GSW,HOU,121,,,11,8,6,8
Brandin Podziemski,G,22023,1641764,22300207,"NOV 18, 2023",GSW vs. OKC,L,25,2,6,0.333,1,4,0.25,3,4,0.75,0,3,3,3,0,0,3,0,8,-15,1,GSW,GSW,OKC,123,,,14,11,11,6
Brandin Podziemski,G,22023,1641764,22300186,"NOV 12, 2023",GSW vs. MIN,L,1,3,5,0.6,2,2,1.0,0,0,0.0,1,0,1,0,1,0,0,0,8,6,1,GSW,GSW,MIN,110,,,9,9,8,1
Brandin Podziemski,G,22023,1641764,22300176,"NOV 11, 2023",GSW vs. CLE,L,8,1,2,0.5,0,0,0.0,0,0,0.0,1,1,2,2,1,0,1,1,2,5,1,GSW,GSW,CLE,110,,,6,4,4,4
Brandin Podziemski,G,22023,1641764,22300169,"NOV 08, 2023",GSW @ DEN,L,11,2,3,0.667,0,0,0.0,1,1,1.0,1,2,3,2,0,0,0,2,5,8,1,GSW,DEN,GSW,105,,,10,8,7,5
Brandin Podziemski,G,22023,1641764,22300145,"NOV 06, 2023",GSW @ DET,W,0,0,0,0.0,0,0,0.0,0,0,0.0,0,0,0,0,0,0,0,0,0,1,1,GSW,DET,GSW,120,,,0,0,0,0
Brandin Podziemski,G,22023,1641764,22300142,"NOV 05, 2023",GSW @ CLE,L,8,0,2,0.0,0,1,0.0,0,0,0.0,1,1,2,2,0,0,2,0,0,5,1,GSW,CLE,GSW,104,,,4,2,2,4
Brandin Podziemski,G,22023,1641764,22300108,"OCT 30, 2023",GSW @ NOP,W,23,2,5,0.4,0,1,0.0,1,2,0.5,1,7,8,2,0,0,2,4,5,15,1,GSW,NOP,GSW,130,,,15,13,7,10
Brandin Podziemski,G,22023,1641764,22300025,"NOV 14, 2023",GSW vs. MIN,L,39,9,18,0.5,3,8,0.375,2,2,1.0,1,6,7,5,1,0,3,4,23,11,1,GSW,GSW,MIN,101,,,35,30,28,12
Brandin Podziemski,G,22023,1641764,22300545,"JAN 13, 2024",GSW @ MIL,L,36,10,14,0.714,3,5,0.6,0,1,0.0,1,9,10,3,2,0,0,3,23,-1,1,GSW,MIL,GSW,118,,,36,33,26,13
Brandin Podziemski,G,22023,1641764,22300201,"NOV 16, 2023",GSW vs. OKC,L,25,4,7,0.571,3,4,0.75,2,2,1.0,2,6,8,3,0,0,1,5,13,-26,1,GSW,GSW,OKC,109,,,24,21,16,11
Kevin Love,F,22023,201567,22300730,"FEB 07, 2024",MIA vs. SAS,W,17,2,7,0.286,2,6,0.333,0,0,0.0,0,6,6,0,1,1,1,3,6,0,1,MIA,MIA,SAS,116,,,12,12,6,6
Kevin Love,F,22023,201567,22300721,"FEB 06, 2024",MIA vs. ORL,W,15,3,9,0.333,1,7,0.143,0,0,0.0,3,1,4,4,0,0,1,4,7,-8,1,MIA,MIA,ORL,121,,,15,11,11,8
Kevin Love,F,22023,201567,22300708,"FEB 04, 2024",MIA vs. LAC,L,15,2,4,0.5,2,4,0.5,0,0,0.0,0,7,7,3,0,0,2,1,6,-2,1,MIA,MIA,LAC,95,,,16,13,9,10
Kevin Love,F,22023,201567,22300689,"FEB 02, 2024",MIA @ WAS,W,15,4,5,0.8,2,3,0.667,3,4,0.75,1,9,10,2,0,0,1,1,13,16,1,MIA,WAS,MIA,110,,,25,23,15,12
Kevin Love,F,22023,201567,22300678,"JAN 31, 2024",MIA vs. SAC,W,14,2,4,0.5,2,3,0.667,2,2,1.0,1,2,3,3,0,0,0,0,8,10,1,MIA,MIA,SAC,115,,,14,11,11,6
Kevin Love,F,22023,201567,22300661,"JAN 29, 2024",MIA vs. PHX,L,13,0,4,0.0,0,4,0.0,4,4,1.0,0,2,2,0,0,1,1,2,4,-16,1,MIA,MIA,PHX,105,,,6,6,4,2
Kevin Love,F,22023,201567,22300643,"JAN 27, 2024",MIA @ NYK,L,14,1,2,0.5,0,1,0.0,0,0,0.0,0,2,2,2,0,0,0,0,2,-3,1,MIA,NYK,MIA,109,,,6,4,4,4
Kevin Love,F,22023,201567,22300621,"JAN 24, 2024",MIA vs. MEM,L,5,0,3,0.0,0,2,0.0,0,0,0.0,0,1,1,0,0,0,0,0,0,-7,1,MIA,MIA,MEM,96,,,1,1,0,1
Kevin Love,F,22023,201567,22300601,"JAN 21, 2024",MIA @ ORL,L,14,3,6,0.5,2,5,0.4,1,2,0.5,3,3,6,0,0,0,1,4,9,-3,1,MIA,ORL,MIA,87,,,15,15,9,6
Kevin Love,F,22023,201567,22300587,"JAN 19, 2024",MIA vs. ATL,L,12,0,5,0.0,0,3,0.0,0,0,0.0,1,4,5,1,1,0,3,1,0,-11,1,MIA,MIA,ATL,108,,,6,5,1,6
Kevin Love,F,22023,201567,22300535,"JAN 12, 2024",MIA vs. ORL,W,16,2,6,0.333,1,4,0.25,0,1,0.0,1,2,3,1,1,0,1,3,5,-3,1,MIA,MIA,ORL,99,,,9,8,6,4
Kevin Love,F,22023,201567,22300522,"JAN 10, 2024",MIA vs. OKC,L,20,3,6,0.5,0,2,0.0,6,6,1.0,1,4,5,2,0,0,1,0,12,-14,1,MIA,MIA,OKC,120,,,19,17,14,7
Kevin Love,F,22023,201567,22300509,"JAN 08, 2024",MIA vs. HOU,W,23,4,7,0.571,1,3,0.333,6,7,0.857,3,4,7,4,1,0,1,2,15,5,1,MIA,MIA,HOU,120,,,26,22,19,11
Kevin Love,F,22023,201567,22300489,"JAN 05, 2024",MIA @ PHX,L,20,6,9,0.667,3,6,0.5,5,6,0.833,3,4,7,2,0,0,2,4,20,-3,1,MIA,PHX,MIA,97,,,29,27,22,9
Kevin Love,F,22023,201567,22300475,"JAN 03, 2024",MIA @ LAL,W,28,4,7,0.571,0,1,0.0,2,6,0.333,3,11,14,3,1,1,0,3,10,11,1,MIA,LAL,MIA,110,,,27,24,13,17
Kevin Love,F,22023,201567,22300458,"JAN 01, 2024",MIA @ LAC,L,23,7,11,0.636,1,5,0.2,2,2,1.0,2,2,4,3,0,2,1,2,17,5,1,MIA,LAC,MIA,104,,,24,21,20,7
Kevin Love,F,22023,201567,22300439,"DEC 30, 2023",MIA @ UTA,L,20,4,11,0.364,2,8,0.25,2,4,0.5,2,4,6,2,0,0,1,1,12,-7,1,MIA,UTA,MIA,109,,,20,18,14,8
Kevin Love,F,22023,201567,22300426,"DEC 28, 2023",MIA @ GSW,W,13,2,5,0.4,1,3,0.333,3,3,1.0,0,7,7,4,0,0,1,1,8,2,1,MIA,GSW,MIA,114,,,19,15,12,11
Kevin Love,F,22023,201567,22300404,"DEC 25, 2023",MIA vs. PHI,W,16,2,3,0.667,1,2,0.5,3,4,0.75,1,9,10,5,0,0,1,0,8,8,1,MIA,MIA,PHI,119,,,23,18,13,15
Kevin Love,F,22023,201567,22300384,"DEC 22, 2023",MIA vs. ATL,W,10,1,4,0.25,1,4,0.25,3,4,0.75,0,0,0,1,0,0,0,3,6,-1,1,MIA,MIA,ATL,122,,,7,6,7,1
Kevin Love,F,22023,201567,22300353,"DEC 18, 2023",MIA vs. MIN,L,24,3,7,0.429,3,7,0.429,0,0,0.0,0,10,10,4,1,0,0,2,9,1,1,MIA,MIA,MIN,108,,,23,19,13,14
Kevin Love,F,22023,201567,22300267,"NOV 30, 2023",MIA vs. IND,W,17,1,1,1.0,0,0,0.0,3,4,0.75,1,7,8,6,1,0,0,2,5,10,1,MIA,MIA,IND,142,,,19,13,11,14
Kevin Love,F,22023,201567,22300056,"NOV 28, 2023",MIA vs. MIL,L,26,2,11,0.182,2,5,0.4,0,0,0.0,4,6,10,4,0,0,0,2,6,-4,1,MIA,MIA,MIL,124,,,20,16,10,14
Kevin Love,F,22023,201567,22300045,"NOV 24, 2023",MIA @ NYK,L,18,2,7,0.286,1,6,0.167,2,2,1.0,1,5,6,1,0,0,2,1,7,-1,1,MIA,NYK,MIA,98,,,14,13,8,7
Kevin Love,F,22023,201567,22300220,"NOV 20, 2023",MIA @ CHI,W,15,4,6,0.667,3,5,0.6,0,0,0.0,0,8,8,1,0,0,1,2,11,17,1,MIA,CHI,MIA,118,,,20,19,12,9
Kevin Love,F,22023,201567,22300204,"NOV 18, 2023",MIA @ CHI,L,12,2,7,0.286,1,6,0.167,0,2,0.0,1,5,6,2,0,0,0,2,5,-4,1,MIA,CHI,MIA,97,,,13,11,7,8
Kevin Love,F,22023,201567,22300200,"NOV 16, 2023",MIA vs. BKN,W,16,2,4,0.5,1,3,0.333,2,2,1.0,1,8,9,4,0,0,0,2,7,16,1,MIA,MIA,BKN,122,,,20,16,11,13
Kevin Love,F,22023,201567,22300017,"NOV 14, 2023",MIA @ CHA,W,14,0,5,0.0,0,5,0.0,3,4,0.75,0,3,3,1,0,0,0,1,3,2,1,MIA,CHA,MIA,111,,,7,6,4,4
Kevin Love,F,22023,201567,22300184,"NOV 12, 2023",MIA @ SAS,W,14,3,8,0.375,2,7,0.286,4,4,1.0,0,2,2,0,0,0,0,2,12,-6,1,MIA,SAS,MIA,118,,,14,14,12,2
Kevin Love,F,22023,201567,22300175,"NOV 11, 2023",MIA @ ATL,W,14,2,4,0.5,1,3,0.333,2,2,1.0,0,4,4,2,0,0,1,0,7,10,1,MIA,ATL,MIA,117,,,13,11,9,6
Kevin Love,F,22023,201567,22300080,"OCT 27, 2023",MIA @ BOS,L,21,3,7,0.429,2,4,0.5,1,2,0.5,2,7,9,2,1,0,0,1,9,13,1,MIA,BOS,MIA,111,,,20,18,11,11
Kevin Love,F,22023,201567,22300068,"OCT 25, 2023",MIA vs. DET,W,28,4,9,0.444,3,6,0.5,2,2,1.0,2,8,10,2,0,0,1,5,13,5,1,MIA,MIA,DET,103,,,25,23,15,12
Kevin Love,F,22023,201567,22300337,"DEC 16, 2023",MIA vs. CHI,W,26,8,12,0.667,6,10,0.6,0,0,0.0,1,6,7,1,1,0,1,2,22,19,1,MIA,MIA,CHI,118,,,30,29,23,8
Kevin Love,F,22023,201567,22300320,"DEC 14, 2023",MIA vs. CHI,L,22,5,12,0.417,3,8,0.375,3,4,0.75,1,8,9,4,1,0,2,1,16,5,1,MIA,MIA,CHI,116,,,29,25,20,13
Kevin Love,F,22023,201567,22300312,"DEC 13, 2023",MIA vs. CHA,W,20,1,9,0.111,0,6,0.0,1,2,0.5,0,8,8,1,2,1,2,1,3,10,1,MIA,MIA,CHA,115,,,12,11,4,9
Kevin Love,F,22023,201567,22300292,"DEC 11, 2023",MIA @ CHA,W,21,7,11,0.636,4,8,0.5,1,1,1.0,1,5,6,1,1,0,0,1,19,8,1,MIA,CHA,MIA,116,,,26,25,20,7
Kevin Love,F,22023,201567,22300240,"NOV 25, 2023",MIA @ BKN,L,17,3,4,0.75,0,0,0.0,2,2,1.0,3,7,10,2,0,0,1,2,8,9,1,MIA,BKN,MIA,97,,,20,18,10,12
Kevin Love,F,22023,201567,22300107,"OCT 30, 2023",MIA @ MIL,L,18,1,6,0.167,1,5,0.2,0,0,0.0,0,5,5,3,0,0,2,1,3,-10,1,MIA,MIL,MIA,114,,,11,8,6,8
Kevin Love,F,22023,201567,22301220,"DEC 08, 2023",MIA vs. CLE,L,28,5,9,0.556,4,8,0.5,0,0,0.0,0,12,12,3,1,1,1,3,14,6,1,MIA,MIA,CLE,99,,,29,26,17,15
Kevin Love,F,22023,201567,22301207,"DEC 06, 2023",MIA @ TOR,W,15,2,5,0.4,1,4,0.25,3,3,1.0,1,1,2,4,0,0,0,2,8,-18,1,MIA,TOR,MIA,112,,,14,10,12,6
Kevin Love,F,22023,201567,22300284,"DEC 02, 2023",MIA vs. IND,L,19,4,6,0.667,3,5,0.6,3,3,1.0,0,1,1,5,0,0,0,4,14,-9,1,MIA,MIA,IND,129,,,20,15,19,6
Dorian Finney-Smith,F,22023,1627827,22300750,"FEB 10, 2024",BKN vs. SAS,W,20,1,4,0.25,1,4,0.25,0,2,0.0,1,2,3,3,1,1,0,6,3,4,1,BKN,BKN,SAS,123,,,9,6,6,6
Dorian Finney-Smith,F,22023,1627827,22300645,"JAN 27, 2024",BKN vs. HOU,W,31,7,12,0.583,4,8,0.5,1,4,0.25,0,7,7,3,2,2,3,2,19,20,1,BKN,BKN,HOU,106,,,29,26,22,10
Dorian Finney-Smith,F,22023,1627827,22300629,"JAN 25, 2024",BKN vs. MIN,L,36,3,6,0.5,2,5,0.4,0,0,0.0,0,2,2,2,0,0,0,2,8,1,1,BKN,BKN,MIN,94,,,12,10,10,4
Dorian Finney-Smith,F,22023,1627827,22300615,"JAN 23, 2024",BKN vs. NYK,L,37,2,10,0.2,1,7,0.143,0,0,0.0,2,0,2,7,1,1,2,3,5,4,1,BKN,BKN,NYK,103,,,14,7,12,9
Dorian Finney-Smith,F,22023,1627827,22300600,"JAN 21, 2024",BKN @ LAC,L,27,0,5,0.0,0,3,0.0,0,0,0.0,0,9,9,0,0,1,1,2,0,-10,1,BKN,LAC,BKN,114,,,9,9,0,9
Dorian Finney-Smith,F,22023,1627827,22300591,"JAN 19, 2024",BKN @ LAL,W,28,1,8,0.125,0,5,0.0,1,2,0.5,1,3,4,1,1,2,0,4,3,19,1,BKN,LAL,BKN,130,,,8,7,4,5
Dorian Finney-Smith,F,22023,1627827,22300578,"JAN 17, 2024",BKN @ POR,L,32,2,5,0.4,1,4,0.25,2,2,1.0,1,4,5,1,2,0,1,1,7,-7,1,BKN,POR,BKN,103,,,13,12,8,6
Dorian Finney-Smith,F,22023,1627827,22300562,"JAN 15, 2024",BKN vs. MIA,L,28,1,6,0.167,1,5,0.2,2,2,1.0,2,5,7,2,0,2,0,0,5,-5,1,BKN,BKN,MIA,95,,,14,12,7,9
Dorian Finney-Smith,F,22023,1627827,22300527,"JAN 11, 2024",BKN @ CLE,L,14,0,1,0.0,0,1,0.0,0,0,0.0,0,0,0,0,0,1,1,3,0,-17,1,BKN,CLE,BKN,102,,,0,0,0,0
Dorian Finney-Smith,F,22023,1627827,22300498,"JAN 07, 2024",BKN vs. POR,L,36,3,8,0.375,3,7,0.429,0,0,0.0,2,3,5,2,1,0,1,3,9,5,1,BKN,BKN,POR,127,,,16,14,11,7
Dorian Finney-Smith,F,22023,1627827,22300481,"JAN 05, 2024",BKN vs. OKC,W,22,3,6,0.5,3,5,0.6,0,0,0.0,1,2,3,2,1,1,0,4,9,6,1,BKN,BKN,OKC,124,,,14,12,11,5
Dorian Finney-Smith,F,22023,1627827,22300469,"JAN 03, 2024",BKN @ HOU,L,20,4,16,0.25,1,11,0.091,0,0,0.0,1,1,2,2,0,1,2,2,9,4,1,BKN,HOU,BKN,101,,,13,11,11,4
Dorian Finney-Smith,F,22023,1627827,22300461,"JAN 02, 2024",BKN @ NOP,L,20,1,6,0.167,1,4,0.25,0,0,0.0,1,3,4,1,2,0,0,1,3,-17,1,BKN,NOP,BKN,85,,,8,7,4,5
Dorian Finney-Smith,F,22023,1627827,22300447,"DEC 31, 2023",BKN @ OKC,L,24,3,13,0.231,2,8,0.25,0,0,0.0,3,3,6,2,1,0,0,2,8,-11,1,BKN,OKC,BKN,108,,,16,14,10,8
Dorian Finney-Smith,F,22023,1627827,22300430,"DEC 29, 2023",BKN @ WAS,L,33,2,8,0.25,0,3,0.0,0,0,0.0,5,2,7,1,1,0,0,2,4,-11,1,BKN,WAS,BKN,104,,,12,11,5,8
Dorian Finney-Smith,F,22023,1627827,22300406,"DEC 26, 2023",BKN @ DET,W,33,3,8,0.375,3,7,0.429,2,2,1.0,1,3,4,1,1,0,0,4,11,16,1,BKN,DET,BKN,118,,,16,15,12,5
Dorian Finney-Smith,F,22023,1627827,22300394,"DEC 23, 2023",BKN vs. DET,W,27,4,6,0.667,2,4,0.5,0,0,0.0,0,6,6,1,2,0,0,1,10,22,1,BKN,BKN,DET,126,,,17,16,11,7
Dorian Finney-Smith,F,22023,1627827,22300383,"DEC 22, 2023",BKN vs. DEN,L,30,5,9,0.556,4,5,0.8,0,0,0.0,2,2,4,1,0,0,1,2,14,11,1,BKN,BKN,DEN,117,,,19,18,15,5
Dorian Finney-Smith,F,22023,1627827,22300368,"DEC 20, 2023",BKN vs. NYK,L,24,3,8,0.375,2,6,0.333,2,2,1.0,0,3,3,0,0,0,1,2,10,-9,1,BKN,BKN,NYK,102,,,13,13,10,3
Dorian Finney-Smith,F,22023,1627827,22300357,"DEC 18, 2023",BKN @ UTA,L,21,2,7,0.286,2,5,0.4,0,0,0.0,2,0,2,3,1,0,0,4,6,-7,1,BKN,UTA,BKN,108,,,11,8,9,5
Dorian Finney-Smith,F,22023,1627827,22300322,"DEC 14, 2023",BKN @ DEN,L,16,0,3,0.0,0,1,0.0,0,0,0.0,4,0,4,0,1,0,1,2,0,-9,1,BKN,DEN,BKN,101,,,4,4,0,4
Dorian Finney-Smith,F,22023,1627827,22300317,"DEC 13, 2023",BKN @ PHX,W,25,4,9,0.444,0,4,0.0,0,0,0.0,3,3,6,1,2,0,2,3,8,15,1,BKN,PHX,BKN,116,,,15,14,9,7
Dorian Finney-Smith,F,22023,1627827,22300303,"DEC 11, 2023",BKN @ SAC,L,25,5,6,0.833,3,4,0.75,0,0,0.0,0,3,3,1,1,2,0,0,13,-10,1,BKN,SAC,BKN,118,,,17,16,14,4
Dorian Finney-Smith,F,22023,1627827,22301219,"DEC 08, 2023",BKN vs. WAS,W,26,2,5,0.4,1,4,0.25,3,3,1.0,2,1,3,0,1,0,0,0,8,12,1,BKN,BKN,WAS,124,,,11,11,8,3
Dorian Finney-Smith,F,22023,1627827,22301209,"DEC 06, 2023",BKN @ ATL,W,30,6,10,0.6,3,6,0.5,0,0,0.0,2,3,5,0,1,1,1,3,15,6,1,BKN,ATL,BKN,114,,,20,20,15,5
Dorian Finney-Smith,F,22023,1627827,22300266,"NOV 30, 2023",BKN vs. CHA,L,39,5,7,0.714,4,6,0.667,0,0,0.0,3,3,6,1,2,1,1,0,14,2,1,BKN,BKN,CHA,128,,,21,20,15,7
Dorian Finney-Smith,F,22023,1627827,22300054,"NOV 28, 2023",BKN vs. TOR,W,26,2,10,0.2,1,4,0.25,0,0,0.0,5,4,9,2,1,1,0,4,5,10,1,BKN,BKN,TOR,115,,,16,14,7,11
Dorian Finney-Smith,F,22023,1627827,22300250,"NOV 26, 2023",BKN vs. CHI,W,34,3,10,0.3,3,7,0.429,0,0,0.0,0,4,4,1,2,1,1,3,9,-17,1,BKN,BKN,CHI,118,,,14,13,10,5
Dorian Finney-Smith,F,22023,1627827,22300240,"NOV 25, 2023",BKN vs. MIA,W,34,7,9,0.778,2,4,0.5,0,0,0.0,2,3,5,3,0,1,0,0,16,23,1,BKN,BKN,MIA,112,,,24,21,19,8
Dorian Finney-Smith,F,22023,1627827,22300227,"NOV 22, 2023",BKN @ ATL,L,38,3,7,0.429,2,5,0.4,0,0,0.0,3,5,8,1,0,0,1,3,8,-5,1,BKN,ATL,BKN,145,,,17,16,9,9
Dorian Finney-Smith,F,22023,1627827,22300208,"NOV 19, 2023",BKN vs. PHI,L,27,2,7,0.286,1,3,0.333,0,0,0.0,1,2,3,2,0,0,1,2,5,-19,1,BKN,BKN,PHI,99,,,10,8,7,5
Dorian Finney-Smith,F,22023,1627827,22300200,"NOV 16, 2023",BKN @ MIA,L,32,4,6,0.667,3,4,0.75,0,0,0.0,1,5,6,1,1,0,3,3,11,-9,1,BKN,MIA,BKN,115,,,18,17,12,7
Dorian Finney-Smith,F,22023,1627827,22300020,"NOV 14, 2023",BKN vs. ORL,W,24,2,5,0.4,1,4,0.25,0,0,0.0,2,2,4,0,1,0,0,1,5,-6,1,BKN,BKN,ORL,124,,,9,9,5,4
Dorian Finney-Smith,F,22023,1627827,22300178,"NOV 12, 2023",BKN vs. WAS,W,20,2,7,0.286,2,6,0.333,0,0,0.0,2,1,3,0,0,0,2,5,6,7,1,BKN,BKN,WAS,102,,,9,9,6,3
Dorian Finney-Smith,F,22023,1627827,22300010,"NOV 10, 2023",BKN @ BOS,L,27,3,6,0.5,3,5,0.6,0,0,0.0,2,1,3,2,0,1,0,4,9,-24,1,BKN,BOS,BKN,107,,,14,12,11,5
Dorian Finney-Smith,F,22023,1627827,22300160,"NOV 08, 2023",BKN vs. LAC,W,35,4,11,0.364,4,8,0.5,0,0,0.0,3,6,9,2,1,3,0,2,12,4,1,BKN,BKN,LAC,100,,,23,21,14,11
Dorian Finney-Smith,F,22023,1627827,22300149,"NOV 06, 2023",BKN vs. MIL,L,37,3,12,0.25,1,7,0.143,0,0,0.0,4,2,6,2,0,1,1,2,7,7,1,BKN,BKN,MIL,125,,,15,13,9,8
Dorian Finney-Smith,F,22023,1627827,22300136,"NOV 04, 2023",BKN vs. BOS,L,37,5,10,0.5,4,9,0.444,0,0,0.0,4,4,8,1,0,0,0,3,14,-19,1,BKN,BKN,BOS,114,,,23,22,15,9
Dorian Finney-Smith,F,22023,1627827,22300004,"NOV 03, 2023",BKN @ CHI,W,33,8,14,0.571,5,9,0.556,0,0,0.0,2,1,3,0,0,1,0,1,21,-8,1,BKN,CHI,BKN,109,,,24,24,21,3
Dorian Finney-Smith,F,22023,1627827,22300119,"NOV 01, 2023",BKN @ MIA,W,30,6,10,0.6,3,5,0.6,0,0,0.0,0,3,3,2,0,0,1,3,15,-20,1,BKN,MIA,BKN,109,,,20,18,17,5
Dorian Finney-Smith,F,22023,1627827,22300101,"OCT 30, 2023",BKN @ CHA,W,31,7,12,0.583,4,9,0.444,1,2,0.5,1,6,7,1,1,2,1,0,19,5,1,BKN,CHA,BKN,133,,,27,26,20,8
Dorian Finney-Smith,F,22023,1627827,22300084,"OCT 27, 2023",BKN @ DAL,L,32,4,8,0.5,4,7,0.571,0,0,0.0,1,6,7,3,0,0,2,5,12,-15,1,BKN,DAL,BKN,120,,,22,19,15,10
Dorian Finney-Smith,F,22023,1627827,22300067,"OCT 25, 2023",BKN vs. CLE,L,28,4,8,0.5,2,6,0.333,0,1,0.0,1,4,5,2,0,0,3,1,10,7,1,BKN,BKN,CLE,113,,,17,15,12,7
Duop Reath,C,22023,1641871,22300712,"FEB 04, 2024",POR @ DEN,L,13,3,3,1.0,2,2,1.0,0,0,0.0,0,1,1,1,0,0,1,3,8,-16,1,POR,DEN,POR,103,,,10,9,9,2
Duop Reath,C,22023,1641871,22300697,"FEB 02, 2024",POR @ DEN,L,21,3,4,0.75,2,2,1.0,2,4,0.5,1,3,4,1,1,1,1,3,10,6,1,POR,DEN,POR,108,,,15,14,11,5
Duop Reath,C,22023,1641871,22300683,"JAN 31, 2024",POR vs. MIL,W,13,4,6,0.667,2,2,1.0,0,0,0.0,2,2,4,1,1,0,1,3,10,13,1,POR,POR,MIL,119,,,15,14,11,5
Duop Reath,C,22023,1641871,22300668,"JAN 29, 2024",POR vs. PHI,W,12,2,3,0.667,1,1,1.0,0,0,0.0,1,0,1,1,0,0,0,5,5,-9,1,POR,POR,PHI,128,,,7,6,6,2
Duop Reath,C,22023,1641871,22300656,"JAN 28, 2024",POR vs. CHI,L,11,1,7,0.143,1,7,0.143,0,0,0.0,0,3,3,0,0,0,0,2,3,-8,1,POR,POR,CHI,96,,,6,6,3,3
Duop Reath,C,22023,1641871,22300641,"JAN 26, 2024",POR @ SAS,L,13,1,4,0.25,0,2,0.0,1,2,0.5,1,2,3,0,0,0,0,2,3,-7,1,POR,SAS,POR,98,,,6,6,3,3
Duop Reath,C,22023,1641871,22300623,"JAN 24, 2024",POR @ HOU,W,12,4,7,0.571,1,3,0.333,0,0,0.0,1,1,2,2,0,0,0,0,9,-9,1,POR,HOU,POR,137,,,13,11,11,4
Duop Reath,C,22023,1641871,22300617,"JAN 23, 2024",POR @ OKC,L,21,3,5,0.6,2,3,0.667,2,2,1.0,1,3,4,3,1,1,2,3,10,7,1,POR,OKC,POR,109,,,17,14,13,7
Duop Reath,C,22023,1641871,22300605,"JAN 21, 2024",POR @ LAL,L,22,6,9,0.667,2,4,0.5,2,2,1.0,2,1,3,4,0,1,1,3,16,-8,1,POR,LAL,POR,108,,,23,19,20,7
Duop Reath,C,22023,1641871,22300590,"JAN 19, 2024",POR vs. IND,W,18,1,1,1.0,0,0,0.0,1,2,0.5,2,3,5,2,0,2,0,4,3,18,1,POR,POR,IND,118,,,10,8,5,7
Duop Reath,C,22023,1641871,22300399,"DEC 23, 2023",POR @ GSW,L,9,0,2,0.0,0,2,0.0,0,0,0.0,0,1,1,0,0,0,0,3,0,-13,1,POR,GSW,POR,106,,,1,1,0,1
Duop Reath,C,22023,1641871,22300381,"DEC 21, 2023",POR vs. WAS,L,10,4,7,0.571,1,1,1.0,1,1,1.0,1,4,5,0,0,1,1,4,10,8,1,POR,POR,WAS,117,,,15,15,10,5
Duop Reath,C,22023,1641871,22300363,"DEC 19, 2023",POR vs. PHX,W,4,1,1,1.0,1,1,1.0,0,0,0.0,1,1,2,0,1,0,1,0,3,-3,1,POR,POR,PHX,109,,,5,5,3,2
Duop Reath,C,22023,1641871,22300341,"DEC 16, 2023",POR vs. DAL,L,15,3,9,0.333,0,3,0.0,5,5,1.0,3,2,5,1,0,0,0,0,11,-8,1,POR,POR,DAL,120,,,17,16,12,6
Duop Reath,C,22023,1641871,22300323,"DEC 14, 2023",POR vs. UTA,L,13,6,11,0.545,3,6,0.5,0,0,0.0,2,3,5,0,1,1,0,1,15,21,1,POR,POR,UTA,114,,,20,20,15,5
Duop Reath,C,22023,1641871,22300289,"DEC 02, 2023",POR @ UTA,L,14,3,8,0.375,1,4,0.25,2,2,1.0,1,0,1,1,0,0,0,0,9,8,1,POR,UTA,POR,113,,,11,10,10,2
Duop Reath,C,22023,1641871,22300265,"NOV 30, 2023",POR @ CLE,W,18,4,5,0.8,3,4,0.75,2,2,1.0,1,1,2,2,1,1,1,2,13,14,1,POR,CLE,POR,103,,,17,15,15,4
Duop Reath,C,22023,1641871,22300254,"NOV 27, 2023",POR @ IND,W,10,1,1,1.0,1,1,1.0,1,2,0.5,0,2,2,1,0,0,1,1,4,1,1,POR,IND,POR,114,,,7,6,5,3
Duop Reath,C,22023,1641871,22300245,"NOV 26, 2023",POR @ MIL,L,12,1,5,0.2,1,4,0.25,0,0,0.0,0,0,0,0,2,0,1,2,3,7,1,POR,MIL,POR,102,,,3,3,3,0
Duop Reath,C,22023,1641871,22300041,"NOV 21, 2023",POR @ PHX,L,13,4,6,0.667,2,3,0.667,0,0,0.0,1,0,1,1,2,0,0,1,10,15,1,POR,PHX,POR,107,,,12,11,11,2
Duop Reath,C,22023,1641871,22300215,"NOV 19, 2023",POR vs. OKC,L,12,1,6,0.167,0,2,0.0,2,2,1.0,0,2,2,0,0,0,1,2,4,-9,1,POR,POR,OKC,89,,,6,6,4,2
Duop Reath,C,22023,1641871,22300036,"NOV 17, 2023",POR vs. LAL,L,10,0,5,0.0,0,4,0.0,0,0,0.0,1,1,2,0,0,0,0,1,0,-6,1,POR,POR,LAL,95,,,2,2,0,2
Duop Reath,C,22023,1641871,22300199,"NOV 15, 2023",POR vs. CLE,L,20,6,10,0.6,2,5,0.4,2,2,1.0,2,0,2,3,0,0,1,2,16,0,1,POR,POR,CLE,93,,,21,18,19,5
Duop Reath,C,22023,1641871,22300023,"NOV 14, 2023",POR @ UTA,L,10,0,4,0.0,0,3,0.0,0,0,0.0,1,0,1,0,0,0,2,1,0,-5,1,POR,UTA,POR,99,,,1,1,0,1
Duop Reath,C,22023,1641871,22300187,"NOV 12, 2023",POR @ LAL,L,14,4,10,0.4,3,8,0.375,0,0,0.0,0,3,3,3,0,1,0,3,11,11,1,POR,LAL,POR,104,,,17,14,14,6
Duop Reath,C,22023,1641871,22300578,"JAN 17, 2024",POR vs. BKN,W,25,7,9,0.778,2,4,0.5,1,1,1.0,2,5,7,3,0,0,1,4,17,5,1,POR,POR,BKN,103,,,27,24,20,10
Duop Reath,C,22023,1641871,22300538,"JAN 12, 2024",POR @ MIN,L,24,6,14,0.429,2,6,0.333,0,3,0.0,3,3,6,0,1,1,1,4,14,-20,1,POR,MIN,POR,91,,,20,20,14,6
Duop Reath,C,22023,1641871,22300514,"JAN 09, 2024",POR @ NYK,L,21,3,6,0.5,1,3,0.333,0,0,0.0,1,5,6,0,0,0,0,2,7,-20,1,POR,NYK,POR,80,,,13,13,7,6
Duop Reath,C,22023,1641871,22300498,"JAN 07, 2024",POR @ BKN,W,41,5,10,0.5,3,4,0.75,2,3,0.667,3,10,13,1,1,3,1,4,15,4,1,POR,BKN,POR,134,,,29,28,16,14
Duop Reath,C,22023,1641871,22300487,"JAN 05, 2024",POR @ DAL,L,27,7,12,0.583,1,3,0.333,1,2,0.5,4,3,7,2,0,0,3,3,16,-16,1,POR,DAL,POR,103,,,25,23,18,9
Duop Reath,C,22023,1641871,22300472,"JAN 03, 2024",POR @ DAL,L,6,1,2,0.5,0,1,0.0,0,0,0.0,0,2,2,1,0,0,2,4,2,0,1,POR,DAL,POR,97,,,5,4,3,3
Duop Reath,C,22023,1641871,22300413,"DEC 26, 2023",POR vs. SAC,W,32,9,15,0.6,3,6,0.5,4,4,1.0,5,4,9,0,1,1,1,3,25,24,1,POR,POR,SAC,130,,,34,34,25,9
Duop Reath,C,22023,1641871,22301214,"DEC 06, 2023",POR @ GSW,L,22,2,6,0.333,1,5,0.2,5,6,0.833,1,5,6,2,1,1,0,5,10,6,1,POR,GSW,POR,106,,,18,16,12,8
Duop Reath,C,22023,1641871,22300237,"NOV 22, 2023",POR vs. UTA,W,20,3,5,0.6,2,4,0.5,0,0,0.0,0,4,4,1,0,1,1,2,8,5,1,POR,POR,UTA,121,,,13,12,9,5
Duop Reath,C,22023,1641871,22300304,"DEC 11, 2023",POR @ LAC,L,26,4,11,0.364,2,6,0.333,0,0,0.0,2,1,3,4,1,0,1,3,10,0,1,POR,LAC,POR,127,,,17,13,14,7
Duop Reath,C,22023,1641871,22300554,"JAN 14, 2024",POR vs. PHX,L,39,7,15,0.467,2,6,0.333,1,1,1.0,2,4,6,1,2,1,2,4,17,-2,1,POR,POR,PHX,116,,,24,23,18,7
Duop Reath,C,22023,1641871,22300529,"JAN 11, 2024",POR @ OKC,L,24,3,9,0.333,1,4,0.25,1,2,0.5,2,5,7,2,0,1,0,2,8,-49,1,POR,OKC,POR,77,,,17,15,10,9
Duop Reath,C,22023,1641871,22301226,"DEC 08, 2023",POR vs. DAL,L,21,4,9,0.444,2,6,0.333,0,0,0.0,2,4,6,1,2,0,1,4,10,2,1,POR,POR,DAL,112,,,17,16,11,7
Isaac Okoro,F,22023,1630171,22300756,"FEB 10, 2024",CLE @ TOR,W,27,4,10,0.4,1,5,0.2,3,3,1.0,0,2,2,4,1,0,0,1,12,19,1,CLE,TOR,CLE,119,,,18,14,16,6
Isaac Okoro,F,22023,1630171,22300735,"FEB 08, 2024",CLE @ BKN,W,24,3,6,0.5,2,3,0.667,0,0,0.0,2,4,6,1,0,3,2,3,8,6,1,CLE,BKN,CLE,118,,,15,14,9,7
Isaac Okoro,F,22023,1630171,22300728,"FEB 07, 2024",CLE @ WAS,W,28,2,3,0.667,0,1,0.0,1,3,0.333,0,3,3,3,1,1,0,1,5,17,1,CLE,WAS,CLE,114,,,11,8,8,6
Isaac Okoro,F,22023,1630171,22300714,"FEB 05, 2024",CLE vs. SAC,W,25,3,4,0.75,2,2,1.0,2,4,0.5,0,0,0,0,2,1,2,1,10,15,1,CLE,CLE,SAC,136,,,10,10,10,0
Isaac Okoro,F,22023,1630171,22300703,"FEB 03, 2024",CLE @ SAS,W,25,3,8,0.375,1,5,0.2,0,0,0.0,0,1,1,2,0,0,0,1,7,9,1,CLE,SAS,CLE,117,,,10,8,9,3
Isaac Okoro,F,22023,1630171,22300687,"FEB 01, 2024",CLE @ MEM,W,21,2,4,0.5,1,1,1.0,1,1,1.0,1,3,4,0,0,0,1,2,6,7,1,CLE,MEM,CLE,108,,,10,10,6,4
Isaac Okoro,F,22023,1630171,22300675,"JAN 31, 2024",CLE vs. DET,W,30,6,8,0.75,0,0,0.0,2,2,1.0,2,1,3,0,4,0,0,1,14,18,1,CLE,CLE,DET,128,,,17,17,14,3
Isaac Okoro,F,22023,1630171,22300658,"JAN 29, 2024",CLE vs. LAC,W,33,5,10,0.5,3,4,0.75,4,4,1.0,1,0,1,3,1,0,1,0,17,-8,1,CLE,CLE,LAC,118,,,21,18,20,4
Isaac Okoro,F,22023,1630171,22300639,"JAN 26, 2024",CLE @ MIL,W,31,1,6,0.167,1,2,0.5,0,4,0.0,0,1,1,1,2,2,0,1,3,12,1,CLE,MIL,CLE,112,,,5,4,4,2
Isaac Okoro,F,22023,1630171,22300624,"JAN 24, 2024",CLE @ MIL,L,24,3,5,0.6,0,1,0.0,4,4,1.0,1,0,1,0,0,0,0,2,10,-16,1,CLE,MIL,CLE,116,,,11,11,10,1
Isaac Okoro,F,22023,1630171,22300607,"JAN 22, 2024",CLE @ ORL,W,20,3,4,0.75,1,1,1.0,1,2,0.5,0,1,1,0,0,0,0,4,8,15,1,CLE,ORL,CLE,126,,,9,9,8,1
Isaac Okoro,F,22023,1630171,22300595,"JAN 20, 2024",CLE @ ATL,W,33,5,9,0.556,1,3,0.333,1,3,0.333,0,5,5,2,2,0,2,3,12,19,1,CLE,ATL,CLE,116,,,19,17,14,7
Isaac Okoro,F,22023,1630171,22300572,"JAN 17, 2024",CLE vs. MIL,W,26,5,7,0.714,0,0,0.0,0,1,0.0,1,2,3,7,1,1,0,2,10,37,1,CLE,CLE,MIL,135,,,20,13,17,10
Isaac Okoro,F,22023,1630171,22300561,"JAN 15, 2024",CLE vs. CHI,W,25,3,12,0.25,1,6,0.167,0,0,0.0,1,4,5,1,0,0,1,1,7,18,1,CLE,CLE,CHI,109,,,13,12,8,6
Isaac Okoro,F,22023,1630171,22300527,"JAN 11, 2024",CLE vs. BKN,W,35,4,12,0.333,2,5,0.4,2,2,1.0,3,1,4,0,0,0,1,4,12,6,1,CLE,CLE,BKN,111,,,16,16,12,4
Isaac Okoro,F,22023,1630171,22300497,"JAN 07, 2024",CLE vs. SAS,W,27,1,2,0.5,1,2,0.5,0,0,0.0,4,1,5,1,0,0,2,0,3,-17,1,CLE,CLE,SAS,117,,,9,8,4,6
Isaac Okoro,F,22023,1630171,22300482,"JAN 05, 2024",CLE vs. WAS,W,22,2,5,0.4,0,0,0.0,4,6,0.667,2,2,4,0,1,0,3,2,8,16,1,CLE,CLE,WAS,114,,,12,12,8,4
Isaac Okoro,F,22023,1630171,22300465,"JAN 03, 2024",CLE vs. WAS,W,20,4,4,1.0,1,1,1.0,0,0,0.0,0,2,2,3,1,0,0,2,9,12,1,CLE,CLE,WAS,140,,,14,11,12,5
Isaac Okoro,F,22023,1630171,22300452,"JAN 01, 2024",CLE @ TOR,L,27,5,10,0.5,0,4,0.0,6,7,0.857,0,1,1,3,2,1,1,4,16,-17,1,CLE,TOR,CLE,121,,,20,17,19,4
Isaac Okoro,F,22023,1630171,22300433,"DEC 29, 2023",CLE vs. MIL,L,30,3,5,0.6,0,1,0.0,2,2,1.0,0,2,2,3,1,1,1,3,8,-10,1,CLE,CLE,MIL,111,,,13,10,11,5
Isaac Okoro,F,22023,1630171,22300420,"DEC 27, 2023",CLE @ DAL,W,39,7,13,0.538,4,7,0.571,4,5,0.8,2,1,3,1,0,1,2,2,22,4,1,CLE,DAL,CLE,113,,,26,25,23,4
Isaac Okoro,F,22023,1630171,22300396,"DEC 23, 2023",CLE @ CHI,W,35,3,9,0.333,0,5,0.0,6,7,0.857,0,3,3,3,0,0,1,2,12,6,1,CLE,CHI,CLE,109,,,18,15,15,6
Isaac Okoro,F,22023,1630171,22300375,"DEC 21, 2023",CLE vs. NOP,L,32,7,10,0.7,2,5,0.4,0,1,0.0,1,2,3,4,1,0,0,2,16,-19,1,CLE,CLE,NOP,104,,,23,19,20,7
Isaac Okoro,F,22023,1630171,22300364,"DEC 20, 2023",CLE vs. UTA,W,25,2,7,0.286,1,3,0.333,0,2,0.0,3,3,6,5,0,0,1,2,5,3,1,CLE,CLE,UTA,124,,,16,11,10,11
Isaac Okoro,F,22023,1630171,22300349,"DEC 18, 2023",CLE vs. HOU,W,32,4,7,0.571,1,2,0.5,2,3,0.667,4,3,7,6,0,1,0,1,11,-2,1,CLE,CLE,HOU,135,,,24,18,17,13
Isaac Okoro,F,22023,1630171,22300336,"DEC 16, 2023",CLE vs. ATL,W,32,6,9,0.667,3,4,0.75,3,4,0.75,3,0,3,3,1,0,0,2,18,-1,1,CLE,CLE,ATL,127,,,24,21,21,6
Isaac Okoro,F,22023,1630171,22300319,"DEC 14, 2023",CLE @ BOS,L,18,2,2,1.0,1,1,1.0,2,2,1.0,1,3,4,2,1,0,1,3,7,4,1,CLE,BOS,CLE,107,,,13,11,9,6
Isaac Okoro,F,22023,1630171,22300305,"DEC 12, 2023",CLE @ BOS,L,16,1,4,0.25,1,2,0.5,0,0,0.0,0,2,2,1,1,0,1,1,3,-15,1,CLE,BOS,CLE,113,,,6,5,4,3
Isaac Okoro,F,22023,1630171,22300294,"DEC 11, 2023",CLE @ ORL,L,26,0,4,0.0,0,4,0.0,1,4,0.25,3,1,4,0,0,0,1,2,1,-21,1,CLE,ORL,CLE,94,,,5,5,1,4
Isaac Okoro,F,22023,1630171,22301220,"DEC 08, 2023",CLE @ MIA,W,22,3,4,0.75,1,2,0.5,2,2,1.0,0,1,1,0,1,1,1,2,9,-12,1,CLE,MIA,CLE,111,,,10,10,9,1
Isaac Okoro,F,22023,1630171,22301205,"DEC 06, 2023",CLE vs. ORL,W,29,0,4,0.0,0,2,0.0,0,0,0.0,0,1,1,1,1,0,0,1,0,16,1,CLE,CLE,ORL,121,,,2,1,1,2
Isaac Okoro,F,22023,1630171,22300283,"DEC 02, 2023",CLE @ DET,W,33,4,7,0.571,1,3,0.333,0,0,0.0,0,6,6,4,4,0,0,3,9,15,1,CLE,DET,CLE,110,,,19,15,13,10
Isaac Okoro,F,22023,1630171,22300265,"NOV 30, 2023",CLE vs. POR,L,17,1,2,0.5,1,1,1.0,0,0,0.0,0,0,0,0,1,0,0,1,3,-12,1,CLE,CLE,POR,95,,,3,3,3,0
Isaac Okoro,F,22023,1630171,22300055,"NOV 28, 2023",CLE vs. ATL,W,16,3,6,0.5,0,1,0.0,0,1,0.0,1,1,2,2,0,2,0,0,6,-3,1,CLE,CLE,ATL,128,,,10,8,8,4
Isaac Okoro,F,22023,1630171,22300251,"NOV 26, 2023",CLE vs. TOR,W,10,1,3,0.333,0,1,0.0,0,0,0.0,0,0,0,0,0,0,1,0,2,-3,1,CLE,CLE,TOR,105,,,2,2,2,0
Isaac Okoro,F,22023,1630171,22300242,"NOV 25, 2023",CLE vs. LAL,L,19,2,3,0.667,0,0,0.0,1,1,1.0,1,2,3,0,0,1,2,1,5,7,1,CLE,CLE,LAL,115,,,8,8,5,3
Isaac Okoro,F,22023,1630171,22300001,"NOV 03, 2023",CLE @ IND,L,23,2,3,0.667,1,1,1.0,0,0,0.0,0,1,1,2,2,0,1,4,5,-19,1,CLE,IND,CLE,116,,,8,6,7,3
Isaac Okoro,F,22023,1630171,22300112,"OCT 31, 2023",CLE vs. NYK,L,25,4,11,0.364,2,5,0.4,1,2,0.5,3,4,7,0,0,0,1,2,11,-9,1,CLE,CLE,NYK,91,,,18,18,11,7
Isaac Okoro,F,22023,1630171,22300091,"OCT 28, 2023",CLE vs. IND,L,35,5,8,0.625,0,0,0.0,1,2,0.5,2,3,5,3,0,1,0,3,11,-2,1,CLE,CLE,IND,113,,,19,16,14,8
Isaac Okoro,F,22023,1630171,22300067,"OCT 25, 2023",CLE @ BKN,W,32,6,10,0.6,2,4,0.5,4,5,0.8,3,3,6,4,2,1,2,5,18,5,1,CLE,BKN,CLE,114,,,28,24,22,10
Isaac Okoro,F,22023,1630171,22300081,"OCT 27, 2023",CLE vs. OKC,L,28,3,8,0.375,1,3,0.333,3,4,0.75,4,3,7,2,2,1,1,3,10,-7,1,CLE,CLE,OKC,105,,,19,17,12,9
Isaac Okoro,F,22023,1630171,22300120,"NOV 01, 2023",CLE @ NYK,W,31,1,3,0.333,0,2,0.0,0,0,0.0,0,3,3,2,1,0,1,6,2,-1,1,CLE,NYK,CLE,95,,,7,5,4,5
Simone Fontecchio,F,22023,1631323,22300711,"FEB 04, 2024",UTA vs. MIL,W,24,4,6,0.667,1,3,0.333,2,2,1.0,2,2,4,1,1,0,1,1,11,-2,1,UTA,UTA,MIL,123,,,16,15,12,5
Simone Fontecchio,F,22023,1631323,22300686,"FEB 01, 2024",UTA vs. PHI,L,27,3,9,0.333,1,6,0.167,0,0,0.0,2,2,4,2,0,0,0,2,7,5,1,UTA,UTA,PHI,124,,,13,11,9,6
Simone Fontecchio,F,22023,1631323,22300671,"JAN 30, 2024",UTA @ NYK,L,29,5,10,0.5,4,8,0.5,0,0,0.0,2,3,5,1,0,1,1,1,14,0,1,UTA,NYK,UTA,103,,,20,19,15,6
Simone Fontecchio,F,22023,1631323,22300660,"JAN 29, 2024",UTA @ BKN,L,22,2,9,0.222,1,4,0.25,0,0,0.0,0,4,4,0,0,1,0,2,5,-11,1,UTA,BKN,UTA,114,,,9,9,5,4
Simone Fontecchio,F,22023,1631323,22300647,"JAN 27, 2024",UTA @ CHA,W,27,2,6,0.333,1,4,0.25,0,0,0.0,1,2,3,3,1,0,0,1,5,8,1,UTA,CHA,UTA,134,,,11,8,8,6
Simone Fontecchio,F,22023,1631323,22300628,"JAN 25, 2024",UTA @ WAS,W,21,4,7,0.571,2,3,0.667,0,0,0.0,2,5,7,2,0,0,0,1,10,11,1,UTA,WAS,UTA,123,,,19,17,12,9
Simone Fontecchio,F,22023,1631323,22300616,"JAN 23, 2024",UTA @ NOP,L,25,6,9,0.667,5,8,0.625,1,1,1.0,0,4,4,2,2,0,1,1,18,-19,1,UTA,NOP,UTA,124,,,24,22,20,6
Simone Fontecchio,F,22023,1631323,22300598,"JAN 20, 2024",UTA @ HOU,L,29,4,7,0.571,2,5,0.4,0,0,0.0,2,5,7,3,0,0,1,2,10,2,1,UTA,HOU,UTA,126,,,20,17,13,10
Simone Fontecchio,F,22023,1631323,22300581,"JAN 18, 2024",UTA vs. OKC,L,29,4,9,0.444,2,7,0.286,2,2,1.0,2,3,5,2,1,0,1,2,12,2,1,UTA,UTA,OKC,129,,,19,17,14,7
Simone Fontecchio,F,22023,1631323,22300564,"JAN 15, 2024",UTA vs. IND,W,24,3,5,0.6,2,3,0.667,0,0,0.0,0,4,4,2,0,0,1,2,8,22,1,UTA,UTA,IND,132,,,14,12,10,6
Simone Fontecchio,F,22023,1631323,22300549,"JAN 13, 2024",UTA vs. LAL,W,24,0,5,0.0,0,3,0.0,0,0,0.0,2,2,4,4,0,0,1,3,0,16,1,UTA,UTA,LAL,132,,,8,4,4,8
Simone Fontecchio,F,22023,1631323,22300540,"JAN 12, 2024",UTA vs. TOR,W,23,5,9,0.556,3,5,0.6,0,0,0.0,1,1,2,0,0,1,0,0,13,10,1,UTA,UTA,TOR,145,,,15,15,13,2
Simone Fontecchio,F,22023,1631323,22300524,"JAN 10, 2024",UTA vs. DEN,W,21,1,5,0.2,1,4,0.25,0,0,0.0,0,0,0,2,0,0,3,0,3,13,1,UTA,UTA,DEN,124,,,5,3,5,2
Simone Fontecchio,F,22023,1631323,22300510,"JAN 08, 2024",UTA @ MIL,W,32,2,6,0.333,1,5,0.2,0,0,0.0,0,3,3,1,1,1,1,4,5,4,1,UTA,MIL,UTA,132,,,9,8,6,4
Simone Fontecchio,F,22023,1631323,22300495,"JAN 06, 2024",UTA @ PHI,W,33,3,9,0.333,1,6,0.167,0,0,0.0,1,6,7,2,1,0,4,1,7,6,1,UTA,PHI,UTA,120,,,16,14,9,9
Simone Fontecchio,F,22023,1631323,22300479,"JAN 05, 2024",UTA @ BOS,L,25,2,7,0.286,2,5,0.4,1,2,0.5,1,3,4,3,1,0,2,2,7,-13,1,UTA,BOS,UTA,97,,,14,11,10,7
Simone Fontecchio,F,22023,1631323,22300474,"JAN 03, 2024",UTA vs. DET,W,35,6,11,0.545,3,4,0.75,1,1,1.0,2,5,7,4,2,0,0,2,16,13,1,UTA,UTA,DET,154,,,27,23,20,11
Simone Fontecchio,F,22023,1631323,22300457,"JAN 01, 2024",UTA vs. DAL,W,29,10,16,0.625,3,8,0.375,1,1,1.0,0,6,6,2,2,1,1,0,24,27,1,UTA,UTA,DAL,127,,,32,30,26,8
Simone Fontecchio,F,22023,1631323,22300439,"DEC 30, 2023",UTA vs. MIA,W,31,4,9,0.444,1,5,0.2,3,6,0.5,3,4,7,2,2,1,0,4,12,7,1,UTA,UTA,MIA,117,,,21,19,14,9
Simone Fontecchio,F,22023,1631323,22300424,"DEC 28, 2023",UTA @ NOP,L,14,2,4,0.5,1,2,0.5,0,0,0.0,2,0,2,0,1,0,1,4,5,-13,1,UTA,NOP,UTA,105,,,7,7,5,2
Simone Fontecchio,F,22023,1631323,22300412,"DEC 26, 2023",UTA @ SAS,W,23,3,5,0.6,2,4,0.5,0,0,0.0,1,2,3,0,0,0,1,1,8,25,1,UTA,SAS,UTA,130,,,11,11,8,3
Simone Fontecchio,F,22023,1631323,22300395,"DEC 23, 2023",UTA @ TOR,W,20,2,3,0.667,2,3,0.667,0,0,0.0,1,0,1,0,1,0,3,3,6,0,1,UTA,TOR,UTA,126,,,7,7,6,1
Simone Fontecchio,F,22023,1631323,22300374,"DEC 21, 2023",UTA @ DET,W,29,6,12,0.5,4,7,0.571,0,0,0.0,0,2,2,0,1,0,0,1,16,2,1,UTA,DET,UTA,119,,,18,18,16,2
Simone Fontecchio,F,22023,1631323,22300364,"DEC 20, 2023",UTA @ CLE,L,36,3,7,0.429,2,5,0.4,1,2,0.5,1,6,7,2,0,0,2,3,9,8,1,UTA,CLE,UTA,116,,,18,16,11,9
Simone Fontecchio,F,22023,1631323,22300357,"DEC 18, 2023",UTA vs. BKN,W,25,1,7,0.143,0,3,0.0,0,0,0.0,2,2,4,3,2,0,1,3,2,9,1,UTA,UTA,BKN,125,,,9,6,5,7
Simone Fontecchio,F,22023,1631323,22300342,"DEC 16, 2023",UTA @ SAC,L,25,3,9,0.333,1,5,0.2,0,0,0.0,0,2,2,0,0,0,0,0,7,-23,1,UTA,SAC,UTA,104,,,9,9,7,2
Simone Fontecchio,F,22023,1631323,22300323,"DEC 14, 2023",UTA @ POR,W,25,7,8,0.875,5,5,1.0,5,5,1.0,1,4,5,0,1,0,0,0,24,24,1,UTA,POR,UTA,122,,,29,29,24,5
Simone Fontecchio,F,22023,1631323,22300318,"DEC 13, 2023",UTA vs. NYK,W,31,4,12,0.333,3,10,0.3,4,4,1.0,3,3,6,2,2,0,2,4,15,-10,1,UTA,UTA,NYK,117,,,23,21,17,8
Simone Fontecchio,F,22023,1631323,22300302,"DEC 11, 2023",UTA @ OKC,L,23,7,11,0.636,3,6,0.5,2,2,1.0,1,1,2,1,0,4,0,1,19,-13,1,UTA,OKC,UTA,120,,,22,21,20,3
Simone Fontecchio,F,22023,1631323,22301225,"DEC 08, 2023",UTA vs. LAC,L,31,3,8,0.375,2,5,0.4,0,2,0.0,0,2,2,0,0,0,2,4,8,-19,1,UTA,UTA,LAC,103,,,10,10,8,2
Simone Fontecchio,F,22023,1631323,22301213,"DEC 06, 2023",UTA @ DAL,L,24,2,5,0.4,1,3,0.333,2,2,1.0,0,2,2,3,0,1,1,1,7,-40,1,UTA,DAL,UTA,97,,,12,9,10,5
Simone Fontecchio,F,22023,1631323,22300289,"DEC 02, 2023",UTA vs. POR,W,35,3,12,0.25,1,8,0.125,0,0,0.0,1,4,5,5,0,2,2,2,7,-4,1,UTA,UTA,POR,118,,,17,12,12,10
Simone Fontecchio,F,22023,1631323,22300270,"NOV 30, 2023",UTA @ MIN,L,34,6,12,0.5,2,7,0.286,2,2,1.0,3,2,5,5,1,0,2,3,16,-11,1,UTA,MIN,UTA,90,,,26,21,21,10
Simone Fontecchio,F,22023,1631323,22300261,"NOV 29, 2023",UTA @ MEM,L,25,4,13,0.308,4,8,0.5,0,0,0.0,0,4,4,4,1,0,0,1,12,-10,1,UTA,MEM,UTA,91,,,20,16,16,8
Simone Fontecchio,F,22023,1631323,22300256,"NOV 27, 2023",UTA vs. NOP,W,28,4,9,0.444,3,8,0.375,3,4,0.75,0,4,4,2,2,0,0,3,14,-1,1,UTA,UTA,NOP,114,,,20,18,16,6
Simone Fontecchio,F,22023,1631323,22300243,"NOV 25, 2023",UTA vs. NOP,W,26,3,8,0.375,2,7,0.286,2,2,1.0,0,3,3,0,0,1,2,1,10,0,1,UTA,UTA,NOP,105,,,13,13,10,3
Simone Fontecchio,F,22023,1631323,22300237,"NOV 22, 2023",UTA @ POR,L,16,3,7,0.429,2,6,0.333,0,0,0.0,1,0,1,1,1,0,1,1,8,-8,1,UTA,POR,UTA,105,,,10,9,9,2
Simone Fontecchio,F,22023,1631323,22300042,"NOV 21, 2023",UTA @ LAL,L,27,4,6,0.667,3,5,0.6,0,0,0.0,2,2,4,0,0,1,1,3,11,-6,1,UTA,LAL,UTA,99,,,15,15,11,4
Simone Fontecchio,F,22023,1631323,22300214,"NOV 19, 2023",UTA vs. PHX,L,18,1,3,0.333,1,1,1.0,0,0,0.0,1,0,1,0,0,1,1,1,3,4,1,UTA,UTA,PHX,137,,,4,4,3,1
Simone Fontecchio,F,22023,1631323,22300035,"NOV 17, 2023",UTA vs. PHX,L,15,3,5,0.6,2,4,0.5,0,0,0.0,0,1,1,0,0,0,1,2,8,-2,1,UTA,UTA,PHX,128,,,9,9,8,1
Simone Fontecchio,F,22023,1631323,22300023,"NOV 14, 2023",UTA vs. POR,W,16,0,2,0.0,0,2,0.0,0,0,0.0,0,1,1,0,0,0,0,2,0,11,1,UTA,UTA,POR,115,,,1,1,0,1
Simone Fontecchio,F,22023,1631323,22300012,"NOV 10, 2023",UTA @ MEM,W,12,2,3,0.667,2,2,1.0,0,0,0.0,1,1,2,1,2,0,1,2,6,-8,1,UTA,MEM,UTA,127,,,9,8,7,3
Simone Fontecchio,F,22023,1631323,22300158,"NOV 08, 2023",UTA @ IND,L,18,4,8,0.5,2,5,0.4,0,0,0.0,3,2,5,1,0,1,2,2,10,-15,1,UTA,IND,UTA,118,,,16,15,11,6
Simone Fontecchio,F,22023,1631323,22300152,"NOV 06, 2023",UTA @ CHI,L,4,0,2,0.0,0,2,0.0,0,0,0.0,0,0,0,0,0,0,1,0,0,5,1,UTA,CHI,UTA,113,,,0,0,0,0
Simone Fontecchio,F,22023,1631323,22300138,"NOV 04, 2023",UTA @ MIN,L,10,2,3,0.667,1,1,1.0,0,0,0.0,0,2,2,0,0,0,1,0,5,-7,1,UTA,MIN,UTA,95,,,7,7,5,2
Simone Fontecchio,F,22023,1631323,22300130,"NOV 02, 2023",UTA vs. ORL,L,7,0,1,0.0,0,1,0.0,0,0,0.0,0,2,2,0,0,0,0,0,0,5,1,UTA,UTA,ORL,113,,,2,2,0,2
Simone Fontecchio,F,22023,1631323,22300125,"NOV 01, 2023",UTA vs. MEM,W,8,2,5,0.4,1,3,0.333,0,0,0.0,0,1,1,1,0,0,1,1,5,-3,1,UTA,UTA,MEM,133,,,7,6,6,2
Simone Fontecchio,F,22023,1631323,22300094,"OCT 28, 2023",UTA @ PHX,L,18,5,8,0.625,3,6,0.5,0,0,0.0,1,2,3,0,0,1,2,1,13,6,1,UTA,PHX,UTA,104,,,16,16,13,3
Simone Fontecchio,F,22023,1631323,22300072,"OCT 25, 2023",UTA vs. SAC,L,2,1,2,0.5,0,1,0.0,0,0,0.0,1,0,1,1,0,0,0,0,2,2,1,UTA,UTA,SAC,114,,,4,3,3,2
Simone Fontecchio,F,22023,1631323,22300749,"FEB 10, 2024",DET @ LAC,L,32,8,19,0.421,3,9,0.333,1,1,1.0,2,7,9,1,1,0,1,1,20,-5,1,DET,LAC,DET,106,,,30,29,21,10
Simone Fontecchio,F,22023,1631323,22300724,"FEB 06, 2024",UTA vs. OKC,W,25,1,4,0.25,0,2,0.0,0,0,0.0,3,3,6,3,1,0,2,0,2,0,1,UTA,UTA,OKC,124,,,11,8,5,9
Chris Paul,G,22023,101108,22300490,"JAN 05, 2024",GSW vs. DET,W,24,3,5,0.6,2,4,0.5,0,1,0.0,0,6,6,4,0,1,1,2,8,2,1,GSW,GSW,DET,113,,,18,14,12,10
Chris Paul,G,22023,101108,22300478,"JAN 04, 2024",GSW vs. DEN,L,30,4,7,0.571,1,3,0.333,0,1,0.0,1,3,4,6,0,0,0,2,9,4,1,GSW,GSW,DEN,127,,,19,13,15,10
Chris Paul,G,22023,101108,22300463,"JAN 02, 2024",GSW vs. ORL,W,30,3,5,0.6,3,3,1.0,3,4,0.75,0,2,2,4,0,0,1,1,12,-8,1,GSW,GSW,ORL,121,,,18,14,16,6
Chris Paul,G,22023,101108,22300444,"DEC 30, 2023",GSW vs. DAL,L,33,9,14,0.643,6,9,0.667,0,0,0.0,0,2,2,6,2,1,0,2,24,-10,1,GSW,GSW,DAL,122,,,32,26,30,8
Chris Paul,G,22023,101108,22300426,"DEC 28, 2023",GSW vs. MIA,L,27,3,6,0.5,1,4,0.25,2,2,1.0,0,4,4,4,0,0,3,4,9,-8,1,GSW,GSW,MIA,102,,,17,13,13,8
Chris Paul,G,22023,101108,22300402,"DEC 25, 2023",GSW @ DEN,L,28,5,10,0.5,3,5,0.6,0,0,0.0,1,2,3,3,0,0,1,1,13,13,1,GSW,DEN,GSW,114,,,19,16,16,6
Chris Paul,G,22023,101108,22300399,"DEC 23, 2023",GSW vs. POR,W,27,1,4,0.25,0,2,0.0,0,0,0.0,0,3,3,11,3,0,1,1,2,9,1,GSW,GSW,POR,126,,,16,5,13,14
Chris Paul,G,22023,101108,22300386,"DEC 22, 2023",GSW vs. WAS,W,25,2,7,0.286,0,3,0.0,0,1,0.0,0,7,7,10,1,0,1,2,4,27,1,GSW,GSW,WAS,129,,,21,11,14,17
Chris Paul,G,22023,101108,22300362,"DEC 19, 2023",GSW vs. BOS,W,35,4,12,0.333,1,5,0.2,0,0,0.0,1,6,7,12,0,0,0,2,9,9,1,GSW,GSW,BOS,132,,,28,16,21,19
Chris Paul,G,22023,101108,22300348,"DEC 17, 2023",GSW @ POR,W,32,2,7,0.286,0,4,0.0,0,0,0.0,1,3,4,8,1,0,2,1,4,-4,1,GSW,POR,GSW,118,,,16,8,12,12
Chris Paul,G,22023,101108,22300339,"DEC 16, 2023",GSW vs. BKN,W,30,1,4,0.25,0,2,0.0,0,0,0.0,0,4,4,11,0,0,3,2,2,3,1,GSW,GSW,BKN,124,,,17,6,13,15
Chris Paul,G,22023,101108,22300325,"DEC 14, 2023",GSW @ LAC,L,29,4,9,0.444,2,5,0.4,2,2,1.0,0,2,2,3,0,0,2,4,12,-11,1,GSW,LAC,GSW,113,,,17,14,15,5
Chris Paul,G,22023,101108,22300308,"DEC 12, 2023",GSW @ PHX,L,30,5,8,0.625,3,4,0.75,2,3,0.667,0,5,5,11,2,0,1,4,15,12,1,GSW,PHX,GSW,116,,,31,20,26,16
Chris Paul,G,22023,101108,22301214,"DEC 06, 2023",GSW vs. POR,W,20,1,4,0.25,0,2,0.0,0,0,0.0,1,2,3,6,0,0,2,2,2,-4,1,GSW,GSW,POR,110,,,11,5,8,9
Chris Paul,G,22023,101108,22300060,"NOV 28, 2023",GSW @ SAC,L,5,1,2,0.5,1,2,0.5,0,0,0.0,0,0,0,0,2,0,0,1,3,0,1,GSW,SAC,GSW,123,,,3,3,3,0
Chris Paul,G,22023,101108,22300051,"NOV 24, 2023",GSW vs. SAS,W,29,2,6,0.333,1,3,0.333,0,0,0.0,0,5,5,10,0,0,1,2,5,16,1,GSW,GSW,SAS,118,,,20,10,15,15
Chris Paul,G,22023,101108,22300236,"NOV 22, 2023",GSW @ PHX,L,17,1,2,0.5,0,1,0.0,4,4,1.0,0,2,2,6,0,0,1,1,6,-18,1,GSW,PHX,GSW,115,,,14,8,12,8
Chris Paul,G,22023,101108,22300224,"NOV 20, 2023",GSW vs. HOU,W,34,4,7,0.571,3,5,0.6,4,4,1.0,1,5,6,12,2,0,1,4,15,12,1,GSW,GSW,HOU,121,,,33,21,27,18
Chris Paul,G,22023,101108,22300207,"NOV 18, 2023",GSW vs. OKC,L,38,4,9,0.444,4,7,0.571,0,0,0.0,1,3,4,11,3,0,0,3,12,3,1,GSW,GSW,OKC,123,,,27,16,23,15
Chris Paul,G,22023,101108,22300186,"NOV 12, 2023",GSW vs. MIN,L,22,0,3,0.0,0,2,0.0,2,2,1.0,0,1,1,5,0,0,2,4,2,-1,1,GSW,GSW,MIN,110,,,8,3,7,6
Chris Paul,G,22023,101108,22300176,"NOV 11, 2023",GSW vs. CLE,L,26,4,7,0.571,1,2,0.5,0,0,0.0,0,3,3,9,3,0,3,2,9,-12,1,GSW,GSW,CLE,110,,,21,12,18,12
Chris Paul,G,22023,101108,22300169,"NOV 08, 2023",GSW @ DEN,L,27,4,10,0.4,1,4,0.25,0,0,0.0,1,4,5,4,1,0,1,2,9,5,1,GSW,DEN,GSW,105,,,18,14,13,9
Chris Paul,G,22023,101108,22300145,"NOV 06, 2023",GSW @ DET,W,21,6,9,0.667,2,3,0.667,3,3,1.0,0,5,5,6,0,0,0,0,17,13,1,GSW,DET,GSW,120,,,28,22,23,11
Chris Paul,G,22023,101108,22300142,"NOV 05, 2023",GSW @ CLE,L,25,2,10,0.2,1,5,0.2,0,0,0.0,0,1,1,2,2,0,0,3,5,-12,1,GSW,CLE,GSW,104,,,8,6,7,3
Chris Paul,G,22023,101108,22300005,"NOV 03, 2023",GSW @ OKC,W,28,0,6,0.0,0,2,0.0,1,2,0.5,0,2,2,13,2,0,0,1,1,6,1,GSW,OKC,GSW,141,,,16,3,14,15
Chris Paul,G,22023,101108,22300126,"NOV 01, 2023",GSW vs. SAC,W,28,1,5,0.2,0,3,0.0,0,0,0.0,1,3,4,8,0,0,0,2,2,5,1,GSW,GSW,SAC,102,,,14,6,10,12
Chris Paul,G,22023,101108,22300108,"OCT 30, 2023",GSW @ NOP,W,25,6,10,0.6,1,5,0.2,0,0,0.0,0,6,6,5,2,0,1,0,13,17,1,GSW,NOP,GSW,130,,,24,19,18,11
Chris Paul,G,22023,101108,22300096,"OCT 29, 2023",GSW @ HOU,W,27,3,8,0.375,0,3,0.0,2,2,1.0,0,5,5,7,1,0,1,1,8,22,1,GSW,HOU,GSW,106,,,20,13,15,12
Chris Paul,G,22023,101108,22300087,"OCT 27, 2023",GSW @ SAC,W,33,5,12,0.417,0,2,0.0,0,0,0.0,0,2,2,12,3,0,3,2,10,2,1,GSW,SAC,GSW,122,,,24,12,22,14
Chris Paul,G,22023,101108,22300062,"OCT 24, 2023",GSW vs. PHX,L,34,4,15,0.267,0,6,0.0,6,7,0.857,1,5,6,9,2,0,1,0,14,5,1,GSW,GSW,PHX,104,,,29,20,23,15
Chris Paul,G,22023,101108,22300025,"NOV 14, 2023",GSW vs. MIN,L,36,6,14,0.429,2,3,0.667,1,1,1.0,0,5,5,4,3,1,4,0,15,-9,1,GSW,GSW,MIN,101,,,24,20,19,9
Chris Paul,G,22023,101108,22300201,"NOV 16, 2023",GSW vs. OKC,L,28,4,8,0.5,4,6,0.667,3,3,1.0,0,3,3,8,1,0,1,1,15,-3,1,GSW,GSW,OKC,109,,,26,18,23,11
Markelle Fultz,G,22023,1628365,22300752,"FEB 10, 2024",ORL vs. CHI,W,17,2,7,0.286,0,2,0.0,1,1,1.0,0,6,6,3,1,0,1,1,5,-13,1,ORL,ORL,CHI,114,,,14,11,8,9
Markelle Fultz,G,22023,1628365,22300734,"FEB 08, 2024",ORL vs. SAS,W,25,1,4,0.25,0,0,0.0,0,0,0.0,3,2,5,4,2,0,1,2,2,22,1,ORL,ORL,SAS,127,,,11,7,6,9
Markelle Fultz,G,22023,1628365,22300721,"FEB 06, 2024",ORL @ MIA,L,28,5,10,0.5,1,2,0.5,2,2,1.0,1,0,1,4,1,1,2,3,13,-9,1,ORL,MIA,ORL,95,,,18,14,17,5
Markelle Fultz,G,22023,1628365,22300704,"FEB 04, 2024",ORL @ DET,W,23,4,9,0.444,0,0,0.0,0,0,0.0,1,3,4,2,0,0,1,3,8,3,1,ORL,DET,ORL,111,,,14,12,10,6
Markelle Fultz,G,22023,1628365,22300694,"FEB 02, 2024",ORL @ MIN,W,23,5,9,0.556,0,0,0.0,0,0,0.0,0,3,3,5,2,1,1,1,10,4,1,ORL,MIN,ORL,108,,,18,13,15,8
Markelle Fultz,G,22023,1628365,22300681,"JAN 31, 2024",ORL @ SAS,W,31,5,11,0.455,0,0,0.0,1,2,0.5,3,4,7,4,2,0,0,0,11,3,1,ORL,SAS,ORL,108,,,22,18,15,11
Markelle Fultz,G,22023,1628365,22300655,"JAN 28, 2024",ORL vs. PHX,W,27,7,10,0.7,0,0,0.0,0,0,0.0,1,1,2,4,5,0,0,3,14,1,1,ORL,ORL,PHX,113,,,20,16,18,6
Markelle Fultz,G,22023,1628365,22300638,"JAN 26, 2024",ORL @ MEM,L,21,5,7,0.714,0,0,0.0,0,0,0.0,1,2,3,3,0,0,1,1,10,-2,1,ORL,MEM,ORL,106,,,16,13,13,6
Markelle Fultz,G,22023,1628365,22300601,"JAN 21, 2024",ORL vs. MIA,W,29,6,8,0.75,0,0,0.0,0,0,0.0,1,0,1,4,2,2,2,3,12,21,1,ORL,ORL,MIA,105,,,17,13,16,5
Markelle Fultz,G,22023,1628365,22300585,"JAN 19, 2024",ORL vs. PHI,L,22,3,6,0.5,0,0,0.0,1,1,1.0,1,0,1,3,0,0,1,3,7,-9,1,ORL,ORL,PHI,109,,,11,8,10,4
Markelle Fultz,G,22023,1628365,22300570,"JAN 17, 2024",ORL @ ATL,L,30,5,8,0.625,0,0,0.0,0,0,0.0,1,3,4,1,3,0,4,5,10,-8,1,ORL,ATL,ORL,104,,,15,14,11,5
Markelle Fultz,G,22023,1628365,22300557,"JAN 15, 2024",ORL @ NYK,W,23,3,8,0.375,0,0,0.0,0,0,0.0,1,4,5,7,0,0,0,2,6,11,1,ORL,NYK,ORL,98,,,18,11,13,12
Markelle Fultz,G,22023,1628365,22300535,"JAN 12, 2024",ORL @ MIA,L,17,1,2,0.5,0,0,0.0,1,2,0.5,2,1,3,3,2,1,2,2,3,-6,1,ORL,MIA,ORL,96,,,9,6,6,6
Markelle Fultz,G,22023,1628365,22300513,"JAN 09, 2024",ORL vs. MIN,L,13,2,7,0.286,0,0,0.0,0,0,0.0,1,2,3,2,0,0,0,0,4,-3,1,ORL,ORL,MIN,92,,,9,7,6,5
Markelle Fultz,G,22023,1628365,22300499,"JAN 07, 2024",ORL vs. ATL,W,15,0,2,0.0,0,0,0.0,0,4,0.0,0,2,2,4,1,0,1,0,0,-6,1,ORL,ORL,ATL,117,,,6,2,4,6
Markelle Fultz,G,22023,1628365,22300172,"NOV 09, 2023",ORL vs. ATL,L,29,5,12,0.417,0,0,0.0,3,3,1.0,2,0,2,3,1,0,1,1,13,-2,1,ORL,ORL,ATL,119,,,18,15,16,5
Markelle Fultz,G,22023,1628365,22300114,"OCT 31, 2023",ORL @ LAC,L,32,6,11,0.545,0,0,0.0,0,1,0.0,1,4,5,1,1,0,2,3,12,-16,1,ORL,LAC,ORL,102,,,18,17,13,6
Markelle Fultz,G,22023,1628365,22300111,"OCT 30, 2023",ORL @ LAL,L,33,7,16,0.438,0,1,0.0,0,0,0.0,1,3,4,8,1,2,1,2,14,0,1,ORL,LAL,ORL,103,,,26,18,22,12
Markelle Fultz,G,22023,1628365,22300086,"OCT 27, 2023",ORL @ POR,W,25,4,8,0.5,0,2,0.0,0,0,0.0,1,1,2,6,0,0,1,0,8,11,1,ORL,POR,ORL,102,,,16,10,14,8
Markelle Fultz,G,22023,1628365,22300066,"OCT 25, 2023",ORL vs. HOU,W,25,5,9,0.556,0,0,0.0,0,0,0.0,3,1,4,2,3,0,1,0,10,12,1,ORL,ORL,HOU,116,,,16,14,12,6
Moses Moody,G,22023,1630541,22300733,"FEB 08, 2024",GSW @ IND,W,13,2,3,0.667,1,1,1.0,0,0,0.0,0,3,3,1,2,1,1,1,5,8,1,GSW,IND,GSW,131,,,9,8,6,4
Moses Moody,G,22023,1630541,22300727,"FEB 07, 2024",GSW @ PHI,W,19,3,8,0.375,2,7,0.286,0,0,0.0,1,1,2,3,0,2,1,0,8,1,1,GSW,PHI,GSW,127,,,13,10,11,5
Moses Moody,G,22023,1630541,22300717,"FEB 05, 2024",GSW @ BKN,W,15,2,5,0.4,0,1,0.0,0,0,0.0,1,0,1,0,0,1,1,0,4,5,1,GSW,BKN,GSW,109,,,5,5,4,1
Moses Moody,G,22023,1630541,22300525,"JAN 10, 2024",GSW vs. NOP,L,25,8,18,0.444,4,8,0.5,1,1,1.0,1,1,2,0,1,0,0,3,21,-7,1,GSW,GSW,NOP,105,,,23,23,21,2
Moses Moody,G,22023,1630541,22300504,"JAN 07, 2024",GSW vs. TOR,L,22,7,9,0.778,4,6,0.667,3,3,1.0,0,3,3,1,1,0,1,1,21,-2,1,GSW,GSW,TOR,118,,,25,24,22,4
Moses Moody,G,22023,1630541,22300490,"JAN 05, 2024",GSW vs. DET,W,6,0,2,0.0,0,1,0.0,0,0,0.0,0,1,1,0,0,0,0,1,0,-4,1,GSW,GSW,DET,113,,,1,1,0,1
Moses Moody,G,22023,1630541,22300426,"DEC 28, 2023",GSW vs. MIA,L,13,4,8,0.5,0,2,0.0,3,3,1.0,1,2,3,0,0,2,0,1,11,10,1,GSW,GSW,MIA,102,,,14,14,11,3
Moses Moody,G,22023,1630541,22300402,"DEC 25, 2023",GSW @ DEN,L,3,0,0,0.0,0,0,0.0,0,0,0.0,0,0,0,0,0,0,0,0,0,-8,1,GSW,DEN,GSW,114,,,0,0,0,0
Moses Moody,G,22023,1630541,22300399,"DEC 23, 2023",GSW vs. POR,W,17,4,6,0.667,1,2,0.5,2,2,1.0,0,1,1,1,1,1,2,3,11,6,1,GSW,GSW,POR,126,,,13,12,12,2
Moses Moody,G,22023,1630541,22300386,"DEC 22, 2023",GSW vs. WAS,W,19,1,4,0.25,0,3,0.0,3,4,0.75,1,2,3,0,1,0,2,1,5,8,1,GSW,GSW,WAS,129,,,8,8,5,3
Moses Moody,G,22023,1630541,22300362,"DEC 19, 2023",GSW vs. BOS,W,17,3,9,0.333,2,6,0.333,2,2,1.0,0,0,0,0,0,0,0,0,10,3,1,GSW,GSW,BOS,132,,,10,10,10,0
Moses Moody,G,22023,1630541,22300348,"DEC 17, 2023",GSW @ POR,W,19,3,7,0.429,0,2,0.0,0,0,0.0,2,2,4,1,1,0,1,0,6,9,1,GSW,POR,GSW,118,,,11,10,7,5
Moses Moody,G,22023,1630541,22300339,"DEC 16, 2023",GSW vs. BKN,W,14,1,3,0.333,0,0,0.0,0,0,0.0,2,1,3,1,0,0,0,0,2,-2,1,GSW,GSW,BKN,124,,,6,5,3,4
Moses Moody,G,22023,1630541,22300325,"DEC 14, 2023",GSW @ LAC,L,16,4,6,0.667,0,1,0.0,3,4,0.75,2,3,5,1,1,0,2,1,11,4,1,GSW,LAC,GSW,113,,,17,16,12,6
Moses Moody,G,22023,1630541,22300308,"DEC 12, 2023",GSW @ PHX,L,24,3,6,0.5,2,3,0.667,4,6,0.667,1,3,4,0,0,0,2,3,12,-15,1,GSW,PHX,GSW,116,,,16,16,12,4
Moses Moody,G,22023,1630541,22301222,"DEC 08, 2023",GSW @ OKC,L,16,1,6,0.167,0,4,0.0,0,0,0.0,2,2,4,0,0,0,2,4,2,-7,1,GSW,OKC,GSW,136,,,6,6,2,4
Moses Moody,G,22023,1630541,22301214,"DEC 06, 2023",GSW vs. POR,W,26,5,10,0.5,1,4,0.25,1,1,1.0,2,2,4,0,1,1,1,2,12,3,1,GSW,GSW,POR,110,,,16,16,12,4
Moses Moody,G,22023,1630541,22300280,"DEC 02, 2023",GSW @ LAC,L,32,5,13,0.385,2,5,0.4,9,10,0.9,3,2,5,2,2,0,0,3,21,-1,1,GSW,LAC,GSW,112,,,28,26,23,7
Moses Moody,G,22023,1630541,22300273,"NOV 30, 2023",GSW vs. LAC,W,28,6,10,0.6,1,4,0.25,0,0,0.0,2,1,3,1,0,1,0,2,13,-9,1,GSW,GSW,LAC,120,,,17,16,14,4
Moses Moody,G,22023,1630541,22300060,"NOV 28, 2023",GSW @ SAC,L,13,4,4,1.0,3,3,1.0,0,0,0.0,1,0,1,2,0,0,0,1,11,-2,1,GSW,SAC,GSW,123,,,14,12,13,3
Moses Moody,G,22023,1630541,22300051,"NOV 24, 2023",GSW vs. SAS,W,17,4,4,1.0,1,1,1.0,0,2,0.0,2,2,4,1,0,0,2,0,9,-6,1,GSW,GSW,SAS,118,,,14,13,10,5
Moses Moody,G,22023,1630541,22300236,"NOV 22, 2023",GSW @ PHX,L,23,4,8,0.5,0,1,0.0,0,1,0.0,1,8,9,1,0,1,1,5,8,-3,1,GSW,PHX,GSW,115,,,18,17,9,10
Moses Moody,G,22023,1630541,22300224,"NOV 20, 2023",GSW vs. HOU,W,22,3,7,0.429,1,3,0.333,0,0,0.0,2,2,4,0,0,0,0,2,7,3,1,GSW,GSW,HOU,121,,,11,11,7,4
Moses Moody,G,22023,1630541,22300207,"NOV 18, 2023",GSW vs. OKC,L,18,1,4,0.25,0,3,0.0,4,4,1.0,2,2,4,1,1,0,2,2,6,-8,1,GSW,GSW,OKC,123,,,11,10,7,5
Moses Moody,G,22023,1630541,22300186,"NOV 12, 2023",GSW vs. MIN,L,13,1,6,0.167,0,4,0.0,0,0,0.0,1,2,3,0,0,0,1,1,2,-10,1,GSW,GSW,MIN,110,,,5,5,2,3
Moses Moody,G,22023,1630541,22300176,"NOV 11, 2023",GSW vs. CLE,L,18,2,4,0.5,2,3,0.667,2,2,1.0,1,4,5,1,0,0,1,3,8,2,1,GSW,GSW,CLE,110,,,14,13,9,6
Moses Moody,G,22023,1630541,22300169,"NOV 08, 2023",GSW @ DEN,L,14,4,7,0.571,2,3,0.667,0,0,0.0,0,3,3,1,1,0,0,0,10,6,1,GSW,DEN,GSW,105,,,14,13,11,4
Moses Moody,G,22023,1630541,22300145,"NOV 06, 2023",GSW @ DET,W,19,2,6,0.333,0,2,0.0,0,0,0.0,1,1,2,2,3,0,0,0,4,8,1,GSW,DET,GSW,120,,,8,6,6,4
Moses Moody,G,22023,1630541,22300142,"NOV 05, 2023",GSW @ CLE,L,14,1,3,0.333,0,2,0.0,1,2,0.5,1,2,3,0,1,0,0,1,3,-1,1,GSW,CLE,GSW,104,,,6,6,3,3
Moses Moody,G,22023,1630541,22300005,"NOV 03, 2023",GSW @ OKC,W,18,3,7,0.429,2,5,0.4,0,0,0.0,1,0,1,2,1,0,1,3,8,4,1,GSW,OKC,GSW,141,,,11,9,10,3
Moses Moody,G,22023,1630541,22300126,"NOV 01, 2023",GSW vs. SAC,W,15,0,3,0.0,0,2,0.0,1,2,0.5,0,3,3,0,0,1,0,1,1,-5,1,GSW,GSW,SAC,102,,,4,4,1,3
Moses Moody,G,22023,1630541,22300108,"OCT 30, 2023",GSW @ NOP,W,21,5,8,0.625,2,5,0.4,1,1,1.0,2,1,3,4,0,0,0,0,13,18,1,GSW,NOP,GSW,130,,,20,16,17,7
Moses Moody,G,22023,1630541,22300096,"OCT 29, 2023",GSW @ HOU,W,17,1,6,0.167,1,5,0.2,2,2,1.0,0,3,3,1,0,1,0,1,5,11,1,GSW,HOU,GSW,106,,,9,8,6,4
Moses Moody,G,22023,1630541,22300087,"OCT 27, 2023",GSW @ SAC,W,21,4,5,0.8,2,3,0.667,0,0,0.0,0,3,3,1,3,0,1,0,10,11,1,GSW,SAC,GSW,122,,,14,13,11,4
Moses Moody,G,22023,1630541,22300062,"OCT 24, 2023",GSW vs. PHX,L,18,4,6,0.667,2,4,0.5,1,2,0.5,1,2,3,0,3,1,1,1,11,-6,1,GSW,GSW,PHX,104,,,14,14,11,3
Moses Moody,G,22023,1630541,22300025,"NOV 14, 2023",GSW vs. MIN,L,14,4,6,0.667,1,2,0.5,2,2,1.0,1,1,2,2,1,0,0,0,11,-12,1,GSW,GSW,MIN,101,,,15,13,13,4
Moses Moody,G,22023,1630541,22300201,"NOV 16, 2023",GSW vs. OKC,L,23,5,11,0.455,2,4,0.5,0,1,0.0,2,2,4,1,0,1,1,1,12,-4,1,GSW,GSW,OKC,109,,,17,16,13,5
Isaiah Joe,G,22023,1630198,22300622,"JAN 24, 2024",OKC @ SAS,W,13,3,5,0.6,3,5,0.6,0,0,0.0,1,0,1,0,0,1,0,0,9,17,1,OKC,SAS,OKC,140,6.0,Points,10,10,9,1
Isaiah Joe,G,22023,1630198,22300622,"JAN 24, 2024",OKC @ SAS,W,13,3,5,0.6,3,5,0.6,0,0,0.0,1,0,1,0,0,1,0,0,9,17,1,OKC,SAS,OKC,140,1.5,3-PT Made,10,10,9,1
Isaiah Joe,G,22023,1630198,22300622,"JAN 24, 2024",OKC @ SAS,W,13,3,5,0.6,3,5,0.6,0,0,0.0,1,0,1,0,0,1,0,0,9,17,1,OKC,SAS,OKC,140,0.5,Blks+Stls,10,10,9,1
Isaiah Joe,G,22023,1630198,22300617,"JAN 23, 2024",OKC vs. POR,W,20,4,5,0.8,1,2,0.5,0,0,0.0,0,1,1,2,0,0,0,2,9,3,1,OKC,OKC,POR,111,6.0,Points,12,10,11,3
Isaiah Joe,G,22023,1630198,22300617,"JAN 23, 2024",OKC vs. POR,W,20,4,5,0.8,1,2,0.5,0,0,0.0,0,1,1,2,0,0,0,2,9,3,1,OKC,OKC,POR,111,1.5,3-PT Made,12,10,11,3
Isaiah Joe,G,22023,1630198,22300617,"JAN 23, 2024",OKC vs. POR,W,20,4,5,0.8,1,2,0.5,0,0,0.0,0,1,1,2,0,0,0,2,9,3,1,OKC,OKC,POR,111,0.5,Blks+Stls,12,10,11,3
Isaiah Joe,G,22023,1630198,22300481,"JAN 05, 2024",OKC @ BKN,L,20,1,5,0.2,1,3,0.333,0,0,0.0,0,1,1,1,0,1,1,1,3,3,1,OKC,BKN,OKC,115,6.0,Points,5,4,4,2
Isaiah Joe,G,22023,1630198,22300481,"JAN 05, 2024",OKC @ BKN,L,20,1,5,0.2,1,3,0.333,0,0,0.0,0,1,1,1,0,1,1,1,3,3,1,OKC,BKN,OKC,115,1.5,3-PT Made,5,4,4,2
Isaiah Joe,G,22023,1630198,22300481,"JAN 05, 2024",OKC @ BKN,L,20,1,5,0.2,1,3,0.333,0,0,0.0,0,1,1,1,0,1,1,1,3,3,1,OKC,BKN,OKC,115,0.5,Blks+Stls,5,4,4,2
Isaiah Joe,G,22023,1630198,22300419,"DEC 27, 2023",OKC vs. NYK,W,16,3,6,0.5,2,4,0.5,0,0,0.0,0,2,2,0,0,0,0,1,8,3,1,OKC,OKC,NYK,129,6.0,Points,10,10,8,2
Isaiah Joe,G,22023,1630198,22300419,"DEC 27, 2023",OKC vs. NYK,W,16,3,6,0.5,2,4,0.5,0,0,0.0,0,2,2,0,0,0,0,1,8,3,1,OKC,OKC,NYK,129,1.5,3-PT Made,10,10,8,2
Isaiah Joe,G,22023,1630198,22300419,"DEC 27, 2023",OKC vs. NYK,W,16,3,6,0.5,2,4,0.5,0,0,0.0,0,2,2,0,0,0,0,1,8,3,1,OKC,OKC,NYK,129,0.5,Blks+Stls,10,10,8,2
Isaiah Joe,G,22023,1630198,22300397,"DEC 23, 2023",OKC vs. LAL,L,20,3,11,0.273,1,6,0.167,0,0,0.0,1,4,5,1,0,2,2,1,7,-20,1,OKC,OKC,LAL,120,6.0,Points,13,12,8,6
Isaiah Joe,G,22023,1630198,22300397,"DEC 23, 2023",OKC vs. LAL,L,20,3,11,0.273,1,6,0.167,0,0,0.0,1,4,5,1,0,2,2,1,7,-20,1,OKC,OKC,LAL,120,1.5,3-PT Made,13,12,8,6
Isaiah Joe,G,22023,1630198,22300397,"DEC 23, 2023",OKC vs. LAL,L,20,3,11,0.273,1,6,0.167,0,0,0.0,1,4,5,1,0,2,2,1,7,-20,1,OKC,OKC,LAL,120,0.5,Blks+Stls,13,12,8,6
Isaiah Joe,G,22023,1630198,22300324,"DEC 14, 2023",OKC @ SAC,L,15,2,7,0.286,1,5,0.2,1,1,1.0,0,1,1,0,0,0,0,1,6,-6,1,OKC,SAC,OKC,123,6.0,Points,7,7,6,1
Isaiah Joe,G,22023,1630198,22300324,"DEC 14, 2023",OKC @ SAC,L,15,2,7,0.286,1,5,0.2,1,1,1.0,0,1,1,0,0,0,0,1,6,-6,1,OKC,SAC,OKC,123,1.5,3-PT Made,7,7,6,1
Isaiah Joe,G,22023,1630198,22300324,"DEC 14, 2023",OKC @ SAC,L,15,2,7,0.286,1,5,0.2,1,1,1.0,0,1,1,0,0,0,0,1,6,-6,1,OKC,SAC,OKC,123,0.5,Blks+Stls,7,7,6,1
Isaiah Joe,G,22023,1630198,22300302,"DEC 11, 2023",OKC vs. UTA,W,15,3,8,0.375,3,7,0.429,0,0,0.0,0,0,0,1,0,1,0,1,9,18,1,OKC,OKC,UTA,134,6.0,Points,10,9,10,1
Isaiah Joe,G,22023,1630198,22300302,"DEC 11, 2023",OKC vs. UTA,W,15,3,8,0.375,3,7,0.429,0,0,0.0,0,0,0,1,0,1,0,1,9,18,1,OKC,OKC,UTA,134,1.5,3-PT Made,10,9,10,1
Isaiah Joe,G,22023,1630198,22300302,"DEC 11, 2023",OKC vs. UTA,W,15,3,8,0.375,3,7,0.429,0,0,0.0,0,0,0,1,0,1,0,1,9,18,1,OKC,OKC,UTA,134,0.5,Blks+Stls,10,9,10,1
Isaiah Joe,G,22023,1630198,22301222,"DEC 08, 2023",OKC vs. GSW,W,23,1,4,0.25,0,3,0.0,3,3,1.0,0,1,1,1,3,0,0,1,5,28,1,OKC,OKC,GSW,138,6.0,Points,7,6,6,2
Isaiah Joe,G,22023,1630198,22301222,"DEC 08, 2023",OKC vs. GSW,W,23,1,4,0.25,0,3,0.0,3,3,1.0,0,1,1,1,3,0,0,1,5,28,1,OKC,OKC,GSW,138,1.5,3-PT Made,7,6,6,2
Isaiah Joe,G,22023,1630198,22301222,"DEC 08, 2023",OKC vs. GSW,W,23,1,4,0.25,0,3,0.0,3,3,1.0,0,1,1,1,3,0,0,1,5,28,1,OKC,OKC,GSW,138,0.5,Blks+Stls,7,6,6,2
Isaiah Joe,G,22023,1630198,22300287,"DEC 02, 2023",OKC @ DAL,W,25,2,6,0.333,2,5,0.4,0,0,0.0,1,6,7,2,0,0,0,1,6,10,1,OKC,DAL,OKC,126,6.0,Points,15,13,8,9
Isaiah Joe,G,22023,1630198,22300287,"DEC 02, 2023",OKC @ DAL,W,25,2,6,0.333,2,5,0.4,0,0,0.0,1,6,7,2,0,0,0,1,6,10,1,OKC,DAL,OKC,126,1.5,3-PT Made,15,13,8,9
Isaiah Joe,G,22023,1630198,22300287,"DEC 02, 2023",OKC @ DAL,W,25,2,6,0.333,2,5,0.4,0,0,0.0,1,6,7,2,0,0,0,1,6,10,1,OKC,DAL,OKC,126,0.5,Blks+Stls,15,13,8,9
Isaiah Joe,G,22023,1630198,22300239,"NOV 25, 2023",OKC vs. PHI,L,26,4,14,0.286,3,12,0.25,2,2,1.0,0,3,3,2,0,0,0,3,13,3,1,OKC,OKC,PHI,123,6.0,Points,18,16,15,5
Isaiah Joe,G,22023,1630198,22300239,"NOV 25, 2023",OKC vs. PHI,L,26,4,14,0.286,3,12,0.25,2,2,1.0,0,3,3,2,0,0,0,3,13,3,1,OKC,OKC,PHI,123,1.5,3-PT Made,18,16,15,5
Isaiah Joe,G,22023,1630198,22300239,"NOV 25, 2023",OKC vs. PHI,L,26,4,14,0.286,3,12,0.25,2,2,1.0,0,3,3,2,0,0,0,3,13,3,1,OKC,OKC,PHI,123,0.5,Blks+Stls,18,16,15,5
Isaiah Joe,G,22023,1630198,22300215,"NOV 19, 2023",OKC @ POR,W,14,5,6,0.833,5,6,0.833,0,0,0.0,0,1,1,1,1,0,1,0,15,20,1,OKC,POR,OKC,134,6.0,Points,17,16,16,2
Isaiah Joe,G,22023,1630198,22300215,"NOV 19, 2023",OKC @ POR,W,14,5,6,0.833,5,6,0.833,0,0,0.0,0,1,1,1,1,0,1,0,15,20,1,OKC,POR,OKC,134,1.5,3-PT Made,17,16,16,2
Isaiah Joe,G,22023,1630198,22300215,"NOV 19, 2023",OKC @ POR,W,14,5,6,0.833,5,6,0.833,0,0,0.0,0,1,1,1,1,0,1,0,15,20,1,OKC,POR,OKC,134,0.5,Blks+Stls,17,16,16,2
Isaiah Joe,G,22023,1630198,22300185,"NOV 12, 2023",OKC @ PHX,W,16,1,3,0.333,1,2,0.5,0,0,0.0,0,1,1,1,1,1,0,1,3,-13,1,OKC,PHX,OKC,111,6.0,Points,5,4,4,2
Isaiah Joe,G,22023,1630198,22300185,"NOV 12, 2023",OKC @ PHX,W,16,1,3,0.333,1,2,0.5,0,0,0.0,0,1,1,1,1,1,0,1,3,-13,1,OKC,PHX,OKC,111,1.5,3-PT Made,5,4,4,2
Isaiah Joe,G,22023,1630198,22300185,"NOV 12, 2023",OKC @ PHX,W,16,1,3,0.333,1,2,0.5,0,0,0.0,0,1,1,1,1,1,0,1,3,-13,1,OKC,PHX,OKC,111,0.5,Blks+Stls,5,4,4,2
Isaiah Joe,G,22023,1630198,22300167,"NOV 08, 2023",OKC vs. CLE,W,18,2,7,0.286,2,6,0.333,0,0,0.0,0,3,3,0,0,0,1,4,6,8,1,OKC,OKC,CLE,128,6.0,Points,9,9,6,3
Isaiah Joe,G,22023,1630198,22300167,"NOV 08, 2023",OKC vs. CLE,W,18,2,7,0.286,2,6,0.333,0,0,0.0,0,3,3,0,0,0,1,4,6,8,1,OKC,OKC,CLE,128,1.5,3-PT Made,9,9,6,3
Isaiah Joe,G,22023,1630198,22300167,"NOV 08, 2023",OKC vs. CLE,W,18,2,7,0.286,2,6,0.333,0,0,0.0,0,3,3,0,0,0,1,4,6,8,1,OKC,OKC,CLE,128,0.5,Blks+Stls,9,9,6,3
Isaiah Joe,G,22023,1630198,22300109,"OCT 30, 2023",OKC vs. DET,W,20,3,6,0.5,3,5,0.6,0,0,0.0,0,0,0,0,0,0,1,1,9,2,1,OKC,OKC,DET,124,6.0,Points,9,9,9,0
Isaiah Joe,G,22023,1630198,22300109,"OCT 30, 2023",OKC vs. DET,W,20,3,6,0.5,3,5,0.6,0,0,0.0,0,0,0,0,0,0,1,1,9,2,1,OKC,OKC,DET,124,1.5,3-PT Made,9,9,9,0
Isaiah Joe,G,22023,1630198,22300109,"OCT 30, 2023",OKC vs. DET,W,20,3,6,0.5,3,5,0.6,0,0,0.0,0,0,0,0,0,0,1,1,9,2,1,OKC,OKC,DET,124,0.5,Blks+Stls,9,9,9,0
Isaiah Joe,G,22023,1630198,22300748,"FEB 10, 2024",OKC @ DAL,L,16,2,6,0.333,2,4,0.5,0,0,0.0,0,1,1,1,0,0,0,0,6,-12,1,OKC,DAL,OKC,111,6.0,Points,8,7,7,2
Isaiah Joe,G,22023,1630198,22300748,"FEB 10, 2024",OKC @ DAL,L,16,2,6,0.333,2,4,0.5,0,0,0.0,0,1,1,1,0,0,0,0,6,-12,1,OKC,DAL,OKC,111,1.5,3-PT Made,8,7,7,2
Isaiah Joe,G,22023,1630198,22300748,"FEB 10, 2024",OKC @ DAL,L,16,2,6,0.333,2,4,0.5,0,0,0.0,0,1,1,1,0,0,0,0,6,-12,1,OKC,DAL,OKC,111,0.5,Blks+Stls,8,7,7,2
Isaiah Joe,G,22023,1630198,22300568,"JAN 16, 2024",OKC @ LAC,L,23,5,7,0.714,5,6,0.833,0,0,0.0,3,3,6,3,2,0,0,2,15,-12,1,OKC,LAC,OKC,117,6.0,Points,24,21,18,9
Isaiah Joe,G,22023,1630198,22300568,"JAN 16, 2024",OKC @ LAC,L,23,5,7,0.714,5,6,0.833,0,0,0.0,3,3,6,3,2,0,0,2,15,-12,1,OKC,LAC,OKC,117,1.5,3-PT Made,24,21,18,9
Isaiah Joe,G,22023,1630198,22300568,"JAN 16, 2024",OKC @ LAC,L,23,5,7,0.714,5,6,0.833,0,0,0.0,3,3,6,3,2,0,0,2,15,-12,1,OKC,LAC,OKC,117,0.5,Blks+Stls,24,21,18,9
Isaiah Joe,G,22023,1630198,22300565,"JAN 15, 2024",OKC @ LAL,L,20,2,10,0.2,0,6,0.0,0,0,0.0,2,5,7,1,2,0,1,1,4,4,1,OKC,LAL,OKC,105,6.0,Points,12,11,5,8
Isaiah Joe,G,22023,1630198,22300565,"JAN 15, 2024",OKC @ LAL,L,20,2,10,0.2,0,6,0.0,0,0,0.0,2,5,7,1,2,0,1,1,4,4,1,OKC,LAL,OKC,105,1.5,3-PT Made,12,11,5,8
Isaiah Joe,G,22023,1630198,22300565,"JAN 15, 2024",OKC @ LAL,L,20,2,10,0.2,0,6,0.0,0,0,0.0,2,5,7,1,2,0,1,1,4,4,1,OKC,LAL,OKC,105,0.5,Blks+Stls,12,11,5,8
Isaiah Joe,G,22023,1630198,22300546,"JAN 13, 2024",OKC vs. ORL,W,16,4,8,0.5,1,4,0.25,0,0,0.0,0,2,2,1,0,0,1,1,9,1,1,OKC,OKC,ORL,112,6.0,Points,12,11,10,3
Isaiah Joe,G,22023,1630198,22300546,"JAN 13, 2024",OKC vs. ORL,W,16,4,8,0.5,1,4,0.25,0,0,0.0,0,2,2,1,0,0,1,1,9,1,1,OKC,OKC,ORL,112,1.5,3-PT Made,12,11,10,3
Isaiah Joe,G,22023,1630198,22300546,"JAN 13, 2024",OKC vs. ORL,W,16,4,8,0.5,1,4,0.25,0,0,0.0,0,2,2,1,0,0,1,1,9,1,1,OKC,OKC,ORL,112,0.5,Blks+Stls,12,11,10,3
Isaiah Joe,G,22023,1630198,22300529,"JAN 11, 2024",OKC vs. POR,W,7,0,0,0.0,0,0,0.0,0,0,0.0,0,1,1,1,1,0,0,0,0,10,1,OKC,OKC,POR,139,6.0,Points,2,1,1,2
Isaiah Joe,G,22023,1630198,22300529,"JAN 11, 2024",OKC vs. POR,W,7,0,0,0.0,0,0,0.0,0,0,0.0,0,1,1,1,1,0,0,0,0,10,1,OKC,OKC,POR,139,1.5,3-PT Made,2,1,1,2
Isaiah Joe,G,22023,1630198,22300529,"JAN 11, 2024",OKC vs. POR,W,7,0,0,0.0,0,0,0.0,0,0,0.0,0,1,1,1,1,0,0,0,0,10,1,OKC,OKC,POR,139,0.5,Blks+Stls,2,1,1,2
Isaiah Joe,G,22023,1630198,22300379,"DEC 21, 2023",OKC vs. LAC,W,25,4,8,0.5,3,7,0.429,0,0,0.0,1,1,2,0,0,1,0,2,11,-11,1,OKC,OKC,LAC,134,6.0,Points,13,13,11,2
Isaiah Joe,G,22023,1630198,22300379,"DEC 21, 2023",OKC vs. LAC,W,25,4,8,0.5,3,7,0.429,0,0,0.0,1,1,2,0,0,1,0,2,11,-11,1,OKC,OKC,LAC,134,1.5,3-PT Made,13,13,11,2
Isaiah Joe,G,22023,1630198,22300379,"DEC 21, 2023",OKC vs. LAC,W,25,4,8,0.5,3,7,0.429,0,0,0.0,1,1,2,0,0,1,0,2,11,-11,1,OKC,OKC,LAC,134,0.5,Blks+Stls,13,13,11,2
Isaiah Joe,G,22023,1630198,22300355,"DEC 18, 2023",OKC vs. MEM,W,19,2,5,0.4,1,3,0.333,0,0,0.0,1,3,4,3,1,0,0,1,5,11,1,OKC,OKC,MEM,116,6.0,Points,12,9,8,7
Isaiah Joe,G,22023,1630198,22300355,"DEC 18, 2023",OKC vs. MEM,W,19,2,5,0.4,1,3,0.333,0,0,0.0,1,3,4,3,1,0,0,1,5,11,1,OKC,OKC,MEM,116,1.5,3-PT Made,12,9,8,7
Isaiah Joe,G,22023,1630198,22300355,"DEC 18, 2023",OKC vs. MEM,W,19,2,5,0.4,1,3,0.333,0,0,0.0,1,3,4,3,1,0,0,1,5,11,1,OKC,OKC,MEM,116,0.5,Blks+Stls,12,9,8,7
Isaiah Joe,G,22023,1630198,22300340,"DEC 16, 2023",OKC @ DEN,W,27,4,7,0.571,1,4,0.25,3,4,0.75,0,2,2,1,1,1,3,1,12,12,1,OKC,DEN,OKC,118,6.0,Points,15,14,13,3
Isaiah Joe,G,22023,1630198,22300340,"DEC 16, 2023",OKC @ DEN,W,27,4,7,0.571,1,4,0.25,3,4,0.75,0,2,2,1,1,1,3,1,12,12,1,OKC,DEN,OKC,118,1.5,3-PT Made,15,14,13,3
Isaiah Joe,G,22023,1630198,22300340,"DEC 16, 2023",OKC @ DEN,W,27,4,7,0.571,1,4,0.25,3,4,0.75,0,2,2,1,1,1,3,1,12,12,1,OKC,DEN,OKC,118,0.5,Blks+Stls,15,14,13,3
Isaiah Joe,G,22023,1630198,22300058,"NOV 28, 2023",OKC @ MIN,L,24,3,7,0.429,1,5,0.2,2,2,1.0,0,1,1,3,3,0,0,2,9,11,1,OKC,MIN,OKC,103,6.0,Points,13,10,12,4
Isaiah Joe,G,22023,1630198,22300058,"NOV 28, 2023",OKC @ MIN,L,24,3,7,0.429,1,5,0.2,2,2,1.0,0,1,1,3,3,0,0,2,9,11,1,OKC,MIN,OKC,103,1.5,3-PT Made,13,10,12,4
Isaiah Joe,G,22023,1630198,22300058,"NOV 28, 2023",OKC @ MIN,L,24,3,7,0.429,1,5,0.2,2,2,1.0,0,1,1,3,3,0,0,2,9,11,1,OKC,MIN,OKC,103,0.5,Blks+Stls,13,10,12,4
Isaiah Joe,G,22023,1630198,22300016,"NOV 10, 2023",OKC @ SAC,L,20,3,9,0.333,3,8,0.375,0,0,0.0,0,1,1,0,1,0,1,0,9,13,1,OKC,SAC,OKC,98,6.0,Points,10,10,9,1
Isaiah Joe,G,22023,1630198,22300016,"NOV 10, 2023",OKC @ SAC,L,20,3,9,0.333,3,8,0.375,0,0,0.0,0,1,1,0,1,0,1,0,9,13,1,OKC,SAC,OKC,98,1.5,3-PT Made,10,10,9,1
Isaiah Joe,G,22023,1630198,22300016,"NOV 10, 2023",OKC @ SAC,L,20,3,9,0.333,3,8,0.375,0,0,0.0,0,1,1,0,1,0,1,0,9,13,1,OKC,SAC,OKC,98,0.5,Blks+Stls,10,10,9,1
Isaiah Joe,G,22023,1630198,22300155,"NOV 06, 2023",OKC vs. ATL,W,20,4,8,0.5,4,8,0.5,0,0,0.0,0,3,3,3,0,0,0,1,12,5,1,OKC,OKC,ATL,126,6.0,Points,18,15,15,6
Isaiah Joe,G,22023,1630198,22300155,"NOV 06, 2023",OKC vs. ATL,W,20,4,8,0.5,4,8,0.5,0,0,0.0,0,3,3,3,0,0,0,1,12,5,1,OKC,OKC,ATL,126,1.5,3-PT Made,18,15,15,6
Isaiah Joe,G,22023,1630198,22300155,"NOV 06, 2023",OKC vs. ATL,W,20,4,8,0.5,4,8,0.5,0,0,0.0,0,3,3,3,0,0,0,1,12,5,1,OKC,OKC,ATL,126,0.5,Blks+Stls,18,15,15,6
Isaiah Joe,G,22023,1630198,22300005,"NOV 03, 2023",OKC vs. GSW,L,26,4,6,0.667,3,5,0.6,5,6,0.833,0,0,0,1,0,0,1,0,16,-2,1,OKC,OKC,GSW,139,6.0,Points,17,16,17,1
Isaiah Joe,G,22023,1630198,22300005,"NOV 03, 2023",OKC vs. GSW,L,26,4,6,0.667,3,5,0.6,5,6,0.833,0,0,0,1,0,0,1,0,16,-2,1,OKC,OKC,GSW,139,1.5,3-PT Made,17,16,17,1
Isaiah Joe,G,22023,1630198,22300005,"NOV 03, 2023",OKC vs. GSW,L,26,4,6,0.667,3,5,0.6,5,6,0.833,0,0,0,1,0,0,1,0,16,-2,1,OKC,OKC,GSW,139,0.5,Blks+Stls,17,16,17,1
Isaiah Joe,G,22023,1630198,22300121,"NOV 01, 2023",OKC vs. NOP,L,14,2,7,0.286,2,7,0.286,3,3,1.0,0,1,1,1,0,0,0,0,9,-6,1,OKC,OKC,NOP,106,6.0,Points,11,10,10,2
Isaiah Joe,G,22023,1630198,22300121,"NOV 01, 2023",OKC vs. NOP,L,14,2,7,0.286,2,7,0.286,3,3,1.0,0,1,1,1,0,0,0,0,9,-6,1,OKC,OKC,NOP,106,1.5,3-PT Made,11,10,10,2
Isaiah Joe,G,22023,1630198,22300121,"NOV 01, 2023",OKC vs. NOP,L,14,2,7,0.286,2,7,0.286,3,3,1.0,0,1,1,1,0,0,0,0,9,-6,1,OKC,OKC,NOP,106,0.5,Blks+Stls,11,10,10,2
Isaiah Joe,G,22023,1630198,22300095,"OCT 29, 2023",OKC vs. DEN,L,17,2,7,0.286,1,4,0.25,0,0,0.0,0,2,2,1,4,0,1,3,5,-5,1,OKC,OKC,DEN,95,6.0,Points,8,7,6,3
Isaiah Joe,G,22023,1630198,22300095,"OCT 29, 2023",OKC vs. DEN,L,17,2,7,0.286,1,4,0.25,0,0,0.0,0,2,2,1,4,0,1,3,5,-5,1,OKC,OKC,DEN,95,1.5,3-PT Made,8,7,6,3
Isaiah Joe,G,22023,1630198,22300095,"OCT 29, 2023",OKC vs. DEN,L,17,2,7,0.286,1,4,0.25,0,0,0.0,0,2,2,1,4,0,1,3,5,-5,1,OKC,OKC,DEN,95,0.5,Blks+Stls,8,7,6,3
Isaiah Joe,G,22023,1630198,22300081,"OCT 27, 2023",OKC @ CLE,W,22,2,10,0.2,1,7,0.143,0,1,0.0,0,3,3,2,0,0,1,1,5,12,1,OKC,CLE,OKC,108,6.0,Points,10,8,7,5
Isaiah Joe,G,22023,1630198,22300081,"OCT 27, 2023",OKC @ CLE,W,22,2,10,0.2,1,7,0.143,0,1,0.0,0,3,3,2,0,0,1,1,5,12,1,OKC,CLE,OKC,108,1.5,3-PT Made,10,8,7,5
Isaiah Joe,G,22023,1630198,22300081,"OCT 27, 2023",OKC @ CLE,W,22,2,10,0.2,1,7,0.143,0,1,0.0,0,3,3,2,0,0,1,1,5,12,1,OKC,CLE,OKC,108,0.5,Blks+Stls,10,8,7,5
Isaiah Joe,G,22023,1630198,22300070,"OCT 25, 2023",OKC @ CHI,W,22,4,8,0.5,3,6,0.5,3,4,0.75,1,4,5,2,1,0,2,2,14,14,1,OKC,CHI,OKC,124,6.0,Points,21,19,16,7
Isaiah Joe,G,22023,1630198,22300070,"OCT 25, 2023",OKC @ CHI,W,22,4,8,0.5,3,6,0.5,3,4,0.75,1,4,5,2,1,0,2,2,14,14,1,OKC,CHI,OKC,124,1.5,3-PT Made,21,19,16,7
Isaiah Joe,G,22023,1630198,22300070,"OCT 25, 2023",OKC @ CHI,W,22,4,8,0.5,3,6,0.5,3,4,0.75,1,4,5,2,1,0,2,2,14,14,1,OKC,CHI,OKC,124,0.5,Blks+Stls,21,19,16,7
Isaiah Joe,G,22023,1630198,22300664,"JAN 29, 2024",OKC vs. MIN,L,16,2,2,1.0,1,1,1.0,0,0,0.0,2,2,4,0,0,0,1,1,5,16,1,OKC,OKC,MIN,101,6.0,Points,9,9,5,4
Isaiah Joe,G,22023,1630198,22300664,"JAN 29, 2024",OKC vs. MIN,L,16,2,2,1.0,1,1,1.0,0,0,0.0,2,2,4,0,0,0,1,1,5,16,1,OKC,OKC,MIN,101,1.5,3-PT Made,9,9,5,4
Isaiah Joe,G,22023,1630198,22300664,"JAN 29, 2024",OKC vs. MIN,L,16,2,2,1.0,1,1,1.0,0,0,0.0,2,2,4,0,0,0,1,1,5,16,1,OKC,OKC,MIN,101,0.5,Blks+Stls,9,9,5,4
Isaiah Joe,G,22023,1630198,22300654,"JAN 28, 2024",OKC @ DET,L,11,2,4,0.5,0,2,0.0,0,0,0.0,0,1,1,0,0,0,1,1,4,-5,1,OKC,DET,OKC,104,6.0,Points,5,5,4,1
Isaiah Joe,G,22023,1630198,22300654,"JAN 28, 2024",OKC @ DET,L,11,2,4,0.5,0,2,0.0,0,0,0.0,0,1,1,0,0,0,1,1,4,-5,1,OKC,DET,OKC,104,1.5,3-PT Made,5,5,4,1
Isaiah Joe,G,22023,1630198,22300654,"JAN 28, 2024",OKC @ DET,L,11,2,4,0.5,0,2,0.0,0,0,0.0,0,1,1,0,0,0,1,1,4,-5,1,OKC,DET,OKC,104,0.5,Blks+Stls,5,5,4,1
Isaiah Joe,G,22023,1630198,22300640,"JAN 26, 2024",OKC @ NOP,W,13,0,3,0.0,0,2,0.0,2,2,1.0,1,0,1,0,1,0,1,0,2,7,1,OKC,NOP,OKC,107,6.0,Points,3,3,2,1
Isaiah Joe,G,22023,1630198,22300640,"JAN 26, 2024",OKC @ NOP,W,13,0,3,0.0,0,2,0.0,2,2,1.0,1,0,1,0,1,0,1,0,2,7,1,OKC,NOP,OKC,107,1.5,3-PT Made,3,3,2,1
Isaiah Joe,G,22023,1630198,22300640,"JAN 26, 2024",OKC @ NOP,W,13,0,3,0.0,0,2,0.0,2,2,1.0,1,0,1,0,1,0,1,0,2,7,1,OKC,NOP,OKC,107,0.5,Blks+Stls,3,3,2,1
Isaiah Joe,G,22023,1630198,22300599,"JAN 20, 2024",OKC @ MIN,W,22,1,3,0.333,1,2,0.5,2,2,1.0,0,5,5,5,1,0,0,4,5,12,1,OKC,MIN,OKC,102,6.0,Points,15,10,10,10
Isaiah Joe,G,22023,1630198,22300599,"JAN 20, 2024",OKC @ MIN,W,22,1,3,0.333,1,2,0.5,2,2,1.0,0,5,5,5,1,0,0,4,5,12,1,OKC,MIN,OKC,102,1.5,3-PT Made,15,10,10,10
Isaiah Joe,G,22023,1630198,22300599,"JAN 20, 2024",OKC @ MIN,W,22,1,3,0.333,1,2,0.5,2,2,1.0,0,5,5,5,1,0,0,4,5,12,1,OKC,MIN,OKC,102,0.5,Blks+Stls,15,10,10,10
Isaiah Joe,G,22023,1630198,22300522,"JAN 10, 2024",OKC @ MIA,W,22,4,7,0.571,3,6,0.5,0,0,0.0,1,1,2,0,0,0,1,1,11,-4,1,OKC,MIA,OKC,128,6.0,Points,13,13,11,2
Isaiah Joe,G,22023,1630198,22300522,"JAN 10, 2024",OKC @ MIA,W,22,4,7,0.571,3,6,0.5,0,0,0.0,1,1,2,0,0,0,1,1,11,-4,1,OKC,MIA,OKC,128,1.5,3-PT Made,13,13,11,2
Isaiah Joe,G,22023,1630198,22300522,"JAN 10, 2024",OKC @ MIA,W,22,4,7,0.571,3,6,0.5,0,0,0.0,1,1,2,0,0,0,1,1,11,-4,1,OKC,MIA,OKC,128,0.5,Blks+Stls,13,13,11,2
Isaiah Joe,G,22023,1630198,22300508,"JAN 08, 2024",OKC @ WAS,W,21,6,10,0.6,4,7,0.571,0,0,0.0,1,3,4,3,0,0,1,0,16,-5,1,OKC,WAS,OKC,136,6.0,Points,23,20,19,7
Isaiah Joe,G,22023,1630198,22300508,"JAN 08, 2024",OKC @ WAS,W,21,6,10,0.6,4,7,0.571,0,0,0.0,1,3,4,3,0,0,1,0,16,-5,1,OKC,WAS,OKC,136,1.5,3-PT Made,23,20,19,7
Isaiah Joe,G,22023,1630198,22300508,"JAN 08, 2024",OKC @ WAS,W,21,6,10,0.6,4,7,0.571,0,0,0.0,1,3,4,3,0,0,1,0,16,-5,1,OKC,WAS,OKC,136,0.5,Blks+Stls,23,20,19,7
Isaiah Joe,G,22023,1630198,22300467,"JAN 03, 2024",OKC @ ATL,L,18,4,8,0.5,1,5,0.2,0,0,0.0,1,0,1,1,1,0,2,2,9,-3,1,OKC,ATL,OKC,138,6.0,Points,11,10,10,2
Isaiah Joe,G,22023,1630198,22300467,"JAN 03, 2024",OKC @ ATL,L,18,4,8,0.5,1,5,0.2,0,0,0.0,1,0,1,1,1,0,2,2,9,-3,1,OKC,ATL,OKC,138,1.5,3-PT Made,11,10,10,2
Isaiah Joe,G,22023,1630198,22300467,"JAN 03, 2024",OKC @ ATL,L,18,4,8,0.5,1,5,0.2,0,0,0.0,1,0,1,1,1,0,2,2,9,-3,1,OKC,ATL,OKC,138,0.5,Blks+Stls,11,10,10,2
Isaiah Joe,G,22023,1630198,22300462,"JAN 02, 2024",OKC vs. BOS,W,13,4,5,0.8,2,3,0.667,0,0,0.0,0,3,3,0,0,0,1,1,10,-4,1,OKC,OKC,BOS,127,6.0,Points,13,13,10,3
Isaiah Joe,G,22023,1630198,22300462,"JAN 02, 2024",OKC vs. BOS,W,13,4,5,0.8,2,3,0.667,0,0,0.0,0,3,3,0,0,0,1,1,10,-4,1,OKC,OKC,BOS,127,1.5,3-PT Made,13,13,10,3
Isaiah Joe,G,22023,1630198,22300462,"JAN 02, 2024",OKC vs. BOS,W,13,4,5,0.8,2,3,0.667,0,0,0.0,0,3,3,0,0,0,1,1,10,-4,1,OKC,OKC,BOS,127,0.5,Blks+Stls,13,13,10,3
Isaiah Joe,G,22023,1630198,22300447,"DEC 31, 2023",OKC vs. BKN,W,16,2,2,1.0,2,2,1.0,1,2,0.5,0,1,1,0,0,0,2,1,7,7,1,OKC,OKC,BKN,124,6.0,Points,8,8,7,1
Isaiah Joe,G,22023,1630198,22300447,"DEC 31, 2023",OKC vs. BKN,W,16,2,2,1.0,2,2,1.0,1,2,0.5,0,1,1,0,0,0,2,1,7,7,1,OKC,OKC,BKN,124,1.5,3-PT Made,8,8,7,1
Isaiah Joe,G,22023,1630198,22300447,"DEC 31, 2023",OKC vs. BKN,W,16,2,2,1.0,2,2,1.0,1,2,0.5,0,1,1,0,0,0,2,1,7,7,1,OKC,OKC,BKN,124,0.5,Blks+Stls,8,8,7,1
Isaiah Joe,G,22023,1630198,22300435,"DEC 29, 2023",OKC @ DEN,W,13,2,6,0.333,1,5,0.2,0,0,0.0,0,1,1,1,0,0,0,0,5,11,1,OKC,DEN,OKC,119,6.0,Points,7,6,6,2
Isaiah Joe,G,22023,1630198,22300435,"DEC 29, 2023",OKC @ DEN,W,13,2,6,0.333,1,5,0.2,0,0,0.0,0,1,1,1,0,0,0,0,5,11,1,OKC,DEN,OKC,119,1.5,3-PT Made,7,6,6,2
Isaiah Joe,G,22023,1630198,22300435,"DEC 29, 2023",OKC @ DEN,W,13,2,6,0.333,1,5,0.2,0,0,0.0,0,1,1,1,0,0,0,0,5,11,1,OKC,DEN,OKC,119,0.5,Blks+Stls,7,6,6,2
Isaiah Joe,G,22023,1630198,22300411,"DEC 26, 2023",OKC vs. MIN,W,16,3,4,0.75,2,3,0.667,0,0,0.0,1,1,2,2,0,0,0,3,8,9,1,OKC,OKC,MIN,129,6.0,Points,12,10,10,4
Isaiah Joe,G,22023,1630198,22300411,"DEC 26, 2023",OKC vs. MIN,W,16,3,4,0.75,2,3,0.667,0,0,0.0,1,1,2,2,0,0,0,3,8,9,1,OKC,OKC,MIN,129,1.5,3-PT Made,12,10,10,4
Isaiah Joe,G,22023,1630198,22300411,"DEC 26, 2023",OKC vs. MIN,W,16,3,4,0.75,2,3,0.667,0,0,0.0,1,1,2,2,0,0,0,3,8,9,1,OKC,OKC,MIN,129,0.5,Blks+Stls,12,10,10,4
Isaiah Joe,G,22023,1630198,22301212,"DEC 06, 2023",OKC @ HOU,L,14,1,5,0.2,1,4,0.25,0,0,0.0,0,1,1,0,0,0,1,1,3,3,1,OKC,HOU,OKC,101,6.0,Points,4,4,3,1
Isaiah Joe,G,22023,1630198,22301212,"DEC 06, 2023",OKC @ HOU,L,14,1,5,0.2,1,4,0.25,0,0,0.0,0,1,1,0,0,0,1,1,3,3,1,OKC,HOU,OKC,101,1.5,3-PT Made,4,4,3,1
Isaiah Joe,G,22023,1630198,22301212,"DEC 06, 2023",OKC @ HOU,L,14,1,5,0.2,1,4,0.25,0,0,0.0,0,1,1,0,0,0,1,1,3,3,1,OKC,HOU,OKC,101,0.5,Blks+Stls,4,4,3,1
Isaiah Joe,G,22023,1630198,22300271,"NOV 30, 2023",OKC vs. LAL,W,20,4,8,0.5,2,6,0.333,0,0,0.0,0,5,5,0,1,3,0,0,10,19,1,OKC,OKC,LAL,133,6.0,Points,15,15,10,5
Isaiah Joe,G,22023,1630198,22300271,"NOV 30, 2023",OKC vs. LAL,W,20,4,8,0.5,2,6,0.333,0,0,0.0,0,5,5,0,1,3,0,0,10,19,1,OKC,OKC,LAL,133,1.5,3-PT Made,15,15,10,5
Isaiah Joe,G,22023,1630198,22300271,"NOV 30, 2023",OKC vs. LAL,W,20,4,8,0.5,2,6,0.333,0,0,0.0,0,5,5,0,1,3,0,0,10,19,1,OKC,OKC,LAL,133,0.5,Blks+Stls,15,15,10,5
Isaiah Joe,G,22023,1630198,22300234,"NOV 22, 2023",OKC vs. CHI,W,27,6,9,0.667,5,7,0.714,3,3,1.0,0,1,1,0,0,1,0,0,20,11,1,OKC,OKC,CHI,116,6.0,Points,21,21,20,1
Isaiah Joe,G,22023,1630198,22300234,"NOV 22, 2023",OKC vs. CHI,W,27,6,9,0.667,5,7,0.714,3,3,1.0,0,1,1,0,0,1,0,0,20,11,1,OKC,OKC,CHI,116,1.5,3-PT Made,21,21,20,1
Isaiah Joe,G,22023,1630198,22300234,"NOV 22, 2023",OKC vs. CHI,W,27,6,9,0.667,5,7,0.714,3,3,1.0,0,1,1,0,0,1,0,0,20,11,1,OKC,OKC,CHI,116,0.5,Blks+Stls,21,21,20,1
Isaiah Joe,G,22023,1630198,22300207,"NOV 18, 2023",OKC @ GSW,W,27,4,9,0.444,2,4,0.5,0,0,0.0,0,4,4,3,1,1,0,2,10,17,1,OKC,GSW,OKC,130,6.0,Points,17,14,13,7
Isaiah Joe,G,22023,1630198,22300207,"NOV 18, 2023",OKC @ GSW,W,27,4,9,0.444,2,4,0.5,0,0,0.0,0,4,4,3,1,1,0,2,10,17,1,OKC,GSW,OKC,130,1.5,3-PT Made,17,14,13,7
Isaiah Joe,G,22023,1630198,22300207,"NOV 18, 2023",OKC @ GSW,W,27,4,9,0.444,2,4,0.5,0,0,0.0,0,4,4,3,1,1,0,2,10,17,1,OKC,GSW,OKC,130,0.5,Blks+Stls,17,14,13,7
Isaiah Joe,G,22023,1630198,22300201,"NOV 16, 2023",OKC @ GSW,W,25,7,7,1.0,7,7,1.0,2,3,0.667,0,5,5,0,1,0,0,1,23,21,1,OKC,GSW,OKC,128,6.0,Points,28,28,23,5
Isaiah Joe,G,22023,1630198,22300201,"NOV 16, 2023",OKC @ GSW,W,25,7,7,1.0,7,7,1.0,2,3,0.667,0,5,5,0,1,0,0,1,23,21,1,OKC,GSW,OKC,128,1.5,3-PT Made,28,28,23,5
Isaiah Joe,G,22023,1630198,22300201,"NOV 16, 2023",OKC @ GSW,W,25,7,7,1.0,7,7,1.0,2,3,0.667,0,5,5,0,1,0,0,1,23,21,1,OKC,GSW,OKC,128,0.5,Blks+Stls,28,28,23,5
Isaiah Joe,G,22023,1630198,22300021,"NOV 14, 2023",OKC vs. SAS,W,14,3,5,0.6,2,3,0.667,0,0,0.0,0,2,2,1,2,0,0,1,8,12,1,OKC,OKC,SAS,123,6.0,Points,11,10,9,3
Isaiah Joe,G,22023,1630198,22300021,"NOV 14, 2023",OKC vs. SAS,W,14,3,5,0.6,2,3,0.667,0,0,0.0,0,2,2,1,2,0,0,1,8,12,1,OKC,OKC,SAS,123,1.5,3-PT Made,11,10,9,3
Isaiah Joe,G,22023,1630198,22300021,"NOV 14, 2023",OKC vs. SAS,W,14,3,5,0.6,2,3,0.667,0,0,0.0,0,2,2,1,2,0,0,1,8,12,1,OKC,OKC,SAS,123,0.5,Blks+Stls,11,10,9,3
Isaiah Joe,G,22023,1630198,22300581,"JAN 18, 2024",OKC @ UTA,W,12,2,4,0.5,2,4,0.5,0,0,0.0,1,1,2,1,0,0,0,1,6,-9,1,OKC,UTA,OKC,134,6.0,Points,9,8,7,3
Isaiah Joe,G,22023,1630198,22300581,"JAN 18, 2024",OKC @ UTA,W,12,2,4,0.5,2,4,0.5,0,0,0.0,1,1,2,1,0,0,0,1,6,-9,1,OKC,UTA,OKC,134,1.5,3-PT Made,9,8,7,3
Isaiah Joe,G,22023,1630198,22300581,"JAN 18, 2024",OKC @ UTA,W,12,2,4,0.5,2,4,0.5,0,0,0.0,1,1,2,1,0,0,0,1,6,-9,1,OKC,UTA,OKC,134,0.5,Blks+Stls,9,8,7,3
Sam Merrill,G,22023,1630241,22300756,"FEB 10, 2024",CLE @ TOR,W,10,2,3,0.667,2,3,0.667,0,0,0.0,0,0,0,0,0,0,0,0,6,3,1,CLE,TOR,CLE,119,,,6,6,6,0
Sam Merrill,G,22023,1630241,22300735,"FEB 08, 2024",CLE @ BKN,W,12,3,7,0.429,3,7,0.429,0,0,0.0,0,0,0,0,1,0,0,1,9,-6,1,CLE,BKN,CLE,118,,,9,9,9,0
Sam Merrill,G,22023,1630241,22300728,"FEB 07, 2024",CLE @ WAS,W,14,1,4,0.25,1,3,0.333,0,0,0.0,0,1,1,2,0,0,0,0,3,-3,1,CLE,WAS,CLE,114,,,6,4,5,3
Sam Merrill,G,22023,1630241,22300714,"FEB 05, 2024",CLE vs. SAC,W,11,3,4,0.75,3,4,0.75,0,0,0.0,0,0,0,2,1,0,0,0,9,8,1,CLE,CLE,SAC,136,,,11,9,11,2
Sam Merrill,G,22023,1630241,22300703,"FEB 03, 2024",CLE @ SAS,W,14,1,3,0.333,1,3,0.333,0,0,0.0,0,1,1,3,1,0,1,2,3,-8,1,CLE,SAS,CLE,117,,,7,4,6,4
Sam Merrill,G,22023,1630241,22300687,"FEB 01, 2024",CLE @ MEM,W,18,3,6,0.5,3,5,0.6,0,0,0.0,0,2,2,1,0,0,0,1,9,-5,1,CLE,MEM,CLE,108,,,12,11,10,3
Sam Merrill,G,22023,1630241,22300675,"JAN 31, 2024",CLE vs. DET,W,16,4,6,0.667,3,5,0.6,0,0,0.0,0,2,2,1,1,0,0,1,11,-9,1,CLE,CLE,DET,128,,,14,13,12,3
Sam Merrill,G,22023,1630241,22300658,"JAN 29, 2024",CLE vs. LAC,W,7,0,1,0.0,0,0,0.0,0,0,0.0,0,0,0,0,0,0,0,1,0,-9,1,CLE,CLE,LAC,118,,,0,0,0,0
Sam Merrill,G,22023,1630241,22300639,"JAN 26, 2024",CLE @ MIL,W,17,3,6,0.5,1,4,0.25,0,0,0.0,0,0,0,0,0,0,0,3,7,5,1,CLE,MIL,CLE,112,,,7,7,7,0
Sam Merrill,G,22023,1630241,22300624,"JAN 24, 2024",CLE @ MIL,L,27,4,9,0.444,4,9,0.444,0,0,0.0,0,2,2,3,0,0,1,1,12,1,1,CLE,MIL,CLE,116,,,17,14,15,5
Sam Merrill,G,22023,1630241,22300607,"JAN 22, 2024",CLE @ ORL,W,31,8,13,0.615,8,13,0.615,2,2,1.0,2,1,3,1,1,0,1,2,26,12,1,CLE,ORL,CLE,126,,,30,29,27,4
Sam Merrill,G,22023,1630241,22300595,"JAN 20, 2024",CLE @ ATL,W,30,6,16,0.375,5,14,0.357,1,1,1.0,0,4,4,6,0,0,1,2,18,8,1,CLE,ATL,CLE,116,,,28,22,24,10
Sam Merrill,G,22023,1630241,22300572,"JAN 17, 2024",CLE vs. MIL,W,22,4,8,0.5,2,6,0.333,0,0,0.0,3,2,5,5,0,0,0,1,10,3,1,CLE,CLE,MIL,135,,,20,15,15,10
Sam Merrill,G,22023,1630241,22300561,"JAN 15, 2024",CLE vs. CHI,W,20,5,7,0.714,4,6,0.667,1,1,1.0,1,2,3,2,2,0,0,4,15,0,1,CLE,CLE,CHI,109,,,20,18,17,5
Sam Merrill,G,22023,1630241,22300527,"JAN 11, 2024",CLE vs. BKN,W,32,2,12,0.167,2,11,0.182,0,0,0.0,2,7,9,1,1,0,0,1,6,2,1,CLE,CLE,BKN,111,,,16,15,7,10
Sam Merrill,G,22023,1630241,22300497,"JAN 07, 2024",CLE vs. SAS,W,23,5,11,0.455,5,9,0.556,3,3,1.0,0,3,3,3,0,0,0,0,18,23,1,CLE,CLE,SAS,117,,,24,21,21,6
Sam Merrill,G,22023,1630241,22300482,"JAN 05, 2024",CLE vs. WAS,W,26,4,12,0.333,3,9,0.333,0,0,0.0,0,2,2,2,1,0,0,2,11,8,1,CLE,CLE,WAS,114,,,15,13,13,4
Sam Merrill,G,22023,1630241,22300465,"JAN 03, 2024",CLE vs. WAS,W,29,4,11,0.364,3,9,0.333,0,0,0.0,1,4,5,6,0,0,0,2,11,27,1,CLE,CLE,WAS,140,,,22,16,17,11
Sam Merrill,G,22023,1630241,22300452,"JAN 01, 2024",CLE @ TOR,L,17,6,11,0.545,4,8,0.5,0,0,0.0,0,3,3,1,0,0,1,2,16,-2,1,CLE,TOR,CLE,121,,,20,19,17,4
Sam Merrill,G,22023,1630241,22300433,"DEC 29, 2023",CLE vs. MIL,L,15,1,4,0.25,1,4,0.25,0,0,0.0,0,0,0,1,0,0,0,1,3,-1,1,CLE,CLE,MIL,111,,,4,3,4,1
Sam Merrill,G,22023,1630241,22300375,"DEC 21, 2023",CLE vs. NOP,L,12,0,4,0.0,0,3,0.0,0,0,0.0,0,0,0,1,0,0,1,0,0,1,1,CLE,CLE,NOP,104,,,1,0,1,1
Sam Merrill,G,22023,1630241,22300364,"DEC 20, 2023",CLE vs. UTA,W,30,9,16,0.563,8,14,0.571,1,2,0.5,0,3,3,2,1,0,2,4,27,17,1,CLE,CLE,UTA,124,,,32,30,29,5
Sam Merrill,G,22023,1630241,22300349,"DEC 18, 2023",CLE vs. HOU,W,24,6,11,0.545,5,10,0.5,2,2,1.0,1,3,4,3,1,1,0,1,19,13,1,CLE,CLE,HOU,135,,,26,23,22,7
Sam Merrill,G,22023,1630241,22300336,"DEC 16, 2023",CLE vs. ATL,W,8,3,6,0.5,3,6,0.5,0,0,0.0,0,1,1,1,0,0,0,1,9,4,1,CLE,CLE,ATL,127,,,11,10,10,2
Sam Merrill,G,22023,1630241,22300294,"DEC 11, 2023",CLE @ ORL,L,17,2,6,0.333,2,4,0.5,0,0,0.0,1,2,3,1,0,0,1,2,6,-4,1,CLE,ORL,CLE,94,,,10,9,7,4
Sam Merrill,G,22023,1630241,22301220,"DEC 08, 2023",CLE @ MIA,W,10,3,5,0.6,3,5,0.6,0,0,0.0,1,2,3,1,0,0,0,2,9,-8,1,CLE,MIA,CLE,111,,,13,12,10,4
Sam Merrill,G,22023,1630241,22300283,"DEC 02, 2023",CLE @ DET,W,3,0,1,0.0,0,1,0.0,0,0,0.0,0,0,0,1,0,0,0,1,0,0,1,CLE,DET,CLE,110,,,1,0,1,1
Sam Merrill,G,22023,1630241,22300229,"NOV 22, 2023",CLE vs. MIA,L,17,3,6,0.5,3,5,0.6,0,0,0.0,0,1,1,1,0,0,1,3,9,-10,1,CLE,CLE,MIA,96,,,11,10,10,2
Sam Merrill,G,22023,1630241,22300040,"NOV 21, 2023",CLE @ PHI,W,6,0,1,0.0,0,1,0.0,0,0,0.0,0,0,0,0,0,0,0,0,0,0,1,CLE,PHI,CLE,122,,,0,0,0,0
Sam Merrill,G,22023,1630241,22300210,"NOV 19, 2023",CLE vs. DEN,W,24,3,10,0.3,3,9,0.333,0,0,0.0,1,1,2,1,0,0,0,2,9,-15,1,CLE,CLE,DEN,121,,,12,11,10,3
Sam Merrill,G,22023,1630241,22300030,"NOV 17, 2023",CLE vs. DET,W,1,0,0,0.0,0,0,0.0,0,0,0.0,0,0,0,0,0,0,0,0,0,-2,1,CLE,CLE,DET,108,,,0,0,0,0
Sam Merrill,G,22023,1630241,22300199,"NOV 15, 2023",CLE @ POR,W,2,0,0,0.0,0,0,0.0,0,0,0.0,0,0,0,0,0,0,0,0,0,0,1,CLE,POR,CLE,109,,,0,0,0,0
Sam Merrill,G,22023,1630241,22300191,"NOV 13, 2023",CLE @ SAC,L,3,0,1,0.0,0,1,0.0,0,0,0.0,0,0,0,0,0,0,0,0,0,1,1,CLE,SAC,CLE,120,,,0,0,0,0
Sam Merrill,G,22023,1630241,22300142,"NOV 05, 2023",CLE vs. GSW,W,1,0,0,0.0,0,0,0.0,0,0,0.0,0,0,0,0,0,0,0,0,0,-2,1,CLE,CLE,GSW,115,,,0,0,0,0
Sam Merrill,G,22023,1630241,22300112,"OCT 31, 2023",CLE vs. NYK,L,14,2,4,0.5,2,4,0.5,0,0,0.0,0,1,1,2,1,0,1,0,6,-2,1,CLE,CLE,NYK,91,,,9,7,8,3
Sam Merrill,G,22023,1630241,22300091,"OCT 28, 2023",CLE vs. IND,L,6,0,2,0.0,0,1,0.0,0,0,0.0,1,1,2,1,1,0,0,0,0,2,1,CLE,CLE,IND,113,,,3,2,1,3
Derrick Rose,G,22023,201565,22300751,"FEB 10, 2024",MEM @ CHA,L,16,4,7,0.571,2,2,1.0,0,0,0.0,0,4,4,5,0,0,0,0,10,-8,1,MEM,CHA,MEM,105,,,19,14,15,9
Derrick Rose,G,22023,201565,22300722,"FEB 06, 2024",MEM @ NYK,L,12,2,4,0.5,1,1,1.0,2,2,1.0,0,3,3,2,1,0,3,0,7,-1,1,MEM,NYK,MEM,97,,,12,10,9,5
Derrick Rose,G,22023,201565,22300693,"FEB 02, 2024",MEM vs. GSW,L,16,5,9,0.556,1,3,0.333,1,1,1.0,0,1,1,4,0,0,0,1,12,-7,1,MEM,MEM,GSW,98,,,17,13,16,5
Derrick Rose,G,22023,201565,22300460,"JAN 02, 2024",MEM vs. SAS,W,9,2,4,0.5,0,1,0.0,0,0,0.0,0,0,0,2,0,0,0,0,4,1,1,MEM,MEM,SAS,106,,,6,4,6,2
Derrick Rose,G,22023,201565,22300449,"DEC 31, 2023",MEM vs. SAC,L,12,1,3,0.333,0,0,0.0,0,0,0.0,0,0,0,3,0,0,1,0,2,-16,1,MEM,MEM,SAC,92,,,5,2,5,3
Derrick Rose,G,22023,201565,22300332,"DEC 15, 2023",MEM vs. HOU,L,9,1,3,0.333,1,2,0.5,0,0,0.0,0,1,1,2,0,0,0,0,3,11,1,MEM,MEM,HOU,96,,,6,4,5,3
Derrick Rose,G,22023,201565,22300314,"DEC 13, 2023",MEM @ HOU,L,31,7,14,0.5,1,4,0.25,4,4,1.0,1,3,4,6,0,1,1,4,19,-14,1,MEM,HOU,MEM,104,,,29,23,25,10
Derrick Rose,G,22023,201565,22300299,"DEC 11, 2023",MEM vs. DAL,L,17,2,7,0.286,1,3,0.333,2,2,1.0,0,3,3,4,0,0,2,1,7,-10,1,MEM,MEM,DAL,113,,,14,10,11,7
Derrick Rose,G,22023,201565,22301221,"DEC 08, 2023",MEM vs. MIN,L,22,2,7,0.286,0,1,0.0,2,2,1.0,0,1,1,7,0,0,1,1,6,-8,1,MEM,MEM,MIN,95,,,14,7,13,8
Derrick Rose,G,22023,201565,22301206,"DEC 06, 2023",MEM @ DET,W,15,2,7,0.286,0,1,0.0,0,0,0.0,0,1,1,2,2,0,5,1,4,2,1,MEM,DET,MEM,104,,,7,5,6,3
Derrick Rose,G,22023,201565,22300277,"DEC 01, 2023",MEM @ DAL,W,20,3,7,0.429,0,2,0.0,0,0,0.0,0,2,2,3,1,0,1,3,6,21,1,MEM,DAL,MEM,89,,,11,8,9,5
Derrick Rose,G,22023,201565,22300261,"NOV 29, 2023",MEM vs. UTA,W,27,7,11,0.636,0,3,0.0,0,0,0.0,0,4,4,9,0,0,1,2,14,20,1,MEM,MEM,UTA,105,,,27,18,23,13
Derrick Rose,G,22023,201565,22300249,"NOV 26, 2023",MEM vs. MIN,L,20,5,12,0.417,0,2,0.0,2,2,1.0,2,0,2,4,1,0,1,2,12,-3,1,MEM,MEM,MIN,91,,,18,14,16,6
Derrick Rose,G,22023,201565,22300044,"NOV 24, 2023",MEM vs. PHX,L,22,8,9,0.889,1,1,1.0,0,0,0.0,0,2,2,1,1,0,1,0,17,-10,1,MEM,MEM,PHX,89,,,20,19,18,3
Derrick Rose,G,22023,201565,22300231,"NOV 22, 2023",MEM @ HOU,L,16,1,3,0.333,1,2,0.5,4,4,1.0,0,1,1,2,0,0,2,0,7,-3,1,MEM,HOU,MEM,91,,,10,8,9,3
Derrick Rose,G,22023,201565,22300206,"NOV 18, 2023",MEM @ SAS,W,14,3,4,0.75,1,1,1.0,2,3,0.667,0,1,1,1,0,0,0,1,9,5,1,MEM,SAS,MEM,120,,,11,10,10,2
Derrick Rose,G,22023,201565,22300106,"OCT 30, 2023",MEM vs. DAL,L,14,0,4,0.0,0,1,0.0,1,2,0.5,0,1,1,0,0,0,0,1,1,-18,1,MEM,MEM,DAL,110,,,2,2,1,1
Derrick Rose,G,22023,201565,22300089,"OCT 28, 2023",MEM @ WAS,L,18,3,8,0.375,1,2,0.5,0,0,0.0,1,0,1,5,1,1,3,0,7,9,1,MEM,WAS,MEM,106,,,13,8,12,6
Derrick Rose,G,22023,201565,22300078,"OCT 27, 2023",MEM vs. DEN,L,22,6,14,0.429,2,3,0.667,2,2,1.0,2,2,4,3,1,0,3,2,16,-1,1,MEM,MEM,DEN,104,,,23,20,19,7
Derrick Rose,G,22023,201565,22300071,"OCT 25, 2023",MEM vs. NOP,L,16,3,11,0.273,2,4,0.5,0,0,0.0,1,1,2,3,0,0,0,0,8,-10,1,MEM,MEM,NOP,104,,,13,10,11,5
Walker Kessler,C,22023,1631117,22300711,"FEB 04, 2024",UTA vs. MIL,W,27,5,8,0.625,0,0,0.0,3,4,0.75,2,6,8,3,0,3,1,4,13,22,1,UTA,UTA,MIL,123,,,24,21,16,11
Walker Kessler,C,22023,1631117,22300686,"FEB 01, 2024",UTA vs. PHI,L,14,4,4,1.0,0,0,0.0,0,0,0.0,3,4,7,2,0,4,1,2,8,4,1,UTA,UTA,PHI,124,,,17,15,10,9
Walker Kessler,C,22023,1631117,22300671,"JAN 30, 2024",UTA @ NYK,L,16,2,4,0.5,0,0,0.0,2,2,1.0,3,4,7,0,0,4,1,0,6,-5,1,UTA,NYK,UTA,103,,,13,13,6,7
Walker Kessler,C,22023,1631117,22300660,"JAN 29, 2024",UTA @ BKN,L,19,4,5,0.8,0,0,0.0,3,4,0.75,4,3,7,0,0,1,0,1,11,-15,1,UTA,BKN,UTA,114,,,18,18,11,7
Walker Kessler,C,22023,1631117,22300647,"JAN 27, 2024",UTA @ CHA,W,16,5,6,0.833,0,0,0.0,0,0,0.0,1,3,4,0,0,3,2,1,10,2,1,UTA,CHA,UTA,134,,,14,14,10,4
Walker Kessler,C,22023,1631117,22300628,"JAN 25, 2024",UTA @ WAS,W,15,2,3,0.667,0,0,0.0,0,0,0.0,0,3,3,0,0,1,0,5,4,-7,1,UTA,WAS,UTA,123,,,7,7,4,3
Walker Kessler,C,22023,1631117,22300616,"JAN 23, 2024",UTA @ NOP,L,25,2,3,0.667,0,0,0.0,2,5,0.4,0,5,5,1,0,4,0,1,6,-26,1,UTA,NOP,UTA,124,,,12,11,7,6
Walker Kessler,C,22023,1631117,22300598,"JAN 20, 2024",UTA @ HOU,L,32,2,4,0.5,0,0,0.0,3,6,0.5,3,7,10,3,0,5,3,6,7,-7,1,UTA,HOU,UTA,126,,,20,17,10,13
Walker Kessler,C,22023,1631117,22300581,"JAN 18, 2024",UTA vs. OKC,L,24,3,4,0.75,0,0,0.0,1,2,0.5,5,6,11,1,1,3,1,1,7,15,1,UTA,UTA,OKC,129,,,19,18,8,12
Walker Kessler,C,22023,1631117,22300564,"JAN 15, 2024",UTA vs. IND,W,25,2,2,1.0,0,0,0.0,0,2,0.0,1,4,5,1,0,5,1,0,4,7,1,UTA,UTA,IND,132,,,10,9,5,6
Walker Kessler,C,22023,1631117,22300549,"JAN 13, 2024",UTA vs. LAL,W,14,2,4,0.5,0,0,0.0,0,2,0.0,2,4,6,0,0,1,0,2,4,-12,1,UTA,UTA,LAL,132,,,10,10,4,6
Walker Kessler,C,22023,1631117,22300540,"JAN 12, 2024",UTA vs. TOR,W,20,5,5,1.0,0,0,0.0,2,4,0.5,2,4,6,1,1,3,0,4,12,7,1,UTA,UTA,TOR,145,,,19,18,13,7
Walker Kessler,C,22023,1631117,22300524,"JAN 10, 2024",UTA vs. DEN,W,15,4,4,1.0,0,0,0.0,0,0,0.0,2,2,4,1,2,1,1,4,8,10,1,UTA,UTA,DEN,124,,,13,12,9,5
Walker Kessler,C,22023,1631117,22300510,"JAN 08, 2024",UTA @ MIL,W,21,3,4,0.75,0,0,0.0,2,4,0.5,2,4,6,0,1,2,0,1,8,10,1,UTA,MIL,UTA,132,,,14,14,8,6
Walker Kessler,C,22023,1631117,22300495,"JAN 06, 2024",UTA @ PHI,W,19,4,4,1.0,0,0,0.0,2,2,1.0,1,3,4,0,1,0,0,2,10,5,1,UTA,PHI,UTA,120,,,14,14,10,4
Walker Kessler,C,22023,1631117,22300479,"JAN 05, 2024",UTA @ BOS,L,14,2,3,0.667,0,0,0.0,0,0,0.0,1,6,7,0,0,0,0,2,4,-4,1,UTA,BOS,UTA,97,,,11,11,4,7
Walker Kessler,C,22023,1631117,22300474,"JAN 03, 2024",UTA vs. DET,W,29,4,6,0.667,0,0,0.0,0,0,0.0,3,5,8,1,0,6,0,4,8,15,1,UTA,UTA,DET,154,,,17,16,9,9
Walker Kessler,C,22023,1631117,22300457,"JAN 01, 2024",UTA vs. DAL,W,27,5,6,0.833,0,1,0.0,1,2,0.5,0,10,10,0,1,4,1,2,11,37,1,UTA,UTA,DAL,127,,,21,21,11,10
Walker Kessler,C,22023,1631117,22300439,"DEC 30, 2023",UTA vs. MIA,W,23,5,5,1.0,0,0,0.0,0,0,0.0,0,8,8,0,0,2,0,1,10,10,1,UTA,UTA,MIA,117,,,18,18,10,8
Walker Kessler,C,22023,1631117,22300424,"DEC 28, 2023",UTA @ NOP,L,29,5,5,1.0,1,1,1.0,0,0,0.0,3,1,4,0,2,1,2,2,11,9,1,UTA,NOP,UTA,105,,,15,15,11,4
Walker Kessler,C,22023,1631117,22300412,"DEC 26, 2023",UTA @ SAS,W,18,5,10,0.5,1,1,1.0,0,0,0.0,3,4,7,1,1,4,1,2,11,1,1,UTA,SAS,UTA,130,,,19,18,12,8
Walker Kessler,C,22023,1631117,22300395,"DEC 23, 2023",UTA @ TOR,W,25,5,6,0.833,0,0,0.0,0,0,0.0,3,5,8,1,0,2,1,2,10,17,1,UTA,TOR,UTA,126,,,19,18,11,9
Walker Kessler,C,22023,1631117,22300374,"DEC 21, 2023",UTA @ DET,W,20,2,3,0.667,0,0,0.0,0,1,0.0,5,5,10,1,0,4,1,1,4,17,1,UTA,DET,UTA,119,,,15,14,5,11
Walker Kessler,C,22023,1631117,22300364,"DEC 20, 2023",UTA @ CLE,L,30,5,8,0.625,0,1,0.0,0,0,0.0,1,4,5,0,2,1,2,2,10,5,1,UTA,CLE,UTA,116,,,15,15,10,5
Walker Kessler,C,22023,1631117,22300357,"DEC 18, 2023",UTA vs. BKN,W,32,6,8,0.75,0,0,0.0,2,4,0.5,3,11,14,0,0,5,1,1,14,9,1,UTA,UTA,BKN,125,,,28,28,14,14
Walker Kessler,C,22023,1631117,22300342,"DEC 16, 2023",UTA @ SAC,L,18,0,0,0.0,0,0,0.0,2,4,0.5,1,2,3,1,0,1,1,2,2,-28,1,UTA,SAC,UTA,104,,,6,5,3,4
Walker Kessler,C,22023,1631117,22300323,"DEC 14, 2023",UTA @ POR,W,26,5,6,0.833,0,1,0.0,0,0,0.0,2,8,10,4,1,7,1,0,10,23,1,UTA,POR,UTA,122,,,24,20,14,14
Walker Kessler,C,22023,1631117,22300318,"DEC 13, 2023",UTA vs. NYK,W,23,4,7,0.571,0,0,0.0,1,3,0.333,4,5,9,1,0,3,2,3,9,3,1,UTA,UTA,NYK,117,,,19,18,10,10
Walker Kessler,C,22023,1631117,22301225,"DEC 08, 2023",UTA vs. LAC,L,31,4,9,0.444,0,0,0.0,0,0,0.0,4,8,12,3,2,5,2,2,8,-10,1,UTA,UTA,LAC,103,,,23,20,11,15
Walker Kessler,C,22023,1631117,22301213,"DEC 06, 2023",UTA @ DAL,L,27,3,7,0.429,0,0,0.0,0,0,0.0,4,4,8,0,1,0,2,4,6,-15,1,UTA,DAL,UTA,97,,,14,14,6,8
Walker Kessler,C,22023,1631117,22300289,"DEC 02, 2023",UTA vs. POR,W,25,6,6,1.0,0,0,0.0,0,0,0.0,4,4,8,0,0,2,2,1,12,-5,1,UTA,UTA,POR,118,,,20,20,12,8
Walker Kessler,C,22023,1631117,22300270,"NOV 30, 2023",UTA @ MIN,L,27,3,6,0.5,0,2,0.0,1,2,0.5,0,5,5,2,1,3,1,1,7,-7,1,UTA,MIN,UTA,90,,,14,12,9,7
Walker Kessler,C,22023,1631117,22300261,"NOV 29, 2023",UTA @ MEM,L,28,4,11,0.364,0,2,0.0,1,2,0.5,3,5,8,2,1,6,1,0,9,-2,1,UTA,MEM,UTA,91,,,19,17,11,10
Walker Kessler,C,22023,1631117,22300256,"NOV 27, 2023",UTA vs. NOP,W,26,7,9,0.778,0,0,0.0,0,1,0.0,1,7,8,3,0,2,0,4,14,3,1,UTA,UTA,NOP,114,,,25,22,17,11
Walker Kessler,C,22023,1631117,22300243,"NOV 25, 2023",UTA vs. NOP,W,21,5,10,0.5,0,1,0.0,1,1,1.0,6,5,11,0,1,2,3,5,11,-1,1,UTA,UTA,NOP,105,,,22,22,11,11
Walker Kessler,C,22023,1631117,22300152,"NOV 06, 2023",UTA @ CHI,L,31,5,12,0.417,1,2,0.5,4,6,0.667,11,4,15,0,0,4,1,3,15,-14,1,UTA,CHI,UTA,113,,,30,30,15,15
Walker Kessler,C,22023,1631117,22300138,"NOV 04, 2023",UTA @ MIN,L,22,2,3,0.667,0,0,0.0,0,0,0.0,1,3,4,0,0,3,0,0,4,-14,1,UTA,MIN,UTA,95,,,8,8,4,4
Walker Kessler,C,22023,1631117,22300130,"NOV 02, 2023",UTA vs. ORL,L,25,2,6,0.333,0,0,0.0,0,0,0.0,3,7,10,1,0,5,1,2,4,-10,1,UTA,UTA,ORL,113,,,15,14,5,11
Walker Kessler,C,22023,1631117,22300125,"NOV 01, 2023",UTA vs. MEM,W,18,1,4,0.25,0,0,0.0,2,4,0.5,1,3,4,0,0,2,0,2,4,-13,1,UTA,UTA,MEM,133,,,8,8,4,4
Walker Kessler,C,22023,1631117,22300110,"OCT 30, 2023",UTA @ DEN,L,29,10,11,0.909,0,0,0.0,2,3,0.667,3,10,13,0,0,1,2,4,22,-2,1,UTA,DEN,UTA,102,,,35,35,22,13
Walker Kessler,C,22023,1631117,22300094,"OCT 28, 2023",UTA @ PHX,L,23,1,4,0.25,0,2,0.0,0,0,0.0,2,3,5,1,0,1,3,3,2,-17,1,UTA,PHX,UTA,104,,,8,7,3,6
Walker Kessler,C,22023,1631117,22300085,"OCT 27, 2023",UTA vs. LAC,W,21,3,6,0.5,1,2,0.5,0,0,0.0,2,2,4,0,0,0,0,0,7,6,1,UTA,UTA,LAC,120,,,11,11,7,4
Walker Kessler,C,22023,1631117,22300072,"OCT 25, 2023",UTA vs. SAC,L,22,4,5,0.8,0,0,0.0,0,0,0.0,4,4,8,0,0,1,1,3,8,-14,1,UTA,UTA,SAC,114,,,16,16,8,8
Walker Kessler,C,22023,1631117,22300739,"FEB 08, 2024",UTA @ PHX,L,27,4,6,0.667,0,0,0.0,2,2,1.0,5,4,9,2,2,4,0,1,10,-5,1,UTA,PHX,UTA,115,,,21,19,12,11
Walker Kessler,C,22023,1631117,22300724,"FEB 06, 2024",UTA vs. OKC,W,21,2,2,1.0,0,0,0.0,0,0,0.0,1,8,9,1,0,3,1,3,4,2,1,UTA,UTA,OKC,124,,,14,13,5,10
Jabari Walker,F,22023,1631133,22300758,"FEB 10, 2024",POR vs. NOP,L,29,3,5,0.6,0,1,0.0,0,0,0.0,1,3,4,0,0,0,1,4,6,-16,1,POR,POR,NOP,75,,,10,10,6,4
Jabari Walker,F,22023,1631133,22300712,"FEB 04, 2024",POR @ DEN,L,30,2,8,0.25,0,5,0.0,0,0,0.0,3,4,7,0,0,0,1,1,4,-22,1,POR,DEN,POR,103,,,11,11,4,7
Jabari Walker,F,22023,1631133,22300697,"FEB 02, 2024",POR @ DEN,L,21,3,7,0.429,0,1,0.0,1,1,1.0,4,4,8,0,0,0,1,2,7,-25,1,POR,DEN,POR,108,,,15,15,7,8
Jabari Walker,F,22023,1631133,22300683,"JAN 31, 2024",POR vs. MIL,W,16,3,4,0.75,1,2,0.5,1,1,1.0,1,4,5,2,1,0,1,3,8,-6,1,POR,POR,MIL,119,,,15,13,10,7
Jabari Walker,F,22023,1631133,22300668,"JAN 29, 2024",POR vs. PHI,W,31,3,6,0.5,1,1,1.0,1,2,0.5,2,10,12,0,1,0,1,1,8,17,1,POR,POR,PHI,128,,,20,20,8,12
Jabari Walker,F,22023,1631133,22300656,"JAN 28, 2024",POR vs. CHI,L,24,3,10,0.3,0,3,0.0,1,1,1.0,1,5,6,0,0,1,3,4,7,-10,1,POR,POR,CHI,96,,,13,13,7,6
Jabari Walker,F,22023,1631133,22300641,"JAN 26, 2024",POR @ SAS,L,37,1,5,0.2,0,2,0.0,1,4,0.25,2,7,9,2,2,1,0,2,3,-21,1,POR,SAS,POR,98,,,14,12,5,11
Jabari Walker,F,22023,1631133,22300623,"JAN 24, 2024",POR @ HOU,W,24,2,4,0.5,1,2,0.5,4,4,1.0,1,6,7,1,0,0,2,4,9,7,1,POR,HOU,POR,137,,,17,16,10,8
Jabari Walker,F,22023,1631133,22300617,"JAN 23, 2024",POR @ OKC,L,34,6,14,0.429,2,7,0.286,0,0,0.0,6,7,13,0,0,1,1,0,14,-7,1,POR,OKC,POR,109,,,27,27,14,13
Jabari Walker,F,22023,1631133,22300605,"JAN 21, 2024",POR @ LAL,L,22,5,8,0.625,1,2,0.5,1,2,0.5,3,4,7,0,0,0,0,0,12,-30,1,POR,LAL,POR,108,,,19,19,12,7
Jabari Walker,F,22023,1631133,22300590,"JAN 19, 2024",POR vs. IND,W,41,4,11,0.364,0,2,0.0,5,6,0.833,2,10,12,3,0,1,0,3,13,3,1,POR,POR,IND,118,,,28,25,16,15
Jabari Walker,F,22023,1631133,22300399,"DEC 23, 2023",POR @ GSW,L,18,2,4,0.5,0,2,0.0,1,2,0.5,2,3,5,0,0,1,1,2,5,-25,1,POR,GSW,POR,106,,,10,10,5,5
Jabari Walker,F,22023,1631133,22300381,"DEC 21, 2023",POR vs. WAS,L,24,3,6,0.5,1,2,0.5,1,2,0.5,4,7,11,3,1,1,2,3,8,18,1,POR,POR,WAS,117,,,22,19,11,14
Jabari Walker,F,22023,1631133,22300363,"DEC 19, 2023",POR vs. PHX,W,10,3,3,1.0,1,1,1.0,2,2,1.0,1,1,2,0,0,0,0,2,9,13,1,POR,POR,PHX,109,,,11,11,9,2
Jabari Walker,F,22023,1631133,22300348,"DEC 17, 2023",POR vs. GSW,L,15,1,3,0.333,0,0,0.0,2,2,1.0,2,3,5,0,1,1,1,4,4,0,1,POR,POR,GSW,114,,,9,9,4,5
Jabari Walker,F,22023,1631133,22300341,"DEC 16, 2023",POR vs. DAL,L,5,0,1,0.0,0,1,0.0,0,0,0.0,0,2,2,0,0,0,0,0,0,-2,1,POR,POR,DAL,120,,,2,2,0,2
Jabari Walker,F,22023,1631133,22300323,"DEC 14, 2023",POR vs. UTA,L,28,5,10,0.5,0,2,0.0,3,5,0.6,4,5,9,1,1,0,0,0,13,13,1,POR,POR,UTA,114,,,23,22,14,10
Jabari Walker,F,22023,1631133,22300289,"DEC 02, 2023",POR @ UTA,L,24,1,5,0.2,0,2,0.0,2,2,1.0,2,4,6,1,1,0,1,0,4,-5,1,POR,UTA,POR,113,,,11,10,5,7
Jabari Walker,F,22023,1631133,22300265,"NOV 30, 2023",POR @ CLE,W,24,3,7,0.429,0,2,0.0,0,0,0.0,2,10,12,1,1,0,1,3,6,5,1,POR,CLE,POR,103,,,19,18,7,13
Jabari Walker,F,22023,1631133,22300254,"NOV 27, 2023",POR @ IND,W,15,0,3,0.0,0,1,0.0,1,2,0.5,1,2,3,0,0,0,1,2,1,-4,1,POR,IND,POR,114,,,4,4,1,3
Jabari Walker,F,22023,1631133,22300245,"NOV 26, 2023",POR @ MIL,L,16,2,3,0.667,0,1,0.0,0,0,0.0,0,3,3,0,0,0,1,4,4,6,1,POR,MIL,POR,102,,,7,7,4,3
Jabari Walker,F,22023,1631133,22300041,"NOV 21, 2023",POR @ PHX,L,14,3,6,0.5,0,2,0.0,2,2,1.0,0,3,3,0,0,0,1,5,8,-4,1,POR,PHX,POR,107,,,11,11,8,3
Jabari Walker,F,22023,1631133,22300215,"NOV 19, 2023",POR vs. OKC,L,22,6,15,0.4,1,5,0.2,0,1,0.0,3,4,7,2,1,0,3,2,13,-21,1,POR,POR,OKC,89,,,22,20,15,9
Jabari Walker,F,22023,1631133,22300036,"NOV 17, 2023",POR vs. LAL,L,18,2,6,0.333,0,2,0.0,3,5,0.6,2,3,5,1,0,0,0,0,7,2,1,POR,POR,LAL,95,,,13,12,8,6
Jabari Walker,F,22023,1631133,22300199,"NOV 15, 2023",POR vs. CLE,L,23,4,7,0.571,3,4,0.75,1,2,0.5,1,2,3,1,0,2,2,2,12,-12,1,POR,POR,CLE,93,,,16,15,13,4
Jabari Walker,F,22023,1631133,22300023,"NOV 14, 2023",POR @ UTA,L,21,5,7,0.714,2,3,0.667,0,0,0.0,2,6,8,0,2,1,0,0,12,-8,1,POR,UTA,POR,99,,,20,20,12,8
Jabari Walker,F,22023,1631133,22300187,"NOV 12, 2023",POR @ LAL,L,18,4,7,0.571,0,2,0.0,0,0,0.0,0,4,4,1,1,1,0,3,8,7,1,POR,LAL,POR,104,,,13,12,9,5
Jabari Walker,F,22023,1631133,22300170,"NOV 08, 2023",POR @ SAC,L,15,1,2,0.5,0,1,0.0,0,0,0.0,0,2,2,1,0,0,1,4,2,-12,1,POR,SAC,POR,118,,,5,4,3,3
Jabari Walker,F,22023,1631133,22300144,"NOV 05, 2023",POR vs. MEM,L,16,2,9,0.222,0,5,0.0,1,1,1.0,3,2,5,1,3,1,0,2,5,4,1,POR,POR,MEM,100,,,11,10,6,6
Jabari Walker,F,22023,1631133,22300007,"NOV 03, 2023",POR vs. MEM,W,9,0,2,0.0,0,0,0.0,0,0,0.0,1,3,4,0,0,1,0,2,0,-7,1,POR,POR,MEM,115,,,4,4,0,4
Jabari Walker,F,22023,1631133,22300115,"NOV 01, 2023",POR @ DET,W,10,0,2,0.0,0,0,0.0,1,2,0.5,0,2,2,0,0,0,1,0,1,-6,1,POR,DET,POR,110,,,3,3,1,2
Jabari Walker,F,22023,1631133,22300105,"OCT 30, 2023",POR @ TOR,W,16,2,3,0.667,0,0,0.0,0,0,0.0,0,3,3,0,0,1,1,2,4,1,1,POR,TOR,POR,99,,,7,7,4,3
Jabari Walker,F,22023,1631133,22300098,"OCT 29, 2023",POR @ PHI,L,24,4,9,0.444,1,3,0.333,3,3,1.0,3,4,7,1,4,1,2,4,12,5,1,POR,PHI,POR,98,,,20,19,13,8
Jabari Walker,F,22023,1631133,22300086,"OCT 27, 2023",POR vs. ORL,L,9,2,3,0.667,1,2,0.5,4,4,1.0,1,3,4,0,0,0,0,3,9,1,1,POR,POR,ORL,97,,,13,13,9,4
Jabari Walker,F,22023,1631133,22300074,"OCT 25, 2023",POR @ LAC,L,6,2,3,0.667,0,0,0.0,2,3,0.667,1,0,1,0,0,0,2,0,6,12,1,POR,LAC,POR,111,,,7,7,6,1
Jabari Walker,F,22023,1631133,22300578,"JAN 17, 2024",POR vs. BKN,W,30,1,4,0.25,1,1,1.0,1,2,0.5,0,6,6,0,1,0,0,2,4,-6,1,POR,POR,BKN,103,,,10,10,4,6
Jabari Walker,F,22023,1631133,22300538,"JAN 12, 2024",POR @ MIN,L,32,6,11,0.545,1,2,0.5,4,4,1.0,2,11,13,3,1,0,4,4,17,1,1,POR,MIN,POR,91,,,33,30,20,16
Jabari Walker,F,22023,1631133,22300472,"JAN 03, 2024",POR @ DAL,L,17,1,3,0.333,0,1,0.0,2,2,1.0,1,4,5,4,0,0,1,2,4,-13,1,POR,DAL,POR,97,,,13,9,8,9
Jabari Walker,F,22023,1631133,22300456,"JAN 01, 2024",POR @ PHX,L,25,3,7,0.429,0,2,0.0,4,6,0.667,2,7,9,0,1,0,1,2,10,-16,1,POR,PHX,POR,84,,,19,19,10,9
Jabari Walker,F,22023,1631133,22300437,"DEC 29, 2023",POR vs. SAS,W,30,7,11,0.636,1,2,0.5,10,13,0.769,6,3,9,1,1,1,1,4,25,12,1,POR,POR,SAS,132,,,35,34,26,10
Jabari Walker,F,22023,1631133,22300427,"DEC 28, 2023",POR vs. SAS,L,30,2,4,0.5,0,0,0.0,2,2,1.0,2,7,9,0,1,1,1,4,6,-18,1,POR,POR,SAS,98,,,15,15,6,9
Jabari Walker,F,22023,1631133,22300413,"DEC 26, 2023",POR vs. SAC,W,22,6,8,0.75,1,2,0.5,4,5,0.8,2,4,6,1,0,0,0,1,17,13,1,POR,POR,SAC,130,,,24,23,18,7
Jabari Walker,F,22023,1631133,22301214,"DEC 06, 2023",POR @ GSW,L,22,5,8,0.625,0,2,0.0,2,2,1.0,2,3,5,1,1,1,2,6,12,-5,1,POR,GSW,POR,106,,,18,17,13,6
Jabari Walker,F,22023,1631133,22300237,"NOV 22, 2023",POR vs. UTA,W,28,8,15,0.533,2,3,0.667,1,2,0.5,6,4,10,2,2,0,1,4,19,11,1,POR,POR,UTA,121,,,31,29,21,12
Jabari Walker,F,22023,1631133,22300304,"DEC 11, 2023",POR @ LAC,L,22,3,4,0.75,1,2,0.5,2,2,1.0,3,5,8,1,1,0,1,1,9,1,1,POR,LAC,POR,127,,,18,17,10,9
Jabari Walker,F,22023,1631133,22300741,"FEB 08, 2024",POR vs. DET,L,43,6,14,0.429,1,3,0.333,4,6,0.667,3,8,11,2,1,2,1,3,17,-5,1,POR,POR,DET,118,,,30,28,19,13
Jabari Walker,F,22023,1631133,22300554,"JAN 14, 2024",POR vs. PHX,L,29,4,6,0.667,2,3,0.667,1,2,0.5,2,6,8,1,0,0,1,2,11,-15,1,POR,POR,PHX,116,,,20,19,12,9
Jabari Walker,F,22023,1631133,22301226,"DEC 08, 2023",POR vs. DAL,L,27,3,10,0.3,1,3,0.333,3,3,1.0,1,2,3,2,0,0,0,2,10,-15,1,POR,POR,DAL,112,,,15,13,12,5
Vince Williams Jr.,G,22023,1631246,22300751,"FEB 10, 2024",MEM @ CHA,L,37,6,13,0.462,2,6,0.333,0,0,0.0,0,2,2,8,2,0,3,3,14,-9,1,MEM,CHA,MEM,105,,,24,16,22,10
Vince Williams Jr.,G,22023,1631246,22300737,"FEB 08, 2024",MEM vs. CHI,L,37,5,10,0.5,2,5,0.4,1,1,1.0,0,11,11,8,3,0,1,2,13,-9,1,MEM,MEM,CHI,95,,,32,24,21,19
Vince Williams Jr.,G,22023,1631246,22300722,"FEB 06, 2024",MEM @ NYK,L,35,6,17,0.353,3,5,0.6,4,4,1.0,1,2,3,5,1,0,4,4,19,-6,1,MEM,NYK,MEM,97,,,27,22,24,8
Vince Williams Jr.,G,22023,1631246,22300693,"FEB 02, 2024",MEM vs. GSW,L,31,6,12,0.5,1,5,0.2,2,5,0.4,1,5,6,4,0,1,4,5,15,-13,1,MEM,MEM,GSW,98,,,25,21,19,10
Vince Williams Jr.,G,22023,1631246,22300687,"FEB 01, 2024",MEM vs. CLE,L,31,5,10,0.5,1,5,0.2,6,6,1.0,2,4,6,2,1,1,2,2,17,-10,1,MEM,MEM,CLE,86,,,25,23,19,8
Vince Williams Jr.,G,22023,1631246,22300652,"JAN 28, 2024",MEM @ IND,L,36,8,12,0.667,2,3,0.667,2,4,0.5,4,4,8,1,0,0,0,3,20,-1,1,MEM,IND,MEM,106,,,29,28,21,9
Vince Williams Jr.,G,22023,1631246,22300638,"JAN 26, 2024",MEM vs. ORL,W,36,3,9,0.333,3,8,0.375,2,4,0.5,0,5,5,4,0,2,1,4,11,2,1,MEM,MEM,ORL,107,,,20,16,15,9
Vince Williams Jr.,G,22023,1631246,22300609,"JAN 22, 2024",MEM @ TOR,W,35,7,11,0.636,2,4,0.5,2,3,0.667,3,7,10,1,2,1,2,2,18,5,1,MEM,TOR,MEM,108,,,29,28,19,11
Vince Williams Jr.,G,22023,1631246,22300597,"JAN 20, 2024",MEM @ CHI,L,30,5,9,0.556,3,6,0.5,1,2,0.5,0,5,5,2,1,0,2,2,14,-5,1,MEM,CHI,MEM,93,,,21,19,16,7
Vince Williams Jr.,G,22023,1631246,22300582,"JAN 18, 2024",MEM @ MIN,L,35,3,8,0.375,2,5,0.4,2,2,1.0,2,5,7,5,3,1,2,3,10,-8,1,MEM,MIN,MEM,103,,,22,17,15,12
Vince Williams Jr.,G,22023,1631246,22300560,"JAN 15, 2024",MEM vs. GSW,W,38,6,11,0.545,3,6,0.5,9,10,0.9,3,4,7,4,2,1,3,2,24,2,1,MEM,MEM,GSW,116,,,35,31,28,11
Vince Williams Jr.,G,22023,1631246,22300503,"JAN 07, 2024",MEM @ PHX,W,37,6,11,0.545,3,4,0.75,4,4,1.0,4,5,9,1,0,2,0,2,19,22,1,MEM,PHX,MEM,121,,,29,28,20,10
Vince Williams Jr.,G,22023,1631246,22300460,"JAN 02, 2024",MEM vs. SAS,W,22,3,6,0.5,2,5,0.4,0,0,0.0,1,4,5,2,0,0,2,5,8,13,1,MEM,MEM,SAS,106,,,15,13,10,7
Vince Williams Jr.,G,22023,1631246,22300449,"DEC 31, 2023",MEM vs. SAC,L,18,0,4,0.0,0,4,0.0,0,0,0.0,0,6,6,1,0,0,0,1,0,-16,1,MEM,MEM,SAC,92,,,7,6,1,7
Vince Williams Jr.,G,22023,1631246,22300438,"DEC 29, 2023",MEM @ LAC,L,22,1,6,0.167,1,4,0.25,2,3,0.667,0,1,1,5,0,1,1,3,5,0,1,MEM,LAC,MEM,106,,,11,6,10,6
Vince Williams Jr.,G,22023,1631246,22300410,"DEC 26, 2023",MEM @ NOP,W,27,1,4,0.25,1,4,0.25,3,4,0.75,2,6,8,3,1,3,2,0,6,0,1,MEM,NOP,MEM,116,,,17,14,9,11
Vince Williams Jr.,G,22023,1631246,22300393,"DEC 23, 2023",MEM @ ATL,W,35,2,6,0.333,1,5,0.2,0,0,0.0,2,9,11,1,2,0,1,4,5,13,1,MEM,ATL,MEM,125,,,17,16,6,12
Vince Williams Jr.,G,22023,1631246,22300377,"DEC 21, 2023",MEM vs. IND,W,35,1,5,0.2,0,3,0.0,0,0,0.0,1,3,4,3,3,1,2,2,2,14,1,MEM,MEM,IND,116,,,9,6,5,7
Vince Williams Jr.,G,22023,1631246,22300360,"DEC 19, 2023",MEM @ NOP,W,35,3,6,0.5,3,5,0.6,0,0,0.0,1,6,7,3,0,1,1,1,9,-8,1,MEM,NOP,MEM,115,,,19,16,12,10
Vince Williams Jr.,G,22023,1631246,22300355,"DEC 18, 2023",MEM @ OKC,L,23,2,7,0.286,1,5,0.2,0,0,0.0,2,3,5,1,0,0,1,3,5,-26,1,MEM,OKC,MEM,97,,,11,10,6,6
Vince Williams Jr.,G,22023,1631246,22300332,"DEC 15, 2023",MEM vs. HOU,L,30,4,8,0.5,3,6,0.5,0,0,0.0,1,7,8,3,1,2,3,2,11,-8,1,MEM,MEM,HOU,96,,,22,19,14,11
Vince Williams Jr.,G,22023,1631246,22300314,"DEC 13, 2023",MEM @ HOU,L,28,2,5,0.4,2,4,0.5,4,6,0.667,1,6,7,1,1,0,0,6,10,-3,1,MEM,HOU,MEM,104,,,18,17,11,8
Vince Williams Jr.,G,22023,1631246,22300299,"DEC 11, 2023",MEM vs. DAL,L,26,3,4,0.75,2,3,0.667,2,2,1.0,3,6,9,1,0,0,1,3,10,0,1,MEM,MEM,DAL,113,,,20,19,11,10
Vince Williams Jr.,G,22023,1631246,22301221,"DEC 08, 2023",MEM vs. MIN,L,17,1,5,0.2,1,4,0.25,1,2,0.5,1,1,2,1,0,0,1,1,4,-8,1,MEM,MEM,MIN,95,,,7,6,5,3
Vince Williams Jr.,G,22023,1631246,22301206,"DEC 06, 2023",MEM @ DET,W,25,1,2,0.5,1,2,0.5,0,0,0.0,0,4,4,1,1,0,0,0,3,17,1,MEM,DET,MEM,104,,,8,7,4,5
Vince Williams Jr.,G,22023,1631246,22300288,"DEC 02, 2023",MEM @ PHX,L,30,3,5,0.6,1,3,0.333,5,5,1.0,0,5,5,2,0,0,1,6,12,2,1,MEM,PHX,MEM,101,,,19,17,14,7
Vince Williams Jr.,G,22023,1631246,22300277,"DEC 01, 2023",MEM @ DAL,W,26,6,9,0.667,3,6,0.5,0,0,0.0,2,7,9,3,0,2,1,4,15,11,1,MEM,DAL,MEM,89,,,27,24,18,12
Vince Williams Jr.,G,22023,1631246,22300261,"NOV 29, 2023",MEM vs. UTA,W,20,1,3,0.333,1,3,0.333,0,0,0.0,2,6,8,2,1,0,2,3,3,6,1,MEM,MEM,UTA,105,,,13,11,5,10
Vince Williams Jr.,G,22023,1631246,22300249,"NOV 26, 2023",MEM vs. MIN,L,10,0,2,0.0,0,2,0.0,0,0,0.0,1,2,3,1,1,0,0,1,0,-11,1,MEM,MEM,MIN,91,,,4,3,1,4
Vince Williams Jr.,G,22023,1631246,22300044,"NOV 24, 2023",MEM vs. PHX,L,14,1,2,0.5,1,2,0.5,0,0,0.0,0,5,5,1,0,0,0,4,3,-6,1,MEM,MEM,PHX,89,,,9,8,4,6
Vince Williams Jr.,G,22023,1631246,22300231,"NOV 22, 2023",MEM @ HOU,L,4,0,1,0.0,0,1,0.0,0,0,0.0,0,1,1,0,0,0,0,0,0,3,1,MEM,HOU,MEM,91,,,1,1,0,1
Vince Williams Jr.,G,22023,1631246,22300213,"NOV 19, 2023",MEM vs. BOS,L,17,2,4,0.5,2,3,0.667,0,0,0.0,0,0,0,0,0,2,0,2,6,8,1,MEM,MEM,BOS,100,,,6,6,6,0
Vince Williams Jr.,G,22023,1631246,22300026,"NOV 14, 2023",MEM @ LAL,L,5,0,1,0.0,0,1,0.0,0,0,0.0,0,1,1,0,0,0,0,0,0,-5,1,MEM,LAL,MEM,107,,,1,1,0,1
Vince Williams Jr.,G,22023,1631246,22300537,"JAN 12, 2024",MEM vs. LAC,L,27,2,6,0.333,2,5,0.4,0,0,0.0,2,1,3,1,1,0,1,2,6,-8,1,MEM,MEM,LAC,119,,,10,9,7,4
Vince Williams Jr.,G,22023,1631246,22300515,"JAN 09, 2024",MEM @ DAL,W,30,2,8,0.25,2,5,0.4,0,0,0.0,2,4,6,6,3,0,3,5,6,0,1,MEM,DAL,MEM,120,,,18,12,12,12
Vince Williams Jr.,G,22023,1631246,22300425,"DEC 28, 2023",MEM @ DEN,L,30,1,7,0.143,1,4,0.25,2,2,1.0,4,7,11,2,0,0,0,3,5,-23,1,MEM,DEN,MEM,105,,,18,16,7,13
Vince Williams Jr.,G,22023,1631246,22300007,"NOV 03, 2023",MEM @ POR,L,10,0,2,0.0,0,2,0.0,0,0,0.0,0,2,2,1,0,0,1,1,0,15,1,MEM,POR,MEM,113,,,3,2,1,3
Vince Williams Jr.,G,22023,1631246,22300125,"NOV 01, 2023",MEM @ UTA,L,16,2,5,0.4,1,4,0.25,7,8,0.875,0,2,2,3,1,3,1,3,12,9,1,MEM,UTA,MEM,109,,,17,14,15,5
Vince Williams Jr.,G,22023,1631246,22300106,"OCT 30, 2023",MEM vs. DAL,L,1,0,0,0.0,0,0,0.0,0,0,0.0,0,0,0,0,0,0,0,0,0,0,1,MEM,MEM,DAL,110,,,0,0,0,0
Vince Williams Jr.,G,22023,1631246,22300621,"JAN 24, 2024",MEM @ MIA,W,33,8,10,0.8,5,6,0.833,4,4,1.0,0,5,5,4,1,0,1,3,25,10,1,MEM,MIA,MEM,90,,,34,30,29,9
Vince Williams Jr.,G,22023,1631246,22300544,"JAN 13, 2024",MEM vs. NYK,L,36,5,13,0.385,1,7,0.143,6,8,0.75,3,5,8,8,2,1,4,1,17,-4,1,MEM,MEM,NYK,94,,,33,25,25,16
Bilal Coulibaly,G,22023,1641731,22300753,"FEB 10, 2024",WAS vs. PHI,L,30,3,6,0.5,0,1,0.0,7,10,0.7,3,2,5,1,0,0,3,1,13,-14,1,WAS,WAS,PHI,113,,,19,18,14,6
Bilal Coulibaly,G,22023,1641731,22300743,"FEB 09, 2024",WAS @ BOS,L,33,6,18,0.333,4,12,0.333,5,5,1.0,3,5,8,3,2,0,2,4,21,6,1,WAS,BOS,WAS,129,,,32,29,24,11
Bilal Coulibaly,G,22023,1641731,22300728,"FEB 07, 2024",WAS vs. CLE,L,28,2,5,0.4,1,2,0.5,1,1,1.0,0,3,3,1,0,0,4,4,6,-17,1,WAS,WAS,CLE,106,,,10,9,7,4
Bilal Coulibaly,G,22023,1641731,22300705,"FEB 04, 2024",WAS vs. PHX,L,25,0,2,0.0,0,1,0.0,0,0,0.0,0,1,1,0,0,0,1,0,0,-25,1,WAS,WAS,PHX,109,,,1,1,0,1
Bilal Coulibaly,G,22023,1641731,22300689,"FEB 02, 2024",WAS vs. MIA,L,25,1,4,0.25,0,2,0.0,3,3,1.0,0,4,4,3,1,1,1,2,5,-19,1,WAS,WAS,MIA,102,,,12,9,8,7
Bilal Coulibaly,G,22023,1641731,22300676,"JAN 31, 2024",WAS vs. LAC,L,37,8,16,0.5,1,4,0.25,2,3,0.667,2,2,4,2,1,2,1,2,19,-9,1,WAS,WAS,LAC,107,,,25,23,21,6
Bilal Coulibaly,G,22023,1641731,22300665,"JAN 29, 2024",WAS @ SAS,W,31,5,6,0.833,2,2,1.0,1,1,1.0,1,0,1,1,2,1,1,2,13,13,1,WAS,SAS,WAS,118,,,15,14,14,2
Bilal Coulibaly,G,22023,1641731,22300642,"JAN 27, 2024",WAS @ DET,W,31,2,7,0.286,1,3,0.333,3,3,1.0,0,7,7,2,1,1,1,3,8,9,1,WAS,DET,WAS,118,,,17,15,10,9
Bilal Coulibaly,G,22023,1641731,22300628,"JAN 25, 2024",WAS vs. UTA,L,29,0,5,0.0,0,2,0.0,2,2,1.0,0,1,1,2,3,0,2,1,2,-14,1,WAS,WAS,UTA,108,,,5,3,4,3
Bilal Coulibaly,G,22023,1641731,22300620,"JAN 24, 2024",WAS vs. MIN,L,20,2,7,0.286,0,3,0.0,0,0,0.0,0,0,0,1,0,0,3,1,4,2,1,WAS,WAS,MIN,107,,,5,4,5,1
Bilal Coulibaly,G,22023,1641731,22300602,"JAN 21, 2024",WAS vs. DEN,L,31,4,9,0.444,1,3,0.333,0,0,0.0,1,2,3,1,1,4,2,2,9,-14,1,WAS,WAS,DEN,104,,,13,12,10,4
Bilal Coulibaly,G,22023,1641731,22300594,"JAN 20, 2024",WAS vs. SAS,L,23,6,9,0.667,2,2,1.0,0,2,0.0,2,2,4,1,0,1,1,1,14,3,1,WAS,WAS,SAS,127,,,19,18,15,5
Bilal Coulibaly,G,22023,1641731,22300579,"JAN 18, 2024",WAS @ NYK,L,17,1,4,0.25,1,3,0.333,2,2,1.0,0,3,3,2,0,0,0,3,5,4,1,WAS,NYK,WAS,109,,,10,8,7,5
Bilal Coulibaly,G,22023,1641731,22300558,"JAN 15, 2024",WAS vs. DET,L,27,1,4,0.25,0,1,0.0,0,0,0.0,1,3,4,2,0,0,0,2,2,-20,1,WAS,WAS,DET,117,,,8,6,4,6
Bilal Coulibaly,G,22023,1641731,22300543,"JAN 13, 2024",WAS @ ATL,W,28,3,8,0.375,1,2,0.5,5,6,0.833,0,6,6,3,2,1,1,4,12,23,1,WAS,ATL,WAS,125,,,21,18,15,9
Bilal Coulibaly,G,22023,1641731,22300520,"JAN 10, 2024",WAS @ IND,L,22,1,5,0.2,0,1,0.0,3,4,0.75,1,5,6,1,0,1,0,4,5,-7,1,WAS,IND,WAS,104,,,12,11,6,7
Bilal Coulibaly,G,22023,1641731,22300508,"JAN 08, 2024",WAS vs. OKC,L,25,1,4,0.25,1,2,0.5,2,2,1.0,1,4,5,3,0,2,0,2,5,1,1,WAS,WAS,OKC,128,,,13,10,8,8
Bilal Coulibaly,G,22023,1641731,22300494,"JAN 06, 2024",WAS vs. NYK,L,28,2,5,0.4,0,2,0.0,0,0,0.0,2,1,3,3,0,0,3,3,4,-22,1,WAS,WAS,NYK,105,,,10,7,7,6
Bilal Coulibaly,G,22023,1641731,22300482,"JAN 05, 2024",WAS @ CLE,L,36,6,13,0.462,2,4,0.5,1,3,0.333,2,5,7,1,1,3,1,0,15,-9,1,WAS,CLE,WAS,90,,,23,22,16,8
Bilal Coulibaly,G,22023,1641731,22300465,"JAN 03, 2024",WAS @ CLE,L,33,2,12,0.167,1,4,0.25,0,2,0.0,1,4,5,1,3,2,2,4,5,-24,1,WAS,CLE,WAS,101,,,11,10,6,6
Bilal Coulibaly,G,22023,1641731,22300445,"DEC 31, 2023",WAS vs. ATL,L,17,0,3,0.0,0,1,0.0,2,2,1.0,1,3,4,3,0,0,0,2,2,-18,1,WAS,WAS,ATL,126,,,9,6,5,7
Bilal Coulibaly,G,22023,1641731,22300430,"DEC 29, 2023",WAS vs. BKN,W,20,2,3,0.667,0,0,0.0,0,0,0.0,2,4,6,2,0,0,1,3,4,7,1,WAS,WAS,BKN,110,,,12,10,6,8
Bilal Coulibaly,G,22023,1641731,22300416,"DEC 27, 2023",WAS vs. TOR,L,25,4,8,0.5,1,4,0.25,1,2,0.5,0,4,4,2,0,0,1,2,10,-11,1,WAS,WAS,TOR,102,,,16,14,12,6
Bilal Coulibaly,G,22023,1641731,22300407,"DEC 26, 2023",WAS vs. ORL,L,26,1,1,1.0,0,0,0.0,2,2,1.0,2,4,6,3,0,2,2,4,4,-2,1,WAS,WAS,ORL,119,,,13,10,7,9
Bilal Coulibaly,G,22023,1641731,22300386,"DEC 22, 2023",WAS @ GSW,L,32,3,8,0.375,1,2,0.5,0,0,0.0,0,3,3,2,1,1,2,1,7,-12,1,WAS,GSW,WAS,118,,,12,10,9,5
Bilal Coulibaly,G,22023,1641731,22300381,"DEC 21, 2023",WAS @ POR,W,18,1,1,1.0,0,0,0.0,0,0,0.0,0,2,2,2,0,0,0,5,2,-13,1,WAS,POR,WAS,118,,,6,4,4,4
Bilal Coulibaly,G,22023,1641731,22300358,"DEC 18, 2023",WAS @ SAC,L,33,3,7,0.429,0,2,0.0,5,7,0.714,1,3,4,2,0,1,0,1,11,1,1,WAS,SAC,WAS,131,,,17,15,13,6
Bilal Coulibaly,G,22023,1641731,22300347,"DEC 17, 2023",WAS @ PHX,L,20,2,7,0.286,2,6,0.333,0,0,0.0,0,1,1,1,0,0,0,3,6,-11,1,WAS,PHX,WAS,108,,,8,7,7,2
Bilal Coulibaly,G,22023,1641731,22300328,"DEC 15, 2023",WAS vs. IND,W,30,6,9,0.667,2,3,0.667,3,3,1.0,1,4,5,0,2,1,4,2,17,8,1,WAS,WAS,IND,137,,,22,22,17,5
Bilal Coulibaly,G,22023,1641731,22300311,"DEC 13, 2023",WAS vs. NOP,L,32,6,9,0.667,4,6,0.667,0,2,0.0,1,4,5,1,1,1,2,3,16,-30,1,WAS,WAS,NOP,122,,,22,21,17,6
Bilal Coulibaly,G,22023,1641731,22300295,"DEC 11, 2023",WAS @ PHI,L,31,4,11,0.364,2,7,0.286,3,6,0.5,3,5,8,4,1,1,3,0,13,-33,1,WAS,PHI,WAS,99,,,25,21,17,12
Bilal Coulibaly,G,22023,1641731,22301219,"DEC 08, 2023",WAS @ BKN,L,25,4,6,0.667,1,2,0.5,2,4,0.5,4,6,10,2,0,0,2,3,11,-22,1,WAS,BKN,WAS,97,,,23,21,13,12
Bilal Coulibaly,G,22023,1641731,22301208,"DEC 06, 2023",WAS vs. PHI,L,28,6,10,0.6,1,5,0.2,1,1,1.0,0,1,1,3,3,0,2,1,14,-7,1,WAS,WAS,PHI,126,,,18,15,17,4
Bilal Coulibaly,G,22023,1641731,22300274,"DEC 01, 2023",WAS @ ORL,L,32,6,7,0.857,0,0,0.0,0,0,0.0,1,4,5,0,3,0,2,1,12,1,1,WAS,ORL,WAS,125,,,17,17,12,5
Bilal Coulibaly,G,22023,1641731,22300259,"NOV 29, 2023",WAS @ ORL,L,25,2,5,0.4,1,1,1.0,2,2,1.0,1,4,5,0,0,0,2,1,7,-17,1,WAS,ORL,WAS,120,,,12,12,7,5
Bilal Coulibaly,G,22023,1641731,22300253,"NOV 27, 2023",WAS @ DET,W,28,2,6,0.333,0,2,0.0,1,1,1.0,0,4,4,0,2,1,2,1,5,19,1,WAS,DET,WAS,126,,,9,9,5,4
Bilal Coulibaly,G,22023,1641731,22300241,"NOV 25, 2023",WAS vs. ATL,L,32,3,5,0.6,1,2,0.5,0,0,0.0,0,3,3,2,1,1,3,1,7,-1,1,WAS,WAS,ATL,108,,,12,10,9,5
Bilal Coulibaly,G,22023,1641731,22300225,"NOV 22, 2023",WAS @ CHA,L,19,2,6,0.333,0,2,0.0,3,3,1.0,0,0,0,2,0,1,1,4,7,-16,1,WAS,CHA,WAS,114,,,9,7,9,2
Bilal Coulibaly,G,22023,1641731,22300219,"NOV 20, 2023",WAS vs. MIL,L,25,5,7,0.714,2,2,1.0,0,0,0.0,1,2,3,1,2,0,1,3,12,4,1,WAS,WAS,MIL,129,,,16,15,13,4
Bilal Coulibaly,G,22023,1641731,22300028,"NOV 17, 2023",WAS vs. NYK,L,31,2,7,0.286,0,3,0.0,2,3,0.667,0,3,3,4,0,1,2,1,6,-17,1,WAS,WAS,NYK,99,,,13,9,10,7
Bilal Coulibaly,G,22023,1641731,22300192,"NOV 15, 2023",WAS vs. DAL,L,28,4,5,0.8,2,2,1.0,0,0,0.0,0,8,8,2,0,1,0,3,10,-8,1,WAS,WAS,DAL,117,,,20,18,12,10
Bilal Coulibaly,G,22023,1641731,22300189,"NOV 13, 2023",WAS @ TOR,L,33,4,7,0.571,1,1,1.0,1,3,0.333,1,6,7,3,3,1,0,4,10,-18,1,WAS,TOR,WAS,107,,,20,17,13,10
Bilal Coulibaly,G,22023,1641731,22300178,"NOV 12, 2023",WAS @ BKN,L,34,8,12,0.667,4,7,0.571,0,1,0.0,1,6,7,3,4,0,2,0,20,2,1,WAS,BKN,WAS,94,,,30,27,23,10
Bilal Coulibaly,G,22023,1641731,22300009,"NOV 10, 2023",WAS vs. CHA,L,20,2,4,0.5,2,4,0.5,4,4,1.0,0,2,2,1,0,0,2,1,10,15,1,WAS,WAS,CHA,117,,,13,12,11,3
Bilal Coulibaly,G,22023,1641731,22300157,"NOV 08, 2023",WAS @ CHA,W,30,2,3,0.667,2,3,0.667,0,0,0.0,0,2,2,1,0,0,0,5,6,23,1,WAS,CHA,WAS,132,,,9,8,7,3
Bilal Coulibaly,G,22023,1641731,22300148,"NOV 06, 2023",WAS @ PHI,L,19,3,7,0.429,1,3,0.333,3,3,1.0,0,3,3,0,0,1,0,3,10,-15,1,WAS,PHI,WAS,128,,,13,13,10,3
Bilal Coulibaly,G,22023,1641731,22300003,"NOV 03, 2023",WAS @ MIA,L,26,4,5,0.8,1,2,0.5,0,2,0.0,0,3,3,3,0,0,1,1,9,13,1,WAS,MIA,WAS,114,,,15,12,12,6
Bilal Coulibaly,G,22023,1641731,22300117,"NOV 01, 2023",WAS @ ATL,L,28,2,5,0.4,1,4,0.25,0,2,0.0,1,2,3,3,3,0,3,2,5,15,1,WAS,ATL,WAS,121,,,11,8,8,6
Bilal Coulibaly,G,22023,1641731,22300103,"OCT 30, 2023",WAS vs. BOS,L,28,4,12,0.333,1,6,0.167,0,0,0.0,2,3,5,1,1,2,1,0,9,-5,1,WAS,WAS,BOS,107,,,15,14,10,6
Bilal Coulibaly,G,22023,1641731,22300089,"OCT 28, 2023",WAS vs. MEM,W,14,0,2,0.0,0,1,0.0,0,0,0.0,0,1,1,0,0,1,1,1,0,-6,1,WAS,WAS,MEM,113,,,1,1,0,1
Bilal Coulibaly,G,22023,1641731,22300064,"OCT 25, 2023",WAS @ IND,L,23,1,3,0.333,1,1,1.0,0,0,0.0,0,4,4,3,0,3,3,1,3,-13,1,WAS,IND,WAS,120,,,10,7,6,7
Malaki Branham,F,22023,1631103,22300750,"FEB 10, 2024",SAS @ BKN,L,19,2,8,0.25,1,5,0.2,0,0,0.0,2,0,2,2,0,0,1,0,5,0,1,SAS,BKN,SAS,103,,,9,7,7,4
Malaki Branham,F,22023,1631103,22300681,"JAN 31, 2024",SAS vs. ORL,L,15,2,4,0.5,0,1,0.0,0,0,0.0,1,3,4,2,0,0,1,0,4,-1,1,SAS,SAS,ORL,98,,,10,8,6,6
Malaki Branham,F,22023,1631103,22300584,"JAN 19, 2024",SAS @ CHA,L,8,0,0,0.0,0,0,0.0,0,0,0.0,0,1,1,0,0,0,0,0,0,0,1,SAS,CHA,SAS,120,,,1,1,0,1
Malaki Branham,F,22023,1631103,22300571,"JAN 17, 2024",SAS @ BOS,L,16,4,9,0.444,0,3,0.0,0,0,0.0,0,1,1,1,0,0,0,0,8,-20,1,SAS,BOS,SAS,95,,,10,9,9,2
Malaki Branham,F,22023,1631103,22300559,"JAN 15, 2024",SAS @ ATL,L,10,2,4,0.5,0,1,0.0,0,0,0.0,0,0,0,0,0,0,0,1,4,-21,1,SAS,ATL,SAS,99,,,4,4,4,0
Malaki Branham,F,22023,1631103,22300548,"JAN 13, 2024",SAS vs. CHI,L,22,6,15,0.4,2,8,0.25,0,0,0.0,0,1,1,1,3,0,1,0,14,3,1,SAS,SAS,CHI,116,,,16,15,15,2
Malaki Branham,F,22023,1631103,22300541,"JAN 12, 2024",SAS vs. CHA,W,20,3,7,0.429,2,3,0.667,0,0,0.0,0,2,2,4,0,0,2,0,8,19,1,SAS,SAS,CHA,127,,,14,10,12,6
Malaki Branham,F,22023,1631103,22300519,"JAN 10, 2024",SAS @ DET,W,21,2,7,0.286,1,3,0.333,2,2,1.0,1,1,2,3,0,0,1,2,7,5,1,SAS,DET,SAS,129,,,12,9,10,5
Malaki Branham,F,22023,1631103,22300497,"JAN 07, 2024",SAS @ CLE,L,15,1,5,0.2,0,3,0.0,0,0,0.0,0,1,1,2,0,0,1,2,2,-20,1,SAS,CLE,SAS,115,,,5,3,4,3
Malaki Branham,F,22023,1631103,22300460,"JAN 02, 2024",SAS @ MEM,L,7,1,5,0.2,0,0,0.0,0,0,0.0,0,1,1,1,0,0,0,1,2,-3,1,SAS,MEM,SAS,98,,,4,3,3,2
Malaki Branham,F,22023,1631103,22300448,"DEC 31, 2023",SAS vs. BOS,L,23,4,9,0.444,1,5,0.2,2,3,0.667,0,1,1,0,0,0,1,0,11,-25,1,SAS,SAS,BOS,101,,,12,12,11,1
Malaki Branham,F,22023,1631103,22300437,"DEC 29, 2023",SAS @ POR,L,29,5,12,0.417,1,3,0.333,0,0,0.0,3,3,6,3,1,0,3,1,11,-24,1,SAS,POR,SAS,128,,,20,17,14,9
Malaki Branham,F,22023,1631103,22300361,"DEC 19, 2023",SAS @ MIL,L,27,5,11,0.455,2,4,0.5,0,0,0.0,0,2,2,3,0,0,1,1,12,0,1,SAS,MIL,SAS,119,,,17,14,15,5
Malaki Branham,F,22023,1631103,22300278,"DEC 01, 2023",SAS @ NOP,L,22,4,7,0.571,2,3,0.667,0,0,0.0,0,2,2,0,0,0,3,1,10,2,1,SAS,NOP,SAS,106,,,12,12,10,2
Malaki Branham,F,22023,1631103,22300235,"NOV 22, 2023",SAS vs. LAC,L,21,0,6,0.0,0,3,0.0,0,0,0.0,1,0,1,1,0,0,0,0,0,-4,1,SAS,SAS,LAC,102,,,2,1,1,2
Malaki Branham,F,22023,1631103,22300206,"NOV 18, 2023",SAS vs. MEM,L,18,2,6,0.333,0,3,0.0,0,0,0.0,0,1,1,3,0,0,2,2,4,2,1,SAS,SAS,MEM,108,,,8,5,7,4
Malaki Branham,F,22023,1631103,22300021,"NOV 14, 2023",SAS @ OKC,L,26,5,13,0.385,0,4,0.0,1,2,0.5,1,1,2,0,1,0,3,2,11,-23,1,SAS,OKC,SAS,87,,,13,13,11,2
Malaki Branham,F,22023,1631103,22300161,"NOV 08, 2023",SAS @ NYK,L,24,6,9,0.667,2,2,1.0,0,0,0.0,0,0,0,1,0,0,1,2,14,-9,1,SAS,NYK,SAS,105,,,15,14,15,1
Malaki Branham,F,22023,1631103,22300146,"NOV 06, 2023",SAS @ IND,L,28,3,6,0.5,0,2,0.0,2,2,1.0,0,0,0,2,0,0,0,0,8,-28,1,SAS,IND,SAS,111,,,10,8,10,2
Malaki Branham,F,22023,1631103,22300099,"OCT 29, 2023",SAS @ LAC,L,21,3,12,0.25,2,4,0.5,1,1,1.0,0,1,1,2,1,0,2,1,9,-10,1,SAS,LAC,SAS,83,,,12,10,11,3
Malaki Branham,F,22023,1631103,22300272,"NOV 30, 2023",SAS vs. ATL,L,17,1,5,0.2,0,2,0.0,0,0,0.0,0,3,3,3,0,1,3,1,2,7,1,SAS,SAS,ATL,135,,,8,5,5,6
Malaki Branham,F,22023,1631103,22300252,"NOV 26, 2023",SAS @ DEN,L,25,6,11,0.545,3,5,0.6,0,0,0.0,1,1,2,3,1,0,0,3,15,-15,1,SAS,DEN,SAS,120,,,20,17,18,5
Malaki Branham,F,22023,1631103,22300051,"NOV 24, 2023",SAS @ GSW,L,19,3,9,0.333,0,5,0.0,0,0,0.0,0,0,0,1,1,0,1,2,6,-8,1,SAS,GSW,SAS,112,,,7,6,7,1
Malaki Branham,F,22023,1631103,22300223,"NOV 20, 2023",SAS vs. LAC,L,21,4,6,0.667,2,3,0.667,0,0,0.0,0,0,0,1,0,0,2,2,10,-19,1,SAS,SAS,LAC,99,,,11,10,11,1
Malaki Branham,F,22023,1631103,22300032,"NOV 17, 2023",SAS vs. SAC,L,28,4,10,0.4,0,3,0.0,2,2,1.0,0,0,0,5,0,0,0,1,10,-18,1,SAS,SAS,SAC,120,,,15,10,15,5
Malaki Branham,F,22023,1631103,22300184,"NOV 12, 2023",SAS vs. MIA,L,20,4,7,0.571,4,5,0.8,1,1,1.0,0,1,1,7,0,0,1,2,13,0,1,SAS,SAS,MIA,113,,,21,14,20,8
Malaki Branham,F,22023,1631103,22300013,"NOV 10, 2023",SAS vs. MIN,L,16,3,11,0.273,0,4,0.0,0,0,0.0,0,2,2,1,2,0,0,0,6,-13,1,SAS,SAS,MIN,110,,,9,8,7,3
Malaki Branham,F,22023,1631103,22300141,"NOV 05, 2023",SAS vs. TOR,L,25,8,9,0.889,0,0,0.0,0,0,0.0,1,5,6,2,0,0,1,4,16,2,1,SAS,SAS,TOR,116,,,24,22,18,8
Malaki Branham,F,22023,1631103,22300131,"NOV 02, 2023",SAS @ PHX,W,20,1,7,0.143,1,6,0.167,0,0,0.0,0,1,1,3,0,1,0,1,3,5,1,SAS,PHX,SAS,132,,,7,4,6,4
Malaki Branham,F,22023,1631103,22300113,"OCT 31, 2023",SAS @ PHX,W,9,1,7,0.143,1,4,0.25,0,0,0.0,0,0,0,0,1,0,1,0,3,2,1,SAS,PHX,SAS,115,,,3,3,3,0
Malaki Branham,F,22023,1631103,22300083,"OCT 27, 2023",SAS vs. HOU,W,14,4,7,0.571,1,1,1.0,0,0,0.0,0,2,2,4,0,0,1,0,9,7,1,SAS,SAS,HOU,126,,,15,11,13,6
Malaki Branham,F,22023,1631103,22300073,"OCT 25, 2023",SAS vs. DAL,L,18,3,7,0.429,0,3,0.0,1,1,1.0,0,2,2,2,1,0,1,1,7,-2,1,SAS,SAS,DAL,119,,,11,9,9,4
Malaki Branham,F,22023,1631103,22300734,"FEB 08, 2024",SAS @ ORL,L,20,1,5,0.2,0,3,0.0,0,0,0.0,0,3,3,3,1,0,1,3,2,-5,1,SAS,ORL,SAS,111,,,8,5,5,6
Malaki Branham,F,22023,1631103,22300730,"FEB 07, 2024",SAS @ MIA,L,8,1,4,0.25,1,2,0.5,0,0,0.0,0,1,1,1,0,0,2,2,3,4,1,SAS,MIA,SAS,104,,,5,4,4,2
Malaki Branham,F,22023,1631103,22300703,"FEB 03, 2024",SAS vs. CLE,L,10,0,5,0.0,0,3,0.0,1,1,1.0,0,0,0,1,0,0,1,1,1,-4,1,SAS,SAS,CLE,101,,,2,1,2,1
Malaki Branham,F,22023,1631103,22300696,"FEB 02, 2024",SAS vs. NOP,L,16,3,4,0.75,1,2,0.5,0,0,0.0,1,1,2,3,0,0,0,0,7,-4,1,SAS,SAS,NOP,113,,,12,9,10,5
Malaki Branham,F,22023,1631103,22300622,"JAN 24, 2024",SAS vs. OKC,L,27,3,5,0.6,1,2,0.5,4,4,1.0,0,3,3,2,2,1,0,1,11,-28,1,SAS,SAS,OKC,114,,,16,14,13,5
Malaki Branham,F,22023,1631103,22300594,"JAN 20, 2024",SAS @ WAS,W,4,1,1,1.0,0,0,0.0,0,0,0.0,0,1,1,1,0,0,1,1,2,0,1,SAS,WAS,SAS,131,,,4,3,3,2
Malaki Branham,F,22023,1631103,22300427,"DEC 28, 2023",SAS @ POR,W,29,4,10,0.4,3,6,0.5,2,2,1.0,2,3,5,4,1,0,2,5,13,4,1,SAS,POR,SAS,118,,,22,18,17,9
Malaki Branham,F,22023,1631103,22300412,"DEC 26, 2023",SAS vs. UTA,L,17,0,3,0.0,0,0,0.0,0,0,0.0,0,4,4,4,0,0,2,1,0,9,1,SAS,SAS,UTA,118,,,8,4,4,8
Malaki Branham,F,22023,1631103,22300398,"DEC 23, 2023",SAS @ DAL,L,24,5,11,0.455,1,4,0.25,1,1,1.0,0,3,3,4,0,0,1,2,12,-22,1,SAS,DAL,SAS,119,,,19,15,16,7
Malaki Branham,F,22023,1631103,22300376,"DEC 21, 2023",SAS @ CHI,L,29,6,11,0.545,1,4,0.25,0,0,0.0,0,6,6,2,0,0,3,1,13,-4,1,SAS,CHI,SAS,95,,,21,19,15,8
Malaki Branham,F,22023,1631103,22300345,"DEC 17, 2023",SAS vs. NOP,L,30,4,8,0.5,1,3,0.333,2,2,1.0,0,2,2,2,0,0,2,1,11,-23,1,SAS,SAS,NOP,110,,,15,13,13,4
Malaki Branham,F,22023,1631103,22300331,"DEC 15, 2023",SAS vs. LAL,W,33,5,8,0.625,2,3,0.667,0,0,0.0,0,4,4,8,1,1,0,3,12,18,1,SAS,SAS,LAL,129,,,24,16,20,12
Malaki Branham,F,22023,1631103,22300316,"DEC 13, 2023",SAS vs. LAL,L,28,8,13,0.615,2,5,0.4,1,1,1.0,0,3,3,0,1,0,3,1,19,3,1,SAS,SAS,LAL,119,,,22,22,19,3
Malaki Branham,F,22023,1631103,22300298,"DEC 11, 2023",SAS @ HOU,L,34,6,13,0.462,0,3,0.0,1,1,1.0,0,6,6,7,1,0,3,0,13,-10,1,SAS,HOU,SAS,82,,,26,19,20,13
Malaki Branham,F,22023,1631103,22301223,"DEC 08, 2023",SAS vs. CHI,L,23,3,6,0.5,2,4,0.5,2,2,1.0,0,0,0,2,0,1,0,2,10,-17,1,SAS,SAS,CHI,112,,,12,10,12,2
Malaki Branham,F,22023,1631103,22301210,"DEC 06, 2023",SAS @ MIN,L,10,0,2,0.0,0,1,0.0,0,0,0.0,2,0,2,0,0,0,0,2,0,-7,1,SAS,MIN,SAS,94,,,2,2,0,2
GG Jackson,F,22023,1641713,22300751,"FEB 10, 2024",MEM @ CHA,L,26,7,14,0.5,2,6,0.333,0,1,0.0,1,0,1,2,2,1,1,1,16,-4,1,MEM,CHA,MEM,105,,,19,17,18,3
GG Jackson,F,22023,1641713,22300737,"FEB 08, 2024",MEM vs. CHI,L,32,9,18,0.5,4,9,0.444,5,6,0.833,4,5,9,1,1,0,0,2,27,-13,1,MEM,MEM,CHI,95,,,37,36,28,10
GG Jackson,F,22023,1641713,22300722,"FEB 06, 2024",MEM @ NYK,L,21,5,10,0.5,3,6,0.5,3,6,0.5,0,5,5,1,1,2,1,1,16,14,1,MEM,NYK,MEM,97,,,22,21,17,6
GG Jackson,F,22023,1641713,22300693,"FEB 02, 2024",MEM vs. GSW,L,16,0,3,0.0,0,2,0.0,1,2,0.5,0,1,1,1,0,0,1,1,1,-8,1,MEM,MEM,GSW,98,,,3,2,2,2
GG Jackson,F,22023,1641713,22300687,"FEB 01, 2024",MEM vs. CLE,L,29,3,14,0.214,1,8,0.125,3,4,0.75,2,3,5,2,0,2,1,2,10,2,1,MEM,MEM,CLE,86,,,17,15,12,7
GG Jackson,F,22023,1641713,22300663,"JAN 29, 2024",MEM vs. SAC,L,30,4,14,0.286,3,10,0.3,1,1,1.0,1,5,6,2,1,0,2,0,12,0,1,MEM,MEM,SAC,72,,,20,18,14,8
GG Jackson,F,22023,1641713,22300652,"JAN 28, 2024",MEM @ IND,L,29,6,9,0.667,2,4,0.5,4,5,0.8,1,3,4,1,1,1,0,0,18,0,1,MEM,IND,MEM,106,,,23,22,19,5
GG Jackson,F,22023,1641713,22300638,"JAN 26, 2024",MEM vs. ORL,W,11,2,2,1.0,0,0,0.0,1,1,1.0,0,0,0,1,0,0,0,2,5,4,1,MEM,MEM,ORL,107,,,6,5,6,1
GG Jackson,F,22023,1641713,22300609,"JAN 22, 2024",MEM @ TOR,W,21,3,5,0.6,1,3,0.333,0,0,0.0,0,5,5,1,1,1,0,0,7,6,1,MEM,TOR,MEM,108,,,13,12,8,6
GG Jackson,F,22023,1641713,22300597,"JAN 20, 2024",MEM @ CHI,L,18,2,3,0.667,2,2,1.0,4,6,0.667,0,1,1,0,0,0,0,2,10,-17,1,MEM,CHI,MEM,93,,,11,11,10,1
GG Jackson,F,22023,1641713,22300582,"JAN 18, 2024",MEM @ MIN,L,10,0,3,0.0,0,2,0.0,1,2,0.5,2,1,3,0,0,0,1,2,1,-25,1,MEM,MIN,MEM,103,,,4,4,1,3
GG Jackson,F,22023,1641713,22300560,"JAN 15, 2024",MEM vs. GSW,W,29,6,9,0.667,5,8,0.625,6,8,0.75,1,5,6,1,2,2,2,3,23,23,1,MEM,MEM,GSW,116,,,30,29,24,7
GG Jackson,F,22023,1641713,22300355,"DEC 18, 2023",MEM @ OKC,L,12,3,6,0.5,2,3,0.667,0,0,0.0,0,0,0,0,0,1,0,2,8,9,1,MEM,OKC,MEM,97,,,8,8,8,0
GG Jackson,F,22023,1641713,22300044,"NOV 24, 2023",MEM vs. PHX,L,2,0,1,0.0,0,1,0.0,0,0,0.0,0,0,0,0,1,0,1,0,0,-4,1,MEM,MEM,PHX,89,,,0,0,0,0
GG Jackson,F,22023,1641713,22300231,"NOV 22, 2023",MEM @ HOU,L,4,0,3,0.0,0,1,0.0,0,0,0.0,1,2,3,0,0,0,0,0,0,3,1,MEM,HOU,MEM,91,,,3,3,0,3
GG Jackson,F,22023,1641713,22300537,"JAN 12, 2024",MEM vs. LAC,L,9,1,5,0.2,0,1,0.0,2,3,0.667,3,2,5,1,0,0,0,1,4,8,1,MEM,MEM,LAC,119,,,10,9,5,6
GG Jackson,F,22023,1641713,22300515,"JAN 09, 2024",MEM @ DAL,W,2,0,2,0.0,0,1,0.0,0,0,0.0,0,0,0,0,0,0,0,0,0,-3,1,MEM,DAL,MEM,120,,,0,0,0,0
GG Jackson,F,22023,1641713,22300106,"OCT 30, 2023",MEM vs. DAL,L,1,0,0,0.0,0,0,0.0,0,0,0.0,0,0,0,0,0,0,0,0,0,0,1,MEM,MEM,DAL,110,,,0,0,0,0
GG Jackson,F,22023,1641713,22300706,"FEB 04, 2024",MEM @ BOS,L,36,8,24,0.333,2,10,0.2,0,0,0.0,2,5,7,1,2,0,4,0,18,-35,1,MEM,BOS,MEM,56,,,26,25,19,8
GG Jackson,F,22023,1641713,22300621,"JAN 24, 2024",MEM @ MIA,W,26,5,9,0.556,4,6,0.667,3,4,0.75,0,4,4,2,0,0,1,3,17,20,1,MEM,MIA,MEM,90,,,23,21,19,6
GG Jackson,F,22023,1641713,22300544,"JAN 13, 2024",MEM vs. NYK,L,27,9,14,0.643,2,4,0.5,0,0,0.0,2,4,6,1,0,2,2,0,20,2,1,MEM,MEM,NYK,94,,,27,26,21,7
Kyle Lowry,G,22023,200768,22300601,"JAN 21, 2024",MIA @ ORL,L,25,1,9,0.111,0,6,0.0,0,0,0.0,1,1,2,3,2,1,0,2,2,-17,1,MIA,ORL,MIA,87,,,7,4,5,5
Kyle Lowry,G,22023,200768,22300587,"JAN 19, 2024",MIA vs. ATL,L,24,1,4,0.25,0,3,0.0,0,0,0.0,1,2,3,4,1,0,1,2,2,-7,1,MIA,MIA,ATL,108,,,9,5,6,7
Kyle Lowry,G,22023,200768,22300574,"JAN 17, 2024",MIA @ TOR,L,29,2,9,0.222,0,6,0.0,0,0,0.0,1,1,2,3,0,1,1,2,4,-7,1,MIA,TOR,MIA,97,,,9,6,7,5
Kyle Lowry,G,22023,200768,22300562,"JAN 15, 2024",MIA @ BKN,W,24,1,5,0.2,0,2,0.0,0,0,0.0,0,4,4,5,1,0,1,3,2,14,1,MIA,BKN,MIA,96,,,11,6,7,9
Kyle Lowry,G,22023,200768,22300551,"JAN 14, 2024",MIA vs. CHA,W,26,0,3,0.0,0,1,0.0,0,0,0.0,0,4,4,3,0,1,2,1,0,7,1,MIA,MIA,CHA,104,,,7,4,3,7
Kyle Lowry,G,22023,200768,22300509,"JAN 08, 2024",MIA vs. HOU,W,16,2,3,0.667,1,1,1.0,1,2,0.5,1,2,3,1,0,2,1,1,6,5,1,MIA,MIA,HOU,120,,,10,9,7,4
Kyle Lowry,G,22023,200768,22300489,"JAN 05, 2024",MIA @ PHX,L,23,2,7,0.286,2,6,0.333,0,0,0.0,1,2,3,4,0,0,4,2,6,-18,1,MIA,PHX,MIA,97,,,13,9,10,7
Kyle Lowry,G,22023,200768,22300475,"JAN 03, 2024",MIA @ LAL,W,26,3,6,0.5,2,5,0.4,2,2,1.0,0,3,3,6,4,0,1,2,10,6,1,MIA,LAL,MIA,110,,,19,13,16,9
Kyle Lowry,G,22023,200768,22300458,"JAN 01, 2024",MIA @ LAC,L,24,3,5,0.6,0,1,0.0,2,2,1.0,1,0,1,3,0,0,3,3,8,-19,1,MIA,LAC,MIA,104,,,12,9,11,4
Kyle Lowry,G,22023,200768,22300404,"DEC 25, 2023",MIA vs. PHI,W,33,5,7,0.714,1,3,0.333,1,1,1.0,0,1,1,4,1,2,3,4,12,0,1,MIA,MIA,PHI,119,,,17,13,16,5
Kyle Lowry,G,22023,200768,22300384,"DEC 22, 2023",MIA vs. ATL,W,22,1,2,0.5,1,2,0.5,0,0,0.0,0,4,4,3,0,0,2,2,3,9,1,MIA,MIA,ATL,122,,,10,7,6,7
Kyle Lowry,G,22023,200768,22300366,"DEC 20, 2023",MIA @ ORL,W,18,1,2,0.5,1,2,0.5,0,0,0.0,0,0,0,2,0,0,0,1,3,2,1,MIA,ORL,MIA,115,,,5,3,5,2
Kyle Lowry,G,22023,200768,22300267,"NOV 30, 2023",MIA vs. IND,W,25,6,10,0.6,3,6,0.5,0,0,0.0,1,2,3,3,0,1,0,5,15,-11,1,MIA,MIA,IND,142,,,21,18,18,6
Kyle Lowry,G,22023,200768,22300056,"NOV 28, 2023",MIA vs. MIL,L,34,7,10,0.7,3,5,0.6,4,4,1.0,0,4,4,6,1,1,1,5,21,-4,1,MIA,MIA,MIL,124,,,31,25,27,10
Kyle Lowry,G,22023,200768,22300045,"NOV 24, 2023",MIA @ NYK,L,33,4,9,0.444,2,5,0.4,0,0,0.0,3,5,8,2,2,0,1,3,10,3,1,MIA,NYK,MIA,98,,,20,18,12,10
Kyle Lowry,G,22023,200768,22300220,"NOV 20, 2023",MIA @ CHI,W,27,3,6,0.5,2,4,0.5,0,0,0.0,1,4,5,6,0,0,1,1,8,15,1,MIA,CHI,MIA,118,,,19,13,14,11
Kyle Lowry,G,22023,200768,22300204,"NOV 18, 2023",MIA @ CHI,L,32,3,10,0.3,2,7,0.286,0,0,0.0,0,3,3,5,3,0,1,3,8,14,1,MIA,CHI,MIA,97,,,16,11,13,8
Kyle Lowry,G,22023,200768,22300200,"NOV 16, 2023",MIA vs. BKN,W,24,1,4,0.25,1,1,1.0,0,0,0.0,1,2,3,3,3,0,0,3,3,7,1,MIA,MIA,BKN,122,,,9,6,6,6
Kyle Lowry,G,22023,200768,22300017,"NOV 14, 2023",MIA @ CHA,W,15,0,1,0.0,0,1,0.0,0,0,0.0,0,1,1,2,0,0,0,4,0,-5,1,MIA,CHA,MIA,111,,,3,1,2,3
Kyle Lowry,G,22023,200768,22300175,"NOV 11, 2023",MIA @ ATL,W,33,4,8,0.5,4,6,0.667,5,5,1.0,0,2,2,4,1,0,3,1,17,10,1,MIA,ATL,MIA,117,,,23,19,21,6
Kyle Lowry,G,22023,200768,22300164,"NOV 08, 2023",MIA @ MEM,W,35,5,11,0.455,4,7,0.571,3,3,1.0,3,8,11,9,1,0,4,4,17,20,1,MIA,MEM,MIA,108,,,37,28,26,20
Kyle Lowry,G,22023,200768,22300150,"NOV 06, 2023",MIA vs. LAL,W,33,2,6,0.333,1,5,0.2,0,0,0.0,2,2,4,5,1,0,0,2,5,2,1,MIA,MIA,LAL,108,,,14,9,10,9
Kyle Lowry,G,22023,200768,22300003,"NOV 03, 2023",MIA vs. WAS,W,26,1,4,0.25,1,4,0.25,0,0,0.0,2,1,3,7,2,0,2,1,3,2,1,MIA,MIA,WAS,121,,,13,6,10,10
Kyle Lowry,G,22023,200768,22300119,"NOV 01, 2023",MIA vs. BKN,L,30,2,5,0.4,2,5,0.4,0,0,0.0,0,3,3,3,2,1,2,3,6,7,1,MIA,MIA,BKN,105,,,12,9,9,6
Kyle Lowry,G,22023,200768,22300093,"OCT 28, 2023",MIA @ MIN,L,32,1,6,0.167,1,5,0.2,0,0,0.0,1,3,4,7,1,0,4,1,3,-20,1,MIA,MIN,MIA,90,,,14,7,10,11
Kyle Lowry,G,22023,200768,22300080,"OCT 27, 2023",MIA @ BOS,L,32,5,7,0.714,3,4,0.75,0,0,0.0,1,7,8,5,0,1,1,3,13,-1,1,MIA,BOS,MIA,111,,,26,21,18,13
Kyle Lowry,G,22023,200768,22300068,"OCT 25, 2023",MIA vs. DET,W,32,0,1,0.0,0,0,0.0,0,0,0.0,0,2,2,2,2,1,0,4,0,4,1,MIA,MIA,DET,103,,,4,2,2,4
Kyle Lowry,G,22023,200768,22300337,"DEC 16, 2023",MIA vs. CHI,W,32,3,7,0.429,1,3,0.333,3,4,0.75,0,3,3,7,0,1,0,2,10,8,1,MIA,MIA,CHI,118,,,20,13,17,10
Kyle Lowry,G,22023,200768,22300320,"DEC 14, 2023",MIA vs. CHI,L,39,6,12,0.5,4,9,0.444,1,1,1.0,1,2,3,3,1,0,1,5,17,-14,1,MIA,MIA,CHI,116,,,23,20,20,6
Kyle Lowry,G,22023,200768,22300312,"DEC 13, 2023",MIA vs. CHA,W,24,5,5,1.0,4,4,1.0,3,3,1.0,0,2,2,1,2,0,2,2,17,14,1,MIA,MIA,CHA,115,,,20,19,18,3
Kyle Lowry,G,22023,200768,22300292,"DEC 11, 2023",MIA @ CHA,W,35,1,6,0.167,1,4,0.25,0,2,0.0,1,4,5,5,2,0,1,3,3,6,1,MIA,CHA,MIA,116,,,13,8,8,10
Kyle Lowry,G,22023,200768,22300240,"NOV 25, 2023",MIA @ BKN,L,30,3,10,0.3,2,7,0.286,1,2,0.5,1,2,3,4,2,0,3,2,9,-19,1,MIA,BKN,MIA,97,,,16,12,13,7
Kyle Lowry,G,22023,200768,22300229,"NOV 22, 2023",MIA @ CLE,W,29,9,15,0.6,7,10,0.7,3,4,0.75,0,1,1,3,0,0,0,3,28,21,1,MIA,CLE,MIA,129,,,32,29,31,4
Kyle Lowry,G,22023,200768,22300107,"OCT 30, 2023",MIA @ MIL,L,28,3,6,0.5,2,5,0.4,0,0,0.0,0,4,4,4,2,0,2,4,8,-11,1,MIA,MIL,MIA,114,,,16,12,12,8
Kyle Lowry,G,22023,200768,22301220,"DEC 08, 2023",MIA vs. CLE,L,32,6,13,0.462,3,9,0.333,2,3,0.667,0,2,2,5,2,0,3,1,17,-8,1,MIA,MIA,CLE,99,,,24,19,22,7
Kyle Lowry,G,22023,200768,22301207,"DEC 06, 2023",MIA @ TOR,W,28,1,4,0.25,1,4,0.25,0,0,0.0,0,4,4,3,0,2,2,2,3,7,1,MIA,TOR,MIA,112,,,10,7,6,7
Kyle Lowry,G,22023,200768,22300284,"DEC 02, 2023",MIA vs. IND,L,29,0,4,0.0,0,3,0.0,4,4,1.0,1,7,8,2,0,0,0,2,4,-9,1,MIA,MIA,IND,129,,,14,12,6,10
Grant Williams,F,22023,1629684,22300751,"FEB 10, 2024",CHA vs. MEM,W,32,5,11,0.455,3,6,0.5,2,2,1.0,0,8,8,1,0,0,2,0,15,19,1,CHA,CHA,MEM,115,,,24,23,16,9
Grant Williams,F,22023,1629684,22300398,"DEC 23, 2023",DAL vs. SAS,W,25,5,8,0.625,4,6,0.667,0,0,0.0,0,2,2,3,0,1,1,3,14,9,1,DAL,DAL,SAS,144,,,19,16,17,5
Grant Williams,F,22023,1629684,22300385,"DEC 22, 2023",DAL @ HOU,L,26,0,5,0.0,0,3,0.0,0,0,0.0,0,4,4,2,2,1,0,2,0,-28,1,DAL,HOU,DAL,96,,,6,4,2,6
Grant Williams,F,22023,1629684,22300356,"DEC 18, 2023",DAL @ DEN,L,22,3,8,0.375,1,2,0.5,0,0,0.0,1,2,3,0,0,0,0,2,7,-13,1,DAL,DEN,DAL,104,,,10,10,7,3
Grant Williams,F,22023,1629684,22300341,"DEC 16, 2023",DAL @ POR,W,31,1,4,0.25,0,3,0.0,1,1,1.0,1,3,4,3,1,1,1,4,3,0,1,DAL,POR,DAL,131,,,10,7,6,7
Grant Williams,F,22023,1629684,22300321,"DEC 14, 2023",DAL vs. MIN,L,36,2,11,0.182,1,7,0.143,0,0,0.0,0,3,3,1,1,0,1,3,5,-14,1,DAL,DAL,MIN,101,,,9,8,6,4
Grant Williams,F,22023,1629684,22300680,"JAN 31, 2024",DAL @ MIN,L,25,1,7,0.143,0,3,0.0,0,0,0.0,1,0,1,1,1,0,1,3,2,-17,1,DAL,MIN,DAL,82,,,4,3,3,2
Grant Williams,F,22023,1629684,22300666,"JAN 29, 2024",DAL vs. ORL,W,29,1,2,0.5,1,2,0.5,0,0,0.0,0,2,2,1,0,0,2,3,3,-13,1,DAL,DAL,ORL,131,,,6,5,4,3
Grant Williams,F,22023,1629684,22300651,"JAN 27, 2024",DAL vs. SAC,L,38,9,16,0.563,7,10,0.7,2,2,1.0,3,5,8,3,3,1,0,5,27,0,1,DAL,DAL,SAC,115,,,38,35,30,11
Grant Williams,F,22023,1629684,22300577,"JAN 17, 2024",DAL @ LAL,L,26,2,6,0.333,2,6,0.333,2,2,1.0,0,3,3,2,0,0,0,3,8,-1,1,DAL,LAL,DAL,105,,,13,11,10,5
Grant Williams,F,22023,1629684,22300556,"JAN 15, 2024",DAL vs. NOP,W,31,3,7,0.429,1,4,0.25,0,0,0.0,0,3,3,7,3,0,0,5,7,16,1,DAL,DAL,NOP,125,,,17,10,14,10
Grant Williams,F,22023,1629684,22300547,"JAN 13, 2024",DAL vs. NOP,L,14,0,2,0.0,0,2,0.0,0,0,0.0,1,0,1,1,0,1,2,5,0,-16,1,DAL,DAL,NOP,108,,,2,1,1,2
Grant Williams,F,22023,1629684,22300530,"JAN 11, 2024",DAL vs. NYK,W,27,3,7,0.429,2,6,0.333,3,3,1.0,3,3,6,3,0,1,1,3,11,-4,1,DAL,DAL,NYK,128,,,20,17,14,9
Grant Williams,F,22023,1629684,22300515,"JAN 09, 2024",DAL vs. MEM,L,7,0,2,0.0,0,0,0.0,0,0,0.0,0,0,0,0,0,0,1,1,0,-20,1,DAL,DAL,MEM,103,,,0,0,0,0
Grant Williams,F,22023,1629684,22300501,"JAN 07, 2024",DAL vs. MIN,W,20,3,5,0.6,1,3,0.333,2,2,1.0,0,2,2,0,0,2,3,3,9,-7,1,DAL,DAL,MIN,115,,,11,11,9,2
Grant Williams,F,22023,1629684,22300472,"JAN 03, 2024",DAL vs. POR,W,15,1,2,0.5,0,0,0.0,0,0,0.0,1,1,2,2,0,0,3,2,2,4,1,DAL,DAL,POR,126,,,6,4,4,4
Grant Williams,F,22023,1629684,22300423,"DEC 28, 2023",DAL @ MIN,L,30,3,9,0.333,2,5,0.4,0,0,0.0,0,3,3,3,1,0,2,4,8,-30,1,DAL,MIN,DAL,110,,,14,11,11,6
Grant Williams,F,22023,1629684,22300420,"DEC 27, 2023",DAL vs. CLE,L,26,2,7,0.286,0,4,0.0,0,0,0.0,2,4,6,0,2,0,0,5,4,-5,1,DAL,DAL,CLE,110,,,10,10,4,6
Grant Williams,F,22023,1629684,22300405,"DEC 25, 2023",DAL @ PHX,W,27,1,3,0.333,0,2,0.0,1,2,0.5,0,3,3,1,0,3,2,4,3,-4,1,DAL,PHX,DAL,128,,,7,6,4,4
Grant Williams,F,22023,1629684,22300306,"DEC 12, 2023",DAL vs. LAL,W,40,7,9,0.778,5,7,0.714,0,0,0.0,1,2,3,1,1,0,1,4,19,7,1,DAL,DAL,LAL,127,,,23,22,20,4
Grant Williams,F,22023,1629684,22300287,"DEC 02, 2023",DAL vs. OKC,L,27,1,6,0.167,0,4,0.0,3,4,0.75,1,0,1,1,0,0,0,3,5,-7,1,DAL,DAL,OKC,120,,,7,6,6,2
Grant Williams,F,22023,1629684,22300277,"DEC 01, 2023",DAL vs. MEM,L,31,4,12,0.333,3,9,0.333,5,6,0.833,2,6,8,3,1,1,1,3,16,-18,1,DAL,DAL,MEM,94,,,27,24,19,11
Grant Williams,F,22023,1629684,22300059,"NOV 28, 2023",DAL vs. HOU,W,18,0,5,0.0,0,3,0.0,0,0,0.0,0,4,4,3,0,0,2,4,0,2,1,DAL,DAL,HOU,121,,,7,4,3,7
Grant Williams,F,22023,1629684,22300244,"NOV 25, 2023",DAL @ LAC,L,35,2,3,0.667,1,2,0.5,0,0,0.0,3,1,4,1,0,0,1,4,5,-9,1,DAL,LAC,DAL,88,,,10,9,6,5
Grant Williams,F,22023,1629684,22300238,"NOV 22, 2023",DAL @ LAL,W,32,2,9,0.222,2,9,0.222,0,0,0.0,1,2,3,2,0,1,0,4,6,-7,1,DAL,LAL,DAL,104,,,11,9,8,5
Grant Williams,F,22023,1629684,22300205,"NOV 18, 2023",DAL @ MIL,L,38,5,11,0.455,4,10,0.4,0,0,0.0,3,4,7,2,0,1,1,1,14,8,1,DAL,MIL,DAL,125,,,23,21,16,9
Grant Williams,F,22023,1629684,22300192,"NOV 15, 2023",DAL @ WAS,W,36,4,13,0.308,2,7,0.286,0,0,0.0,2,1,3,7,1,0,1,1,10,14,1,DAL,WAS,DAL,130,,,20,13,17,10
Grant Williams,F,22023,1629684,22300022,"NOV 14, 2023",DAL @ NOP,L,24,3,6,0.5,3,4,0.75,1,2,0.5,0,1,1,0,0,1,2,0,10,-11,1,DAL,NOP,DAL,110,,,11,11,10,1
Grant Williams,F,22023,1629684,22300183,"NOV 12, 2023",DAL @ NOP,W,22,0,4,0.0,0,2,0.0,0,0,0.0,1,1,2,1,1,2,0,1,0,19,1,DAL,NOP,DAL,136,,,3,2,1,3
Grant Williams,F,22023,1629684,22300014,"NOV 10, 2023",DAL vs. LAC,W,16,1,2,0.5,0,1,0.0,0,0,0.0,0,2,2,1,0,0,1,4,2,3,1,DAL,DAL,LAC,144,,,5,4,3,3
Grant Williams,F,22023,1629684,22300006,"NOV 03, 2023",DAL @ DEN,L,33,4,10,0.4,3,7,0.429,2,2,1.0,2,3,5,2,1,2,1,4,13,-21,1,DAL,DEN,DAL,114,,,20,18,15,7
Grant Williams,F,22023,1629684,22300124,"NOV 01, 2023",DAL vs. CHI,W,30,7,10,0.7,7,9,0.778,4,6,0.667,2,3,5,1,1,0,0,1,25,13,1,DAL,DAL,CHI,114,,,31,30,26,6
Grant Williams,F,22023,1629684,22300106,"OCT 30, 2023",DAL @ MEM,W,31,4,8,0.5,4,8,0.5,3,4,0.75,1,2,3,2,0,0,1,1,15,18,1,DAL,MEM,DAL,125,,,20,18,17,5
Grant Williams,F,22023,1629684,22300084,"OCT 27, 2023",DAL vs. BKN,W,29,2,6,0.333,1,4,0.25,0,0,0.0,0,6,6,0,0,0,2,5,5,-4,1,DAL,DAL,BKN,125,,,11,11,5,6
Grant Williams,F,22023,1629684,22300073,"OCT 25, 2023",DAL @ SAS,W,35,6,11,0.545,4,8,0.5,1,1,1.0,1,5,6,0,0,1,3,4,17,2,1,DAL,SAS,DAL,126,,,23,23,17,6
Grant Williams,F,22023,1629684,22300720,"FEB 06, 2024",DAL @ BKN,W,21,2,5,0.4,1,3,0.333,0,0,0.0,1,2,3,0,1,1,3,1,5,12,1,DAL,BKN,DAL,119,,,8,8,5,3
Grant Williams,F,22023,1629684,22300715,"FEB 05, 2024",DAL @ PHI,W,28,3,5,0.6,2,3,0.667,6,7,0.857,1,6,7,2,0,1,1,3,14,12,1,DAL,PHI,DAL,118,,,23,21,16,9
Grant Williams,F,22023,1629684,22300702,"FEB 03, 2024",DAL vs. MIL,L,23,1,6,0.167,0,2,0.0,0,0,0.0,2,3,5,1,1,0,4,2,2,13,1,DAL,DAL,MIL,117,,,8,7,3,6
Grant Williams,F,22023,1629684,22300634,"JAN 26, 2024",DAL @ ATL,W,28,3,6,0.5,1,3,0.333,2,2,1.0,0,5,5,4,0,0,1,4,9,5,1,DAL,ATL,DAL,148,,,18,14,13,9
Grant Williams,F,22023,1629684,22300625,"JAN 24, 2024",DAL vs. PHX,L,11,3,6,0.5,2,4,0.5,0,0,0.0,0,1,1,1,0,0,3,3,8,5,1,DAL,DAL,PHX,107,,,10,9,9,2
Grant Williams,F,22023,1629684,22300611,"JAN 22, 2024",DAL vs. BOS,L,18,1,5,0.2,0,4,0.0,0,0,0.0,0,3,3,2,0,0,0,1,2,-3,1,DAL,DAL,BOS,110,,,7,5,4,5
Grant Williams,F,22023,1629684,22300457,"JAN 01, 2024",DAL @ UTA,L,18,2,7,0.286,0,4,0.0,0,1,0.0,0,0,0,1,1,2,3,2,4,-17,1,DAL,UTA,DAL,86,,,5,4,5,1
Grant Williams,F,22023,1629684,22300444,"DEC 30, 2023",DAL @ GSW,W,19,3,3,1.0,2,2,1.0,2,2,1.0,1,5,6,0,1,0,0,1,10,2,1,DAL,GSW,DAL,132,,,16,16,10,6
Grant Williams,F,22023,1629684,22300372,"DEC 20, 2023",DAL vs. LAC,L,31,4,7,0.571,1,4,0.25,0,0,0.0,5,4,9,4,0,1,0,6,9,-18,1,DAL,DAL,LAC,111,,,22,18,13,13
Grant Williams,F,22023,1629684,22300212,"NOV 19, 2023",DAL vs. SAC,L,20,3,6,0.5,1,4,0.25,0,2,0.0,2,1,3,2,0,0,1,1,7,-7,1,DAL,DAL,SAC,113,,,12,10,9,5
Grant Williams,F,22023,1629684,22300168,"NOV 08, 2023",DAL vs. TOR,L,27,2,7,0.286,2,5,0.4,0,0,0.0,0,2,2,1,0,0,0,4,6,-4,1,DAL,DAL,TOR,116,,,9,8,7,3
Grant Williams,F,22023,1629684,22300147,"NOV 06, 2023",DAL @ ORL,W,33,5,9,0.556,2,5,0.4,1,3,0.333,1,1,2,0,0,1,0,2,13,18,1,DAL,ORL,DAL,117,,,15,15,13,2
Grant Williams,F,22023,1629684,22300143,"NOV 05, 2023",DAL vs. CHA,W,31,7,9,0.778,4,5,0.8,0,1,0.0,0,4,4,3,0,1,0,3,18,2,1,DAL,DAL,CHA,124,,,25,22,21,7
Josh Green,G,22023,1630182,22300487,"JAN 05, 2024",DAL vs. POR,W,25,7,8,0.875,0,0,0.0,0,0,0.0,2,3,5,5,1,0,1,0,14,28,1,DAL,DAL,POR,132,,,24,19,19,10
Josh Green,G,22023,1630182,22300680,"JAN 31, 2024",DAL @ MIN,L,29,8,13,0.615,2,3,0.667,0,0,0.0,0,2,2,1,0,0,1,4,18,-19,1,DAL,MIN,DAL,82,,,21,20,19,3
Josh Green,G,22023,1630182,22300666,"JAN 29, 2024",DAL vs. ORL,W,33,1,6,0.167,0,3,0.0,0,0,0.0,0,2,2,1,1,0,2,5,2,-18,1,DAL,DAL,ORL,131,,,5,4,3,3
Josh Green,G,22023,1630182,22300651,"JAN 27, 2024",DAL vs. SAC,L,33,4,9,0.444,2,6,0.333,1,2,0.5,0,3,3,5,0,0,2,2,11,-14,1,DAL,DAL,SAC,115,,,19,14,16,8
Josh Green,G,22023,1630182,22300556,"JAN 15, 2024",DAL vs. NOP,W,30,4,8,0.5,3,5,0.6,2,6,0.333,1,3,4,3,0,0,1,5,13,14,1,DAL,DAL,NOP,125,,,20,17,16,7
Josh Green,G,22023,1630182,22300547,"JAN 13, 2024",DAL vs. NOP,L,32,3,8,0.375,1,3,0.333,2,2,1.0,2,4,6,4,0,0,3,2,9,-3,1,DAL,DAL,NOP,108,,,19,15,13,10
Josh Green,G,22023,1630182,22300530,"JAN 11, 2024",DAL vs. NYK,W,35,8,12,0.667,2,4,0.5,0,2,0.0,0,2,2,3,1,0,0,2,18,-15,1,DAL,DAL,NYK,128,,,23,20,21,5
Josh Green,G,22023,1630182,22300515,"JAN 09, 2024",DAL vs. MEM,L,23,0,3,0.0,0,1,0.0,0,0,0.0,1,2,3,0,0,1,0,1,0,1,1,DAL,DAL,MEM,103,,,3,3,0,3
Josh Green,G,22023,1630182,22300501,"JAN 07, 2024",DAL vs. MIN,W,31,2,3,0.667,0,1,0.0,0,0,0.0,0,5,5,1,0,1,0,2,4,-2,1,DAL,DAL,MIN,115,,,10,9,5,6
Josh Green,G,22023,1630182,22300472,"JAN 03, 2024",DAL vs. POR,W,27,3,5,0.6,0,2,0.0,2,2,1.0,0,4,4,1,2,0,0,4,8,22,1,DAL,DAL,POR,126,,,13,12,9,5
Josh Green,G,22023,1630182,22300423,"DEC 28, 2023",DAL @ MIN,L,15,1,3,0.333,0,1,0.0,0,0,0.0,0,0,0,5,0,0,1,0,2,-7,1,DAL,MIN,DAL,110,,,7,2,7,5
Josh Green,G,22023,1630182,22300420,"DEC 27, 2023",DAL vs. CLE,L,21,1,4,0.25,0,2,0.0,0,0,0.0,0,3,3,5,2,0,1,1,2,12,1,DAL,DAL,CLE,110,,,10,5,7,8
Josh Green,G,22023,1630182,22300277,"DEC 01, 2023",DAL vs. MEM,L,31,4,10,0.4,1,3,0.333,1,1,1.0,0,2,2,5,3,0,3,0,10,-6,1,DAL,DAL,MEM,94,,,17,12,15,7
Josh Green,G,22023,1630182,22300059,"NOV 28, 2023",DAL vs. HOU,W,30,2,4,0.5,1,1,1.0,0,0,0.0,1,6,7,2,0,1,1,4,5,12,1,DAL,DAL,HOU,121,,,14,12,7,9
Josh Green,G,22023,1630182,22300244,"NOV 25, 2023",DAL @ LAC,L,9,0,2,0.0,0,1,0.0,0,0,0.0,0,1,1,1,0,0,0,2,0,-15,1,DAL,LAC,DAL,88,,,2,1,1,2
Josh Green,G,22023,1630182,22300238,"NOV 22, 2023",DAL @ LAL,W,22,6,10,0.6,3,6,0.5,0,0,0.0,0,3,3,1,0,0,0,1,15,10,1,DAL,LAL,DAL,104,,,19,18,16,4
Josh Green,G,22023,1630182,22300205,"NOV 18, 2023",DAL @ MIL,L,20,1,3,0.333,1,3,0.333,0,0,0.0,1,3,4,3,0,0,0,1,3,-27,1,DAL,MIL,DAL,125,,,10,7,6,7
Josh Green,G,22023,1630182,22300192,"NOV 15, 2023",DAL @ WAS,W,37,0,4,0.0,0,4,0.0,0,0,0.0,1,3,4,1,1,0,0,1,0,12,1,DAL,WAS,DAL,130,,,5,4,1,5
Josh Green,G,22023,1630182,22300022,"NOV 14, 2023",DAL @ NOP,L,28,1,3,0.333,0,2,0.0,0,0,0.0,1,4,5,4,0,0,2,1,2,-14,1,DAL,NOP,DAL,110,,,11,7,6,9
Josh Green,G,22023,1630182,22300183,"NOV 12, 2023",DAL @ NOP,W,28,5,11,0.455,3,7,0.429,0,0,0.0,0,2,2,3,2,0,1,1,13,11,1,DAL,NOP,DAL,136,,,18,15,16,5
Josh Green,G,22023,1630182,22300014,"NOV 10, 2023",DAL vs. LAC,W,18,1,4,0.25,1,4,0.25,0,0,0.0,0,0,0,3,0,0,0,2,3,-15,1,DAL,DAL,LAC,144,,,6,3,6,3
Josh Green,G,22023,1630182,22300006,"NOV 03, 2023",DAL @ DEN,L,27,5,8,0.625,3,5,0.6,0,0,0.0,1,4,5,2,2,0,0,2,13,4,1,DAL,DEN,DAL,114,,,20,18,15,7
Josh Green,G,22023,1630182,22300124,"NOV 01, 2023",DAL vs. CHI,W,26,1,5,0.2,1,5,0.2,0,0,0.0,0,3,3,1,0,0,2,2,3,14,1,DAL,DAL,CHI,114,,,7,6,4,4
Josh Green,G,22023,1630182,22300106,"OCT 30, 2023",DAL @ MEM,W,34,5,10,0.5,2,4,0.5,0,0,0.0,1,1,2,3,1,0,1,0,12,4,1,DAL,MEM,DAL,125,,,17,14,15,5
Josh Green,G,22023,1630182,22300084,"OCT 27, 2023",DAL vs. BKN,W,28,2,7,0.286,0,3,0.0,3,6,0.5,1,2,3,2,3,0,3,2,7,8,1,DAL,DAL,BKN,125,,,12,10,9,5
Josh Green,G,22023,1630182,22300073,"OCT 25, 2023",DAL @ SAS,W,30,3,5,0.6,2,2,1.0,3,4,0.75,2,0,2,1,1,0,0,4,11,4,1,DAL,SAS,DAL,126,,,14,13,12,3
Josh Green,G,22023,1630182,22300748,"FEB 10, 2024",DAL vs. OKC,W,27,2,4,0.5,0,1,0.0,2,2,1.0,0,2,2,2,2,0,1,3,6,20,1,DAL,DAL,OKC,146,,,10,8,8,4
Josh Green,G,22023,1630182,22300736,"FEB 08, 2024",DAL @ NYK,W,32,5,9,0.556,2,5,0.4,3,3,1.0,1,5,6,3,1,1,0,2,15,5,1,DAL,NYK,DAL,121,,,24,21,18,9
Josh Green,G,22023,1630182,22300720,"FEB 06, 2024",DAL @ BKN,W,33,5,11,0.455,2,5,0.4,0,0,0.0,1,1,2,3,0,0,1,1,12,-5,1,DAL,BKN,DAL,119,,,17,14,15,5
Josh Green,G,22023,1630182,22300715,"FEB 05, 2024",DAL @ PHI,W,32,6,9,0.667,4,7,0.571,4,4,1.0,1,5,6,4,2,0,1,0,20,15,1,DAL,PHI,DAL,118,,,30,26,24,10
Josh Green,G,22023,1630182,22300702,"FEB 03, 2024",DAL vs. MIL,L,38,7,12,0.583,4,8,0.5,2,2,1.0,0,9,9,3,1,0,3,0,20,-29,1,DAL,DAL,MIL,117,,,32,29,23,12
Josh Green,G,22023,1630182,22300634,"JAN 26, 2024",DAL @ ATL,W,35,8,12,0.667,4,5,0.8,1,2,0.5,1,1,2,4,0,0,3,5,21,9,1,DAL,ATL,DAL,148,,,27,23,25,6
Josh Green,G,22023,1630182,22300625,"JAN 24, 2024",DAL vs. PHX,L,31,3,8,0.375,2,6,0.333,0,0,0.0,3,1,4,3,0,0,1,1,8,-13,1,DAL,DAL,PHX,107,,,15,12,11,7
Josh Green,G,22023,1630182,22300611,"JAN 22, 2024",DAL vs. BOS,L,38,5,11,0.455,4,7,0.571,0,0,0.0,1,6,7,1,0,0,3,4,14,-9,1,DAL,DAL,BOS,110,,,22,21,15,8
Josh Green,G,22023,1630182,22300457,"JAN 01, 2024",DAL @ UTA,L,21,0,4,0.0,0,1,0.0,0,0,0.0,0,2,2,1,0,0,2,4,0,-21,1,DAL,UTA,DAL,86,,,3,2,1,3
Josh Green,G,22023,1630182,22300444,"DEC 30, 2023",DAL @ GSW,W,25,6,8,0.75,3,4,0.75,3,3,1.0,0,0,0,2,0,0,1,0,18,2,1,DAL,GSW,DAL,132,,,20,18,20,2
Josh Green,G,22023,1630182,22300212,"NOV 19, 2023",DAL vs. SAC,L,26,4,8,0.5,2,5,0.4,1,2,0.5,1,3,4,5,2,0,1,2,11,-1,1,DAL,DAL,SAC,113,,,20,15,16,9
Josh Green,G,22023,1630182,22300168,"NOV 08, 2023",DAL vs. TOR,L,18,1,3,0.333,1,2,0.5,0,0,0.0,0,1,1,2,0,1,1,2,3,-21,1,DAL,DAL,TOR,116,,,6,4,5,3
Josh Green,G,22023,1630182,22300147,"NOV 06, 2023",DAL @ ORL,W,20,2,3,0.667,1,2,0.5,1,2,0.5,0,2,2,1,1,0,1,3,6,10,1,DAL,ORL,DAL,117,,,9,8,7,3
Josh Green,G,22023,1630182,22300143,"NOV 05, 2023",DAL vs. CHA,W,24,3,9,0.333,1,4,0.25,0,2,0.0,0,2,2,3,1,1,1,1,7,2,1,DAL,DAL,CHA,124,,,12,9,10,5
Ausar Thompson,F,22023,1641709,22300534,"JAN 12, 2024",DET vs. HOU,L,18,2,3,0.667,0,1,0.0,0,0,0.0,2,6,8,0,0,0,1,2,4,5,1,DET,DET,HOU,110,,,12,12,4,8
Ausar Thompson,F,22023,1641709,22300453,"JAN 01, 2024",DET @ HOU,L,24,2,4,0.5,0,0,0.0,1,2,0.5,1,3,4,2,0,2,2,2,5,-10,1,DET,HOU,DET,113,,,11,9,7,6
Ausar Thompson,F,22023,1641709,22300394,"DEC 23, 2023",DET @ BKN,L,31,2,7,0.286,1,3,0.333,2,3,0.667,1,4,5,2,1,0,0,2,7,-2,1,DET,BKN,DET,115,,,14,12,9,7
Ausar Thompson,F,22023,1641709,22300374,"DEC 21, 2023",DET vs. UTA,L,19,3,3,1.0,0,0,0.0,1,2,0.5,1,1,2,1,1,2,3,2,7,-18,1,DET,DET,UTA,111,,,10,9,8,3
Ausar Thompson,F,22023,1641709,22300352,"DEC 18, 2023",DET @ ATL,L,19,1,5,0.2,0,1,0.0,0,0,0.0,3,5,8,3,1,0,2,2,2,-16,1,DET,ATL,DET,124,,,13,10,5,11
Ausar Thompson,F,22023,1641709,22300334,"DEC 16, 2023",DET @ MIL,L,24,3,6,0.5,1,3,0.333,0,0,0.0,0,6,6,1,0,0,0,4,7,-17,1,DET,MIL,DET,114,,,14,13,8,7
Ausar Thompson,F,22023,1641709,22301217,"DEC 08, 2023",DET @ ORL,L,20,2,12,0.167,0,5,0.0,1,2,0.5,1,1,2,2,1,0,0,3,5,-15,1,DET,ORL,DET,91,,,9,7,7,4
Ausar Thompson,F,22023,1641709,22300283,"DEC 02, 2023",DET vs. CLE,L,16,2,6,0.333,0,2,0.0,0,0,0.0,4,4,8,0,0,0,2,5,4,-14,1,DET,DET,CLE,101,,,12,12,4,8
Ausar Thompson,F,22023,1641709,22300268,"NOV 30, 2023",DET @ NYK,L,13,1,2,0.5,1,1,1.0,0,0,0.0,1,6,7,0,0,0,3,5,3,-13,1,DET,NYK,DET,112,,,10,10,3,7
Ausar Thompson,F,22023,1641709,22300258,"NOV 29, 2023",DET vs. LAL,L,21,6,11,0.545,0,3,0.0,0,0,0.0,1,5,6,0,1,0,0,4,12,-23,1,DET,DET,LAL,107,,,18,18,12,6
Ausar Thompson,F,22023,1641709,22300047,"NOV 24, 2023",DET @ IND,L,30,4,5,0.8,0,0,0.0,0,0,0.0,1,5,6,3,0,2,1,2,8,6,1,DET,IND,DET,113,,,17,14,11,9
Ausar Thompson,F,22023,1641709,22300218,"NOV 20, 2023",DET vs. DEN,L,24,4,10,0.4,0,0,0.0,0,0,0.0,3,4,7,0,0,2,0,5,8,-7,1,DET,DET,DEN,103,,,15,15,8,7
Ausar Thompson,F,22023,1641709,22300211,"NOV 19, 2023",DET @ TOR,L,30,3,5,0.6,0,1,0.0,3,4,0.75,1,9,10,2,1,1,5,6,9,-21,1,DET,TOR,DET,113,,,21,19,11,12
Ausar Thompson,F,22023,1641709,22300030,"NOV 17, 2023",DET @ CLE,L,17,4,8,0.5,0,1,0.0,1,3,0.333,5,5,10,2,0,0,5,4,9,-5,1,DET,CLE,DET,100,,,21,19,11,12
Ausar Thompson,F,22023,1641709,22300018,"NOV 14, 2023",DET vs. ATL,L,35,9,12,0.75,0,1,0.0,3,6,0.5,1,7,8,5,3,2,2,3,21,-4,1,DET,DET,ATL,120,,,34,29,26,13
Ausar Thompson,F,22023,1641709,22300181,"NOV 12, 2023",DET @ CHI,L,32,2,9,0.222,0,1,0.0,5,7,0.714,6,10,16,2,0,2,3,1,9,-19,1,DET,CHI,DET,108,,,27,25,11,18
Ausar Thompson,F,22023,1641709,22300008,"NOV 10, 2023",DET vs. PHI,L,32,6,11,0.545,0,1,0.0,0,1,0.0,3,10,13,4,1,3,2,4,12,2,1,DET,DET,PHI,106,,,29,25,16,17
Ausar Thompson,F,22023,1641709,22300165,"NOV 08, 2023",DET @ MIL,L,37,3,8,0.375,0,1,0.0,0,0,0.0,3,12,15,3,0,1,2,4,6,-6,1,DET,MIL,DET,118,,,24,21,9,18
Ausar Thompson,F,22023,1641709,22300145,"NOV 06, 2023",DET vs. GSW,L,38,6,10,0.6,1,4,0.25,3,3,1.0,4,3,7,2,4,0,1,2,16,3,1,DET,DET,GSW,109,,,25,23,18,9
Ausar Thompson,F,22023,1641709,22300140,"NOV 05, 2023",DET vs. PHX,L,38,6,14,0.429,2,3,0.667,0,0,0.0,5,4,9,4,4,4,1,3,14,-13,1,DET,DET,PHX,106,,,27,23,18,13
Ausar Thompson,F,22023,1641709,22300129,"NOV 02, 2023",DET @ NOP,L,25,5,17,0.294,0,6,0.0,6,7,0.857,5,2,7,5,0,1,3,5,16,-16,1,DET,NOP,DET,116,,,28,23,21,12
Ausar Thompson,F,22023,1641709,22300115,"NOV 01, 2023",DET vs. POR,L,30,8,14,0.571,0,3,0.0,0,0,0.0,3,4,7,2,2,0,2,4,16,-9,1,DET,DET,POR,101,,,25,23,18,9
Ausar Thompson,F,22023,1641709,22300109,"OCT 30, 2023",DET @ OKC,L,31,6,14,0.429,0,2,0.0,3,4,0.75,7,3,10,3,1,3,3,4,15,-13,1,DET,OKC,DET,112,,,28,25,18,13
Ausar Thompson,F,22023,1641709,22300088,"OCT 28, 2023",DET vs. CHI,W,31,3,7,0.429,0,2,0.0,3,4,0.75,3,9,12,5,1,1,2,3,9,6,1,DET,DET,CHI,118,,,26,21,14,17
Ausar Thompson,F,22023,1641709,22300077,"OCT 27, 2023",DET @ CHA,W,30,2,9,0.222,0,1,0.0,2,2,1.0,4,9,13,6,0,1,3,5,6,10,1,DET,CHA,DET,111,,,25,19,12,19
Ausar Thompson,F,22023,1641709,22300068,"OCT 25, 2023",DET @ MIA,L,27,1,7,0.143,1,2,0.5,1,2,0.5,3,4,7,3,0,5,2,2,4,-14,1,DET,MIA,DET,102,,,14,11,7,10
Ausar Thompson,F,22023,1641709,22300704,"FEB 04, 2024",DET vs. ORL,L,27,7,10,0.7,1,3,0.333,2,3,0.667,4,3,7,1,1,3,2,1,17,-8,1,DET,DET,ORL,99,,,25,24,18,8
Ausar Thompson,F,22023,1641709,22300688,"FEB 02, 2024",DET vs. LAC,L,26,1,4,0.25,0,1,0.0,1,2,0.5,4,3,7,1,2,1,1,1,3,-11,1,DET,DET,LAC,125,,,11,10,4,8
Ausar Thompson,F,22023,1641709,22300675,"JAN 31, 2024",DET @ CLE,L,18,2,3,0.667,0,1,0.0,0,0,0.0,1,5,6,2,2,0,2,0,4,19,1,DET,CLE,DET,121,,,12,10,6,8
Ausar Thompson,F,22023,1641709,22300654,"JAN 28, 2024",DET vs. OKC,W,20,3,7,0.429,0,1,0.0,3,3,1.0,2,2,4,1,1,1,0,1,9,16,1,DET,DET,OKC,120,,,14,13,10,5
Ausar Thompson,F,22023,1641709,22300642,"JAN 27, 2024",DET vs. WAS,L,17,4,6,0.667,0,2,0.0,0,0,0.0,2,0,2,0,1,2,1,0,8,-18,1,DET,DET,WAS,104,,,10,10,8,2
Ausar Thompson,F,22023,1641709,22300619,"JAN 24, 2024",DET vs. CHA,W,27,3,4,0.75,0,1,0.0,1,2,0.5,0,2,2,1,2,0,2,4,7,3,1,DET,DET,CHA,113,,,10,9,8,3
Ausar Thompson,F,22023,1641709,22300606,"JAN 22, 2024",DET vs. MIL,L,19,0,1,0.0,0,0,0.0,0,2,0.0,1,4,5,1,0,0,0,2,0,11,1,DET,DET,MIL,113,,,6,5,1,6
Ausar Thompson,F,22023,1641709,22300592,"JAN 20, 2024",DET vs. MIL,L,32,10,15,0.667,2,2,1.0,0,0,0.0,5,4,9,1,0,1,1,4,22,6,1,DET,DET,MIL,135,,,32,31,23,10
Ausar Thompson,F,22023,1641709,22300569,"JAN 17, 2024",DET vs. MIN,L,22,3,6,0.5,0,2,0.0,1,5,0.2,3,6,9,1,0,1,0,0,7,-6,1,DET,DET,MIN,117,,,17,16,8,10
Ausar Thompson,F,22023,1641709,22300519,"JAN 10, 2024",DET vs. SAS,L,15,1,6,0.167,0,3,0.0,1,1,1.0,0,6,6,1,0,1,1,4,3,-10,1,DET,DET,SAS,108,,,10,9,4,7
Ausar Thompson,F,22023,1641709,22300512,"JAN 09, 2024",DET vs. SAC,L,14,0,2,0.0,0,0,0.0,0,0,0.0,0,2,2,0,3,0,0,3,0,-2,1,DET,DET,SAC,110,,,2,2,0,2
Ausar Thompson,F,22023,1641709,22300502,"JAN 07, 2024",DET @ DEN,L,20,2,5,0.4,0,1,0.0,1,2,0.5,3,2,5,4,0,0,1,2,5,0,1,DET,DEN,DET,114,,,14,10,9,9
Ausar Thompson,F,22023,1641709,22300490,"JAN 05, 2024",DET @ GSW,L,9,0,3,0.0,0,1,0.0,2,2,1.0,0,4,4,1,2,0,1,3,2,3,1,DET,GSW,DET,109,,,7,6,3,5
Ausar Thompson,F,22023,1641709,22300474,"JAN 03, 2024",DET @ UTA,L,11,1,4,0.25,0,1,0.0,0,2,0.0,2,1,3,1,1,1,0,2,2,6,1,DET,UTA,DET,148,,,6,5,3,4
Ausar Thompson,F,22023,1641709,22300440,"DEC 30, 2023",DET vs. TOR,W,12,2,4,0.5,0,2,0.0,2,2,1.0,0,1,1,0,0,0,0,1,6,3,1,DET,DET,TOR,129,,,7,7,6,1
Ausar Thompson,F,22023,1641709,22300421,"DEC 28, 2023",DET @ BOS,L,12,1,2,0.5,0,1,0.0,0,0,0.0,0,3,3,2,0,0,0,1,2,-1,1,DET,BOS,DET,122,,,7,5,4,5
Ausar Thompson,F,22023,1641709,22300406,"DEC 26, 2023",DET vs. BKN,L,9,0,2,0.0,0,0,0.0,2,2,1.0,0,1,1,1,1,1,0,2,2,-5,1,DET,DET,BKN,112,,,4,3,3,2
Ausar Thompson,F,22023,1641709,22300327,"DEC 15, 2023",DET @ PHI,L,22,3,5,0.6,0,0,0.0,2,2,1.0,0,3,3,1,0,1,1,2,8,-15,1,DET,PHI,DET,92,,,12,11,9,4
Ausar Thompson,F,22023,1641709,22300310,"DEC 13, 2023",DET vs. PHI,L,30,5,7,0.714,0,1,0.0,0,0,0.0,2,6,8,3,1,0,0,3,10,-1,1,DET,DET,PHI,111,,,21,18,13,11
Ausar Thompson,F,22023,1641709,22300293,"DEC 11, 2023",DET vs. IND,L,33,8,10,0.8,1,2,0.5,3,5,0.6,2,4,6,2,1,1,1,4,20,-8,1,DET,DET,IND,123,,,28,26,22,8
Ausar Thompson,F,22023,1641709,22301206,"DEC 06, 2023",DET vs. MEM,L,16,2,6,0.333,1,4,0.25,0,0,0.0,2,2,4,0,0,0,0,0,5,-15,1,DET,DET,MEM,102,,,9,9,5,4
Ausar Thompson,F,22023,1641709,22300749,"FEB 10, 2024",DET @ LAC,L,28,5,12,0.417,0,2,0.0,0,0,0.0,4,4,8,5,2,0,2,2,10,3,1,DET,LAC,DET,106,,,23,18,15,13
Ausar Thompson,F,22023,1641709,22300732,"FEB 07, 2024",DET @ SAC,W,27,5,6,0.833,0,0,0.0,2,2,1.0,1,5,6,2,2,1,2,5,12,12,1,DET,SAC,DET,133,,,20,18,14,8
Ausar Thompson,F,22023,1641709,22300558,"JAN 15, 2024",DET @ WAS,W,27,6,8,0.75,0,1,0.0,2,3,0.667,1,7,8,2,3,0,0,2,14,9,1,DET,WAS,DET,129,,,24,22,16,10
Ausar Thompson,F,22023,1641709,22300253,"NOV 27, 2023",DET vs. WAS,L,28,8,14,0.571,0,2,0.0,0,0,0.0,0,4,4,2,2,1,1,4,16,-3,1,DET,DET,WAS,107,,,22,20,18,6
Ausar Thompson,F,22023,1641709,22300741,"FEB 08, 2024",DET @ POR,W,29,3,9,0.333,0,0,0.0,0,2,0.0,2,3,5,1,1,0,0,4,6,20,1,DET,POR,DET,128,,,12,11,7,6
Sam Hauser,F,22023,1630573,22300706,"FEB 04, 2024",BOS vs. MEM,W,24,1,3,0.333,1,3,0.333,0,0,0.0,0,3,3,1,0,0,0,1,3,16,1,BOS,BOS,MEM,131,,,7,6,4,4
Sam Hauser,F,22023,1630573,22300684,"FEB 01, 2024",BOS vs. LAL,L,23,6,11,0.545,5,9,0.556,0,0,0.0,0,3,3,0,0,0,0,1,17,6,1,BOS,BOS,LAL,105,,,20,20,17,3
Sam Hauser,F,22023,1630573,22300646,"JAN 27, 2024",BOS vs. LAC,L,20,2,5,0.4,2,4,0.5,0,0,0.0,0,3,3,1,0,1,0,1,6,-11,1,BOS,BOS,LAC,96,,,10,9,7,4
Sam Hauser,F,22023,1630573,22300630,"JAN 25, 2024",BOS @ MIA,W,12,2,2,1.0,1,1,1.0,0,0,0.0,0,0,0,1,0,0,1,0,5,13,1,BOS,MIA,BOS,143,,,6,5,6,1
Sam Hauser,F,22023,1630573,22300571,"JAN 17, 2024",BOS vs. SAS,W,20,3,6,0.5,1,4,0.25,0,0,0.0,0,4,4,2,0,0,2,0,7,18,1,BOS,BOS,SAS,117,,,13,11,9,6
Sam Hauser,F,22023,1630573,22300528,"JAN 11, 2024",BOS @ MIL,L,24,4,8,0.5,4,8,0.5,3,3,1.0,1,3,4,0,1,0,1,1,15,-16,1,BOS,MIL,BOS,102,,,19,19,15,4
Sam Hauser,F,22023,1630573,22300493,"JAN 06, 2024",BOS @ IND,W,16,2,6,0.333,1,5,0.2,0,0,0.0,0,4,4,1,0,0,1,4,5,2,1,BOS,IND,BOS,118,,,10,9,6,5
Sam Hauser,F,22023,1630573,22300479,"JAN 05, 2024",BOS vs. UTA,W,23,5,10,0.5,3,7,0.429,0,0,0.0,1,4,5,1,1,0,0,1,13,17,1,BOS,BOS,UTA,126,,,19,18,14,6
Sam Hauser,F,22023,1630573,22300448,"DEC 31, 2023",BOS @ SAS,W,20,4,6,0.667,3,5,0.6,0,0,0.0,0,4,4,1,0,0,1,2,11,15,1,BOS,SAS,BOS,134,,,16,15,12,5
Sam Hauser,F,22023,1630573,22300432,"DEC 29, 2023",BOS vs. TOR,W,34,3,7,0.429,3,7,0.429,0,0,0.0,0,9,9,1,0,1,0,2,9,-8,1,BOS,BOS,TOR,120,,,19,18,10,10
Sam Hauser,F,22023,1630573,22300389,"DEC 23, 2023",BOS @ LAC,W,19,1,5,0.2,1,5,0.2,0,0,0.0,0,2,2,4,0,0,0,3,3,11,1,BOS,LAC,BOS,142,,,9,5,7,6
Sam Hauser,F,22023,1630573,22300344,"DEC 17, 2023",BOS vs. ORL,W,17,2,5,0.4,0,3,0.0,0,0,0.0,1,1,2,0,1,0,1,0,4,12,1,BOS,BOS,ORL,114,,,6,6,4,2
Sam Hauser,F,22023,1630573,22301227,"DEC 08, 2023",BOS vs. NYK,W,21,0,5,0.0,0,5,0.0,1,2,0.5,1,2,3,1,0,1,0,1,1,-10,1,BOS,BOS,NYK,133,,,5,4,2,4
Sam Hauser,F,22023,1630573,22301202,"DEC 04, 2023",BOS @ IND,L,23,5,9,0.556,5,7,0.714,0,0,0.0,2,4,6,1,0,0,0,2,15,9,1,BOS,IND,BOS,112,,,22,21,16,7
Sam Hauser,F,22023,1630573,22300275,"DEC 01, 2023",BOS vs. PHI,W,26,3,5,0.6,3,4,0.75,2,2,1.0,1,4,5,1,1,1,3,2,11,-3,1,BOS,BOS,PHI,125,,,17,16,12,6
Sam Hauser,F,22023,1630573,22300053,"NOV 28, 2023",BOS vs. CHI,W,21,3,12,0.25,2,10,0.2,1,2,0.5,4,6,10,2,0,0,2,1,9,13,1,BOS,BOS,CHI,124,,,21,19,11,12
Sam Hauser,F,22023,1630573,22300246,"NOV 26, 2023",BOS vs. ATL,W,32,4,9,0.444,4,9,0.444,0,0,0.0,2,2,4,2,0,0,0,2,12,11,1,BOS,BOS,ATL,113,,,18,16,14,6
Sam Hauser,F,22023,1630573,22300043,"NOV 24, 2023",BOS @ ORL,L,25,4,6,0.667,2,4,0.5,0,0,0.0,1,1,2,0,0,0,1,0,10,-16,1,BOS,ORL,BOS,96,,,12,12,10,2
Sam Hauser,F,22023,1630573,22300194,"NOV 15, 2023",BOS @ PHI,W,35,3,9,0.333,2,8,0.25,0,0,0.0,1,1,2,2,0,1,0,2,8,4,1,BOS,PHI,BOS,117,,,12,10,10,4
Sam Hauser,F,22023,1630573,22300174,"NOV 11, 2023",BOS vs. TOR,W,18,4,6,0.667,4,6,0.667,0,0,0.0,0,4,4,0,0,0,0,2,12,-2,1,BOS,BOS,TOR,117,,,16,16,12,4
Sam Hauser,F,22023,1630573,22300010,"NOV 10, 2023",BOS vs. BKN,W,25,5,10,0.5,5,10,0.5,0,0,0.0,1,1,2,1,0,0,0,1,15,-1,1,BOS,BOS,BKN,121,,,18,17,16,3
Sam Hauser,F,22023,1630573,22300118,"NOV 01, 2023",BOS vs. IND,W,19,5,7,0.714,5,6,0.833,2,2,1.0,0,3,3,0,1,0,1,3,17,23,1,BOS,BOS,IND,155,,,20,20,17,3
Sam Hauser,F,22023,1630573,22300103,"OCT 30, 2023",BOS @ WAS,W,25,3,10,0.3,2,9,0.222,0,0,0.0,3,5,8,1,0,1,1,3,8,-10,1,BOS,WAS,BOS,126,,,17,16,9,9
Sam Hauser,F,22023,1630573,22300729,"FEB 07, 2024",BOS vs. ATL,W,25,3,8,0.375,2,6,0.333,2,2,1.0,2,3,5,0,0,0,2,1,10,14,1,BOS,BOS,ATL,125,,,15,15,10,5
Sam Hauser,F,22023,1630573,22300670,"JAN 30, 2024",BOS vs. IND,W,23,3,5,0.6,3,5,0.6,0,0,0.0,0,2,2,1,1,0,2,3,9,14,1,BOS,BOS,IND,129,,,12,11,10,3
Sam Hauser,F,22023,1630573,22300659,"JAN 29, 2024",BOS vs. NOP,W,26,4,8,0.5,3,7,0.429,0,0,0.0,0,0,0,1,1,0,0,0,11,9,1,BOS,BOS,NOP,118,,,12,11,12,1
Sam Hauser,F,22023,1630573,22300603,"JAN 21, 2024",BOS @ HOU,W,31,3,12,0.25,3,12,0.25,0,0,0.0,2,5,7,6,1,1,1,0,9,8,1,BOS,HOU,BOS,116,,,22,16,15,13
Sam Hauser,F,22023,1630573,22300563,"JAN 15, 2024",BOS @ TOR,W,16,1,2,0.5,1,1,1.0,0,0,0.0,0,5,5,0,0,1,0,0,3,5,1,BOS,TOR,BOS,105,,,8,8,3,5
Sam Hauser,F,22023,1630573,22300542,"JAN 13, 2024",BOS vs. HOU,W,20,2,9,0.222,2,8,0.25,0,0,0.0,0,6,6,0,0,0,0,0,6,20,1,BOS,BOS,HOU,145,,,12,12,6,6
Sam Hauser,F,22023,1630573,22300517,"JAN 10, 2024",BOS vs. MIN,W,18,2,6,0.333,2,5,0.4,0,0,0.0,0,4,4,0,0,1,0,2,6,-2,1,BOS,BOS,MIN,127,,,10,10,6,4
Sam Hauser,F,22023,1630573,22300421,"DEC 28, 2023",BOS vs. DET,W,18,2,6,0.333,1,4,0.25,0,0,0.0,1,2,3,1,0,0,1,0,5,-8,1,BOS,BOS,DET,128,,,9,8,6,4
Sam Hauser,F,22023,1630573,22300373,"DEC 20, 2023",BOS @ SAC,W,35,4,6,0.667,2,4,0.5,0,0,0.0,0,5,5,1,0,0,0,3,10,24,1,BOS,SAC,BOS,144,,,16,15,11,6
Sam Hauser,F,22023,1630573,22300362,"DEC 19, 2023",BOS @ GSW,L,21,0,7,0.0,0,6,0.0,0,0,0.0,1,2,3,1,0,0,0,2,0,1,1,BOS,GSW,BOS,126,,,4,3,1,4
Sam Hauser,F,22023,1630573,22300329,"DEC 15, 2023",BOS vs. ORL,W,32,4,8,0.5,3,6,0.5,0,0,0.0,2,5,7,4,4,0,1,1,11,19,1,BOS,BOS,ORL,128,,,22,18,15,11
Sam Hauser,F,22023,1630573,22300217,"NOV 20, 2023",BOS @ CHA,L,37,1,9,0.111,1,9,0.111,0,0,0.0,0,1,1,1,0,0,1,3,3,-22,1,BOS,CHA,BOS,118,,,5,4,4,2
Sam Hauser,F,22023,1630573,22300136,"NOV 04, 2023",BOS @ BKN,W,19,2,3,0.667,1,2,0.5,0,0,0.0,0,1,1,0,2,0,1,3,5,-5,1,BOS,BKN,BOS,124,,,6,6,5,1
Sam Hauser,F,22023,1630573,22300080,"OCT 27, 2023",BOS vs. MIA,W,10,1,2,0.5,1,2,0.5,0,0,0.0,0,1,1,0,0,0,0,1,3,6,1,BOS,BOS,MIA,119,,,4,4,3,1
Sam Hauser,F,22023,1630573,22300743,"FEB 09, 2024",BOS vs. WAS,W,16,1,6,0.167,1,6,0.167,2,2,1.0,0,1,1,1,1,0,0,1,5,14,1,BOS,BOS,WAS,133,,,7,6,6,2
Sam Hauser,F,22023,1630573,22300611,"JAN 22, 2024",BOS @ DAL,W,15,2,3,0.667,1,2,0.5,0,0,0.0,1,0,1,0,0,0,0,1,5,-4,1,BOS,DAL,BOS,119,,,6,6,5,1
Sam Hauser,F,22023,1630573,22300586,"JAN 19, 2024",BOS vs. DEN,L,16,0,1,0.0,0,1,0.0,0,0,0.0,0,1,1,1,0,0,0,2,0,-5,1,BOS,BOS,DEN,100,,,2,1,1,2
Sam Hauser,F,22023,1630573,22300462,"JAN 02, 2024",BOS @ OKC,L,10,2,3,0.667,2,3,0.667,0,0,0.0,0,1,1,0,0,0,0,0,6,-7,1,BOS,OKC,BOS,123,,,7,7,6,1
Sam Hauser,F,22023,1630573,22300403,"DEC 25, 2023",BOS @ LAL,W,15,1,5,0.2,0,4,0.0,0,0,0.0,1,1,2,0,0,0,0,0,2,3,1,BOS,LAL,BOS,126,,,4,4,2,2
Sam Hauser,F,22023,1630573,22300319,"DEC 14, 2023",BOS vs. CLE,W,18,3,3,1.0,3,3,1.0,0,0,0.0,0,0,0,1,0,0,0,2,9,9,1,BOS,BOS,CLE,116,,,10,9,10,1
Sam Hauser,F,22023,1630573,22300305,"DEC 12, 2023",BOS vs. CLE,W,20,3,5,0.6,3,4,0.75,0,0,0.0,1,2,3,1,0,0,0,1,9,14,1,BOS,BOS,CLE,120,,,13,12,10,4
Sam Hauser,F,22023,1630573,22300228,"NOV 22, 2023",BOS vs. MIL,W,20,4,5,0.8,2,3,0.667,0,0,0.0,1,1,2,1,0,1,1,2,10,10,1,BOS,BOS,MIL,119,,,13,12,11,3
Sam Hauser,F,22023,1630573,22300213,"NOV 19, 2023",BOS @ MEM,W,22,5,8,0.625,5,7,0.714,0,0,0.0,0,4,4,0,2,0,0,0,15,17,1,BOS,MEM,BOS,102,,,19,19,15,4
Sam Hauser,F,22023,1630573,22300031,"NOV 17, 2023",BOS @ TOR,W,23,4,7,0.571,3,6,0.5,0,0,0.0,1,2,3,3,1,0,0,0,11,8,1,BOS,TOR,BOS,108,,,17,14,14,6
Sam Hauser,F,22023,1630573,22300188,"NOV 13, 2023",BOS vs. NYK,W,21,4,6,0.667,4,6,0.667,0,0,0.0,0,4,4,2,0,0,0,0,12,6,1,BOS,BOS,NYK,114,,,18,16,14,6
Sam Hauser,F,22023,1630573,22300159,"NOV 08, 2023",BOS @ PHI,L,19,5,8,0.625,3,6,0.5,0,0,0.0,0,4,4,0,1,1,0,0,13,-6,1,BOS,PHI,BOS,103,,,17,17,13,4
Sam Hauser,F,22023,1630573,22300154,"NOV 06, 2023",BOS @ MIN,L,25,3,8,0.375,3,8,0.375,2,2,1.0,1,3,4,0,1,1,1,3,11,-3,1,BOS,MIN,BOS,109,,,15,15,11,4
Sam Hauser,F,22023,1630573,22300065,"OCT 25, 2023",BOS @ NYK,W,14,0,4,0.0,0,4,0.0,0,0,0.0,0,2,2,0,1,1,0,1,0,5,1,BOS,NYK,BOS,108,,,2,2,0,2
David Roddy,F,22023,1631223,22300722,"FEB 06, 2024",MEM @ NYK,L,23,6,11,0.545,3,5,0.6,0,2,0.0,1,2,3,3,0,0,3,0,15,2,1,MEM,NYK,MEM,97,,,21,18,18,6
David Roddy,F,22023,1631223,22300693,"FEB 02, 2024",MEM vs. GSW,L,27,6,10,0.6,1,3,0.333,3,4,0.75,0,2,2,4,0,0,2,3,16,-16,1,MEM,MEM,GSW,98,,,22,18,20,6
David Roddy,F,22023,1631223,22300687,"FEB 01, 2024",MEM vs. CLE,L,18,1,12,0.083,0,2,0.0,0,0,0.0,0,4,4,3,1,0,0,2,2,2,1,MEM,MEM,CLE,86,,,9,6,5,7
David Roddy,F,22023,1631223,22300663,"JAN 29, 2024",MEM vs. SAC,L,35,3,9,0.333,0,4,0.0,3,5,0.6,2,8,10,2,1,0,4,0,9,-19,1,MEM,MEM,SAC,72,,,21,19,11,12
David Roddy,F,22023,1631223,22300652,"JAN 28, 2024",MEM @ IND,L,32,5,13,0.385,2,7,0.286,2,2,1.0,1,4,5,1,1,1,0,4,14,4,1,MEM,IND,MEM,106,,,20,19,15,6
David Roddy,F,22023,1631223,22300638,"JAN 26, 2024",MEM vs. ORL,W,17,1,4,0.25,0,1,0.0,1,2,0.5,3,7,10,3,0,0,1,2,3,4,1,MEM,MEM,ORL,107,,,16,13,6,13
David Roddy,F,22023,1631223,22300609,"JAN 22, 2024",MEM @ TOR,W,23,4,12,0.333,0,0,0.0,0,0,0.0,6,3,9,2,0,0,1,1,8,-5,1,MEM,TOR,MEM,108,,,19,17,10,11
David Roddy,F,22023,1631223,22300597,"JAN 20, 2024",MEM @ CHI,L,32,5,11,0.455,1,5,0.2,0,0,0.0,0,2,2,3,0,0,1,3,11,-22,1,MEM,CHI,MEM,93,,,16,13,14,5
David Roddy,F,22023,1631223,22300582,"JAN 18, 2024",MEM @ MIN,L,23,2,7,0.286,1,2,0.5,3,4,0.75,1,3,4,1,0,0,0,2,8,-13,1,MEM,MIN,MEM,103,,,13,12,9,5
David Roddy,F,22023,1631223,22300560,"JAN 15, 2024",MEM vs. GSW,W,21,5,12,0.417,2,4,0.5,0,0,0.0,3,4,7,2,0,0,2,1,12,9,1,MEM,MEM,GSW,116,,,21,19,14,9
David Roddy,F,22023,1631223,22300491,"JAN 05, 2024",MEM @ LAL,W,7,0,2,0.0,0,1,0.0,0,0,0.0,0,2,2,0,0,0,0,1,0,0,1,MEM,LAL,MEM,127,,,2,2,0,2
David Roddy,F,22023,1631223,22300470,"JAN 03, 2024",MEM vs. TOR,L,8,0,2,0.0,0,2,0.0,0,0,0.0,0,0,0,0,0,0,0,0,0,-10,1,MEM,MEM,TOR,111,,,0,0,0,0
David Roddy,F,22023,1631223,22300460,"JAN 02, 2024",MEM vs. SAS,W,0,0,0,0.0,0,0,0.0,0,0,0.0,0,0,0,0,0,0,0,0,0,-4,1,MEM,MEM,SAS,106,,,0,0,0,0
David Roddy,F,22023,1631223,22300449,"DEC 31, 2023",MEM vs. SAC,L,11,0,3,0.0,0,2,0.0,2,2,1.0,0,0,0,1,0,0,1,0,2,-13,1,MEM,MEM,SAC,92,,,3,2,3,1
David Roddy,F,22023,1631223,22300438,"DEC 29, 2023",MEM @ LAC,L,22,1,3,0.333,0,1,0.0,2,3,0.667,0,2,2,1,0,0,1,1,4,7,1,MEM,LAC,MEM,106,,,7,6,5,3
David Roddy,F,22023,1631223,22300410,"DEC 26, 2023",MEM @ NOP,W,16,3,7,0.429,2,5,0.4,0,0,0.0,1,3,4,1,0,0,0,0,8,1,1,MEM,NOP,MEM,116,,,13,12,9,5
David Roddy,F,22023,1631223,22300360,"DEC 19, 2023",MEM @ NOP,W,9,0,2,0.0,0,1,0.0,0,0,0.0,1,0,1,3,0,0,1,0,0,7,1,MEM,NOP,MEM,115,,,4,1,3,4
David Roddy,F,22023,1631223,22300355,"DEC 18, 2023",MEM @ OKC,L,22,2,5,0.4,1,3,0.333,3,3,1.0,0,4,4,1,1,0,3,1,8,-1,1,MEM,OKC,MEM,97,,,13,12,9,5
David Roddy,F,22023,1631223,22300332,"DEC 15, 2023",MEM vs. HOU,L,28,3,10,0.3,1,6,0.167,2,2,1.0,1,4,5,2,0,1,0,2,9,-3,1,MEM,MEM,HOU,96,,,16,14,11,7
David Roddy,F,22023,1631223,22300314,"DEC 13, 2023",MEM @ HOU,L,32,3,14,0.214,2,7,0.286,1,2,0.5,1,5,6,4,1,0,1,1,9,1,1,MEM,HOU,MEM,104,,,19,15,13,10
David Roddy,F,22023,1631223,22300299,"DEC 11, 2023",MEM vs. DAL,L,29,3,9,0.333,1,5,0.2,1,2,0.5,2,4,6,2,1,0,1,1,8,1,1,MEM,MEM,DAL,113,,,16,14,10,8
David Roddy,F,22023,1631223,22301221,"DEC 08, 2023",MEM vs. MIN,L,25,6,11,0.545,1,4,0.25,0,0,0.0,0,3,3,0,0,0,0,0,13,-11,1,MEM,MEM,MIN,95,,,16,16,13,3
David Roddy,F,22023,1631223,22301206,"DEC 06, 2023",MEM @ DET,W,22,1,3,0.333,1,2,0.5,1,2,0.5,1,5,6,1,2,0,3,1,4,-5,1,MEM,DET,MEM,104,,,11,10,5,7
David Roddy,F,22023,1631223,22300288,"DEC 02, 2023",MEM @ PHX,L,30,3,7,0.429,2,3,0.667,0,0,0.0,2,4,6,1,1,0,1,2,8,-10,1,MEM,PHX,MEM,101,,,15,14,9,7
David Roddy,F,22023,1631223,22300277,"DEC 01, 2023",MEM @ DAL,W,24,2,9,0.222,0,3,0.0,2,2,1.0,1,5,6,3,1,1,1,2,6,12,1,MEM,DAL,MEM,89,,,15,12,9,9
David Roddy,F,22023,1631223,22300261,"NOV 29, 2023",MEM vs. UTA,W,25,7,11,0.636,5,9,0.556,0,0,0.0,1,5,6,1,0,0,0,2,19,0,1,MEM,MEM,UTA,105,,,26,25,20,7
David Roddy,F,22023,1631223,22300249,"NOV 26, 2023",MEM vs. MIN,L,28,4,9,0.444,2,5,0.4,1,1,1.0,2,2,4,2,0,0,1,2,11,-5,1,MEM,MEM,MIN,91,,,17,15,13,6
David Roddy,F,22023,1631223,22300044,"NOV 24, 2023",MEM vs. PHX,L,27,5,9,0.556,2,4,0.5,2,3,0.667,0,4,4,0,2,1,2,0,14,-15,1,MEM,MEM,PHX,89,,,18,18,14,4
David Roddy,F,22023,1631223,22300231,"NOV 22, 2023",MEM @ HOU,L,22,2,7,0.286,0,1,0.0,0,0,0.0,0,6,6,1,0,0,2,0,4,-5,1,MEM,HOU,MEM,91,,,11,10,5,7
David Roddy,F,22023,1631223,22300213,"NOV 19, 2023",MEM vs. BOS,L,20,0,2,0.0,0,2,0.0,0,0,0.0,0,2,2,0,0,0,0,0,0,-3,1,MEM,MEM,BOS,100,,,2,2,0,2
David Roddy,F,22023,1631223,22300206,"NOV 18, 2023",MEM @ SAS,W,26,0,5,0.0,0,3,0.0,0,2,0.0,2,2,4,1,2,0,1,1,0,16,1,MEM,SAS,MEM,120,,,5,4,1,5
David Roddy,F,22023,1631223,22300026,"NOV 14, 2023",MEM @ LAL,L,31,6,17,0.353,2,8,0.25,3,4,0.75,1,2,3,3,2,2,0,2,17,-7,1,MEM,LAL,MEM,107,,,23,20,20,6
David Roddy,F,22023,1631223,22300179,"NOV 12, 2023",MEM @ LAC,W,21,4,7,0.571,0,1,0.0,0,0,0.0,4,2,6,0,1,1,0,1,8,-5,1,MEM,LAC,MEM,105,,,14,14,8,6
David Roddy,F,22023,1631223,22300012,"NOV 10, 2023",MEM vs. UTA,L,19,3,9,0.333,1,5,0.2,0,0,0.0,1,2,3,0,0,0,2,1,7,-6,1,MEM,MEM,UTA,121,,,10,10,7,3
David Roddy,F,22023,1631223,22300164,"NOV 08, 2023",MEM vs. MIA,L,13,1,2,0.5,0,0,0.0,2,2,1.0,2,1,3,0,1,0,2,2,4,10,1,MEM,MEM,MIA,102,,,7,7,4,3
David Roddy,F,22023,1631223,22300144,"NOV 05, 2023",MEM @ POR,W,13,2,5,0.4,0,1,0.0,0,0,0.0,0,2,2,0,1,0,0,1,4,5,1,MEM,POR,MEM,112,,,6,6,4,2
David Roddy,F,22023,1631223,22300537,"JAN 12, 2024",MEM vs. LAC,L,27,7,11,0.636,3,5,0.6,0,0,0.0,1,5,6,4,1,0,2,3,17,-5,1,MEM,MEM,LAC,119,,,27,23,21,10
David Roddy,F,22023,1631223,22300515,"JAN 09, 2024",MEM @ DAL,W,25,3,7,0.429,1,2,0.5,4,4,1.0,2,3,5,3,0,0,2,2,11,11,1,MEM,DAL,MEM,120,,,19,16,14,8
David Roddy,F,22023,1631223,22300425,"DEC 28, 2023",MEM @ DEN,L,29,5,9,0.556,1,2,0.5,4,8,0.5,0,0,0,2,0,0,0,0,15,-11,1,MEM,DEN,MEM,105,,,17,15,17,2
David Roddy,F,22023,1631223,22300007,"NOV 03, 2023",MEM @ POR,L,32,8,14,0.571,0,4,0.0,0,0,0.0,1,2,3,0,0,0,0,4,16,-13,1,MEM,POR,MEM,113,,,19,19,16,3
David Roddy,F,22023,1631223,22300125,"NOV 01, 2023",MEM @ UTA,L,24,4,8,0.5,1,3,0.333,0,0,0.0,1,2,3,1,0,1,1,1,9,-17,1,MEM,UTA,MEM,109,,,13,12,10,4
David Roddy,F,22023,1631223,22300106,"OCT 30, 2023",MEM vs. DAL,L,29,4,8,0.5,0,1,0.0,1,2,0.5,1,4,5,2,0,1,0,2,9,-2,1,MEM,MEM,DAL,110,,,16,14,11,7
David Roddy,F,22023,1631223,22300089,"OCT 28, 2023",MEM @ WAS,L,24,5,8,0.625,3,4,0.75,1,1,1.0,0,6,6,2,0,1,1,3,14,0,1,MEM,WAS,MEM,106,,,22,20,16,8
David Roddy,F,22023,1631223,22300078,"OCT 27, 2023",MEM vs. DEN,L,15,0,4,0.0,0,2,0.0,0,0,0.0,0,2,2,2,1,0,2,3,0,-8,1,MEM,MEM,DEN,104,,,4,2,2,4
David Roddy,F,22023,1631223,22300071,"OCT 25, 2023",MEM vs. NOP,L,28,4,7,0.571,1,3,0.333,0,0,0.0,1,4,5,2,0,0,1,2,9,-3,1,MEM,MEM,NOP,104,,,16,14,11,7
David Roddy,F,22023,1631223,22300706,"FEB 04, 2024",MEM @ BOS,L,33,6,16,0.375,0,5,0.0,2,3,0.667,1,7,8,1,0,0,3,0,14,-38,1,MEM,BOS,MEM,56,,,23,22,15,9
David Roddy,F,22023,1631223,22300621,"JAN 24, 2024",MEM @ MIA,W,32,4,11,0.364,2,4,0.5,0,0,0.0,2,1,3,4,2,1,3,2,10,-9,1,MEM,MIA,MEM,90,,,17,13,14,7
David Roddy,F,22023,1631223,22300544,"JAN 13, 2024",MEM vs. NYK,L,35,6,12,0.5,2,4,0.5,0,0,0.0,1,3,4,1,2,0,2,4,14,-19,1,MEM,MEM,NYK,94,,,19,18,15,5
Kelly Olynyk,F-C,22023,203482,22300756,"FEB 10, 2024",TOR vs. CLE,L,22,4,10,0.4,1,2,0.5,2,2,1.0,4,2,6,3,3,1,2,0,11,-19,1,TOR,TOR,CLE,95,,,20,17,14,9
Kelly Olynyk,F-C,22023,203482,22300711,"FEB 04, 2024",UTA vs. MIL,W,21,2,5,0.4,1,2,0.5,3,4,0.75,2,5,7,6,0,0,0,3,8,24,1,UTA,UTA,MIL,123,,,21,15,14,13
Kelly Olynyk,F-C,22023,203482,22300686,"FEB 01, 2024",UTA vs. PHI,L,19,3,4,0.75,1,2,0.5,7,7,1.0,0,3,3,3,0,0,0,1,14,-5,1,UTA,UTA,PHI,124,,,20,17,17,6
Kelly Olynyk,F-C,22023,203482,22300671,"JAN 30, 2024",UTA @ NYK,L,21,0,3,0.0,0,1,0.0,1,2,0.5,1,4,5,3,0,0,1,2,1,-16,1,UTA,NYK,UTA,103,,,9,6,4,8
Kelly Olynyk,F-C,22023,203482,22300660,"JAN 29, 2024",UTA @ BKN,L,16,1,1,1.0,0,0,0.0,3,4,0.75,0,4,4,4,0,0,2,0,5,-8,1,UTA,BKN,UTA,114,,,13,9,9,8
Kelly Olynyk,F-C,22023,203482,22300647,"JAN 27, 2024",UTA @ CHA,W,18,2,2,1.0,1,1,1.0,1,2,0.5,1,8,9,8,1,0,4,2,6,1,1,UTA,CHA,UTA,134,,,23,15,14,17
Kelly Olynyk,F-C,22023,203482,22300628,"JAN 25, 2024",UTA @ WAS,W,21,8,11,0.727,3,4,0.75,0,0,0.0,2,2,4,2,0,0,1,3,19,13,1,UTA,WAS,UTA,123,,,25,23,21,6
Kelly Olynyk,F-C,22023,203482,22300616,"JAN 23, 2024",UTA @ NOP,L,14,4,5,0.8,0,1,0.0,1,2,0.5,0,3,3,2,0,0,1,3,9,-9,1,UTA,NOP,UTA,124,,,14,12,11,5
Kelly Olynyk,F-C,22023,203482,22300598,"JAN 20, 2024",UTA @ HOU,L,16,3,5,0.6,0,1,0.0,0,0,0.0,0,3,3,1,1,0,1,4,6,-8,1,UTA,HOU,UTA,126,,,10,9,7,4
Kelly Olynyk,F-C,22023,203482,22300581,"JAN 18, 2024",UTA vs. OKC,L,17,3,7,0.429,0,2,0.0,1,1,1.0,0,2,2,4,1,0,1,3,7,-5,1,UTA,UTA,OKC,129,,,13,9,11,6
Kelly Olynyk,F-C,22023,203482,22300564,"JAN 15, 2024",UTA vs. IND,W,17,1,3,0.333,0,0,0.0,2,2,1.0,1,5,6,4,0,1,3,4,4,-5,1,UTA,UTA,IND,132,,,14,10,8,10
Kelly Olynyk,F-C,22023,203482,22300549,"JAN 13, 2024",UTA vs. LAL,W,15,2,8,0.25,0,1,0.0,0,0,0.0,1,4,5,2,0,0,2,1,4,-10,1,UTA,UTA,LAL,132,,,11,9,6,7
Kelly Olynyk,F-C,22023,203482,22300540,"JAN 12, 2024",UTA vs. TOR,W,21,4,7,0.571,1,2,0.5,2,4,0.5,2,8,10,5,1,0,1,3,11,14,1,UTA,UTA,TOR,145,,,26,21,16,15
Kelly Olynyk,F-C,22023,203482,22300524,"JAN 10, 2024",UTA vs. DEN,W,19,4,5,0.8,1,1,1.0,0,0,0.0,0,3,3,5,2,1,1,2,9,0,1,UTA,UTA,DEN,124,,,17,12,14,8
Kelly Olynyk,F-C,22023,203482,22300510,"JAN 08, 2024",UTA @ MIL,W,17,4,6,0.667,2,2,1.0,3,4,0.75,2,4,6,3,0,0,2,4,13,9,1,UTA,MIL,UTA,132,,,22,19,16,9
Kelly Olynyk,F-C,22023,203482,22300495,"JAN 06, 2024",UTA @ PHI,W,15,2,3,0.667,1,1,1.0,0,0,0.0,0,1,1,4,0,0,3,3,5,5,1,UTA,PHI,UTA,120,,,10,6,9,5
Kelly Olynyk,F-C,22023,203482,22300479,"JAN 05, 2024",UTA @ BOS,L,14,0,2,0.0,0,1,0.0,6,8,0.75,0,1,1,1,1,0,0,3,6,-22,1,UTA,BOS,UTA,97,,,8,7,7,2
Kelly Olynyk,F-C,22023,203482,22300474,"JAN 03, 2024",UTA vs. DET,W,20,3,5,0.6,0,1,0.0,3,3,1.0,2,3,5,4,1,0,2,3,9,0,1,UTA,UTA,DET,154,,,18,14,13,9
Kelly Olynyk,F-C,22023,203482,22300457,"JAN 01, 2024",UTA vs. DAL,W,19,3,3,1.0,1,1,1.0,0,0,0.0,0,5,5,6,3,0,1,3,7,28,1,UTA,UTA,DAL,127,,,18,12,13,11
Kelly Olynyk,F-C,22023,203482,22300439,"DEC 30, 2023",UTA vs. MIA,W,28,8,12,0.667,0,1,0.0,3,3,1.0,3,3,6,10,1,1,3,5,19,11,1,UTA,UTA,MIA,117,,,35,25,29,16
Kelly Olynyk,F-C,22023,203482,22300424,"DEC 28, 2023",UTA @ NOP,L,19,3,5,0.6,0,1,0.0,0,0,0.0,2,1,3,3,1,0,2,0,6,-10,1,UTA,NOP,UTA,105,,,12,9,9,6
Kelly Olynyk,F-C,22023,203482,22300412,"DEC 26, 2023",UTA @ SAS,W,23,2,6,0.333,1,3,0.333,2,2,1.0,2,3,5,6,0,1,0,1,7,-4,1,UTA,SAS,UTA,130,,,18,12,13,11
Kelly Olynyk,F-C,22023,203482,22300395,"DEC 23, 2023",UTA @ TOR,W,17,3,5,0.6,1,3,0.333,0,0,0.0,0,4,4,7,0,1,0,4,7,-9,1,UTA,TOR,UTA,126,,,18,11,14,11
Kelly Olynyk,F-C,22023,203482,22300374,"DEC 21, 2023",UTA @ DET,W,35,10,16,0.625,3,6,0.5,4,4,1.0,0,3,3,6,4,0,4,2,27,-4,1,UTA,DET,UTA,119,,,36,30,33,9
Kelly Olynyk,F-C,22023,203482,22300364,"DEC 20, 2023",UTA @ CLE,L,20,2,3,0.667,0,1,0.0,1,2,0.5,1,1,2,6,1,2,3,0,5,-14,1,UTA,CLE,UTA,116,,,13,7,11,8
Kelly Olynyk,F-C,22023,203482,22300357,"DEC 18, 2023",UTA vs. BKN,W,20,1,2,0.5,0,1,0.0,0,0,0.0,1,4,5,3,1,0,0,4,2,2,1,UTA,UTA,BKN,125,,,10,7,5,8
Kelly Olynyk,F-C,22023,203482,22300342,"DEC 16, 2023",UTA @ SAC,L,29,4,7,0.571,1,2,0.5,0,0,0.0,0,5,5,13,1,1,1,3,9,-18,1,UTA,SAC,UTA,104,,,27,14,22,18
Kelly Olynyk,F-C,22023,203482,22300323,"DEC 14, 2023",UTA @ POR,W,24,1,6,0.167,0,3,0.0,0,0,0.0,1,9,10,7,0,0,0,1,2,27,1,UTA,POR,UTA,122,,,19,12,9,17
Kelly Olynyk,F-C,22023,203482,22300318,"DEC 13, 2023",UTA vs. NYK,W,30,3,9,0.333,1,2,0.5,2,2,1.0,1,9,10,8,0,0,3,3,9,-1,1,UTA,UTA,NYK,117,,,27,19,17,18
Kelly Olynyk,F-C,22023,203482,22300302,"DEC 11, 2023",UTA @ OKC,L,21,1,5,0.2,0,2,0.0,0,0,0.0,0,6,6,3,0,0,2,2,2,-19,1,UTA,OKC,UTA,120,,,11,8,5,9
Kelly Olynyk,F-C,22023,203482,22301225,"DEC 08, 2023",UTA vs. LAC,L,18,4,5,0.8,1,1,1.0,4,4,1.0,0,4,4,2,1,0,0,3,13,6,1,UTA,UTA,LAC,103,,,19,17,15,6
Kelly Olynyk,F-C,22023,203482,22300270,"NOV 30, 2023",UTA @ MIN,L,14,3,5,0.6,2,2,1.0,0,0,0.0,1,3,4,3,0,0,2,3,8,2,1,UTA,MIN,UTA,90,,,15,12,11,7
Kelly Olynyk,F-C,22023,203482,22300261,"NOV 29, 2023",UTA @ MEM,L,18,2,2,1.0,1,1,1.0,0,0,0.0,0,2,2,2,2,0,1,3,5,-13,1,UTA,MEM,UTA,91,,,9,7,7,4
Kelly Olynyk,F-C,22023,203482,22300256,"NOV 27, 2023",UTA vs. NOP,W,19,0,1,0.0,0,0,0.0,4,4,1.0,0,4,4,4,0,0,0,5,4,4,1,UTA,UTA,NOP,114,,,12,8,8,8
Kelly Olynyk,F-C,22023,203482,22300243,"NOV 25, 2023",UTA vs. NOP,W,24,4,6,0.667,3,3,1.0,2,2,1.0,1,5,6,3,1,1,3,0,13,11,1,UTA,UTA,NOP,105,,,22,19,16,9
Kelly Olynyk,F-C,22023,203482,22300237,"NOV 22, 2023",UTA @ POR,L,32,5,5,1.0,0,0,0.0,3,3,1.0,3,6,9,5,1,1,3,1,13,-8,1,UTA,POR,UTA,105,,,27,22,18,14
Kelly Olynyk,F-C,22023,203482,22300042,"NOV 21, 2023",UTA @ LAL,L,24,1,6,0.167,0,4,0.0,2,4,0.5,2,3,5,5,0,0,2,3,4,-17,1,UTA,LAL,UTA,99,,,14,9,9,10
Kelly Olynyk,F-C,22023,203482,22300214,"NOV 19, 2023",UTA vs. PHX,L,20,1,4,0.25,0,2,0.0,4,4,1.0,3,2,5,5,0,0,4,6,6,2,1,UTA,UTA,PHX,137,,,16,11,11,10
Kelly Olynyk,F-C,22023,203482,22300035,"NOV 17, 2023",UTA vs. PHX,L,20,3,4,0.75,1,2,0.5,0,0,0.0,1,3,4,7,0,0,1,2,7,-2,1,UTA,UTA,PHX,128,,,18,11,14,11
Kelly Olynyk,F-C,22023,203482,22300023,"NOV 14, 2023",UTA vs. POR,W,24,4,8,0.5,2,3,0.667,2,2,1.0,6,6,12,3,1,0,3,1,12,11,1,UTA,UTA,POR,115,,,27,24,15,15
Kelly Olynyk,F-C,22023,203482,22300012,"NOV 10, 2023",UTA @ MEM,W,21,2,3,0.667,0,0,0.0,2,2,1.0,2,6,8,2,1,1,2,3,6,5,1,UTA,MEM,UTA,127,,,16,14,8,10
Kelly Olynyk,F-C,22023,203482,22300158,"NOV 08, 2023",UTA @ IND,L,21,2,4,0.5,0,2,0.0,0,0,0.0,1,4,5,0,1,0,2,5,4,-19,1,UTA,IND,UTA,118,,,9,9,4,5
Kelly Olynyk,F-C,22023,203482,22300152,"NOV 06, 2023",UTA @ CHI,L,23,5,7,0.714,2,3,0.667,1,1,1.0,0,7,7,8,0,0,1,1,13,-8,1,UTA,CHI,UTA,113,,,28,20,21,15
Kelly Olynyk,F-C,22023,203482,22300138,"NOV 04, 2023",UTA @ MIN,L,18,0,4,0.0,0,2,0.0,0,0,0.0,2,2,4,1,0,0,2,4,0,-11,1,UTA,MIN,UTA,95,,,5,4,1,5
Kelly Olynyk,F-C,22023,203482,22300130,"NOV 02, 2023",UTA vs. ORL,L,19,2,4,0.5,0,1,0.0,0,0,0.0,1,1,2,3,3,0,2,5,4,-3,1,UTA,UTA,ORL,113,,,9,6,7,5
Kelly Olynyk,F-C,22023,203482,22300125,"NOV 01, 2023",UTA vs. MEM,W,26,5,7,0.714,3,4,0.75,1,2,0.5,3,5,8,5,1,0,3,1,14,38,1,UTA,UTA,MEM,133,,,27,22,19,13
Kelly Olynyk,F-C,22023,203482,22300110,"OCT 30, 2023",UTA @ DEN,L,18,0,2,0.0,0,2,0.0,3,4,0.75,2,2,4,5,3,0,1,4,3,-8,1,UTA,DEN,UTA,102,,,12,7,8,9
Kelly Olynyk,F-C,22023,203482,22300094,"OCT 28, 2023",UTA @ PHX,L,16,4,5,0.8,0,1,0.0,1,1,1.0,2,4,6,3,0,0,1,2,9,-5,1,UTA,PHX,UTA,104,,,18,15,12,9
Kelly Olynyk,F-C,22023,203482,22300085,"OCT 27, 2023",UTA vs. LAC,W,27,5,6,0.833,2,2,1.0,3,3,1.0,3,1,4,3,1,1,3,3,15,-4,1,UTA,UTA,LAC,120,,,22,19,18,7
Kelly Olynyk,F-C,22023,203482,22300072,"OCT 25, 2023",UTA vs. SAC,L,17,2,3,0.667,0,0,0.0,1,1,1.0,3,3,6,4,1,0,1,3,5,-5,1,UTA,UTA,SAC,114,,,15,11,9,10
Kelly Olynyk,F-C,22023,203482,22300724,"FEB 06, 2024",UTA vs. OKC,W,16,4,6,0.667,0,0,0.0,2,2,1.0,2,2,4,7,0,0,0,2,10,-2,1,UTA,UTA,OKC,124,,,21,14,17,11
T.J. McConnell,G,22023,204456,22300550,"JAN 14, 2024",IND @ DEN,L,19,2,9,0.222,0,2,0.0,1,2,0.5,1,1,2,5,0,0,1,0,5,8,1,IND,DEN,IND,109,,,12,7,10,7
T.J. McConnell,G,22023,204456,22300533,"JAN 12, 2024",IND @ ATL,W,25,3,5,0.6,0,0,0.0,0,0,0.0,0,4,4,14,3,1,5,0,6,14,1,IND,ATL,IND,126,,,24,10,20,18
T.J. McConnell,G,22023,204456,22300520,"JAN 10, 2024",IND vs. WAS,W,22,7,10,0.7,0,0,0.0,0,0,0.0,0,2,2,8,2,0,0,2,14,7,1,IND,IND,WAS,112,,,24,16,22,10
T.J. McConnell,G,22023,204456,22300507,"JAN 08, 2024",IND vs. BOS,W,25,6,12,0.5,0,2,0.0,0,0,0.0,1,3,4,7,2,0,2,1,12,10,1,IND,IND,BOS,133,,,23,16,19,11
T.J. McConnell,G,22023,204456,22300480,"JAN 05, 2024",IND vs. ATL,W,23,5,6,0.833,0,0,0.0,0,0,0.0,2,1,3,10,3,0,1,2,10,10,1,IND,IND,ATL,148,,,23,13,20,13
T.J. McConnell,G,22023,204456,22300466,"JAN 03, 2024",IND vs. MIL,W,19,2,6,0.333,0,1,0.0,2,2,1.0,0,6,6,3,0,0,1,1,6,3,1,IND,IND,MIL,142,,,15,12,9,9
T.J. McConnell,G,22023,204456,22300377,"DEC 21, 2023",IND @ MEM,L,4,1,1,1.0,0,0,0.0,0,0,0.0,0,1,1,1,0,0,1,0,2,-5,1,IND,MEM,IND,103,,,4,3,3,2
T.J. McConnell,G,22023,204456,22300365,"DEC 20, 2023",IND vs. CHA,W,20,3,3,1.0,0,0,0.0,3,4,0.75,1,4,5,9,1,0,1,1,9,-1,1,IND,IND,CHA,142,,,23,14,18,14
T.J. McConnell,G,22023,204456,22300350,"DEC 18, 2023",IND vs. LAC,L,20,5,10,0.5,0,0,0.0,0,0,0.0,1,4,5,8,1,0,0,2,10,16,1,IND,IND,LAC,127,,,23,15,18,13
T.J. McConnell,G,22023,204456,22300338,"DEC 16, 2023",IND @ MIN,L,26,5,12,0.417,0,1,0.0,0,0,0.0,1,3,4,6,2,1,1,1,10,-17,1,IND,MIN,IND,109,,,20,14,16,10
T.J. McConnell,G,22023,204456,22300328,"DEC 15, 2023",IND @ WAS,L,20,4,10,0.4,0,0,0.0,1,1,1.0,0,3,3,9,1,0,2,0,9,-1,1,IND,WAS,IND,123,,,21,12,18,12
T.J. McConnell,G,22023,204456,22300315,"DEC 13, 2023",IND @ MIL,L,16,4,9,0.444,0,2,0.0,1,1,1.0,1,4,5,5,2,0,3,1,9,-12,1,IND,MIL,IND,126,,,19,14,14,10
T.J. McConnell,G,22023,204456,22300293,"DEC 11, 2023",IND @ DET,W,15,4,10,0.4,0,1,0.0,0,0,0.0,0,2,2,5,1,0,2,2,8,0,1,IND,DET,IND,131,,,15,10,13,7
T.J. McConnell,G,22023,204456,22301229,"DEC 07, 2023",IND @ MIL,W,11,4,7,0.571,0,0,0.0,1,2,0.5,1,0,1,4,3,0,3,0,9,9,1,IND,MIL,IND,128,,,14,10,13,5
T.J. McConnell,G,22023,204456,22301202,"DEC 04, 2023",IND vs. BOS,W,9,1,5,0.2,0,0,0.0,0,0,0.0,0,2,2,3,1,0,0,0,2,-5,1,IND,IND,BOS,122,,,7,4,5,5
T.J. McConnell,G,22023,204456,22300284,"DEC 02, 2023",IND @ MIA,W,25,10,11,0.909,0,0,0.0,0,0,0.0,0,2,2,11,0,0,1,0,20,5,1,IND,MIA,IND,144,,,33,22,31,13
T.J. McConnell,G,22023,204456,22300254,"NOV 27, 2023",IND vs. POR,L,10,0,2,0.0,0,1,0.0,0,2,0.0,2,2,4,4,1,1,3,0,0,4,1,IND,IND,POR,110,,,8,4,4,8
T.J. McConnell,G,22023,204456,22300230,"NOV 22, 2023",IND vs. TOR,L,14,3,6,0.5,1,1,1.0,0,0,0.0,0,2,2,5,1,0,0,5,7,-4,1,IND,IND,TOR,131,,,14,9,12,7
T.J. McConnell,G,22023,204456,22300039,"NOV 21, 2023",IND @ ATL,W,14,1,5,0.2,0,0,0.0,0,0,0.0,0,0,0,4,0,0,0,1,2,-4,1,IND,ATL,IND,157,,,6,2,6,4
T.J. McConnell,G,22023,204456,22300209,"NOV 19, 2023",IND vs. ORL,L,21,5,9,0.556,0,1,0.0,1,3,0.333,1,3,4,5,0,0,2,1,11,2,1,IND,IND,ORL,116,,,20,15,16,9
T.J. McConnell,G,22023,204456,22300019,"NOV 14, 2023",IND @ PHI,W,13,5,8,0.625,0,2,0.0,1,1,1.0,1,2,3,3,0,0,1,3,11,-7,1,IND,PHI,IND,132,,,17,14,14,6
T.J. McConnell,G,22023,204456,22300180,"NOV 12, 2023",IND @ PHI,L,17,3,5,0.6,0,0,0.0,2,2,1.0,0,2,2,1,3,1,1,1,8,10,1,IND,PHI,IND,126,,,11,10,9,3
T.J. McConnell,G,22023,204456,22300146,"NOV 06, 2023",IND vs. SAS,W,9,1,2,0.5,0,0,0.0,2,2,1.0,0,3,3,4,0,0,1,1,4,6,1,IND,IND,SAS,152,,,11,7,8,7
T.J. McConnell,G,22023,204456,22300133,"NOV 04, 2023",IND vs. CHA,L,5,0,2,0.0,0,0,0.0,0,0,0.0,0,0,0,0,0,0,1,1,0,-9,1,IND,IND,CHA,124,,,0,0,0,0
T.J. McConnell,G,22023,204456,22300118,"NOV 01, 2023",IND @ BOS,L,28,8,13,0.615,0,1,0.0,2,2,1.0,2,5,7,5,1,0,1,2,18,-29,1,IND,BOS,IND,104,,,30,25,23,12
T.J. McConnell,G,22023,204456,22300091,"OCT 28, 2023",IND @ CLE,W,19,3,5,0.6,0,0,0.0,2,2,1.0,1,1,2,8,0,0,0,1,8,21,1,IND,CLE,IND,125,,,18,10,16,10
T.J. McConnell,G,22023,204456,22300064,"OCT 25, 2023",IND vs. WAS,W,6,2,2,1.0,0,0,0.0,0,0,0.0,0,1,1,2,2,0,0,0,4,1,1,IND,IND,WAS,143,,,7,5,6,3
T.J. McConnell,G,22023,204456,22300707,"FEB 04, 2024",IND @ CHA,W,21,2,5,0.4,0,0,0.0,0,0,0.0,1,5,6,7,0,0,4,2,4,0,1,IND,CHA,IND,115,,,17,10,11,13
T.J. McConnell,G,22023,204456,22300627,"JAN 25, 2024",IND vs. PHI,W,24,4,6,0.667,0,0,0.0,0,0,0.0,1,3,4,5,2,0,3,4,8,-4,1,IND,IND,PHI,134,,,17,12,13,9
T.J. McConnell,G,22023,204456,22300564,"JAN 15, 2024",IND @ UTA,L,19,3,6,0.5,0,0,0.0,2,2,1.0,1,4,5,5,1,0,3,1,8,3,1,IND,UTA,IND,105,,,18,13,13,10
T.J. McConnell,G,22023,204456,22300493,"JAN 06, 2024",IND vs. BOS,L,12,3,3,1.0,0,0,0.0,0,0,0.0,0,1,1,5,2,0,3,0,6,-3,1,IND,IND,BOS,101,,,12,7,11,6
T.J. McConnell,G,22023,204456,22300755,"FEB 10, 2024",IND @ NYK,W,18,8,10,0.8,0,0,0.0,0,0,0.0,0,4,4,6,1,0,1,1,16,6,1,IND,NYK,IND,125,,,26,20,22,10
T.J. McConnell,G,22023,204456,22300733,"FEB 08, 2024",IND vs. GSW,L,22,3,7,0.429,0,0,0.0,0,0,0.0,0,0,0,8,1,0,1,1,6,-13,1,IND,IND,GSW,109,,,14,6,14,8
T.J. McConnell,G,22023,204456,22300719,"FEB 06, 2024",IND vs. HOU,W,19,8,11,0.727,0,1,0.0,1,1,1.0,1,2,3,4,1,0,1,1,17,2,1,IND,IND,HOU,132,,,24,20,21,7
T.J. McConnell,G,22023,204456,22300691,"FEB 02, 2024",IND vs. SAC,L,23,3,5,0.6,1,1,1.0,2,2,1.0,1,2,3,7,2,0,1,0,9,1,1,IND,IND,SAC,122,,,19,12,16,10
T.J. McConnell,G,22023,204456,22300590,"JAN 19, 2024",IND @ POR,L,13,1,4,0.25,0,0,0.0,0,0,0.0,0,0,0,2,0,0,2,1,2,-19,1,IND,POR,IND,115,,,4,2,4,2
T.J. McConnell,G,22023,204456,22300454,"JAN 01, 2024",IND @ MIL,W,22,5,9,0.556,0,1,0.0,6,8,0.75,1,3,4,9,1,0,0,0,16,31,1,IND,MIL,IND,122,,,29,20,25,13
T.J. McConnell,G,22023,204456,22300441,"DEC 30, 2023",IND vs. NYK,W,12,2,3,0.667,0,0,0.0,1,1,1.0,0,0,0,3,0,0,2,0,5,-5,1,IND,IND,NYK,140,,,8,5,8,3
T.J. McConnell,G,22023,204456,22300391,"DEC 23, 2023",IND vs. ORL,L,7,0,1,0.0,0,0,0.0,1,2,0.5,0,0,0,2,0,0,1,0,1,-17,1,IND,IND,ORL,110,,,3,1,3,2
T.J. McConnell,G,22023,204456,22300636,"JAN 26, 2024",IND vs. PHX,W,18,1,5,0.2,0,0,0.0,0,0,0.0,0,1,1,8,1,0,0,1,2,-5,1,IND,IND,PHX,133,,,11,3,10,9
T.J. McConnell,G,22023,204456,22300614,"JAN 23, 2024",IND vs. DEN,L,21,7,11,0.636,1,1,1.0,2,2,1.0,0,1,1,7,0,0,3,3,17,10,1,IND,IND,DEN,109,,,25,18,24,8
T.J. McConnell,G,22023,204456,22300604,"JAN 21, 2024",IND @ PHX,L,12,2,8,0.25,0,0,0.0,0,0,0.0,0,1,1,3,2,0,1,0,4,-9,1,IND,PHX,IND,110,,,8,5,7,4
T.J. McConnell,G,22023,204456,22300583,"JAN 18, 2024",IND @ SAC,W,33,9,14,0.643,0,0,0.0,2,3,0.667,0,1,1,10,1,0,4,2,20,-15,1,IND,SAC,IND,126,,,31,21,30,11
Jaden Hardy,G,22023,1630702,22300487,"JAN 05, 2024",DAL vs. POR,W,32,8,14,0.571,3,7,0.429,0,0,0.0,2,7,9,9,1,0,4,2,19,11,1,DAL,DAL,POR,132,,,37,28,28,18
Jaden Hardy,G,22023,1630702,22300398,"DEC 23, 2023",DAL vs. SAS,W,22,1,7,0.143,1,4,0.25,3,4,0.75,0,6,6,1,3,0,0,1,6,15,1,DAL,DAL,SAS,144,,,13,12,7,7
Jaden Hardy,G,22023,1630702,22300385,"DEC 22, 2023",DAL @ HOU,L,24,3,17,0.176,2,12,0.167,0,0,0.0,0,2,2,4,0,0,0,5,8,-33,1,DAL,HOU,DAL,96,,,14,10,12,6
Jaden Hardy,G,22023,1630702,22300356,"DEC 18, 2023",DAL @ DEN,L,19,3,9,0.333,2,3,0.667,1,2,0.5,0,1,1,4,0,0,1,1,9,-13,1,DAL,DEN,DAL,104,,,14,10,13,5
Jaden Hardy,G,22023,1630702,22300341,"DEC 16, 2023",DAL @ POR,W,6,2,2,1.0,0,0,0.0,0,0,0.0,0,3,3,0,0,0,0,1,4,5,1,DAL,POR,DAL,131,,,7,7,4,3
Jaden Hardy,G,22023,1630702,22300321,"DEC 14, 2023",DAL vs. MIN,L,13,2,4,0.5,1,2,0.5,0,0,0.0,0,2,2,1,0,0,0,0,5,-1,1,DAL,DAL,MIN,101,,,8,7,6,3
Jaden Hardy,G,22023,1630702,22300680,"JAN 31, 2024",DAL @ MIN,L,31,6,14,0.429,1,5,0.2,2,2,1.0,0,2,2,2,1,0,5,2,15,-23,1,DAL,MIN,DAL,82,,,19,17,17,4
Jaden Hardy,G,22023,1630702,22300666,"JAN 29, 2024",DAL vs. ORL,W,27,8,9,0.889,4,5,0.8,0,0,0.0,0,1,1,7,1,1,1,2,20,7,1,DAL,DAL,ORL,131,,,28,21,27,8
Jaden Hardy,G,22023,1630702,22300651,"JAN 27, 2024",DAL vs. SAC,L,19,1,7,0.143,1,5,0.2,0,0,0.0,2,3,5,7,0,0,1,2,3,-3,1,DAL,DAL,SAC,115,,,15,8,10,12
Jaden Hardy,G,22023,1630702,22300577,"JAN 17, 2024",DAL @ LAL,L,20,3,7,0.429,1,5,0.2,0,0,0.0,0,0,0,0,0,0,1,0,7,-7,1,DAL,LAL,DAL,105,,,7,7,7,0
Jaden Hardy,G,22023,1630702,22300556,"JAN 15, 2024",DAL vs. NOP,W,15,2,7,0.286,1,5,0.2,0,0,0.0,1,3,4,1,0,0,0,2,5,0,1,DAL,DAL,NOP,125,,,10,9,6,5
Jaden Hardy,G,22023,1630702,22300547,"JAN 13, 2024",DAL vs. NOP,L,23,3,8,0.375,2,4,0.5,0,0,0.0,0,2,2,1,0,0,2,1,8,-13,1,DAL,DAL,NOP,108,,,11,10,9,3
Jaden Hardy,G,22023,1630702,22300530,"JAN 11, 2024",DAL vs. NYK,W,23,2,8,0.25,0,2,0.0,4,5,0.8,0,6,6,4,0,0,0,2,8,14,1,DAL,DAL,NYK,128,,,18,14,12,10
Jaden Hardy,G,22023,1630702,22300515,"JAN 09, 2024",DAL vs. MEM,L,19,4,7,0.571,2,4,0.5,0,0,0.0,0,0,0,1,0,0,1,2,10,-11,1,DAL,DAL,MEM,103,,,11,10,11,1
Jaden Hardy,G,22023,1630702,22300501,"JAN 07, 2024",DAL vs. MIN,W,4,0,1,0.0,0,0,0.0,0,0,0.0,0,0,0,0,0,0,0,0,0,3,1,DAL,DAL,MIN,115,,,0,0,0,0
Jaden Hardy,G,22023,1630702,22300472,"JAN 03, 2024",DAL vs. POR,W,11,4,10,0.4,1,6,0.167,2,3,0.667,0,1,1,1,0,1,0,0,11,2,1,DAL,DAL,POR,126,,,13,12,12,2
Jaden Hardy,G,22023,1630702,22300423,"DEC 28, 2023",DAL @ MIN,L,31,7,18,0.389,3,8,0.375,0,0,0.0,0,2,2,1,1,1,0,2,17,0,1,DAL,MIN,DAL,110,,,20,19,18,3
Jaden Hardy,G,22023,1630702,22300405,"DEC 25, 2023",DAL @ PHX,W,13,1,4,0.25,1,3,0.333,0,0,0.0,0,2,2,1,0,0,0,0,3,4,1,DAL,PHX,DAL,128,,,6,5,4,3
Jaden Hardy,G,22023,1630702,22300306,"DEC 12, 2023",DAL vs. LAL,W,19,1,7,0.143,0,3,0.0,0,0,0.0,0,1,1,1,0,0,1,2,2,0,1,DAL,DAL,LAL,127,,,4,3,3,2
Jaden Hardy,G,22023,1630702,22300299,"DEC 11, 2023",DAL @ MEM,W,34,7,15,0.467,5,7,0.714,0,0,0.0,0,0,0,4,1,0,2,1,19,6,1,DAL,MEM,DAL,120,,,23,19,23,4
Jaden Hardy,G,22023,1630702,22301213,"DEC 06, 2023",DAL vs. UTA,W,8,3,7,0.429,2,4,0.5,0,0,0.0,2,1,3,4,0,0,1,1,8,10,1,DAL,DAL,UTA,147,,,15,11,12,7
Jaden Hardy,G,22023,1630702,22300287,"DEC 02, 2023",DAL vs. OKC,L,15,2,6,0.333,1,4,0.25,1,2,0.5,0,2,2,0,0,0,2,5,6,-17,1,DAL,DAL,OKC,120,,,8,8,6,2
Jaden Hardy,G,22023,1630702,22300277,"DEC 01, 2023",DAL vs. MEM,L,21,4,9,0.444,0,4,0.0,0,2,0.0,2,3,5,5,1,0,2,1,8,-10,1,DAL,DAL,MEM,94,,,18,13,13,10
Jaden Hardy,G,22023,1630702,22300059,"NOV 28, 2023",DAL vs. HOU,W,4,0,1,0.0,0,0,0.0,0,0,0.0,0,0,0,0,0,0,0,0,0,-2,1,DAL,DAL,HOU,121,,,0,0,0,0
Jaden Hardy,G,22023,1630702,22300244,"NOV 25, 2023",DAL @ LAC,L,8,1,3,0.333,0,1,0.0,2,2,1.0,2,2,4,1,0,0,1,0,4,1,1,DAL,LAC,DAL,88,,,9,8,5,5
Jaden Hardy,G,22023,1630702,22300238,"NOV 22, 2023",DAL @ LAL,W,7,1,5,0.2,0,1,0.0,0,0,0.0,0,0,0,0,0,0,0,0,2,-2,1,DAL,LAL,DAL,104,,,2,2,2,0
Jaden Hardy,G,22023,1630702,22300192,"NOV 15, 2023",DAL @ WAS,W,4,1,2,0.5,0,0,0.0,0,1,0.0,0,0,0,0,1,0,1,0,2,-3,1,DAL,WAS,DAL,130,,,2,2,2,0
Jaden Hardy,G,22023,1630702,22300022,"NOV 14, 2023",DAL @ NOP,L,18,4,12,0.333,0,3,0.0,1,1,1.0,0,2,2,3,1,0,1,3,9,-2,1,DAL,NOP,DAL,110,,,14,11,12,5
Jaden Hardy,G,22023,1630702,22300183,"NOV 12, 2023",DAL @ NOP,W,7,3,6,0.5,1,4,0.25,0,0,0.0,1,1,2,2,0,0,0,1,7,-3,1,DAL,NOP,DAL,136,,,11,9,9,4
Jaden Hardy,G,22023,1630702,22300014,"NOV 10, 2023",DAL vs. LAC,W,12,5,8,0.625,1,2,0.5,0,1,0.0,0,2,2,0,0,0,2,1,11,-8,1,DAL,DAL,LAC,144,,,13,13,11,2
Jaden Hardy,G,22023,1630702,22300006,"NOV 03, 2023",DAL @ DEN,L,14,2,6,0.333,2,4,0.5,0,0,0.0,1,2,3,3,0,0,0,2,6,8,1,DAL,DEN,DAL,114,,,12,9,9,6
Jaden Hardy,G,22023,1630702,22300124,"NOV 01, 2023",DAL vs. CHI,W,14,3,7,0.429,1,2,0.5,2,2,1.0,0,1,1,1,0,0,0,0,9,6,1,DAL,DAL,CHI,114,,,11,10,10,2
Jaden Hardy,G,22023,1630702,22300106,"OCT 30, 2023",DAL @ MEM,W,10,2,6,0.333,2,4,0.5,0,0,0.0,0,0,0,1,0,0,1,1,6,-7,1,DAL,MEM,DAL,125,,,7,6,7,1
Jaden Hardy,G,22023,1630702,22300748,"FEB 10, 2024",DAL vs. OKC,W,10,4,5,0.8,2,3,0.667,1,2,0.5,0,0,0,3,1,0,0,1,11,-5,1,DAL,DAL,OKC,146,,,14,11,14,3
Jaden Hardy,G,22023,1630702,22300736,"FEB 08, 2024",DAL @ NYK,W,14,2,5,0.4,0,1,0.0,0,0,0.0,0,2,2,1,1,0,1,0,4,2,1,DAL,NYK,DAL,121,,,7,6,5,3
Jaden Hardy,G,22023,1630702,22300720,"FEB 06, 2024",DAL @ BKN,W,8,2,2,1.0,2,2,1.0,0,0,0.0,1,1,2,1,0,0,1,0,6,13,1,DAL,BKN,DAL,119,,,9,8,7,3
Jaden Hardy,G,22023,1630702,22300715,"FEB 05, 2024",DAL @ PHI,W,15,6,10,0.6,3,6,0.5,2,2,1.0,0,1,1,0,0,0,1,0,17,3,1,DAL,PHI,DAL,118,,,18,18,17,1
Jaden Hardy,G,22023,1630702,22300702,"FEB 03, 2024",DAL vs. MIL,L,11,1,4,0.25,0,2,0.0,2,2,1.0,0,2,2,0,0,0,0,2,4,-4,1,DAL,DAL,MIL,117,,,6,6,4,2
Jaden Hardy,G,22023,1630702,22300634,"JAN 26, 2024",DAL @ ATL,W,14,2,6,0.333,1,3,0.333,3,4,0.75,1,0,1,1,1,0,0,1,8,-10,1,DAL,ATL,DAL,148,,,10,9,9,2
Jaden Hardy,G,22023,1630702,22300625,"JAN 24, 2024",DAL vs. PHX,L,15,4,9,0.444,3,4,0.75,0,0,0.0,0,3,3,2,0,0,0,1,11,3,1,DAL,DAL,PHX,107,,,16,14,13,5
Jaden Hardy,G,22023,1630702,22300611,"JAN 22, 2024",DAL vs. BOS,L,2,0,1,0.0,0,1,0.0,0,0,0.0,0,0,0,0,0,0,0,0,0,-3,1,DAL,DAL,BOS,110,,,0,0,0,0
Jaden Hardy,G,22023,1630702,22300457,"JAN 01, 2024",DAL @ UTA,L,21,6,15,0.4,5,9,0.556,0,0,0.0,0,3,3,1,0,0,2,0,17,-22,1,DAL,UTA,DAL,86,,,21,20,18,4
Jaden Hardy,G,22023,1630702,22300444,"DEC 30, 2023",DAL @ GSW,W,24,4,8,0.5,1,5,0.2,0,0,0.0,0,2,2,0,0,0,1,2,9,7,1,DAL,GSW,DAL,132,,,11,11,9,2
Jaden Hardy,G,22023,1630702,22300372,"DEC 20, 2023",DAL vs. LAC,L,23,5,13,0.385,5,9,0.556,0,0,0.0,0,2,2,1,1,0,0,3,15,1,1,DAL,DAL,LAC,111,,,18,17,16,3
Jaden Hardy,G,22023,1630702,22300212,"NOV 19, 2023",DAL vs. SAC,L,10,1,4,0.25,1,2,0.5,1,2,0.5,0,0,0,0,1,0,1,2,4,0,1,DAL,DAL,SAC,113,,,4,4,4,0
Jaden Hardy,G,22023,1630702,22300168,"NOV 08, 2023",DAL vs. TOR,L,12,2,4,0.5,1,3,0.333,1,2,0.5,0,1,1,2,0,0,0,0,6,-5,1,DAL,DAL,TOR,116,,,9,7,8,3
Jaden Hardy,G,22023,1630702,22300147,"NOV 06, 2023",DAL @ ORL,W,11,1,5,0.2,0,3,0.0,3,4,0.75,0,1,1,1,1,0,1,0,5,2,1,DAL,ORL,DAL,117,,,7,6,6,2
Jaden Hardy,G,22023,1630702,22300143,"NOV 05, 2023",DAL vs. CHA,W,15,3,7,0.429,1,4,0.25,7,8,0.875,0,4,4,0,0,0,0,1,14,9,1,DAL,DAL,CHA,124,,,18,18,14,4
Andre Drummond,C,22023,203083,22300139,"NOV 04, 2023",CHI @ DEN,L,15,2,3,0.667,0,0,0.0,1,2,0.5,4,7,11,0,1,0,0,1,5,7,1,CHI,DEN,CHI,101,,,16,16,5,11
Andre Drummond,C,22023,203083,22300737,"FEB 08, 2024",CHI @ MEM,W,31,10,11,0.909,0,0,0.0,1,3,0.333,3,10,13,1,1,1,1,1,21,7,1,CHI,MEM,CHI,118,,,35,34,22,14
Andre Drummond,C,22023,203083,22300723,"FEB 06, 2024",CHI vs. MIN,W,35,7,13,0.538,0,0,0.0,2,4,0.5,6,10,16,0,0,4,1,4,16,4,1,CHI,CHI,MIN,129,,,32,32,16,16
Andre Drummond,C,22023,203083,22300700,"FEB 03, 2024",CHI vs. SAC,L,14,1,4,0.25,0,0,0.0,0,0,0.0,4,4,8,0,0,0,0,0,2,-5,1,CHI,CHI,SAC,115,,,10,10,2,8
Andre Drummond,C,22023,203083,22300674,"JAN 31, 2024",CHI @ CHA,W,15,5,8,0.625,0,0,0.0,0,1,0.0,3,5,8,1,0,0,0,2,10,4,1,CHI,CHA,CHI,117,,,19,18,11,9
Andre Drummond,C,22023,203083,22300672,"JAN 30, 2024",CHI vs. TOR,L,14,3,4,0.75,0,0,0.0,1,2,0.5,3,4,7,0,1,1,0,0,7,4,1,CHI,CHI,TOR,107,,,14,14,7,7
Andre Drummond,C,22023,203083,22300656,"JAN 28, 2024",CHI @ POR,W,17,6,11,0.545,0,0,0.0,3,3,1.0,4,3,7,0,1,1,0,3,15,3,1,CHI,POR,CHI,104,,,22,22,15,7
Andre Drummond,C,22023,203083,22300633,"JAN 25, 2024",CHI @ LAL,L,17,5,7,0.714,0,0,0.0,1,2,0.5,5,4,9,1,1,0,1,0,11,0,1,CHI,LAL,CHI,132,,,21,20,12,10
Andre Drummond,C,22023,203083,22300612,"JAN 22, 2024",CHI @ PHX,L,11,2,4,0.5,0,0,0.0,2,4,0.5,3,2,5,0,0,0,1,0,6,-12,1,CHI,PHX,CHI,113,,,11,11,6,5
Andre Drummond,C,22023,203083,22300597,"JAN 20, 2024",CHI vs. MEM,W,19,7,11,0.636,0,0,0.0,1,2,0.5,5,5,10,1,4,0,0,2,15,18,1,CHI,CHI,MEM,125,,,26,25,16,11
Andre Drummond,C,22023,203083,22300580,"JAN 18, 2024",CHI @ TOR,W,10,1,1,1.0,0,0,0.0,3,4,0.75,0,4,4,0,0,1,1,1,5,-12,1,CHI,TOR,CHI,116,,,9,9,5,4
Andre Drummond,C,22023,203083,22300561,"JAN 15, 2024",CHI @ CLE,L,22,3,3,1.0,0,0,0.0,2,4,0.5,3,7,10,1,2,2,2,2,8,4,1,CHI,CLE,CHI,91,,,19,18,9,11
Andre Drummond,C,22023,203083,22300548,"JAN 13, 2024",CHI @ SAS,W,17,3,7,0.429,0,0,0.0,1,3,0.333,4,6,10,1,1,1,0,2,7,-7,1,CHI,SAS,CHI,122,,,18,17,8,11
Andre Drummond,C,22023,203083,22300506,"JAN 08, 2024",CHI @ CHA,W,23,9,12,0.75,0,0,0.0,3,3,1.0,5,10,15,0,0,0,2,1,21,16,1,CHI,CHA,CHI,119,,,36,36,21,15
Andre Drummond,C,22023,203083,22300484,"JAN 05, 2024",CHI vs. CHA,W,23,3,7,0.429,0,0,0.0,1,2,0.5,3,7,10,0,1,3,2,1,7,8,1,CHI,CHI,CHA,104,,,17,17,7,10
Andre Drummond,C,22023,203083,22300468,"JAN 03, 2024",CHI @ NYK,L,30,5,12,0.417,0,0,0.0,3,6,0.5,8,8,16,0,2,1,1,3,13,-15,1,CHI,NYK,CHI,100,,,29,29,13,16
Andre Drummond,C,22023,203083,22300459,"JAN 02, 2024",CHI @ PHI,L,28,5,13,0.385,0,1,0.0,1,4,0.25,10,7,17,0,1,1,2,2,11,-31,1,CHI,PHI,CHI,97,,,28,28,11,17
Andre Drummond,C,22023,203083,22300442,"DEC 30, 2023",CHI vs. PHI,W,30,6,8,0.75,0,0,0.0,3,10,0.3,3,20,23,2,2,3,3,4,15,16,1,CHI,CHI,PHI,105,,,40,38,17,25
Andre Drummond,C,22023,203083,22300422,"DEC 28, 2023",CHI vs. IND,L,21,3,9,0.333,0,0,0.0,1,4,0.25,7,9,16,0,1,0,1,4,7,-8,1,CHI,CHI,IND,104,,,23,23,7,16
Andre Drummond,C,22023,203083,22300408,"DEC 26, 2023",CHI vs. ATL,W,38,11,13,0.846,0,0,0.0,2,2,1.0,10,15,25,1,3,2,2,4,24,4,1,CHI,CHI,ATL,118,,,50,49,25,26
Andre Drummond,C,22023,203083,22300396,"DEC 23, 2023",CHI vs. CLE,L,13,0,0,0.0,0,0,0.0,1,2,0.5,2,4,6,0,1,0,1,4,1,-10,1,CHI,CHI,CLE,95,,,7,7,1,6
Andre Drummond,C,22023,203083,22300376,"DEC 21, 2023",CHI vs. SAS,W,19,5,10,0.5,0,0,0.0,2,3,0.667,4,4,8,1,5,2,1,0,12,17,1,CHI,CHI,SAS,114,,,21,20,13,9
Andre Drummond,C,22023,203083,22300370,"DEC 20, 2023",CHI vs. LAL,W,16,4,5,0.8,0,0,0.0,3,4,0.75,0,7,7,1,1,0,2,2,11,12,1,CHI,CHI,LAL,124,,,19,18,12,8
Andre Drummond,C,22023,203083,22300351,"DEC 18, 2023",CHI @ PHI,W,14,2,3,0.667,0,0,0.0,1,2,0.5,3,5,8,0,1,1,0,0,5,8,1,CHI,PHI,CHI,108,,,13,13,5,8
Andre Drummond,C,22023,203083,22300337,"DEC 16, 2023",CHI @ MIA,L,11,1,2,0.5,0,0,0.0,2,2,1.0,0,4,4,0,1,0,1,1,4,-3,1,CHI,MIA,CHI,116,,,8,8,4,4
Andre Drummond,C,22023,203083,22300320,"DEC 14, 2023",CHI @ MIA,W,12,3,4,0.75,0,0,0.0,1,2,0.5,1,4,5,0,0,0,0,3,7,-4,1,CHI,MIA,CHI,124,,,12,12,7,5
Andre Drummond,C,22023,203083,22300307,"DEC 12, 2023",CHI vs. DEN,L,14,3,4,0.75,0,0,0.0,2,3,0.667,1,3,4,0,2,2,1,1,8,-5,1,CHI,CHI,DEN,106,,,12,12,8,4
Andre Drummond,C,22023,203083,22300300,"DEC 11, 2023",CHI @ MIL,L,14,3,12,0.25,0,0,0.0,3,3,1.0,11,5,16,1,1,0,0,1,9,-2,1,CHI,MIL,CHI,129,,,26,25,10,17
Andre Drummond,C,22023,203083,22301223,"DEC 08, 2023",CHI @ SAS,W,12,3,7,0.429,0,0,0.0,1,4,0.25,6,2,8,0,0,0,0,2,7,-6,1,CHI,SAS,CHI,121,,,15,15,7,8
Andre Drummond,C,22023,203083,22301211,"DEC 06, 2023",CHI vs. CHA,W,14,3,8,0.375,0,0,0.0,1,2,0.5,5,4,9,1,1,0,3,3,7,10,1,CHI,CHI,CHA,111,,,17,16,8,10
Andre Drummond,C,22023,203083,22300285,"DEC 02, 2023",CHI vs. NOP,W,15,3,7,0.429,0,0,0.0,1,2,0.5,3,5,8,1,0,1,1,2,7,0,1,CHI,CHI,NOP,124,,,16,15,8,9
Andre Drummond,C,22023,203083,22300269,"NOV 30, 2023",CHI vs. MIL,W,13,2,2,1.0,0,0,0.0,6,8,0.75,5,9,14,1,1,0,2,1,10,13,1,CHI,CHI,MIL,120,,,25,24,11,15
Andre Drummond,C,22023,203083,22300053,"NOV 28, 2023",CHI @ BOS,L,13,2,5,0.4,0,0,0.0,1,6,0.167,2,4,6,0,0,1,0,1,5,-11,1,CHI,BOS,CHI,97,,,11,11,5,6
Andre Drummond,C,22023,203083,22300250,"NOV 26, 2023",CHI @ BKN,L,11,1,2,0.5,0,0,0.0,2,3,0.667,2,3,5,0,1,0,2,3,4,-11,1,CHI,BKN,CHI,109,,,9,9,4,5
Andre Drummond,C,22023,203083,22300046,"NOV 24, 2023",CHI @ TOR,L,6,1,4,0.25,0,0,0.0,0,0,0.0,3,2,5,0,0,0,0,2,2,-10,1,CHI,TOR,CHI,108,,,7,7,2,5
Andre Drummond,C,22023,203083,22300234,"NOV 22, 2023",CHI @ OKC,L,11,1,3,0.333,0,0,0.0,0,0,0.0,1,4,5,1,0,0,0,2,2,-11,1,CHI,OKC,CHI,102,,,8,7,3,6
Andre Drummond,C,22023,203083,22300220,"NOV 20, 2023",CHI vs. MIA,L,14,1,3,0.333,0,0,0.0,0,0,0.0,1,4,5,1,0,1,1,1,2,-2,1,CHI,CHI,MIA,100,,,8,7,3,6
Andre Drummond,C,22023,203083,22300204,"NOV 18, 2023",CHI vs. MIA,W,15,2,3,0.667,0,0,0.0,2,2,1.0,3,6,9,0,1,1,1,3,6,10,1,CHI,CHI,MIA,102,,,15,15,6,9
Andre Drummond,C,22023,203083,22300033,"NOV 17, 2023",CHI vs. ORL,L,18,1,2,0.5,0,1,0.0,3,4,0.75,2,4,6,0,2,1,2,1,5,-2,1,CHI,CHI,ORL,97,,,11,11,5,6
Andre Drummond,C,22023,203083,22300196,"NOV 15, 2023",CHI vs. ORL,L,12,3,5,0.6,0,0,0.0,3,4,0.75,5,9,14,1,1,0,2,3,9,-6,1,CHI,CHI,ORL,94,,,24,23,10,15
Andre Drummond,C,22023,203083,22300190,"NOV 13, 2023",CHI @ MIL,L,12,2,5,0.4,0,0,0.0,0,0,0.0,1,2,3,0,2,0,1,2,4,-8,1,CHI,MIL,CHI,109,,,7,7,4,3
Andre Drummond,C,22023,203083,22300181,"NOV 12, 2023",CHI vs. DET,W,15,5,8,0.625,0,0,0.0,1,2,0.5,5,8,13,1,2,0,1,2,11,5,1,CHI,CHI,DET,119,,,25,24,12,14
Andre Drummond,C,22023,203083,22300162,"NOV 08, 2023",CHI vs. PHX,L,12,1,1,1.0,0,0,0.0,0,0,0.0,1,2,3,1,1,0,2,2,2,15,1,CHI,CHI,PHX,115,,,6,5,3,4
Andre Drummond,C,22023,203083,22300152,"NOV 06, 2023",CHI vs. UTA,W,14,5,10,0.5,0,0,0.0,2,3,0.667,5,2,7,1,1,1,2,2,12,4,1,CHI,CHI,UTA,130,,,20,19,13,8
Andre Drummond,C,22023,203083,22300004,"NOV 03, 2023",CHI vs. BKN,L,12,3,3,1.0,0,0,0.0,1,4,0.25,0,4,4,0,1,0,1,1,7,-9,1,CHI,CHI,BKN,107,,,11,11,7,4
Andre Drummond,C,22023,203083,22300124,"NOV 01, 2023",CHI @ DAL,L,12,4,5,0.8,0,0,0.0,0,0,0.0,1,2,3,0,2,0,0,2,8,-3,1,CHI,DAL,CHI,105,,,11,11,8,3
Andre Drummond,C,22023,203083,22300102,"OCT 30, 2023",CHI @ IND,W,14,2,4,0.5,0,0,0.0,1,2,0.5,2,1,3,2,1,0,1,0,5,7,1,CHI,IND,CHI,112,,,10,8,7,5
Andre Drummond,C,22023,203083,22300088,"OCT 28, 2023",CHI @ DET,L,14,1,6,0.167,0,0,0.0,0,0,0.0,3,2,5,2,3,1,0,0,2,-5,1,CHI,DET,CHI,102,,,9,7,4,7
Andre Drummond,C,22023,203083,22300082,"OCT 27, 2023",CHI vs. TOR,W,12,3,6,0.5,0,0,0.0,2,2,1.0,2,0,2,0,0,0,2,2,8,1,1,CHI,CHI,TOR,104,,,10,10,8,2
Andre Drummond,C,22023,203083,22300070,"OCT 25, 2023",CHI vs. OKC,L,16,3,4,0.75,0,0,0.0,0,0,0.0,3,2,5,1,1,0,1,1,6,-1,1,CHI,CHI,OKC,104,,,12,11,7,6
Andre Drummond,C,22023,203083,22300752,"FEB 10, 2024",CHI @ ORL,L,17,1,3,0.333,0,0,0.0,2,4,0.5,2,3,5,0,2,0,3,4,4,-11,1,CHI,ORL,CHI,108,,,9,9,4,5
Andre Drummond,C,22023,203083,22300536,"JAN 12, 2024",CHI vs. GSW,L,12,2,2,1.0,0,0,0.0,1,2,0.5,0,4,4,1,0,1,0,0,5,-6,1,CHI,CHI,GSW,131,,,10,9,6,5
Andre Drummond,C,22023,203083,22300523,"JAN 10, 2024",CHI vs. HOU,W,13,2,2,1.0,0,0,0.0,0,0,0.0,0,0,0,1,2,0,3,1,4,-11,1,CHI,CHI,HOU,124,,,5,4,5,1
Landry Shamet,G,22023,1629013,22300753,"FEB 10, 2024",WAS vs. PHI,L,19,4,7,0.571,1,4,0.25,0,0,0.0,0,1,1,0,3,0,0,4,9,12,1,WAS,WAS,PHI,113,,,10,10,9,1
Landry Shamet,G,22023,1629013,22300743,"FEB 09, 2024",WAS @ BOS,L,14,1,3,0.333,1,2,0.5,0,0,0.0,0,1,1,0,0,0,1,1,3,-14,1,WAS,BOS,WAS,129,,,4,4,3,1
Landry Shamet,G,22023,1629013,22300728,"FEB 07, 2024",WAS vs. CLE,L,12,1,5,0.2,1,4,0.25,0,0,0.0,1,2,3,3,0,0,0,3,3,0,1,WAS,WAS,CLE,106,,,9,6,6,6
Landry Shamet,G,22023,1629013,22300705,"FEB 04, 2024",WAS vs. PHX,L,21,6,10,0.6,1,4,0.25,0,0,0.0,2,0,2,1,0,0,1,1,13,-11,1,WAS,WAS,PHX,109,,,16,15,14,3
Landry Shamet,G,22023,1629013,22300689,"FEB 02, 2024",WAS vs. MIA,L,13,1,5,0.2,0,2,0.0,3,3,1.0,0,2,2,1,0,0,1,1,5,-7,1,WAS,WAS,MIA,102,,,8,7,6,3
Landry Shamet,G,22023,1629013,22300665,"JAN 29, 2024",WAS @ SAS,W,10,2,4,0.5,2,4,0.5,0,0,0.0,0,0,0,2,0,0,0,0,6,5,1,WAS,SAS,WAS,118,,,8,6,8,2
Landry Shamet,G,22023,1629013,22300642,"JAN 27, 2024",WAS @ DET,W,13,1,8,0.125,0,2,0.0,1,1,1.0,3,2,5,0,0,0,1,2,3,-7,1,WAS,DET,WAS,118,,,8,8,3,5
Landry Shamet,G,22023,1629013,22300628,"JAN 25, 2024",WAS vs. UTA,L,11,1,4,0.25,0,3,0.0,0,0,0.0,0,0,0,1,0,0,0,2,2,-6,1,WAS,WAS,UTA,108,,,3,2,3,1
Landry Shamet,G,22023,1629013,22300620,"JAN 24, 2024",WAS vs. MIN,L,12,1,3,0.333,1,1,1.0,6,6,1.0,0,1,1,2,0,0,0,0,9,5,1,WAS,WAS,MIN,107,,,12,10,11,3
Landry Shamet,G,22023,1629013,22300602,"JAN 21, 2024",WAS vs. DEN,L,16,4,10,0.4,1,5,0.2,5,5,1.0,1,0,1,3,1,0,0,2,14,3,1,WAS,WAS,DEN,104,,,18,15,17,4
Landry Shamet,G,22023,1629013,22300594,"JAN 20, 2024",WAS vs. SAS,L,6,3,5,0.6,1,2,0.5,0,0,0.0,1,0,1,1,0,0,0,2,7,5,1,WAS,WAS,SAS,127,,,9,8,8,2
Landry Shamet,G,22023,1629013,22300579,"JAN 18, 2024",WAS @ NYK,L,14,5,6,0.833,3,4,0.75,0,0,0.0,1,0,1,1,0,0,2,5,13,-2,1,WAS,NYK,WAS,109,,,15,14,14,2
Landry Shamet,G,22023,1629013,22300558,"JAN 15, 2024",WAS vs. DET,L,14,4,7,0.571,2,3,0.667,1,1,1.0,0,0,0,0,1,1,0,1,11,6,1,WAS,WAS,DET,117,,,11,11,11,0
Landry Shamet,G,22023,1629013,22300508,"JAN 08, 2024",WAS vs. OKC,L,16,3,7,0.429,1,4,0.25,8,9,0.889,1,1,2,1,2,2,3,4,15,-6,1,WAS,WAS,OKC,128,,,18,17,16,3
Landry Shamet,G,22023,1629013,22300465,"JAN 03, 2024",WAS @ CLE,L,15,3,6,0.5,2,3,0.667,1,2,0.5,0,3,3,2,1,0,0,0,9,-15,1,WAS,CLE,WAS,101,,,14,12,11,5
Landry Shamet,G,22023,1629013,22300445,"DEC 31, 2023",WAS vs. ATL,L,19,2,6,0.333,0,2,0.0,0,0,0.0,0,2,2,2,1,2,0,1,4,-11,1,WAS,WAS,ATL,126,,,8,6,6,4
Landry Shamet,G,22023,1629013,22300430,"DEC 29, 2023",WAS vs. BKN,W,18,3,7,0.429,1,4,0.25,1,1,1.0,0,1,1,2,1,0,0,0,8,8,1,WAS,WAS,BKN,110,,,11,9,10,3
Landry Shamet,G,22023,1629013,22300416,"DEC 27, 2023",WAS vs. TOR,L,11,3,5,0.6,1,1,1.0,0,0,0.0,0,0,0,1,0,0,3,0,7,-6,1,WAS,WAS,TOR,102,,,8,7,8,1
Landry Shamet,G,22023,1629013,22300407,"DEC 26, 2023",WAS vs. ORL,L,8,0,3,0.0,0,3,0.0,0,0,0.0,0,0,0,0,0,0,0,0,0,-12,1,WAS,WAS,ORL,119,,,0,0,0,0
Landry Shamet,G,22023,1629013,22300386,"DEC 22, 2023",WAS @ GSW,L,13,0,2,0.0,0,1,0.0,0,0,0.0,0,0,0,1,0,0,0,2,0,-16,1,WAS,GSW,WAS,118,,,1,0,1,1
Landry Shamet,G,22023,1629013,22300274,"DEC 01, 2023",WAS @ ORL,L,18,5,8,0.625,3,3,1.0,0,3,0.0,0,0,0,2,0,0,2,4,13,3,1,WAS,ORL,WAS,125,,,15,13,15,2
Landry Shamet,G,22023,1629013,22300259,"NOV 29, 2023",WAS @ ORL,L,18,2,6,0.333,1,3,0.333,0,0,0.0,0,1,1,1,1,0,1,4,5,-8,1,WAS,ORL,WAS,120,,,7,6,6,2
Landry Shamet,G,22023,1629013,22300253,"NOV 27, 2023",WAS @ DET,W,22,4,7,0.571,2,3,0.667,2,2,1.0,0,2,2,4,2,1,1,2,12,8,1,WAS,DET,WAS,126,,,18,14,16,6
Landry Shamet,G,22023,1629013,22300241,"NOV 25, 2023",WAS vs. ATL,L,17,5,9,0.556,2,5,0.4,0,0,0.0,0,1,1,2,0,0,1,1,12,-18,1,WAS,WAS,ATL,108,,,15,13,14,3
Landry Shamet,G,22023,1629013,22300049,"NOV 24, 2023",WAS @ MIL,L,24,6,11,0.545,3,7,0.429,0,1,0.0,0,2,2,0,1,0,0,2,15,0,1,WAS,MIL,WAS,128,,,17,17,15,2
Landry Shamet,G,22023,1629013,22300225,"NOV 22, 2023",WAS @ CHA,L,18,2,6,0.333,1,3,0.333,2,3,0.667,1,1,2,1,0,0,0,3,7,1,1,WAS,CHA,WAS,114,,,10,9,8,3
Landry Shamet,G,22023,1629013,22300219,"NOV 20, 2023",WAS vs. MIL,L,14,3,4,0.75,2,3,0.667,0,0,0.0,0,3,3,2,0,0,1,2,8,-3,1,WAS,WAS,MIL,129,,,13,11,10,5
Landry Shamet,G,22023,1629013,22300028,"NOV 17, 2023",WAS vs. NYK,L,7,2,3,0.667,1,2,0.5,0,0,0.0,0,0,0,2,0,0,0,0,5,-5,1,WAS,WAS,NYK,99,,,7,5,7,2
Landry Shamet,G,22023,1629013,22300192,"NOV 15, 2023",WAS vs. DAL,L,21,2,12,0.167,0,7,0.0,0,0,0.0,0,2,2,1,0,0,0,2,4,-12,1,WAS,WAS,DAL,117,,,7,6,5,3
Landry Shamet,G,22023,1629013,22300189,"NOV 13, 2023",WAS @ TOR,L,15,1,2,0.5,0,1,0.0,0,0,0.0,0,0,0,0,3,0,1,1,2,3,1,WAS,TOR,WAS,107,,,2,2,2,0
Landry Shamet,G,22023,1629013,22300178,"NOV 12, 2023",WAS @ BKN,L,20,3,7,0.429,2,4,0.5,0,0,0.0,1,4,5,1,0,0,1,1,8,12,1,WAS,BKN,WAS,94,,,14,13,9,6
Landry Shamet,G,22023,1629013,22300009,"NOV 10, 2023",WAS vs. CHA,L,17,4,10,0.4,2,7,0.286,1,1,1.0,0,0,0,0,0,0,1,3,11,-3,1,WAS,WAS,CHA,117,,,11,11,11,0
Landry Shamet,G,22023,1629013,22300157,"NOV 08, 2023",WAS @ CHA,W,17,6,9,0.667,3,6,0.5,0,1,0.0,0,1,1,2,1,1,0,3,15,24,1,WAS,CHA,WAS,132,,,18,16,17,3
Landry Shamet,G,22023,1629013,22300003,"NOV 03, 2023",WAS @ MIA,L,14,0,2,0.0,0,2,0.0,0,0,0.0,0,1,1,2,0,0,0,0,0,-13,1,WAS,MIA,WAS,114,,,3,1,2,3
Landry Shamet,G,22023,1629013,22300117,"NOV 01, 2023",WAS @ ATL,L,12,3,5,0.6,2,4,0.5,0,0,0.0,0,1,1,2,1,0,0,3,8,-4,1,WAS,ATL,WAS,121,,,11,9,10,3
Payton Pritchard,G,22023,1630202,22300706,"FEB 04, 2024",BOS vs. MEM,W,15,2,8,0.25,0,6,0.0,2,2,1.0,1,1,2,3,1,0,1,2,6,2,1,BOS,BOS,MEM,131,,,11,8,9,5
Payton Pritchard,G,22023,1630202,22300684,"FEB 01, 2024",BOS vs. LAL,L,21,3,6,0.5,2,5,0.4,0,0,0.0,0,0,0,1,0,1,1,1,8,13,1,BOS,BOS,LAL,105,,,9,8,9,1
Payton Pritchard,G,22023,1630202,22300646,"JAN 27, 2024",BOS vs. LAC,L,21,4,8,0.5,3,7,0.429,1,1,1.0,0,4,4,2,0,0,0,1,12,-12,1,BOS,BOS,LAC,96,,,18,16,14,6
Payton Pritchard,G,22023,1630202,22300630,"JAN 25, 2024",BOS @ MIA,W,23,4,7,0.571,1,2,0.5,2,2,1.0,0,3,3,3,0,0,0,0,11,13,1,BOS,MIA,BOS,143,,,17,14,14,6
Payton Pritchard,G,22023,1630202,22300571,"JAN 17, 2024",BOS vs. SAS,W,27,4,10,0.4,2,4,0.5,2,2,1.0,1,2,3,4,1,0,0,2,12,17,1,BOS,BOS,SAS,117,,,19,15,16,7
Payton Pritchard,G,22023,1630202,22300528,"JAN 11, 2024",BOS @ MIL,L,31,6,13,0.462,2,9,0.222,7,7,1.0,0,4,4,4,0,1,1,1,21,-13,1,BOS,MIL,BOS,102,,,29,25,25,8
Payton Pritchard,G,22023,1630202,22300507,"JAN 08, 2024",BOS @ IND,L,23,5,6,0.833,4,5,0.8,0,0,0.0,4,3,7,3,0,0,1,2,14,-2,1,BOS,IND,BOS,131,,,24,21,17,10
Payton Pritchard,G,22023,1630202,22300493,"JAN 06, 2024",BOS @ IND,W,15,2,5,0.4,1,3,0.333,0,0,0.0,0,2,2,0,1,0,0,0,5,10,1,BOS,IND,BOS,118,,,7,7,5,2
Payton Pritchard,G,22023,1630202,22300479,"JAN 05, 2024",BOS vs. UTA,W,23,3,10,0.3,1,7,0.143,0,0,0.0,1,1,2,4,1,0,3,3,7,14,1,BOS,BOS,UTA,126,,,13,9,11,6
Payton Pritchard,G,22023,1630202,22300448,"DEC 31, 2023",BOS @ SAS,W,19,4,8,0.5,1,5,0.2,0,2,0.0,1,2,3,7,0,0,0,0,9,10,1,BOS,SAS,BOS,134,,,19,12,16,10
Payton Pritchard,G,22023,1630202,22300432,"DEC 29, 2023",BOS vs. TOR,W,25,3,10,0.3,3,8,0.375,0,0,0.0,3,2,5,6,0,0,2,3,9,-3,1,BOS,BOS,TOR,120,,,20,14,15,11
Payton Pritchard,G,22023,1630202,22300389,"DEC 23, 2023",BOS @ LAC,W,23,3,8,0.375,3,5,0.6,0,0,0.0,1,3,4,3,0,0,0,3,9,13,1,BOS,LAC,BOS,142,,,16,13,12,7
Payton Pritchard,G,22023,1630202,22300344,"DEC 17, 2023",BOS vs. ORL,W,21,2,5,0.4,1,1,1.0,0,0,0.0,2,4,6,3,0,1,1,3,5,10,1,BOS,BOS,ORL,114,,,14,11,8,9
Payton Pritchard,G,22023,1630202,22301227,"DEC 08, 2023",BOS vs. NYK,W,19,2,4,0.5,1,3,0.333,0,0,0.0,1,1,2,2,0,0,0,2,5,-12,1,BOS,BOS,NYK,133,,,9,7,7,4
Payton Pritchard,G,22023,1630202,22301202,"DEC 04, 2023",BOS @ IND,L,15,0,5,0.0,0,4,0.0,0,0,0.0,0,4,4,2,0,0,0,0,0,-4,1,BOS,IND,BOS,112,,,6,4,2,6
Payton Pritchard,G,22023,1630202,22300275,"DEC 01, 2023",BOS vs. PHI,W,23,3,7,0.429,2,6,0.333,2,2,1.0,0,2,2,5,1,0,0,1,10,-2,1,BOS,BOS,PHI,125,,,17,12,15,7
Payton Pritchard,G,22023,1630202,22300053,"NOV 28, 2023",BOS vs. CHI,W,23,4,10,0.4,3,7,0.429,0,0,0.0,1,4,5,2,1,0,0,0,11,11,1,BOS,BOS,CHI,124,,,18,16,13,7
Payton Pritchard,G,22023,1630202,22300246,"NOV 26, 2023",BOS vs. ATL,W,20,2,6,0.333,2,6,0.333,0,0,0.0,0,2,2,0,0,0,0,0,6,-10,1,BOS,BOS,ATL,113,,,8,8,6,2
Payton Pritchard,G,22023,1630202,22300043,"NOV 24, 2023",BOS @ ORL,L,13,1,2,0.5,0,0,0.0,0,0,0.0,0,1,1,2,0,0,1,0,2,-6,1,BOS,ORL,BOS,96,,,5,3,4,3
Payton Pritchard,G,22023,1630202,22300194,"NOV 15, 2023",BOS @ PHI,W,23,2,5,0.4,1,3,0.333,0,0,0.0,1,1,2,3,0,0,0,0,5,7,1,BOS,PHI,BOS,117,,,10,7,8,5
Payton Pritchard,G,22023,1630202,22300174,"NOV 11, 2023",BOS vs. TOR,W,25,2,5,0.4,1,3,0.333,2,2,1.0,3,3,6,4,0,0,1,1,7,14,1,BOS,BOS,TOR,117,,,17,13,11,10
Payton Pritchard,G,22023,1630202,22300010,"NOV 10, 2023",BOS vs. BKN,W,30,5,10,0.5,2,7,0.286,1,2,0.5,4,1,5,3,1,0,0,1,13,9,1,BOS,BOS,BKN,121,,,21,18,16,8
Payton Pritchard,G,22023,1630202,22300118,"NOV 01, 2023",BOS vs. IND,W,26,6,10,0.6,2,3,0.667,1,1,1.0,1,3,4,9,0,0,0,2,15,32,1,BOS,BOS,IND,155,,,28,19,24,13
Payton Pritchard,G,22023,1630202,22300103,"OCT 30, 2023",BOS @ WAS,W,25,0,8,0.0,0,6,0.0,0,0,0.0,1,6,7,6,1,0,4,3,0,-2,1,BOS,WAS,BOS,126,,,13,7,6,13
Payton Pritchard,G,22023,1630202,22300729,"FEB 07, 2024",BOS vs. ATL,W,16,3,5,0.6,2,4,0.5,0,0,0.0,0,2,2,2,1,0,2,1,8,11,1,BOS,BOS,ATL,125,,,12,10,10,4
Payton Pritchard,G,22023,1630202,22300670,"JAN 30, 2024",BOS vs. IND,W,17,1,4,0.25,1,3,0.333,0,0,0.0,1,3,4,3,0,0,0,2,3,12,1,BOS,BOS,IND,129,,,10,7,6,7
Payton Pritchard,G,22023,1630202,22300659,"JAN 29, 2024",BOS vs. NOP,W,14,2,5,0.4,1,4,0.25,0,0,0.0,0,0,0,0,1,0,1,3,5,-8,1,BOS,BOS,NOP,118,,,5,5,5,0
Payton Pritchard,G,22023,1630202,22300603,"JAN 21, 2024",BOS @ HOU,W,30,3,6,0.5,3,5,0.6,0,0,0.0,1,1,2,4,2,0,0,1,9,5,1,BOS,HOU,BOS,116,,,15,11,13,6
Payton Pritchard,G,22023,1630202,22300563,"JAN 15, 2024",BOS @ TOR,W,24,1,7,0.143,1,6,0.167,0,0,0.0,0,3,3,2,0,0,0,2,3,16,1,BOS,TOR,BOS,105,,,8,6,5,5
Payton Pritchard,G,22023,1630202,22300542,"JAN 13, 2024",BOS vs. HOU,W,23,7,10,0.7,3,6,0.5,2,2,1.0,2,2,4,3,0,0,2,1,19,12,1,BOS,BOS,HOU,145,,,26,23,22,7
Payton Pritchard,G,22023,1630202,22300517,"JAN 10, 2024",BOS vs. MIN,W,16,1,4,0.25,1,3,0.333,0,0,0.0,0,1,1,1,0,0,0,0,3,3,1,BOS,BOS,MIN,127,,,5,4,4,2
Payton Pritchard,G,22023,1630202,22300421,"DEC 28, 2023",BOS vs. DET,W,24,4,11,0.364,1,6,0.167,0,0,0.0,2,2,4,2,1,0,1,0,9,-9,1,BOS,BOS,DET,128,,,15,13,11,6
Payton Pritchard,G,22023,1630202,22300373,"DEC 20, 2023",BOS @ SAC,W,29,6,12,0.5,6,11,0.545,2,3,0.667,0,4,4,4,1,0,1,1,20,10,1,BOS,SAC,BOS,144,,,28,24,24,8
Payton Pritchard,G,22023,1630202,22300362,"DEC 19, 2023",BOS @ GSW,L,19,4,6,0.667,3,5,0.6,0,0,0.0,0,0,0,2,0,0,1,1,11,-10,1,BOS,GSW,BOS,126,,,13,11,13,2
Payton Pritchard,G,22023,1630202,22300329,"DEC 15, 2023",BOS vs. ORL,W,28,7,10,0.7,6,7,0.857,1,2,0.5,1,2,3,5,1,0,0,4,21,8,1,BOS,BOS,ORL,128,,,29,24,26,8
Payton Pritchard,G,22023,1630202,22300217,"NOV 20, 2023",BOS @ CHA,L,33,8,14,0.571,5,8,0.625,0,0,0.0,2,4,6,3,2,0,0,1,21,16,1,BOS,CHA,BOS,118,,,30,27,24,9
Payton Pritchard,G,22023,1630202,22300136,"NOV 04, 2023",BOS @ BKN,W,19,0,4,0.0,0,4,0.0,0,0,0.0,0,0,0,2,0,0,1,2,0,-10,1,BOS,BKN,BOS,124,,,2,0,2,2
Payton Pritchard,G,22023,1630202,22300080,"OCT 27, 2023",BOS vs. MIA,W,13,1,1,1.0,1,1,1.0,0,0,0.0,0,0,0,1,0,0,0,2,3,8,1,BOS,BOS,MIA,119,,,4,3,4,1
Payton Pritchard,G,22023,1630202,22300743,"FEB 09, 2024",BOS vs. WAS,W,17,4,7,0.571,2,5,0.4,1,1,1.0,0,6,6,1,0,0,0,0,11,7,1,BOS,BOS,WAS,133,,,18,17,12,7
Payton Pritchard,G,22023,1630202,22300611,"JAN 22, 2024",BOS @ DAL,W,25,2,7,0.286,1,4,0.25,0,0,0.0,1,6,7,6,1,1,1,1,5,16,1,BOS,DAL,BOS,119,,,18,12,11,13
Payton Pritchard,G,22023,1630202,22300586,"JAN 19, 2024",BOS vs. DEN,L,12,1,2,0.5,1,1,1.0,0,0,0.0,1,1,2,1,0,0,0,1,3,0,1,BOS,BOS,DEN,100,,,6,5,4,3
Payton Pritchard,G,22023,1630202,22300462,"JAN 02, 2024",BOS @ OKC,L,25,2,5,0.4,1,4,0.25,0,0,0.0,1,2,3,4,2,0,0,1,5,9,1,BOS,OKC,BOS,123,,,12,8,9,7
Payton Pritchard,G,22023,1630202,22300403,"DEC 25, 2023",BOS @ LAL,W,13,4,8,0.5,2,6,0.333,0,0,0.0,2,0,2,0,0,0,0,1,10,-5,1,BOS,LAL,BOS,126,,,12,12,10,2
Payton Pritchard,G,22023,1630202,22300319,"DEC 14, 2023",BOS vs. CLE,W,14,0,1,0.0,0,1,0.0,0,0,0.0,0,3,3,2,0,1,0,1,0,1,1,BOS,BOS,CLE,116,,,5,3,2,5
Payton Pritchard,G,22023,1630202,22300305,"DEC 12, 2023",BOS vs. CLE,W,12,2,5,0.4,2,5,0.4,0,0,0.0,0,3,3,3,2,1,1,1,6,10,1,BOS,BOS,CLE,120,,,12,9,9,6
Payton Pritchard,G,22023,1630202,22300228,"NOV 22, 2023",BOS vs. MIL,W,21,4,7,0.571,2,4,0.5,0,0,0.0,0,2,2,1,0,0,2,0,10,6,1,BOS,BOS,MIL,119,,,13,12,11,3
Payton Pritchard,G,22023,1630202,22300213,"NOV 19, 2023",BOS @ MEM,W,15,2,5,0.4,1,2,0.5,2,4,0.5,0,3,3,1,0,0,1,0,7,0,1,BOS,MEM,BOS,102,,,11,10,8,4
Payton Pritchard,G,22023,1630202,22300031,"NOV 17, 2023",BOS @ TOR,W,17,2,7,0.286,1,5,0.2,0,0,0.0,1,2,3,3,1,0,0,1,5,11,1,BOS,TOR,BOS,108,,,11,8,8,6
Payton Pritchard,G,22023,1630202,22300188,"NOV 13, 2023",BOS vs. NYK,W,19,2,3,0.667,1,1,1.0,0,0,0.0,0,3,3,3,0,0,0,3,5,5,1,BOS,BOS,NYK,114,,,11,8,8,6
Payton Pritchard,G,22023,1630202,22300159,"NOV 08, 2023",BOS @ PHI,L,16,0,4,0.0,0,2,0.0,0,0,0.0,2,0,2,4,0,0,1,0,0,-2,1,BOS,PHI,BOS,103,,,6,2,4,6
Payton Pritchard,G,22023,1630202,22300154,"NOV 06, 2023",BOS @ MIN,L,20,0,3,0.0,0,1,0.0,0,0,0.0,3,3,6,3,0,0,0,2,0,13,1,BOS,MIN,BOS,109,,,9,6,3,9
Payton Pritchard,G,22023,1630202,22300065,"OCT 25, 2023",BOS @ NYK,W,11,1,4,0.25,0,3,0.0,2,2,1.0,0,1,1,1,0,0,0,1,4,-8,1,BOS,NYK,BOS,108,,,6,5,5,2
Al Horford,C-F,22023,201143,22300706,"FEB 04, 2024",BOS vs. MEM,W,23,5,9,0.556,1,5,0.2,0,0,0.0,0,5,5,2,2,0,1,1,11,27,1,BOS,BOS,MEM,131,6.5,Points,18,16,13,7
Al Horford,C-F,22023,201143,22300706,"FEB 04, 2024",BOS vs. MEM,W,23,5,9,0.556,1,5,0.2,0,0,0.0,0,5,5,2,2,0,1,1,11,27,1,BOS,BOS,MEM,131,5.5,Rebounds,18,16,13,7
Al Horford,C-F,22023,201143,22300706,"FEB 04, 2024",BOS vs. MEM,W,23,5,9,0.556,1,5,0.2,0,0,0.0,0,5,5,2,2,0,1,1,11,27,1,BOS,BOS,MEM,131,12.5,Pts+Rebs,18,16,13,7
Al Horford,C-F,22023,201143,22300706,"FEB 04, 2024",BOS vs. MEM,W,23,5,9,0.556,1,5,0.2,0,0,0.0,0,5,5,2,2,0,1,1,11,27,1,BOS,BOS,MEM,131,0.5,Blocked Shots,18,16,13,7
Al Horford,C-F,22023,201143,22300706,"FEB 04, 2024",BOS vs. MEM,W,23,5,9,0.556,1,5,0.2,0,0,0.0,0,5,5,2,2,0,1,1,11,27,1,BOS,BOS,MEM,131,8.0,Rebs+Asts,18,16,13,7
Al Horford,C-F,22023,201143,22300706,"FEB 04, 2024",BOS vs. MEM,W,23,5,9,0.556,1,5,0.2,0,0,0.0,0,5,5,2,2,0,1,1,11,27,1,BOS,BOS,MEM,131,0.5,Turnovers,18,16,13,7
Al Horford,C-F,22023,201143,22300684,"FEB 01, 2024",BOS vs. LAL,L,24,2,6,0.333,2,6,0.333,0,0,0.0,0,9,9,1,1,2,0,0,6,3,1,BOS,BOS,LAL,105,6.5,Points,16,15,7,10
Al Horford,C-F,22023,201143,22300684,"FEB 01, 2024",BOS vs. LAL,L,24,2,6,0.333,2,6,0.333,0,0,0.0,0,9,9,1,1,2,0,0,6,3,1,BOS,BOS,LAL,105,5.5,Rebounds,16,15,7,10
Al Horford,C-F,22023,201143,22300684,"FEB 01, 2024",BOS vs. LAL,L,24,2,6,0.333,2,6,0.333,0,0,0.0,0,9,9,1,1,2,0,0,6,3,1,BOS,BOS,LAL,105,12.5,Pts+Rebs,16,15,7,10
Al Horford,C-F,22023,201143,22300684,"FEB 01, 2024",BOS vs. LAL,L,24,2,6,0.333,2,6,0.333,0,0,0.0,0,9,9,1,1,2,0,0,6,3,1,BOS,BOS,LAL,105,0.5,Blocked Shots,16,15,7,10
Al Horford,C-F,22023,201143,22300684,"FEB 01, 2024",BOS vs. LAL,L,24,2,6,0.333,2,6,0.333,0,0,0.0,0,9,9,1,1,2,0,0,6,3,1,BOS,BOS,LAL,105,8.0,Rebs+Asts,16,15,7,10
Al Horford,C-F,22023,201143,22300684,"FEB 01, 2024",BOS vs. LAL,L,24,2,6,0.333,2,6,0.333,0,0,0.0,0,9,9,1,1,2,0,0,6,3,1,BOS,BOS,LAL,105,0.5,Turnovers,16,15,7,10
Al Horford,C-F,22023,201143,22300646,"JAN 27, 2024",BOS vs. LAC,L,19,0,5,0.0,0,4,0.0,0,0,0.0,0,2,2,1,0,0,1,1,0,-21,1,BOS,BOS,LAC,96,6.5,Points,3,2,1,3
Al Horford,C-F,22023,201143,22300646,"JAN 27, 2024",BOS vs. LAC,L,19,0,5,0.0,0,4,0.0,0,0,0.0,0,2,2,1,0,0,1,1,0,-21,1,BOS,BOS,LAC,96,5.5,Rebounds,3,2,1,3
Al Horford,C-F,22023,201143,22300646,"JAN 27, 2024",BOS vs. LAC,L,19,0,5,0.0,0,4,0.0,0,0,0.0,0,2,2,1,0,0,1,1,0,-21,1,BOS,BOS,LAC,96,12.5,Pts+Rebs,3,2,1,3
Al Horford,C-F,22023,201143,22300646,"JAN 27, 2024",BOS vs. LAC,L,19,0,5,0.0,0,4,0.0,0,0,0.0,0,2,2,1,0,0,1,1,0,-21,1,BOS,BOS,LAC,96,0.5,Blocked Shots,3,2,1,3
Al Horford,C-F,22023,201143,22300646,"JAN 27, 2024",BOS vs. LAC,L,19,0,5,0.0,0,4,0.0,0,0,0.0,0,2,2,1,0,0,1,1,0,-21,1,BOS,BOS,LAC,96,8.0,Rebs+Asts,3,2,1,3
Al Horford,C-F,22023,201143,22300646,"JAN 27, 2024",BOS vs. LAC,L,19,0,5,0.0,0,4,0.0,0,0,0.0,0,2,2,1,0,0,1,1,0,-21,1,BOS,BOS,LAC,96,0.5,Turnovers,3,2,1,3
Al Horford,C-F,22023,201143,22300630,"JAN 25, 2024",BOS @ MIA,W,23,3,4,0.75,2,3,0.667,0,0,0.0,0,7,7,6,0,1,1,2,8,12,1,BOS,MIA,BOS,143,6.5,Points,21,15,14,13
Al Horford,C-F,22023,201143,22300630,"JAN 25, 2024",BOS @ MIA,W,23,3,4,0.75,2,3,0.667,0,0,0.0,0,7,7,6,0,1,1,2,8,12,1,BOS,MIA,BOS,143,5.5,Rebounds,21,15,14,13
Al Horford,C-F,22023,201143,22300630,"JAN 25, 2024",BOS @ MIA,W,23,3,4,0.75,2,3,0.667,0,0,0.0,0,7,7,6,0,1,1,2,8,12,1,BOS,MIA,BOS,143,12.5,Pts+Rebs,21,15,14,13
Al Horford,C-F,22023,201143,22300630,"JAN 25, 2024",BOS @ MIA,W,23,3,4,0.75,2,3,0.667,0,0,0.0,0,7,7,6,0,1,1,2,8,12,1,BOS,MIA,BOS,143,0.5,Blocked Shots,21,15,14,13
Al Horford,C-F,22023,201143,22300630,"JAN 25, 2024",BOS @ MIA,W,23,3,4,0.75,2,3,0.667,0,0,0.0,0,7,7,6,0,1,1,2,8,12,1,BOS,MIA,BOS,143,8.0,Rebs+Asts,21,15,14,13
Al Horford,C-F,22023,201143,22300630,"JAN 25, 2024",BOS @ MIA,W,23,3,4,0.75,2,3,0.667,0,0,0.0,0,7,7,6,0,1,1,2,8,12,1,BOS,MIA,BOS,143,0.5,Turnovers,21,15,14,13
Al Horford,C-F,22023,201143,22300571,"JAN 17, 2024",BOS vs. SAS,W,25,3,4,0.75,3,4,0.75,0,0,0.0,0,3,3,0,1,0,0,2,9,14,1,BOS,BOS,SAS,117,6.5,Points,12,12,9,3
Al Horford,C-F,22023,201143,22300571,"JAN 17, 2024",BOS vs. SAS,W,25,3,4,0.75,3,4,0.75,0,0,0.0,0,3,3,0,1,0,0,2,9,14,1,BOS,BOS,SAS,117,5.5,Rebounds,12,12,9,3
Al Horford,C-F,22023,201143,22300571,"JAN 17, 2024",BOS vs. SAS,W,25,3,4,0.75,3,4,0.75,0,0,0.0,0,3,3,0,1,0,0,2,9,14,1,BOS,BOS,SAS,117,12.5,Pts+Rebs,12,12,9,3
Al Horford,C-F,22023,201143,22300571,"JAN 17, 2024",BOS vs. SAS,W,25,3,4,0.75,3,4,0.75,0,0,0.0,0,3,3,0,1,0,0,2,9,14,1,BOS,BOS,SAS,117,0.5,Blocked Shots,12,12,9,3
Al Horford,C-F,22023,201143,22300571,"JAN 17, 2024",BOS vs. SAS,W,25,3,4,0.75,3,4,0.75,0,0,0.0,0,3,3,0,1,0,0,2,9,14,1,BOS,BOS,SAS,117,8.0,Rebs+Asts,12,12,9,3
Al Horford,C-F,22023,201143,22300571,"JAN 17, 2024",BOS vs. SAS,W,25,3,4,0.75,3,4,0.75,0,0,0.0,0,3,3,0,1,0,0,2,9,14,1,BOS,BOS,SAS,117,0.5,Turnovers,12,12,9,3
Al Horford,C-F,22023,201143,22300507,"JAN 08, 2024",BOS @ IND,L,32,4,5,0.8,3,4,0.75,0,0,0.0,0,6,6,0,0,1,1,1,11,-9,1,BOS,IND,BOS,131,6.5,Points,17,17,11,6
Al Horford,C-F,22023,201143,22300507,"JAN 08, 2024",BOS @ IND,L,32,4,5,0.8,3,4,0.75,0,0,0.0,0,6,6,0,0,1,1,1,11,-9,1,BOS,IND,BOS,131,5.5,Rebounds,17,17,11,6
Al Horford,C-F,22023,201143,22300507,"JAN 08, 2024",BOS @ IND,L,32,4,5,0.8,3,4,0.75,0,0,0.0,0,6,6,0,0,1,1,1,11,-9,1,BOS,IND,BOS,131,12.5,Pts+Rebs,17,17,11,6
Al Horford,C-F,22023,201143,22300507,"JAN 08, 2024",BOS @ IND,L,32,4,5,0.8,3,4,0.75,0,0,0.0,0,6,6,0,0,1,1,1,11,-9,1,BOS,IND,BOS,131,0.5,Blocked Shots,17,17,11,6
Al Horford,C-F,22023,201143,22300507,"JAN 08, 2024",BOS @ IND,L,32,4,5,0.8,3,4,0.75,0,0,0.0,0,6,6,0,0,1,1,1,11,-9,1,BOS,IND,BOS,131,8.0,Rebs+Asts,17,17,11,6
Al Horford,C-F,22023,201143,22300507,"JAN 08, 2024",BOS @ IND,L,32,4,5,0.8,3,4,0.75,0,0,0.0,0,6,6,0,0,1,1,1,11,-9,1,BOS,IND,BOS,131,0.5,Turnovers,17,17,11,6
Al Horford,C-F,22023,201143,22300493,"JAN 06, 2024",BOS @ IND,W,30,4,8,0.5,2,5,0.4,0,2,0.0,1,6,7,8,1,2,2,1,10,10,1,BOS,IND,BOS,118,6.5,Points,25,17,18,15
Al Horford,C-F,22023,201143,22300493,"JAN 06, 2024",BOS @ IND,W,30,4,8,0.5,2,5,0.4,0,2,0.0,1,6,7,8,1,2,2,1,10,10,1,BOS,IND,BOS,118,5.5,Rebounds,25,17,18,15
Al Horford,C-F,22023,201143,22300493,"JAN 06, 2024",BOS @ IND,W,30,4,8,0.5,2,5,0.4,0,2,0.0,1,6,7,8,1,2,2,1,10,10,1,BOS,IND,BOS,118,12.5,Pts+Rebs,25,17,18,15
Al Horford,C-F,22023,201143,22300493,"JAN 06, 2024",BOS @ IND,W,30,4,8,0.5,2,5,0.4,0,2,0.0,1,6,7,8,1,2,2,1,10,10,1,BOS,IND,BOS,118,0.5,Blocked Shots,25,17,18,15
Al Horford,C-F,22023,201143,22300493,"JAN 06, 2024",BOS @ IND,W,30,4,8,0.5,2,5,0.4,0,2,0.0,1,6,7,8,1,2,2,1,10,10,1,BOS,IND,BOS,118,8.0,Rebs+Asts,25,17,18,15
Al Horford,C-F,22023,201143,22300493,"JAN 06, 2024",BOS @ IND,W,30,4,8,0.5,2,5,0.4,0,2,0.0,1,6,7,8,1,2,2,1,10,10,1,BOS,IND,BOS,118,0.5,Turnovers,25,17,18,15
Al Horford,C-F,22023,201143,22300448,"DEC 31, 2023",BOS @ SAS,W,20,3,5,0.6,1,3,0.333,0,0,0.0,1,6,7,4,0,0,0,0,7,17,1,BOS,SAS,BOS,134,6.5,Points,18,14,11,11
Al Horford,C-F,22023,201143,22300448,"DEC 31, 2023",BOS @ SAS,W,20,3,5,0.6,1,3,0.333,0,0,0.0,1,6,7,4,0,0,0,0,7,17,1,BOS,SAS,BOS,134,5.5,Rebounds,18,14,11,11
Al Horford,C-F,22023,201143,22300448,"DEC 31, 2023",BOS @ SAS,W,20,3,5,0.6,1,3,0.333,0,0,0.0,1,6,7,4,0,0,0,0,7,17,1,BOS,SAS,BOS,134,12.5,Pts+Rebs,18,14,11,11
Al Horford,C-F,22023,201143,22300448,"DEC 31, 2023",BOS @ SAS,W,20,3,5,0.6,1,3,0.333,0,0,0.0,1,6,7,4,0,0,0,0,7,17,1,BOS,SAS,BOS,134,0.5,Blocked Shots,18,14,11,11
Al Horford,C-F,22023,201143,22300448,"DEC 31, 2023",BOS @ SAS,W,20,3,5,0.6,1,3,0.333,0,0,0.0,1,6,7,4,0,0,0,0,7,17,1,BOS,SAS,BOS,134,8.0,Rebs+Asts,18,14,11,11
Al Horford,C-F,22023,201143,22300448,"DEC 31, 2023",BOS @ SAS,W,20,3,5,0.6,1,3,0.333,0,0,0.0,1,6,7,4,0,0,0,0,7,17,1,BOS,SAS,BOS,134,0.5,Turnovers,18,14,11,11
Al Horford,C-F,22023,201143,22300389,"DEC 23, 2023",BOS @ LAC,W,27,2,6,0.333,2,5,0.4,0,0,0.0,0,8,8,5,1,2,0,2,6,24,1,BOS,LAC,BOS,142,6.5,Points,19,14,11,13
Al Horford,C-F,22023,201143,22300389,"DEC 23, 2023",BOS @ LAC,W,27,2,6,0.333,2,5,0.4,0,0,0.0,0,8,8,5,1,2,0,2,6,24,1,BOS,LAC,BOS,142,5.5,Rebounds,19,14,11,13
Al Horford,C-F,22023,201143,22300389,"DEC 23, 2023",BOS @ LAC,W,27,2,6,0.333,2,5,0.4,0,0,0.0,0,8,8,5,1,2,0,2,6,24,1,BOS,LAC,BOS,142,12.5,Pts+Rebs,19,14,11,13
Al Horford,C-F,22023,201143,22300389,"DEC 23, 2023",BOS @ LAC,W,27,2,6,0.333,2,5,0.4,0,0,0.0,0,8,8,5,1,2,0,2,6,24,1,BOS,LAC,BOS,142,0.5,Blocked Shots,19,14,11,13
Al Horford,C-F,22023,201143,22300389,"DEC 23, 2023",BOS @ LAC,W,27,2,6,0.333,2,5,0.4,0,0,0.0,0,8,8,5,1,2,0,2,6,24,1,BOS,LAC,BOS,142,8.0,Rebs+Asts,19,14,11,13
Al Horford,C-F,22023,201143,22300389,"DEC 23, 2023",BOS @ LAC,W,27,2,6,0.333,2,5,0.4,0,0,0.0,0,8,8,5,1,2,0,2,6,24,1,BOS,LAC,BOS,142,0.5,Turnovers,19,14,11,13
Al Horford,C-F,22023,201143,22300344,"DEC 17, 2023",BOS vs. ORL,W,24,3,7,0.429,2,3,0.667,0,0,0.0,1,7,8,2,0,1,0,2,8,19,1,BOS,BOS,ORL,114,6.5,Points,18,16,10,10
Al Horford,C-F,22023,201143,22300344,"DEC 17, 2023",BOS vs. ORL,W,24,3,7,0.429,2,3,0.667,0,0,0.0,1,7,8,2,0,1,0,2,8,19,1,BOS,BOS,ORL,114,5.5,Rebounds,18,16,10,10
Al Horford,C-F,22023,201143,22300344,"DEC 17, 2023",BOS vs. ORL,W,24,3,7,0.429,2,3,0.667,0,0,0.0,1,7,8,2,0,1,0,2,8,19,1,BOS,BOS,ORL,114,12.5,Pts+Rebs,18,16,10,10
Al Horford,C-F,22023,201143,22300344,"DEC 17, 2023",BOS vs. ORL,W,24,3,7,0.429,2,3,0.667,0,0,0.0,1,7,8,2,0,1,0,2,8,19,1,BOS,BOS,ORL,114,0.5,Blocked Shots,18,16,10,10
Al Horford,C-F,22023,201143,22300344,"DEC 17, 2023",BOS vs. ORL,W,24,3,7,0.429,2,3,0.667,0,0,0.0,1,7,8,2,0,1,0,2,8,19,1,BOS,BOS,ORL,114,8.0,Rebs+Asts,18,16,10,10
Al Horford,C-F,22023,201143,22300344,"DEC 17, 2023",BOS vs. ORL,W,24,3,7,0.429,2,3,0.667,0,0,0.0,1,7,8,2,0,1,0,2,8,19,1,BOS,BOS,ORL,114,0.5,Turnovers,18,16,10,10
Al Horford,C-F,22023,201143,22301227,"DEC 08, 2023",BOS vs. NYK,W,27,5,8,0.625,3,6,0.5,1,1,1.0,2,8,10,2,0,0,2,1,14,9,1,BOS,BOS,NYK,133,6.5,Points,26,24,16,12
Al Horford,C-F,22023,201143,22301227,"DEC 08, 2023",BOS vs. NYK,W,27,5,8,0.625,3,6,0.5,1,1,1.0,2,8,10,2,0,0,2,1,14,9,1,BOS,BOS,NYK,133,5.5,Rebounds,26,24,16,12
Al Horford,C-F,22023,201143,22301227,"DEC 08, 2023",BOS vs. NYK,W,27,5,8,0.625,3,6,0.5,1,1,1.0,2,8,10,2,0,0,2,1,14,9,1,BOS,BOS,NYK,133,12.5,Pts+Rebs,26,24,16,12
Al Horford,C-F,22023,201143,22301227,"DEC 08, 2023",BOS vs. NYK,W,27,5,8,0.625,3,6,0.5,1,1,1.0,2,8,10,2,0,0,2,1,14,9,1,BOS,BOS,NYK,133,0.5,Blocked Shots,26,24,16,12
Al Horford,C-F,22023,201143,22301227,"DEC 08, 2023",BOS vs. NYK,W,27,5,8,0.625,3,6,0.5,1,1,1.0,2,8,10,2,0,0,2,1,14,9,1,BOS,BOS,NYK,133,8.0,Rebs+Asts,26,24,16,12
Al Horford,C-F,22023,201143,22301227,"DEC 08, 2023",BOS vs. NYK,W,27,5,8,0.625,3,6,0.5,1,1,1.0,2,8,10,2,0,0,2,1,14,9,1,BOS,BOS,NYK,133,0.5,Turnovers,26,24,16,12
Al Horford,C-F,22023,201143,22301202,"DEC 04, 2023",BOS @ IND,L,31,1,3,0.333,0,1,0.0,0,0,0.0,2,5,7,4,0,1,2,1,2,-2,1,BOS,IND,BOS,112,6.5,Points,13,9,6,11
Al Horford,C-F,22023,201143,22301202,"DEC 04, 2023",BOS @ IND,L,31,1,3,0.333,0,1,0.0,0,0,0.0,2,5,7,4,0,1,2,1,2,-2,1,BOS,IND,BOS,112,5.5,Rebounds,13,9,6,11
Al Horford,C-F,22023,201143,22301202,"DEC 04, 2023",BOS @ IND,L,31,1,3,0.333,0,1,0.0,0,0,0.0,2,5,7,4,0,1,2,1,2,-2,1,BOS,IND,BOS,112,12.5,Pts+Rebs,13,9,6,11
Al Horford,C-F,22023,201143,22301202,"DEC 04, 2023",BOS @ IND,L,31,1,3,0.333,0,1,0.0,0,0,0.0,2,5,7,4,0,1,2,1,2,-2,1,BOS,IND,BOS,112,0.5,Blocked Shots,13,9,6,11
Al Horford,C-F,22023,201143,22301202,"DEC 04, 2023",BOS @ IND,L,31,1,3,0.333,0,1,0.0,0,0,0.0,2,5,7,4,0,1,2,1,2,-2,1,BOS,IND,BOS,112,8.0,Rebs+Asts,13,9,6,11
Al Horford,C-F,22023,201143,22301202,"DEC 04, 2023",BOS @ IND,L,31,1,3,0.333,0,1,0.0,0,0,0.0,2,5,7,4,0,1,2,1,2,-2,1,BOS,IND,BOS,112,0.5,Turnovers,13,9,6,11
Al Horford,C-F,22023,201143,22300275,"DEC 01, 2023",BOS vs. PHI,W,33,7,9,0.778,2,4,0.5,4,4,1.0,2,4,6,3,1,2,1,4,20,10,1,BOS,BOS,PHI,125,6.5,Points,29,26,23,9
Al Horford,C-F,22023,201143,22300275,"DEC 01, 2023",BOS vs. PHI,W,33,7,9,0.778,2,4,0.5,4,4,1.0,2,4,6,3,1,2,1,4,20,10,1,BOS,BOS,PHI,125,5.5,Rebounds,29,26,23,9
Al Horford,C-F,22023,201143,22300275,"DEC 01, 2023",BOS vs. PHI,W,33,7,9,0.778,2,4,0.5,4,4,1.0,2,4,6,3,1,2,1,4,20,10,1,BOS,BOS,PHI,125,12.5,Pts+Rebs,29,26,23,9
Al Horford,C-F,22023,201143,22300275,"DEC 01, 2023",BOS vs. PHI,W,33,7,9,0.778,2,4,0.5,4,4,1.0,2,4,6,3,1,2,1,4,20,10,1,BOS,BOS,PHI,125,0.5,Blocked Shots,29,26,23,9
Al Horford,C-F,22023,201143,22300275,"DEC 01, 2023",BOS vs. PHI,W,33,7,9,0.778,2,4,0.5,4,4,1.0,2,4,6,3,1,2,1,4,20,10,1,BOS,BOS,PHI,125,8.0,Rebs+Asts,29,26,23,9
Al Horford,C-F,22023,201143,22300275,"DEC 01, 2023",BOS vs. PHI,W,33,7,9,0.778,2,4,0.5,4,4,1.0,2,4,6,3,1,2,1,4,20,10,1,BOS,BOS,PHI,125,0.5,Turnovers,29,26,23,9
Al Horford,C-F,22023,201143,22300053,"NOV 28, 2023",BOS vs. CHI,W,28,6,8,0.75,4,6,0.667,0,0,0.0,0,9,9,6,2,3,3,3,16,18,1,BOS,BOS,CHI,124,6.5,Points,31,25,22,15
Al Horford,C-F,22023,201143,22300053,"NOV 28, 2023",BOS vs. CHI,W,28,6,8,0.75,4,6,0.667,0,0,0.0,0,9,9,6,2,3,3,3,16,18,1,BOS,BOS,CHI,124,5.5,Rebounds,31,25,22,15
Al Horford,C-F,22023,201143,22300053,"NOV 28, 2023",BOS vs. CHI,W,28,6,8,0.75,4,6,0.667,0,0,0.0,0,9,9,6,2,3,3,3,16,18,1,BOS,BOS,CHI,124,12.5,Pts+Rebs,31,25,22,15
Al Horford,C-F,22023,201143,22300053,"NOV 28, 2023",BOS vs. CHI,W,28,6,8,0.75,4,6,0.667,0,0,0.0,0,9,9,6,2,3,3,3,16,18,1,BOS,BOS,CHI,124,0.5,Blocked Shots,31,25,22,15
Al Horford,C-F,22023,201143,22300053,"NOV 28, 2023",BOS vs. CHI,W,28,6,8,0.75,4,6,0.667,0,0,0.0,0,9,9,6,2,3,3,3,16,18,1,BOS,BOS,CHI,124,8.0,Rebs+Asts,31,25,22,15
Al Horford,C-F,22023,201143,22300053,"NOV 28, 2023",BOS vs. CHI,W,28,6,8,0.75,4,6,0.667,0,0,0.0,0,9,9,6,2,3,3,3,16,18,1,BOS,BOS,CHI,124,0.5,Turnovers,31,25,22,15
Al Horford,C-F,22023,201143,22300246,"NOV 26, 2023",BOS vs. ATL,W,32,3,8,0.375,0,5,0.0,0,0,0.0,3,12,15,3,1,2,0,1,6,17,1,BOS,BOS,ATL,113,6.5,Points,24,21,9,18
Al Horford,C-F,22023,201143,22300246,"NOV 26, 2023",BOS vs. ATL,W,32,3,8,0.375,0,5,0.0,0,0,0.0,3,12,15,3,1,2,0,1,6,17,1,BOS,BOS,ATL,113,5.5,Rebounds,24,21,9,18
Al Horford,C-F,22023,201143,22300246,"NOV 26, 2023",BOS vs. ATL,W,32,3,8,0.375,0,5,0.0,0,0,0.0,3,12,15,3,1,2,0,1,6,17,1,BOS,BOS,ATL,113,12.5,Pts+Rebs,24,21,9,18
Al Horford,C-F,22023,201143,22300246,"NOV 26, 2023",BOS vs. ATL,W,32,3,8,0.375,0,5,0.0,0,0,0.0,3,12,15,3,1,2,0,1,6,17,1,BOS,BOS,ATL,113,0.5,Blocked Shots,24,21,9,18
Al Horford,C-F,22023,201143,22300246,"NOV 26, 2023",BOS vs. ATL,W,32,3,8,0.375,0,5,0.0,0,0,0.0,3,12,15,3,1,2,0,1,6,17,1,BOS,BOS,ATL,113,8.0,Rebs+Asts,24,21,9,18
Al Horford,C-F,22023,201143,22300246,"NOV 26, 2023",BOS vs. ATL,W,32,3,8,0.375,0,5,0.0,0,0,0.0,3,12,15,3,1,2,0,1,6,17,1,BOS,BOS,ATL,113,0.5,Turnovers,24,21,9,18
Al Horford,C-F,22023,201143,22300043,"NOV 24, 2023",BOS @ ORL,L,33,1,5,0.2,1,5,0.2,0,0,0.0,0,5,5,3,0,0,1,4,3,-26,1,BOS,ORL,BOS,96,6.5,Points,11,8,6,8
Al Horford,C-F,22023,201143,22300043,"NOV 24, 2023",BOS @ ORL,L,33,1,5,0.2,1,5,0.2,0,0,0.0,0,5,5,3,0,0,1,4,3,-26,1,BOS,ORL,BOS,96,5.5,Rebounds,11,8,6,8
Al Horford,C-F,22023,201143,22300043,"NOV 24, 2023",BOS @ ORL,L,33,1,5,0.2,1,5,0.2,0,0,0.0,0,5,5,3,0,0,1,4,3,-26,1,BOS,ORL,BOS,96,12.5,Pts+Rebs,11,8,6,8
Al Horford,C-F,22023,201143,22300043,"NOV 24, 2023",BOS @ ORL,L,33,1,5,0.2,1,5,0.2,0,0,0.0,0,5,5,3,0,0,1,4,3,-26,1,BOS,ORL,BOS,96,0.5,Blocked Shots,11,8,6,8
Al Horford,C-F,22023,201143,22300043,"NOV 24, 2023",BOS @ ORL,L,33,1,5,0.2,1,5,0.2,0,0,0.0,0,5,5,3,0,0,1,4,3,-26,1,BOS,ORL,BOS,96,8.0,Rebs+Asts,11,8,6,8
Al Horford,C-F,22023,201143,22300043,"NOV 24, 2023",BOS @ ORL,L,33,1,5,0.2,1,5,0.2,0,0,0.0,0,5,5,3,0,0,1,4,3,-26,1,BOS,ORL,BOS,96,0.5,Turnovers,11,8,6,8
Al Horford,C-F,22023,201143,22300194,"NOV 15, 2023",BOS @ PHI,W,29,5,9,0.556,4,8,0.5,0,0,0.0,1,7,8,3,0,5,0,2,14,14,1,BOS,PHI,BOS,117,6.5,Points,25,22,17,11
Al Horford,C-F,22023,201143,22300194,"NOV 15, 2023",BOS @ PHI,W,29,5,9,0.556,4,8,0.5,0,0,0.0,1,7,8,3,0,5,0,2,14,14,1,BOS,PHI,BOS,117,5.5,Rebounds,25,22,17,11
Al Horford,C-F,22023,201143,22300194,"NOV 15, 2023",BOS @ PHI,W,29,5,9,0.556,4,8,0.5,0,0,0.0,1,7,8,3,0,5,0,2,14,14,1,BOS,PHI,BOS,117,12.5,Pts+Rebs,25,22,17,11
Al Horford,C-F,22023,201143,22300194,"NOV 15, 2023",BOS @ PHI,W,29,5,9,0.556,4,8,0.5,0,0,0.0,1,7,8,3,0,5,0,2,14,14,1,BOS,PHI,BOS,117,0.5,Blocked Shots,25,22,17,11
Al Horford,C-F,22023,201143,22300194,"NOV 15, 2023",BOS @ PHI,W,29,5,9,0.556,4,8,0.5,0,0,0.0,1,7,8,3,0,5,0,2,14,14,1,BOS,PHI,BOS,117,8.0,Rebs+Asts,25,22,17,11
Al Horford,C-F,22023,201143,22300194,"NOV 15, 2023",BOS @ PHI,W,29,5,9,0.556,4,8,0.5,0,0,0.0,1,7,8,3,0,5,0,2,14,14,1,BOS,PHI,BOS,117,0.5,Turnovers,25,22,17,11
Al Horford,C-F,22023,201143,22300174,"NOV 11, 2023",BOS vs. TOR,W,24,3,5,0.6,1,3,0.333,0,0,0.0,1,6,7,4,0,0,0,2,7,11,1,BOS,BOS,TOR,117,6.5,Points,18,14,11,11
Al Horford,C-F,22023,201143,22300174,"NOV 11, 2023",BOS vs. TOR,W,24,3,5,0.6,1,3,0.333,0,0,0.0,1,6,7,4,0,0,0,2,7,11,1,BOS,BOS,TOR,117,5.5,Rebounds,18,14,11,11
Al Horford,C-F,22023,201143,22300174,"NOV 11, 2023",BOS vs. TOR,W,24,3,5,0.6,1,3,0.333,0,0,0.0,1,6,7,4,0,0,0,2,7,11,1,BOS,BOS,TOR,117,12.5,Pts+Rebs,18,14,11,11
Al Horford,C-F,22023,201143,22300174,"NOV 11, 2023",BOS vs. TOR,W,24,3,5,0.6,1,3,0.333,0,0,0.0,1,6,7,4,0,0,0,2,7,11,1,BOS,BOS,TOR,117,0.5,Blocked Shots,18,14,11,11
Al Horford,C-F,22023,201143,22300174,"NOV 11, 2023",BOS vs. TOR,W,24,3,5,0.6,1,3,0.333,0,0,0.0,1,6,7,4,0,0,0,2,7,11,1,BOS,BOS,TOR,117,8.0,Rebs+Asts,18,14,11,11
Al Horford,C-F,22023,201143,22300174,"NOV 11, 2023",BOS vs. TOR,W,24,3,5,0.6,1,3,0.333,0,0,0.0,1,6,7,4,0,0,0,2,7,11,1,BOS,BOS,TOR,117,0.5,Turnovers,18,14,11,11
Al Horford,C-F,22023,201143,22300118,"NOV 01, 2023",BOS vs. IND,W,11,1,3,0.333,1,1,1.0,2,2,1.0,2,2,4,0,1,1,1,0,5,7,1,BOS,BOS,IND,155,6.5,Points,9,9,5,4
Al Horford,C-F,22023,201143,22300118,"NOV 01, 2023",BOS vs. IND,W,11,1,3,0.333,1,1,1.0,2,2,1.0,2,2,4,0,1,1,1,0,5,7,1,BOS,BOS,IND,155,5.5,Rebounds,9,9,5,4
Al Horford,C-F,22023,201143,22300118,"NOV 01, 2023",BOS vs. IND,W,11,1,3,0.333,1,1,1.0,2,2,1.0,2,2,4,0,1,1,1,0,5,7,1,BOS,BOS,IND,155,12.5,Pts+Rebs,9,9,5,4
Al Horford,C-F,22023,201143,22300118,"NOV 01, 2023",BOS vs. IND,W,11,1,3,0.333,1,1,1.0,2,2,1.0,2,2,4,0,1,1,1,0,5,7,1,BOS,BOS,IND,155,0.5,Blocked Shots,9,9,5,4
Al Horford,C-F,22023,201143,22300118,"NOV 01, 2023",BOS vs. IND,W,11,1,3,0.333,1,1,1.0,2,2,1.0,2,2,4,0,1,1,1,0,5,7,1,BOS,BOS,IND,155,8.0,Rebs+Asts,9,9,5,4
Al Horford,C-F,22023,201143,22300118,"NOV 01, 2023",BOS vs. IND,W,11,1,3,0.333,1,1,1.0,2,2,1.0,2,2,4,0,1,1,1,0,5,7,1,BOS,BOS,IND,155,0.5,Turnovers,9,9,5,4
Al Horford,C-F,22023,201143,22300103,"OCT 30, 2023",BOS @ WAS,W,16,4,9,0.444,0,3,0.0,0,0,0.0,4,1,5,1,2,0,0,1,8,4,1,BOS,WAS,BOS,126,6.5,Points,14,13,9,6
Al Horford,C-F,22023,201143,22300103,"OCT 30, 2023",BOS @ WAS,W,16,4,9,0.444,0,3,0.0,0,0,0.0,4,1,5,1,2,0,0,1,8,4,1,BOS,WAS,BOS,126,5.5,Rebounds,14,13,9,6
Al Horford,C-F,22023,201143,22300103,"OCT 30, 2023",BOS @ WAS,W,16,4,9,0.444,0,3,0.0,0,0,0.0,4,1,5,1,2,0,0,1,8,4,1,BOS,WAS,BOS,126,12.5,Pts+Rebs,14,13,9,6
Al Horford,C-F,22023,201143,22300103,"OCT 30, 2023",BOS @ WAS,W,16,4,9,0.444,0,3,0.0,0,0,0.0,4,1,5,1,2,0,0,1,8,4,1,BOS,WAS,BOS,126,0.5,Blocked Shots,14,13,9,6
Al Horford,C-F,22023,201143,22300103,"OCT 30, 2023",BOS @ WAS,W,16,4,9,0.444,0,3,0.0,0,0,0.0,4,1,5,1,2,0,0,1,8,4,1,BOS,WAS,BOS,126,8.0,Rebs+Asts,14,13,9,6
Al Horford,C-F,22023,201143,22300103,"OCT 30, 2023",BOS @ WAS,W,16,4,9,0.444,0,3,0.0,0,0,0.0,4,1,5,1,2,0,0,1,8,4,1,BOS,WAS,BOS,126,0.5,Turnovers,14,13,9,6
Al Horford,C-F,22023,201143,22300729,"FEB 07, 2024",BOS vs. ATL,W,36,5,12,0.417,4,9,0.444,0,0,0.0,2,6,8,8,2,4,1,1,14,12,1,BOS,BOS,ATL,125,6.5,Points,30,22,22,16
Al Horford,C-F,22023,201143,22300729,"FEB 07, 2024",BOS vs. ATL,W,36,5,12,0.417,4,9,0.444,0,0,0.0,2,6,8,8,2,4,1,1,14,12,1,BOS,BOS,ATL,125,5.5,Rebounds,30,22,22,16
Al Horford,C-F,22023,201143,22300729,"FEB 07, 2024",BOS vs. ATL,W,36,5,12,0.417,4,9,0.444,0,0,0.0,2,6,8,8,2,4,1,1,14,12,1,BOS,BOS,ATL,125,12.5,Pts+Rebs,30,22,22,16
Al Horford,C-F,22023,201143,22300729,"FEB 07, 2024",BOS vs. ATL,W,36,5,12,0.417,4,9,0.444,0,0,0.0,2,6,8,8,2,4,1,1,14,12,1,BOS,BOS,ATL,125,0.5,Blocked Shots,30,22,22,16
Al Horford,C-F,22023,201143,22300729,"FEB 07, 2024",BOS vs. ATL,W,36,5,12,0.417,4,9,0.444,0,0,0.0,2,6,8,8,2,4,1,1,14,12,1,BOS,BOS,ATL,125,8.0,Rebs+Asts,30,22,22,16
Al Horford,C-F,22023,201143,22300729,"FEB 07, 2024",BOS vs. ATL,W,36,5,12,0.417,4,9,0.444,0,0,0.0,2,6,8,8,2,4,1,1,14,12,1,BOS,BOS,ATL,125,0.5,Turnovers,30,22,22,16
Al Horford,C-F,22023,201143,22300659,"JAN 29, 2024",BOS vs. NOP,W,36,4,9,0.444,3,6,0.5,0,0,0.0,1,7,8,4,0,1,0,1,11,12,1,BOS,BOS,NOP,118,6.5,Points,23,19,15,12
Al Horford,C-F,22023,201143,22300659,"JAN 29, 2024",BOS vs. NOP,W,36,4,9,0.444,3,6,0.5,0,0,0.0,1,7,8,4,0,1,0,1,11,12,1,BOS,BOS,NOP,118,5.5,Rebounds,23,19,15,12
Al Horford,C-F,22023,201143,22300659,"JAN 29, 2024",BOS vs. NOP,W,36,4,9,0.444,3,6,0.5,0,0,0.0,1,7,8,4,0,1,0,1,11,12,1,BOS,BOS,NOP,118,12.5,Pts+Rebs,23,19,15,12
Al Horford,C-F,22023,201143,22300659,"JAN 29, 2024",BOS vs. NOP,W,36,4,9,0.444,3,6,0.5,0,0,0.0,1,7,8,4,0,1,0,1,11,12,1,BOS,BOS,NOP,118,0.5,Blocked Shots,23,19,15,12
Al Horford,C-F,22023,201143,22300659,"JAN 29, 2024",BOS vs. NOP,W,36,4,9,0.444,3,6,0.5,0,0,0.0,1,7,8,4,0,1,0,1,11,12,1,BOS,BOS,NOP,118,8.0,Rebs+Asts,23,19,15,12
Al Horford,C-F,22023,201143,22300659,"JAN 29, 2024",BOS vs. NOP,W,36,4,9,0.444,3,6,0.5,0,0,0.0,1,7,8,4,0,1,0,1,11,12,1,BOS,BOS,NOP,118,0.5,Turnovers,23,19,15,12
Al Horford,C-F,22023,201143,22300563,"JAN 15, 2024",BOS @ TOR,W,35,4,10,0.4,2,4,0.5,0,0,0.0,2,9,11,2,1,0,1,3,10,1,1,BOS,TOR,BOS,105,6.5,Points,23,21,12,13
Al Horford,C-F,22023,201143,22300563,"JAN 15, 2024",BOS @ TOR,W,35,4,10,0.4,2,4,0.5,0,0,0.0,2,9,11,2,1,0,1,3,10,1,1,BOS,TOR,BOS,105,5.5,Rebounds,23,21,12,13
Al Horford,C-F,22023,201143,22300563,"JAN 15, 2024",BOS @ TOR,W,35,4,10,0.4,2,4,0.5,0,0,0.0,2,9,11,2,1,0,1,3,10,1,1,BOS,TOR,BOS,105,12.5,Pts+Rebs,23,21,12,13
Al Horford,C-F,22023,201143,22300563,"JAN 15, 2024",BOS @ TOR,W,35,4,10,0.4,2,4,0.5,0,0,0.0,2,9,11,2,1,0,1,3,10,1,1,BOS,TOR,BOS,105,0.5,Blocked Shots,23,21,12,13
Al Horford,C-F,22023,201143,22300563,"JAN 15, 2024",BOS @ TOR,W,35,4,10,0.4,2,4,0.5,0,0,0.0,2,9,11,2,1,0,1,3,10,1,1,BOS,TOR,BOS,105,8.0,Rebs+Asts,23,21,12,13
Al Horford,C-F,22023,201143,22300563,"JAN 15, 2024",BOS @ TOR,W,35,4,10,0.4,2,4,0.5,0,0,0.0,2,9,11,2,1,0,1,3,10,1,1,BOS,TOR,BOS,105,0.5,Turnovers,23,21,12,13
Al Horford,C-F,22023,201143,22300542,"JAN 13, 2024",BOS vs. HOU,W,20,2,3,0.667,1,2,0.5,2,2,1.0,0,4,4,1,0,1,0,0,7,29,1,BOS,BOS,HOU,145,6.5,Points,12,11,8,5
Al Horford,C-F,22023,201143,22300542,"JAN 13, 2024",BOS vs. HOU,W,20,2,3,0.667,1,2,0.5,2,2,1.0,0,4,4,1,0,1,0,0,7,29,1,BOS,BOS,HOU,145,5.5,Rebounds,12,11,8,5
Al Horford,C-F,22023,201143,22300542,"JAN 13, 2024",BOS vs. HOU,W,20,2,3,0.667,1,2,0.5,2,2,1.0,0,4,4,1,0,1,0,0,7,29,1,BOS,BOS,HOU,145,12.5,Pts+Rebs,12,11,8,5
Al Horford,C-F,22023,201143,22300542,"JAN 13, 2024",BOS vs. HOU,W,20,2,3,0.667,1,2,0.5,2,2,1.0,0,4,4,1,0,1,0,0,7,29,1,BOS,BOS,HOU,145,0.5,Blocked Shots,12,11,8,5
Al Horford,C-F,22023,201143,22300542,"JAN 13, 2024",BOS vs. HOU,W,20,2,3,0.667,1,2,0.5,2,2,1.0,0,4,4,1,0,1,0,0,7,29,1,BOS,BOS,HOU,145,8.0,Rebs+Asts,12,11,8,5
Al Horford,C-F,22023,201143,22300542,"JAN 13, 2024",BOS vs. HOU,W,20,2,3,0.667,1,2,0.5,2,2,1.0,0,4,4,1,0,1,0,0,7,29,1,BOS,BOS,HOU,145,0.5,Turnovers,12,11,8,5
Al Horford,C-F,22023,201143,22300517,"JAN 10, 2024",BOS vs. MIN,W,38,3,8,0.375,3,6,0.5,0,0,0.0,1,7,8,5,0,0,1,3,9,2,1,BOS,BOS,MIN,127,6.5,Points,22,17,14,13
Al Horford,C-F,22023,201143,22300517,"JAN 10, 2024",BOS vs. MIN,W,38,3,8,0.375,3,6,0.5,0,0,0.0,1,7,8,5,0,0,1,3,9,2,1,BOS,BOS,MIN,127,5.5,Rebounds,22,17,14,13
Al Horford,C-F,22023,201143,22300517,"JAN 10, 2024",BOS vs. MIN,W,38,3,8,0.375,3,6,0.5,0,0,0.0,1,7,8,5,0,0,1,3,9,2,1,BOS,BOS,MIN,127,12.5,Pts+Rebs,22,17,14,13
Al Horford,C-F,22023,201143,22300517,"JAN 10, 2024",BOS vs. MIN,W,38,3,8,0.375,3,6,0.5,0,0,0.0,1,7,8,5,0,0,1,3,9,2,1,BOS,BOS,MIN,127,0.5,Blocked Shots,22,17,14,13
Al Horford,C-F,22023,201143,22300517,"JAN 10, 2024",BOS vs. MIN,W,38,3,8,0.375,3,6,0.5,0,0,0.0,1,7,8,5,0,0,1,3,9,2,1,BOS,BOS,MIN,127,8.0,Rebs+Asts,22,17,14,13
Al Horford,C-F,22023,201143,22300517,"JAN 10, 2024",BOS vs. MIN,W,38,3,8,0.375,3,6,0.5,0,0,0.0,1,7,8,5,0,0,1,3,9,2,1,BOS,BOS,MIN,127,0.5,Turnovers,22,17,14,13
Al Horford,C-F,22023,201143,22300421,"DEC 28, 2023",BOS vs. DET,W,37,3,4,0.75,2,3,0.667,0,0,0.0,2,3,5,3,1,1,1,1,8,10,1,BOS,BOS,DET,128,6.5,Points,16,13,11,8
Al Horford,C-F,22023,201143,22300421,"DEC 28, 2023",BOS vs. DET,W,37,3,4,0.75,2,3,0.667,0,0,0.0,2,3,5,3,1,1,1,1,8,10,1,BOS,BOS,DET,128,5.5,Rebounds,16,13,11,8
Al Horford,C-F,22023,201143,22300421,"DEC 28, 2023",BOS vs. DET,W,37,3,4,0.75,2,3,0.667,0,0,0.0,2,3,5,3,1,1,1,1,8,10,1,BOS,BOS,DET,128,12.5,Pts+Rebs,16,13,11,8
Al Horford,C-F,22023,201143,22300421,"DEC 28, 2023",BOS vs. DET,W,37,3,4,0.75,2,3,0.667,0,0,0.0,2,3,5,3,1,1,1,1,8,10,1,BOS,BOS,DET,128,0.5,Blocked Shots,16,13,11,8
Al Horford,C-F,22023,201143,22300421,"DEC 28, 2023",BOS vs. DET,W,37,3,4,0.75,2,3,0.667,0,0,0.0,2,3,5,3,1,1,1,1,8,10,1,BOS,BOS,DET,128,8.0,Rebs+Asts,16,13,11,8
Al Horford,C-F,22023,201143,22300421,"DEC 28, 2023",BOS vs. DET,W,37,3,4,0.75,2,3,0.667,0,0,0.0,2,3,5,3,1,1,1,1,8,10,1,BOS,BOS,DET,128,0.5,Turnovers,16,13,11,8
Al Horford,C-F,22023,201143,22300362,"DEC 19, 2023",BOS @ GSW,L,38,4,14,0.286,3,10,0.3,2,2,1.0,2,10,12,6,0,1,2,1,13,-8,1,BOS,GSW,BOS,126,6.5,Points,31,25,19,18
Al Horford,C-F,22023,201143,22300362,"DEC 19, 2023",BOS @ GSW,L,38,4,14,0.286,3,10,0.3,2,2,1.0,2,10,12,6,0,1,2,1,13,-8,1,BOS,GSW,BOS,126,5.5,Rebounds,31,25,19,18
Al Horford,C-F,22023,201143,22300362,"DEC 19, 2023",BOS @ GSW,L,38,4,14,0.286,3,10,0.3,2,2,1.0,2,10,12,6,0,1,2,1,13,-8,1,BOS,GSW,BOS,126,12.5,Pts+Rebs,31,25,19,18
Al Horford,C-F,22023,201143,22300362,"DEC 19, 2023",BOS @ GSW,L,38,4,14,0.286,3,10,0.3,2,2,1.0,2,10,12,6,0,1,2,1,13,-8,1,BOS,GSW,BOS,126,0.5,Blocked Shots,31,25,19,18
Al Horford,C-F,22023,201143,22300362,"DEC 19, 2023",BOS @ GSW,L,38,4,14,0.286,3,10,0.3,2,2,1.0,2,10,12,6,0,1,2,1,13,-8,1,BOS,GSW,BOS,126,8.0,Rebs+Asts,31,25,19,18
Al Horford,C-F,22023,201143,22300362,"DEC 19, 2023",BOS @ GSW,L,38,4,14,0.286,3,10,0.3,2,2,1.0,2,10,12,6,0,1,2,1,13,-8,1,BOS,GSW,BOS,126,0.5,Turnovers,31,25,19,18
Al Horford,C-F,22023,201143,22300136,"NOV 04, 2023",BOS @ BKN,W,30,4,7,0.571,0,3,0.0,0,0,0.0,2,5,7,3,1,1,0,1,8,29,1,BOS,BKN,BOS,124,6.5,Points,18,15,11,10
Al Horford,C-F,22023,201143,22300136,"NOV 04, 2023",BOS @ BKN,W,30,4,7,0.571,0,3,0.0,0,0,0.0,2,5,7,3,1,1,0,1,8,29,1,BOS,BKN,BOS,124,5.5,Rebounds,18,15,11,10
Al Horford,C-F,22023,201143,22300136,"NOV 04, 2023",BOS @ BKN,W,30,4,7,0.571,0,3,0.0,0,0,0.0,2,5,7,3,1,1,0,1,8,29,1,BOS,BKN,BOS,124,12.5,Pts+Rebs,18,15,11,10
Al Horford,C-F,22023,201143,22300136,"NOV 04, 2023",BOS @ BKN,W,30,4,7,0.571,0,3,0.0,0,0,0.0,2,5,7,3,1,1,0,1,8,29,1,BOS,BKN,BOS,124,0.5,Blocked Shots,18,15,11,10
Al Horford,C-F,22023,201143,22300136,"NOV 04, 2023",BOS @ BKN,W,30,4,7,0.571,0,3,0.0,0,0,0.0,2,5,7,3,1,1,0,1,8,29,1,BOS,BKN,BOS,124,8.0,Rebs+Asts,18,15,11,10
Al Horford,C-F,22023,201143,22300136,"NOV 04, 2023",BOS @ BKN,W,30,4,7,0.571,0,3,0.0,0,0,0.0,2,5,7,3,1,1,0,1,8,29,1,BOS,BKN,BOS,124,0.5,Turnovers,18,15,11,10
Al Horford,C-F,22023,201143,22300080,"OCT 27, 2023",BOS vs. MIA,W,25,0,6,0.0,0,2,0.0,0,0,0.0,3,7,10,2,0,1,3,1,0,7,1,BOS,BOS,MIA,119,6.5,Points,12,10,2,12
Al Horford,C-F,22023,201143,22300080,"OCT 27, 2023",BOS vs. MIA,W,25,0,6,0.0,0,2,0.0,0,0,0.0,3,7,10,2,0,1,3,1,0,7,1,BOS,BOS,MIA,119,5.5,Rebounds,12,10,2,12
Al Horford,C-F,22023,201143,22300080,"OCT 27, 2023",BOS vs. MIA,W,25,0,6,0.0,0,2,0.0,0,0,0.0,3,7,10,2,0,1,3,1,0,7,1,BOS,BOS,MIA,119,12.5,Pts+Rebs,12,10,2,12
Al Horford,C-F,22023,201143,22300080,"OCT 27, 2023",BOS vs. MIA,W,25,0,6,0.0,0,2,0.0,0,0,0.0,3,7,10,2,0,1,3,1,0,7,1,BOS,BOS,MIA,119,0.5,Blocked Shots,12,10,2,12
Al Horford,C-F,22023,201143,22300080,"OCT 27, 2023",BOS vs. MIA,W,25,0,6,0.0,0,2,0.0,0,0,0.0,3,7,10,2,0,1,3,1,0,7,1,BOS,BOS,MIA,119,8.0,Rebs+Asts,12,10,2,12
Al Horford,C-F,22023,201143,22300080,"OCT 27, 2023",BOS vs. MIA,W,25,0,6,0.0,0,2,0.0,0,0,0.0,3,7,10,2,0,1,3,1,0,7,1,BOS,BOS,MIA,119,0.5,Turnovers,12,10,2,12
Al Horford,C-F,22023,201143,22300743,"FEB 09, 2024",BOS vs. WAS,W,23,2,5,0.4,1,2,0.5,1,2,0.5,2,3,5,1,2,0,0,1,6,7,1,BOS,BOS,WAS,133,6.5,Points,12,11,7,6
Al Horford,C-F,22023,201143,22300743,"FEB 09, 2024",BOS vs. WAS,W,23,2,5,0.4,1,2,0.5,1,2,0.5,2,3,5,1,2,0,0,1,6,7,1,BOS,BOS,WAS,133,5.5,Rebounds,12,11,7,6
Al Horford,C-F,22023,201143,22300743,"FEB 09, 2024",BOS vs. WAS,W,23,2,5,0.4,1,2,0.5,1,2,0.5,2,3,5,1,2,0,0,1,6,7,1,BOS,BOS,WAS,133,12.5,Pts+Rebs,12,11,7,6
Al Horford,C-F,22023,201143,22300743,"FEB 09, 2024",BOS vs. WAS,W,23,2,5,0.4,1,2,0.5,1,2,0.5,2,3,5,1,2,0,0,1,6,7,1,BOS,BOS,WAS,133,0.5,Blocked Shots,12,11,7,6
Al Horford,C-F,22023,201143,22300743,"FEB 09, 2024",BOS vs. WAS,W,23,2,5,0.4,1,2,0.5,1,2,0.5,2,3,5,1,2,0,0,1,6,7,1,BOS,BOS,WAS,133,8.0,Rebs+Asts,12,11,7,6
Al Horford,C-F,22023,201143,22300743,"FEB 09, 2024",BOS vs. WAS,W,23,2,5,0.4,1,2,0.5,1,2,0.5,2,3,5,1,2,0,0,1,6,7,1,BOS,BOS,WAS,133,0.5,Turnovers,12,11,7,6
Al Horford,C-F,22023,201143,22300611,"JAN 22, 2024",BOS @ DAL,W,31,4,7,0.571,3,6,0.5,0,0,0.0,1,5,6,3,1,0,1,2,11,8,1,BOS,DAL,BOS,119,6.5,Points,20,17,14,9
Al Horford,C-F,22023,201143,22300611,"JAN 22, 2024",BOS @ DAL,W,31,4,7,0.571,3,6,0.5,0,0,0.0,1,5,6,3,1,0,1,2,11,8,1,BOS,DAL,BOS,119,5.5,Rebounds,20,17,14,9
Al Horford,C-F,22023,201143,22300611,"JAN 22, 2024",BOS @ DAL,W,31,4,7,0.571,3,6,0.5,0,0,0.0,1,5,6,3,1,0,1,2,11,8,1,BOS,DAL,BOS,119,12.5,Pts+Rebs,20,17,14,9
Al Horford,C-F,22023,201143,22300611,"JAN 22, 2024",BOS @ DAL,W,31,4,7,0.571,3,6,0.5,0,0,0.0,1,5,6,3,1,0,1,2,11,8,1,BOS,DAL,BOS,119,0.5,Blocked Shots,20,17,14,9
Al Horford,C-F,22023,201143,22300611,"JAN 22, 2024",BOS @ DAL,W,31,4,7,0.571,3,6,0.5,0,0,0.0,1,5,6,3,1,0,1,2,11,8,1,BOS,DAL,BOS,119,8.0,Rebs+Asts,20,17,14,9
Al Horford,C-F,22023,201143,22300611,"JAN 22, 2024",BOS @ DAL,W,31,4,7,0.571,3,6,0.5,0,0,0.0,1,5,6,3,1,0,1,2,11,8,1,BOS,DAL,BOS,119,0.5,Turnovers,20,17,14,9
Al Horford,C-F,22023,201143,22300586,"JAN 19, 2024",BOS vs. DEN,L,27,2,5,0.4,2,5,0.4,0,0,0.0,3,7,10,2,0,0,0,3,6,4,1,BOS,BOS,DEN,100,6.5,Points,18,16,8,12
Al Horford,C-F,22023,201143,22300586,"JAN 19, 2024",BOS vs. DEN,L,27,2,5,0.4,2,5,0.4,0,0,0.0,3,7,10,2,0,0,0,3,6,4,1,BOS,BOS,DEN,100,5.5,Rebounds,18,16,8,12
Al Horford,C-F,22023,201143,22300586,"JAN 19, 2024",BOS vs. DEN,L,27,2,5,0.4,2,5,0.4,0,0,0.0,3,7,10,2,0,0,0,3,6,4,1,BOS,BOS,DEN,100,12.5,Pts+Rebs,18,16,8,12
Al Horford,C-F,22023,201143,22300586,"JAN 19, 2024",BOS vs. DEN,L,27,2,5,0.4,2,5,0.4,0,0,0.0,3,7,10,2,0,0,0,3,6,4,1,BOS,BOS,DEN,100,0.5,Blocked Shots,18,16,8,12
Al Horford,C-F,22023,201143,22300586,"JAN 19, 2024",BOS vs. DEN,L,27,2,5,0.4,2,5,0.4,0,0,0.0,3,7,10,2,0,0,0,3,6,4,1,BOS,BOS,DEN,100,8.0,Rebs+Asts,18,16,8,12
Al Horford,C-F,22023,201143,22300586,"JAN 19, 2024",BOS vs. DEN,L,27,2,5,0.4,2,5,0.4,0,0,0.0,3,7,10,2,0,0,0,3,6,4,1,BOS,BOS,DEN,100,0.5,Turnovers,18,16,8,12
Al Horford,C-F,22023,201143,22300462,"JAN 02, 2024",BOS @ OKC,L,20,3,5,0.6,1,3,0.333,0,0,0.0,0,2,2,3,1,5,0,0,7,-13,1,BOS,OKC,BOS,123,6.5,Points,12,9,10,5
Al Horford,C-F,22023,201143,22300462,"JAN 02, 2024",BOS @ OKC,L,20,3,5,0.6,1,3,0.333,0,0,0.0,0,2,2,3,1,5,0,0,7,-13,1,BOS,OKC,BOS,123,5.5,Rebounds,12,9,10,5
Al Horford,C-F,22023,201143,22300462,"JAN 02, 2024",BOS @ OKC,L,20,3,5,0.6,1,3,0.333,0,0,0.0,0,2,2,3,1,5,0,0,7,-13,1,BOS,OKC,BOS,123,12.5,Pts+Rebs,12,9,10,5
Al Horford,C-F,22023,201143,22300462,"JAN 02, 2024",BOS @ OKC,L,20,3,5,0.6,1,3,0.333,0,0,0.0,0,2,2,3,1,5,0,0,7,-13,1,BOS,OKC,BOS,123,0.5,Blocked Shots,12,9,10,5
Al Horford,C-F,22023,201143,22300462,"JAN 02, 2024",BOS @ OKC,L,20,3,5,0.6,1,3,0.333,0,0,0.0,0,2,2,3,1,5,0,0,7,-13,1,BOS,OKC,BOS,123,8.0,Rebs+Asts,12,9,10,5
Al Horford,C-F,22023,201143,22300462,"JAN 02, 2024",BOS @ OKC,L,20,3,5,0.6,1,3,0.333,0,0,0.0,0,2,2,3,1,5,0,0,7,-13,1,BOS,OKC,BOS,123,0.5,Turnovers,12,9,10,5
Al Horford,C-F,22023,201143,22300403,"DEC 25, 2023",BOS @ LAL,W,23,2,4,0.5,2,4,0.5,0,0,0.0,0,6,6,1,0,1,0,3,6,1,1,BOS,LAL,BOS,126,6.5,Points,13,12,7,7
Al Horford,C-F,22023,201143,22300403,"DEC 25, 2023",BOS @ LAL,W,23,2,4,0.5,2,4,0.5,0,0,0.0,0,6,6,1,0,1,0,3,6,1,1,BOS,LAL,BOS,126,5.5,Rebounds,13,12,7,7
Al Horford,C-F,22023,201143,22300403,"DEC 25, 2023",BOS @ LAL,W,23,2,4,0.5,2,4,0.5,0,0,0.0,0,6,6,1,0,1,0,3,6,1,1,BOS,LAL,BOS,126,12.5,Pts+Rebs,13,12,7,7
Al Horford,C-F,22023,201143,22300403,"DEC 25, 2023",BOS @ LAL,W,23,2,4,0.5,2,4,0.5,0,0,0.0,0,6,6,1,0,1,0,3,6,1,1,BOS,LAL,BOS,126,0.5,Blocked Shots,13,12,7,7
Al Horford,C-F,22023,201143,22300403,"DEC 25, 2023",BOS @ LAL,W,23,2,4,0.5,2,4,0.5,0,0,0.0,0,6,6,1,0,1,0,3,6,1,1,BOS,LAL,BOS,126,8.0,Rebs+Asts,13,12,7,7
Al Horford,C-F,22023,201143,22300403,"DEC 25, 2023",BOS @ LAL,W,23,2,4,0.5,2,4,0.5,0,0,0.0,0,6,6,1,0,1,0,3,6,1,1,BOS,LAL,BOS,126,0.5,Turnovers,13,12,7,7
Al Horford,C-F,22023,201143,22300319,"DEC 14, 2023",BOS vs. CLE,W,24,3,4,0.75,1,2,0.5,0,0,0.0,3,7,10,3,0,1,0,1,7,9,1,BOS,BOS,CLE,116,6.5,Points,20,17,10,13
Al Horford,C-F,22023,201143,22300319,"DEC 14, 2023",BOS vs. CLE,W,24,3,4,0.75,1,2,0.5,0,0,0.0,3,7,10,3,0,1,0,1,7,9,1,BOS,BOS,CLE,116,5.5,Rebounds,20,17,10,13
Al Horford,C-F,22023,201143,22300319,"DEC 14, 2023",BOS vs. CLE,W,24,3,4,0.75,1,2,0.5,0,0,0.0,3,7,10,3,0,1,0,1,7,9,1,BOS,BOS,CLE,116,12.5,Pts+Rebs,20,17,10,13
Al Horford,C-F,22023,201143,22300319,"DEC 14, 2023",BOS vs. CLE,W,24,3,4,0.75,1,2,0.5,0,0,0.0,3,7,10,3,0,1,0,1,7,9,1,BOS,BOS,CLE,116,0.5,Blocked Shots,20,17,10,13
Al Horford,C-F,22023,201143,22300319,"DEC 14, 2023",BOS vs. CLE,W,24,3,4,0.75,1,2,0.5,0,0,0.0,3,7,10,3,0,1,0,1,7,9,1,BOS,BOS,CLE,116,8.0,Rebs+Asts,20,17,10,13
Al Horford,C-F,22023,201143,22300319,"DEC 14, 2023",BOS vs. CLE,W,24,3,4,0.75,1,2,0.5,0,0,0.0,3,7,10,3,0,1,0,1,7,9,1,BOS,BOS,CLE,116,0.5,Turnovers,20,17,10,13
Al Horford,C-F,22023,201143,22300305,"DEC 12, 2023",BOS vs. CLE,W,22,1,3,0.333,0,2,0.0,0,0,0.0,2,3,5,1,1,0,0,0,2,13,1,BOS,BOS,CLE,120,6.5,Points,8,7,3,6
Al Horford,C-F,22023,201143,22300305,"DEC 12, 2023",BOS vs. CLE,W,22,1,3,0.333,0,2,0.0,0,0,0.0,2,3,5,1,1,0,0,0,2,13,1,BOS,BOS,CLE,120,5.5,Rebounds,8,7,3,6
Al Horford,C-F,22023,201143,22300305,"DEC 12, 2023",BOS vs. CLE,W,22,1,3,0.333,0,2,0.0,0,0,0.0,2,3,5,1,1,0,0,0,2,13,1,BOS,BOS,CLE,120,12.5,Pts+Rebs,8,7,3,6
Al Horford,C-F,22023,201143,22300305,"DEC 12, 2023",BOS vs. CLE,W,22,1,3,0.333,0,2,0.0,0,0,0.0,2,3,5,1,1,0,0,0,2,13,1,BOS,BOS,CLE,120,0.5,Blocked Shots,8,7,3,6
Al Horford,C-F,22023,201143,22300305,"DEC 12, 2023",BOS vs. CLE,W,22,1,3,0.333,0,2,0.0,0,0,0.0,2,3,5,1,1,0,0,0,2,13,1,BOS,BOS,CLE,120,8.0,Rebs+Asts,8,7,3,6
Al Horford,C-F,22023,201143,22300305,"DEC 12, 2023",BOS vs. CLE,W,22,1,3,0.333,0,2,0.0,0,0,0.0,2,3,5,1,1,0,0,0,2,13,1,BOS,BOS,CLE,120,0.5,Turnovers,8,7,3,6
Al Horford,C-F,22023,201143,22300228,"NOV 22, 2023",BOS vs. MIL,W,31,4,7,0.571,2,3,0.667,1,1,1.0,1,7,8,6,0,1,0,1,11,5,1,BOS,BOS,MIL,119,6.5,Points,25,19,17,14
Al Horford,C-F,22023,201143,22300228,"NOV 22, 2023",BOS vs. MIL,W,31,4,7,0.571,2,3,0.667,1,1,1.0,1,7,8,6,0,1,0,1,11,5,1,BOS,BOS,MIL,119,5.5,Rebounds,25,19,17,14
Al Horford,C-F,22023,201143,22300228,"NOV 22, 2023",BOS vs. MIL,W,31,4,7,0.571,2,3,0.667,1,1,1.0,1,7,8,6,0,1,0,1,11,5,1,BOS,BOS,MIL,119,12.5,Pts+Rebs,25,19,17,14
Al Horford,C-F,22023,201143,22300228,"NOV 22, 2023",BOS vs. MIL,W,31,4,7,0.571,2,3,0.667,1,1,1.0,1,7,8,6,0,1,0,1,11,5,1,BOS,BOS,MIL,119,0.5,Blocked Shots,25,19,17,14
Al Horford,C-F,22023,201143,22300228,"NOV 22, 2023",BOS vs. MIL,W,31,4,7,0.571,2,3,0.667,1,1,1.0,1,7,8,6,0,1,0,1,11,5,1,BOS,BOS,MIL,119,8.0,Rebs+Asts,25,19,17,14
Al Horford,C-F,22023,201143,22300228,"NOV 22, 2023",BOS vs. MIL,W,31,4,7,0.571,2,3,0.667,1,1,1.0,1,7,8,6,0,1,0,1,11,5,1,BOS,BOS,MIL,119,0.5,Turnovers,25,19,17,14
Al Horford,C-F,22023,201143,22300213,"NOV 19, 2023",BOS @ MEM,W,22,2,5,0.4,1,3,0.333,0,0,0.0,2,1,3,2,0,0,0,2,5,2,1,BOS,MEM,BOS,102,6.5,Points,10,8,7,5
Al Horford,C-F,22023,201143,22300213,"NOV 19, 2023",BOS @ MEM,W,22,2,5,0.4,1,3,0.333,0,0,0.0,2,1,3,2,0,0,0,2,5,2,1,BOS,MEM,BOS,102,5.5,Rebounds,10,8,7,5
Al Horford,C-F,22023,201143,22300213,"NOV 19, 2023",BOS @ MEM,W,22,2,5,0.4,1,3,0.333,0,0,0.0,2,1,3,2,0,0,0,2,5,2,1,BOS,MEM,BOS,102,12.5,Pts+Rebs,10,8,7,5
Al Horford,C-F,22023,201143,22300213,"NOV 19, 2023",BOS @ MEM,W,22,2,5,0.4,1,3,0.333,0,0,0.0,2,1,3,2,0,0,0,2,5,2,1,BOS,MEM,BOS,102,0.5,Blocked Shots,10,8,7,5
Al Horford,C-F,22023,201143,22300213,"NOV 19, 2023",BOS @ MEM,W,22,2,5,0.4,1,3,0.333,0,0,0.0,2,1,3,2,0,0,0,2,5,2,1,BOS,MEM,BOS,102,8.0,Rebs+Asts,10,8,7,5
Al Horford,C-F,22023,201143,22300213,"NOV 19, 2023",BOS @ MEM,W,22,2,5,0.4,1,3,0.333,0,0,0.0,2,1,3,2,0,0,0,2,5,2,1,BOS,MEM,BOS,102,0.5,Turnovers,10,8,7,5
Al Horford,C-F,22023,201143,22300031,"NOV 17, 2023",BOS @ TOR,W,23,4,5,0.8,3,4,0.75,0,0,0.0,1,3,4,2,0,0,0,1,11,-3,1,BOS,TOR,BOS,108,6.5,Points,17,15,13,6
Al Horford,C-F,22023,201143,22300031,"NOV 17, 2023",BOS @ TOR,W,23,4,5,0.8,3,4,0.75,0,0,0.0,1,3,4,2,0,0,0,1,11,-3,1,BOS,TOR,BOS,108,5.5,Rebounds,17,15,13,6
Al Horford,C-F,22023,201143,22300031,"NOV 17, 2023",BOS @ TOR,W,23,4,5,0.8,3,4,0.75,0,0,0.0,1,3,4,2,0,0,0,1,11,-3,1,BOS,TOR,BOS,108,12.5,Pts+Rebs,17,15,13,6
Al Horford,C-F,22023,201143,22300031,"NOV 17, 2023",BOS @ TOR,W,23,4,5,0.8,3,4,0.75,0,0,0.0,1,3,4,2,0,0,0,1,11,-3,1,BOS,TOR,BOS,108,0.5,Blocked Shots,17,15,13,6
Al Horford,C-F,22023,201143,22300031,"NOV 17, 2023",BOS @ TOR,W,23,4,5,0.8,3,4,0.75,0,0,0.0,1,3,4,2,0,0,0,1,11,-3,1,BOS,TOR,BOS,108,8.0,Rebs+Asts,17,15,13,6
Al Horford,C-F,22023,201143,22300031,"NOV 17, 2023",BOS @ TOR,W,23,4,5,0.8,3,4,0.75,0,0,0.0,1,3,4,2,0,0,0,1,11,-3,1,BOS,TOR,BOS,108,0.5,Turnovers,17,15,13,6
Al Horford,C-F,22023,201143,22300188,"NOV 13, 2023",BOS vs. NYK,W,22,1,2,0.5,0,1,0.0,0,0,0.0,0,4,4,0,0,0,1,2,2,2,1,BOS,BOS,NYK,114,6.5,Points,6,6,2,4
Al Horford,C-F,22023,201143,22300188,"NOV 13, 2023",BOS vs. NYK,W,22,1,2,0.5,0,1,0.0,0,0,0.0,0,4,4,0,0,0,1,2,2,2,1,BOS,BOS,NYK,114,5.5,Rebounds,6,6,2,4
Al Horford,C-F,22023,201143,22300188,"NOV 13, 2023",BOS vs. NYK,W,22,1,2,0.5,0,1,0.0,0,0,0.0,0,4,4,0,0,0,1,2,2,2,1,BOS,BOS,NYK,114,12.5,Pts+Rebs,6,6,2,4
Al Horford,C-F,22023,201143,22300188,"NOV 13, 2023",BOS vs. NYK,W,22,1,2,0.5,0,1,0.0,0,0,0.0,0,4,4,0,0,0,1,2,2,2,1,BOS,BOS,NYK,114,0.5,Blocked Shots,6,6,2,4
Al Horford,C-F,22023,201143,22300188,"NOV 13, 2023",BOS vs. NYK,W,22,1,2,0.5,0,1,0.0,0,0,0.0,0,4,4,0,0,0,1,2,2,2,1,BOS,BOS,NYK,114,8.0,Rebs+Asts,6,6,2,4
Al Horford,C-F,22023,201143,22300188,"NOV 13, 2023",BOS vs. NYK,W,22,1,2,0.5,0,1,0.0,0,0,0.0,0,4,4,0,0,0,1,2,2,2,1,BOS,BOS,NYK,114,0.5,Turnovers,6,6,2,4
Al Horford,C-F,22023,201143,22300159,"NOV 08, 2023",BOS @ PHI,L,26,1,6,0.167,1,6,0.167,0,0,0.0,0,5,5,3,0,2,1,1,3,-23,1,BOS,PHI,BOS,103,6.5,Points,11,8,6,8
Al Horford,C-F,22023,201143,22300159,"NOV 08, 2023",BOS @ PHI,L,26,1,6,0.167,1,6,0.167,0,0,0.0,0,5,5,3,0,2,1,1,3,-23,1,BOS,PHI,BOS,103,5.5,Rebounds,11,8,6,8
Al Horford,C-F,22023,201143,22300159,"NOV 08, 2023",BOS @ PHI,L,26,1,6,0.167,1,6,0.167,0,0,0.0,0,5,5,3,0,2,1,1,3,-23,1,BOS,PHI,BOS,103,12.5,Pts+Rebs,11,8,6,8
Al Horford,C-F,22023,201143,22300159,"NOV 08, 2023",BOS @ PHI,L,26,1,6,0.167,1,6,0.167,0,0,0.0,0,5,5,3,0,2,1,1,3,-23,1,BOS,PHI,BOS,103,0.5,Blocked Shots,11,8,6,8
Al Horford,C-F,22023,201143,22300159,"NOV 08, 2023",BOS @ PHI,L,26,1,6,0.167,1,6,0.167,0,0,0.0,0,5,5,3,0,2,1,1,3,-23,1,BOS,PHI,BOS,103,8.0,Rebs+Asts,11,8,6,8
Al Horford,C-F,22023,201143,22300159,"NOV 08, 2023",BOS @ PHI,L,26,1,6,0.167,1,6,0.167,0,0,0.0,0,5,5,3,0,2,1,1,3,-23,1,BOS,PHI,BOS,103,0.5,Turnovers,11,8,6,8
Al Horford,C-F,22023,201143,22300154,"NOV 06, 2023",BOS @ MIN,L,36,1,5,0.2,1,4,0.25,0,0,0.0,2,3,5,4,1,0,2,4,3,7,1,BOS,MIN,BOS,109,6.5,Points,12,8,7,9
Al Horford,C-F,22023,201143,22300154,"NOV 06, 2023",BOS @ MIN,L,36,1,5,0.2,1,4,0.25,0,0,0.0,2,3,5,4,1,0,2,4,3,7,1,BOS,MIN,BOS,109,5.5,Rebounds,12,8,7,9
Al Horford,C-F,22023,201143,22300154,"NOV 06, 2023",BOS @ MIN,L,36,1,5,0.2,1,4,0.25,0,0,0.0,2,3,5,4,1,0,2,4,3,7,1,BOS,MIN,BOS,109,12.5,Pts+Rebs,12,8,7,9
Al Horford,C-F,22023,201143,22300154,"NOV 06, 2023",BOS @ MIN,L,36,1,5,0.2,1,4,0.25,0,0,0.0,2,3,5,4,1,0,2,4,3,7,1,BOS,MIN,BOS,109,0.5,Blocked Shots,12,8,7,9
Al Horford,C-F,22023,201143,22300154,"NOV 06, 2023",BOS @ MIN,L,36,1,5,0.2,1,4,0.25,0,0,0.0,2,3,5,4,1,0,2,4,3,7,1,BOS,MIN,BOS,109,8.0,Rebs+Asts,12,8,7,9
Al Horford,C-F,22023,201143,22300154,"NOV 06, 2023",BOS @ MIN,L,36,1,5,0.2,1,4,0.25,0,0,0.0,2,3,5,4,1,0,2,4,3,7,1,BOS,MIN,BOS,109,0.5,Turnovers,12,8,7,9
Al Horford,C-F,22023,201143,22300065,"OCT 25, 2023",BOS @ NYK,W,26,3,4,0.75,2,3,0.667,0,0,0.0,3,4,7,2,0,0,3,2,8,-7,1,BOS,NYK,BOS,108,6.5,Points,17,15,10,9
Al Horford,C-F,22023,201143,22300065,"OCT 25, 2023",BOS @ NYK,W,26,3,4,0.75,2,3,0.667,0,0,0.0,3,4,7,2,0,0,3,2,8,-7,1,BOS,NYK,BOS,108,5.5,Rebounds,17,15,10,9
Al Horford,C-F,22023,201143,22300065,"OCT 25, 2023",BOS @ NYK,W,26,3,4,0.75,2,3,0.667,0,0,0.0,3,4,7,2,0,0,3,2,8,-7,1,BOS,NYK,BOS,108,12.5,Pts+Rebs,17,15,10,9
Al Horford,C-F,22023,201143,22300065,"OCT 25, 2023",BOS @ NYK,W,26,3,4,0.75,2,3,0.667,0,0,0.0,3,4,7,2,0,0,3,2,8,-7,1,BOS,NYK,BOS,108,0.5,Blocked Shots,17,15,10,9
Al Horford,C-F,22023,201143,22300065,"OCT 25, 2023",BOS @ NYK,W,26,3,4,0.75,2,3,0.667,0,0,0.0,3,4,7,2,0,0,3,2,8,-7,1,BOS,NYK,BOS,108,8.0,Rebs+Asts,17,15,10,9
Al Horford,C-F,22023,201143,22300065,"OCT 25, 2023",BOS @ NYK,W,26,3,4,0.75,2,3,0.667,0,0,0.0,3,4,7,2,0,0,3,2,8,-7,1,BOS,NYK,BOS,108,0.5,Turnovers,17,15,10,9
Kevin Knox II,F,22023,1628995,22300534,"JAN 12, 2024",DET vs. HOU,L,35,7,9,0.778,2,4,0.5,3,3,1.0,0,7,7,2,1,2,1,1,19,-1,1,DET,DET,HOU,110,,,28,26,21,9
Kevin Knox II,F,22023,1628995,22300453,"JAN 01, 2024",DET @ HOU,L,23,4,7,0.571,1,4,0.25,2,2,1.0,0,3,3,0,0,0,0,2,11,-5,1,DET,HOU,DET,113,,,14,14,11,3
Kevin Knox II,F,22023,1628995,22300394,"DEC 23, 2023",DET @ BKN,L,24,5,6,0.833,3,3,1.0,1,1,1.0,0,1,1,0,0,0,0,2,14,-11,1,DET,BKN,DET,115,,,15,15,14,1
Kevin Knox II,F,22023,1628995,22300334,"DEC 16, 2023",DET @ MIL,L,9,0,2,0.0,0,1,0.0,0,0,0.0,0,0,0,0,1,0,0,2,0,0,1,DET,MIL,DET,114,,,0,0,0,0
Kevin Knox II,F,22023,1628995,22301217,"DEC 08, 2023",DET @ ORL,L,5,0,0,0.0,0,0,0.0,0,0,0.0,0,1,1,0,0,0,1,0,0,-3,1,DET,ORL,DET,91,,,1,1,0,1
Kevin Knox II,F,22023,1628995,22300268,"NOV 30, 2023",DET @ NYK,L,9,1,3,0.333,0,2,0.0,1,1,1.0,0,0,0,0,0,0,2,1,3,-10,1,DET,NYK,DET,112,,,3,3,3,0
Kevin Knox II,F,22023,1628995,22300258,"NOV 29, 2023",DET vs. LAL,L,6,1,1,1.0,1,1,1.0,0,0,0.0,0,0,0,0,0,0,0,0,3,4,1,DET,DET,LAL,107,,,3,3,3,0
Kevin Knox II,F,22023,1628995,22300211,"NOV 19, 2023",DET @ TOR,L,26,2,11,0.182,1,5,0.2,1,2,0.5,1,3,4,0,1,0,2,3,6,-22,1,DET,TOR,DET,113,,,10,10,6,4
Kevin Knox II,F,22023,1628995,22300030,"NOV 17, 2023",DET @ CLE,L,31,5,10,0.5,1,4,0.25,0,0,0.0,3,7,10,1,2,1,0,3,11,15,1,DET,CLE,DET,100,,,22,21,12,11
Kevin Knox II,F,22023,1628995,22300018,"NOV 14, 2023",DET vs. ATL,L,29,5,8,0.625,2,4,0.5,0,0,0.0,1,3,4,1,0,0,2,3,12,-6,1,DET,DET,ATL,120,,,17,16,13,5
Kevin Knox II,F,22023,1628995,22300181,"NOV 12, 2023",DET @ CHI,L,24,7,8,0.875,4,5,0.8,0,0,0.0,0,3,3,1,1,0,0,2,18,-3,1,DET,CHI,DET,108,,,22,21,19,4
Kevin Knox II,F,22023,1628995,22300704,"FEB 04, 2024",DET vs. ORL,L,13,0,3,0.0,0,2,0.0,0,0,0.0,0,1,1,1,0,0,1,1,0,1,1,DET,DET,ORL,99,,,2,1,1,2
Kevin Knox II,F,22023,1628995,22300688,"FEB 02, 2024",DET vs. LAC,L,18,0,2,0.0,0,2,0.0,0,0,0.0,0,1,1,2,1,0,1,3,0,16,1,DET,DET,LAC,125,,,3,1,2,3
Kevin Knox II,F,22023,1628995,22300675,"JAN 31, 2024",DET @ CLE,L,20,5,9,0.556,1,3,0.333,1,1,1.0,2,3,5,0,0,0,2,1,12,4,1,DET,CLE,DET,121,,,17,17,12,5
Kevin Knox II,F,22023,1628995,22300654,"JAN 28, 2024",DET vs. OKC,W,14,3,5,0.6,0,0,0.0,0,0,0.0,1,2,3,1,1,0,2,3,6,4,1,DET,DET,OKC,120,,,10,9,7,4
Kevin Knox II,F,22023,1628995,22300642,"JAN 27, 2024",DET vs. WAS,L,11,1,3,0.333,0,2,0.0,2,2,1.0,0,0,0,0,0,0,0,1,4,-10,1,DET,DET,WAS,104,,,4,4,4,0
Kevin Knox II,F,22023,1628995,22300619,"JAN 24, 2024",DET vs. CHA,W,13,0,4,0.0,0,2,0.0,0,0,0.0,0,4,4,0,0,0,0,0,0,6,1,DET,DET,CHA,113,,,4,4,0,4
Kevin Knox II,F,22023,1628995,22300606,"JAN 22, 2024",DET vs. MIL,L,9,2,3,0.667,0,1,0.0,0,0,0.0,0,2,2,0,0,0,0,3,4,-6,1,DET,DET,MIL,113,,,6,6,4,2
Kevin Knox II,F,22023,1628995,22300592,"JAN 20, 2024",DET vs. MIL,L,16,1,5,0.2,1,2,0.5,0,0,0.0,0,3,3,0,1,0,0,3,3,-22,1,DET,DET,MIL,135,,,6,6,3,3
Kevin Knox II,F,22023,1628995,22300569,"JAN 17, 2024",DET vs. MIN,L,21,2,3,0.667,1,2,0.5,0,0,0.0,0,1,1,2,0,0,1,2,5,-13,1,DET,DET,MIN,117,,,8,6,7,3
Kevin Knox II,F,22023,1628995,22300519,"JAN 10, 2024",DET vs. SAS,L,24,5,11,0.455,2,5,0.4,0,0,0.0,3,1,4,0,0,0,0,2,12,-17,1,DET,DET,SAS,108,,,16,16,12,4
Kevin Knox II,F,22023,1628995,22300512,"JAN 09, 2024",DET vs. SAC,L,20,3,8,0.375,1,4,0.25,1,1,1.0,1,1,2,1,1,0,2,1,8,-5,1,DET,DET,SAC,110,,,11,10,9,3
Kevin Knox II,F,22023,1628995,22300502,"JAN 07, 2024",DET @ DEN,L,20,4,8,0.5,1,3,0.333,3,4,0.75,2,1,3,1,0,0,0,0,12,-13,1,DET,DEN,DET,114,,,16,15,13,4
Kevin Knox II,F,22023,1628995,22300490,"JAN 05, 2024",DET @ GSW,L,23,7,13,0.538,4,8,0.5,0,0,0.0,0,1,1,3,1,2,0,3,18,-6,1,DET,GSW,DET,109,,,22,19,21,4
Kevin Knox II,F,22023,1628995,22300474,"JAN 03, 2024",DET @ UTA,L,13,2,5,0.4,0,2,0.0,0,0,0.0,1,0,1,2,0,0,0,1,4,6,1,DET,UTA,DET,148,,,7,5,6,3
Kevin Knox II,F,22023,1628995,22300440,"DEC 30, 2023",DET vs. TOR,W,31,7,14,0.5,3,8,0.375,0,0,0.0,0,2,2,2,1,1,1,2,17,1,1,DET,DET,TOR,129,,,21,19,19,4
Kevin Knox II,F,22023,1628995,22300421,"DEC 28, 2023",DET @ BOS,L,18,3,9,0.333,0,6,0.0,0,0,0.0,0,2,2,0,1,0,0,3,6,9,1,DET,BOS,DET,122,,,8,8,6,2
Kevin Knox II,F,22023,1628995,22300406,"DEC 26, 2023",DET vs. BKN,L,12,1,4,0.25,0,1,0.0,1,1,1.0,1,2,3,0,0,0,1,2,3,-11,1,DET,DET,BKN,112,,,6,6,3,3
Kevin Knox II,F,22023,1628995,22300310,"DEC 13, 2023",DET vs. PHI,L,10,2,5,0.4,1,4,0.25,2,2,1.0,0,2,2,2,0,1,2,0,7,8,1,DET,DET,PHI,111,,,11,9,9,4
Kevin Knox II,F,22023,1628995,22300293,"DEC 11, 2023",DET vs. IND,L,1,0,0,0.0,0,0,0.0,0,0,0.0,0,0,0,0,0,0,0,0,0,-2,1,DET,DET,IND,123,,,0,0,0,0
Kevin Knox II,F,22023,1628995,22300558,"JAN 15, 2024",DET @ WAS,W,33,1,7,0.143,1,4,0.25,2,2,1.0,2,0,2,1,0,0,1,0,5,7,1,DET,WAS,DET,129,,,8,7,6,3
Precious Achiuwa,F,22023,1630173,22300755,"FEB 10, 2024",NYK vs. IND,L,43,6,6,1.0,1,1,1.0,2,2,1.0,3,3,6,0,2,3,2,2,15,-12,1,NYK,NYK,IND,111,,,21,21,15,6
Precious Achiuwa,F,22023,1630173,22300736,"FEB 08, 2024",NYK vs. DAL,L,41,6,9,0.667,1,2,0.5,0,0,0.0,3,13,16,3,0,1,3,5,13,-14,1,NYK,NYK,DAL,108,,,32,29,16,19
Precious Achiuwa,F,22023,1630173,22300722,"FEB 06, 2024",NYK vs. MEM,W,40,8,13,0.615,1,2,0.5,0,0,0.0,2,3,5,3,3,1,0,2,17,-1,1,NYK,NYK,MEM,121,,,25,22,20,8
Precious Achiuwa,F,22023,1630173,22300701,"FEB 03, 2024",NYK vs. LAL,L,42,4,11,0.364,0,3,0.0,2,2,1.0,4,4,8,0,0,1,1,2,10,-10,1,NYK,NYK,LAL,105,,,18,18,10,8
Precious Achiuwa,F,22023,1630173,22300685,"FEB 01, 2024",NYK vs. IND,W,43,5,16,0.313,0,3,0.0,2,4,0.5,8,8,16,0,4,2,2,4,12,7,1,NYK,NYK,IND,109,,,28,28,12,16
Precious Achiuwa,F,22023,1630173,22300671,"JAN 30, 2024",NYK vs. UTA,W,40,8,13,0.615,0,3,0.0,2,2,1.0,1,4,5,1,0,2,0,3,18,14,1,NYK,NYK,UTA,118,,,24,23,19,6
Precious Achiuwa,F,22023,1630173,22300657,"JAN 29, 2024",NYK @ CHA,W,33,4,6,0.667,1,1,1.0,0,0,0.0,1,4,5,0,0,1,0,4,9,21,1,NYK,CHA,NYK,113,,,14,14,9,5
Precious Achiuwa,F,22023,1630173,22300643,"JAN 27, 2024",NYK vs. MIA,W,31,2,7,0.286,0,0,0.0,0,0,0.0,3,7,10,1,1,2,0,2,4,19,1,NYK,NYK,MIA,125,,,15,14,5,11
Precious Achiuwa,F,22023,1630173,22300631,"JAN 25, 2024",NYK vs. DEN,W,23,1,4,0.25,0,0,0.0,0,0,0.0,6,4,10,3,0,1,0,1,2,18,1,NYK,NYK,DEN,122,,,15,12,5,13
Precious Achiuwa,F,22023,1630173,22300615,"JAN 23, 2024",NYK @ BKN,W,21,3,6,0.5,0,1,0.0,0,0,0.0,4,5,9,2,0,0,0,1,6,13,1,NYK,BKN,NYK,108,,,17,15,8,11
Precious Achiuwa,F,22023,1630173,22300596,"JAN 20, 2024",NYK vs. TOR,W,25,9,10,0.9,0,0,0.0,0,0,0.0,4,7,11,0,0,1,3,4,18,13,1,NYK,NYK,TOR,126,,,29,29,18,11
Precious Achiuwa,F,22023,1630173,22300579,"JAN 18, 2024",NYK vs. WAS,W,9,1,1,1.0,0,0,0.0,0,0,0.0,0,1,1,0,1,0,0,1,2,-4,1,NYK,NYK,WAS,113,,,3,3,2,1
Precious Achiuwa,F,22023,1630173,22300573,"JAN 17, 2024",NYK vs. HOU,W,6,0,2,0.0,0,0,0.0,0,0,0.0,1,3,4,0,0,1,0,3,0,2,1,NYK,NYK,HOU,109,,,4,4,0,4
Precious Achiuwa,F,22023,1630173,22300557,"JAN 15, 2024",NYK vs. ORL,L,20,2,4,0.5,0,0,0.0,2,2,1.0,3,2,5,1,0,1,1,0,6,-4,1,NYK,NYK,ORL,94,,,12,11,7,6
Precious Achiuwa,F,22023,1630173,22300544,"JAN 13, 2024",NYK @ MEM,W,6,0,0,0.0,0,0,0.0,0,0,0.0,1,0,1,0,0,1,1,0,0,5,1,NYK,MEM,NYK,106,,,1,1,0,1
Precious Achiuwa,F,22023,1630173,22300530,"JAN 11, 2024",NYK @ DAL,L,16,3,3,1.0,0,0,0.0,1,2,0.5,1,5,6,0,1,0,2,4,7,3,1,NYK,DAL,NYK,124,,,13,13,7,6
Precious Achiuwa,F,22023,1630173,22300514,"JAN 09, 2024",NYK vs. POR,W,20,1,9,0.111,0,3,0.0,0,0,0.0,5,4,9,1,1,1,1,0,2,-3,1,NYK,NYK,POR,112,,,12,11,3,10
Precious Achiuwa,F,22023,1630173,22300494,"JAN 06, 2024",NYK @ WAS,W,8,1,1,1.0,0,0,0.0,0,0,0.0,0,0,0,0,0,0,0,1,2,-11,1,NYK,WAS,NYK,121,,,2,2,2,0
Precious Achiuwa,F,22023,1630173,22300483,"JAN 05, 2024",NYK @ PHI,W,13,2,3,0.667,1,2,0.5,0,0,0.0,2,1,3,0,0,1,1,0,5,10,1,NYK,PHI,NYK,128,,,8,8,5,3
Precious Achiuwa,F,22023,1630173,22300468,"JAN 03, 2024",NYK vs. CHI,W,11,2,2,1.0,0,0,0.0,0,0,0.0,2,1,3,1,0,1,0,2,4,-16,1,NYK,NYK,CHI,116,,,8,7,5,4
Precious Achiuwa,F,22023,1630173,22300451,"JAN 01, 2024",NYK vs. MIN,W,9,0,2,0.0,0,0,0.0,0,0,0.0,1,2,3,0,0,0,0,2,0,-3,1,NYK,NYK,MIN,112,,,3,3,0,3
Precious Achiuwa,F,22023,1630173,22300432,"DEC 29, 2023",TOR @ BOS,L,2,0,1,0.0,0,0,0.0,0,0,0.0,0,2,2,0,0,0,0,0,0,1,1,TOR,BOS,TOR,118,,,2,2,0,2
Precious Achiuwa,F,22023,1630173,22300416,"DEC 27, 2023",TOR @ WAS,W,11,1,2,0.5,0,0,0.0,1,2,0.5,0,1,1,0,1,1,1,0,3,5,1,TOR,WAS,TOR,132,,,4,4,3,1
Precious Achiuwa,F,22023,1630173,22300395,"DEC 23, 2023",TOR vs. UTA,L,21,3,7,0.429,0,3,0.0,2,2,1.0,1,1,2,1,0,2,0,1,8,-3,1,TOR,TOR,UTA,119,,,11,10,9,3
Precious Achiuwa,F,22023,1630173,22300382,"DEC 22, 2023",TOR @ PHI,L,16,2,9,0.222,0,2,0.0,0,2,0.0,3,3,6,1,2,0,1,2,4,-1,1,TOR,PHI,TOR,111,,,11,10,5,7
Precious Achiuwa,F,22023,1630173,22300369,"DEC 20, 2023",TOR vs. DEN,L,25,6,10,0.6,1,2,0.5,0,1,0.0,4,1,5,1,1,1,1,2,13,6,1,TOR,TOR,DEN,104,,,19,18,14,6
Precious Achiuwa,F,22023,1630173,22300354,"DEC 18, 2023",TOR vs. CHA,W,18,5,9,0.556,0,1,0.0,2,4,0.5,5,2,7,1,1,0,0,1,12,12,1,TOR,TOR,CHA,114,,,20,19,13,8
Precious Achiuwa,F,22023,1630173,22300330,"DEC 15, 2023",TOR vs. ATL,L,17,4,7,0.571,0,2,0.0,1,2,0.5,0,2,2,5,0,0,0,1,9,-9,1,TOR,TOR,ATL,104,,,16,11,14,7
Precious Achiuwa,F,22023,1630173,22300313,"DEC 13, 2023",TOR vs. ATL,W,17,2,5,0.4,1,3,0.333,2,2,1.0,1,6,7,1,1,2,2,0,7,-5,1,TOR,TOR,ATL,135,,,15,14,8,8
Precious Achiuwa,F,22023,1630173,22300297,"DEC 11, 2023",TOR @ NYK,L,21,3,8,0.375,1,4,0.25,2,2,1.0,0,5,5,3,1,0,1,4,9,-1,1,TOR,NYK,TOR,130,,,17,14,12,8
Precious Achiuwa,F,22023,1630173,22301216,"DEC 08, 2023",TOR @ CHA,L,22,7,10,0.7,3,4,0.75,0,0,0.0,4,6,10,1,0,0,4,4,17,5,1,TOR,CHA,TOR,116,,,28,27,18,11
Precious Achiuwa,F,22023,1630173,22301207,"DEC 06, 2023",TOR vs. MIA,L,13,4,7,0.571,1,3,0.333,0,0,0.0,0,3,3,2,1,0,1,0,9,-4,1,TOR,TOR,MIA,103,,,14,12,11,5
Precious Achiuwa,F,22023,1630173,22300276,"DEC 01, 2023",TOR vs. NYK,L,17,4,11,0.364,0,1,0.0,0,0,0.0,5,1,6,1,0,0,1,2,8,-22,1,TOR,TOR,NYK,106,,,15,14,9,7
Precious Achiuwa,F,22023,1630173,22300260,"NOV 29, 2023",TOR vs. PHX,W,18,5,10,0.5,1,1,1.0,3,4,0.75,6,4,10,1,2,0,1,2,14,6,1,TOR,TOR,PHX,112,,,25,24,15,11
Precious Achiuwa,F,22023,1630173,22300054,"NOV 28, 2023",TOR @ BKN,L,10,0,4,0.0,0,2,0.0,1,4,0.25,1,2,3,1,1,0,1,3,1,-2,1,TOR,BKN,TOR,103,,,5,4,2,4
Precious Achiuwa,F,22023,1630173,22300251,"NOV 26, 2023",TOR @ CLE,L,13,1,4,0.25,1,2,0.5,1,4,0.25,0,2,2,1,1,0,0,0,4,-15,1,TOR,CLE,TOR,102,,,7,6,5,3
Precious Achiuwa,F,22023,1630173,22300046,"NOV 24, 2023",TOR vs. CHI,W,18,3,4,0.75,0,0,0.0,2,2,1.0,3,4,7,4,0,3,2,0,8,-2,1,TOR,TOR,CHI,121,,,19,15,12,11
Precious Achiuwa,F,22023,1630173,22300038,"NOV 21, 2023",TOR @ ORL,L,15,2,4,0.5,0,1,0.0,1,2,0.5,2,4,6,4,1,0,3,3,5,-9,1,TOR,ORL,TOR,107,,,15,11,9,10
Precious Achiuwa,F,22023,1630173,22300211,"NOV 19, 2023",TOR vs. DET,W,19,5,10,0.5,2,4,0.5,0,2,0.0,3,3,6,5,0,0,0,1,12,17,1,TOR,TOR,DET,142,,,23,18,17,11
Precious Achiuwa,F,22023,1630173,22300031,"NOV 17, 2023",TOR vs. BOS,L,24,2,4,0.5,0,2,0.0,1,2,0.5,0,9,9,1,2,0,1,1,5,-2,1,TOR,TOR,BOS,105,,,15,14,6,10
Precious Achiuwa,F,22023,1630173,22300195,"NOV 15, 2023",TOR vs. MIL,L,17,4,7,0.571,1,2,0.5,2,2,1.0,3,1,4,0,0,2,1,3,11,-3,1,TOR,TOR,MIL,112,,,15,15,11,4
Precious Achiuwa,F,22023,1630173,22300189,"NOV 13, 2023",TOR vs. WAS,W,19,5,8,0.625,0,1,0.0,0,0,0.0,1,3,4,1,1,0,2,1,10,8,1,TOR,TOR,WAS,111,,,15,14,11,5
Precious Achiuwa,F,22023,1630173,22300174,"NOV 11, 2023",TOR @ BOS,L,19,1,5,0.2,0,2,0.0,0,0,0.0,0,5,5,5,0,0,0,1,2,-12,1,TOR,BOS,TOR,94,,,12,7,7,10
Precious Achiuwa,F,22023,1630173,22300092,"OCT 28, 2023",TOR vs. PHI,L,18,3,10,0.3,0,1,0.0,0,0,0.0,3,4,7,3,0,1,1,1,6,5,1,TOR,TOR,PHI,107,,,16,13,9,10
Precious Achiuwa,F,22023,1630173,22300082,"OCT 27, 2023",TOR @ CHI,L,23,2,5,0.4,1,3,0.333,3,3,1.0,2,7,9,1,0,0,3,6,8,-22,1,TOR,CHI,TOR,103,,,18,17,9,10
Precious Achiuwa,F,22023,1630173,22300069,"OCT 25, 2023",TOR vs. MIN,W,24,4,9,0.444,0,1,0.0,0,0,0.0,3,5,8,0,0,0,2,1,8,-5,1,TOR,TOR,MIN,97,,,16,16,8,8
Precious Achiuwa,F,22023,1630173,22300755,"FEB 10, 2024",NYK vs. IND,L,43,6,6,1.0,1,1,1.0,2,2,1.0,3,3,6,0,2,3,2,2,15,-12,1,NYK,NYK,IND,111,,,21,21,15,6
Precious Achiuwa,F,22023,1630173,22300736,"FEB 08, 2024",NYK vs. DAL,L,41,6,9,0.667,1,2,0.5,0,0,0.0,3,13,16,3,0,1,3,5,13,-14,1,NYK,NYK,DAL,108,,,32,29,16,19
Precious Achiuwa,F,22023,1630173,22300722,"FEB 06, 2024",NYK vs. MEM,W,40,8,13,0.615,1,2,0.5,0,0,0.0,2,3,5,3,3,1,0,2,17,-1,1,NYK,NYK,MEM,121,,,25,22,20,8
Precious Achiuwa,F,22023,1630173,22300701,"FEB 03, 2024",NYK vs. LAL,L,42,4,11,0.364,0,3,0.0,2,2,1.0,4,4,8,0,0,1,1,2,10,-10,1,NYK,NYK,LAL,105,,,18,18,10,8
Precious Achiuwa,F,22023,1630173,22300685,"FEB 01, 2024",NYK vs. IND,W,43,5,16,0.313,0,3,0.0,2,4,0.5,8,8,16,0,4,2,2,4,12,7,1,NYK,NYK,IND,109,,,28,28,12,16
Precious Achiuwa,F,22023,1630173,22300671,"JAN 30, 2024",NYK vs. UTA,W,40,8,13,0.615,0,3,0.0,2,2,1.0,1,4,5,1,0,2,0,3,18,14,1,NYK,NYK,UTA,118,,,24,23,19,6
Precious Achiuwa,F,22023,1630173,22300657,"JAN 29, 2024",NYK @ CHA,W,33,4,6,0.667,1,1,1.0,0,0,0.0,1,4,5,0,0,1,0,4,9,21,1,NYK,CHA,NYK,113,,,14,14,9,5
Precious Achiuwa,F,22023,1630173,22300643,"JAN 27, 2024",NYK vs. MIA,W,31,2,7,0.286,0,0,0.0,0,0,0.0,3,7,10,1,1,2,0,2,4,19,1,NYK,NYK,MIA,125,,,15,14,5,11
Precious Achiuwa,F,22023,1630173,22300631,"JAN 25, 2024",NYK vs. DEN,W,23,1,4,0.25,0,0,0.0,0,0,0.0,6,4,10,3,0,1,0,1,2,18,1,NYK,NYK,DEN,122,,,15,12,5,13
Precious Achiuwa,F,22023,1630173,22300615,"JAN 23, 2024",NYK @ BKN,W,21,3,6,0.5,0,1,0.0,0,0,0.0,4,5,9,2,0,0,0,1,6,13,1,NYK,BKN,NYK,108,,,17,15,8,11
Precious Achiuwa,F,22023,1630173,22300596,"JAN 20, 2024",NYK vs. TOR,W,25,9,10,0.9,0,0,0.0,0,0,0.0,4,7,11,0,0,1,3,4,18,13,1,NYK,NYK,TOR,126,,,29,29,18,11
Precious Achiuwa,F,22023,1630173,22300579,"JAN 18, 2024",NYK vs. WAS,W,9,1,1,1.0,0,0,0.0,0,0,0.0,0,1,1,0,1,0,0,1,2,-4,1,NYK,NYK,WAS,113,,,3,3,2,1
Precious Achiuwa,F,22023,1630173,22300573,"JAN 17, 2024",NYK vs. HOU,W,6,0,2,0.0,0,0,0.0,0,0,0.0,1,3,4,0,0,1,0,3,0,2,1,NYK,NYK,HOU,109,,,4,4,0,4
Precious Achiuwa,F,22023,1630173,22300557,"JAN 15, 2024",NYK vs. ORL,L,20,2,4,0.5,0,0,0.0,2,2,1.0,3,2,5,1,0,1,1,0,6,-4,1,NYK,NYK,ORL,94,,,12,11,7,6
Precious Achiuwa,F,22023,1630173,22300544,"JAN 13, 2024",NYK @ MEM,W,6,0,0,0.0,0,0,0.0,0,0,0.0,1,0,1,0,0,1,1,0,0,5,1,NYK,MEM,NYK,106,,,1,1,0,1
Precious Achiuwa,F,22023,1630173,22300530,"JAN 11, 2024",NYK @ DAL,L,16,3,3,1.0,0,0,0.0,1,2,0.5,1,5,6,0,1,0,2,4,7,3,1,NYK,DAL,NYK,124,,,13,13,7,6
Precious Achiuwa,F,22023,1630173,22300514,"JAN 09, 2024",NYK vs. POR,W,20,1,9,0.111,0,3,0.0,0,0,0.0,5,4,9,1,1,1,1,0,2,-3,1,NYK,NYK,POR,112,,,12,11,3,10
Precious Achiuwa,F,22023,1630173,22300494,"JAN 06, 2024",NYK @ WAS,W,8,1,1,1.0,0,0,0.0,0,0,0.0,0,0,0,0,0,0,0,1,2,-11,1,NYK,WAS,NYK,121,,,2,2,2,0
Precious Achiuwa,F,22023,1630173,22300483,"JAN 05, 2024",NYK @ PHI,W,13,2,3,0.667,1,2,0.5,0,0,0.0,2,1,3,0,0,1,1,0,5,10,1,NYK,PHI,NYK,128,,,8,8,5,3
Precious Achiuwa,F,22023,1630173,22300468,"JAN 03, 2024",NYK vs. CHI,W,11,2,2,1.0,0,0,0.0,0,0,0.0,2,1,3,1,0,1,0,2,4,-16,1,NYK,NYK,CHI,116,,,8,7,5,4
Precious Achiuwa,F,22023,1630173,22300451,"JAN 01, 2024",NYK vs. MIN,W,9,0,2,0.0,0,0,0.0,0,0,0.0,1,2,3,0,0,0,0,2,0,-3,1,NYK,NYK,MIN,112,,,3,3,0,3
Precious Achiuwa,F,22023,1630173,22300432,"DEC 29, 2023",TOR @ BOS,L,2,0,1,0.0,0,0,0.0,0,0,0.0,0,2,2,0,0,0,0,0,0,1,1,TOR,BOS,TOR,118,,,2,2,0,2
Precious Achiuwa,F,22023,1630173,22300416,"DEC 27, 2023",TOR @ WAS,W,11,1,2,0.5,0,0,0.0,1,2,0.5,0,1,1,0,1,1,1,0,3,5,1,TOR,WAS,TOR,132,,,4,4,3,1
Precious Achiuwa,F,22023,1630173,22300395,"DEC 23, 2023",TOR vs. UTA,L,21,3,7,0.429,0,3,0.0,2,2,1.0,1,1,2,1,0,2,0,1,8,-3,1,TOR,TOR,UTA,119,,,11,10,9,3
Precious Achiuwa,F,22023,1630173,22300382,"DEC 22, 2023",TOR @ PHI,L,16,2,9,0.222,0,2,0.0,0,2,0.0,3,3,6,1,2,0,1,2,4,-1,1,TOR,PHI,TOR,111,,,11,10,5,7
Precious Achiuwa,F,22023,1630173,22300369,"DEC 20, 2023",TOR vs. DEN,L,25,6,10,0.6,1,2,0.5,0,1,0.0,4,1,5,1,1,1,1,2,13,6,1,TOR,TOR,DEN,104,,,19,18,14,6
Precious Achiuwa,F,22023,1630173,22300354,"DEC 18, 2023",TOR vs. CHA,W,18,5,9,0.556,0,1,0.0,2,4,0.5,5,2,7,1,1,0,0,1,12,12,1,TOR,TOR,CHA,114,,,20,19,13,8
Precious Achiuwa,F,22023,1630173,22300330,"DEC 15, 2023",TOR vs. ATL,L,17,4,7,0.571,0,2,0.0,1,2,0.5,0,2,2,5,0,0,0,1,9,-9,1,TOR,TOR,ATL,104,,,16,11,14,7
Precious Achiuwa,F,22023,1630173,22300313,"DEC 13, 2023",TOR vs. ATL,W,17,2,5,0.4,1,3,0.333,2,2,1.0,1,6,7,1,1,2,2,0,7,-5,1,TOR,TOR,ATL,135,,,15,14,8,8
Precious Achiuwa,F,22023,1630173,22300297,"DEC 11, 2023",TOR @ NYK,L,21,3,8,0.375,1,4,0.25,2,2,1.0,0,5,5,3,1,0,1,4,9,-1,1,TOR,NYK,TOR,130,,,17,14,12,8
Precious Achiuwa,F,22023,1630173,22301216,"DEC 08, 2023",TOR @ CHA,L,22,7,10,0.7,3,4,0.75,0,0,0.0,4,6,10,1,0,0,4,4,17,5,1,TOR,CHA,TOR,116,,,28,27,18,11
Precious Achiuwa,F,22023,1630173,22301207,"DEC 06, 2023",TOR vs. MIA,L,13,4,7,0.571,1,3,0.333,0,0,0.0,0,3,3,2,1,0,1,0,9,-4,1,TOR,TOR,MIA,103,,,14,12,11,5
Precious Achiuwa,F,22023,1630173,22300276,"DEC 01, 2023",TOR vs. NYK,L,17,4,11,0.364,0,1,0.0,0,0,0.0,5,1,6,1,0,0,1,2,8,-22,1,TOR,TOR,NYK,106,,,15,14,9,7
Precious Achiuwa,F,22023,1630173,22300260,"NOV 29, 2023",TOR vs. PHX,W,18,5,10,0.5,1,1,1.0,3,4,0.75,6,4,10,1,2,0,1,2,14,6,1,TOR,TOR,PHX,112,,,25,24,15,11
Precious Achiuwa,F,22023,1630173,22300054,"NOV 28, 2023",TOR @ BKN,L,10,0,4,0.0,0,2,0.0,1,4,0.25,1,2,3,1,1,0,1,3,1,-2,1,TOR,BKN,TOR,103,,,5,4,2,4
Precious Achiuwa,F,22023,1630173,22300251,"NOV 26, 2023",TOR @ CLE,L,13,1,4,0.25,1,2,0.5,1,4,0.25,0,2,2,1,1,0,0,0,4,-15,1,TOR,CLE,TOR,102,,,7,6,5,3
Precious Achiuwa,F,22023,1630173,22300046,"NOV 24, 2023",TOR vs. CHI,W,18,3,4,0.75,0,0,0.0,2,2,1.0,3,4,7,4,0,3,2,0,8,-2,1,TOR,TOR,CHI,121,,,19,15,12,11
Precious Achiuwa,F,22023,1630173,22300038,"NOV 21, 2023",TOR @ ORL,L,15,2,4,0.5,0,1,0.0,1,2,0.5,2,4,6,4,1,0,3,3,5,-9,1,TOR,ORL,TOR,107,,,15,11,9,10
Precious Achiuwa,F,22023,1630173,22300211,"NOV 19, 2023",TOR vs. DET,W,19,5,10,0.5,2,4,0.5,0,2,0.0,3,3,6,5,0,0,0,1,12,17,1,TOR,TOR,DET,142,,,23,18,17,11
Precious Achiuwa,F,22023,1630173,22300031,"NOV 17, 2023",TOR vs. BOS,L,24,2,4,0.5,0,2,0.0,1,2,0.5,0,9,9,1,2,0,1,1,5,-2,1,TOR,TOR,BOS,105,,,15,14,6,10
Precious Achiuwa,F,22023,1630173,22300195,"NOV 15, 2023",TOR vs. MIL,L,17,4,7,0.571,1,2,0.5,2,2,1.0,3,1,4,0,0,2,1,3,11,-3,1,TOR,TOR,MIL,112,,,15,15,11,4
Precious Achiuwa,F,22023,1630173,22300189,"NOV 13, 2023",TOR vs. WAS,W,19,5,8,0.625,0,1,0.0,0,0,0.0,1,3,4,1,1,0,2,1,10,8,1,TOR,TOR,WAS,111,,,15,14,11,5
Precious Achiuwa,F,22023,1630173,22300174,"NOV 11, 2023",TOR @ BOS,L,19,1,5,0.2,0,2,0.0,0,0,0.0,0,5,5,5,0,0,0,1,2,-12,1,TOR,BOS,TOR,94,,,12,7,7,10
Precious Achiuwa,F,22023,1630173,22300092,"OCT 28, 2023",TOR vs. PHI,L,18,3,10,0.3,0,1,0.0,0,0,0.0,3,4,7,3,0,1,1,1,6,5,1,TOR,TOR,PHI,107,,,16,13,9,10
Precious Achiuwa,F,22023,1630173,22300082,"OCT 27, 2023",TOR @ CHI,L,23,2,5,0.4,1,3,0.333,3,3,1.0,2,7,9,1,0,0,3,6,8,-22,1,TOR,CHI,TOR,103,,,18,17,9,10
Precious Achiuwa,F,22023,1630173,22300069,"OCT 25, 2023",TOR vs. MIN,W,24,4,9,0.444,0,1,0.0,0,0,0.0,3,5,8,0,0,0,2,1,8,-5,1,TOR,TOR,MIN,97,,,16,16,8,8
Ziaire Williams,F,22023,1630533,22300652,"JAN 28, 2024",MEM @ IND,L,14,2,6,0.333,0,3,0.0,0,0,0.0,0,3,3,3,0,0,2,1,4,-18,1,MEM,IND,MEM,106,,,10,7,7,6
Ziaire Williams,F,22023,1630533,22300638,"JAN 26, 2024",MEM vs. ORL,W,30,7,10,0.7,3,6,0.5,0,0,0.0,0,4,4,5,2,0,3,3,17,-1,1,MEM,MEM,ORL,107,,,26,21,22,9
Ziaire Williams,F,22023,1630533,22300609,"JAN 22, 2024",MEM @ TOR,W,14,1,3,0.333,1,1,1.0,3,3,1.0,1,1,2,2,0,0,2,3,6,1,1,MEM,TOR,MEM,108,,,10,8,8,4
Ziaire Williams,F,22023,1630533,22300597,"JAN 20, 2024",MEM @ CHI,L,22,2,9,0.222,0,5,0.0,4,4,1.0,1,0,1,1,2,0,1,3,8,-29,1,MEM,CHI,MEM,93,,,10,9,9,2
Ziaire Williams,F,22023,1630533,22300582,"JAN 18, 2024",MEM @ MIN,L,12,1,5,0.2,0,2,0.0,0,0,0.0,0,1,1,2,2,0,2,1,2,-26,1,MEM,MIN,MEM,103,,,5,3,4,3
Ziaire Williams,F,22023,1630533,22300560,"JAN 15, 2024",MEM vs. GSW,W,20,1,6,0.167,1,5,0.2,1,4,0.25,2,1,3,0,1,0,1,2,4,-13,1,MEM,MEM,GSW,116,,,7,7,4,3
Ziaire Williams,F,22023,1630533,22300503,"JAN 07, 2024",MEM @ PHX,W,27,4,10,0.4,1,5,0.2,0,1,0.0,2,2,4,3,2,0,1,4,9,6,1,MEM,PHX,MEM,121,,,16,13,12,7
Ziaire Williams,F,22023,1630533,22300491,"JAN 05, 2024",MEM @ LAL,W,20,6,11,0.545,2,6,0.333,1,1,1.0,0,1,1,1,1,0,2,2,15,10,1,MEM,LAL,MEM,127,,,17,16,16,2
Ziaire Williams,F,22023,1630533,22300470,"JAN 03, 2024",MEM vs. TOR,L,18,7,12,0.583,4,7,0.571,0,0,0.0,2,4,6,0,1,0,0,1,18,-1,1,MEM,MEM,TOR,111,,,24,24,18,6
Ziaire Williams,F,22023,1630533,22300460,"JAN 02, 2024",MEM vs. SAS,W,0,0,0,0.0,0,0,0.0,0,0,0.0,0,0,0,0,0,0,0,0,0,-4,1,MEM,MEM,SAS,106,,,0,0,0,0
Ziaire Williams,F,22023,1630533,22300449,"DEC 31, 2023",MEM vs. SAC,L,5,0,2,0.0,0,0,0.0,0,0,0.0,0,1,1,0,0,0,1,0,0,-6,1,MEM,MEM,SAC,92,,,1,1,0,1
Ziaire Williams,F,22023,1630533,22300438,"DEC 29, 2023",MEM @ LAC,L,6,0,3,0.0,0,2,0.0,0,0,0.0,0,2,2,1,0,0,0,1,0,-3,1,MEM,LAC,MEM,106,,,3,2,1,3
Ziaire Williams,F,22023,1630533,22300410,"DEC 26, 2023",MEM @ NOP,W,12,0,2,0.0,0,2,0.0,2,2,1.0,0,1,1,1,1,1,2,1,2,-7,1,MEM,NOP,MEM,116,,,4,3,3,2
Ziaire Williams,F,22023,1630533,22300393,"DEC 23, 2023",MEM @ ATL,W,23,3,8,0.375,1,3,0.333,1,3,0.333,1,2,3,3,0,0,1,3,8,6,1,MEM,ATL,MEM,125,,,14,11,11,6
Ziaire Williams,F,22023,1630533,22300377,"DEC 21, 2023",MEM vs. IND,W,18,6,9,0.667,3,4,0.75,1,2,0.5,0,1,1,2,1,2,2,2,16,6,1,MEM,MEM,IND,116,,,19,17,18,3
Ziaire Williams,F,22023,1630533,22300360,"DEC 19, 2023",MEM @ NOP,W,18,2,5,0.4,0,3,0.0,0,0,0.0,1,1,2,0,0,0,1,1,4,1,1,MEM,NOP,MEM,115,,,6,6,4,2
Ziaire Williams,F,22023,1630533,22300355,"DEC 18, 2023",MEM @ OKC,L,22,6,12,0.5,2,7,0.286,5,5,1.0,0,7,7,5,0,0,4,3,19,6,1,MEM,OKC,MEM,97,,,31,26,24,12
Ziaire Williams,F,22023,1630533,22300332,"DEC 15, 2023",MEM vs. HOU,L,15,0,1,0.0,0,0,0.0,0,0,0.0,1,3,4,2,0,0,2,1,0,-12,1,MEM,MEM,HOU,96,,,6,4,2,6
Ziaire Williams,F,22023,1630533,22300314,"DEC 13, 2023",MEM @ HOU,L,26,1,8,0.125,0,6,0.0,3,3,1.0,0,4,4,3,0,0,1,2,5,-4,1,MEM,HOU,MEM,104,,,12,9,8,7
Ziaire Williams,F,22023,1630533,22300299,"DEC 11, 2023",MEM vs. DAL,L,16,2,5,0.4,1,3,0.333,0,0,0.0,1,2,3,1,1,0,0,2,5,-4,1,MEM,MEM,DAL,113,,,9,8,6,4
Ziaire Williams,F,22023,1630533,22301221,"DEC 08, 2023",MEM vs. MIN,L,4,2,3,0.667,0,0,0.0,0,0,0.0,0,0,0,0,0,0,0,0,4,0,1,MEM,MEM,MIN,95,,,4,4,4,0
Ziaire Williams,F,22023,1630533,22301206,"DEC 06, 2023",MEM @ DET,W,0,0,0,0.0,0,0,0.0,0,0,0.0,0,0,0,0,0,0,0,0,0,0,1,MEM,DET,MEM,104,,,0,0,0,0
Ziaire Williams,F,22023,1630533,22300277,"DEC 01, 2023",MEM @ DAL,W,10,1,2,0.5,1,1,1.0,0,0,0.0,0,0,0,1,1,0,2,1,3,-8,1,MEM,DAL,MEM,89,,,4,3,4,1
Ziaire Williams,F,22023,1630533,22300261,"NOV 29, 2023",MEM vs. UTA,W,25,6,8,0.75,3,3,1.0,0,0,0.0,2,6,8,0,2,0,2,0,15,8,1,MEM,MEM,UTA,105,,,23,23,15,8
Ziaire Williams,F,22023,1630533,22300249,"NOV 26, 2023",MEM vs. MIN,L,18,4,8,0.5,2,3,0.667,1,2,0.5,0,2,2,1,0,0,2,5,11,-9,1,MEM,MEM,MIN,91,,,14,13,12,3
Ziaire Williams,F,22023,1630533,22300044,"NOV 24, 2023",MEM vs. PHX,L,2,0,1,0.0,0,1,0.0,0,0,0.0,0,0,0,1,0,0,0,1,0,-4,1,MEM,MEM,PHX,89,,,1,0,1,1
Ziaire Williams,F,22023,1630533,22300231,"NOV 22, 2023",MEM @ HOU,L,20,4,10,0.4,2,5,0.4,3,3,1.0,0,2,2,0,0,0,0,2,13,-27,1,MEM,HOU,MEM,91,,,15,15,13,2
Ziaire Williams,F,22023,1630533,22300213,"NOV 19, 2023",MEM vs. BOS,L,24,3,11,0.273,0,4,0.0,0,0,0.0,2,5,7,4,0,0,0,2,6,-5,1,MEM,MEM,BOS,100,,,17,13,10,11
Ziaire Williams,F,22023,1630533,22300206,"NOV 18, 2023",MEM @ SAS,W,25,4,8,0.5,2,3,0.667,7,8,0.875,1,6,7,5,1,0,1,1,17,27,1,MEM,SAS,MEM,120,,,29,24,22,12
Ziaire Williams,F,22023,1630533,22300026,"NOV 14, 2023",MEM @ LAL,L,26,4,16,0.25,2,7,0.286,0,0,0.0,0,1,1,0,1,1,1,3,10,-15,1,MEM,LAL,MEM,107,,,11,11,10,1
Ziaire Williams,F,22023,1630533,22300179,"NOV 12, 2023",MEM @ LAC,W,9,0,4,0.0,0,3,0.0,0,0,0.0,1,0,1,1,0,0,0,1,0,-6,1,MEM,LAC,MEM,105,,,2,1,1,2
Ziaire Williams,F,22023,1630533,22300164,"NOV 08, 2023",MEM vs. MIA,L,21,1,9,0.111,0,5,0.0,0,0,0.0,1,1,2,0,2,0,1,2,2,-10,1,MEM,MEM,MIA,102,,,4,4,2,2
Ziaire Williams,F,22023,1630533,22300144,"NOV 05, 2023",MEM @ POR,W,28,2,4,0.5,1,2,0.5,1,2,0.5,1,6,7,1,0,1,2,2,6,-17,1,MEM,POR,MEM,112,,,14,13,7,8
Ziaire Williams,F,22023,1630533,22300537,"JAN 12, 2024",MEM vs. LAC,L,19,5,12,0.417,3,5,0.6,0,0,0.0,2,1,3,2,0,0,1,2,13,4,1,MEM,MEM,LAC,119,,,18,16,15,5
Ziaire Williams,F,22023,1630533,22300515,"JAN 09, 2024",MEM @ DAL,W,27,6,9,0.667,2,5,0.4,0,0,0.0,1,3,4,0,1,0,1,1,14,12,1,MEM,DAL,MEM,120,,,18,18,14,4
Ziaire Williams,F,22023,1630533,22300425,"DEC 28, 2023",MEM @ DEN,L,24,2,8,0.25,1,3,0.333,2,2,1.0,1,1,2,1,1,1,1,1,7,-16,1,MEM,DEN,MEM,105,,,10,9,8,3
Ziaire Williams,F,22023,1630533,22300007,"NOV 03, 2023",MEM @ POR,L,27,5,8,0.625,1,1,1.0,2,2,1.0,0,6,6,3,1,1,2,6,13,-16,1,MEM,POR,MEM,113,,,22,19,16,9
Ziaire Williams,F,22023,1630533,22300125,"NOV 01, 2023",MEM @ UTA,L,19,2,5,0.4,2,5,0.4,2,2,1.0,1,3,4,0,0,2,1,2,8,-12,1,MEM,UTA,MEM,109,,,12,12,8,4
Ziaire Williams,F,22023,1630533,22300106,"OCT 30, 2023",MEM vs. DAL,L,33,3,8,0.375,2,4,0.5,0,0,0.0,1,6,7,2,1,0,3,2,8,-21,1,MEM,MEM,DAL,110,,,17,15,10,9
Ziaire Williams,F,22023,1630533,22300089,"OCT 28, 2023",MEM @ WAS,L,34,6,14,0.429,4,12,0.333,0,0,0.0,0,10,10,1,0,0,1,2,16,-1,1,MEM,WAS,MEM,106,,,27,26,17,11
Ziaire Williams,F,22023,1630533,22300078,"OCT 27, 2023",MEM vs. DEN,L,31,3,10,0.3,0,3,0.0,5,5,1.0,2,7,9,3,0,0,4,0,11,0,1,MEM,MEM,DEN,104,,,23,20,14,12
Ziaire Williams,F,22023,1630533,22300071,"OCT 25, 2023",MEM vs. NOP,L,29,4,7,0.571,1,3,0.333,0,0,0.0,0,4,4,0,0,0,1,2,9,-8,1,MEM,MEM,NOP,104,,,13,13,9,4
Ziaire Williams,F,22023,1630533,22300621,"JAN 24, 2024",MEM @ MIA,W,17,0,8,0.0,0,4,0.0,0,0,0.0,1,5,6,1,1,0,1,1,0,6,1,MEM,MIA,MEM,90,,,7,6,1,7
Ziaire Williams,F,22023,1630533,22300544,"JAN 13, 2024",MEM vs. NYK,L,20,2,8,0.25,1,4,0.25,5,5,1.0,1,3,4,2,1,0,2,0,10,-9,1,MEM,MEM,NYK,94,,,16,14,12,6
Terance Mann,G-F,22023,1629611,22300731,"FEB 07, 2024",LAC vs. NOP,L,25,2,5,0.4,1,1,1.0,0,0,0.0,2,3,5,1,0,0,2,4,5,-5,1,LAC,LAC,NOP,106,,,11,10,6,6
Terance Mann,G-F,22023,1629611,22300688,"FEB 02, 2024",LAC @ DET,W,24,4,4,1.0,0,0,0.0,4,4,1.0,1,0,1,0,0,0,1,1,12,-20,1,LAC,DET,LAC,136,,,13,13,12,1
Terance Mann,G-F,22023,1629611,22300676,"JAN 31, 2024",LAC @ WAS,W,31,2,6,0.333,0,3,0.0,2,2,1.0,1,2,3,2,0,0,0,1,6,7,1,LAC,WAS,LAC,125,,,11,9,8,5
Terance Mann,G-F,22023,1629611,22300658,"JAN 29, 2024",LAC @ CLE,L,19,2,4,0.5,1,2,0.5,0,0,0.0,0,0,0,1,2,0,0,2,5,-11,1,LAC,CLE,LAC,108,,,6,5,6,1
Terance Mann,G-F,22023,1629611,22300646,"JAN 27, 2024",LAC @ BOS,W,24,6,12,0.5,1,3,0.333,1,2,0.5,3,3,6,3,0,0,0,2,14,27,1,LAC,BOS,LAC,115,,,23,20,17,9
Terance Mann,G-F,22023,1629611,22300637,"JAN 26, 2024",LAC @ TOR,W,29,3,6,0.5,0,1,0.0,0,0,0.0,1,2,3,2,0,0,0,1,6,20,1,LAC,TOR,LAC,127,,,11,9,8,5
Terance Mann,G-F,22023,1629611,22300537,"JAN 12, 2024",LAC @ MEM,W,26,3,8,0.375,1,4,0.25,0,0,0.0,2,3,5,0,0,0,1,0,7,2,1,LAC,MEM,LAC,128,,,12,12,7,5
Terance Mann,G-F,22023,1629611,22300511,"JAN 08, 2024",LAC vs. PHX,W,28,5,9,0.556,3,6,0.5,1,2,0.5,3,2,5,3,0,0,1,2,14,14,1,LAC,LAC,PHX,138,,,22,19,17,8
Terance Mann,G-F,22023,1629611,22300486,"JAN 05, 2024",LAC @ NOP,W,17,2,3,0.667,2,3,0.667,2,2,1.0,1,2,3,1,1,0,0,2,8,11,1,LAC,NOP,LAC,111,,,12,11,9,4
Terance Mann,G-F,22023,1629611,22300458,"JAN 01, 2024",LAC vs. MIA,W,18,5,7,0.714,1,2,0.5,1,1,1.0,1,2,3,0,0,0,1,2,12,8,1,LAC,LAC,MIA,121,,,15,15,12,3
Terance Mann,G-F,22023,1629611,22300389,"DEC 23, 2023",LAC vs. BOS,L,24,0,10,0.0,0,6,0.0,0,0,0.0,1,3,4,3,0,0,0,2,0,-33,1,LAC,LAC,BOS,108,,,7,4,3,7
Terance Mann,G-F,22023,1629611,22300379,"DEC 21, 2023",LAC @ OKC,L,24,2,8,0.25,1,4,0.25,0,0,0.0,0,1,1,1,3,1,1,3,5,-31,1,LAC,OKC,LAC,115,,,7,6,6,2
Terance Mann,G-F,22023,1629611,22300350,"DEC 18, 2023",LAC @ IND,W,28,2,5,0.4,0,3,0.0,0,0,0.0,1,1,2,1,0,1,1,0,4,10,1,LAC,IND,LAC,151,,,7,6,5,3
Terance Mann,G-F,22023,1629611,22300343,"DEC 16, 2023",LAC vs. NYK,W,27,4,8,0.5,2,4,0.5,3,3,1.0,0,1,1,4,0,0,0,1,13,19,1,LAC,LAC,NYK,144,,,18,14,17,5
Terance Mann,G-F,22023,1629611,22300618,"JAN 23, 2024",LAC vs. LAL,W,23,7,10,0.7,2,4,0.5,1,2,0.5,1,0,1,1,1,0,2,4,17,1,1,LAC,LAC,LAL,127,,,19,18,18,2
Terance Mann,G-F,22023,1629611,22300438,"DEC 29, 2023",LAC vs. MEM,W,23,3,10,0.3,0,6,0.0,5,6,0.833,1,2,3,2,1,0,0,1,11,10,1,LAC,LAC,MEM,117,,,16,14,13,5
Terance Mann,G-F,22023,1629611,22300414,"DEC 26, 2023",LAC vs. CHA,W,20,1,4,0.25,0,1,0.0,2,2,1.0,1,0,1,0,0,0,1,2,4,2,1,LAC,LAC,CHA,113,,,5,5,4,1
Terance Mann,G-F,22023,1629611,22300325,"DEC 14, 2023",LAC vs. GSW,W,20,1,5,0.2,0,4,0.0,0,0,0.0,1,2,3,2,1,0,0,1,2,-22,1,LAC,LAC,GSW,121,,,7,5,4,5
Terance Mann,G-F,22023,1629611,22300309,"DEC 12, 2023",LAC vs. SAC,W,30,3,6,0.5,2,3,0.667,2,2,1.0,1,4,5,2,1,0,1,1,10,7,1,LAC,LAC,SAC,117,,,17,15,12,7
Terance Mann,G-F,22023,1629611,22300304,"DEC 11, 2023",LAC vs. POR,W,29,3,6,0.5,1,4,0.25,2,2,1.0,2,1,3,4,0,0,0,2,9,5,1,LAC,LAC,POR,132,,,16,12,13,7
Terance Mann,G-F,22023,1629611,22301225,"DEC 08, 2023",LAC @ UTA,W,30,4,9,0.444,2,5,0.4,0,2,0.0,1,3,4,1,1,1,2,3,10,17,1,LAC,UTA,LAC,117,,,15,14,11,5
Terance Mann,G-F,22023,1629611,22301215,"DEC 06, 2023",LAC vs. DEN,W,20,1,2,0.5,0,0,0.0,0,0,0.0,0,1,1,0,0,0,0,1,2,-16,1,LAC,LAC,DEN,111,,,3,3,2,1
Terance Mann,G-F,22023,1629611,22300280,"DEC 02, 2023",LAC vs. GSW,W,24,1,6,0.167,1,5,0.2,0,0,0.0,1,1,2,2,1,0,0,1,3,-5,1,LAC,LAC,GSW,113,,,7,5,5,4
Terance Mann,G-F,22023,1629611,22300273,"NOV 30, 2023",LAC @ GSW,L,34,4,10,0.4,1,4,0.25,0,0,0.0,3,2,5,1,1,0,2,1,9,13,1,LAC,GSW,LAC,114,,,15,14,10,6
Terance Mann,G-F,22023,1629611,22300264,"NOV 29, 2023",LAC @ SAC,W,31,8,12,0.667,1,3,0.333,1,1,1.0,0,3,3,1,0,0,0,1,18,12,1,LAC,SAC,LAC,131,,,22,21,19,4
Terance Mann,G-F,22023,1629611,22300244,"NOV 25, 2023",LAC vs. DAL,W,32,7,14,0.5,0,4,0.0,3,4,0.75,2,1,3,1,0,1,0,0,17,19,1,LAC,LAC,DAL,107,,,21,20,18,4
Terance Mann,G-F,22023,1629611,22300014,"NOV 10, 2023",LAC @ DAL,L,29,5,8,0.625,1,3,0.333,0,0,0.0,3,3,6,3,0,0,0,4,11,-10,1,LAC,DAL,LAC,126,,,20,17,14,9
Terance Mann,G-F,22023,1629611,22300749,"FEB 10, 2024",LAC vs. DET,W,24,0,3,0.0,0,2,0.0,2,2,1.0,0,3,3,1,0,0,0,2,2,3,1,LAC,LAC,DET,112,,,6,5,3,4
Terance Mann,G-F,22023,1629611,22300716,"FEB 05, 2024",LAC @ ATL,W,21,4,4,1.0,1,1,1.0,0,0,0.0,1,0,1,2,0,0,0,2,9,8,1,LAC,ATL,LAC,149,,,12,10,11,3
Terance Mann,G-F,22023,1629611,22300708,"FEB 04, 2024",LAC @ MIA,W,20,3,5,0.6,1,2,0.5,0,0,0.0,2,3,5,1,0,0,0,1,7,-1,1,LAC,MIA,LAC,103,,,13,12,8,6
Terance Mann,G-F,22023,1629611,22300600,"JAN 21, 2024",LAC vs. BKN,W,26,4,6,0.667,2,3,0.667,3,3,1.0,0,3,3,2,1,0,0,1,13,-4,1,LAC,LAC,BKN,125,,,18,16,15,5
Terance Mann,G-F,22023,1629611,22300568,"JAN 16, 2024",LAC vs. OKC,W,24,3,6,0.5,1,2,0.5,0,0,0.0,2,1,3,4,0,2,1,4,7,5,1,LAC,LAC,OKC,128,,,14,10,11,7
Terance Mann,G-F,22023,1629611,22300553,"JAN 14, 2024",LAC @ MIN,L,19,1,2,0.5,0,1,0.0,0,0,0.0,2,1,3,0,0,0,0,3,2,-6,1,LAC,MIN,LAC,105,,,5,5,2,3
Terance Mann,G-F,22023,1629611,22300526,"JAN 10, 2024",LAC vs. TOR,W,24,5,5,1.0,3,3,1.0,0,0,0.0,2,0,2,1,0,0,1,1,13,6,1,LAC,LAC,TOR,126,,,16,15,14,3
Terance Mann,G-F,22023,1629611,22300505,"JAN 07, 2024",LAC @ LAL,L,25,2,5,0.4,2,3,0.667,0,0,0.0,0,0,0,3,0,0,1,2,6,1,1,LAC,LAL,LAC,103,,,9,6,9,3
Terance Mann,G-F,22023,1629611,22300473,"JAN 03, 2024",LAC @ PHX,W,23,5,8,0.625,2,4,0.5,0,0,0.0,2,1,3,1,2,0,0,1,12,17,1,LAC,PHX,LAC,131,,,16,15,13,4
Terance Mann,G-F,22023,1629611,22300372,"DEC 20, 2023",LAC @ DAL,W,29,3,8,0.375,1,2,0.5,0,0,0.0,1,3,4,1,0,1,1,3,7,1,1,LAC,DAL,LAC,120,,,12,11,8,5
Terance Mann,G-F,22023,1629611,22300235,"NOV 22, 2023",LAC @ SAS,W,23,2,5,0.4,0,3,0.0,2,4,0.5,0,2,2,1,2,1,1,3,6,3,1,LAC,SAS,LAC,109,,,9,8,7,3
Terance Mann,G-F,22023,1629611,22300223,"NOV 20, 2023",LAC @ SAS,W,25,0,6,0.0,0,4,0.0,0,0,0.0,0,6,6,2,4,0,1,0,0,7,1,LAC,SAS,LAC,124,,,8,6,2,8
Terance Mann,G-F,22023,1629611,22300179,"NOV 12, 2023",LAC vs. MEM,L,27,3,7,0.429,1,3,0.333,0,0,0.0,1,2,3,3,0,0,1,2,7,13,1,LAC,LAC,MEM,101,,,13,10,10,6
Terance Mann,G-F,22023,1629611,22300257,"NOV 27, 2023",LAC vs. DEN,L,30,2,3,0.667,0,1,0.0,1,2,0.5,1,2,3,0,0,1,1,2,5,-11,1,LAC,LAC,DEN,104,,,8,8,5,3
Terance Mann,G-F,22023,1629611,22300052,"NOV 24, 2023",LAC vs. NOP,L,24,3,4,0.75,1,1,1.0,0,0,0.0,0,2,2,5,2,1,0,5,7,-4,1,LAC,LAC,NOP,106,,,14,9,12,7
Terance Mann,G-F,22023,1629611,22300037,"NOV 17, 2023",LAC vs. HOU,W,21,0,3,0.0,0,2,0.0,1,2,0.5,1,5,6,3,1,1,0,3,1,15,1,LAC,LAC,HOU,106,,,10,7,4,9
Terance Mann,G-F,22023,1629611,22300024,"NOV 14, 2023",LAC @ DEN,L,28,0,1,0.0,0,0,0.0,0,0,0.0,4,2,6,5,0,0,1,3,0,-3,1,LAC,DEN,LAC,108,,,11,6,5,11
Terance Mann,G-F,22023,1629611,22300160,"NOV 08, 2023",LAC @ BKN,L,19,0,2,0.0,0,2,0.0,0,0,0.0,0,4,4,1,0,0,2,1,0,-2,1,LAC,BKN,LAC,93,,,5,4,1,5
Naji Marshall,F,22023,1630230,22300758,"FEB 10, 2024",NOP @ POR,W,18,4,5,0.8,2,2,1.0,0,0,0.0,1,2,3,1,0,0,1,2,10,-1,1,NOP,POR,NOP,93,,,14,13,11,4
Naji Marshall,F,22023,1630230,22300718,"FEB 05, 2024",NOP vs. TOR,W,19,2,7,0.286,0,2,0.0,4,4,1.0,1,0,1,5,1,0,4,3,8,2,1,NOP,NOP,TOR,138,,,14,9,13,6
Naji Marshall,F,22023,1630230,22300696,"FEB 02, 2024",NOP @ SAS,W,17,1,6,0.167,0,2,0.0,0,0,0.0,1,2,3,2,1,0,1,1,2,-19,1,NOP,SAS,NOP,114,,,7,5,4,5
Naji Marshall,F,22023,1630230,22300679,"JAN 31, 2024",NOP @ HOU,W,31,3,4,0.75,1,1,1.0,3,4,0.75,0,7,7,2,0,1,0,2,10,8,1,NOP,HOU,NOP,110,,,19,17,12,9
Naji Marshall,F,22023,1630230,22300648,"JAN 27, 2024",NOP @ MIL,L,15,3,6,0.5,0,0,0.0,2,6,0.333,1,0,1,1,1,0,1,2,8,-7,1,NOP,MIL,NOP,117,,,10,9,9,2
Naji Marshall,F,22023,1630230,22300640,"JAN 26, 2024",NOP vs. OKC,L,13,0,4,0.0,0,3,0.0,0,0,0.0,0,1,1,0,1,0,1,1,0,-10,1,NOP,NOP,OKC,83,,,1,1,0,1
Naji Marshall,F,22023,1630230,22300616,"JAN 23, 2024",NOP vs. UTA,W,17,1,3,0.333,1,1,1.0,0,0,0.0,1,1,2,4,1,0,1,3,3,12,1,NOP,NOP,UTA,153,,,9,5,7,6
Naji Marshall,F,22023,1630230,22300588,"JAN 19, 2024",NOP vs. PHX,L,13,1,4,0.25,1,2,0.5,2,2,1.0,0,0,0,1,0,0,1,0,5,0,1,NOP,NOP,PHX,109,,,6,5,6,1
Naji Marshall,F,22023,1630230,22300575,"JAN 17, 2024",NOP vs. CHA,W,17,3,5,0.6,0,1,0.0,2,2,1.0,1,1,2,1,1,0,0,0,8,4,1,NOP,NOP,CHA,132,,,11,10,9,3
Naji Marshall,F,22023,1630230,22300547,"JAN 13, 2024",NOP @ DAL,W,31,5,12,0.417,2,4,0.5,1,2,0.5,1,5,6,1,0,0,2,3,13,-7,1,NOP,DAL,NOP,118,,,20,19,14,7
Naji Marshall,F,22023,1630230,22300539,"JAN 12, 2024",NOP @ DEN,L,12,2,5,0.4,0,2,0.0,2,2,1.0,1,1,2,0,0,0,0,0,6,-5,1,NOP,DEN,NOP,113,,,8,8,6,2
Naji Marshall,F,22023,1630230,22300486,"JAN 05, 2024",NOP vs. LAC,L,17,4,9,0.444,1,1,1.0,0,0,0.0,3,0,3,1,1,0,2,2,9,3,1,NOP,NOP,LAC,95,,,13,12,10,4
Naji Marshall,F,22023,1630230,22300471,"JAN 03, 2024",NOP @ MIN,W,14,1,4,0.25,0,2,0.0,0,0,0.0,0,2,2,0,1,0,0,4,2,-10,1,NOP,MIN,NOP,117,,,4,4,2,2
Naji Marshall,F,22023,1630230,22300461,"JAN 02, 2024",NOP vs. BKN,W,16,2,6,0.333,0,2,0.0,2,2,1.0,1,1,2,1,1,1,0,0,6,8,1,NOP,NOP,BKN,112,,,9,8,7,3
Naji Marshall,F,22023,1630230,22300446,"DEC 31, 2023",NOP vs. LAL,W,21,3,8,0.375,0,3,0.0,0,0,0.0,2,3,5,3,0,0,0,2,6,10,1,NOP,NOP,LAL,129,,,14,11,9,8
Naji Marshall,F,22023,1630230,22300424,"DEC 28, 2023",NOP vs. UTA,W,16,4,5,0.8,1,1,1.0,0,0,0.0,0,2,2,2,0,0,3,1,9,4,1,NOP,NOP,UTA,112,,,13,11,11,4
Naji Marshall,F,22023,1630230,22300410,"DEC 26, 2023",NOP vs. MEM,L,14,1,5,0.2,0,3,0.0,0,0,0.0,0,1,1,1,0,0,1,2,2,-6,1,NOP,NOP,MEM,115,,,4,3,3,2
Naji Marshall,F,22023,1630230,22300392,"DEC 23, 2023",NOP vs. HOU,L,12,2,2,1.0,0,0,0.0,2,3,0.667,1,1,2,2,0,0,0,1,6,4,1,NOP,NOP,HOU,104,,,10,8,8,4
Naji Marshall,F,22023,1630230,22300375,"DEC 21, 2023",NOP @ CLE,W,22,4,11,0.364,1,4,0.25,5,7,0.714,3,3,6,3,1,0,1,1,14,16,1,NOP,CLE,NOP,123,,,23,20,17,9
Naji Marshall,F,22023,1630230,22300360,"DEC 19, 2023",NOP vs. MEM,L,17,1,7,0.143,1,4,0.25,0,0,0.0,1,1,2,1,0,0,1,0,3,-11,1,NOP,NOP,MEM,113,,,6,5,4,3
Naji Marshall,F,22023,1630230,22300345,"DEC 17, 2023",NOP @ SAS,W,20,4,6,0.667,3,4,0.75,0,2,0.0,0,3,3,7,2,0,2,3,11,32,1,NOP,SAS,NOP,146,,,21,14,18,10
Naji Marshall,F,22023,1630230,22300326,"DEC 15, 2023",NOP @ CHA,W,13,1,4,0.25,1,2,0.5,0,0,0.0,0,1,1,1,0,0,0,0,3,-11,1,NOP,CHA,NOP,112,,,5,4,4,2
Naji Marshall,F,22023,1630230,22300311,"DEC 13, 2023",NOP @ WAS,W,28,6,11,0.545,2,5,0.4,2,2,1.0,0,4,4,7,2,0,1,1,16,37,1,NOP,WAS,NOP,142,,,27,20,23,11
Naji Marshall,F,22023,1630230,22300301,"DEC 11, 2023",NOP vs. MIN,W,14,2,4,0.5,1,2,0.5,0,0,0.0,0,5,5,1,0,1,1,2,5,-10,1,NOP,NOP,MIN,121,,,11,10,6,6
Naji Marshall,F,22023,1630230,22301230,"DEC 07, 2023",NOP @ LAL,L,12,1,2,0.5,1,1,1.0,2,2,1.0,2,2,4,0,0,0,1,1,5,-17,1,NOP,LAL,NOP,89,,,9,9,5,4
Naji Marshall,F,22023,1630230,22301204,"DEC 04, 2023",NOP @ SAC,W,13,1,3,0.333,0,2,0.0,2,2,1.0,2,2,4,2,1,0,1,1,4,7,1,NOP,SAC,NOP,127,,,10,8,6,6
Naji Marshall,F,22023,1630230,22300285,"DEC 02, 2023",NOP @ CHI,L,27,2,7,0.286,1,4,0.25,2,2,1.0,2,1,3,2,1,0,1,3,7,-8,1,NOP,CHI,NOP,118,,,12,10,9,5
Naji Marshall,F,22023,1630230,22300262,"NOV 29, 2023",NOP vs. PHI,W,19,1,4,0.25,1,3,0.333,1,2,0.5,2,1,3,3,1,1,1,1,4,-3,1,NOP,NOP,PHI,124,,,10,7,7,6
Naji Marshall,F,22023,1630230,22300256,"NOV 27, 2023",NOP @ UTA,L,28,6,12,0.5,1,3,0.333,1,2,0.5,2,7,9,3,3,0,1,3,14,6,1,NOP,UTA,NOP,112,,,26,23,17,12
Naji Marshall,F,22023,1630230,22300243,"NOV 25, 2023",NOP @ UTA,L,21,2,6,0.333,1,2,0.5,0,0,0.0,0,3,3,4,0,0,0,1,5,-2,1,NOP,UTA,NOP,100,,,12,8,9,7
Naji Marshall,F,22023,1630230,22300052,"NOV 24, 2023",NOP @ LAC,W,27,0,7,0.0,0,3,0.0,5,6,0.833,2,6,8,1,0,0,0,1,5,-3,1,NOP,LAC,NOP,116,,,14,13,6,9
Naji Marshall,F,22023,1630230,22300233,"NOV 22, 2023",NOP vs. SAC,W,20,4,5,0.8,2,2,1.0,2,3,0.667,2,4,6,4,1,1,1,0,12,25,1,NOP,NOP,SAC,117,,,22,18,16,10
Naji Marshall,F,22023,1630230,22300222,"NOV 20, 2023",NOP vs. SAC,W,26,5,11,0.455,1,5,0.2,0,0,0.0,1,6,7,4,1,0,3,2,11,2,1,NOP,NOP,SAC,129,,,22,18,15,11
Naji Marshall,F,22023,1630230,22300659,"JAN 29, 2024",NOP @ BOS,L,19,2,3,0.667,0,1,0.0,0,0,0.0,0,4,4,3,1,0,0,0,4,9,1,NOP,BOS,NOP,112,,,11,8,7,7
Naji Marshall,F,22023,1630230,22300556,"JAN 15, 2024",NOP @ DAL,L,9,0,1,0.0,0,0,0.0,0,0,0.0,0,1,1,0,1,0,1,5,0,15,1,NOP,DAL,NOP,120,,,1,1,0,1
Naji Marshall,F,22023,1630230,22300525,"JAN 10, 2024",NOP @ GSW,W,13,5,6,0.833,0,0,0.0,2,2,1.0,0,3,3,2,1,0,1,1,12,1,1,NOP,GSW,NOP,141,,,17,15,14,5
Naji Marshall,F,22023,1630230,22300500,"JAN 07, 2024",NOP @ SAC,W,22,3,4,0.75,1,1,1.0,4,4,1.0,2,4,6,2,0,0,1,2,11,20,1,NOP,SAC,NOP,133,,,19,17,13,8
Naji Marshall,F,22023,1630230,22300278,"DEC 01, 2023",NOP vs. SAS,W,19,3,4,0.75,1,1,1.0,3,3,1.0,2,4,6,0,0,0,2,1,10,5,1,NOP,NOP,SAS,121,,,16,16,10,6
Naji Marshall,F,22023,1630230,22300203,"NOV 18, 2023",NOP vs. MIN,L,24,2,4,0.5,1,2,0.5,2,3,0.667,0,1,1,1,1,0,2,2,7,-7,1,NOP,NOP,MIN,120,,,9,8,8,2
Naji Marshall,F,22023,1630230,22300034,"NOV 17, 2023",NOP vs. DEN,W,18,4,6,0.667,4,5,0.8,0,0,0.0,0,5,5,1,1,0,2,0,12,-1,1,NOP,NOP,DEN,115,,,18,17,13,6
Naji Marshall,F,22023,1630230,22300022,"NOV 14, 2023",NOP vs. DAL,W,21,5,9,0.556,1,4,0.25,5,5,1.0,2,2,4,2,1,2,1,2,16,2,1,NOP,NOP,DAL,131,,,22,20,18,6
Naji Marshall,F,22023,1630230,22300183,"NOV 12, 2023",NOP vs. DAL,L,14,2,3,0.667,1,1,1.0,3,3,1.0,1,1,2,2,0,0,2,2,8,4,1,NOP,NOP,DAL,124,,,12,10,10,4
Day'Ron Sharpe,C,22023,1630549,22300498,"JAN 07, 2024",BKN vs. POR,L,17,4,7,0.571,0,0,0.0,3,4,0.75,3,3,6,2,0,1,0,3,11,-5,1,BKN,BKN,POR,127,,,19,17,13,8
Day'Ron Sharpe,C,22023,1630549,22300481,"JAN 05, 2024",BKN vs. OKC,W,9,1,3,0.333,0,0,0.0,4,4,1.0,1,1,2,2,1,0,0,1,6,-1,1,BKN,BKN,OKC,124,,,10,8,8,4
Day'Ron Sharpe,C,22023,1630549,22300469,"JAN 03, 2024",BKN @ HOU,L,20,4,7,0.571,0,0,0.0,3,6,0.5,4,8,12,1,1,1,1,5,11,-5,1,BKN,HOU,BKN,101,,,24,23,12,13
Day'Ron Sharpe,C,22023,1630549,22300461,"JAN 02, 2024",BKN @ NOP,L,17,6,9,0.667,0,0,0.0,0,0,0.0,3,6,9,2,0,1,1,0,12,-8,1,BKN,NOP,BKN,85,,,23,21,14,11
Day'Ron Sharpe,C,22023,1630549,22300447,"DEC 31, 2023",BKN @ OKC,L,8,1,1,1.0,0,0,0.0,1,2,0.5,1,1,2,0,1,1,0,1,3,6,1,BKN,OKC,BKN,108,,,5,5,3,2
Day'Ron Sharpe,C,22023,1630549,22300430,"DEC 29, 2023",BKN @ WAS,L,18,5,7,0.714,0,0,0.0,0,0,0.0,5,4,9,3,0,0,2,3,10,-10,1,BKN,WAS,BKN,104,,,22,19,13,12
Day'Ron Sharpe,C,22023,1630549,22300417,"DEC 27, 2023",BKN vs. MIL,L,16,5,6,0.833,1,1,1.0,1,2,0.5,2,2,4,4,0,1,0,3,12,2,1,BKN,BKN,MIL,122,,,20,16,16,8
Day'Ron Sharpe,C,22023,1630549,22300406,"DEC 26, 2023",BKN @ DET,W,22,3,4,0.75,0,0,0.0,5,7,0.714,3,8,11,3,2,4,1,1,11,15,1,BKN,DET,BKN,118,,,25,22,14,14
Day'Ron Sharpe,C,22023,1630549,22300394,"DEC 23, 2023",BKN vs. DET,W,18,5,6,0.833,0,0,0.0,1,3,0.333,1,2,3,1,0,0,1,4,11,6,1,BKN,BKN,DET,126,,,15,14,12,4
Day'Ron Sharpe,C,22023,1630549,22300383,"DEC 22, 2023",BKN vs. DEN,L,19,5,8,0.625,0,0,0.0,3,6,0.5,5,5,10,4,2,2,0,2,13,2,1,BKN,BKN,DEN,117,,,27,23,17,14
Day'Ron Sharpe,C,22023,1630549,22300368,"DEC 20, 2023",BKN vs. NYK,L,19,3,7,0.429,0,0,0.0,3,4,0.75,9,6,15,3,1,0,1,4,9,6,1,BKN,BKN,NYK,102,,,27,24,12,18
Day'Ron Sharpe,C,22023,1630549,22300357,"DEC 18, 2023",BKN @ UTA,L,16,3,5,0.6,0,0,0.0,0,1,0.0,3,2,5,0,0,1,1,1,6,6,1,BKN,UTA,BKN,108,,,11,11,6,5
Day'Ron Sharpe,C,22023,1630549,22300339,"DEC 16, 2023",BKN @ GSW,L,9,0,3,0.0,0,0,0.0,0,0,0.0,3,1,4,2,0,2,0,3,0,-2,1,BKN,GSW,BKN,120,,,6,4,2,6
Day'Ron Sharpe,C,22023,1630549,22300322,"DEC 14, 2023",BKN @ DEN,L,26,4,9,0.444,0,1,0.0,0,0,0.0,4,9,13,5,0,1,3,4,8,-8,1,BKN,DEN,BKN,101,,,26,21,13,18
Day'Ron Sharpe,C,22023,1630549,22300317,"DEC 13, 2023",BKN @ PHX,W,8,1,3,0.333,0,1,0.0,1,2,0.5,3,0,3,0,0,0,0,0,3,-6,1,BKN,PHX,BKN,116,,,6,6,3,3
Day'Ron Sharpe,C,22023,1630549,22300303,"DEC 11, 2023",BKN @ SAC,L,14,2,4,0.5,0,0,0.0,0,0,0.0,1,6,7,2,1,1,1,2,4,7,1,BKN,SAC,BKN,118,,,13,11,6,9
Day'Ron Sharpe,C,22023,1630549,22301219,"DEC 08, 2023",BKN vs. WAS,W,20,7,13,0.538,0,0,0.0,1,1,1.0,5,6,11,4,1,1,2,3,15,11,1,BKN,BKN,WAS,124,,,30,26,19,15
Day'Ron Sharpe,C,22023,1630549,22301209,"DEC 06, 2023",BKN @ ATL,W,19,3,5,0.6,0,0,0.0,2,5,0.4,4,6,10,0,0,2,3,4,8,5,1,BKN,ATL,BKN,114,,,18,18,8,10
Day'Ron Sharpe,C,22023,1630549,22300282,"DEC 02, 2023",BKN vs. ORL,W,24,2,2,1.0,0,0,0.0,1,3,0.333,1,5,6,2,0,1,1,3,5,21,1,BKN,BKN,ORL,129,,,13,11,7,8
Day'Ron Sharpe,C,22023,1630549,22300266,"NOV 30, 2023",BKN vs. CHA,L,18,4,5,0.8,0,0,0.0,1,3,0.333,2,3,5,0,1,0,0,3,9,4,1,BKN,BKN,CHA,128,,,14,14,9,5
Day'Ron Sharpe,C,22023,1630549,22300054,"NOV 28, 2023",BKN vs. TOR,W,15,2,4,0.5,0,0,0.0,1,1,1.0,1,4,5,2,0,0,0,2,5,-13,1,BKN,BKN,TOR,115,,,12,10,7,7
Day'Ron Sharpe,C,22023,1630549,22300250,"NOV 26, 2023",BKN vs. CHI,W,27,4,7,0.571,0,2,0.0,1,2,0.5,3,6,9,3,0,1,1,4,9,31,1,BKN,BKN,CHI,118,,,21,18,12,12
Day'Ron Sharpe,C,22023,1630549,22300240,"NOV 25, 2023",BKN vs. MIA,W,12,0,1,0.0,0,0,0.0,4,4,1.0,0,4,4,1,0,2,0,2,4,4,1,BKN,BKN,MIA,112,,,9,8,5,5
Day'Ron Sharpe,C,22023,1630549,22300227,"NOV 22, 2023",BKN @ ATL,L,14,3,6,0.5,0,0,0.0,0,0,0.0,4,3,7,0,2,1,1,2,6,4,1,BKN,ATL,BKN,145,,,13,13,6,7
Day'Ron Sharpe,C,22023,1630549,22300208,"NOV 19, 2023",BKN vs. PHI,L,20,3,3,1.0,0,0,0.0,0,0,0.0,2,6,8,2,0,2,1,1,6,-8,1,BKN,BKN,PHI,99,,,16,14,8,10
Day'Ron Sharpe,C,22023,1630549,22300200,"NOV 16, 2023",BKN @ MIA,L,15,1,6,0.167,0,0,0.0,0,0,0.0,2,3,5,0,0,0,1,0,2,-6,1,BKN,MIA,BKN,115,,,7,7,2,5
Day'Ron Sharpe,C,22023,1630549,22300020,"NOV 14, 2023",BKN vs. ORL,W,24,4,7,0.571,0,0,0.0,3,5,0.6,5,5,10,0,0,1,2,6,11,-2,1,BKN,BKN,ORL,124,,,21,21,11,10
Day'Ron Sharpe,C,22023,1630549,22300178,"NOV 12, 2023",BKN vs. WAS,W,19,3,6,0.5,0,1,0.0,2,2,1.0,7,5,12,1,1,1,1,1,8,-4,1,BKN,BKN,WAS,102,,,21,20,9,13
Day'Ron Sharpe,C,22023,1630549,22300010,"NOV 10, 2023",BKN @ BOS,L,13,1,4,0.25,0,1,0.0,3,4,0.75,0,3,3,1,0,0,2,2,5,5,1,BKN,BOS,BKN,107,,,9,8,6,4
Day'Ron Sharpe,C,22023,1630549,22300160,"NOV 08, 2023",BKN vs. LAC,W,19,4,9,0.444,0,0,0.0,3,3,1.0,4,6,10,0,1,0,2,3,11,7,1,BKN,BKN,LAC,100,,,21,21,11,10
Day'Ron Sharpe,C,22023,1630549,22300149,"NOV 06, 2023",BKN vs. MIL,L,8,2,3,0.667,0,0,0.0,0,0,0.0,0,0,0,0,0,1,0,0,4,-7,1,BKN,BKN,MIL,125,,,4,4,4,0
Day'Ron Sharpe,C,22023,1630549,22300136,"NOV 04, 2023",BKN vs. BOS,L,17,3,4,0.75,0,0,0.0,5,8,0.625,3,4,7,1,0,0,2,3,11,6,1,BKN,BKN,BOS,114,,,19,18,12,8
Day'Ron Sharpe,C,22023,1630549,22300004,"NOV 03, 2023",BKN @ CHI,W,15,3,3,1.0,0,0,0.0,0,1,0.0,1,9,10,0,0,0,0,1,6,8,1,BKN,CHI,BKN,109,,,16,16,6,10
Day'Ron Sharpe,C,22023,1630549,22300119,"NOV 01, 2023",BKN @ MIA,W,13,2,3,0.667,0,0,0.0,1,2,0.5,1,6,7,1,1,0,0,0,5,15,1,BKN,MIA,BKN,109,,,13,12,6,8
Day'Ron Sharpe,C,22023,1630549,22300101,"OCT 30, 2023",BKN @ CHA,W,10,5,8,0.625,0,0,0.0,1,3,0.333,4,4,8,1,0,1,1,5,11,2,1,BKN,CHA,BKN,133,,,20,19,12,9
Day'Ron Sharpe,C,22023,1630549,22300084,"OCT 27, 2023",BKN @ DAL,L,3,1,2,0.5,0,0,0.0,0,0,0.0,2,2,4,0,1,0,2,1,2,5,1,BKN,DAL,BKN,120,,,6,6,2,4
Day'Ron Sharpe,C,22023,1630549,22300067,"OCT 25, 2023",BKN vs. CLE,L,12,2,3,0.667,0,0,0.0,0,0,0.0,1,1,2,0,0,2,3,2,4,2,1,BKN,BKN,CLE,113,,,6,6,4,2
Cedi Osman,F,22023,1626224,22300750,"FEB 10, 2024",SAS @ BKN,L,12,2,5,0.4,2,3,0.667,2,2,1.0,1,4,5,0,0,0,1,0,8,-6,1,SAS,BKN,SAS,103,,,13,13,8,5
Cedi Osman,F,22023,1626224,22300681,"JAN 31, 2024",SAS vs. ORL,L,28,3,8,0.375,2,6,0.333,0,0,0.0,0,2,2,3,0,0,2,4,8,-2,1,SAS,SAS,ORL,98,,,13,10,11,5
Cedi Osman,F,22023,1626224,22300665,"JAN 29, 2024",SAS vs. WAS,L,29,8,12,0.667,4,6,0.667,0,0,0.0,2,1,3,2,2,0,0,1,20,-5,1,SAS,SAS,WAS,113,,,25,23,22,5
Cedi Osman,F,22023,1626224,22300649,"JAN 27, 2024",SAS vs. MIN,W,16,1,4,0.25,0,3,0.0,0,0,0.0,0,3,3,4,1,0,1,1,2,3,1,SAS,SAS,MIN,113,,,9,5,6,7
Cedi Osman,F,22023,1626224,22300584,"JAN 19, 2024",SAS @ CHA,L,13,2,4,0.5,1,1,1.0,0,0,0.0,0,3,3,1,0,0,0,1,5,15,1,SAS,CHA,SAS,120,,,9,8,6,4
Cedi Osman,F,22023,1626224,22300571,"JAN 17, 2024",SAS @ BOS,L,12,1,2,0.5,0,0,0.0,0,0,0.0,2,3,5,1,0,0,0,2,2,-10,1,SAS,BOS,SAS,95,,,8,7,3,6
Cedi Osman,F,22023,1626224,22300559,"JAN 15, 2024",SAS @ ATL,L,12,1,5,0.2,1,5,0.2,0,0,0.0,0,1,1,0,0,0,1,3,3,-11,1,SAS,ATL,SAS,99,,,4,4,3,1
Cedi Osman,F,22023,1626224,22300548,"JAN 13, 2024",SAS vs. CHI,L,23,3,5,0.6,3,5,0.6,0,0,0.0,0,2,2,1,1,0,0,3,9,5,1,SAS,SAS,CHI,116,,,12,11,10,3
Cedi Osman,F,22023,1626224,22300541,"JAN 12, 2024",SAS vs. CHA,W,14,4,4,1.0,2,2,1.0,1,2,0.5,1,3,4,1,1,0,3,2,11,3,1,SAS,SAS,CHA,127,,,16,15,12,5
Cedi Osman,F,22023,1626224,22300519,"JAN 10, 2024",SAS @ DET,W,21,4,6,0.667,1,3,0.333,2,3,0.667,1,5,6,3,2,0,0,0,11,14,1,SAS,DET,SAS,129,,,20,17,14,9
Cedi Osman,F,22023,1626224,22300497,"JAN 07, 2024",SAS @ CLE,L,21,4,7,0.571,1,4,0.25,0,0,0.0,2,4,6,1,1,0,0,1,9,-19,1,SAS,CLE,SAS,115,,,16,15,10,7
Cedi Osman,F,22023,1626224,22300477,"JAN 04, 2024",SAS vs. MIL,L,28,4,7,0.571,3,6,0.5,2,3,0.667,0,2,2,5,3,0,1,3,13,10,1,SAS,SAS,MIL,121,,,20,15,18,7
Cedi Osman,F,22023,1626224,22300460,"JAN 02, 2024",SAS @ MEM,L,12,0,3,0.0,0,2,0.0,0,0,0.0,0,6,6,2,0,0,2,2,0,-9,1,SAS,MEM,SAS,98,,,8,6,2,8
Cedi Osman,F,22023,1626224,22300448,"DEC 31, 2023",SAS vs. BOS,L,16,2,4,0.5,1,2,0.5,0,0,0.0,0,0,0,2,1,0,0,2,5,-14,1,SAS,SAS,BOS,101,,,7,5,7,2
Cedi Osman,F,22023,1626224,22300437,"DEC 29, 2023",SAS @ POR,L,18,2,4,0.5,0,1,0.0,0,0,0.0,0,4,4,2,0,0,0,1,4,5,1,SAS,POR,SAS,128,,,10,8,6,6
Cedi Osman,F,22023,1626224,22300361,"DEC 19, 2023",SAS @ MIL,L,19,3,6,0.5,0,2,0.0,4,4,1.0,0,2,2,1,0,0,0,1,10,-9,1,SAS,MIL,SAS,119,,,13,12,11,3
Cedi Osman,F,22023,1626224,22300278,"DEC 01, 2023",SAS @ NOP,L,27,4,9,0.444,2,5,0.4,1,2,0.5,0,2,2,5,0,1,0,3,11,-17,1,SAS,NOP,SAS,106,,,18,13,16,7
Cedi Osman,F,22023,1626224,22300235,"NOV 22, 2023",SAS vs. LAC,L,19,2,6,0.333,1,3,0.333,0,0,0.0,0,1,1,0,2,0,0,3,5,-18,1,SAS,SAS,LAC,102,,,6,6,5,1
Cedi Osman,F,22023,1626224,22300206,"NOV 18, 2023",SAS vs. MEM,L,24,4,10,0.4,3,7,0.429,2,2,1.0,2,3,5,1,1,0,1,1,13,-21,1,SAS,SAS,MEM,108,,,19,18,14,6
Cedi Osman,F,22023,1626224,22300021,"NOV 14, 2023",SAS @ OKC,L,15,2,5,0.4,2,5,0.4,0,0,0.0,0,0,0,0,0,0,0,0,6,-7,1,SAS,OKC,SAS,87,,,6,6,6,0
Cedi Osman,F,22023,1626224,22300161,"NOV 08, 2023",SAS @ NYK,L,13,1,4,0.25,0,3,0.0,0,0,0.0,1,2,3,2,0,0,0,0,2,-5,1,SAS,NYK,SAS,105,,,7,5,4,5
Cedi Osman,F,22023,1626224,22300146,"NOV 06, 2023",SAS @ IND,L,19,2,6,0.333,1,2,0.5,1,2,0.5,1,2,3,2,1,0,1,1,6,-22,1,SAS,IND,SAS,111,,,11,9,8,5
Cedi Osman,F,22023,1626224,22300099,"OCT 29, 2023",SAS @ LAC,L,17,4,7,0.571,2,4,0.5,2,2,1.0,0,1,1,1,1,1,0,1,12,-5,1,SAS,LAC,SAS,83,,,14,13,13,2
Cedi Osman,F,22023,1626224,22300272,"NOV 30, 2023",SAS vs. ATL,L,15,1,7,0.143,1,5,0.2,0,0,0.0,0,1,1,2,0,0,1,3,3,-3,1,SAS,SAS,ATL,135,,,6,4,5,3
Cedi Osman,F,22023,1626224,22300252,"NOV 26, 2023",SAS @ DEN,L,16,1,5,0.2,1,3,0.333,4,4,1.0,1,2,3,3,0,0,3,2,7,-9,1,SAS,DEN,SAS,120,,,13,10,10,6
Cedi Osman,F,22023,1626224,22300051,"NOV 24, 2023",SAS @ GSW,L,18,5,11,0.455,1,6,0.167,0,0,0.0,1,0,1,0,0,0,1,3,11,-3,1,SAS,GSW,SAS,112,,,12,12,11,1
Cedi Osman,F,22023,1626224,22300223,"NOV 20, 2023",SAS vs. LAC,L,23,7,10,0.7,2,4,0.5,1,1,1.0,2,3,5,1,0,0,0,4,17,-11,1,SAS,SAS,LAC,99,,,23,22,18,6
Cedi Osman,F,22023,1626224,22300032,"NOV 17, 2023",SAS vs. SAC,L,15,1,3,0.333,1,2,0.5,0,0,0.0,0,2,2,1,0,0,0,1,3,-7,1,SAS,SAS,SAC,120,,,6,5,4,3
Cedi Osman,F,22023,1626224,22300184,"NOV 12, 2023",SAS vs. MIA,L,20,1,3,0.333,1,1,1.0,0,0,0.0,1,0,1,0,0,1,0,2,3,-15,1,SAS,SAS,MIA,113,,,4,4,3,1
Cedi Osman,F,22023,1626224,22300013,"NOV 10, 2023",SAS vs. MIN,L,16,1,2,0.5,0,1,0.0,0,0,0.0,0,0,0,2,1,0,0,1,2,-14,1,SAS,SAS,MIN,110,,,4,2,4,2
Cedi Osman,F,22023,1626224,22300141,"NOV 05, 2023",SAS vs. TOR,L,26,3,6,0.5,1,2,0.5,0,0,0.0,0,4,4,3,0,0,2,4,7,9,1,SAS,SAS,TOR,116,,,14,11,10,7
Cedi Osman,F,22023,1626224,22300131,"NOV 02, 2023",SAS @ PHX,W,22,5,8,0.625,3,6,0.5,0,0,0.0,0,2,2,1,1,0,0,1,13,-16,1,SAS,PHX,SAS,132,,,16,15,14,3
Cedi Osman,F,22023,1626224,22300113,"OCT 31, 2023",SAS @ PHX,W,19,4,7,0.571,1,2,0.5,0,1,0.0,0,2,2,1,1,0,0,0,9,6,1,SAS,PHX,SAS,115,,,12,11,10,3
Cedi Osman,F,22023,1626224,22300083,"OCT 27, 2023",SAS vs. HOU,W,23,5,7,0.714,4,6,0.667,0,0,0.0,0,2,2,1,0,0,3,1,14,9,1,SAS,SAS,HOU,126,,,17,16,15,3
Cedi Osman,F,22023,1626224,22300073,"OCT 25, 2023",SAS vs. DAL,L,22,5,10,0.5,2,6,0.333,0,0,0.0,0,0,0,2,0,1,0,2,12,-11,1,SAS,SAS,DAL,119,,,14,12,14,2
Cedi Osman,F,22023,1626224,22300734,"FEB 08, 2024",SAS @ ORL,L,15,1,2,0.5,1,2,0.5,0,0,0.0,0,1,1,0,1,0,0,1,3,4,1,SAS,ORL,SAS,111,,,4,4,3,1
Cedi Osman,F,22023,1626224,22300730,"FEB 07, 2024",SAS @ MIA,L,22,3,7,0.429,2,4,0.5,0,0,0.0,0,5,5,0,0,0,0,1,8,-2,1,SAS,MIA,SAS,104,,,13,13,8,5
Cedi Osman,F,22023,1626224,22300703,"FEB 03, 2024",SAS vs. CLE,L,16,2,5,0.4,2,4,0.5,1,2,0.5,0,1,1,0,0,0,1,1,7,-12,1,SAS,SAS,CLE,101,,,8,8,7,1
Cedi Osman,F,22023,1626224,22300696,"FEB 02, 2024",SAS vs. NOP,L,19,1,6,0.167,1,5,0.2,0,0,0.0,0,0,0,0,2,2,2,3,3,-6,1,SAS,SAS,NOP,113,,,3,3,3,0
Cedi Osman,F,22023,1626224,22300622,"JAN 24, 2024",SAS vs. OKC,L,14,3,5,0.6,1,3,0.333,2,3,0.667,0,0,0,0,0,1,0,0,9,-15,1,SAS,SAS,OKC,114,,,9,9,9,0
Cedi Osman,F,22023,1626224,22300594,"JAN 20, 2024",SAS @ WAS,W,17,1,3,0.333,1,3,0.333,0,0,0.0,0,3,3,4,0,0,0,1,3,-18,1,SAS,WAS,SAS,131,,,10,6,7,7
Cedi Osman,F,22023,1626224,22300427,"DEC 28, 2023",SAS @ POR,W,16,2,3,0.667,0,0,0.0,0,0,0.0,0,2,2,2,0,0,0,0,4,-2,1,SAS,POR,SAS,118,,,8,6,6,4
Cedi Osman,F,22023,1626224,22300412,"DEC 26, 2023",SAS vs. UTA,L,13,0,2,0.0,0,1,0.0,1,4,0.25,0,2,2,3,0,0,0,0,1,-10,1,SAS,SAS,UTA,118,,,6,3,4,5
Cedi Osman,F,22023,1626224,22300398,"DEC 23, 2023",SAS @ DAL,L,10,1,3,0.333,1,2,0.5,0,0,0.0,0,0,0,2,1,0,0,1,3,-14,1,SAS,DAL,SAS,119,,,5,3,5,2
Cedi Osman,F,22023,1626224,22300376,"DEC 21, 2023",SAS @ CHI,L,11,0,4,0.0,0,3,0.0,2,2,1.0,0,1,1,3,0,0,2,1,2,-12,1,SAS,CHI,SAS,95,,,6,3,5,4
Cedi Osman,F,22023,1626224,22300345,"DEC 17, 2023",SAS vs. NOP,L,17,5,7,0.714,1,2,0.5,3,4,0.75,0,3,3,0,0,0,1,2,14,-11,1,SAS,SAS,NOP,110,,,17,17,14,3
Cedi Osman,F,22023,1626224,22300331,"DEC 15, 2023",SAS vs. LAL,W,25,6,11,0.545,3,6,0.5,0,0,0.0,0,2,2,6,0,0,0,2,15,13,1,SAS,SAS,LAL,129,,,23,17,21,8
Cedi Osman,F,22023,1626224,22300316,"DEC 13, 2023",SAS vs. LAL,L,17,2,4,0.5,1,2,0.5,0,0,0.0,0,7,7,2,0,0,0,0,5,9,1,SAS,SAS,LAL,119,,,14,12,7,9
Cedi Osman,F,22023,1626224,22300298,"DEC 11, 2023",SAS @ HOU,L,13,4,7,0.571,0,2,0.0,2,4,0.5,0,2,2,1,0,0,2,1,10,-3,1,SAS,HOU,SAS,82,,,13,12,11,3
Cedi Osman,F,22023,1626224,22301223,"DEC 08, 2023",SAS vs. CHI,L,10,3,7,0.429,1,4,0.25,0,0,0.0,0,1,1,1,0,1,0,1,7,1,1,SAS,SAS,CHI,112,,,9,8,8,2
Cedi Osman,F,22023,1626224,22301210,"DEC 06, 2023",SAS @ MIN,L,32,3,8,0.375,0,3,0.0,0,2,0.0,2,6,8,6,2,0,1,2,6,-10,1,SAS,MIN,SAS,94,,,20,14,12,14
Cedi Osman,F,22023,1626224,22300641,"JAN 26, 2024",SAS vs. POR,W,18,3,4,0.75,0,1,0.0,1,1,1.0,0,3,3,1,1,1,2,1,7,-6,1,SAS,SAS,POR,116,,,11,10,8,4
Cedi Osman,F,22023,1626224,22300608,"JAN 22, 2024",SAS @ PHI,L,11,1,1,1.0,0,0,0.0,0,0,0.0,0,3,3,1,0,0,0,2,2,-4,1,SAS,PHI,SAS,123,,,6,5,3,4
Josh Hart,G,22023,1628404,22300755,"FEB 10, 2024",NYK vs. IND,L,36,2,6,0.333,0,2,0.0,0,0,0.0,1,9,10,5,1,0,1,4,4,-20,1,NYK,NYK,IND,111,,,19,14,9,15
Josh Hart,G,22023,1628404,22300736,"FEB 08, 2024",NYK vs. DAL,L,39,8,22,0.364,3,8,0.375,4,4,1.0,1,9,10,12,1,0,2,3,23,-12,1,NYK,NYK,DAL,108,,,45,33,35,22
Josh Hart,G,22023,1628404,22300722,"FEB 06, 2024",NYK vs. MEM,W,37,3,7,0.429,1,2,0.5,3,4,0.75,1,9,10,4,0,0,1,1,10,20,1,NYK,NYK,MEM,121,,,24,20,14,14
Josh Hart,G,22023,1628404,22300701,"FEB 03, 2024",NYK vs. LAL,L,42,5,16,0.313,2,6,0.333,0,0,0.0,4,7,11,4,1,0,2,3,12,-12,1,NYK,NYK,LAL,105,,,27,23,16,15
Josh Hart,G,22023,1628404,22300685,"FEB 01, 2024",NYK vs. IND,W,38,0,6,0.0,0,3,0.0,5,6,0.833,3,9,12,3,0,1,2,3,5,0,1,NYK,NYK,IND,109,,,20,17,8,15
Josh Hart,G,22023,1628404,22300671,"JAN 30, 2024",NYK vs. UTA,W,43,4,10,0.4,0,3,0.0,2,2,1.0,1,9,10,10,2,2,3,2,10,2,1,NYK,NYK,UTA,118,,,30,20,20,20
Josh Hart,G,22023,1628404,22300657,"JAN 29, 2024",NYK @ CHA,W,39,3,7,0.429,0,3,0.0,2,2,1.0,2,10,12,7,0,0,1,0,8,15,1,NYK,CHA,NYK,113,,,27,20,15,19
Josh Hart,G,22023,1628404,22300643,"JAN 27, 2024",NYK vs. MIA,W,32,5,7,0.714,2,3,0.667,2,2,1.0,1,8,9,5,0,0,1,1,14,30,1,NYK,NYK,MIA,125,,,28,23,19,14
Josh Hart,G,22023,1628404,22300631,"JAN 25, 2024",NYK vs. DEN,W,26,2,5,0.4,0,2,0.0,0,0,0.0,0,7,7,3,1,1,0,0,4,6,1,NYK,NYK,DEN,122,,,14,11,7,10
Josh Hart,G,22023,1628404,22300615,"JAN 23, 2024",NYK @ BKN,W,28,1,7,0.143,0,3,0.0,0,0,0.0,1,4,5,1,2,1,1,1,2,9,1,NYK,BKN,NYK,108,,,8,7,3,6
Josh Hart,G,22023,1628404,22300596,"JAN 20, 2024",NYK vs. TOR,W,26,3,5,0.6,2,3,0.667,2,2,1.0,1,8,9,1,0,1,3,1,10,20,1,NYK,NYK,TOR,126,,,20,19,11,10
Josh Hart,G,22023,1628404,22300573,"JAN 17, 2024",NYK vs. HOU,W,30,5,11,0.455,0,2,0.0,0,0,0.0,5,9,14,1,0,0,0,2,10,10,1,NYK,NYK,HOU,109,,,25,24,11,15
Josh Hart,G,22023,1628404,22300557,"JAN 15, 2024",NYK vs. ORL,L,24,2,7,0.286,0,2,0.0,0,0,0.0,1,5,6,1,0,0,1,2,4,-13,1,NYK,NYK,ORL,94,,,11,10,5,7
Josh Hart,G,22023,1628404,22300544,"JAN 13, 2024",NYK @ MEM,W,29,3,7,0.429,2,4,0.5,0,0,0.0,0,7,7,3,2,0,2,2,8,7,1,NYK,MEM,NYK,106,,,18,15,11,10
Josh Hart,G,22023,1628404,22300530,"JAN 11, 2024",NYK @ DAL,L,23,1,4,0.25,0,3,0.0,2,3,0.667,3,1,4,2,0,0,1,3,4,-11,1,NYK,DAL,NYK,124,,,10,8,6,6
Josh Hart,G,22023,1628404,22300514,"JAN 09, 2024",NYK vs. POR,W,26,1,4,0.25,0,2,0.0,0,0,0.0,1,6,7,4,0,0,3,3,2,12,1,NYK,NYK,POR,112,,,13,9,6,11
Josh Hart,G,22023,1628404,22300494,"JAN 06, 2024",NYK @ WAS,W,32,3,8,0.375,1,4,0.25,2,2,1.0,2,2,4,1,0,0,2,1,9,24,1,NYK,WAS,NYK,121,,,14,13,10,5
Josh Hart,G,22023,1628404,22300483,"JAN 05, 2024",NYK @ PHI,W,30,4,7,0.571,0,2,0.0,2,2,1.0,3,12,15,6,0,1,2,2,10,46,1,NYK,PHI,NYK,128,,,31,25,16,21
Josh Hart,G,22023,1628404,22300468,"JAN 03, 2024",NYK vs. CHI,W,25,1,5,0.2,1,2,0.5,0,0,0.0,1,4,5,3,0,0,2,2,3,2,1,NYK,NYK,CHI,116,,,11,8,6,8
Josh Hart,G,22023,1628404,22300451,"JAN 01, 2024",NYK vs. MIN,W,29,3,7,0.429,2,3,0.667,0,0,0.0,2,9,11,2,0,0,1,2,8,-12,1,NYK,NYK,MIN,112,,,21,19,10,13
Josh Hart,G,22023,1628404,22300441,"DEC 30, 2023",NYK @ IND,L,38,4,9,0.444,1,2,0.5,1,2,0.5,3,7,10,1,1,0,0,3,10,-19,1,NYK,IND,NYK,124,,,21,20,11,11
Josh Hart,G,22023,1628404,22300388,"DEC 23, 2023",NYK vs. MIL,L,26,1,6,0.167,0,3,0.0,0,0,0.0,0,2,2,3,1,0,1,3,2,-19,1,NYK,NYK,MIL,109,,,7,4,5,5
Josh Hart,G,22023,1628404,22300368,"DEC 20, 2023",NYK @ BKN,W,31,2,5,0.4,2,3,0.667,4,4,1.0,2,11,13,3,1,0,2,2,10,6,1,NYK,BKN,NYK,119,,,26,23,13,16
Josh Hart,G,22023,1628404,22300343,"DEC 16, 2023",NYK @ LAC,L,8,0,1,0.0,0,0,0.0,0,0,0.0,0,1,1,1,1,0,1,2,0,1,1,NYK,LAC,NYK,120,,,2,1,1,2
Josh Hart,G,22023,1628404,22300333,"DEC 15, 2023",NYK @ PHX,W,29,3,8,0.375,0,3,0.0,0,0,0.0,2,0,2,2,0,0,0,0,6,34,1,NYK,PHX,NYK,139,,,10,8,8,4
Josh Hart,G,22023,1628404,22301201,"DEC 05, 2023",NYK @ MIL,L,26,5,8,0.625,1,1,1.0,0,0,0.0,1,3,4,1,3,0,0,3,11,-14,1,NYK,MIL,NYK,122,,,16,15,12,5
Josh Hart,G,22023,1628404,22300221,"NOV 20, 2023",NYK @ MIN,L,24,2,6,0.333,0,2,0.0,0,0,0.0,1,1,2,1,2,0,0,0,4,-5,1,NYK,MIN,NYK,100,,,7,6,5,3
Josh Hart,G,22023,1628404,22300028,"NOV 17, 2023",NYK @ WAS,W,32,4,7,0.571,1,2,0.5,0,0,0.0,1,4,5,2,0,2,1,1,9,27,1,NYK,WAS,NYK,120,,,16,14,11,7
Josh Hart,G,22023,1628404,22300177,"NOV 12, 2023",NYK vs. CHA,W,27,3,6,0.5,0,2,0.0,0,0,0.0,1,3,4,2,0,0,0,1,6,16,1,NYK,NYK,CHA,129,,,12,10,8,6
Josh Hart,G,22023,1628404,22300161,"NOV 08, 2023",NYK vs. SAS,W,24,1,3,0.333,1,2,0.5,0,0,0.0,0,5,5,0,1,0,0,0,3,-3,1,NYK,NYK,SAS,126,,,8,8,3,5
Josh Hart,G,22023,1628404,22300112,"OCT 31, 2023",NYK @ CLE,W,28,2,6,0.333,1,3,0.333,0,0,0.0,0,7,7,3,0,0,1,2,5,2,1,NYK,CLE,NYK,109,,,15,12,8,10
Josh Hart,G,22023,1628404,22300429,"DEC 29, 2023",NYK @ ORL,L,31,2,4,0.5,1,2,0.5,0,0,0.0,0,4,4,0,0,0,2,2,5,6,1,NYK,ORL,NYK,106,,,9,9,5,4
Josh Hart,G,22023,1628404,22300419,"DEC 27, 2023",NYK @ OKC,L,34,1,4,0.25,0,2,0.0,2,2,1.0,2,5,7,6,0,0,1,1,4,-4,1,NYK,OKC,NYK,116,,,17,11,10,13
Josh Hart,G,22023,1628404,22300401,"DEC 25, 2023",NYK vs. MIL,W,31,5,7,0.714,0,2,0.0,0,0,0.0,0,9,9,4,2,0,2,1,10,7,1,NYK,NYK,MIL,129,,,23,19,14,13
Josh Hart,G,22023,1628404,22300359,"DEC 18, 2023",NYK @ LAL,W,22,2,6,0.333,0,3,0.0,2,2,1.0,0,5,5,2,0,1,4,1,6,0,1,NYK,LAL,NYK,114,,,13,11,8,7
Josh Hart,G,22023,1628404,22300318,"DEC 13, 2023",NYK @ UTA,L,29,0,5,0.0,0,4,0.0,0,0,0.0,0,2,2,2,1,0,0,2,0,-7,1,NYK,UTA,NYK,113,,,4,2,2,4
Josh Hart,G,22023,1628404,22300297,"DEC 11, 2023",NYK vs. TOR,W,31,6,8,0.75,3,3,1.0,1,2,0.5,3,4,7,8,1,0,1,4,16,8,1,NYK,NYK,TOR,136,,,31,23,24,15
Josh Hart,G,22023,1628404,22301227,"DEC 08, 2023",NYK @ BOS,L,27,2,4,0.5,2,3,0.667,0,0,0.0,1,5,6,7,0,0,1,4,6,5,1,NYK,BOS,NYK,123,,,19,12,13,13
Josh Hart,G,22023,1628404,22300276,"DEC 01, 2023",NYK @ TOR,W,31,7,11,0.636,3,4,0.75,0,0,0.0,3,5,8,2,0,1,3,3,17,11,1,NYK,TOR,NYK,119,,,27,25,19,10
Josh Hart,G,22023,1628404,22300268,"NOV 30, 2023",NYK vs. DET,W,32,2,3,0.667,1,2,0.5,2,4,0.5,0,7,7,2,2,0,1,2,7,6,1,NYK,NYK,DET,118,,,16,14,9,9
Josh Hart,G,22023,1628404,22300057,"NOV 28, 2023",NYK vs. CHA,W,30,7,10,0.7,2,3,0.667,1,1,1.0,1,5,6,2,1,1,1,2,17,25,1,NYK,NYK,CHA,115,,,25,23,19,8
Josh Hart,G,22023,1628404,22300247,"NOV 26, 2023",NYK vs. PHX,L,24,1,3,0.333,0,2,0.0,2,2,1.0,0,3,3,2,0,0,0,0,4,1,1,NYK,NYK,PHX,113,,,9,7,6,5
Josh Hart,G,22023,1628404,22300045,"NOV 24, 2023",NYK vs. MIA,W,26,4,7,0.571,1,3,0.333,1,1,1.0,1,7,8,4,1,0,1,1,10,5,1,NYK,NYK,MIA,100,,,22,18,14,12
Josh Hart,G,22023,1628404,22300202,"NOV 18, 2023",NYK @ CHA,W,29,3,5,0.6,1,2,0.5,0,0,0.0,0,6,6,4,3,0,0,0,7,7,1,NYK,CHA,NYK,122,,,17,13,11,10
Josh Hart,G,22023,1628404,22300151,"NOV 06, 2023",NYK vs. LAC,W,32,4,9,0.444,1,4,0.25,1,1,1.0,0,3,3,7,2,0,2,2,10,13,1,NYK,NYK,LAC,111,,,20,13,17,10
Josh Hart,G,22023,1628404,22300090,"OCT 28, 2023",NYK @ NOP,L,21,1,5,0.2,1,3,0.333,0,0,0.0,2,8,10,2,1,0,2,2,3,-10,1,NYK,NOP,NYK,87,,,15,13,5,12
Josh Hart,G,22023,1628404,22300079,"OCT 27, 2023",NYK @ ATL,W,22,2,4,0.5,0,1,0.0,0,0,0.0,0,3,3,0,1,0,0,3,4,-2,1,NYK,ATL,NYK,126,,,7,7,4,3
Josh Hart,G,22023,1628404,22300065,"OCT 25, 2023",NYK vs. BOS,L,22,2,4,0.5,2,4,0.5,1,2,0.5,1,5,6,0,0,0,1,1,7,-1,1,NYK,NYK,BOS,104,,,13,13,7,6
Josh Hart,G,22023,1628404,22300193,"NOV 15, 2023",NYK @ ATL,W,33,4,9,0.444,1,4,0.25,0,0,0.0,2,6,8,5,0,1,2,4,9,7,1,NYK,ATL,NYK,116,,,22,17,14,13
Josh Hart,G,22023,1628404,22300188,"NOV 13, 2023",NYK @ BOS,L,43,6,12,0.5,3,6,0.5,1,2,0.5,2,7,9,3,1,0,2,4,16,-10,1,NYK,BOS,NYK,98,,,28,25,19,12
Josh Hart,G,22023,1628404,22300002,"NOV 03, 2023",NYK @ MIL,L,36,2,9,0.222,0,4,0.0,2,2,1.0,2,8,10,5,3,1,0,4,6,1,1,NYK,MIL,NYK,105,,,21,16,11,15
Josh Hart,G,22023,1628404,22300120,"NOV 01, 2023",NYK vs. CLE,L,29,5,14,0.357,1,5,0.2,0,0,0.0,3,5,8,3,0,0,2,1,11,-5,1,NYK,NYK,CLE,89,,,22,19,14,11
Cody Martin,F,22023,1628998,22300745,"FEB 09, 2024",CHA @ MIL,L,24,2,9,0.222,0,3,0.0,1,2,0.5,1,4,5,5,0,0,3,2,5,-36,1,CHA,MIL,CHA,80,,,15,10,10,10
Cody Martin,F,22023,1628998,22300635,"JAN 26, 2024",CHA vs. HOU,L,19,3,8,0.375,0,1,0.0,0,1,0.0,0,1,1,0,0,0,0,2,6,-14,1,CHA,CHA,HOU,104,,,7,7,6,1
Cody Martin,F,22023,1628998,22300619,"JAN 24, 2024",CHA @ DET,L,25,1,4,0.25,0,2,0.0,3,4,0.75,1,2,3,3,1,0,0,2,5,-5,1,CHA,DET,CHA,106,,,11,8,8,6
Cody Martin,F,22023,1628998,22300584,"JAN 19, 2024",CHA vs. SAS,W,25,2,5,0.4,1,1,1.0,0,0,0.0,1,2,3,3,2,1,2,3,5,6,1,CHA,CHA,SAS,124,,,11,8,8,6
Cody Martin,F,22023,1628998,22300575,"JAN 17, 2024",CHA @ NOP,L,28,2,9,0.222,1,5,0.2,2,2,1.0,1,3,4,4,2,0,0,2,7,-15,1,CHA,NOP,CHA,108,,,15,11,11,8
Cody Martin,F,22023,1628998,22300551,"JAN 14, 2024",CHA @ MIA,L,23,1,3,0.333,1,2,0.5,0,0,0.0,2,0,2,2,0,2,3,1,3,-8,1,CHA,MIA,CHA,85,,,7,5,5,4
Cody Martin,F,22023,1628998,22300751,"FEB 10, 2024",CHA vs. MEM,W,28,2,7,0.286,1,3,0.333,0,0,0.0,0,7,7,2,0,0,4,0,5,5,1,CHA,CHA,MEM,115,,,14,12,7,9
Cody Martin,F,22023,1628998,22300726,"FEB 07, 2024",CHA vs. TOR,L,28,7,13,0.538,3,5,0.6,2,3,0.667,0,5,5,8,2,0,1,3,19,-1,1,CHA,CHA,TOR,117,,,32,24,27,13
Cody Martin,F,22023,1628998,22300695,"FEB 02, 2024",CHA @ OKC,L,21,3,5,0.6,1,3,0.333,0,0,0.0,0,1,1,4,0,0,1,0,7,-19,1,CHA,OKC,CHA,106,,,12,8,11,5
Cody Martin,F,22023,1628998,22300674,"JAN 31, 2024",CHA vs. CHI,L,28,3,10,0.3,1,2,0.5,0,1,0.0,0,1,1,6,0,0,3,3,7,0,1,CHA,CHA,CHI,110,,,14,8,13,7
Cody Martin,F,22023,1628998,22300657,"JAN 29, 2024",CHA vs. NYK,L,31,5,10,0.5,3,5,0.6,1,1,1.0,0,6,6,8,1,0,5,2,14,-3,1,CHA,CHA,NYK,92,,,28,20,22,14
Cody Martin,F,22023,1628998,22300647,"JAN 27, 2024",CHA vs. UTA,L,29,3,8,0.375,1,3,0.333,2,4,0.5,0,7,7,6,0,0,1,2,9,-14,1,CHA,CHA,UTA,122,,,22,16,15,13
Cody Martin,F,22023,1628998,22300455,"JAN 01, 2024",CHA @ DEN,L,25,0,6,0.0,0,3,0.0,2,4,0.5,1,2,3,6,2,2,0,0,2,-2,1,CHA,DEN,CHA,91,,,11,5,8,9
Cody Martin,F,22023,1628998,22300428,"DEC 28, 2023",CHA @ LAL,L,20,2,7,0.286,0,3,0.0,1,4,0.25,2,2,4,2,1,0,2,1,5,-19,1,CHA,LAL,CHA,110,,,11,9,7,6
Cody Martin,F,22023,1628998,22300593,"JAN 20, 2024",CHA vs. PHI,L,29,2,7,0.286,0,3,0.0,0,0,0.0,0,6,6,3,1,4,2,2,4,-11,1,CHA,CHA,PHI,89,,,13,10,7,9
Cody Martin,F,22023,1628998,22300484,"JAN 05, 2024",CHA @ CHI,L,36,5,11,0.455,3,7,0.429,0,0,0.0,2,3,5,2,2,0,1,4,13,-14,1,CHA,CHI,CHA,87,,,20,18,15,7
Cody Martin,F,22023,1628998,22300464,"JAN 02, 2024",CHA @ SAC,W,33,4,10,0.4,1,5,0.2,1,2,0.5,0,2,2,2,1,0,1,2,10,-8,1,CHA,SAC,CHA,111,,,14,12,12,4
Cody Martin,F,22023,1628998,22300436,"DEC 29, 2023",CHA @ PHX,L,27,5,10,0.5,3,4,0.75,0,0,0.0,3,1,4,1,2,1,1,1,13,-10,1,CHA,PHX,CHA,119,,,18,17,14,5
Cody Martin,F,22023,1628998,22300414,"DEC 26, 2023",CHA @ LAC,L,25,3,8,0.375,1,2,0.5,0,0,0.0,0,2,2,2,4,1,0,2,7,3,1,CHA,LAC,CHA,104,,,11,9,9,4
Cody Martin,F,22023,1628998,22300390,"DEC 23, 2023",CHA vs. DEN,L,17,3,5,0.6,0,0,0.0,0,0,0.0,0,0,0,0,0,0,1,1,6,5,1,CHA,CHA,DEN,95,,,6,6,6,0
Quentin Grimes,G,22023,1629656,22300671,"JAN 30, 2024",NYK vs. UTA,W,20,4,10,0.4,2,6,0.333,2,2,1.0,0,6,6,2,1,0,0,1,12,6,1,NYK,NYK,UTA,118,,,20,18,14,8
Quentin Grimes,G,22023,1629656,22300657,"JAN 29, 2024",NYK @ CHA,W,32,3,11,0.273,1,6,0.167,0,0,0.0,0,2,2,2,0,0,0,1,7,3,1,NYK,CHA,NYK,113,,,11,9,9,4
Quentin Grimes,G,22023,1629656,22300643,"JAN 27, 2024",NYK vs. MIA,W,24,3,6,0.5,2,5,0.4,4,8,0.5,1,3,4,1,1,0,0,2,12,10,1,NYK,NYK,MIA,125,,,17,16,13,5
Quentin Grimes,G,22023,1629656,22300631,"JAN 25, 2024",NYK vs. DEN,W,23,7,11,0.636,2,5,0.4,3,3,1.0,0,5,5,0,0,0,2,0,19,13,1,NYK,NYK,DEN,122,,,24,24,19,5
Quentin Grimes,G,22023,1629656,22300615,"JAN 23, 2024",NYK @ BKN,W,20,2,5,0.4,1,4,0.25,0,0,0.0,0,1,1,2,1,0,0,2,5,5,1,NYK,BKN,NYK,108,,,8,6,7,3
Quentin Grimes,G,22023,1629656,22300596,"JAN 20, 2024",NYK vs. TOR,W,20,2,8,0.25,0,4,0.0,0,0,0.0,1,3,4,1,1,1,1,3,4,8,1,NYK,NYK,TOR,126,,,9,8,5,5
Quentin Grimes,G,22023,1629656,22300579,"JAN 18, 2024",NYK vs. WAS,W,19,0,5,0.0,0,5,0.0,0,0,0.0,0,1,1,2,0,0,0,1,0,-12,1,NYK,NYK,WAS,113,,,3,1,2,3
Quentin Grimes,G,22023,1629656,22300573,"JAN 17, 2024",NYK vs. HOU,W,17,2,8,0.25,2,6,0.333,5,5,1.0,2,1,3,1,0,0,0,1,11,-1,1,NYK,NYK,HOU,109,,,15,14,12,4
Quentin Grimes,G,22023,1629656,22300557,"JAN 15, 2024",NYK vs. ORL,L,14,3,4,0.75,2,3,0.667,0,0,0.0,0,2,2,1,1,0,2,2,8,-12,1,NYK,NYK,ORL,94,,,11,10,9,3
Quentin Grimes,G,22023,1629656,22300544,"JAN 13, 2024",NYK @ MEM,W,15,1,5,0.2,1,4,0.25,0,0,0.0,0,2,2,1,0,0,0,1,3,4,1,NYK,MEM,NYK,106,,,6,5,4,3
Quentin Grimes,G,22023,1629656,22300530,"JAN 11, 2024",NYK @ DAL,L,15,3,6,0.5,3,6,0.5,0,2,0.0,0,0,0,3,0,0,0,1,9,-8,1,NYK,DAL,NYK,124,,,12,9,12,3
Quentin Grimes,G,22023,1629656,22300514,"JAN 09, 2024",NYK vs. POR,W,21,5,11,0.455,4,9,0.444,3,3,1.0,0,4,4,1,3,0,2,1,17,9,1,NYK,NYK,POR,112,,,22,21,18,5
Quentin Grimes,G,22023,1629656,22300494,"JAN 06, 2024",NYK @ WAS,W,15,2,5,0.4,2,4,0.5,0,0,0.0,0,1,1,1,1,0,1,1,6,-6,1,NYK,WAS,NYK,121,,,8,7,7,2
Quentin Grimes,G,22023,1629656,22300483,"JAN 05, 2024",NYK @ PHI,W,24,6,13,0.462,4,9,0.444,3,3,1.0,2,6,8,2,1,1,1,3,19,37,1,NYK,PHI,NYK,128,,,29,27,21,10
Quentin Grimes,G,22023,1629656,22300468,"JAN 03, 2024",NYK vs. CHI,W,18,3,9,0.333,2,6,0.333,0,0,0.0,0,1,1,0,1,0,0,0,8,-20,1,NYK,NYK,CHI,116,,,9,9,8,1
Quentin Grimes,G,22023,1629656,22300451,"JAN 01, 2024",NYK vs. MIN,W,18,3,4,0.75,2,3,0.667,2,2,1.0,2,1,3,1,0,0,0,1,10,-6,1,NYK,NYK,MIN,112,,,14,13,11,4
Quentin Grimes,G,22023,1629656,22300388,"DEC 23, 2023",NYK vs. MIL,L,16,1,3,0.333,0,1,0.0,0,0,0.0,0,2,2,0,1,0,0,2,2,-5,1,NYK,NYK,MIL,109,,,4,4,2,2
Quentin Grimes,G,22023,1629656,22300368,"DEC 20, 2023",NYK @ BKN,W,18,2,7,0.286,1,4,0.25,0,0,0.0,0,1,1,0,1,1,0,1,5,-2,1,NYK,BKN,NYK,119,,,6,6,5,1
Quentin Grimes,G,22023,1629656,22300343,"DEC 16, 2023",NYK @ LAC,L,24,3,8,0.375,2,5,0.4,0,0,0.0,0,1,1,0,1,0,0,3,8,-5,1,NYK,LAC,NYK,120,,,9,9,8,1
Quentin Grimes,G,22023,1629656,22300333,"DEC 15, 2023",NYK @ PHX,W,15,3,7,0.429,3,6,0.5,0,0,0.0,2,0,2,1,0,0,0,2,9,12,1,NYK,PHX,NYK,139,,,12,11,10,3
Quentin Grimes,G,22023,1629656,22301201,"DEC 05, 2023",NYK @ MIL,L,18,0,1,0.0,0,1,0.0,0,0,0.0,0,1,1,0,1,0,0,4,0,-3,1,NYK,MIL,NYK,122,,,1,1,0,1
Quentin Grimes,G,22023,1629656,22300221,"NOV 20, 2023",NYK @ MIN,L,25,0,6,0.0,0,6,0.0,0,0,0.0,0,1,1,2,2,0,0,2,0,-18,1,NYK,MIN,NYK,100,,,3,1,2,3
Quentin Grimes,G,22023,1629656,22300177,"NOV 12, 2023",NYK vs. CHA,W,23,2,5,0.4,2,5,0.4,0,0,0.0,0,1,1,1,1,0,0,1,6,5,1,NYK,NYK,CHA,129,,,8,7,7,2
Quentin Grimes,G,22023,1629656,22300161,"NOV 08, 2023",NYK vs. SAS,W,19,3,5,0.6,2,4,0.5,0,0,0.0,0,1,1,3,0,0,0,0,8,26,1,NYK,NYK,SAS,126,,,12,9,11,4
Quentin Grimes,G,22023,1629656,22300112,"OCT 31, 2023",NYK @ CLE,W,22,2,4,0.5,1,3,0.333,0,0,0.0,0,1,1,1,2,0,0,3,5,8,1,NYK,CLE,NYK,109,,,7,6,6,2
Quentin Grimes,G,22023,1629656,22300429,"DEC 29, 2023",NYK @ ORL,L,14,1,3,0.333,1,3,0.333,0,0,0.0,0,2,2,0,1,0,0,1,3,1,1,NYK,ORL,NYK,106,,,5,5,3,2
Quentin Grimes,G,22023,1629656,22300419,"DEC 27, 2023",NYK @ OKC,L,11,2,2,1.0,2,2,1.0,0,0,0.0,0,3,3,1,0,0,0,1,6,0,1,NYK,OKC,NYK,116,,,10,9,7,4
Quentin Grimes,G,22023,1629656,22300401,"DEC 25, 2023",NYK vs. MIL,W,12,1,2,0.5,0,1,0.0,0,1,0.0,0,1,1,2,0,0,0,0,2,-1,1,NYK,NYK,MIL,129,,,5,3,4,3
Quentin Grimes,G,22023,1629656,22300359,"DEC 18, 2023",NYK @ LAL,W,11,1,5,0.2,1,4,0.25,0,0,0.0,0,0,0,2,1,0,0,0,3,4,1,NYK,LAL,NYK,114,,,5,3,5,2
Quentin Grimes,G,22023,1629656,22300318,"DEC 13, 2023",NYK @ UTA,L,16,1,4,0.25,0,3,0.0,0,2,0.0,0,2,2,1,0,0,1,1,2,-27,1,NYK,UTA,NYK,113,,,5,4,3,3
Quentin Grimes,G,22023,1629656,22300297,"DEC 11, 2023",NYK vs. TOR,W,27,7,11,0.636,5,7,0.714,0,0,0.0,0,3,3,1,0,0,0,0,19,10,1,NYK,NYK,TOR,136,,,23,22,20,4
Quentin Grimes,G,22023,1629656,22301227,"DEC 08, 2023",NYK @ BOS,L,19,5,10,0.5,3,7,0.429,0,0,0.0,0,1,1,2,0,0,2,1,13,12,1,NYK,BOS,NYK,123,,,16,14,15,3
Quentin Grimes,G,22023,1629656,22300276,"DEC 01, 2023",NYK @ TOR,W,21,1,3,0.333,0,2,0.0,2,2,1.0,1,0,1,2,0,0,0,2,4,0,1,NYK,TOR,NYK,119,,,7,5,6,3
Quentin Grimes,G,22023,1629656,22300268,"NOV 30, 2023",NYK vs. DET,W,16,0,5,0.0,0,3,0.0,0,0,0.0,0,1,1,0,2,0,0,1,0,-2,1,NYK,NYK,DET,118,,,1,1,0,1
Quentin Grimes,G,22023,1629656,22300057,"NOV 28, 2023",NYK vs. CHA,W,19,2,4,0.5,2,3,0.667,0,0,0.0,1,0,1,1,0,0,1,0,6,2,1,NYK,NYK,CHA,115,,,8,7,7,2
Quentin Grimes,G,22023,1629656,22300247,"NOV 26, 2023",NYK vs. PHX,L,20,1,5,0.2,1,3,0.333,0,0,0.0,1,2,3,2,0,0,1,2,3,-8,1,NYK,NYK,PHX,113,,,8,6,5,5
Quentin Grimes,G,22023,1629656,22300045,"NOV 24, 2023",NYK vs. MIA,W,21,1,4,0.25,1,3,0.333,0,0,0.0,0,0,0,2,1,0,0,3,3,-20,1,NYK,NYK,MIA,100,,,5,3,5,2
Quentin Grimes,G,22023,1629656,22300151,"NOV 06, 2023",NYK vs. LAC,W,21,1,4,0.25,1,4,0.25,0,0,0.0,0,1,1,0,1,0,1,1,3,-6,1,NYK,NYK,LAC,111,,,4,4,3,1
Quentin Grimes,G,22023,1629656,22300090,"OCT 28, 2023",NYK @ NOP,L,27,2,9,0.222,1,6,0.167,0,0,0.0,0,2,2,1,2,0,0,1,5,-2,1,NYK,NOP,NYK,87,,,8,7,6,3
Quentin Grimes,G,22023,1629656,22300079,"OCT 27, 2023",NYK @ ATL,W,25,2,6,0.333,2,5,0.4,0,0,0.0,1,0,1,1,0,0,1,3,6,8,1,NYK,ATL,NYK,126,,,8,7,7,2
Quentin Grimes,G,22023,1629656,22300065,"OCT 25, 2023",NYK vs. BOS,L,23,4,7,0.571,3,6,0.5,0,1,0.0,0,1,1,0,0,0,0,2,11,-1,1,NYK,NYK,BOS,104,,,12,12,11,1
Quentin Grimes,G,22023,1629656,22300193,"NOV 15, 2023",NYK @ ATL,W,29,4,11,0.364,3,8,0.375,0,0,0.0,0,1,1,1,1,0,3,3,11,2,1,NYK,ATL,NYK,116,,,13,12,12,2
Quentin Grimes,G,22023,1629656,22300188,"NOV 13, 2023",NYK @ BOS,L,28,4,6,0.667,4,6,0.667,0,0,0.0,0,0,0,1,0,0,0,2,12,-10,1,NYK,BOS,NYK,98,,,13,12,13,1
Quentin Grimes,G,22023,1629656,22300002,"NOV 03, 2023",NYK @ MIL,L,34,6,11,0.545,5,10,0.5,0,0,0.0,0,4,4,2,0,0,1,3,17,3,1,NYK,MIL,NYK,105,,,23,21,19,6
Quentin Grimes,G,22023,1629656,22300120,"NOV 01, 2023",NYK vs. CLE,L,22,2,7,0.286,1,6,0.167,0,0,0.0,0,2,2,1,1,0,1,0,5,-9,1,NYK,NYK,CLE,89,,,8,7,6,3
Dennis Smith Jr.,G,22023,1628372,22300750,"FEB 10, 2024",BKN vs. SAS,W,24,6,9,0.667,2,3,0.667,0,0,0.0,1,5,6,2,0,1,0,1,14,18,1,BKN,BKN,SAS,123,,,22,20,16,8
Dennis Smith Jr.,G,22023,1628372,22300735,"FEB 08, 2024",BKN vs. CLE,L,26,3,8,0.375,0,0,0.0,0,0,0.0,2,2,4,7,5,0,0,2,6,6,1,BKN,BKN,CLE,95,,,17,10,13,11
Dennis Smith Jr.,G,22023,1628372,22300720,"FEB 06, 2024",BKN vs. DAL,L,18,3,5,0.6,0,1,0.0,0,0,0.0,0,2,2,3,0,0,1,3,6,-7,1,BKN,BKN,DAL,107,,,11,8,9,5
Dennis Smith Jr.,G,22023,1628372,22300717,"FEB 05, 2024",BKN vs. GSW,L,31,4,9,0.444,1,3,0.333,3,5,0.6,4,4,8,5,2,2,4,4,12,1,1,BKN,BKN,GSW,98,,,25,20,17,13
Dennis Smith Jr.,G,22023,1628372,22300677,"JAN 31, 2024",BKN vs. PHX,L,19,2,5,0.4,0,1,0.0,0,0,0.0,3,2,5,2,1,0,0,2,4,-15,1,BKN,BKN,PHX,120,,,11,9,6,7
Dennis Smith Jr.,G,22023,1628372,22300660,"JAN 29, 2024",BKN vs. UTA,W,15,5,8,0.625,0,2,0.0,2,2,1.0,1,1,2,5,2,0,1,2,12,6,1,BKN,BKN,UTA,147,,,19,14,17,7
Dennis Smith Jr.,G,22023,1628372,22300645,"JAN 27, 2024",BKN vs. HOU,W,18,2,4,0.5,0,1,0.0,1,2,0.5,1,2,3,4,2,0,1,2,5,0,1,BKN,BKN,HOU,106,,,12,8,9,7
Dennis Smith Jr.,G,22023,1628372,22300629,"JAN 25, 2024",BKN vs. MIN,L,16,0,4,0.0,0,0,0.0,0,0,0.0,2,0,2,2,0,0,1,1,0,-3,1,BKN,BKN,MIN,94,,,4,2,2,4
Dennis Smith Jr.,G,22023,1628372,22300615,"JAN 23, 2024",BKN vs. NYK,L,29,4,9,0.444,0,1,0.0,0,0,0.0,0,5,5,5,2,1,5,5,8,-11,1,BKN,BKN,NYK,103,,,18,13,13,10
Dennis Smith Jr.,G,22023,1628372,22300600,"JAN 21, 2024",BKN @ LAC,L,18,6,8,0.75,1,2,0.5,0,0,0.0,1,2,3,1,0,0,2,2,13,-2,1,BKN,LAC,BKN,114,,,17,16,14,4
Dennis Smith Jr.,G,22023,1628372,22300591,"JAN 19, 2024",BKN @ LAL,W,17,4,7,0.571,2,4,0.5,1,1,1.0,1,1,2,5,3,0,2,2,11,2,1,BKN,LAL,BKN,130,,,18,13,16,7
Dennis Smith Jr.,G,22023,1628372,22300578,"JAN 17, 2024",BKN @ POR,L,14,1,4,0.25,0,1,0.0,0,0,0.0,2,1,3,2,2,0,1,1,2,-14,1,BKN,POR,BKN,103,,,7,5,4,5
Dennis Smith Jr.,G,22023,1628372,22300562,"JAN 15, 2024",BKN vs. MIA,L,32,3,8,0.375,1,4,0.25,1,2,0.5,1,4,5,5,4,1,2,2,8,10,1,BKN,BKN,MIA,95,,,18,13,13,10
Dennis Smith Jr.,G,22023,1628372,22300527,"JAN 11, 2024",BKN @ CLE,L,23,1,2,0.5,0,0,0.0,0,0,0.0,1,3,4,5,0,1,1,1,2,6,1,BKN,CLE,BKN,102,,,11,6,7,9
Dennis Smith Jr.,G,22023,1628372,22300498,"JAN 07, 2024",BKN vs. POR,L,29,3,8,0.375,0,1,0.0,4,4,1.0,0,2,2,10,2,1,1,6,10,-19,1,BKN,BKN,POR,127,,,22,12,20,12
Dennis Smith Jr.,G,22023,1628372,22300481,"JAN 05, 2024",BKN vs. OKC,W,25,6,11,0.545,1,4,0.25,0,0,0.0,6,6,12,7,2,0,0,4,13,14,1,BKN,BKN,OKC,124,,,32,25,20,19
Dennis Smith Jr.,G,22023,1628372,22300461,"JAN 02, 2024",BKN @ NOP,L,20,3,7,0.429,2,4,0.5,1,2,0.5,0,1,1,4,1,0,1,1,9,-5,1,BKN,NOP,BKN,85,,,14,10,13,5
Dennis Smith Jr.,G,22023,1628372,22300447,"DEC 31, 2023",BKN @ OKC,L,15,2,3,0.667,0,1,0.0,3,3,1.0,1,2,3,4,1,0,3,4,7,-7,1,BKN,OKC,BKN,108,,,14,10,11,7
Dennis Smith Jr.,G,22023,1628372,22300430,"DEC 29, 2023",BKN @ WAS,L,20,2,6,0.333,0,1,0.0,1,2,0.5,0,2,2,3,2,0,0,3,5,-21,1,BKN,WAS,BKN,104,,,10,7,8,5
Dennis Smith Jr.,G,22023,1628372,22300417,"DEC 27, 2023",BKN vs. MIL,L,30,7,17,0.412,0,4,0.0,0,0,0.0,1,6,7,8,1,0,2,0,14,-11,1,BKN,BKN,MIL,122,,,29,21,22,15
Dennis Smith Jr.,G,22023,1628372,22300406,"DEC 26, 2023",BKN @ DET,W,21,3,8,0.375,0,1,0.0,0,0,0.0,0,2,2,3,1,0,3,3,6,3,1,BKN,DET,BKN,118,,,11,8,9,5
Dennis Smith Jr.,G,22023,1628372,22300394,"DEC 23, 2023",BKN vs. DET,W,19,2,6,0.333,1,2,0.5,1,2,0.5,0,0,0,3,0,0,1,3,6,0,1,BKN,BKN,DET,126,,,9,6,9,3
Dennis Smith Jr.,G,22023,1628372,22300383,"DEC 22, 2023",BKN vs. DEN,L,19,2,7,0.286,1,4,0.25,2,2,1.0,1,3,4,5,1,0,0,5,7,9,1,BKN,BKN,DEN,117,,,16,11,12,9
Dennis Smith Jr.,G,22023,1628372,22301209,"DEC 06, 2023",BKN @ ATL,W,22,4,7,0.571,0,0,0.0,5,5,1.0,2,1,3,4,2,0,0,3,13,5,1,BKN,ATL,BKN,114,,,20,16,17,7
Dennis Smith Jr.,G,22023,1628372,22300282,"DEC 02, 2023",BKN vs. ORL,W,21,5,10,0.5,0,3,0.0,0,1,0.0,1,10,11,6,2,1,1,0,10,18,1,BKN,BKN,ORL,129,,,27,21,16,17
Dennis Smith Jr.,G,22023,1628372,22300200,"NOV 16, 2023",BKN @ MIA,L,16,2,6,0.333,1,2,0.5,0,0,0.0,0,2,2,5,0,0,0,2,5,-9,1,BKN,MIA,BKN,115,,,12,7,10,7
Dennis Smith Jr.,G,22023,1628372,22300020,"NOV 14, 2023",BKN vs. ORL,W,19,3,7,0.429,0,1,0.0,0,0,0.0,1,2,3,5,2,0,1,3,6,9,1,BKN,BKN,ORL,124,,,14,9,11,8
Dennis Smith Jr.,G,22023,1628372,22300178,"NOV 12, 2023",BKN vs. WAS,W,19,2,4,0.5,2,2,1.0,2,2,1.0,1,3,4,6,0,0,4,1,8,-10,1,BKN,BKN,WAS,102,,,18,12,14,10
Dennis Smith Jr.,G,22023,1628372,22300010,"NOV 10, 2023",BKN @ BOS,L,27,5,10,0.5,0,1,0.0,4,4,1.0,1,3,4,7,0,0,0,4,14,1,1,BKN,BOS,BKN,107,,,25,18,21,11
Dennis Smith Jr.,G,22023,1628372,22300160,"NOV 08, 2023",BKN vs. LAC,W,25,2,7,0.286,0,3,0.0,0,0,0.0,1,0,1,5,2,0,1,4,4,5,1,BKN,BKN,LAC,100,,,10,5,9,6
Dennis Smith Jr.,G,22023,1628372,22300149,"NOV 06, 2023",BKN vs. MIL,L,11,1,3,0.333,0,0,0.0,0,0,0.0,0,0,0,1,0,0,0,1,2,-14,1,BKN,BKN,MIL,125,,,3,2,3,1
Dennis Smith Jr.,G,22023,1628372,22300136,"NOV 04, 2023",BKN vs. BOS,L,15,2,5,0.4,1,4,0.25,0,0,0.0,0,1,1,1,1,2,1,3,5,-5,1,BKN,BKN,BOS,114,,,7,6,6,2
Dennis Smith Jr.,G,22023,1628372,22300004,"NOV 03, 2023",BKN @ CHI,W,16,3,9,0.333,1,2,0.5,0,0,0.0,1,0,1,1,1,0,1,0,7,8,1,BKN,CHI,BKN,109,,,9,8,8,2
Dennis Smith Jr.,G,22023,1628372,22300101,"OCT 30, 2023",BKN @ CHA,W,14,1,4,0.25,0,1,0.0,1,2,0.5,1,3,4,2,1,0,1,2,3,7,1,BKN,CHA,BKN,133,,,9,7,5,6
Dennis Smith Jr.,G,22023,1628372,22300084,"OCT 27, 2023",BKN @ DAL,L,8,0,3,0.0,0,0,0.0,0,0,0.0,0,1,1,1,0,0,1,4,0,-7,1,BKN,DAL,BKN,120,,,2,1,1,2
Dennis Smith Jr.,G,22023,1628372,22300067,"OCT 25, 2023",BKN vs. CLE,L,16,4,5,0.8,2,3,0.667,0,0,0.0,2,2,4,1,0,0,1,1,10,5,1,BKN,BKN,CLE,113,,,15,14,11,5
Gary Harris,G,22023,203914,22300752,"FEB 10, 2024",ORL vs. CHI,W,22,1,5,0.2,0,2,0.0,0,0,0.0,2,0,2,0,0,0,0,1,2,13,1,ORL,ORL,CHI,114,,,4,4,2,2
Gary Harris,G,22023,203914,22300734,"FEB 08, 2024",ORL vs. SAS,W,19,2,5,0.4,1,3,0.333,0,0,0.0,0,0,0,4,2,2,0,2,5,-2,1,ORL,ORL,SAS,127,,,9,5,9,4
Gary Harris,G,22023,203914,22300721,"FEB 06, 2024",ORL @ MIA,L,19,3,6,0.5,0,3,0.0,1,1,1.0,1,0,1,1,1,0,0,1,7,-17,1,ORL,MIA,ORL,95,,,9,8,8,2
Gary Harris,G,22023,203914,22300704,"FEB 04, 2024",ORL @ DET,W,24,4,9,0.444,2,5,0.4,0,0,0.0,0,1,1,1,0,1,2,3,10,1,1,ORL,DET,ORL,111,,,12,11,11,2
Gary Harris,G,22023,203914,22300694,"FEB 02, 2024",ORL @ MIN,W,18,1,1,1.0,0,0,0.0,0,0,0.0,1,1,2,1,0,0,1,1,2,-4,1,ORL,MIN,ORL,108,,,5,4,3,3
Gary Harris,G,22023,203914,22300463,"JAN 02, 2024",ORL @ GSW,L,29,3,7,0.429,2,6,0.333,0,0,0.0,0,2,2,2,0,0,0,1,8,3,1,ORL,GSW,ORL,115,,,12,10,10,4
Gary Harris,G,22023,203914,22300450,"DEC 31, 2023",ORL @ PHX,L,32,2,7,0.286,1,6,0.167,0,0,0.0,0,2,2,2,0,0,0,1,5,7,1,ORL,PHX,ORL,107,,,9,7,7,4
Gary Harris,G,22023,203914,22300407,"DEC 26, 2023",ORL @ WAS,W,19,1,2,0.5,1,1,1.0,0,0,0.0,0,0,0,1,1,0,1,3,3,4,1,ORL,WAS,ORL,127,,,4,3,4,1
Gary Harris,G,22023,203914,22300391,"DEC 23, 2023",ORL @ IND,W,35,5,9,0.556,2,4,0.5,3,3,1.0,0,1,1,3,2,0,3,2,15,0,1,ORL,IND,ORL,117,,,19,16,18,4
Gary Harris,G,22023,203914,22300378,"DEC 21, 2023",ORL @ MIL,L,35,5,11,0.455,2,6,0.333,2,3,0.667,1,1,2,5,0,0,0,4,14,-11,1,ORL,MIL,ORL,114,,,21,16,19,7
Gary Harris,G,22023,203914,22300366,"DEC 20, 2023",ORL vs. MIA,L,20,0,2,0.0,0,2,0.0,0,0,0.0,3,0,3,1,2,0,0,3,0,4,1,ORL,ORL,MIA,106,,,4,3,1,4
Gary Harris,G,22023,203914,22300344,"DEC 17, 2023",ORL @ BOS,L,26,0,3,0.0,0,3,0.0,0,0,0.0,0,1,1,2,0,0,0,1,0,-26,1,ORL,BOS,ORL,97,,,3,1,2,3
Gary Harris,G,22023,203914,22300329,"DEC 15, 2023",ORL @ BOS,L,16,1,3,0.333,0,2,0.0,0,0,0.0,0,0,0,0,1,0,0,3,2,-10,1,ORL,BOS,ORL,111,,,2,2,2,0
Gary Harris,G,22023,203914,22300294,"DEC 11, 2023",ORL vs. CLE,W,26,1,3,0.333,1,3,0.333,0,0,0.0,0,1,1,2,0,1,0,2,3,1,1,ORL,ORL,CLE,104,,,6,4,5,3
Gary Harris,G,22023,203914,22301217,"DEC 08, 2023",ORL vs. DET,W,23,4,8,0.5,2,5,0.4,1,1,1.0,0,3,3,1,2,0,1,3,11,23,1,ORL,ORL,DET,123,,,15,14,12,4
Gary Harris,G,22023,203914,22301205,"DEC 06, 2023",ORL @ CLE,L,31,1,7,0.143,0,4,0.0,6,6,1.0,1,2,3,3,1,0,0,4,8,0,1,ORL,CLE,ORL,111,,,14,11,11,6
Gary Harris,G,22023,203914,22300282,"DEC 02, 2023",ORL @ BKN,L,21,2,8,0.25,0,5,0.0,0,0,0.0,0,1,1,2,0,0,0,1,4,-7,1,ORL,BKN,ORL,101,,,7,5,6,3
Gary Harris,G,22023,203914,22300274,"DEC 01, 2023",ORL vs. WAS,W,22,3,9,0.333,1,6,0.167,1,2,0.5,0,0,0,0,0,0,1,0,8,-11,1,ORL,ORL,WAS,130,,,8,8,8,0
Gary Harris,G,22023,203914,22300259,"NOV 29, 2023",ORL vs. WAS,W,19,2,2,1.0,2,2,1.0,2,3,0.667,0,2,2,4,2,0,1,3,8,20,1,ORL,ORL,WAS,139,,,14,10,12,6
Gary Harris,G,22023,203914,22300248,"NOV 26, 2023",ORL vs. CHA,W,24,2,6,0.333,1,5,0.2,0,0,0.0,0,0,0,6,1,0,0,2,5,5,1,ORL,ORL,CHA,130,,,11,5,11,6
Gary Harris,G,22023,203914,22300043,"NOV 24, 2023",ORL vs. BOS,W,19,1,3,0.333,1,3,0.333,1,1,1.0,2,1,3,0,0,0,2,1,4,9,1,ORL,ORL,BOS,113,,,7,7,4,3
Gary Harris,G,22023,203914,22300226,"NOV 22, 2023",ORL vs. DEN,W,23,1,7,0.143,1,6,0.167,2,2,1.0,0,3,3,3,3,0,0,2,5,1,1,ORL,ORL,DEN,124,,,11,8,8,6
Gary Harris,G,22023,203914,22300038,"NOV 21, 2023",ORL vs. TOR,W,23,4,7,0.571,2,5,0.4,0,0,0.0,0,1,1,1,1,0,0,3,10,18,1,ORL,ORL,TOR,126,,,12,11,11,2
Gary Harris,G,22023,203914,22300209,"NOV 19, 2023",ORL @ IND,W,22,4,6,0.667,3,3,1.0,2,2,1.0,0,0,0,2,2,0,0,1,13,10,1,ORL,IND,ORL,128,,,15,13,15,2
Gary Harris,G,22023,203914,22300033,"NOV 17, 2023",ORL @ CHI,W,29,5,10,0.5,3,7,0.429,2,2,1.0,2,4,6,2,1,2,0,3,15,5,1,ORL,CHI,ORL,103,,,23,21,17,8
Gary Harris,G,22023,203914,22300196,"NOV 15, 2023",ORL @ CHI,W,21,2,4,0.5,1,3,0.333,1,2,0.5,0,0,0,0,2,0,0,0,6,2,1,ORL,CHI,ORL,96,,,6,6,6,0
Gary Harris,G,22023,203914,22300130,"NOV 02, 2023",ORL @ UTA,W,14,0,2,0.0,0,2,0.0,0,0,0.0,0,0,0,1,0,1,0,1,0,6,1,ORL,UTA,ORL,115,,,1,0,1,1
Gary Harris,G,22023,203914,22300114,"OCT 31, 2023",ORL @ LAC,L,18,3,5,0.6,2,4,0.5,1,3,0.333,0,2,2,2,1,0,0,1,9,0,1,ORL,LAC,ORL,102,,,13,11,11,4
Gary Harris,G,22023,203914,22300111,"OCT 30, 2023",ORL @ LAL,L,21,6,6,1.0,5,5,1.0,0,0,0.0,1,2,3,3,0,0,3,0,17,4,1,ORL,LAL,ORL,103,,,23,20,20,6
Gary Harris,G,22023,203914,22300086,"OCT 27, 2023",ORL @ POR,W,19,1,5,0.2,1,3,0.333,0,0,0.0,0,1,1,1,0,0,1,0,3,2,1,ORL,POR,ORL,102,,,5,4,4,2
Gary Harris,G,22023,203914,22300066,"OCT 25, 2023",ORL vs. HOU,W,17,5,8,0.625,1,4,0.25,0,0,0.0,3,2,5,0,0,1,0,0,11,8,1,ORL,ORL,HOU,116,,,16,16,11,5
Gary Harris,G,22023,203914,22300476,"JAN 03, 2024",ORL @ SAC,L,12,2,4,0.5,1,3,0.333,0,1,0.0,0,1,1,1,1,0,1,2,5,-8,1,ORL,SAC,ORL,135,,,7,6,6,2
Christian Wood,F,22023,1626174,22300605,"JAN 21, 2024",LAL vs. POR,W,18,2,3,0.667,0,1,0.0,0,0,0.0,1,5,6,2,2,3,0,2,4,20,1,LAL,LAL,POR,134,,,12,10,6,8
Christian Wood,F,22023,1626174,22300331,"DEC 15, 2023",LAL @ SAS,L,30,6,10,0.6,2,5,0.4,3,8,0.375,2,6,8,3,1,2,0,1,17,13,1,LAL,SAS,LAL,115,,,28,25,20,11
Christian Wood,F,22023,1626174,22300271,"NOV 30, 2023",LAL @ OKC,L,20,1,6,0.167,0,2,0.0,5,7,0.714,1,3,4,1,0,0,1,1,7,-11,1,LAL,OKC,LAL,110,,,12,11,8,5
Christian Wood,F,22023,1626174,22300163,"NOV 08, 2023",LAL @ HOU,L,22,0,1,0.0,0,0,0.0,0,2,0.0,0,4,4,1,0,0,0,4,0,-19,1,LAL,HOU,LAL,94,,,5,4,1,5
Christian Wood,F,22023,1626174,22300134,"NOV 04, 2023",LAL @ ORL,L,29,2,6,0.333,2,5,0.4,0,0,0.0,0,2,2,2,1,2,3,3,6,-11,1,LAL,ORL,LAL,101,,,10,8,8,4
Christian Wood,F,22023,1626174,22300740,"FEB 08, 2024",LAL vs. DEN,L,19,1,1,1.0,0,0,0.0,1,2,0.5,0,4,4,1,1,1,0,2,3,7,1,LAL,LAL,DEN,106,,,8,7,4,5
Christian Wood,F,22023,1626174,22300713,"FEB 05, 2024",LAL @ CHA,W,10,3,5,0.6,1,2,0.5,4,4,1.0,1,5,6,0,0,0,0,1,11,3,1,LAL,CHA,LAL,124,,,17,17,11,6
Christian Wood,F,22023,1626174,22300701,"FEB 03, 2024",LAL @ NYK,W,7,0,2,0.0,0,2,0.0,0,0,0.0,0,0,0,0,0,0,0,0,0,-2,1,LAL,NYK,LAL,113,,,0,0,0,0
Christian Wood,F,22023,1626174,22300684,"FEB 01, 2024",LAL @ BOS,W,19,1,9,0.111,1,4,0.25,1,2,0.5,2,2,4,1,1,0,0,0,4,2,1,LAL,BOS,LAL,114,,,9,8,5,5
Christian Wood,F,22023,1626174,22300669,"JAN 30, 2024",LAL @ ATL,L,22,4,7,0.571,0,1,0.0,1,2,0.5,1,7,8,2,0,0,0,2,9,-4,1,LAL,ATL,LAL,122,,,19,17,11,10
Christian Wood,F,22023,1626174,22300662,"JAN 29, 2024",LAL @ HOU,L,10,1,6,0.167,0,2,0.0,0,0,0.0,0,2,2,0,2,0,2,2,2,-9,1,LAL,HOU,LAL,119,,,4,4,2,2
Christian Wood,F,22023,1626174,22300650,"JAN 27, 2024",LAL @ GSW,W,11,3,4,0.75,0,1,0.0,2,2,1.0,0,1,1,1,0,0,1,1,8,-14,1,LAL,GSW,LAL,145,,,10,9,9,2
Christian Wood,F,22023,1626174,22300633,"JAN 25, 2024",LAL vs. CHI,W,12,0,1,0.0,0,0,0.0,2,2,1.0,0,0,0,0,0,1,0,3,2,-4,1,LAL,LAL,CHI,141,,,2,2,2,0
Christian Wood,F,22023,1626174,22300618,"JAN 23, 2024",LAL @ LAC,L,14,2,2,1.0,0,0,0.0,2,5,0.4,0,7,7,3,0,0,1,0,6,-5,1,LAL,LAC,LAL,116,,,16,13,9,10
Christian Wood,F,22023,1626174,22300591,"JAN 19, 2024",LAL vs. BKN,L,11,1,6,0.167,1,3,0.333,2,2,1.0,0,4,4,3,1,1,1,0,5,-7,1,LAL,LAL,BKN,112,,,12,9,8,7
Christian Wood,F,22023,1626174,22300577,"JAN 17, 2024",LAL vs. DAL,W,17,1,5,0.2,0,3,0.0,0,0,0.0,0,2,2,1,1,0,1,0,2,-6,1,LAL,LAL,DAL,127,,,5,4,3,3
Christian Wood,F,22023,1626174,22300565,"JAN 15, 2024",LAL vs. OKC,W,14,4,7,0.571,1,2,0.5,2,2,1.0,2,5,7,1,0,3,1,2,11,-2,1,LAL,LAL,OKC,112,,,19,18,12,8
Christian Wood,F,22023,1626174,22300549,"JAN 13, 2024",LAL @ UTA,L,22,5,10,0.5,2,6,0.333,3,3,1.0,1,8,9,1,0,1,0,1,15,-4,1,LAL,UTA,LAL,125,,,25,24,16,10
Christian Wood,F,22023,1626174,22300516,"JAN 09, 2024",LAL vs. TOR,W,24,5,10,0.5,2,4,0.5,2,2,1.0,0,4,4,1,1,1,2,5,14,3,1,LAL,LAL,TOR,132,,,19,18,15,5
Christian Wood,F,22023,1626174,22300505,"JAN 07, 2024",LAL vs. LAC,W,16,4,6,0.667,1,2,0.5,0,0,0.0,1,9,10,0,0,2,1,2,9,7,1,LAL,LAL,LAC,106,,,19,19,9,10
Christian Wood,F,22023,1626174,22300491,"JAN 05, 2024",LAL vs. MEM,L,16,3,5,0.6,1,2,0.5,4,4,1.0,0,5,5,0,1,0,1,0,11,6,1,LAL,LAL,MEM,113,,,16,16,11,5
Christian Wood,F,22023,1626174,22300475,"JAN 03, 2024",LAL vs. MIA,L,24,5,10,0.5,0,2,0.0,3,3,1.0,4,4,8,3,0,1,2,1,13,1,1,LAL,LAL,MIA,96,,,24,21,16,11
Christian Wood,F,22023,1626174,22300446,"DEC 31, 2023",LAL @ NOP,L,25,1,4,0.25,1,4,0.25,0,0,0.0,0,5,5,1,0,1,0,1,3,-12,1,LAL,NOP,LAL,109,,,9,8,4,6
Christian Wood,F,22023,1626174,22300428,"DEC 28, 2023",LAL vs. CHA,W,23,3,4,0.75,3,3,1.0,0,0,0.0,0,5,5,4,0,1,2,2,9,19,1,LAL,LAL,CHA,133,,,18,14,13,9
Christian Wood,F,22023,1626174,22300370,"DEC 20, 2023",LAL @ CHI,L,1,0,0,0.0,0,0,0.0,0,0,0.0,0,0,0,0,0,1,1,0,0,0,1,LAL,CHI,LAL,108,,,0,0,0,0
Christian Wood,F,22023,1626174,22300316,"DEC 13, 2023",LAL @ SAS,W,21,4,7,0.571,1,3,0.333,0,2,0.0,1,5,6,1,0,0,0,2,9,-13,1,LAL,SAS,LAL,122,,,16,15,10,7
Christian Wood,F,22023,1626174,22301230,"DEC 07, 2023",LAL vs. NOP,W,8,2,4,0.5,0,1,0.0,0,0,0.0,3,3,6,2,0,0,2,0,4,6,1,LAL,LAL,NOP,133,,,12,10,6,8
Christian Wood,F,22023,1626174,22300291,"DEC 02, 2023",LAL vs. HOU,W,11,0,1,0.0,0,0,0.0,1,2,0.5,0,2,2,1,0,0,1,0,1,-6,1,LAL,LAL,HOU,107,,,4,3,2,3
Christian Wood,F,22023,1626174,22300258,"NOV 29, 2023",LAL @ DET,W,25,4,9,0.444,0,4,0.0,4,4,1.0,0,9,9,0,1,2,1,1,12,2,1,LAL,DET,LAL,133,,,21,21,12,9
Christian Wood,F,22023,1626174,22300255,"NOV 27, 2023",LAL @ PHI,L,22,3,9,0.333,0,5,0.0,0,0,0.0,0,7,7,1,0,1,3,1,6,-15,1,LAL,PHI,LAL,94,,,14,13,7,8
Christian Wood,F,22023,1626174,22300242,"NOV 25, 2023",LAL @ CLE,W,17,5,7,0.714,2,3,0.667,1,1,1.0,1,2,3,0,0,0,1,1,13,-8,1,LAL,CLE,LAL,121,,,16,16,13,3
Christian Wood,F,22023,1626174,22300238,"NOV 22, 2023",LAL vs. DAL,L,15,0,1,0.0,0,0,0.0,1,2,0.5,0,5,5,1,0,0,0,1,1,-15,1,LAL,LAL,DAL,101,,,7,6,2,6
Christian Wood,F,22023,1626174,22300042,"NOV 21, 2023",LAL vs. UTA,W,27,6,7,0.857,1,2,0.5,3,3,1.0,1,7,8,2,0,1,2,5,16,13,1,LAL,LAL,UTA,131,,,26,24,18,10
Christian Wood,F,22023,1626174,22300036,"NOV 17, 2023",LAL @ POR,W,20,5,9,0.556,0,3,0.0,0,0,0.0,2,8,10,0,0,0,0,1,10,6,1,LAL,POR,LAL,107,,,20,20,10,10
Christian Wood,F,22023,1626174,22300198,"NOV 15, 2023",LAL vs. SAC,L,9,2,2,1.0,0,0,0.0,1,2,0.5,0,2,2,0,0,0,1,1,5,-6,1,LAL,LAL,SAC,110,,,7,7,5,2
Christian Wood,F,22023,1626174,22300026,"NOV 14, 2023",LAL vs. MEM,W,22,1,8,0.125,0,3,0.0,0,0,0.0,3,7,10,2,0,1,3,2,2,9,1,LAL,LAL,MEM,134,,,14,12,4,12
Christian Wood,F,22023,1626174,22300187,"NOV 12, 2023",LAL vs. POR,W,15,1,4,0.25,0,2,0.0,5,7,0.714,1,0,1,0,0,0,1,2,7,-11,1,LAL,LAL,POR,116,,,8,8,7,1
Christian Wood,F,22023,1626174,22300150,"NOV 06, 2023",LAL @ MIA,L,30,4,10,0.4,3,6,0.5,1,2,0.5,0,6,6,1,1,0,1,2,12,-1,1,LAL,MIA,LAL,107,,,19,18,13,7
Christian Wood,F,22023,1626174,22300127,"NOV 01, 2023",LAL vs. LAC,W,29,4,6,0.667,2,4,0.5,0,0,0.0,2,9,11,0,1,1,2,3,10,14,1,LAL,LAL,LAC,130,,,21,21,10,11
Christian Wood,F,22023,1626174,22300061,"OCT 24, 2023",LAL @ DEN,L,15,3,4,0.75,0,1,0.0,1,2,0.5,1,3,4,0,0,0,1,1,7,2,1,LAL,DEN,LAL,107,,,11,11,7,4
Christian Wood,F,22023,1626174,22300747,"FEB 09, 2024",LAL vs. NOP,W,6,4,5,0.8,1,1,1.0,0,0,0.0,1,0,1,0,0,0,1,0,9,2,1,LAL,LAL,NOP,139,,,10,10,9,1
Christian Wood,F,22023,1626174,22300443,"DEC 30, 2023",LAL @ MIN,L,13,2,4,0.5,2,2,1.0,1,2,0.5,0,5,5,0,0,1,2,1,7,3,1,LAL,MIN,LAL,106,,,12,12,7,5
Christian Wood,F,22023,1626174,22300380,"DEC 21, 2023",LAL @ MIN,L,3,0,0,0.0,0,0,0.0,0,0,0.0,0,0,0,0,0,0,1,0,0,-12,1,LAL,MIN,LAL,111,,,0,0,0,0
Christian Wood,F,22023,1626174,22300216,"NOV 19, 2023",LAL vs. HOU,W,18,0,4,0.0,0,3,0.0,0,0,0.0,0,2,2,0,0,0,1,3,0,8,1,LAL,LAL,HOU,105,,,2,2,0,2
Christian Wood,F,22023,1626174,22300015,"NOV 10, 2023",LAL @ PHX,W,18,2,5,0.4,1,1,1.0,0,0,0.0,3,6,9,0,0,1,1,0,5,8,1,LAL,PHX,LAL,122,,,14,14,5,9
Christian Wood,F,22023,1626174,22300111,"OCT 30, 2023",LAL vs. ORL,W,26,3,6,0.5,1,4,0.25,2,4,0.5,1,8,9,3,0,3,3,3,9,12,1,LAL,LAL,ORL,106,,,21,18,12,12
Christian Wood,F,22023,1626174,22300100,"OCT 29, 2023",LAL @ SAC,L,14,3,3,1.0,2,2,1.0,3,3,1.0,0,5,5,1,0,0,0,0,11,12,1,LAL,SAC,LAL,127,,,17,16,12,6
Christian Wood,F,22023,1626174,22300076,"OCT 26, 2023",LAL vs. PHX,W,21,2,7,0.286,0,2,0.0,3,4,0.75,2,8,10,1,0,0,1,2,7,23,1,LAL,LAL,PHX,100,,,18,17,8,11
Christian Braun,G,22023,1631128,22300746,"FEB 09, 2024",DEN @ SAC,L,27,4,8,0.5,1,2,0.5,4,4,1.0,2,1,3,1,0,1,1,3,13,-13,1,DEN,SAC,DEN,106,,,17,16,14,4
Christian Braun,G,22023,1631128,22300740,"FEB 08, 2024",DEN @ LAL,W,13,1,3,0.333,1,1,1.0,0,0,0.0,1,0,1,1,0,1,0,0,3,-9,1,DEN,LAL,DEN,114,,,5,4,4,2
Christian Braun,G,22023,1631128,22300712,"FEB 04, 2024",DEN vs. POR,W,28,1,4,0.25,0,0,0.0,2,3,0.667,2,1,3,2,1,0,0,0,4,18,1,DEN,DEN,POR,112,,,9,7,6,5
Christian Braun,G,22023,1631128,22300697,"FEB 02, 2024",DEN vs. POR,W,8,1,2,0.5,0,1,0.0,0,0,0.0,1,1,2,0,0,0,1,1,2,-7,1,DEN,DEN,POR,120,,,4,4,2,2
Christian Braun,G,22023,1631128,22300682,"JAN 31, 2024",DEN @ OKC,L,16,4,7,0.571,2,4,0.5,0,0,0.0,1,4,5,0,1,0,0,0,10,-12,1,DEN,OKC,DEN,100,,,15,15,10,5
Christian Braun,G,22023,1631128,22300667,"JAN 29, 2024",DEN vs. MIL,W,17,0,1,0.0,0,0,0.0,0,0,0.0,2,4,6,1,0,0,0,2,0,10,1,DEN,DEN,MIL,113,,,7,6,1,7
Christian Braun,G,22023,1631128,22300644,"JAN 27, 2024",DEN vs. PHI,W,17,0,2,0.0,0,1,0.0,2,2,1.0,0,0,0,2,0,0,0,2,2,0,1,DEN,DEN,PHI,111,,,4,2,4,2
Christian Braun,G,22023,1631128,22300631,"JAN 25, 2024",DEN @ NYK,L,15,1,4,0.25,0,1,0.0,2,2,1.0,1,2,3,0,0,0,1,1,4,-10,1,DEN,NYK,DEN,84,,,7,7,4,3
Christian Braun,G,22023,1631128,22300614,"JAN 23, 2024",DEN @ IND,W,15,1,3,0.333,0,2,0.0,0,0,0.0,3,1,4,0,1,1,0,0,2,-1,1,DEN,IND,DEN,114,,,6,6,2,4
Christian Braun,G,22023,1631128,22300602,"JAN 21, 2024",DEN @ WAS,W,21,1,3,0.333,0,0,0.0,0,0,0.0,2,4,6,2,0,1,1,3,2,-9,1,DEN,WAS,DEN,113,,,10,8,4,8
Christian Braun,G,22023,1631128,22300586,"JAN 19, 2024",DEN @ BOS,W,5,0,2,0.0,0,2,0.0,0,0,0.0,0,0,0,0,0,0,0,0,0,-7,1,DEN,BOS,DEN,102,,,0,0,0,0
Christian Braun,G,22023,1631128,22300566,"JAN 16, 2024",DEN @ PHI,L,18,3,5,0.6,2,3,0.667,3,3,1.0,0,4,4,0,0,1,0,3,11,3,1,DEN,PHI,DEN,121,,,15,15,11,4
Christian Braun,G,22023,1631128,22300550,"JAN 14, 2024",DEN vs. IND,W,15,1,5,0.2,0,1,0.0,0,2,0.0,0,2,2,0,0,0,0,1,2,-5,1,DEN,DEN,IND,117,,,4,4,2,2
Christian Braun,G,22023,1631128,22300539,"JAN 12, 2024",DEN vs. NOP,W,17,1,4,0.25,1,4,0.25,1,2,0.5,1,5,6,0,0,0,3,2,4,7,1,DEN,DEN,NOP,125,,,10,10,4,6
Christian Braun,G,22023,1631128,22300524,"JAN 10, 2024",DEN @ UTA,L,17,2,4,0.5,1,2,0.5,0,0,0.0,0,3,3,1,1,0,1,1,5,-5,1,DEN,UTA,DEN,111,,,9,8,6,4
Christian Braun,G,22023,1631128,22300502,"JAN 07, 2024",DEN vs. DET,W,21,3,5,0.6,0,1,0.0,1,2,0.5,0,3,3,1,0,1,0,0,7,6,1,DEN,DEN,DET,131,,,11,10,8,4
Christian Braun,G,22023,1631128,22300488,"JAN 05, 2024",DEN vs. ORL,L,16,2,4,0.5,1,3,0.333,1,2,0.5,1,3,4,0,0,0,1,0,6,-2,1,DEN,DEN,ORL,120,,,10,10,6,4
Christian Braun,G,22023,1631128,22300478,"JAN 04, 2024",DEN @ GSW,W,18,1,4,0.25,0,2,0.0,0,0,0.0,0,0,0,1,1,1,1,3,2,-5,1,DEN,GSW,DEN,130,,,3,2,3,1
Christian Braun,G,22023,1631128,22300455,"JAN 01, 2024",DEN vs. CHA,W,24,3,6,0.5,1,3,0.333,2,3,0.667,1,3,4,2,1,2,1,1,9,-11,1,DEN,DEN,CHA,111,,,15,13,11,6
Christian Braun,G,22023,1631128,22300435,"DEC 29, 2023",DEN vs. OKC,L,17,0,3,0.0,0,2,0.0,4,4,1.0,0,3,3,1,0,0,1,1,4,-6,1,DEN,DEN,OKC,93,,,8,7,5,4
Christian Braun,G,22023,1631128,22300425,"DEC 28, 2023",DEN vs. MEM,W,23,4,8,0.5,1,2,0.5,2,4,0.5,0,3,3,4,1,0,0,0,11,13,1,DEN,DEN,MEM,142,,,18,14,15,7
Christian Braun,G,22023,1631128,22300402,"DEC 25, 2023",DEN vs. GSW,W,11,2,4,0.5,2,2,1.0,0,2,0.0,0,0,0,1,0,0,1,3,6,-22,1,DEN,DEN,GSW,120,,,7,6,7,1
Christian Braun,G,22023,1631128,22300390,"DEC 23, 2023",DEN @ CHA,W,18,3,7,0.429,2,3,0.667,3,3,1.0,2,5,7,1,0,2,1,1,11,-8,1,DEN,CHA,DEN,102,,,19,18,12,8
Christian Braun,G,22023,1631128,22300383,"DEC 22, 2023",DEN @ BKN,W,16,0,3,0.0,0,1,0.0,2,2,1.0,0,0,0,1,0,0,0,1,2,-12,1,DEN,BKN,DEN,122,,,3,2,3,1
Christian Braun,G,22023,1631128,22300369,"DEC 20, 2023",DEN @ TOR,W,17,1,4,0.25,1,2,0.5,0,0,0.0,1,2,3,2,1,0,0,0,3,-6,1,DEN,TOR,DEN,113,,,8,6,5,5
Christian Braun,G,22023,1631128,22300356,"DEC 18, 2023",DEN vs. DAL,W,20,2,4,0.5,0,1,0.0,2,3,0.667,0,4,4,1,0,0,1,4,6,19,1,DEN,DEN,DAL,130,,,11,10,7,5
Christian Braun,G,22023,1631128,22300340,"DEC 16, 2023",DEN vs. OKC,L,25,5,10,0.5,2,5,0.4,2,2,1.0,0,2,2,1,1,0,1,3,14,1,1,DEN,DEN,OKC,117,,,17,16,15,3
Christian Braun,G,22023,1631128,22300322,"DEC 14, 2023",DEN vs. BKN,W,24,4,10,0.4,1,3,0.333,1,1,1.0,1,3,4,2,0,2,1,0,10,7,1,DEN,DEN,BKN,124,,,16,14,12,6
Christian Braun,G,22023,1631128,22300307,"DEC 12, 2023",DEN @ CHI,W,23,4,6,0.667,2,4,0.5,3,4,0.75,1,1,2,2,0,1,3,1,13,-16,1,DEN,CHI,DEN,114,,,17,15,15,4
Christian Braun,G,22023,1631128,22300296,"DEC 11, 2023",DEN @ ATL,W,11,2,3,0.667,0,0,0.0,2,2,1.0,0,2,2,1,0,0,0,2,6,-2,1,DEN,ATL,DEN,129,,,9,8,7,3
Christian Braun,G,22023,1631128,22301224,"DEC 08, 2023",DEN vs. HOU,L,14,1,4,0.25,0,2,0.0,0,0,0.0,0,1,1,1,2,0,1,3,2,-9,1,DEN,DEN,HOU,106,,,4,3,3,2
Christian Braun,G,22023,1631128,22301215,"DEC 06, 2023",DEN @ LAC,L,16,4,6,0.667,0,1,0.0,0,0,0.0,1,4,5,0,0,1,0,3,8,-17,1,DEN,LAC,DEN,102,,,13,13,8,5
Christian Braun,G,22023,1631128,22300290,"DEC 02, 2023",DEN @ SAC,L,17,5,10,0.5,1,2,0.5,0,0,0.0,0,3,3,2,1,1,1,1,11,0,1,DEN,SAC,DEN,117,,,16,14,13,5
Christian Braun,G,22023,1631128,22300279,"DEC 01, 2023",DEN @ PHX,W,22,4,6,0.667,0,0,0.0,0,0,0.0,1,3,4,4,1,0,1,0,8,5,1,DEN,PHX,DEN,119,,,16,12,12,8
Christian Braun,G,22023,1631128,22300263,"NOV 29, 2023",DEN vs. HOU,W,19,4,7,0.571,1,2,0.5,2,2,1.0,1,2,3,1,0,0,2,2,11,0,1,DEN,DEN,HOU,134,,,15,14,12,4
Christian Braun,G,22023,1631128,22300257,"NOV 27, 2023",DEN @ LAC,W,12,0,4,0.0,0,1,0.0,0,0,0.0,1,1,2,2,0,0,0,4,0,-19,1,DEN,LAC,DEN,113,,,4,2,2,4
Christian Braun,G,22023,1631128,22300252,"NOV 26, 2023",DEN vs. SAS,W,25,1,5,0.2,0,1,0.0,3,4,0.75,1,3,4,4,0,0,0,1,5,0,1,DEN,DEN,SAS,132,,,13,9,9,8
Christian Braun,G,22023,1631128,22300048,"NOV 24, 2023",DEN @ HOU,L,26,3,9,0.333,0,0,0.0,1,1,1.0,0,3,3,0,0,0,0,1,7,-2,1,DEN,HOU,DEN,86,,,10,10,7,3
Christian Braun,G,22023,1631128,22300226,"NOV 22, 2023",DEN @ ORL,L,21,4,7,0.571,2,2,1.0,3,3,1.0,1,6,7,1,0,0,3,4,13,-13,1,DEN,ORL,DEN,119,,,21,20,14,8
Christian Braun,G,22023,1631128,22300218,"NOV 20, 2023",DEN @ DET,W,32,5,10,0.5,2,2,1.0,3,4,0.75,1,5,6,2,1,1,2,2,15,21,1,DEN,DET,DEN,107,,,23,21,17,8
Christian Braun,G,22023,1631128,22300210,"NOV 19, 2023",DEN @ CLE,L,25,6,11,0.545,1,1,1.0,0,0,0.0,0,2,2,0,0,0,0,1,13,3,1,DEN,CLE,DEN,109,,,15,15,13,2
Christian Braun,G,22023,1631128,22300034,"NOV 17, 2023",DEN @ NOP,L,30,11,19,0.579,3,5,0.6,0,1,0.0,2,7,9,3,0,0,0,1,25,3,1,DEN,NOP,DEN,110,,,37,34,28,12
Christian Braun,G,22023,1631128,22300024,"NOV 14, 2023",DEN vs. LAC,W,20,5,6,0.833,0,0,0.0,0,0,0.0,0,1,1,1,0,0,0,3,10,-3,1,DEN,DEN,LAC,111,,,12,11,11,2
Christian Braun,G,22023,1631128,22300182,"NOV 12, 2023",DEN @ HOU,L,14,0,4,0.0,0,2,0.0,0,0,0.0,1,0,1,0,0,0,1,1,0,-11,1,DEN,HOU,DEN,104,,,1,1,0,1
Christian Braun,G,22023,1631128,22300169,"NOV 08, 2023",DEN vs. GSW,W,16,1,3,0.333,1,2,0.5,1,2,0.5,0,2,2,2,0,0,0,1,4,-8,1,DEN,DEN,GSW,108,,,8,6,6,4
Christian Braun,G,22023,1631128,22300156,"NOV 06, 2023",DEN vs. NOP,W,18,1,5,0.2,0,1,0.0,4,6,0.667,0,0,0,1,0,0,0,1,6,4,1,DEN,DEN,NOP,134,,,7,6,7,1
Christian Braun,G,22023,1631128,22300139,"NOV 04, 2023",DEN vs. CHI,W,18,4,8,0.5,1,3,0.333,1,2,0.5,1,4,5,4,1,0,0,1,10,-3,1,DEN,DEN,CHI,123,,,19,15,14,9
Christian Braun,G,22023,1631128,22300006,"NOV 03, 2023",DEN vs. DAL,W,15,3,4,0.75,0,0,0.0,3,3,1.0,2,3,5,0,1,0,1,3,9,-5,1,DEN,DEN,DAL,125,,,14,14,9,5
Christian Braun,G,22023,1631128,22300123,"NOV 01, 2023",DEN @ MIN,L,20,4,8,0.5,0,1,0.0,0,0,0.0,3,6,9,2,0,1,1,3,8,-3,1,DEN,MIN,DEN,89,,,19,17,10,11
Christian Braun,G,22023,1631128,22300110,"OCT 30, 2023",DEN vs. UTA,W,30,4,8,0.5,1,2,0.5,0,0,0.0,1,7,8,2,1,0,1,0,9,6,1,DEN,DEN,UTA,110,,,19,17,11,10
Christian Braun,G,22023,1631128,22300095,"OCT 29, 2023",DEN @ OKC,W,21,4,9,0.444,0,2,0.0,5,5,1.0,1,6,7,7,1,1,0,2,13,25,1,DEN,OKC,DEN,128,,,27,20,20,14
Christian Braun,G,22023,1631128,22300078,"OCT 27, 2023",DEN @ MEM,W,19,2,6,0.333,1,4,0.25,0,2,0.0,1,3,4,2,1,0,1,1,5,0,1,DEN,MEM,DEN,108,,,11,9,7,6
Christian Braun,G,22023,1631128,22300061,"OCT 24, 2023",DEN vs. LAL,W,19,2,5,0.4,0,1,0.0,1,2,0.5,1,2,3,2,0,1,1,1,5,5,1,DEN,DEN,LAL,119,,,10,8,7,5
Marcus Sasser,G,22023,1631204,22300534,"JAN 12, 2024",DET vs. HOU,L,11,0,2,0.0,0,1,0.0,0,0,0.0,1,0,1,7,1,0,1,2,0,3,1,DET,DET,HOU,110,,,8,1,7,8
Marcus Sasser,G,22023,1631204,22300453,"JAN 01, 2024",DET @ HOU,L,7,3,3,1.0,2,2,1.0,1,2,0.5,0,0,0,2,0,0,0,0,9,7,1,DET,HOU,DET,113,,,11,9,11,2
Marcus Sasser,G,22023,1631204,22300394,"DEC 23, 2023",DET @ BKN,L,6,0,1,0.0,0,1,0.0,0,0,0.0,0,1,1,0,0,0,2,2,0,-5,1,DET,BKN,DET,115,,,1,1,0,1
Marcus Sasser,G,22023,1631204,22300374,"DEC 21, 2023",DET vs. UTA,L,13,3,8,0.375,2,5,0.4,0,0,0.0,1,2,3,0,0,0,2,0,8,-13,1,DET,DET,UTA,111,,,11,11,8,3
Marcus Sasser,G,22023,1631204,22300352,"DEC 18, 2023",DET @ ATL,L,21,2,3,0.667,1,1,1.0,0,0,0.0,0,1,1,1,1,1,0,6,5,10,1,DET,ATL,DET,124,,,7,6,6,2
Marcus Sasser,G,22023,1631204,22300334,"DEC 16, 2023",DET @ MIL,L,17,2,4,0.5,1,2,0.5,6,6,1.0,0,1,1,2,2,0,2,2,11,-15,1,DET,MIL,DET,114,,,14,12,13,3
Marcus Sasser,G,22023,1631204,22301217,"DEC 08, 2023",DET @ ORL,L,5,2,3,0.667,0,1,0.0,0,0,0.0,0,0,0,1,0,0,0,0,4,-3,1,DET,ORL,DET,91,,,5,4,5,1
Marcus Sasser,G,22023,1631204,22300283,"DEC 02, 2023",DET vs. CLE,L,16,2,5,0.4,0,2,0.0,0,0,0.0,0,2,2,1,0,0,2,1,4,-21,1,DET,DET,CLE,101,,,7,6,5,3
Marcus Sasser,G,22023,1631204,22300268,"NOV 30, 2023",DET @ NYK,L,20,6,11,0.545,5,7,0.714,0,0,0.0,0,2,2,4,1,0,0,3,17,-3,1,DET,NYK,DET,112,,,23,19,21,6
Marcus Sasser,G,22023,1631204,22300258,"NOV 29, 2023",DET vs. LAL,L,28,3,8,0.375,1,2,0.5,2,2,1.0,0,1,1,8,2,1,1,2,9,-8,1,DET,DET,LAL,107,,,18,10,17,9
Marcus Sasser,G,22023,1631204,22300047,"NOV 24, 2023",DET @ IND,L,5,0,1,0.0,0,0,0.0,0,0,0.0,0,0,0,0,0,0,0,0,0,-2,1,DET,IND,DET,113,,,0,0,0,0
Marcus Sasser,G,22023,1631204,22300218,"NOV 20, 2023",DET vs. DEN,L,5,1,2,0.5,0,1,0.0,0,0,0.0,0,0,0,0,0,0,0,0,2,2,1,DET,DET,DEN,103,,,2,2,2,0
Marcus Sasser,G,22023,1631204,22300211,"NOV 19, 2023",DET @ TOR,L,21,4,6,0.667,1,2,0.5,0,0,0.0,0,1,1,6,1,0,3,1,9,-7,1,DET,TOR,DET,113,,,16,10,15,7
Marcus Sasser,G,22023,1631204,22300030,"NOV 17, 2023",DET @ CLE,L,15,2,7,0.286,0,3,0.0,2,2,1.0,0,0,0,0,0,0,0,1,6,-8,1,DET,CLE,DET,100,,,6,6,6,0
Marcus Sasser,G,22023,1631204,22300018,"NOV 14, 2023",DET vs. ATL,L,8,0,2,0.0,0,2,0.0,0,0,0.0,0,1,1,1,0,0,0,0,0,-1,1,DET,DET,ATL,120,,,2,1,1,2
Marcus Sasser,G,22023,1631204,22300181,"NOV 12, 2023",DET @ CHI,L,20,2,6,0.333,1,3,0.333,0,0,0.0,0,3,3,6,1,0,2,1,5,1,1,DET,CHI,DET,108,,,14,8,11,9
Marcus Sasser,G,22023,1631204,22300008,"NOV 10, 2023",DET vs. PHI,L,35,3,13,0.231,1,7,0.143,2,2,1.0,0,3,3,4,0,0,0,4,9,-6,1,DET,DET,PHI,106,,,16,12,13,7
Marcus Sasser,G,22023,1631204,22300165,"NOV 08, 2023",DET @ MIL,L,28,11,17,0.647,3,7,0.429,1,1,1.0,0,6,6,2,1,0,3,1,26,6,1,DET,MIL,DET,118,,,34,32,28,8
Marcus Sasser,G,22023,1631204,22300145,"NOV 06, 2023",DET vs. GSW,L,33,3,10,0.3,1,5,0.2,0,0,0.0,0,3,3,4,1,0,2,5,7,-18,1,DET,DET,GSW,109,,,14,10,11,7
Marcus Sasser,G,22023,1631204,22300140,"NOV 05, 2023",DET vs. PHX,L,30,9,16,0.563,4,6,0.667,0,0,0.0,0,3,3,4,1,0,0,3,22,3,1,DET,DET,PHX,106,,,29,25,26,7
Marcus Sasser,G,22023,1631204,22300129,"NOV 02, 2023",DET @ NOP,L,23,6,10,0.6,5,8,0.625,2,2,1.0,1,1,2,3,1,0,0,2,19,-14,1,DET,NOP,DET,116,,,24,21,22,5
Marcus Sasser,G,22023,1631204,22300115,"NOV 01, 2023",DET vs. POR,L,23,4,6,0.667,0,1,0.0,0,0,0.0,0,3,3,6,4,1,0,3,8,1,1,DET,DET,POR,101,,,17,11,14,9
Marcus Sasser,G,22023,1631204,22300109,"OCT 30, 2023",DET @ OKC,L,14,2,4,0.5,2,2,1.0,0,0,0.0,0,2,2,2,1,0,0,1,6,-1,1,DET,OKC,DET,112,,,10,8,8,4
Marcus Sasser,G,22023,1631204,22300088,"OCT 28, 2023",DET vs. CHI,W,6,1,2,0.5,0,1,0.0,0,0,0.0,1,2,3,1,0,0,0,0,2,2,1,DET,DET,CHI,118,,,6,5,3,4
Marcus Sasser,G,22023,1631204,22300077,"OCT 27, 2023",DET @ CHA,W,8,0,1,0.0,0,1,0.0,0,0,0.0,0,1,1,1,0,0,1,1,0,3,1,DET,CHA,DET,111,,,2,1,1,2
Marcus Sasser,G,22023,1631204,22300068,"OCT 25, 2023",DET @ MIA,L,10,3,4,0.75,2,3,0.667,0,0,0.0,0,2,2,1,0,0,1,0,8,2,1,DET,MIA,DET,102,,,11,10,9,3
Marcus Sasser,G,22023,1631204,22300704,"FEB 04, 2024",DET vs. ORL,L,10,2,4,0.5,2,3,0.667,0,0,0.0,0,0,0,4,0,0,2,1,6,-10,1,DET,DET,ORL,99,,,10,6,10,4
Marcus Sasser,G,22023,1631204,22300688,"FEB 02, 2024",DET vs. LAC,L,20,8,10,0.8,5,6,0.833,0,0,0.0,0,1,1,2,0,0,2,2,21,-7,1,DET,DET,LAC,125,,,24,22,23,3
Marcus Sasser,G,22023,1631204,22300675,"JAN 31, 2024",DET @ CLE,L,10,1,2,0.5,1,1,1.0,0,0,0.0,0,0,0,4,0,0,0,1,3,-1,1,DET,CLE,DET,121,,,7,3,7,4
Marcus Sasser,G,22023,1631204,22300654,"JAN 28, 2024",DET vs. OKC,W,19,5,9,0.556,2,3,0.667,0,0,0.0,0,2,2,4,0,0,1,1,12,16,1,DET,DET,OKC,120,,,18,14,16,6
Marcus Sasser,G,22023,1631204,22300619,"JAN 24, 2024",DET vs. CHA,W,12,2,5,0.4,1,4,0.25,0,0,0.0,0,2,2,2,0,0,1,1,5,8,1,DET,DET,CHA,113,,,9,7,7,4
Marcus Sasser,G,22023,1631204,22300606,"JAN 22, 2024",DET vs. MIL,L,26,9,17,0.529,0,4,0.0,5,5,1.0,0,1,1,3,1,0,2,1,23,8,1,DET,DET,MIL,113,,,27,24,26,4
Marcus Sasser,G,22023,1631204,22300592,"JAN 20, 2024",DET vs. MIL,L,16,3,6,0.5,1,2,0.5,2,2,1.0,0,1,1,5,1,0,0,1,9,8,1,DET,DET,MIL,135,,,15,10,14,6
Marcus Sasser,G,22023,1631204,22300569,"JAN 17, 2024",DET vs. MIN,L,12,2,4,0.5,1,2,0.5,0,0,0.0,0,1,1,2,0,0,4,2,5,-7,1,DET,DET,MIN,117,,,8,6,7,3
Marcus Sasser,G,22023,1631204,22300519,"JAN 10, 2024",DET vs. SAS,L,16,3,7,0.429,0,1,0.0,0,0,0.0,1,1,2,5,0,0,1,2,6,-11,1,DET,DET,SAS,108,,,13,8,11,7
Marcus Sasser,G,22023,1631204,22300512,"JAN 09, 2024",DET vs. SAC,L,19,0,4,0.0,0,2,0.0,2,2,1.0,0,2,2,4,1,1,0,0,2,-8,1,DET,DET,SAC,110,,,8,4,6,6
Marcus Sasser,G,22023,1631204,22300502,"JAN 07, 2024",DET @ DEN,L,11,2,6,0.333,1,2,0.5,2,2,1.0,0,2,2,1,0,0,0,0,7,-6,1,DET,DEN,DET,114,,,10,9,8,3
Marcus Sasser,G,22023,1631204,22300490,"JAN 05, 2024",DET @ GSW,L,6,0,0,0.0,0,0,0.0,0,0,0.0,0,0,0,2,0,0,0,1,0,4,1,DET,GSW,DET,109,,,2,0,2,2
Marcus Sasser,G,22023,1631204,22300406,"DEC 26, 2023",DET vs. BKN,L,10,0,1,0.0,0,1,0.0,0,0,0.0,0,0,0,0,0,0,0,0,0,-11,1,DET,DET,BKN,112,,,0,0,0,0
Marcus Sasser,G,22023,1631204,22300327,"DEC 15, 2023",DET @ PHI,L,17,4,4,1.0,1,1,1.0,2,4,0.5,0,2,2,4,1,1,2,1,11,1,1,DET,PHI,DET,92,,,17,13,15,6
Marcus Sasser,G,22023,1631204,22300310,"DEC 13, 2023",DET vs. PHI,L,5,3,3,1.0,2,2,1.0,0,0,0.0,0,0,0,1,0,0,1,0,8,6,1,DET,DET,PHI,111,,,9,8,9,1
Marcus Sasser,G,22023,1631204,22301206,"DEC 06, 2023",DET vs. MEM,L,5,0,2,0.0,0,0,0.0,0,0,0.0,0,1,1,2,0,0,0,1,0,-5,1,DET,DET,MEM,102,,,3,1,2,3
Marcus Sasser,G,22023,1631204,22300749,"FEB 10, 2024",DET @ LAC,L,14,2,4,0.5,1,2,0.5,0,0,0.0,0,2,2,4,1,0,2,4,5,-9,1,DET,LAC,DET,106,,,11,7,9,6
Marcus Sasser,G,22023,1631204,22300732,"FEB 07, 2024",DET @ SAC,W,32,7,14,0.5,2,6,0.333,2,2,1.0,0,3,3,4,0,0,0,1,18,16,1,DET,SAC,DET,133,,,25,21,22,7
Marcus Sasser,G,22023,1631204,22300558,"JAN 15, 2024",DET @ WAS,W,11,3,7,0.429,0,0,0.0,0,0,0.0,0,2,2,4,0,2,1,0,6,9,1,DET,WAS,DET,129,,,12,8,10,6
Marcus Sasser,G,22023,1631204,22300253,"NOV 27, 2023",DET vs. WAS,L,22,3,10,0.3,1,5,0.2,0,0,0.0,1,0,1,3,0,1,1,1,7,-15,1,DET,DET,WAS,107,,,11,8,10,4
Marcus Sasser,G,22023,1631204,22300741,"FEB 08, 2024",DET @ POR,W,38,6,13,0.462,3,7,0.429,2,4,0.5,0,2,2,11,2,0,2,2,17,10,1,DET,POR,DET,128,,,30,19,28,13
Craig Porter,G,22023,1641854,22300735,"FEB 08, 2024",CLE @ BKN,W,3,0,1,0.0,0,0,0.0,0,0,0.0,1,1,2,0,0,0,0,0,0,4,1,CLE,BKN,CLE,118,,,2,2,0,2
Craig Porter,G,22023,1641854,22300714,"FEB 05, 2024",CLE vs. SAC,W,3,0,0,0.0,0,0,0.0,0,0,0.0,0,0,0,0,0,0,0,0,0,0,1,CLE,CLE,SAC,136,,,0,0,0,0
Craig Porter,G,22023,1641854,22300703,"FEB 03, 2024",CLE @ SAS,W,1,0,0,0.0,0,0,0.0,0,0,0.0,0,0,0,0,0,0,0,0,0,-2,1,CLE,SAS,CLE,117,,,0,0,0,0
Craig Porter,G,22023,1641854,22300624,"JAN 24, 2024",CLE @ MIL,L,1,0,0,0.0,0,0,0.0,2,2,1.0,0,0,0,0,0,0,0,0,2,5,1,CLE,MIL,CLE,116,,,2,2,2,0
Craig Porter,G,22023,1641854,22300607,"JAN 22, 2024",CLE @ ORL,W,22,5,7,0.714,0,0,0.0,2,2,1.0,0,3,3,5,0,0,1,2,12,0,1,CLE,ORL,CLE,126,,,20,15,17,8
Craig Porter,G,22023,1641854,22300595,"JAN 20, 2024",CLE @ ATL,W,21,1,3,0.333,0,1,0.0,2,2,1.0,0,5,5,3,0,0,3,2,4,5,1,CLE,ATL,CLE,116,,,12,9,7,8
Craig Porter,G,22023,1641854,22300572,"JAN 17, 2024",CLE vs. MIL,W,20,4,7,0.571,0,0,0.0,1,2,0.5,0,2,2,2,0,0,1,0,9,6,1,CLE,CLE,MIL,135,,,13,11,11,4
Craig Porter,G,22023,1641854,22300497,"JAN 07, 2024",CLE vs. SAS,W,4,0,0,0.0,0,0,0.0,0,0,0.0,0,1,1,1,0,1,0,0,0,8,1,CLE,CLE,SAS,117,,,2,1,1,2
Craig Porter,G,22023,1641854,22300482,"JAN 05, 2024",CLE vs. WAS,W,12,3,6,0.5,0,0,0.0,1,1,1.0,1,3,4,4,1,0,5,2,7,4,1,CLE,CLE,WAS,114,,,15,11,11,8
Craig Porter,G,22023,1641854,22300465,"JAN 03, 2024",CLE vs. WAS,W,15,4,5,0.8,0,0,0.0,0,1,0.0,1,2,3,3,0,0,1,0,8,7,1,CLE,CLE,WAS,140,,,14,11,11,6
Craig Porter,G,22023,1641854,22300452,"JAN 01, 2024",CLE @ TOR,L,6,0,2,0.0,0,1,0.0,0,0,0.0,0,1,1,0,0,0,0,1,0,-11,1,CLE,TOR,CLE,121,,,1,1,0,1
Craig Porter,G,22023,1641854,22300433,"DEC 29, 2023",CLE vs. MIL,L,15,6,10,0.6,1,3,0.333,1,1,1.0,0,1,1,1,1,0,0,1,14,0,1,CLE,CLE,MIL,111,,,16,15,15,2
Craig Porter,G,22023,1641854,22300420,"DEC 27, 2023",CLE @ DAL,W,30,4,11,0.364,0,1,0.0,1,2,0.5,4,8,12,7,3,1,2,4,9,9,1,CLE,DAL,CLE,113,,,28,21,16,19
Craig Porter,G,22023,1641854,22300396,"DEC 23, 2023",CLE @ CHI,W,39,8,14,0.571,1,3,0.333,2,5,0.4,1,6,7,8,1,1,3,1,19,14,1,CLE,CHI,CLE,109,,,34,26,27,15
Craig Porter,G,22023,1641854,22300375,"DEC 21, 2023",CLE vs. NOP,L,29,3,9,0.333,1,1,1.0,0,0,0.0,0,3,3,11,1,0,2,1,7,3,1,CLE,CLE,NOP,104,,,21,10,18,14
Craig Porter,G,22023,1641854,22300364,"DEC 20, 2023",CLE vs. UTA,W,25,2,7,0.286,0,2,0.0,2,2,1.0,3,4,7,6,0,3,0,0,6,-2,1,CLE,CLE,UTA,124,,,19,13,12,13
Craig Porter,G,22023,1641854,22300349,"DEC 18, 2023",CLE vs. HOU,W,9,1,2,0.5,1,1,1.0,0,0,0.0,0,0,0,3,1,0,0,0,3,4,1,CLE,CLE,HOU,135,,,6,3,6,3
Craig Porter,G,22023,1641854,22300336,"DEC 16, 2023",CLE vs. ATL,W,15,3,8,0.375,0,1,0.0,0,0,0.0,1,1,2,3,0,0,1,1,6,6,1,CLE,CLE,ATL,127,,,11,8,9,5
Craig Porter,G,22023,1641854,22301220,"DEC 08, 2023",CLE @ MIA,W,23,3,7,0.429,0,0,0.0,2,4,0.5,0,3,3,4,2,1,0,0,8,7,1,CLE,MIA,CLE,111,,,15,11,12,7
Craig Porter,G,22023,1641854,22300283,"DEC 02, 2023",CLE @ DET,W,4,0,0,0.0,0,0,0.0,0,0,0.0,0,0,0,0,0,0,0,1,0,0,1,CLE,DET,CLE,110,,,0,0,0,0
Craig Porter,G,22023,1641854,22300055,"NOV 28, 2023",CLE vs. ATL,W,3,1,2,0.5,0,0,0.0,0,0,0.0,0,0,0,0,0,0,2,0,2,-8,1,CLE,CLE,ATL,128,,,2,2,2,0
Craig Porter,G,22023,1641854,22300242,"NOV 25, 2023",CLE vs. LAL,L,17,5,7,0.714,1,1,1.0,0,0,0.0,0,1,1,1,0,0,1,2,11,-10,1,CLE,CLE,LAL,115,,,13,12,12,2
Craig Porter,G,22023,1641854,22300229,"NOV 22, 2023",CLE vs. MIA,L,35,6,12,0.5,2,5,0.4,2,3,0.667,0,2,2,5,1,2,4,1,16,-24,1,CLE,CLE,MIA,96,,,23,18,21,7
Craig Porter,G,22023,1641854,22300040,"NOV 21, 2023",CLE @ PHI,W,27,5,9,0.556,0,0,0.0,2,2,1.0,0,3,3,9,0,1,1,0,12,21,1,CLE,PHI,CLE,122,,,24,15,21,12
Craig Porter,G,22023,1641854,22300210,"NOV 19, 2023",CLE vs. DEN,W,25,7,10,0.7,0,0,0.0,7,7,1.0,2,2,4,4,2,1,1,3,21,-2,1,CLE,CLE,DEN,121,,,29,25,25,8
Craig Porter,G,22023,1641854,22300030,"NOV 17, 2023",CLE vs. DET,W,16,5,9,0.556,0,0,0.0,2,2,1.0,0,3,3,5,1,0,0,0,12,14,1,CLE,CLE,DET,108,,,20,15,17,8
Craig Porter,G,22023,1641854,22300199,"NOV 15, 2023",CLE @ POR,W,9,2,3,0.667,0,0,0.0,0,0,0.0,0,2,2,0,0,0,2,1,4,-8,1,CLE,POR,CLE,109,,,6,6,4,2
Craig Porter,G,22023,1641854,22300191,"NOV 13, 2023",CLE @ SAC,L,3,0,1,0.0,0,0,0.0,0,0,0.0,0,3,3,3,0,0,0,1,0,1,1,CLE,SAC,CLE,120,,,6,3,3,6
Craig Porter,G,22023,1641854,22300176,"NOV 11, 2023",CLE @ GSW,W,2,0,0,0.0,0,0,0.0,1,6,0.167,0,0,0,0,0,0,0,0,1,-8,1,CLE,GSW,CLE,118,,,1,1,1,0
Craig Porter,G,22023,1641854,22300112,"OCT 31, 2023",CLE vs. NYK,L,22,5,12,0.417,0,1,0.0,0,0,0.0,1,3,4,2,2,1,3,3,10,-9,1,CLE,CLE,NYK,91,,,16,14,12,6
Craig Porter,G,22023,1641854,22300091,"OCT 28, 2023",CLE vs. IND,L,4,0,0,0.0,0,0,0.0,0,0,0.0,0,0,0,1,0,0,0,0,0,-10,1,CLE,CLE,IND,113,,,1,0,1,1
Craig Porter,G,22023,1641854,22300120,"NOV 01, 2023",CLE @ NYK,W,11,1,1,1.0,0,0,0.0,2,2,1.0,0,1,1,0,1,0,0,3,4,3,1,CLE,NYK,CLE,95,,,5,5,4,1
Royce O'Neale,F,22023,1626220,22300757,"FEB 10, 2024",PHX @ GSW,L,11,1,3,0.333,1,2,0.5,0,0,0.0,2,2,4,1,1,1,1,2,3,4,1,PHX,GSW,PHX,112,,,8,7,4,5
Royce O'Neale,F,22023,1626220,22300720,"FEB 06, 2024",BKN vs. DAL,L,32,6,16,0.375,4,11,0.364,2,2,1.0,1,5,6,2,0,0,2,1,18,-9,1,BKN,BKN,DAL,107,,,26,24,20,8
Royce O'Neale,F,22023,1626220,22300717,"FEB 05, 2024",BKN vs. GSW,L,27,5,12,0.417,5,12,0.417,0,0,0.0,1,2,3,1,1,0,1,4,15,-12,1,BKN,BKN,GSW,98,,,19,18,16,4
Royce O'Neale,F,22023,1626220,22300698,"FEB 03, 2024",BKN @ PHI,W,26,3,5,0.6,2,4,0.5,0,0,0.0,1,3,4,2,0,0,1,2,8,-5,1,BKN,PHI,BKN,136,,,14,12,10,6
Royce O'Neale,F,22023,1626220,22300677,"JAN 31, 2024",BKN vs. PHX,L,21,1,3,0.333,1,3,0.333,0,0,0.0,0,1,1,1,0,0,0,5,3,-13,1,BKN,BKN,PHX,120,,,5,4,4,2
Royce O'Neale,F,22023,1626220,22300660,"JAN 29, 2024",BKN vs. UTA,W,18,4,7,0.571,3,6,0.5,0,0,0.0,0,4,4,2,2,2,0,3,11,27,1,BKN,BKN,UTA,147,,,17,15,13,6
Royce O'Neale,F,22023,1626220,22300645,"JAN 27, 2024",BKN vs. HOU,W,23,2,3,0.667,2,3,0.667,0,0,0.0,0,6,6,0,0,1,2,2,6,-10,1,BKN,BKN,HOU,106,,,12,12,6,6
Royce O'Neale,F,22023,1626220,22300629,"JAN 25, 2024",BKN vs. MIN,L,18,1,4,0.25,1,4,0.25,0,0,0.0,1,3,4,2,0,1,1,2,3,-1,1,BKN,BKN,MIN,94,,,9,7,5,6
Royce O'Neale,F,22023,1626220,22300615,"JAN 23, 2024",BKN vs. NYK,L,20,3,4,0.75,2,3,0.667,0,0,0.0,2,2,4,3,1,1,1,3,8,-8,1,BKN,BKN,NYK,103,,,15,12,11,7
Royce O'Neale,F,22023,1626220,22300600,"JAN 21, 2024",BKN @ LAC,L,15,1,6,0.167,0,5,0.0,2,2,1.0,0,1,1,0,0,0,0,2,4,8,1,BKN,LAC,BKN,114,,,5,5,4,1
Royce O'Neale,F,22023,1626220,22300591,"JAN 19, 2024",BKN @ LAL,W,17,0,5,0.0,0,5,0.0,0,0,0.0,0,7,7,3,0,0,0,1,0,4,1,BKN,LAL,BKN,130,,,10,7,3,10
Royce O'Neale,F,22023,1626220,22300578,"JAN 17, 2024",BKN @ POR,L,20,1,4,0.25,0,3,0.0,0,0,0.0,0,3,3,3,0,0,2,1,2,-3,1,BKN,POR,BKN,103,,,8,5,5,6
Royce O'Neale,F,22023,1626220,22300562,"JAN 15, 2024",BKN vs. MIA,L,30,5,10,0.5,5,10,0.5,0,0,0.0,1,8,9,5,0,1,0,4,15,9,1,BKN,BKN,MIA,95,,,29,24,20,14
Royce O'Neale,F,22023,1626220,22300527,"JAN 11, 2024",BKN @ CLE,L,17,0,2,0.0,0,2,0.0,0,0,0.0,0,2,2,1,0,0,1,2,0,-8,1,BKN,CLE,BKN,102,,,3,2,1,3
Royce O'Neale,F,22023,1626220,22300498,"JAN 07, 2024",BKN vs. POR,L,18,3,5,0.6,2,4,0.5,0,0,0.0,0,3,3,1,1,0,2,3,8,-8,1,BKN,BKN,POR,127,,,12,11,9,4
Royce O'Neale,F,22023,1626220,22300481,"JAN 05, 2024",BKN vs. OKC,W,16,2,4,0.5,1,2,0.5,0,0,0.0,2,2,4,2,1,0,5,3,5,16,1,BKN,BKN,OKC,124,,,11,9,7,6
Royce O'Neale,F,22023,1626220,22300469,"JAN 03, 2024",BKN @ HOU,L,30,5,13,0.385,2,8,0.25,1,2,0.5,1,3,4,3,2,0,1,3,13,-7,1,BKN,HOU,BKN,101,,,20,17,16,7
Royce O'Neale,F,22023,1626220,22300461,"JAN 02, 2024",BKN @ NOP,L,28,0,6,0.0,0,5,0.0,0,0,0.0,4,4,8,5,1,0,3,3,0,-10,1,BKN,NOP,BKN,85,,,13,8,5,13
Royce O'Neale,F,22023,1626220,22300447,"DEC 31, 2023",BKN @ OKC,L,21,2,9,0.222,1,7,0.143,0,0,0.0,1,2,3,2,1,0,0,2,5,-11,1,BKN,OKC,BKN,108,,,10,8,7,5
Royce O'Neale,F,22023,1626220,22300430,"DEC 29, 2023",BKN @ WAS,L,18,3,4,0.75,1,2,0.5,0,0,0.0,1,2,3,2,0,0,2,0,7,-10,1,BKN,WAS,BKN,104,,,12,10,9,5
Royce O'Neale,F,22023,1626220,22300417,"DEC 27, 2023",BKN vs. MIL,L,10,1,4,0.25,1,3,0.333,0,0,0.0,0,1,1,2,0,0,0,1,3,1,1,BKN,BKN,MIL,122,,,6,4,5,3
Royce O'Neale,F,22023,1626220,22300406,"DEC 26, 2023",BKN @ DET,W,15,3,6,0.5,2,3,0.667,0,0,0.0,0,2,2,2,0,0,0,2,8,14,1,BKN,DET,BKN,118,,,12,10,10,4
Royce O'Neale,F,22023,1626220,22300394,"DEC 23, 2023",BKN vs. DET,W,19,2,3,0.667,1,1,1.0,0,0,0.0,0,6,6,5,1,0,1,1,5,13,1,BKN,BKN,DET,126,,,16,11,10,11
Royce O'Neale,F,22023,1626220,22300383,"DEC 22, 2023",BKN vs. DEN,L,22,4,7,0.571,2,5,0.4,3,4,0.75,2,4,6,3,0,2,1,1,13,5,1,BKN,BKN,DEN,117,,,22,19,16,9
Royce O'Neale,F,22023,1626220,22300368,"DEC 20, 2023",BKN vs. NYK,L,28,2,11,0.182,2,10,0.2,0,0,0.0,1,5,6,6,1,3,2,2,6,-10,1,BKN,BKN,NYK,102,,,18,12,12,12
Royce O'Neale,F,22023,1626220,22300357,"DEC 18, 2023",BKN @ UTA,L,23,2,6,0.333,2,6,0.333,0,0,0.0,0,1,1,1,1,0,1,2,6,-11,1,BKN,UTA,BKN,108,,,8,7,7,2
Royce O'Neale,F,22023,1626220,22300339,"DEC 16, 2023",BKN @ GSW,L,34,4,10,0.4,3,9,0.333,0,0,0.0,3,2,5,3,1,1,3,4,11,3,1,BKN,GSW,BKN,120,,,19,16,14,8
Royce O'Neale,F,22023,1626220,22300322,"DEC 14, 2023",BKN @ DEN,L,14,1,1,1.0,0,0,0.0,0,0,0.0,0,1,1,1,1,0,1,1,2,-19,1,BKN,DEN,BKN,101,,,4,3,3,2
Royce O'Neale,F,22023,1626220,22300317,"DEC 13, 2023",BKN @ PHX,W,19,3,5,0.6,2,4,0.5,0,0,0.0,0,1,1,4,0,0,0,1,8,19,1,BKN,PHX,BKN,116,,,13,9,12,5
Royce O'Neale,F,22023,1626220,22300303,"DEC 11, 2023",BKN @ SAC,L,19,1,3,0.333,1,1,1.0,2,2,1.0,1,3,4,1,0,0,0,0,5,-2,1,BKN,SAC,BKN,118,,,10,9,6,5
Royce O'Neale,F,22023,1626220,22301219,"DEC 08, 2023",BKN vs. WAS,W,26,4,10,0.4,3,9,0.333,2,2,1.0,2,6,8,5,1,1,0,1,13,11,1,BKN,BKN,WAS,124,,,26,21,18,13
Royce O'Neale,F,22023,1626220,22301209,"DEC 06, 2023",BKN @ ATL,W,21,2,6,0.333,1,4,0.25,1,2,0.5,0,3,3,2,1,0,0,2,6,10,1,BKN,ATL,BKN,114,,,11,9,8,5
Royce O'Neale,F,22023,1626220,22300282,"DEC 02, 2023",BKN vs. ORL,W,26,1,3,0.333,1,3,0.333,0,0,0.0,1,5,6,7,1,1,0,3,3,24,1,BKN,BKN,ORL,129,,,16,9,10,13
Royce O'Neale,F,22023,1626220,22300054,"NOV 28, 2023",BKN vs. TOR,W,31,6,12,0.5,6,12,0.5,0,0,0.0,2,5,7,4,2,2,1,5,18,15,1,BKN,BKN,TOR,115,,,29,25,22,11
Royce O'Neale,F,22023,1626220,22300250,"NOV 26, 2023",BKN vs. CHI,W,36,7,11,0.636,6,10,0.6,0,0,0.0,0,9,9,4,1,0,1,2,20,11,1,BKN,BKN,CHI,118,,,33,29,24,13
Royce O'Neale,F,22023,1626220,22300240,"NOV 25, 2023",BKN vs. MIA,W,29,2,6,0.333,2,5,0.4,0,0,0.0,1,1,2,4,2,1,1,4,6,9,1,BKN,BKN,MIA,112,,,12,8,10,6
Royce O'Neale,F,22023,1626220,22300227,"NOV 22, 2023",BKN @ ATL,L,21,0,3,0.0,0,2,0.0,0,2,0.0,0,3,3,1,1,1,1,3,0,-5,1,BKN,ATL,BKN,145,,,4,3,1,4
Royce O'Neale,F,22023,1626220,22300208,"NOV 19, 2023",BKN vs. PHI,L,25,0,2,0.0,0,0,0.0,0,0,0.0,1,3,4,3,1,2,1,1,0,-1,1,BKN,BKN,PHI,99,,,7,4,3,7
Royce O'Neale,F,22023,1626220,22300200,"NOV 16, 2023",BKN @ MIA,L,20,2,5,0.4,1,4,0.25,0,0,0.0,0,0,0,4,1,0,1,2,5,-22,1,BKN,MIA,BKN,115,,,9,5,9,4
Royce O'Neale,F,22023,1626220,22300020,"NOV 14, 2023",BKN vs. ORL,W,34,4,6,0.667,4,6,0.667,1,2,0.5,0,4,4,1,0,0,1,4,13,15,1,BKN,BKN,ORL,124,,,18,17,14,5
Royce O'Neale,F,22023,1626220,22300178,"NOV 12, 2023",BKN vs. WAS,W,31,3,8,0.375,3,7,0.429,1,2,0.5,1,5,6,4,2,0,2,4,10,-2,1,BKN,BKN,WAS,102,,,20,16,14,10
Royce O'Neale,F,22023,1626220,22300010,"NOV 10, 2023",BKN @ BOS,L,27,1,3,0.333,1,3,0.333,0,0,0.0,0,3,3,4,0,0,1,3,3,-13,1,BKN,BOS,BKN,107,,,10,6,7,7
Royce O'Neale,F,22023,1626220,22300160,"NOV 08, 2023",BKN vs. LAC,W,34,4,10,0.4,4,8,0.5,0,0,0.0,3,7,10,2,0,3,0,1,12,3,1,BKN,BKN,LAC,100,,,24,22,14,12
Royce O'Neale,F,22023,1626220,22300149,"NOV 06, 2023",BKN vs. MIL,L,25,4,8,0.5,4,7,0.571,0,0,0.0,1,8,9,3,0,1,1,4,12,-12,1,BKN,BKN,MIL,125,,,24,21,15,12
Royce O'Neale,F,22023,1626220,22300136,"NOV 04, 2023",BKN vs. BOS,L,37,2,15,0.133,2,13,0.154,0,0,0.0,1,3,4,3,1,1,0,4,6,-18,1,BKN,BKN,BOS,114,,,13,10,9,7
Royce O'Neale,F,22023,1626220,22300004,"NOV 03, 2023",BKN @ CHI,W,32,3,10,0.3,3,9,0.333,0,0,0.0,0,5,5,8,0,1,0,4,9,-3,1,BKN,CHI,BKN,109,,,22,14,17,13
Royce O'Neale,F,22023,1626220,22300119,"NOV 01, 2023",BKN @ MIA,W,39,2,6,0.333,2,5,0.4,0,0,0.0,0,7,7,5,2,1,3,5,6,-3,1,BKN,MIA,BKN,109,,,18,13,11,12
Royce O'Neale,F,22023,1626220,22300101,"OCT 30, 2023",BKN @ CHA,W,32,3,8,0.375,2,6,0.333,0,0,0.0,0,2,2,0,0,2,0,1,8,0,1,BKN,CHA,BKN,133,,,10,10,8,2
Royce O'Neale,F,22023,1626220,22300084,"OCT 27, 2023",BKN @ DAL,L,34,4,9,0.444,3,7,0.429,0,0,0.0,2,8,10,3,1,0,3,4,11,-11,1,BKN,DAL,BKN,120,,,24,21,14,13
Royce O'Neale,F,22023,1626220,22300067,"OCT 25, 2023",BKN vs. CLE,L,23,2,6,0.333,1,4,0.25,0,0,0.0,0,7,7,2,0,0,1,2,5,8,1,BKN,BKN,CLE,113,,,14,12,7,9
Ben Simmons,G,22023,1627732,22300750,"FEB 10, 2024",BKN vs. SAS,W,22,6,7,0.857,0,0,0.0,1,2,0.5,0,3,3,5,3,2,4,2,13,10,1,BKN,BKN,SAS,123,,,21,16,18,8
Ben Simmons,G,22023,1627732,22300735,"FEB 08, 2024",BKN vs. CLE,L,20,3,4,0.75,0,0,0.0,0,0,0.0,0,1,1,2,1,0,2,1,6,-26,1,BKN,BKN,CLE,95,,,9,7,8,3
Ben Simmons,G,22023,1627732,22300720,"FEB 06, 2024",BKN vs. DAL,L,20,4,7,0.571,0,0,0.0,1,2,0.5,4,5,9,7,1,0,2,2,9,1,1,BKN,BKN,DAL,107,,,25,18,16,16
Ben Simmons,G,22023,1627732,22300698,"FEB 03, 2024",BKN @ PHI,W,14,0,0,0.0,0,0,0.0,0,0,0.0,1,8,9,5,0,0,1,4,0,8,1,BKN,PHI,BKN,136,,,14,9,5,14
Ben Simmons,G,22023,1627732,22300660,"JAN 29, 2024",BKN vs. UTA,W,18,5,5,1.0,0,0,0.0,0,0,0.0,5,3,8,11,1,1,0,3,10,27,1,BKN,BKN,UTA,147,,,29,18,21,19
Ben Simmons,G,22023,1627732,22300149,"NOV 06, 2023",BKN vs. MIL,L,33,1,3,0.333,0,0,0.0,0,0,0.0,3,12,15,4,0,0,1,3,2,-12,1,BKN,BKN,MIL,125,,,21,17,6,19
Ben Simmons,G,22023,1627732,22300004,"NOV 03, 2023",BKN @ CHI,W,33,4,8,0.5,0,0,0.0,0,0,0.0,3,6,9,6,1,0,4,3,8,-9,1,BKN,CHI,BKN,109,,,23,17,14,15
Ben Simmons,G,22023,1627732,22300119,"NOV 01, 2023",BKN @ MIA,W,34,2,5,0.4,0,0,0.0,0,2,0.0,2,9,11,5,0,1,4,4,4,-9,1,BKN,MIA,BKN,109,,,20,15,9,16
Ben Simmons,G,22023,1627732,22300101,"OCT 30, 2023",BKN @ CHA,W,35,5,6,0.833,0,0,0.0,1,2,0.5,3,7,10,8,0,1,2,1,11,3,1,BKN,CHA,BKN,133,,,29,21,19,18
Ben Simmons,G,22023,1627732,22300084,"OCT 27, 2023",BKN @ DAL,L,32,5,8,0.625,0,0,0.0,0,0,0.0,4,6,10,8,2,2,2,3,10,0,1,BKN,DAL,BKN,120,,,28,20,18,18
Ben Simmons,G,22023,1627732,22300067,"OCT 25, 2023",BKN vs. CLE,L,23,2,6,0.333,0,0,0.0,0,0,0.0,1,9,10,9,0,1,2,2,4,-6,1,BKN,BKN,CLE,113,,,23,14,13,19
Trey Lyles,F,22023,1626168,22300746,"FEB 09, 2024",SAC vs. DEN,W,21,5,6,0.833,3,4,0.75,2,2,1.0,1,6,7,0,1,0,1,2,15,19,1,SAC,SAC,DEN,135,7.5,Points,22,22,15,7
Trey Lyles,F,22023,1626168,22300746,"FEB 09, 2024",SAC vs. DEN,W,21,5,6,0.833,3,4,0.75,2,2,1.0,1,6,7,0,1,0,1,2,15,19,1,SAC,SAC,DEN,135,4.5,Rebounds,22,22,15,7
Trey Lyles,F,22023,1626168,22300746,"FEB 09, 2024",SAC vs. DEN,W,21,5,6,0.833,3,4,0.75,2,2,1.0,1,6,7,0,1,0,1,2,15,19,1,SAC,SAC,DEN,135,1.5,3-PT Made,22,22,15,7
Trey Lyles,F,22023,1626168,22300746,"FEB 09, 2024",SAC vs. DEN,W,21,5,6,0.833,3,4,0.75,2,2,1.0,1,6,7,0,1,0,1,2,15,19,1,SAC,SAC,DEN,135,12.5,Pts+Rebs,22,22,15,7
Trey Lyles,F,22023,1626168,22300746,"FEB 09, 2024",SAC vs. DEN,W,21,5,6,0.833,3,4,0.75,2,2,1.0,1,6,7,0,1,0,1,2,15,19,1,SAC,SAC,DEN,135,0.5,Blks+Stls,22,22,15,7
Trey Lyles,F,22023,1626168,22300746,"FEB 09, 2024",SAC vs. DEN,W,21,5,6,0.833,3,4,0.75,2,2,1.0,1,6,7,0,1,0,1,2,15,19,1,SAC,SAC,DEN,135,0.5,Turnovers,22,22,15,7
Trey Lyles,F,22023,1626168,22300732,"FEB 07, 2024",SAC vs. DET,L,23,6,13,0.462,5,10,0.5,2,2,1.0,1,1,2,1,0,1,0,0,19,5,1,SAC,SAC,DET,120,7.5,Points,22,21,20,3
Trey Lyles,F,22023,1626168,22300732,"FEB 07, 2024",SAC vs. DET,L,23,6,13,0.462,5,10,0.5,2,2,1.0,1,1,2,1,0,1,0,0,19,5,1,SAC,SAC,DET,120,4.5,Rebounds,22,21,20,3
Trey Lyles,F,22023,1626168,22300732,"FEB 07, 2024",SAC vs. DET,L,23,6,13,0.462,5,10,0.5,2,2,1.0,1,1,2,1,0,1,0,0,19,5,1,SAC,SAC,DET,120,1.5,3-PT Made,22,21,20,3
Trey Lyles,F,22023,1626168,22300732,"FEB 07, 2024",SAC vs. DET,L,23,6,13,0.462,5,10,0.5,2,2,1.0,1,1,2,1,0,1,0,0,19,5,1,SAC,SAC,DET,120,12.5,Pts+Rebs,22,21,20,3
Trey Lyles,F,22023,1626168,22300732,"FEB 07, 2024",SAC vs. DET,L,23,6,13,0.462,5,10,0.5,2,2,1.0,1,1,2,1,0,1,0,0,19,5,1,SAC,SAC,DET,120,0.5,Blks+Stls,22,21,20,3
Trey Lyles,F,22023,1626168,22300732,"FEB 07, 2024",SAC vs. DET,L,23,6,13,0.462,5,10,0.5,2,2,1.0,1,1,2,1,0,1,0,0,19,5,1,SAC,SAC,DET,120,0.5,Turnovers,22,21,20,3
Trey Lyles,F,22023,1626168,22300714,"FEB 05, 2024",SAC @ CLE,L,19,2,5,0.4,0,3,0.0,3,4,0.75,0,4,4,1,1,0,0,0,7,-8,1,SAC,CLE,SAC,110,7.5,Points,12,11,8,5
Trey Lyles,F,22023,1626168,22300714,"FEB 05, 2024",SAC @ CLE,L,19,2,5,0.4,0,3,0.0,3,4,0.75,0,4,4,1,1,0,0,0,7,-8,1,SAC,CLE,SAC,110,4.5,Rebounds,12,11,8,5
Trey Lyles,F,22023,1626168,22300714,"FEB 05, 2024",SAC @ CLE,L,19,2,5,0.4,0,3,0.0,3,4,0.75,0,4,4,1,1,0,0,0,7,-8,1,SAC,CLE,SAC,110,1.5,3-PT Made,12,11,8,5
Trey Lyles,F,22023,1626168,22300714,"FEB 05, 2024",SAC @ CLE,L,19,2,5,0.4,0,3,0.0,3,4,0.75,0,4,4,1,1,0,0,0,7,-8,1,SAC,CLE,SAC,110,12.5,Pts+Rebs,12,11,8,5
Trey Lyles,F,22023,1626168,22300714,"FEB 05, 2024",SAC @ CLE,L,19,2,5,0.4,0,3,0.0,3,4,0.75,0,4,4,1,1,0,0,0,7,-8,1,SAC,CLE,SAC,110,0.5,Blks+Stls,12,11,8,5
Trey Lyles,F,22023,1626168,22300714,"FEB 05, 2024",SAC @ CLE,L,19,2,5,0.4,0,3,0.0,3,4,0.75,0,4,4,1,1,0,0,0,7,-8,1,SAC,CLE,SAC,110,0.5,Turnovers,12,11,8,5
Trey Lyles,F,22023,1626168,22300700,"FEB 03, 2024",SAC @ CHI,W,24,5,8,0.625,5,7,0.714,1,1,1.0,2,3,5,3,2,0,2,1,16,0,1,SAC,CHI,SAC,123,7.5,Points,24,21,19,8
Trey Lyles,F,22023,1626168,22300700,"FEB 03, 2024",SAC @ CHI,W,24,5,8,0.625,5,7,0.714,1,1,1.0,2,3,5,3,2,0,2,1,16,0,1,SAC,CHI,SAC,123,4.5,Rebounds,24,21,19,8
Trey Lyles,F,22023,1626168,22300700,"FEB 03, 2024",SAC @ CHI,W,24,5,8,0.625,5,7,0.714,1,1,1.0,2,3,5,3,2,0,2,1,16,0,1,SAC,CHI,SAC,123,1.5,3-PT Made,24,21,19,8
Trey Lyles,F,22023,1626168,22300700,"FEB 03, 2024",SAC @ CHI,W,24,5,8,0.625,5,7,0.714,1,1,1.0,2,3,5,3,2,0,2,1,16,0,1,SAC,CHI,SAC,123,12.5,Pts+Rebs,24,21,19,8
Trey Lyles,F,22023,1626168,22300700,"FEB 03, 2024",SAC @ CHI,W,24,5,8,0.625,5,7,0.714,1,1,1.0,2,3,5,3,2,0,2,1,16,0,1,SAC,CHI,SAC,123,0.5,Blks+Stls,24,21,19,8
Trey Lyles,F,22023,1626168,22300700,"FEB 03, 2024",SAC @ CHI,W,24,5,8,0.625,5,7,0.714,1,1,1.0,2,3,5,3,2,0,2,1,16,0,1,SAC,CHI,SAC,123,0.5,Turnovers,24,21,19,8
Trey Lyles,F,22023,1626168,22300691,"FEB 02, 2024",SAC @ IND,W,16,4,5,0.8,3,4,0.75,2,2,1.0,1,2,3,0,0,0,0,1,13,1,1,SAC,IND,SAC,133,7.5,Points,16,16,13,3
Trey Lyles,F,22023,1626168,22300691,"FEB 02, 2024",SAC @ IND,W,16,4,5,0.8,3,4,0.75,2,2,1.0,1,2,3,0,0,0,0,1,13,1,1,SAC,IND,SAC,133,4.5,Rebounds,16,16,13,3
Trey Lyles,F,22023,1626168,22300691,"FEB 02, 2024",SAC @ IND,W,16,4,5,0.8,3,4,0.75,2,2,1.0,1,2,3,0,0,0,0,1,13,1,1,SAC,IND,SAC,133,1.5,3-PT Made,16,16,13,3
Trey Lyles,F,22023,1626168,22300691,"FEB 02, 2024",SAC @ IND,W,16,4,5,0.8,3,4,0.75,2,2,1.0,1,2,3,0,0,0,0,1,13,1,1,SAC,IND,SAC,133,12.5,Pts+Rebs,16,16,13,3
Trey Lyles,F,22023,1626168,22300691,"FEB 02, 2024",SAC @ IND,W,16,4,5,0.8,3,4,0.75,2,2,1.0,1,2,3,0,0,0,0,1,13,1,1,SAC,IND,SAC,133,0.5,Blks+Stls,16,16,13,3
Trey Lyles,F,22023,1626168,22300691,"FEB 02, 2024",SAC @ IND,W,16,4,5,0.8,3,4,0.75,2,2,1.0,1,2,3,0,0,0,0,1,13,1,1,SAC,IND,SAC,133,0.5,Turnovers,16,16,13,3
Trey Lyles,F,22023,1626168,22300678,"JAN 31, 2024",SAC @ MIA,L,18,2,6,0.333,1,4,0.25,0,0,0.0,2,2,4,2,1,0,0,1,5,-10,1,SAC,MIA,SAC,106,7.5,Points,11,9,7,6
Trey Lyles,F,22023,1626168,22300678,"JAN 31, 2024",SAC @ MIA,L,18,2,6,0.333,1,4,0.25,0,0,0.0,2,2,4,2,1,0,0,1,5,-10,1,SAC,MIA,SAC,106,4.5,Rebounds,11,9,7,6
Trey Lyles,F,22023,1626168,22300678,"JAN 31, 2024",SAC @ MIA,L,18,2,6,0.333,1,4,0.25,0,0,0.0,2,2,4,2,1,0,0,1,5,-10,1,SAC,MIA,SAC,106,1.5,3-PT Made,11,9,7,6
Trey Lyles,F,22023,1626168,22300678,"JAN 31, 2024",SAC @ MIA,L,18,2,6,0.333,1,4,0.25,0,0,0.0,2,2,4,2,1,0,0,1,5,-10,1,SAC,MIA,SAC,106,12.5,Pts+Rebs,11,9,7,6
Trey Lyles,F,22023,1626168,22300678,"JAN 31, 2024",SAC @ MIA,L,18,2,6,0.333,1,4,0.25,0,0,0.0,2,2,4,2,1,0,0,1,5,-10,1,SAC,MIA,SAC,106,0.5,Blks+Stls,11,9,7,6
Trey Lyles,F,22023,1626168,22300678,"JAN 31, 2024",SAC @ MIA,L,18,2,6,0.333,1,4,0.25,0,0,0.0,2,2,4,2,1,0,0,1,5,-10,1,SAC,MIA,SAC,106,0.5,Turnovers,11,9,7,6
Trey Lyles,F,22023,1626168,22300663,"JAN 29, 2024",SAC @ MEM,W,24,4,7,0.571,2,5,0.4,0,0,0.0,1,0,1,1,1,0,2,3,10,8,1,SAC,MEM,SAC,103,7.5,Points,12,11,11,2
Trey Lyles,F,22023,1626168,22300663,"JAN 29, 2024",SAC @ MEM,W,24,4,7,0.571,2,5,0.4,0,0,0.0,1,0,1,1,1,0,2,3,10,8,1,SAC,MEM,SAC,103,4.5,Rebounds,12,11,11,2
Trey Lyles,F,22023,1626168,22300663,"JAN 29, 2024",SAC @ MEM,W,24,4,7,0.571,2,5,0.4,0,0,0.0,1,0,1,1,1,0,2,3,10,8,1,SAC,MEM,SAC,103,1.5,3-PT Made,12,11,11,2
Trey Lyles,F,22023,1626168,22300663,"JAN 29, 2024",SAC @ MEM,W,24,4,7,0.571,2,5,0.4,0,0,0.0,1,0,1,1,1,0,2,3,10,8,1,SAC,MEM,SAC,103,12.5,Pts+Rebs,12,11,11,2
Trey Lyles,F,22023,1626168,22300663,"JAN 29, 2024",SAC @ MEM,W,24,4,7,0.571,2,5,0.4,0,0,0.0,1,0,1,1,1,0,2,3,10,8,1,SAC,MEM,SAC,103,0.5,Blks+Stls,12,11,11,2
Trey Lyles,F,22023,1626168,22300663,"JAN 29, 2024",SAC @ MEM,W,24,4,7,0.571,2,5,0.4,0,0,0.0,1,0,1,1,1,0,2,3,10,8,1,SAC,MEM,SAC,103,0.5,Turnovers,12,11,11,2
Trey Lyles,F,22023,1626168,22300651,"JAN 27, 2024",SAC @ DAL,W,17,0,2,0.0,0,1,0.0,1,2,0.5,0,4,4,1,0,1,1,2,1,8,1,SAC,DAL,SAC,120,7.5,Points,6,5,2,5
Trey Lyles,F,22023,1626168,22300651,"JAN 27, 2024",SAC @ DAL,W,17,0,2,0.0,0,1,0.0,1,2,0.5,0,4,4,1,0,1,1,2,1,8,1,SAC,DAL,SAC,120,4.5,Rebounds,6,5,2,5
Trey Lyles,F,22023,1626168,22300651,"JAN 27, 2024",SAC @ DAL,W,17,0,2,0.0,0,1,0.0,1,2,0.5,0,4,4,1,0,1,1,2,1,8,1,SAC,DAL,SAC,120,1.5,3-PT Made,6,5,2,5
Trey Lyles,F,22023,1626168,22300651,"JAN 27, 2024",SAC @ DAL,W,17,0,2,0.0,0,1,0.0,1,2,0.5,0,4,4,1,0,1,1,2,1,8,1,SAC,DAL,SAC,120,12.5,Pts+Rebs,6,5,2,5
Trey Lyles,F,22023,1626168,22300651,"JAN 27, 2024",SAC @ DAL,W,17,0,2,0.0,0,1,0.0,1,2,0.5,0,4,4,1,0,1,1,2,1,8,1,SAC,DAL,SAC,120,0.5,Blks+Stls,6,5,2,5
Trey Lyles,F,22023,1626168,22300651,"JAN 27, 2024",SAC @ DAL,W,17,0,2,0.0,0,1,0.0,1,2,0.5,0,4,4,1,0,1,1,2,1,8,1,SAC,DAL,SAC,120,0.5,Turnovers,6,5,2,5
Trey Lyles,F,22023,1626168,22300632,"JAN 25, 2024",SAC @ GSW,W,15,3,7,0.429,2,4,0.5,0,0,0.0,0,0,0,2,1,0,0,1,8,-9,1,SAC,GSW,SAC,134,7.5,Points,10,8,10,2
Trey Lyles,F,22023,1626168,22300632,"JAN 25, 2024",SAC @ GSW,W,15,3,7,0.429,2,4,0.5,0,0,0.0,0,0,0,2,1,0,0,1,8,-9,1,SAC,GSW,SAC,134,4.5,Rebounds,10,8,10,2
Trey Lyles,F,22023,1626168,22300632,"JAN 25, 2024",SAC @ GSW,W,15,3,7,0.429,2,4,0.5,0,0,0.0,0,0,0,2,1,0,0,1,8,-9,1,SAC,GSW,SAC,134,1.5,3-PT Made,10,8,10,2
Trey Lyles,F,22023,1626168,22300632,"JAN 25, 2024",SAC @ GSW,W,15,3,7,0.429,2,4,0.5,0,0,0.0,0,0,0,2,1,0,0,1,8,-9,1,SAC,GSW,SAC,134,12.5,Pts+Rebs,10,8,10,2
Trey Lyles,F,22023,1626168,22300632,"JAN 25, 2024",SAC @ GSW,W,15,3,7,0.429,2,4,0.5,0,0,0.0,0,0,0,2,1,0,0,1,8,-9,1,SAC,GSW,SAC,134,0.5,Blks+Stls,10,8,10,2
Trey Lyles,F,22023,1626168,22300632,"JAN 25, 2024",SAC @ GSW,W,15,3,7,0.429,2,4,0.5,0,0,0.0,0,0,0,2,1,0,0,1,8,-9,1,SAC,GSW,SAC,134,0.5,Turnovers,10,8,10,2
Trey Lyles,F,22023,1626168,22300613,"JAN 22, 2024",SAC vs. ATL,W,16,4,8,0.5,2,5,0.4,0,0,0.0,2,5,7,0,0,0,1,0,10,7,1,SAC,SAC,ATL,122,7.5,Points,17,17,10,7
Trey Lyles,F,22023,1626168,22300613,"JAN 22, 2024",SAC vs. ATL,W,16,4,8,0.5,2,5,0.4,0,0,0.0,2,5,7,0,0,0,1,0,10,7,1,SAC,SAC,ATL,122,4.5,Rebounds,17,17,10,7
Trey Lyles,F,22023,1626168,22300613,"JAN 22, 2024",SAC vs. ATL,W,16,4,8,0.5,2,5,0.4,0,0,0.0,2,5,7,0,0,0,1,0,10,7,1,SAC,SAC,ATL,122,1.5,3-PT Made,17,17,10,7
Trey Lyles,F,22023,1626168,22300613,"JAN 22, 2024",SAC vs. ATL,W,16,4,8,0.5,2,5,0.4,0,0,0.0,2,5,7,0,0,0,1,0,10,7,1,SAC,SAC,ATL,122,12.5,Pts+Rebs,17,17,10,7
Trey Lyles,F,22023,1626168,22300613,"JAN 22, 2024",SAC vs. ATL,W,16,4,8,0.5,2,5,0.4,0,0,0.0,2,5,7,0,0,0,1,0,10,7,1,SAC,SAC,ATL,122,0.5,Blks+Stls,17,17,10,7
Trey Lyles,F,22023,1626168,22300613,"JAN 22, 2024",SAC vs. ATL,W,16,4,8,0.5,2,5,0.4,0,0,0.0,2,5,7,0,0,0,1,0,10,7,1,SAC,SAC,ATL,122,0.5,Turnovers,17,17,10,7
Trey Lyles,F,22023,1626168,22300583,"JAN 18, 2024",SAC vs. IND,L,19,0,2,0.0,0,2,0.0,0,0,0.0,1,2,3,2,1,0,0,0,0,-9,1,SAC,SAC,IND,121,7.5,Points,5,3,2,5
Trey Lyles,F,22023,1626168,22300583,"JAN 18, 2024",SAC vs. IND,L,19,0,2,0.0,0,2,0.0,0,0,0.0,1,2,3,2,1,0,0,0,0,-9,1,SAC,SAC,IND,121,4.5,Rebounds,5,3,2,5
Trey Lyles,F,22023,1626168,22300583,"JAN 18, 2024",SAC vs. IND,L,19,0,2,0.0,0,2,0.0,0,0,0.0,1,2,3,2,1,0,0,0,0,-9,1,SAC,SAC,IND,121,1.5,3-PT Made,5,3,2,5
Trey Lyles,F,22023,1626168,22300583,"JAN 18, 2024",SAC vs. IND,L,19,0,2,0.0,0,2,0.0,0,0,0.0,1,2,3,2,1,0,0,0,0,-9,1,SAC,SAC,IND,121,12.5,Pts+Rebs,5,3,2,5
Trey Lyles,F,22023,1626168,22300583,"JAN 18, 2024",SAC vs. IND,L,19,0,2,0.0,0,2,0.0,0,0,0.0,1,2,3,2,1,0,0,0,0,-9,1,SAC,SAC,IND,121,0.5,Blks+Stls,5,3,2,5
Trey Lyles,F,22023,1626168,22300583,"JAN 18, 2024",SAC vs. IND,L,19,0,2,0.0,0,2,0.0,0,0,0.0,1,2,3,2,1,0,0,0,0,-9,1,SAC,SAC,IND,121,0.5,Turnovers,5,3,2,5
Trey Lyles,F,22023,1626168,22300567,"JAN 16, 2024",SAC @ PHX,L,14,0,2,0.0,0,2,0.0,0,0,0.0,0,2,2,0,1,0,0,1,0,9,1,SAC,PHX,SAC,117,7.5,Points,2,2,0,2
Trey Lyles,F,22023,1626168,22300567,"JAN 16, 2024",SAC @ PHX,L,14,0,2,0.0,0,2,0.0,0,0,0.0,0,2,2,0,1,0,0,1,0,9,1,SAC,PHX,SAC,117,4.5,Rebounds,2,2,0,2
Trey Lyles,F,22023,1626168,22300567,"JAN 16, 2024",SAC @ PHX,L,14,0,2,0.0,0,2,0.0,0,0,0.0,0,2,2,0,1,0,0,1,0,9,1,SAC,PHX,SAC,117,1.5,3-PT Made,2,2,0,2
Trey Lyles,F,22023,1626168,22300567,"JAN 16, 2024",SAC @ PHX,L,14,0,2,0.0,0,2,0.0,0,0,0.0,0,2,2,0,1,0,0,1,0,9,1,SAC,PHX,SAC,117,12.5,Pts+Rebs,2,2,0,2
Trey Lyles,F,22023,1626168,22300567,"JAN 16, 2024",SAC @ PHX,L,14,0,2,0.0,0,2,0.0,0,0,0.0,0,2,2,0,1,0,0,1,0,9,1,SAC,PHX,SAC,117,0.5,Blks+Stls,2,2,0,2
Trey Lyles,F,22023,1626168,22300567,"JAN 16, 2024",SAC @ PHX,L,14,0,2,0.0,0,2,0.0,0,0,0.0,0,2,2,0,1,0,0,1,0,9,1,SAC,PHX,SAC,117,0.5,Turnovers,2,2,0,2
Trey Lyles,F,22023,1626168,22300552,"JAN 14, 2024",SAC @ MIL,L,33,3,8,0.375,3,7,0.429,0,0,0.0,1,6,7,2,0,0,0,3,9,10,1,SAC,MIL,SAC,142,7.5,Points,18,16,11,9
Trey Lyles,F,22023,1626168,22300552,"JAN 14, 2024",SAC @ MIL,L,33,3,8,0.375,3,7,0.429,0,0,0.0,1,6,7,2,0,0,0,3,9,10,1,SAC,MIL,SAC,142,4.5,Rebounds,18,16,11,9
Trey Lyles,F,22023,1626168,22300552,"JAN 14, 2024",SAC @ MIL,L,33,3,8,0.375,3,7,0.429,0,0,0.0,1,6,7,2,0,0,0,3,9,10,1,SAC,MIL,SAC,142,1.5,3-PT Made,18,16,11,9
Trey Lyles,F,22023,1626168,22300552,"JAN 14, 2024",SAC @ MIL,L,33,3,8,0.375,3,7,0.429,0,0,0.0,1,6,7,2,0,0,0,3,9,10,1,SAC,MIL,SAC,142,12.5,Pts+Rebs,18,16,11,9
Trey Lyles,F,22023,1626168,22300552,"JAN 14, 2024",SAC @ MIL,L,33,3,8,0.375,3,7,0.429,0,0,0.0,1,6,7,2,0,0,0,3,9,10,1,SAC,MIL,SAC,142,0.5,Blks+Stls,18,16,11,9
Trey Lyles,F,22023,1626168,22300552,"JAN 14, 2024",SAC @ MIL,L,33,3,8,0.375,3,7,0.429,0,0,0.0,1,6,7,2,0,0,0,3,9,10,1,SAC,MIL,SAC,142,0.5,Turnovers,18,16,11,9
Trey Lyles,F,22023,1626168,22300532,"JAN 12, 2024",SAC @ PHI,L,22,2,8,0.25,1,5,0.2,0,0,0.0,2,1,3,0,0,0,0,1,5,-6,1,SAC,PHI,SAC,90,7.5,Points,8,8,5,3
Trey Lyles,F,22023,1626168,22300532,"JAN 12, 2024",SAC @ PHI,L,22,2,8,0.25,1,5,0.2,0,0,0.0,2,1,3,0,0,0,0,1,5,-6,1,SAC,PHI,SAC,90,4.5,Rebounds,8,8,5,3
Trey Lyles,F,22023,1626168,22300532,"JAN 12, 2024",SAC @ PHI,L,22,2,8,0.25,1,5,0.2,0,0,0.0,2,1,3,0,0,0,0,1,5,-6,1,SAC,PHI,SAC,90,1.5,3-PT Made,8,8,5,3
Trey Lyles,F,22023,1626168,22300532,"JAN 12, 2024",SAC @ PHI,L,22,2,8,0.25,1,5,0.2,0,0,0.0,2,1,3,0,0,0,0,1,5,-6,1,SAC,PHI,SAC,90,12.5,Pts+Rebs,8,8,5,3
Trey Lyles,F,22023,1626168,22300532,"JAN 12, 2024",SAC @ PHI,L,22,2,8,0.25,1,5,0.2,0,0,0.0,2,1,3,0,0,0,0,1,5,-6,1,SAC,PHI,SAC,90,0.5,Blks+Stls,8,8,5,3
Trey Lyles,F,22023,1626168,22300532,"JAN 12, 2024",SAC @ PHI,L,22,2,8,0.25,1,5,0.2,0,0,0.0,2,1,3,0,0,0,0,1,5,-6,1,SAC,PHI,SAC,90,0.5,Turnovers,8,8,5,3
Trey Lyles,F,22023,1626168,22300518,"JAN 10, 2024",SAC @ CHA,W,21,2,4,0.5,2,4,0.5,2,4,0.5,1,4,5,2,0,0,1,1,8,27,1,SAC,CHA,SAC,121,7.5,Points,15,13,10,7
Trey Lyles,F,22023,1626168,22300518,"JAN 10, 2024",SAC @ CHA,W,21,2,4,0.5,2,4,0.5,2,4,0.5,1,4,5,2,0,0,1,1,8,27,1,SAC,CHA,SAC,121,4.5,Rebounds,15,13,10,7
Trey Lyles,F,22023,1626168,22300518,"JAN 10, 2024",SAC @ CHA,W,21,2,4,0.5,2,4,0.5,2,4,0.5,1,4,5,2,0,0,1,1,8,27,1,SAC,CHA,SAC,121,1.5,3-PT Made,15,13,10,7
Trey Lyles,F,22023,1626168,22300518,"JAN 10, 2024",SAC @ CHA,W,21,2,4,0.5,2,4,0.5,2,4,0.5,1,4,5,2,0,0,1,1,8,27,1,SAC,CHA,SAC,121,12.5,Pts+Rebs,15,13,10,7
Trey Lyles,F,22023,1626168,22300518,"JAN 10, 2024",SAC @ CHA,W,21,2,4,0.5,2,4,0.5,2,4,0.5,1,4,5,2,0,0,1,1,8,27,1,SAC,CHA,SAC,121,0.5,Blks+Stls,15,13,10,7
Trey Lyles,F,22023,1626168,22300518,"JAN 10, 2024",SAC @ CHA,W,21,2,4,0.5,2,4,0.5,2,4,0.5,1,4,5,2,0,0,1,1,8,27,1,SAC,CHA,SAC,121,0.5,Turnovers,15,13,10,7
Trey Lyles,F,22023,1626168,22300512,"JAN 09, 2024",SAC @ DET,W,32,1,4,0.25,1,3,0.333,3,4,0.75,1,7,8,3,0,0,1,2,6,31,1,SAC,DET,SAC,131,7.5,Points,17,14,9,11
Trey Lyles,F,22023,1626168,22300512,"JAN 09, 2024",SAC @ DET,W,32,1,4,0.25,1,3,0.333,3,4,0.75,1,7,8,3,0,0,1,2,6,31,1,SAC,DET,SAC,131,4.5,Rebounds,17,14,9,11
Trey Lyles,F,22023,1626168,22300512,"JAN 09, 2024",SAC @ DET,W,32,1,4,0.25,1,3,0.333,3,4,0.75,1,7,8,3,0,0,1,2,6,31,1,SAC,DET,SAC,131,1.5,3-PT Made,17,14,9,11
Trey Lyles,F,22023,1626168,22300512,"JAN 09, 2024",SAC @ DET,W,32,1,4,0.25,1,3,0.333,3,4,0.75,1,7,8,3,0,0,1,2,6,31,1,SAC,DET,SAC,131,12.5,Pts+Rebs,17,14,9,11
Trey Lyles,F,22023,1626168,22300512,"JAN 09, 2024",SAC @ DET,W,32,1,4,0.25,1,3,0.333,3,4,0.75,1,7,8,3,0,0,1,2,6,31,1,SAC,DET,SAC,131,0.5,Blks+Stls,17,14,9,11
Trey Lyles,F,22023,1626168,22300512,"JAN 09, 2024",SAC @ DET,W,32,1,4,0.25,1,3,0.333,3,4,0.75,1,7,8,3,0,0,1,2,6,31,1,SAC,DET,SAC,131,0.5,Turnovers,17,14,9,11
Trey Lyles,F,22023,1626168,22300492,"JAN 05, 2024",SAC vs. TOR,W,15,4,6,0.667,4,5,0.8,0,0,0.0,0,3,3,1,0,0,0,2,12,1,1,SAC,SAC,TOR,135,7.5,Points,16,15,13,4
Trey Lyles,F,22023,1626168,22300492,"JAN 05, 2024",SAC vs. TOR,W,15,4,6,0.667,4,5,0.8,0,0,0.0,0,3,3,1,0,0,0,2,12,1,1,SAC,SAC,TOR,135,4.5,Rebounds,16,15,13,4
Trey Lyles,F,22023,1626168,22300492,"JAN 05, 2024",SAC vs. TOR,W,15,4,6,0.667,4,5,0.8,0,0,0.0,0,3,3,1,0,0,0,2,12,1,1,SAC,SAC,TOR,135,1.5,3-PT Made,16,15,13,4
Trey Lyles,F,22023,1626168,22300492,"JAN 05, 2024",SAC vs. TOR,W,15,4,6,0.667,4,5,0.8,0,0,0.0,0,3,3,1,0,0,0,2,12,1,1,SAC,SAC,TOR,135,12.5,Pts+Rebs,16,15,13,4
Trey Lyles,F,22023,1626168,22300492,"JAN 05, 2024",SAC vs. TOR,W,15,4,6,0.667,4,5,0.8,0,0,0.0,0,3,3,1,0,0,0,2,12,1,1,SAC,SAC,TOR,135,0.5,Blks+Stls,16,15,13,4
Trey Lyles,F,22023,1626168,22300492,"JAN 05, 2024",SAC vs. TOR,W,15,4,6,0.667,4,5,0.8,0,0,0.0,0,3,3,1,0,0,0,2,12,1,1,SAC,SAC,TOR,135,0.5,Turnovers,16,15,13,4
Trey Lyles,F,22023,1626168,22300476,"JAN 03, 2024",SAC vs. ORL,W,22,4,6,0.667,2,3,0.667,0,0,0.0,3,0,3,0,0,1,0,3,10,-1,1,SAC,SAC,ORL,138,7.5,Points,13,13,10,3
Trey Lyles,F,22023,1626168,22300476,"JAN 03, 2024",SAC vs. ORL,W,22,4,6,0.667,2,3,0.667,0,0,0.0,3,0,3,0,0,1,0,3,10,-1,1,SAC,SAC,ORL,138,4.5,Rebounds,13,13,10,3
Trey Lyles,F,22023,1626168,22300476,"JAN 03, 2024",SAC vs. ORL,W,22,4,6,0.667,2,3,0.667,0,0,0.0,3,0,3,0,0,1,0,3,10,-1,1,SAC,SAC,ORL,138,1.5,3-PT Made,13,13,10,3
Trey Lyles,F,22023,1626168,22300476,"JAN 03, 2024",SAC vs. ORL,W,22,4,6,0.667,2,3,0.667,0,0,0.0,3,0,3,0,0,1,0,3,10,-1,1,SAC,SAC,ORL,138,12.5,Pts+Rebs,13,13,10,3
Trey Lyles,F,22023,1626168,22300476,"JAN 03, 2024",SAC vs. ORL,W,22,4,6,0.667,2,3,0.667,0,0,0.0,3,0,3,0,0,1,0,3,10,-1,1,SAC,SAC,ORL,138,0.5,Blks+Stls,13,13,10,3
Trey Lyles,F,22023,1626168,22300476,"JAN 03, 2024",SAC vs. ORL,W,22,4,6,0.667,2,3,0.667,0,0,0.0,3,0,3,0,0,1,0,3,10,-1,1,SAC,SAC,ORL,138,0.5,Turnovers,13,13,10,3
Trey Lyles,F,22023,1626168,22300464,"JAN 02, 2024",SAC vs. CHA,L,17,3,6,0.5,3,5,0.6,0,0,0.0,0,3,3,1,0,0,0,0,9,-2,1,SAC,SAC,CHA,104,7.5,Points,13,12,10,4
Trey Lyles,F,22023,1626168,22300464,"JAN 02, 2024",SAC vs. CHA,L,17,3,6,0.5,3,5,0.6,0,0,0.0,0,3,3,1,0,0,0,0,9,-2,1,SAC,SAC,CHA,104,4.5,Rebounds,13,12,10,4
Trey Lyles,F,22023,1626168,22300464,"JAN 02, 2024",SAC vs. CHA,L,17,3,6,0.5,3,5,0.6,0,0,0.0,0,3,3,1,0,0,0,0,9,-2,1,SAC,SAC,CHA,104,1.5,3-PT Made,13,12,10,4
Trey Lyles,F,22023,1626168,22300464,"JAN 02, 2024",SAC vs. CHA,L,17,3,6,0.5,3,5,0.6,0,0,0.0,0,3,3,1,0,0,0,0,9,-2,1,SAC,SAC,CHA,104,12.5,Pts+Rebs,13,12,10,4
Trey Lyles,F,22023,1626168,22300464,"JAN 02, 2024",SAC vs. CHA,L,17,3,6,0.5,3,5,0.6,0,0,0.0,0,3,3,1,0,0,0,0,9,-2,1,SAC,SAC,CHA,104,0.5,Blks+Stls,13,12,10,4
Trey Lyles,F,22023,1626168,22300464,"JAN 02, 2024",SAC vs. CHA,L,17,3,6,0.5,3,5,0.6,0,0,0.0,0,3,3,1,0,0,0,0,9,-2,1,SAC,SAC,CHA,104,0.5,Turnovers,13,12,10,4
Trey Lyles,F,22023,1626168,22300449,"DEC 31, 2023",SAC @ MEM,W,19,4,4,1.0,3,3,1.0,1,1,1.0,0,3,3,0,1,0,1,1,12,17,1,SAC,MEM,SAC,123,7.5,Points,15,15,12,3
Trey Lyles,F,22023,1626168,22300449,"DEC 31, 2023",SAC @ MEM,W,19,4,4,1.0,3,3,1.0,1,1,1.0,0,3,3,0,1,0,1,1,12,17,1,SAC,MEM,SAC,123,4.5,Rebounds,15,15,12,3
Trey Lyles,F,22023,1626168,22300449,"DEC 31, 2023",SAC @ MEM,W,19,4,4,1.0,3,3,1.0,1,1,1.0,0,3,3,0,1,0,1,1,12,17,1,SAC,MEM,SAC,123,1.5,3-PT Made,15,15,12,3
Trey Lyles,F,22023,1626168,22300449,"DEC 31, 2023",SAC @ MEM,W,19,4,4,1.0,3,3,1.0,1,1,1.0,0,3,3,0,1,0,1,1,12,17,1,SAC,MEM,SAC,123,12.5,Pts+Rebs,15,15,12,3
Trey Lyles,F,22023,1626168,22300449,"DEC 31, 2023",SAC @ MEM,W,19,4,4,1.0,3,3,1.0,1,1,1.0,0,3,3,0,1,0,1,1,12,17,1,SAC,MEM,SAC,123,0.5,Blks+Stls,15,15,12,3
Trey Lyles,F,22023,1626168,22300449,"DEC 31, 2023",SAC @ MEM,W,19,4,4,1.0,3,3,1.0,1,1,1.0,0,3,3,0,1,0,1,1,12,17,1,SAC,MEM,SAC,123,0.5,Turnovers,15,15,12,3
Trey Lyles,F,22023,1626168,22300431,"DEC 29, 2023",SAC @ ATL,W,25,7,12,0.583,4,9,0.444,1,1,1.0,0,6,6,1,0,0,2,3,19,4,1,SAC,ATL,SAC,117,7.5,Points,26,25,20,7
Trey Lyles,F,22023,1626168,22300431,"DEC 29, 2023",SAC @ ATL,W,25,7,12,0.583,4,9,0.444,1,1,1.0,0,6,6,1,0,0,2,3,19,4,1,SAC,ATL,SAC,117,4.5,Rebounds,26,25,20,7
Trey Lyles,F,22023,1626168,22300431,"DEC 29, 2023",SAC @ ATL,W,25,7,12,0.583,4,9,0.444,1,1,1.0,0,6,6,1,0,0,2,3,19,4,1,SAC,ATL,SAC,117,1.5,3-PT Made,26,25,20,7
Trey Lyles,F,22023,1626168,22300431,"DEC 29, 2023",SAC @ ATL,W,25,7,12,0.583,4,9,0.444,1,1,1.0,0,6,6,1,0,0,2,3,19,4,1,SAC,ATL,SAC,117,12.5,Pts+Rebs,26,25,20,7
Trey Lyles,F,22023,1626168,22300431,"DEC 29, 2023",SAC @ ATL,W,25,7,12,0.583,4,9,0.444,1,1,1.0,0,6,6,1,0,0,2,3,19,4,1,SAC,ATL,SAC,117,0.5,Blks+Stls,26,25,20,7
Trey Lyles,F,22023,1626168,22300431,"DEC 29, 2023",SAC @ ATL,W,25,7,12,0.583,4,9,0.444,1,1,1.0,0,6,6,1,0,0,2,3,19,4,1,SAC,ATL,SAC,117,0.5,Turnovers,26,25,20,7
Trey Lyles,F,22023,1626168,22300413,"DEC 26, 2023",SAC @ POR,L,14,0,0,0.0,0,0,0.0,0,0,0.0,0,2,2,2,0,2,0,1,0,-9,1,SAC,POR,SAC,113,7.5,Points,4,2,2,4
Trey Lyles,F,22023,1626168,22300413,"DEC 26, 2023",SAC @ POR,L,14,0,0,0.0,0,0,0.0,0,0,0.0,0,2,2,2,0,2,0,1,0,-9,1,SAC,POR,SAC,113,4.5,Rebounds,4,2,2,4
Trey Lyles,F,22023,1626168,22300413,"DEC 26, 2023",SAC @ POR,L,14,0,0,0.0,0,0,0.0,0,0,0.0,0,2,2,2,0,2,0,1,0,-9,1,SAC,POR,SAC,113,1.5,3-PT Made,4,2,2,4
Trey Lyles,F,22023,1626168,22300413,"DEC 26, 2023",SAC @ POR,L,14,0,0,0.0,0,0,0.0,0,0,0.0,0,2,2,2,0,2,0,1,0,-9,1,SAC,POR,SAC,113,12.5,Pts+Rebs,4,2,2,4
Trey Lyles,F,22023,1626168,22300413,"DEC 26, 2023",SAC @ POR,L,14,0,0,0.0,0,0,0.0,0,0,0.0,0,2,2,2,0,2,0,1,0,-9,1,SAC,POR,SAC,113,0.5,Blks+Stls,4,2,2,4
Trey Lyles,F,22023,1626168,22300413,"DEC 26, 2023",SAC @ POR,L,14,0,0,0.0,0,0,0.0,0,0,0.0,0,2,2,2,0,2,0,1,0,-9,1,SAC,POR,SAC,113,0.5,Turnovers,4,2,2,4
Trey Lyles,F,22023,1626168,22300400,"DEC 23, 2023",SAC vs. MIN,L,27,4,8,0.5,1,4,0.25,1,3,0.333,3,4,7,3,0,0,1,1,10,7,1,SAC,SAC,MIN,98,7.5,Points,20,17,13,10
Trey Lyles,F,22023,1626168,22300400,"DEC 23, 2023",SAC vs. MIN,L,27,4,8,0.5,1,4,0.25,1,3,0.333,3,4,7,3,0,0,1,1,10,7,1,SAC,SAC,MIN,98,4.5,Rebounds,20,17,13,10
Trey Lyles,F,22023,1626168,22300400,"DEC 23, 2023",SAC vs. MIN,L,27,4,8,0.5,1,4,0.25,1,3,0.333,3,4,7,3,0,0,1,1,10,7,1,SAC,SAC,MIN,98,1.5,3-PT Made,20,17,13,10
Trey Lyles,F,22023,1626168,22300400,"DEC 23, 2023",SAC vs. MIN,L,27,4,8,0.5,1,4,0.25,1,3,0.333,3,4,7,3,0,0,1,1,10,7,1,SAC,SAC,MIN,98,12.5,Pts+Rebs,20,17,13,10
Trey Lyles,F,22023,1626168,22300400,"DEC 23, 2023",SAC vs. MIN,L,27,4,8,0.5,1,4,0.25,1,3,0.333,3,4,7,3,0,0,1,1,10,7,1,SAC,SAC,MIN,98,0.5,Blks+Stls,20,17,13,10
Trey Lyles,F,22023,1626168,22300400,"DEC 23, 2023",SAC vs. MIN,L,27,4,8,0.5,1,4,0.25,1,3,0.333,3,4,7,3,0,0,1,1,10,7,1,SAC,SAC,MIN,98,0.5,Turnovers,20,17,13,10
Trey Lyles,F,22023,1626168,22300387,"DEC 22, 2023",SAC vs. PHX,W,11,0,1,0.0,0,0,0.0,0,0,0.0,1,3,4,0,0,0,1,1,0,4,1,SAC,SAC,PHX,120,7.5,Points,4,4,0,4
Trey Lyles,F,22023,1626168,22300387,"DEC 22, 2023",SAC vs. PHX,W,11,0,1,0.0,0,0,0.0,0,0,0.0,1,3,4,0,0,0,1,1,0,4,1,SAC,SAC,PHX,120,4.5,Rebounds,4,4,0,4
Trey Lyles,F,22023,1626168,22300387,"DEC 22, 2023",SAC vs. PHX,W,11,0,1,0.0,0,0,0.0,0,0,0.0,1,3,4,0,0,0,1,1,0,4,1,SAC,SAC,PHX,120,1.5,3-PT Made,4,4,0,4
Trey Lyles,F,22023,1626168,22300387,"DEC 22, 2023",SAC vs. PHX,W,11,0,1,0.0,0,0,0.0,0,0,0.0,1,3,4,0,0,0,1,1,0,4,1,SAC,SAC,PHX,120,12.5,Pts+Rebs,4,4,0,4
Trey Lyles,F,22023,1626168,22300387,"DEC 22, 2023",SAC vs. PHX,W,11,0,1,0.0,0,0,0.0,0,0,0.0,1,3,4,0,0,0,1,1,0,4,1,SAC,SAC,PHX,120,0.5,Blks+Stls,4,4,0,4
Trey Lyles,F,22023,1626168,22300387,"DEC 22, 2023",SAC vs. PHX,W,11,0,1,0.0,0,0,0.0,0,0,0.0,1,3,4,0,0,0,1,1,0,4,1,SAC,SAC,PHX,120,0.5,Turnovers,4,4,0,4
Trey Lyles,F,22023,1626168,22300373,"DEC 20, 2023",SAC vs. BOS,L,27,4,7,0.571,3,6,0.5,0,0,0.0,1,4,5,3,0,1,0,1,11,-19,1,SAC,SAC,BOS,119,7.5,Points,19,16,14,8
Trey Lyles,F,22023,1626168,22300373,"DEC 20, 2023",SAC vs. BOS,L,27,4,7,0.571,3,6,0.5,0,0,0.0,1,4,5,3,0,1,0,1,11,-19,1,SAC,SAC,BOS,119,4.5,Rebounds,19,16,14,8
Trey Lyles,F,22023,1626168,22300373,"DEC 20, 2023",SAC vs. BOS,L,27,4,7,0.571,3,6,0.5,0,0,0.0,1,4,5,3,0,1,0,1,11,-19,1,SAC,SAC,BOS,119,1.5,3-PT Made,19,16,14,8
Trey Lyles,F,22023,1626168,22300373,"DEC 20, 2023",SAC vs. BOS,L,27,4,7,0.571,3,6,0.5,0,0,0.0,1,4,5,3,0,1,0,1,11,-19,1,SAC,SAC,BOS,119,12.5,Pts+Rebs,19,16,14,8
Trey Lyles,F,22023,1626168,22300373,"DEC 20, 2023",SAC vs. BOS,L,27,4,7,0.571,3,6,0.5,0,0,0.0,1,4,5,3,0,1,0,1,11,-19,1,SAC,SAC,BOS,119,0.5,Blks+Stls,19,16,14,8
Trey Lyles,F,22023,1626168,22300373,"DEC 20, 2023",SAC vs. BOS,L,27,4,7,0.571,3,6,0.5,0,0,0.0,1,4,5,3,0,1,0,1,11,-19,1,SAC,SAC,BOS,119,0.5,Turnovers,19,16,14,8
Trey Lyles,F,22023,1626168,22300358,"DEC 18, 2023",SAC vs. WAS,W,18,0,3,0.0,0,3,0.0,0,0,0.0,0,2,2,0,0,0,0,0,0,-4,1,SAC,SAC,WAS,141,7.5,Points,2,2,0,2
Trey Lyles,F,22023,1626168,22300358,"DEC 18, 2023",SAC vs. WAS,W,18,0,3,0.0,0,3,0.0,0,0,0.0,0,2,2,0,0,0,0,0,0,-4,1,SAC,SAC,WAS,141,4.5,Rebounds,2,2,0,2
Trey Lyles,F,22023,1626168,22300358,"DEC 18, 2023",SAC vs. WAS,W,18,0,3,0.0,0,3,0.0,0,0,0.0,0,2,2,0,0,0,0,0,0,-4,1,SAC,SAC,WAS,141,1.5,3-PT Made,2,2,0,2
Trey Lyles,F,22023,1626168,22300358,"DEC 18, 2023",SAC vs. WAS,W,18,0,3,0.0,0,3,0.0,0,0,0.0,0,2,2,0,0,0,0,0,0,-4,1,SAC,SAC,WAS,141,12.5,Pts+Rebs,2,2,0,2
Trey Lyles,F,22023,1626168,22300358,"DEC 18, 2023",SAC vs. WAS,W,18,0,3,0.0,0,3,0.0,0,0,0.0,0,2,2,0,0,0,0,0,0,-4,1,SAC,SAC,WAS,141,0.5,Blks+Stls,2,2,0,2
Trey Lyles,F,22023,1626168,22300358,"DEC 18, 2023",SAC vs. WAS,W,18,0,3,0.0,0,3,0.0,0,0,0.0,0,2,2,0,0,0,0,0,0,-4,1,SAC,SAC,WAS,141,0.5,Turnovers,2,2,0,2
Trey Lyles,F,22023,1626168,22300342,"DEC 16, 2023",SAC vs. UTA,W,18,0,2,0.0,0,2,0.0,0,0,0.0,1,7,8,0,0,1,2,4,0,1,1,SAC,SAC,UTA,125,7.5,Points,8,8,0,8
Trey Lyles,F,22023,1626168,22300342,"DEC 16, 2023",SAC vs. UTA,W,18,0,2,0.0,0,2,0.0,0,0,0.0,1,7,8,0,0,1,2,4,0,1,1,SAC,SAC,UTA,125,4.5,Rebounds,8,8,0,8
Trey Lyles,F,22023,1626168,22300342,"DEC 16, 2023",SAC vs. UTA,W,18,0,2,0.0,0,2,0.0,0,0,0.0,1,7,8,0,0,1,2,4,0,1,1,SAC,SAC,UTA,125,1.5,3-PT Made,8,8,0,8
Trey Lyles,F,22023,1626168,22300342,"DEC 16, 2023",SAC vs. UTA,W,18,0,2,0.0,0,2,0.0,0,0,0.0,1,7,8,0,0,1,2,4,0,1,1,SAC,SAC,UTA,125,12.5,Pts+Rebs,8,8,0,8
Trey Lyles,F,22023,1626168,22300342,"DEC 16, 2023",SAC vs. UTA,W,18,0,2,0.0,0,2,0.0,0,0,0.0,1,7,8,0,0,1,2,4,0,1,1,SAC,SAC,UTA,125,0.5,Blks+Stls,8,8,0,8
Trey Lyles,F,22023,1626168,22300342,"DEC 16, 2023",SAC vs. UTA,W,18,0,2,0.0,0,2,0.0,0,0,0.0,1,7,8,0,0,1,2,4,0,1,1,SAC,SAC,UTA,125,0.5,Turnovers,8,8,0,8
Trey Lyles,F,22023,1626168,22300324,"DEC 14, 2023",SAC vs. OKC,W,19,2,5,0.4,1,4,0.25,0,0,0.0,1,6,7,1,0,1,0,2,5,22,1,SAC,SAC,OKC,128,7.5,Points,13,12,6,8
Trey Lyles,F,22023,1626168,22300324,"DEC 14, 2023",SAC vs. OKC,W,19,2,5,0.4,1,4,0.25,0,0,0.0,1,6,7,1,0,1,0,2,5,22,1,SAC,SAC,OKC,128,4.5,Rebounds,13,12,6,8
Trey Lyles,F,22023,1626168,22300324,"DEC 14, 2023",SAC vs. OKC,W,19,2,5,0.4,1,4,0.25,0,0,0.0,1,6,7,1,0,1,0,2,5,22,1,SAC,SAC,OKC,128,1.5,3-PT Made,13,12,6,8
Trey Lyles,F,22023,1626168,22300324,"DEC 14, 2023",SAC vs. OKC,W,19,2,5,0.4,1,4,0.25,0,0,0.0,1,6,7,1,0,1,0,2,5,22,1,SAC,SAC,OKC,128,12.5,Pts+Rebs,13,12,6,8
Trey Lyles,F,22023,1626168,22300324,"DEC 14, 2023",SAC vs. OKC,W,19,2,5,0.4,1,4,0.25,0,0,0.0,1,6,7,1,0,1,0,2,5,22,1,SAC,SAC,OKC,128,0.5,Blks+Stls,13,12,6,8
Trey Lyles,F,22023,1626168,22300324,"DEC 14, 2023",SAC vs. OKC,W,19,2,5,0.4,1,4,0.25,0,0,0.0,1,6,7,1,0,1,0,2,5,22,1,SAC,SAC,OKC,128,0.5,Turnovers,13,12,6,8
Trey Lyles,F,22023,1626168,22300309,"DEC 12, 2023",SAC @ LAC,L,20,1,4,0.25,0,3,0.0,1,2,0.5,1,5,6,3,1,0,0,1,3,-19,1,SAC,LAC,SAC,99,7.5,Points,12,9,6,9
Trey Lyles,F,22023,1626168,22300309,"DEC 12, 2023",SAC @ LAC,L,20,1,4,0.25,0,3,0.0,1,2,0.5,1,5,6,3,1,0,0,1,3,-19,1,SAC,LAC,SAC,99,4.5,Rebounds,12,9,6,9
Trey Lyles,F,22023,1626168,22300309,"DEC 12, 2023",SAC @ LAC,L,20,1,4,0.25,0,3,0.0,1,2,0.5,1,5,6,3,1,0,0,1,3,-19,1,SAC,LAC,SAC,99,1.5,3-PT Made,12,9,6,9
Trey Lyles,F,22023,1626168,22300309,"DEC 12, 2023",SAC @ LAC,L,20,1,4,0.25,0,3,0.0,1,2,0.5,1,5,6,3,1,0,0,1,3,-19,1,SAC,LAC,SAC,99,12.5,Pts+Rebs,12,9,6,9
Trey Lyles,F,22023,1626168,22300309,"DEC 12, 2023",SAC @ LAC,L,20,1,4,0.25,0,3,0.0,1,2,0.5,1,5,6,3,1,0,0,1,3,-19,1,SAC,LAC,SAC,99,0.5,Blks+Stls,12,9,6,9
Trey Lyles,F,22023,1626168,22300309,"DEC 12, 2023",SAC @ LAC,L,20,1,4,0.25,0,3,0.0,1,2,0.5,1,5,6,3,1,0,0,1,3,-19,1,SAC,LAC,SAC,99,0.5,Turnovers,12,9,6,9
Trey Lyles,F,22023,1626168,22300303,"DEC 11, 2023",SAC vs. BKN,W,23,6,7,0.857,5,6,0.833,0,0,0.0,0,6,6,1,0,1,0,0,17,9,1,SAC,SAC,BKN,131,7.5,Points,24,23,18,7
Trey Lyles,F,22023,1626168,22300303,"DEC 11, 2023",SAC vs. BKN,W,23,6,7,0.857,5,6,0.833,0,0,0.0,0,6,6,1,0,1,0,0,17,9,1,SAC,SAC,BKN,131,4.5,Rebounds,24,23,18,7
Trey Lyles,F,22023,1626168,22300303,"DEC 11, 2023",SAC vs. BKN,W,23,6,7,0.857,5,6,0.833,0,0,0.0,0,6,6,1,0,1,0,0,17,9,1,SAC,SAC,BKN,131,1.5,3-PT Made,24,23,18,7
Trey Lyles,F,22023,1626168,22300303,"DEC 11, 2023",SAC vs. BKN,W,23,6,7,0.857,5,6,0.833,0,0,0.0,0,6,6,1,0,1,0,0,17,9,1,SAC,SAC,BKN,131,12.5,Pts+Rebs,24,23,18,7
Trey Lyles,F,22023,1626168,22300303,"DEC 11, 2023",SAC vs. BKN,W,23,6,7,0.857,5,6,0.833,0,0,0.0,0,6,6,1,0,1,0,0,17,9,1,SAC,SAC,BKN,131,0.5,Blks+Stls,24,23,18,7
Trey Lyles,F,22023,1626168,22300303,"DEC 11, 2023",SAC vs. BKN,W,23,6,7,0.857,5,6,0.833,0,0,0.0,0,6,6,1,0,1,0,0,17,9,1,SAC,SAC,BKN,131,0.5,Turnovers,24,23,18,7
Trey Lyles,F,22023,1626168,22301228,"DEC 08, 2023",SAC @ PHX,W,13,2,6,0.333,1,4,0.25,0,0,0.0,0,6,6,2,0,0,0,1,5,9,1,SAC,PHX,SAC,114,7.5,Points,13,11,7,8
Trey Lyles,F,22023,1626168,22301228,"DEC 08, 2023",SAC @ PHX,W,13,2,6,0.333,1,4,0.25,0,0,0.0,0,6,6,2,0,0,0,1,5,9,1,SAC,PHX,SAC,114,4.5,Rebounds,13,11,7,8
Trey Lyles,F,22023,1626168,22301228,"DEC 08, 2023",SAC @ PHX,W,13,2,6,0.333,1,4,0.25,0,0,0.0,0,6,6,2,0,0,0,1,5,9,1,SAC,PHX,SAC,114,1.5,3-PT Made,13,11,7,8
Trey Lyles,F,22023,1626168,22301228,"DEC 08, 2023",SAC @ PHX,W,13,2,6,0.333,1,4,0.25,0,0,0.0,0,6,6,2,0,0,0,1,5,9,1,SAC,PHX,SAC,114,12.5,Pts+Rebs,13,11,7,8
Trey Lyles,F,22023,1626168,22301228,"DEC 08, 2023",SAC @ PHX,W,13,2,6,0.333,1,4,0.25,0,0,0.0,0,6,6,2,0,0,0,1,5,9,1,SAC,PHX,SAC,114,0.5,Blks+Stls,13,11,7,8
Trey Lyles,F,22023,1626168,22301228,"DEC 08, 2023",SAC @ PHX,W,13,2,6,0.333,1,4,0.25,0,0,0.0,0,6,6,2,0,0,0,1,5,9,1,SAC,PHX,SAC,114,0.5,Turnovers,13,11,7,8
Trey Lyles,F,22023,1626168,22301204,"DEC 04, 2023",SAC vs. NOP,L,16,1,4,0.25,0,3,0.0,3,4,0.75,0,1,1,6,0,0,0,3,5,-2,1,SAC,SAC,NOP,117,7.5,Points,12,6,11,7
Trey Lyles,F,22023,1626168,22301204,"DEC 04, 2023",SAC vs. NOP,L,16,1,4,0.25,0,3,0.0,3,4,0.75,0,1,1,6,0,0,0,3,5,-2,1,SAC,SAC,NOP,117,4.5,Rebounds,12,6,11,7
Trey Lyles,F,22023,1626168,22301204,"DEC 04, 2023",SAC vs. NOP,L,16,1,4,0.25,0,3,0.0,3,4,0.75,0,1,1,6,0,0,0,3,5,-2,1,SAC,SAC,NOP,117,1.5,3-PT Made,12,6,11,7
Trey Lyles,F,22023,1626168,22301204,"DEC 04, 2023",SAC vs. NOP,L,16,1,4,0.25,0,3,0.0,3,4,0.75,0,1,1,6,0,0,0,3,5,-2,1,SAC,SAC,NOP,117,12.5,Pts+Rebs,12,6,11,7
Trey Lyles,F,22023,1626168,22301204,"DEC 04, 2023",SAC vs. NOP,L,16,1,4,0.25,0,3,0.0,3,4,0.75,0,1,1,6,0,0,0,3,5,-2,1,SAC,SAC,NOP,117,0.5,Blks+Stls,12,6,11,7
Trey Lyles,F,22023,1626168,22301204,"DEC 04, 2023",SAC vs. NOP,L,16,1,4,0.25,0,3,0.0,3,4,0.75,0,1,1,6,0,0,0,3,5,-2,1,SAC,SAC,NOP,117,0.5,Turnovers,12,6,11,7
Trey Lyles,F,22023,1626168,22300290,"DEC 02, 2023",SAC vs. DEN,W,18,3,8,0.375,0,3,0.0,1,1,1.0,2,2,4,1,0,0,0,2,7,-1,1,SAC,SAC,DEN,123,7.5,Points,12,11,8,5
Trey Lyles,F,22023,1626168,22300290,"DEC 02, 2023",SAC vs. DEN,W,18,3,8,0.375,0,3,0.0,1,1,1.0,2,2,4,1,0,0,0,2,7,-1,1,SAC,SAC,DEN,123,4.5,Rebounds,12,11,8,5
Trey Lyles,F,22023,1626168,22300290,"DEC 02, 2023",SAC vs. DEN,W,18,3,8,0.375,0,3,0.0,1,1,1.0,2,2,4,1,0,0,0,2,7,-1,1,SAC,SAC,DEN,123,1.5,3-PT Made,12,11,8,5
Trey Lyles,F,22023,1626168,22300290,"DEC 02, 2023",SAC vs. DEN,W,18,3,8,0.375,0,3,0.0,1,1,1.0,2,2,4,1,0,0,0,2,7,-1,1,SAC,SAC,DEN,123,12.5,Pts+Rebs,12,11,8,5
Trey Lyles,F,22023,1626168,22300290,"DEC 02, 2023",SAC vs. DEN,W,18,3,8,0.375,0,3,0.0,1,1,1.0,2,2,4,1,0,0,0,2,7,-1,1,SAC,SAC,DEN,123,0.5,Blks+Stls,12,11,8,5
Trey Lyles,F,22023,1626168,22300290,"DEC 02, 2023",SAC vs. DEN,W,18,3,8,0.375,0,3,0.0,1,1,1.0,2,2,4,1,0,0,0,2,7,-1,1,SAC,SAC,DEN,123,0.5,Turnovers,12,11,8,5
Trey Lyles,F,22023,1626168,22300264,"NOV 29, 2023",SAC vs. LAC,L,18,1,5,0.2,0,3,0.0,0,2,0.0,2,3,5,2,0,0,2,2,2,4,1,SAC,SAC,LAC,117,7.5,Points,9,7,4,7
Trey Lyles,F,22023,1626168,22300264,"NOV 29, 2023",SAC vs. LAC,L,18,1,5,0.2,0,3,0.0,0,2,0.0,2,3,5,2,0,0,2,2,2,4,1,SAC,SAC,LAC,117,4.5,Rebounds,9,7,4,7
Trey Lyles,F,22023,1626168,22300264,"NOV 29, 2023",SAC vs. LAC,L,18,1,5,0.2,0,3,0.0,0,2,0.0,2,3,5,2,0,0,2,2,2,4,1,SAC,SAC,LAC,117,1.5,3-PT Made,9,7,4,7
Trey Lyles,F,22023,1626168,22300264,"NOV 29, 2023",SAC vs. LAC,L,18,1,5,0.2,0,3,0.0,0,2,0.0,2,3,5,2,0,0,2,2,2,4,1,SAC,SAC,LAC,117,12.5,Pts+Rebs,9,7,4,7
Trey Lyles,F,22023,1626168,22300264,"NOV 29, 2023",SAC vs. LAC,L,18,1,5,0.2,0,3,0.0,0,2,0.0,2,3,5,2,0,0,2,2,2,4,1,SAC,SAC,LAC,117,0.5,Blks+Stls,9,7,4,7
Trey Lyles,F,22023,1626168,22300264,"NOV 29, 2023",SAC vs. LAC,L,18,1,5,0.2,0,3,0.0,0,2,0.0,2,3,5,2,0,0,2,2,2,4,1,SAC,SAC,LAC,117,0.5,Turnovers,9,7,4,7
Trey Lyles,F,22023,1626168,22300060,"NOV 28, 2023",SAC vs. GSW,W,24,2,6,0.333,1,4,0.25,6,9,0.667,3,3,6,0,0,1,1,2,11,4,1,SAC,SAC,GSW,124,7.5,Points,17,17,11,6
Trey Lyles,F,22023,1626168,22300060,"NOV 28, 2023",SAC vs. GSW,W,24,2,6,0.333,1,4,0.25,6,9,0.667,3,3,6,0,0,1,1,2,11,4,1,SAC,SAC,GSW,124,4.5,Rebounds,17,17,11,6
Trey Lyles,F,22023,1626168,22300060,"NOV 28, 2023",SAC vs. GSW,W,24,2,6,0.333,1,4,0.25,6,9,0.667,3,3,6,0,0,1,1,2,11,4,1,SAC,SAC,GSW,124,1.5,3-PT Made,17,17,11,6
Trey Lyles,F,22023,1626168,22300060,"NOV 28, 2023",SAC vs. GSW,W,24,2,6,0.333,1,4,0.25,6,9,0.667,3,3,6,0,0,1,1,2,11,4,1,SAC,SAC,GSW,124,12.5,Pts+Rebs,17,17,11,6
Trey Lyles,F,22023,1626168,22300060,"NOV 28, 2023",SAC vs. GSW,W,24,2,6,0.333,1,4,0.25,6,9,0.667,3,3,6,0,0,1,1,2,11,4,1,SAC,SAC,GSW,124,0.5,Blks+Stls,17,17,11,6
Trey Lyles,F,22023,1626168,22300060,"NOV 28, 2023",SAC vs. GSW,W,24,2,6,0.333,1,4,0.25,6,9,0.667,3,3,6,0,0,1,1,2,11,4,1,SAC,SAC,GSW,124,0.5,Turnovers,17,17,11,6
Trey Lyles,F,22023,1626168,22300050,"NOV 24, 2023",SAC @ MIN,W,19,3,6,0.5,3,6,0.5,0,0,0.0,1,6,7,0,0,0,1,1,9,15,1,SAC,MIN,SAC,124,7.5,Points,16,16,9,7
Trey Lyles,F,22023,1626168,22300050,"NOV 24, 2023",SAC @ MIN,W,19,3,6,0.5,3,6,0.5,0,0,0.0,1,6,7,0,0,0,1,1,9,15,1,SAC,MIN,SAC,124,4.5,Rebounds,16,16,9,7
Trey Lyles,F,22023,1626168,22300050,"NOV 24, 2023",SAC @ MIN,W,19,3,6,0.5,3,6,0.5,0,0,0.0,1,6,7,0,0,0,1,1,9,15,1,SAC,MIN,SAC,124,1.5,3-PT Made,16,16,9,7
Trey Lyles,F,22023,1626168,22300050,"NOV 24, 2023",SAC @ MIN,W,19,3,6,0.5,3,6,0.5,0,0,0.0,1,6,7,0,0,0,1,1,9,15,1,SAC,MIN,SAC,124,12.5,Pts+Rebs,16,16,9,7
Trey Lyles,F,22023,1626168,22300050,"NOV 24, 2023",SAC @ MIN,W,19,3,6,0.5,3,6,0.5,0,0,0.0,1,6,7,0,0,0,1,1,9,15,1,SAC,MIN,SAC,124,0.5,Blks+Stls,16,16,9,7
Trey Lyles,F,22023,1626168,22300050,"NOV 24, 2023",SAC @ MIN,W,19,3,6,0.5,3,6,0.5,0,0,0.0,1,6,7,0,0,0,1,1,9,15,1,SAC,MIN,SAC,124,0.5,Turnovers,16,16,9,7
Trey Lyles,F,22023,1626168,22300233,"NOV 22, 2023",SAC @ NOP,L,28,4,8,0.5,3,7,0.429,1,1,1.0,0,8,8,0,0,0,3,5,12,-9,1,SAC,NOP,SAC,112,7.5,Points,20,20,12,8
Trey Lyles,F,22023,1626168,22300233,"NOV 22, 2023",SAC @ NOP,L,28,4,8,0.5,3,7,0.429,1,1,1.0,0,8,8,0,0,0,3,5,12,-9,1,SAC,NOP,SAC,112,4.5,Rebounds,20,20,12,8
Trey Lyles,F,22023,1626168,22300233,"NOV 22, 2023",SAC @ NOP,L,28,4,8,0.5,3,7,0.429,1,1,1.0,0,8,8,0,0,0,3,5,12,-9,1,SAC,NOP,SAC,112,1.5,3-PT Made,20,20,12,8
Trey Lyles,F,22023,1626168,22300233,"NOV 22, 2023",SAC @ NOP,L,28,4,8,0.5,3,7,0.429,1,1,1.0,0,8,8,0,0,0,3,5,12,-9,1,SAC,NOP,SAC,112,12.5,Pts+Rebs,20,20,12,8
Trey Lyles,F,22023,1626168,22300233,"NOV 22, 2023",SAC @ NOP,L,28,4,8,0.5,3,7,0.429,1,1,1.0,0,8,8,0,0,0,3,5,12,-9,1,SAC,NOP,SAC,112,0.5,Blks+Stls,20,20,12,8
Trey Lyles,F,22023,1626168,22300233,"NOV 22, 2023",SAC @ NOP,L,28,4,8,0.5,3,7,0.429,1,1,1.0,0,8,8,0,0,0,3,5,12,-9,1,SAC,NOP,SAC,112,0.5,Turnovers,20,20,12,8
Nickeil Alexander-Walker,F,22023,1629638,22300738,"FEB 08, 2024",MIN @ MIL,W,25,2,7,0.286,1,4,0.25,2,2,1.0,1,2,3,4,0,0,1,0,7,20,1,MIN,MIL,MIN,129,,,14,10,11,7
Nickeil Alexander-Walker,F,22023,1629638,22300723,"FEB 06, 2024",MIN @ CHI,L,19,1,4,0.25,1,3,0.333,0,0,0.0,0,1,1,2,1,0,0,2,3,-8,1,MIN,CHI,MIN,123,,,6,4,5,3
Nickeil Alexander-Walker,F,22023,1629638,22300709,"FEB 04, 2024",MIN vs. HOU,W,21,2,7,0.286,1,4,0.25,0,0,0.0,1,6,7,1,1,0,2,2,5,13,1,MIN,MIN,HOU,111,,,13,12,6,8
Nickeil Alexander-Walker,F,22023,1629638,22300694,"FEB 02, 2024",MIN vs. ORL,L,27,2,7,0.286,1,5,0.2,2,2,1.0,0,1,1,0,1,0,1,2,7,0,1,MIN,MIN,ORL,106,,,8,8,7,1
Nickeil Alexander-Walker,F,22023,1629638,22300680,"JAN 31, 2024",MIN vs. DAL,W,23,3,7,0.429,1,5,0.2,2,2,1.0,0,0,0,3,0,0,0,5,9,15,1,MIN,MIN,DAL,121,,,12,9,12,3
Nickeil Alexander-Walker,F,22023,1629638,22300664,"JAN 29, 2024",MIN @ OKC,W,35,4,12,0.333,2,7,0.286,2,2,1.0,0,2,2,3,2,0,1,2,12,10,1,MIN,OKC,MIN,107,,,17,14,15,5
Nickeil Alexander-Walker,F,22023,1629638,22300649,"JAN 27, 2024",MIN @ SAS,L,33,4,7,0.571,3,4,0.75,0,0,0.0,1,3,4,7,1,0,1,1,11,2,1,MIN,SAS,MIN,112,,,22,15,18,11
Nickeil Alexander-Walker,F,22023,1629638,22300629,"JAN 25, 2024",MIN @ BKN,W,17,2,4,0.5,1,3,0.333,1,2,0.5,0,1,1,4,0,0,0,2,6,1,1,MIN,BKN,MIN,96,,,11,7,10,5
Nickeil Alexander-Walker,F,22023,1629638,22300620,"JAN 24, 2024",MIN @ WAS,W,31,2,4,0.5,1,3,0.333,1,2,0.5,1,4,5,5,1,0,0,2,6,8,1,MIN,WAS,MIN,118,,,16,11,11,10
Nickeil Alexander-Walker,F,22023,1629638,22300610,"JAN 22, 2024",MIN vs. CHA,L,30,6,9,0.667,4,6,0.667,2,2,1.0,0,0,0,2,1,0,1,2,18,-5,1,MIN,MIN,CHA,125,,,20,18,20,2
Nickeil Alexander-Walker,F,22023,1629638,22300599,"JAN 20, 2024",MIN vs. OKC,L,19,1,3,0.333,1,2,0.5,0,0,0.0,0,5,5,2,1,1,2,1,3,8,1,MIN,MIN,OKC,97,,,10,8,5,7
Nickeil Alexander-Walker,F,22023,1629638,22300582,"JAN 18, 2024",MIN vs. MEM,W,25,3,5,0.6,1,3,0.333,0,0,0.0,0,2,2,5,0,0,2,0,7,13,1,MIN,MIN,MEM,118,,,14,9,12,7
Nickeil Alexander-Walker,F,22023,1629638,22300569,"JAN 17, 2024",MIN @ DET,W,23,3,6,0.5,1,3,0.333,0,0,0.0,0,0,0,1,1,1,0,2,7,-6,1,MIN,DET,MIN,124,,,8,7,8,1
Nickeil Alexander-Walker,F,22023,1629638,22300553,"JAN 14, 2024",MIN vs. LAC,W,20,2,6,0.333,2,5,0.4,0,0,0.0,0,0,0,1,0,1,0,4,6,-4,1,MIN,MIN,LAC,109,,,7,6,7,1
Nickeil Alexander-Walker,F,22023,1629638,22300538,"JAN 12, 2024",MIN vs. POR,W,19,1,3,0.333,0,2,0.0,0,0,0.0,0,2,2,3,2,0,2,1,2,1,1,MIN,MIN,POR,116,,,7,4,5,5
Nickeil Alexander-Walker,F,22023,1629638,22300517,"JAN 10, 2024",MIN @ BOS,L,40,5,8,0.625,3,5,0.6,2,2,1.0,2,2,4,3,1,1,1,4,15,-4,1,MIN,BOS,MIN,120,,,22,19,18,7
Nickeil Alexander-Walker,F,22023,1629638,22300513,"JAN 09, 2024",MIN @ ORL,W,18,0,5,0.0,0,4,0.0,0,0,0.0,0,2,2,3,0,1,2,1,0,11,1,MIN,ORL,MIN,113,,,5,2,3,5
Nickeil Alexander-Walker,F,22023,1629638,22300501,"JAN 07, 2024",MIN @ DAL,L,13,1,5,0.2,1,4,0.25,0,0,0.0,1,0,1,1,0,0,0,0,3,-6,1,MIN,DAL,MIN,108,,,5,4,4,2
Nickeil Alexander-Walker,F,22023,1629638,22300485,"JAN 05, 2024",MIN @ HOU,W,18,4,6,0.667,2,4,0.5,1,2,0.5,1,2,3,3,2,2,0,2,11,17,1,MIN,HOU,MIN,122,,,17,14,14,6
Nickeil Alexander-Walker,F,22023,1629638,22300471,"JAN 03, 2024",MIN vs. NOP,L,19,1,3,0.333,0,2,0.0,2,2,1.0,0,0,0,1,0,0,1,0,4,-5,1,MIN,MIN,NOP,106,,,5,4,5,1
Nickeil Alexander-Walker,F,22023,1629638,22300451,"JAN 01, 2024",MIN @ NYK,L,17,1,3,0.333,1,2,0.5,0,0,0.0,0,0,0,2,0,0,0,2,3,4,1,MIN,NYK,MIN,106,,,5,3,5,2
Nickeil Alexander-Walker,F,22023,1629638,22300443,"DEC 30, 2023",MIN vs. LAL,W,16,2,4,0.5,2,4,0.5,0,0,0.0,0,2,2,2,1,0,2,4,6,-1,1,MIN,MIN,LAL,108,,,10,8,8,4
Nickeil Alexander-Walker,F,22023,1629638,22300423,"DEC 28, 2023",MIN vs. DAL,W,24,1,3,0.333,1,3,0.333,0,0,0.0,0,0,0,3,4,1,0,0,3,-3,1,MIN,MIN,DAL,118,,,6,3,6,3
Nickeil Alexander-Walker,F,22023,1629638,22300411,"DEC 26, 2023",MIN @ OKC,L,19,3,3,1.0,2,2,1.0,0,0,0.0,1,0,1,3,1,0,0,3,8,-13,1,MIN,OKC,MIN,106,,,12,9,11,4
Nickeil Alexander-Walker,F,22023,1629638,22300400,"DEC 23, 2023",MIN @ SAC,W,23,1,4,0.25,0,2,0.0,0,0,0.0,0,0,0,0,0,0,0,2,2,-1,1,MIN,SAC,MIN,110,,,2,2,2,0
Nickeil Alexander-Walker,F,22023,1629638,22300380,"DEC 21, 2023",MIN vs. LAL,W,15,2,6,0.333,1,5,0.2,0,0,0.0,0,1,1,3,3,0,1,2,5,6,1,MIN,MIN,LAL,118,,,9,6,8,4
Nickeil Alexander-Walker,F,22023,1629638,22300367,"DEC 20, 2023",MIN @ PHI,L,16,2,3,0.667,0,1,0.0,0,0,0.0,0,2,2,2,0,1,0,1,4,-23,1,MIN,PHI,MIN,113,,,8,6,6,4
Nickeil Alexander-Walker,F,22023,1629638,22300353,"DEC 18, 2023",MIN @ MIA,W,22,2,5,0.4,2,4,0.5,2,2,1.0,1,0,1,3,1,0,0,2,8,13,1,MIN,MIA,MIN,112,,,12,9,11,4
Nickeil Alexander-Walker,F,22023,1629638,22300338,"DEC 16, 2023",MIN vs. IND,W,26,1,6,0.167,1,2,0.5,0,0,0.0,0,2,2,1,1,0,1,0,3,2,1,MIN,MIN,IND,127,,,6,5,4,3
Nickeil Alexander-Walker,F,22023,1629638,22300321,"DEC 14, 2023",MIN @ DAL,W,20,5,6,0.833,3,4,0.75,0,0,0.0,1,0,1,1,0,1,1,2,13,20,1,MIN,DAL,MIN,119,,,15,14,14,2
Nickeil Alexander-Walker,F,22023,1629638,22300301,"DEC 11, 2023",MIN @ NOP,L,24,2,7,0.286,1,4,0.25,2,2,1.0,0,1,1,5,1,1,3,4,7,-13,1,MIN,NOP,MIN,107,,,13,8,12,6
Nickeil Alexander-Walker,F,22023,1629638,22301221,"DEC 08, 2023",MIN @ MEM,W,34,4,9,0.444,4,8,0.5,2,2,1.0,2,0,2,2,0,1,2,2,14,23,1,MIN,MEM,MIN,127,,,18,16,16,4
Nickeil Alexander-Walker,F,22023,1629638,22301210,"DEC 06, 2023",MIN vs. SAS,W,20,3,8,0.375,1,6,0.167,0,0,0.0,0,2,2,0,0,0,1,1,7,2,1,MIN,MIN,SAS,102,,,9,9,7,2
Nickeil Alexander-Walker,F,22023,1629638,22300281,"DEC 02, 2023",MIN @ CHA,W,30,2,5,0.4,0,2,0.0,2,2,1.0,0,2,2,2,0,0,1,1,6,-7,1,MIN,CHA,MIN,123,,,10,8,8,4
Nickeil Alexander-Walker,F,22023,1629638,22300270,"NOV 30, 2023",MIN vs. UTA,W,36,8,16,0.5,4,8,0.5,0,0,0.0,2,3,5,7,5,2,4,4,20,15,1,MIN,MIN,UTA,101,,,32,25,27,12
Nickeil Alexander-Walker,F,22023,1629638,22300058,"NOV 28, 2023",MIN vs. OKC,W,26,1,7,0.143,1,5,0.2,0,0,0.0,1,1,2,1,0,0,2,2,3,-4,1,MIN,MIN,OKC,106,,,6,5,4,3
Nickeil Alexander-Walker,F,22023,1629638,22300249,"NOV 26, 2023",MIN @ MEM,W,34,3,7,0.429,2,6,0.333,1,3,0.333,0,1,1,3,1,0,1,2,9,17,1,MIN,MEM,MIN,119,,,13,10,12,4
Nickeil Alexander-Walker,F,22023,1629638,22300050,"NOV 24, 2023",MIN vs. SAC,L,22,2,8,0.25,2,7,0.286,0,0,0.0,1,0,1,2,2,1,0,4,6,-12,1,MIN,MIN,SAC,111,,,9,7,8,3
Nickeil Alexander-Walker,F,22023,1629638,22300232,"NOV 22, 2023",MIN vs. PHI,W,29,3,6,0.5,1,4,0.25,0,0,0.0,2,4,6,4,0,1,0,4,7,22,1,MIN,MIN,PHI,112,,,17,13,11,10
Nickeil Alexander-Walker,F,22023,1629638,22300221,"NOV 20, 2023",MIN vs. NYK,W,33,4,8,0.5,3,6,0.5,0,0,0.0,1,2,3,3,0,0,0,2,11,15,1,MIN,MIN,NYK,117,,,17,14,14,6
Nickeil Alexander-Walker,F,22023,1629638,22300203,"NOV 18, 2023",MIN @ NOP,W,18,4,7,0.571,2,4,0.5,0,0,0.0,0,1,1,3,1,1,2,2,10,6,1,MIN,NOP,MIN,121,,,14,11,13,4
Nickeil Alexander-Walker,F,22023,1629638,22300197,"NOV 15, 2023",MIN @ PHX,L,23,3,6,0.5,2,5,0.4,0,0,0.0,0,0,0,0,0,1,0,1,8,-5,1,MIN,PHX,MIN,115,,,8,8,8,0
Nickeil Alexander-Walker,F,22023,1629638,22300025,"NOV 14, 2023",MIN @ GSW,W,25,2,5,0.4,1,4,0.25,0,0,0.0,0,0,0,1,1,1,2,1,5,-16,1,MIN,GSW,MIN,104,,,6,5,6,1
Nickeil Alexander-Walker,F,22023,1629638,22300186,"NOV 12, 2023",MIN @ GSW,W,17,4,6,0.667,2,3,0.667,0,0,0.0,0,2,2,1,2,0,0,2,10,0,1,MIN,GSW,MIN,116,,,13,12,11,3
Nickeil Alexander-Walker,F,22023,1629638,22300013,"NOV 10, 2023",MIN @ SAS,W,19,3,4,0.75,1,1,1.0,2,2,1.0,0,3,3,4,0,1,0,0,9,11,1,MIN,SAS,MIN,117,,,16,12,13,7
Nickeil Alexander-Walker,F,22023,1629638,22300166,"NOV 08, 2023",MIN vs. NOP,W,18,0,1,0.0,0,1,0.0,0,0,0.0,0,4,4,8,1,0,2,0,0,-13,1,MIN,MIN,NOP,122,,,12,4,8,12
Nickeil Alexander-Walker,F,22023,1629638,22300154,"NOV 06, 2023",MIN vs. BOS,W,20,3,6,0.5,2,4,0.5,0,1,0.0,0,1,1,3,1,0,1,3,8,13,1,MIN,MIN,BOS,114,,,12,9,11,4
Nickeil Alexander-Walker,F,22023,1629638,22300138,"NOV 04, 2023",MIN vs. UTA,W,18,0,3,0.0,0,1,0.0,0,1,0.0,1,2,3,1,2,3,0,0,0,1,1,MIN,MIN,UTA,123,,,4,3,1,4
Nickeil Alexander-Walker,F,22023,1629638,22300123,"NOV 01, 2023",MIN vs. DEN,W,21,2,6,0.333,1,2,0.5,0,0,0.0,0,0,0,1,0,1,0,2,5,2,1,MIN,MIN,DEN,110,,,6,5,6,1
Nickeil Alexander-Walker,F,22023,1629638,22300104,"OCT 30, 2023",MIN @ ATL,L,13,1,3,0.333,1,3,0.333,0,2,0.0,0,0,0,2,0,0,1,1,3,-9,1,MIN,ATL,MIN,113,,,5,3,5,2
Nickeil Alexander-Walker,F,22023,1629638,22300093,"OCT 28, 2023",MIN vs. MIA,W,23,2,8,0.25,1,6,0.167,0,0,0.0,0,3,3,3,1,2,3,3,5,8,1,MIN,MIN,MIA,106,,,11,8,8,6
Nickeil Alexander-Walker,F,22023,1629638,22300069,"OCT 25, 2023",MIN @ TOR,L,23,1,5,0.2,0,3,0.0,0,0,0.0,0,4,4,2,1,0,1,3,2,-17,1,MIN,TOR,MIN,94,,,8,6,4,6
Killian Hayes,G,22023,1630165,22300534,"JAN 12, 2024",DET vs. HOU,L,29,2,6,0.333,0,2,0.0,1,1,1.0,0,4,4,8,1,1,1,1,5,-7,1,DET,DET,HOU,110,,,17,9,13,12
Killian Hayes,G,22023,1630165,22300453,"JAN 01, 2024",DET @ HOU,L,19,3,8,0.375,1,2,0.5,1,4,0.25,0,1,1,3,1,0,1,2,8,-2,1,DET,HOU,DET,113,,,12,9,11,4
Killian Hayes,G,22023,1630165,22300334,"DEC 16, 2023",DET @ MIL,L,14,1,4,0.25,0,0,0.0,0,0,0.0,0,4,4,5,0,0,1,0,2,-3,1,DET,MIL,DET,114,,,11,6,7,9
Killian Hayes,G,22023,1630165,22301217,"DEC 08, 2023",DET @ ORL,L,32,7,11,0.636,0,2,0.0,2,3,0.667,1,6,7,4,0,1,2,1,16,-22,1,DET,ORL,DET,91,,,27,23,20,11
Killian Hayes,G,22023,1630165,22300283,"DEC 02, 2023",DET vs. CLE,L,33,6,11,0.545,1,1,1.0,0,1,0.0,0,6,6,3,2,1,2,2,13,7,1,DET,DET,CLE,101,,,22,19,16,9
Killian Hayes,G,22023,1630165,22300268,"NOV 30, 2023",DET @ NYK,L,28,10,13,0.769,2,3,0.667,1,4,0.25,0,3,3,4,1,1,0,3,23,-3,1,DET,NYK,DET,112,,,30,26,27,7
Killian Hayes,G,22023,1630165,22300258,"NOV 29, 2023",DET vs. LAL,L,22,3,9,0.333,0,3,0.0,1,1,1.0,0,1,1,8,2,0,0,2,7,8,1,DET,DET,LAL,107,,,16,8,15,9
Killian Hayes,G,22023,1630165,22300047,"NOV 24, 2023",DET @ IND,L,17,3,6,0.5,0,0,0.0,0,0,0.0,0,1,1,3,0,0,0,0,6,-25,1,DET,IND,DET,113,,,10,7,9,4
Killian Hayes,G,22023,1630165,22300218,"NOV 20, 2023",DET vs. DEN,L,14,0,2,0.0,0,1,0.0,0,0,0.0,0,0,0,2,2,0,2,2,0,-5,1,DET,DET,DEN,103,,,2,0,2,2
Killian Hayes,G,22023,1630165,22300030,"NOV 17, 2023",DET @ CLE,L,22,2,6,0.333,0,2,0.0,0,0,0.0,0,0,0,2,1,1,0,0,4,-14,1,DET,CLE,DET,100,,,6,4,6,2
Killian Hayes,G,22023,1630165,22300018,"NOV 14, 2023",DET vs. ATL,L,23,3,8,0.375,1,3,0.333,1,2,0.5,0,3,3,5,1,2,1,2,8,12,1,DET,DET,ATL,120,,,16,11,13,8
Killian Hayes,G,22023,1630165,22300181,"NOV 12, 2023",DET @ CHI,L,25,3,8,0.375,1,3,0.333,0,0,0.0,0,3,3,3,0,0,0,1,7,-12,1,DET,CHI,DET,108,,,13,10,10,6
Killian Hayes,G,22023,1630165,22300008,"NOV 10, 2023",DET vs. PHI,L,39,8,17,0.471,2,6,0.333,5,7,0.714,0,5,5,6,2,0,2,1,23,-9,1,DET,DET,PHI,106,,,34,28,29,11
Killian Hayes,G,22023,1630165,22300165,"NOV 08, 2023",DET @ MIL,L,29,6,15,0.4,0,3,0.0,2,2,1.0,0,5,5,4,1,0,1,1,14,-2,1,DET,MIL,DET,118,,,23,19,18,9
Killian Hayes,G,22023,1630165,22300145,"NOV 06, 2023",DET vs. GSW,L,34,8,12,0.667,3,4,0.75,2,2,1.0,0,4,4,7,1,1,0,3,21,-6,1,DET,DET,GSW,109,,,32,25,28,11
Killian Hayes,G,22023,1630165,22300140,"NOV 05, 2023",DET vs. PHX,L,34,4,8,0.5,1,3,0.333,4,4,1.0,0,2,2,5,0,1,0,4,13,-22,1,DET,DET,PHX,106,,,20,15,18,7
Killian Hayes,G,22023,1630165,22300129,"NOV 02, 2023",DET @ NOP,L,39,4,8,0.5,2,4,0.5,0,0,0.0,3,2,5,9,1,0,0,4,10,10,1,DET,NOP,DET,116,,,24,15,19,14
Killian Hayes,G,22023,1630165,22300115,"NOV 01, 2023",DET vs. POR,L,26,0,6,0.0,0,1,0.0,0,0,0.0,0,3,3,1,3,0,1,2,0,6,1,DET,DET,POR,101,,,4,3,1,4
Killian Hayes,G,22023,1630165,22300109,"OCT 30, 2023",DET @ OKC,L,27,4,11,0.364,1,4,0.25,1,2,0.5,0,4,4,7,1,1,1,3,10,-15,1,DET,OKC,DET,112,,,21,14,17,11
Killian Hayes,G,22023,1630165,22300088,"OCT 28, 2023",DET vs. CHI,W,23,2,5,0.4,2,3,0.667,0,0,0.0,1,0,1,4,1,0,1,2,6,7,1,DET,DET,CHI,118,,,11,7,10,5
Killian Hayes,G,22023,1630165,22300077,"OCT 27, 2023",DET @ CHA,W,29,2,10,0.2,1,3,0.333,1,2,0.5,0,3,3,3,2,1,3,4,6,-7,1,DET,CHA,DET,111,,,12,9,9,6
Killian Hayes,G,22023,1630165,22300068,"OCT 25, 2023",DET @ MIA,L,31,4,12,0.333,0,6,0.0,2,3,0.667,0,1,1,3,2,1,1,2,10,1,1,DET,MIA,DET,102,,,14,11,13,4
Killian Hayes,G,22023,1630165,22300654,"JAN 28, 2024",DET vs. OKC,W,14,1,2,0.5,0,0,0.0,0,0,0.0,0,3,3,3,0,0,1,0,2,-9,1,DET,DET,OKC,120,,,8,5,5,6
Killian Hayes,G,22023,1630165,22300642,"JAN 27, 2024",DET vs. WAS,L,10,1,2,0.5,0,0,0.0,0,0,0.0,0,1,1,0,0,2,2,1,2,-6,1,DET,DET,WAS,104,,,3,3,2,1
Killian Hayes,G,22023,1630165,22300619,"JAN 24, 2024",DET vs. CHA,W,27,2,3,0.667,1,2,0.5,1,3,0.333,0,7,7,8,0,0,1,1,6,4,1,DET,DET,CHA,113,,,21,13,14,15
Killian Hayes,G,22023,1630165,22300606,"JAN 22, 2024",DET vs. MIL,L,16,1,2,0.5,0,0,0.0,0,0,0.0,0,1,1,5,1,1,1,2,2,-10,1,DET,DET,MIL,113,,,8,3,7,6
Killian Hayes,G,22023,1630165,22300592,"JAN 20, 2024",DET vs. MIL,L,18,1,3,0.333,0,0,0.0,0,0,0.0,0,1,1,5,1,0,1,3,2,-19,1,DET,DET,MIL,135,,,8,3,7,6
Killian Hayes,G,22023,1630165,22300569,"JAN 17, 2024",DET vs. MIN,L,26,4,4,1.0,0,0,0.0,0,0,0.0,0,1,1,8,0,0,0,3,8,-3,1,DET,DET,MIN,117,,,17,9,16,9
Killian Hayes,G,22023,1630165,22300519,"JAN 10, 2024",DET vs. SAS,L,32,2,8,0.25,0,0,0.0,0,0,0.0,1,3,4,12,0,0,1,1,4,-11,1,DET,DET,SAS,108,,,20,8,16,16
Killian Hayes,G,22023,1630165,22300512,"JAN 09, 2024",DET vs. SAC,L,31,1,4,0.25,0,1,0.0,2,2,1.0,1,3,4,7,1,0,6,2,4,-15,1,DET,DET,SAC,110,,,15,8,11,11
Killian Hayes,G,22023,1630165,22300502,"JAN 07, 2024",DET @ DEN,L,25,1,5,0.2,0,1,0.0,0,0,0.0,0,2,2,6,1,0,1,4,2,-10,1,DET,DEN,DET,114,,,10,4,8,8
Killian Hayes,G,22023,1630165,22300490,"JAN 05, 2024",DET @ GSW,L,16,0,3,0.0,0,2,0.0,0,0,0.0,0,1,1,5,2,0,0,0,0,-4,1,DET,GSW,DET,109,,,6,1,5,6
Killian Hayes,G,22023,1630165,22300474,"JAN 03, 2024",DET @ UTA,L,13,1,3,0.333,0,0,0.0,0,0,0.0,0,4,4,6,0,1,0,2,2,4,1,DET,UTA,DET,148,,,12,6,8,10
Killian Hayes,G,22023,1630165,22300440,"DEC 30, 2023",DET vs. TOR,W,10,0,2,0.0,0,0,0.0,0,0,0.0,0,1,1,4,1,0,3,2,0,1,1,DET,DET,TOR,129,,,5,1,4,5
Killian Hayes,G,22023,1630165,22300421,"DEC 28, 2023",DET @ BOS,L,10,1,3,0.333,0,0,0.0,0,0,0.0,0,2,2,0,1,0,3,0,2,-10,1,DET,BOS,DET,122,,,4,4,2,2
Killian Hayes,G,22023,1630165,22300327,"DEC 15, 2023",DET @ PHI,L,21,1,6,0.167,0,1,0.0,3,4,0.75,1,3,4,2,0,1,3,3,5,-28,1,DET,PHI,DET,92,,,11,9,7,6
Killian Hayes,G,22023,1630165,22300310,"DEC 13, 2023",DET vs. PHI,L,32,3,8,0.375,0,0,0.0,0,0,0.0,0,3,3,6,1,0,1,2,6,1,1,DET,DET,PHI,111,,,15,9,12,9
Killian Hayes,G,22023,1630165,22300293,"DEC 11, 2023",DET vs. IND,L,23,2,4,0.5,0,0,0.0,2,2,1.0,0,1,1,7,1,0,2,0,6,-4,1,DET,DET,IND,123,,,14,7,13,8
Killian Hayes,G,22023,1630165,22301206,"DEC 06, 2023",DET vs. MEM,L,27,5,13,0.385,1,3,0.333,1,1,1.0,2,2,4,4,1,0,3,3,12,-6,1,DET,DET,MEM,102,,,20,16,16,8
Killian Hayes,G,22023,1630165,22300732,"FEB 07, 2024",DET @ SAC,W,28,3,7,0.429,2,4,0.5,0,0,0.0,0,4,4,9,0,0,1,2,8,-1,1,DET,SAC,DET,133,,,21,12,17,13
Killian Hayes,G,22023,1630165,22300558,"JAN 15, 2024",DET @ WAS,W,24,2,4,0.5,0,1,0.0,0,0,0.0,0,1,1,6,0,0,1,1,4,-4,1,DET,WAS,DET,129,,,11,5,10,7
Killian Hayes,G,22023,1630165,22300253,"NOV 27, 2023",DET vs. WAS,L,16,0,1,0.0,0,0,0.0,0,0,0.0,1,3,4,3,0,3,0,1,0,-10,1,DET,DET,WAS,107,,,7,4,3,7
Jae Crowder,F,22023,203109,22300745,"FEB 09, 2024",MIL vs. CHA,W,30,1,7,0.143,1,6,0.167,2,3,0.667,0,2,2,3,0,0,0,1,5,39,1,MIL,MIL,CHA,120,,,10,7,8,5
Jae Crowder,F,22023,203109,22300738,"FEB 08, 2024",MIL vs. MIN,L,37,7,11,0.636,4,5,0.8,3,3,1.0,1,7,8,5,1,0,0,2,21,-15,1,MIL,MIL,MIN,105,,,34,29,26,13
Jae Crowder,F,22023,203109,22300725,"FEB 06, 2024",MIL @ PHX,L,40,4,9,0.444,0,4,0.0,2,2,1.0,0,6,6,3,2,1,1,4,10,-8,1,MIL,PHX,MIL,106,,,19,16,13,9
Jae Crowder,F,22023,203109,22300711,"FEB 04, 2024",MIL @ UTA,L,40,2,10,0.2,2,7,0.286,0,0,0.0,0,2,2,3,1,0,0,2,6,-19,1,MIL,UTA,MIL,108,,,11,8,9,5
Jae Crowder,F,22023,203109,22300702,"FEB 03, 2024",MIL @ DAL,W,21,4,6,0.667,0,1,0.0,0,0,0.0,0,2,2,2,2,0,0,3,8,-18,1,MIL,DAL,MIL,129,,,12,10,10,4
Jae Crowder,F,22023,203109,22300683,"JAN 31, 2024",MIL @ POR,L,19,2,6,0.333,1,5,0.2,1,2,0.5,2,3,5,2,0,1,0,1,6,-11,1,MIL,POR,MIL,116,,,13,11,8,7
Jae Crowder,F,22023,203109,22300667,"JAN 29, 2024",MIL @ DEN,L,19,1,3,0.333,1,3,0.333,0,0,0.0,0,0,0,1,1,0,0,1,3,-9,1,MIL,DEN,MIL,107,,,4,3,4,1
Jae Crowder,F,22023,203109,22300648,"JAN 27, 2024",MIL vs. NOP,W,22,2,5,0.4,1,4,0.25,0,0,0.0,1,3,4,1,0,0,0,3,5,18,1,MIL,MIL,NOP,141,,,10,9,6,5
Jae Crowder,F,22023,203109,22300639,"JAN 26, 2024",MIL vs. CLE,L,22,2,4,0.5,2,4,0.5,0,0,0.0,0,3,3,0,0,0,0,2,6,-5,1,MIL,MIL,CLE,100,,,9,9,6,3
Jae Crowder,F,22023,203109,22300624,"JAN 24, 2024",MIL vs. CLE,W,18,1,2,0.5,1,2,0.5,0,0,0.0,1,2,3,1,0,0,3,2,3,-2,1,MIL,MIL,CLE,126,,,7,6,4,4
Jae Crowder,F,22023,203109,22300606,"JAN 22, 2024",MIL @ DET,W,12,1,6,0.167,1,4,0.25,0,0,0.0,0,2,2,1,0,0,1,1,3,-6,1,MIL,DET,MIL,122,,,6,5,4,3
Jae Crowder,F,22023,203109,22300592,"JAN 20, 2024",MIL @ DET,W,14,1,3,0.333,0,2,0.0,0,0,0.0,0,2,2,0,1,0,0,2,2,-13,1,MIL,DET,MIL,141,,,4,4,2,2
Jae Crowder,F,22023,203109,22300173,"NOV 11, 2023",MIL @ ORL,L,17,0,1,0.0,0,1,0.0,1,2,0.5,0,2,2,0,0,0,0,0,1,-13,1,MIL,ORL,MIL,97,,,3,3,1,2
Jae Crowder,F,22023,203109,22300171,"NOV 09, 2023",MIL @ IND,L,29,2,2,1.0,1,1,1.0,0,0,0.0,0,4,4,1,1,0,0,2,5,-5,1,MIL,IND,MIL,124,,,10,9,6,5
Jae Crowder,F,22023,203109,22300165,"NOV 08, 2023",MIL vs. DET,W,37,3,6,0.5,2,4,0.5,2,3,0.667,0,5,5,2,1,0,0,2,10,-2,1,MIL,MIL,DET,120,,,17,15,12,7
Jae Crowder,F,22023,203109,22300149,"NOV 06, 2023",MIL @ BKN,W,30,5,10,0.5,4,9,0.444,1,2,0.5,2,3,5,0,1,0,2,1,15,-6,1,MIL,BKN,MIL,129,,,20,20,15,5
Jae Crowder,F,22023,203109,22300002,"NOV 03, 2023",MIL vs. NYK,W,24,5,8,0.625,4,6,0.667,0,0,0.0,0,6,6,2,1,0,0,1,14,3,1,MIL,MIL,NYK,110,,,22,20,16,8
Jae Crowder,F,22023,203109,22300116,"NOV 01, 2023",MIL @ TOR,L,25,3,5,0.6,2,3,0.667,1,3,0.333,1,0,1,3,0,1,0,2,9,-5,1,MIL,TOR,MIL,111,,,13,10,12,4
Jae Crowder,F,22023,203109,22300107,"OCT 30, 2023",MIL vs. MIA,W,25,3,7,0.429,2,3,0.667,0,0,0.0,1,4,5,2,1,1,1,2,8,-11,1,MIL,MIL,MIA,122,,,15,13,10,7
Jae Crowder,F,22023,203109,22300097,"OCT 29, 2023",MIL vs. ATL,L,26,1,4,0.25,0,3,0.0,0,0,0.0,0,3,3,3,0,1,0,1,2,-27,1,MIL,MIL,ATL,110,,,8,5,5,6
Jae Crowder,F,22023,203109,22300075,"OCT 26, 2023",MIL vs. PHI,W,27,3,4,0.75,1,1,1.0,2,2,1.0,0,4,4,2,2,0,1,3,9,11,1,MIL,MIL,PHI,118,,,15,13,11,6
Jae Crowder,F,22023,203109,22300572,"JAN 17, 2024",MIL @ CLE,L,19,5,13,0.385,4,10,0.4,1,2,0.5,0,1,1,0,1,0,0,1,15,-3,1,MIL,CLE,MIL,95,,,16,16,15,1
Isaiah Hartenstein,C-F,22023,1628392,22300736,"FEB 08, 2024",NYK vs. DAL,L,15,4,5,0.8,0,0,0.0,2,2,1.0,2,2,4,2,2,0,2,2,10,-10,1,NYK,NYK,DAL,108,,,16,14,12,6
Isaiah Hartenstein,C-F,22023,1628392,22300722,"FEB 06, 2024",NYK vs. MEM,W,35,7,8,0.875,0,0,0.0,3,4,0.75,4,5,9,3,1,3,3,3,17,12,1,NYK,NYK,MEM,121,,,29,26,20,12
Isaiah Hartenstein,C-F,22023,1628392,22300701,"FEB 03, 2024",NYK vs. LAL,L,33,2,9,0.222,0,0,0.0,2,2,1.0,6,9,15,2,0,2,0,5,6,-3,1,NYK,NYK,LAL,105,,,23,21,8,17
Isaiah Hartenstein,C-F,22023,1628392,22300685,"FEB 01, 2024",NYK vs. IND,W,36,6,8,0.75,0,0,0.0,0,1,0.0,8,11,19,6,0,1,1,2,12,9,1,NYK,NYK,IND,109,,,37,31,18,25
Isaiah Hartenstein,C-F,22023,1628392,22300671,"JAN 30, 2024",NYK vs. UTA,W,29,6,10,0.6,0,0,0.0,2,2,1.0,7,5,12,2,2,1,1,4,14,1,1,NYK,NYK,UTA,118,,,28,26,16,14
Isaiah Hartenstein,C-F,22023,1628392,22300657,"JAN 29, 2024",NYK @ CHA,W,16,4,4,1.0,0,0,0.0,2,3,0.667,1,3,4,1,3,0,1,2,10,10,1,NYK,CHA,NYK,113,,,15,14,11,5
Isaiah Hartenstein,C-F,22023,1628392,22300643,"JAN 27, 2024",NYK vs. MIA,W,16,2,2,1.0,0,0,0.0,0,0,0.0,2,4,6,1,0,0,0,2,4,1,1,NYK,NYK,MIA,125,,,11,10,5,7
Isaiah Hartenstein,C-F,22023,1628392,22300596,"JAN 20, 2024",NYK vs. TOR,W,23,0,1,0.0,0,0,0.0,1,2,0.5,0,4,4,1,0,0,0,2,1,13,1,NYK,NYK,TOR,126,,,6,5,2,5
Isaiah Hartenstein,C-F,22023,1628392,22300579,"JAN 18, 2024",NYK vs. WAS,W,39,3,5,0.6,0,0,0.0,0,0,0.0,5,12,17,3,2,1,2,2,6,8,1,NYK,NYK,WAS,113,,,26,23,9,20
Isaiah Hartenstein,C-F,22023,1628392,22300573,"JAN 17, 2024",NYK vs. HOU,W,41,3,5,0.6,0,0,0.0,1,1,1.0,2,9,11,5,2,2,2,4,7,13,1,NYK,NYK,HOU,109,,,23,18,12,16
Isaiah Hartenstein,C-F,22023,1628392,22300557,"JAN 15, 2024",NYK vs. ORL,L,28,3,6,0.5,0,0,0.0,1,1,1.0,5,7,12,3,0,0,2,5,7,0,1,NYK,NYK,ORL,94,,,22,19,10,15
Isaiah Hartenstein,C-F,22023,1628392,22300544,"JAN 13, 2024",NYK @ MEM,W,42,5,6,0.833,0,0,0.0,2,4,0.5,7,13,20,2,2,4,3,1,12,7,1,NYK,MEM,NYK,106,,,34,32,14,22
Isaiah Hartenstein,C-F,22023,1628392,22300530,"JAN 11, 2024",NYK @ DAL,L,32,2,3,0.667,0,0,0.0,4,4,1.0,5,10,15,3,1,0,0,4,8,-7,1,NYK,DAL,NYK,124,,,26,23,11,18
Isaiah Hartenstein,C-F,22023,1628392,22300514,"JAN 09, 2024",NYK vs. POR,W,28,1,1,1.0,0,0,0.0,3,4,0.75,5,9,14,3,3,1,2,3,5,31,1,NYK,NYK,POR,112,,,22,19,8,17
Isaiah Hartenstein,C-F,22023,1628392,22300494,"JAN 06, 2024",NYK @ WAS,W,39,4,8,0.5,0,0,0.0,0,0,0.0,2,17,19,2,4,2,5,3,8,29,1,NYK,WAS,NYK,121,,,29,27,10,21
Isaiah Hartenstein,C-F,22023,1628392,22300483,"JAN 05, 2024",NYK @ PHI,W,35,8,9,0.889,0,0,0.0,1,2,0.5,1,5,6,5,2,2,1,4,17,26,1,NYK,PHI,NYK,128,,,28,23,22,11
Isaiah Hartenstein,C-F,22023,1628392,22300468,"JAN 03, 2024",NYK vs. CHI,W,37,4,6,0.667,0,0,0.0,2,3,0.667,7,13,20,1,0,5,2,2,10,32,1,NYK,NYK,CHI,116,,,31,30,11,21
Isaiah Hartenstein,C-F,22023,1628392,22300451,"JAN 01, 2024",NYK vs. MIN,W,39,2,3,0.667,0,0,0.0,3,4,0.75,4,5,9,3,3,3,1,3,7,10,1,NYK,NYK,MIN,112,,,19,16,10,12
Isaiah Hartenstein,C-F,22023,1628392,22300441,"DEC 30, 2023",NYK @ IND,L,33,1,3,0.333,0,0,0.0,0,0,0.0,2,7,9,6,4,0,1,3,2,-4,1,NYK,IND,NYK,124,,,17,11,8,15
Isaiah Hartenstein,C-F,22023,1628392,22300388,"DEC 23, 2023",NYK vs. MIL,L,33,4,5,0.8,0,0,0.0,4,4,1.0,7,6,13,1,1,0,1,4,12,-14,1,NYK,NYK,MIL,109,,,26,25,13,14
Isaiah Hartenstein,C-F,22023,1628392,22300368,"DEC 20, 2023",NYK @ BKN,W,30,1,3,0.333,0,0,0.0,0,0,0.0,5,5,10,3,0,2,0,1,2,21,1,NYK,BKN,NYK,119,,,15,12,5,13
Isaiah Hartenstein,C-F,22023,1628392,22300343,"DEC 16, 2023",NYK @ LAC,L,30,5,7,0.714,0,0,0.0,2,4,0.5,6,4,10,2,0,3,3,3,12,-9,1,NYK,LAC,NYK,120,,,24,22,14,12
Isaiah Hartenstein,C-F,22023,1628392,22300333,"DEC 15, 2023",NYK @ PHX,W,31,2,2,1.0,0,0,0.0,3,4,0.75,1,7,8,2,1,3,2,3,7,29,1,NYK,PHX,NYK,139,,,17,15,9,10
Isaiah Hartenstein,C-F,22023,1628392,22301201,"DEC 05, 2023",NYK @ MIL,L,18,2,3,0.667,0,0,0.0,0,0,0.0,4,3,7,5,0,2,1,2,4,-12,1,NYK,MIL,NYK,122,,,16,11,9,12
Isaiah Hartenstein,C-F,22023,1628392,22300221,"NOV 20, 2023",NYK @ MIN,L,14,1,3,0.333,0,0,0.0,0,0,0.0,2,2,4,0,0,1,1,3,2,-6,1,NYK,MIN,NYK,100,,,6,6,2,4
Isaiah Hartenstein,C-F,22023,1628392,22300028,"NOV 17, 2023",NYK @ WAS,W,20,1,3,0.333,0,0,0.0,1,2,0.5,3,5,8,2,1,1,1,4,3,4,1,NYK,WAS,NYK,120,,,13,11,5,10
Isaiah Hartenstein,C-F,22023,1628392,22300177,"NOV 12, 2023",NYK vs. CHA,W,18,2,3,0.667,0,0,0.0,2,4,0.5,2,4,6,1,1,2,2,6,6,24,1,NYK,NYK,CHA,129,,,13,12,7,7
Isaiah Hartenstein,C-F,22023,1628392,22300161,"NOV 08, 2023",NYK vs. SAS,W,15,6,9,0.667,0,0,0.0,1,1,1.0,3,0,3,0,2,0,0,4,13,-7,1,NYK,NYK,SAS,126,,,16,16,13,3
Isaiah Hartenstein,C-F,22023,1628392,22300112,"OCT 31, 2023",NYK @ CLE,W,23,5,10,0.5,0,2,0.0,3,3,1.0,4,3,7,1,2,1,1,3,13,12,1,NYK,CLE,NYK,109,,,21,20,14,8
Isaiah Hartenstein,C-F,22023,1628392,22300429,"DEC 29, 2023",NYK @ ORL,L,25,2,4,0.5,0,0,0.0,3,3,1.0,1,2,3,3,3,0,2,4,7,-18,1,NYK,ORL,NYK,106,,,13,10,10,6
Isaiah Hartenstein,C-F,22023,1628392,22300419,"DEC 27, 2023",NYK @ OKC,L,37,2,6,0.333,0,0,0.0,0,0,0.0,3,6,9,2,0,1,2,3,4,4,1,NYK,OKC,NYK,116,,,15,13,6,11
Isaiah Hartenstein,C-F,22023,1628392,22300401,"DEC 25, 2023",NYK vs. MIL,W,33,5,7,0.714,0,0,0.0,1,2,0.5,4,4,8,4,0,1,0,4,11,3,1,NYK,NYK,MIL,129,,,23,19,15,12
Isaiah Hartenstein,C-F,22023,1628392,22300359,"DEC 18, 2023",NYK @ LAL,W,39,3,4,0.75,0,0,0.0,3,6,0.5,7,10,17,2,2,2,1,3,9,15,1,NYK,LAL,NYK,114,,,28,26,11,19
Isaiah Hartenstein,C-F,22023,1628392,22300318,"DEC 13, 2023",NYK @ UTA,L,29,3,4,0.75,0,0,0.0,1,1,1.0,3,3,6,0,0,2,0,3,7,5,1,NYK,UTA,NYK,113,,,13,13,7,6
Isaiah Hartenstein,C-F,22023,1628392,22300297,"DEC 11, 2023",NYK vs. TOR,W,27,4,7,0.571,0,0,0.0,3,4,0.75,5,3,8,2,2,1,2,4,11,0,1,NYK,NYK,TOR,136,,,21,19,13,10
Isaiah Hartenstein,C-F,22023,1628392,22301227,"DEC 08, 2023",NYK @ BOS,L,29,2,4,0.5,0,0,0.0,1,2,0.5,4,12,16,4,0,2,1,4,5,9,1,NYK,BOS,NYK,123,,,25,21,9,20
Isaiah Hartenstein,C-F,22023,1628392,22300276,"DEC 01, 2023",NYK @ TOR,W,16,1,3,0.333,0,0,0.0,2,3,0.667,2,6,8,0,0,1,0,1,4,7,1,NYK,TOR,NYK,119,,,12,12,4,8
Isaiah Hartenstein,C-F,22023,1628392,22300268,"NOV 30, 2023",NYK vs. DET,W,17,1,1,1.0,0,0,0.0,0,0,0.0,2,1,3,0,2,0,2,3,2,-2,1,NYK,NYK,DET,118,,,5,5,2,3
Isaiah Hartenstein,C-F,22023,1628392,22300057,"NOV 28, 2023",NYK vs. CHA,W,14,2,3,0.667,0,0,0.0,0,0,0.0,3,3,6,2,0,0,0,2,4,7,1,NYK,NYK,CHA,115,,,12,10,6,8
Isaiah Hartenstein,C-F,22023,1628392,22300247,"NOV 26, 2023",NYK vs. PHX,L,14,2,3,0.667,0,0,0.0,3,4,0.75,4,1,5,1,0,1,0,3,7,-2,1,NYK,NYK,PHX,113,,,13,12,8,6
Isaiah Hartenstein,C-F,22023,1628392,22300045,"NOV 24, 2023",NYK vs. MIA,W,28,1,3,0.333,0,0,0.0,0,0,0.0,1,4,5,1,2,1,1,3,2,18,1,NYK,NYK,MIA,100,,,8,7,3,6
Isaiah Hartenstein,C-F,22023,1628392,22300202,"NOV 18, 2023",NYK @ CHA,W,15,1,2,0.5,0,0,0.0,2,2,1.0,2,5,7,0,0,0,1,1,4,5,1,NYK,CHA,NYK,122,,,11,11,4,7
Isaiah Hartenstein,C-F,22023,1628392,22300151,"NOV 06, 2023",NYK vs. LAC,W,13,3,5,0.6,0,0,0.0,0,0,0.0,2,1,3,2,2,0,0,2,6,10,1,NYK,NYK,LAC,111,,,11,9,8,5
Isaiah Hartenstein,C-F,22023,1628392,22300090,"OCT 28, 2023",NYK @ NOP,L,15,1,1,1.0,0,0,0.0,2,4,0.5,1,2,3,1,0,0,0,0,4,-8,1,NYK,NOP,NYK,87,,,8,7,5,4
Isaiah Hartenstein,C-F,22023,1628392,22300079,"OCT 27, 2023",NYK @ ATL,W,10,3,4,0.75,0,0,0.0,2,4,0.5,1,1,2,1,1,1,1,4,8,-5,1,NYK,ATL,NYK,126,,,11,10,9,3
Isaiah Hartenstein,C-F,22023,1628392,22300065,"OCT 25, 2023",NYK vs. BOS,L,26,3,4,0.75,0,0,0.0,1,2,0.5,5,3,8,2,0,0,1,5,7,-5,1,NYK,NYK,BOS,104,,,17,15,9,10
Isaiah Hartenstein,C-F,22023,1628392,22300193,"NOV 15, 2023",NYK @ ATL,W,17,5,9,0.556,0,0,0.0,1,1,1.0,3,1,4,0,1,0,0,2,11,-5,1,NYK,ATL,NYK,116,,,15,15,11,4
Isaiah Hartenstein,C-F,22023,1628392,22300188,"NOV 13, 2023",NYK @ BOS,L,15,1,2,0.5,1,1,1.0,0,0,0.0,3,0,3,1,1,0,0,0,3,-2,1,NYK,BOS,NYK,98,,,7,6,4,4
Isaiah Hartenstein,C-F,22023,1628392,22300002,"NOV 03, 2023",NYK @ MIL,L,18,2,3,0.667,0,0,0.0,0,0,0.0,1,2,3,0,0,0,2,3,4,-1,1,NYK,MIL,NYK,105,,,7,7,4,3
Isaiah Hartenstein,C-F,22023,1628392,22300120,"NOV 01, 2023",NYK vs. CLE,L,16,0,2,0.0,0,0,0.0,0,0,0.0,2,4,6,2,3,0,2,2,0,-5,1,NYK,NYK,CLE,89,,,8,6,2,8
Robert Williams III,C-F,22023,1629057,22300144,"NOV 05, 2023",POR vs. MEM,L,11,2,3,0.667,0,0,0.0,1,1,1.0,2,1,3,0,0,0,1,4,5,4,1,POR,POR,MEM,100,,,8,8,5,3
Robert Williams III,C-F,22023,1629057,22300007,"NOV 03, 2023",POR vs. MEM,W,20,3,4,0.75,0,0,0.0,2,3,0.667,4,6,10,0,2,1,1,1,8,-5,1,POR,POR,MEM,115,,,18,18,8,10
Robert Williams III,C-F,22023,1629057,22300115,"NOV 01, 2023",POR @ DET,W,19,2,4,0.5,0,0,0.0,2,2,1.0,0,8,8,1,0,3,1,4,6,10,1,POR,DET,POR,110,,,15,14,7,9
Robert Williams III,C-F,22023,1629057,22300098,"OCT 29, 2023",POR @ PHI,L,26,2,3,0.667,0,0,0.0,2,2,1.0,2,5,7,2,2,2,1,2,6,-6,1,POR,PHI,POR,98,,,15,13,8,9
Robert Williams III,C-F,22023,1629057,22300086,"OCT 27, 2023",POR vs. ORL,L,20,3,5,0.6,0,0,0.0,0,0,0.0,1,2,3,2,0,0,1,2,6,-10,1,POR,POR,ORL,97,,,11,9,8,5
Robert Williams III,C-F,22023,1629057,22300074,"OCT 25, 2023",POR @ LAC,L,23,5,7,0.714,0,0,0.0,0,1,0.0,2,5,7,0,3,1,2,4,10,-23,1,POR,LAC,POR,111,,,17,17,10,7
Isaiah Jackson,F,22023,1630543,22300550,"JAN 14, 2024",IND @ DEN,L,20,6,9,0.667,0,0,0.0,0,0,0.0,3,4,7,1,2,0,2,3,12,-3,1,IND,DEN,IND,109,,,20,19,13,8
Isaiah Jackson,F,22023,1630543,22300533,"JAN 12, 2024",IND @ ATL,W,18,6,7,0.857,0,0,0.0,0,0,0.0,1,4,5,2,4,3,2,3,12,11,1,IND,ATL,IND,126,,,19,17,14,7
Isaiah Jackson,F,22023,1630543,22300520,"JAN 10, 2024",IND vs. WAS,W,17,4,4,1.0,0,0,0.0,4,6,0.667,2,1,3,1,1,3,2,3,12,4,1,IND,IND,WAS,112,,,16,15,13,4
Isaiah Jackson,F,22023,1630543,22300507,"JAN 08, 2024",IND vs. BOS,W,7,0,0,0.0,0,0,0.0,0,0,0.0,1,1,2,0,0,2,0,1,0,-2,1,IND,IND,BOS,133,,,2,2,0,2
Isaiah Jackson,F,22023,1630543,22300480,"JAN 05, 2024",IND vs. ATL,W,7,1,2,0.5,0,0,0.0,0,2,0.0,1,2,3,0,0,0,1,3,2,12,1,IND,IND,ATL,148,,,5,5,2,3
Isaiah Jackson,F,22023,1630543,22300466,"JAN 03, 2024",IND vs. MIL,W,18,4,6,0.667,0,0,0.0,1,1,1.0,2,2,4,3,1,0,1,3,9,-3,1,IND,IND,MIL,142,,,16,13,12,7
Isaiah Jackson,F,22023,1630543,22300377,"DEC 21, 2023",IND @ MEM,L,12,1,2,0.5,0,0,0.0,0,0,0.0,1,2,3,0,0,1,0,2,2,-11,1,IND,MEM,IND,103,,,5,5,2,3
Isaiah Jackson,F,22023,1630543,22300365,"DEC 20, 2023",IND vs. CHA,W,15,4,7,0.571,0,1,0.0,2,3,0.667,1,2,3,1,1,2,1,3,10,9,1,IND,IND,CHA,142,,,14,13,11,4
Isaiah Jackson,F,22023,1630543,22300350,"DEC 18, 2023",IND vs. LAC,L,25,6,9,0.667,0,0,0.0,3,5,0.6,2,2,4,2,0,1,0,1,15,-21,1,IND,IND,LAC,127,,,21,19,17,6
Isaiah Jackson,F,22023,1630543,22300338,"DEC 16, 2023",IND @ MIN,L,20,6,6,1.0,0,0,0.0,0,0,0.0,1,2,3,4,3,2,1,3,12,-11,1,IND,MIN,IND,109,,,19,15,16,7
Isaiah Jackson,F,22023,1630543,22300328,"DEC 15, 2023",IND @ WAS,L,20,10,13,0.769,0,0,0.0,0,0,0.0,6,7,13,1,0,1,1,5,20,0,1,IND,WAS,IND,123,,,34,33,21,14
Isaiah Jackson,F,22023,1630543,22300315,"DEC 13, 2023",IND @ MIL,L,13,3,4,0.75,0,0,0.0,3,4,0.75,0,3,3,1,1,2,1,3,9,-4,1,IND,MIL,IND,126,,,13,12,10,4
Isaiah Jackson,F,22023,1630543,22300293,"DEC 11, 2023",IND @ DET,W,17,5,6,0.833,0,0,0.0,0,0,0.0,2,3,5,0,0,0,0,3,10,-4,1,IND,DET,IND,131,,,15,15,10,5
Isaiah Jackson,F,22023,1630543,22301229,"DEC 07, 2023",IND @ MIL,W,16,5,7,0.714,0,0,0.0,1,1,1.0,1,5,6,0,1,0,1,1,11,14,1,IND,MIL,IND,128,,,17,17,11,6
Isaiah Jackson,F,22023,1630543,22300284,"DEC 02, 2023",IND @ MIA,W,8,3,3,1.0,0,0,0.0,2,2,1.0,0,3,3,1,0,1,0,1,8,-6,1,IND,MIA,IND,144,,,12,11,9,4
Isaiah Jackson,F,22023,1630543,22300267,"NOV 30, 2023",IND @ MIA,L,6,0,0,0.0,0,0,0.0,0,0,0.0,0,1,1,1,1,0,0,3,0,-2,1,IND,MIA,IND,132,,,2,1,1,2
Isaiah Jackson,F,22023,1630543,22300254,"NOV 27, 2023",IND vs. POR,L,10,1,2,0.5,0,0,0.0,0,0,0.0,1,4,5,1,0,1,1,3,2,1,1,IND,IND,POR,110,,,8,7,3,6
Isaiah Jackson,F,22023,1630543,22300047,"NOV 24, 2023",IND vs. DET,W,19,3,8,0.375,0,1,0.0,2,2,1.0,4,2,6,1,0,3,1,4,8,5,1,IND,IND,DET,136,,,15,14,9,7
Isaiah Jackson,F,22023,1630543,22300039,"NOV 21, 2023",IND @ ATL,W,12,1,1,1.0,0,0,0.0,0,0,0.0,1,4,5,1,0,4,1,5,2,8,1,IND,ATL,IND,157,,,8,7,3,6
Isaiah Jackson,F,22023,1630543,22300209,"NOV 19, 2023",IND vs. ORL,L,12,1,2,0.5,0,0,0.0,4,6,0.667,1,2,3,1,3,1,0,2,6,17,1,IND,IND,ORL,116,,,10,9,7,4
Isaiah Jackson,F,22023,1630543,22300019,"NOV 14, 2023",IND @ PHI,W,17,1,4,0.25,0,0,0.0,5,8,0.625,5,4,9,2,0,1,1,4,7,-2,1,IND,PHI,IND,132,,,18,16,9,11
Isaiah Jackson,F,22023,1630543,22300171,"NOV 09, 2023",IND vs. MIL,W,11,1,2,0.5,0,0,0.0,1,2,0.5,1,2,3,0,1,2,0,3,3,-12,1,IND,IND,MIL,126,,,6,6,3,3
Isaiah Jackson,F,22023,1630543,22300146,"NOV 06, 2023",IND vs. SAS,W,15,3,3,1.0,0,0,0.0,1,1,1.0,2,1,3,1,0,2,0,5,7,12,1,IND,IND,SAS,152,,,11,10,8,4
Isaiah Jackson,F,22023,1630543,22300118,"NOV 01, 2023",IND @ BOS,L,19,3,5,0.6,0,0,0.0,1,2,0.5,0,3,3,1,0,4,1,1,7,-18,1,IND,BOS,IND,104,,,11,10,8,4
Isaiah Jackson,F,22023,1630543,22300064,"OCT 25, 2023",IND vs. WAS,W,11,2,4,0.5,0,0,0.0,0,0,0.0,1,3,4,0,0,0,0,2,4,3,1,IND,IND,WAS,143,,,8,8,4,4
Isaiah Jackson,F,22023,1630543,22300707,"FEB 04, 2024",IND @ CHA,W,2,1,1,1.0,0,0,0.0,0,0,0.0,1,1,2,1,0,0,0,0,2,0,1,IND,CHA,IND,115,,,5,4,3,3
Isaiah Jackson,F,22023,1630543,22300627,"JAN 25, 2024",IND vs. PHI,W,5,0,1,0.0,0,0,0.0,0,0,0.0,0,0,0,0,0,2,1,1,0,-1,1,IND,IND,PHI,134,,,0,0,0,0
Isaiah Jackson,F,22023,1630543,22300564,"JAN 15, 2024",IND @ UTA,L,8,0,2,0.0,0,0,0.0,1,2,0.5,1,3,4,1,0,1,1,4,1,-5,1,IND,UTA,IND,105,,,6,5,2,5
Isaiah Jackson,F,22023,1630543,22300493,"JAN 06, 2024",IND vs. BOS,L,9,2,3,0.667,0,0,0.0,0,0,0.0,1,2,3,0,0,0,0,4,4,-8,1,IND,IND,BOS,101,,,7,7,4,3
Isaiah Jackson,F,22023,1630543,22300755,"FEB 10, 2024",IND @ NYK,W,17,5,6,0.833,0,0,0.0,2,2,1.0,3,5,8,1,0,1,3,6,12,9,1,IND,NYK,IND,125,,,21,20,13,9
Isaiah Jackson,F,22023,1630543,22300733,"FEB 08, 2024",IND vs. GSW,L,11,1,2,0.5,0,0,0.0,2,2,1.0,1,2,3,2,1,0,0,1,4,-12,1,IND,IND,GSW,109,,,9,7,6,5
Isaiah Jackson,F,22023,1630543,22300719,"FEB 06, 2024",IND vs. HOU,W,2,2,2,1.0,0,0,0.0,0,0,0.0,0,0,0,0,0,0,0,0,4,2,1,IND,IND,HOU,132,,,4,4,4,0
Isaiah Jackson,F,22023,1630543,22300691,"FEB 02, 2024",IND vs. SAC,L,27,3,8,0.375,0,0,0.0,4,4,1.0,2,6,8,2,2,0,2,3,10,-15,1,IND,IND,SAC,122,,,20,18,12,10
Isaiah Jackson,F,22023,1630543,22300454,"JAN 01, 2024",IND @ MIL,W,20,6,9,0.667,0,0,0.0,6,7,0.857,2,7,9,1,1,0,2,5,18,29,1,IND,MIL,IND,122,,,28,27,19,10
Isaiah Jackson,F,22023,1630543,22300441,"DEC 30, 2023",IND vs. NYK,W,9,1,1,1.0,0,0,0.0,0,0,0.0,0,1,1,0,0,1,1,2,2,-2,1,IND,IND,NYK,140,,,3,3,2,1
Isaiah Jackson,F,22023,1630543,22300422,"DEC 28, 2023",IND @ CHI,W,11,1,1,1.0,0,0,0.0,1,3,0.333,0,0,0,1,1,0,1,0,3,-5,1,IND,CHI,IND,120,,,4,3,4,1
Isaiah Jackson,F,22023,1630543,22300409,"DEC 26, 2023",IND @ HOU,W,20,3,3,1.0,0,0,0.0,5,5,1.0,3,5,8,0,1,3,1,3,11,3,1,IND,HOU,IND,123,,,19,19,11,8
Isaiah Jackson,F,22023,1630543,22300391,"DEC 23, 2023",IND vs. ORL,L,6,0,2,0.0,0,0,0.0,0,0,0.0,2,1,3,0,0,0,0,4,0,-8,1,IND,IND,ORL,110,,,3,3,0,3
Isaiah Jackson,F,22023,1630543,22300652,"JAN 28, 2024",IND vs. MEM,W,14,4,6,0.667,0,1,0.0,2,2,1.0,5,2,7,1,0,1,0,4,10,0,1,IND,IND,MEM,116,,,18,17,11,8
Isaiah Jackson,F,22023,1630543,22300614,"JAN 23, 2024",IND vs. DEN,L,9,1,3,0.333,0,0,0.0,1,2,0.5,0,2,2,0,0,0,0,1,3,0,1,IND,IND,DEN,109,,,5,5,3,2
Isaiah Jackson,F,22023,1630543,22300583,"JAN 18, 2024",IND @ SAC,W,5,1,2,0.5,0,0,0.0,0,0,0.0,1,0,1,1,0,0,0,1,2,2,1,IND,SAC,IND,126,,,4,3,3,2
Jose Alvarado,G,22023,1630631,22300758,"FEB 10, 2024",NOP @ POR,W,20,1,3,0.333,0,1,0.0,0,0,0.0,0,2,2,2,3,1,1,0,2,-10,1,NOP,POR,NOP,93,,,6,4,4,4
Jose Alvarado,G,22023,1630631,22300747,"FEB 09, 2024",NOP @ LAL,L,21,3,9,0.333,1,5,0.2,0,0,0.0,1,2,3,2,0,0,0,2,7,-1,1,NOP,LAL,NOP,122,,,12,10,9,5
Jose Alvarado,G,22023,1630631,22300731,"FEB 07, 2024",NOP @ LAC,W,13,3,4,0.75,1,2,0.5,0,0,0.0,1,0,1,0,0,0,0,0,7,6,1,NOP,LAC,NOP,117,,,8,8,7,1
Jose Alvarado,G,22023,1630631,22300718,"FEB 05, 2024",NOP vs. TOR,W,25,5,11,0.455,1,7,0.143,0,0,0.0,0,4,4,4,3,0,1,0,11,23,1,NOP,NOP,TOR,138,,,19,15,15,8
Jose Alvarado,G,22023,1630631,22300696,"FEB 02, 2024",NOP @ SAS,W,19,3,7,0.429,2,5,0.4,0,0,0.0,0,2,2,3,2,0,0,3,8,9,1,NOP,SAS,NOP,114,,,13,10,11,5
Jose Alvarado,G,22023,1630631,22300679,"JAN 31, 2024",NOP @ HOU,W,14,2,3,0.667,2,3,0.667,1,2,0.5,0,1,1,0,0,0,0,3,7,7,1,NOP,HOU,NOP,110,,,8,8,7,1
Jose Alvarado,G,22023,1630631,22300648,"JAN 27, 2024",NOP @ MIL,L,21,1,2,0.5,0,0,0.0,2,2,1.0,0,1,1,2,2,0,0,4,4,0,1,NOP,MIL,NOP,117,,,7,5,6,3
Jose Alvarado,G,22023,1630631,22300640,"JAN 26, 2024",NOP vs. OKC,L,12,2,7,0.286,1,6,0.167,0,0,0.0,0,2,2,3,2,0,1,0,5,-3,1,NOP,NOP,OKC,83,,,10,7,8,5
Jose Alvarado,G,22023,1630631,22300616,"JAN 23, 2024",NOP vs. UTA,W,5,3,5,0.6,3,4,0.75,0,0,0.0,0,2,2,0,0,0,1,0,9,3,1,NOP,NOP,UTA,153,,,11,11,9,2
Jose Alvarado,G,22023,1630631,22300588,"JAN 19, 2024",NOP vs. PHX,L,7,1,4,0.25,0,3,0.0,0,0,0.0,0,0,0,1,0,0,0,1,2,11,1,NOP,NOP,PHX,109,,,3,2,3,1
Jose Alvarado,G,22023,1630631,22300575,"JAN 17, 2024",NOP vs. CHA,W,3,0,0,0.0,0,0,0.0,2,2,1.0,0,0,0,0,0,0,0,2,2,-2,1,NOP,NOP,CHA,132,,,2,2,2,0
Jose Alvarado,G,22023,1630631,22300547,"JAN 13, 2024",NOP @ DAL,W,26,5,12,0.417,3,8,0.375,1,2,0.5,0,2,2,4,1,0,0,2,14,8,1,NOP,DAL,NOP,118,,,20,16,18,6
Jose Alvarado,G,22023,1630631,22300539,"JAN 12, 2024",NOP @ DEN,L,17,3,7,0.429,2,3,0.667,2,2,1.0,1,0,1,1,1,0,1,0,10,-2,1,NOP,DEN,NOP,113,,,12,11,11,2
Jose Alvarado,G,22023,1630631,22300486,"JAN 05, 2024",NOP vs. LAC,L,19,1,7,0.143,0,2,0.0,0,0,0.0,0,1,1,2,0,1,0,0,2,-9,1,NOP,NOP,LAC,95,,,5,3,4,3
Jose Alvarado,G,22023,1630631,22300471,"JAN 03, 2024",NOP @ MIN,W,27,3,8,0.375,2,6,0.333,0,0,0.0,1,2,3,3,0,1,1,3,8,2,1,NOP,MIN,NOP,117,,,14,11,11,6
Jose Alvarado,G,22023,1630631,22300461,"JAN 02, 2024",NOP vs. BKN,W,22,4,9,0.444,3,6,0.5,2,3,0.667,1,2,3,2,2,0,1,2,13,16,1,NOP,NOP,BKN,112,,,18,16,15,5
Jose Alvarado,G,22023,1630631,22300446,"DEC 31, 2023",NOP vs. LAL,W,20,3,8,0.375,2,5,0.4,0,0,0.0,0,3,3,1,4,2,1,1,8,8,1,NOP,NOP,LAL,129,,,12,11,9,4
Jose Alvarado,G,22023,1630631,22300424,"DEC 28, 2023",NOP vs. UTA,W,12,3,4,0.75,1,2,0.5,0,0,0.0,0,0,0,0,0,0,1,2,7,1,1,NOP,NOP,UTA,112,,,7,7,7,0
Jose Alvarado,G,22023,1630631,22300410,"DEC 26, 2023",NOP vs. MEM,L,12,3,8,0.375,1,4,0.25,1,2,0.5,1,2,3,2,1,0,0,0,8,10,1,NOP,NOP,MEM,115,,,13,11,10,5
Jose Alvarado,G,22023,1630631,22300392,"DEC 23, 2023",NOP vs. HOU,L,10,2,4,0.5,0,2,0.0,0,0,0.0,0,2,2,0,0,1,1,3,4,2,1,NOP,NOP,HOU,104,,,6,6,4,2
Jose Alvarado,G,22023,1630631,22300375,"DEC 21, 2023",NOP @ CLE,W,18,1,1,1.0,0,0,0.0,0,0,0.0,1,1,2,3,0,0,0,2,2,16,1,NOP,CLE,NOP,123,,,7,4,5,5
Jose Alvarado,G,22023,1630631,22300360,"DEC 19, 2023",NOP vs. MEM,L,8,1,4,0.25,0,2,0.0,0,0,0.0,1,1,2,0,0,0,0,1,2,-9,1,NOP,NOP,MEM,113,,,4,4,2,2
Jose Alvarado,G,22023,1630631,22300345,"DEC 17, 2023",NOP @ SAS,W,22,5,7,0.714,3,5,0.6,3,4,0.75,0,3,3,4,1,0,1,0,16,15,1,NOP,SAS,NOP,146,,,23,19,20,7
Jose Alvarado,G,22023,1630631,22300326,"DEC 15, 2023",NOP @ CHA,W,21,1,6,0.167,1,3,0.333,5,6,0.833,1,7,8,1,1,1,1,3,8,9,1,NOP,CHA,NOP,112,,,17,16,9,9
Jose Alvarado,G,22023,1630631,22300311,"DEC 13, 2023",NOP @ WAS,W,18,2,3,0.667,2,3,0.667,1,2,0.5,0,2,2,1,2,0,2,2,7,15,1,NOP,WAS,NOP,142,,,10,9,8,3
Jose Alvarado,G,22023,1630631,22300301,"DEC 11, 2023",NOP vs. MIN,W,15,0,5,0.0,0,3,0.0,0,0,0.0,1,1,2,3,1,1,1,3,0,-11,1,NOP,NOP,MIN,121,,,5,2,3,5
Jose Alvarado,G,22023,1630631,22301230,"DEC 07, 2023",NOP @ LAL,L,20,3,7,0.429,2,3,0.667,0,0,0.0,0,2,2,4,2,0,1,1,8,-13,1,NOP,LAL,NOP,89,,,14,10,12,6
Jose Alvarado,G,22023,1630631,22301204,"DEC 04, 2023",NOP @ SAC,W,18,3,4,0.75,2,3,0.667,1,2,0.5,0,3,3,2,2,2,1,1,9,19,1,NOP,SAC,NOP,127,,,14,12,11,5
Jose Alvarado,G,22023,1630631,22300285,"DEC 02, 2023",NOP @ CHI,L,18,3,8,0.375,2,5,0.4,0,0,0.0,0,1,1,2,0,0,1,0,8,-7,1,NOP,CHI,NOP,118,,,11,9,10,3
Jose Alvarado,G,22023,1630631,22300262,"NOV 29, 2023",NOP vs. PHI,W,9,2,5,0.4,1,2,0.5,0,0,0.0,2,0,2,1,1,0,2,1,5,-12,1,NOP,NOP,PHI,124,,,8,7,6,3
Jose Alvarado,G,22023,1630631,22300256,"NOV 27, 2023",NOP @ UTA,L,14,2,3,0.667,0,0,0.0,0,0,0.0,0,1,1,2,0,0,0,2,4,3,1,NOP,UTA,NOP,112,,,7,5,6,3
Jose Alvarado,G,22023,1630631,22300243,"NOV 25, 2023",NOP @ UTA,L,23,5,11,0.455,3,6,0.5,0,0,0.0,1,3,4,3,2,1,0,4,13,11,1,NOP,UTA,NOP,100,,,20,17,16,7
Jose Alvarado,G,22023,1630631,22300052,"NOV 24, 2023",NOP @ LAC,W,16,1,6,0.167,0,2,0.0,2,2,1.0,1,4,5,1,1,0,1,0,4,-12,1,NOP,LAC,NOP,116,,,10,9,5,6
Jose Alvarado,G,22023,1630631,22300233,"NOV 22, 2023",NOP vs. SAC,W,19,4,9,0.444,2,6,0.333,0,4,0.0,0,1,1,2,3,0,1,2,10,9,1,NOP,NOP,SAC,117,,,13,11,12,3
Jose Alvarado,G,22023,1630631,22300222,"NOV 20, 2023",NOP vs. SAC,W,15,2,5,0.4,1,3,0.333,0,0,0.0,0,0,0,3,0,0,2,0,5,8,1,NOP,NOP,SAC,129,,,8,5,8,3
Peyton Watson,G,22023,1631212,22300746,"FEB 09, 2024",DEN @ SAC,L,20,2,4,0.5,0,1,0.0,0,0,0.0,1,2,3,1,1,3,4,3,4,-10,1,DEN,SAC,DEN,106,,,8,7,5,4
Peyton Watson,G,22023,1631212,22300740,"FEB 08, 2024",DEN @ LAL,W,25,2,6,0.333,1,3,0.333,0,0,0.0,1,3,4,2,0,0,1,2,5,-3,1,DEN,LAL,DEN,114,,,11,9,7,6
Peyton Watson,G,22023,1631212,22300712,"FEB 04, 2024",DEN vs. POR,W,30,5,6,0.833,2,3,0.667,0,0,0.0,3,3,6,1,2,1,1,1,12,15,1,DEN,DEN,POR,112,,,19,18,13,7
Peyton Watson,G,22023,1631212,22300697,"FEB 02, 2024",DEN vs. POR,W,22,6,8,0.75,2,2,1.0,0,0,0.0,1,4,5,0,0,1,0,4,14,0,1,DEN,DEN,POR,120,,,19,19,14,5
Peyton Watson,G,22023,1631212,22300682,"JAN 31, 2024",DEN @ OKC,L,21,3,10,0.3,1,4,0.25,2,2,1.0,2,2,4,1,2,1,2,4,9,13,1,DEN,OKC,DEN,100,,,14,13,10,5
Peyton Watson,G,22023,1631212,22300667,"JAN 29, 2024",DEN vs. MIL,W,23,3,4,0.75,0,0,0.0,0,0,0.0,0,4,4,2,1,0,0,3,6,14,1,DEN,DEN,MIL,113,,,12,10,8,6
Peyton Watson,G,22023,1631212,22300644,"JAN 27, 2024",DEN vs. PHI,W,21,3,7,0.429,0,3,0.0,3,6,0.5,0,3,3,3,1,1,0,1,9,-6,1,DEN,DEN,PHI,111,,,15,12,12,6
Peyton Watson,G,22023,1631212,22300631,"JAN 25, 2024",DEN @ NYK,L,23,3,8,0.375,0,4,0.0,1,2,0.5,1,3,4,3,0,2,2,2,7,-12,1,DEN,NYK,DEN,84,,,14,11,10,7
Peyton Watson,G,22023,1631212,22300614,"JAN 23, 2024",DEN @ IND,W,19,2,4,0.5,1,2,0.5,2,2,1.0,0,2,2,0,1,2,2,1,7,-3,1,DEN,IND,DEN,114,,,9,9,7,2
Peyton Watson,G,22023,1631212,22300602,"JAN 21, 2024",DEN @ WAS,W,13,1,2,0.5,0,0,0.0,0,1,0.0,0,3,3,2,0,3,2,0,2,-2,1,DEN,WAS,DEN,113,,,7,5,4,5
Peyton Watson,G,22023,1631212,22300586,"JAN 19, 2024",DEN @ BOS,W,21,4,11,0.364,1,6,0.167,0,0,0.0,0,2,2,0,0,2,0,2,9,7,1,DEN,BOS,DEN,102,,,11,11,9,2
Peyton Watson,G,22023,1631212,22300566,"JAN 16, 2024",DEN @ PHI,L,11,1,4,0.25,1,2,0.5,2,2,1.0,1,0,1,2,0,0,0,0,5,-8,1,DEN,PHI,DEN,121,,,8,6,7,3
Peyton Watson,G,22023,1631212,22300550,"JAN 14, 2024",DEN vs. IND,W,14,0,3,0.0,0,0,0.0,0,0,0.0,0,3,3,0,1,0,0,3,0,-1,1,DEN,DEN,IND,117,,,3,3,0,3
Peyton Watson,G,22023,1631212,22300539,"JAN 12, 2024",DEN vs. NOP,W,15,3,7,0.429,2,4,0.5,0,0,0.0,1,2,3,0,1,1,0,1,8,9,1,DEN,DEN,NOP,125,,,11,11,8,3
Peyton Watson,G,22023,1631212,22300524,"JAN 10, 2024",DEN @ UTA,L,17,1,8,0.125,1,5,0.2,0,0,0.0,1,1,2,0,0,0,0,1,3,-12,1,DEN,UTA,DEN,111,,,5,5,3,2
Peyton Watson,G,22023,1631212,22300502,"JAN 07, 2024",DEN vs. DET,W,23,4,10,0.4,2,4,0.5,5,5,1.0,1,5,6,1,1,1,0,0,15,7,1,DEN,DEN,DET,131,,,22,21,16,7
Peyton Watson,G,22023,1631212,22300488,"JAN 05, 2024",DEN vs. ORL,L,13,2,6,0.333,0,2,0.0,0,0,0.0,1,0,1,0,0,0,0,4,4,-16,1,DEN,DEN,ORL,120,,,5,5,4,1
Peyton Watson,G,22023,1631212,22300478,"JAN 04, 2024",DEN @ GSW,W,19,6,10,0.6,2,4,0.5,5,6,0.833,1,4,5,0,0,0,0,1,19,7,1,DEN,GSW,DEN,130,,,24,24,19,5
Peyton Watson,G,22023,1631212,22300455,"JAN 01, 2024",DEN vs. CHA,W,19,3,6,0.5,2,4,0.5,0,0,0.0,0,4,4,1,1,1,0,2,8,-5,1,DEN,DEN,CHA,111,,,13,12,9,5
Peyton Watson,G,22023,1631212,22300435,"DEC 29, 2023",DEN vs. OKC,L,32,6,12,0.5,1,6,0.167,1,2,0.5,0,2,2,2,1,2,1,4,14,-7,1,DEN,DEN,OKC,93,,,18,16,16,4
Peyton Watson,G,22023,1631212,22300425,"DEC 28, 2023",DEN vs. MEM,W,23,6,14,0.429,4,10,0.4,4,4,1.0,0,5,5,2,0,0,0,1,20,28,1,DEN,DEN,MEM,142,,,27,25,22,7
Peyton Watson,G,22023,1631212,22300402,"DEC 25, 2023",DEN vs. GSW,W,21,2,5,0.4,1,2,0.5,0,0,0.0,0,0,0,1,0,0,2,2,5,-11,1,DEN,DEN,GSW,120,,,6,5,6,1
Peyton Watson,G,22023,1631212,22300390,"DEC 23, 2023",DEN @ CHA,W,17,1,2,0.5,0,1,0.0,0,0,0.0,0,3,3,0,1,1,1,2,2,-3,1,DEN,CHA,DEN,102,,,5,5,2,3
Peyton Watson,G,22023,1631212,22300383,"DEC 22, 2023",DEN @ BKN,W,20,4,5,0.8,1,2,0.5,0,1,0.0,0,3,3,0,0,0,0,2,9,-14,1,DEN,BKN,DEN,122,,,12,12,9,3
Peyton Watson,G,22023,1631212,22300369,"DEC 20, 2023",DEN @ TOR,W,18,5,6,0.833,1,1,1.0,0,0,0.0,1,3,4,1,1,1,0,1,11,-5,1,DEN,TOR,DEN,113,,,16,15,12,5
Peyton Watson,G,22023,1631212,22300356,"DEC 18, 2023",DEN vs. DAL,W,24,3,5,0.6,2,3,0.667,2,4,0.5,1,6,7,3,1,1,0,1,10,8,1,DEN,DEN,DAL,130,,,20,17,13,10
Peyton Watson,G,22023,1631212,22300340,"DEC 16, 2023",DEN vs. OKC,L,16,5,8,0.625,2,2,1.0,1,2,0.5,1,3,4,0,0,0,1,5,13,3,1,DEN,DEN,OKC,117,,,17,17,13,4
Peyton Watson,G,22023,1631212,22300322,"DEC 14, 2023",DEN vs. BKN,W,24,7,10,0.7,2,5,0.4,2,3,0.667,3,4,7,5,1,1,1,3,18,7,1,DEN,DEN,BKN,124,,,30,25,23,12
Peyton Watson,G,22023,1631212,22300307,"DEC 12, 2023",DEN @ CHI,W,23,1,6,0.167,0,0,0.0,2,2,1.0,1,0,1,1,1,1,1,1,4,7,1,DEN,CHI,DEN,114,,,6,5,5,2
Peyton Watson,G,22023,1631212,22300296,"DEC 11, 2023",DEN @ ATL,W,20,1,2,0.5,0,0,0.0,1,2,0.5,1,1,2,0,0,1,0,2,3,-7,1,DEN,ATL,DEN,129,,,5,5,3,2
Peyton Watson,G,22023,1631212,22301224,"DEC 08, 2023",DEN vs. HOU,L,26,4,9,0.444,0,1,0.0,5,5,1.0,1,3,4,2,0,0,1,3,13,4,1,DEN,DEN,HOU,106,,,19,17,15,6
Peyton Watson,G,22023,1631212,22301215,"DEC 06, 2023",DEN @ LAC,L,16,0,3,0.0,0,2,0.0,2,2,1.0,0,3,3,3,1,1,1,1,2,-15,1,DEN,LAC,DEN,102,,,8,5,5,6
Peyton Watson,G,22023,1631212,22300290,"DEC 02, 2023",DEN @ SAC,L,14,1,1,1.0,0,0,0.0,2,2,1.0,0,1,1,1,1,2,0,2,4,8,1,DEN,SAC,DEN,117,,,6,5,5,2
Peyton Watson,G,22023,1631212,22300279,"DEC 01, 2023",DEN @ PHX,W,25,4,9,0.444,0,2,0.0,0,0,0.0,0,3,3,0,0,0,0,5,8,5,1,DEN,PHX,DEN,119,,,11,11,8,3
Peyton Watson,G,22023,1631212,22300257,"NOV 27, 2023",DEN @ LAC,W,24,4,7,0.571,0,0,0.0,0,2,0.0,0,3,3,1,2,1,1,0,8,2,1,DEN,LAC,DEN,113,,,12,11,9,4
Peyton Watson,G,22023,1631212,22300252,"NOV 26, 2023",DEN vs. SAS,W,22,2,6,0.333,0,2,0.0,0,0,0.0,1,3,4,2,1,2,1,1,4,5,1,DEN,DEN,SAS,132,,,10,8,6,6
Peyton Watson,G,22023,1631212,22300048,"NOV 24, 2023",DEN @ HOU,L,6,0,3,0.0,0,1,0.0,0,0,0.0,1,0,1,0,0,1,0,1,0,-18,1,DEN,HOU,DEN,86,,,1,1,0,1
Peyton Watson,G,22023,1631212,22300226,"NOV 22, 2023",DEN @ ORL,L,10,1,1,1.0,0,0,0.0,0,2,0.0,1,0,1,0,0,0,0,1,2,-9,1,DEN,ORL,DEN,119,,,3,3,2,1
Peyton Watson,G,22023,1631212,22300218,"NOV 20, 2023",DEN @ DET,W,13,1,2,0.5,0,0,0.0,2,2,1.0,0,1,1,2,0,2,1,1,4,5,1,DEN,DET,DEN,107,,,7,5,6,3
Peyton Watson,G,22023,1631212,22300034,"NOV 17, 2023",DEN @ NOP,L,11,1,3,0.333,0,1,0.0,1,2,0.5,2,1,3,1,0,0,2,2,3,-2,1,DEN,NOP,DEN,110,,,7,6,4,4
Peyton Watson,G,22023,1631212,22300024,"NOV 14, 2023",DEN vs. LAC,W,11,2,2,1.0,0,0,0.0,0,0,0.0,0,0,0,0,0,0,0,1,4,2,1,DEN,DEN,LAC,111,,,4,4,4,0
Peyton Watson,G,22023,1631212,22300182,"NOV 12, 2023",DEN @ HOU,L,7,0,2,0.0,0,0,0.0,0,0,0.0,0,0,0,1,0,1,0,2,0,-6,1,DEN,HOU,DEN,104,,,1,0,1,1
Peyton Watson,G,22023,1631212,22300169,"NOV 08, 2023",DEN vs. GSW,W,11,1,2,0.5,0,0,0.0,0,0,0.0,0,0,0,0,0,0,0,0,2,-8,1,DEN,DEN,GSW,108,,,2,2,2,0
Peyton Watson,G,22023,1631212,22300156,"NOV 06, 2023",DEN vs. NOP,W,19,2,3,0.667,0,0,0.0,0,0,0.0,0,3,3,1,2,2,0,0,4,15,1,DEN,DEN,NOP,134,,,8,7,5,4
Peyton Watson,G,22023,1631212,22300139,"NOV 04, 2023",DEN vs. CHI,W,18,1,3,0.333,0,1,0.0,0,0,0.0,0,2,2,2,2,0,2,2,2,-8,1,DEN,DEN,CHI,123,,,6,4,4,4
Peyton Watson,G,22023,1631212,22300006,"NOV 03, 2023",DEN vs. DAL,W,13,1,4,0.25,0,1,0.0,1,2,0.5,2,1,3,1,0,2,0,2,3,-14,1,DEN,DEN,DAL,125,,,7,6,4,4
Peyton Watson,G,22023,1631212,22300123,"NOV 01, 2023",DEN @ MIN,L,16,2,3,0.667,0,1,0.0,0,0,0.0,0,2,2,1,0,0,2,2,4,-6,1,DEN,MIN,DEN,89,,,7,6,5,3
Peyton Watson,G,22023,1631212,22300110,"OCT 30, 2023",DEN vs. UTA,W,15,2,4,0.5,0,1,0.0,1,2,0.5,0,2,2,0,0,1,0,0,5,0,1,DEN,DEN,UTA,110,,,7,7,5,2
Peyton Watson,G,22023,1631212,22300095,"OCT 29, 2023",DEN @ OKC,W,22,8,11,0.727,1,3,0.333,0,0,0.0,1,3,4,1,1,1,0,1,17,11,1,DEN,OKC,DEN,128,,,22,21,18,5
Peyton Watson,G,22023,1631212,22300078,"OCT 27, 2023",DEN @ MEM,W,18,3,4,0.75,2,3,0.667,1,2,0.5,0,3,3,0,1,3,1,3,9,-4,1,DEN,MEM,DEN,108,,,12,12,9,3
Peyton Watson,G,22023,1631212,22300061,"OCT 24, 2023",DEN vs. LAL,W,11,1,3,0.333,1,3,0.333,0,0,0.0,0,0,0,0,0,1,1,1,3,1,1,DEN,DEN,LAL,119,,,3,3,3,0
Trayce Jackson-Davis,F,22023,1631218,22300757,"FEB 10, 2024",GSW vs. PHX,W,5,0,2,0.0,0,0,0.0,0,0,0.0,2,2,4,1,0,0,1,2,0,4,1,GSW,GSW,PHX,113,,,5,4,1,5
Trayce Jackson-Davis,F,22023,1631218,22300733,"FEB 08, 2024",GSW @ IND,W,4,2,3,0.667,0,0,0.0,2,2,1.0,1,1,2,0,0,1,1,2,6,4,1,GSW,IND,GSW,131,,,8,8,6,2
Trayce Jackson-Davis,F,22023,1631218,22300727,"FEB 07, 2024",GSW @ PHI,W,4,1,1,1.0,0,0,0.0,0,0,0.0,0,1,1,1,0,0,0,1,2,2,1,GSW,PHI,GSW,127,,,4,3,3,2
Trayce Jackson-Davis,F,22023,1631218,22300699,"FEB 03, 2024",GSW @ ATL,L,9,2,3,0.667,0,0,0.0,1,1,1.0,1,4,5,0,0,1,1,1,5,-2,1,GSW,ATL,GSW,134,,,10,10,5,5
Trayce Jackson-Davis,F,22023,1631218,22300693,"FEB 02, 2024",GSW @ MEM,W,9,2,2,1.0,0,0,0.0,1,2,0.5,0,2,2,0,0,1,0,1,5,2,1,GSW,MEM,GSW,121,,,7,7,5,2
Trayce Jackson-Davis,F,22023,1631218,22300673,"JAN 30, 2024",GSW vs. PHI,W,12,3,5,0.6,0,0,0.0,0,0,0.0,2,2,4,0,0,0,0,0,6,-5,1,GSW,GSW,PHI,119,,,10,10,6,4
Trayce Jackson-Davis,F,22023,1631218,22300650,"JAN 27, 2024",GSW vs. LAL,L,6,2,2,1.0,0,0,0.0,0,1,0.0,0,1,1,0,1,0,0,1,4,-6,1,GSW,GSW,LAL,144,,,5,5,4,1
Trayce Jackson-Davis,F,22023,1631218,22300626,"JAN 24, 2024",GSW vs. ATL,W,15,2,4,0.5,0,0,0.0,0,4,0.0,2,4,6,1,0,2,0,2,4,6,1,GSW,GSW,ATL,134,,,11,10,5,7
Trayce Jackson-Davis,F,22023,1631218,22300560,"JAN 15, 2024",GSW @ MEM,L,10,0,2,0.0,0,0,0.0,0,0,0.0,0,2,2,1,0,1,0,2,0,-6,1,GSW,MEM,GSW,107,,,3,2,1,3
Trayce Jackson-Davis,F,22023,1631218,22300536,"JAN 12, 2024",GSW @ CHI,W,17,4,5,0.8,0,0,0.0,5,7,0.714,3,4,7,2,1,1,1,2,13,13,1,GSW,CHI,GSW,140,,,22,20,15,9
Trayce Jackson-Davis,F,22023,1631218,22300525,"JAN 10, 2024",GSW vs. NOP,L,22,9,11,0.818,0,0,0.0,1,1,1.0,3,2,5,1,1,1,1,1,19,-16,1,GSW,GSW,NOP,105,,,25,24,20,6
Trayce Jackson-Davis,F,22023,1631218,22300504,"JAN 07, 2024",GSW vs. TOR,L,27,8,9,0.889,0,0,0.0,0,0,0.0,3,8,11,2,0,3,0,0,16,-3,1,GSW,GSW,TOR,118,,,29,27,18,13
Trayce Jackson-Davis,F,22023,1631218,22300490,"JAN 05, 2024",GSW vs. DET,W,23,5,5,1.0,0,0,0.0,1,1,1.0,2,7,9,0,0,1,2,2,11,-2,1,GSW,GSW,DET,113,,,20,20,11,9
Trayce Jackson-Davis,F,22023,1631218,22300478,"JAN 04, 2024",GSW vs. DEN,L,21,2,4,0.5,0,0,0.0,0,0,0.0,2,0,2,2,0,0,2,4,4,0,1,GSW,GSW,DEN,127,,,8,6,6,4
Trayce Jackson-Davis,F,22023,1631218,22300463,"JAN 02, 2024",GSW vs. ORL,W,24,3,4,0.75,0,0,0.0,4,6,0.667,2,2,4,2,1,2,3,1,10,-1,1,GSW,GSW,ORL,121,,,16,14,12,6
Trayce Jackson-Davis,F,22023,1631218,22300444,"DEC 30, 2023",GSW vs. DAL,L,29,8,11,0.727,0,0,0.0,1,3,0.333,3,3,6,2,1,0,1,4,17,-4,1,GSW,GSW,DAL,122,,,25,23,19,8
Trayce Jackson-Davis,F,22023,1631218,22300426,"DEC 28, 2023",GSW vs. MIA,L,26,4,9,0.444,0,0,0.0,2,2,1.0,4,7,11,1,0,2,1,1,10,8,1,GSW,GSW,MIA,102,,,22,21,11,12
Trayce Jackson-Davis,F,22023,1631218,22300402,"DEC 25, 2023",GSW @ DEN,L,15,3,4,0.75,0,0,0.0,2,2,1.0,0,3,3,1,0,0,0,5,8,-4,1,GSW,DEN,GSW,114,,,12,11,9,4
Trayce Jackson-Davis,F,22023,1631218,22300399,"DEC 23, 2023",GSW vs. POR,W,17,6,7,0.857,0,0,0.0,1,4,0.25,1,4,5,3,1,0,2,2,13,-1,1,GSW,GSW,POR,126,,,21,18,16,8
Trayce Jackson-Davis,F,22023,1631218,22300386,"DEC 22, 2023",GSW vs. WAS,W,25,5,7,0.714,0,0,0.0,0,0,0.0,5,10,15,3,0,1,1,2,10,10,1,GSW,GSW,WAS,129,,,28,25,13,18
Trayce Jackson-Davis,F,22023,1631218,22300362,"DEC 19, 2023",GSW vs. BOS,W,29,5,7,0.714,0,0,0.0,0,0,0.0,4,9,13,1,0,3,1,3,10,25,1,GSW,GSW,BOS,132,,,24,23,11,14
Trayce Jackson-Davis,F,22023,1631218,22300348,"DEC 17, 2023",GSW @ POR,W,18,6,9,0.667,0,0,0.0,2,2,1.0,5,3,8,3,2,1,2,2,14,8,1,GSW,POR,GSW,118,,,25,22,17,11
Trayce Jackson-Davis,F,22023,1631218,22300325,"DEC 14, 2023",GSW @ LAC,L,5,1,3,0.333,0,0,0.0,0,0,0.0,3,0,3,0,0,0,0,0,2,-11,1,GSW,LAC,GSW,113,,,5,5,2,3
Trayce Jackson-Davis,F,22023,1631218,22300308,"DEC 12, 2023",GSW @ PHX,L,7,1,1,1.0,0,0,0.0,0,0,0.0,0,0,0,0,1,1,0,1,2,-6,1,GSW,PHX,GSW,116,,,2,2,2,0
Trayce Jackson-Davis,F,22023,1631218,22300051,"NOV 24, 2023",GSW vs. SAS,W,5,0,1,0.0,0,0,0.0,2,2,1.0,0,0,0,0,0,1,1,1,2,1,1,GSW,GSW,SAS,118,,,2,2,2,0
Trayce Jackson-Davis,F,22023,1631218,22300236,"NOV 22, 2023",GSW @ PHX,L,15,2,3,0.667,0,0,0.0,2,5,0.4,2,2,4,0,1,0,1,3,6,-5,1,GSW,PHX,GSW,115,,,10,10,6,4
Trayce Jackson-Davis,F,22023,1631218,22300224,"NOV 20, 2023",GSW vs. HOU,W,4,0,0,0.0,0,0,0.0,0,0,0.0,0,0,0,0,0,0,0,0,0,1,1,GSW,GSW,HOU,121,,,0,0,0,0
Trayce Jackson-Davis,F,22023,1631218,22300186,"NOV 12, 2023",GSW vs. MIN,L,1,1,1,1.0,0,0,0.0,0,0,0.0,0,0,0,1,0,0,0,0,2,6,1,GSW,GSW,MIN,110,,,3,2,3,1
Trayce Jackson-Davis,F,22023,1631218,22300176,"NOV 11, 2023",GSW vs. CLE,L,6,0,1,0.0,0,0,0.0,1,2,0.5,1,0,1,0,0,0,0,1,1,4,1,GSW,GSW,CLE,110,,,2,2,1,1
Trayce Jackson-Davis,F,22023,1631218,22300169,"NOV 08, 2023",GSW @ DEN,L,18,2,3,0.667,0,0,0.0,4,5,0.8,0,2,2,1,0,0,0,4,8,4,1,GSW,DEN,GSW,105,,,11,10,9,3
Trayce Jackson-Davis,F,22023,1631218,22300145,"NOV 06, 2023",GSW @ DET,W,0,0,0,0.0,0,0,0.0,0,0,0.0,0,0,0,0,0,0,0,0,0,1,1,GSW,DET,GSW,120,,,0,0,0,0
Trayce Jackson-Davis,F,22023,1631218,22300142,"NOV 05, 2023",GSW @ CLE,L,12,2,3,0.667,0,0,0.0,1,5,0.2,1,3,4,1,1,1,0,4,5,8,1,GSW,CLE,GSW,104,,,10,9,6,5
Trayce Jackson-Davis,F,22023,1631218,22300126,"NOV 01, 2023",GSW vs. SAC,W,0,0,0,0.0,0,0,0.0,0,0,0.0,0,0,0,0,0,0,0,0,0,0,1,GSW,GSW,SAC,102,,,0,0,0,0
Trayce Jackson-Davis,F,22023,1631218,22300108,"OCT 30, 2023",GSW @ NOP,W,20,5,9,0.556,0,0,0.0,3,4,0.75,7,2,9,0,0,4,2,2,13,11,1,GSW,NOP,GSW,130,,,22,22,13,9
Trayce Jackson-Davis,F,22023,1631218,22300087,"OCT 27, 2023",GSW @ SAC,W,5,0,0,0.0,0,0,0.0,0,0,0.0,0,1,1,0,0,0,0,1,0,7,1,GSW,SAC,GSW,122,,,1,1,0,1
Trayce Jackson-Davis,F,22023,1631218,22300025,"NOV 14, 2023",GSW vs. MIN,L,12,0,1,0.0,0,0,0.0,2,2,1.0,0,2,2,3,0,0,2,2,2,-2,1,GSW,GSW,MIN,101,,,7,4,5,5
Trayce Jackson-Davis,F,22023,1631218,22300545,"JAN 13, 2024",GSW @ MIL,L,18,6,8,0.75,0,0,0.0,0,2,0.0,0,2,2,1,1,1,0,0,12,-13,1,GSW,MIL,GSW,118,,,15,14,13,3
Trayce Jackson-Davis,F,22023,1631218,22300201,"NOV 16, 2023",GSW vs. OKC,L,5,0,0,0.0,0,0,0.0,0,0,0.0,0,0,0,0,0,1,0,0,0,1,1,GSW,GSW,OKC,109,,,0,0,0,0
Marcus Morris Sr.,F,22023,202694,22300715,"FEB 05, 2024",PHI vs. DAL,L,24,4,10,0.4,2,4,0.5,0,0,0.0,0,5,5,0,1,1,1,1,10,-3,1,PHI,PHI,DAL,102,,,15,15,10,5
Marcus Morris Sr.,F,22023,202694,22300698,"FEB 03, 2024",PHI vs. BKN,L,19,2,5,0.4,0,1,0.0,0,0,0.0,0,3,3,1,1,0,1,1,4,-9,1,PHI,PHI,BKN,121,,,8,7,5,4
Marcus Morris Sr.,F,22023,202694,22300668,"JAN 29, 2024",PHI @ POR,L,22,3,7,0.429,1,3,0.333,2,2,1.0,0,2,2,0,0,0,3,1,9,-2,1,PHI,POR,PHI,104,,,11,11,9,2
Marcus Morris Sr.,F,22023,202694,22300532,"JAN 12, 2024",PHI vs. SAC,W,17,0,5,0.0,0,0,0.0,0,0,0.0,0,4,4,0,0,0,1,0,0,2,1,PHI,PHI,SAC,112,,,4,4,0,4
Marcus Morris Sr.,F,22023,202694,22300521,"JAN 10, 2024",PHI @ ATL,L,26,4,9,0.444,3,8,0.375,6,6,1.0,1,3,4,1,0,0,1,3,17,-10,1,PHI,ATL,PHI,132,,,22,21,18,5
Marcus Morris Sr.,F,22023,202694,22300495,"JAN 06, 2024",PHI vs. UTA,L,28,5,12,0.417,3,7,0.429,2,2,1.0,2,4,6,1,2,2,0,2,15,-2,1,PHI,PHI,UTA,109,,,22,21,16,7
Marcus Morris Sr.,F,22023,202694,22300483,"JAN 05, 2024",PHI vs. NYK,L,16,0,1,0.0,0,1,0.0,0,0,0.0,0,0,0,1,0,0,0,0,0,-24,1,PHI,PHI,NYK,92,,,1,0,1,1
Marcus Morris Sr.,F,22023,202694,22300459,"JAN 02, 2024",PHI vs. CHI,W,11,0,3,0.0,0,0,0.0,2,4,0.5,1,1,2,0,1,0,1,0,2,-7,1,PHI,PHI,CHI,110,,,4,4,2,2
Marcus Morris Sr.,F,22023,202694,22300442,"DEC 30, 2023",PHI @ CHI,L,17,2,5,0.4,0,2,0.0,0,0,0.0,0,2,2,1,0,0,1,3,4,-9,1,PHI,CHI,PHI,92,,,7,6,5,3
Marcus Morris Sr.,F,22023,202694,22300434,"DEC 29, 2023",PHI @ HOU,W,27,4,8,0.5,2,5,0.4,4,5,0.8,1,4,5,1,1,1,1,5,14,10,1,PHI,HOU,PHI,131,,,20,19,15,6
Marcus Morris Sr.,F,22023,202694,22300415,"DEC 27, 2023",PHI @ ORL,W,22,6,14,0.429,0,3,0.0,2,3,0.667,0,3,3,0,0,0,0,3,14,4,1,PHI,ORL,PHI,112,,,17,17,14,3
Marcus Morris Sr.,F,22023,202694,22300404,"DEC 25, 2023",PHI @ MIA,L,11,0,4,0.0,0,3,0.0,0,0,0.0,0,1,1,0,0,0,0,1,0,-17,1,PHI,MIA,PHI,113,,,1,1,0,1
Marcus Morris Sr.,F,22023,202694,22300367,"DEC 20, 2023",PHI vs. MIN,W,25,2,4,0.5,1,2,0.5,0,0,0.0,0,1,1,0,1,0,0,2,5,23,1,PHI,PHI,MIN,127,,,6,6,5,1
Marcus Morris Sr.,F,22023,202694,22300335,"DEC 16, 2023",PHI @ CHA,W,16,3,7,0.429,0,2,0.0,0,0,0.0,0,4,4,1,0,0,0,1,6,11,1,PHI,CHA,PHI,135,,,11,10,7,5
Marcus Morris Sr.,F,22023,202694,22300327,"DEC 15, 2023",PHI vs. DET,W,15,5,8,0.625,5,5,1.0,0,0,0.0,0,2,2,1,1,0,1,1,15,12,1,PHI,PHI,DET,124,,,18,17,16,3
Marcus Morris Sr.,F,22023,202694,22300310,"DEC 13, 2023",PHI @ DET,W,16,2,2,1.0,0,0,0.0,0,0,0.0,1,7,8,2,0,1,0,2,4,6,1,PHI,DET,PHI,129,,,14,12,6,10
Marcus Morris Sr.,F,22023,202694,22300295,"DEC 11, 2023",PHI vs. WAS,W,12,5,6,0.833,2,3,0.667,0,0,0.0,0,2,2,1,1,0,0,3,12,24,1,PHI,PHI,WAS,146,,,15,14,13,3
Marcus Morris Sr.,F,22023,202694,22301218,"DEC 08, 2023",PHI vs. ATL,W,16,1,1,1.0,1,1,1.0,0,0,0.0,0,3,3,1,0,1,0,3,3,3,1,PHI,PHI,ATL,125,,,7,6,4,4
Marcus Morris Sr.,F,22023,202694,22300275,"DEC 01, 2023",PHI @ BOS,L,28,5,12,0.417,2,3,0.667,1,1,1.0,1,6,7,1,1,1,0,1,13,-2,1,PHI,BOS,PHI,119,,,21,20,14,8
Marcus Morris Sr.,F,22023,202694,22300262,"NOV 29, 2023",PHI @ NOP,L,17,3,7,0.429,1,3,0.333,0,0,0.0,1,2,3,2,1,1,1,4,7,-17,1,PHI,NOP,PHI,114,,,12,10,9,5
Marcus Morris Sr.,F,22023,202694,22300255,"NOV 27, 2023",PHI vs. LAL,W,20,6,8,0.75,4,5,0.8,0,0,0.0,0,1,1,0,1,0,0,2,16,24,1,PHI,PHI,LAL,138,,,17,17,16,1
Marcus Morris Sr.,F,22023,202694,22300232,"NOV 22, 2023",PHI @ MIN,L,16,6,12,0.5,3,5,0.6,1,1,1.0,2,2,4,2,1,2,2,5,16,-7,1,PHI,MIN,PHI,99,,,22,20,18,6
Marcus Morris Sr.,F,22023,202694,22300208,"NOV 19, 2023",PHI @ BKN,W,6,1,1,1.0,1,1,1.0,0,0,0.0,0,1,1,0,0,0,0,0,3,2,1,PHI,BKN,PHI,121,,,4,4,3,1
Marcus Morris Sr.,F,22023,202694,22300148,"NOV 06, 2023",PHI vs. WAS,W,6,1,2,0.5,0,0,0.0,1,1,1.0,0,1,1,0,0,1,0,0,3,7,1,PHI,PHI,WAS,146,,,4,4,3,1
Marcus Morris Sr.,F,22023,202694,22300644,"JAN 27, 2024",PHI @ DEN,L,33,7,16,0.438,1,5,0.2,2,2,1.0,0,4,4,2,0,0,1,2,17,-7,1,PHI,DEN,PHI,105,,,23,21,19,6
Marcus Morris Sr.,F,22023,202694,22300593,"JAN 20, 2024",PHI @ CHA,W,14,0,4,0.0,0,3,0.0,0,0,0.0,0,0,0,0,0,0,0,0,0,-5,1,PHI,CHA,PHI,97,,,0,0,0,0
Marcus Morris Sr.,F,22023,202694,22300585,"JAN 19, 2024",PHI @ ORL,W,26,5,10,0.5,0,2,0.0,0,0,0.0,4,5,9,0,0,0,2,1,10,5,1,PHI,ORL,PHI,124,,,19,19,10,9
Marcus Morris Sr.,F,22023,202694,22300566,"JAN 16, 2024",PHI vs. DEN,W,19,1,3,0.333,1,2,0.5,4,5,0.8,1,1,2,0,0,0,0,3,7,-3,1,PHI,PHI,DEN,126,,,9,9,7,2
Marcus Morris Sr.,F,22023,202694,22300555,"JAN 15, 2024",PHI vs. HOU,W,14,3,3,1.0,2,2,1.0,0,0,0.0,0,5,5,1,0,0,0,1,8,26,1,PHI,PHI,HOU,124,,,14,13,9,6
Marcus Morris Sr.,F,22023,202694,22301208,"DEC 06, 2023",PHI @ WAS,W,15,1,4,0.25,0,1,0.0,2,2,1.0,1,2,3,0,0,0,0,0,4,-8,1,PHI,WAS,PHI,131,,,7,7,4,3
Marcus Morris Sr.,F,22023,202694,22300239,"NOV 25, 2023",PHI @ OKC,W,15,0,2,0.0,0,2,0.0,0,0,0.0,1,2,3,0,0,0,1,3,0,-10,1,PHI,OKC,PHI,127,,,3,3,0,3
Marcus Morris Sr.,F,22023,202694,22300040,"NOV 21, 2023",PHI vs. CLE,L,3,0,0,0.0,0,0,0.0,0,0,0.0,0,0,0,0,0,0,0,0,0,-1,1,PHI,PHI,CLE,119,,,0,0,0,0
Marcus Morris Sr.,F,22023,202694,22300008,"NOV 10, 2023",PHI @ DET,W,6,0,0,0.0,0,0,0.0,0,0,0.0,0,1,1,0,0,0,0,2,0,-10,1,PHI,DET,PHI,114,,,1,1,0,1
Marcus Morris Sr.,F,22023,202694,22300029,"NOV 17, 2023",PHI @ ATL,W,2,0,0,0.0,0,0,0.0,0,0,0.0,0,1,1,0,0,0,0,1,0,2,1,PHI,ATL,PHI,126,,,1,1,0,1
Marcus Morris Sr.,F,22023,202694,22300194,"NOV 15, 2023",PHI vs. BOS,L,8,0,3,0.0,0,2,0.0,0,0,0.0,0,0,0,0,0,0,1,0,0,-16,1,PHI,PHI,BOS,107,,,0,0,0,0
Marcus Morris Sr.,F,22023,202694,22300019,"NOV 14, 2023",PHI vs. IND,L,18,1,4,0.25,0,2,0.0,0,0,0.0,0,3,3,1,0,0,0,1,2,-5,1,PHI,PHI,IND,126,,,6,5,3,4
Marcus Morris Sr.,F,22023,202694,22300382,"DEC 22, 2023",PHI vs. TOR,W,31,2,3,0.667,1,2,0.5,2,2,1.0,1,3,4,5,0,0,0,3,7,4,1,PHI,PHI,TOR,121,,,16,11,12,9
Cam Reddish,F-G,22023,1629629,22300605,"JAN 21, 2024",LAL vs. POR,W,21,5,8,0.625,0,2,0.0,0,0,0.0,0,4,4,1,2,0,0,2,10,10,1,LAL,LAL,POR,134,,,15,14,11,5
Cam Reddish,F-G,22023,1629629,22300163,"NOV 08, 2023",LAL @ HOU,L,25,2,7,0.286,0,3,0.0,3,4,0.75,0,1,1,0,3,0,0,0,7,-20,1,LAL,HOU,LAL,94,,,8,8,7,1
Cam Reddish,F-G,22023,1629629,22300134,"NOV 04, 2023",LAL @ ORL,L,24,1,5,0.2,0,1,0.0,0,0,0.0,0,3,3,0,0,0,1,4,2,-15,1,LAL,ORL,LAL,101,,,5,5,2,3
Cam Reddish,F-G,22023,1629629,22300618,"JAN 23, 2024",LAL @ LAC,L,16,3,5,0.6,2,4,0.5,1,4,0.25,0,0,0,1,1,3,1,1,9,-1,1,LAL,LAC,LAL,116,,,10,9,10,1
Cam Reddish,F-G,22023,1629629,22300549,"JAN 13, 2024",LAL @ UTA,L,11,0,1,0.0,0,1,0.0,0,0,0.0,0,1,1,0,0,0,0,0,0,3,1,LAL,UTA,LAL,125,,,1,1,0,1
Cam Reddish,F-G,22023,1629629,22300531,"JAN 11, 2024",LAL vs. PHX,L,8,0,1,0.0,0,1,0.0,0,0,0.0,0,0,0,0,0,0,0,1,0,-5,1,LAL,LAL,PHX,109,,,0,0,0,0
Cam Reddish,F-G,22023,1629629,22300516,"JAN 09, 2024",LAL vs. TOR,W,23,4,7,0.571,4,6,0.667,1,2,0.5,0,1,1,0,1,1,2,1,13,-7,1,LAL,LAL,TOR,132,,,14,14,13,1
Cam Reddish,F-G,22023,1629629,22300505,"JAN 07, 2024",LAL vs. LAC,W,20,2,6,0.333,2,3,0.667,1,2,0.5,1,3,4,1,2,0,5,1,7,-8,1,LAL,LAL,LAC,106,,,12,11,8,5
Cam Reddish,F-G,22023,1629629,22300491,"JAN 05, 2024",LAL vs. MEM,L,32,3,8,0.375,2,3,0.667,0,0,0.0,1,1,2,0,1,0,0,0,8,-20,1,LAL,LAL,MEM,113,,,10,10,8,2
Cam Reddish,F-G,22023,1629629,22300475,"JAN 03, 2024",LAL vs. MIA,L,19,0,1,0.0,0,1,0.0,0,0,0.0,0,0,0,1,0,0,4,2,0,-7,1,LAL,LAL,MIA,96,,,1,0,1,1
Cam Reddish,F-G,22023,1629629,22300370,"DEC 20, 2023",LAL @ CHI,L,28,5,14,0.357,3,8,0.375,0,0,0.0,1,3,4,2,2,0,1,1,13,-1,1,LAL,CHI,LAL,108,,,19,17,15,6
Cam Reddish,F-G,22023,1629629,22300316,"DEC 13, 2023",LAL @ SAS,W,24,4,7,0.571,2,3,0.667,0,0,0.0,0,2,2,3,3,1,1,0,10,12,1,LAL,SAS,LAL,122,,,15,12,13,5
Cam Reddish,F-G,22023,1629629,22300306,"DEC 12, 2023",LAL @ DAL,L,22,2,4,0.5,0,0,0.0,0,0,0.0,1,2,3,2,0,1,2,3,4,-10,1,LAL,DAL,LAL,125,,,9,7,6,5
Cam Reddish,F-G,22023,1629629,22301230,"DEC 07, 2023",LAL vs. NOP,W,23,3,6,0.5,1,2,0.5,2,2,1.0,2,3,5,2,0,0,1,1,9,31,1,LAL,LAL,NOP,133,,,16,14,11,7
Cam Reddish,F-G,22023,1629629,22301203,"DEC 05, 2023",LAL vs. PHX,W,30,0,4,0.0,0,2,0.0,4,4,1.0,1,1,2,1,1,0,0,4,4,-7,1,LAL,LAL,PHX,106,,,7,6,5,3
Cam Reddish,F-G,22023,1629629,22300291,"DEC 02, 2023",LAL vs. HOU,W,24,4,7,0.571,0,1,0.0,3,3,1.0,1,4,5,1,0,1,0,3,11,-1,1,LAL,LAL,HOU,107,,,17,16,12,6
Cam Reddish,F-G,22023,1629629,22300258,"NOV 29, 2023",LAL @ DET,W,20,0,3,0.0,0,2,0.0,0,0,0.0,0,3,3,2,0,0,1,2,0,13,1,LAL,DET,LAL,133,,,5,3,2,5
Cam Reddish,F-G,22023,1629629,22300042,"NOV 21, 2023",LAL vs. UTA,W,5,0,0,0.0,0,0,0.0,0,0,0.0,0,0,0,0,0,0,0,1,0,4,1,LAL,LAL,UTA,131,,,0,0,0,0
Cam Reddish,F-G,22023,1629629,22300036,"NOV 17, 2023",LAL @ POR,W,31,2,4,0.5,1,2,0.5,3,4,0.75,1,1,2,1,3,1,1,0,8,1,1,LAL,POR,LAL,107,,,11,10,9,3
Cam Reddish,F-G,22023,1629629,22300198,"NOV 15, 2023",LAL vs. SAC,L,32,7,14,0.5,2,5,0.4,0,0,0.0,0,2,2,0,5,0,1,1,16,0,1,LAL,LAL,SAC,110,,,18,18,16,2
Cam Reddish,F-G,22023,1629629,22300026,"NOV 14, 2023",LAL vs. MEM,W,25,3,7,0.429,3,5,0.6,1,2,0.5,0,1,1,2,0,0,0,2,10,16,1,LAL,LAL,MEM,134,,,13,11,12,3
Cam Reddish,F-G,22023,1629629,22300187,"NOV 12, 2023",LAL vs. POR,W,38,7,10,0.7,1,3,0.333,3,3,1.0,1,6,7,2,3,1,1,1,18,10,1,LAL,LAL,POR,116,,,27,25,20,9
Cam Reddish,F-G,22023,1629629,22300150,"NOV 06, 2023",LAL @ MIA,L,29,2,5,0.4,0,0,0.0,3,4,0.75,2,2,4,2,1,0,2,0,7,-4,1,LAL,MIA,LAL,107,,,13,11,9,6
Cam Reddish,F-G,22023,1629629,22300127,"NOV 01, 2023",LAL vs. LAC,W,37,2,7,0.286,1,5,0.2,3,4,0.75,0,4,4,4,3,1,0,5,8,-4,1,LAL,LAL,LAC,130,,,16,12,12,8
Cam Reddish,F-G,22023,1629629,22300061,"OCT 24, 2023",LAL @ DEN,L,18,2,4,0.5,1,2,0.5,2,2,1.0,2,2,4,0,0,1,0,2,7,7,1,LAL,DEN,LAL,107,,,11,11,7,4
Cam Reddish,F-G,22023,1629629,22300443,"DEC 30, 2023",LAL @ MIN,L,22,2,7,0.286,0,1,0.0,0,0,0.0,1,2,3,4,0,0,0,0,4,1,1,LAL,MIN,LAL,106,,,11,7,8,7
Cam Reddish,F-G,22023,1629629,22300403,"DEC 25, 2023",LAL vs. BOS,L,18,1,2,0.5,1,1,1.0,2,2,1.0,0,0,0,0,0,0,2,2,5,-12,1,LAL,LAL,BOS,115,,,5,5,5,0
Cam Reddish,F-G,22023,1629629,22300397,"DEC 23, 2023",LAL @ OKC,W,28,2,7,0.286,0,4,0.0,0,0,0.0,1,3,4,7,1,0,0,2,4,13,1,LAL,OKC,LAL,129,,,15,8,11,11
Cam Reddish,F-G,22023,1629629,22300380,"DEC 21, 2023",LAL @ MIN,L,37,3,8,0.375,0,2,0.0,2,2,1.0,1,0,1,2,1,0,1,1,8,-6,1,LAL,MIN,LAL,111,,,11,9,10,3
Cam Reddish,F-G,22023,1629629,22300359,"DEC 18, 2023",LAL vs. NYK,L,27,2,9,0.222,0,4,0.0,0,0,0.0,1,1,2,1,3,0,0,5,4,-6,1,LAL,LAL,NYK,109,,,7,6,5,3
Cam Reddish,F-G,22023,1629629,22300216,"NOV 19, 2023",LAL vs. HOU,W,39,3,9,0.333,1,5,0.2,0,0,0.0,0,3,3,3,3,0,1,2,7,13,1,LAL,LAL,HOU,105,,,13,10,10,6
Cam Reddish,F-G,22023,1629629,22300015,"NOV 10, 2023",LAL @ PHX,W,28,5,10,0.5,5,8,0.625,2,2,1.0,1,2,3,0,3,0,0,3,17,7,1,LAL,PHX,LAL,122,,,20,20,17,3
Cam Reddish,F-G,22023,1629629,22300111,"OCT 30, 2023",LAL vs. ORL,W,14,0,1,0.0,0,1,0.0,0,0,0.0,0,2,2,2,1,0,1,0,0,-3,1,LAL,LAL,ORL,106,,,4,2,2,4
Cam Reddish,F-G,22023,1629629,22300100,"OCT 29, 2023",LAL @ SAC,L,5,0,2,0.0,0,1,0.0,0,0,0.0,0,1,1,0,0,0,0,0,0,-7,1,LAL,SAC,LAL,127,,,1,1,0,1
Cam Reddish,F-G,22023,1629629,22300076,"OCT 26, 2023",LAL vs. PHX,W,12,2,5,0.4,0,3,0.0,0,0,0.0,0,1,1,0,0,0,1,2,4,-12,1,LAL,LAL,PHX,100,,,5,5,4,1
Cason Wallace,G,22023,1641717,22300682,"JAN 31, 2024",OKC vs. DEN,W,20,2,7,0.286,1,3,0.333,0,0,0.0,1,1,2,1,0,0,0,3,5,0,1,OKC,OKC,DEN,105,0.5,Steals,8,7,6,3
Cason Wallace,G,22023,1641717,22300622,"JAN 24, 2024",OKC @ SAS,W,23,5,7,0.714,2,3,0.667,1,1,1.0,1,2,3,4,1,0,0,4,13,14,1,OKC,SAS,OKC,140,0.5,Steals,20,16,17,7
Cason Wallace,G,22023,1641717,22300617,"JAN 23, 2024",OKC vs. POR,W,12,1,2,0.5,1,2,0.5,0,0,0.0,0,4,4,0,0,0,2,0,3,-4,1,OKC,OKC,POR,111,0.5,Steals,7,7,3,4
Cason Wallace,G,22023,1641717,22300481,"JAN 05, 2024",OKC @ BKN,L,23,3,7,0.429,2,4,0.5,0,0,0.0,1,1,2,0,1,0,0,1,8,-5,1,OKC,BKN,OKC,115,0.5,Steals,10,10,8,2
Cason Wallace,G,22023,1641717,22300419,"DEC 27, 2023",OKC vs. NYK,W,22,2,6,0.333,0,2,0.0,0,0,0.0,0,1,1,0,1,0,1,1,4,6,1,OKC,OKC,NYK,129,0.5,Steals,5,5,4,1
Cason Wallace,G,22023,1641717,22300397,"DEC 23, 2023",OKC vs. LAL,L,24,2,6,0.333,1,4,0.25,0,0,0.0,1,2,3,4,1,0,0,2,5,-5,1,OKC,OKC,LAL,120,0.5,Steals,12,8,9,7
Cason Wallace,G,22023,1641717,22300324,"DEC 14, 2023",OKC @ SAC,L,19,1,3,0.333,1,2,0.5,0,0,0.0,0,0,0,4,0,0,0,3,3,-18,1,OKC,SAC,OKC,123,0.5,Steals,7,3,7,4
Cason Wallace,G,22023,1641717,22300302,"DEC 11, 2023",OKC vs. UTA,W,25,4,8,0.5,2,4,0.5,0,0,0.0,0,3,3,2,1,2,0,4,10,17,1,OKC,OKC,UTA,134,0.5,Steals,15,13,12,5
Cason Wallace,G,22023,1641717,22301222,"DEC 08, 2023",OKC vs. GSW,W,24,4,5,0.8,1,2,0.5,1,2,0.5,0,1,1,0,1,1,1,0,10,1,1,OKC,OKC,GSW,138,0.5,Steals,11,11,10,1
Cason Wallace,G,22023,1641717,22300287,"DEC 02, 2023",OKC @ DAL,W,20,6,12,0.5,2,7,0.286,1,2,0.5,2,4,6,0,0,0,0,3,15,0,1,OKC,DAL,OKC,126,0.5,Steals,21,21,15,6
Cason Wallace,G,22023,1641717,22300239,"NOV 25, 2023",OKC vs. PHI,L,14,0,2,0.0,0,0,0.0,0,0,0.0,1,0,1,1,0,0,0,1,0,-15,1,OKC,OKC,PHI,123,0.5,Steals,2,1,1,2
Cason Wallace,G,22023,1641717,22300215,"NOV 19, 2023",OKC @ POR,W,21,1,2,0.5,0,0,0.0,0,0,0.0,0,1,1,0,1,0,1,1,2,19,1,OKC,POR,OKC,134,0.5,Steals,3,3,2,1
Cason Wallace,G,22023,1641717,22300185,"NOV 12, 2023",OKC @ PHX,W,17,0,1,0.0,0,0,0.0,0,0,0.0,0,0,0,1,0,0,0,3,0,2,1,OKC,PHX,OKC,111,0.5,Steals,1,0,1,1
Cason Wallace,G,22023,1641717,22300167,"NOV 08, 2023",OKC vs. CLE,W,24,5,7,0.714,2,3,0.667,2,2,1.0,1,2,3,2,0,0,2,3,14,6,1,OKC,OKC,CLE,128,0.5,Steals,19,17,16,5
Cason Wallace,G,22023,1641717,22300109,"OCT 30, 2023",OKC vs. DET,W,22,1,2,0.5,0,1,0.0,2,2,1.0,0,4,4,2,0,0,1,2,4,-2,1,OKC,OKC,DET,124,0.5,Steals,10,8,6,6
Cason Wallace,G,22023,1641717,22300748,"FEB 10, 2024",OKC @ DAL,L,25,5,11,0.455,3,7,0.429,2,2,1.0,0,2,2,0,1,0,1,2,15,-18,1,OKC,DAL,OKC,111,0.5,Steals,17,17,15,2
Cason Wallace,G,22023,1641717,22300724,"FEB 06, 2024",OKC @ UTA,L,16,1,2,0.5,1,2,0.5,0,0,0.0,0,0,0,0,0,0,0,1,3,-1,1,OKC,UTA,OKC,117,0.5,Steals,3,3,3,0
Cason Wallace,G,22023,1641717,22300710,"FEB 04, 2024",OKC vs. TOR,W,18,3,8,0.375,2,7,0.286,0,0,0.0,0,1,1,2,0,1,0,1,8,-10,1,OKC,OKC,TOR,135,0.5,Steals,11,9,10,3
Cason Wallace,G,22023,1641717,22300695,"FEB 02, 2024",OKC vs. CHA,W,25,5,7,0.714,2,4,0.5,0,0,0.0,0,2,2,1,1,0,1,1,12,22,1,OKC,OKC,CHA,126,0.5,Steals,15,14,13,3
Cason Wallace,G,22023,1641717,22300568,"JAN 16, 2024",OKC @ LAC,L,15,2,4,0.5,1,2,0.5,0,0,0.0,2,0,2,1,1,1,0,1,5,-1,1,OKC,LAC,OKC,117,0.5,Steals,8,7,6,3
Cason Wallace,G,22023,1641717,22300565,"JAN 15, 2024",OKC @ LAL,L,20,2,6,0.333,1,4,0.25,0,0,0.0,0,0,0,1,2,1,1,0,5,-7,1,OKC,LAL,OKC,105,0.5,Steals,6,5,6,1
Cason Wallace,G,22023,1641717,22300546,"JAN 13, 2024",OKC vs. ORL,W,20,0,5,0.0,0,4,0.0,1,2,0.5,2,1,3,0,0,0,0,3,1,5,1,OKC,OKC,ORL,112,0.5,Steals,4,4,1,3
Cason Wallace,G,22023,1641717,22300529,"JAN 11, 2024",OKC vs. POR,W,17,1,5,0.2,0,3,0.0,2,2,1.0,1,5,6,2,0,0,0,0,4,17,1,OKC,OKC,POR,139,0.5,Steals,12,10,6,8
Cason Wallace,G,22023,1641717,22300379,"DEC 21, 2023",OKC vs. LAC,W,20,1,4,0.25,0,2,0.0,0,0,0.0,0,0,0,3,0,1,1,2,2,-5,1,OKC,OKC,LAC,134,0.5,Steals,5,2,5,3
Cason Wallace,G,22023,1641717,22300355,"DEC 18, 2023",OKC vs. MEM,W,17,3,6,0.5,1,4,0.25,0,0,0.0,0,2,2,2,0,0,1,1,7,12,1,OKC,OKC,MEM,116,0.5,Steals,11,9,9,4
Cason Wallace,G,22023,1641717,22300340,"DEC 16, 2023",OKC @ DEN,W,18,1,2,0.5,0,0,0.0,0,0,0.0,1,1,2,1,0,0,1,0,2,-7,1,OKC,DEN,OKC,118,0.5,Steals,5,4,3,3
Cason Wallace,G,22023,1641717,22300058,"NOV 28, 2023",OKC @ MIN,L,17,3,4,0.75,3,3,1.0,1,2,0.5,0,0,0,0,1,0,0,0,10,5,1,OKC,MIN,OKC,103,0.5,Steals,10,10,10,0
Cason Wallace,G,22023,1641717,22300016,"NOV 10, 2023",OKC @ SAC,L,24,3,7,0.429,2,5,0.4,0,0,0.0,1,2,3,2,0,1,0,1,8,3,1,OKC,SAC,OKC,98,0.5,Steals,13,11,10,5
Cason Wallace,G,22023,1641717,22300155,"NOV 06, 2023",OKC vs. ATL,W,24,3,6,0.5,0,3,0.0,0,0,0.0,0,2,2,4,4,0,1,1,6,3,1,OKC,OKC,ATL,126,0.5,Steals,12,8,10,6
Cason Wallace,G,22023,1641717,22300005,"NOV 03, 2023",OKC vs. GSW,L,36,6,10,0.6,1,2,0.5,0,0,0.0,1,1,2,1,0,0,1,1,13,4,1,OKC,OKC,GSW,139,0.5,Steals,16,15,14,3
Cason Wallace,G,22023,1641717,22300121,"NOV 01, 2023",OKC vs. NOP,L,18,1,2,0.5,0,0,0.0,2,2,1.0,0,2,2,1,0,0,0,4,4,-4,1,OKC,OKC,NOP,106,0.5,Steals,7,6,5,3
Cason Wallace,G,22023,1641717,22300095,"OCT 29, 2023",OKC vs. DEN,L,22,3,3,1.0,1,1,1.0,0,0,0.0,1,2,3,1,1,1,0,1,7,-11,1,OKC,OKC,DEN,95,0.5,Steals,11,10,8,4
Cason Wallace,G,22023,1641717,22300081,"OCT 27, 2023",OKC @ CLE,W,19,3,4,0.75,1,1,1.0,2,2,1.0,1,1,2,0,0,0,0,0,9,3,1,OKC,CLE,OKC,108,0.5,Steals,11,11,9,2
Cason Wallace,G,22023,1641717,22300070,"OCT 25, 2023",OKC @ CHI,W,19,5,5,1.0,3,3,1.0,0,0,0.0,0,2,2,1,0,1,1,3,13,9,1,OKC,CHI,OKC,124,0.5,Steals,16,15,14,3
Cason Wallace,G,22023,1641717,22300664,"JAN 29, 2024",OKC vs. MIN,L,20,1,1,1.0,1,1,1.0,0,0,0.0,0,2,2,2,0,1,0,6,3,-10,1,OKC,OKC,MIN,101,0.5,Steals,7,5,5,4
Cason Wallace,G,22023,1641717,22300654,"JAN 28, 2024",OKC @ DET,L,21,2,4,0.5,0,1,0.0,0,0,0.0,1,3,4,1,2,0,0,1,4,-13,1,OKC,DET,OKC,104,0.5,Steals,9,8,5,5
Cason Wallace,G,22023,1641717,22300640,"JAN 26, 2024",OKC @ NOP,W,21,5,10,0.5,2,5,0.4,0,0,0.0,1,1,2,1,4,0,0,1,12,18,1,OKC,NOP,OKC,107,0.5,Steals,15,14,13,3
Cason Wallace,G,22023,1641717,22300599,"JAN 20, 2024",OKC @ MIN,W,13,0,1,0.0,0,0,0.0,0,0,0.0,1,2,3,0,1,0,1,2,0,-15,1,OKC,MIN,OKC,102,0.5,Steals,3,3,0,3
Cason Wallace,G,22023,1641717,22300522,"JAN 10, 2024",OKC @ MIA,W,18,3,5,0.6,2,4,0.5,0,0,0.0,1,1,2,1,0,0,1,2,8,9,1,OKC,MIA,OKC,128,0.5,Steals,11,10,9,3
Cason Wallace,G,22023,1641717,22300508,"JAN 08, 2024",OKC @ WAS,W,24,2,7,0.286,1,4,0.25,0,0,0.0,1,1,2,2,2,3,1,1,5,-4,1,OKC,WAS,OKC,136,0.5,Steals,9,7,7,4
Cason Wallace,G,22023,1641717,22300467,"JAN 03, 2024",OKC @ ATL,L,20,5,9,0.556,3,7,0.429,2,2,1.0,0,1,1,2,1,0,0,2,15,-16,1,OKC,ATL,OKC,138,0.5,Steals,18,16,17,3
Cason Wallace,G,22023,1641717,22300462,"JAN 02, 2024",OKC vs. BOS,W,17,2,3,0.667,1,2,0.5,0,0,0.0,1,0,1,3,1,0,0,3,5,-14,1,OKC,OKC,BOS,127,0.5,Steals,9,6,8,4
Cason Wallace,G,22023,1641717,22300447,"DEC 31, 2023",OKC vs. BKN,W,23,3,7,0.429,2,4,0.5,2,2,1.0,1,2,3,1,0,1,0,5,10,9,1,OKC,OKC,BKN,124,0.5,Steals,14,13,11,4
Cason Wallace,G,22023,1641717,22300435,"DEC 29, 2023",OKC @ DEN,W,18,2,5,0.4,0,2,0.0,0,0,0.0,0,3,3,2,0,1,0,1,4,-2,1,OKC,DEN,OKC,119,0.5,Steals,9,7,6,5
Cason Wallace,G,22023,1641717,22300411,"DEC 26, 2023",OKC vs. MIN,W,24,2,5,0.4,1,4,0.25,0,0,0.0,1,0,1,1,2,0,1,0,5,4,1,OKC,OKC,MIN,129,0.5,Steals,7,6,6,2
Cason Wallace,G,22023,1641717,22301212,"DEC 06, 2023",OKC @ HOU,L,25,2,5,0.4,1,2,0.5,0,0,0.0,0,3,3,0,2,1,0,3,5,12,1,OKC,HOU,OKC,101,0.5,Steals,8,8,5,3
Cason Wallace,G,22023,1641717,22300271,"NOV 30, 2023",OKC vs. LAL,W,22,4,7,0.571,2,4,0.5,0,0,0.0,0,3,3,1,0,1,1,1,10,19,1,OKC,OKC,LAL,133,0.5,Steals,14,13,11,4
Cason Wallace,G,22023,1641717,22300234,"NOV 22, 2023",OKC vs. CHI,W,24,2,3,0.667,1,2,0.5,0,0,0.0,1,2,3,0,0,1,1,1,5,-2,1,OKC,OKC,CHI,116,0.5,Steals,8,8,5,3
Cason Wallace,G,22023,1641717,22300207,"NOV 18, 2023",OKC @ GSW,W,28,1,3,0.333,0,2,0.0,1,1,1.0,0,1,1,2,0,0,0,3,3,4,1,OKC,GSW,OKC,130,0.5,Steals,6,4,5,3
Cason Wallace,G,22023,1641717,22300201,"NOV 16, 2023",OKC @ GSW,W,26,4,7,0.571,2,2,1.0,0,0,0.0,1,1,2,4,1,0,0,1,10,22,1,OKC,GSW,OKC,128,0.5,Steals,16,12,14,6
Cason Wallace,G,22023,1641717,22300021,"NOV 14, 2023",OKC vs. SAS,W,21,4,5,0.8,1,1,1.0,0,0,0.0,1,4,5,3,2,2,1,1,9,8,1,OKC,OKC,SAS,123,0.5,Steals,17,14,12,8
Cason Wallace,G,22023,1641717,22300581,"JAN 18, 2024",OKC @ UTA,W,32,6,7,0.857,4,5,0.8,0,0,0.0,2,2,4,1,1,1,1,3,16,-1,1,OKC,UTA,OKC,134,0.5,Steals,21,20,17,5
Daniel Theis,F-C,22023,1628464,22300731,"FEB 07, 2024",LAC vs. NOP,L,7,0,1,0.0,0,0,0.0,2,2,1.0,0,1,1,0,0,0,0,1,2,1,1,LAC,LAC,NOP,106,,,3,3,2,1
Daniel Theis,F-C,22023,1628464,22300688,"FEB 02, 2024",LAC @ DET,W,18,2,3,0.667,0,1,0.0,1,2,0.5,0,3,3,2,1,2,2,3,5,11,1,LAC,DET,LAC,136,,,10,8,7,5
Daniel Theis,F-C,22023,1628464,22300676,"JAN 31, 2024",LAC @ WAS,W,20,2,5,0.4,0,1,0.0,0,0,0.0,1,1,2,0,1,1,0,3,4,-9,1,LAC,WAS,LAC,125,,,6,6,4,2
Daniel Theis,F-C,22023,1628464,22300658,"JAN 29, 2024",LAC @ CLE,L,17,0,1,0.0,0,1,0.0,0,0,0.0,1,3,4,5,0,0,1,3,0,-1,1,LAC,CLE,LAC,108,,,9,4,5,9
Daniel Theis,F-C,22023,1628464,22300646,"JAN 27, 2024",LAC @ BOS,W,26,8,9,0.889,2,3,0.667,0,1,0.0,1,6,7,2,1,2,0,4,18,-3,1,LAC,BOS,LAC,115,,,27,25,20,9
Daniel Theis,F-C,22023,1628464,22300637,"JAN 26, 2024",LAC @ TOR,W,18,3,4,0.75,0,0,0.0,0,0,0.0,2,2,4,1,0,0,2,1,6,6,1,LAC,TOR,LAC,127,,,11,10,7,5
Daniel Theis,F-C,22023,1628464,22300537,"JAN 12, 2024",LAC @ MEM,W,22,2,4,0.5,1,1,1.0,2,4,0.5,2,3,5,4,2,3,0,2,7,14,1,LAC,MEM,LAC,128,,,16,12,11,9
Daniel Theis,F-C,22023,1628464,22300511,"JAN 08, 2024",LAC vs. PHX,W,14,3,6,0.5,0,1,0.0,0,0,0.0,2,1,3,3,1,1,1,3,6,15,1,LAC,LAC,PHX,138,,,12,9,9,6
Daniel Theis,F-C,22023,1628464,22300486,"JAN 05, 2024",LAC @ NOP,W,17,1,3,0.333,0,1,0.0,0,0,0.0,2,3,5,0,0,0,1,1,2,13,1,LAC,NOP,LAC,111,,,7,7,2,5
Daniel Theis,F-C,22023,1628464,22300458,"JAN 01, 2024",LAC vs. MIA,W,16,2,3,0.667,0,1,0.0,2,2,1.0,0,1,1,0,0,0,2,3,6,-8,1,LAC,LAC,MIA,121,,,7,7,6,1
Daniel Theis,F-C,22023,1628464,22300389,"DEC 23, 2023",LAC vs. BOS,L,21,5,5,1.0,2,2,1.0,3,3,1.0,0,1,1,1,1,0,0,2,15,-9,1,LAC,LAC,BOS,108,,,17,16,16,2
Daniel Theis,F-C,22023,1628464,22300379,"DEC 21, 2023",LAC @ OKC,L,15,2,2,1.0,0,0,0.0,0,0,0.0,0,1,1,0,0,1,2,1,4,-14,1,LAC,OKC,LAC,115,,,5,5,4,1
Daniel Theis,F-C,22023,1628464,22300350,"DEC 18, 2023",LAC @ IND,W,22,1,4,0.25,0,0,0.0,2,2,1.0,5,4,9,0,0,2,2,2,4,0,1,LAC,IND,LAC,151,,,13,13,4,9
Daniel Theis,F-C,22023,1628464,22300343,"DEC 16, 2023",LAC vs. NYK,W,15,1,3,0.333,0,0,0.0,5,6,0.833,0,1,1,0,1,0,0,4,7,-3,1,LAC,LAC,NYK,144,,,8,8,7,1
Daniel Theis,F-C,22023,1628464,22300171,"NOV 09, 2023",IND vs. MIL,W,8,1,4,0.25,0,1,0.0,0,0,0.0,0,0,0,0,0,0,0,1,2,0,1,IND,IND,MIL,126,,,2,2,2,0
Daniel Theis,F-C,22023,1628464,22300618,"JAN 23, 2024",LAC vs. LAL,W,21,1,3,0.333,0,2,0.0,1,1,1.0,1,1,2,2,1,0,0,5,3,-2,1,LAC,LAC,LAL,127,,,7,5,5,4
Daniel Theis,F-C,22023,1628464,22300438,"DEC 29, 2023",LAC vs. MEM,W,13,2,3,0.667,0,1,0.0,1,2,0.5,1,1,2,0,0,2,1,3,5,-1,1,LAC,LAC,MEM,117,,,7,7,5,2
Daniel Theis,F-C,22023,1628464,22300414,"DEC 26, 2023",LAC vs. CHA,W,15,5,7,0.714,0,0,0.0,0,0,0.0,2,2,4,0,0,0,1,0,10,-2,1,LAC,LAC,CHA,113,,,14,14,10,4
Daniel Theis,F-C,22023,1628464,22300325,"DEC 14, 2023",LAC vs. GSW,W,16,0,2,0.0,0,1,0.0,4,4,1.0,0,1,1,1,1,1,0,2,4,8,1,LAC,LAC,GSW,121,,,6,5,5,2
Daniel Theis,F-C,22023,1628464,22300309,"DEC 12, 2023",LAC vs. SAC,W,16,4,8,0.5,0,1,0.0,0,0,0.0,1,2,3,0,1,0,0,2,8,15,1,LAC,LAC,SAC,117,,,11,11,8,3
Daniel Theis,F-C,22023,1628464,22300304,"DEC 11, 2023",LAC vs. POR,W,14,1,3,0.333,1,1,1.0,0,0,0.0,0,0,0,0,1,1,0,2,3,1,1,LAC,LAC,POR,132,,,3,3,3,0
Daniel Theis,F-C,22023,1628464,22301215,"DEC 06, 2023",LAC vs. DEN,W,21,3,8,0.375,2,4,0.5,0,0,0.0,5,6,11,0,0,3,1,2,8,14,1,LAC,LAC,DEN,111,,,19,19,8,11
Daniel Theis,F-C,22023,1628464,22300280,"DEC 02, 2023",LAC vs. GSW,W,22,6,11,0.545,0,2,0.0,0,0,0.0,2,2,4,1,1,2,1,3,12,-1,1,LAC,LAC,GSW,113,,,17,16,13,5
Daniel Theis,F-C,22023,1628464,22300273,"NOV 30, 2023",LAC @ GSW,L,15,4,9,0.444,1,1,1.0,1,2,0.5,1,1,2,2,0,0,0,2,10,-20,1,LAC,GSW,LAC,114,,,14,12,12,4
Daniel Theis,F-C,22023,1628464,22300264,"NOV 29, 2023",LAC @ SAC,W,17,2,5,0.4,0,0,0.0,1,2,0.5,3,0,3,0,0,0,0,5,5,-12,1,LAC,SAC,LAC,131,,,8,8,5,3
Daniel Theis,F-C,22023,1628464,22300244,"NOV 25, 2023",LAC vs. DAL,W,16,2,6,0.333,0,1,0.0,1,2,0.5,2,1,3,0,0,1,1,2,5,-1,1,LAC,LAC,DAL,107,,,8,8,5,3
Daniel Theis,F-C,22023,1628464,22300716,"FEB 05, 2024",LAC @ ATL,W,19,4,7,0.571,1,1,1.0,0,0,0.0,2,6,8,2,0,0,0,3,9,-5,1,LAC,ATL,LAC,149,,,19,17,11,10
Daniel Theis,F-C,22023,1628464,22300600,"JAN 21, 2024",LAC vs. BKN,W,17,4,6,0.667,0,1,0.0,0,0,0.0,2,1,3,1,0,2,1,1,8,0,1,LAC,LAC,BKN,125,,,12,11,9,4
Daniel Theis,F-C,22023,1628464,22300568,"JAN 16, 2024",LAC vs. OKC,W,20,4,6,0.667,1,2,0.5,0,0,0.0,5,3,8,0,0,3,2,3,9,-2,1,LAC,LAC,OKC,128,,,17,17,9,8
Daniel Theis,F-C,22023,1628464,22300553,"JAN 14, 2024",LAC @ MIN,L,22,1,3,0.333,1,2,0.5,0,0,0.0,1,3,4,0,1,0,0,3,3,-7,1,LAC,MIN,LAC,105,,,7,7,3,4
Daniel Theis,F-C,22023,1628464,22300526,"JAN 10, 2024",LAC vs. TOR,W,16,1,2,0.5,0,0,0.0,2,2,1.0,2,2,4,1,1,1,1,1,4,2,1,LAC,LAC,TOR,126,,,9,8,5,5
Daniel Theis,F-C,22023,1628464,22300505,"JAN 07, 2024",LAC @ LAL,L,9,1,3,0.333,0,0,0.0,0,0,0.0,1,2,3,0,0,1,0,0,2,-3,1,LAC,LAL,LAC,103,,,5,5,2,3
Daniel Theis,F-C,22023,1628464,22300473,"JAN 03, 2024",LAC @ PHX,W,20,3,5,0.6,0,0,0.0,0,0,0.0,1,2,3,1,1,0,0,3,6,8,1,LAC,PHX,LAC,131,,,10,9,7,4
Daniel Theis,F-C,22023,1628464,22300372,"DEC 20, 2023",LAC @ DAL,W,16,4,4,1.0,2,2,1.0,1,2,0.5,1,1,2,2,0,0,0,4,11,-1,1,LAC,DAL,LAC,120,,,15,13,13,4
Daniel Theis,F-C,22023,1628464,22300235,"NOV 22, 2023",LAC @ SAS,W,20,4,11,0.364,0,0,0.0,0,0,0.0,5,6,11,4,0,0,1,2,8,12,1,LAC,SAS,LAC,109,,,23,19,12,15
Daniel Theis,F-C,22023,1628464,22300223,"NOV 20, 2023",LAC @ SAS,W,21,8,10,0.8,1,1,1.0,2,2,1.0,3,4,7,2,1,0,1,4,19,18,1,LAC,SAS,LAC,124,,,28,26,21,9
Daniel Theis,F-C,22023,1628464,22300257,"NOV 27, 2023",LAC vs. DEN,L,12,2,4,0.5,0,0,0.0,0,0,0.0,1,0,1,1,0,2,1,3,4,0,1,LAC,LAC,DEN,104,,,6,5,5,2
Daniel Theis,F-C,22023,1628464,22300052,"NOV 24, 2023",LAC vs. NOP,L,21,1,3,0.333,1,2,0.5,0,0,0.0,0,4,4,2,0,3,1,2,3,5,1,LAC,LAC,NOP,106,,,9,7,5,6
Daniel Theis,F-C,22023,1628464,22300037,"NOV 17, 2023",LAC vs. HOU,W,10,1,3,0.333,0,1,0.0,0,2,0.0,0,3,3,0,1,0,0,2,2,-6,1,LAC,LAC,HOU,106,,,5,5,2,3
Daniel Theis,F-C,22023,1628464,22300731,"FEB 07, 2024",LAC vs. NOP,L,7,0,1,0.0,0,0,0.0,2,2,1.0,0,1,1,0,0,0,0,1,2,1,1,LAC,LAC,NOP,106,,,3,3,2,1
Daniel Theis,F-C,22023,1628464,22300688,"FEB 02, 2024",LAC @ DET,W,18,2,3,0.667,0,1,0.0,1,2,0.5,0,3,3,2,1,2,2,3,5,11,1,LAC,DET,LAC,136,,,10,8,7,5
Daniel Theis,F-C,22023,1628464,22300676,"JAN 31, 2024",LAC @ WAS,W,20,2,5,0.4,0,1,0.0,0,0,0.0,1,1,2,0,1,1,0,3,4,-9,1,LAC,WAS,LAC,125,,,6,6,4,2
Daniel Theis,F-C,22023,1628464,22300658,"JAN 29, 2024",LAC @ CLE,L,17,0,1,0.0,0,1,0.0,0,0,0.0,1,3,4,5,0,0,1,3,0,-1,1,LAC,CLE,LAC,108,,,9,4,5,9
Daniel Theis,F-C,22023,1628464,22300646,"JAN 27, 2024",LAC @ BOS,W,26,8,9,0.889,2,3,0.667,0,1,0.0,1,6,7,2,1,2,0,4,18,-3,1,LAC,BOS,LAC,115,,,27,25,20,9
Daniel Theis,F-C,22023,1628464,22300637,"JAN 26, 2024",LAC @ TOR,W,18,3,4,0.75,0,0,0.0,0,0,0.0,2,2,4,1,0,0,2,1,6,6,1,LAC,TOR,LAC,127,,,11,10,7,5
Daniel Theis,F-C,22023,1628464,22300537,"JAN 12, 2024",LAC @ MEM,W,22,2,4,0.5,1,1,1.0,2,4,0.5,2,3,5,4,2,3,0,2,7,14,1,LAC,MEM,LAC,128,,,16,12,11,9
Daniel Theis,F-C,22023,1628464,22300511,"JAN 08, 2024",LAC vs. PHX,W,14,3,6,0.5,0,1,0.0,0,0,0.0,2,1,3,3,1,1,1,3,6,15,1,LAC,LAC,PHX,138,,,12,9,9,6
Daniel Theis,F-C,22023,1628464,22300486,"JAN 05, 2024",LAC @ NOP,W,17,1,3,0.333,0,1,0.0,0,0,0.0,2,3,5,0,0,0,1,1,2,13,1,LAC,NOP,LAC,111,,,7,7,2,5
Daniel Theis,F-C,22023,1628464,22300458,"JAN 01, 2024",LAC vs. MIA,W,16,2,3,0.667,0,1,0.0,2,2,1.0,0,1,1,0,0,0,2,3,6,-8,1,LAC,LAC,MIA,121,,,7,7,6,1
Daniel Theis,F-C,22023,1628464,22300389,"DEC 23, 2023",LAC vs. BOS,L,21,5,5,1.0,2,2,1.0,3,3,1.0,0,1,1,1,1,0,0,2,15,-9,1,LAC,LAC,BOS,108,,,17,16,16,2
Daniel Theis,F-C,22023,1628464,22300379,"DEC 21, 2023",LAC @ OKC,L,15,2,2,1.0,0,0,0.0,0,0,0.0,0,1,1,0,0,1,2,1,4,-14,1,LAC,OKC,LAC,115,,,5,5,4,1
Daniel Theis,F-C,22023,1628464,22300350,"DEC 18, 2023",LAC @ IND,W,22,1,4,0.25,0,0,0.0,2,2,1.0,5,4,9,0,0,2,2,2,4,0,1,LAC,IND,LAC,151,,,13,13,4,9
Daniel Theis,F-C,22023,1628464,22300343,"DEC 16, 2023",LAC vs. NYK,W,15,1,3,0.333,0,0,0.0,5,6,0.833,0,1,1,0,1,0,0,4,7,-3,1,LAC,LAC,NYK,144,,,8,8,7,1
Daniel Theis,F-C,22023,1628464,22300171,"NOV 09, 2023",IND vs. MIL,W,8,1,4,0.25,0,1,0.0,0,0,0.0,0,0,0,0,0,0,0,1,2,0,1,IND,IND,MIL,126,,,2,2,2,0
Daniel Theis,F-C,22023,1628464,22300618,"JAN 23, 2024",LAC vs. LAL,W,21,1,3,0.333,0,2,0.0,1,1,1.0,1,1,2,2,1,0,0,5,3,-2,1,LAC,LAC,LAL,127,,,7,5,5,4
Daniel Theis,F-C,22023,1628464,22300438,"DEC 29, 2023",LAC vs. MEM,W,13,2,3,0.667,0,1,0.0,1,2,0.5,1,1,2,0,0,2,1,3,5,-1,1,LAC,LAC,MEM,117,,,7,7,5,2
Daniel Theis,F-C,22023,1628464,22300414,"DEC 26, 2023",LAC vs. CHA,W,15,5,7,0.714,0,0,0.0,0,0,0.0,2,2,4,0,0,0,1,0,10,-2,1,LAC,LAC,CHA,113,,,14,14,10,4
Daniel Theis,F-C,22023,1628464,22300325,"DEC 14, 2023",LAC vs. GSW,W,16,0,2,0.0,0,1,0.0,4,4,1.0,0,1,1,1,1,1,0,2,4,8,1,LAC,LAC,GSW,121,,,6,5,5,2
Daniel Theis,F-C,22023,1628464,22300309,"DEC 12, 2023",LAC vs. SAC,W,16,4,8,0.5,0,1,0.0,0,0,0.0,1,2,3,0,1,0,0,2,8,15,1,LAC,LAC,SAC,117,,,11,11,8,3
Daniel Theis,F-C,22023,1628464,22300304,"DEC 11, 2023",LAC vs. POR,W,14,1,3,0.333,1,1,1.0,0,0,0.0,0,0,0,0,1,1,0,2,3,1,1,LAC,LAC,POR,132,,,3,3,3,0
Daniel Theis,F-C,22023,1628464,22301215,"DEC 06, 2023",LAC vs. DEN,W,21,3,8,0.375,2,4,0.5,0,0,0.0,5,6,11,0,0,3,1,2,8,14,1,LAC,LAC,DEN,111,,,19,19,8,11
Daniel Theis,F-C,22023,1628464,22300280,"DEC 02, 2023",LAC vs. GSW,W,22,6,11,0.545,0,2,0.0,0,0,0.0,2,2,4,1,1,2,1,3,12,-1,1,LAC,LAC,GSW,113,,,17,16,13,5
Daniel Theis,F-C,22023,1628464,22300273,"NOV 30, 2023",LAC @ GSW,L,15,4,9,0.444,1,1,1.0,1,2,0.5,1,1,2,2,0,0,0,2,10,-20,1,LAC,GSW,LAC,114,,,14,12,12,4
Daniel Theis,F-C,22023,1628464,22300264,"NOV 29, 2023",LAC @ SAC,W,17,2,5,0.4,0,0,0.0,1,2,0.5,3,0,3,0,0,0,0,5,5,-12,1,LAC,SAC,LAC,131,,,8,8,5,3
Daniel Theis,F-C,22023,1628464,22300244,"NOV 25, 2023",LAC vs. DAL,W,16,2,6,0.333,0,1,0.0,1,2,0.5,2,1,3,0,0,1,1,2,5,-1,1,LAC,LAC,DAL,107,,,8,8,5,3
Daniel Theis,F-C,22023,1628464,22300716,"FEB 05, 2024",LAC @ ATL,W,19,4,7,0.571,1,1,1.0,0,0,0.0,2,6,8,2,0,0,0,3,9,-5,1,LAC,ATL,LAC,149,,,19,17,11,10
Daniel Theis,F-C,22023,1628464,22300600,"JAN 21, 2024",LAC vs. BKN,W,17,4,6,0.667,0,1,0.0,0,0,0.0,2,1,3,1,0,2,1,1,8,0,1,LAC,LAC,BKN,125,,,12,11,9,4
Daniel Theis,F-C,22023,1628464,22300568,"JAN 16, 2024",LAC vs. OKC,W,20,4,6,0.667,1,2,0.5,0,0,0.0,5,3,8,0,0,3,2,3,9,-2,1,LAC,LAC,OKC,128,,,17,17,9,8
Daniel Theis,F-C,22023,1628464,22300553,"JAN 14, 2024",LAC @ MIN,L,22,1,3,0.333,1,2,0.5,0,0,0.0,1,3,4,0,1,0,0,3,3,-7,1,LAC,MIN,LAC,105,,,7,7,3,4
Daniel Theis,F-C,22023,1628464,22300526,"JAN 10, 2024",LAC vs. TOR,W,16,1,2,0.5,0,0,0.0,2,2,1.0,2,2,4,1,1,1,1,1,4,2,1,LAC,LAC,TOR,126,,,9,8,5,5
Daniel Theis,F-C,22023,1628464,22300505,"JAN 07, 2024",LAC @ LAL,L,9,1,3,0.333,0,0,0.0,0,0,0.0,1,2,3,0,0,1,0,0,2,-3,1,LAC,LAL,LAC,103,,,5,5,2,3
Daniel Theis,F-C,22023,1628464,22300473,"JAN 03, 2024",LAC @ PHX,W,20,3,5,0.6,0,0,0.0,0,0,0.0,1,2,3,1,1,0,0,3,6,8,1,LAC,PHX,LAC,131,,,10,9,7,4
Daniel Theis,F-C,22023,1628464,22300372,"DEC 20, 2023",LAC @ DAL,W,16,4,4,1.0,2,2,1.0,1,2,0.5,1,1,2,2,0,0,0,4,11,-1,1,LAC,DAL,LAC,120,,,15,13,13,4
Daniel Theis,F-C,22023,1628464,22300235,"NOV 22, 2023",LAC @ SAS,W,20,4,11,0.364,0,0,0.0,0,0,0.0,5,6,11,4,0,0,1,2,8,12,1,LAC,SAS,LAC,109,,,23,19,12,15
Daniel Theis,F-C,22023,1628464,22300223,"NOV 20, 2023",LAC @ SAS,W,21,8,10,0.8,1,1,1.0,2,2,1.0,3,4,7,2,1,0,1,4,19,18,1,LAC,SAS,LAC,124,,,28,26,21,9
Daniel Theis,F-C,22023,1628464,22300257,"NOV 27, 2023",LAC vs. DEN,L,12,2,4,0.5,0,0,0.0,0,0,0.0,1,0,1,1,0,2,1,3,4,0,1,LAC,LAC,DEN,104,,,6,5,5,2
Daniel Theis,F-C,22023,1628464,22300052,"NOV 24, 2023",LAC vs. NOP,L,21,1,3,0.333,1,2,0.5,0,0,0.0,0,4,4,2,0,3,1,2,3,5,1,LAC,LAC,NOP,106,,,9,7,5,6
Daniel Theis,F-C,22023,1628464,22300037,"NOV 17, 2023",LAC vs. HOU,W,10,1,3,0.333,0,1,0.0,0,2,0.0,0,3,3,0,1,0,0,2,2,-6,1,LAC,LAC,HOU,106,,,5,5,2,3
Toumani Camara,F,22023,1641739,22300758,"FEB 10, 2024",POR vs. NOP,L,20,2,8,0.25,1,3,0.333,0,0,0.0,0,3,3,1,1,0,3,1,5,3,1,POR,POR,NOP,75,,,9,8,6,4
Toumani Camara,F,22023,1641739,22300712,"FEB 04, 2024",POR @ DEN,L,23,4,6,0.667,2,3,0.667,0,0,0.0,2,4,6,0,0,0,1,4,10,10,1,POR,DEN,POR,103,,,16,16,10,6
Toumani Camara,F,22023,1641739,22300697,"FEB 02, 2024",POR @ DEN,L,24,3,6,0.5,0,2,0.0,4,4,1.0,0,2,2,0,2,1,1,1,10,-11,1,POR,DEN,POR,108,,,12,12,10,2
Toumani Camara,F,22023,1641739,22300683,"JAN 31, 2024",POR vs. MIL,W,23,2,3,0.667,0,0,0.0,0,0,0.0,1,3,4,2,2,0,0,2,4,0,1,POR,POR,MIL,119,,,10,8,6,6
Toumani Camara,F,22023,1641739,22300668,"JAN 29, 2024",POR vs. PHI,W,16,2,4,0.5,1,3,0.333,1,2,0.5,2,1,3,3,1,0,1,1,6,4,1,POR,POR,PHI,128,,,12,9,9,6
Toumani Camara,F,22023,1641739,22300656,"JAN 28, 2024",POR vs. CHI,L,3,1,1,1.0,0,0,0.0,0,0,0.0,0,1,1,0,0,0,0,0,2,-1,1,POR,POR,CHI,96,,,3,3,2,1
Toumani Camara,F,22023,1641739,22300641,"JAN 26, 2024",POR @ SAS,L,23,4,9,0.444,0,1,0.0,4,4,1.0,2,2,4,1,2,1,3,0,12,-9,1,POR,SAS,POR,98,,,17,16,13,5
Toumani Camara,F,22023,1641739,22300623,"JAN 24, 2024",POR @ HOU,W,17,1,4,0.25,0,0,0.0,2,2,1.0,1,3,4,1,2,0,0,3,4,-1,1,POR,HOU,POR,137,,,9,8,5,5
Toumani Camara,F,22023,1641739,22300617,"JAN 23, 2024",POR @ OKC,L,14,0,2,0.0,0,0,0.0,0,0,0.0,2,3,5,1,2,0,0,2,0,5,1,POR,OKC,POR,109,,,6,5,1,6
Toumani Camara,F,22023,1641739,22300605,"JAN 21, 2024",POR @ LAL,L,23,2,5,0.4,0,2,0.0,1,2,0.5,1,4,5,1,2,0,1,3,5,5,1,POR,LAL,POR,108,,,11,10,6,6
Toumani Camara,F,22023,1641739,22300590,"JAN 19, 2024",POR vs. IND,W,19,1,3,0.333,0,0,0.0,2,2,1.0,1,3,4,0,0,0,1,2,4,11,1,POR,POR,IND,118,,,8,8,4,4
Toumani Camara,F,22023,1641739,22300399,"DEC 23, 2023",POR @ GSW,L,25,2,3,0.667,0,0,0.0,2,2,1.0,0,2,2,0,1,1,1,1,6,-2,1,POR,GSW,POR,106,,,8,8,6,2
Toumani Camara,F,22023,1641739,22300381,"DEC 21, 2023",POR vs. WAS,L,18,2,3,0.667,0,1,0.0,0,0,0.0,1,2,3,0,1,0,0,3,4,-16,1,POR,POR,WAS,117,,,7,7,4,3
Toumani Camara,F,22023,1641739,22300363,"DEC 19, 2023",POR vs. PHX,W,22,2,4,0.5,1,1,1.0,0,0,0.0,3,6,9,0,3,1,2,3,5,-8,1,POR,POR,PHX,109,,,14,14,5,9
Toumani Camara,F,22023,1641739,22300348,"DEC 17, 2023",POR vs. GSW,L,22,3,4,0.75,3,3,1.0,2,4,0.5,1,2,3,0,2,0,1,2,11,-5,1,POR,POR,GSW,114,,,14,14,11,3
Toumani Camara,F,22023,1641739,22300341,"DEC 16, 2023",POR vs. DAL,L,20,3,7,0.429,0,4,0.0,2,2,1.0,0,3,3,1,1,0,0,3,8,5,1,POR,POR,DAL,120,,,12,11,9,4
Toumani Camara,F,22023,1641739,22300323,"DEC 14, 2023",POR vs. UTA,L,24,7,10,0.7,3,4,0.75,1,2,0.5,4,2,6,0,0,0,1,3,18,-24,1,POR,POR,UTA,114,,,24,24,18,6
Toumani Camara,F,22023,1641739,22300289,"DEC 02, 2023",POR @ UTA,L,30,4,8,0.5,0,3,0.0,0,0,0.0,2,1,3,0,4,1,0,4,8,-5,1,POR,UTA,POR,113,,,11,11,8,3
Toumani Camara,F,22023,1641739,22300265,"NOV 30, 2023",POR @ CLE,W,24,4,6,0.667,1,3,0.333,0,0,0.0,1,1,2,1,2,1,1,0,9,-2,1,POR,CLE,POR,103,,,12,11,10,3
Toumani Camara,F,22023,1641739,22300254,"NOV 27, 2023",POR @ IND,W,17,1,3,0.333,1,2,0.5,2,2,1.0,2,0,2,0,0,0,0,2,5,0,1,POR,IND,POR,114,,,7,7,5,2
Toumani Camara,F,22023,1641739,22300245,"NOV 26, 2023",POR @ MIL,L,17,2,3,0.667,2,2,1.0,0,0,0.0,2,1,3,0,0,0,2,4,6,-3,1,POR,MIL,POR,102,,,9,9,6,3
Toumani Camara,F,22023,1641739,22300041,"NOV 21, 2023",POR @ PHX,L,39,2,4,0.5,0,2,0.0,3,4,0.75,0,4,4,0,1,0,1,4,7,-16,1,POR,PHX,POR,107,,,11,11,7,4
Toumani Camara,F,22023,1641739,22300215,"NOV 19, 2023",POR vs. OKC,L,15,3,5,0.6,0,2,0.0,0,0,0.0,0,2,2,0,0,0,1,4,6,-15,1,POR,POR,OKC,89,,,8,8,6,2
Toumani Camara,F,22023,1641739,22300036,"NOV 17, 2023",POR vs. LAL,L,36,3,8,0.375,1,6,0.167,3,5,0.6,2,4,6,0,2,1,1,3,10,-7,1,POR,POR,LAL,95,,,16,16,10,6
Toumani Camara,F,22023,1641739,22300199,"NOV 15, 2023",POR vs. CLE,L,22,0,4,0.0,0,3,0.0,0,0,0.0,0,1,1,3,2,0,1,1,0,-12,1,POR,POR,CLE,93,,,4,1,3,4
Toumani Camara,F,22023,1641739,22300023,"NOV 14, 2023",POR @ UTA,L,26,3,6,0.5,2,4,0.5,1,2,0.5,2,3,5,1,0,2,2,2,9,-8,1,POR,UTA,POR,99,,,15,14,10,6
Toumani Camara,F,22023,1641739,22300187,"NOV 12, 2023",POR @ LAL,L,24,1,3,0.333,0,2,0.0,0,0,0.0,4,2,6,2,0,1,2,5,2,0,1,POR,LAL,POR,104,,,10,8,4,8
Toumani Camara,F,22023,1641739,22300170,"NOV 08, 2023",POR @ SAC,L,25,1,2,0.5,0,0,0.0,0,0,0.0,1,3,4,1,3,0,1,3,2,7,1,POR,SAC,POR,118,,,7,6,3,5
Toumani Camara,F,22023,1641739,22300144,"NOV 05, 2023",POR vs. MEM,L,24,3,5,0.6,2,3,0.667,0,0,0.0,3,3,6,2,1,0,3,1,8,-4,1,POR,POR,MEM,100,,,16,14,10,8
Toumani Camara,F,22023,1641739,22300007,"NOV 03, 2023",POR vs. MEM,W,31,2,8,0.25,0,3,0.0,1,1,1.0,3,0,3,1,2,0,1,4,5,2,1,POR,POR,MEM,115,,,9,8,6,4
Toumani Camara,F,22023,1641739,22300115,"NOV 01, 2023",POR @ DET,W,26,2,3,0.667,0,0,0.0,3,3,1.0,2,5,7,0,1,1,1,2,7,6,1,POR,DET,POR,110,,,14,14,7,7
Toumani Camara,F,22023,1641739,22300105,"OCT 30, 2023",POR @ TOR,W,23,1,4,0.25,0,2,0.0,1,2,0.5,2,5,7,0,0,1,1,2,3,12,1,POR,TOR,POR,99,,,10,10,3,7
Toumani Camara,F,22023,1641739,22300098,"OCT 29, 2023",POR @ PHI,L,28,5,16,0.313,1,5,0.2,1,2,0.5,3,0,3,2,0,2,0,3,12,-13,1,POR,PHI,POR,98,,,17,15,14,5
Toumani Camara,F,22023,1641739,22300086,"OCT 27, 2023",POR vs. ORL,L,23,0,4,0.0,0,2,0.0,2,2,1.0,1,3,4,3,0,0,0,0,2,2,1,POR,POR,ORL,97,,,9,6,5,7
Toumani Camara,F,22023,1641739,22300074,"OCT 25, 2023",POR @ LAC,L,16,2,5,0.4,2,2,1.0,1,2,0.5,0,2,2,1,0,1,0,2,7,13,1,POR,LAC,POR,111,,,10,9,8,3
Toumani Camara,F,22023,1641739,22300578,"JAN 17, 2024",POR vs. BKN,W,20,3,4,0.75,0,0,0.0,0,0,0.0,2,4,6,1,0,0,0,2,6,5,1,POR,POR,BKN,103,,,13,12,7,7
Toumani Camara,F,22023,1641739,22300538,"JAN 12, 2024",POR @ MIN,L,25,5,8,0.625,1,3,0.333,3,4,0.75,2,3,5,0,0,1,3,1,14,-15,1,POR,MIN,POR,91,,,19,19,14,5
Toumani Camara,F,22023,1641739,22300514,"JAN 09, 2024",POR @ NYK,L,26,2,4,0.5,1,3,0.333,0,0,0.0,3,3,6,2,1,2,2,3,5,-3,1,POR,NYK,POR,80,,,13,11,7,8
Toumani Camara,F,22023,1641739,22300498,"JAN 07, 2024",POR @ BKN,W,29,1,4,0.25,0,2,0.0,3,4,0.75,1,5,6,1,1,0,2,4,5,0,1,POR,BKN,POR,134,,,12,11,6,7
Toumani Camara,F,22023,1641739,22300487,"JAN 05, 2024",POR @ DAL,L,24,4,10,0.4,2,7,0.286,0,1,0.0,1,6,7,1,1,0,2,2,10,-11,1,POR,DAL,POR,103,,,18,17,11,8
Toumani Camara,F,22023,1641739,22300472,"JAN 03, 2024",POR @ DAL,L,20,3,8,0.375,2,4,0.5,2,3,0.667,2,3,5,0,2,1,2,6,10,-11,1,POR,DAL,POR,97,,,15,15,10,5
Toumani Camara,F,22023,1641739,22300437,"DEC 29, 2023",POR vs. SAS,W,36,6,12,0.5,1,3,0.333,0,0,0.0,4,7,11,2,3,0,3,1,13,9,1,POR,POR,SAS,132,,,26,24,15,13
Toumani Camara,F,22023,1641739,22300427,"DEC 28, 2023",POR vs. SAS,L,21,0,5,0.0,0,1,0.0,1,2,0.5,3,4,7,0,0,0,1,1,1,-11,1,POR,POR,SAS,98,,,8,8,1,7
Toumani Camara,F,22023,1641739,22300413,"DEC 26, 2023",POR vs. SAC,W,18,2,5,0.4,0,1,0.0,0,0,0.0,2,1,3,1,0,0,1,1,4,0,1,POR,POR,SAC,130,,,8,7,5,4
Toumani Camara,F,22023,1641739,22301214,"DEC 06, 2023",POR @ GSW,L,27,3,14,0.214,0,4,0.0,0,0,0.0,5,8,13,2,0,0,3,6,6,-3,1,POR,GSW,POR,106,,,21,19,8,15
Toumani Camara,F,22023,1641739,22300237,"NOV 22, 2023",POR vs. UTA,W,28,4,8,0.5,2,4,0.5,2,2,1.0,3,4,7,3,0,1,2,2,12,15,1,POR,POR,UTA,121,,,22,19,15,10
Toumani Camara,F,22023,1641739,22300304,"DEC 11, 2023",POR @ LAC,L,37,3,6,0.5,1,3,0.333,0,2,0.0,0,4,4,4,1,1,1,5,7,-5,1,POR,LAC,POR,127,,,15,11,11,8
Toumani Camara,F,22023,1641739,22300741,"FEB 08, 2024",POR vs. DET,L,36,4,7,0.571,1,1,1.0,0,0,0.0,4,6,10,1,1,0,1,5,9,-9,1,POR,POR,DET,118,,,20,19,10,11
Toumani Camara,F,22023,1641739,22300554,"JAN 14, 2024",POR vs. PHX,L,23,1,4,0.25,0,2,0.0,0,0,0.0,2,0,2,2,0,0,0,1,2,-6,1,POR,POR,PHX,116,,,6,4,4,4
Toumani Camara,F,22023,1641739,22300529,"JAN 11, 2024",POR @ OKC,L,32,2,9,0.222,1,6,0.167,1,2,0.5,2,3,5,1,2,2,2,3,6,-38,1,POR,OKC,POR,77,,,12,11,7,6
Toumani Camara,F,22023,1641739,22301226,"DEC 08, 2023",POR vs. DAL,L,32,6,20,0.3,2,10,0.2,0,0,0.0,6,3,9,0,1,0,0,5,14,-23,1,POR,POR,DAL,112,,,23,23,14,9
Aaron Holiday,G,22023,1628988,22300754,"FEB 10, 2024",HOU @ ATL,L,22,7,10,0.7,3,5,0.6,1,1,1.0,0,1,1,2,0,1,0,4,18,1,1,HOU,ATL,HOU,113,,,21,19,20,3
Aaron Holiday,G,22023,1628988,22300744,"FEB 09, 2024",HOU @ TOR,L,31,5,13,0.385,2,8,0.25,0,0,0.0,0,3,3,5,1,0,1,2,12,15,1,HOU,TOR,HOU,104,,,20,15,17,8
Aaron Holiday,G,22023,1628988,22300719,"FEB 06, 2024",HOU @ IND,L,20,3,3,1.0,2,2,1.0,0,0,0.0,0,2,2,5,0,0,1,1,8,-10,1,HOU,IND,HOU,129,,,15,10,13,7
Aaron Holiday,G,22023,1628988,22300709,"FEB 04, 2024",HOU @ MIN,L,16,1,3,0.333,0,1,0.0,3,3,1.0,0,2,2,2,2,0,1,3,5,10,1,HOU,MIN,HOU,90,,,9,7,7,4
Aaron Holiday,G,22023,1628988,22300692,"FEB 02, 2024",HOU vs. TOR,W,12,1,2,0.5,1,2,0.5,0,0,0.0,0,0,0,2,1,0,2,1,3,-1,1,HOU,HOU,TOR,135,,,5,3,5,2
Aaron Holiday,G,22023,1628988,22300679,"JAN 31, 2024",HOU vs. NOP,L,17,0,4,0.0,0,4,0.0,0,0,0.0,1,0,1,1,0,0,0,1,0,9,1,HOU,HOU,NOP,99,,,2,1,1,2
Aaron Holiday,G,22023,1628988,22300645,"JAN 27, 2024",HOU @ BKN,L,18,3,6,0.5,0,0,0.0,0,0,0.0,1,2,3,1,0,0,2,2,6,1,1,HOU,BKN,HOU,104,,,10,9,7,4
Aaron Holiday,G,22023,1628988,22300635,"JAN 26, 2024",HOU @ CHA,W,19,4,6,0.667,2,4,0.5,0,0,0.0,0,1,1,6,0,0,2,2,10,12,1,HOU,CHA,HOU,138,,,17,11,16,7
Aaron Holiday,G,22023,1628988,22300623,"JAN 24, 2024",HOU vs. POR,L,30,2,4,0.5,2,3,0.667,6,6,1.0,0,3,3,2,1,0,0,0,12,4,1,HOU,HOU,POR,131,,,17,15,14,5
Aaron Holiday,G,22023,1628988,22300603,"JAN 21, 2024",HOU vs. BOS,L,27,5,8,0.625,2,5,0.4,0,0,0.0,0,4,4,5,1,0,2,4,12,5,1,HOU,HOU,BOS,107,,,21,16,17,9
Aaron Holiday,G,22023,1628988,22300598,"JAN 20, 2024",HOU vs. UTA,W,9,2,2,1.0,0,0,0.0,2,2,1.0,0,0,0,0,3,0,0,2,6,-1,1,HOU,HOU,UTA,127,,,6,6,6,0
Aaron Holiday,G,22023,1628988,22300573,"JAN 17, 2024",HOU @ NYK,L,4,0,0,0.0,0,0,0.0,0,0,0.0,0,1,1,1,0,0,0,0,0,4,1,HOU,NYK,HOU,94,,,2,1,1,2
Aaron Holiday,G,22023,1628988,22300555,"JAN 15, 2024",HOU @ PHI,L,6,0,1,0.0,0,1,0.0,0,0,0.0,0,1,1,1,0,0,0,0,0,-5,1,HOU,PHI,HOU,115,,,2,1,1,2
Aaron Holiday,G,22023,1628988,22300542,"JAN 13, 2024",HOU @ BOS,L,9,2,6,0.333,0,3,0.0,1,2,0.5,0,0,0,1,0,0,0,0,5,-13,1,HOU,BOS,HOU,113,,,6,5,6,1
Aaron Holiday,G,22023,1628988,22300409,"DEC 26, 2023",HOU vs. IND,L,25,6,10,0.6,3,6,0.5,0,0,0.0,0,3,3,1,1,0,1,1,15,9,1,HOU,HOU,IND,117,,,19,18,16,4
Aaron Holiday,G,22023,1628988,22300392,"DEC 23, 2023",HOU @ NOP,W,15,1,2,0.5,1,2,0.5,2,2,1.0,0,1,1,1,1,0,1,0,5,2,1,HOU,NOP,HOU,106,,,7,6,6,2
Aaron Holiday,G,22023,1628988,22300385,"DEC 22, 2023",HOU vs. DAL,W,15,1,3,0.333,1,3,0.333,0,0,0.0,0,3,3,0,0,0,2,0,3,-5,1,HOU,HOU,DAL,122,,,6,6,3,3
Aaron Holiday,G,22023,1628988,22300371,"DEC 20, 2023",HOU vs. ATL,L,26,3,8,0.375,2,5,0.4,0,0,0.0,0,2,2,0,0,0,2,1,8,2,1,HOU,HOU,ATL,127,,,10,10,8,2
Aaron Holiday,G,22023,1628988,22300349,"DEC 18, 2023",HOU @ CLE,L,17,5,9,0.556,2,5,0.4,2,2,1.0,1,1,2,0,0,0,0,4,14,3,1,HOU,CLE,HOU,130,,,16,16,14,2
Aaron Holiday,G,22023,1628988,22300346,"DEC 17, 2023",HOU @ MIL,L,13,0,3,0.0,0,1,0.0,0,0,0.0,0,1,1,2,1,0,2,2,0,-3,1,HOU,MIL,HOU,119,,,3,1,2,3
Aaron Holiday,G,22023,1628988,22300332,"DEC 15, 2023",HOU @ MEM,W,19,1,5,0.2,1,3,0.333,1,1,1.0,1,1,2,0,1,1,0,1,4,7,1,HOU,MEM,HOU,103,,,6,6,4,2
Aaron Holiday,G,22023,1628988,22300314,"DEC 13, 2023",HOU vs. MEM,W,14,2,6,0.333,2,3,0.667,0,0,0.0,0,0,0,2,0,1,1,2,6,-9,1,HOU,HOU,MEM,117,,,8,6,8,2
Aaron Holiday,G,22023,1628988,22300298,"DEC 11, 2023",HOU vs. SAS,W,15,1,6,0.167,1,5,0.2,4,4,1.0,1,1,2,0,0,0,0,2,7,14,1,HOU,HOU,SAS,93,,,9,9,7,2
Aaron Holiday,G,22023,1628988,22301224,"DEC 08, 2023",HOU @ DEN,W,16,3,5,0.6,2,2,1.0,0,1,0.0,0,1,1,1,0,0,2,1,8,19,1,HOU,DEN,HOU,114,,,10,9,9,2
Aaron Holiday,G,22023,1628988,22301212,"DEC 06, 2023",HOU vs. OKC,W,27,8,13,0.615,6,7,0.857,0,0,0.0,1,5,6,4,1,0,0,3,22,-5,1,HOU,HOU,OKC,110,,,32,28,26,10
Aaron Holiday,G,22023,1628988,22300291,"DEC 02, 2023",HOU @ LAL,L,14,5,6,0.833,1,2,0.5,0,0,0.0,1,0,1,3,0,0,0,2,11,6,1,HOU,LAL,HOU,97,,,15,12,14,4
Aaron Holiday,G,22023,1628988,22300263,"NOV 29, 2023",HOU @ DEN,L,35,4,10,0.4,0,5,0.0,1,1,1.0,0,3,3,5,0,0,0,2,9,-16,1,HOU,DEN,HOU,124,,,17,12,14,8
Aaron Holiday,G,22023,1628988,22300059,"NOV 28, 2023",HOU @ DAL,L,21,3,8,0.375,2,4,0.5,0,0,0.0,1,3,4,4,0,0,1,3,8,-6,1,HOU,DAL,HOU,115,,,16,12,12,8
Aaron Holiday,G,22023,1628988,22300048,"NOV 24, 2023",HOU vs. DEN,W,15,3,4,0.75,1,1,1.0,0,0,0.0,0,0,0,0,1,1,0,2,7,2,1,HOU,HOU,DEN,105,,,7,7,7,0
Aaron Holiday,G,22023,1628988,22300231,"NOV 22, 2023",HOU vs. MEM,W,17,3,6,0.5,1,4,0.25,0,0,0.0,0,3,3,2,0,0,0,3,7,2,1,HOU,HOU,MEM,111,,,12,10,9,5
Aaron Holiday,G,22023,1628988,22300224,"NOV 20, 2023",HOU @ GSW,L,28,4,5,0.8,3,4,0.75,2,3,0.667,0,4,4,1,4,0,0,3,13,8,1,HOU,GSW,HOU,116,,,18,17,14,5
Aaron Holiday,G,22023,1628988,22300216,"NOV 19, 2023",HOU @ LAL,L,15,0,3,0.0,0,2,0.0,0,0,0.0,0,0,0,5,0,0,1,4,0,2,1,HOU,LAL,HOU,104,,,5,0,5,5
Aaron Holiday,G,22023,1628988,22300037,"NOV 17, 2023",HOU @ LAC,L,18,2,3,0.667,1,2,0.5,0,0,0.0,0,1,1,2,1,0,0,2,5,9,1,HOU,LAC,HOU,100,,,8,6,7,3
Aaron Holiday,G,22023,1628988,22300182,"NOV 12, 2023",HOU vs. DEN,W,17,2,8,0.25,1,5,0.2,0,0,0.0,0,2,2,2,0,0,0,1,5,8,1,HOU,HOU,DEN,107,,,9,7,7,4
Aaron Holiday,G,22023,1628988,22300011,"NOV 10, 2023",HOU vs. NOP,W,14,1,5,0.2,1,3,0.333,2,2,1.0,0,0,0,2,1,0,0,0,5,8,1,HOU,HOU,NOP,104,,,7,5,7,2
Aaron Holiday,G,22023,1628988,22300163,"NOV 08, 2023",HOU vs. LAL,W,23,3,6,0.5,1,2,0.5,0,0,0.0,0,2,2,3,0,0,0,3,7,12,1,HOU,HOU,LAL,128,,,12,9,10,5
Aaron Holiday,G,22023,1628988,22300153,"NOV 06, 2023",HOU vs. SAC,W,21,6,6,1.0,0,0,0.0,1,1,1.0,0,3,3,1,1,0,2,1,13,16,1,HOU,HOU,SAC,122,,,17,16,14,4
Aaron Holiday,G,22023,1628988,22300137,"NOV 04, 2023",HOU vs. SAC,W,19,0,4,0.0,0,2,0.0,0,0,0.0,1,2,3,0,0,0,1,1,0,-1,1,HOU,HOU,SAC,107,,,3,3,0,3
Aaron Holiday,G,22023,1628988,22300122,"NOV 01, 2023",HOU vs. CHA,W,11,2,2,1.0,2,2,1.0,0,0,0.0,0,1,1,1,0,0,1,1,6,-1,1,HOU,HOU,CHA,128,,,8,7,7,2
Aaron Holiday,G,22023,1628988,22300066,"OCT 25, 2023",HOU @ ORL,L,5,0,3,0.0,0,1,0.0,0,0,0.0,0,0,0,0,0,0,0,0,0,-9,1,HOU,ORL,HOU,86,,,0,0,0,0
Aaron Holiday,G,22023,1628988,22300534,"JAN 12, 2024",HOU @ DET,W,3,0,0,0.0,0,0,0.0,0,0,0.0,0,1,1,0,0,0,0,0,0,-9,1,HOU,DET,HOU,112,,,1,1,0,1
Aaron Holiday,G,22023,1628988,22300485,"JAN 05, 2024",HOU vs. MIN,L,19,2,3,0.667,1,1,1.0,0,0,0.0,0,2,2,2,0,0,0,0,5,-14,1,HOU,HOU,MIN,95,,,9,7,7,4
Aaron Holiday,G,22023,1628988,22300469,"JAN 03, 2024",HOU vs. BKN,W,14,1,5,0.2,1,3,0.333,0,0,0.0,0,1,1,3,0,0,1,2,3,-5,1,HOU,HOU,BKN,112,,,7,4,6,4
Aaron Holiday,G,22023,1628988,22300453,"JAN 01, 2024",HOU vs. DET,W,11,0,3,0.0,0,1,0.0,0,0,0.0,1,2,3,4,0,0,0,1,0,8,1,HOU,HOU,DET,136,,,7,3,4,7
Aaron Holiday,G,22023,1628988,22300418,"DEC 27, 2023",HOU vs. PHX,L,24,4,13,0.308,3,8,0.375,2,2,1.0,0,2,2,2,0,0,2,2,13,-3,1,HOU,HOU,PHX,113,,,17,15,15,4
Aaron Holiday,G,22023,1628988,22300434,"DEC 29, 2023",HOU vs. PHI,L,15,2,6,0.333,0,2,0.0,0,0,0.0,1,1,2,3,2,0,3,2,4,-5,1,HOU,HOU,PHI,127,,,9,6,7,5
Aaron Holiday,G,22023,1628988,22300523,"JAN 10, 2024",HOU @ CHI,L,11,1,3,0.333,0,1,0.0,2,2,1.0,1,1,2,0,2,0,2,0,4,-1,1,HOU,CHI,HOU,119,,,6,6,4,2
Aaron Holiday,G,22023,1628988,22300509,"JAN 08, 2024",HOU @ MIA,L,23,2,6,0.333,1,5,0.2,3,3,1.0,0,4,4,1,1,0,0,2,8,10,1,HOU,MIA,HOU,113,,,13,12,9,5
Aaron Holiday,G,22023,1628988,22300496,"JAN 06, 2024",HOU vs. MIL,W,21,4,7,0.571,3,5,0.6,0,0,0.0,0,1,1,0,0,0,2,1,11,3,1,HOU,HOU,MIL,112,,,12,12,11,1
Goga Bitadze,C-F,22023,1629048,22300752,"FEB 10, 2024",ORL vs. CHI,W,14,2,2,1.0,0,0,0.0,1,3,0.333,1,1,2,0,0,1,0,1,5,10,1,ORL,ORL,CHI,114,,,7,7,5,2
Goga Bitadze,C-F,22023,1629048,22300734,"FEB 08, 2024",ORL vs. SAS,W,3,0,0,0.0,0,0,0.0,0,0,0.0,0,0,0,0,0,0,0,0,0,-3,1,ORL,ORL,SAS,127,,,0,0,0,0
Goga Bitadze,C-F,22023,1629048,22300721,"FEB 06, 2024",ORL @ MIA,L,3,0,0,0.0,0,0,0.0,0,0,0.0,0,1,1,1,0,0,1,0,0,-2,1,ORL,MIA,ORL,95,,,2,1,1,2
Goga Bitadze,C-F,22023,1629048,22300666,"JAN 29, 2024",ORL @ DAL,L,0,0,0,0.0,0,0,0.0,0,0,0.0,0,0,0,0,0,0,0,0,0,0,1,ORL,DAL,ORL,129,,,0,0,0,0
Goga Bitadze,C-F,22023,1629048,22300655,"JAN 28, 2024",ORL vs. PHX,W,2,0,0,0.0,0,0,0.0,0,0,0.0,0,0,0,0,0,1,0,0,0,1,1,ORL,ORL,PHX,113,,,0,0,0,0
Goga Bitadze,C-F,22023,1629048,22300607,"JAN 22, 2024",ORL vs. CLE,L,9,1,1,1.0,0,0,0.0,0,0,0.0,1,0,1,1,0,0,0,1,2,4,1,ORL,ORL,CLE,99,,,4,3,3,2
Goga Bitadze,C-F,22023,1629048,22300585,"JAN 19, 2024",ORL vs. PHI,L,16,1,2,0.5,0,1,0.0,0,0,0.0,0,2,2,1,1,1,1,4,2,-12,1,ORL,ORL,PHI,109,,,5,4,3,3
Goga Bitadze,C-F,22023,1629048,22300570,"JAN 17, 2024",ORL @ ATL,L,24,5,8,0.625,0,1,0.0,0,0,0.0,7,3,10,3,1,2,1,3,10,-2,1,ORL,ATL,ORL,104,,,23,20,13,13
Goga Bitadze,C-F,22023,1629048,22300557,"JAN 15, 2024",ORL @ NYK,W,29,1,3,0.333,0,0,0.0,1,2,0.5,4,7,11,3,0,0,0,3,3,-10,1,ORL,NYK,ORL,98,,,17,14,6,14
Goga Bitadze,C-F,22023,1629048,22300546,"JAN 13, 2024",ORL @ OKC,L,22,4,6,0.667,0,1,0.0,0,0,0.0,2,7,9,2,2,0,1,2,8,-1,1,ORL,OKC,ORL,100,,,19,17,10,11
Goga Bitadze,C-F,22023,1629048,22300535,"JAN 12, 2024",ORL @ MIA,L,19,1,1,1.0,0,0,0.0,0,2,0.0,0,9,9,1,1,1,0,1,2,-10,1,ORL,MIA,ORL,96,,,12,11,3,10
Goga Bitadze,C-F,22023,1629048,22300513,"JAN 09, 2024",ORL vs. MIN,L,17,1,3,0.333,0,0,0.0,0,0,0.0,4,2,6,1,1,2,1,4,2,-8,1,ORL,ORL,MIN,92,,,9,8,3,7
Goga Bitadze,C-F,22023,1629048,22300499,"JAN 07, 2024",ORL vs. ATL,W,28,5,6,0.833,0,0,0.0,1,2,0.5,7,7,14,3,0,2,0,4,11,14,1,ORL,ORL,ATL,117,,,28,25,14,17
Goga Bitadze,C-F,22023,1629048,22300463,"JAN 02, 2024",ORL @ GSW,L,26,6,6,1.0,1,1,1.0,0,0,0.0,3,4,7,1,1,1,0,3,13,-15,1,ORL,GSW,ORL,115,,,21,20,14,8
Goga Bitadze,C-F,22023,1629048,22300450,"DEC 31, 2023",ORL @ PHX,L,22,3,5,0.6,0,0,0.0,0,0,0.0,4,3,7,1,0,1,2,4,6,-15,1,ORL,PHX,ORL,107,,,14,13,7,8
Goga Bitadze,C-F,22023,1629048,22300429,"DEC 29, 2023",ORL vs. NYK,W,30,4,8,0.5,0,0,0.0,5,8,0.625,3,4,7,0,1,2,2,3,13,16,1,ORL,ORL,NYK,117,,,20,20,13,7
Goga Bitadze,C-F,22023,1629048,22300415,"DEC 27, 2023",ORL vs. PHI,L,9,1,1,1.0,0,0,0.0,0,0,0.0,0,1,1,0,0,4,0,0,2,-13,1,ORL,ORL,PHI,92,,,3,3,2,1
Goga Bitadze,C-F,22023,1629048,22300407,"DEC 26, 2023",ORL @ WAS,W,12,4,5,0.8,0,0,0.0,2,2,1.0,4,3,7,3,0,1,0,0,10,-1,1,ORL,WAS,ORL,127,,,20,17,13,10
Goga Bitadze,C-F,22023,1629048,22300391,"DEC 23, 2023",ORL @ IND,W,11,0,0,0.0,0,0,0.0,1,2,0.5,1,0,1,2,2,1,2,1,1,11,1,ORL,IND,ORL,117,,,4,2,3,3
Goga Bitadze,C-F,22023,1629048,22300366,"DEC 20, 2023",ORL vs. MIA,L,12,2,3,0.667,0,0,0.0,0,0,0.0,3,3,6,1,0,2,1,0,4,0,1,ORL,ORL,MIA,106,,,11,10,5,7
Goga Bitadze,C-F,22023,1629048,22300344,"DEC 17, 2023",ORL @ BOS,L,26,2,6,0.333,0,0,0.0,0,0,0.0,2,6,8,1,2,3,1,3,4,1,1,ORL,BOS,ORL,97,,,13,12,5,9
Goga Bitadze,C-F,22023,1629048,22300329,"DEC 15, 2023",ORL @ BOS,L,27,7,8,0.875,0,0,0.0,1,2,0.5,5,6,11,1,0,0,4,2,15,-1,1,ORL,BOS,ORL,111,,,27,26,16,12
Goga Bitadze,C-F,22023,1629048,22300294,"DEC 11, 2023",ORL vs. CLE,W,29,6,8,0.75,0,0,0.0,3,4,0.75,3,4,7,2,0,4,0,3,15,8,1,ORL,ORL,CLE,104,,,24,22,17,9
Goga Bitadze,C-F,22023,1629048,22301217,"DEC 08, 2023",ORL vs. DET,W,28,6,7,0.857,0,0,0.0,1,1,1.0,4,4,8,2,0,4,1,1,13,26,1,ORL,ORL,DET,123,,,23,21,15,10
Goga Bitadze,C-F,22023,1629048,22301205,"DEC 06, 2023",ORL @ CLE,L,25,3,4,0.75,0,1,0.0,0,1,0.0,0,3,3,3,0,1,0,3,6,-1,1,ORL,CLE,ORL,111,,,12,9,9,6
Goga Bitadze,C-F,22023,1629048,22300282,"DEC 02, 2023",ORL @ BKN,L,15,1,6,0.167,0,0,0.0,1,2,0.5,3,2,5,0,0,1,0,2,3,-4,1,ORL,BKN,ORL,101,,,8,8,3,5
Goga Bitadze,C-F,22023,1629048,22300274,"DEC 01, 2023",ORL vs. WAS,W,24,1,1,1.0,1,1,1.0,0,0,0.0,1,4,5,4,0,2,3,4,3,2,1,ORL,ORL,WAS,130,,,12,8,7,9
Goga Bitadze,C-F,22023,1629048,22300259,"NOV 29, 2023",ORL vs. WAS,W,24,2,5,0.4,0,0,0.0,4,4,1.0,1,6,7,2,0,1,1,1,8,7,1,ORL,ORL,WAS,139,,,17,15,10,9
Goga Bitadze,C-F,22023,1629048,22300248,"NOV 26, 2023",ORL vs. CHA,W,20,5,7,0.714,0,0,0.0,1,1,1.0,2,5,7,3,1,0,2,4,11,-1,1,ORL,ORL,CHA,130,,,21,18,14,10
Goga Bitadze,C-F,22023,1629048,22300043,"NOV 24, 2023",ORL vs. BOS,W,19,3,5,0.6,0,0,0.0,0,0,0.0,2,3,5,3,1,1,0,5,6,-2,1,ORL,ORL,BOS,113,,,14,11,9,8
Goga Bitadze,C-F,22023,1629048,22300226,"NOV 22, 2023",ORL vs. DEN,W,32,2,5,0.4,0,0,0.0,2,2,1.0,3,9,12,2,0,1,1,2,6,2,1,ORL,ORL,DEN,124,,,20,18,8,14
Goga Bitadze,C-F,22023,1629048,22300038,"NOV 21, 2023",ORL vs. TOR,W,31,2,6,0.333,0,0,0.0,1,4,0.25,3,4,7,6,2,5,1,1,5,9,1,ORL,ORL,TOR,126,,,18,12,11,13
Goga Bitadze,C-F,22023,1629048,22300209,"NOV 19, 2023",ORL @ IND,W,22,3,5,0.6,0,0,0.0,2,2,1.0,1,7,8,2,0,4,0,2,8,21,1,ORL,IND,ORL,128,,,18,16,10,10
Goga Bitadze,C-F,22023,1629048,22300033,"NOV 17, 2023",ORL @ CHI,W,21,0,1,0.0,0,0,0.0,2,4,0.5,0,4,4,0,1,2,1,4,2,2,1,ORL,CHI,ORL,103,,,6,6,2,4
Goga Bitadze,C-F,22023,1629048,22300196,"NOV 15, 2023",ORL @ CHI,W,26,6,10,0.6,0,0,0.0,3,4,0.75,6,5,11,2,2,1,0,5,15,6,1,ORL,CHI,ORL,96,,,28,26,17,13
Goga Bitadze,C-F,22023,1629048,22300020,"NOV 14, 2023",ORL @ BKN,L,24,6,7,0.857,0,1,0.0,2,2,1.0,1,2,3,1,2,0,0,4,14,-14,1,ORL,BKN,ORL,104,,,18,17,15,4
Goga Bitadze,C-F,22023,1629048,22300173,"NOV 11, 2023",ORL vs. MIL,W,21,1,5,0.2,0,0,0.0,0,0,0.0,5,4,9,2,2,0,1,2,2,4,1,ORL,ORL,MIL,112,,,13,11,4,11
Goga Bitadze,C-F,22023,1629048,22300172,"NOV 09, 2023",ORL vs. ATL,L,21,5,7,0.714,0,0,0.0,2,4,0.5,2,3,5,0,0,2,1,2,12,7,1,ORL,ORL,ATL,119,,,17,17,12,5
Goga Bitadze,C-F,22023,1629048,22300147,"NOV 06, 2023",ORL vs. DAL,L,22,3,5,0.6,0,1,0.0,1,1,1.0,2,4,6,0,2,1,1,3,7,0,1,ORL,ORL,DAL,102,,,13,13,7,6
Goga Bitadze,C-F,22023,1629048,22300134,"NOV 04, 2023",ORL vs. LAL,W,26,3,6,0.5,0,1,0.0,4,4,1.0,4,6,10,2,0,5,0,2,10,27,1,ORL,ORL,LAL,120,,,22,20,12,12
Goga Bitadze,C-F,22023,1629048,22300114,"OCT 31, 2023",ORL @ LAC,L,4,0,0,0.0,0,0,0.0,1,2,0.5,1,0,1,3,0,0,0,0,1,-1,1,ORL,LAC,ORL,102,,,5,2,4,4
Goga Bitadze,C-F,22023,1629048,22300111,"OCT 30, 2023",ORL @ LAL,L,1,0,0,0.0,0,0,0.0,0,0,0.0,0,0,0,0,0,0,0,0,0,5,1,ORL,LAL,ORL,103,,,0,0,0,0
Goga Bitadze,C-F,22023,1629048,22300066,"OCT 25, 2023",ORL vs. HOU,W,5,2,2,1.0,0,0,0.0,3,4,0.75,1,2,3,0,1,0,1,1,7,9,1,ORL,ORL,HOU,116,,,10,10,7,3
Goga Bitadze,C-F,22023,1629048,22300476,"JAN 03, 2024",ORL @ SAC,L,28,2,5,0.4,0,1,0.0,2,2,1.0,1,5,6,2,1,3,1,3,6,-15,1,ORL,SAC,ORL,135,,,14,12,8,8
Amen Thompson,G-F,22023,1641708,22300754,"FEB 10, 2024",HOU @ ATL,L,33,6,10,0.6,0,1,0.0,0,0,0.0,4,7,11,3,1,0,2,5,12,-15,1,HOU,ATL,HOU,113,,,26,23,15,14
Amen Thompson,G-F,22023,1641708,22300744,"FEB 09, 2024",HOU @ TOR,L,32,4,5,0.8,0,0,0.0,0,0,0.0,2,7,9,4,1,0,6,4,8,-11,1,HOU,TOR,HOU,104,,,21,17,12,13
Amen Thompson,G-F,22023,1641708,22300719,"FEB 06, 2024",HOU @ IND,L,34,6,12,0.5,0,2,0.0,1,4,0.25,7,6,13,6,0,3,3,3,13,-7,1,HOU,IND,HOU,129,,,32,26,19,19
Amen Thompson,G-F,22023,1641708,22300709,"FEB 04, 2024",HOU @ MIN,L,20,2,7,0.286,0,0,0.0,4,6,0.667,3,4,7,2,1,0,0,1,8,-11,1,HOU,MIN,HOU,90,,,17,15,10,9
Amen Thompson,G-F,22023,1641708,22300692,"FEB 02, 2024",HOU vs. TOR,W,24,9,11,0.818,0,1,0.0,1,2,0.5,1,6,7,4,2,1,2,3,19,27,1,HOU,HOU,TOR,135,,,30,26,23,11
Amen Thompson,G-F,22023,1641708,22300679,"JAN 31, 2024",HOU vs. NOP,L,17,3,6,0.5,0,1,0.0,4,4,1.0,2,4,6,0,1,0,0,3,10,-5,1,HOU,HOU,NOP,99,,,16,16,10,6
Amen Thompson,G-F,22023,1641708,22300662,"JAN 29, 2024",HOU vs. LAL,W,12,0,1,0.0,0,0,0.0,0,0,0.0,1,6,7,3,1,0,5,3,0,-3,1,HOU,HOU,LAL,135,,,10,7,3,10
Amen Thompson,G-F,22023,1641708,22300645,"JAN 27, 2024",HOU @ BKN,L,15,2,3,0.667,1,2,0.5,0,0,0.0,1,3,4,2,3,2,2,3,5,-1,1,HOU,BKN,HOU,104,,,11,9,7,6
Amen Thompson,G-F,22023,1641708,22300635,"JAN 26, 2024",HOU @ CHA,W,23,4,6,0.667,1,1,1.0,4,6,0.667,2,4,6,8,2,0,1,2,13,25,1,HOU,CHA,HOU,138,,,27,19,21,14
Amen Thompson,G-F,22023,1641708,22300623,"JAN 24, 2024",HOU vs. POR,L,14,3,5,0.6,0,0,0.0,0,0,0.0,1,2,3,2,0,1,0,3,6,4,1,HOU,HOU,POR,131,,,11,9,8,5
Amen Thompson,G-F,22023,1641708,22300603,"JAN 21, 2024",HOU vs. BOS,L,32,5,10,0.5,0,2,0.0,5,6,0.833,3,11,14,5,1,0,2,3,15,-8,1,HOU,HOU,BOS,107,,,34,29,20,19
Amen Thompson,G-F,22023,1641708,22300598,"JAN 20, 2024",HOU vs. UTA,W,18,2,6,0.333,0,1,0.0,2,2,1.0,4,4,8,2,2,2,0,3,6,8,1,HOU,HOU,UTA,127,,,16,14,8,10
Amen Thompson,G-F,22023,1641708,22300573,"JAN 17, 2024",HOU @ NYK,L,10,2,3,0.667,0,0,0.0,0,0,0.0,0,1,1,1,1,2,0,2,4,-5,1,HOU,NYK,HOU,94,,,6,5,5,2
Amen Thompson,G-F,22023,1641708,22300555,"JAN 15, 2024",HOU @ PHI,L,19,7,8,0.875,0,1,0.0,0,1,0.0,2,1,3,0,1,0,1,2,14,-5,1,HOU,PHI,HOU,115,,,17,17,14,3
Amen Thompson,G-F,22023,1641708,22300542,"JAN 13, 2024",HOU @ BOS,L,25,3,10,0.3,0,0,0.0,4,4,1.0,3,7,10,3,3,0,4,0,10,-14,1,HOU,BOS,HOU,113,,,23,20,13,13
Amen Thompson,G-F,22023,1641708,22300409,"DEC 26, 2023",HOU vs. IND,L,12,3,5,0.6,0,0,0.0,1,1,1.0,2,2,4,0,2,0,1,1,7,9,1,HOU,HOU,IND,117,,,11,11,7,4
Amen Thompson,G-F,22023,1641708,22300392,"DEC 23, 2023",HOU @ NOP,W,10,0,1,0.0,0,1,0.0,2,4,0.5,0,0,0,0,1,0,0,0,2,3,1,HOU,NOP,HOU,106,,,2,2,2,0
Amen Thompson,G-F,22023,1641708,22300385,"DEC 22, 2023",HOU vs. DAL,W,22,4,9,0.444,0,2,0.0,1,2,0.5,0,6,6,4,1,0,3,4,9,-3,1,HOU,HOU,DAL,122,,,19,15,13,10
Amen Thompson,G-F,22023,1641708,22300371,"DEC 20, 2023",HOU vs. ATL,L,8,1,2,0.5,0,0,0.0,0,0,0.0,0,2,2,0,0,0,0,1,2,-10,1,HOU,HOU,ATL,127,,,4,4,2,2
Amen Thompson,G-F,22023,1641708,22300298,"DEC 11, 2023",HOU vs. SAS,W,10,1,2,0.5,0,1,0.0,0,0,0.0,2,3,5,1,0,0,0,1,2,7,1,HOU,HOU,SAS,93,,,8,7,3,6
Amen Thompson,G-F,22023,1641708,22300122,"NOV 01, 2023",HOU vs. CHA,W,13,1,3,0.333,0,1,0.0,2,2,1.0,0,1,1,1,1,0,1,3,4,10,1,HOU,HOU,CHA,128,,,6,5,5,2
Amen Thompson,G-F,22023,1641708,22300096,"OCT 29, 2023",HOU vs. GSW,L,20,3,5,0.6,1,2,0.5,2,2,1.0,0,4,4,0,1,0,0,3,9,2,1,HOU,HOU,GSW,95,,,13,13,9,4
Amen Thompson,G-F,22023,1641708,22300083,"OCT 27, 2023",HOU @ SAS,L,13,2,4,0.5,0,1,0.0,0,2,0.0,0,1,1,3,0,1,1,1,4,1,1,HOU,SAS,HOU,122,,,8,5,7,4
Amen Thompson,G-F,22023,1641708,22300066,"OCT 25, 2023",HOU @ ORL,L,21,3,10,0.3,1,7,0.143,1,2,0.5,1,4,5,2,0,0,4,2,8,-34,1,HOU,ORL,HOU,86,,,15,13,10,7
Amen Thompson,G-F,22023,1641708,22300534,"JAN 12, 2024",HOU @ DET,W,8,1,2,0.5,0,0,0.0,0,0,0.0,0,1,1,2,1,0,0,0,2,-8,1,HOU,DET,HOU,112,,,5,3,4,3
Amen Thompson,G-F,22023,1641708,22300485,"JAN 05, 2024",HOU vs. MIN,L,20,2,9,0.222,0,2,0.0,2,3,0.667,1,5,6,1,3,0,2,3,6,-20,1,HOU,HOU,MIN,95,,,13,12,7,7
Amen Thompson,G-F,22023,1641708,22300469,"JAN 03, 2024",HOU vs. BKN,W,20,3,7,0.429,1,3,0.333,3,7,0.429,0,6,6,1,0,0,1,1,10,0,1,HOU,HOU,BKN,112,,,17,16,11,7
Amen Thompson,G-F,22023,1641708,22300453,"JAN 01, 2024",HOU vs. DET,W,28,5,6,0.833,1,1,1.0,1,1,1.0,1,3,4,6,2,0,2,3,12,10,1,HOU,HOU,DET,136,,,22,16,18,10
Amen Thompson,G-F,22023,1641708,22300418,"DEC 27, 2023",HOU vs. PHX,L,17,1,6,0.167,0,1,0.0,0,0,0.0,2,2,4,3,0,1,0,2,2,2,1,HOU,HOU,PHX,113,,,9,6,5,7
Amen Thompson,G-F,22023,1641708,22300434,"DEC 29, 2023",HOU vs. PHI,L,9,0,1,0.0,0,0,0.0,1,2,0.5,1,2,3,1,0,0,0,1,1,0,1,HOU,HOU,PHI,127,,,5,4,2,4
Amen Thompson,G-F,22023,1641708,22300523,"JAN 10, 2024",HOU @ CHI,L,14,3,7,0.429,0,3,0.0,0,0,0.0,0,2,2,3,1,0,2,2,6,3,1,HOU,CHI,HOU,119,,,11,8,9,5
Amen Thompson,G-F,22023,1641708,22300509,"JAN 08, 2024",HOU @ MIA,L,11,1,2,0.5,0,0,0.0,3,3,1.0,0,2,2,1,1,1,2,3,5,-5,1,HOU,MIA,HOU,113,,,8,7,6,3
Amen Thompson,G-F,22023,1641708,22300496,"JAN 06, 2024",HOU vs. MIL,W,16,2,3,0.667,0,1,0.0,0,0,0.0,1,2,3,5,0,0,1,2,4,7,1,HOU,HOU,MIL,112,,,12,7,9,8
Nick Smith Jr.,G,22023,1641733,22300745,"FEB 09, 2024",CHA @ MIL,L,24,2,10,0.2,2,8,0.25,7,8,0.875,0,3,3,3,0,0,2,0,13,0,1,CHA,MIL,CHA,80,,,19,16,16,6
Nick Smith Jr.,G,22023,1641733,22300335,"DEC 16, 2023",CHA vs. PHI,L,26,4,8,0.5,1,4,0.25,0,0,0.0,1,0,1,1,0,0,0,2,9,-35,1,CHA,CHA,PHI,80,,,11,10,10,2
Nick Smith Jr.,G,22023,1641733,22300177,"NOV 12, 2023",CHA @ NYK,L,8,1,6,0.167,1,4,0.25,0,0,0.0,0,0,0,2,0,0,0,0,3,6,1,CHA,NYK,CHA,107,,,5,3,5,2
Nick Smith Jr.,G,22023,1641733,22300635,"JAN 26, 2024",CHA vs. HOU,L,17,4,6,0.667,2,2,1.0,0,0,0.0,0,1,1,0,0,0,3,2,10,-12,1,CHA,CHA,HOU,104,,,11,11,10,1
Nick Smith Jr.,G,22023,1641733,22300619,"JAN 24, 2024",CHA @ DET,L,17,1,2,0.5,1,1,1.0,0,0,0.0,0,0,0,1,0,0,0,0,3,-7,1,CHA,DET,CHA,106,,,4,3,4,1
Nick Smith Jr.,G,22023,1641733,22300610,"JAN 22, 2024",CHA @ MIN,W,15,3,4,0.75,2,3,0.667,0,0,0.0,0,2,2,2,0,0,2,1,8,13,1,CHA,MIN,CHA,126,,,12,10,10,4
Nick Smith Jr.,G,22023,1641733,22300584,"JAN 19, 2024",CHA vs. SAS,W,18,2,6,0.333,1,2,0.5,0,0,0.0,1,3,4,0,0,0,1,1,5,-10,1,CHA,CHA,SAS,124,,,9,9,5,4
Nick Smith Jr.,G,22023,1641733,22300575,"JAN 17, 2024",CHA @ NOP,L,17,1,5,0.2,1,2,0.5,0,0,0.0,2,1,3,3,0,0,1,1,3,-9,1,CHA,NOP,CHA,108,,,9,6,6,6
Nick Smith Jr.,G,22023,1641733,22300551,"JAN 14, 2024",CHA @ MIA,L,16,2,5,0.4,0,2,0.0,0,0,0.0,0,2,2,0,0,0,2,0,4,-19,1,CHA,MIA,CHA,85,,,6,6,4,2
Nick Smith Jr.,G,22023,1641733,22300541,"JAN 12, 2024",CHA @ SAS,L,25,4,9,0.444,1,3,0.333,0,0,0.0,2,4,6,5,0,0,1,2,9,-16,1,CHA,SAS,CHA,99,,,20,15,14,11
Nick Smith Jr.,G,22023,1641733,22300225,"NOV 22, 2023",CHA vs. WAS,W,1,1,1,1.0,0,0,0.0,0,0,0.0,0,0,0,0,0,0,0,1,2,-6,1,CHA,CHA,WAS,117,,,2,2,2,0
Nick Smith Jr.,G,22023,1641733,22300027,"NOV 17, 2023",CHA vs. MIL,L,9,1,6,0.167,0,1,0.0,0,0,0.0,1,1,2,0,0,1,1,1,2,-18,1,CHA,CHA,MIL,99,,,4,4,2,2
Nick Smith Jr.,G,22023,1641733,22300017,"NOV 14, 2023",CHA vs. MIA,L,15,1,2,0.5,1,1,1.0,0,0,0.0,0,1,1,0,0,0,0,1,3,-2,1,CHA,CHA,MIA,105,,,4,4,3,1
Nick Smith Jr.,G,22023,1641733,22300157,"NOV 08, 2023",CHA vs. WAS,L,4,2,2,1.0,1,1,1.0,0,0,0.0,0,1,1,0,1,0,1,0,5,4,1,CHA,CHA,WAS,116,,,6,6,5,1
Nick Smith Jr.,G,22023,1641733,22300063,"OCT 25, 2023",CHA vs. ATL,W,1,0,0,0.0,0,0,0.0,0,0,0.0,0,0,0,0,0,0,0,0,0,0,1,CHA,CHA,ATL,116,,,0,0,0,0
Nick Smith Jr.,G,22023,1641733,22300726,"FEB 07, 2024",CHA vs. TOR,L,13,3,4,0.75,3,4,0.75,0,0,0.0,0,0,0,1,0,0,0,1,9,-11,1,CHA,CHA,TOR,117,,,10,9,10,1
Nick Smith Jr.,G,22023,1641733,22300713,"FEB 05, 2024",CHA vs. LAL,L,20,2,7,0.286,1,3,0.333,0,0,0.0,0,2,2,4,0,0,1,2,5,-5,1,CHA,CHA,LAL,118,,,11,7,9,6
Nick Smith Jr.,G,22023,1641733,22300707,"FEB 04, 2024",CHA vs. IND,L,25,1,8,0.125,0,4,0.0,0,0,0.0,1,1,2,2,2,0,0,4,2,7,1,CHA,CHA,IND,99,,,6,4,4,4
Nick Smith Jr.,G,22023,1641733,22300695,"FEB 02, 2024",CHA @ OKC,L,21,4,10,0.4,3,4,0.75,1,1,1.0,0,0,0,0,1,0,0,4,12,3,1,CHA,OKC,CHA,106,,,12,12,12,0
Nick Smith Jr.,G,22023,1641733,22300674,"JAN 31, 2024",CHA vs. CHI,L,12,2,5,0.4,1,3,0.333,0,0,0.0,1,1,2,1,0,0,1,0,5,4,1,CHA,CHA,CHI,110,,,8,7,6,3
Nick Smith Jr.,G,22023,1641733,22300657,"JAN 29, 2024",CHA vs. NYK,L,12,2,5,0.4,2,4,0.5,0,0,0.0,0,0,0,0,0,0,0,0,6,1,1,CHA,CHA,NYK,92,,,6,6,6,0
Nick Smith Jr.,G,22023,1641733,22300647,"JAN 27, 2024",CHA vs. UTA,L,19,1,4,0.25,1,3,0.333,0,0,0.0,0,0,0,4,1,0,0,3,3,-5,1,CHA,CHA,UTA,122,,,7,3,7,4
Nick Smith Jr.,G,22023,1641733,22300518,"JAN 10, 2024",CHA vs. SAC,L,25,4,15,0.267,2,8,0.25,1,2,0.5,0,3,3,1,0,0,2,3,11,-22,1,CHA,CHA,SAC,96,,,15,14,12,4
Nick Smith Jr.,G,22023,1641733,22300365,"DEC 20, 2023",CHA @ IND,L,6,3,6,0.5,0,3,0.0,0,0,0.0,0,0,0,0,0,0,1,0,6,-5,1,CHA,IND,CHA,109,,,6,6,6,0
Nick Smith Jr.,G,22023,1641733,22300354,"DEC 18, 2023",CHA @ TOR,L,20,3,9,0.333,1,5,0.2,0,0,0.0,0,1,1,0,0,1,1,2,7,-12,1,CHA,TOR,CHA,99,,,8,8,7,1
Nick Smith Jr.,G,22023,1641733,22300057,"NOV 28, 2023",CHA @ NYK,L,5,3,4,0.75,2,2,1.0,0,0,0.0,0,0,0,0,0,0,0,0,8,-1,1,CHA,NYK,CHA,91,,,8,8,8,0
Nick Smith Jr.,G,22023,1641733,22300506,"JAN 08, 2024",CHA vs. CHI,L,32,6,15,0.4,3,6,0.5,0,0,0.0,2,2,4,3,1,0,3,2,15,-4,1,CHA,CHA,CHI,109,,,22,19,18,7
Nick Smith Jr.,G,22023,1641733,22300455,"JAN 01, 2024",CHA @ DEN,L,19,2,8,0.25,1,3,0.333,0,0,0.0,2,1,3,2,0,1,2,2,5,10,1,CHA,DEN,CHA,91,,,10,8,7,5
Nick Smith Jr.,G,22023,1641733,22300428,"DEC 28, 2023",CHA @ LAL,L,18,2,4,0.5,2,2,1.0,0,0,0.0,0,3,3,4,0,1,2,1,6,-1,1,CHA,LAL,CHA,110,,,13,9,10,7
Nick Smith Jr.,G,22023,1641733,22300593,"JAN 20, 2024",CHA vs. PHI,L,15,0,4,0.0,0,2,0.0,0,0,0.0,0,0,0,1,0,0,1,0,0,-20,1,CHA,CHA,PHI,89,,,1,0,1,1
Nick Smith Jr.,G,22023,1641733,22300484,"JAN 05, 2024",CHA @ CHI,L,16,4,6,0.667,2,2,1.0,0,0,0.0,0,2,2,0,1,0,1,0,10,-9,1,CHA,CHI,CHA,87,,,12,12,10,2
Nick Smith Jr.,G,22023,1641733,22300464,"JAN 02, 2024",CHA @ SAC,W,14,2,3,0.667,2,3,0.667,0,0,0.0,0,0,0,1,0,2,0,1,6,-2,1,CHA,SAC,CHA,111,,,7,6,7,1
Nick Smith Jr.,G,22023,1641733,22300436,"DEC 29, 2023",CHA @ PHX,L,13,4,7,0.571,2,4,0.5,0,0,0.0,1,1,2,1,0,0,1,1,10,-1,1,CHA,PHX,CHA,119,,,13,12,11,3
Nick Smith Jr.,G,22023,1641733,22300414,"DEC 26, 2023",CHA @ LAC,L,12,2,5,0.4,1,4,0.25,0,0,0.0,0,0,0,1,0,0,0,3,5,-10,1,CHA,LAC,CHA,104,,,6,5,6,1
Nick Smith Jr.,G,22023,1641733,22300390,"DEC 23, 2023",CHA vs. DEN,L,25,6,12,0.5,5,7,0.714,2,2,1.0,1,2,3,2,0,0,1,2,19,6,1,CHA,CHA,DEN,95,,,24,22,21,5
Nick Smith Jr.,G,22023,1641733,22300266,"NOV 30, 2023",CHA @ BKN,W,14,3,4,0.75,3,3,1.0,0,0,0.0,1,0,1,0,0,1,0,2,9,4,1,CHA,BKN,CHA,129,,,10,10,9,1
Cameron Payne,G,22023,1626166,22300725,"FEB 06, 2024",MIL @ PHX,L,23,4,10,0.4,1,4,0.25,2,4,0.5,0,4,4,3,2,0,1,2,11,-3,1,MIL,PHX,MIL,106,,,18,15,14,7
Cameron Payne,G,22023,1626166,22300711,"FEB 04, 2024",MIL @ UTA,L,10,1,3,0.333,1,3,0.333,0,0,0.0,1,2,3,2,0,0,0,0,3,6,1,MIL,UTA,MIL,108,,,8,6,5,5
Cameron Payne,G,22023,1626166,22300702,"FEB 03, 2024",MIL @ DAL,W,10,0,0,0.0,0,0,0.0,0,0,0.0,0,2,2,3,1,0,1,2,0,-4,1,MIL,DAL,MIL,129,,,5,2,3,5
Cameron Payne,G,22023,1626166,22300683,"JAN 31, 2024",MIL @ POR,L,8,0,5,0.0,0,2,0.0,0,0,0.0,1,0,1,2,0,0,0,0,0,-9,1,MIL,POR,MIL,116,,,3,1,2,3
Cameron Payne,G,22023,1626166,22300667,"JAN 29, 2024",MIL @ DEN,L,13,1,2,0.5,1,2,0.5,0,0,0.0,0,1,1,2,1,0,0,2,3,-7,1,MIL,DEN,MIL,107,,,6,4,5,3
Cameron Payne,G,22023,1626166,22300648,"JAN 27, 2024",MIL vs. NOP,W,18,4,7,0.571,3,4,0.75,0,0,0.0,0,2,2,5,2,0,0,0,11,4,1,MIL,MIL,NOP,141,,,18,13,16,7
Cameron Payne,G,22023,1626166,22300639,"JAN 26, 2024",MIL vs. CLE,L,11,1,3,0.333,1,2,0.5,1,2,0.5,0,2,2,0,0,1,0,2,4,-9,1,MIL,MIL,CLE,100,,,6,6,4,2
Cameron Payne,G,22023,1626166,22300624,"JAN 24, 2024",MIL vs. CLE,W,13,2,6,0.333,1,3,0.333,0,0,0.0,0,2,2,0,1,0,1,1,5,2,1,MIL,MIL,CLE,126,,,7,7,5,2
Cameron Payne,G,22023,1626166,22300552,"JAN 14, 2024",MIL vs. SAC,W,12,5,7,0.714,3,4,0.75,2,2,1.0,0,0,0,1,1,0,0,0,15,7,1,MIL,MIL,SAC,143,,,16,15,16,1
Cameron Payne,G,22023,1626166,22300528,"JAN 11, 2024",MIL vs. BOS,W,15,3,4,0.75,1,2,0.5,0,0,0.0,0,4,4,3,0,0,0,0,7,-4,1,MIL,MIL,BOS,135,,,14,11,10,7
Cameron Payne,G,22023,1626166,22300496,"JAN 06, 2024",MIL @ HOU,L,8,0,1,0.0,0,1,0.0,1,2,0.5,0,0,0,1,0,0,0,0,1,-1,1,MIL,HOU,MIL,108,,,2,1,2,1
Cameron Payne,G,22023,1626166,22300477,"JAN 04, 2024",MIL @ SAS,W,15,0,3,0.0,0,3,0.0,5,5,1.0,0,1,1,4,0,0,0,1,5,-4,1,MIL,SAS,MIL,125,,,10,6,9,5
Cameron Payne,G,22023,1626166,22300466,"JAN 03, 2024",MIL @ IND,L,10,2,3,0.667,1,2,0.5,2,3,0.667,0,1,1,2,0,0,0,3,7,5,1,MIL,IND,MIL,130,,,10,8,9,3
Cameron Payne,G,22023,1626166,22300454,"JAN 01, 2024",MIL vs. IND,L,12,1,4,0.25,0,2,0.0,3,3,1.0,1,0,1,2,1,0,2,1,5,-13,1,MIL,MIL,IND,113,,,8,6,7,3
Cameron Payne,G,22023,1626166,22300433,"DEC 29, 2023",MIL @ CLE,W,6,0,1,0.0,0,1,0.0,0,0,0.0,0,0,0,0,0,0,3,0,0,-9,1,MIL,CLE,MIL,119,,,0,0,0,0
Cameron Payne,G,22023,1626166,22300417,"DEC 27, 2023",MIL @ BKN,W,23,6,9,0.667,5,8,0.625,1,1,1.0,1,3,4,6,2,0,0,4,18,24,1,MIL,BKN,MIL,144,,,28,22,24,10
Cameron Payne,G,22023,1626166,22300401,"DEC 25, 2023",MIL @ NYK,L,10,1,2,0.5,1,2,0.5,0,0,0.0,0,0,0,1,0,0,0,0,3,-1,1,MIL,NYK,MIL,122,,,4,3,4,1
Cameron Payne,G,22023,1626166,22300388,"DEC 23, 2023",MIL @ NYK,W,14,2,2,1.0,1,1,1.0,3,4,0.75,0,1,1,1,0,0,0,0,8,16,1,MIL,NYK,MIL,130,,,10,9,9,2
Cameron Payne,G,22023,1626166,22300378,"DEC 21, 2023",MIL vs. ORL,W,13,1,4,0.25,0,3,0.0,0,0,0.0,0,1,1,4,0,0,0,2,2,-5,1,MIL,MIL,ORL,118,,,7,3,6,5
Cameron Payne,G,22023,1626166,22300361,"DEC 19, 2023",MIL vs. SAS,W,13,2,6,0.333,0,2,0.0,3,3,1.0,0,0,0,0,0,0,0,1,7,-9,1,MIL,MIL,SAS,132,,,7,7,7,0
Cameron Payne,G,22023,1626166,22300346,"DEC 17, 2023",MIL vs. HOU,W,11,0,4,0.0,0,4,0.0,0,0,0.0,0,0,0,1,0,0,0,2,0,2,1,MIL,MIL,HOU,128,,,1,0,1,1
Cameron Payne,G,22023,1626166,22300334,"DEC 16, 2023",MIL vs. DET,W,15,3,5,0.6,1,3,0.333,4,4,1.0,0,1,1,5,1,0,2,2,11,5,1,MIL,MIL,DET,146,,,17,12,16,6
Cameron Payne,G,22023,1626166,22300315,"DEC 13, 2023",MIL vs. IND,W,14,0,4,0.0,0,2,0.0,1,2,0.5,0,0,0,4,0,0,1,1,1,4,1,MIL,MIL,IND,140,,,5,1,5,4
Cameron Payne,G,22023,1626166,22300300,"DEC 11, 2023",MIL vs. CHI,W,18,2,4,0.5,1,2,0.5,0,0,0.0,0,0,0,5,0,0,1,2,5,0,1,MIL,MIL,CHI,133,,,10,5,10,5
Cameron Payne,G,22023,1626166,22301229,"DEC 07, 2023",MIL vs. IND,L,16,2,9,0.222,0,3,0.0,0,0,0.0,0,1,1,2,0,0,2,0,4,-18,1,MIL,MIL,IND,119,,,7,5,6,3
Cameron Payne,G,22023,1626166,22301201,"DEC 05, 2023",MIL vs. NYK,W,14,5,6,0.833,2,3,0.667,0,0,0.0,0,2,2,2,1,0,1,2,12,7,1,MIL,MIL,NYK,146,,,16,14,14,4
Cameron Payne,G,22023,1626166,22300286,"DEC 02, 2023",MIL vs. ATL,W,20,7,11,0.636,2,6,0.333,2,2,1.0,0,3,3,2,0,0,1,5,18,5,1,MIL,MIL,ATL,132,,,23,21,20,5
Cameron Payne,G,22023,1626166,22300269,"NOV 30, 2023",MIL @ CHI,L,12,2,6,0.333,2,5,0.4,0,0,0.0,0,1,1,1,0,0,0,0,6,-20,1,MIL,CHI,MIL,113,,,8,7,7,2
Cameron Payne,G,22023,1626166,22300056,"NOV 28, 2023",MIL @ MIA,W,18,1,2,0.5,0,1,0.0,0,0,0.0,0,1,1,3,0,0,1,2,2,-15,1,MIL,MIA,MIL,131,,,6,3,5,4
Cameron Payne,G,22023,1626166,22300245,"NOV 26, 2023",MIL vs. POR,W,17,1,4,0.25,1,3,0.333,0,0,0.0,0,2,2,3,1,0,3,2,3,3,1,MIL,MIL,POR,108,,,8,5,6,5
Cameron Payne,G,22023,1626166,22300049,"NOV 24, 2023",MIL vs. WAS,W,17,2,4,0.5,0,2,0.0,0,0,0.0,0,3,3,3,0,0,0,3,4,-4,1,MIL,MIL,WAS,131,,,10,7,7,6
Cameron Payne,G,22023,1626166,22300228,"NOV 22, 2023",MIL @ BOS,L,10,1,5,0.2,1,3,0.333,0,0,0.0,0,0,0,2,0,0,0,0,3,-12,1,MIL,BOS,MIL,116,,,5,3,5,2
Cameron Payne,G,22023,1626166,22300219,"NOV 20, 2023",MIL @ WAS,W,16,2,5,0.4,2,4,0.5,0,0,0.0,0,2,2,2,1,0,1,1,6,8,1,MIL,WAS,MIL,142,,,10,8,8,4
Cameron Payne,G,22023,1626166,22300205,"NOV 18, 2023",MIL vs. DAL,W,17,4,5,0.8,3,4,0.75,0,0,0.0,0,2,2,2,1,0,0,4,11,10,1,MIL,MIL,DAL,132,,,15,13,13,4
Cameron Payne,G,22023,1626166,22300027,"NOV 17, 2023",MIL @ CHA,W,21,1,3,0.333,0,2,0.0,0,0,0.0,0,3,3,6,0,1,0,1,2,21,1,MIL,CHA,MIL,130,,,11,5,8,9
Cameron Payne,G,22023,1626166,22300190,"NOV 13, 2023",MIL vs. CHI,W,17,0,2,0.0,0,2,0.0,0,0,0.0,0,0,0,5,0,0,2,2,0,15,1,MIL,MIL,CHI,118,,,5,0,5,5
Cameron Payne,G,22023,1626166,22300173,"NOV 11, 2023",MIL @ ORL,L,26,6,8,0.75,2,3,0.667,0,0,0.0,0,0,0,2,2,0,2,3,14,-8,1,MIL,ORL,MIL,97,,,16,14,16,2
Cameron Payne,G,22023,1626166,22300171,"NOV 09, 2023",MIL @ IND,L,30,3,9,0.333,1,2,0.5,0,0,0.0,0,4,4,5,0,1,1,4,7,-17,1,MIL,IND,MIL,124,,,16,11,12,9
Cameron Payne,G,22023,1626166,22300165,"NOV 08, 2023",MIL vs. DET,W,24,1,4,0.25,1,3,0.333,4,4,1.0,0,1,1,3,2,0,1,2,7,7,1,MIL,MIL,DET,120,,,11,8,10,4
Cameron Payne,G,22023,1626166,22300149,"NOV 06, 2023",MIL @ BKN,W,16,4,6,0.667,3,4,0.75,0,0,0.0,0,1,1,3,0,0,0,1,11,9,1,MIL,BKN,MIL,129,,,15,12,14,4
Cameron Payne,G,22023,1626166,22300002,"NOV 03, 2023",MIL vs. NYK,W,12,0,1,0.0,0,0,0.0,0,0,0.0,0,0,0,1,0,0,1,2,0,3,1,MIL,MIL,NYK,110,,,1,0,1,1
Cameron Payne,G,22023,1626166,22300116,"NOV 01, 2023",MIL @ TOR,L,19,2,5,0.4,0,2,0.0,0,0,0.0,0,2,2,1,0,0,1,2,4,-4,1,MIL,TOR,MIL,111,,,7,6,5,3
Cameron Payne,G,22023,1626166,22300107,"OCT 30, 2023",MIL vs. MIA,W,13,4,5,0.8,3,4,0.75,0,0,0.0,1,0,1,0,0,0,1,0,11,6,1,MIL,MIL,MIA,122,,,12,12,11,1
Cameron Payne,G,22023,1626166,22300097,"OCT 29, 2023",MIL vs. ATL,L,14,2,3,0.667,2,3,0.667,0,0,0.0,0,1,1,1,0,0,1,4,6,3,1,MIL,MIL,ATL,110,,,8,7,7,2
Cameron Payne,G,22023,1626166,22300075,"OCT 26, 2023",MIL vs. PHI,W,9,1,3,0.333,0,1,0.0,0,0,0.0,0,0,0,0,1,0,0,3,2,-7,1,MIL,MIL,PHI,118,,,2,2,2,0
Cameron Payne,G,22023,1626166,22300572,"JAN 17, 2024",MIL @ CLE,L,13,5,9,0.556,2,5,0.4,1,1,1.0,0,0,0,1,1,0,0,0,13,-4,1,MIL,CLE,MIL,95,,,14,13,14,1
Cameron Payne,G,22023,1626166,22300195,"NOV 15, 2023",MIL @ TOR,W,16,4,8,0.5,3,4,0.75,2,2,1.0,0,1,1,2,0,0,0,2,13,1,1,MIL,TOR,MIL,128,,,16,14,15,3
Cameron Payne,G,22023,1626166,22300742,"FEB 09, 2024",PHI vs. ATL,L,36,7,16,0.438,4,9,0.444,2,2,1.0,3,0,3,6,2,1,2,2,20,4,1,PHI,PHI,ATL,121,,,29,23,26,9
Cameron Payne,G,22023,1626166,22300753,"FEB 10, 2024",PHI @ WAS,W,21,3,8,0.375,0,3,0.0,0,1,0.0,0,1,1,6,0,0,1,1,6,14,1,PHI,WAS,PHI,119,,,13,7,12,7
Jonathan Isaac,F,22023,1628371,22300752,"FEB 10, 2024",ORL vs. CHI,W,25,3,8,0.375,1,2,0.5,0,0,0.0,6,6,12,0,1,3,0,4,7,10,1,ORL,ORL,CHI,114,,,19,19,7,12
Jonathan Isaac,F,22023,1628371,22300734,"FEB 08, 2024",ORL vs. SAS,W,19,4,4,1.0,0,0,0.0,1,2,0.5,0,6,6,1,0,1,1,1,9,2,1,ORL,ORL,SAS,127,,,16,15,10,7
Jonathan Isaac,F,22023,1628371,22300721,"FEB 06, 2024",ORL @ MIA,L,10,1,2,0.5,1,2,0.5,0,0,0.0,0,3,3,1,0,1,2,0,3,-18,1,ORL,MIA,ORL,95,,,7,6,4,4
Jonathan Isaac,F,22023,1628371,22300704,"FEB 04, 2024",ORL @ DET,W,21,1,2,0.5,0,0,0.0,3,4,0.75,1,5,6,0,1,1,0,1,5,9,1,ORL,DET,ORL,111,,,11,11,5,6
Jonathan Isaac,F,22023,1628371,22300694,"FEB 02, 2024",ORL @ MIN,W,20,1,4,0.25,0,0,0.0,1,2,0.5,2,6,8,0,2,1,0,1,3,5,1,ORL,MIN,ORL,108,,,11,11,3,8
Jonathan Isaac,F,22023,1628371,22300681,"JAN 31, 2024",ORL @ SAS,W,18,4,7,0.571,0,0,0.0,0,0,0.0,2,2,4,0,0,4,1,1,8,1,1,ORL,SAS,ORL,108,,,12,12,8,4
Jonathan Isaac,F,22023,1628371,22300666,"JAN 29, 2024",ORL @ DAL,L,8,1,2,0.5,0,1,0.0,0,0,0.0,0,0,0,0,0,0,0,1,2,15,1,ORL,DAL,ORL,129,,,2,2,2,0
Jonathan Isaac,F,22023,1628371,22300655,"JAN 28, 2024",ORL vs. PHX,W,23,3,7,0.429,1,2,0.5,2,4,0.5,1,2,3,1,1,2,1,2,9,17,1,ORL,ORL,PHX,113,,,13,12,10,4
Jonathan Isaac,F,22023,1628371,22300638,"JAN 26, 2024",ORL @ MEM,L,22,4,5,0.8,0,1,0.0,2,2,1.0,2,3,5,0,0,0,0,0,10,7,1,ORL,MEM,ORL,106,,,15,15,10,5
Jonathan Isaac,F,22023,1628371,22300601,"JAN 21, 2024",ORL vs. MIA,W,14,2,3,0.667,0,1,0.0,2,2,1.0,0,1,1,0,0,1,0,0,6,5,1,ORL,ORL,MIA,105,,,7,7,6,1
Jonathan Isaac,F,22023,1628371,22300585,"JAN 19, 2024",ORL vs. PHI,L,13,3,7,0.429,1,3,0.333,0,0,0.0,1,2,3,1,0,1,0,0,7,-3,1,ORL,ORL,PHI,109,,,11,10,8,4
Jonathan Isaac,F,22023,1628371,22300570,"JAN 17, 2024",ORL @ ATL,L,10,1,2,0.5,0,0,0.0,0,0,0.0,0,0,0,2,2,0,0,0,2,8,1,ORL,ATL,ORL,104,,,4,2,4,2
Jonathan Isaac,F,22023,1628371,22300557,"JAN 15, 2024",ORL @ NYK,W,16,2,4,0.5,1,2,0.5,0,0,0.0,1,6,7,0,0,1,0,1,5,15,1,ORL,NYK,ORL,98,,,12,12,5,7
Jonathan Isaac,F,22023,1628371,22300546,"JAN 13, 2024",ORL @ OKC,L,15,0,1,0.0,0,0,0.0,6,8,0.75,2,3,5,1,0,0,0,3,6,-7,1,ORL,OKC,ORL,100,,,12,11,7,6
Jonathan Isaac,F,22023,1628371,22300391,"DEC 23, 2023",ORL @ IND,W,12,2,3,0.667,0,1,0.0,0,0,0.0,0,1,1,1,0,3,0,0,4,9,1,ORL,IND,ORL,117,,,6,5,5,2
Jonathan Isaac,F,22023,1628371,22300378,"DEC 21, 2023",ORL @ MIL,L,14,2,7,0.286,0,0,0.0,0,1,0.0,3,1,4,0,1,3,1,2,4,6,1,ORL,MIL,ORL,114,,,8,8,4,4
Jonathan Isaac,F,22023,1628371,22300366,"DEC 20, 2023",ORL vs. MIA,L,12,4,7,0.571,1,2,0.5,0,0,0.0,1,3,4,1,1,0,1,3,9,-10,1,ORL,ORL,MIA,106,,,14,13,10,5
Jonathan Isaac,F,22023,1628371,22300344,"DEC 17, 2023",ORL @ BOS,L,17,2,5,0.4,2,4,0.5,2,2,1.0,0,2,2,0,1,1,0,0,8,-17,1,ORL,BOS,ORL,97,,,10,10,8,2
Jonathan Isaac,F,22023,1628371,22300329,"DEC 15, 2023",ORL @ BOS,L,16,3,5,0.6,1,2,0.5,0,0,0.0,1,3,4,0,0,0,0,1,7,-13,1,ORL,BOS,ORL,111,,,11,11,7,4
Jonathan Isaac,F,22023,1628371,22300294,"DEC 11, 2023",ORL vs. CLE,W,13,3,6,0.5,1,3,0.333,0,0,0.0,1,3,4,0,2,0,0,0,7,8,1,ORL,ORL,CLE,104,,,11,11,7,4
Jonathan Isaac,F,22023,1628371,22300274,"DEC 01, 2023",ORL vs. WAS,W,7,1,2,0.5,0,1,0.0,1,1,1.0,1,4,5,0,0,1,0,1,3,10,1,ORL,ORL,WAS,130,,,8,8,3,5
Jonathan Isaac,F,22023,1628371,22300043,"NOV 24, 2023",ORL vs. BOS,W,16,1,2,0.5,0,1,0.0,3,4,0.75,3,4,7,0,0,0,0,3,5,17,1,ORL,ORL,BOS,113,,,12,12,5,7
Jonathan Isaac,F,22023,1628371,22300226,"NOV 22, 2023",ORL vs. DEN,W,14,4,6,0.667,0,2,0.0,1,1,1.0,2,4,6,1,1,1,1,1,9,6,1,ORL,ORL,DEN,124,,,16,15,10,7
Jonathan Isaac,F,22023,1628371,22300038,"NOV 21, 2023",ORL vs. TOR,W,12,4,6,0.667,0,2,0.0,1,2,0.5,1,2,3,0,1,2,2,0,9,9,1,ORL,ORL,TOR,126,,,12,12,9,3
Jonathan Isaac,F,22023,1628371,22300209,"NOV 19, 2023",ORL @ IND,W,14,2,5,0.4,0,0,0.0,1,2,0.5,1,2,3,0,1,1,0,1,5,-1,1,ORL,IND,ORL,128,,,8,8,5,3
Jonathan Isaac,F,22023,1628371,22300033,"NOV 17, 2023",ORL @ CHI,W,20,6,8,0.75,2,4,0.5,4,4,1.0,3,6,9,1,1,1,1,2,18,10,1,ORL,CHI,ORL,103,,,28,27,19,10
Jonathan Isaac,F,22023,1628371,22300196,"NOV 15, 2023",ORL @ CHI,W,17,1,4,0.25,0,1,0.0,2,2,1.0,1,6,7,0,2,2,1,0,4,4,1,ORL,CHI,ORL,96,,,11,11,4,7
Jonathan Isaac,F,22023,1628371,22300020,"NOV 14, 2023",ORL @ BKN,L,12,1,4,0.25,1,4,0.25,0,0,0.0,0,3,3,1,2,1,2,1,3,2,1,ORL,BKN,ORL,104,,,7,6,4,4
Jonathan Isaac,F,22023,1628371,22300173,"NOV 11, 2023",ORL vs. MIL,W,17,3,10,0.3,2,4,0.5,2,2,1.0,3,2,5,0,2,2,0,4,10,9,1,ORL,ORL,MIL,112,,,15,15,10,5
Jonathan Isaac,F,22023,1628371,22300172,"NOV 09, 2023",ORL vs. ATL,L,16,3,8,0.375,1,4,0.25,5,7,0.714,1,6,7,0,0,2,0,1,12,-2,1,ORL,ORL,ATL,119,,,19,19,12,7
Jonathan Isaac,F,22023,1628371,22300134,"NOV 04, 2023",ORL vs. LAL,W,11,0,3,0.0,0,2,0.0,0,0,0.0,0,0,0,0,0,1,1,2,0,-7,1,ORL,ORL,LAL,120,,,0,0,0,0
Jonathan Isaac,F,22023,1628371,22300130,"NOV 02, 2023",ORL @ UTA,W,12,1,4,0.25,0,3,0.0,1,1,1.0,1,2,3,1,1,3,0,1,3,8,1,ORL,UTA,ORL,115,,,7,6,4,4
Jonathan Isaac,F,22023,1628371,22300111,"OCT 30, 2023",ORL @ LAL,L,11,1,3,0.333,1,3,0.333,0,0,0.0,0,3,3,0,1,0,0,1,3,-1,1,ORL,LAL,ORL,103,,,6,6,3,3
Jonathan Isaac,F,22023,1628371,22300086,"OCT 27, 2023",ORL @ POR,W,8,0,2,0.0,0,1,0.0,0,0,0.0,0,2,2,1,1,0,0,1,0,-3,1,ORL,POR,ORL,102,,,3,2,1,3
Jonathan Isaac,F,22023,1628371,22300066,"OCT 25, 2023",ORL vs. HOU,W,14,4,6,0.667,1,3,0.333,2,3,0.667,1,3,4,0,0,2,2,2,11,12,1,ORL,ORL,HOU,116,,,15,15,11,4
Skylar Mays,G,22023,1630219,22300399,"DEC 23, 2023",POR @ GSW,L,5,0,2,0.0,0,0,0.0,1,2,0.5,0,0,0,1,0,0,1,0,1,-1,1,POR,GSW,POR,106,,,2,1,2,1
Skylar Mays,G,22023,1630219,22300323,"DEC 14, 2023",POR vs. UTA,L,17,0,0,0.0,0,0,0.0,0,0,0.0,1,0,1,5,1,0,0,0,0,24,1,POR,POR,UTA,114,,,6,1,5,6
Skylar Mays,G,22023,1630219,22300041,"NOV 21, 2023",POR @ PHX,L,21,2,5,0.4,2,3,0.667,0,0,0.0,0,2,2,3,0,0,1,2,6,-13,1,POR,PHX,POR,107,,,11,8,9,5
Skylar Mays,G,22023,1630219,22300215,"NOV 19, 2023",POR vs. OKC,L,26,4,9,0.444,2,6,0.333,1,2,0.5,0,2,2,7,2,0,3,0,11,-37,1,POR,POR,OKC,89,,,20,13,18,9
Skylar Mays,G,22023,1630219,22300036,"NOV 17, 2023",POR vs. LAL,L,26,6,14,0.429,3,7,0.429,0,0,0.0,3,2,5,8,2,0,0,3,15,-11,1,POR,POR,LAL,95,,,28,20,23,13
Skylar Mays,G,22023,1630219,22300199,"NOV 15, 2023",POR vs. CLE,L,31,4,13,0.308,2,4,0.5,3,3,1.0,0,1,1,4,1,0,2,4,13,-13,1,POR,POR,CLE,93,,,18,14,17,5
Skylar Mays,G,22023,1630219,22300023,"NOV 14, 2023",POR @ UTA,L,31,3,8,0.375,0,1,0.0,0,0,0.0,0,5,5,10,0,2,2,1,6,1,1,POR,UTA,POR,99,,,21,11,16,15
Skylar Mays,G,22023,1630219,22300187,"NOV 12, 2023",POR @ LAL,L,33,7,13,0.538,0,4,0.0,1,2,0.5,0,4,4,12,0,0,1,2,15,-1,1,POR,LAL,POR,104,,,31,19,27,16
Skylar Mays,G,22023,1630219,22300170,"NOV 08, 2023",POR @ SAC,L,37,8,15,0.533,0,2,0.0,2,2,1.0,0,2,2,11,2,0,3,4,18,-8,1,POR,SAC,POR,118,,,31,20,29,13
Skylar Mays,G,22023,1630219,22300144,"NOV 05, 2023",POR vs. MEM,L,16,2,9,0.222,1,5,0.2,2,2,1.0,0,1,1,2,2,0,0,3,7,9,1,POR,POR,MEM,100,,,10,8,9,3
Skylar Mays,G,22023,1630219,22300007,"NOV 03, 2023",POR vs. MEM,W,15,3,8,0.375,1,5,0.2,2,2,1.0,0,1,1,1,1,0,1,0,9,-9,1,POR,POR,MEM,115,,,11,10,10,2
Skylar Mays,G,22023,1630219,22300115,"NOV 01, 2023",POR @ DET,W,8,1,3,0.333,0,0,0.0,0,0,0.0,1,0,1,2,0,0,1,0,2,9,1,POR,DET,POR,110,,,5,3,4,3
Skylar Mays,G,22023,1630219,22300105,"OCT 30, 2023",POR @ TOR,W,11,2,4,0.5,1,3,0.333,0,0,0.0,0,0,0,1,1,0,0,0,5,3,1,POR,TOR,POR,99,,,6,5,6,1
Skylar Mays,G,22023,1630219,22300098,"OCT 29, 2023",POR @ PHI,L,5,0,2,0.0,0,1,0.0,0,0,0.0,0,0,0,1,0,0,1,0,0,-7,1,POR,PHI,POR,98,,,1,0,1,1
Skylar Mays,G,22023,1630219,22300086,"OCT 27, 2023",POR vs. ORL,L,8,1,2,0.5,0,0,0.0,0,0,0.0,0,0,0,1,0,0,0,0,2,0,1,POR,POR,ORL,97,,,3,2,3,1
Skylar Mays,G,22023,1630219,22300472,"JAN 03, 2024",POR @ DAL,L,8,2,4,0.5,0,0,0.0,1,2,0.5,1,4,5,1,0,0,1,0,5,3,1,POR,DAL,POR,97,,,11,10,6,6
Skylar Mays,G,22023,1630219,22300456,"JAN 01, 2024",POR @ PHX,L,17,3,8,0.375,1,3,0.333,0,0,0.0,1,1,2,3,0,1,1,1,7,-10,1,POR,PHX,POR,84,,,12,9,10,5
Skylar Mays,G,22023,1630219,22300437,"DEC 29, 2023",POR vs. SAS,W,20,5,10,0.5,1,1,1.0,0,0,0.0,1,1,2,2,1,0,0,0,11,-9,1,POR,POR,SAS,132,,,15,13,13,4
Skylar Mays,G,22023,1630219,22300427,"DEC 28, 2023",POR vs. SAS,L,14,0,8,0.0,0,4,0.0,0,0,0.0,1,2,3,0,1,0,0,0,0,-9,1,POR,POR,SAS,98,,,3,3,0,3
Skylar Mays,G,22023,1630219,22300413,"DEC 26, 2023",POR vs. SAC,W,2,0,0,0.0,0,0,0.0,0,0,0.0,0,0,0,0,0,0,0,0,0,-2,1,POR,POR,SAC,130,,,0,0,0,0
Skylar Mays,G,22023,1630219,22300237,"NOV 22, 2023",POR vs. UTA,W,6,0,1,0.0,0,0,0.0,0,0,0.0,0,0,0,0,0,0,0,0,0,-14,1,POR,POR,UTA,121,,,0,0,0,0
Skylar Mays,G,22023,1630219,22300740,"FEB 08, 2024",LAL vs. DEN,L,7,0,1,0.0,0,0,0.0,0,0,0.0,0,0,0,2,1,0,1,0,0,1,1,LAL,LAL,DEN,106,,,2,0,2,2
Skylar Mays,G,22023,1630219,22300684,"FEB 01, 2024",LAL @ BOS,W,1,0,0,0.0,0,0,0.0,0,0,0.0,0,0,0,0,0,0,0,0,0,0,1,LAL,BOS,LAL,114,,,0,0,0,0
Skylar Mays,G,22023,1630219,22300669,"JAN 30, 2024",LAL @ ATL,L,3,0,0,0.0,0,0,0.0,0,0,0.0,0,1,1,2,0,0,0,1,0,2,1,LAL,ATL,LAL,122,,,3,1,2,3
Skylar Mays,G,22023,1630219,22300577,"JAN 17, 2024",LAL vs. DAL,W,5,1,2,0.5,0,0,0.0,0,0,0.0,0,0,0,1,0,0,0,1,2,-6,1,LAL,LAL,DAL,127,,,3,2,3,1
Skylar Mays,G,22023,1630219,22300549,"JAN 13, 2024",LAL @ UTA,L,10,0,2,0.0,0,0,0.0,0,0,0.0,0,1,1,2,1,0,0,2,0,-5,1,LAL,UTA,LAL,125,,,3,1,2,3
Skylar Mays,G,22023,1630219,22300531,"JAN 11, 2024",LAL vs. PHX,L,12,5,6,0.833,2,2,1.0,0,0,0.0,1,0,1,1,1,0,0,0,12,9,1,LAL,LAL,PHX,109,,,14,13,13,2
Skylar Mays,G,22023,1630219,22300747,"FEB 09, 2024",LAL vs. NOP,W,16,1,5,0.2,0,3,0.0,0,0,0.0,0,1,1,0,0,1,0,0,2,0,1,LAL,LAL,NOP,139,,,3,3,2,1
Skylar Mays,G,22023,1630219,22300399,"DEC 23, 2023",POR @ GSW,L,5,0,2,0.0,0,0,0.0,1,2,0.5,0,0,0,1,0,0,1,0,1,-1,1,POR,GSW,POR,106,,,2,1,2,1
Skylar Mays,G,22023,1630219,22300323,"DEC 14, 2023",POR vs. UTA,L,17,0,0,0.0,0,0,0.0,0,0,0.0,1,0,1,5,1,0,0,0,0,24,1,POR,POR,UTA,114,,,6,1,5,6
Skylar Mays,G,22023,1630219,22300041,"NOV 21, 2023",POR @ PHX,L,21,2,5,0.4,2,3,0.667,0,0,0.0,0,2,2,3,0,0,1,2,6,-13,1,POR,PHX,POR,107,,,11,8,9,5
Skylar Mays,G,22023,1630219,22300215,"NOV 19, 2023",POR vs. OKC,L,26,4,9,0.444,2,6,0.333,1,2,0.5,0,2,2,7,2,0,3,0,11,-37,1,POR,POR,OKC,89,,,20,13,18,9
Skylar Mays,G,22023,1630219,22300036,"NOV 17, 2023",POR vs. LAL,L,26,6,14,0.429,3,7,0.429,0,0,0.0,3,2,5,8,2,0,0,3,15,-11,1,POR,POR,LAL,95,,,28,20,23,13
Skylar Mays,G,22023,1630219,22300199,"NOV 15, 2023",POR vs. CLE,L,31,4,13,0.308,2,4,0.5,3,3,1.0,0,1,1,4,1,0,2,4,13,-13,1,POR,POR,CLE,93,,,18,14,17,5
Skylar Mays,G,22023,1630219,22300023,"NOV 14, 2023",POR @ UTA,L,31,3,8,0.375,0,1,0.0,0,0,0.0,0,5,5,10,0,2,2,1,6,1,1,POR,UTA,POR,99,,,21,11,16,15
Skylar Mays,G,22023,1630219,22300187,"NOV 12, 2023",POR @ LAL,L,33,7,13,0.538,0,4,0.0,1,2,0.5,0,4,4,12,0,0,1,2,15,-1,1,POR,LAL,POR,104,,,31,19,27,16
Skylar Mays,G,22023,1630219,22300170,"NOV 08, 2023",POR @ SAC,L,37,8,15,0.533,0,2,0.0,2,2,1.0,0,2,2,11,2,0,3,4,18,-8,1,POR,SAC,POR,118,,,31,20,29,13
Skylar Mays,G,22023,1630219,22300144,"NOV 05, 2023",POR vs. MEM,L,16,2,9,0.222,1,5,0.2,2,2,1.0,0,1,1,2,2,0,0,3,7,9,1,POR,POR,MEM,100,,,10,8,9,3
Skylar Mays,G,22023,1630219,22300007,"NOV 03, 2023",POR vs. MEM,W,15,3,8,0.375,1,5,0.2,2,2,1.0,0,1,1,1,1,0,1,0,9,-9,1,POR,POR,MEM,115,,,11,10,10,2
Skylar Mays,G,22023,1630219,22300115,"NOV 01, 2023",POR @ DET,W,8,1,3,0.333,0,0,0.0,0,0,0.0,1,0,1,2,0,0,1,0,2,9,1,POR,DET,POR,110,,,5,3,4,3
Skylar Mays,G,22023,1630219,22300105,"OCT 30, 2023",POR @ TOR,W,11,2,4,0.5,1,3,0.333,0,0,0.0,0,0,0,1,1,0,0,0,5,3,1,POR,TOR,POR,99,,,6,5,6,1
Skylar Mays,G,22023,1630219,22300098,"OCT 29, 2023",POR @ PHI,L,5,0,2,0.0,0,1,0.0,0,0,0.0,0,0,0,1,0,0,1,0,0,-7,1,POR,PHI,POR,98,,,1,0,1,1
Skylar Mays,G,22023,1630219,22300086,"OCT 27, 2023",POR vs. ORL,L,8,1,2,0.5,0,0,0.0,0,0,0.0,0,0,0,1,0,0,0,0,2,0,1,POR,POR,ORL,97,,,3,2,3,1
Skylar Mays,G,22023,1630219,22300472,"JAN 03, 2024",POR @ DAL,L,8,2,4,0.5,0,0,0.0,1,2,0.5,1,4,5,1,0,0,1,0,5,3,1,POR,DAL,POR,97,,,11,10,6,6
Skylar Mays,G,22023,1630219,22300456,"JAN 01, 2024",POR @ PHX,L,17,3,8,0.375,1,3,0.333,0,0,0.0,1,1,2,3,0,1,1,1,7,-10,1,POR,PHX,POR,84,,,12,9,10,5
Skylar Mays,G,22023,1630219,22300437,"DEC 29, 2023",POR vs. SAS,W,20,5,10,0.5,1,1,1.0,0,0,0.0,1,1,2,2,1,0,0,0,11,-9,1,POR,POR,SAS,132,,,15,13,13,4
Skylar Mays,G,22023,1630219,22300427,"DEC 28, 2023",POR vs. SAS,L,14,0,8,0.0,0,4,0.0,0,0,0.0,1,2,3,0,1,0,0,0,0,-9,1,POR,POR,SAS,98,,,3,3,0,3
Skylar Mays,G,22023,1630219,22300413,"DEC 26, 2023",POR vs. SAC,W,2,0,0,0.0,0,0,0.0,0,0,0.0,0,0,0,0,0,0,0,0,0,-2,1,POR,POR,SAC,130,,,0,0,0,0
Skylar Mays,G,22023,1630219,22300237,"NOV 22, 2023",POR vs. UTA,W,6,0,1,0.0,0,0,0.0,0,0,0.0,0,0,0,0,0,0,0,0,0,-14,1,POR,POR,UTA,121,,,0,0,0,0
Skylar Mays,G,22023,1630219,22300740,"FEB 08, 2024",LAL vs. DEN,L,7,0,1,0.0,0,0,0.0,0,0,0.0,0,0,0,2,1,0,1,0,0,1,1,LAL,LAL,DEN,106,,,2,0,2,2
Skylar Mays,G,22023,1630219,22300684,"FEB 01, 2024",LAL @ BOS,W,1,0,0,0.0,0,0,0.0,0,0,0.0,0,0,0,0,0,0,0,0,0,0,1,LAL,BOS,LAL,114,,,0,0,0,0
Skylar Mays,G,22023,1630219,22300669,"JAN 30, 2024",LAL @ ATL,L,3,0,0,0.0,0,0,0.0,0,0,0.0,0,1,1,2,0,0,0,1,0,2,1,LAL,ATL,LAL,122,,,3,1,2,3
Skylar Mays,G,22023,1630219,22300577,"JAN 17, 2024",LAL vs. DAL,W,5,1,2,0.5,0,0,0.0,0,0,0.0,0,0,0,1,0,0,0,1,2,-6,1,LAL,LAL,DAL,127,,,3,2,3,1
Skylar Mays,G,22023,1630219,22300549,"JAN 13, 2024",LAL @ UTA,L,10,0,2,0.0,0,0,0.0,0,0,0.0,0,1,1,2,1,0,0,2,0,-5,1,LAL,UTA,LAL,125,,,3,1,2,3
Skylar Mays,G,22023,1630219,22300531,"JAN 11, 2024",LAL vs. PHX,L,12,5,6,0.833,2,2,1.0,0,0,0.0,1,0,1,1,1,0,0,0,12,9,1,LAL,LAL,PHX,109,,,14,13,13,2
Skylar Mays,G,22023,1630219,22300747,"FEB 09, 2024",LAL vs. NOP,W,16,1,5,0.2,0,3,0.0,0,0,0.0,0,1,1,0,0,1,0,0,2,0,1,LAL,LAL,NOP,139,,,3,3,2,1
Monte Morris,G,22023,1628420,22300704,"FEB 04, 2024",DET vs. ORL,L,9,1,5,0.2,0,2,0.0,0,0,0.0,2,2,4,0,0,0,0,0,2,3,1,DET,DET,ORL,99,,,6,6,2,4
Monte Morris,G,22023,1628420,22300688,"FEB 02, 2024",DET vs. LAC,L,10,0,4,0.0,0,2,0.0,0,0,0.0,0,1,1,1,0,0,0,0,0,-15,1,DET,DET,LAC,125,,,2,1,1,2
Monte Morris,G,22023,1628420,22300675,"JAN 31, 2024",DET @ CLE,L,16,4,8,0.5,0,2,0.0,0,0,0.0,0,2,2,2,0,0,1,0,8,16,1,DET,CLE,DET,121,,,12,10,10,4
Monte Morris,G,22023,1628420,22300654,"JAN 28, 2024",DET vs. OKC,W,14,4,8,0.5,1,2,0.5,0,0,0.0,0,1,1,2,1,0,0,0,9,5,1,DET,DET,OKC,120,,,12,10,11,3
Monte Morris,G,22023,1628420,22300642,"JAN 27, 2024",DET vs. WAS,L,8,0,4,0.0,0,2,0.0,1,2,0.5,0,1,1,0,0,1,1,1,1,-14,1,DET,DET,WAS,104,,,2,2,1,1
Monte Morris,G,22023,1628420,22300619,"JAN 24, 2024",DET vs. CHA,W,11,3,4,0.75,1,1,1.0,0,0,0.0,0,3,3,3,0,0,0,0,7,3,1,DET,DET,CHA,113,,,13,10,10,6
Kyle Anderson,F-G,22023,203937,22300738,"FEB 08, 2024",MIN @ MIL,W,24,3,3,1.0,0,0,0.0,2,2,1.0,3,2,5,6,3,0,3,1,8,9,1,MIN,MIL,MIN,129,,,19,13,14,11
Kyle Anderson,F-G,22023,203937,22300723,"FEB 06, 2024",MIN @ CHI,L,16,1,2,0.5,0,0,0.0,0,0,0.0,1,1,2,3,0,0,1,1,2,-4,1,MIN,CHI,MIN,123,,,7,4,5,5
Kyle Anderson,F-G,22023,203937,22300709,"FEB 04, 2024",MIN vs. HOU,W,17,3,5,0.6,0,1,0.0,0,0,0.0,1,1,2,4,1,1,0,2,6,-7,1,MIN,MIN,HOU,111,,,12,8,10,6
Kyle Anderson,F-G,22023,203937,22300694,"FEB 02, 2024",MIN vs. ORL,L,16,3,6,0.5,1,1,1.0,0,0,0.0,1,2,3,4,0,1,0,2,7,10,1,MIN,MIN,ORL,106,,,14,10,11,7
Kyle Anderson,F-G,22023,203937,22300680,"JAN 31, 2024",MIN vs. DAL,W,16,2,2,1.0,0,0,0.0,1,2,0.5,1,2,3,3,0,0,1,0,5,14,1,MIN,MIN,DAL,121,,,11,8,8,6
Kyle Anderson,F-G,22023,203937,22300664,"JAN 29, 2024",MIN @ OKC,W,17,1,4,0.25,0,0,0.0,0,0,0.0,1,2,3,3,1,0,0,2,2,-5,1,MIN,OKC,MIN,107,,,8,5,5,6
Kyle Anderson,F-G,22023,203937,22300649,"JAN 27, 2024",MIN @ SAS,L,19,2,6,0.333,0,0,0.0,0,2,0.0,2,1,3,1,1,0,1,0,4,-5,1,MIN,SAS,MIN,112,,,8,7,5,4
Kyle Anderson,F-G,22023,203937,22300629,"JAN 25, 2024",MIN @ BKN,W,18,1,3,0.333,0,0,0.0,1,2,0.5,1,2,3,5,2,0,1,0,3,-1,1,MIN,BKN,MIN,96,,,11,6,8,8
Kyle Anderson,F-G,22023,203937,22300620,"JAN 24, 2024",MIN @ WAS,W,22,1,4,0.25,0,0,0.0,1,2,0.5,1,4,5,5,0,0,0,1,3,-3,1,MIN,WAS,MIN,118,,,13,8,8,10
Kyle Anderson,F-G,22023,203937,22300610,"JAN 22, 2024",MIN vs. CHA,L,22,1,2,0.5,0,0,0.0,3,3,1.0,1,3,4,8,0,0,1,1,5,-8,1,MIN,MIN,CHA,125,,,17,9,13,12
Kyle Anderson,F-G,22023,203937,22300599,"JAN 20, 2024",MIN vs. OKC,L,19,2,4,0.5,1,3,0.333,0,0,0.0,1,0,1,4,1,0,0,2,5,13,1,MIN,MIN,OKC,97,,,10,6,9,5
Kyle Anderson,F-G,22023,203937,22300582,"JAN 18, 2024",MIN vs. MEM,W,15,1,3,0.333,0,0,0.0,2,2,1.0,0,3,3,3,1,0,1,3,4,5,1,MIN,MIN,MEM,118,,,10,7,7,6
Kyle Anderson,F-G,22023,203937,22300569,"JAN 17, 2024",MIN @ DET,W,22,2,6,0.333,0,0,0.0,0,0,0.0,0,3,3,9,1,2,1,2,4,3,1,MIN,DET,MIN,124,,,16,7,13,12
Kyle Anderson,F-G,22023,203937,22300553,"JAN 14, 2024",MIN vs. LAC,W,27,4,6,0.667,1,1,1.0,1,3,0.333,0,1,1,3,1,0,0,4,10,-6,1,MIN,MIN,LAC,109,,,14,11,13,4
Kyle Anderson,F-G,22023,203937,22300538,"JAN 12, 2024",MIN vs. POR,W,15,1,2,0.5,0,0,0.0,0,0,0.0,0,2,2,1,0,0,2,2,2,-4,1,MIN,MIN,POR,116,,,5,4,3,3
Kyle Anderson,F-G,22023,203937,22300517,"JAN 10, 2024",MIN @ BOS,L,39,7,12,0.583,0,0,0.0,3,4,0.75,2,6,8,5,1,1,0,5,17,-11,1,MIN,BOS,MIN,120,,,30,25,22,13
Kyle Anderson,F-G,22023,203937,22300513,"JAN 09, 2024",MIN @ ORL,W,21,4,6,0.667,0,1,0.0,3,4,0.75,0,1,1,3,0,0,0,1,11,5,1,MIN,ORL,MIN,113,,,15,12,14,4
Kyle Anderson,F-G,22023,203937,22300501,"JAN 07, 2024",MIN @ DAL,L,20,1,1,1.0,0,0,0.0,2,2,1.0,1,1,2,4,0,0,1,3,4,-6,1,MIN,DAL,MIN,108,,,10,6,8,6
Kyle Anderson,F-G,22023,203937,22300485,"JAN 05, 2024",MIN @ HOU,W,18,1,4,0.25,0,0,0.0,0,0,0.0,1,6,7,5,3,0,2,3,2,16,1,MIN,HOU,MIN,122,,,14,9,7,12
Kyle Anderson,F-G,22023,203937,22300471,"JAN 03, 2024",MIN vs. NOP,L,13,0,2,0.0,0,0,0.0,1,2,0.5,1,3,4,0,2,0,0,0,1,0,1,MIN,MIN,NOP,106,,,5,5,1,4
Kyle Anderson,F-G,22023,203937,22300451,"JAN 01, 2024",MIN @ NYK,L,17,1,1,1.0,0,0,0.0,0,2,0.0,0,2,2,3,2,0,3,0,2,-2,1,MIN,NYK,MIN,106,,,7,4,5,5
Kyle Anderson,F-G,22023,203937,22300443,"DEC 30, 2023",MIN vs. LAL,W,24,2,4,0.5,0,1,0.0,0,0,0.0,0,3,3,7,0,1,1,0,4,-8,1,MIN,MIN,LAL,108,,,14,7,11,10
Kyle Anderson,F-G,22023,203937,22300423,"DEC 28, 2023",MIN vs. DAL,W,27,3,8,0.375,1,1,1.0,1,2,0.5,1,9,10,3,0,0,3,0,8,-11,1,MIN,MIN,DAL,118,,,21,18,11,13
Kyle Anderson,F-G,22023,203937,22300411,"DEC 26, 2023",MIN @ OKC,L,23,2,4,0.5,0,1,0.0,3,3,1.0,0,0,0,1,0,0,2,1,7,-10,1,MIN,OKC,MIN,106,,,8,7,8,1
Kyle Anderson,F-G,22023,203937,22300400,"DEC 23, 2023",MIN @ SAC,W,29,4,9,0.444,0,0,0.0,2,2,1.0,1,4,5,5,0,1,2,4,10,9,1,MIN,SAC,MIN,110,,,20,15,15,10
Kyle Anderson,F-G,22023,203937,22300380,"DEC 21, 2023",MIN vs. LAL,W,23,4,7,0.571,0,2,0.0,1,1,1.0,2,3,5,4,1,1,1,0,9,8,1,MIN,MIN,LAL,118,,,18,14,13,9
Kyle Anderson,F-G,22023,203937,22300367,"DEC 20, 2023",MIN @ PHI,L,13,1,5,0.2,0,0,0.0,0,0,0.0,0,0,0,1,0,0,2,0,2,-10,1,MIN,PHI,MIN,113,,,3,2,3,1
Kyle Anderson,F-G,22023,203937,22300353,"DEC 18, 2023",MIN @ MIA,W,22,2,4,0.5,0,0,0.0,1,2,0.5,0,1,1,5,1,1,1,2,5,1,1,MIN,MIA,MIN,112,,,11,6,10,6
Kyle Anderson,F-G,22023,203937,22300338,"DEC 16, 2023",MIN vs. IND,W,23,2,4,0.5,0,0,0.0,0,0,0.0,1,3,4,10,0,0,2,4,4,6,1,MIN,MIN,IND,127,,,18,8,14,14
Kyle Anderson,F-G,22023,203937,22300321,"DEC 14, 2023",MIN @ DAL,W,18,3,7,0.429,0,1,0.0,0,0,0.0,0,2,2,2,2,1,1,2,6,4,1,MIN,DAL,MIN,119,,,10,8,8,4
Kyle Anderson,F-G,22023,203937,22300301,"DEC 11, 2023",MIN @ NOP,L,19,3,6,0.5,0,0,0.0,0,0,0.0,1,3,4,3,2,0,0,1,6,7,1,MIN,NOP,MIN,107,,,13,10,9,7
Kyle Anderson,F-G,22023,203937,22301221,"DEC 08, 2023",MIN @ MEM,W,22,2,11,0.182,0,6,0.0,3,4,0.75,1,5,6,5,0,0,2,0,7,-3,1,MIN,MEM,MIN,127,,,18,13,12,11
Kyle Anderson,F-G,22023,203937,22301210,"DEC 06, 2023",MIN vs. SAS,W,22,2,6,0.333,0,0,0.0,3,4,0.75,0,1,1,2,0,4,0,2,7,-7,1,MIN,MIN,SAS,102,,,10,8,9,3
Kyle Anderson,F-G,22023,203937,22300281,"DEC 02, 2023",MIN @ CHA,W,26,2,6,0.333,0,0,0.0,7,7,1.0,2,4,6,4,2,0,2,3,11,2,1,MIN,CHA,MIN,123,,,21,17,15,10
Kyle Anderson,F-G,22023,203937,22300270,"NOV 30, 2023",MIN vs. UTA,W,19,2,7,0.286,0,1,0.0,0,0,0.0,0,1,1,6,0,0,0,0,4,-6,1,MIN,MIN,UTA,101,,,11,5,10,7
Kyle Anderson,F-G,22023,203937,22300058,"NOV 28, 2023",MIN vs. OKC,W,23,2,6,0.333,0,0,0.0,3,4,0.75,2,3,5,2,0,1,4,1,7,-7,1,MIN,MIN,OKC,106,,,14,12,9,7
Kyle Anderson,F-G,22023,203937,22300249,"NOV 26, 2023",MIN @ MEM,W,23,3,7,0.429,0,1,0.0,0,0,0.0,1,5,6,3,0,1,0,3,6,13,1,MIN,MEM,MIN,119,,,15,12,9,9
Kyle Anderson,F-G,22023,203937,22300050,"NOV 24, 2023",MIN vs. SAC,L,18,1,2,0.5,0,0,0.0,2,2,1.0,0,1,1,4,0,0,0,1,4,-24,1,MIN,MIN,SAC,111,,,9,5,8,5
Kyle Anderson,F-G,22023,203937,22300232,"NOV 22, 2023",MIN vs. PHI,W,28,3,6,0.5,0,0,0.0,1,4,0.25,1,4,5,3,0,1,2,1,7,3,1,MIN,MIN,PHI,112,,,15,12,10,8
Kyle Anderson,F-G,22023,203937,22300221,"NOV 20, 2023",MIN vs. NYK,W,23,3,4,0.75,0,0,0.0,3,5,0.6,0,2,2,5,1,2,1,2,9,3,1,MIN,MIN,NYK,117,,,16,11,14,7
Kyle Anderson,F-G,22023,203937,22300203,"NOV 18, 2023",MIN @ NOP,W,26,4,7,0.571,0,0,0.0,1,2,0.5,1,4,5,5,1,2,1,0,9,5,1,MIN,NOP,MIN,121,,,19,14,14,10
Kyle Anderson,F-G,22023,203937,22300197,"NOV 15, 2023",MIN @ PHX,L,21,2,5,0.4,0,0,0.0,2,2,1.0,1,1,2,3,2,1,1,0,6,-13,1,MIN,PHX,MIN,115,,,11,8,9,5
Kyle Anderson,F-G,22023,203937,22300025,"NOV 14, 2023",MIN @ GSW,W,27,3,9,0.333,0,2,0.0,2,2,1.0,1,3,4,3,0,1,2,4,8,11,1,MIN,GSW,MIN,104,,,15,12,11,7
Kyle Anderson,F-G,22023,203937,22300186,"NOV 12, 2023",MIN @ GSW,W,17,4,4,1.0,0,0,0.0,0,2,0.0,0,4,4,1,1,0,3,1,8,-13,1,MIN,GSW,MIN,116,,,13,12,9,5
Kyle Anderson,F-G,22023,203937,22300013,"NOV 10, 2023",MIN @ SAS,W,26,2,2,1.0,0,0,0.0,2,4,0.5,0,5,5,4,1,0,4,1,6,9,1,MIN,SAS,MIN,117,,,15,11,10,9
Kyle Anderson,F-G,22023,203937,22300166,"NOV 08, 2023",MIN vs. NOP,W,25,2,3,0.667,1,2,0.5,1,2,0.5,0,2,2,5,1,2,2,2,6,16,1,MIN,MIN,NOP,122,,,13,8,11,7
Kyle Anderson,F-G,22023,203937,22300154,"NOV 06, 2023",MIN vs. BOS,W,25,1,6,0.167,0,2,0.0,1,2,0.5,2,3,5,6,0,1,4,4,3,6,1,MIN,MIN,BOS,114,,,14,8,9,11
Kyle Anderson,F-G,22023,203937,22300138,"NOV 04, 2023",MIN vs. UTA,W,27,5,6,0.833,0,0,0.0,2,2,1.0,1,2,3,6,1,2,0,3,12,11,1,MIN,MIN,UTA,123,,,21,15,18,9
Kyle Anderson,F-G,22023,203937,22300123,"NOV 01, 2023",MIN vs. DEN,W,25,4,6,0.667,1,1,1.0,0,0,0.0,0,3,3,2,0,0,0,0,9,-1,1,MIN,MIN,DEN,110,,,14,12,11,5
Kyle Anderson,F-G,22023,203937,22300104,"OCT 30, 2023",MIN @ ATL,L,25,2,5,0.4,0,2,0.0,0,0,0.0,1,1,2,5,2,1,2,1,4,-8,1,MIN,ATL,MIN,113,,,11,6,9,7
Kyle Anderson,F-G,22023,203937,22300093,"OCT 28, 2023",MIN vs. MIA,W,23,5,6,0.833,0,0,0.0,2,2,1.0,0,2,2,4,2,0,2,1,12,7,1,MIN,MIN,MIA,106,,,18,14,16,6
Kyle Anderson,F-G,22023,203937,22300069,"OCT 25, 2023",MIN @ TOR,L,30,3,9,0.333,0,1,0.0,1,2,0.5,2,7,9,5,2,0,1,0,7,15,1,MIN,TOR,MIN,94,,,21,16,12,14
Mitchell Robinson,C,22023,1629011,22301201,"DEC 05, 2023",NYK @ MIL,L,27,1,2,0.5,0,0,0.0,0,0,0.0,1,3,4,3,2,1,2,2,2,-10,1,NYK,MIL,NYK,122,,,9,6,5,7
Mitchell Robinson,C,22023,1629011,22300221,"NOV 20, 2023",NYK @ MIN,L,30,5,7,0.714,0,0,0.0,0,0,0.0,7,4,11,0,2,2,2,3,10,-11,1,NYK,MIN,NYK,100,,,21,21,10,11
Mitchell Robinson,C,22023,1629011,22300028,"NOV 17, 2023",NYK @ WAS,W,27,3,4,0.75,0,0,0.0,0,1,0.0,3,5,8,1,0,1,0,1,6,16,1,NYK,WAS,NYK,120,,,15,14,7,9
Mitchell Robinson,C,22023,1629011,22300177,"NOV 12, 2023",NYK vs. CHA,W,24,5,7,0.714,0,0,0.0,0,2,0.0,5,4,9,0,1,0,0,2,10,4,1,NYK,NYK,CHA,129,,,19,19,10,9
Mitchell Robinson,C,22023,1629011,22300161,"NOV 08, 2023",NYK vs. SAS,W,31,3,4,0.75,0,0,0.0,2,6,0.333,5,7,12,1,0,0,0,3,8,30,1,NYK,NYK,SAS,126,,,21,20,9,13
Mitchell Robinson,C,22023,1629011,22300112,"OCT 31, 2023",NYK @ CLE,W,22,4,4,1.0,0,0,0.0,0,0,0.0,3,4,7,0,1,0,1,0,8,6,1,NYK,CLE,NYK,109,,,15,15,8,7
Mitchell Robinson,C,22023,1629011,22301227,"DEC 08, 2023",NYK @ BOS,L,19,5,6,0.833,0,0,0.0,0,2,0.0,5,3,8,2,1,0,1,2,10,-19,1,NYK,BOS,NYK,123,,,20,18,12,10
Mitchell Robinson,C,22023,1629011,22300276,"DEC 01, 2023",NYK @ TOR,W,32,3,3,1.0,0,0,0.0,0,0,0.0,2,3,5,1,4,1,2,3,6,6,1,NYK,TOR,NYK,119,,,12,11,7,6
Mitchell Robinson,C,22023,1629011,22300268,"NOV 30, 2023",NYK vs. DET,W,31,2,4,0.5,0,0,0.0,2,2,1.0,6,3,9,1,1,1,1,2,6,8,1,NYK,NYK,DET,118,,,16,15,7,10
Mitchell Robinson,C,22023,1629011,22300057,"NOV 28, 2023",NYK vs. CHA,W,33,3,6,0.5,0,0,0.0,0,0,0.0,5,5,10,0,2,6,4,1,6,18,1,NYK,NYK,CHA,115,,,16,16,6,10
Mitchell Robinson,C,22023,1629011,22300247,"NOV 26, 2023",NYK vs. PHX,L,34,1,2,0.5,0,0,0.0,1,4,0.25,5,6,11,1,1,1,1,2,3,-1,1,NYK,NYK,PHX,113,,,15,14,4,12
Mitchell Robinson,C,22023,1629011,22300045,"NOV 24, 2023",NYK vs. MIA,W,20,2,4,0.5,0,0,0.0,1,4,0.25,3,4,7,0,2,0,0,2,5,-17,1,NYK,NYK,MIA,100,,,12,12,5,7
Mitchell Robinson,C,22023,1629011,22300202,"NOV 18, 2023",NYK @ CHA,W,33,2,5,0.4,0,0,0.0,0,0,0.0,11,3,14,1,0,3,3,0,4,9,1,NYK,CHA,NYK,122,,,19,18,5,15
Mitchell Robinson,C,22023,1629011,22300151,"NOV 06, 2023",NYK vs. LAC,W,35,6,10,0.6,0,0,0.0,1,1,1.0,9,6,15,0,4,0,0,2,13,4,1,NYK,NYK,LAC,111,,,28,28,13,15
Mitchell Robinson,C,22023,1629011,22300090,"OCT 28, 2023",NYK @ NOP,L,29,4,8,0.5,0,0,0.0,0,0,0.0,10,5,15,0,1,2,0,1,8,-11,1,NYK,NOP,NYK,87,,,23,23,8,15
Mitchell Robinson,C,22023,1629011,22300079,"OCT 27, 2023",NYK @ ATL,W,38,2,6,0.333,0,0,0.0,3,4,0.75,6,7,13,1,4,4,0,1,7,11,1,NYK,ATL,NYK,126,,,21,20,8,14
Mitchell Robinson,C,22023,1629011,22300065,"OCT 25, 2023",NYK vs. BOS,L,22,1,4,0.25,0,0,0.0,0,2,0.0,3,3,6,1,2,0,1,4,2,1,1,NYK,NYK,BOS,104,,,9,8,3,7
Mitchell Robinson,C,22023,1629011,22300193,"NOV 15, 2023",NYK @ ATL,W,31,3,3,1.0,0,0,0.0,0,0,0.0,6,9,15,0,3,1,1,0,6,8,1,NYK,ATL,NYK,116,,,21,21,6,15
Mitchell Robinson,C,22023,1629011,22300188,"NOV 13, 2023",NYK @ BOS,L,33,2,2,1.0,0,0,0.0,0,2,0.0,3,3,6,1,1,2,1,2,4,-14,1,NYK,BOS,NYK,98,,,11,10,5,7
Mitchell Robinson,C,22023,1629011,22300002,"NOV 03, 2023",NYK @ MIL,L,29,0,4,0.0,0,0,0.0,0,0,0.0,6,9,15,1,0,0,0,4,0,-4,1,NYK,MIL,NYK,105,,,16,15,1,16
Mitchell Robinson,C,22023,1629011,22300120,"NOV 01, 2023",NYK vs. CLE,L,32,1,3,0.333,0,0,0.0,4,8,0.5,8,8,16,0,0,2,1,3,6,-1,1,NYK,NYK,CLE,89,,,22,22,6,16
Paul Reed,F,22023,1630194,22300742,"FEB 09, 2024",PHI vs. ATL,L,31,5,9,0.556,0,2,0.0,2,3,0.667,6,7,13,1,1,1,1,6,12,-11,1,PHI,PHI,ATL,121,,,26,25,13,14
Paul Reed,F,22023,1630194,22300727,"FEB 07, 2024",PHI vs. GSW,L,31,3,6,0.5,0,1,0.0,0,0,0.0,4,4,8,4,2,2,0,3,6,-8,1,PHI,PHI,GSW,104,,,18,14,10,12
Paul Reed,F,22023,1630194,22300715,"FEB 05, 2024",PHI vs. DAL,L,22,1,6,0.167,0,1,0.0,0,0,0.0,3,3,6,0,0,1,0,0,2,-9,1,PHI,PHI,DAL,102,,,8,8,2,6
Paul Reed,F,22023,1630194,22300698,"FEB 03, 2024",PHI vs. BKN,L,15,1,5,0.2,0,0,0.0,0,0,0.0,2,2,4,0,0,0,0,2,2,-15,1,PHI,PHI,BKN,121,,,6,6,2,4
Paul Reed,F,22023,1630194,22300686,"FEB 01, 2024",PHI @ UTA,W,28,3,9,0.333,0,1,0.0,1,1,1.0,4,6,10,4,1,2,1,2,7,5,1,PHI,UTA,PHI,127,,,21,17,11,14
Paul Reed,F,22023,1630194,22300668,"JAN 29, 2024",PHI @ POR,L,24,5,8,0.625,1,1,1.0,0,1,0.0,3,3,6,3,1,2,2,3,11,-19,1,PHI,POR,PHI,104,,,20,17,14,9
Paul Reed,F,22023,1630194,22300532,"JAN 12, 2024",PHI vs. SAC,W,24,3,9,0.333,0,1,0.0,2,2,1.0,5,3,8,2,2,3,0,4,8,9,1,PHI,PHI,SAC,112,,,18,16,10,10
Paul Reed,F,22023,1630194,22300521,"JAN 10, 2024",PHI @ ATL,L,19,4,8,0.5,0,1,0.0,1,1,1.0,1,8,9,2,1,2,0,2,9,-2,1,PHI,ATL,PHI,132,,,20,18,11,11
Paul Reed,F,22023,1630194,22300495,"JAN 06, 2024",PHI vs. UTA,L,25,7,12,0.583,0,0,0.0,2,4,0.5,3,3,6,1,0,0,1,1,16,-7,1,PHI,PHI,UTA,109,,,23,22,17,7
Paul Reed,F,22023,1630194,22300483,"JAN 05, 2024",PHI vs. NYK,L,12,3,5,0.6,0,0,0.0,0,0,0.0,0,1,1,0,0,0,0,2,6,-7,1,PHI,PHI,NYK,92,,,7,7,6,1
Paul Reed,F,22023,1630194,22300459,"JAN 02, 2024",PHI vs. CHI,W,13,1,3,0.333,0,0,0.0,0,0,0.0,0,4,4,0,2,0,0,2,2,-9,1,PHI,PHI,CHI,110,,,6,6,2,4
Paul Reed,F,22023,1630194,22300442,"DEC 30, 2023",PHI @ CHI,L,28,4,10,0.4,1,2,0.5,2,2,1.0,4,3,7,3,4,1,1,3,11,-7,1,PHI,CHI,PHI,92,,,21,18,14,10
Paul Reed,F,22023,1630194,22300434,"DEC 29, 2023",PHI @ HOU,W,24,3,5,0.6,0,0,0.0,1,2,0.5,2,0,2,4,1,0,0,3,7,-6,1,PHI,HOU,PHI,131,,,13,9,11,6
Paul Reed,F,22023,1630194,22300415,"DEC 27, 2023",PHI @ ORL,W,32,6,11,0.545,1,1,1.0,2,3,0.667,5,5,10,3,1,3,2,4,15,8,1,PHI,ORL,PHI,112,,,28,25,18,13
Paul Reed,F,22023,1630194,22300404,"DEC 25, 2023",PHI @ MIA,L,17,2,3,0.667,0,1,0.0,0,2,0.0,0,2,2,1,0,1,0,5,4,12,1,PHI,MIA,PHI,113,,,7,6,5,3
Paul Reed,F,22023,1630194,22300367,"DEC 20, 2023",PHI vs. MIN,W,12,3,5,0.6,0,0,0.0,2,2,1.0,4,4,8,3,3,1,2,3,8,11,1,PHI,PHI,MIN,127,,,19,16,11,11
Paul Reed,F,22023,1630194,22300335,"DEC 16, 2023",PHI @ CHA,W,14,2,4,0.5,0,0,0.0,0,0,0.0,1,2,3,1,0,1,0,1,4,11,1,PHI,CHA,PHI,135,,,8,7,5,4
Paul Reed,F,22023,1630194,22300327,"DEC 15, 2023",PHI vs. DET,W,12,0,1,0.0,0,0,0.0,0,0,0.0,2,3,5,2,0,0,2,1,0,11,1,PHI,PHI,DET,124,,,7,5,2,7
Paul Reed,F,22023,1630194,22300310,"DEC 13, 2023",PHI @ DET,W,13,1,3,0.333,0,0,0.0,3,3,1.0,1,3,4,0,0,0,3,2,5,-4,1,PHI,DET,PHI,129,,,9,9,5,4
Paul Reed,F,22023,1630194,22300295,"DEC 11, 2023",PHI vs. WAS,W,13,2,2,1.0,0,0,0.0,0,1,0.0,2,4,6,3,0,1,0,3,4,12,1,PHI,PHI,WAS,146,,,13,10,7,9
Paul Reed,F,22023,1630194,22301218,"DEC 08, 2023",PHI vs. ATL,W,6,1,2,0.5,0,0,0.0,0,0,0.0,2,2,4,0,0,0,3,1,2,-3,1,PHI,PHI,ATL,125,,,6,6,2,4
Paul Reed,F,22023,1630194,22300275,"DEC 01, 2023",PHI @ BOS,L,22,6,7,0.857,1,1,1.0,1,1,1.0,0,4,4,1,0,1,1,3,14,-6,1,PHI,BOS,PHI,119,,,19,18,15,5
Paul Reed,F,22023,1630194,22300262,"NOV 29, 2023",PHI @ NOP,L,27,3,4,0.75,0,1,0.0,3,3,1.0,2,2,4,5,1,0,3,4,9,1,1,PHI,NOP,PHI,114,,,18,13,14,9
Paul Reed,F,22023,1630194,22300255,"NOV 27, 2023",PHI vs. LAL,W,17,4,5,0.8,1,1,1.0,0,0,0.0,1,2,3,0,2,0,0,1,9,33,1,PHI,PHI,LAL,138,,,12,12,9,3
Paul Reed,F,22023,1630194,22300232,"NOV 22, 2023",PHI @ MIN,L,26,5,9,0.556,0,0,0.0,0,0,0.0,6,3,9,1,2,4,1,4,10,-10,1,PHI,MIN,PHI,99,,,20,19,11,10
Paul Reed,F,22023,1630194,22300208,"NOV 19, 2023",PHI @ BKN,W,14,0,4,0.0,0,1,0.0,0,0,0.0,1,3,4,1,0,2,0,2,0,-6,1,PHI,BKN,PHI,121,,,5,4,1,5
Paul Reed,F,22023,1630194,22300148,"NOV 06, 2023",PHI vs. WAS,W,14,3,3,1.0,0,0,0.0,0,0,0.0,2,4,6,2,1,0,1,1,6,9,1,PHI,PHI,WAS,146,,,14,12,8,8
Paul Reed,F,22023,1630194,22300132,"NOV 04, 2023",PHI vs. PHX,W,15,2,4,0.5,0,0,0.0,0,0,0.0,1,4,5,1,0,0,0,3,4,13,1,PHI,PHI,PHX,112,,,10,9,5,6
Paul Reed,F,22023,1630194,22300128,"NOV 02, 2023",PHI vs. TOR,W,12,3,4,0.75,0,0,0.0,0,0,0.0,3,2,5,0,0,1,1,2,6,-5,1,PHI,PHI,TOR,114,,,11,11,6,5
Paul Reed,F,22023,1630194,22300098,"OCT 29, 2023",PHI vs. POR,W,17,1,5,0.2,0,2,0.0,0,0,0.0,1,4,5,1,0,1,1,2,2,0,1,PHI,PHI,POR,126,,,8,7,3,6
Paul Reed,F,22023,1630194,22300644,"JAN 27, 2024",PHI @ DEN,L,42,14,21,0.667,2,4,0.5,0,0,0.0,3,10,13,1,2,0,0,5,30,-12,1,PHI,DEN,PHI,105,,,44,43,31,14
Paul Reed,F,22023,1630194,22300627,"JAN 25, 2024",PHI @ IND,L,17,3,5,0.6,1,2,0.5,0,0,0.0,1,5,6,1,3,0,1,2,7,8,1,PHI,IND,PHI,122,,,14,13,8,7
Paul Reed,F,22023,1630194,22300608,"JAN 22, 2024",PHI vs. SAS,W,14,3,6,0.5,0,0,0.0,0,0,0.0,5,3,8,0,1,1,0,4,6,-6,1,PHI,PHI,SAS,133,,,14,14,6,8
Paul Reed,F,22023,1630194,22300593,"JAN 20, 2024",PHI @ CHA,W,11,1,2,0.5,0,0,0.0,0,0,0.0,1,7,8,0,0,0,0,0,2,10,1,PHI,CHA,PHI,97,,,10,10,2,8
Paul Reed,F,22023,1630194,22300585,"JAN 19, 2024",PHI @ ORL,W,15,1,3,0.333,0,1,0.0,0,0,0.0,3,2,5,0,0,0,1,4,2,1,1,PHI,ORL,PHI,124,,,7,7,2,5
Paul Reed,F,22023,1630194,22300566,"JAN 16, 2024",PHI vs. DEN,W,9,1,1,1.0,0,0,0.0,0,0,0.0,1,1,2,0,0,2,0,1,2,5,1,PHI,PHI,DEN,126,,,4,4,2,2
Paul Reed,F,22023,1630194,22300555,"JAN 15, 2024",PHI vs. HOU,W,17,3,4,0.75,0,0,0.0,1,2,0.5,2,2,4,2,0,1,1,0,7,2,1,PHI,PHI,HOU,124,,,13,11,9,6
Paul Reed,F,22023,1630194,22300351,"DEC 18, 2023",PHI vs. CHI,L,12,3,5,0.6,0,1,0.0,2,2,1.0,2,2,4,1,1,1,0,2,8,-4,1,PHI,PHI,CHI,104,,,13,12,9,5
Paul Reed,F,22023,1630194,22301208,"DEC 06, 2023",PHI @ WAS,W,10,0,1,0.0,0,1,0.0,0,0,0.0,0,1,1,0,0,0,0,3,0,-3,1,PHI,WAS,PHI,131,,,1,1,0,1
Paul Reed,F,22023,1630194,22300239,"NOV 25, 2023",PHI @ OKC,W,11,2,4,0.5,1,1,1.0,0,0,0.0,2,1,3,0,0,0,2,1,5,-3,1,PHI,OKC,PHI,127,,,8,8,5,3
Paul Reed,F,22023,1630194,22300040,"NOV 21, 2023",PHI vs. CLE,L,9,2,4,0.5,0,0,0.0,0,0,0.0,2,1,3,0,1,0,0,1,4,-5,1,PHI,PHI,CLE,119,,,7,7,4,3
Paul Reed,F,22023,1630194,22300180,"NOV 12, 2023",PHI vs. IND,W,15,2,4,0.5,0,0,0.0,0,0,0.0,2,4,6,3,1,0,0,2,4,12,1,PHI,PHI,IND,137,,,13,10,7,9
Paul Reed,F,22023,1630194,22300008,"NOV 10, 2023",PHI @ DET,W,12,1,2,0.5,0,0,0.0,0,0,0.0,0,4,4,0,0,0,0,3,2,7,1,PHI,DET,PHI,114,,,6,6,2,4
Paul Reed,F,22023,1630194,22300159,"NOV 08, 2023",PHI vs. BOS,W,11,4,5,0.8,0,0,0.0,0,0,0.0,3,1,4,0,1,0,1,0,8,-1,1,PHI,PHI,BOS,106,,,12,12,8,4
Paul Reed,F,22023,1630194,22300673,"JAN 30, 2024",PHI @ GSW,L,10,0,1,0.0,0,0,0.0,0,0,0.0,0,1,1,0,0,0,0,1,0,3,1,PHI,GSW,PHI,107,,,1,1,0,1
Paul Reed,F,22023,1630194,22300029,"NOV 17, 2023",PHI @ ATL,W,11,1,3,0.333,0,0,0.0,0,0,0.0,1,1,2,0,0,0,0,1,2,-6,1,PHI,ATL,PHI,126,,,4,4,2,2
Paul Reed,F,22023,1630194,22300194,"NOV 15, 2023",PHI vs. BOS,L,14,4,5,0.8,1,1,1.0,1,2,0.5,3,3,6,2,0,1,1,1,10,15,1,PHI,PHI,BOS,107,,,18,16,12,8
Paul Reed,F,22023,1630194,22300019,"NOV 14, 2023",PHI vs. IND,L,10,1,1,1.0,0,0,0.0,0,0,0.0,1,0,1,1,0,1,1,1,2,3,1,PHI,PHI,IND,126,,,4,3,3,2
Paul Reed,F,22023,1630194,22300092,"OCT 28, 2023",PHI @ TOR,W,13,2,4,0.5,0,0,0.0,0,0,0.0,2,3,5,0,1,0,1,4,4,9,1,PHI,TOR,PHI,114,,,9,9,4,5
Paul Reed,F,22023,1630194,22300075,"OCT 26, 2023",PHI @ MIL,L,12,1,2,0.5,0,1,0.0,1,2,0.5,1,3,4,2,0,1,2,4,3,0,1,PHI,MIL,PHI,117,,,9,7,5,6
Paul Reed,F,22023,1630194,22300753,"FEB 10, 2024",PHI @ WAS,W,22,6,8,0.75,0,0,0.0,0,0,0.0,3,4,7,1,0,1,0,3,12,6,1,PHI,WAS,PHI,119,,,20,19,13,8
Paul Reed,F,22023,1630194,22300382,"DEC 22, 2023",PHI vs. TOR,W,13,1,2,0.5,0,1,0.0,2,2,1.0,1,3,4,0,1,1,0,2,4,8,1,PHI,PHI,TOR,121,,,8,8,4,4
Bones Hyland,G,22023,1630538,22300099,"OCT 29, 2023",LAC vs. SAS,W,21,7,14,0.5,4,8,0.5,0,0,0.0,0,3,3,1,1,0,4,1,18,10,1,LAC,LAC,SAS,123,,,22,21,19,4
Bones Hyland,G,22023,1630538,22300085,"OCT 27, 2023",LAC @ UTA,L,22,5,10,0.5,2,5,0.4,0,0,0.0,0,2,2,1,1,0,3,2,12,-1,1,LAC,UTA,LAC,118,,,15,14,13,3
Bones Hyland,G,22023,1630538,22300074,"OCT 25, 2023",LAC vs. POR,W,22,6,11,0.545,3,8,0.375,2,2,1.0,0,0,0,3,0,0,2,4,17,-4,1,LAC,LAC,POR,123,,,20,17,20,3
Bones Hyland,G,22023,1630538,22300676,"JAN 31, 2024",LAC @ WAS,W,5,1,4,0.25,0,2,0.0,0,0,0.0,1,0,1,0,0,0,2,2,2,-13,1,LAC,WAS,LAC,125,,,3,3,2,1
Bones Hyland,G,22023,1630538,22300646,"JAN 27, 2024",LAC @ BOS,W,10,1,8,0.125,0,6,0.0,0,0,0.0,0,1,1,4,2,0,1,2,2,-16,1,LAC,BOS,LAC,115,,,7,3,6,5
Bones Hyland,G,22023,1630538,22300637,"JAN 26, 2024",LAC @ TOR,W,2,0,1,0.0,0,1,0.0,0,0,0.0,0,0,0,1,0,0,0,0,0,4,1,LAC,TOR,LAC,127,,,1,0,1,1
Bones Hyland,G,22023,1630538,22300486,"JAN 05, 2024",LAC @ NOP,W,6,0,3,0.0,0,0,0.0,0,0,0.0,0,0,0,1,0,1,0,1,0,-12,1,LAC,NOP,LAC,111,,,1,0,1,1
Bones Hyland,G,22023,1630538,22300389,"DEC 23, 2023",LAC vs. BOS,L,8,1,4,0.25,0,2,0.0,0,0,0.0,0,0,0,0,0,0,0,0,2,-11,1,LAC,LAC,BOS,108,,,2,2,2,0
Bones Hyland,G,22023,1630538,22300379,"DEC 21, 2023",LAC @ OKC,L,10,2,4,0.5,1,1,1.0,1,2,0.5,0,0,0,2,1,0,1,0,6,1,1,LAC,OKC,LAC,115,,,8,6,8,2
Bones Hyland,G,22023,1630538,22300309,"DEC 12, 2023",LAC vs. SAC,W,9,2,8,0.25,2,4,0.5,0,0,0.0,0,1,1,1,0,0,0,0,6,-12,1,LAC,LAC,SAC,117,,,8,7,7,2
Bones Hyland,G,22023,1630538,22300273,"NOV 30, 2023",LAC @ GSW,L,4,0,1,0.0,0,1,0.0,0,0,0.0,0,0,0,0,0,0,0,1,0,0,1,LAC,GSW,LAC,114,,,0,0,0,0
Bones Hyland,G,22023,1630538,22300264,"NOV 29, 2023",LAC @ SAC,W,1,0,0,0.0,0,0,0.0,0,0,0.0,0,0,0,0,1,0,0,0,0,0,1,LAC,SAC,LAC,131,,,0,0,0,0
Bones Hyland,G,22023,1630538,22300244,"NOV 25, 2023",LAC vs. DAL,W,4,1,4,0.25,1,3,0.333,0,0,0.0,0,0,0,0,0,0,2,0,3,-1,1,LAC,LAC,DAL,107,,,3,3,3,0
Bones Hyland,G,22023,1630538,22300014,"NOV 10, 2023",LAC @ DAL,L,29,5,9,0.556,1,5,0.2,6,6,1.0,1,3,4,6,1,0,2,5,17,8,1,LAC,DAL,LAC,126,,,27,21,23,10
Bones Hyland,G,22023,1630538,22300151,"NOV 06, 2023",LAC @ NYK,L,22,2,9,0.222,1,4,0.25,0,0,0.0,0,1,1,4,1,0,3,2,5,-5,1,LAC,NYK,LAC,97,,,10,6,9,5
Bones Hyland,G,22023,1630538,22300127,"NOV 01, 2023",LAC @ LAL,L,34,2,7,0.286,0,3,0.0,0,0,0.0,0,1,1,5,1,0,0,3,4,8,1,LAC,LAL,LAC,125,,,10,5,9,6
Bones Hyland,G,22023,1630538,22300114,"OCT 31, 2023",LAC vs. ORL,W,32,6,14,0.429,4,7,0.571,1,2,0.5,0,0,0,3,1,0,1,4,17,8,1,LAC,LAC,ORL,118,,,20,17,20,3
Bones Hyland,G,22023,1630538,22300223,"NOV 20, 2023",LAC @ SAS,W,4,1,3,0.333,1,2,0.5,0,0,0.0,0,1,1,1,0,0,1,0,3,3,1,LAC,SAS,LAC,124,,,5,4,4,2
Bones Hyland,G,22023,1630538,22300160,"NOV 08, 2023",LAC @ BKN,L,6,2,6,0.333,0,2,0.0,0,0,0.0,1,1,2,0,0,0,1,0,4,-2,1,LAC,BKN,LAC,93,,,6,6,4,2
Jeff Green,F,22023,201145,22300754,"FEB 10, 2024",HOU @ ATL,L,31,6,10,0.6,4,7,0.571,3,5,0.6,1,5,6,2,0,1,5,4,19,-20,1,HOU,ATL,HOU,113,,,27,25,21,8
Jeff Green,F,22023,201145,22300744,"FEB 09, 2024",HOU @ TOR,L,27,3,11,0.273,1,6,0.167,4,5,0.8,1,5,6,4,1,1,0,1,11,18,1,HOU,TOR,HOU,104,,,21,17,15,10
Jeff Green,F,22023,201145,22300719,"FEB 06, 2024",HOU @ IND,L,11,1,3,0.333,0,1,0.0,1,1,1.0,0,2,2,3,0,0,2,2,3,-9,1,HOU,IND,HOU,129,,,8,5,6,5
Jeff Green,F,22023,201145,22300709,"FEB 04, 2024",HOU @ MIN,L,16,1,3,0.333,1,2,0.5,1,2,0.5,1,1,2,0,0,0,0,1,4,-8,1,HOU,MIN,HOU,90,,,6,6,4,2
Jeff Green,F,22023,201145,22300692,"FEB 02, 2024",HOU vs. TOR,W,15,2,2,1.0,0,0,0.0,4,4,1.0,0,3,3,1,1,0,2,3,8,5,1,HOU,HOU,TOR,135,,,12,11,9,4
Jeff Green,F,22023,201145,22300679,"JAN 31, 2024",HOU vs. NOP,L,15,0,3,0.0,0,2,0.0,0,0,0.0,0,0,0,1,0,0,0,3,0,2,1,HOU,HOU,NOP,99,,,1,0,1,1
Jeff Green,F,22023,201145,22300662,"JAN 29, 2024",HOU vs. LAL,W,8,1,3,0.333,0,1,0.0,3,3,1.0,0,2,2,0,0,0,0,0,5,4,1,HOU,HOU,LAL,135,,,7,7,5,2
Jeff Green,F,22023,201145,22300645,"JAN 27, 2024",HOU @ BKN,L,16,1,5,0.2,0,1,0.0,0,0,0.0,0,2,2,0,0,0,1,0,2,-15,1,HOU,BKN,HOU,104,,,4,4,2,2
Jeff Green,F,22023,201145,22300635,"JAN 26, 2024",HOU @ CHA,W,17,0,1,0.0,0,1,0.0,0,0,0.0,0,1,1,0,0,0,0,1,0,10,1,HOU,CHA,HOU,138,,,1,1,0,1
Jeff Green,F,22023,201145,22300623,"JAN 24, 2024",HOU vs. POR,L,38,2,4,0.5,0,2,0.0,0,0,0.0,0,4,4,1,2,1,0,2,4,-11,1,HOU,HOU,POR,131,,,9,8,5,5
Jeff Green,F,22023,201145,22300598,"JAN 20, 2024",HOU vs. UTA,W,16,1,6,0.167,1,3,0.333,0,0,0.0,1,2,3,2,0,0,1,0,3,5,1,HOU,HOU,UTA,127,,,8,6,5,5
Jeff Green,F,22023,201145,22300573,"JAN 17, 2024",HOU @ NYK,L,21,2,4,0.5,1,2,0.5,4,4,1.0,1,4,5,0,0,2,0,2,9,-6,1,HOU,NYK,HOU,94,,,14,14,9,5
Jeff Green,F,22023,201145,22300555,"JAN 15, 2024",HOU @ PHI,L,13,0,5,0.0,0,1,0.0,1,2,0.5,1,1,2,0,0,2,1,1,1,-30,1,HOU,PHI,HOU,115,,,3,3,1,2
Jeff Green,F,22023,201145,22300542,"JAN 13, 2024",HOU @ BOS,L,14,3,5,0.6,1,1,1.0,2,2,1.0,0,1,1,1,0,0,0,1,9,-6,1,HOU,BOS,HOU,113,,,11,10,10,2
Jeff Green,F,22023,201145,22300409,"DEC 26, 2023",HOU vs. IND,L,11,1,1,1.0,0,0,0.0,0,0,0.0,0,0,0,0,0,0,1,2,2,5,1,HOU,HOU,IND,117,,,2,2,2,0
Jeff Green,F,22023,201145,22300392,"DEC 23, 2023",HOU @ NOP,W,21,1,3,0.333,0,1,0.0,0,0,0.0,1,2,3,2,0,0,0,1,2,6,1,HOU,NOP,HOU,106,,,7,5,4,5
Jeff Green,F,22023,201145,22300385,"DEC 22, 2023",HOU vs. DAL,W,8,1,2,0.5,0,0,0.0,0,0,0.0,0,1,1,0,0,2,0,0,2,5,1,HOU,HOU,DAL,122,,,3,3,2,1
Jeff Green,F,22023,201145,22300371,"DEC 20, 2023",HOU vs. ATL,L,12,1,2,0.5,0,1,0.0,0,0,0.0,0,1,1,0,0,0,3,4,2,-10,1,HOU,HOU,ATL,127,,,3,3,2,1
Jeff Green,F,22023,201145,22300349,"DEC 18, 2023",HOU @ CLE,L,24,6,6,1.0,0,0,0.0,3,3,1.0,0,1,1,3,0,1,1,3,15,16,1,HOU,CLE,HOU,130,,,19,16,18,4
Jeff Green,F,22023,201145,22300346,"DEC 17, 2023",HOU @ MIL,L,17,4,5,0.8,1,1,1.0,7,8,0.875,0,0,0,1,0,0,1,0,16,-2,1,HOU,MIL,HOU,119,,,17,16,17,1
Jeff Green,F,22023,201145,22300332,"DEC 15, 2023",HOU @ MEM,W,19,3,9,0.333,0,1,0.0,6,7,0.857,2,2,4,1,0,1,1,1,12,8,1,HOU,MEM,HOU,103,,,17,16,13,5
Jeff Green,F,22023,201145,22300314,"DEC 13, 2023",HOU vs. MEM,W,13,3,3,1.0,0,0,0.0,3,3,1.0,1,2,3,0,0,0,2,2,9,10,1,HOU,HOU,MEM,117,,,12,12,9,3
Jeff Green,F,22023,201145,22300298,"DEC 11, 2023",HOU vs. SAS,W,19,2,4,0.5,1,2,0.5,7,7,1.0,1,1,2,1,0,0,0,3,12,-6,1,HOU,HOU,SAS,93,,,15,14,13,3
Jeff Green,F,22023,201145,22301224,"DEC 08, 2023",HOU @ DEN,W,27,0,1,0.0,0,1,0.0,5,6,0.833,2,2,4,1,1,1,0,4,5,2,1,HOU,DEN,HOU,114,,,10,9,6,5
Jeff Green,F,22023,201145,22300291,"DEC 02, 2023",HOU @ LAL,L,11,0,2,0.0,0,0,0.0,0,0,0.0,0,1,1,0,0,0,2,3,0,-12,1,HOU,LAL,HOU,97,,,1,1,0,1
Jeff Green,F,22023,201145,22300263,"NOV 29, 2023",HOU @ DEN,L,22,4,6,0.667,2,3,0.667,2,3,0.667,0,2,2,2,1,1,0,1,12,4,1,HOU,DEN,HOU,124,,,16,14,14,4
Jeff Green,F,22023,201145,22300059,"NOV 28, 2023",HOU @ DAL,L,13,2,2,1.0,0,0,0.0,2,2,1.0,0,0,0,1,0,0,2,1,6,2,1,HOU,DAL,HOU,115,,,7,6,7,1
Jeff Green,F,22023,201145,22300048,"NOV 24, 2023",HOU vs. DEN,W,8,0,2,0.0,0,2,0.0,0,0,0.0,0,0,0,0,0,3,0,0,0,12,1,HOU,HOU,DEN,105,,,0,0,0,0
Jeff Green,F,22023,201145,22300231,"NOV 22, 2023",HOU vs. MEM,W,12,0,3,0.0,0,1,0.0,0,0,0.0,0,1,1,0,0,1,0,1,0,2,1,HOU,HOU,MEM,111,,,1,1,0,1
Jeff Green,F,22023,201145,22300224,"NOV 20, 2023",HOU @ GSW,L,14,1,4,0.25,1,3,0.333,2,2,1.0,1,0,1,1,0,0,0,0,5,-11,1,HOU,GSW,HOU,116,,,7,6,6,2
Jeff Green,F,22023,201145,22300216,"NOV 19, 2023",HOU @ LAL,L,14,5,5,1.0,0,0,0.0,3,3,1.0,0,2,2,0,0,0,0,2,13,-15,1,HOU,LAL,HOU,104,,,15,15,13,2
Jeff Green,F,22023,201145,22300037,"NOV 17, 2023",HOU @ LAC,L,15,0,3,0.0,0,1,0.0,0,0,0.0,1,1,2,2,0,0,1,0,0,4,1,HOU,LAC,HOU,100,,,4,2,2,4
Jeff Green,F,22023,201145,22300182,"NOV 12, 2023",HOU vs. DEN,W,26,5,7,0.714,2,4,0.5,3,4,0.75,1,3,4,0,1,1,0,1,15,14,1,HOU,HOU,DEN,107,,,19,19,15,4
Jeff Green,F,22023,201145,22300011,"NOV 10, 2023",HOU vs. NOP,W,23,1,3,0.333,0,2,0.0,3,3,1.0,1,3,4,0,0,0,1,1,5,12,1,HOU,HOU,NOP,104,,,9,9,5,4
Jeff Green,F,22023,201145,22300163,"NOV 08, 2023",HOU vs. LAL,W,11,4,5,0.8,0,0,0.0,1,2,0.5,3,3,6,0,0,0,1,3,9,10,1,HOU,HOU,LAL,128,,,15,15,9,6
Jeff Green,F,22023,201145,22300153,"NOV 06, 2023",HOU vs. SAC,W,5,2,2,1.0,0,0,0.0,2,4,0.5,0,1,1,0,1,0,0,1,6,12,1,HOU,HOU,SAC,122,,,7,7,6,1
Jeff Green,F,22023,201145,22300137,"NOV 04, 2023",HOU vs. SAC,W,5,0,1,0.0,0,0,0.0,1,2,0.5,2,3,5,0,0,0,1,0,1,-2,1,HOU,HOU,SAC,107,,,6,6,1,5
Jeff Green,F,22023,201145,22300122,"NOV 01, 2023",HOU vs. CHA,W,12,2,3,0.667,2,2,1.0,3,4,0.75,0,2,2,0,0,0,1,1,9,2,1,HOU,HOU,CHA,128,,,11,11,9,2
Jeff Green,F,22023,201145,22300096,"OCT 29, 2023",HOU vs. GSW,L,21,2,7,0.286,0,2,0.0,2,2,1.0,1,2,3,2,0,1,0,0,6,-13,1,HOU,HOU,GSW,95,,,11,9,8,5
Jeff Green,F,22023,201145,22300083,"OCT 27, 2023",HOU @ SAS,L,21,4,4,1.0,0,0,0.0,2,2,1.0,0,1,1,1,0,0,0,1,10,-1,1,HOU,SAS,HOU,122,,,12,11,11,2
Jeff Green,F,22023,201145,22300066,"OCT 25, 2023",HOU @ ORL,L,14,2,4,0.5,0,1,0.0,0,1,0.0,3,0,3,1,0,0,1,2,4,-11,1,HOU,ORL,HOU,86,,,8,7,5,4
Jeff Green,F,22023,201145,22300534,"JAN 12, 2024",HOU @ DET,W,13,2,2,1.0,0,0,0.0,2,2,1.0,0,2,2,0,0,0,1,2,6,-3,1,HOU,DET,HOU,112,,,8,8,6,2
Jeff Green,F,22023,201145,22300485,"JAN 05, 2024",HOU vs. MIN,L,21,2,4,0.5,0,2,0.0,0,0,0.0,1,0,1,0,0,0,0,2,4,-17,1,HOU,HOU,MIN,95,,,5,5,4,1
Jeff Green,F,22023,201145,22300469,"JAN 03, 2024",HOU vs. BKN,W,17,2,4,0.5,2,2,1.0,2,2,1.0,0,0,0,0,0,0,1,1,8,-7,1,HOU,HOU,BKN,112,,,8,8,8,0
Jeff Green,F,22023,201145,22300453,"JAN 01, 2024",HOU vs. DET,W,9,1,2,0.5,0,1,0.0,1,2,0.5,0,2,2,2,0,0,1,0,3,6,1,HOU,HOU,DET,136,,,7,5,5,4
Jeff Green,F,22023,201145,22300418,"DEC 27, 2023",HOU vs. PHX,L,7,1,3,0.333,0,1,0.0,0,0,0.0,0,1,1,1,0,1,1,2,2,-9,1,HOU,HOU,PHX,113,,,4,3,3,2
Jeff Green,F,22023,201145,22300434,"DEC 29, 2023",HOU vs. PHI,L,33,5,11,0.455,0,2,0.0,0,1,0.0,2,2,4,0,1,1,0,2,10,-7,1,HOU,HOU,PHI,127,,,14,14,10,4
Jeff Green,F,22023,201145,22300523,"JAN 10, 2024",HOU @ CHI,L,19,4,5,0.8,0,1,0.0,1,1,1.0,1,2,3,1,0,0,1,1,9,3,1,HOU,CHI,HOU,119,,,13,12,10,4
Jeff Green,F,22023,201145,22300509,"JAN 08, 2024",HOU @ MIA,L,20,2,4,0.5,0,1,0.0,1,2,0.5,0,0,0,2,0,1,1,3,5,-9,1,HOU,MIA,HOU,113,,,7,5,7,2
Jeff Green,F,22023,201145,22300496,"JAN 06, 2024",HOU vs. MIL,W,34,5,11,0.455,2,5,0.4,4,5,0.8,0,2,2,2,0,1,1,4,16,2,1,HOU,HOU,MIL,112,,,20,18,18,4
Mason Plumlee,F-C,22023,203486,22300099,"OCT 29, 2023",LAC vs. SAS,W,21,2,3,0.667,0,0,0.0,0,0,0.0,2,4,6,1,0,0,0,0,4,7,1,LAC,LAC,SAS,123,,,11,10,5,7
Mason Plumlee,F-C,22023,203486,22300085,"OCT 27, 2023",LAC @ UTA,L,12,1,1,1.0,0,0,0.0,1,2,0.5,1,3,4,0,0,0,1,2,3,-11,1,LAC,UTA,LAC,118,,,7,7,3,4
Mason Plumlee,F-C,22023,203486,22300074,"OCT 25, 2023",LAC vs. POR,W,18,2,4,0.5,0,0,0.0,2,4,0.5,3,5,8,2,0,0,0,0,6,-6,1,LAC,LAC,POR,123,,,16,14,8,10
Mason Plumlee,F-C,22023,203486,22300731,"FEB 07, 2024",LAC vs. NOP,L,15,4,4,1.0,0,0,0.0,3,3,1.0,1,2,3,1,0,0,2,6,11,-16,1,LAC,LAC,NOP,106,,,15,14,12,4
Mason Plumlee,F-C,22023,203486,22300688,"FEB 02, 2024",LAC @ DET,W,26,5,7,0.714,0,0,0.0,2,3,0.667,3,6,9,2,1,0,1,3,12,-4,1,LAC,DET,LAC,136,,,23,21,14,11
Mason Plumlee,F-C,22023,203486,22300676,"JAN 31, 2024",LAC @ WAS,W,19,2,5,0.4,0,0,0.0,1,1,1.0,5,6,11,1,0,0,1,2,5,23,1,LAC,WAS,LAC,125,,,17,16,6,12
Mason Plumlee,F-C,22023,203486,22300658,"JAN 29, 2024",LAC @ CLE,L,22,1,1,1.0,0,0,0.0,3,4,0.75,1,4,5,0,0,1,1,2,5,-11,1,LAC,CLE,LAC,108,,,10,10,5,5
Mason Plumlee,F-C,22023,203486,22300646,"JAN 27, 2024",LAC @ BOS,W,21,4,4,1.0,0,0,0.0,0,0,0.0,2,5,7,0,0,1,0,2,8,27,1,LAC,BOS,LAC,115,,,15,15,8,7
Mason Plumlee,F-C,22023,203486,22300637,"JAN 26, 2024",LAC @ TOR,W,25,6,12,0.5,0,0,0.0,0,0,0.0,4,8,12,3,0,0,1,1,12,19,1,LAC,TOR,LAC,127,,,27,24,15,15
Mason Plumlee,F-C,22023,203486,22300511,"JAN 08, 2024",LAC vs. PHX,W,5,0,0,0.0,0,0,0.0,1,2,0.5,0,2,2,3,0,0,0,0,1,2,1,LAC,LAC,PHX,138,,,6,3,4,5
Mason Plumlee,F-C,22023,203486,22300486,"JAN 05, 2024",LAC @ NOP,W,7,2,2,1.0,0,0,0.0,4,5,0.8,1,1,2,0,0,0,0,1,8,-15,1,LAC,NOP,LAC,111,,,10,10,8,2
Mason Plumlee,F-C,22023,203486,22300618,"JAN 23, 2024",LAC vs. LAL,W,19,0,1,0.0,0,0,0.0,0,0,0.0,0,2,2,2,0,0,1,0,0,4,1,LAC,LAC,LAL,127,,,4,2,2,4
Mason Plumlee,F-C,22023,203486,22300151,"NOV 06, 2023",LAC @ NYK,L,11,1,1,1.0,0,0,0.0,0,0,0.0,0,2,2,1,1,0,1,0,2,10,1,LAC,NYK,LAC,97,,,5,4,3,3
Mason Plumlee,F-C,22023,203486,22300127,"NOV 01, 2023",LAC @ LAL,L,19,1,3,0.333,0,0,0.0,3,6,0.5,0,6,6,0,3,0,1,0,5,-9,1,LAC,LAL,LAC,125,,,11,11,5,6
Mason Plumlee,F-C,22023,203486,22300114,"OCT 31, 2023",LAC vs. ORL,W,22,5,7,0.714,0,0,0.0,0,2,0.0,2,5,7,2,0,1,2,4,10,-5,1,LAC,LAC,ORL,118,,,19,17,12,9
Mason Plumlee,F-C,22023,203486,22300749,"FEB 10, 2024",LAC vs. DET,W,12,1,2,0.5,0,0,0.0,4,4,1.0,0,5,5,0,0,1,1,1,6,1,1,LAC,LAC,DET,112,,,11,11,6,5
Mason Plumlee,F-C,22023,203486,22300716,"FEB 05, 2024",LAC @ ATL,W,21,3,5,0.6,0,0,0.0,2,4,0.5,2,7,9,3,1,1,0,0,8,6,1,LAC,ATL,LAC,149,,,20,17,11,12
Mason Plumlee,F-C,22023,203486,22300708,"FEB 04, 2024",LAC @ MIA,W,26,1,2,0.5,0,0,0.0,3,4,0.75,2,7,9,0,0,0,0,0,5,11,1,LAC,MIA,LAC,103,,,14,14,5,9
Mason Plumlee,F-C,22023,203486,22300600,"JAN 21, 2024",LAC vs. BKN,W,15,1,3,0.333,0,0,0.0,5,6,0.833,1,7,8,1,0,0,0,2,7,-7,1,LAC,LAC,BKN,125,,,16,15,8,9
Mason Plumlee,F-C,22023,203486,22300568,"JAN 16, 2024",LAC vs. OKC,W,28,5,5,1.0,0,0,0.0,4,7,0.571,2,3,5,2,0,3,0,2,14,13,1,LAC,LAC,OKC,128,,,21,19,16,7
Mason Plumlee,F-C,22023,203486,22300553,"JAN 14, 2024",LAC @ MIN,L,16,4,5,0.8,0,0,0.0,0,0,0.0,0,3,3,0,1,0,0,4,8,3,1,LAC,MIN,LAC,105,,,11,11,8,3
Chris Boucher,F-C,22023,1628449,22300432,"DEC 29, 2023",TOR @ BOS,L,7,1,3,0.333,1,3,0.333,0,0,0.0,0,3,3,0,0,0,0,1,3,-8,1,TOR,BOS,TOR,118,,,6,6,3,3
Chris Boucher,F-C,22023,1628449,22300416,"DEC 27, 2023",TOR @ WAS,W,12,2,5,0.4,2,4,0.5,0,0,0.0,1,3,4,0,0,0,0,3,6,7,1,TOR,WAS,TOR,132,,,10,10,6,4
Chris Boucher,F-C,22023,1628449,22300395,"DEC 23, 2023",TOR vs. UTA,L,13,3,3,1.0,1,1,1.0,2,3,0.667,1,2,3,1,1,0,0,2,9,-11,1,TOR,TOR,UTA,119,,,13,12,10,4
Chris Boucher,F-C,22023,1628449,22300369,"DEC 20, 2023",TOR vs. DEN,L,12,2,3,0.667,1,1,1.0,0,0,0.0,2,5,7,0,0,1,1,1,5,8,1,TOR,TOR,DEN,104,,,12,12,5,7
Chris Boucher,F-C,22023,1628449,22300354,"DEC 18, 2023",TOR vs. CHA,W,15,3,6,0.5,0,1,0.0,1,2,0.5,1,2,3,0,0,1,0,1,7,7,1,TOR,TOR,CHA,114,,,10,10,7,3
Chris Boucher,F-C,22023,1628449,22300330,"DEC 15, 2023",TOR vs. ATL,L,15,2,4,0.5,1,3,0.333,2,5,0.4,0,3,3,0,1,2,1,1,7,-7,1,TOR,TOR,ATL,104,,,10,10,7,3
Chris Boucher,F-C,22023,1628449,22300313,"DEC 13, 2023",TOR vs. ATL,W,10,1,2,0.5,0,1,0.0,0,0,0.0,0,0,0,0,0,2,0,0,2,-10,1,TOR,TOR,ATL,135,,,2,2,2,0
Chris Boucher,F-C,22023,1628449,22300297,"DEC 11, 2023",TOR @ NYK,L,10,2,8,0.25,0,4,0.0,1,1,1.0,2,1,3,0,0,0,1,1,5,-8,1,TOR,NYK,TOR,130,,,8,8,5,3
Chris Boucher,F-C,22023,1628449,22301216,"DEC 08, 2023",TOR @ CHA,L,13,4,9,0.444,0,3,0.0,1,1,1.0,1,2,3,0,0,1,1,4,9,11,1,TOR,CHA,TOR,116,,,12,12,9,3
Chris Boucher,F-C,22023,1628449,22301207,"DEC 06, 2023",TOR vs. MIA,L,10,0,2,0.0,0,1,0.0,0,0,0.0,0,4,4,0,0,0,1,0,0,2,1,TOR,TOR,MIA,103,,,4,4,0,4
Chris Boucher,F-C,22023,1628449,22300276,"DEC 01, 2023",TOR vs. NYK,L,19,4,10,0.4,1,4,0.25,2,3,0.667,2,1,3,2,1,0,0,0,11,5,1,TOR,TOR,NYK,106,,,16,14,13,5
Chris Boucher,F-C,22023,1628449,22300260,"NOV 29, 2023",TOR vs. PHX,W,3,0,0,0.0,0,0,0.0,0,0,0.0,0,0,0,0,0,0,0,0,0,0,1,TOR,TOR,PHX,112,,,0,0,0,0
Chris Boucher,F-C,22023,1628449,22300054,"NOV 28, 2023",TOR @ BKN,L,12,5,7,0.714,3,4,0.75,0,0,0.0,1,0,1,0,1,0,0,0,13,8,1,TOR,BKN,TOR,103,,,14,14,13,1
Chris Boucher,F-C,22023,1628449,22300251,"NOV 26, 2023",TOR @ CLE,L,10,1,2,0.5,0,0,0.0,3,4,0.75,2,2,4,0,1,0,1,0,5,-9,1,TOR,CLE,TOR,102,,,9,9,5,4
Chris Boucher,F-C,22023,1628449,22300046,"NOV 24, 2023",TOR vs. CHI,W,10,1,3,0.333,0,1,0.0,2,2,1.0,0,1,1,0,1,0,0,1,4,-1,1,TOR,TOR,CHI,121,,,5,5,4,1
Chris Boucher,F-C,22023,1628449,22300038,"NOV 21, 2023",TOR @ ORL,L,18,1,4,0.25,1,3,0.333,0,0,0.0,0,2,2,0,0,1,0,3,3,-12,1,TOR,ORL,TOR,107,,,5,5,3,2
Chris Boucher,F-C,22023,1628449,22300211,"NOV 19, 2023",TOR vs. DET,W,18,5,7,0.714,3,4,0.75,1,3,0.333,1,5,6,1,1,1,0,4,14,10,1,TOR,TOR,DET,142,,,21,20,15,7
Chris Boucher,F-C,22023,1628449,22300031,"NOV 17, 2023",TOR vs. BOS,L,18,2,6,0.333,1,2,0.5,1,2,0.5,1,3,4,0,0,0,0,0,6,-10,1,TOR,TOR,BOS,105,,,10,10,6,4
Chris Boucher,F-C,22023,1628449,22300195,"NOV 15, 2023",TOR vs. MIL,L,20,2,8,0.25,1,3,0.333,4,4,1.0,5,4,9,0,0,1,1,1,9,6,1,TOR,TOR,MIL,112,,,18,18,9,9
Chris Boucher,F-C,22023,1628449,22300189,"NOV 13, 2023",TOR vs. WAS,W,21,3,6,0.5,1,2,0.5,0,0,0.0,2,5,7,2,0,3,0,1,7,14,1,TOR,TOR,WAS,111,,,16,14,9,9
Chris Boucher,F-C,22023,1628449,22300174,"NOV 11, 2023",TOR @ BOS,L,22,2,4,0.5,2,3,0.667,0,0,0.0,0,5,5,1,0,0,0,2,6,-9,1,TOR,BOS,TOR,94,,,12,11,7,6
Chris Boucher,F-C,22023,1628449,22300092,"OCT 28, 2023",TOR vs. PHI,L,12,1,6,0.167,0,2,0.0,3,3,1.0,1,3,4,0,1,0,1,2,5,-2,1,TOR,TOR,PHI,107,,,9,9,5,4
Chris Boucher,F-C,22023,1628449,22300082,"OCT 27, 2023",TOR @ CHI,L,17,3,4,0.75,0,0,0.0,4,5,0.8,1,5,6,0,0,0,1,3,10,22,1,TOR,CHI,TOR,103,,,16,16,10,6
Chris Boucher,F-C,22023,1628449,22300230,"NOV 22, 2023",TOR @ IND,W,10,1,3,0.333,0,1,0.0,4,4,1.0,1,0,1,0,0,0,0,2,6,6,1,TOR,IND,TOR,132,,,7,7,6,1
Chris Boucher,F-C,22023,1628449,22300168,"NOV 08, 2023",TOR @ DAL,W,15,4,4,1.0,1,1,1.0,1,2,0.5,1,1,2,0,0,1,1,5,10,4,1,TOR,DAL,TOR,127,,,12,12,10,2
Chris Boucher,F-C,22023,1628449,22300128,"NOV 02, 2023",TOR @ PHI,L,13,2,4,0.5,0,2,0.0,2,2,1.0,2,2,4,0,0,1,1,3,6,-5,1,TOR,PHI,TOR,99,,,10,10,6,4
Chris Boucher,F-C,22023,1628449,22300116,"NOV 01, 2023",TOR vs. MIL,W,13,2,4,0.5,0,1,0.0,2,2,1.0,1,4,5,1,1,0,0,3,6,-10,1,TOR,TOR,MIL,130,,,12,11,7,6
Chris Boucher,F-C,22023,1628449,22300105,"OCT 30, 2023",TOR vs. POR,L,17,1,4,0.25,0,0,0.0,2,2,1.0,3,4,7,1,0,1,1,2,4,-3,1,TOR,TOR,POR,91,,,12,11,5,8
Chris Boucher,F-C,22023,1628449,22300718,"FEB 05, 2024",TOR @ NOP,L,12,4,5,0.8,1,2,0.5,2,2,1.0,1,5,6,1,0,1,1,0,11,-4,1,TOR,NOP,TOR,100,,,18,17,12,7
Chris Boucher,F-C,22023,1628449,22300672,"JAN 30, 2024",TOR @ CHI,W,7,2,2,1.0,1,1,1.0,0,0,0.0,0,2,2,0,0,0,1,1,5,-5,1,TOR,CHI,TOR,118,,,7,7,5,2
Chris Boucher,F-C,22023,1628449,22300653,"JAN 28, 2024",TOR @ ATL,L,13,1,2,0.5,0,1,0.0,3,3,1.0,1,3,4,0,0,0,1,2,5,14,1,TOR,ATL,TOR,113,,,9,9,5,4
Chris Boucher,F-C,22023,1628449,22300637,"JAN 26, 2024",TOR vs. LAC,L,17,4,8,0.5,0,3,0.0,1,2,0.5,3,2,5,0,0,0,0,1,9,-4,1,TOR,TOR,LAC,107,,,14,14,9,5
Chris Boucher,F-C,22023,1628449,22300609,"JAN 22, 2024",TOR vs. MEM,L,12,1,3,0.333,1,2,0.5,2,2,1.0,2,3,5,1,0,0,0,1,5,-4,1,TOR,TOR,MEM,100,,,11,10,6,6
Chris Boucher,F-C,22023,1628449,22300596,"JAN 20, 2024",TOR @ NYK,L,12,2,5,0.4,0,1,0.0,1,2,0.5,2,0,2,1,0,0,0,2,5,-4,1,TOR,NYK,TOR,94,,,8,7,6,3
Chris Boucher,F-C,22023,1628449,22300580,"JAN 18, 2024",TOR vs. CHI,L,18,2,4,0.5,1,3,0.333,1,2,0.5,2,7,9,2,0,0,2,1,6,13,1,TOR,TOR,CHI,100,,,17,15,8,11
Chris Boucher,F-C,22023,1628449,22300574,"JAN 17, 2024",TOR vs. MIA,W,18,1,3,0.333,0,1,0.0,0,0,0.0,2,5,7,0,0,1,0,0,2,20,1,TOR,TOR,MIA,115,,,9,9,2,7
Chris Boucher,F-C,22023,1628449,22300563,"JAN 15, 2024",TOR vs. BOS,L,14,1,6,0.167,0,4,0.0,2,2,1.0,1,1,2,0,0,0,0,1,4,-8,1,TOR,TOR,BOS,94,,,6,6,4,2
Chris Boucher,F-C,22023,1628449,22300540,"JAN 12, 2024",TOR @ UTA,L,12,2,4,0.5,1,3,0.333,2,2,1.0,0,0,0,0,0,0,1,1,7,-12,1,TOR,UTA,TOR,104,,,7,7,7,0
Chris Boucher,F-C,22023,1628449,22300526,"JAN 10, 2024",TOR @ LAC,L,11,1,3,0.333,0,1,0.0,1,1,1.0,0,1,1,0,0,0,0,0,3,-10,1,TOR,LAC,TOR,111,,,4,4,3,1
Chris Boucher,F-C,22023,1628449,22300516,"JAN 09, 2024",TOR @ LAL,L,14,1,3,0.333,0,2,0.0,0,0,0.0,0,7,7,1,2,0,3,1,2,-4,1,TOR,LAL,TOR,131,,,10,9,3,8
Chris Boucher,F-C,22023,1628449,22300504,"JAN 07, 2024",TOR @ GSW,W,16,7,7,1.0,3,3,1.0,0,0,0.0,2,7,9,1,1,1,0,0,17,17,1,TOR,GSW,TOR,131,,,27,26,18,10
Chris Boucher,F-C,22023,1628449,22300492,"JAN 05, 2024",TOR @ SAC,L,28,5,9,0.556,1,5,0.2,3,5,0.6,3,6,9,1,1,1,0,2,14,1,1,TOR,SAC,TOR,120,,,24,23,15,10
Chris Boucher,F-C,22023,1628449,22300470,"JAN 03, 2024",TOR @ MEM,W,13,2,2,1.0,0,0,0.0,0,0,0.0,3,5,8,2,0,0,1,0,4,10,1,TOR,MEM,TOR,116,,,14,12,6,10
Chris Boucher,F-C,22023,1628449,22300452,"JAN 01, 2024",TOR vs. CLE,W,11,0,0,0.0,0,0,0.0,0,0,0.0,0,1,1,0,0,0,0,0,0,1,1,TOR,TOR,CLE,124,,,1,1,0,1
Chris Boucher,F-C,22023,1628449,22300440,"DEC 30, 2023",TOR @ DET,L,17,0,1,0.0,0,1,0.0,4,6,0.667,0,2,2,0,0,0,0,2,4,-3,1,TOR,DET,TOR,127,,,6,6,4,2
Torrey Craig,F,22023,1628470,22300139,"NOV 04, 2023",CHI @ DEN,L,27,3,6,0.5,0,1,0.0,1,1,1.0,2,4,6,3,1,0,0,1,7,-19,1,CHI,DEN,CHI,101,,,16,13,10,9
Torrey Craig,F,22023,1628470,22300737,"FEB 08, 2024",CHI @ MEM,W,16,1,4,0.25,1,4,0.25,0,0,0.0,1,4,5,1,0,0,0,1,3,6,1,CHI,MEM,CHI,118,,,9,8,4,6
Torrey Craig,F,22023,1628470,22300723,"FEB 06, 2024",CHI vs. MIN,W,22,2,5,0.4,1,4,0.25,2,2,1.0,2,4,6,1,1,2,2,1,7,-2,1,CHI,CHI,MIN,129,,,14,13,8,7
Torrey Craig,F,22023,1628470,22300700,"FEB 03, 2024",CHI vs. SAC,L,14,2,5,0.4,1,4,0.25,0,0,0.0,0,3,3,0,0,0,0,1,5,-10,1,CHI,CHI,SAC,115,,,8,8,5,3
Torrey Craig,F,22023,1628470,22300337,"DEC 16, 2023",CHI @ MIA,L,14,5,7,0.714,4,5,0.8,2,3,0.667,2,0,2,0,0,0,0,0,16,-11,1,CHI,MIA,CHI,116,,,18,18,16,2
Torrey Craig,F,22023,1628470,22300320,"DEC 14, 2023",CHI @ MIA,W,23,2,7,0.286,0,3,0.0,1,1,1.0,1,2,3,0,1,0,0,3,5,-6,1,CHI,MIA,CHI,124,,,8,8,5,3
Torrey Craig,F,22023,1628470,22300307,"DEC 12, 2023",CHI vs. DEN,L,19,1,4,0.25,0,2,0.0,0,0,0.0,2,3,5,1,1,0,2,4,2,-4,1,CHI,CHI,DEN,106,,,8,7,3,6
Torrey Craig,F,22023,1628470,22300300,"DEC 11, 2023",CHI @ MIL,L,29,2,9,0.222,1,5,0.2,2,4,0.5,1,4,5,1,0,1,0,6,7,-11,1,CHI,MIL,CHI,129,,,13,12,8,6
Torrey Craig,F,22023,1628470,22301223,"DEC 08, 2023",CHI @ SAS,W,23,5,8,0.625,5,7,0.714,1,2,0.5,4,4,8,0,2,0,0,3,16,1,1,CHI,SAS,CHI,121,,,24,24,16,8
Torrey Craig,F,22023,1628470,22301211,"DEC 06, 2023",CHI vs. CHA,W,17,2,4,0.5,2,2,1.0,0,0,0.0,3,1,4,2,1,0,0,2,6,1,1,CHI,CHI,CHA,111,,,12,10,8,6
Torrey Craig,F,22023,1628470,22300285,"DEC 02, 2023",CHI vs. NOP,W,19,5,6,0.833,3,4,0.75,2,2,1.0,3,3,6,2,0,1,1,3,15,16,1,CHI,CHI,NOP,124,,,23,21,17,8
Torrey Craig,F,22023,1628470,22300269,"NOV 30, 2023",CHI vs. MIL,W,27,4,10,0.4,2,6,0.333,0,0,0.0,3,5,8,2,1,1,2,4,10,14,1,CHI,CHI,MIL,120,,,20,18,12,10
Torrey Craig,F,22023,1628470,22300053,"NOV 28, 2023",CHI @ BOS,L,13,1,1,1.0,1,1,1.0,0,0,0.0,0,1,1,0,1,1,0,0,3,-5,1,CHI,BOS,CHI,97,,,4,4,3,1
Torrey Craig,F,22023,1628470,22300250,"NOV 26, 2023",CHI @ BKN,L,20,1,2,0.5,0,0,0.0,2,2,1.0,2,1,3,0,0,0,2,0,4,-25,1,CHI,BKN,CHI,109,,,7,7,4,3
Torrey Craig,F,22023,1628470,22300046,"NOV 24, 2023",CHI @ TOR,L,19,1,3,0.333,0,1,0.0,3,4,0.75,2,3,5,1,0,1,1,2,5,-6,1,CHI,TOR,CHI,108,,,11,10,6,6
Torrey Craig,F,22023,1628470,22300234,"NOV 22, 2023",CHI @ OKC,L,15,0,3,0.0,0,3,0.0,0,0,0.0,0,3,3,0,0,0,1,4,0,-15,1,CHI,OKC,CHI,102,,,3,3,0,3
Torrey Craig,F,22023,1628470,22300220,"NOV 20, 2023",CHI vs. MIA,L,16,1,5,0.2,0,3,0.0,0,0,0.0,0,1,1,0,0,0,0,1,2,-7,1,CHI,CHI,MIA,100,,,3,3,2,1
Torrey Craig,F,22023,1628470,22300204,"NOV 18, 2023",CHI vs. MIA,W,17,3,5,0.6,1,3,0.333,0,0,0.0,1,4,5,2,0,1,0,1,7,12,1,CHI,CHI,MIA,102,,,14,12,9,7
Torrey Craig,F,22023,1628470,22300033,"NOV 17, 2023",CHI vs. ORL,L,26,1,3,0.333,1,3,0.333,0,0,0.0,0,1,1,0,1,0,1,3,3,-15,1,CHI,CHI,ORL,97,,,4,4,3,1
Torrey Craig,F,22023,1628470,22300196,"NOV 15, 2023",CHI vs. ORL,L,28,4,7,0.571,0,2,0.0,3,3,1.0,3,4,7,0,1,0,2,1,11,-8,1,CHI,CHI,ORL,94,,,18,18,11,7
Torrey Craig,F,22023,1628470,22300190,"NOV 13, 2023",CHI @ MIL,L,22,3,8,0.375,1,4,0.25,1,1,1.0,7,5,12,2,0,0,0,2,8,1,1,CHI,MIL,CHI,109,,,22,20,10,14
Torrey Craig,F,22023,1628470,22300181,"NOV 12, 2023",CHI vs. DET,W,31,1,6,0.167,1,4,0.25,0,0,0.0,3,7,10,2,1,0,0,3,3,12,1,CHI,CHI,DET,119,,,15,13,5,12
Torrey Craig,F,22023,1628470,22300162,"NOV 08, 2023",CHI vs. PHX,L,20,0,3,0.0,0,2,0.0,0,0,0.0,0,2,2,1,1,0,0,3,0,-24,1,CHI,CHI,PHX,115,,,3,2,1,3
Torrey Craig,F,22023,1628470,22300152,"NOV 06, 2023",CHI vs. UTA,W,20,1,3,0.333,1,1,1.0,0,0,0.0,0,3,3,2,1,1,0,5,3,8,1,CHI,CHI,UTA,130,,,8,6,5,5
Torrey Craig,F,22023,1628470,22300004,"NOV 03, 2023",CHI vs. BKN,L,23,1,4,0.25,1,2,0.5,0,0,0.0,0,6,6,4,1,0,1,4,3,6,1,CHI,CHI,BKN,107,,,13,9,7,10
Torrey Craig,F,22023,1628470,22300124,"NOV 01, 2023",CHI @ DAL,L,17,1,2,0.5,0,1,0.0,0,0,0.0,2,3,5,1,0,0,0,3,2,1,1,CHI,DAL,CHI,105,,,8,7,3,6
Torrey Craig,F,22023,1628470,22300102,"OCT 30, 2023",CHI @ IND,W,20,2,3,0.667,1,1,1.0,0,0,0.0,1,3,4,1,2,1,2,3,5,5,1,CHI,IND,CHI,112,,,10,9,6,5
Torrey Craig,F,22023,1628470,22300088,"OCT 28, 2023",CHI @ DET,L,23,2,7,0.286,0,2,0.0,0,0,0.0,1,2,3,0,0,1,0,3,4,-12,1,CHI,DET,CHI,102,,,7,7,4,3
Torrey Craig,F,22023,1628470,22300082,"OCT 27, 2023",CHI vs. TOR,W,24,3,7,0.429,1,4,0.25,0,0,0.0,3,2,5,0,1,1,0,2,7,-6,1,CHI,CHI,TOR,104,,,12,12,7,5
Torrey Craig,F,22023,1628470,22300070,"OCT 25, 2023",CHI vs. OKC,L,22,4,6,0.667,3,4,0.75,0,0,0.0,4,3,7,1,0,0,1,2,11,-12,1,CHI,CHI,OKC,104,,,19,18,12,8
Torrey Craig,F,22023,1628470,22300752,"FEB 10, 2024",CHI @ ORL,L,21,1,3,0.333,1,2,0.5,0,0,0.0,1,0,1,1,1,1,0,0,3,-6,1,CHI,ORL,CHI,108,,,5,4,4,2
Haywood Highsmith,F,22023,1629312,22300721,"FEB 06, 2024",MIA vs. ORL,W,3,0,0,0.0,0,0,0.0,0,0,0.0,0,0,0,0,0,0,0,0,0,2,1,MIA,MIA,ORL,121,,,0,0,0,0
Haywood Highsmith,F,22023,1629312,22300708,"FEB 04, 2024",MIA vs. LAC,L,27,2,5,0.4,1,3,0.333,0,0,0.0,0,3,3,0,1,0,0,5,5,-3,1,MIA,MIA,LAC,95,,,8,8,5,3
Haywood Highsmith,F,22023,1629312,22300689,"FEB 02, 2024",MIA @ WAS,W,15,2,6,0.333,0,4,0.0,0,0,0.0,1,1,2,0,0,0,1,2,4,1,1,MIA,WAS,MIA,110,,,6,6,4,2
Haywood Highsmith,F,22023,1629312,22300678,"JAN 31, 2024",MIA vs. SAC,W,16,2,4,0.5,0,1,0.0,0,0,0.0,1,1,2,1,0,0,1,1,4,5,1,MIA,MIA,SAC,115,,,7,6,5,3
Haywood Highsmith,F,22023,1629312,22300661,"JAN 29, 2024",MIA vs. PHX,L,15,1,3,0.333,0,2,0.0,1,1,1.0,0,2,2,0,0,0,0,3,3,-8,1,MIA,MIA,PHX,105,,,5,5,3,2
Haywood Highsmith,F,22023,1629312,22300643,"JAN 27, 2024",MIA @ NYK,L,21,3,5,0.6,2,4,0.5,0,0,0.0,1,3,4,2,0,2,0,2,8,4,1,MIA,NYK,MIA,109,,,14,12,10,6
Haywood Highsmith,F,22023,1629312,22300630,"JAN 25, 2024",MIA vs. BOS,L,26,5,7,0.714,4,4,1.0,0,0,0.0,1,2,3,1,0,0,1,3,14,-8,1,MIA,MIA,BOS,110,,,18,17,15,4
Haywood Highsmith,F,22023,1629312,22300621,"JAN 24, 2024",MIA vs. MEM,L,24,3,6,0.5,2,4,0.5,0,0,0.0,1,3,4,1,2,1,1,1,8,-9,1,MIA,MIA,MEM,96,,,13,12,9,5
Haywood Highsmith,F,22023,1629312,22300601,"JAN 21, 2024",MIA @ ORL,L,25,1,3,0.333,1,1,1.0,2,3,0.667,0,2,2,1,2,0,0,4,5,-6,1,MIA,ORL,MIA,87,,,8,7,6,3
Haywood Highsmith,F,22023,1629312,22300587,"JAN 19, 2024",MIA vs. ATL,L,10,0,2,0.0,0,1,0.0,0,0,0.0,0,0,0,0,1,0,0,0,0,1,1,MIA,MIA,ATL,108,,,0,0,0,0
Haywood Highsmith,F,22023,1629312,22300574,"JAN 17, 2024",MIA @ TOR,L,12,1,2,0.5,0,1,0.0,0,0,0.0,2,1,3,0,0,1,0,0,2,-19,1,MIA,TOR,MIA,97,,,5,5,2,3
Haywood Highsmith,F,22023,1629312,22300562,"JAN 15, 2024",MIA @ BKN,W,12,0,2,0.0,0,1,0.0,0,0,0.0,0,1,1,0,0,0,0,2,0,-16,1,MIA,BKN,MIA,96,,,1,1,0,1
Haywood Highsmith,F,22023,1629312,22300551,"JAN 14, 2024",MIA vs. CHA,W,31,3,5,0.6,1,1,1.0,0,0,0.0,0,2,2,2,2,1,0,0,7,11,1,MIA,MIA,CHA,104,,,11,9,9,4
Haywood Highsmith,F,22023,1629312,22300535,"JAN 12, 2024",MIA vs. ORL,W,32,2,5,0.4,1,3,0.333,2,2,1.0,2,6,8,1,1,0,1,2,7,-5,1,MIA,MIA,ORL,99,,,16,15,8,9
Haywood Highsmith,F,22023,1629312,22300522,"JAN 10, 2024",MIA vs. OKC,L,35,7,14,0.5,5,7,0.714,0,0,0.0,2,3,5,2,1,0,0,2,19,-1,1,MIA,MIA,OKC,120,,,26,24,21,7
Haywood Highsmith,F,22023,1629312,22300509,"JAN 08, 2024",MIA vs. HOU,W,16,1,2,0.5,1,2,0.5,0,0,0.0,0,3,3,0,0,0,0,0,3,-4,1,MIA,MIA,HOU,120,,,6,6,3,3
Haywood Highsmith,F,22023,1629312,22300439,"DEC 30, 2023",MIA @ UTA,L,26,1,5,0.2,0,4,0.0,2,2,1.0,0,6,6,1,2,1,2,2,4,4,1,MIA,UTA,MIA,109,,,11,10,5,7
Haywood Highsmith,F,22023,1629312,22300426,"DEC 28, 2023",MIA @ GSW,W,18,1,3,0.333,1,2,0.5,0,0,0.0,0,0,0,0,1,0,0,4,3,4,1,MIA,GSW,MIA,114,,,3,3,3,0
Haywood Highsmith,F,22023,1629312,22300384,"DEC 22, 2023",MIA vs. ATL,W,10,2,6,0.333,1,3,0.333,0,0,0.0,3,2,5,2,0,0,0,2,5,-4,1,MIA,MIA,ATL,122,,,12,10,7,7
Haywood Highsmith,F,22023,1629312,22300366,"DEC 20, 2023",MIA @ ORL,W,30,5,12,0.417,4,9,0.444,1,2,0.5,4,2,6,2,2,0,1,3,15,6,1,MIA,ORL,MIA,115,,,23,21,17,8
Haywood Highsmith,F,22023,1629312,22300353,"DEC 18, 2023",MIA vs. MIN,L,12,0,0,0.0,0,0,0.0,0,0,0.0,1,0,1,1,1,1,1,2,0,-10,1,MIA,MIA,MIN,108,,,2,1,1,2
Haywood Highsmith,F,22023,1629312,22300267,"NOV 30, 2023",MIA vs. IND,W,15,1,2,0.5,0,1,0.0,0,0,0.0,0,1,1,1,0,0,1,4,2,-12,1,MIA,MIA,IND,142,,,4,3,3,2
Haywood Highsmith,F,22023,1629312,22300045,"NOV 24, 2023",MIA @ NYK,L,24,1,6,0.167,1,5,0.2,2,2,1.0,0,3,3,3,2,0,2,1,5,10,1,MIA,NYK,MIA,98,,,11,8,8,6
Haywood Highsmith,F,22023,1629312,22300220,"NOV 20, 2023",MIA @ CHI,W,20,3,4,0.75,1,1,1.0,0,0,0.0,1,1,2,3,1,0,1,3,7,1,1,MIA,CHI,MIA,118,,,12,9,10,5
Haywood Highsmith,F,22023,1629312,22300204,"NOV 18, 2023",MIA @ CHI,L,24,0,4,0.0,0,3,0.0,0,0,0.0,1,2,3,0,3,0,4,1,0,20,1,MIA,CHI,MIA,97,,,3,3,0,3
Haywood Highsmith,F,22023,1629312,22300200,"NOV 16, 2023",MIA vs. BKN,W,23,2,5,0.4,0,3,0.0,2,2,1.0,0,1,1,0,0,0,1,3,6,3,1,MIA,MIA,BKN,122,,,7,7,6,1
Haywood Highsmith,F,22023,1629312,22300017,"NOV 14, 2023",MIA @ CHA,W,33,5,8,0.625,2,5,0.4,0,0,0.0,1,3,4,2,5,2,0,1,12,6,1,MIA,CHA,MIA,111,,,18,16,14,6
Haywood Highsmith,F,22023,1629312,22300184,"NOV 12, 2023",MIA @ SAS,W,26,0,4,0.0,0,3,0.0,0,0,0.0,1,3,4,1,0,0,0,3,0,-20,1,MIA,SAS,MIA,118,,,5,4,1,5
Haywood Highsmith,F,22023,1629312,22300175,"NOV 11, 2023",MIA @ ATL,W,34,3,13,0.231,0,5,0.0,5,7,0.714,1,5,6,5,2,1,1,2,11,10,1,MIA,ATL,MIA,117,,,22,17,16,11
Haywood Highsmith,F,22023,1629312,22300164,"NOV 08, 2023",MIA @ MEM,W,27,5,7,0.714,2,4,0.5,2,2,1.0,2,0,2,1,1,3,0,2,14,12,1,MIA,MEM,MIA,108,,,17,16,15,3
Haywood Highsmith,F,22023,1629312,22300150,"NOV 06, 2023",MIA vs. LAL,W,22,2,6,0.333,1,5,0.2,0,0,0.0,0,1,1,0,1,1,0,2,5,10,1,MIA,MIA,LAL,108,,,6,6,5,1
Haywood Highsmith,F,22023,1629312,22300003,"NOV 03, 2023",MIA vs. WAS,W,22,3,4,0.75,2,3,0.667,0,0,0.0,0,0,0,0,0,0,2,3,8,10,1,MIA,MIA,WAS,121,,,8,8,8,0
Haywood Highsmith,F,22023,1629312,22300119,"NOV 01, 2023",MIA vs. BKN,L,22,3,5,0.6,3,4,0.75,0,0,0.0,0,4,4,2,1,1,1,0,9,-9,1,MIA,MIA,BKN,105,,,15,13,11,6
Haywood Highsmith,F,22023,1629312,22300337,"DEC 16, 2023",MIA vs. CHI,W,14,1,2,0.5,0,1,0.0,0,1,0.0,1,0,1,1,0,0,0,2,2,-10,1,MIA,MIA,CHI,118,,,4,3,3,2
Haywood Highsmith,F,22023,1629312,22300240,"NOV 25, 2023",MIA @ BKN,L,15,3,7,0.429,2,3,0.667,0,0,0.0,1,3,4,0,0,1,1,2,8,-22,1,MIA,BKN,MIA,97,,,12,12,8,4
Haywood Highsmith,F,22023,1629312,22300229,"NOV 22, 2023",MIA @ CLE,W,25,4,6,0.667,2,3,0.667,0,0,0.0,1,5,6,5,1,2,0,4,10,18,1,MIA,CLE,MIA,129,,,21,16,15,11
Haywood Highsmith,F,22023,1629312,22300284,"DEC 02, 2023",MIA vs. IND,L,3,0,1,0.0,0,1,0.0,0,0,0.0,0,0,0,0,0,0,1,1,0,-1,1,MIA,MIA,IND,129,,,0,0,0,0
Nicolas Batum,G-F,22023,201587,22300668,"JAN 29, 2024",PHI @ POR,L,24,1,5,0.2,1,4,0.25,0,0,0.0,3,1,4,1,0,0,0,1,3,-19,1,PHI,POR,PHI,104,,,8,7,4,5
Nicolas Batum,G-F,22023,201587,22300532,"JAN 12, 2024",PHI vs. SAC,W,25,5,5,1.0,4,4,1.0,0,0,0.0,3,2,5,3,0,0,0,2,14,2,1,PHI,PHI,SAC,112,,,22,19,17,8
Nicolas Batum,G-F,22023,201587,22300521,"JAN 10, 2024",PHI @ ATL,L,37,2,4,0.5,1,2,0.5,1,2,0.5,2,2,4,2,0,3,1,4,6,2,1,PHI,ATL,PHI,132,,,12,10,8,6
Nicolas Batum,G-F,22023,201587,22300495,"JAN 06, 2024",PHI vs. UTA,L,26,1,6,0.167,0,5,0.0,0,0,0.0,1,3,4,4,4,2,2,3,2,-13,1,PHI,PHI,UTA,109,,,10,6,6,8
Nicolas Batum,G-F,22023,201587,22300483,"JAN 05, 2024",PHI vs. NYK,L,21,0,2,0.0,0,1,0.0,0,0,0.0,1,3,4,1,0,1,2,2,0,-6,1,PHI,PHI,NYK,92,,,5,4,1,5
Nicolas Batum,G-F,22023,201587,22300459,"JAN 02, 2024",PHI vs. CHI,W,22,2,4,0.5,1,3,0.333,1,1,1.0,2,1,3,2,0,1,1,2,6,18,1,PHI,PHI,CHI,110,,,11,9,8,5
Nicolas Batum,G-F,22023,201587,22300442,"DEC 30, 2023",PHI @ CHI,L,19,3,6,0.5,3,5,0.6,0,0,0.0,0,3,3,2,0,0,1,1,9,-1,1,PHI,CHI,PHI,92,,,14,12,11,5
Nicolas Batum,G-F,22023,201587,22300335,"DEC 16, 2023",PHI @ CHA,W,20,1,3,0.333,1,2,0.5,0,0,0.0,0,3,3,3,0,0,0,2,3,24,1,PHI,CHA,PHI,135,,,9,6,6,6
Nicolas Batum,G-F,22023,201587,22300327,"DEC 15, 2023",PHI vs. DET,W,22,2,4,0.5,0,1,0.0,0,0,0.0,2,3,5,4,2,0,0,0,4,30,1,PHI,PHI,DET,124,,,13,9,8,9
Nicolas Batum,G-F,22023,201587,22300310,"DEC 13, 2023",PHI @ DET,W,20,2,2,1.0,1,1,1.0,0,0,0.0,0,1,1,2,0,0,0,3,5,6,1,PHI,DET,PHI,129,,,8,6,7,3
Nicolas Batum,G-F,22023,201587,22300295,"DEC 11, 2023",PHI vs. WAS,W,20,2,5,0.4,0,3,0.0,0,0,0.0,0,2,2,1,1,2,0,0,4,12,1,PHI,PHI,WAS,146,,,7,6,5,3
Nicolas Batum,G-F,22023,201587,22301218,"DEC 08, 2023",PHI vs. ATL,W,29,3,4,0.75,2,3,0.667,0,0,0.0,2,2,4,4,0,0,0,1,8,3,1,PHI,PHI,ATL,125,,,16,12,12,8
Nicolas Batum,G-F,22023,201587,22300262,"NOV 29, 2023",PHI @ NOP,L,14,1,1,1.0,1,1,1.0,0,0,0.0,0,1,1,0,0,0,1,1,3,-21,1,PHI,NOP,PHI,114,,,4,4,3,1
Nicolas Batum,G-F,22023,201587,22300255,"NOV 27, 2023",PHI vs. LAL,W,29,4,7,0.571,2,3,0.667,0,0,0.0,3,4,7,4,3,0,0,3,10,30,1,PHI,PHI,LAL,138,,,21,17,14,11
Nicolas Batum,G-F,22023,201587,22300232,"NOV 22, 2023",PHI @ MIN,L,24,2,4,0.5,2,4,0.5,0,0,0.0,0,3,3,0,0,1,1,2,6,-23,1,PHI,MIN,PHI,99,,,9,9,6,3
Nicolas Batum,G-F,22023,201587,22300208,"NOV 19, 2023",PHI @ BKN,W,24,1,1,1.0,1,1,1.0,0,0,0.0,0,3,3,3,0,0,0,2,3,25,1,PHI,BKN,PHI,121,,,9,6,6,6
Nicolas Batum,G-F,22023,201587,22300148,"NOV 06, 2023",PHI vs. WAS,W,17,4,5,0.8,3,4,0.75,0,0,0.0,0,2,2,0,1,0,0,1,11,28,1,PHI,PHI,WAS,146,,,13,13,11,2
Nicolas Batum,G-F,22023,201587,22300644,"JAN 27, 2024",PHI @ DEN,L,26,0,1,0.0,0,0,0.0,0,0,0.0,0,4,4,2,0,0,1,3,0,-10,1,PHI,DEN,PHI,105,,,6,4,2,6
Nicolas Batum,G-F,22023,201587,22300627,"JAN 25, 2024",PHI @ IND,L,22,4,5,0.8,2,3,0.667,0,0,0.0,0,3,3,1,0,0,1,2,10,-14,1,PHI,IND,PHI,122,,,14,13,11,4
Nicolas Batum,G-F,22023,201587,22300608,"JAN 22, 2024",PHI vs. SAS,W,33,2,4,0.5,1,3,0.333,0,0,0.0,4,4,8,6,3,0,1,3,5,3,1,PHI,PHI,SAS,133,,,19,13,11,14
Nicolas Batum,G-F,22023,201587,22300593,"JAN 20, 2024",PHI @ CHA,W,29,4,6,0.667,1,3,0.333,0,0,0.0,3,2,5,1,2,2,0,1,9,11,1,PHI,CHA,PHI,97,,,15,14,10,6
Nicolas Batum,G-F,22023,201587,22300585,"JAN 19, 2024",PHI @ ORL,W,20,1,2,0.5,1,2,0.5,0,0,0.0,2,0,2,5,0,0,0,4,3,11,1,PHI,ORL,PHI,124,,,10,5,8,7
Nicolas Batum,G-F,22023,201587,22300566,"JAN 16, 2024",PHI vs. DEN,W,35,3,4,0.75,2,3,0.667,0,0,0.0,1,3,4,2,0,2,2,3,8,7,1,PHI,PHI,DEN,126,,,14,12,10,6
Nicolas Batum,G-F,22023,201587,22300555,"JAN 15, 2024",PHI vs. HOU,W,28,2,7,0.286,1,3,0.333,0,0,0.0,2,3,5,3,2,1,0,2,5,0,1,PHI,PHI,HOU,124,,,13,10,8,8
Nicolas Batum,G-F,22023,201587,22300351,"DEC 18, 2023",PHI vs. CHI,L,27,1,4,0.25,1,4,0.25,0,0,0.0,1,3,4,3,0,0,2,0,3,7,1,PHI,PHI,CHI,104,,,10,7,6,7
Nicolas Batum,G-F,22023,201587,22301208,"DEC 06, 2023",PHI @ WAS,W,33,2,4,0.5,1,3,0.333,4,7,0.571,1,5,6,5,0,0,0,2,9,7,1,PHI,WAS,PHI,131,,,20,15,14,11
Nicolas Batum,G-F,22023,201587,22300239,"NOV 25, 2023",PHI @ OKC,W,32,4,7,0.571,3,6,0.5,3,4,0.75,4,3,7,3,0,2,1,0,14,14,1,PHI,OKC,PHI,127,,,24,21,17,10
Nicolas Batum,G-F,22023,201587,22300040,"NOV 21, 2023",PHI vs. CLE,L,27,2,5,0.4,1,4,0.25,0,0,0.0,0,4,4,2,0,0,2,5,5,-3,1,PHI,PHI,CLE,119,,,11,9,7,6
Nicolas Batum,G-F,22023,201587,22300180,"NOV 12, 2023",PHI vs. IND,W,33,3,5,0.6,3,5,0.6,0,0,0.0,2,5,7,0,1,3,1,2,9,1,1,PHI,PHI,IND,137,,,16,16,9,7
Nicolas Batum,G-F,22023,201587,22300008,"NOV 10, 2023",PHI @ DET,W,26,1,2,0.5,1,2,0.5,0,0,0.0,1,2,3,3,1,0,0,4,3,13,1,PHI,DET,PHI,114,,,9,6,6,6
Nicolas Batum,G-F,22023,201587,22300159,"NOV 08, 2023",PHI vs. BOS,W,26,2,3,0.667,1,2,0.5,0,0,0.0,2,2,4,1,0,1,0,2,5,7,1,PHI,PHI,BOS,106,,,10,9,6,5
Nicolas Batum,G-F,22023,201587,22300099,"OCT 29, 2023",LAC vs. SAS,W,15,0,4,0.0,0,4,0.0,0,0,0.0,0,2,2,1,1,0,1,1,0,6,1,LAC,LAC,SAS,123,,,3,2,1,3
Nicolas Batum,G-F,22023,201587,22300085,"OCT 27, 2023",LAC @ UTA,L,30,3,4,0.75,2,3,0.667,0,0,0.0,0,2,2,3,1,3,0,4,8,-4,1,LAC,UTA,LAC,118,,,13,10,11,5
Nicolas Batum,G-F,22023,201587,22300074,"OCT 25, 2023",LAC vs. POR,W,9,0,0,0.0,0,0,0.0,0,0,0.0,0,3,3,1,1,1,0,0,0,-2,1,LAC,LAC,POR,123,,,4,3,1,4
Nicolas Batum,G-F,22023,201587,22300668,"JAN 29, 2024",PHI @ POR,L,24,1,5,0.2,1,4,0.25,0,0,0.0,3,1,4,1,0,0,0,1,3,-19,1,PHI,POR,PHI,104,,,8,7,4,5
Nicolas Batum,G-F,22023,201587,22300532,"JAN 12, 2024",PHI vs. SAC,W,25,5,5,1.0,4,4,1.0,0,0,0.0,3,2,5,3,0,0,0,2,14,2,1,PHI,PHI,SAC,112,,,22,19,17,8
Nicolas Batum,G-F,22023,201587,22300521,"JAN 10, 2024",PHI @ ATL,L,37,2,4,0.5,1,2,0.5,1,2,0.5,2,2,4,2,0,3,1,4,6,2,1,PHI,ATL,PHI,132,,,12,10,8,6
Nicolas Batum,G-F,22023,201587,22300495,"JAN 06, 2024",PHI vs. UTA,L,26,1,6,0.167,0,5,0.0,0,0,0.0,1,3,4,4,4,2,2,3,2,-13,1,PHI,PHI,UTA,109,,,10,6,6,8
Nicolas Batum,G-F,22023,201587,22300483,"JAN 05, 2024",PHI vs. NYK,L,21,0,2,0.0,0,1,0.0,0,0,0.0,1,3,4,1,0,1,2,2,0,-6,1,PHI,PHI,NYK,92,,,5,4,1,5
Nicolas Batum,G-F,22023,201587,22300459,"JAN 02, 2024",PHI vs. CHI,W,22,2,4,0.5,1,3,0.333,1,1,1.0,2,1,3,2,0,1,1,2,6,18,1,PHI,PHI,CHI,110,,,11,9,8,5
Nicolas Batum,G-F,22023,201587,22300442,"DEC 30, 2023",PHI @ CHI,L,19,3,6,0.5,3,5,0.6,0,0,0.0,0,3,3,2,0,0,1,1,9,-1,1,PHI,CHI,PHI,92,,,14,12,11,5
Nicolas Batum,G-F,22023,201587,22300335,"DEC 16, 2023",PHI @ CHA,W,20,1,3,0.333,1,2,0.5,0,0,0.0,0,3,3,3,0,0,0,2,3,24,1,PHI,CHA,PHI,135,,,9,6,6,6
Nicolas Batum,G-F,22023,201587,22300327,"DEC 15, 2023",PHI vs. DET,W,22,2,4,0.5,0,1,0.0,0,0,0.0,2,3,5,4,2,0,0,0,4,30,1,PHI,PHI,DET,124,,,13,9,8,9
Nicolas Batum,G-F,22023,201587,22300310,"DEC 13, 2023",PHI @ DET,W,20,2,2,1.0,1,1,1.0,0,0,0.0,0,1,1,2,0,0,0,3,5,6,1,PHI,DET,PHI,129,,,8,6,7,3
Nicolas Batum,G-F,22023,201587,22300295,"DEC 11, 2023",PHI vs. WAS,W,20,2,5,0.4,0,3,0.0,0,0,0.0,0,2,2,1,1,2,0,0,4,12,1,PHI,PHI,WAS,146,,,7,6,5,3
Nicolas Batum,G-F,22023,201587,22301218,"DEC 08, 2023",PHI vs. ATL,W,29,3,4,0.75,2,3,0.667,0,0,0.0,2,2,4,4,0,0,0,1,8,3,1,PHI,PHI,ATL,125,,,16,12,12,8
Nicolas Batum,G-F,22023,201587,22300262,"NOV 29, 2023",PHI @ NOP,L,14,1,1,1.0,1,1,1.0,0,0,0.0,0,1,1,0,0,0,1,1,3,-21,1,PHI,NOP,PHI,114,,,4,4,3,1
Nicolas Batum,G-F,22023,201587,22300255,"NOV 27, 2023",PHI vs. LAL,W,29,4,7,0.571,2,3,0.667,0,0,0.0,3,4,7,4,3,0,0,3,10,30,1,PHI,PHI,LAL,138,,,21,17,14,11
Nicolas Batum,G-F,22023,201587,22300232,"NOV 22, 2023",PHI @ MIN,L,24,2,4,0.5,2,4,0.5,0,0,0.0,0,3,3,0,0,1,1,2,6,-23,1,PHI,MIN,PHI,99,,,9,9,6,3
Nicolas Batum,G-F,22023,201587,22300208,"NOV 19, 2023",PHI @ BKN,W,24,1,1,1.0,1,1,1.0,0,0,0.0,0,3,3,3,0,0,0,2,3,25,1,PHI,BKN,PHI,121,,,9,6,6,6
Nicolas Batum,G-F,22023,201587,22300148,"NOV 06, 2023",PHI vs. WAS,W,17,4,5,0.8,3,4,0.75,0,0,0.0,0,2,2,0,1,0,0,1,11,28,1,PHI,PHI,WAS,146,,,13,13,11,2
Nicolas Batum,G-F,22023,201587,22300644,"JAN 27, 2024",PHI @ DEN,L,26,0,1,0.0,0,0,0.0,0,0,0.0,0,4,4,2,0,0,1,3,0,-10,1,PHI,DEN,PHI,105,,,6,4,2,6
Nicolas Batum,G-F,22023,201587,22300627,"JAN 25, 2024",PHI @ IND,L,22,4,5,0.8,2,3,0.667,0,0,0.0,0,3,3,1,0,0,1,2,10,-14,1,PHI,IND,PHI,122,,,14,13,11,4
Nicolas Batum,G-F,22023,201587,22300608,"JAN 22, 2024",PHI vs. SAS,W,33,2,4,0.5,1,3,0.333,0,0,0.0,4,4,8,6,3,0,1,3,5,3,1,PHI,PHI,SAS,133,,,19,13,11,14
Nicolas Batum,G-F,22023,201587,22300593,"JAN 20, 2024",PHI @ CHA,W,29,4,6,0.667,1,3,0.333,0,0,0.0,3,2,5,1,2,2,0,1,9,11,1,PHI,CHA,PHI,97,,,15,14,10,6
Nicolas Batum,G-F,22023,201587,22300585,"JAN 19, 2024",PHI @ ORL,W,20,1,2,0.5,1,2,0.5,0,0,0.0,2,0,2,5,0,0,0,4,3,11,1,PHI,ORL,PHI,124,,,10,5,8,7
Nicolas Batum,G-F,22023,201587,22300566,"JAN 16, 2024",PHI vs. DEN,W,35,3,4,0.75,2,3,0.667,0,0,0.0,1,3,4,2,0,2,2,3,8,7,1,PHI,PHI,DEN,126,,,14,12,10,6
Nicolas Batum,G-F,22023,201587,22300555,"JAN 15, 2024",PHI vs. HOU,W,28,2,7,0.286,1,3,0.333,0,0,0.0,2,3,5,3,2,1,0,2,5,0,1,PHI,PHI,HOU,124,,,13,10,8,8
Nicolas Batum,G-F,22023,201587,22300351,"DEC 18, 2023",PHI vs. CHI,L,27,1,4,0.25,1,4,0.25,0,0,0.0,1,3,4,3,0,0,2,0,3,7,1,PHI,PHI,CHI,104,,,10,7,6,7
Nicolas Batum,G-F,22023,201587,22301208,"DEC 06, 2023",PHI @ WAS,W,33,2,4,0.5,1,3,0.333,4,7,0.571,1,5,6,5,0,0,0,2,9,7,1,PHI,WAS,PHI,131,,,20,15,14,11
Nicolas Batum,G-F,22023,201587,22300239,"NOV 25, 2023",PHI @ OKC,W,32,4,7,0.571,3,6,0.5,3,4,0.75,4,3,7,3,0,2,1,0,14,14,1,PHI,OKC,PHI,127,,,24,21,17,10
Nicolas Batum,G-F,22023,201587,22300040,"NOV 21, 2023",PHI vs. CLE,L,27,2,5,0.4,1,4,0.25,0,0,0.0,0,4,4,2,0,0,2,5,5,-3,1,PHI,PHI,CLE,119,,,11,9,7,6
Nicolas Batum,G-F,22023,201587,22300180,"NOV 12, 2023",PHI vs. IND,W,33,3,5,0.6,3,5,0.6,0,0,0.0,2,5,7,0,1,3,1,2,9,1,1,PHI,PHI,IND,137,,,16,16,9,7
Nicolas Batum,G-F,22023,201587,22300008,"NOV 10, 2023",PHI @ DET,W,26,1,2,0.5,1,2,0.5,0,0,0.0,1,2,3,3,1,0,0,4,3,13,1,PHI,DET,PHI,114,,,9,6,6,6
Nicolas Batum,G-F,22023,201587,22300159,"NOV 08, 2023",PHI vs. BOS,W,26,2,3,0.667,1,2,0.5,0,0,0.0,2,2,4,1,0,1,0,2,5,7,1,PHI,PHI,BOS,106,,,10,9,6,5
Nicolas Batum,G-F,22023,201587,22300099,"OCT 29, 2023",LAC vs. SAS,W,15,0,4,0.0,0,4,0.0,0,0,0.0,0,2,2,1,1,0,1,1,0,6,1,LAC,LAC,SAS,123,,,3,2,1,3
Nicolas Batum,G-F,22023,201587,22300085,"OCT 27, 2023",LAC @ UTA,L,30,3,4,0.75,2,3,0.667,0,0,0.0,0,2,2,3,1,3,0,4,8,-4,1,LAC,UTA,LAC,118,,,13,10,11,5
Nicolas Batum,G-F,22023,201587,22300074,"OCT 25, 2023",LAC vs. POR,W,9,0,0,0.0,0,0,0.0,0,0,0.0,0,3,3,1,1,1,0,0,0,-2,1,LAC,LAC,POR,123,,,4,3,1,4
Patrick Beverley,G,22023,201976,22300745,"FEB 09, 2024",MIL vs. CHA,W,12,2,5,0.4,2,3,0.667,0,0,0.0,0,1,1,4,0,0,1,1,6,8,1,MIL,MIL,CHA,120,,,11,7,10,5
Patrick Beverley,G,22023,201976,22300727,"FEB 07, 2024",PHI vs. GSW,L,23,5,8,0.625,1,2,0.5,2,2,1.0,0,3,3,5,0,0,3,1,13,-17,1,PHI,PHI,GSW,104,,,21,16,18,8
Patrick Beverley,G,22023,201976,22300715,"FEB 05, 2024",PHI vs. DAL,L,21,3,8,0.375,1,3,0.333,0,0,0.0,2,1,3,2,0,0,1,1,7,-11,1,PHI,PHI,DAL,102,,,12,10,9,5
Patrick Beverley,G,22023,201976,22300698,"FEB 03, 2024",PHI vs. BKN,L,20,4,8,0.5,1,3,0.333,0,0,0.0,0,3,3,9,0,1,2,1,9,-15,1,PHI,PHI,BKN,121,,,21,12,18,12
Patrick Beverley,G,22023,201976,22300686,"FEB 01, 2024",PHI @ UTA,W,18,2,2,1.0,2,2,1.0,2,2,1.0,0,4,4,5,0,0,2,2,8,4,1,PHI,UTA,PHI,127,,,17,12,13,9
Patrick Beverley,G,22023,201976,22300668,"JAN 29, 2024",PHI @ POR,L,30,5,10,0.5,0,3,0.0,4,4,1.0,0,1,1,5,1,0,2,2,14,-25,1,PHI,POR,PHI,104,,,20,15,19,6
Patrick Beverley,G,22023,201976,22300532,"JAN 12, 2024",PHI vs. SAC,W,27,2,8,0.25,0,4,0.0,0,0,0.0,0,9,9,7,0,0,3,2,4,13,1,PHI,PHI,SAC,112,,,20,13,11,16
Patrick Beverley,G,22023,201976,22300521,"JAN 10, 2024",PHI @ ATL,L,13,3,4,0.75,1,2,0.5,2,2,1.0,1,2,3,2,0,0,1,2,9,-15,1,PHI,ATL,PHI,132,,,14,12,11,5
Patrick Beverley,G,22023,201976,22300495,"JAN 06, 2024",PHI vs. UTA,L,34,5,13,0.385,2,6,0.333,0,0,0.0,2,2,4,7,0,0,0,0,12,-2,1,PHI,PHI,UTA,109,,,23,16,19,11
Patrick Beverley,G,22023,201976,22300483,"JAN 05, 2024",PHI vs. NYK,L,14,0,1,0.0,0,1,0.0,2,2,1.0,0,2,2,0,1,0,2,2,2,-12,1,PHI,PHI,NYK,92,,,4,4,2,2
Patrick Beverley,G,22023,201976,22300459,"JAN 02, 2024",PHI vs. CHI,W,14,1,1,1.0,1,1,1.0,0,0,0.0,0,1,1,2,0,0,1,1,3,15,1,PHI,PHI,CHI,110,,,6,4,5,3
Patrick Beverley,G,22023,201976,22300442,"DEC 30, 2023",PHI @ CHI,L,24,1,4,0.25,0,2,0.0,2,2,1.0,0,2,2,3,1,2,1,4,4,-7,1,PHI,CHI,PHI,92,,,9,6,7,5
Patrick Beverley,G,22023,201976,22300434,"DEC 29, 2023",PHI @ HOU,W,20,3,4,0.75,1,1,1.0,2,2,1.0,2,1,3,3,0,0,0,1,9,7,1,PHI,HOU,PHI,131,,,15,12,12,6
Patrick Beverley,G,22023,201976,22300415,"DEC 27, 2023",PHI @ ORL,W,17,4,7,0.571,0,1,0.0,2,2,1.0,0,4,4,2,1,1,1,2,10,3,1,PHI,ORL,PHI,112,,,16,14,12,6
Patrick Beverley,G,22023,201976,22300404,"DEC 25, 2023",PHI @ MIA,L,13,2,4,0.5,1,3,0.333,4,4,1.0,0,3,3,0,0,0,2,2,9,-18,1,PHI,MIA,PHI,113,,,12,12,9,3
Patrick Beverley,G,22023,201976,22300367,"DEC 20, 2023",PHI vs. MIN,W,18,2,5,0.4,1,2,0.5,0,0,0.0,0,3,3,3,0,1,0,0,5,7,1,PHI,PHI,MIN,127,,,11,8,8,6
Patrick Beverley,G,22023,201976,22300335,"DEC 16, 2023",PHI @ CHA,W,8,0,1,0.0,0,1,0.0,3,4,0.75,0,0,0,2,0,0,0,1,3,14,1,PHI,CHA,PHI,135,,,5,3,5,2
Patrick Beverley,G,22023,201976,22300327,"DEC 15, 2023",PHI vs. DET,W,12,0,1,0.0,0,0,0.0,1,2,0.5,0,0,0,0,3,0,0,0,1,-6,1,PHI,PHI,DET,124,,,1,1,1,0
Patrick Beverley,G,22023,201976,22300310,"DEC 13, 2023",PHI @ DET,W,13,1,3,0.333,1,2,0.5,0,2,0.0,0,1,1,1,0,0,0,2,3,17,1,PHI,DET,PHI,129,,,5,4,4,2
Patrick Beverley,G,22023,201976,22300295,"DEC 11, 2023",PHI vs. WAS,W,11,4,6,0.667,3,4,0.75,1,1,1.0,1,1,2,2,0,0,0,2,12,22,1,PHI,PHI,WAS,146,,,16,14,14,4
Patrick Beverley,G,22023,201976,22301218,"DEC 08, 2023",PHI vs. ATL,W,18,2,6,0.333,0,3,0.0,1,1,1.0,1,0,1,1,0,0,1,0,5,4,1,PHI,PHI,ATL,125,,,7,6,6,2
Patrick Beverley,G,22023,201976,22300275,"DEC 01, 2023",PHI @ BOS,L,38,10,15,0.667,3,5,0.6,3,5,0.6,2,6,8,7,2,0,3,4,26,-12,1,PHI,BOS,PHI,119,,,41,34,33,15
Patrick Beverley,G,22023,201976,22300262,"NOV 29, 2023",PHI @ NOP,L,21,3,4,0.75,1,1,1.0,4,4,1.0,0,1,1,7,1,0,0,1,11,3,1,PHI,NOP,PHI,114,,,19,12,18,8
Patrick Beverley,G,22023,201976,22300255,"NOV 27, 2023",PHI vs. LAL,W,24,4,9,0.444,4,8,0.5,0,0,0.0,2,4,6,3,0,0,1,2,12,26,1,PHI,PHI,LAL,138,,,21,18,15,9
Patrick Beverley,G,22023,201976,22300232,"NOV 22, 2023",PHI @ MIN,L,16,1,2,0.5,0,1,0.0,0,0,0.0,0,0,0,2,0,0,2,2,2,-16,1,PHI,MIN,PHI,99,,,4,2,4,2
Patrick Beverley,G,22023,201976,22300208,"NOV 19, 2023",PHI @ BKN,W,12,1,4,0.25,0,1,0.0,0,0,0.0,0,1,1,2,0,0,1,1,2,1,1,PHI,BKN,PHI,121,,,5,3,4,3
Patrick Beverley,G,22023,201976,22300148,"NOV 06, 2023",PHI vs. WAS,W,12,2,3,0.667,1,2,0.5,1,1,1.0,2,2,4,5,1,1,1,0,6,27,1,PHI,PHI,WAS,146,,,15,10,11,9
Patrick Beverley,G,22023,201976,22300132,"NOV 04, 2023",PHI vs. PHX,W,12,0,1,0.0,0,1,0.0,0,0,0.0,1,3,4,1,0,0,0,1,0,-2,1,PHI,PHI,PHX,112,,,5,4,1,5
Patrick Beverley,G,22023,201976,22300128,"NOV 02, 2023",PHI vs. TOR,W,28,1,6,0.167,0,3,0.0,0,0,0.0,3,2,5,1,2,1,2,3,2,10,1,PHI,PHI,TOR,114,,,8,7,3,6
Patrick Beverley,G,22023,201976,22300098,"OCT 29, 2023",PHI vs. POR,W,20,2,3,0.667,0,0,0.0,0,0,0.0,1,1,2,2,1,3,1,3,4,8,1,PHI,PHI,POR,126,,,8,6,6,4
Patrick Beverley,G,22023,201976,22300644,"JAN 27, 2024",PHI @ DEN,L,37,6,12,0.5,1,3,0.333,4,4,1.0,0,4,4,11,0,2,4,3,17,-14,1,PHI,DEN,PHI,105,,,32,21,28,15
Patrick Beverley,G,22023,201976,22300627,"JAN 25, 2024",PHI @ IND,L,19,1,6,0.167,0,3,0.0,2,3,0.667,0,3,3,5,0,1,2,3,4,-15,1,PHI,IND,PHI,122,,,12,7,9,8
Patrick Beverley,G,22023,201976,22300585,"JAN 19, 2024",PHI @ ORL,W,28,2,7,0.286,1,3,0.333,0,0,0.0,1,5,6,4,1,2,1,1,5,7,1,PHI,ORL,PHI,124,,,15,11,9,10
Patrick Beverley,G,22023,201976,22300566,"JAN 16, 2024",PHI vs. DEN,W,27,3,7,0.429,2,3,0.667,0,0,0.0,0,2,2,2,2,0,0,2,8,4,1,PHI,PHI,DEN,126,,,12,10,10,4
Patrick Beverley,G,22023,201976,22300555,"JAN 15, 2024",PHI vs. HOU,W,29,3,8,0.375,1,4,0.25,4,6,0.667,0,5,5,6,1,1,3,2,11,15,1,PHI,PHI,HOU,124,,,22,16,17,11
Patrick Beverley,G,22023,201976,22300351,"DEC 18, 2023",PHI vs. CHI,L,19,2,6,0.333,0,2,0.0,0,0,0.0,0,3,3,1,0,0,1,1,4,-15,1,PHI,PHI,CHI,104,,,8,7,5,4
Patrick Beverley,G,22023,201976,22301208,"DEC 06, 2023",PHI @ WAS,W,21,2,7,0.286,1,5,0.2,0,0,0.0,0,4,4,4,1,0,2,0,5,-7,1,PHI,WAS,PHI,131,,,13,9,9,8
Patrick Beverley,G,22023,201976,22300239,"NOV 25, 2023",PHI @ OKC,W,21,2,5,0.4,1,3,0.333,1,2,0.5,2,2,4,4,0,0,0,1,6,-10,1,PHI,OKC,PHI,127,,,14,10,10,8
Patrick Beverley,G,22023,201976,22300040,"NOV 21, 2023",PHI vs. CLE,L,21,1,2,0.5,0,1,0.0,0,0,0.0,1,3,4,0,2,1,1,3,2,11,1,PHI,PHI,CLE,119,,,6,6,2,4
Patrick Beverley,G,22023,201976,22300180,"NOV 12, 2023",PHI vs. IND,W,17,1,4,0.25,1,4,0.25,0,0,0.0,1,1,2,1,1,0,0,3,3,3,1,PHI,PHI,IND,137,,,6,5,4,3
Patrick Beverley,G,22023,201976,22300008,"NOV 10, 2023",PHI @ DET,W,5,0,1,0.0,0,0,0.0,0,0,0.0,0,0,0,1,0,0,0,0,0,-8,1,PHI,DET,PHI,114,,,1,0,1,1
Patrick Beverley,G,22023,201976,22300159,"NOV 08, 2023",PHI vs. BOS,W,15,1,2,0.5,0,1,0.0,0,0,0.0,0,5,5,4,0,0,0,2,2,4,1,PHI,PHI,BOS,106,,,11,7,6,9
Patrick Beverley,G,22023,201976,22300673,"JAN 30, 2024",PHI @ GSW,L,28,4,12,0.333,2,4,0.5,2,2,1.0,2,3,5,2,2,1,1,4,12,-19,1,PHI,GSW,PHI,107,,,19,17,14,7
Patrick Beverley,G,22023,201976,22300029,"NOV 17, 2023",PHI @ ATL,W,14,0,1,0.0,0,1,0.0,2,2,1.0,0,2,2,1,0,0,0,3,2,16,1,PHI,ATL,PHI,126,,,5,4,3,3
Patrick Beverley,G,22023,201976,22300194,"NOV 15, 2023",PHI vs. BOS,L,10,0,4,0.0,0,2,0.0,0,2,0.0,0,1,1,1,0,0,0,1,0,-17,1,PHI,PHI,BOS,107,,,2,1,1,2
Patrick Beverley,G,22023,201976,22300019,"NOV 14, 2023",PHI vs. IND,L,28,1,3,0.333,0,2,0.0,0,0,0.0,0,5,5,2,0,0,0,5,2,-9,1,PHI,PHI,IND,126,,,9,7,4,7
Patrick Beverley,G,22023,201976,22300092,"OCT 28, 2023",PHI @ TOR,W,17,1,2,0.5,0,0,0.0,0,0,0.0,3,2,5,2,0,0,1,2,2,10,1,PHI,TOR,PHI,114,,,9,7,4,7
Patrick Beverley,G,22023,201976,22300075,"OCT 26, 2023",PHI @ MIL,L,14,1,1,1.0,0,0,0.0,0,0,0.0,0,2,2,2,0,0,0,2,2,6,1,PHI,MIL,PHI,117,,,6,4,4,4
Doug McDermott,F,22023,203926,22300681,"JAN 31, 2024",SAS vs. ORL,L,12,1,6,0.167,0,4,0.0,0,2,0.0,0,1,1,0,0,0,1,0,2,4,1,SAS,SAS,ORL,98,,,3,3,2,1
Doug McDermott,F,22023,203926,22300665,"JAN 29, 2024",SAS vs. WAS,L,10,2,4,0.5,2,4,0.5,0,0,0.0,1,0,1,1,0,0,0,2,6,-5,1,SAS,SAS,WAS,113,,,8,7,7,2
Doug McDermott,F,22023,203926,22300649,"JAN 27, 2024",SAS vs. MIN,W,17,3,5,0.6,3,5,0.6,0,0,0.0,0,1,1,1,0,0,0,0,9,11,1,SAS,SAS,MIN,113,,,11,10,10,2
Doug McDermott,F,22023,203926,22300584,"JAN 19, 2024",SAS @ CHA,L,9,0,2,0.0,0,1,0.0,0,0,0.0,0,0,0,2,1,0,1,0,0,7,1,SAS,CHA,SAS,120,,,2,0,2,2
Doug McDermott,F,22023,203926,22300571,"JAN 17, 2024",SAS @ BOS,L,12,1,4,0.25,0,2,0.0,0,0,0.0,0,0,0,1,0,0,0,1,2,-15,1,SAS,BOS,SAS,95,,,3,2,3,1
Doug McDermott,F,22023,203926,22300559,"JAN 15, 2024",SAS @ ATL,L,15,2,5,0.4,2,5,0.4,0,0,0.0,0,1,1,0,0,0,0,1,6,2,1,SAS,ATL,SAS,99,,,7,7,6,1
Doug McDermott,F,22023,203926,22300541,"JAN 12, 2024",SAS vs. CHA,W,12,4,6,0.667,4,6,0.667,2,3,0.667,0,2,2,0,0,0,0,0,14,13,1,SAS,SAS,CHA,127,,,16,16,14,2
Doug McDermott,F,22023,203926,22300519,"JAN 10, 2024",SAS @ DET,W,15,5,6,0.833,4,5,0.8,0,0,0.0,0,2,2,0,0,0,0,0,14,-3,1,SAS,DET,SAS,129,,,16,16,14,2
Doug McDermott,F,22023,203926,22300460,"JAN 02, 2024",SAS @ MEM,L,16,1,4,0.25,1,4,0.25,0,0,0.0,0,0,0,0,0,0,0,0,3,-9,1,SAS,MEM,SAS,98,,,3,3,3,0
Doug McDermott,F,22023,203926,22300448,"DEC 31, 2023",SAS vs. BOS,L,16,0,3,0.0,0,3,0.0,0,0,0.0,0,0,0,1,0,0,1,1,0,-10,1,SAS,SAS,BOS,101,,,1,0,1,1
Doug McDermott,F,22023,203926,22300437,"DEC 29, 2023",SAS @ POR,L,23,6,9,0.667,6,8,0.75,0,0,0.0,0,1,1,1,0,0,2,1,18,12,1,SAS,POR,SAS,128,,,20,19,19,2
Doug McDermott,F,22023,203926,22300361,"DEC 19, 2023",SAS @ MIL,L,13,0,2,0.0,0,1,0.0,0,0,0.0,0,2,2,2,0,0,0,3,0,0,1,SAS,MIL,SAS,119,,,4,2,2,4
Doug McDermott,F,22023,203926,22300235,"NOV 22, 2023",SAS vs. LAC,L,14,1,2,0.5,1,2,0.5,0,0,0.0,0,2,2,1,0,1,3,2,3,4,1,SAS,SAS,LAC,102,,,6,5,4,3
Doug McDermott,F,22023,203926,22300206,"NOV 18, 2023",SAS vs. MEM,L,16,2,5,0.4,1,3,0.333,0,0,0.0,0,0,0,2,1,0,0,3,5,-8,1,SAS,SAS,MEM,108,,,7,5,7,2
Doug McDermott,F,22023,203926,22300021,"NOV 14, 2023",SAS @ OKC,L,18,2,4,0.5,1,2,0.5,0,0,0.0,0,1,1,1,0,0,4,0,5,-18,1,SAS,OKC,SAS,87,,,7,6,6,2
Doug McDermott,F,22023,203926,22300161,"NOV 08, 2023",SAS @ NYK,L,22,4,9,0.444,3,8,0.375,0,0,0.0,1,2,3,1,0,0,3,3,11,-5,1,SAS,NYK,SAS,105,,,15,14,12,4
Doug McDermott,F,22023,203926,22300146,"NOV 06, 2023",SAS @ IND,L,20,5,9,0.556,4,6,0.667,3,4,0.75,0,1,1,4,0,0,0,1,17,-18,1,SAS,IND,SAS,111,,,22,18,21,5
Doug McDermott,F,22023,203926,22300099,"OCT 29, 2023",SAS @ LAC,L,15,3,6,0.5,2,4,0.5,0,0,0.0,0,3,3,2,0,0,0,3,8,-8,1,SAS,LAC,SAS,83,,,13,11,10,5
Doug McDermott,F,22023,203926,22300252,"NOV 26, 2023",SAS @ DEN,L,12,0,2,0.0,0,2,0.0,0,0,0.0,0,0,0,1,0,0,0,0,0,-12,1,SAS,DEN,SAS,120,,,1,0,1,1
Doug McDermott,F,22023,203926,22300051,"NOV 24, 2023",SAS @ GSW,L,19,3,6,0.5,1,3,0.333,0,0,0.0,1,0,1,4,3,0,0,0,7,-1,1,SAS,GSW,SAS,112,,,12,8,11,5
Doug McDermott,F,22023,203926,22300223,"NOV 20, 2023",SAS vs. LAC,L,14,1,3,0.333,1,3,0.333,0,0,0.0,0,2,2,2,0,0,0,1,3,-8,1,SAS,SAS,LAC,99,,,7,5,5,4
Doug McDermott,F,22023,203926,22300032,"NOV 17, 2023",SAS vs. SAC,L,16,2,4,0.5,1,2,0.5,1,2,0.5,0,0,0,3,0,0,0,1,6,16,1,SAS,SAS,SAC,120,,,9,6,9,3
Doug McDermott,F,22023,203926,22300184,"NOV 12, 2023",SAS vs. MIA,L,21,3,4,0.75,2,3,0.667,0,0,0.0,1,2,3,5,0,0,0,2,8,-3,1,SAS,SAS,MIA,113,,,16,11,13,8
Doug McDermott,F,22023,203926,22300013,"NOV 10, 2023",SAS vs. MIN,L,14,1,4,0.25,1,3,0.333,0,0,0.0,0,0,0,1,0,0,0,2,3,3,1,SAS,SAS,MIN,110,,,4,3,4,1
Doug McDermott,F,22023,203926,22300141,"NOV 05, 2023",SAS vs. TOR,L,24,4,8,0.5,4,8,0.5,0,0,0.0,0,1,1,2,0,0,2,2,12,0,1,SAS,SAS,TOR,116,,,15,13,14,3
Doug McDermott,F,22023,203926,22300131,"NOV 02, 2023",SAS @ PHX,W,16,2,4,0.5,2,3,0.667,0,0,0.0,0,0,0,0,1,0,0,0,6,-17,1,SAS,PHX,SAS,132,,,6,6,6,0
Doug McDermott,F,22023,203926,22300113,"OCT 31, 2023",SAS @ PHX,W,15,2,3,0.667,2,2,1.0,0,0,0.0,0,1,1,1,1,0,0,1,6,0,1,SAS,PHX,SAS,115,,,8,7,7,2
Doug McDermott,F,22023,203926,22300083,"OCT 27, 2023",SAS vs. HOU,W,16,3,5,0.6,2,4,0.5,0,0,0.0,0,0,0,0,0,0,0,0,8,-4,1,SAS,SAS,HOU,126,,,8,8,8,0
Doug McDermott,F,22023,203926,22300073,"OCT 25, 2023",SAS vs. DAL,L,11,0,1,0.0,0,1,0.0,0,0,0.0,0,1,1,1,0,1,0,1,0,-7,1,SAS,SAS,DAL,119,,,2,1,1,2
Doug McDermott,F,22023,203926,22300730,"FEB 07, 2024",SAS @ MIA,L,10,1,3,0.333,1,3,0.333,0,0,0.0,0,1,1,0,0,0,0,1,3,-1,1,SAS,MIA,SAS,104,,,4,4,3,1
Doug McDermott,F,22023,203926,22300703,"FEB 03, 2024",SAS vs. CLE,L,20,3,5,0.6,2,3,0.667,0,0,0.0,0,0,0,3,1,0,0,3,8,-7,1,SAS,SAS,CLE,101,,,11,8,11,3
Doug McDermott,F,22023,203926,22300696,"FEB 02, 2024",SAS vs. NOP,L,12,2,5,0.4,2,5,0.4,0,0,0.0,0,2,2,0,0,0,0,0,6,-8,1,SAS,SAS,NOP,113,,,8,8,6,2
Doug McDermott,F,22023,203926,22300622,"JAN 24, 2024",SAS vs. OKC,L,17,3,6,0.5,2,4,0.5,0,0,0.0,0,1,1,3,0,0,3,1,8,-3,1,SAS,SAS,OKC,114,,,12,9,11,4
Doug McDermott,F,22023,203926,22300594,"JAN 20, 2024",SAS @ WAS,W,10,1,2,0.5,1,2,0.5,0,0,0.0,0,0,0,1,0,0,0,2,3,-17,1,SAS,WAS,SAS,131,,,4,3,4,1
Doug McDermott,F,22023,203926,22300427,"DEC 28, 2023",SAS @ POR,W,16,3,4,0.75,2,3,0.667,0,0,0.0,0,1,1,1,0,0,0,0,8,-3,1,SAS,POR,SAS,118,,,10,9,9,2
Doug McDermott,F,22023,203926,22300412,"DEC 26, 2023",SAS vs. UTA,L,11,0,2,0.0,0,2,0.0,0,0,0.0,0,0,0,0,0,0,0,0,0,-10,1,SAS,SAS,UTA,118,,,0,0,0,0
Doug McDermott,F,22023,203926,22300398,"DEC 23, 2023",SAS @ DAL,L,6,0,0,0.0,0,0,0.0,0,2,0.0,0,0,0,0,0,0,0,0,0,4,1,SAS,DAL,SAS,119,,,0,0,0,0
Doug McDermott,F,22023,203926,22300376,"DEC 21, 2023",SAS @ CHI,L,12,1,4,0.25,1,4,0.25,0,0,0.0,0,0,0,1,1,0,0,3,3,-11,1,SAS,CHI,SAS,95,,,4,3,4,1
Doug McDermott,F,22023,203926,22300345,"DEC 17, 2023",SAS vs. NOP,L,15,2,7,0.286,1,5,0.2,2,2,1.0,1,1,2,1,0,0,0,1,7,-26,1,SAS,SAS,NOP,110,,,10,9,8,3
Doug McDermott,F,22023,203926,22300331,"DEC 15, 2023",SAS vs. LAL,W,17,2,4,0.5,2,4,0.5,0,0,0.0,0,1,1,0,0,0,1,1,6,-2,1,SAS,SAS,LAL,129,,,7,7,6,1
Doug McDermott,F,22023,203926,22300316,"DEC 13, 2023",SAS vs. LAL,L,15,1,5,0.2,1,3,0.333,0,0,0.0,0,1,1,1,1,0,0,0,3,-9,1,SAS,SAS,LAL,119,,,5,4,4,2
Doug McDermott,F,22023,203926,22300298,"DEC 11, 2023",SAS @ HOU,L,15,2,5,0.4,2,5,0.4,0,0,0.0,0,0,0,1,1,0,0,0,6,-2,1,SAS,HOU,SAS,82,,,7,6,7,1
Doug McDermott,F,22023,203926,22301223,"DEC 08, 2023",SAS vs. CHI,L,15,3,6,0.5,3,4,0.75,0,0,0.0,0,1,1,1,0,0,1,2,9,10,1,SAS,SAS,CHI,112,,,11,10,10,2
Doug McDermott,F,22023,203926,22301210,"DEC 06, 2023",SAS @ MIN,L,22,3,8,0.375,3,8,0.375,2,2,1.0,0,3,3,2,0,0,0,1,11,2,1,SAS,MIN,SAS,94,,,16,14,13,5
Doug McDermott,F,22023,203926,22300641,"JAN 26, 2024",SAS vs. POR,W,14,0,2,0.0,0,2,0.0,0,0,0.0,0,0,0,2,0,0,0,1,0,13,1,SAS,SAS,POR,116,,,2,0,2,2
Doug McDermott,F,22023,203926,22300608,"JAN 22, 2024",SAS @ PHI,L,22,5,12,0.417,3,9,0.333,0,0,0.0,3,2,5,0,0,0,2,1,13,-7,1,SAS,PHI,SAS,123,,,18,18,13,5
Doug McDermott,F,22023,203926,22300755,"FEB 10, 2024",IND @ NYK,W,7,0,1,0.0,0,1,0.0,0,0,0.0,0,0,0,0,0,0,0,1,0,-1,1,IND,NYK,IND,125,,,0,0,0,0
James Wiseman,C,22023,1630164,22300453,"JAN 01, 2024",DET @ HOU,L,16,1,1,1.0,0,0,0.0,2,2,1.0,1,3,4,0,0,1,1,5,4,-24,1,DET,HOU,DET,113,,,8,8,4,4
James Wiseman,C,22023,1630164,22300374,"DEC 21, 2023",DET vs. UTA,L,15,1,2,0.5,0,0,0.0,0,0,0.0,2,3,5,0,0,1,2,1,2,-16,1,DET,DET,UTA,111,,,7,7,2,5
James Wiseman,C,22023,1630164,22300352,"DEC 18, 2023",DET @ ATL,L,25,5,5,1.0,0,0,0.0,0,2,0.0,2,5,7,2,0,0,2,2,10,4,1,DET,ATL,DET,124,,,19,17,12,9
James Wiseman,C,22023,1630164,22300334,"DEC 16, 2023",DET @ MIL,L,26,7,9,0.778,0,0,0.0,3,3,1.0,3,3,6,5,1,0,0,4,17,-15,1,DET,MIL,DET,114,,,28,23,22,11
James Wiseman,C,22023,1630164,22301217,"DEC 08, 2023",DET @ ORL,L,16,0,0,0.0,0,0,0.0,2,4,0.5,2,3,5,0,0,0,1,2,2,-6,1,DET,ORL,DET,91,,,7,7,2,5
James Wiseman,C,22023,1630164,22300258,"NOV 29, 2023",DET vs. LAL,L,12,2,2,1.0,0,0,0.0,0,0,0.0,1,4,5,0,0,0,1,2,4,0,1,DET,DET,LAL,107,,,9,9,4,5
James Wiseman,C,22023,1630164,22300218,"NOV 20, 2023",DET vs. DEN,L,10,0,1,0.0,0,0,0.0,0,0,0.0,1,2,3,0,0,0,1,2,0,-10,1,DET,DET,DEN,103,,,3,3,0,3
James Wiseman,C,22023,1630164,22300211,"NOV 19, 2023",DET @ TOR,L,24,6,8,0.75,0,0,0.0,3,5,0.6,0,3,3,1,0,1,2,4,15,0,1,DET,TOR,DET,113,,,19,18,16,4
James Wiseman,C,22023,1630164,22300030,"NOV 17, 2023",DET @ CLE,L,4,0,0,0.0,0,0,0.0,0,0,0.0,0,2,2,0,0,0,0,0,0,8,1,DET,CLE,DET,100,,,2,2,0,2
James Wiseman,C,22023,1630164,22300018,"NOV 14, 2023",DET vs. ATL,L,14,5,6,0.833,0,0,0.0,1,2,0.5,1,3,4,1,0,0,0,2,11,-9,1,DET,DET,ATL,120,,,16,15,12,5
James Wiseman,C,22023,1630164,22300181,"NOV 12, 2023",DET @ CHI,L,14,3,6,0.5,0,1,0.0,0,0,0.0,1,1,2,0,1,2,2,3,6,5,1,DET,CHI,DET,108,,,8,8,6,2
James Wiseman,C,22023,1630164,22300008,"NOV 10, 2023",DET vs. PHI,L,7,3,3,1.0,0,0,0.0,0,0,0.0,3,1,4,0,0,0,0,1,6,0,1,DET,DET,PHI,106,,,10,10,6,4
James Wiseman,C,22023,1630164,22300145,"NOV 06, 2023",DET vs. GSW,L,11,0,3,0.0,0,0,0.0,0,0,0.0,0,3,3,0,0,0,0,0,0,-6,1,DET,DET,GSW,109,,,3,3,0,3
James Wiseman,C,22023,1630164,22300115,"NOV 01, 2023",DET vs. POR,L,6,2,4,0.5,0,0,0.0,0,0,0.0,0,2,2,1,0,0,1,4,4,-15,1,DET,DET,POR,101,,,7,6,5,3
James Wiseman,C,22023,1630164,22300704,"FEB 04, 2024",DET vs. ORL,L,5,0,1,0.0,0,0,0.0,0,0,0.0,0,0,0,0,0,0,1,1,0,0,1,DET,DET,ORL,99,,,0,0,0,0
James Wiseman,C,22023,1630164,22300688,"FEB 02, 2024",DET vs. LAC,L,2,1,1,1.0,0,0,0.0,1,1,1.0,0,1,1,0,0,0,0,0,3,7,1,DET,DET,LAC,125,,,4,4,3,1
James Wiseman,C,22023,1630164,22300592,"JAN 20, 2024",DET vs. MIL,L,5,0,1,0.0,0,0,0.0,0,0,0.0,0,1,1,0,0,0,0,0,0,0,1,DET,DET,MIL,135,,,1,1,0,1
James Wiseman,C,22023,1630164,22300519,"JAN 10, 2024",DET vs. SAS,L,17,1,1,1.0,0,0,0.0,1,2,0.5,0,3,3,3,0,0,0,2,3,-15,1,DET,DET,SAS,108,,,9,6,6,6
James Wiseman,C,22023,1630164,22300512,"JAN 09, 2024",DET vs. SAC,L,24,2,3,0.667,0,0,0.0,0,0,0.0,1,4,5,1,0,1,1,2,4,1,1,DET,DET,SAC,110,,,10,9,5,6
James Wiseman,C,22023,1630164,22300502,"JAN 07, 2024",DET @ DEN,L,18,4,7,0.571,0,0,0.0,1,3,0.333,2,1,3,0,0,0,0,1,9,-3,1,DET,DEN,DET,114,,,12,12,9,3
James Wiseman,C,22023,1630164,22300490,"JAN 05, 2024",DET @ GSW,L,15,1,5,0.2,0,1,0.0,2,3,0.667,1,2,3,0,0,2,0,2,4,1,1,DET,GSW,DET,109,,,7,7,4,3
James Wiseman,C,22023,1630164,22300474,"JAN 03, 2024",DET @ UTA,L,17,4,7,0.571,0,0,0.0,0,0,0.0,5,4,9,0,0,0,3,1,8,11,1,DET,UTA,DET,148,,,17,17,8,9
James Wiseman,C,22023,1630164,22300440,"DEC 30, 2023",DET vs. TOR,W,13,4,4,1.0,0,0,0.0,0,0,0.0,0,4,4,0,0,3,0,1,8,4,1,DET,DET,TOR,129,,,12,12,8,4
James Wiseman,C,22023,1630164,22300421,"DEC 28, 2023",DET @ BOS,L,13,3,3,1.0,0,0,0.0,0,0,0.0,2,3,5,1,0,0,1,0,6,0,1,DET,BOS,DET,122,,,12,11,7,6
James Wiseman,C,22023,1630164,22300406,"DEC 26, 2023",DET vs. BKN,L,12,0,2,0.0,0,0,0.0,0,0,0.0,2,0,2,0,0,0,1,2,0,-12,1,DET,DET,BKN,112,,,2,2,0,2
James Wiseman,C,22023,1630164,22300327,"DEC 15, 2023",DET @ PHI,L,28,9,12,0.75,0,0,0.0,2,2,1.0,3,10,13,1,0,1,2,2,20,-5,1,DET,PHI,DET,92,,,34,33,21,14
James Wiseman,C,22023,1630164,22300310,"DEC 13, 2023",DET vs. PHI,L,16,5,7,0.714,0,0,0.0,0,0,0.0,0,3,3,0,1,1,1,6,10,-21,1,DET,DET,PHI,111,,,13,13,10,3
James Wiseman,C,22023,1630164,22300293,"DEC 11, 2023",DET vs. IND,L,13,1,1,1.0,0,0,0.0,2,2,1.0,2,2,4,1,1,3,1,3,4,4,1,DET,DET,IND,123,,,9,8,5,5
James Wiseman,C,22023,1630164,22301206,"DEC 06, 2023",DET vs. MEM,L,8,2,3,0.667,0,0,0.0,0,0,0.0,1,0,1,1,0,2,1,2,4,-8,1,DET,DET,MEM,102,,,6,5,5,2
James Wiseman,C,22023,1630164,22300749,"FEB 10, 2024",DET @ LAC,L,13,2,4,0.5,0,0,0.0,0,0,0.0,2,1,3,1,0,0,1,0,4,1,1,DET,LAC,DET,106,,,8,7,5,4
James Wiseman,C,22023,1630164,22300558,"JAN 15, 2024",DET @ WAS,W,15,3,4,0.75,0,0,0.0,0,0,0.0,2,3,5,0,0,2,0,1,6,1,1,DET,WAS,DET,129,,,11,11,6,5
James Wiseman,C,22023,1630164,22300253,"NOV 27, 2023",DET vs. WAS,L,9,3,4,0.75,0,0,0.0,2,4,0.5,3,1,4,0,0,0,1,0,8,-12,1,DET,DET,WAS,107,,,12,12,8,4
James Wiseman,C,22023,1630164,22300741,"FEB 08, 2024",DET @ POR,W,16,3,3,1.0,0,0,0.0,1,2,0.5,4,1,5,1,0,1,0,4,7,2,1,DET,POR,DET,128,,,13,12,8,6
Xavier Tillman,C,22023,1630214,22300663,"JAN 29, 2024",MEM vs. SAC,L,37,5,8,0.625,0,1,0.0,0,0,0.0,2,3,5,3,3,0,0,4,10,-8,1,MEM,MEM,SAC,72,,,18,15,13,8
Xavier Tillman,C,22023,1630214,22300652,"JAN 28, 2024",MEM @ IND,L,17,0,3,0.0,0,0,0.0,3,6,0.5,3,1,4,1,1,2,0,2,3,-17,1,MEM,IND,MEM,106,,,8,7,4,5
Xavier Tillman,C,22023,1630214,22300638,"JAN 26, 2024",MEM vs. ORL,W,13,2,7,0.286,0,1,0.0,1,2,0.5,0,2,2,0,1,2,0,2,5,-4,1,MEM,MEM,ORL,107,,,7,7,5,2
Xavier Tillman,C,22023,1630214,22300609,"JAN 22, 2024",MEM @ TOR,W,16,1,6,0.167,0,1,0.0,0,0,0.0,1,3,4,2,1,0,1,2,2,8,1,MEM,TOR,MEM,108,,,8,6,4,6
Xavier Tillman,C,22023,1630214,22300582,"JAN 18, 2024",MEM @ MIN,L,36,5,11,0.455,0,2,0.0,0,0,0.0,2,3,5,6,1,1,2,1,10,-2,1,MEM,MIN,MEM,103,,,21,15,16,11
Xavier Tillman,C,22023,1630214,22300560,"JAN 15, 2024",MEM vs. GSW,W,30,1,6,0.167,0,2,0.0,0,0,0.0,1,3,4,3,1,2,0,0,2,13,1,MEM,MEM,GSW,116,,,9,6,5,7
Xavier Tillman,C,22023,1630214,22300503,"JAN 07, 2024",MEM @ PHX,W,3,0,3,0.0,0,1,0.0,0,0,0.0,3,0,3,0,0,0,0,1,0,-7,1,MEM,PHX,MEM,121,,,3,3,0,3
Xavier Tillman,C,22023,1630214,22300491,"JAN 05, 2024",MEM @ LAL,W,12,0,1,0.0,0,0,0.0,1,2,0.5,1,4,5,1,2,0,1,3,1,6,1,MEM,LAL,MEM,127,,,7,6,2,6
Xavier Tillman,C,22023,1630214,22300470,"JAN 03, 2024",MEM vs. TOR,L,23,2,3,0.667,0,0,0.0,0,0,0.0,2,3,5,2,0,0,0,3,4,-15,1,MEM,MEM,TOR,111,,,11,9,6,7
Xavier Tillman,C,22023,1630214,22300460,"JAN 02, 2024",MEM vs. SAS,W,0,0,0,0.0,0,0,0.0,0,0,0.0,0,0,0,0,0,0,0,0,0,-4,1,MEM,MEM,SAS,106,,,0,0,0,0
Xavier Tillman,C,22023,1630214,22300449,"DEC 31, 2023",MEM vs. SAC,L,8,1,4,0.25,0,2,0.0,0,0,0.0,1,1,2,0,0,0,0,0,2,-9,1,MEM,MEM,SAC,92,,,4,4,2,2
Xavier Tillman,C,22023,1630214,22300438,"DEC 29, 2023",MEM @ LAC,L,17,1,5,0.2,0,1,0.0,0,0,0.0,2,2,4,0,1,1,1,3,2,-14,1,MEM,LAC,MEM,106,,,6,6,2,4
Xavier Tillman,C,22023,1630214,22300410,"DEC 26, 2023",MEM @ NOP,W,28,1,3,0.333,0,1,0.0,0,0,0.0,3,5,8,0,1,5,0,1,2,2,1,MEM,NOP,MEM,116,,,10,10,2,8
Xavier Tillman,C,22023,1630214,22300393,"DEC 23, 2023",MEM @ ATL,W,16,3,7,0.429,0,0,0.0,0,0,0.0,2,1,3,0,1,2,0,0,6,4,1,MEM,ATL,MEM,125,,,9,9,6,3
Xavier Tillman,C,22023,1630214,22300377,"DEC 21, 2023",MEM vs. IND,W,21,2,3,0.667,0,0,0.0,1,4,0.25,3,2,5,2,0,1,1,2,5,10,1,MEM,MEM,IND,116,,,12,10,7,7
Xavier Tillman,C,22023,1630214,22300360,"DEC 19, 2023",MEM @ NOP,W,20,3,5,0.6,1,1,1.0,0,0,0.0,2,4,6,1,1,0,1,3,7,3,1,MEM,NOP,MEM,115,,,14,13,8,7
Xavier Tillman,C,22023,1630214,22300355,"DEC 18, 2023",MEM @ OKC,L,25,0,8,0.0,0,3,0.0,0,0,0.0,0,8,8,2,1,1,1,1,0,-15,1,MEM,OKC,MEM,97,,,10,8,2,10
Xavier Tillman,C,22023,1630214,22300299,"DEC 11, 2023",MEM vs. DAL,L,7,0,1,0.0,0,0,0.0,0,2,0.0,0,0,0,0,1,0,0,0,0,-9,1,MEM,MEM,DAL,113,,,0,0,0,0
Xavier Tillman,C,22023,1630214,22301221,"DEC 08, 2023",MEM vs. MIN,L,17,5,8,0.625,1,2,0.5,1,3,0.333,2,0,2,0,4,0,0,1,12,-9,1,MEM,MEM,MIN,95,,,14,14,12,2
Xavier Tillman,C,22023,1630214,22301206,"DEC 06, 2023",MEM @ DET,W,7,1,4,0.25,0,0,0.0,0,0,0.0,1,0,1,1,0,0,0,0,2,-1,1,MEM,DET,MEM,104,,,4,3,3,2
Xavier Tillman,C,22023,1630214,22300288,"DEC 02, 2023",MEM @ PHX,L,12,1,4,0.25,0,2,0.0,0,0,0.0,0,0,0,0,0,1,1,0,2,0,1,MEM,PHX,MEM,101,,,2,2,2,0
Xavier Tillman,C,22023,1630214,22300277,"DEC 01, 2023",MEM @ DAL,W,22,2,6,0.333,0,3,0.0,0,0,0.0,0,2,2,2,2,2,0,0,4,9,1,MEM,DAL,MEM,89,,,8,6,6,4
Xavier Tillman,C,22023,1630214,22300026,"NOV 14, 2023",MEM @ LAL,L,22,6,7,0.857,3,3,1.0,0,0,0.0,1,1,2,2,1,0,1,1,15,-4,1,MEM,LAL,MEM,107,,,19,17,17,4
Xavier Tillman,C,22023,1630214,22300537,"JAN 12, 2024",MEM vs. LAC,L,31,8,10,0.8,1,2,0.5,3,7,0.429,4,5,9,2,1,2,2,1,20,-5,1,MEM,MEM,LAC,119,,,31,29,22,11
Xavier Tillman,C,22023,1630214,22300515,"JAN 09, 2024",MEM @ DAL,W,28,6,9,0.667,0,1,0.0,2,4,0.5,6,5,11,2,0,2,3,3,14,17,1,MEM,DAL,MEM,120,,,27,25,16,13
Xavier Tillman,C,22023,1630214,22300425,"DEC 28, 2023",MEM @ DEN,L,22,2,7,0.286,1,4,0.25,1,2,0.5,0,3,3,4,1,1,2,0,6,-18,1,MEM,DEN,MEM,105,,,13,9,10,7
Xavier Tillman,C,22023,1630214,22300007,"NOV 03, 2023",MEM @ POR,L,24,3,8,0.375,0,2,0.0,0,0,0.0,1,6,7,5,1,2,1,5,6,-11,1,MEM,POR,MEM,113,,,18,13,11,12
Xavier Tillman,C,22023,1630214,22300125,"NOV 01, 2023",MEM @ UTA,L,14,0,3,0.0,0,0,0.0,0,0,0.0,3,1,4,0,1,0,2,3,0,-7,1,MEM,UTA,MEM,109,,,4,4,0,4
Xavier Tillman,C,22023,1630214,22300106,"OCT 30, 2023",MEM vs. DAL,L,29,3,14,0.214,0,5,0.0,0,3,0.0,2,5,7,1,2,1,0,0,6,4,1,MEM,MEM,DAL,110,,,14,13,7,8
Xavier Tillman,C,22023,1630214,22300089,"OCT 28, 2023",MEM @ WAS,L,24,3,7,0.429,2,2,1.0,0,0,0.0,1,6,7,3,0,0,1,4,8,-14,1,MEM,WAS,MEM,106,,,18,15,11,10
Xavier Tillman,C,22023,1630214,22300078,"OCT 27, 2023",MEM vs. DEN,L,34,5,9,0.556,1,3,0.333,2,4,0.5,2,6,8,2,3,2,5,5,13,-5,1,MEM,MEM,DEN,104,,,23,21,15,10
Xavier Tillman,C,22023,1630214,22300071,"OCT 25, 2023",MEM vs. NOP,L,34,7,16,0.438,1,5,0.2,2,2,1.0,4,8,12,4,3,1,0,2,17,3,1,MEM,MEM,NOP,104,,,33,29,21,16
Xavier Tillman,C,22023,1630214,22300621,"JAN 24, 2024",MEM @ MIA,W,18,2,2,1.0,1,1,1.0,1,2,0.5,1,3,4,1,1,3,1,3,6,4,1,MEM,MIA,MEM,90,,,11,10,7,5
Xavier Tillman,C,22023,1630214,22300544,"JAN 13, 2024",MEM vs. NYK,L,36,6,15,0.4,0,2,0.0,0,0,0.0,0,5,5,5,6,1,2,4,12,-6,1,MEM,MEM,NYK,94,,,22,17,17,10
Julian Champagnie,F,22023,1630577,22300750,"FEB 10, 2024",SAS @ BKN,L,20,1,5,0.2,0,3,0.0,0,0,0.0,1,2,3,1,0,0,0,2,2,-9,1,SAS,BKN,SAS,103,,,6,5,3,4
Julian Champagnie,F,22023,1630577,22300681,"JAN 31, 2024",SAS vs. ORL,L,20,0,4,0.0,0,2,0.0,0,0,0.0,0,1,1,1,2,0,1,1,0,-15,1,SAS,SAS,ORL,98,,,2,1,1,2
Julian Champagnie,F,22023,1630577,22300665,"JAN 29, 2024",SAS vs. WAS,L,20,1,2,0.5,1,1,1.0,0,1,0.0,0,1,1,1,0,2,1,0,3,2,1,SAS,SAS,WAS,113,,,5,4,4,2
Julian Champagnie,F,22023,1630577,22300649,"JAN 27, 2024",SAS vs. MIN,W,18,1,4,0.25,1,3,0.333,1,2,0.5,2,1,3,0,0,0,0,1,4,1,1,SAS,SAS,MIN,113,,,7,7,4,3
Julian Champagnie,F,22023,1630577,22300584,"JAN 19, 2024",SAS @ CHA,L,19,4,7,0.571,1,4,0.25,0,0,0.0,1,1,2,3,1,1,0,0,9,-18,1,SAS,CHA,SAS,120,,,14,11,12,5
Julian Champagnie,F,22023,1630577,22300571,"JAN 17, 2024",SAS @ BOS,L,18,4,8,0.5,1,2,0.5,0,0,0.0,1,4,5,0,0,0,1,1,9,2,1,SAS,BOS,SAS,95,,,14,14,9,5
Julian Champagnie,F,22023,1630577,22300559,"JAN 15, 2024",SAS @ ATL,L,20,5,8,0.625,5,8,0.625,0,0,0.0,0,1,1,1,1,0,0,1,15,5,1,SAS,ATL,SAS,99,,,17,16,16,2
Julian Champagnie,F,22023,1630577,22300548,"JAN 13, 2024",SAS vs. CHI,L,17,1,5,0.2,1,3,0.333,3,3,1.0,0,5,5,4,0,0,1,1,6,-4,1,SAS,SAS,CHI,116,,,15,11,10,9
Julian Champagnie,F,22023,1630577,22300541,"JAN 12, 2024",SAS vs. CHA,W,21,2,8,0.25,2,7,0.286,3,3,1.0,0,2,2,1,0,0,1,2,9,15,1,SAS,SAS,CHA,127,,,12,11,10,3
Julian Champagnie,F,22023,1630577,22300519,"JAN 10, 2024",SAS @ DET,W,21,1,3,0.333,0,2,0.0,0,0,0.0,1,3,4,1,2,0,0,2,2,9,1,SAS,DET,SAS,129,,,7,6,3,5
Julian Champagnie,F,22023,1630577,22300497,"JAN 07, 2024",SAS @ CLE,L,16,0,2,0.0,0,2,0.0,2,2,1.0,0,2,2,1,1,0,1,0,2,9,1,SAS,CLE,SAS,115,,,5,4,3,3
Julian Champagnie,F,22023,1630577,22300477,"JAN 04, 2024",SAS vs. MIL,L,21,0,4,0.0,0,2,0.0,0,0,0.0,0,0,0,2,1,0,0,0,0,-3,1,SAS,SAS,MIL,121,,,2,0,2,2
Julian Champagnie,F,22023,1630577,22300460,"JAN 02, 2024",SAS @ MEM,L,22,3,6,0.5,3,6,0.5,3,3,1.0,0,4,4,2,1,0,1,4,12,12,1,SAS,MEM,SAS,98,,,18,16,14,6
Julian Champagnie,F,22023,1630577,22300448,"DEC 31, 2023",SAS vs. BOS,L,19,0,2,0.0,0,2,0.0,0,0,0.0,0,2,2,2,0,0,1,2,0,-26,1,SAS,SAS,BOS,101,,,4,2,2,4
Julian Champagnie,F,22023,1630577,22300437,"DEC 29, 2023",SAS @ POR,L,12,1,5,0.2,1,4,0.25,4,5,0.8,2,1,3,0,1,1,1,1,7,-8,1,SAS,POR,SAS,128,,,10,10,7,3
Julian Champagnie,F,22023,1630577,22300361,"DEC 19, 2023",SAS @ MIL,L,2,1,1,1.0,0,0,0.0,0,0,0.0,0,0,0,0,0,0,0,0,2,2,1,SAS,MIL,SAS,119,,,2,2,2,0
Julian Champagnie,F,22023,1630577,22300278,"DEC 01, 2023",SAS @ NOP,L,22,4,7,0.571,3,6,0.5,1,1,1.0,1,4,5,3,0,0,3,3,12,-7,1,SAS,NOP,SAS,106,,,20,17,15,8
Julian Champagnie,F,22023,1630577,22300206,"NOV 18, 2023",SAS vs. MEM,L,20,2,6,0.333,2,6,0.333,0,0,0.0,0,2,2,2,0,0,1,0,6,6,1,SAS,SAS,MEM,108,,,10,8,8,4
Julian Champagnie,F,22023,1630577,22300021,"NOV 14, 2023",SAS @ OKC,L,31,4,14,0.286,3,7,0.429,2,2,1.0,1,2,3,3,4,3,2,0,13,-21,1,SAS,OKC,SAS,87,,,19,16,16,6
Julian Champagnie,F,22023,1630577,22300161,"NOV 08, 2023",SAS @ NYK,L,3,0,2,0.0,0,2,0.0,0,0,0.0,0,0,0,0,0,0,0,0,0,0,1,SAS,NYK,SAS,105,,,0,0,0,0
Julian Champagnie,F,22023,1630577,22300146,"NOV 06, 2023",SAS @ IND,L,17,2,8,0.25,0,3,0.0,0,0,0.0,0,2,2,0,0,2,1,0,4,-15,1,SAS,IND,SAS,111,,,6,6,4,2
Julian Champagnie,F,22023,1630577,22300099,"OCT 29, 2023",SAS @ LAC,L,7,1,4,0.25,1,2,0.5,0,0,0.0,0,2,2,0,0,1,1,0,3,-13,1,SAS,LAC,SAS,83,,,5,5,3,2
Julian Champagnie,F,22023,1630577,22300272,"NOV 30, 2023",SAS vs. ATL,L,20,5,8,0.625,5,8,0.625,0,0,0.0,1,2,3,0,0,0,1,2,15,-6,1,SAS,SAS,ATL,135,,,18,18,15,3
Julian Champagnie,F,22023,1630577,22300252,"NOV 26, 2023",SAS @ DEN,L,17,4,8,0.5,3,6,0.5,2,4,0.5,0,1,1,1,0,1,0,1,13,2,1,SAS,DEN,SAS,120,,,15,14,14,2
Julian Champagnie,F,22023,1630577,22300223,"NOV 20, 2023",SAS vs. LAC,L,23,2,7,0.286,1,5,0.2,0,0,0.0,1,3,4,1,1,1,1,2,5,-11,1,SAS,SAS,LAC,99,,,10,9,6,5
Julian Champagnie,F,22023,1630577,22300032,"NOV 17, 2023",SAS vs. SAC,L,25,2,5,0.4,2,4,0.5,3,4,0.75,1,1,2,3,0,1,2,3,9,-9,1,SAS,SAS,SAC,120,,,14,11,12,5
Julian Champagnie,F,22023,1630577,22300141,"NOV 05, 2023",SAS vs. TOR,L,7,1,3,0.333,0,2,0.0,0,0,0.0,0,0,0,0,1,0,1,0,2,-1,1,SAS,SAS,TOR,116,,,2,2,2,0
Julian Champagnie,F,22023,1630577,22300113,"OCT 31, 2023",SAS @ PHX,W,3,0,1,0.0,0,1,0.0,0,0,0.0,0,0,0,0,0,0,0,0,0,-1,1,SAS,PHX,SAS,115,,,0,0,0,0
Julian Champagnie,F,22023,1630577,22300734,"FEB 08, 2024",SAS @ ORL,L,21,2,4,0.5,1,3,0.333,3,3,1.0,1,4,5,2,0,0,0,0,8,-12,1,SAS,ORL,SAS,111,,,15,13,10,7
Julian Champagnie,F,22023,1630577,22300730,"FEB 07, 2024",SAS @ MIA,L,19,2,7,0.286,2,5,0.4,0,0,0.0,3,2,5,3,2,0,0,2,6,7,1,SAS,MIA,SAS,104,,,14,11,9,8
Julian Champagnie,F,22023,1630577,22300703,"FEB 03, 2024",SAS vs. CLE,L,23,3,6,0.5,1,3,0.333,1,2,0.5,1,4,5,1,0,2,1,1,8,10,1,SAS,SAS,CLE,101,,,14,13,9,6
Julian Champagnie,F,22023,1630577,22300696,"FEB 02, 2024",SAS vs. NOP,L,30,2,6,0.333,0,4,0.0,1,2,0.5,3,3,6,3,0,3,0,2,5,-3,1,SAS,SAS,NOP,113,,,14,11,8,9
Julian Champagnie,F,22023,1630577,22300622,"JAN 24, 2024",SAS vs. OKC,L,21,1,5,0.2,1,5,0.2,0,0,0.0,0,2,2,1,2,0,2,1,3,3,1,SAS,SAS,OKC,114,,,6,5,4,3
Julian Champagnie,F,22023,1630577,22300594,"JAN 20, 2024",SAS @ WAS,W,23,4,7,0.571,3,6,0.5,0,0,0.0,2,5,7,0,0,2,2,2,11,-10,1,SAS,WAS,SAS,131,,,18,18,11,7
Julian Champagnie,F,22023,1630577,22300427,"DEC 28, 2023",SAS @ POR,W,14,0,1,0.0,0,1,0.0,2,2,1.0,0,1,1,0,2,1,1,0,2,8,1,SAS,POR,SAS,118,,,3,3,2,1
Julian Champagnie,F,22023,1630577,22300412,"DEC 26, 2023",SAS vs. UTA,L,25,6,9,0.667,4,6,0.667,0,0,0.0,1,4,5,1,2,1,0,5,16,4,1,SAS,SAS,UTA,118,,,22,21,17,6
Julian Champagnie,F,22023,1630577,22300398,"DEC 23, 2023",SAS @ DAL,L,21,4,6,0.667,2,4,0.5,2,2,1.0,0,5,5,1,1,0,0,0,12,-7,1,SAS,DAL,SAS,119,,,18,17,13,6
Julian Champagnie,F,22023,1630577,22300376,"DEC 21, 2023",SAS @ CHI,L,11,1,1,1.0,1,1,1.0,0,0,0.0,0,1,1,0,0,1,1,1,3,-7,1,SAS,CHI,SAS,95,,,4,4,3,1
Julian Champagnie,F,22023,1630577,22300345,"DEC 17, 2023",SAS vs. NOP,L,14,5,6,0.833,5,6,0.833,0,0,0.0,1,0,1,1,0,2,0,0,15,-12,1,SAS,SAS,NOP,110,,,17,16,16,2
Julian Champagnie,F,22023,1630577,22300331,"DEC 15, 2023",SAS vs. LAL,W,9,0,2,0.0,0,2,0.0,0,0,0.0,0,0,0,0,0,0,0,1,0,-8,1,SAS,SAS,LAL,129,,,0,0,0,0
Julian Champagnie,F,22023,1630577,22300316,"DEC 13, 2023",SAS vs. LAL,L,6,0,2,0.0,0,2,0.0,0,0,0.0,0,1,1,1,1,0,0,0,0,-2,1,SAS,SAS,LAL,119,,,2,1,1,2
Julian Champagnie,F,22023,1630577,22300298,"DEC 11, 2023",SAS @ HOU,L,8,0,1,0.0,0,1,0.0,0,0,0.0,0,1,1,0,0,0,0,1,0,-2,1,SAS,HOU,SAS,82,,,1,1,0,1
Julian Champagnie,F,22023,1630577,22301223,"DEC 08, 2023",SAS vs. CHI,L,6,0,0,0.0,0,0,0.0,0,0,0.0,0,0,0,0,0,1,0,3,0,-12,1,SAS,SAS,CHI,112,,,0,0,0,0
Julian Champagnie,F,22023,1630577,22301210,"DEC 06, 2023",SAS @ MIN,L,4,0,1,0.0,0,1,0.0,0,0,0.0,0,1,1,0,0,0,0,0,0,-1,1,SAS,MIN,SAS,94,,,1,1,0,1
Julian Champagnie,F,22023,1630577,22300641,"JAN 26, 2024",SAS vs. POR,W,19,2,4,0.5,0,2,0.0,1,1,1.0,0,4,4,3,1,0,1,0,5,6,1,SAS,SAS,POR,116,,,12,9,8,7
Julian Champagnie,F,22023,1630577,22300608,"JAN 22, 2024",SAS @ PHI,L,15,3,4,0.75,3,3,1.0,3,3,1.0,0,2,2,1,0,0,0,2,12,0,1,SAS,PHI,SAS,123,,,15,14,13,3
Julian Strawther,G,22023,1631124,22300746,"FEB 09, 2024",DEN @ SAC,L,20,3,8,0.375,1,5,0.2,0,0,0.0,0,3,3,2,1,0,2,1,7,-18,1,DEN,SAC,DEN,106,,,12,10,9,5
Julian Strawther,G,22023,1631124,22300478,"JAN 04, 2024",DEN @ GSW,W,9,0,1,0.0,0,1,0.0,0,0,0.0,1,0,1,1,1,0,0,0,0,-6,1,DEN,GSW,DEN,130,,,2,1,1,2
Julian Strawther,G,22023,1631124,22300455,"JAN 01, 2024",DEN vs. CHA,W,13,1,2,0.5,0,1,0.0,0,0,0.0,0,1,1,1,0,0,1,1,2,-14,1,DEN,DEN,CHA,111,,,4,3,3,2
Julian Strawther,G,22023,1631124,22300435,"DEC 29, 2023",DEN vs. OKC,L,12,3,7,0.429,1,4,0.25,3,4,0.75,0,1,1,0,0,0,3,3,10,-15,1,DEN,DEN,OKC,93,,,11,11,10,1
Julian Strawther,G,22023,1631124,22300425,"DEC 28, 2023",DEN vs. MEM,W,25,5,13,0.385,2,8,0.25,0,0,0.0,0,3,3,2,0,1,1,4,12,6,1,DEN,DEN,MEM,142,,,17,15,14,5
Julian Strawther,G,22023,1631124,22300402,"DEC 25, 2023",DEN vs. GSW,W,8,1,1,1.0,0,0,0.0,0,1,0.0,0,0,0,0,0,0,0,0,2,-4,1,DEN,DEN,GSW,120,,,2,2,2,0
Julian Strawther,G,22023,1631124,22300390,"DEC 23, 2023",DEN @ CHA,W,16,4,10,0.4,2,5,0.4,0,0,0.0,1,0,1,1,1,0,1,0,10,-4,1,DEN,CHA,DEN,102,,,12,11,11,2
Julian Strawther,G,22023,1631124,22300383,"DEC 22, 2023",DEN @ BKN,W,11,0,5,0.0,0,3,0.0,0,0,0.0,1,2,3,0,0,0,1,1,0,-10,1,DEN,BKN,DEN,122,,,3,3,0,3
Julian Strawther,G,22023,1631124,22300369,"DEC 20, 2023",DEN @ TOR,W,14,3,6,0.5,1,4,0.25,0,0,0.0,0,1,1,2,2,0,0,2,7,1,1,DEN,TOR,DEN,113,,,10,8,9,3
Julian Strawther,G,22023,1631124,22300356,"DEC 18, 2023",DEN vs. DAL,W,21,5,10,0.5,2,4,0.5,0,0,0.0,0,3,3,2,1,0,0,1,12,9,1,DEN,DEN,DAL,130,,,17,15,14,5
Julian Strawther,G,22023,1631124,22300340,"DEC 16, 2023",DEN vs. OKC,L,15,0,3,0.0,0,2,0.0,0,0,0.0,0,1,1,1,0,0,0,0,0,8,1,DEN,DEN,OKC,117,,,2,1,1,2
Julian Strawther,G,22023,1631124,22300322,"DEC 14, 2023",DEN vs. BKN,W,20,3,11,0.273,2,6,0.333,0,0,0.0,0,4,4,1,0,0,0,0,8,5,1,DEN,DEN,BKN,124,,,13,12,9,5
Julian Strawther,G,22023,1631124,22300307,"DEC 12, 2023",DEN @ CHI,W,23,4,9,0.444,2,5,0.4,6,8,0.75,0,6,6,3,1,0,2,1,16,12,1,DEN,CHI,DEN,114,,,25,22,19,9
Julian Strawther,G,22023,1631124,22300296,"DEC 11, 2023",DEN @ ATL,W,28,8,16,0.5,6,11,0.545,0,0,0.0,0,1,1,2,5,0,2,1,22,-2,1,DEN,ATL,DEN,129,,,25,23,24,3
Julian Strawther,G,22023,1631124,22301224,"DEC 08, 2023",DEN vs. HOU,L,4,0,0,0.0,0,0,0.0,0,0,0.0,0,0,0,0,0,0,0,1,0,-15,1,DEN,DEN,HOU,106,,,0,0,0,0
Julian Strawther,G,22023,1631124,22301215,"DEC 06, 2023",DEN @ LAC,L,13,0,2,0.0,0,2,0.0,0,0,0.0,0,1,1,2,0,0,1,4,0,-9,1,DEN,LAC,DEN,102,,,3,1,2,3
Julian Strawther,G,22023,1631124,22300290,"DEC 02, 2023",DEN @ SAC,L,12,1,3,0.333,0,2,0.0,1,2,0.5,0,1,1,2,0,0,0,0,3,-7,1,DEN,SAC,DEN,117,,,6,4,5,3
Julian Strawther,G,22023,1631124,22300279,"DEC 01, 2023",DEN @ PHX,W,18,4,9,0.444,3,8,0.375,0,0,0.0,0,3,3,0,0,1,0,2,11,0,1,DEN,PHX,DEN,119,,,14,14,11,3
Julian Strawther,G,22023,1631124,22300263,"NOV 29, 2023",DEN vs. HOU,W,13,0,4,0.0,0,2,0.0,0,0,0.0,0,1,1,1,0,0,0,1,0,-2,1,DEN,DEN,HOU,134,,,2,1,1,2
Julian Strawther,G,22023,1631124,22300257,"NOV 27, 2023",DEN @ LAC,W,19,3,8,0.375,3,5,0.6,0,0,0.0,0,3,3,1,0,1,1,1,9,9,1,DEN,LAC,DEN,113,,,13,12,10,4
Julian Strawther,G,22023,1631124,22300252,"NOV 26, 2023",DEN vs. SAS,W,19,4,8,0.5,2,4,0.5,0,0,0.0,0,1,1,4,3,0,1,4,10,7,1,DEN,DEN,SAS,132,,,15,11,14,5
Julian Strawther,G,22023,1631124,22300048,"NOV 24, 2023",DEN @ HOU,L,6,0,0,0.0,0,0,0.0,0,0,0.0,0,0,0,0,0,0,0,1,0,-15,1,DEN,HOU,DEN,86,,,0,0,0,0
Julian Strawther,G,22023,1631124,22300226,"NOV 22, 2023",DEN @ ORL,L,17,2,6,0.333,1,4,0.25,2,2,1.0,1,1,2,2,0,0,0,5,7,-5,1,DEN,ORL,DEN,119,,,11,9,9,4
Julian Strawther,G,22023,1631124,22300218,"NOV 20, 2023",DEN @ DET,W,15,1,5,0.2,0,3,0.0,2,2,1.0,0,2,2,2,0,0,0,1,4,-8,1,DEN,DET,DEN,107,,,8,6,6,4
Julian Strawther,G,22023,1631124,22300210,"NOV 19, 2023",DEN @ CLE,L,20,2,6,0.333,1,3,0.333,2,2,1.0,0,2,2,1,0,1,0,4,7,8,1,DEN,CLE,DEN,109,,,10,9,8,3
Julian Strawther,G,22023,1631124,22300034,"NOV 17, 2023",DEN @ NOP,L,9,1,4,0.25,0,3,0.0,0,0,0.0,0,0,0,1,1,0,0,2,2,-16,1,DEN,NOP,DEN,110,,,3,2,3,1
Julian Strawther,G,22023,1631124,22300182,"NOV 12, 2023",DEN @ HOU,L,8,0,2,0.0,0,2,0.0,0,0,0.0,0,0,0,1,0,0,0,2,0,-5,1,DEN,HOU,DEN,104,,,1,0,1,1
Julian Strawther,G,22023,1631124,22300169,"NOV 08, 2023",DEN vs. GSW,W,8,0,1,0.0,0,1,0.0,0,0,0.0,0,1,1,0,0,0,0,2,0,-12,1,DEN,DEN,GSW,108,,,1,1,0,1
Julian Strawther,G,22023,1631124,22300156,"NOV 06, 2023",DEN vs. NOP,W,19,8,13,0.615,5,9,0.556,0,1,0.0,0,2,2,1,0,0,1,1,21,-7,1,DEN,DEN,NOP,134,,,24,23,22,3
Julian Strawther,G,22023,1631124,22300139,"NOV 04, 2023",DEN vs. CHI,W,9,1,2,0.5,1,2,0.5,0,0,0.0,0,1,1,1,0,0,0,0,3,-8,1,DEN,DEN,CHI,123,,,5,4,4,2
Julian Strawther,G,22023,1631124,22300123,"NOV 01, 2023",DEN @ MIN,L,16,2,7,0.286,1,6,0.167,0,1,0.0,0,0,0,0,1,2,0,0,5,2,1,DEN,MIN,DEN,89,,,5,5,5,0
Julian Strawther,G,22023,1631124,22300110,"OCT 30, 2023",DEN vs. UTA,W,6,2,4,0.5,0,2,0.0,0,0,0.0,0,2,2,0,0,0,0,0,4,1,1,DEN,DEN,UTA,110,,,6,6,4,2
Julian Strawther,G,22023,1631124,22300095,"OCT 29, 2023",DEN @ OKC,W,8,3,5,0.6,2,3,0.667,0,0,0.0,0,1,1,1,0,0,0,0,8,4,1,DEN,OKC,DEN,128,,,10,9,9,2
Julian Strawther,G,22023,1631124,22300078,"OCT 27, 2023",DEN @ MEM,W,5,0,2,0.0,0,0,0.0,0,0,0.0,0,0,0,0,0,0,0,2,0,-2,1,DEN,MEM,DEN,108,,,0,0,0,0
Larry Nance Jr.,F-C,22023,1626204,22300758,"FEB 10, 2024",NOP @ POR,W,19,1,2,0.5,0,0,0.0,0,0,0.0,0,2,2,1,0,0,0,0,2,2,1,NOP,POR,NOP,93,,,5,4,3,3
Larry Nance Jr.,F-C,22023,1626204,22300747,"FEB 09, 2024",NOP @ LAL,L,19,2,4,0.5,0,1,0.0,0,2,0.0,2,4,6,6,0,0,2,2,4,-18,1,NOP,LAL,NOP,122,,,16,10,10,12
Larry Nance Jr.,F-C,22023,1626204,22300731,"FEB 07, 2024",NOP @ LAC,W,27,1,1,1.0,0,0,0.0,0,0,0.0,1,2,3,3,4,0,0,3,2,13,1,NOP,LAC,NOP,117,,,8,5,5,6
Larry Nance Jr.,F-C,22023,1626204,22300718,"FEB 05, 2024",NOP vs. TOR,W,20,2,4,0.5,0,0,0.0,0,0,0.0,1,5,6,1,0,0,0,4,4,27,1,NOP,NOP,TOR,138,,,11,10,5,7
Larry Nance Jr.,F-C,22023,1626204,22300679,"JAN 31, 2024",NOP @ HOU,W,15,0,3,0.0,0,2,0.0,0,0,0.0,1,4,5,3,1,0,0,3,0,-2,1,NOP,HOU,NOP,110,,,8,5,3,8
Larry Nance Jr.,F-C,22023,1626204,22300648,"JAN 27, 2024",NOP @ MIL,L,18,3,6,0.5,2,3,0.667,2,2,1.0,2,3,5,0,0,0,0,2,10,-21,1,NOP,MIL,NOP,117,,,15,15,10,5
Larry Nance Jr.,F-C,22023,1626204,22300640,"JAN 26, 2024",NOP vs. OKC,L,22,2,3,0.667,0,0,0.0,0,0,0.0,1,4,5,3,1,1,0,1,4,-10,1,NOP,NOP,OKC,83,,,12,9,7,8
Larry Nance Jr.,F-C,22023,1626204,22300616,"JAN 23, 2024",NOP vs. UTA,W,20,5,6,0.833,1,2,0.5,1,1,1.0,0,8,8,3,1,1,1,2,12,6,1,NOP,NOP,UTA,153,,,23,20,15,11
Larry Nance Jr.,F-C,22023,1626204,22300588,"JAN 19, 2024",NOP vs. PHX,L,18,1,2,0.5,1,2,0.5,0,0,0.0,0,5,5,1,0,0,0,1,3,-4,1,NOP,NOP,PHX,109,,,9,8,4,6
Larry Nance Jr.,F-C,22023,1626204,22300575,"JAN 17, 2024",NOP vs. CHA,W,19,3,3,1.0,1,1,1.0,0,0,0.0,2,4,6,2,0,1,0,1,7,21,1,NOP,NOP,CHA,132,,,15,13,9,8
Larry Nance Jr.,F-C,22023,1626204,22300547,"JAN 13, 2024",NOP @ DAL,W,20,4,4,1.0,0,0,0.0,6,6,1.0,1,1,2,3,2,0,0,0,14,14,1,NOP,DAL,NOP,118,,,19,16,17,5
Larry Nance Jr.,F-C,22023,1626204,22300539,"JAN 12, 2024",NOP @ DEN,L,20,5,6,0.833,3,4,0.75,0,0,0.0,0,2,2,1,2,1,1,1,13,-9,1,NOP,DEN,NOP,113,,,16,15,14,3
Larry Nance Jr.,F-C,22023,1626204,22300486,"JAN 05, 2024",NOP vs. LAC,L,19,3,6,0.5,1,2,0.5,0,0,0.0,3,3,6,2,1,0,0,0,7,-21,1,NOP,NOP,LAC,95,,,15,13,9,8
Larry Nance Jr.,F-C,22023,1626204,22300471,"JAN 03, 2024",NOP @ MIN,W,22,4,6,0.667,0,0,0.0,0,0,0.0,3,6,9,2,1,1,0,1,8,-2,1,NOP,MIN,NOP,117,,,19,17,10,11
Larry Nance Jr.,F-C,22023,1626204,22300461,"JAN 02, 2024",NOP vs. BKN,W,20,2,4,0.5,1,2,0.5,1,2,0.5,2,6,8,0,2,0,1,2,6,10,1,NOP,NOP,BKN,112,,,14,14,6,8
Larry Nance Jr.,F-C,22023,1626204,22300446,"DEC 31, 2023",NOP vs. LAL,W,23,3,4,0.75,1,1,1.0,4,4,1.0,2,8,10,3,0,0,1,3,11,17,1,NOP,NOP,LAL,129,,,24,21,14,13
Larry Nance Jr.,F-C,22023,1626204,22300424,"DEC 28, 2023",NOP vs. UTA,W,25,4,6,0.667,1,2,0.5,0,0,0.0,1,6,7,0,5,1,2,0,9,16,1,NOP,NOP,UTA,112,,,16,16,9,7
Larry Nance Jr.,F-C,22023,1626204,22300256,"NOV 27, 2023",NOP @ UTA,L,9,1,1,1.0,0,0,0.0,1,2,0.5,2,2,4,2,0,0,1,1,3,-5,1,NOP,UTA,NOP,112,,,9,7,5,6
Larry Nance Jr.,F-C,22023,1626204,22300243,"NOV 25, 2023",NOP @ UTA,L,12,0,0,0.0,0,0,0.0,0,0,0.0,1,2,3,0,3,0,1,1,0,-2,1,NOP,UTA,NOP,100,,,3,3,0,3
Larry Nance Jr.,F-C,22023,1626204,22300052,"NOV 24, 2023",NOP @ LAC,W,20,2,4,0.5,0,1,0.0,0,0,0.0,1,2,3,0,0,3,1,1,4,-5,1,NOP,LAC,NOP,116,,,7,7,4,3
Larry Nance Jr.,F-C,22023,1626204,22300233,"NOV 22, 2023",NOP vs. SAC,W,12,2,4,0.5,0,1,0.0,0,0,0.0,1,3,4,0,1,0,1,2,4,-4,1,NOP,NOP,SAC,117,,,8,8,4,4
Larry Nance Jr.,F-C,22023,1626204,22300659,"JAN 29, 2024",NOP @ BOS,L,20,1,3,0.333,1,2,0.5,0,0,0.0,1,2,3,1,0,1,0,0,3,-12,1,NOP,BOS,NOP,112,,,7,6,4,4
Larry Nance Jr.,F-C,22023,1626204,22300556,"JAN 15, 2024",NOP @ DAL,L,26,5,11,0.455,1,4,0.25,3,3,1.0,1,7,8,2,3,0,1,1,14,16,1,NOP,DAL,NOP,120,,,24,22,16,10
Larry Nance Jr.,F-C,22023,1626204,22300525,"JAN 10, 2024",NOP @ GSW,W,19,1,1,1.0,1,1,1.0,3,4,0.75,1,4,5,1,2,1,1,0,6,17,1,NOP,GSW,NOP,141,,,12,11,7,6
Larry Nance Jr.,F-C,22023,1626204,22300500,"JAN 07, 2024",NOP @ SAC,W,14,1,4,0.25,0,0,0.0,0,0,0.0,2,5,7,4,0,1,2,1,2,23,1,NOP,SAC,NOP,133,,,13,9,6,11
Larry Nance Jr.,F-C,22023,1626204,22300183,"NOV 12, 2023",NOP vs. DAL,L,7,0,2,0.0,0,1,0.0,0,0,0.0,1,2,3,0,0,0,1,1,0,-9,1,NOP,NOP,DAL,124,,,3,3,0,3
Larry Nance Jr.,F-C,22023,1626204,22300011,"NOV 10, 2023",NOP @ HOU,L,15,0,0,0.0,0,0,0.0,1,2,0.5,1,4,5,1,0,0,1,1,1,-8,1,NOP,HOU,NOP,101,,,7,6,2,6
Larry Nance Jr.,F-C,22023,1626204,22300166,"NOV 08, 2023",NOP @ MIN,L,18,3,7,0.429,0,1,0.0,0,0,0.0,2,1,3,0,2,0,1,1,6,-11,1,NOP,MIN,NOP,101,,,9,9,6,3
Larry Nance Jr.,F-C,22023,1626204,22300156,"NOV 06, 2023",NOP @ DEN,L,15,2,3,0.667,1,1,1.0,0,0,0.0,1,2,3,1,0,0,1,1,5,2,1,NOP,DEN,NOP,116,,,9,8,6,4
Larry Nance Jr.,F-C,22023,1626204,22300135,"NOV 04, 2023",NOP vs. ATL,L,15,2,5,0.4,0,2,0.0,2,2,1.0,1,2,3,1,0,0,0,1,6,6,1,NOP,NOP,ATL,105,,,10,9,7,4
Larry Nance Jr.,F-C,22023,1626204,22300129,"NOV 02, 2023",NOP vs. DET,W,15,2,6,0.333,0,2,0.0,0,0,0.0,1,0,1,1,0,0,0,2,4,-11,1,NOP,NOP,DET,125,,,6,5,5,2
Larry Nance Jr.,F-C,22023,1626204,22300121,"NOV 01, 2023",NOP @ OKC,W,23,4,5,0.8,1,1,1.0,0,2,0.0,2,5,7,2,2,0,0,2,9,-1,1,NOP,OKC,NOP,110,,,18,16,11,9
Larry Nance Jr.,F-C,22023,1626204,22300108,"OCT 30, 2023",NOP vs. GSW,L,17,2,2,1.0,1,1,1.0,0,0,0.0,2,3,5,2,0,0,3,2,5,-6,1,NOP,NOP,GSW,102,,,12,10,7,7
Larry Nance Jr.,F-C,22023,1626204,22300090,"OCT 28, 2023",NOP vs. NYK,W,16,0,1,0.0,0,0,0.0,0,0,0.0,1,5,6,0,0,1,0,2,0,7,1,NOP,NOP,NYK,96,,,6,6,0,6
Larry Nance Jr.,F-C,22023,1626204,22300071,"OCT 25, 2023",NOP @ MEM,W,15,1,2,0.5,0,0,0.0,0,0,0.0,1,7,8,0,1,0,2,1,2,-4,1,NOP,MEM,NOP,111,,,10,10,2,8
Sasha Vezenkov,F,22023,1628426,22300746,"FEB 09, 2024",SAC vs. DEN,W,16,2,7,0.286,2,4,0.5,0,0,0.0,0,0,0,1,1,0,0,2,6,20,1,SAC,SAC,DEN,135,,,7,6,7,1
Sasha Vezenkov,F,22023,1628426,22300732,"FEB 07, 2024",SAC vs. DET,L,6,0,0,0.0,0,0,0.0,3,3,1.0,0,1,1,0,0,0,0,2,3,4,1,SAC,SAC,DET,120,,,4,4,3,1
Sasha Vezenkov,F,22023,1628426,22300613,"JAN 22, 2024",SAC vs. ATL,W,6,3,4,0.75,2,3,0.667,0,0,0.0,1,1,2,0,0,0,0,1,8,6,1,SAC,SAC,ATL,122,,,10,10,8,2
Sasha Vezenkov,F,22023,1628426,22300583,"JAN 18, 2024",SAC vs. IND,L,11,2,3,0.667,2,3,0.667,1,2,0.5,2,1,3,0,1,1,0,1,7,-6,1,SAC,SAC,IND,121,,,10,10,7,3
Sasha Vezenkov,F,22023,1628426,22300567,"JAN 16, 2024",SAC @ PHX,L,18,6,9,0.667,2,3,0.667,0,0,0.0,1,1,2,1,1,0,1,1,14,7,1,SAC,PHX,SAC,117,,,17,16,15,3
Sasha Vezenkov,F,22023,1628426,22300552,"JAN 14, 2024",SAC @ MIL,L,6,2,4,0.5,0,2,0.0,0,0,0.0,0,1,1,0,0,0,0,0,4,-5,1,SAC,MIL,SAC,142,,,5,5,4,1
Sasha Vezenkov,F,22023,1628426,22300532,"JAN 12, 2024",SAC @ PHI,L,9,1,5,0.2,0,1,0.0,0,0,0.0,5,0,5,0,0,0,1,0,2,-5,1,SAC,PHI,SAC,90,,,7,7,2,5
Sasha Vezenkov,F,22023,1628426,22300500,"JAN 07, 2024",SAC vs. NOP,L,21,5,9,0.556,1,5,0.2,0,0,0.0,1,1,2,0,0,0,0,0,11,-24,1,SAC,SAC,NOP,100,,,13,13,11,2
Sasha Vezenkov,F,22023,1628426,22300449,"DEC 31, 2023",SAC @ MEM,W,3,1,2,0.5,0,0,0.0,0,0,0.0,0,1,1,0,0,0,0,0,2,2,1,SAC,MEM,SAC,123,,,3,3,2,1
Sasha Vezenkov,F,22023,1628426,22300413,"DEC 26, 2023",SAC @ POR,L,9,0,3,0.0,0,3,0.0,0,0,0.0,1,0,1,1,0,0,0,1,0,-12,1,SAC,POR,SAC,113,,,2,1,1,2
Sasha Vezenkov,F,22023,1628426,22300400,"DEC 23, 2023",SAC vs. MIN,L,8,0,1,0.0,0,1,0.0,0,0,0.0,0,1,1,0,1,0,0,1,0,-5,1,SAC,SAC,MIN,98,,,1,1,0,1
Sasha Vezenkov,F,22023,1628426,22300387,"DEC 22, 2023",SAC vs. PHX,W,6,1,1,1.0,1,1,1.0,0,0,0.0,1,0,1,0,0,0,1,1,3,-4,1,SAC,SAC,PHX,120,,,4,4,3,1
Sasha Vezenkov,F,22023,1628426,22300373,"DEC 20, 2023",SAC vs. BOS,L,13,1,4,0.25,1,3,0.333,0,0,0.0,2,1,3,0,0,0,0,0,3,1,1,SAC,SAC,BOS,119,,,6,6,3,3
Sasha Vezenkov,F,22023,1628426,22300358,"DEC 18, 2023",SAC vs. WAS,W,12,3,5,0.6,2,3,0.667,0,0,0.0,4,3,7,1,2,0,1,1,8,-4,1,SAC,SAC,WAS,141,,,16,15,9,8
Sasha Vezenkov,F,22023,1628426,22300342,"DEC 16, 2023",SAC vs. UTA,W,11,1,3,0.333,1,2,0.5,0,0,0.0,0,4,4,2,0,0,0,0,3,-7,1,SAC,SAC,UTA,125,,,9,7,5,6
Sasha Vezenkov,F,22023,1628426,22300324,"DEC 14, 2023",SAC vs. OKC,W,10,1,4,0.25,1,4,0.25,0,0,0.0,1,3,4,0,0,0,0,1,3,9,1,SAC,SAC,OKC,128,,,7,7,3,4
Sasha Vezenkov,F,22023,1628426,22300309,"DEC 12, 2023",SAC @ LAC,L,20,4,7,0.571,1,3,0.333,0,0,0.0,0,3,3,3,1,0,0,0,9,2,1,SAC,LAC,SAC,99,,,15,12,12,6
Sasha Vezenkov,F,22023,1628426,22300303,"DEC 11, 2023",SAC vs. BKN,W,11,1,4,0.25,0,2,0.0,0,0,0.0,1,4,5,0,0,1,1,2,2,-3,1,SAC,SAC,BKN,131,,,7,7,2,5
Sasha Vezenkov,F,22023,1628426,22301228,"DEC 08, 2023",SAC @ PHX,W,20,5,7,0.714,2,3,0.667,2,2,1.0,3,0,3,2,3,0,1,1,14,5,1,SAC,PHX,SAC,114,,,19,17,16,5
Sasha Vezenkov,F,22023,1628426,22301204,"DEC 04, 2023",SAC vs. NOP,L,6,0,3,0.0,0,1,0.0,0,0,0.0,2,0,2,0,0,0,0,2,0,-12,1,SAC,SAC,NOP,117,,,2,2,0,2
Sasha Vezenkov,F,22023,1628426,22300290,"DEC 02, 2023",SAC vs. DEN,W,14,1,3,0.333,1,1,1.0,1,3,0.333,1,2,3,0,0,0,1,0,4,14,1,SAC,SAC,DEN,123,,,7,7,4,3
Sasha Vezenkov,F,22023,1628426,22300264,"NOV 29, 2023",SAC vs. LAC,L,24,5,7,0.714,3,5,0.6,0,0,0.0,1,4,5,0,0,0,0,2,13,6,1,SAC,SAC,LAC,117,,,18,18,13,5
Sasha Vezenkov,F,22023,1628426,22300060,"NOV 28, 2023",SAC vs. GSW,W,15,3,9,0.333,2,6,0.333,0,0,0.0,1,3,4,1,0,2,0,1,8,17,1,SAC,SAC,GSW,124,,,13,12,9,5
Sasha Vezenkov,F,22023,1628426,22300233,"NOV 22, 2023",SAC @ NOP,L,10,1,5,0.2,1,4,0.25,0,0,0.0,0,2,2,0,0,0,2,0,3,-14,1,SAC,NOP,SAC,112,,,5,5,3,2
Sasha Vezenkov,F,22023,1628426,22300212,"NOV 19, 2023",SAC @ DAL,W,13,3,5,0.6,1,2,0.5,0,0,0.0,1,0,1,1,0,1,1,2,7,2,1,SAC,DAL,SAC,129,,,9,8,8,2
Sasha Vezenkov,F,22023,1628426,22300032,"NOV 17, 2023",SAC @ SAS,W,17,2,4,0.5,1,2,0.5,0,0,0.0,0,4,4,0,0,0,0,3,5,10,1,SAC,SAS,SAC,129,,,9,9,5,4
Sasha Vezenkov,F,22023,1628426,22300198,"NOV 15, 2023",SAC @ LAL,W,12,1,4,0.25,0,3,0.0,2,2,1.0,0,0,0,0,2,0,0,0,4,-6,1,SAC,LAL,SAC,125,,,4,4,4,0
Sasha Vezenkov,F,22023,1628426,22300191,"NOV 13, 2023",SAC vs. CLE,W,17,4,6,0.667,3,5,0.6,0,0,0.0,0,2,2,0,0,0,0,1,11,7,1,SAC,SAC,CLE,132,,,13,13,11,2
Sasha Vezenkov,F,22023,1628426,22300016,"NOV 10, 2023",SAC vs. OKC,W,8,2,3,0.667,2,3,0.667,0,0,0.0,0,1,1,0,1,0,0,1,6,5,1,SAC,SAC,OKC,105,,,7,7,6,1
Sasha Vezenkov,F,22023,1628426,22300153,"NOV 06, 2023",SAC @ HOU,L,12,1,4,0.25,0,3,0.0,0,0,0.0,0,0,0,1,0,0,0,2,2,-15,1,SAC,HOU,SAC,97,,,3,2,3,1
Sasha Vezenkov,F,22023,1628426,22300137,"NOV 04, 2023",SAC @ HOU,L,11,0,2,0.0,0,1,0.0,0,0,0.0,0,1,1,0,1,1,0,3,0,3,1,SAC,HOU,SAC,89,,,1,1,0,1
Sasha Vezenkov,F,22023,1628426,22300126,"NOV 01, 2023",SAC @ GSW,L,17,1,6,0.167,0,3,0.0,0,0,0.0,0,5,5,0,0,0,1,2,2,-3,1,SAC,GSW,SAC,101,,,7,7,2,5
Sasha Vezenkov,F,22023,1628426,22300100,"OCT 29, 2023",SAC vs. LAL,W,18,4,10,0.4,2,6,0.333,1,1,1.0,0,4,4,1,0,1,0,0,11,-1,1,SAC,SAC,LAL,132,,,16,15,12,5
Sasha Vezenkov,F,22023,1628426,22300087,"OCT 27, 2023",SAC vs. GSW,L,12,4,6,0.667,2,4,0.5,0,0,0.0,0,1,1,0,0,0,0,0,10,1,1,SAC,SAC,GSW,114,,,11,11,10,1
Sasha Vezenkov,F,22023,1628426,22300072,"OCT 25, 2023",SAC @ UTA,W,16,3,6,0.5,2,5,0.4,0,0,0.0,1,1,2,0,2,0,0,1,8,9,1,SAC,UTA,SAC,130,,,10,10,8,2
Drew Eubanks,F-C,22023,1629234,22300757,"FEB 10, 2024",PHX @ GSW,L,16,1,1,1.0,0,0,0.0,2,2,1.0,1,3,4,1,2,2,0,0,4,3,1,PHX,GSW,PHX,112,,,9,8,5,5
Drew Eubanks,F-C,22023,1629234,22300739,"FEB 08, 2024",PHX vs. UTA,W,18,5,8,0.625,0,0,0.0,2,4,0.5,0,7,7,0,1,0,0,3,12,10,1,PHX,PHX,UTA,129,,,19,19,12,7
Drew Eubanks,F-C,22023,1629234,22300725,"FEB 06, 2024",PHX vs. MIL,W,16,1,3,0.333,0,0,0.0,0,0,0.0,1,4,5,0,1,1,0,0,2,-2,1,PHX,PHX,MIL,114,,,7,7,2,5
Drew Eubanks,F-C,22023,1629234,22300705,"FEB 04, 2024",PHX @ WAS,W,15,1,1,1.0,0,0,0.0,3,4,0.75,0,3,3,1,0,2,3,2,5,9,1,PHX,WAS,PHX,140,,,9,8,6,4
Drew Eubanks,F-C,22023,1629234,22300690,"FEB 02, 2024",PHX @ ATL,L,17,3,3,1.0,0,0,0.0,0,0,0.0,2,2,4,1,0,0,1,1,6,-7,1,PHX,ATL,PHX,120,,,11,10,7,5
Drew Eubanks,F-C,22023,1629234,22300661,"JAN 29, 2024",PHX @ MIA,W,21,5,5,1.0,0,0,0.0,1,1,1.0,3,2,5,1,0,1,0,2,11,24,1,PHX,MIA,PHX,118,,,17,16,12,6
Drew Eubanks,F-C,22023,1629234,22300655,"JAN 28, 2024",PHX @ ORL,L,29,2,2,1.0,0,0,0.0,0,0,0.0,1,7,8,3,1,1,2,3,4,-2,1,PHX,ORL,PHX,98,,,15,12,7,11
Drew Eubanks,F-C,22023,1629234,22300636,"JAN 26, 2024",PHX @ IND,L,16,4,4,1.0,0,0,0.0,0,0,0.0,2,3,5,1,0,0,1,1,8,12,1,PHX,IND,PHX,131,,,14,13,9,6
Drew Eubanks,F-C,22023,1629234,22300625,"JAN 24, 2024",PHX @ DAL,W,9,1,2,0.5,0,0,0.0,0,0,0.0,0,0,0,0,0,0,1,1,2,-10,1,PHX,DAL,PHX,132,,,2,2,2,0
Drew Eubanks,F-C,22023,1629234,22300612,"JAN 22, 2024",PHX vs. CHI,W,22,4,4,1.0,0,0,0.0,2,2,1.0,2,6,8,4,0,0,0,3,10,19,1,PHX,PHX,CHI,115,,,22,18,14,12
Drew Eubanks,F-C,22023,1629234,22300604,"JAN 21, 2024",PHX vs. IND,W,11,1,1,1.0,0,0,0.0,1,2,0.5,0,2,2,0,0,0,1,2,3,-1,1,PHX,PHX,IND,117,,,5,5,3,2
Drew Eubanks,F-C,22023,1629234,22300567,"JAN 16, 2024",PHX vs. SAC,W,10,1,1,1.0,0,0,0.0,1,1,1.0,3,1,4,0,1,0,0,0,3,-6,1,PHX,PHX,SAC,119,,,7,7,3,4
Drew Eubanks,F-C,22023,1629234,22300554,"JAN 14, 2024",PHX @ POR,W,4,0,1,0.0,0,0,0.0,0,0,0.0,0,1,1,0,0,0,0,0,0,4,1,PHX,POR,PHX,127,,,1,1,0,1
Drew Eubanks,F-C,22023,1629234,22300511,"JAN 08, 2024",PHX @ LAC,L,16,0,1,0.0,0,0,0.0,0,0,0.0,2,2,4,0,0,2,0,2,0,-5,1,PHX,LAC,PHX,111,,,4,4,0,4
Drew Eubanks,F-C,22023,1629234,22300503,"JAN 07, 2024",PHX vs. MEM,L,13,2,3,0.667,0,0,0.0,4,5,0.8,3,4,7,0,0,0,2,1,8,0,1,PHX,PHX,MEM,115,,,15,15,8,7
Drew Eubanks,F-C,22023,1629234,22300489,"JAN 05, 2024",PHX vs. MIA,W,22,4,8,0.5,1,1,1.0,2,4,0.5,2,4,6,0,1,0,0,1,11,-5,1,PHX,PHX,MIA,113,,,17,17,11,6
Drew Eubanks,F-C,22023,1629234,22300473,"JAN 03, 2024",PHX vs. LAC,L,4,0,0,0.0,0,0,0.0,0,0,0.0,0,0,0,0,0,0,0,1,0,2,1,PHX,PHX,LAC,122,,,0,0,0,0
Drew Eubanks,F-C,22023,1629234,22300456,"JAN 01, 2024",PHX vs. POR,W,6,0,0,0.0,0,0,0.0,1,4,0.25,0,1,1,0,0,0,0,2,1,-5,1,PHX,PHX,POR,109,,,2,2,1,1
Drew Eubanks,F-C,22023,1629234,22300405,"DEC 25, 2023",PHX vs. DAL,L,17,1,3,0.333,0,0,0.0,0,0,0.0,2,5,7,0,1,0,1,3,2,-14,1,PHX,PHX,DAL,114,,,9,9,2,7
Drew Eubanks,F-C,22023,1629234,22300387,"DEC 22, 2023",PHX @ SAC,L,15,1,3,0.333,0,0,0.0,0,0,0.0,1,1,2,0,1,0,2,2,2,-23,1,PHX,SAC,PHX,105,,,4,4,2,2
Drew Eubanks,F-C,22023,1629234,22300363,"DEC 19, 2023",PHX @ POR,L,17,2,2,1.0,0,0,0.0,1,2,0.5,3,3,6,1,1,3,1,1,5,0,1,PHX,POR,PHX,104,,,12,11,6,7
Drew Eubanks,F-C,22023,1629234,22300347,"DEC 17, 2023",PHX vs. WAS,W,17,5,7,0.714,0,0,0.0,2,2,1.0,1,4,5,0,1,1,2,0,12,10,1,PHX,PHX,WAS,112,,,17,17,12,5
Drew Eubanks,F-C,22023,1629234,22300333,"DEC 15, 2023",PHX vs. NYK,L,15,3,4,0.75,0,0,0.0,2,2,1.0,1,2,3,0,1,2,1,1,8,-13,1,PHX,PHX,NYK,122,,,11,11,8,3
Drew Eubanks,F-C,22023,1629234,22301203,"DEC 05, 2023",PHX @ LAL,L,18,3,3,1.0,0,0,0.0,0,0,0.0,2,0,2,1,1,0,3,2,6,-16,1,PHX,LAL,PHX,103,,,9,8,7,3
Drew Eubanks,F-C,22023,1629234,22300288,"DEC 02, 2023",PHX vs. MEM,W,18,2,5,0.4,0,0,0.0,2,2,1.0,1,2,3,1,0,2,1,3,6,1,1,PHX,PHX,MEM,116,,,10,9,7,4
Drew Eubanks,F-C,22023,1629234,22300279,"DEC 01, 2023",PHX vs. DEN,L,15,0,1,0.0,0,0,0.0,0,0,0.0,0,6,6,1,0,0,0,2,0,-9,1,PHX,PHX,DEN,111,,,7,6,1,7
Drew Eubanks,F-C,22023,1629234,22300236,"NOV 22, 2023",PHX vs. GSW,W,16,2,4,0.5,0,0,0.0,2,2,1.0,1,5,6,0,0,3,0,1,6,3,1,PHX,PHX,GSW,123,,,12,12,6,6
Drew Eubanks,F-C,22023,1629234,22300041,"NOV 21, 2023",PHX vs. POR,W,13,1,4,0.25,0,0,0.0,5,5,1.0,2,0,2,0,0,0,2,4,7,-3,1,PHX,PHX,POR,120,,,9,9,7,2
Drew Eubanks,F-C,22023,1629234,22300214,"NOV 19, 2023",PHX @ UTA,W,17,2,4,0.5,0,0,0.0,0,0,0.0,0,0,0,1,0,0,0,1,4,-4,1,PHX,UTA,PHX,140,,,5,4,5,1
Drew Eubanks,F-C,22023,1629234,22300035,"NOV 17, 2023",PHX @ UTA,W,21,5,5,1.0,1,1,1.0,0,0,0.0,0,4,4,0,0,0,0,2,11,8,1,PHX,UTA,PHX,131,,,15,15,11,4
Drew Eubanks,F-C,22023,1629234,22300197,"NOV 15, 2023",PHX vs. MIN,W,20,6,9,0.667,1,1,1.0,0,0,0.0,2,2,4,3,0,0,1,2,13,11,1,PHX,PHX,MIN,133,,,20,17,16,7
Drew Eubanks,F-C,22023,1629234,22300185,"NOV 12, 2023",PHX vs. OKC,L,21,7,9,0.778,0,0,0.0,1,2,0.5,4,1,5,1,0,0,2,1,15,4,1,PHX,PHX,OKC,99,,,21,20,16,6
Drew Eubanks,F-C,22023,1629234,22300015,"NOV 10, 2023",PHX vs. LAL,L,14,1,3,0.333,0,0,0.0,0,0,0.0,2,3,5,1,0,1,2,2,2,-6,1,PHX,PHX,LAL,119,,,8,7,3,6
Drew Eubanks,F-C,22023,1629234,22300162,"NOV 08, 2023",PHX @ CHI,W,14,1,1,1.0,0,0,0.0,2,2,1.0,0,3,3,2,0,2,0,2,4,-12,1,PHX,CHI,PHX,116,,,9,7,6,5
Drew Eubanks,F-C,22023,1629234,22300140,"NOV 05, 2023",PHX @ DET,W,18,4,5,0.8,0,0,0.0,0,0,0.0,1,2,3,1,1,3,2,4,8,6,1,PHX,DET,PHX,120,,,12,11,9,4
Drew Eubanks,F-C,22023,1629234,22300132,"NOV 04, 2023",PHX @ PHI,L,20,2,4,0.5,0,0,0.0,6,6,1.0,2,3,5,4,1,1,0,1,10,-13,1,PHX,PHI,PHX,100,,,19,15,14,9
Drew Eubanks,F-C,22023,1629234,22300131,"NOV 02, 2023",PHX vs. SAS,L,27,5,9,0.556,0,0,0.0,3,3,1.0,1,4,5,1,0,1,1,1,13,-9,1,PHX,PHX,SAS,121,,,19,18,14,6
Drew Eubanks,F-C,22023,1629234,22300113,"OCT 31, 2023",PHX vs. SAS,L,17,1,3,0.333,0,0,0.0,1,2,0.5,1,8,9,4,1,2,2,1,3,13,1,PHX,PHX,SAS,114,,,16,12,7,13
Drew Eubanks,F-C,22023,1629234,22300094,"OCT 28, 2023",PHX vs. UTA,W,19,6,7,0.857,0,0,0.0,0,0,0.0,2,3,5,2,0,2,0,3,12,11,1,PHX,PHX,UTA,126,,,19,17,14,7
Drew Eubanks,F-C,22023,1629234,22300076,"OCT 26, 2023",PHX @ LAL,L,17,1,2,0.5,0,0,0.0,0,0,0.0,1,3,4,2,0,0,2,3,2,-1,1,PHX,LAL,PHX,95,,,8,6,4,6
Drew Eubanks,F-C,22023,1629234,22300062,"OCT 24, 2023",PHX @ GSW,W,19,1,3,0.333,0,0,0.0,2,4,0.5,2,5,7,2,0,3,3,3,4,-2,1,PHX,GSW,PHX,108,,,13,11,6,9
Drew Eubanks,F-C,22023,1629234,22300677,"JAN 31, 2024",PHX @ BKN,W,18,3,4,0.75,0,0,0.0,0,2,0.0,0,6,6,2,0,1,0,1,6,0,1,PHX,BKN,PHX,136,,,14,12,8,8
Drew Eubanks,F-C,22023,1629234,22300317,"DEC 13, 2023",PHX vs. BKN,L,4,0,1,0.0,0,0,0.0,0,0,0.0,0,0,0,0,0,0,0,0,0,-18,1,PHX,PHX,BKN,112,,,0,0,0,0
Drew Eubanks,F-C,22023,1629234,22300308,"DEC 12, 2023",PHX vs. GSW,W,17,1,1,1.0,0,0,0.0,1,1,1.0,1,5,6,1,1,2,3,1,3,-7,1,PHX,PHX,GSW,119,,,10,9,4,7
Drew Eubanks,F-C,22023,1629234,22301228,"DEC 08, 2023",PHX vs. SAC,L,16,4,8,0.5,0,0,0.0,0,0,0.0,2,4,6,0,0,0,1,3,8,-10,1,PHX,PHX,SAC,106,,,14,14,8,6
Drew Eubanks,F-C,22023,1629234,22300260,"NOV 29, 2023",PHX @ TOR,L,18,2,6,0.333,0,0,0.0,0,0,0.0,1,3,4,1,0,1,0,0,4,-9,1,PHX,TOR,PHX,105,,,9,8,5,5
Drew Eubanks,F-C,22023,1629234,22300247,"NOV 26, 2023",PHX @ NYK,W,15,1,2,0.5,0,0,0.0,1,2,0.5,4,2,6,1,0,0,2,4,3,2,1,PHX,NYK,PHX,116,,,10,9,4,7
Dean Wade,F,22023,1629731,22300756,"FEB 10, 2024",CLE @ TOR,W,14,0,5,0.0,0,4,0.0,0,0,0.0,0,4,4,0,1,0,0,2,0,26,1,CLE,TOR,CLE,119,,,4,4,0,4
Dean Wade,F,22023,1629731,22300735,"FEB 08, 2024",CLE @ BKN,W,16,3,4,0.75,3,4,0.75,0,0,0.0,0,1,1,0,0,2,0,2,9,-4,1,CLE,BKN,CLE,118,,,10,10,9,1
Dean Wade,F,22023,1629731,22300728,"FEB 07, 2024",CLE @ WAS,W,12,2,6,0.333,2,6,0.333,0,0,0.0,0,2,2,0,1,0,0,2,6,8,1,CLE,WAS,CLE,114,,,8,8,6,2
Dean Wade,F,22023,1629731,22300714,"FEB 05, 2024",CLE vs. SAC,W,15,2,2,1.0,2,2,1.0,0,0,0.0,0,5,5,2,0,0,0,0,6,9,1,CLE,CLE,SAC,136,,,13,11,8,7
Dean Wade,F,22023,1629731,22300703,"FEB 03, 2024",CLE @ SAS,W,14,0,2,0.0,0,2,0.0,0,0,0.0,0,2,2,1,0,1,0,2,0,6,1,CLE,SAS,CLE,117,,,3,2,1,3
Dean Wade,F,22023,1629731,22300687,"FEB 01, 2024",CLE @ MEM,W,28,2,5,0.4,2,5,0.4,0,0,0.0,0,5,5,1,2,2,0,1,6,19,1,CLE,MEM,CLE,108,,,12,11,7,6
Dean Wade,F,22023,1629731,22300675,"JAN 31, 2024",CLE vs. DET,W,12,0,3,0.0,0,2,0.0,0,0,0.0,0,1,1,0,0,1,1,2,0,-7,1,CLE,CLE,DET,128,,,1,1,0,1
Dean Wade,F,22023,1629731,22300658,"JAN 29, 2024",CLE vs. LAC,W,26,2,8,0.25,2,8,0.25,0,0,0.0,2,2,4,2,0,0,1,1,6,20,1,CLE,CLE,LAC,118,,,12,10,8,6
Dean Wade,F,22023,1629731,22300639,"JAN 26, 2024",CLE @ MIL,W,21,3,5,0.6,3,4,0.75,0,0,0.0,0,5,5,0,0,1,0,1,9,2,1,CLE,MIL,CLE,112,,,14,14,9,5
Dean Wade,F,22023,1629731,22300624,"JAN 24, 2024",CLE @ MIL,L,23,2,4,0.5,2,4,0.5,0,0,0.0,0,5,5,0,0,1,1,1,6,-10,1,CLE,MIL,CLE,116,,,11,11,6,5
Dean Wade,F,22023,1629731,22300607,"JAN 22, 2024",CLE @ ORL,W,24,3,4,0.75,3,3,1.0,0,0,0.0,0,3,3,0,2,0,0,2,9,24,1,CLE,ORL,CLE,126,,,12,12,9,3
Dean Wade,F,22023,1629731,22300595,"JAN 20, 2024",CLE @ ATL,W,26,6,7,0.857,5,6,0.833,0,0,0.0,1,4,5,0,1,0,0,1,17,11,1,CLE,ATL,CLE,116,,,22,22,17,5
Dean Wade,F,22023,1629731,22300572,"JAN 17, 2024",CLE vs. MIL,W,21,2,5,0.4,1,4,0.25,0,1,0.0,0,3,3,0,1,0,2,0,5,40,1,CLE,CLE,MIL,135,,,8,8,5,3
Dean Wade,F,22023,1629731,22300561,"JAN 15, 2024",CLE vs. CHI,W,26,4,10,0.4,4,10,0.4,0,0,0.0,1,6,7,3,3,0,0,2,12,15,1,CLE,CLE,CHI,109,,,22,19,15,10
Dean Wade,F,22023,1629731,22300527,"JAN 11, 2024",CLE vs. BKN,W,27,0,1,0.0,0,1,0.0,4,4,1.0,0,1,1,2,2,0,0,5,4,8,1,CLE,CLE,BKN,111,,,7,5,6,3
Dean Wade,F,22023,1629731,22300497,"JAN 07, 2024",CLE vs. SAS,W,11,0,3,0.0,0,2,0.0,0,0,0.0,0,2,2,1,0,0,1,2,0,-21,1,CLE,CLE,SAS,117,,,3,2,1,3
Dean Wade,F,22023,1629731,22300482,"JAN 05, 2024",CLE vs. WAS,W,22,2,4,0.5,2,3,0.667,0,0,0.0,0,5,5,1,1,0,0,0,6,20,1,CLE,CLE,WAS,114,,,12,11,7,6
Dean Wade,F,22023,1629731,22300465,"JAN 03, 2024",CLE vs. WAS,W,20,1,3,0.333,0,1,0.0,0,0,0.0,0,3,3,1,0,0,0,1,2,15,1,CLE,CLE,WAS,140,,,6,5,3,4
Dean Wade,F,22023,1629731,22300452,"JAN 01, 2024",CLE @ TOR,L,21,1,2,0.5,0,1,0.0,0,0,0.0,0,3,3,0,1,0,0,2,2,5,1,CLE,TOR,CLE,121,,,5,5,2,3
Dean Wade,F,22023,1629731,22300433,"DEC 29, 2023",CLE vs. MIL,L,17,0,3,0.0,0,2,0.0,0,0,0.0,0,5,5,1,1,0,2,1,0,-8,1,CLE,CLE,MIL,111,,,6,5,1,6
Dean Wade,F,22023,1629731,22300420,"DEC 27, 2023",CLE @ DAL,W,32,1,5,0.2,1,5,0.2,0,0,0.0,1,7,8,0,0,0,0,2,3,15,1,CLE,DAL,CLE,113,,,11,11,3,8
Dean Wade,F,22023,1629731,22300396,"DEC 23, 2023",CLE @ CHI,W,36,4,12,0.333,3,10,0.3,0,0,0.0,1,6,7,1,2,0,1,1,11,12,1,CLE,CHI,CLE,109,,,19,18,12,8
Dean Wade,F,22023,1629731,22300375,"DEC 21, 2023",CLE vs. NOP,L,26,7,11,0.636,6,8,0.75,0,0,0.0,0,9,9,0,0,2,0,3,20,-4,1,CLE,CLE,NOP,104,,,29,29,20,9
Dean Wade,F,22023,1629731,22300364,"DEC 20, 2023",CLE vs. UTA,W,30,1,3,0.333,1,3,0.333,0,0,0.0,2,5,7,2,0,0,0,4,3,-3,1,CLE,CLE,UTA,124,,,12,10,5,9
Dean Wade,F,22023,1629731,22300349,"DEC 18, 2023",CLE vs. HOU,W,22,4,5,0.8,2,3,0.667,2,2,1.0,2,1,3,1,1,2,2,3,12,-1,1,CLE,CLE,HOU,135,,,16,15,13,4
Dean Wade,F,22023,1629731,22300336,"DEC 16, 2023",CLE vs. ATL,W,22,5,8,0.625,4,7,0.571,2,2,1.0,1,4,5,3,1,0,0,5,16,6,1,CLE,CLE,ATL,127,,,24,21,19,8
Dean Wade,F,22023,1629731,22300319,"DEC 14, 2023",CLE @ BOS,L,16,1,5,0.2,1,5,0.2,2,2,1.0,1,3,4,0,0,0,0,0,5,-11,1,CLE,BOS,CLE,107,,,9,9,5,4
Dean Wade,F,22023,1629731,22300305,"DEC 12, 2023",CLE @ BOS,L,20,2,6,0.333,2,6,0.333,2,2,1.0,1,2,3,3,0,1,0,3,8,2,1,CLE,BOS,CLE,113,,,14,11,11,6
Dean Wade,F,22023,1629731,22300294,"DEC 11, 2023",CLE @ ORL,L,29,3,5,0.6,2,3,0.667,1,2,0.5,4,2,6,0,3,0,2,2,9,-14,1,CLE,ORL,CLE,94,,,15,15,9,6
Dean Wade,F,22023,1629731,22301220,"DEC 08, 2023",CLE @ MIA,W,25,2,5,0.4,1,4,0.25,0,0,0.0,3,3,6,0,3,0,1,1,5,23,1,CLE,MIA,CLE,111,,,11,11,5,6
Dean Wade,F,22023,1629731,22301205,"DEC 06, 2023",CLE vs. ORL,W,14,3,6,0.5,2,5,0.4,0,0,0.0,1,4,5,0,0,0,0,2,8,-4,1,CLE,CLE,ORL,121,,,13,13,8,5
Dean Wade,F,22023,1629731,22300040,"NOV 21, 2023",CLE @ PHI,W,31,0,4,0.0,0,4,0.0,0,0,0.0,4,4,8,2,3,0,1,5,0,-12,1,CLE,PHI,CLE,122,,,10,8,2,10
Dean Wade,F,22023,1629731,22300210,"NOV 19, 2023",CLE vs. DEN,W,24,2,4,0.5,2,4,0.5,0,0,0.0,1,9,10,2,2,0,0,1,6,25,1,CLE,CLE,DEN,121,,,18,16,8,12
Dean Wade,F,22023,1629731,22300030,"NOV 17, 2023",CLE vs. DET,W,22,1,1,1.0,1,1,1.0,0,0,0.0,0,1,1,0,0,0,0,1,3,0,1,CLE,CLE,DET,108,,,4,4,3,1
Dean Wade,F,22023,1629731,22300199,"NOV 15, 2023",CLE @ POR,W,33,0,3,0.0,0,3,0.0,0,0,0.0,1,2,3,2,0,1,0,1,0,6,1,CLE,POR,CLE,109,,,5,3,2,5
Dean Wade,F,22023,1629731,22300191,"NOV 13, 2023",CLE @ SAC,L,13,0,1,0.0,0,1,0.0,0,0,0.0,0,0,0,1,0,0,0,1,0,-18,1,CLE,SAC,CLE,120,,,1,0,1,1
Dean Wade,F,22023,1629731,22300176,"NOV 11, 2023",CLE @ GSW,W,17,2,4,0.5,2,4,0.5,2,2,1.0,0,7,7,0,0,0,0,6,8,20,1,CLE,GSW,CLE,118,,,15,15,8,7
Dean Wade,F,22023,1629731,22300167,"NOV 08, 2023",CLE @ OKC,L,11,0,1,0.0,0,1,0.0,0,2,0.0,2,4,6,0,1,1,2,4,0,-8,1,CLE,OKC,CLE,120,,,6,6,0,6
Dean Wade,F,22023,1629731,22300142,"NOV 05, 2023",CLE vs. GSW,W,13,1,3,0.333,1,3,0.333,0,0,0.0,1,3,4,0,3,0,0,1,3,8,1,CLE,CLE,GSW,115,,,7,7,3,4
Dean Wade,F,22023,1629731,22300001,"NOV 03, 2023",CLE @ IND,L,3,0,0,0.0,0,0,0.0,0,0,0.0,0,0,0,0,0,0,0,1,0,-9,1,CLE,IND,CLE,116,,,0,0,0,0
Dean Wade,F,22023,1629731,22300112,"OCT 31, 2023",CLE vs. NYK,L,16,0,5,0.0,0,4,0.0,0,0,0.0,2,1,3,1,0,0,1,3,0,-5,1,CLE,CLE,NYK,91,,,4,3,1,4
Dean Wade,F,22023,1629731,22300091,"OCT 28, 2023",CLE vs. IND,L,37,2,5,0.4,2,5,0.4,0,0,0.0,0,3,3,3,0,1,0,2,6,3,1,CLE,CLE,IND,113,,,12,9,9,6
Dean Wade,F,22023,1629731,22300081,"OCT 27, 2023",CLE vs. OKC,L,27,3,6,0.5,2,5,0.4,0,0,0.0,0,5,5,0,2,0,1,3,8,-9,1,CLE,CLE,OKC,105,,,13,13,8,5
Dean Wade,F,22023,1629731,22300120,"NOV 01, 2023",CLE @ NYK,W,20,2,3,0.667,2,3,0.667,0,0,0.0,1,2,3,0,0,0,0,0,6,-1,1,CLE,NYK,CLE,95,,,9,9,6,3
Aaron Wiggins,G,22023,1630598,22300682,"JAN 31, 2024",OKC vs. DEN,W,25,5,8,0.625,2,3,0.667,0,0,0.0,1,3,4,2,0,0,0,2,12,-2,1,OKC,OKC,DEN,105,7.5,Points,18,16,14,6
Aaron Wiggins,G,22023,1630598,22300682,"JAN 31, 2024",OKC vs. DEN,W,25,5,8,0.625,2,3,0.667,0,0,0.0,1,3,4,2,0,0,0,2,12,-2,1,OKC,OKC,DEN,105,10.5,Pts+Rebs,18,16,14,6
Aaron Wiggins,G,22023,1630598,22300682,"JAN 31, 2024",OKC vs. DEN,W,25,5,8,0.625,2,3,0.667,0,0,0.0,1,3,4,2,0,0,0,2,12,-2,1,OKC,OKC,DEN,105,0.5,Turnovers,18,16,14,6
Aaron Wiggins,G,22023,1630598,22300622,"JAN 24, 2024",OKC @ SAS,W,19,9,11,0.818,4,6,0.667,0,0,0.0,0,3,3,1,0,1,0,1,22,6,1,OKC,SAS,OKC,140,7.5,Points,26,25,23,4
Aaron Wiggins,G,22023,1630598,22300622,"JAN 24, 2024",OKC @ SAS,W,19,9,11,0.818,4,6,0.667,0,0,0.0,0,3,3,1,0,1,0,1,22,6,1,OKC,SAS,OKC,140,10.5,Pts+Rebs,26,25,23,4
Aaron Wiggins,G,22023,1630598,22300622,"JAN 24, 2024",OKC @ SAS,W,19,9,11,0.818,4,6,0.667,0,0,0.0,0,3,3,1,0,1,0,1,22,6,1,OKC,SAS,OKC,140,0.5,Turnovers,26,25,23,4
Aaron Wiggins,G,22023,1630598,22300617,"JAN 23, 2024",OKC vs. POR,W,17,6,8,0.75,1,1,1.0,0,0,0.0,2,1,3,0,0,0,1,3,13,-2,1,OKC,OKC,POR,111,7.5,Points,16,16,13,3
Aaron Wiggins,G,22023,1630598,22300617,"JAN 23, 2024",OKC vs. POR,W,17,6,8,0.75,1,1,1.0,0,0,0.0,2,1,3,0,0,0,1,3,13,-2,1,OKC,OKC,POR,111,10.5,Pts+Rebs,16,16,13,3
Aaron Wiggins,G,22023,1630598,22300617,"JAN 23, 2024",OKC vs. POR,W,17,6,8,0.75,1,1,1.0,0,0,0.0,2,1,3,0,0,0,1,3,13,-2,1,OKC,OKC,POR,111,0.5,Turnovers,16,16,13,3
Aaron Wiggins,G,22023,1630598,22300481,"JAN 05, 2024",OKC @ BKN,L,8,1,2,0.5,0,1,0.0,0,0,0.0,0,0,0,2,0,0,0,2,2,-3,1,OKC,BKN,OKC,115,7.5,Points,4,2,4,2
Aaron Wiggins,G,22023,1630598,22300481,"JAN 05, 2024",OKC @ BKN,L,8,1,2,0.5,0,1,0.0,0,0,0.0,0,0,0,2,0,0,0,2,2,-3,1,OKC,BKN,OKC,115,10.5,Pts+Rebs,4,2,4,2
Aaron Wiggins,G,22023,1630598,22300481,"JAN 05, 2024",OKC @ BKN,L,8,1,2,0.5,0,1,0.0,0,0,0.0,0,0,0,2,0,0,0,2,2,-3,1,OKC,BKN,OKC,115,0.5,Turnovers,4,2,4,2
Aaron Wiggins,G,22023,1630598,22300419,"DEC 27, 2023",OKC vs. NYK,W,12,2,4,0.5,1,3,0.333,0,0,0.0,0,0,0,2,0,1,0,4,5,7,1,OKC,OKC,NYK,129,7.5,Points,7,5,7,2
Aaron Wiggins,G,22023,1630598,22300419,"DEC 27, 2023",OKC vs. NYK,W,12,2,4,0.5,1,3,0.333,0,0,0.0,0,0,0,2,0,1,0,4,5,7,1,OKC,OKC,NYK,129,10.5,Pts+Rebs,7,5,7,2
Aaron Wiggins,G,22023,1630598,22300419,"DEC 27, 2023",OKC vs. NYK,W,12,2,4,0.5,1,3,0.333,0,0,0.0,0,0,0,2,0,1,0,4,5,7,1,OKC,OKC,NYK,129,0.5,Turnovers,7,5,7,2
Aaron Wiggins,G,22023,1630598,22300397,"DEC 23, 2023",OKC vs. LAL,L,6,0,1,0.0,0,0,0.0,0,0,0.0,1,0,1,1,0,0,1,0,0,-6,1,OKC,OKC,LAL,120,7.5,Points,2,1,1,2
Aaron Wiggins,G,22023,1630598,22300397,"DEC 23, 2023",OKC vs. LAL,L,6,0,1,0.0,0,0,0.0,0,0,0.0,1,0,1,1,0,0,1,0,0,-6,1,OKC,OKC,LAL,120,10.5,Pts+Rebs,2,1,1,2
Aaron Wiggins,G,22023,1630598,22300397,"DEC 23, 2023",OKC vs. LAL,L,6,0,1,0.0,0,0,0.0,0,0,0.0,1,0,1,1,0,0,1,0,0,-6,1,OKC,OKC,LAL,120,0.5,Turnovers,2,1,1,2
Aaron Wiggins,G,22023,1630598,22300324,"DEC 14, 2023",OKC @ SAC,L,7,3,4,0.75,0,0,0.0,0,0,0.0,1,0,1,0,0,0,1,0,6,-5,1,OKC,SAC,OKC,123,7.5,Points,7,7,6,1
Aaron Wiggins,G,22023,1630598,22300324,"DEC 14, 2023",OKC @ SAC,L,7,3,4,0.75,0,0,0.0,0,0,0.0,1,0,1,0,0,0,1,0,6,-5,1,OKC,SAC,OKC,123,10.5,Pts+Rebs,7,7,6,1
Aaron Wiggins,G,22023,1630598,22300324,"DEC 14, 2023",OKC @ SAC,L,7,3,4,0.75,0,0,0.0,0,0,0.0,1,0,1,0,0,0,1,0,6,-5,1,OKC,SAC,OKC,123,0.5,Turnovers,7,7,6,1
Aaron Wiggins,G,22023,1630598,22300302,"DEC 11, 2023",OKC vs. UTA,W,4,1,4,0.25,1,1,1.0,0,0,0.0,1,0,1,0,0,0,0,0,3,2,1,OKC,OKC,UTA,134,7.5,Points,4,4,3,1
Aaron Wiggins,G,22023,1630598,22300302,"DEC 11, 2023",OKC vs. UTA,W,4,1,4,0.25,1,1,1.0,0,0,0.0,1,0,1,0,0,0,0,0,3,2,1,OKC,OKC,UTA,134,10.5,Pts+Rebs,4,4,3,1
Aaron Wiggins,G,22023,1630598,22300302,"DEC 11, 2023",OKC vs. UTA,W,4,1,4,0.25,1,1,1.0,0,0,0.0,1,0,1,0,0,0,0,0,3,2,1,OKC,OKC,UTA,134,0.5,Turnovers,4,4,3,1
Aaron Wiggins,G,22023,1630598,22301222,"DEC 08, 2023",OKC vs. GSW,W,22,4,5,0.8,1,2,0.5,0,0,0.0,1,2,3,1,2,0,1,2,9,-15,1,OKC,OKC,GSW,138,7.5,Points,13,12,10,4
Aaron Wiggins,G,22023,1630598,22301222,"DEC 08, 2023",OKC vs. GSW,W,22,4,5,0.8,1,2,0.5,0,0,0.0,1,2,3,1,2,0,1,2,9,-15,1,OKC,OKC,GSW,138,10.5,Pts+Rebs,13,12,10,4
Aaron Wiggins,G,22023,1630598,22301222,"DEC 08, 2023",OKC vs. GSW,W,22,4,5,0.8,1,2,0.5,0,0,0.0,1,2,3,1,2,0,1,2,9,-15,1,OKC,OKC,GSW,138,0.5,Turnovers,13,12,10,4
Aaron Wiggins,G,22023,1630598,22300287,"DEC 02, 2023",OKC @ DAL,W,10,0,1,0.0,0,0,0.0,0,0,0.0,0,0,0,0,0,0,0,0,0,0,1,OKC,DAL,OKC,126,7.5,Points,0,0,0,0
Aaron Wiggins,G,22023,1630598,22300287,"DEC 02, 2023",OKC @ DAL,W,10,0,1,0.0,0,0,0.0,0,0,0.0,0,0,0,0,0,0,0,0,0,0,1,OKC,DAL,OKC,126,10.5,Pts+Rebs,0,0,0,0
Aaron Wiggins,G,22023,1630598,22300287,"DEC 02, 2023",OKC @ DAL,W,10,0,1,0.0,0,0,0.0,0,0,0.0,0,0,0,0,0,0,0,0,0,0,1,OKC,DAL,OKC,126,0.5,Turnovers,0,0,0,0
Aaron Wiggins,G,22023,1630598,22300239,"NOV 25, 2023",OKC vs. PHI,L,20,2,4,0.5,1,3,0.333,2,4,0.5,2,1,3,1,0,0,0,1,7,0,1,OKC,OKC,PHI,123,7.5,Points,11,10,8,4
Aaron Wiggins,G,22023,1630598,22300239,"NOV 25, 2023",OKC vs. PHI,L,20,2,4,0.5,1,3,0.333,2,4,0.5,2,1,3,1,0,0,0,1,7,0,1,OKC,OKC,PHI,123,10.5,Pts+Rebs,11,10,8,4
Aaron Wiggins,G,22023,1630598,22300239,"NOV 25, 2023",OKC vs. PHI,L,20,2,4,0.5,1,3,0.333,2,4,0.5,2,1,3,1,0,0,0,1,7,0,1,OKC,OKC,PHI,123,0.5,Turnovers,11,10,8,4
Aaron Wiggins,G,22023,1630598,22300215,"NOV 19, 2023",OKC @ POR,W,16,4,7,0.571,2,3,0.667,3,3,1.0,2,3,5,1,3,0,2,1,13,11,1,OKC,POR,OKC,134,7.5,Points,19,18,14,6
Aaron Wiggins,G,22023,1630598,22300215,"NOV 19, 2023",OKC @ POR,W,16,4,7,0.571,2,3,0.667,3,3,1.0,2,3,5,1,3,0,2,1,13,11,1,OKC,POR,OKC,134,10.5,Pts+Rebs,19,18,14,6
Aaron Wiggins,G,22023,1630598,22300215,"NOV 19, 2023",OKC @ POR,W,16,4,7,0.571,2,3,0.667,3,3,1.0,2,3,5,1,3,0,2,1,13,11,1,OKC,POR,OKC,134,0.5,Turnovers,19,18,14,6
Aaron Wiggins,G,22023,1630598,22300185,"NOV 12, 2023",OKC @ PHX,W,12,1,4,0.25,0,0,0.0,0,0,0.0,0,2,2,1,1,0,0,1,2,9,1,OKC,PHX,OKC,111,7.5,Points,5,4,3,3
Aaron Wiggins,G,22023,1630598,22300185,"NOV 12, 2023",OKC @ PHX,W,12,1,4,0.25,0,0,0.0,0,0,0.0,0,2,2,1,1,0,0,1,2,9,1,OKC,PHX,OKC,111,10.5,Pts+Rebs,5,4,3,3
Aaron Wiggins,G,22023,1630598,22300185,"NOV 12, 2023",OKC @ PHX,W,12,1,4,0.25,0,0,0.0,0,0,0.0,0,2,2,1,1,0,0,1,2,9,1,OKC,PHX,OKC,111,0.5,Turnovers,5,4,3,3
Aaron Wiggins,G,22023,1630598,22300167,"NOV 08, 2023",OKC vs. CLE,W,9,0,3,0.0,0,2,0.0,0,0,0.0,0,0,0,0,0,0,0,0,0,4,1,OKC,OKC,CLE,128,7.5,Points,0,0,0,0
Aaron Wiggins,G,22023,1630598,22300167,"NOV 08, 2023",OKC vs. CLE,W,9,0,3,0.0,0,2,0.0,0,0,0.0,0,0,0,0,0,0,0,0,0,4,1,OKC,OKC,CLE,128,10.5,Pts+Rebs,0,0,0,0
Aaron Wiggins,G,22023,1630598,22300167,"NOV 08, 2023",OKC vs. CLE,W,9,0,3,0.0,0,2,0.0,0,0,0.0,0,0,0,0,0,0,0,0,0,4,1,OKC,OKC,CLE,128,0.5,Turnovers,0,0,0,0
Aaron Wiggins,G,22023,1630598,22300748,"FEB 10, 2024",OKC @ DAL,L,22,2,4,0.5,1,2,0.5,2,2,1.0,1,3,4,0,2,0,0,3,7,-11,1,OKC,DAL,OKC,111,7.5,Points,11,11,7,4
Aaron Wiggins,G,22023,1630598,22300748,"FEB 10, 2024",OKC @ DAL,L,22,2,4,0.5,1,2,0.5,2,2,1.0,1,3,4,0,2,0,0,3,7,-11,1,OKC,DAL,OKC,111,10.5,Pts+Rebs,11,11,7,4
Aaron Wiggins,G,22023,1630598,22300748,"FEB 10, 2024",OKC @ DAL,L,22,2,4,0.5,1,2,0.5,2,2,1.0,1,3,4,0,2,0,0,3,7,-11,1,OKC,DAL,OKC,111,0.5,Turnovers,11,11,7,4
Aaron Wiggins,G,22023,1630598,22300724,"FEB 06, 2024",OKC @ UTA,L,17,3,5,0.6,2,3,0.667,1,2,0.5,2,2,4,1,0,0,0,0,9,-11,1,OKC,UTA,OKC,117,7.5,Points,14,13,10,5
Aaron Wiggins,G,22023,1630598,22300724,"FEB 06, 2024",OKC @ UTA,L,17,3,5,0.6,2,3,0.667,1,2,0.5,2,2,4,1,0,0,0,0,9,-11,1,OKC,UTA,OKC,117,10.5,Pts+Rebs,14,13,10,5
Aaron Wiggins,G,22023,1630598,22300724,"FEB 06, 2024",OKC @ UTA,L,17,3,5,0.6,2,3,0.667,1,2,0.5,2,2,4,1,0,0,0,0,9,-11,1,OKC,UTA,OKC,117,0.5,Turnovers,14,13,10,5
Aaron Wiggins,G,22023,1630598,22300710,"FEB 04, 2024",OKC vs. TOR,W,33,8,17,0.471,4,11,0.364,0,0,0.0,4,2,6,2,0,0,1,1,20,3,1,OKC,OKC,TOR,135,7.5,Points,28,26,22,8
Aaron Wiggins,G,22023,1630598,22300710,"FEB 04, 2024",OKC vs. TOR,W,33,8,17,0.471,4,11,0.364,0,0,0.0,4,2,6,2,0,0,1,1,20,3,1,OKC,OKC,TOR,135,10.5,Pts+Rebs,28,26,22,8
Aaron Wiggins,G,22023,1630598,22300710,"FEB 04, 2024",OKC vs. TOR,W,33,8,17,0.471,4,11,0.364,0,0,0.0,4,2,6,2,0,0,1,1,20,3,1,OKC,OKC,TOR,135,0.5,Turnovers,28,26,22,8
Aaron Wiggins,G,22023,1630598,22300695,"FEB 02, 2024",OKC vs. CHA,W,19,3,6,0.5,2,5,0.4,2,3,0.667,0,2,2,4,1,0,1,1,10,17,1,OKC,OKC,CHA,126,7.5,Points,16,12,14,6
Aaron Wiggins,G,22023,1630598,22300695,"FEB 02, 2024",OKC vs. CHA,W,19,3,6,0.5,2,5,0.4,2,3,0.667,0,2,2,4,1,0,1,1,10,17,1,OKC,OKC,CHA,126,10.5,Pts+Rebs,16,12,14,6
Aaron Wiggins,G,22023,1630598,22300695,"FEB 02, 2024",OKC vs. CHA,W,19,3,6,0.5,2,5,0.4,2,3,0.667,0,2,2,4,1,0,1,1,10,17,1,OKC,OKC,CHA,126,0.5,Turnovers,16,12,14,6
Aaron Wiggins,G,22023,1630598,22300568,"JAN 16, 2024",OKC @ LAC,L,17,3,4,0.75,1,1,1.0,0,0,0.0,0,4,4,2,1,0,0,0,7,4,1,OKC,LAC,OKC,117,7.5,Points,13,11,9,6
Aaron Wiggins,G,22023,1630598,22300568,"JAN 16, 2024",OKC @ LAC,L,17,3,4,0.75,1,1,1.0,0,0,0.0,0,4,4,2,1,0,0,0,7,4,1,OKC,LAC,OKC,117,10.5,Pts+Rebs,13,11,9,6
Aaron Wiggins,G,22023,1630598,22300568,"JAN 16, 2024",OKC @ LAC,L,17,3,4,0.75,1,1,1.0,0,0,0.0,0,4,4,2,1,0,0,0,7,4,1,OKC,LAC,OKC,117,0.5,Turnovers,13,11,9,6
Aaron Wiggins,G,22023,1630598,22300546,"JAN 13, 2024",OKC vs. ORL,W,7,0,2,0.0,0,0,0.0,0,0,0.0,1,0,1,1,2,0,0,4,0,-2,1,OKC,OKC,ORL,112,7.5,Points,2,1,1,2
Aaron Wiggins,G,22023,1630598,22300546,"JAN 13, 2024",OKC vs. ORL,W,7,0,2,0.0,0,0,0.0,0,0,0.0,1,0,1,1,2,0,0,4,0,-2,1,OKC,OKC,ORL,112,10.5,Pts+Rebs,2,1,1,2
Aaron Wiggins,G,22023,1630598,22300546,"JAN 13, 2024",OKC vs. ORL,W,7,0,2,0.0,0,0,0.0,0,0,0.0,1,0,1,1,2,0,0,4,0,-2,1,OKC,OKC,ORL,112,0.5,Turnovers,2,1,1,2
Aaron Wiggins,G,22023,1630598,22300529,"JAN 11, 2024",OKC vs. POR,W,7,0,2,0.0,0,0,0.0,0,0,0.0,0,0,0,0,1,0,0,0,0,6,1,OKC,OKC,POR,139,7.5,Points,0,0,0,0
Aaron Wiggins,G,22023,1630598,22300529,"JAN 11, 2024",OKC vs. POR,W,7,0,2,0.0,0,0,0.0,0,0,0.0,0,0,0,0,1,0,0,0,0,6,1,OKC,OKC,POR,139,10.5,Pts+Rebs,0,0,0,0
Aaron Wiggins,G,22023,1630598,22300529,"JAN 11, 2024",OKC vs. POR,W,7,0,2,0.0,0,0,0.0,0,0,0.0,0,0,0,0,1,0,0,0,0,6,1,OKC,OKC,POR,139,0.5,Turnovers,0,0,0,0
Aaron Wiggins,G,22023,1630598,22300379,"DEC 21, 2023",OKC vs. LAC,W,25,3,6,0.5,1,2,0.5,1,2,0.5,0,7,7,1,1,0,1,3,8,22,1,OKC,OKC,LAC,134,7.5,Points,16,15,9,8
Aaron Wiggins,G,22023,1630598,22300379,"DEC 21, 2023",OKC vs. LAC,W,25,3,6,0.5,1,2,0.5,1,2,0.5,0,7,7,1,1,0,1,3,8,22,1,OKC,OKC,LAC,134,10.5,Pts+Rebs,16,15,9,8
Aaron Wiggins,G,22023,1630598,22300379,"DEC 21, 2023",OKC vs. LAC,W,25,3,6,0.5,1,2,0.5,1,2,0.5,0,7,7,1,1,0,1,3,8,22,1,OKC,OKC,LAC,134,0.5,Turnovers,16,15,9,8
Aaron Wiggins,G,22023,1630598,22300355,"DEC 18, 2023",OKC vs. MEM,W,12,1,4,0.25,0,0,0.0,0,0,0.0,1,1,2,1,1,0,1,0,2,-8,1,OKC,OKC,MEM,116,7.5,Points,5,4,3,3
Aaron Wiggins,G,22023,1630598,22300355,"DEC 18, 2023",OKC vs. MEM,W,12,1,4,0.25,0,0,0.0,0,0,0.0,1,1,2,1,1,0,1,0,2,-8,1,OKC,OKC,MEM,116,10.5,Pts+Rebs,5,4,3,3
Aaron Wiggins,G,22023,1630598,22300355,"DEC 18, 2023",OKC vs. MEM,W,12,1,4,0.25,0,0,0.0,0,0,0.0,1,1,2,1,1,0,1,0,2,-8,1,OKC,OKC,MEM,116,0.5,Turnovers,5,4,3,3
Aaron Wiggins,G,22023,1630598,22300340,"DEC 16, 2023",OKC @ DEN,W,12,2,2,1.0,0,0,0.0,2,2,1.0,1,1,2,1,0,0,0,1,6,-4,1,OKC,DEN,OKC,118,7.5,Points,9,8,7,3
Aaron Wiggins,G,22023,1630598,22300340,"DEC 16, 2023",OKC @ DEN,W,12,2,2,1.0,0,0,0.0,2,2,1.0,1,1,2,1,0,0,0,1,6,-4,1,OKC,DEN,OKC,118,10.5,Pts+Rebs,9,8,7,3
Aaron Wiggins,G,22023,1630598,22300340,"DEC 16, 2023",OKC @ DEN,W,12,2,2,1.0,0,0,0.0,2,2,1.0,1,1,2,1,0,0,0,1,6,-4,1,OKC,DEN,OKC,118,0.5,Turnovers,9,8,7,3
Aaron Wiggins,G,22023,1630598,22300058,"NOV 28, 2023",OKC @ MIN,L,16,3,4,0.75,2,2,1.0,0,0,0.0,1,2,3,1,0,0,0,2,8,-7,1,OKC,MIN,OKC,103,7.5,Points,12,11,9,4
Aaron Wiggins,G,22023,1630598,22300058,"NOV 28, 2023",OKC @ MIN,L,16,3,4,0.75,2,2,1.0,0,0,0.0,1,2,3,1,0,0,0,2,8,-7,1,OKC,MIN,OKC,103,10.5,Pts+Rebs,12,11,9,4
Aaron Wiggins,G,22023,1630598,22300058,"NOV 28, 2023",OKC @ MIN,L,16,3,4,0.75,2,2,1.0,0,0,0.0,1,2,3,1,0,0,0,2,8,-7,1,OKC,MIN,OKC,103,0.5,Turnovers,12,11,9,4
Aaron Wiggins,G,22023,1630598,22300155,"NOV 06, 2023",OKC vs. ATL,W,7,2,2,1.0,1,1,1.0,0,0,0.0,1,0,1,0,0,0,0,0,5,3,1,OKC,OKC,ATL,126,7.5,Points,6,6,5,1
Aaron Wiggins,G,22023,1630598,22300155,"NOV 06, 2023",OKC vs. ATL,W,7,2,2,1.0,1,1,1.0,0,0,0.0,1,0,1,0,0,0,0,0,5,3,1,OKC,OKC,ATL,126,10.5,Pts+Rebs,6,6,5,1
Aaron Wiggins,G,22023,1630598,22300155,"NOV 06, 2023",OKC vs. ATL,W,7,2,2,1.0,1,1,1.0,0,0,0.0,1,0,1,0,0,0,0,0,5,3,1,OKC,OKC,ATL,126,0.5,Turnovers,6,6,5,1
Aaron Wiggins,G,22023,1630598,22300005,"NOV 03, 2023",OKC vs. GSW,L,17,3,6,0.5,1,3,0.333,0,0,0.0,0,2,2,0,1,0,0,1,7,-3,1,OKC,OKC,GSW,139,7.5,Points,9,9,7,2
Aaron Wiggins,G,22023,1630598,22300005,"NOV 03, 2023",OKC vs. GSW,L,17,3,6,0.5,1,3,0.333,0,0,0.0,0,2,2,0,1,0,0,1,7,-3,1,OKC,OKC,GSW,139,10.5,Pts+Rebs,9,9,7,2
Aaron Wiggins,G,22023,1630598,22300005,"NOV 03, 2023",OKC vs. GSW,L,17,3,6,0.5,1,3,0.333,0,0,0.0,0,2,2,0,1,0,0,1,7,-3,1,OKC,OKC,GSW,139,0.5,Turnovers,9,9,7,2
Aaron Wiggins,G,22023,1630598,22300121,"NOV 01, 2023",OKC vs. NOP,L,14,4,5,0.8,0,1,0.0,2,2,1.0,0,4,4,2,0,0,2,5,10,14,1,OKC,OKC,NOP,106,7.5,Points,16,14,12,6
Aaron Wiggins,G,22023,1630598,22300121,"NOV 01, 2023",OKC vs. NOP,L,14,4,5,0.8,0,1,0.0,2,2,1.0,0,4,4,2,0,0,2,5,10,14,1,OKC,OKC,NOP,106,10.5,Pts+Rebs,16,14,12,6
Aaron Wiggins,G,22023,1630598,22300121,"NOV 01, 2023",OKC vs. NOP,L,14,4,5,0.8,0,1,0.0,2,2,1.0,0,4,4,2,0,0,2,5,10,14,1,OKC,OKC,NOP,106,0.5,Turnovers,16,14,12,6
Aaron Wiggins,G,22023,1630598,22300095,"OCT 29, 2023",OKC vs. DEN,L,10,2,3,0.667,0,1,0.0,1,2,0.5,0,0,0,0,0,0,0,0,5,-8,1,OKC,OKC,DEN,95,7.5,Points,5,5,5,0
Aaron Wiggins,G,22023,1630598,22300095,"OCT 29, 2023",OKC vs. DEN,L,10,2,3,0.667,0,1,0.0,1,2,0.5,0,0,0,0,0,0,0,0,5,-8,1,OKC,OKC,DEN,95,10.5,Pts+Rebs,5,5,5,0
Aaron Wiggins,G,22023,1630598,22300095,"OCT 29, 2023",OKC vs. DEN,L,10,2,3,0.667,0,1,0.0,1,2,0.5,0,0,0,0,0,0,0,0,5,-8,1,OKC,OKC,DEN,95,0.5,Turnovers,5,5,5,0
Aaron Wiggins,G,22023,1630598,22300081,"OCT 27, 2023",OKC @ CLE,W,11,0,0,0.0,0,0,0.0,0,0,0.0,0,0,0,1,0,1,1,0,0,2,1,OKC,CLE,OKC,108,7.5,Points,1,0,1,1
Aaron Wiggins,G,22023,1630598,22300081,"OCT 27, 2023",OKC @ CLE,W,11,0,0,0.0,0,0,0.0,0,0,0.0,0,0,0,1,0,1,1,0,0,2,1,OKC,CLE,OKC,108,10.5,Pts+Rebs,1,0,1,1
Aaron Wiggins,G,22023,1630598,22300081,"OCT 27, 2023",OKC @ CLE,W,11,0,0,0.0,0,0,0.0,0,0,0.0,0,0,0,1,0,1,1,0,0,2,1,OKC,CLE,OKC,108,0.5,Turnovers,1,0,1,1
Aaron Wiggins,G,22023,1630598,22300070,"OCT 25, 2023",OKC @ CHI,W,11,1,3,0.333,0,1,0.0,0,0,0.0,1,2,3,0,0,0,1,2,2,-4,1,OKC,CHI,OKC,124,7.5,Points,5,5,2,3
Aaron Wiggins,G,22023,1630598,22300070,"OCT 25, 2023",OKC @ CHI,W,11,1,3,0.333,0,1,0.0,0,0,0.0,1,2,3,0,0,0,1,2,2,-4,1,OKC,CHI,OKC,124,10.5,Pts+Rebs,5,5,2,3
Aaron Wiggins,G,22023,1630598,22300070,"OCT 25, 2023",OKC @ CHI,W,11,1,3,0.333,0,1,0.0,0,0,0.0,1,2,3,0,0,0,1,2,2,-4,1,OKC,CHI,OKC,124,0.5,Turnovers,5,5,2,3
Aaron Wiggins,G,22023,1630598,22300664,"JAN 29, 2024",OKC vs. MIN,L,20,3,3,1.0,1,1,1.0,0,0,0.0,1,3,4,1,1,0,1,1,7,-6,1,OKC,OKC,MIN,101,7.5,Points,12,11,8,5
Aaron Wiggins,G,22023,1630598,22300664,"JAN 29, 2024",OKC vs. MIN,L,20,3,3,1.0,1,1,1.0,0,0,0.0,1,3,4,1,1,0,1,1,7,-6,1,OKC,OKC,MIN,101,10.5,Pts+Rebs,12,11,8,5
Aaron Wiggins,G,22023,1630598,22300664,"JAN 29, 2024",OKC vs. MIN,L,20,3,3,1.0,1,1,1.0,0,0,0.0,1,3,4,1,1,0,1,1,7,-6,1,OKC,OKC,MIN,101,0.5,Turnovers,12,11,8,5
Aaron Wiggins,G,22023,1630598,22300654,"JAN 28, 2024",OKC @ DET,L,20,3,8,0.375,1,3,0.333,0,0,0.0,1,0,1,0,2,0,2,2,7,-11,1,OKC,DET,OKC,104,7.5,Points,8,8,7,1
Aaron Wiggins,G,22023,1630598,22300654,"JAN 28, 2024",OKC @ DET,L,20,3,8,0.375,1,3,0.333,0,0,0.0,1,0,1,0,2,0,2,2,7,-11,1,OKC,DET,OKC,104,10.5,Pts+Rebs,8,8,7,1
Aaron Wiggins,G,22023,1630598,22300654,"JAN 28, 2024",OKC @ DET,L,20,3,8,0.375,1,3,0.333,0,0,0.0,1,0,1,0,2,0,2,2,7,-11,1,OKC,DET,OKC,104,0.5,Turnovers,8,8,7,1
Aaron Wiggins,G,22023,1630598,22300640,"JAN 26, 2024",OKC @ NOP,W,17,3,5,0.6,2,2,1.0,0,0,0.0,0,2,2,1,0,0,1,1,8,11,1,OKC,NOP,OKC,107,7.5,Points,11,10,9,3
Aaron Wiggins,G,22023,1630598,22300640,"JAN 26, 2024",OKC @ NOP,W,17,3,5,0.6,2,2,1.0,0,0,0.0,0,2,2,1,0,0,1,1,8,11,1,OKC,NOP,OKC,107,10.5,Pts+Rebs,11,10,9,3
Aaron Wiggins,G,22023,1630598,22300640,"JAN 26, 2024",OKC @ NOP,W,17,3,5,0.6,2,2,1.0,0,0,0.0,0,2,2,1,0,0,1,1,8,11,1,OKC,NOP,OKC,107,0.5,Turnovers,11,10,9,3
Aaron Wiggins,G,22023,1630598,22300599,"JAN 20, 2024",OKC @ MIN,W,12,2,2,1.0,1,1,1.0,0,0,0.0,0,0,0,0,0,0,1,0,5,-14,1,OKC,MIN,OKC,102,7.5,Points,5,5,5,0
Aaron Wiggins,G,22023,1630598,22300599,"JAN 20, 2024",OKC @ MIN,W,12,2,2,1.0,1,1,1.0,0,0,0.0,0,0,0,0,0,0,1,0,5,-14,1,OKC,MIN,OKC,102,10.5,Pts+Rebs,5,5,5,0
Aaron Wiggins,G,22023,1630598,22300599,"JAN 20, 2024",OKC @ MIN,W,12,2,2,1.0,1,1,1.0,0,0,0.0,0,0,0,0,0,0,1,0,5,-14,1,OKC,MIN,OKC,102,0.5,Turnovers,5,5,5,0
Aaron Wiggins,G,22023,1630598,22300522,"JAN 10, 2024",OKC @ MIA,W,8,1,4,0.25,0,0,0.0,0,0,0.0,0,0,0,0,0,0,0,1,2,-7,1,OKC,MIA,OKC,128,7.5,Points,2,2,2,0
Aaron Wiggins,G,22023,1630598,22300522,"JAN 10, 2024",OKC @ MIA,W,8,1,4,0.25,0,0,0.0,0,0,0.0,0,0,0,0,0,0,0,1,2,-7,1,OKC,MIA,OKC,128,10.5,Pts+Rebs,2,2,2,0
Aaron Wiggins,G,22023,1630598,22300522,"JAN 10, 2024",OKC @ MIA,W,8,1,4,0.25,0,0,0.0,0,0,0.0,0,0,0,0,0,0,0,1,2,-7,1,OKC,MIA,OKC,128,0.5,Turnovers,2,2,2,0
Aaron Wiggins,G,22023,1630598,22300508,"JAN 08, 2024",OKC @ WAS,W,23,6,8,0.75,1,1,1.0,0,0,0.0,2,3,5,0,1,0,1,1,13,-2,1,OKC,WAS,OKC,136,7.5,Points,18,18,13,5
Aaron Wiggins,G,22023,1630598,22300508,"JAN 08, 2024",OKC @ WAS,W,23,6,8,0.75,1,1,1.0,0,0,0.0,2,3,5,0,1,0,1,1,13,-2,1,OKC,WAS,OKC,136,10.5,Pts+Rebs,18,18,13,5
Aaron Wiggins,G,22023,1630598,22300508,"JAN 08, 2024",OKC @ WAS,W,23,6,8,0.75,1,1,1.0,0,0,0.0,2,3,5,0,1,0,1,1,13,-2,1,OKC,WAS,OKC,136,0.5,Turnovers,18,18,13,5
Aaron Wiggins,G,22023,1630598,22300467,"JAN 03, 2024",OKC @ ATL,L,21,6,7,0.857,1,1,1.0,0,0,0.0,1,2,3,2,1,1,0,1,13,-7,1,OKC,ATL,OKC,138,7.5,Points,18,16,15,5
Aaron Wiggins,G,22023,1630598,22300467,"JAN 03, 2024",OKC @ ATL,L,21,6,7,0.857,1,1,1.0,0,0,0.0,1,2,3,2,1,1,0,1,13,-7,1,OKC,ATL,OKC,138,10.5,Pts+Rebs,18,16,15,5
Aaron Wiggins,G,22023,1630598,22300467,"JAN 03, 2024",OKC @ ATL,L,21,6,7,0.857,1,1,1.0,0,0,0.0,1,2,3,2,1,1,0,1,13,-7,1,OKC,ATL,OKC,138,0.5,Turnovers,18,16,15,5
Aaron Wiggins,G,22023,1630598,22300462,"JAN 02, 2024",OKC vs. BOS,W,13,1,3,0.333,0,1,0.0,2,2,1.0,0,1,1,1,1,0,0,1,4,4,1,OKC,OKC,BOS,127,7.5,Points,6,5,5,2
Aaron Wiggins,G,22023,1630598,22300462,"JAN 02, 2024",OKC vs. BOS,W,13,1,3,0.333,0,1,0.0,2,2,1.0,0,1,1,1,1,0,0,1,4,4,1,OKC,OKC,BOS,127,10.5,Pts+Rebs,6,5,5,2
Aaron Wiggins,G,22023,1630598,22300462,"JAN 02, 2024",OKC vs. BOS,W,13,1,3,0.333,0,1,0.0,2,2,1.0,0,1,1,1,1,0,0,1,4,4,1,OKC,OKC,BOS,127,0.5,Turnovers,6,5,5,2
Aaron Wiggins,G,22023,1630598,22300447,"DEC 31, 2023",OKC vs. BKN,W,11,0,0,0.0,0,0,0.0,0,0,0.0,1,4,5,0,0,0,2,0,0,3,1,OKC,OKC,BKN,124,7.5,Points,5,5,0,5
Aaron Wiggins,G,22023,1630598,22300447,"DEC 31, 2023",OKC vs. BKN,W,11,0,0,0.0,0,0,0.0,0,0,0.0,1,4,5,0,0,0,2,0,0,3,1,OKC,OKC,BKN,124,10.5,Pts+Rebs,5,5,0,5
Aaron Wiggins,G,22023,1630598,22300447,"DEC 31, 2023",OKC vs. BKN,W,11,0,0,0.0,0,0,0.0,0,0,0.0,1,4,5,0,0,0,2,0,0,3,1,OKC,OKC,BKN,124,0.5,Turnovers,5,5,0,5
Aaron Wiggins,G,22023,1630598,22300435,"DEC 29, 2023",OKC @ DEN,W,12,3,5,0.6,1,1,1.0,0,0,0.0,2,3,5,0,0,0,1,2,7,14,1,OKC,DEN,OKC,119,7.5,Points,12,12,7,5
Aaron Wiggins,G,22023,1630598,22300435,"DEC 29, 2023",OKC @ DEN,W,12,3,5,0.6,1,1,1.0,0,0,0.0,2,3,5,0,0,0,1,2,7,14,1,OKC,DEN,OKC,119,10.5,Pts+Rebs,12,12,7,5
Aaron Wiggins,G,22023,1630598,22300435,"DEC 29, 2023",OKC @ DEN,W,12,3,5,0.6,1,1,1.0,0,0,0.0,2,3,5,0,0,0,1,2,7,14,1,OKC,DEN,OKC,119,0.5,Turnovers,12,12,7,5
Aaron Wiggins,G,22023,1630598,22300411,"DEC 26, 2023",OKC vs. MIN,W,14,1,2,0.5,1,2,0.5,0,0,0.0,1,4,5,1,0,0,0,1,3,7,1,OKC,OKC,MIN,129,7.5,Points,9,8,4,6
Aaron Wiggins,G,22023,1630598,22300411,"DEC 26, 2023",OKC vs. MIN,W,14,1,2,0.5,1,2,0.5,0,0,0.0,1,4,5,1,0,0,0,1,3,7,1,OKC,OKC,MIN,129,10.5,Pts+Rebs,9,8,4,6
Aaron Wiggins,G,22023,1630598,22300411,"DEC 26, 2023",OKC vs. MIN,W,14,1,2,0.5,1,2,0.5,0,0,0.0,1,4,5,1,0,0,0,1,3,7,1,OKC,OKC,MIN,129,0.5,Turnovers,9,8,4,6
Aaron Wiggins,G,22023,1630598,22301212,"DEC 06, 2023",OKC @ HOU,L,15,4,4,1.0,0,0,0.0,3,4,0.75,0,1,1,0,1,0,0,3,11,-5,1,OKC,HOU,OKC,101,7.5,Points,12,12,11,1
Aaron Wiggins,G,22023,1630598,22301212,"DEC 06, 2023",OKC @ HOU,L,15,4,4,1.0,0,0,0.0,3,4,0.75,0,1,1,0,1,0,0,3,11,-5,1,OKC,HOU,OKC,101,10.5,Pts+Rebs,12,12,11,1
Aaron Wiggins,G,22023,1630598,22301212,"DEC 06, 2023",OKC @ HOU,L,15,4,4,1.0,0,0,0.0,3,4,0.75,0,1,1,0,1,0,0,3,11,-5,1,OKC,HOU,OKC,101,0.5,Turnovers,12,12,11,1
Aaron Wiggins,G,22023,1630598,22300271,"NOV 30, 2023",OKC vs. LAL,W,13,2,2,1.0,1,1,1.0,1,2,0.5,2,3,5,2,0,0,0,2,6,5,1,OKC,OKC,LAL,133,7.5,Points,13,11,8,7
Aaron Wiggins,G,22023,1630598,22300271,"NOV 30, 2023",OKC vs. LAL,W,13,2,2,1.0,1,1,1.0,1,2,0.5,2,3,5,2,0,0,0,2,6,5,1,OKC,OKC,LAL,133,10.5,Pts+Rebs,13,11,8,7
Aaron Wiggins,G,22023,1630598,22300271,"NOV 30, 2023",OKC vs. LAL,W,13,2,2,1.0,1,1,1.0,1,2,0.5,2,3,5,2,0,0,0,2,6,5,1,OKC,OKC,LAL,133,0.5,Turnovers,13,11,8,7
Aaron Wiggins,G,22023,1630598,22300234,"NOV 22, 2023",OKC vs. CHI,W,11,2,2,1.0,0,0,0.0,2,2,1.0,0,4,4,1,0,0,1,1,6,2,1,OKC,OKC,CHI,116,7.5,Points,11,10,7,5
Aaron Wiggins,G,22023,1630598,22300234,"NOV 22, 2023",OKC vs. CHI,W,11,2,2,1.0,0,0,0.0,2,2,1.0,0,4,4,1,0,0,1,1,6,2,1,OKC,OKC,CHI,116,10.5,Pts+Rebs,11,10,7,5
Aaron Wiggins,G,22023,1630598,22300234,"NOV 22, 2023",OKC vs. CHI,W,11,2,2,1.0,0,0,0.0,2,2,1.0,0,4,4,1,0,0,1,1,6,2,1,OKC,OKC,CHI,116,0.5,Turnovers,11,10,7,5
Aaron Wiggins,G,22023,1630598,22300207,"NOV 18, 2023",OKC @ GSW,W,6,0,0,0.0,0,0,0.0,0,0,0.0,0,2,2,1,0,0,2,0,0,2,1,OKC,GSW,OKC,130,7.5,Points,3,2,1,3
Aaron Wiggins,G,22023,1630598,22300207,"NOV 18, 2023",OKC @ GSW,W,6,0,0,0.0,0,0,0.0,0,0,0.0,0,2,2,1,0,0,2,0,0,2,1,OKC,GSW,OKC,130,10.5,Pts+Rebs,3,2,1,3
Aaron Wiggins,G,22023,1630598,22300207,"NOV 18, 2023",OKC @ GSW,W,6,0,0,0.0,0,0,0.0,0,0,0.0,0,2,2,1,0,0,2,0,0,2,1,OKC,GSW,OKC,130,0.5,Turnovers,3,2,1,3
Aaron Wiggins,G,22023,1630598,22300201,"NOV 16, 2023",OKC @ GSW,W,11,2,3,0.667,0,1,0.0,1,2,0.5,0,2,2,1,0,0,0,0,5,3,1,OKC,GSW,OKC,128,7.5,Points,8,7,6,3
Aaron Wiggins,G,22023,1630598,22300201,"NOV 16, 2023",OKC @ GSW,W,11,2,3,0.667,0,1,0.0,1,2,0.5,0,2,2,1,0,0,0,0,5,3,1,OKC,GSW,OKC,128,10.5,Pts+Rebs,8,7,6,3
Aaron Wiggins,G,22023,1630598,22300201,"NOV 16, 2023",OKC @ GSW,W,11,2,3,0.667,0,1,0.0,1,2,0.5,0,2,2,1,0,0,0,0,5,3,1,OKC,GSW,OKC,128,0.5,Turnovers,8,7,6,3
Aaron Wiggins,G,22023,1630598,22300021,"NOV 14, 2023",OKC vs. SAS,W,5,1,1,1.0,1,1,1.0,0,0,0.0,0,0,0,1,1,0,0,0,3,-2,1,OKC,OKC,SAS,123,7.5,Points,4,3,4,1
Aaron Wiggins,G,22023,1630598,22300021,"NOV 14, 2023",OKC vs. SAS,W,5,1,1,1.0,1,1,1.0,0,0,0.0,0,0,0,1,1,0,0,0,3,-2,1,OKC,OKC,SAS,123,10.5,Pts+Rebs,4,3,4,1
Aaron Wiggins,G,22023,1630598,22300021,"NOV 14, 2023",OKC vs. SAS,W,5,1,1,1.0,1,1,1.0,0,0,0.0,0,0,0,1,1,0,0,0,3,-2,1,OKC,OKC,SAS,123,0.5,Turnovers,4,3,4,1
Aaron Wiggins,G,22023,1630598,22300581,"JAN 18, 2024",OKC @ UTA,W,22,1,3,0.333,0,1,0.0,2,2,1.0,0,2,2,5,0,1,0,3,4,5,1,OKC,UTA,OKC,134,7.5,Points,11,6,9,7
Aaron Wiggins,G,22023,1630598,22300581,"JAN 18, 2024",OKC @ UTA,W,22,1,3,0.333,0,1,0.0,2,2,1.0,0,2,2,5,0,1,0,3,4,5,1,OKC,UTA,OKC,134,10.5,Pts+Rebs,11,6,9,7
Aaron Wiggins,G,22023,1630598,22300581,"JAN 18, 2024",OKC @ UTA,W,22,1,3,0.333,0,1,0.0,2,2,1.0,0,2,2,5,0,1,0,3,4,5,1,OKC,UTA,OKC,134,0.5,Turnovers,11,6,9,7
Jamal Cain,F,22023,1631288,22300489,"JAN 05, 2024",MIA @ PHX,L,5,2,5,0.4,1,1,1.0,2,2,1.0,2,0,2,0,0,0,0,0,7,2,1,MIA,PHX,MIA,97,,,9,9,7,2
Jamal Cain,F,22023,1631288,22300475,"JAN 03, 2024",MIA @ LAL,W,1,0,0,0.0,0,0,0.0,0,0,0.0,0,0,0,0,0,0,0,0,0,0,1,MIA,LAL,MIA,110,,,0,0,0,0
Jamal Cain,F,22023,1631288,22300458,"JAN 01, 2024",MIA @ LAC,L,35,4,12,0.333,1,4,0.25,0,0,0.0,3,0,3,1,1,1,0,3,9,-22,1,MIA,LAC,MIA,104,,,13,12,10,4
Jamal Cain,F,22023,1631288,22300439,"DEC 30, 2023",MIA @ UTA,L,11,3,4,0.75,0,0,0.0,0,0,0.0,0,1,1,1,0,0,1,2,6,-8,1,MIA,UTA,MIA,109,,,8,7,7,2
Jamal Cain,F,22023,1631288,22300426,"DEC 28, 2023",MIA @ GSW,W,28,7,14,0.5,2,5,0.4,2,2,1.0,1,5,6,0,2,0,1,1,18,7,1,MIA,GSW,MIA,114,,,24,24,18,6
Jamal Cain,F,22023,1631288,22300404,"DEC 25, 2023",MIA vs. PHI,W,17,0,2,0.0,0,0,0.0,3,4,0.75,1,4,5,0,0,1,0,4,3,16,1,MIA,MIA,PHI,119,,,8,8,3,5
Jamal Cain,F,22023,1631288,22300056,"NOV 28, 2023",MIA vs. MIL,L,11,1,2,0.5,1,2,0.5,2,4,0.5,0,0,0,0,0,0,0,0,5,3,1,MIA,MIA,MIL,124,,,5,5,5,0
Jamal Cain,F,22023,1631288,22300175,"NOV 11, 2023",MIA @ ATL,W,0,0,0,0.0,0,0,0.0,0,0,0.0,0,0,0,0,0,0,0,0,0,0,1,MIA,ATL,MIA,117,,,0,0,0,0
Jamal Cain,F,22023,1631288,22300093,"OCT 28, 2023",MIA @ MIN,L,25,4,8,0.5,0,3,0.0,0,0,0.0,3,2,5,0,2,0,0,1,8,-23,1,MIA,MIN,MIA,90,,,13,13,8,5
Jamal Cain,F,22023,1631288,22300080,"OCT 27, 2023",MIA @ BOS,L,4,0,1,0.0,0,1,0.0,0,0,0.0,0,1,1,0,1,0,1,1,0,-5,1,MIA,BOS,MIA,111,,,1,1,0,1
Jamal Cain,F,22023,1631288,22300320,"DEC 14, 2023",MIA vs. CHI,L,8,0,0,0.0,0,0,0.0,3,4,0.75,0,0,0,0,0,1,0,1,3,5,1,MIA,MIA,CHI,116,,,3,3,3,0
Jamal Cain,F,22023,1631288,22300312,"DEC 13, 2023",MIA vs. CHA,W,29,5,12,0.417,2,6,0.333,2,2,1.0,2,1,3,1,2,1,0,0,14,-6,1,MIA,MIA,CHA,115,,,18,17,15,4
Jamal Cain,F,22023,1631288,22300240,"NOV 25, 2023",MIA @ BKN,L,29,3,6,0.5,1,3,0.333,0,1,0.0,0,3,3,0,1,0,1,1,7,7,1,MIA,BKN,MIA,97,,,10,10,7,3
Jamal Cain,F,22023,1631288,22300284,"DEC 02, 2023",MIA vs. IND,L,5,0,0,0.0,0,0,0.0,0,0,0.0,0,0,0,0,0,0,0,2,0,1,1,MIA,MIA,IND,129,,,0,0,0,0
Matisse Thybulle,F,22023,1629680,22300758,"FEB 10, 2024",POR vs. NOP,L,29,2,6,0.333,1,5,0.2,2,2,1.0,1,1,2,1,2,0,1,0,7,-13,1,POR,POR,NOP,75,,,10,9,8,3
Matisse Thybulle,F,22023,1629680,22300712,"FEB 04, 2024",POR @ DEN,L,34,2,7,0.286,1,5,0.2,1,2,0.5,0,1,1,3,3,0,0,1,6,4,1,POR,DEN,POR,103,,,10,7,9,4
Matisse Thybulle,F,22023,1629680,22300697,"FEB 02, 2024",POR @ DEN,L,23,1,5,0.2,1,4,0.25,0,0,0.0,0,1,1,0,1,1,0,2,3,5,1,POR,DEN,POR,108,,,4,4,3,1
Matisse Thybulle,F,22023,1629680,22300683,"JAN 31, 2024",POR vs. MIL,W,19,2,6,0.333,2,6,0.333,0,0,0.0,1,2,3,1,1,0,0,2,6,13,1,POR,POR,MIL,119,,,10,9,7,4
Matisse Thybulle,F,22023,1629680,22300668,"JAN 29, 2024",POR vs. PHI,W,19,1,6,0.167,1,5,0.2,0,0,0.0,0,1,1,0,0,0,1,0,3,0,1,POR,POR,PHI,128,,,4,4,3,1
Matisse Thybulle,F,22023,1629680,22300656,"JAN 28, 2024",POR vs. CHI,L,32,3,5,0.6,1,3,0.333,0,0,0.0,0,2,2,1,0,1,3,3,7,-3,1,POR,POR,CHI,96,,,10,9,8,3
Matisse Thybulle,F,22023,1629680,22300641,"JAN 26, 2024",POR @ SAS,L,27,2,5,0.4,1,4,0.25,0,0,0.0,1,0,1,4,2,0,1,4,5,-6,1,POR,SAS,POR,98,,,10,6,9,5
Matisse Thybulle,F,22023,1629680,22300623,"JAN 24, 2024",POR @ HOU,W,22,5,7,0.714,3,4,0.75,0,0,0.0,1,3,4,1,3,0,1,3,13,-9,1,POR,HOU,POR,137,,,18,17,14,5
Matisse Thybulle,F,22023,1629680,22300617,"JAN 23, 2024",POR @ OKC,L,20,3,6,0.5,2,5,0.4,0,0,0.0,1,2,3,1,1,1,0,2,8,8,1,POR,OKC,POR,109,,,12,11,9,4
Matisse Thybulle,F,22023,1629680,22300605,"JAN 21, 2024",POR @ LAL,L,12,0,1,0.0,0,1,0.0,0,0,0.0,0,0,0,2,3,0,0,0,0,-8,1,POR,LAL,POR,108,,,2,0,2,2
Matisse Thybulle,F,22023,1629680,22300590,"JAN 19, 2024",POR vs. IND,W,28,1,2,0.5,0,1,0.0,2,2,1.0,0,1,1,2,1,2,0,3,4,-14,1,POR,POR,IND,118,,,7,5,6,3
Matisse Thybulle,F,22023,1629680,22300399,"DEC 23, 2023",POR @ GSW,L,16,2,6,0.333,1,5,0.2,0,0,0.0,1,1,2,2,1,0,0,0,5,-14,1,POR,GSW,POR,106,,,9,7,7,4
Matisse Thybulle,F,22023,1629680,22300381,"DEC 21, 2023",POR vs. WAS,L,30,0,3,0.0,0,2,0.0,0,0,0.0,2,2,4,2,3,3,0,2,0,19,1,POR,POR,WAS,117,,,6,4,2,6
Matisse Thybulle,F,22023,1629680,22300363,"DEC 19, 2023",POR vs. PHX,W,21,2,3,0.667,2,3,0.667,2,2,1.0,0,1,1,0,3,1,0,0,8,17,1,POR,POR,PHX,109,,,9,9,8,1
Matisse Thybulle,F,22023,1629680,22300348,"DEC 17, 2023",POR vs. GSW,L,18,1,4,0.25,1,4,0.25,0,0,0.0,1,3,4,1,3,2,0,1,3,4,1,POR,POR,GSW,114,,,8,7,4,5
Matisse Thybulle,F,22023,1629680,22300341,"DEC 16, 2023",POR vs. DAL,L,19,2,6,0.333,1,4,0.25,0,0,0.0,1,3,4,0,2,1,1,0,5,-16,1,POR,POR,DAL,120,,,9,9,5,4
Matisse Thybulle,F,22023,1629680,22300323,"DEC 14, 2023",POR vs. UTA,L,17,1,5,0.2,1,4,0.25,0,0,0.0,0,3,3,2,1,0,0,1,3,-24,1,POR,POR,UTA,114,,,8,6,5,5
Matisse Thybulle,F,22023,1629680,22300289,"DEC 02, 2023",POR @ UTA,L,33,2,5,0.4,2,4,0.5,0,0,0.0,0,3,3,2,1,2,0,1,6,9,1,POR,UTA,POR,113,,,11,9,8,5
Matisse Thybulle,F,22023,1629680,22300265,"NOV 30, 2023",POR @ CLE,W,24,4,8,0.5,2,5,0.4,0,0,0.0,1,1,2,0,1,0,0,1,10,10,1,POR,CLE,POR,103,,,12,12,10,2
Matisse Thybulle,F,22023,1629680,22300254,"NOV 27, 2023",POR @ IND,W,29,0,2,0.0,0,2,0.0,0,0,0.0,0,1,1,1,1,1,2,3,0,10,1,POR,IND,POR,114,,,2,1,1,2
Matisse Thybulle,F,22023,1629680,22300245,"NOV 26, 2023",POR @ MIL,L,26,1,4,0.25,1,4,0.25,2,2,1.0,0,1,1,1,4,1,2,1,5,4,1,POR,MIL,POR,102,,,7,6,6,2
Matisse Thybulle,F,22023,1629680,22300041,"NOV 21, 2023",POR @ PHX,L,22,0,2,0.0,0,2,0.0,0,0,0.0,1,1,2,0,1,1,0,1,0,4,1,POR,PHX,POR,107,,,2,2,0,2
Matisse Thybulle,F,22023,1629680,22300215,"NOV 19, 2023",POR vs. OKC,L,19,1,3,0.333,0,2,0.0,0,0,0.0,0,1,1,2,2,0,0,0,2,-27,1,POR,POR,OKC,89,,,5,3,4,3
Matisse Thybulle,F,22023,1629680,22300036,"NOV 17, 2023",POR vs. LAL,L,24,2,3,0.667,1,2,0.5,0,0,0.0,1,3,4,1,2,0,2,1,5,-10,1,POR,POR,LAL,95,,,10,9,6,5
Matisse Thybulle,F,22023,1629680,22300199,"NOV 15, 2023",POR vs. CLE,L,26,5,6,0.833,3,4,0.75,0,0,0.0,0,3,3,3,3,1,0,1,13,-4,1,POR,POR,CLE,93,,,19,16,16,6
Matisse Thybulle,F,22023,1629680,22300023,"NOV 14, 2023",POR @ UTA,L,22,2,5,0.4,2,5,0.4,0,0,0.0,0,2,2,1,0,0,0,1,6,-13,1,POR,UTA,POR,99,,,9,8,7,3
Matisse Thybulle,F,22023,1629680,22300187,"NOV 12, 2023",POR @ LAL,L,20,5,9,0.556,4,8,0.5,0,0,0.0,0,2,2,3,1,2,0,2,14,-6,1,POR,LAL,POR,104,,,19,16,17,5
Matisse Thybulle,F,22023,1629680,22300170,"NOV 08, 2023",POR @ SAC,L,34,4,8,0.5,1,4,0.25,4,5,0.8,1,1,2,1,4,0,2,1,13,-2,1,POR,SAC,POR,118,,,16,15,14,3
Matisse Thybulle,F,22023,1629680,22300144,"NOV 05, 2023",POR vs. MEM,L,19,2,3,0.667,2,3,0.667,0,0,0.0,0,3,3,1,1,2,1,1,6,0,1,POR,POR,MEM,100,,,10,9,7,4
Matisse Thybulle,F,22023,1629680,22300007,"NOV 03, 2023",POR vs. MEM,W,19,2,4,0.5,1,3,0.333,0,0,0.0,0,0,0,0,0,2,0,1,5,-3,1,POR,POR,MEM,115,,,5,5,5,0
Matisse Thybulle,F,22023,1629680,22300115,"NOV 01, 2023",POR @ DET,W,17,0,3,0.0,0,3,0.0,0,0,0.0,0,1,1,1,1,0,0,1,0,-3,1,POR,DET,POR,110,,,2,1,1,2
Matisse Thybulle,F,22023,1629680,22300105,"OCT 30, 2023",POR @ TOR,W,19,3,4,0.75,3,4,0.75,0,0,0.0,0,0,0,2,0,0,0,1,9,-5,1,POR,TOR,POR,99,,,11,9,11,2
Matisse Thybulle,F,22023,1629680,22300098,"OCT 29, 2023",POR @ PHI,L,11,1,3,0.333,0,2,0.0,0,0,0.0,0,0,0,0,0,0,0,1,2,-14,1,POR,PHI,POR,98,,,2,2,2,0
Matisse Thybulle,F,22023,1629680,22300086,"OCT 27, 2023",POR vs. ORL,L,17,0,1,0.0,0,1,0.0,0,0,0.0,0,2,2,0,1,1,0,2,0,-15,1,POR,POR,ORL,97,,,2,2,0,2
Matisse Thybulle,F,22023,1629680,22300074,"OCT 25, 2023",POR @ LAC,L,20,3,7,0.429,2,6,0.333,0,0,0.0,1,0,1,1,1,0,2,0,8,-12,1,POR,LAC,POR,111,,,10,9,9,2
Matisse Thybulle,F,22023,1629680,22300578,"JAN 17, 2024",POR vs. BKN,W,21,1,4,0.25,1,3,0.333,0,0,0.0,0,0,0,3,0,0,0,3,3,-3,1,POR,POR,BKN,103,,,6,3,6,3
Matisse Thybulle,F,22023,1629680,22300538,"JAN 12, 2024",POR @ MIN,L,14,1,3,0.333,1,2,0.5,0,0,0.0,0,1,1,0,2,0,0,1,3,-14,1,POR,MIN,POR,91,,,4,4,3,1
Matisse Thybulle,F,22023,1629680,22300514,"JAN 09, 2024",POR @ NYK,L,12,0,1,0.0,0,1,0.0,0,0,0.0,0,1,1,0,1,1,0,0,0,-12,1,POR,NYK,POR,80,,,1,1,0,1
Matisse Thybulle,F,22023,1629680,22300487,"JAN 05, 2024",POR @ DAL,L,14,0,2,0.0,0,1,0.0,0,0,0.0,0,2,2,0,1,1,0,0,0,-14,1,POR,DAL,POR,103,,,2,2,0,2
Matisse Thybulle,F,22023,1629680,22300472,"JAN 03, 2024",POR @ DAL,L,23,4,6,0.667,4,6,0.667,0,0,0.0,0,2,2,1,1,0,0,4,12,-2,1,POR,DAL,POR,97,,,15,14,13,3
Matisse Thybulle,F,22023,1629680,22300456,"JAN 01, 2024",POR @ PHX,L,29,1,5,0.2,1,4,0.25,0,0,0.0,1,3,4,0,2,2,0,2,3,-10,1,POR,PHX,POR,84,,,7,7,3,4
Matisse Thybulle,F,22023,1629680,22300437,"DEC 29, 2023",POR vs. SAS,W,27,3,6,0.5,1,4,0.25,0,0,0.0,0,1,1,0,1,2,1,1,7,10,1,POR,POR,SAS,132,,,8,8,7,1
Matisse Thybulle,F,22023,1629680,22300427,"DEC 28, 2023",POR vs. SAS,L,28,1,7,0.143,1,7,0.143,1,2,0.5,0,2,2,1,2,0,0,1,4,-6,1,POR,POR,SAS,98,,,7,6,5,3
Matisse Thybulle,F,22023,1629680,22300413,"DEC 26, 2023",POR vs. SAC,W,26,2,5,0.4,2,4,0.5,0,0,0.0,1,3,4,4,2,2,1,3,6,26,1,POR,POR,SAC,130,,,14,10,10,8
Matisse Thybulle,F,22023,1629680,22301214,"DEC 06, 2023",POR @ GSW,L,31,3,6,0.5,3,5,0.6,0,0,0.0,0,1,1,1,3,1,1,1,9,-2,1,POR,GSW,POR,106,,,11,10,10,2
Matisse Thybulle,F,22023,1629680,22300237,"NOV 22, 2023",POR vs. UTA,W,32,5,9,0.556,3,6,0.5,0,1,0.0,1,0,1,2,3,2,3,2,13,24,1,POR,POR,UTA,121,,,16,14,15,3
Matisse Thybulle,F,22023,1629680,22300304,"DEC 11, 2023",POR @ LAC,L,31,4,6,0.667,3,5,0.6,0,0,0.0,0,1,1,0,1,0,0,3,11,-9,1,POR,LAC,POR,127,,,12,12,11,1
Matisse Thybulle,F,22023,1629680,22300741,"FEB 08, 2024",POR vs. DET,L,38,1,6,0.167,0,2,0.0,0,0,0.0,0,1,1,7,5,2,0,5,2,4,1,POR,POR,DET,118,,,10,3,9,8
Matisse Thybulle,F,22023,1629680,22300529,"JAN 11, 2024",POR @ OKC,L,19,1,5,0.2,0,4,0.0,2,2,1.0,0,0,0,1,1,0,0,1,4,-10,1,POR,OKC,POR,77,,,5,4,5,1
Matisse Thybulle,F,22023,1629680,22301226,"DEC 08, 2023",POR vs. DAL,L,36,3,7,0.429,3,5,0.6,0,0,0.0,3,5,8,1,3,1,2,0,9,-11,1,POR,POR,DAL,112,,,18,17,10,9
Ochai Agbaji,G,22023,1630534,22300756,"FEB 10, 2024",TOR vs. CLE,L,19,3,9,0.333,0,5,0.0,2,3,0.667,0,2,2,0,0,0,1,3,8,-7,1,TOR,TOR,CLE,95,,,10,10,8,2
Ochai Agbaji,G,22023,1630534,22300711,"FEB 04, 2024",UTA vs. MIL,W,10,1,2,0.5,1,2,0.5,0,0,0.0,0,1,1,1,0,0,0,0,3,-8,1,UTA,UTA,MIL,123,,,5,4,4,2
Ochai Agbaji,G,22023,1630534,22300686,"FEB 01, 2024",UTA vs. PHI,L,17,0,3,0.0,0,0,0.0,0,0,0.0,0,1,1,1,0,0,1,2,0,-5,1,UTA,UTA,PHI,124,,,2,1,1,2
Ochai Agbaji,G,22023,1630534,22300671,"JAN 30, 2024",UTA @ NYK,L,13,1,1,1.0,1,1,1.0,0,0,0.0,0,1,1,0,1,0,0,0,3,4,1,UTA,NYK,UTA,103,,,4,4,3,1
Ochai Agbaji,G,22023,1630534,22300660,"JAN 29, 2024",UTA @ BKN,L,21,2,5,0.4,0,2,0.0,0,0,0.0,0,3,3,2,0,2,0,0,4,-14,1,UTA,BKN,UTA,114,,,9,7,6,5
Ochai Agbaji,G,22023,1630534,22300647,"JAN 27, 2024",UTA @ CHA,W,16,2,5,0.4,1,3,0.333,0,0,0.0,1,1,2,2,0,0,0,0,5,-4,1,UTA,CHA,UTA,134,,,9,7,7,4
Ochai Agbaji,G,22023,1630534,22300628,"JAN 25, 2024",UTA @ WAS,W,20,0,3,0.0,0,1,0.0,0,0,0.0,0,4,4,0,0,1,1,1,0,-2,1,UTA,WAS,UTA,123,,,4,4,0,4
Ochai Agbaji,G,22023,1630534,22300616,"JAN 23, 2024",UTA @ NOP,L,23,2,4,0.5,1,1,1.0,0,0,0.0,1,1,2,0,0,0,0,0,5,-10,1,UTA,NOP,UTA,124,,,7,7,5,2
Ochai Agbaji,G,22023,1630534,22300598,"JAN 20, 2024",UTA @ HOU,L,13,0,1,0.0,0,1,0.0,0,0,0.0,0,0,0,0,0,3,1,0,0,-15,1,UTA,HOU,UTA,126,,,0,0,0,0
Ochai Agbaji,G,22023,1630534,22300581,"JAN 18, 2024",UTA vs. OKC,L,14,1,1,1.0,0,0,0.0,2,3,0.667,0,1,1,1,2,0,2,1,4,-8,1,UTA,UTA,OKC,129,,,6,5,5,2
Ochai Agbaji,G,22023,1630534,22300564,"JAN 15, 2024",UTA vs. IND,W,24,1,4,0.25,0,1,0.0,2,2,1.0,0,4,4,0,0,1,1,2,4,5,1,UTA,UTA,IND,132,,,8,8,4,4
Ochai Agbaji,G,22023,1630534,22300549,"JAN 13, 2024",UTA vs. LAL,W,18,1,5,0.2,0,2,0.0,0,0,0.0,1,3,4,0,0,1,0,0,2,-9,1,UTA,UTA,LAL,132,,,6,6,2,4
Ochai Agbaji,G,22023,1630534,22300540,"JAN 12, 2024",UTA vs. TOR,W,22,3,8,0.375,2,7,0.286,0,0,0.0,1,4,5,1,0,2,0,1,8,17,1,UTA,UTA,TOR,145,,,14,13,9,6
Ochai Agbaji,G,22023,1630534,22300524,"JAN 10, 2024",UTA vs. DEN,W,13,0,2,0.0,0,1,0.0,0,0,0.0,1,3,4,1,1,2,0,1,0,1,1,UTA,UTA,DEN,124,,,5,4,1,5
Ochai Agbaji,G,22023,1630534,22300510,"JAN 08, 2024",UTA @ MIL,W,15,1,2,0.5,0,1,0.0,0,0,0.0,0,1,1,0,0,0,0,1,2,11,1,UTA,MIL,UTA,132,,,3,3,2,1
Ochai Agbaji,G,22023,1630534,22300495,"JAN 06, 2024",UTA @ PHI,W,13,0,2,0.0,0,2,0.0,0,0,0.0,1,2,3,1,0,0,1,1,0,3,1,UTA,PHI,UTA,120,,,4,3,1,4
Ochai Agbaji,G,22023,1630534,22300479,"JAN 05, 2024",UTA @ BOS,L,22,2,5,0.4,0,3,0.0,1,1,1.0,1,3,4,1,0,0,2,4,5,-12,1,UTA,BOS,UTA,97,,,10,9,6,5
Ochai Agbaji,G,22023,1630534,22300474,"JAN 03, 2024",UTA vs. DET,W,13,1,1,1.0,1,1,1.0,0,0,0.0,0,1,1,2,2,0,1,2,3,-6,1,UTA,UTA,DET,154,,,6,4,5,3
Ochai Agbaji,G,22023,1630534,22300457,"JAN 01, 2024",UTA vs. DAL,W,19,1,6,0.167,0,5,0.0,0,0,0.0,1,1,2,0,0,0,1,1,2,10,1,UTA,UTA,DAL,127,,,4,4,2,2
Ochai Agbaji,G,22023,1630534,22300439,"DEC 30, 2023",UTA vs. MIA,W,15,0,4,0.0,0,3,0.0,0,2,0.0,0,0,0,0,0,1,0,1,0,1,1,UTA,UTA,MIA,117,,,0,0,0,0
Ochai Agbaji,G,22023,1630534,22300424,"DEC 28, 2023",UTA @ NOP,L,16,1,2,0.5,0,0,0.0,0,0,0.0,0,1,1,2,0,0,2,0,2,-4,1,UTA,NOP,UTA,105,,,5,3,4,3
Ochai Agbaji,G,22023,1630534,22300412,"DEC 26, 2023",UTA @ SAS,W,19,4,6,0.667,2,4,0.5,0,0,0.0,1,3,4,1,0,0,0,0,10,18,1,UTA,SAS,UTA,130,,,15,14,11,5
Ochai Agbaji,G,22023,1630534,22300395,"DEC 23, 2023",UTA @ TOR,W,24,3,5,0.6,1,3,0.333,2,2,1.0,0,3,3,0,0,1,1,2,9,8,1,UTA,TOR,UTA,126,,,12,12,9,3
Ochai Agbaji,G,22023,1630534,22300374,"DEC 21, 2023",UTA @ DET,W,33,7,12,0.583,2,6,0.333,2,2,1.0,0,2,2,0,2,0,0,4,18,10,1,UTA,DET,UTA,119,,,20,20,18,2
Ochai Agbaji,G,22023,1630534,22300364,"DEC 20, 2023",UTA @ CLE,L,16,1,1,1.0,1,1,1.0,0,0,0.0,1,2,3,1,0,1,0,1,3,-17,1,UTA,CLE,UTA,116,,,7,6,4,4
Ochai Agbaji,G,22023,1630534,22300357,"DEC 18, 2023",UTA vs. BKN,W,23,6,10,0.6,1,5,0.2,0,0,0.0,1,2,3,2,1,1,2,1,13,13,1,UTA,UTA,BKN,125,,,18,16,15,5
Ochai Agbaji,G,22023,1630534,22300342,"DEC 16, 2023",UTA @ SAC,L,23,2,7,0.286,1,3,0.333,0,0,0.0,3,1,4,0,1,0,0,2,5,2,1,UTA,SAC,UTA,104,,,9,9,5,4
Ochai Agbaji,G,22023,1630534,22300323,"DEC 14, 2023",UTA @ POR,W,26,7,12,0.583,2,6,0.333,0,0,0.0,0,3,3,2,0,0,1,3,16,-17,1,UTA,POR,UTA,122,,,21,19,18,5
Ochai Agbaji,G,22023,1630534,22300318,"DEC 13, 2023",UTA vs. NYK,W,30,2,12,0.167,1,5,0.2,0,0,0.0,3,1,4,2,0,0,0,2,5,16,1,UTA,UTA,NYK,117,,,11,9,7,6
Ochai Agbaji,G,22023,1630534,22300302,"DEC 11, 2023",UTA @ OKC,L,22,1,4,0.25,0,1,0.0,0,0,0.0,0,1,1,2,3,1,1,1,2,-19,1,UTA,OKC,UTA,120,,,5,3,4,3
Ochai Agbaji,G,22023,1630534,22301225,"DEC 08, 2023",UTA vs. LAC,L,17,2,4,0.5,1,2,0.5,0,0,0.0,0,1,1,0,0,0,1,2,5,5,1,UTA,UTA,LAC,103,,,6,6,5,1
Ochai Agbaji,G,22023,1630534,22301213,"DEC 06, 2023",UTA @ DAL,L,30,7,14,0.5,5,10,0.5,2,2,1.0,0,0,0,0,2,0,0,1,21,-47,1,UTA,DAL,UTA,97,,,21,21,21,0
Ochai Agbaji,G,22023,1630534,22300289,"DEC 02, 2023",UTA vs. POR,W,26,3,4,0.75,0,0,0.0,0,0,0.0,0,2,2,0,0,0,2,2,6,8,1,UTA,UTA,POR,118,,,8,8,6,2
Ochai Agbaji,G,22023,1630534,22300270,"NOV 30, 2023",UTA @ MIN,L,36,5,10,0.5,3,6,0.5,0,0,0.0,3,3,6,3,4,0,1,1,13,-3,1,UTA,MIN,UTA,90,,,22,19,16,9
Ochai Agbaji,G,22023,1630534,22300261,"NOV 29, 2023",UTA @ MEM,L,21,2,5,0.4,1,4,0.25,0,0,0.0,1,3,4,3,0,0,1,1,5,-1,1,UTA,MEM,UTA,91,,,12,9,8,7
Ochai Agbaji,G,22023,1630534,22300256,"NOV 27, 2023",UTA vs. NOP,W,16,4,7,0.571,3,6,0.5,1,1,1.0,0,0,0,0,0,0,0,1,12,5,1,UTA,UTA,NOP,114,,,12,12,12,0
Ochai Agbaji,G,22023,1630534,22300243,"NOV 25, 2023",UTA vs. NOP,W,22,3,8,0.375,2,7,0.286,1,1,1.0,0,1,1,3,3,0,1,1,9,5,1,UTA,UTA,NOP,105,,,13,10,12,4
Ochai Agbaji,G,22023,1630534,22300237,"NOV 22, 2023",UTA @ POR,L,14,4,4,1.0,1,1,1.0,0,0,0.0,0,0,0,1,0,1,1,0,9,-9,1,UTA,POR,UTA,105,,,10,9,10,1
Ochai Agbaji,G,22023,1630534,22300042,"NOV 21, 2023",UTA @ LAL,L,17,0,5,0.0,0,3,0.0,0,0,0.0,1,2,3,0,0,0,1,2,0,-16,1,UTA,LAL,UTA,99,,,3,3,0,3
Ochai Agbaji,G,22023,1630534,22300214,"NOV 19, 2023",UTA vs. PHX,L,34,1,1,1.0,1,1,1.0,0,0,0.0,2,1,3,1,1,1,1,4,3,-14,1,UTA,UTA,PHX,137,,,7,6,4,4
Ochai Agbaji,G,22023,1630534,22300035,"NOV 17, 2023",UTA vs. PHX,L,25,3,4,0.75,2,2,1.0,0,0,0.0,2,3,5,0,0,3,0,3,8,4,1,UTA,UTA,PHX,128,,,13,13,8,5
Ochai Agbaji,G,22023,1630534,22300023,"NOV 14, 2023",UTA vs. POR,W,26,2,7,0.286,0,2,0.0,2,2,1.0,4,4,8,1,2,1,0,1,6,5,1,UTA,UTA,POR,115,,,15,14,7,9
Ochai Agbaji,G,22023,1630534,22300012,"NOV 10, 2023",UTA @ MEM,W,30,6,8,0.75,3,5,0.6,0,0,0.0,1,5,6,1,1,2,1,3,15,3,1,UTA,MEM,UTA,127,,,22,21,16,7
Ochai Agbaji,G,22023,1630534,22300158,"NOV 08, 2023",UTA @ IND,L,26,1,3,0.333,1,3,0.333,0,0,0.0,1,3,4,1,0,1,3,0,3,-3,1,UTA,IND,UTA,118,,,8,7,4,5
Ochai Agbaji,G,22023,1630534,22300152,"NOV 06, 2023",UTA @ CHI,L,11,1,3,0.333,1,2,0.5,0,0,0.0,0,1,1,1,0,1,1,2,3,-15,1,UTA,CHI,UTA,113,,,5,4,4,2
Ochai Agbaji,G,22023,1630534,22300138,"NOV 04, 2023",UTA @ MIN,L,17,3,5,0.6,2,4,0.5,0,1,0.0,2,0,2,1,0,0,0,1,8,-4,1,UTA,MIN,UTA,95,,,11,10,9,3
Ochai Agbaji,G,22023,1630534,22300130,"NOV 02, 2023",UTA vs. ORL,L,8,1,2,0.5,0,1,0.0,0,0,0.0,0,0,0,1,0,0,0,2,2,-1,1,UTA,UTA,ORL,113,,,3,2,3,1
Ochai Agbaji,G,22023,1630534,22300125,"NOV 01, 2023",UTA vs. MEM,W,18,2,5,0.4,2,5,0.4,0,1,0.0,0,3,3,1,0,0,2,0,6,5,1,UTA,UTA,MEM,133,,,10,9,7,4
Ochai Agbaji,G,22023,1630534,22300110,"OCT 30, 2023",UTA @ DEN,L,15,0,5,0.0,0,2,0.0,0,0,0.0,1,1,2,2,0,0,0,0,0,-1,1,UTA,DEN,UTA,102,,,4,2,2,4
Ochai Agbaji,G,22023,1630534,22300094,"OCT 28, 2023",UTA @ PHX,L,6,0,1,0.0,0,1,0.0,0,0,0.0,0,0,0,0,0,1,0,0,0,-3,1,UTA,PHX,UTA,104,,,0,0,0,0
Ochai Agbaji,G,22023,1630534,22300085,"OCT 27, 2023",UTA vs. LAC,W,12,1,3,0.333,0,2,0.0,0,0,0.0,0,1,1,2,1,1,0,3,2,-2,1,UTA,UTA,LAC,120,,,5,3,4,3
Ochai Agbaji,G,22023,1630534,22300072,"OCT 25, 2023",UTA vs. SAC,L,19,2,6,0.333,1,2,0.5,0,0,0.0,0,3,3,0,0,0,0,2,5,-11,1,UTA,UTA,SAC,114,,,8,8,5,3
Trendon Watford,F,22023,1630570,22300750,"FEB 10, 2024",BKN vs. SAS,W,8,2,2,1.0,0,0,0.0,2,2,1.0,1,0,1,0,0,0,0,1,6,0,1,BKN,BKN,SAS,123,,,7,7,6,1
Trendon Watford,F,22023,1630570,22300735,"FEB 08, 2024",BKN vs. CLE,L,26,5,13,0.385,0,2,0.0,5,5,1.0,1,5,6,2,0,2,1,3,15,1,1,BKN,BKN,CLE,95,,,23,21,17,8
Trendon Watford,F,22023,1630570,22300720,"FEB 06, 2024",BKN vs. DAL,L,3,0,1,0.0,0,0,0.0,0,0,0.0,0,0,0,0,0,0,0,0,0,-7,1,BKN,BKN,DAL,107,,,0,0,0,0
Trendon Watford,F,22023,1630570,22300698,"FEB 03, 2024",BKN @ PHI,W,9,4,5,0.8,1,1,1.0,0,0,0.0,1,2,3,1,0,0,0,0,9,-9,1,BKN,PHI,BKN,136,,,13,12,10,4
Trendon Watford,F,22023,1630570,22300677,"JAN 31, 2024",BKN vs. PHX,L,6,1,1,1.0,0,0,0.0,0,0,0.0,0,0,0,2,0,0,0,1,2,0,1,BKN,BKN,PHX,120,,,4,2,4,2
Trendon Watford,F,22023,1630570,22300660,"JAN 29, 2024",BKN vs. UTA,W,3,1,2,0.5,0,1,0.0,0,0,0.0,0,1,1,0,0,0,0,2,2,4,1,BKN,BKN,UTA,147,,,3,3,2,1
Trendon Watford,F,22023,1630570,22300600,"JAN 21, 2024",BKN @ LAC,L,12,1,3,0.333,0,1,0.0,0,0,0.0,1,0,1,1,1,0,1,1,2,4,1,BKN,LAC,BKN,114,,,4,3,3,2
Trendon Watford,F,22023,1630570,22300591,"JAN 19, 2024",BKN @ LAL,W,4,0,2,0.0,0,1,0.0,0,0,0.0,1,0,1,0,0,0,0,0,0,2,1,BKN,LAL,BKN,130,,,1,1,0,1
Trendon Watford,F,22023,1630570,22300578,"JAN 17, 2024",BKN @ POR,L,8,2,3,0.667,2,3,0.667,0,0,0.0,0,0,0,2,0,0,1,1,6,-1,1,BKN,POR,BKN,103,,,8,6,8,2
Trendon Watford,F,22023,1630570,22300562,"JAN 15, 2024",BKN vs. MIA,L,4,0,1,0.0,0,0,0.0,0,0,0.0,1,0,1,1,0,0,0,1,0,2,1,BKN,BKN,MIA,95,,,2,1,1,2
Trendon Watford,F,22023,1630570,22300527,"JAN 11, 2024",BKN @ CLE,L,13,4,5,0.8,0,1,0.0,0,0,0.0,2,2,4,1,1,0,0,6,8,11,1,BKN,CLE,BKN,102,,,13,12,9,5
Trendon Watford,F,22023,1630570,22300498,"JAN 07, 2024",BKN vs. POR,L,0,0,0,0.0,0,0,0.0,0,0,0.0,0,0,0,0,0,0,1,0,0,0,1,BKN,BKN,POR,127,,,0,0,0,0
Trendon Watford,F,22023,1630570,22300469,"JAN 03, 2024",BKN @ HOU,L,20,3,6,0.5,2,2,1.0,3,4,0.75,4,3,7,1,2,0,0,1,11,9,1,BKN,HOU,BKN,101,,,19,18,12,8
Trendon Watford,F,22023,1630570,22300461,"JAN 02, 2024",BKN @ NOP,L,7,2,4,0.5,0,0,0.0,0,1,0.0,1,0,1,1,0,0,0,1,4,3,1,BKN,NOP,BKN,85,,,6,5,5,2
Trendon Watford,F,22023,1630570,22300447,"DEC 31, 2023",BKN @ OKC,L,2,1,1,1.0,0,0,0.0,0,0,0.0,0,0,0,0,0,0,0,0,2,1,1,BKN,OKC,BKN,108,,,2,2,2,0
Trendon Watford,F,22023,1630570,22300417,"DEC 27, 2023",BKN vs. MIL,L,28,6,9,0.667,0,1,0.0,5,6,0.833,0,5,5,4,2,0,1,1,17,-15,1,BKN,BKN,MIL,122,,,26,22,21,9
Trendon Watford,F,22023,1630570,22300394,"DEC 23, 2023",BKN vs. DET,W,1,0,0,0.0,0,0,0.0,0,0,0.0,0,0,0,0,0,0,0,0,0,-6,1,BKN,BKN,DET,126,,,0,0,0,0
Trendon Watford,F,22023,1630570,22300368,"DEC 20, 2023",BKN vs. NYK,L,11,2,3,0.667,0,1,0.0,0,1,0.0,0,3,3,1,0,1,1,1,4,8,1,BKN,BKN,NYK,102,,,8,7,5,4
Trendon Watford,F,22023,1630570,22300357,"DEC 18, 2023",BKN @ UTA,L,7,2,3,0.667,1,1,1.0,0,0,0.0,0,3,3,1,0,1,0,0,5,-1,1,BKN,UTA,BKN,108,,,9,8,6,4
Trendon Watford,F,22023,1630570,22300339,"DEC 16, 2023",BKN @ GSW,L,8,0,1,0.0,0,0,0.0,0,0,0.0,0,2,2,2,0,0,1,1,0,2,1,BKN,GSW,BKN,120,,,4,2,2,4
Trendon Watford,F,22023,1630570,22300322,"DEC 14, 2023",BKN @ DEN,L,22,4,10,0.4,0,1,0.0,0,0,0.0,2,2,4,6,0,2,2,2,8,-7,1,BKN,DEN,BKN,101,,,18,12,14,10
Trendon Watford,F,22023,1630570,22300317,"DEC 13, 2023",BKN @ PHX,W,18,3,5,0.6,0,2,0.0,1,1,1.0,0,1,1,1,1,0,0,1,7,11,1,BKN,PHX,BKN,116,,,9,8,8,2
Trendon Watford,F,22023,1630570,22300303,"DEC 11, 2023",BKN @ SAC,L,11,3,4,0.75,0,0,0.0,2,2,1.0,1,4,5,2,1,0,1,3,8,4,1,BKN,SAC,BKN,118,,,15,13,10,7
Trendon Watford,F,22023,1630570,22301219,"DEC 08, 2023",BKN vs. WAS,W,19,2,5,0.4,0,1,0.0,4,4,1.0,0,2,2,2,0,0,0,2,8,13,1,BKN,BKN,WAS,124,,,12,10,10,4
Trendon Watford,F,22023,1630570,22300282,"DEC 02, 2023",BKN vs. ORL,W,7,3,4,0.75,0,0,0.0,1,1,1.0,3,1,4,1,0,1,1,1,7,6,1,BKN,BKN,ORL,129,,,12,11,8,5
Trendon Watford,F,22023,1630570,22300266,"NOV 30, 2023",BKN vs. CHA,L,14,3,5,0.6,0,1,0.0,0,0,0.0,1,3,4,2,0,0,0,2,6,-3,1,BKN,BKN,CHA,128,,,12,10,8,6
Trendon Watford,F,22023,1630570,22300054,"NOV 28, 2023",BKN vs. TOR,W,11,1,2,0.5,0,0,0.0,0,0,0.0,0,1,1,0,0,0,3,1,2,-8,1,BKN,BKN,TOR,115,,,3,3,2,1
Trendon Watford,F,22023,1630570,22300250,"NOV 26, 2023",BKN vs. CHI,W,17,5,8,0.625,1,2,0.5,0,1,0.0,1,3,4,2,1,0,0,2,11,-2,1,BKN,BKN,CHI,118,,,17,15,13,6
Trendon Watford,F,22023,1630570,22300240,"NOV 25, 2023",BKN vs. MIA,W,13,3,5,0.6,1,1,1.0,0,0,0.0,0,2,2,0,1,0,1,4,7,-6,1,BKN,BKN,MIA,112,,,9,9,7,2
Trendon Watford,F,22023,1630570,22300227,"NOV 22, 2023",BKN @ ATL,L,15,3,8,0.375,1,2,0.5,0,0,0.0,1,6,7,1,0,0,3,3,7,-6,1,BKN,ATL,BKN,145,,,15,14,8,8
Trendon Watford,F,22023,1630570,22300208,"NOV 19, 2023",BKN vs. PHI,L,22,3,9,0.333,0,2,0.0,2,2,1.0,2,2,4,4,1,1,2,3,8,0,1,BKN,BKN,PHI,99,,,16,12,12,8
Trendon Watford,F,22023,1630570,22300200,"NOV 16, 2023",BKN @ MIA,L,10,2,3,0.667,0,0,0.0,0,0,0.0,2,0,2,1,0,0,0,1,4,-2,1,BKN,MIA,BKN,115,,,7,6,5,3
Trendon Watford,F,22023,1630570,22300178,"NOV 12, 2023",BKN vs. WAS,W,9,1,3,0.333,0,0,0.0,0,0,0.0,0,3,3,1,0,0,1,2,2,-3,1,BKN,BKN,WAS,102,,,6,5,3,4
Trendon Watford,F,22023,1630570,22300010,"NOV 10, 2023",BKN @ BOS,L,27,6,11,0.545,0,1,0.0,2,2,1.0,3,4,7,3,0,1,0,4,14,1,1,BKN,BOS,BKN,107,,,24,21,17,10
Trendon Watford,F,22023,1630570,22300160,"NOV 08, 2023",BKN vs. LAC,W,19,3,6,0.5,1,2,0.5,2,2,1.0,2,3,5,2,3,0,4,2,9,5,1,BKN,BKN,LAC,100,,,16,14,11,7
Trendon Watford,F,22023,1630570,22300136,"NOV 04, 2023",BKN vs. BOS,L,5,0,0,0.0,0,0,0.0,0,0,0.0,0,2,2,2,0,0,0,1,0,8,1,BKN,BKN,BOS,114,,,4,2,2,4
Trendon Watford,F,22023,1630570,22300119,"NOV 01, 2023",BKN @ MIA,W,14,4,6,0.667,1,2,0.5,2,2,1.0,1,3,4,4,1,0,1,2,11,19,1,BKN,MIA,BKN,109,,,19,15,15,8
Dyson Daniels,G,22023,1630700,22300747,"FEB 09, 2024",NOP @ LAL,L,27,2,4,0.5,2,3,0.667,1,2,0.5,0,1,1,1,1,1,2,3,7,-13,1,NOP,LAL,NOP,122,,,9,8,8,2
Dyson Daniels,G,22023,1630700,22300731,"FEB 07, 2024",NOP @ LAC,W,22,5,7,0.714,0,2,0.0,0,0,0.0,1,3,4,1,4,2,1,2,10,6,1,NOP,LAC,NOP,117,,,15,14,11,5
Dyson Daniels,G,22023,1630700,22300718,"FEB 05, 2024",NOP vs. TOR,W,21,2,5,0.4,1,2,0.5,0,0,0.0,1,2,3,4,3,1,0,1,5,19,1,NOP,NOP,TOR,138,,,12,8,9,7
Dyson Daniels,G,22023,1630700,22300696,"FEB 02, 2024",NOP @ SAS,W,21,1,3,0.333,0,1,0.0,0,0,0.0,2,4,6,5,3,0,1,1,2,20,1,NOP,SAS,NOP,114,,,13,8,7,11
Dyson Daniels,G,22023,1630700,22300679,"JAN 31, 2024",NOP @ HOU,W,24,4,6,0.667,1,3,0.333,0,0,0.0,0,2,2,3,1,0,2,2,9,1,1,NOP,HOU,NOP,110,,,14,11,12,5
Dyson Daniels,G,22023,1630700,22300648,"JAN 27, 2024",NOP @ MIL,L,18,0,1,0.0,0,0,0.0,0,0,0.0,0,2,2,3,1,1,2,1,0,-2,1,NOP,MIL,NOP,117,,,5,2,3,5
Dyson Daniels,G,22023,1630700,22300640,"JAN 26, 2024",NOP vs. OKC,L,17,2,4,0.5,1,1,1.0,0,0,0.0,1,0,1,0,0,1,4,0,5,-11,1,NOP,NOP,OKC,83,,,6,6,5,1
Dyson Daniels,G,22023,1630700,22300616,"JAN 23, 2024",NOP vs. UTA,W,17,0,2,0.0,0,1,0.0,0,0,0.0,0,5,5,3,1,0,0,2,0,13,1,NOP,NOP,UTA,153,,,8,5,3,8
Dyson Daniels,G,22023,1630700,22300588,"JAN 19, 2024",NOP vs. PHX,L,11,1,4,0.25,0,1,0.0,0,0,0.0,1,2,3,1,2,0,1,2,2,3,1,NOP,NOP,PHX,109,,,6,5,3,4
Dyson Daniels,G,22023,1630700,22300575,"JAN 17, 2024",NOP vs. CHA,W,13,0,2,0.0,0,1,0.0,0,0,0.0,2,0,2,1,0,0,2,1,0,7,1,NOP,NOP,CHA,132,,,3,2,1,3
Dyson Daniels,G,22023,1630700,22300547,"JAN 13, 2024",NOP @ DAL,W,38,4,7,0.571,0,1,0.0,2,2,1.0,2,4,6,7,0,0,2,2,10,18,1,NOP,DAL,NOP,118,,,23,16,17,13
Dyson Daniels,G,22023,1630700,22300539,"JAN 12, 2024",NOP @ DEN,L,15,1,4,0.25,0,2,0.0,0,2,0.0,2,2,4,3,3,0,0,0,2,7,1,NOP,DEN,NOP,113,,,9,6,5,7
Dyson Daniels,G,22023,1630700,22300486,"JAN 05, 2024",NOP vs. LAC,L,26,1,4,0.25,0,1,0.0,0,2,0.0,0,3,3,3,4,0,0,1,2,-6,1,NOP,NOP,LAC,95,,,8,5,5,6
Dyson Daniels,G,22023,1630700,22300471,"JAN 03, 2024",NOP @ MIN,W,24,2,3,0.667,1,1,1.0,2,2,1.0,2,3,5,1,1,0,0,0,7,-1,1,NOP,MIN,NOP,117,,,13,12,8,6
Dyson Daniels,G,22023,1630700,22300461,"JAN 02, 2024",NOP vs. BKN,W,20,2,5,0.4,1,4,0.25,2,2,1.0,1,1,2,3,2,2,1,0,7,5,1,NOP,NOP,BKN,112,,,12,9,10,5
Dyson Daniels,G,22023,1630700,22300446,"DEC 31, 2023",NOP vs. LAL,W,8,1,1,1.0,1,1,1.0,0,0,0.0,0,1,1,0,0,0,1,1,3,6,1,NOP,NOP,LAL,129,,,4,4,3,1
Dyson Daniels,G,22023,1630700,22300424,"DEC 28, 2023",NOP vs. UTA,W,14,0,1,0.0,0,1,0.0,0,0,0.0,0,2,2,2,2,1,1,2,0,-1,1,NOP,NOP,UTA,112,,,4,2,2,4
Dyson Daniels,G,22023,1630700,22300410,"DEC 26, 2023",NOP vs. MEM,L,19,3,3,1.0,1,1,1.0,4,6,0.667,0,0,0,1,2,0,0,4,11,0,1,NOP,NOP,MEM,115,,,12,11,12,1
Dyson Daniels,G,22023,1630700,22300392,"DEC 23, 2023",NOP vs. HOU,L,14,0,3,0.0,0,2,0.0,0,0,0.0,2,1,3,0,0,0,1,0,0,-6,1,NOP,NOP,HOU,104,,,3,3,0,3
Dyson Daniels,G,22023,1630700,22300375,"DEC 21, 2023",NOP @ CLE,W,20,3,4,0.75,1,1,1.0,0,0,0.0,0,2,2,1,0,0,0,1,7,-2,1,NOP,CLE,NOP,123,,,10,9,8,3
Dyson Daniels,G,22023,1630700,22300360,"DEC 19, 2023",NOP vs. MEM,L,13,1,2,0.5,1,2,0.5,0,0,0.0,0,1,1,2,0,0,0,1,3,17,1,NOP,NOP,MEM,113,,,6,4,5,3
Dyson Daniels,G,22023,1630700,22300345,"DEC 17, 2023",NOP @ SAS,W,18,2,4,0.5,1,2,0.5,0,0,0.0,1,3,4,4,1,0,1,0,5,8,1,NOP,SAS,NOP,146,,,13,9,9,8
Dyson Daniels,G,22023,1630700,22300326,"DEC 15, 2023",NOP @ CHA,W,15,0,0,0.0,0,0,0.0,0,0,0.0,0,0,0,0,1,0,0,1,0,7,1,NOP,CHA,NOP,112,,,0,0,0,0
Dyson Daniels,G,22023,1630700,22300311,"DEC 13, 2023",NOP @ WAS,W,16,1,6,0.167,0,4,0.0,0,0,0.0,2,2,4,2,2,0,0,0,2,-17,1,NOP,WAS,NOP,142,,,8,6,4,6
Dyson Daniels,G,22023,1630700,22300301,"DEC 11, 2023",NOP vs. MIN,W,28,1,3,0.333,1,1,1.0,3,4,0.75,1,1,2,2,2,1,0,3,6,5,1,NOP,NOP,MIN,121,,,10,8,8,4
Dyson Daniels,G,22023,1630700,22301230,"DEC 07, 2023",NOP @ LAL,L,17,1,5,0.2,0,2,0.0,2,2,1.0,2,6,8,0,0,1,0,1,4,2,1,NOP,LAL,NOP,89,,,12,12,4,8
Dyson Daniels,G,22023,1630700,22301204,"DEC 04, 2023",NOP @ SAC,W,6,0,1,0.0,0,0,0.0,0,0,0.0,1,0,1,0,2,0,0,1,0,8,1,NOP,SAC,NOP,127,,,1,1,0,1
Dyson Daniels,G,22023,1630700,22300285,"DEC 02, 2023",NOP @ CHI,L,22,3,5,0.6,1,3,0.333,0,0,0.0,0,2,2,2,2,0,1,2,7,4,1,NOP,CHI,NOP,118,,,11,9,9,4
Dyson Daniels,G,22023,1630700,22300262,"NOV 29, 2023",NOP vs. PHI,W,14,2,4,0.5,0,1,0.0,0,0,0.0,1,3,4,1,2,1,1,2,4,4,1,NOP,NOP,PHI,124,,,9,8,5,5
Dyson Daniels,G,22023,1630700,22300256,"NOV 27, 2023",NOP @ UTA,L,24,1,6,0.167,0,4,0.0,0,0,0.0,0,3,3,4,0,0,1,4,2,-6,1,NOP,UTA,NOP,112,,,9,5,6,7
Dyson Daniels,G,22023,1630700,22300243,"NOV 25, 2023",NOP @ UTA,L,34,3,14,0.214,0,6,0.0,0,1,0.0,1,5,6,5,6,1,5,1,6,-18,1,NOP,UTA,NOP,100,,,17,12,11,11
Dyson Daniels,G,22023,1630700,22300052,"NOV 24, 2023",NOP @ LAC,W,36,3,7,0.429,1,2,0.5,0,0,0.0,2,6,8,5,1,1,1,2,7,18,1,NOP,LAC,NOP,116,,,20,15,12,13
Dyson Daniels,G,22023,1630700,22300233,"NOV 22, 2023",NOP vs. SAC,W,29,2,9,0.222,0,5,0.0,4,4,1.0,3,4,7,0,1,0,0,2,8,-7,1,NOP,NOP,SAC,117,,,15,15,8,7
Dyson Daniels,G,22023,1630700,22300222,"NOV 20, 2023",NOP vs. SAC,W,25,1,4,0.25,1,4,0.25,0,0,0.0,0,2,2,5,1,0,0,2,3,28,1,NOP,NOP,SAC,129,,,10,5,8,7
Dyson Daniels,G,22023,1630700,22300659,"JAN 29, 2024",NOP @ BOS,L,14,0,0,0.0,0,0,0.0,0,0,0.0,2,1,3,0,1,2,0,0,0,-8,1,NOP,BOS,NOP,112,,,3,3,0,3
Dyson Daniels,G,22023,1630700,22300556,"JAN 15, 2024",NOP @ DAL,L,19,1,2,0.5,0,1,0.0,0,0,0.0,2,1,3,2,0,0,0,3,2,-20,1,NOP,DAL,NOP,120,,,7,5,4,5
Dyson Daniels,G,22023,1630700,22300525,"JAN 10, 2024",NOP @ GSW,W,22,3,4,0.75,1,2,0.5,1,2,0.5,0,3,3,3,1,0,1,2,8,25,1,NOP,GSW,NOP,141,,,14,11,11,6
Dyson Daniels,G,22023,1630700,22300500,"JAN 07, 2024",NOP @ SAC,W,29,6,6,1.0,2,2,1.0,0,0,0.0,1,4,5,6,0,0,0,3,14,7,1,NOP,SAC,NOP,133,,,25,19,20,11
Dyson Daniels,G,22023,1630700,22300278,"DEC 01, 2023",NOP vs. SAS,W,12,1,4,0.25,0,1,0.0,0,0,0.0,0,2,2,1,0,0,0,2,2,1,1,NOP,NOP,SAS,121,,,5,4,3,3
Dyson Daniels,G,22023,1630700,22300203,"NOV 18, 2023",NOP vs. MIN,L,37,6,12,0.5,1,3,0.333,0,0,0.0,1,4,5,6,1,0,3,4,13,-6,1,NOP,NOP,MIN,120,,,24,18,19,11
Dyson Daniels,G,22023,1630700,22300034,"NOV 17, 2023",NOP vs. DEN,W,33,4,6,0.667,0,1,0.0,2,3,0.667,1,7,8,7,3,0,0,1,10,12,1,NOP,NOP,DEN,115,,,25,18,17,15
Dyson Daniels,G,22023,1630700,22300022,"NOV 14, 2023",NOP vs. DAL,W,29,4,10,0.4,2,5,0.4,0,0,0.0,1,1,2,6,3,0,1,4,10,12,1,NOP,NOP,DAL,131,,,18,12,16,8
Dyson Daniels,G,22023,1630700,22300183,"NOV 12, 2023",NOP vs. DAL,L,31,7,12,0.583,3,6,0.5,0,0,0.0,2,7,9,4,0,0,3,3,17,-29,1,NOP,NOP,DAL,124,,,30,26,21,13
Dyson Daniels,G,22023,1630700,22300011,"NOV 10, 2023",NOP @ HOU,L,41,2,6,0.333,0,3,0.0,6,6,1.0,2,8,10,2,1,0,2,2,10,9,1,NOP,HOU,NOP,101,,,22,20,12,12
Dyson Daniels,G,22023,1630700,22300166,"NOV 08, 2023",NOP @ MIN,L,31,3,10,0.3,1,3,0.333,0,0,0.0,1,2,3,5,4,0,3,2,7,-26,1,NOP,MIN,NOP,101,,,15,10,12,8
Dyson Daniels,G,22023,1630700,22300156,"NOV 06, 2023",NOP @ DEN,L,21,4,5,0.8,1,1,1.0,0,0,0.0,0,2,2,1,1,1,3,0,9,9,1,NOP,DEN,NOP,116,,,12,11,10,3
Dyson Daniels,G,22023,1630700,22300135,"NOV 04, 2023",NOP vs. ATL,L,22,3,4,0.75,1,2,0.5,0,0,0.0,1,2,3,5,1,1,0,0,7,-4,1,NOP,NOP,ATL,105,,,15,10,12,8
Dyson Daniels,G,22023,1630700,22300129,"NOV 02, 2023",NOP vs. DET,W,25,3,4,0.75,2,2,1.0,2,2,1.0,1,6,7,6,1,0,1,2,10,5,1,NOP,NOP,DET,125,,,23,17,16,13
Dyson Daniels,G,22023,1630700,22300121,"NOV 01, 2023",NOP @ OKC,W,25,3,10,0.3,1,6,0.167,1,4,0.25,3,1,4,1,1,2,1,1,8,-6,1,NOP,OKC,NOP,110,,,13,12,9,5
Dyson Daniels,G,22023,1630700,22300108,"OCT 30, 2023",NOP vs. GSW,L,24,3,5,0.6,1,2,0.5,0,0,0.0,0,4,4,3,0,0,0,1,7,-13,1,NOP,NOP,GSW,102,,,14,11,10,7
Dyson Daniels,G,22023,1630700,22300090,"OCT 28, 2023",NOP vs. NYK,W,22,1,7,0.143,0,3,0.0,0,4,0.0,0,4,4,3,1,0,1,2,2,11,1,NOP,NOP,NYK,96,,,9,6,5,7
Dyson Daniels,G,22023,1630700,22300071,"OCT 25, 2023",NOP @ MEM,W,19,3,6,0.5,0,1,0.0,0,0,0.0,2,3,5,0,2,1,2,4,6,-2,1,NOP,MEM,NOP,111,,,11,11,6,5
Nikola Jovic,F,22023,1631107,22300730,"FEB 07, 2024",MIA vs. SAS,W,2,0,0,0.0,0,0,0.0,0,0,0.0,0,0,0,0,0,0,1,0,0,-5,1,MIA,MIA,SAS,116,,,0,0,0,0
Nikola Jovic,F,22023,1631107,22300643,"JAN 27, 2024",MIA @ NYK,L,1,0,0,0.0,0,0,0.0,0,0,0.0,0,0,0,0,0,0,0,0,0,4,1,MIA,NYK,MIA,109,,,0,0,0,0
Nikola Jovic,F,22023,1631107,22300630,"JAN 25, 2024",MIA vs. BOS,L,7,1,4,0.25,1,2,0.5,0,0,0.0,2,1,3,0,0,0,1,0,3,-1,1,MIA,MIA,BOS,110,,,6,6,3,3
Nikola Jovic,F,22023,1631107,22300601,"JAN 21, 2024",MIA @ ORL,L,15,1,4,0.25,0,1,0.0,0,1,0.0,0,3,3,0,0,0,1,2,2,-2,1,MIA,ORL,MIA,87,,,5,5,2,3
Nikola Jovic,F,22023,1631107,22300587,"JAN 19, 2024",MIA vs. ATL,L,15,1,5,0.2,0,1,0.0,0,0,0.0,2,1,3,0,0,0,0,2,2,4,1,MIA,MIA,ATL,108,,,5,5,2,3
Nikola Jovic,F,22023,1631107,22300574,"JAN 17, 2024",MIA @ TOR,L,21,4,9,0.444,1,2,0.5,1,2,0.5,3,4,7,2,0,1,2,1,10,6,1,MIA,TOR,MIA,97,,,19,17,12,9
Nikola Jovic,F,22023,1631107,22300562,"JAN 15, 2024",MIA @ BKN,W,19,2,4,0.5,1,3,0.333,0,0,0.0,0,3,3,2,0,0,0,0,5,17,1,MIA,BKN,MIA,96,,,10,8,7,5
Nikola Jovic,F,22023,1631107,22300551,"JAN 14, 2024",MIA vs. CHA,W,28,2,6,0.333,1,2,0.5,0,0,0.0,1,6,7,2,0,2,3,3,5,13,1,MIA,MIA,CHA,104,,,14,12,7,9
Nikola Jovic,F,22023,1631107,22300535,"JAN 12, 2024",MIA vs. ORL,W,25,1,8,0.125,1,4,0.25,1,2,0.5,0,3,3,4,0,0,2,2,4,-1,1,MIA,MIA,ORL,99,,,11,7,8,7
Nikola Jovic,F,22023,1631107,22300522,"JAN 10, 2024",MIA vs. OKC,L,33,5,8,0.625,3,5,0.6,2,2,1.0,0,5,5,4,1,1,1,3,15,13,1,MIA,MIA,OKC,120,,,24,20,19,9
Nikola Jovic,F,22023,1631107,22300509,"JAN 08, 2024",MIA vs. HOU,W,21,2,9,0.222,1,5,0.2,1,4,0.25,3,5,8,6,2,2,2,3,6,7,1,MIA,MIA,HOU,120,,,20,14,12,14
Nikola Jovic,F,22023,1631107,22300489,"JAN 05, 2024",MIA @ PHX,L,24,1,3,0.333,1,3,0.333,0,0,0.0,1,3,4,1,0,0,0,0,3,-10,1,MIA,PHX,MIA,97,,,8,7,4,5
Nikola Jovic,F,22023,1631107,22300475,"JAN 03, 2024",MIA @ LAL,W,28,6,11,0.545,3,5,0.6,0,0,0.0,1,7,8,1,1,0,0,4,15,3,1,MIA,LAL,MIA,110,,,24,23,16,9
Nikola Jovic,F,22023,1631107,22300458,"JAN 01, 2024",MIA @ LAC,L,3,1,2,0.5,1,2,0.5,0,0,0.0,0,0,0,1,0,0,0,0,3,3,1,MIA,LAC,MIA,104,,,4,3,4,1
Nikola Jovic,F,22023,1631107,22300439,"DEC 30, 2023",MIA @ UTA,L,10,2,2,1.0,2,2,1.0,0,0,0.0,1,1,2,1,0,0,1,5,6,2,1,MIA,UTA,MIA,109,,,9,8,7,3
Nikola Jovic,F,22023,1631107,22300426,"DEC 28, 2023",MIA @ GSW,W,20,4,5,0.8,0,1,0.0,3,5,0.6,2,1,3,3,1,1,0,3,11,10,1,MIA,GSW,MIA,114,,,17,14,14,6
Nikola Jovic,F,22023,1631107,22300093,"OCT 28, 2023",MIA @ MIN,L,21,3,6,0.5,2,4,0.5,0,0,0.0,0,11,11,4,1,0,0,2,8,6,1,MIA,MIN,MIA,90,,,23,19,12,15
Nikola Jovic,F,22023,1631107,22300240,"NOV 25, 2023",MIA @ BKN,L,17,0,3,0.0,0,1,0.0,1,2,0.5,1,5,6,5,0,0,2,5,1,-5,1,MIA,BKN,MIA,97,,,12,7,6,11
Nikola Jovic,F,22023,1631107,22300107,"OCT 30, 2023",MIA @ MIL,L,7,1,2,0.5,1,1,1.0,2,2,1.0,0,4,4,0,0,0,2,0,5,9,1,MIA,MIL,MIA,114,,,9,9,5,4
Nikola Jovic,F,22023,1631107,22301207,"DEC 06, 2023",MIA @ TOR,W,3,0,1,0.0,0,1,0.0,0,0,0.0,0,2,2,0,0,0,1,2,0,-3,1,MIA,TOR,MIA,112,,,2,2,0,2
Dexter Dennis,G,22023,1641926,22300398,"DEC 23, 2023",DAL vs. SAS,W,6,0,2,0.0,0,2,0.0,0,0,0.0,0,2,2,0,0,1,3,1,0,-12,1,DAL,DAL,SAS,144,,,2,2,0,2
Dexter Dennis,G,22023,1641926,22300385,"DEC 22, 2023",DAL @ HOU,L,17,8,11,0.727,1,3,0.333,1,2,0.5,0,5,5,4,0,0,0,0,18,10,1,DAL,HOU,DAL,96,,,27,23,22,9
Dexter Dennis,G,22023,1641926,22300287,"DEC 02, 2023",DAL vs. OKC,L,3,0,2,0.0,0,2,0.0,0,0,0.0,1,1,2,0,0,0,0,0,0,-11,1,DAL,DAL,OKC,120,,,2,2,0,2
Dexter Dennis,G,22023,1641926,22300277,"DEC 01, 2023",DAL vs. MEM,L,4,2,4,0.5,0,1,0.0,0,1,0.0,0,0,0,0,0,0,0,0,4,4,1,DAL,DAL,MEM,94,,,4,4,4,0
Pat Connaughton,G,22023,1626192,22300745,"FEB 09, 2024",MIL vs. CHA,W,16,2,3,0.667,1,2,0.5,0,0,0.0,2,4,6,1,0,0,1,0,5,9,1,MIL,MIL,CHA,120,,,12,11,6,7
Pat Connaughton,G,22023,1626192,22300738,"FEB 08, 2024",MIL vs. MIN,L,37,4,6,0.667,1,2,0.5,0,0,0.0,1,1,2,9,0,1,4,2,9,-12,1,MIL,MIL,MIN,105,,,20,11,18,11
Pat Connaughton,G,22023,1626192,22300725,"FEB 06, 2024",MIL @ PHX,L,32,4,6,0.667,3,5,0.6,1,2,0.5,0,6,6,6,0,0,0,4,12,-15,1,MIL,PHX,MIL,106,,,24,18,18,12
Pat Connaughton,G,22023,1626192,22300711,"FEB 04, 2024",MIL @ UTA,L,18,0,0,0.0,0,0,0.0,1,4,0.25,1,3,4,1,2,0,1,1,1,11,1,MIL,UTA,MIL,108,,,6,5,2,5
Pat Connaughton,G,22023,1626192,22300702,"FEB 03, 2024",MIL @ DAL,W,18,1,6,0.167,0,3,0.0,0,0,0.0,0,3,3,1,1,0,0,1,2,-10,1,MIL,DAL,MIL,129,,,6,5,3,4
Pat Connaughton,G,22023,1626192,22300683,"JAN 31, 2024",MIL @ POR,L,14,0,0,0.0,0,0,0.0,0,0,0.0,0,1,1,0,1,0,1,2,0,-10,1,MIL,POR,MIL,116,,,1,1,0,1
Pat Connaughton,G,22023,1626192,22300667,"JAN 29, 2024",MIL @ DEN,L,16,1,2,0.5,1,2,0.5,4,4,1.0,0,1,1,3,0,1,1,0,7,-11,1,MIL,DEN,MIL,107,,,11,8,10,4
Pat Connaughton,G,22023,1626192,22300648,"JAN 27, 2024",MIL vs. NOP,W,20,2,4,0.5,1,3,0.333,0,0,0.0,2,1,3,4,1,0,1,1,5,10,1,MIL,MIL,NOP,141,,,12,8,9,7
Pat Connaughton,G,22023,1626192,22300639,"JAN 26, 2024",MIL vs. CLE,L,14,2,3,0.667,2,3,0.667,0,0,0.0,0,0,0,0,0,0,0,2,6,5,1,MIL,MIL,CLE,100,,,6,6,6,0
Pat Connaughton,G,22023,1626192,22300624,"JAN 24, 2024",MIL vs. CLE,W,17,2,4,0.5,2,3,0.667,0,0,0.0,0,1,1,0,2,0,0,1,6,-4,1,MIL,MIL,CLE,126,,,7,7,6,1
Pat Connaughton,G,22023,1626192,22300606,"JAN 22, 2024",MIL @ DET,W,9,1,2,0.5,0,1,0.0,0,0,0.0,0,1,1,0,0,0,0,2,2,-9,1,MIL,DET,MIL,122,,,3,3,2,1
Pat Connaughton,G,22023,1626192,22300592,"JAN 20, 2024",MIL @ DET,W,14,4,5,0.8,2,3,0.667,0,0,0.0,0,4,4,1,0,0,1,1,10,-18,1,MIL,DET,MIL,141,,,15,14,11,5
Pat Connaughton,G,22023,1626192,22300552,"JAN 14, 2024",MIL vs. SAC,W,33,1,3,0.333,1,3,0.333,2,2,1.0,0,3,3,2,0,0,0,3,5,5,1,MIL,MIL,SAC,143,,,10,8,7,5
Pat Connaughton,G,22023,1626192,22300545,"JAN 13, 2024",MIL vs. GSW,W,22,1,4,0.25,1,3,0.333,0,0,0.0,0,2,2,2,1,1,0,1,3,7,1,MIL,MIL,GSW,129,,,7,5,5,4
Pat Connaughton,G,22023,1626192,22300528,"JAN 11, 2024",MIL vs. BOS,W,21,1,1,1.0,0,0,0.0,0,0,0.0,1,0,1,3,0,0,0,3,2,20,1,MIL,MIL,BOS,135,,,6,3,5,4
Pat Connaughton,G,22023,1626192,22300510,"JAN 08, 2024",MIL vs. UTA,L,22,2,3,0.667,2,3,0.667,0,0,0.0,0,2,2,1,0,0,0,3,6,-12,1,MIL,MIL,UTA,116,,,9,8,7,3
Pat Connaughton,G,22023,1626192,22300496,"JAN 06, 2024",MIL @ HOU,L,19,3,5,0.6,3,5,0.6,0,0,0.0,0,1,1,1,0,0,0,0,9,-13,1,MIL,HOU,MIL,108,,,11,10,10,2
Pat Connaughton,G,22023,1626192,22300477,"JAN 04, 2024",MIL @ SAS,W,28,2,4,0.5,2,4,0.5,1,2,0.5,1,5,6,0,1,0,3,0,7,3,1,MIL,SAS,MIL,125,,,13,13,7,6
Pat Connaughton,G,22023,1626192,22300466,"JAN 03, 2024",MIL @ IND,L,14,1,3,0.333,1,2,0.5,0,0,0.0,1,1,2,1,0,0,0,3,3,-4,1,MIL,IND,MIL,130,,,6,5,4,3
Pat Connaughton,G,22023,1626192,22300454,"JAN 01, 2024",MIL vs. IND,L,24,1,3,0.333,1,3,0.333,0,0,0.0,0,2,2,2,1,1,0,1,3,-22,1,MIL,MIL,IND,113,,,7,5,5,4
Pat Connaughton,G,22023,1626192,22300433,"DEC 29, 2023",MIL @ CLE,W,23,1,3,0.333,1,3,0.333,0,0,0.0,0,1,1,3,0,0,1,0,3,6,1,MIL,CLE,MIL,119,,,7,4,6,4
Pat Connaughton,G,22023,1626192,22300417,"DEC 27, 2023",MIL @ BKN,W,18,1,3,0.333,1,3,0.333,0,0,0.0,1,0,1,1,0,0,0,0,3,14,1,MIL,BKN,MIL,144,,,5,4,4,2
Pat Connaughton,G,22023,1626192,22300401,"DEC 25, 2023",MIL @ NYK,L,24,1,4,0.25,1,4,0.25,0,0,0.0,4,3,7,1,1,0,0,3,3,-13,1,MIL,NYK,MIL,122,,,11,10,4,8
Pat Connaughton,G,22023,1626192,22300388,"DEC 23, 2023",MIL @ NYK,W,22,3,6,0.5,2,5,0.4,0,0,0.0,0,8,8,0,0,0,0,0,8,7,1,MIL,NYK,MIL,130,,,16,16,8,8
Pat Connaughton,G,22023,1626192,22300378,"DEC 21, 2023",MIL vs. ORL,W,21,3,6,0.5,0,3,0.0,2,2,1.0,2,6,8,2,0,0,0,4,8,-6,1,MIL,MIL,ORL,118,,,18,16,10,10
Pat Connaughton,G,22023,1626192,22300361,"DEC 19, 2023",MIL vs. SAS,W,18,1,8,0.125,1,6,0.167,0,0,0.0,0,3,3,2,1,0,0,2,3,5,1,MIL,MIL,SAS,132,,,8,6,5,5
Pat Connaughton,G,22023,1626192,22300346,"DEC 17, 2023",MIL vs. HOU,W,17,2,4,0.5,1,3,0.333,0,0,0.0,1,1,2,4,1,0,1,0,5,12,1,MIL,MIL,HOU,128,,,11,7,9,6
Pat Connaughton,G,22023,1626192,22300334,"DEC 16, 2023",MIL vs. DET,W,12,2,2,1.0,1,1,1.0,1,1,1.0,1,3,4,2,0,1,0,1,6,28,1,MIL,MIL,DET,146,,,12,10,8,6
Pat Connaughton,G,22023,1626192,22300056,"NOV 28, 2023",MIL @ MIA,W,15,3,5,0.6,1,3,0.333,0,0,0.0,0,1,1,1,0,0,0,0,7,-8,1,MIL,MIA,MIL,131,,,9,8,8,2
Pat Connaughton,G,22023,1626192,22300245,"NOV 26, 2023",MIL vs. POR,W,20,2,4,0.5,1,2,0.5,0,0,0.0,2,2,4,1,1,0,2,1,5,4,1,MIL,MIL,POR,108,,,10,9,6,5
Pat Connaughton,G,22023,1626192,22300049,"NOV 24, 2023",MIL vs. WAS,W,27,1,5,0.2,0,3,0.0,0,2,0.0,0,4,4,1,1,0,1,1,2,2,1,MIL,MIL,WAS,131,,,7,6,3,5
Pat Connaughton,G,22023,1626192,22300228,"NOV 22, 2023",MIL @ BOS,L,20,1,2,0.5,1,2,0.5,0,0,0.0,0,3,3,0,0,1,1,0,3,-9,1,MIL,BOS,MIL,116,,,6,6,3,3
Pat Connaughton,G,22023,1626192,22300219,"NOV 20, 2023",MIL @ WAS,W,26,1,2,0.5,1,2,0.5,0,0,0.0,1,3,4,4,0,0,0,1,3,-4,1,MIL,WAS,MIL,142,,,11,7,7,8
Pat Connaughton,G,22023,1626192,22300205,"NOV 18, 2023",MIL vs. DAL,W,35,6,12,0.5,4,9,0.444,0,0,0.0,2,3,5,3,2,0,2,1,16,22,1,MIL,MIL,DAL,132,,,24,21,19,8
Pat Connaughton,G,22023,1626192,22300027,"NOV 17, 2023",MIL @ CHA,W,31,4,9,0.444,3,6,0.5,0,0,0.0,1,6,7,3,0,0,1,0,11,2,1,MIL,CHA,MIL,130,,,21,18,14,10
Pat Connaughton,G,22023,1626192,22300190,"NOV 13, 2023",MIL vs. CHI,W,29,1,3,0.333,1,3,0.333,3,3,1.0,1,7,8,5,1,0,0,4,6,9,1,MIL,MIL,CHI,118,,,19,14,11,13
Pat Connaughton,G,22023,1626192,22300173,"NOV 11, 2023",MIL @ ORL,L,16,1,3,0.333,0,1,0.0,1,2,0.5,0,3,3,1,0,0,0,2,3,-11,1,MIL,ORL,MIL,97,,,7,6,4,4
Pat Connaughton,G,22023,1626192,22300171,"NOV 09, 2023",MIL @ IND,L,25,3,6,0.5,1,3,0.333,1,1,1.0,0,2,2,4,1,0,0,0,8,17,1,MIL,IND,MIL,124,,,14,10,12,6
Pat Connaughton,G,22023,1626192,22300165,"NOV 08, 2023",MIL vs. DET,W,19,1,3,0.333,0,1,0.0,0,0,0.0,0,0,0,1,0,0,1,0,2,-4,1,MIL,MIL,DET,120,,,3,2,3,1
Pat Connaughton,G,22023,1626192,22300149,"NOV 06, 2023",MIL @ BKN,W,19,4,7,0.571,2,5,0.4,0,0,0.0,1,0,1,3,0,0,1,1,10,-1,1,MIL,BKN,MIL,129,,,14,11,13,4
Pat Connaughton,G,22023,1626192,22300002,"NOV 03, 2023",MIL vs. NYK,W,24,1,4,0.25,0,2,0.0,0,0,0.0,2,0,2,2,1,0,1,2,2,-4,1,MIL,MIL,NYK,110,,,6,4,4,4
Pat Connaughton,G,22023,1626192,22300116,"NOV 01, 2023",MIL @ TOR,L,23,1,2,0.5,0,1,0.0,1,2,0.5,0,2,2,1,0,0,1,1,3,-10,1,MIL,TOR,MIL,111,,,6,5,4,3
Pat Connaughton,G,22023,1626192,22300107,"OCT 30, 2023",MIL vs. MIA,W,23,3,5,0.6,2,3,0.667,0,0,0.0,0,5,5,2,0,1,1,2,8,5,1,MIL,MIL,MIA,122,,,15,13,10,7
Pat Connaughton,G,22023,1626192,22300097,"OCT 29, 2023",MIL vs. ATL,L,23,2,9,0.222,1,6,0.167,0,0,0.0,1,2,3,2,2,0,1,1,5,-15,1,MIL,MIL,ATL,110,,,10,8,7,5
Pat Connaughton,G,22023,1626192,22300075,"OCT 26, 2023",MIL vs. PHI,W,20,2,6,0.333,1,4,0.25,2,2,1.0,0,2,2,2,0,1,0,0,7,-5,1,MIL,MIL,PHI,118,,,11,9,9,4
Pat Connaughton,G,22023,1626192,22300572,"JAN 17, 2024",MIL @ CLE,L,14,3,4,0.75,2,3,0.667,0,0,0.0,0,1,1,1,0,1,0,0,8,-3,1,MIL,CLE,MIL,95,,,10,9,9,2
Pat Connaughton,G,22023,1626192,22300195,"NOV 15, 2023",MIL @ TOR,W,22,1,3,0.333,1,3,0.333,0,0,0.0,1,6,7,0,0,0,1,2,3,10,1,MIL,TOR,MIL,128,,,10,10,3,7
Gary Payton II,G,22023,1627780,22300757,"FEB 10, 2024",GSW vs. PHX,W,14,5,5,1.0,1,1,1.0,0,0,0.0,2,2,4,2,1,1,0,2,11,-2,1,GSW,GSW,PHX,113,,,17,15,13,6
Gary Payton II,G,22023,1627780,22300463,"JAN 02, 2024",GSW vs. ORL,W,11,1,5,0.2,0,3,0.0,0,0,0.0,1,3,4,0,0,0,1,0,2,10,1,GSW,GSW,ORL,121,,,6,6,2,4
Gary Payton II,G,22023,1627780,22300444,"DEC 30, 2023",GSW vs. DAL,L,9,1,3,0.333,0,1,0.0,0,0,0.0,0,0,0,0,0,1,0,3,2,-1,1,GSW,GSW,DAL,122,,,2,2,2,0
Gary Payton II,G,22023,1627780,22300060,"NOV 28, 2023",GSW @ SAC,L,17,3,4,0.75,0,1,0.0,1,1,1.0,1,4,5,1,2,1,1,3,7,-9,1,GSW,SAC,GSW,123,,,13,12,8,6
Gary Payton II,G,22023,1627780,22300051,"NOV 24, 2023",GSW vs. SAS,W,19,2,3,0.667,0,1,0.0,0,0,0.0,0,3,3,0,1,1,2,4,4,0,1,GSW,GSW,SAS,118,,,7,7,4,3
Gary Payton II,G,22023,1627780,22300186,"NOV 12, 2023",GSW vs. MIN,L,14,2,2,1.0,0,0,0.0,0,0,0.0,2,2,4,2,0,0,1,2,4,-2,1,GSW,GSW,MIN,110,,,10,8,6,6
Gary Payton II,G,22023,1627780,22300176,"NOV 11, 2023",GSW vs. CLE,L,11,1,4,0.25,0,1,0.0,1,2,0.5,2,3,5,0,0,0,1,0,3,-12,1,GSW,GSW,CLE,110,,,8,8,3,5
Gary Payton II,G,22023,1627780,22300145,"NOV 06, 2023",GSW @ DET,W,24,3,5,0.6,0,0,0.0,0,0,0.0,4,2,6,0,2,0,0,2,6,11,1,GSW,DET,GSW,120,,,12,12,6,6
Gary Payton II,G,22023,1627780,22300142,"NOV 05, 2023",GSW @ CLE,L,12,2,7,0.286,1,3,0.333,0,0,0.0,2,0,2,1,0,0,0,2,5,-10,1,GSW,CLE,GSW,104,,,8,7,6,3
Gary Payton II,G,22023,1627780,22300005,"NOV 03, 2023",GSW @ OKC,W,22,4,6,0.667,1,3,0.333,0,0,0.0,0,3,3,1,2,0,1,2,9,9,1,GSW,OKC,GSW,141,,,13,12,10,4
Gary Payton II,G,22023,1627780,22300126,"NOV 01, 2023",GSW vs. SAC,W,22,2,4,0.5,0,0,0.0,0,0,0.0,0,2,2,1,1,0,1,0,4,5,1,GSW,GSW,SAC,102,,,7,6,5,3
Gary Payton II,G,22023,1627780,22300108,"OCT 30, 2023",GSW @ NOP,W,20,4,10,0.4,2,6,0.333,0,0,0.0,2,2,4,1,1,1,0,4,10,17,1,GSW,NOP,GSW,130,,,15,14,11,5
Gary Payton II,G,22023,1627780,22300096,"OCT 29, 2023",GSW @ HOU,W,19,6,8,0.75,3,4,0.75,0,0,0.0,0,4,4,1,3,1,0,1,15,13,1,GSW,HOU,GSW,106,,,20,19,16,5
Gary Payton II,G,22023,1627780,22300087,"OCT 27, 2023",GSW @ SAC,W,18,2,4,0.5,1,3,0.333,2,2,1.0,0,0,0,1,1,0,2,3,7,-3,1,GSW,SAC,GSW,122,,,8,7,8,1
Gary Payton II,G,22023,1627780,22300062,"OCT 24, 2023",GSW vs. PHX,L,22,0,5,0.0,0,2,0.0,1,2,0.5,0,2,2,2,3,0,0,1,1,15,1,GSW,GSW,PHX,104,,,5,3,3,4
Gary Payton II,G,22023,1627780,22300025,"NOV 14, 2023",GSW vs. MIN,L,16,3,5,0.6,1,3,0.333,0,0,0.0,1,2,3,2,0,0,0,1,7,-3,1,GSW,GSW,MIN,101,,,12,10,9,5
Gary Payton II,G,22023,1627780,22300201,"NOV 16, 2023",GSW vs. OKC,L,8,0,4,0.0,0,1,0.0,1,2,0.5,1,0,1,0,1,0,0,1,1,-12,1,GSW,GSW,OKC,109,,,2,2,1,1
Gabe Vincent,G,22023,1629216,22300370,"DEC 20, 2023",LAL @ CHI,L,14,1,4,0.25,1,3,0.333,0,0,0.0,0,1,1,3,0,0,0,2,3,-12,1,LAL,CHI,LAL,108,,,7,4,6,4
Gabe Vincent,G,22023,1629216,22300061,"OCT 24, 2023",LAL @ DEN,L,22,3,8,0.375,0,4,0.0,0,0,0.0,1,0,1,2,1,0,2,3,6,-17,1,LAL,DEN,LAL,107,,,9,7,8,3
Gabe Vincent,G,22023,1629216,22300111,"OCT 30, 2023",LAL vs. ORL,W,25,4,7,0.571,1,3,0.333,0,0,0.0,0,0,0,2,1,0,0,2,9,10,1,LAL,LAL,ORL,106,,,11,9,11,2
Gabe Vincent,G,22023,1629216,22300100,"OCT 29, 2023",LAL @ SAC,L,32,1,3,0.333,0,2,0.0,0,0,0.0,0,0,0,2,1,0,0,4,2,4,1,LAL,SAC,LAL,127,,,4,2,4,2
Gabe Vincent,G,22023,1629216,22300076,"OCT 26, 2023",LAL vs. PHX,W,35,3,10,0.3,0,5,0.0,1,2,0.5,1,2,3,6,3,0,0,1,7,13,1,LAL,LAL,PHX,100,,,16,10,13,9
Amir Coffey,G-F,22023,1629599,22300099,"OCT 29, 2023",LAC vs. SAS,W,6,0,0,0.0,0,0,0.0,0,0,0.0,0,1,1,1,0,0,1,0,0,10,1,LAC,LAC,SAS,123,,,2,1,1,2
Amir Coffey,G-F,22023,1629599,22300074,"OCT 25, 2023",LAC vs. POR,W,4,0,1,0.0,0,0,0.0,2,2,1.0,0,0,0,1,0,0,0,0,2,-7,1,LAC,LAC,POR,123,,,3,2,3,1
Amir Coffey,G-F,22023,1629599,22300731,"FEB 07, 2024",LAC vs. NOP,L,21,2,4,0.5,2,4,0.5,2,2,1.0,0,0,0,3,0,0,0,0,8,-7,1,LAC,LAC,NOP,106,,,11,8,11,3
Amir Coffey,G-F,22023,1629599,22300688,"FEB 02, 2024",LAC @ DET,W,24,5,7,0.714,1,1,1.0,3,3,1.0,0,4,4,0,4,1,1,0,14,9,1,LAC,DET,LAC,136,,,18,18,14,4
Amir Coffey,G-F,22023,1629599,22300676,"JAN 31, 2024",LAC @ WAS,W,21,5,7,0.714,2,2,1.0,5,5,1.0,0,1,1,1,1,0,1,1,17,15,1,LAC,WAS,LAC,125,,,19,18,18,2
Amir Coffey,G-F,22023,1629599,22300658,"JAN 29, 2024",LAC @ CLE,L,27,5,9,0.556,2,5,0.4,1,2,0.5,0,1,1,1,1,0,0,1,13,-5,1,LAC,CLE,LAC,108,,,15,14,14,2
Amir Coffey,G-F,22023,1629599,22300646,"JAN 27, 2024",LAC @ BOS,W,26,4,9,0.444,0,4,0.0,2,2,1.0,1,2,3,1,0,2,0,0,10,-7,1,LAC,BOS,LAC,115,,,14,13,11,4
Amir Coffey,G-F,22023,1629599,22300637,"JAN 26, 2024",LAC @ TOR,W,19,1,2,0.5,0,1,0.0,3,3,1.0,0,2,2,2,0,0,1,6,5,0,1,LAC,TOR,LAC,127,,,9,7,7,4
Amir Coffey,G-F,22023,1629599,22300537,"JAN 12, 2024",LAC @ MEM,W,26,6,6,1.0,1,1,1.0,0,1,0.0,0,2,2,1,2,0,1,0,13,-4,1,LAC,MEM,LAC,128,,,16,15,14,3
Amir Coffey,G-F,22023,1629599,22300511,"JAN 08, 2024",LAC vs. PHX,W,23,4,5,0.8,1,1,1.0,0,0,0.0,0,2,2,0,0,0,0,3,9,12,1,LAC,LAC,PHX,138,,,11,11,9,2
Amir Coffey,G-F,22023,1629599,22300486,"JAN 05, 2024",LAC @ NOP,W,21,2,4,0.5,0,2,0.0,0,0,0.0,1,2,3,0,1,0,2,1,4,0,1,LAC,NOP,LAC,111,,,7,7,4,3
Amir Coffey,G-F,22023,1629599,22300458,"JAN 01, 2024",LAC vs. MIA,W,19,2,3,0.667,1,2,0.5,0,0,0.0,1,0,1,2,0,0,0,2,5,-7,1,LAC,LAC,MIA,121,,,8,6,7,3
Amir Coffey,G-F,22023,1629599,22300389,"DEC 23, 2023",LAC vs. BOS,L,17,1,3,0.333,0,1,0.0,0,0,0.0,0,2,2,1,0,0,1,0,2,-11,1,LAC,LAC,BOS,108,,,5,4,3,3
Amir Coffey,G-F,22023,1629599,22300379,"DEC 21, 2023",LAC @ OKC,L,33,4,7,0.571,1,4,0.25,0,0,0.0,2,2,4,1,0,0,1,2,9,-8,1,LAC,OKC,LAC,115,,,14,13,10,5
Amir Coffey,G-F,22023,1629599,22300350,"DEC 18, 2023",LAC @ IND,W,18,0,1,0.0,0,1,0.0,0,0,0.0,0,3,3,2,0,0,0,2,0,-9,1,LAC,IND,LAC,151,,,5,3,2,5
Amir Coffey,G-F,22023,1629599,22300343,"DEC 16, 2023",LAC vs. NYK,W,17,1,3,0.333,1,3,0.333,0,0,0.0,0,1,1,0,0,0,0,3,3,1,1,LAC,LAC,NYK,144,,,4,4,3,1
Amir Coffey,G-F,22023,1629599,22300618,"JAN 23, 2024",LAC vs. LAL,W,24,3,4,0.75,3,3,1.0,0,0,0.0,0,2,2,0,1,0,0,2,9,9,1,LAC,LAC,LAL,127,,,11,11,9,2
Amir Coffey,G-F,22023,1629599,22300438,"DEC 29, 2023",LAC vs. MEM,W,31,5,6,0.833,3,4,0.75,0,0,0.0,1,1,2,2,1,0,0,0,13,23,1,LAC,LAC,MEM,117,,,17,15,15,4
Amir Coffey,G-F,22023,1629599,22300414,"DEC 26, 2023",LAC vs. CHA,W,23,1,3,0.333,0,1,0.0,2,2,1.0,0,2,2,0,0,0,0,0,4,-1,1,LAC,LAC,CHA,113,,,6,6,4,2
Amir Coffey,G-F,22023,1629599,22300325,"DEC 14, 2023",LAC vs. GSW,W,29,6,15,0.4,4,11,0.364,2,3,0.667,1,3,4,1,0,0,1,2,18,5,1,LAC,LAC,GSW,121,,,23,22,19,5
Amir Coffey,G-F,22023,1629599,22300309,"DEC 12, 2023",LAC vs. SAC,W,9,1,1,1.0,0,0,0.0,0,0,0.0,1,0,1,0,0,0,0,0,2,-12,1,LAC,LAC,SAC,117,,,3,3,2,1
Amir Coffey,G-F,22023,1629599,22300273,"NOV 30, 2023",LAC @ GSW,L,1,0,0,0.0,0,0,0.0,0,0,0.0,0,0,0,0,0,0,0,2,0,2,1,LAC,GSW,LAC,114,,,0,0,0,0
Amir Coffey,G-F,22023,1629599,22300264,"NOV 29, 2023",LAC @ SAC,W,1,0,0,0.0,0,0,0.0,0,0,0.0,0,0,0,0,0,0,0,0,0,0,1,LAC,SAC,LAC,131,,,0,0,0,0
Amir Coffey,G-F,22023,1629599,22300244,"NOV 25, 2023",LAC vs. DAL,W,5,0,0,0.0,0,0,0.0,0,0,0.0,1,0,1,1,0,0,0,1,0,-1,1,LAC,LAC,DAL,107,,,2,1,1,2
Amir Coffey,G-F,22023,1629599,22300014,"NOV 10, 2023",LAC @ DAL,L,13,2,6,0.333,0,2,0.0,2,2,1.0,0,2,2,0,0,0,0,1,6,8,1,LAC,DAL,LAC,126,,,8,8,6,2
Amir Coffey,G-F,22023,1629599,22300151,"NOV 06, 2023",LAC @ NYK,L,4,0,0,0.0,0,0,0.0,0,0,0.0,0,0,0,0,0,0,0,0,0,2,1,LAC,NYK,LAC,97,,,0,0,0,0
Amir Coffey,G-F,22023,1629599,22300114,"OCT 31, 2023",LAC vs. ORL,W,10,0,1,0.0,0,0,0.0,0,0,0.0,0,0,0,0,0,0,1,1,0,-4,1,LAC,LAC,ORL,118,,,0,0,0,0
Amir Coffey,G-F,22023,1629599,22300749,"FEB 10, 2024",LAC vs. DET,W,27,3,8,0.375,2,5,0.4,4,4,1.0,0,1,1,0,1,1,0,1,12,5,1,LAC,LAC,DET,112,,,13,13,12,1
Amir Coffey,G-F,22023,1629599,22300716,"FEB 05, 2024",LAC @ ATL,W,26,4,8,0.5,2,4,0.5,3,4,0.75,0,0,0,2,0,1,0,3,13,-3,1,LAC,ATL,LAC,149,,,15,13,15,2
Amir Coffey,G-F,22023,1629599,22300708,"FEB 04, 2024",LAC @ MIA,W,23,2,3,0.667,1,1,1.0,0,0,0.0,1,2,3,0,1,1,0,3,5,9,1,LAC,MIA,LAC,103,,,8,8,5,3
Amir Coffey,G-F,22023,1629599,22300600,"JAN 21, 2024",LAC vs. BKN,W,15,2,2,1.0,1,1,1.0,0,0,0.0,0,1,1,1,1,0,0,2,5,-13,1,LAC,LAC,BKN,125,,,7,6,6,2
Amir Coffey,G-F,22023,1629599,22300568,"JAN 16, 2024",LAC vs. OKC,W,16,3,4,0.75,3,3,1.0,0,0,0.0,1,2,3,0,0,0,0,2,9,-2,1,LAC,LAC,OKC,128,,,12,12,9,3
Amir Coffey,G-F,22023,1629599,22300553,"JAN 14, 2024",LAC @ MIN,L,9,0,1,0.0,0,0,0.0,0,0,0.0,1,0,1,0,1,0,1,0,0,-1,1,LAC,MIN,LAC,105,,,1,1,0,1
Amir Coffey,G-F,22023,1629599,22300526,"JAN 10, 2024",LAC vs. TOR,W,18,3,5,0.6,0,2,0.0,0,0,0.0,0,1,1,1,1,0,0,1,6,3,1,LAC,LAC,TOR,126,,,8,7,7,2
Amir Coffey,G-F,22023,1629599,22300505,"JAN 07, 2024",LAC @ LAL,L,13,0,1,0.0,0,0,0.0,0,0,0.0,0,1,1,0,0,0,0,0,0,-7,1,LAC,LAL,LAC,103,,,1,1,0,1
Amir Coffey,G-F,22023,1629599,22300473,"JAN 03, 2024",LAC @ PHX,W,13,1,1,1.0,0,0,0.0,1,2,0.5,0,0,0,1,0,0,0,1,3,0,1,LAC,PHX,LAC,131,,,4,3,4,1
Amir Coffey,G-F,22023,1629599,22300372,"DEC 20, 2023",LAC @ DAL,W,39,3,6,0.5,2,5,0.4,4,4,1.0,0,5,5,3,1,0,3,5,12,-3,1,LAC,DAL,LAC,120,,,20,17,15,8
Amir Coffey,G-F,22023,1629599,22300235,"NOV 22, 2023",LAC @ SAS,W,10,2,3,0.667,0,1,0.0,0,0,0.0,1,2,3,0,1,0,0,0,4,8,1,LAC,SAS,LAC,109,,,7,7,4,3
Amir Coffey,G-F,22023,1629599,22300223,"NOV 20, 2023",LAC @ SAS,W,4,0,1,0.0,0,0,0.0,0,0,0.0,0,0,0,0,0,0,0,0,0,3,1,LAC,SAS,LAC,124,,,0,0,0,0
Kevon Looney,C,22023,1626172,22300757,"FEB 10, 2024",GSW vs. PHX,W,5,1,1,1.0,0,0,0.0,1,2,0.5,2,2,4,0,0,0,1,2,3,1,1,GSW,GSW,PHX,113,,,7,7,3,4
Kevon Looney,C,22023,1626172,22300733,"FEB 08, 2024",GSW @ IND,W,5,1,1,1.0,0,0,0.0,0,0,0.0,1,0,1,0,0,0,1,2,2,-8,1,GSW,IND,GSW,131,,,3,3,2,1
Kevon Looney,C,22023,1626172,22300727,"FEB 07, 2024",GSW @ PHI,W,17,4,8,0.5,0,0,0.0,1,1,1.0,3,6,9,2,0,2,0,3,9,15,1,GSW,PHI,GSW,127,,,20,18,11,11
Kevon Looney,C,22023,1626172,22300717,"FEB 05, 2024",GSW @ BKN,W,13,1,2,0.5,0,0,0.0,0,0,0.0,2,3,5,3,0,1,0,4,2,3,1,GSW,BKN,GSW,109,,,10,7,5,8
Kevon Looney,C,22023,1626172,22300699,"FEB 03, 2024",GSW @ ATL,L,15,0,0,0.0,0,0,0.0,0,0,0.0,2,8,10,1,0,0,1,2,0,3,1,GSW,ATL,GSW,134,,,11,10,1,11
Kevon Looney,C,22023,1626172,22300693,"FEB 02, 2024",GSW @ MEM,W,11,4,4,1.0,0,0,0.0,1,3,0.333,0,1,1,1,1,0,3,1,9,8,1,GSW,MEM,GSW,121,,,11,10,10,2
Kevon Looney,C,22023,1626172,22300673,"JAN 30, 2024",GSW vs. PHI,W,8,0,1,0.0,0,0,0.0,0,0,0.0,0,3,3,1,0,1,0,0,0,-5,1,GSW,GSW,PHI,119,,,4,3,1,4
Kevon Looney,C,22023,1626172,22300650,"JAN 27, 2024",GSW vs. LAL,L,5,0,2,0.0,0,1,0.0,0,0,0.0,0,1,1,1,0,0,2,2,0,-14,1,GSW,GSW,LAL,144,,,2,1,1,2
Kevon Looney,C,22023,1626172,22300632,"JAN 25, 2024",GSW vs. SAC,L,16,2,2,1.0,0,0,0.0,0,0,0.0,0,3,3,2,0,1,1,2,4,-15,1,GSW,GSW,SAC,133,,,9,7,6,5
Kevon Looney,C,22023,1626172,22300626,"JAN 24, 2024",GSW vs. ATL,W,10,1,2,0.5,0,0,0.0,0,0,0.0,2,5,7,1,1,1,1,1,2,-3,1,GSW,GSW,ATL,134,,,10,9,3,8
Kevon Looney,C,22023,1626172,22300560,"JAN 15, 2024",GSW @ MEM,L,18,4,4,1.0,0,0,0.0,0,0,0.0,1,4,5,2,1,0,1,1,8,-1,1,GSW,MEM,GSW,107,,,15,13,10,7
Kevon Looney,C,22023,1626172,22300536,"JAN 12, 2024",GSW @ CHI,W,27,4,4,1.0,0,0,0.0,1,2,0.5,3,2,5,1,0,1,0,2,9,-7,1,GSW,CHI,GSW,140,,,15,14,10,6
Kevon Looney,C,22023,1626172,22300525,"JAN 10, 2024",GSW vs. NOP,L,19,3,3,1.0,0,0,0.0,1,2,0.5,2,5,7,0,0,1,0,4,7,-3,1,GSW,GSW,NOP,105,,,14,14,7,7
Kevon Looney,C,22023,1626172,22300504,"JAN 07, 2024",GSW vs. TOR,L,17,4,6,0.667,0,0,0.0,2,2,1.0,7,0,7,2,0,0,1,2,10,-7,1,GSW,GSW,TOR,118,,,19,17,12,9
Kevon Looney,C,22023,1626172,22300490,"JAN 05, 2024",GSW vs. DET,W,12,1,1,1.0,0,0,0.0,2,2,1.0,1,3,4,1,0,0,0,2,4,6,1,GSW,GSW,DET,113,,,9,8,5,5
Kevon Looney,C,22023,1626172,22300478,"JAN 04, 2024",GSW vs. DEN,L,22,3,4,0.75,0,0,0.0,1,1,1.0,2,2,4,3,0,0,0,5,7,-2,1,GSW,GSW,DEN,127,,,14,11,10,7
Kevon Looney,C,22023,1626172,22300463,"JAN 02, 2024",GSW vs. ORL,W,17,1,2,0.5,0,0,0.0,3,4,0.75,1,4,5,2,0,0,0,4,5,10,1,GSW,GSW,ORL,121,,,12,10,7,7
Kevon Looney,C,22023,1626172,22300444,"DEC 30, 2023",GSW vs. DAL,L,11,2,2,1.0,0,0,0.0,1,2,0.5,2,1,3,1,0,0,0,2,5,-7,1,GSW,GSW,DAL,122,,,9,8,6,4
Kevon Looney,C,22023,1626172,22300426,"DEC 28, 2023",GSW vs. MIA,L,14,2,2,1.0,0,0,0.0,1,3,0.333,3,2,5,0,0,1,0,3,5,-9,1,GSW,GSW,MIA,102,,,10,10,5,5
Kevon Looney,C,22023,1626172,22300402,"DEC 25, 2023",GSW @ DEN,L,22,2,3,0.667,0,0,0.0,0,0,0.0,0,3,3,2,0,0,1,3,4,-9,1,GSW,DEN,GSW,114,,,9,7,6,5
Kevon Looney,C,22023,1626172,22300399,"DEC 23, 2023",GSW vs. POR,W,22,2,3,0.667,0,0,0.0,2,2,1.0,6,5,11,7,0,0,3,2,6,15,1,GSW,GSW,POR,126,,,24,17,13,18
Kevon Looney,C,22023,1626172,22300386,"DEC 22, 2023",GSW vs. WAS,W,11,2,3,0.667,0,0,0.0,1,1,1.0,2,3,5,0,0,0,0,2,5,1,1,GSW,GSW,WAS,129,,,10,10,5,5
Kevon Looney,C,22023,1626172,22300362,"DEC 19, 2023",GSW vs. BOS,W,14,1,2,0.5,0,0,0.0,1,1,1.0,1,5,6,2,0,0,1,0,3,-19,1,GSW,GSW,BOS,132,,,11,9,5,8
Kevon Looney,C,22023,1626172,22300348,"DEC 17, 2023",GSW @ POR,W,15,2,5,0.4,0,0,0.0,0,0,0.0,1,3,4,2,1,1,0,2,4,-2,1,GSW,POR,GSW,118,,,10,8,6,6
Kevon Looney,C,22023,1626172,22300339,"DEC 16, 2023",GSW vs. BKN,W,27,2,5,0.4,0,0,0.0,0,0,0.0,1,6,7,3,1,0,0,2,4,6,1,GSW,GSW,BKN,124,,,14,11,7,10
Kevon Looney,C,22023,1626172,22300325,"DEC 14, 2023",GSW @ LAC,L,26,4,7,0.571,0,0,0.0,0,0,0.0,5,2,7,5,1,0,1,2,8,0,1,GSW,LAC,GSW,113,,,20,15,13,12
Kevon Looney,C,22023,1626172,22300308,"DEC 12, 2023",GSW @ PHX,L,11,0,0,0.0,0,0,0.0,0,0,0.0,2,3,5,2,1,0,0,2,0,-13,1,GSW,PHX,GSW,116,,,7,5,2,7
Kevon Looney,C,22023,1626172,22301222,"DEC 08, 2023",GSW @ OKC,L,16,2,2,1.0,0,0,0.0,1,3,0.333,1,3,4,2,0,0,2,1,5,3,1,GSW,OKC,GSW,136,,,11,9,7,6
Kevon Looney,C,22023,1626172,22301214,"DEC 06, 2023",GSW vs. POR,W,16,2,6,0.333,0,0,0.0,2,2,1.0,2,6,8,0,1,0,0,2,6,-7,1,GSW,GSW,POR,110,,,14,14,6,8
Kevon Looney,C,22023,1626172,22300280,"DEC 02, 2023",GSW @ LAC,L,18,3,3,1.0,0,0,0.0,1,2,0.5,0,8,8,3,0,1,1,1,7,3,1,GSW,LAC,GSW,112,,,18,15,10,11
Kevon Looney,C,22023,1626172,22300273,"NOV 30, 2023",GSW vs. LAC,W,13,0,4,0.0,0,0,0.0,2,2,1.0,2,3,5,2,0,0,0,2,2,-6,1,GSW,GSW,LAC,120,,,9,7,4,7
Kevon Looney,C,22023,1626172,22300060,"NOV 28, 2023",GSW @ SAC,L,29,0,1,0.0,0,0,0.0,2,4,0.5,1,4,5,2,1,0,0,4,2,5,1,GSW,SAC,GSW,123,,,9,7,4,7
Kevon Looney,C,22023,1626172,22300051,"NOV 24, 2023",GSW vs. SAS,W,24,2,3,0.667,0,0,0.0,2,3,0.667,1,7,8,4,2,0,2,3,6,-3,1,GSW,GSW,SAS,118,,,18,14,10,12
Kevon Looney,C,22023,1626172,22300236,"NOV 22, 2023",GSW @ PHX,L,17,3,5,0.6,0,0,0.0,0,0,0.0,1,5,6,2,1,0,2,4,6,-5,1,GSW,PHX,GSW,115,,,14,12,8,8
Kevon Looney,C,22023,1626172,22300224,"NOV 20, 2023",GSW vs. HOU,W,22,2,4,0.5,0,0,0.0,3,4,0.75,1,4,5,3,0,0,0,3,7,2,1,GSW,GSW,HOU,121,,,15,12,10,8
Kevon Looney,C,22023,1626172,22300207,"NOV 18, 2023",GSW vs. OKC,L,35,3,6,0.5,0,0,0.0,0,0,0.0,7,9,16,5,0,1,1,0,6,-1,1,GSW,GSW,OKC,123,,,27,22,11,21
Kevon Looney,C,22023,1626172,22300186,"NOV 12, 2023",GSW vs. MIN,L,19,1,3,0.333,0,0,0.0,0,0,0.0,5,1,6,0,1,0,0,3,2,-12,1,GSW,GSW,MIN,110,,,8,8,2,6
Kevon Looney,C,22023,1626172,22300176,"NOV 11, 2023",GSW vs. CLE,L,24,1,2,0.5,0,0,0.0,0,0,0.0,3,10,13,2,0,0,1,5,2,-3,1,GSW,GSW,CLE,110,,,17,15,4,15
Kevon Looney,C,22023,1626172,22300169,"NOV 08, 2023",GSW @ DEN,L,30,4,4,1.0,0,0,0.0,2,3,0.667,2,6,8,4,1,0,2,5,10,-6,1,GSW,DEN,GSW,105,,,22,18,14,12
Kevon Looney,C,22023,1626172,22300145,"NOV 06, 2023",GSW @ DET,W,25,5,6,0.833,0,0,0.0,0,0,0.0,2,4,6,1,0,2,2,4,10,5,1,GSW,DET,GSW,120,,,17,16,11,7
Kevon Looney,C,22023,1626172,22300142,"NOV 05, 2023",GSW @ CLE,L,15,1,2,0.5,0,0,0.0,0,0,0.0,5,6,11,5,0,0,0,1,2,-6,1,GSW,CLE,GSW,104,,,18,13,7,16
Kevon Looney,C,22023,1626172,22300005,"NOV 03, 2023",GSW @ OKC,W,11,1,2,0.5,0,0,0.0,2,2,1.0,1,2,3,4,1,1,2,4,4,-5,1,GSW,OKC,GSW,141,,,11,7,8,7
Kevon Looney,C,22023,1626172,22300126,"NOV 01, 2023",GSW vs. SAC,W,23,3,4,0.75,0,0,0.0,0,0,0.0,2,7,9,6,1,0,0,2,6,0,1,GSW,GSW,SAC,102,,,21,15,12,15
Kevon Looney,C,22023,1626172,22300108,"OCT 30, 2023",GSW @ NOP,W,25,3,5,0.6,0,0,0.0,2,2,1.0,2,5,7,1,1,0,1,2,8,19,1,GSW,NOP,GSW,130,,,16,15,9,8
Kevon Looney,C,22023,1626172,22300096,"OCT 29, 2023",GSW @ HOU,W,27,2,3,0.667,0,0,0.0,1,2,0.5,2,9,11,1,1,1,1,2,5,5,1,GSW,HOU,GSW,106,,,17,16,6,12
Kevon Looney,C,22023,1626172,22300087,"OCT 27, 2023",GSW @ SAC,W,28,4,6,0.667,0,0,0.0,0,0,0.0,3,9,12,6,3,1,1,3,8,4,1,GSW,SAC,GSW,122,,,26,20,14,18
Kevon Looney,C,22023,1626172,22300062,"OCT 24, 2023",GSW vs. PHX,L,28,3,6,0.5,0,0,0.0,1,1,1.0,5,6,11,1,0,0,2,2,7,-11,1,GSW,GSW,PHX,104,,,19,18,8,12
Kevon Looney,C,22023,1626172,22300025,"NOV 14, 2023",GSW vs. MIN,L,32,1,4,0.25,0,0,0.0,0,0,0.0,6,6,12,3,1,0,0,2,2,2,1,GSW,GSW,MIN,101,,,17,14,5,15
Kevon Looney,C,22023,1626172,22300545,"JAN 13, 2024",GSW @ MIL,L,18,3,6,0.5,0,0,0.0,0,0,0.0,4,2,6,3,0,1,0,2,6,7,1,GSW,MIL,GSW,118,,,15,12,9,9
Kevon Looney,C,22023,1626172,22300201,"NOV 16, 2023",GSW vs. OKC,L,19,6,9,0.667,0,0,0.0,1,2,0.5,7,4,11,1,1,0,1,3,13,-17,1,GSW,GSW,OKC,109,,,25,24,14,12
Kris Dunn,G,22023,1627739,22300711,"FEB 04, 2024",UTA vs. MIL,W,22,1,5,0.2,0,3,0.0,0,0,0.0,1,2,3,6,0,0,1,4,2,5,1,UTA,UTA,MIL,123,,,11,5,8,9
Kris Dunn,G,22023,1627739,22300686,"FEB 01, 2024",UTA vs. PHI,L,16,1,4,0.25,1,1,1.0,0,0,0.0,0,3,3,4,0,2,1,0,3,3,1,UTA,UTA,PHI,124,,,10,6,7,7
Kris Dunn,G,22023,1627739,22300671,"JAN 30, 2024",UTA @ NYK,L,17,3,5,0.6,0,0,0.0,0,0,0.0,2,1,3,6,1,0,3,2,6,-5,1,UTA,NYK,UTA,103,,,15,9,12,9
Kris Dunn,G,22023,1627739,22300660,"JAN 29, 2024",UTA @ BKN,L,17,3,5,0.6,3,3,1.0,0,0,0.0,0,2,2,2,2,0,4,1,9,-7,1,UTA,BKN,UTA,114,,,13,11,11,4
Kris Dunn,G,22023,1627739,22300647,"JAN 27, 2024",UTA @ CHA,W,17,3,4,0.75,1,1,1.0,0,0,0.0,2,2,4,6,1,1,1,1,7,5,1,UTA,CHA,UTA,134,,,17,11,13,10
Kris Dunn,G,22023,1627739,22300628,"JAN 25, 2024",UTA @ WAS,W,17,2,4,0.5,0,1,0.0,0,0,0.0,0,1,1,3,1,0,0,1,4,2,1,UTA,WAS,UTA,123,,,8,5,7,4
Kris Dunn,G,22023,1627739,22300616,"JAN 23, 2024",UTA @ NOP,L,17,4,7,0.571,2,4,0.5,0,0,0.0,2,1,3,4,0,0,1,3,10,2,1,UTA,NOP,UTA,124,,,17,13,14,7
Kris Dunn,G,22023,1627739,22300598,"JAN 20, 2024",UTA @ HOU,L,27,4,6,0.667,1,2,0.5,1,2,0.5,2,6,8,7,1,0,0,2,10,17,1,UTA,HOU,UTA,126,,,25,18,17,15
Kris Dunn,G,22023,1627739,22300581,"JAN 18, 2024",UTA vs. OKC,L,13,0,2,0.0,0,0,0.0,0,0,0.0,0,1,1,6,0,0,1,4,0,-2,1,UTA,UTA,OKC,129,,,7,1,6,7
Kris Dunn,G,22023,1627739,22300564,"JAN 15, 2024",UTA vs. IND,W,21,2,3,0.667,0,0,0.0,0,0,0.0,1,1,2,6,2,1,1,3,4,21,1,UTA,UTA,IND,132,,,12,6,10,8
Kris Dunn,G,22023,1627739,22300549,"JAN 13, 2024",UTA vs. LAL,W,17,3,4,0.75,1,2,0.5,0,0,0.0,0,0,0,3,1,0,2,2,7,6,1,UTA,UTA,LAL,132,,,10,7,10,3
Kris Dunn,G,22023,1627739,22300540,"JAN 12, 2024",UTA vs. TOR,W,17,3,4,0.75,0,1,0.0,0,0,0.0,2,3,5,5,1,2,2,3,6,15,1,UTA,UTA,TOR,145,,,16,11,11,10
Kris Dunn,G,22023,1627739,22300524,"JAN 10, 2024",UTA vs. DEN,W,26,2,2,1.0,1,1,1.0,0,0,0.0,1,3,4,3,4,1,2,4,5,6,1,UTA,UTA,DEN,124,,,12,9,8,7
Kris Dunn,G,22023,1627739,22300510,"JAN 08, 2024",UTA @ MIL,W,24,2,2,1.0,1,1,1.0,0,0,0.0,1,3,4,13,1,2,1,1,5,11,1,UTA,MIL,UTA,132,,,22,9,18,17
Kris Dunn,G,22023,1627739,22300495,"JAN 06, 2024",UTA @ PHI,W,23,0,1,0.0,0,1,0.0,0,0,0.0,0,5,5,1,1,2,1,3,0,8,1,UTA,PHI,UTA,120,,,6,5,1,6
Kris Dunn,G,22023,1627739,22300479,"JAN 05, 2024",UTA @ BOS,L,26,1,7,0.143,0,1,0.0,0,0,0.0,2,3,5,5,3,1,1,4,2,-9,1,UTA,BOS,UTA,97,,,12,7,7,10
Kris Dunn,G,22023,1627739,22300474,"JAN 03, 2024",UTA vs. DET,W,16,2,6,0.333,0,1,0.0,0,0,0.0,0,1,1,4,3,1,0,0,4,-3,1,UTA,UTA,DET,154,,,9,5,8,5
Kris Dunn,G,22023,1627739,22300457,"JAN 01, 2024",UTA vs. DAL,W,21,3,4,0.75,1,1,1.0,0,0,0.0,0,3,3,7,0,0,2,2,7,-1,1,UTA,UTA,DAL,127,,,17,10,14,10
Kris Dunn,G,22023,1627739,22300439,"DEC 30, 2023",UTA vs. MIA,W,18,1,5,0.2,0,1,0.0,0,0,0.0,0,1,1,6,2,1,1,3,2,0,1,UTA,UTA,MIA,117,,,9,3,8,7
Kris Dunn,G,22023,1627739,22300424,"DEC 28, 2023",UTA @ NOP,L,19,3,5,0.6,1,3,0.333,0,0,0.0,0,0,0,3,0,1,0,2,7,2,1,UTA,NOP,UTA,105,,,10,7,10,3
Kris Dunn,G,22023,1627739,22300412,"DEC 26, 2023",UTA @ SAS,W,19,0,2,0.0,0,1,0.0,2,2,1.0,2,5,7,6,0,0,1,0,2,5,1,UTA,SAS,UTA,130,,,15,9,8,13
Kris Dunn,G,22023,1627739,22300395,"DEC 23, 2023",UTA @ TOR,W,34,3,11,0.273,2,6,0.333,0,0,0.0,0,8,8,13,1,1,2,1,8,10,1,UTA,TOR,UTA,126,,,29,16,21,21
Kris Dunn,G,22023,1627739,22300374,"DEC 21, 2023",UTA @ DET,W,33,5,11,0.455,0,2,0.0,3,4,0.75,1,4,5,10,2,1,1,2,13,11,1,UTA,DET,UTA,119,,,28,18,23,15
Kris Dunn,G,22023,1627739,22300364,"DEC 20, 2023",UTA @ CLE,L,16,3,3,1.0,2,2,1.0,0,0,0.0,0,2,2,1,0,0,4,4,8,-10,1,UTA,CLE,UTA,116,,,11,10,9,3
Kris Dunn,G,22023,1627739,22300357,"DEC 18, 2023",UTA vs. BKN,W,16,2,2,1.0,0,0,0.0,0,0,0.0,2,1,3,5,0,0,0,1,4,6,1,UTA,UTA,BKN,125,,,12,7,9,8
Kris Dunn,G,22023,1627739,22300342,"DEC 16, 2023",UTA @ SAC,L,27,5,10,0.5,1,4,0.25,0,0,0.0,1,3,4,3,1,1,6,1,11,-13,1,UTA,SAC,UTA,104,,,18,15,14,7
Kris Dunn,G,22023,1627739,22300323,"DEC 14, 2023",UTA @ POR,W,26,3,8,0.375,0,2,0.0,0,0,0.0,1,1,2,5,0,0,0,2,6,-17,1,UTA,POR,UTA,122,,,13,8,11,7
Kris Dunn,G,22023,1627739,22300318,"DEC 13, 2023",UTA vs. NYK,W,18,4,4,1.0,2,2,1.0,0,0,0.0,0,2,2,7,1,0,1,3,10,13,1,UTA,UTA,NYK,117,,,19,12,17,9
Kris Dunn,G,22023,1627739,22300302,"DEC 11, 2023",UTA @ OKC,L,25,2,4,0.5,0,1,0.0,0,0,0.0,2,4,6,7,1,0,0,2,4,11,1,UTA,OKC,UTA,120,,,17,10,11,13
Kris Dunn,G,22023,1627739,22301213,"DEC 06, 2023",UTA @ DAL,L,17,3,8,0.375,1,4,0.25,1,2,0.5,1,3,4,2,0,0,0,2,8,-3,1,UTA,DAL,UTA,97,,,14,12,10,6
Kris Dunn,G,22023,1627739,22300243,"NOV 25, 2023",UTA vs. NOP,W,19,4,7,0.571,0,0,0.0,0,0,0.0,1,2,3,2,2,0,2,3,8,2,1,UTA,UTA,NOP,105,,,13,11,10,5
Kris Dunn,G,22023,1627739,22300237,"NOV 22, 2023",UTA @ POR,L,5,0,1,0.0,0,0,0.0,1,2,0.5,0,2,2,1,0,1,0,0,1,2,1,UTA,POR,UTA,105,,,4,3,2,3
Kris Dunn,G,22023,1627739,22300042,"NOV 21, 2023",UTA @ LAL,L,8,2,4,0.5,1,1,1.0,0,0,0.0,0,0,0,2,0,0,2,1,5,1,1,UTA,LAL,UTA,99,,,7,5,7,2
Kris Dunn,G,22023,1627739,22300035,"NOV 17, 2023",UTA vs. PHX,L,0,0,0,0.0,0,0,0.0,0,0,0.0,0,0,0,0,0,0,0,0,0,0,1,UTA,UTA,PHX,128,,,0,0,0,0
Kris Dunn,G,22023,1627739,22300023,"NOV 14, 2023",UTA vs. POR,W,1,0,0,0.0,0,0,0.0,0,0,0.0,0,0,0,0,0,0,1,0,0,0,1,UTA,UTA,POR,115,,,0,0,0,0
Kris Dunn,G,22023,1627739,22300158,"NOV 08, 2023",UTA @ IND,L,12,3,5,0.6,1,1,1.0,0,0,0.0,1,3,4,2,0,0,0,0,7,-3,1,UTA,IND,UTA,118,,,13,11,9,6
Kris Dunn,G,22023,1627739,22300152,"NOV 06, 2023",UTA @ CHI,L,11,1,1,1.0,1,1,1.0,0,0,0.0,2,3,5,3,0,0,2,1,3,-3,1,UTA,CHI,UTA,113,,,11,8,6,8
Kris Dunn,G,22023,1627739,22300130,"NOV 02, 2023",UTA vs. ORL,L,6,1,2,0.5,0,0,0.0,0,0,0.0,0,2,2,3,0,0,0,0,2,-1,1,UTA,UTA,ORL,113,,,7,4,5,5
Kris Dunn,G,22023,1627739,22300125,"NOV 01, 2023",UTA vs. MEM,W,13,1,2,0.5,1,1,1.0,2,2,1.0,0,1,1,3,0,0,0,3,5,10,1,UTA,UTA,MEM,133,,,9,6,8,4
Kris Dunn,G,22023,1627739,22300110,"OCT 30, 2023",UTA @ DEN,L,6,0,2,0.0,0,1,0.0,0,0,0.0,0,2,2,1,0,0,0,1,0,0,1,UTA,DEN,UTA,102,,,3,2,1,3
Kris Dunn,G,22023,1627739,22300094,"OCT 28, 2023",UTA @ PHX,L,20,2,7,0.286,0,1,0.0,0,0,0.0,0,2,2,3,2,0,1,2,4,4,1,UTA,PHX,UTA,104,,,9,6,7,5
Kris Dunn,G,22023,1627739,22300085,"OCT 27, 2023",UTA vs. LAC,W,19,2,7,0.286,0,2,0.0,0,0,0.0,0,1,1,3,1,0,3,6,4,8,1,UTA,UTA,LAC,120,,,8,5,7,4
Kris Dunn,G,22023,1627739,22300072,"OCT 25, 2023",UTA vs. SAC,L,16,3,6,0.5,0,1,0.0,2,4,0.5,0,1,1,2,2,0,4,0,8,-16,1,UTA,UTA,SAC,114,,,11,9,10,3
Kris Dunn,G,22023,1627739,22300739,"FEB 08, 2024",UTA @ PHX,L,24,3,7,0.429,2,3,0.667,1,2,0.5,1,3,4,3,3,0,1,2,9,-3,1,UTA,PHX,UTA,115,,,16,13,12,7
Kris Dunn,G,22023,1627739,22300724,"FEB 06, 2024",UTA vs. OKC,W,27,3,8,0.375,2,5,0.4,0,0,0.0,1,2,3,5,4,3,1,1,8,18,1,UTA,UTA,OKC,124,,,16,11,13,8
Luke Kornet,C-F,22023,1628436,22300706,"FEB 04, 2024",BOS vs. MEM,W,15,0,2,0.0,0,0,0.0,2,2,1.0,5,3,8,1,1,1,1,0,2,-5,1,BOS,BOS,MEM,131,,,11,10,3,9
Luke Kornet,C-F,22023,1628436,22300646,"JAN 27, 2024",BOS vs. LAC,L,18,5,10,0.5,0,0,0.0,1,1,1.0,4,1,5,0,0,1,0,2,11,-15,1,BOS,BOS,LAC,96,,,16,16,11,5
Luke Kornet,C-F,22023,1628436,22300630,"JAN 25, 2024",BOS @ MIA,W,19,4,4,1.0,0,0,0.0,4,4,1.0,1,4,5,1,0,0,0,1,12,10,1,BOS,MIA,BOS,143,,,18,17,13,6
Luke Kornet,C-F,22023,1628436,22300571,"JAN 17, 2024",BOS vs. SAS,W,30,3,5,0.6,0,0,0.0,0,0,0.0,3,6,9,4,1,3,2,2,6,11,1,BOS,BOS,SAS,117,,,19,15,10,13
Luke Kornet,C-F,22023,1628436,22300528,"JAN 11, 2024",BOS @ MIL,L,10,0,0,0.0,0,0,0.0,0,0,0.0,0,0,0,1,0,0,0,1,0,-16,1,BOS,MIL,BOS,102,,,1,0,1,1
Luke Kornet,C-F,22023,1628436,22300507,"JAN 08, 2024",BOS @ IND,L,10,1,4,0.25,0,0,0.0,3,4,0.75,2,0,2,2,0,2,1,2,5,-3,1,BOS,IND,BOS,131,,,9,7,7,4
Luke Kornet,C-F,22023,1628436,22300493,"JAN 06, 2024",BOS @ IND,W,16,1,2,0.5,0,0,0.0,2,2,1.0,3,1,4,3,1,0,1,1,4,3,1,BOS,IND,BOS,118,,,11,8,7,7
Luke Kornet,C-F,22023,1628436,22300479,"JAN 05, 2024",BOS vs. UTA,W,11,1,3,0.333,0,0,0.0,0,0,0.0,4,3,7,0,1,1,1,1,2,13,1,BOS,BOS,UTA,126,,,9,9,2,7
Luke Kornet,C-F,22023,1628436,22300448,"DEC 31, 2023",BOS @ SAS,W,16,5,7,0.714,0,0,0.0,2,2,1.0,3,1,4,2,0,2,0,1,12,6,1,BOS,SAS,BOS,134,,,18,16,14,6
Luke Kornet,C-F,22023,1628436,22300432,"DEC 29, 2023",BOS vs. TOR,W,33,9,11,0.818,0,0,0.0,2,2,1.0,5,3,8,3,0,3,1,3,20,-2,1,BOS,BOS,TOR,120,,,31,28,23,11
Luke Kornet,C-F,22023,1628436,22301227,"DEC 08, 2023",BOS vs. NYK,W,11,2,3,0.667,0,0,0.0,0,0,0.0,1,0,1,1,0,0,0,0,4,-8,1,BOS,BOS,NYK,133,,,6,5,5,2
Luke Kornet,C-F,22023,1628436,22301202,"DEC 04, 2023",BOS @ IND,L,17,3,5,0.6,0,0,0.0,0,0,0.0,4,0,4,2,1,4,1,2,6,-8,1,BOS,IND,BOS,112,,,12,10,8,6
Luke Kornet,C-F,22023,1628436,22300275,"DEC 01, 2023",BOS vs. PHI,W,8,0,0,0.0,0,0,0.0,0,0,0.0,0,1,1,0,0,0,0,1,0,-9,1,BOS,BOS,PHI,125,,,1,1,0,1
Luke Kornet,C-F,22023,1628436,22300053,"NOV 28, 2023",BOS vs. CHI,W,19,2,3,0.667,0,0,0.0,0,0,0.0,2,1,3,0,0,3,1,3,4,9,1,BOS,BOS,CHI,124,,,7,7,4,3
Luke Kornet,C-F,22023,1628436,22300246,"NOV 26, 2023",BOS vs. ATL,W,9,2,2,1.0,0,0,0.0,0,0,0.0,1,1,2,0,1,1,0,1,4,-6,1,BOS,BOS,ATL,113,,,6,6,4,2
Luke Kornet,C-F,22023,1628436,22300043,"NOV 24, 2023",BOS @ ORL,L,25,5,6,0.833,0,0,0.0,2,2,1.0,2,4,6,1,2,2,1,2,12,-2,1,BOS,ORL,BOS,96,,,19,18,13,7
Luke Kornet,C-F,22023,1628436,22300194,"NOV 15, 2023",BOS @ PHI,W,19,4,4,1.0,0,0,0.0,1,2,0.5,3,3,6,1,1,0,2,2,9,-4,1,BOS,PHI,BOS,117,,,16,15,10,7
Luke Kornet,C-F,22023,1628436,22300174,"NOV 11, 2023",BOS vs. TOR,W,9,1,1,1.0,0,0,0.0,0,0,0.0,0,5,5,1,0,0,0,1,2,3,1,BOS,BOS,TOR,117,,,8,7,3,6
Luke Kornet,C-F,22023,1628436,22300010,"NOV 10, 2023",BOS vs. BKN,W,18,3,5,0.6,0,0,0.0,1,1,1.0,6,3,9,1,0,1,0,1,7,-2,1,BOS,BOS,BKN,121,,,17,16,8,10
Luke Kornet,C-F,22023,1628436,22300118,"NOV 01, 2023",BOS vs. IND,W,6,1,1,1.0,0,0,0.0,0,0,0.0,1,1,2,0,0,0,0,0,2,7,1,BOS,BOS,IND,155,,,4,4,2,2
Luke Kornet,C-F,22023,1628436,22300103,"OCT 30, 2023",BOS @ WAS,W,11,0,0,0.0,0,0,0.0,0,0,0.0,0,1,1,1,0,0,1,1,0,-11,1,BOS,WAS,BOS,126,,,2,1,1,2
Luke Kornet,C-F,22023,1628436,22300729,"FEB 07, 2024",BOS vs. ATL,W,21,2,2,1.0,0,0,0.0,0,0,0.0,1,5,6,0,0,2,0,2,4,2,1,BOS,BOS,ATL,125,,,10,10,4,6
Luke Kornet,C-F,22023,1628436,22300603,"JAN 21, 2024",BOS @ HOU,W,23,4,4,1.0,0,0,0.0,0,0,0.0,5,4,9,1,1,3,1,3,8,-2,1,BOS,HOU,BOS,116,,,18,17,9,10
Luke Kornet,C-F,22023,1628436,22300563,"JAN 15, 2024",BOS @ TOR,W,18,2,2,1.0,0,0,0.0,0,0,0.0,0,3,3,0,0,1,0,1,4,12,1,BOS,TOR,BOS,105,,,7,7,4,3
Luke Kornet,C-F,22023,1628436,22300542,"JAN 13, 2024",BOS vs. HOU,W,14,1,2,0.5,0,0,0.0,0,0,0.0,1,1,2,0,0,1,0,5,2,0,1,BOS,BOS,HOU,145,,,4,4,2,2
Luke Kornet,C-F,22023,1628436,22300517,"JAN 10, 2024",BOS vs. MIN,W,18,3,4,0.75,0,0,0.0,2,2,1.0,2,3,5,0,0,1,0,1,8,6,1,BOS,BOS,MIN,127,,,13,13,8,5
Luke Kornet,C-F,22023,1628436,22300217,"NOV 20, 2023",BOS @ CHA,L,19,2,2,1.0,0,0,0.0,0,0,0.0,0,3,3,0,0,1,0,0,4,25,1,BOS,CHA,BOS,118,,,7,7,4,3
Luke Kornet,C-F,22023,1628436,22300136,"NOV 04, 2023",BOS @ BKN,W,15,5,5,1.0,0,0,0.0,1,1,1.0,0,7,7,0,1,0,0,3,11,7,1,BOS,BKN,BOS,124,,,18,18,11,7
Luke Kornet,C-F,22023,1628436,22300743,"FEB 09, 2024",BOS vs. WAS,W,11,0,0,0.0,0,0,0.0,0,0,0.0,0,0,0,0,0,1,0,2,0,4,1,BOS,BOS,WAS,133,,,0,0,0,0
Luke Kornet,C-F,22023,1628436,22300611,"JAN 22, 2024",BOS @ DAL,W,19,1,3,0.333,0,0,0.0,0,0,0.0,1,4,5,1,0,1,2,2,2,-4,1,BOS,DAL,BOS,119,,,8,7,3,6
Luke Kornet,C-F,22023,1628436,22300586,"JAN 19, 2024",BOS vs. DEN,L,8,2,2,1.0,0,0,0.0,0,0,0.0,0,2,2,1,0,0,0,0,4,-1,1,BOS,BOS,DEN,100,,,7,6,5,3
Luke Kornet,C-F,22023,1628436,22300462,"JAN 02, 2024",BOS @ OKC,L,15,0,2,0.0,0,0,0.0,0,0,0.0,2,0,2,0,1,1,0,0,0,-1,1,BOS,OKC,BOS,123,,,2,2,0,2
Luke Kornet,C-F,22023,1628436,22300305,"DEC 12, 2023",BOS vs. CLE,W,8,1,3,0.333,0,0,0.0,2,2,1.0,3,1,4,0,0,0,0,0,4,2,1,BOS,BOS,CLE,120,,,8,8,4,4
Luke Kornet,C-F,22023,1628436,22300159,"NOV 08, 2023",BOS @ PHI,L,3,0,0,0.0,0,0,0.0,0,0,0.0,0,0,0,0,0,0,0,0,0,-3,1,BOS,PHI,BOS,103,,,0,0,0,0
Luke Kornet,C-F,22023,1628436,22300154,"NOV 06, 2023",BOS @ MIN,L,16,1,2,0.5,0,0,0.0,3,4,0.75,1,0,1,0,2,0,0,2,5,4,1,BOS,MIN,BOS,109,,,6,6,5,1
Luke Kornet,C-F,22023,1628436,22300065,"OCT 25, 2023",BOS @ NYK,W,8,0,1,0.0,0,0,0.0,0,0,0.0,1,0,1,2,0,1,0,0,0,-1,1,BOS,NYK,BOS,108,,,3,1,2,3
Anthony Black,G,22023,1641710,22300734,"FEB 08, 2024",ORL vs. SAS,W,3,0,0,0.0,0,0,0.0,0,0,0.0,0,0,0,2,0,0,0,1,0,-3,1,ORL,ORL,SAS,127,,,2,0,2,2
Anthony Black,G,22023,1641710,22300721,"FEB 06, 2024",ORL @ MIA,L,3,0,1,0.0,0,0,0.0,0,0,0.0,0,1,1,0,0,0,1,0,0,-2,1,ORL,MIA,ORL,95,,,1,1,0,1
Anthony Black,G,22023,1641710,22300704,"FEB 04, 2024",ORL @ DET,W,0,0,0,0.0,0,0,0.0,0,0,0.0,0,0,0,0,0,0,0,0,0,-2,1,ORL,DET,ORL,111,,,0,0,0,0
Anthony Black,G,22023,1641710,22300681,"JAN 31, 2024",ORL @ SAS,W,17,0,0,0.0,0,0,0.0,2,2,1.0,0,0,0,1,0,0,0,2,2,4,1,ORL,SAS,ORL,108,,,3,2,3,1
Anthony Black,G,22023,1641710,22300666,"JAN 29, 2024",ORL @ DAL,L,30,7,9,0.778,4,4,1.0,2,2,1.0,0,3,3,1,0,1,1,3,20,-11,1,ORL,DAL,ORL,129,,,24,23,21,4
Anthony Black,G,22023,1641710,22300655,"JAN 28, 2024",ORL vs. PHX,W,13,1,2,0.5,0,1,0.0,2,2,1.0,0,1,1,1,0,1,0,1,4,4,1,ORL,ORL,PHX,113,,,6,5,5,2
Anthony Black,G,22023,1641710,22300638,"JAN 26, 2024",ORL @ MEM,L,27,0,3,0.0,0,1,0.0,2,4,0.5,2,1,3,1,0,0,1,5,2,1,1,ORL,MEM,ORL,106,,,6,5,3,4
Anthony Black,G,22023,1641710,22300607,"JAN 22, 2024",ORL vs. CLE,L,18,3,6,0.5,0,1,0.0,1,2,0.5,1,0,1,2,1,0,0,0,7,-18,1,ORL,ORL,CLE,99,,,10,8,9,3
Anthony Black,G,22023,1641710,22300601,"JAN 21, 2024",ORL vs. MIA,W,14,2,5,0.4,1,2,0.5,1,2,0.5,0,0,0,1,0,0,1,3,6,-3,1,ORL,ORL,MIA,105,,,7,6,7,1
Anthony Black,G,22023,1641710,22300585,"JAN 19, 2024",ORL vs. PHI,L,13,1,2,0.5,1,2,0.5,4,4,1.0,0,3,3,3,0,1,0,2,7,-2,1,ORL,ORL,PHI,109,,,13,10,10,6
Anthony Black,G,22023,1641710,22300570,"JAN 17, 2024",ORL @ ATL,L,0,0,0,0.0,0,0,0.0,0,0,0.0,0,0,0,0,0,0,0,0,0,0,1,ORL,ATL,ORL,104,,,0,0,0,0
Anthony Black,G,22023,1641710,22300546,"JAN 13, 2024",ORL @ OKC,L,33,5,8,0.625,0,1,0.0,3,6,0.5,0,4,4,1,1,1,1,2,13,-9,1,ORL,OKC,ORL,100,,,18,17,14,5
Anthony Black,G,22023,1641710,22300535,"JAN 12, 2024",ORL @ MIA,L,9,0,1,0.0,0,0,0.0,1,2,0.5,0,3,3,1,1,0,0,0,1,4,1,ORL,MIA,ORL,96,,,5,4,2,4
Anthony Black,G,22023,1641710,22300513,"JAN 09, 2024",ORL vs. MIN,L,21,1,4,0.25,1,3,0.333,0,0,0.0,0,1,1,4,3,1,2,2,3,0,1,ORL,ORL,MIN,92,,,8,4,7,5
Anthony Black,G,22023,1641710,22300499,"JAN 07, 2024",ORL vs. ATL,W,12,0,2,0.0,0,1,0.0,0,0,0.0,0,0,0,0,1,0,1,1,0,-10,1,ORL,ORL,ATL,117,,,0,0,0,0
Anthony Black,G,22023,1641710,22300488,"JAN 05, 2024",ORL @ DEN,W,5,0,1,0.0,0,0,0.0,0,0,0.0,0,0,0,1,0,0,0,1,0,-6,1,ORL,DEN,ORL,122,,,1,0,1,1
Anthony Black,G,22023,1641710,22300463,"JAN 02, 2024",ORL @ GSW,L,13,0,2,0.0,0,1,0.0,0,0,0.0,0,0,0,0,1,0,1,2,0,-1,1,ORL,GSW,ORL,115,,,0,0,0,0
Anthony Black,G,22023,1641710,22300450,"DEC 31, 2023",ORL @ PHX,L,22,1,3,0.333,0,1,0.0,0,0,0.0,0,2,2,0,0,0,2,2,2,-19,1,ORL,PHX,ORL,107,,,4,4,2,2
Anthony Black,G,22023,1641710,22300429,"DEC 29, 2023",ORL vs. NYK,W,29,2,2,1.0,0,0,0.0,0,0,0.0,2,4,6,5,2,0,1,4,4,0,1,ORL,ORL,NYK,117,,,15,10,9,11
Anthony Black,G,22023,1641710,22300415,"DEC 27, 2023",ORL vs. PHI,L,23,1,6,0.167,1,3,0.333,0,0,0.0,1,3,4,4,1,1,0,2,3,-3,1,ORL,ORL,PHI,92,,,11,7,7,8
Anthony Black,G,22023,1641710,22300407,"DEC 26, 2023",ORL @ WAS,W,33,9,13,0.692,4,6,0.667,1,1,1.0,1,5,6,1,4,0,5,4,23,-2,1,ORL,WAS,ORL,127,,,30,29,24,7
Anthony Black,G,22023,1641710,22300391,"DEC 23, 2023",ORL @ IND,W,28,2,3,0.667,0,0,0.0,4,4,1.0,0,3,3,2,1,1,2,2,8,-3,1,ORL,IND,ORL,117,,,13,11,10,5
Anthony Black,G,22023,1641710,22300378,"DEC 21, 2023",ORL @ MIL,L,20,0,0,0.0,0,0,0.0,1,2,0.5,0,2,2,1,1,2,1,2,1,-20,1,ORL,MIL,ORL,114,,,4,3,2,3
Anthony Black,G,22023,1641710,22300366,"DEC 20, 2023",ORL vs. MIA,L,22,2,4,0.5,0,1,0.0,0,0,0.0,1,1,2,4,0,0,0,3,4,2,1,ORL,ORL,MIA,106,,,10,6,8,6
Anthony Black,G,22023,1641710,22300344,"DEC 17, 2023",ORL @ BOS,L,17,2,5,0.4,1,3,0.333,0,3,0.0,1,1,2,3,1,0,0,1,5,17,1,ORL,BOS,ORL,97,,,10,7,8,5
Anthony Black,G,22023,1641710,22300329,"DEC 15, 2023",ORL @ BOS,L,28,5,8,0.625,3,5,0.6,0,0,0.0,3,6,9,4,0,0,0,2,13,0,1,ORL,BOS,ORL,111,,,26,22,17,13
Anthony Black,G,22023,1641710,22300294,"DEC 11, 2023",ORL vs. CLE,W,19,0,2,0.0,0,1,0.0,0,0,0.0,0,1,1,0,3,1,1,3,0,12,1,ORL,ORL,CLE,104,,,1,1,0,1
Anthony Black,G,22023,1641710,22301217,"DEC 08, 2023",ORL vs. DET,W,25,2,4,0.5,0,1,0.0,2,4,0.5,1,4,5,3,0,0,1,2,6,7,1,ORL,ORL,DET,123,,,14,11,9,8
Anthony Black,G,22023,1641710,22301205,"DEC 06, 2023",ORL @ CLE,L,15,5,5,1.0,0,0,0.0,1,1,1.0,0,0,0,0,0,0,0,1,11,-7,1,ORL,CLE,ORL,111,,,11,11,11,0
Anthony Black,G,22023,1641710,22300282,"DEC 02, 2023",ORL @ BKN,L,19,1,1,1.0,0,0,0.0,0,0,0.0,0,3,3,1,0,0,0,3,2,-5,1,ORL,BKN,ORL,101,,,6,5,3,4
Anthony Black,G,22023,1641710,22300274,"DEC 01, 2023",ORL vs. WAS,W,23,2,4,0.5,1,1,1.0,1,2,0.5,0,2,2,3,0,1,1,3,6,-5,1,ORL,ORL,WAS,130,,,11,8,9,5
Anthony Black,G,22023,1641710,22300259,"NOV 29, 2023",ORL vs. WAS,W,27,3,5,0.6,1,2,0.5,0,0,0.0,0,5,5,3,0,1,2,1,7,4,1,ORL,ORL,WAS,139,,,15,12,10,8
Anthony Black,G,22023,1641710,22300248,"NOV 26, 2023",ORL vs. CHA,W,15,1,4,0.25,0,1,0.0,0,0,0.0,0,0,0,3,0,0,0,3,2,-2,1,ORL,ORL,CHA,130,,,5,2,5,3
Anthony Black,G,22023,1641710,22300043,"NOV 24, 2023",ORL vs. BOS,W,6,0,1,0.0,0,0,0.0,0,0,0.0,0,1,1,0,0,0,1,1,0,-6,1,ORL,ORL,BOS,113,,,1,1,0,1
Anthony Black,G,22023,1641710,22300226,"NOV 22, 2023",ORL vs. DEN,W,15,0,1,0.0,0,0,0.0,0,0,0.0,0,1,1,1,0,0,3,2,0,4,1,ORL,ORL,DEN,124,,,2,1,1,2
Anthony Black,G,22023,1641710,22300038,"NOV 21, 2023",ORL vs. TOR,W,23,2,7,0.286,0,3,0.0,1,2,0.5,2,3,5,1,1,0,0,3,5,7,1,ORL,ORL,TOR,126,,,11,10,6,6
Anthony Black,G,22023,1641710,22300209,"NOV 19, 2023",ORL @ IND,W,24,1,5,0.2,0,2,0.0,5,6,0.833,0,5,5,1,0,2,2,5,7,-6,1,ORL,IND,ORL,128,,,13,12,8,6
Anthony Black,G,22023,1641710,22300033,"NOV 17, 2023",ORL @ CHI,W,11,1,2,0.5,0,0,0.0,0,1,0.0,0,0,0,0,0,0,3,0,2,-4,1,ORL,CHI,ORL,103,,,2,2,2,0
Anthony Black,G,22023,1641710,22300196,"NOV 15, 2023",ORL @ CHI,W,27,3,8,0.375,0,2,0.0,1,2,0.5,2,2,4,2,0,0,2,3,7,-2,1,ORL,CHI,ORL,96,,,13,11,9,6
Anthony Black,G,22023,1641710,22300020,"NOV 14, 2023",ORL @ BKN,L,19,1,4,0.25,0,3,0.0,0,0,0.0,0,0,0,1,0,0,1,2,2,-4,1,ORL,BKN,ORL,104,,,3,2,3,1
Anthony Black,G,22023,1641710,22300173,"NOV 11, 2023",ORL vs. MIL,W,28,1,3,0.333,0,1,0.0,0,0,0.0,0,0,0,3,0,0,1,2,2,6,1,ORL,ORL,MIL,112,,,5,2,5,3
Anthony Black,G,22023,1641710,22300172,"NOV 09, 2023",ORL vs. ATL,L,17,3,4,0.75,1,2,0.5,2,2,1.0,2,1,3,1,1,1,1,3,9,-3,1,ORL,ORL,ATL,119,,,13,12,10,4
Anthony Black,G,22023,1641710,22300147,"NOV 06, 2023",ORL vs. DAL,L,33,3,7,0.429,2,4,0.5,0,0,0.0,2,3,5,2,0,0,1,2,8,-13,1,ORL,ORL,DAL,102,,,15,13,10,7
Anthony Black,G,22023,1641710,22300134,"NOV 04, 2023",ORL vs. LAL,W,30,4,6,0.667,2,3,0.667,1,1,1.0,1,3,4,2,1,0,0,2,11,32,1,ORL,ORL,LAL,120,,,17,15,13,6
Anthony Black,G,22023,1641710,22300130,"NOV 02, 2023",ORL @ UTA,W,16,4,4,1.0,0,0,0.0,1,3,0.333,1,2,3,1,2,0,1,2,9,6,1,ORL,UTA,ORL,115,,,13,12,10,4
Anthony Black,G,22023,1641710,22300114,"OCT 31, 2023",ORL @ LAC,L,4,0,0,0.0,0,0,0.0,0,0,0.0,0,0,0,1,0,0,0,1,0,-1,1,ORL,LAC,ORL,102,,,1,0,1,1
Anthony Black,G,22023,1641710,22300066,"OCT 25, 2023",ORL vs. HOU,W,5,2,2,1.0,0,0,0.0,1,1,1.0,0,0,0,1,0,2,0,0,5,9,1,ORL,ORL,HOU,116,,,6,5,6,1
Anthony Black,G,22023,1641710,22300476,"JAN 03, 2024",ORL @ SAC,L,25,4,7,0.571,1,1,1.0,0,0,0.0,1,1,2,4,0,0,1,1,9,-1,1,ORL,SAC,ORL,135,,,15,11,13,6
Noah Clowney,F,22023,1641730,22300750,"FEB 10, 2024",BKN vs. SAS,W,4,1,1,1.0,1,1,1.0,0,0,0.0,0,0,0,0,0,0,1,0,3,-4,1,BKN,BKN,SAS,123,,,3,3,3,0
Noah Clowney,F,22023,1641730,22300735,"FEB 08, 2024",BKN vs. CLE,L,23,3,6,0.5,0,2,0.0,2,2,1.0,3,1,4,1,0,0,1,1,8,-5,1,BKN,BKN,CLE,95,,,13,12,9,5
Noah Clowney,F,22023,1641730,22300720,"FEB 06, 2024",BKN vs. DAL,L,4,1,1,1.0,0,0,0.0,0,0,0.0,0,1,1,0,0,0,0,1,2,5,1,BKN,BKN,DAL,107,,,3,3,2,1
Noah Clowney,F,22023,1641730,22300660,"JAN 29, 2024",BKN vs. UTA,W,3,0,1,0.0,0,0,0.0,2,2,1.0,0,2,2,1,0,1,0,0,2,4,1,BKN,BKN,UTA,147,,,5,4,3,3
Noah Clowney,F,22023,1641730,22300417,"DEC 27, 2023",BKN vs. MIL,L,24,6,9,0.667,0,1,0.0,2,2,1.0,3,1,4,2,0,0,1,3,14,-19,1,BKN,BKN,MIL,122,,,20,18,16,6
Noah Clowney,F,22023,1641730,22300240,"NOV 25, 2023",BKN vs. MIA,W,3,0,0,0.0,0,0,0.0,0,0,0.0,0,1,1,0,0,0,0,0,0,-6,1,BKN,BKN,MIA,112,,,1,1,0,1
Bismack Biyombo,C,22023,202687,22300503,"JAN 07, 2024",MEM @ PHX,W,26,0,2,0.0,0,0,0.0,1,2,0.5,1,5,6,2,0,3,2,3,1,-5,1,MEM,PHX,MEM,121,,,9,7,3,8
Bismack Biyombo,C,22023,202687,22300491,"JAN 05, 2024",MEM @ LAL,W,31,3,3,1.0,0,0,0.0,0,0,0.0,1,9,10,1,0,0,2,2,6,17,1,MEM,LAL,MEM,127,,,17,16,7,11
Bismack Biyombo,C,22023,202687,22300460,"JAN 02, 2024",MEM vs. SAS,W,28,2,4,0.5,0,0,0.0,0,0,0.0,2,6,8,1,1,3,2,4,4,8,1,MEM,MEM,SAS,106,,,13,12,5,9
Bismack Biyombo,C,22023,202687,22300449,"DEC 31, 2023",MEM vs. SAC,L,22,0,0,0.0,0,0,0.0,0,0,0.0,0,6,6,0,0,1,0,1,0,-14,1,MEM,MEM,SAC,92,,,6,6,0,6
Bismack Biyombo,C,22023,202687,22300438,"DEC 29, 2023",MEM @ LAC,L,8,1,2,0.5,0,0,0.0,0,0,0.0,0,2,2,0,1,0,1,1,2,-4,1,MEM,LAC,MEM,106,,,4,4,2,2
Bismack Biyombo,C,22023,202687,22300410,"DEC 26, 2023",MEM @ NOP,W,25,4,5,0.8,0,0,0.0,0,0,0.0,0,7,7,1,0,2,0,4,8,-4,1,MEM,NOP,MEM,116,,,16,15,9,8
Bismack Biyombo,C,22023,202687,22300393,"DEC 23, 2023",MEM @ ATL,W,29,3,6,0.5,0,0,0.0,2,6,0.333,7,4,11,3,1,0,1,2,8,4,1,MEM,ATL,MEM,125,,,22,19,11,14
Bismack Biyombo,C,22023,202687,22300377,"DEC 21, 2023",MEM vs. IND,W,17,1,4,0.25,0,0,0.0,0,1,0.0,1,2,3,1,0,1,0,2,2,0,1,MEM,MEM,IND,116,,,6,5,3,4
Bismack Biyombo,C,22023,202687,22300360,"DEC 19, 2023",MEM @ NOP,W,22,4,5,0.8,0,0,0.0,0,0,0.0,0,2,2,0,1,1,1,3,8,3,1,MEM,NOP,MEM,115,,,10,10,8,2
Bismack Biyombo,C,22023,202687,22300332,"DEC 15, 2023",MEM vs. HOU,L,33,5,9,0.556,0,0,0.0,0,1,0.0,1,8,9,1,0,1,2,2,10,3,1,MEM,MEM,HOU,96,,,20,19,11,10
Bismack Biyombo,C,22023,202687,22300314,"DEC 13, 2023",MEM @ HOU,L,24,1,2,0.5,0,0,0.0,1,6,0.167,1,5,6,1,0,0,2,5,3,-2,1,MEM,HOU,MEM,104,,,10,9,4,7
Bismack Biyombo,C,22023,202687,22300299,"DEC 11, 2023",MEM vs. DAL,L,12,1,1,1.0,0,0,0.0,0,0,0.0,1,1,2,1,0,1,2,1,2,-10,1,MEM,MEM,DAL,113,,,5,4,3,3
Bismack Biyombo,C,22023,202687,22301221,"DEC 08, 2023",MEM vs. MIN,L,20,1,2,0.5,0,0,0.0,0,0,0.0,0,3,3,2,0,0,0,4,2,-12,1,MEM,MEM,MIN,95,,,7,5,4,5
Bismack Biyombo,C,22023,202687,22301206,"DEC 06, 2023",MEM @ DET,W,26,1,3,0.333,0,0,0.0,0,0,0.0,2,9,11,4,0,1,2,2,2,-1,1,MEM,DET,MEM,104,,,17,13,6,15
Bismack Biyombo,C,22023,202687,22300288,"DEC 02, 2023",MEM @ PHX,L,17,1,5,0.2,0,0,0.0,0,0,0.0,2,3,5,1,0,3,2,4,2,-3,1,MEM,PHX,MEM,101,,,8,7,3,6
Bismack Biyombo,C,22023,202687,22300277,"DEC 01, 2023",MEM @ DAL,W,23,2,3,0.667,0,0,0.0,0,0,0.0,1,5,6,4,0,2,2,2,4,10,1,MEM,DAL,MEM,89,,,14,10,8,10
Bismack Biyombo,C,22023,202687,22300261,"NOV 29, 2023",MEM vs. UTA,W,30,3,3,1.0,0,0,0.0,0,0,0.0,0,6,6,2,1,3,5,3,6,5,1,MEM,MEM,UTA,105,,,14,12,8,8
Bismack Biyombo,C,22023,202687,22300249,"NOV 26, 2023",MEM vs. MIN,L,30,2,3,0.667,0,0,0.0,6,10,0.6,2,3,5,3,1,0,1,1,10,-16,1,MEM,MEM,MIN,91,,,18,15,13,8
Bismack Biyombo,C,22023,202687,22300044,"NOV 24, 2023",MEM vs. PHX,L,29,3,5,0.6,0,0,0.0,0,0,0.0,1,3,4,1,0,1,1,3,6,-9,1,MEM,MEM,PHX,89,,,11,10,7,5
Bismack Biyombo,C,22023,202687,22300231,"NOV 22, 2023",MEM @ HOU,L,31,2,4,0.5,0,0,0.0,1,2,0.5,0,5,5,2,1,2,1,0,5,-10,1,MEM,HOU,MEM,91,,,12,10,7,7
Bismack Biyombo,C,22023,202687,22300213,"NOV 19, 2023",MEM vs. BOS,L,14,1,2,0.5,0,0,0.0,0,0,0.0,1,1,2,0,0,1,0,5,2,0,1,MEM,MEM,BOS,100,,,4,4,2,2
Bismack Biyombo,C,22023,202687,22300206,"NOV 18, 2023",MEM @ SAS,W,31,7,9,0.778,0,0,0.0,0,1,0.0,1,8,9,4,0,0,1,4,14,6,1,MEM,SAS,MEM,120,,,27,23,18,13
Bismack Biyombo,C,22023,202687,22300026,"NOV 14, 2023",MEM @ LAL,L,23,0,5,0.0,0,0,0.0,0,0,0.0,6,2,8,4,0,2,0,3,0,-21,1,MEM,LAL,MEM,107,,,12,8,4,12
Bismack Biyombo,C,22023,202687,22300179,"NOV 12, 2023",MEM @ LAC,W,36,5,6,0.833,0,0,0.0,3,7,0.429,4,8,12,3,1,2,1,3,13,20,1,MEM,LAC,MEM,105,,,28,25,16,15
Bismack Biyombo,C,22023,202687,22300012,"NOV 10, 2023",MEM vs. UTA,L,34,5,10,0.5,0,0,0.0,5,6,0.833,9,6,15,0,1,0,0,4,15,-5,1,MEM,MEM,UTA,121,,,30,30,15,15
Bismack Biyombo,C,22023,202687,22300164,"NOV 08, 2023",MEM vs. MIA,L,30,4,4,1.0,0,0,0.0,1,2,0.5,6,4,10,0,1,0,1,4,9,-17,1,MEM,MEM,MIA,102,,,19,19,9,10
Bismack Biyombo,C,22023,202687,22300144,"NOV 05, 2023",MEM @ POR,W,26,3,6,0.5,0,0,0.0,2,2,1.0,5,6,11,4,0,3,2,5,8,18,1,MEM,POR,MEM,112,,,23,19,12,15
Bismack Biyombo,C,22023,202687,22300515,"JAN 09, 2024",MEM @ DAL,W,18,1,2,0.5,0,0,0.0,0,0,0.0,1,1,2,4,0,0,2,2,2,3,1,MEM,DAL,MEM,120,,,8,4,6,6
Bismack Biyombo,C,22023,202687,22300425,"DEC 28, 2023",MEM @ DEN,L,22,1,4,0.25,0,0,0.0,0,0,0.0,1,4,5,1,0,1,2,3,2,-28,1,MEM,DEN,MEM,105,,,8,7,3,6
Bismack Biyombo,C,22023,202687,22300007,"NOV 03, 2023",MEM @ POR,L,0,0,0,0.0,0,0,0.0,0,0,0.0,0,0,0,0,0,0,0,0,0,0,1,MEM,POR,MEM,113,,,0,0,0,0
Josh Okogie,F,22023,1629006,22300757,"FEB 10, 2024",PHX @ GSW,L,10,3,3,1.0,2,2,1.0,0,0,0.0,1,0,1,1,1,1,0,0,8,-6,1,PHX,GSW,PHX,112,,,10,9,9,2
Josh Okogie,F,22023,1629006,22300739,"FEB 08, 2024",PHX vs. UTA,W,14,2,4,0.5,0,1,0.0,0,0,0.0,3,0,3,1,1,0,1,0,4,2,1,PHX,PHX,UTA,129,,,8,7,5,4
Josh Okogie,F,22023,1629006,22300725,"FEB 06, 2024",PHX vs. MIL,W,4,0,0,0.0,0,0,0.0,0,0,0.0,0,0,0,0,0,0,0,0,0,-11,1,PHX,PHX,MIL,114,,,0,0,0,0
Josh Okogie,F,22023,1629006,22300705,"FEB 04, 2024",PHX @ WAS,W,16,2,2,1.0,0,0,0.0,0,0,0.0,2,0,2,0,1,0,1,0,4,8,1,PHX,WAS,PHX,140,,,6,6,4,2
Josh Okogie,F,22023,1629006,22300690,"FEB 02, 2024",PHX @ ATL,L,15,1,3,0.333,1,1,1.0,0,0,0.0,0,0,0,0,0,1,0,0,3,-12,1,PHX,ATL,PHX,120,,,3,3,3,0
Josh Okogie,F,22023,1629006,22300661,"JAN 29, 2024",PHX @ MIA,W,18,4,5,0.8,2,2,1.0,1,3,0.333,3,4,7,0,1,1,0,1,11,4,1,PHX,MIA,PHX,118,,,18,18,11,7
Josh Okogie,F,22023,1629006,22300655,"JAN 28, 2024",PHX @ ORL,L,6,0,1,0.0,0,0,0.0,0,0,0.0,0,2,2,0,0,0,0,0,0,2,1,PHX,ORL,PHX,98,,,2,2,0,2
Josh Okogie,F,22023,1629006,22300636,"JAN 26, 2024",PHX @ IND,L,13,0,1,0.0,0,0,0.0,0,0,0.0,2,1,3,1,1,0,0,1,0,-1,1,PHX,IND,PHX,131,,,4,3,1,4
Josh Okogie,F,22023,1629006,22300625,"JAN 24, 2024",PHX @ DAL,W,24,2,7,0.286,1,3,0.333,1,1,1.0,1,3,4,3,2,1,2,2,6,15,1,PHX,DAL,PHX,132,,,13,10,9,7
Josh Okogie,F,22023,1629006,22300612,"JAN 22, 2024",PHX vs. CHI,W,14,1,3,0.333,0,2,0.0,2,4,0.5,1,2,3,0,1,0,0,1,4,-4,1,PHX,PHX,CHI,115,,,7,7,4,3
Josh Okogie,F,22023,1629006,22300604,"JAN 21, 2024",PHX vs. IND,W,15,0,1,0.0,0,1,0.0,0,0,0.0,1,1,2,2,1,0,0,0,0,-14,1,PHX,PHX,IND,117,,,4,2,2,4
Josh Okogie,F,22023,1629006,22300588,"JAN 19, 2024",PHX @ NOP,W,6,1,1,1.0,1,1,1.0,0,2,0.0,1,2,3,2,0,0,0,0,3,12,1,PHX,NOP,PHX,123,,,8,6,5,5
Josh Okogie,F,22023,1629006,22300567,"JAN 16, 2024",PHX vs. SAC,W,16,1,3,0.333,0,0,0.0,0,0,0.0,0,2,2,0,0,1,0,1,2,-9,1,PHX,PHX,SAC,119,,,4,4,2,2
Josh Okogie,F,22023,1629006,22300554,"JAN 14, 2024",PHX @ POR,W,7,0,0,0.0,0,0,0.0,0,0,0.0,0,1,1,0,0,0,0,1,0,-6,1,PHX,POR,PHX,127,,,1,1,0,1
Josh Okogie,F,22023,1629006,22300531,"JAN 11, 2024",PHX @ LAL,W,12,2,4,0.5,0,2,0.0,1,2,0.5,0,0,0,0,1,0,0,1,5,-3,1,PHX,LAL,PHX,127,,,5,5,5,0
Josh Okogie,F,22023,1629006,22300511,"JAN 08, 2024",PHX @ LAC,L,18,2,3,0.667,0,1,0.0,0,0,0.0,1,0,1,2,3,0,0,2,4,-12,1,PHX,LAC,PHX,111,,,7,5,6,3
Josh Okogie,F,22023,1629006,22300503,"JAN 07, 2024",PHX vs. MEM,L,14,2,5,0.4,0,2,0.0,2,2,1.0,0,1,1,2,2,0,0,5,6,12,1,PHX,PHX,MEM,115,,,9,7,8,3
Josh Okogie,F,22023,1629006,22300489,"JAN 05, 2024",PHX vs. MIA,W,24,0,2,0.0,0,1,0.0,7,8,0.875,1,1,2,4,3,2,0,5,7,4,1,PHX,PHX,MIA,113,,,13,9,11,6
Josh Okogie,F,22023,1629006,22300473,"JAN 03, 2024",PHX vs. LAC,L,16,2,3,0.667,1,2,0.5,0,0,0.0,1,1,2,1,0,1,1,2,5,8,1,PHX,PHX,LAC,122,,,8,7,6,3
Josh Okogie,F,22023,1629006,22300456,"JAN 01, 2024",PHX vs. POR,W,18,1,2,0.5,0,0,0.0,1,2,0.5,0,2,2,3,0,1,1,1,3,8,1,PHX,PHX,POR,109,,,8,5,6,5
Josh Okogie,F,22023,1629006,22300450,"DEC 31, 2023",PHX vs. ORL,W,7,0,2,0.0,0,1,0.0,0,0,0.0,1,1,2,2,0,0,0,3,0,-8,1,PHX,PHX,ORL,112,,,4,2,2,4
Josh Okogie,F,22023,1629006,22300418,"DEC 27, 2023",PHX @ HOU,W,10,0,2,0.0,0,1,0.0,0,0,0.0,1,0,1,0,0,0,0,1,0,5,1,PHX,HOU,PHX,129,,,1,1,0,1
Josh Okogie,F,22023,1629006,22300405,"DEC 25, 2023",PHX vs. DAL,L,12,0,5,0.0,0,3,0.0,1,2,0.5,1,1,2,2,1,0,0,2,1,-7,1,PHX,PHX,DAL,114,,,5,3,3,4
Josh Okogie,F,22023,1629006,22301203,"DEC 05, 2023",PHX @ LAL,L,9,0,1,0.0,0,1,0.0,0,0,0.0,0,1,1,0,1,0,0,0,0,-11,1,PHX,LAL,PHX,103,,,1,1,0,1
Josh Okogie,F,22023,1629006,22300288,"DEC 02, 2023",PHX vs. MEM,W,26,1,2,0.5,0,1,0.0,1,6,0.167,3,4,7,1,3,1,1,2,3,12,1,PHX,PHX,MEM,116,,,11,10,4,8
Josh Okogie,F,22023,1629006,22300279,"DEC 01, 2023",PHX vs. DEN,L,26,5,9,0.556,1,5,0.2,2,2,1.0,2,2,4,0,1,2,2,3,13,4,1,PHX,PHX,DEN,111,,,17,17,13,4
Josh Okogie,F,22023,1629006,22300044,"NOV 24, 2023",PHX @ MEM,W,28,2,9,0.222,1,4,0.25,0,1,0.0,1,6,7,3,1,0,0,1,5,22,1,PHX,MEM,PHX,110,,,15,12,8,10
Josh Okogie,F,22023,1629006,22300236,"NOV 22, 2023",PHX vs. GSW,W,27,4,5,0.8,1,2,0.5,3,4,0.75,1,1,2,0,1,1,1,1,12,-1,1,PHX,PHX,GSW,123,,,14,14,12,2
Josh Okogie,F,22023,1629006,22300041,"NOV 21, 2023",PHX vs. POR,W,13,0,0,0.0,0,0,0.0,2,2,1.0,1,2,3,1,1,0,1,0,2,9,1,PHX,PHX,POR,120,,,6,5,3,4
Josh Okogie,F,22023,1629006,22300214,"NOV 19, 2023",PHX @ UTA,W,14,1,2,0.5,1,2,0.5,0,0,0.0,2,1,3,0,3,0,1,1,3,-10,1,PHX,UTA,PHX,140,,,6,6,3,3
Josh Okogie,F,22023,1629006,22300035,"NOV 17, 2023",PHX @ UTA,W,13,0,1,0.0,0,0,0.0,1,2,0.5,1,0,1,0,0,0,1,2,1,-14,1,PHX,UTA,PHX,131,,,2,2,1,1
Josh Okogie,F,22023,1629006,22300197,"NOV 15, 2023",PHX vs. MIN,W,19,4,5,0.8,3,3,1.0,1,2,0.5,0,0,0,1,0,0,0,1,12,11,1,PHX,PHX,MIN,133,,,13,12,13,1
Josh Okogie,F,22023,1629006,22300185,"NOV 12, 2023",PHX vs. OKC,L,21,0,3,0.0,0,2,0.0,8,8,1.0,1,1,2,1,0,1,1,1,8,-8,1,PHX,PHX,OKC,99,,,11,10,9,3
Josh Okogie,F,22023,1629006,22300015,"NOV 10, 2023",PHX vs. LAL,L,13,0,4,0.0,0,4,0.0,2,2,1.0,2,4,6,1,0,0,0,0,2,7,1,PHX,PHX,LAL,119,,,9,8,3,7
Josh Okogie,F,22023,1629006,22300162,"NOV 08, 2023",PHX @ CHI,W,18,3,6,0.5,0,2,0.0,1,2,0.5,2,0,2,0,1,0,0,2,7,-18,1,PHX,CHI,PHX,116,,,9,9,7,2
Josh Okogie,F,22023,1629006,22300140,"NOV 05, 2023",PHX @ DET,W,29,3,6,0.5,0,1,0.0,4,5,0.8,4,3,7,2,2,0,2,1,10,9,1,PHX,DET,PHX,120,,,19,17,12,9
Josh Okogie,F,22023,1629006,22300132,"NOV 04, 2023",PHX @ PHI,L,26,2,7,0.286,0,2,0.0,0,0,0.0,1,0,1,2,2,1,1,0,4,-12,1,PHX,PHI,PHX,100,,,7,5,6,3
Josh Okogie,F,22023,1629006,22300131,"NOV 02, 2023",PHX vs. SAS,L,12,0,2,0.0,0,1,0.0,0,0,0.0,0,1,1,0,2,0,0,0,0,-4,1,PHX,PHX,SAS,121,,,1,1,0,1
Josh Okogie,F,22023,1629006,22300113,"OCT 31, 2023",PHX vs. SAS,L,30,3,10,0.3,1,4,0.25,4,5,0.8,1,1,2,2,0,2,2,1,11,-3,1,PHX,PHX,SAS,114,,,15,13,13,4
Josh Okogie,F,22023,1629006,22300094,"OCT 28, 2023",PHX vs. UTA,W,23,2,4,0.5,0,2,0.0,3,3,1.0,0,1,1,0,0,0,0,3,7,25,1,PHX,PHX,UTA,126,,,8,8,7,1
Josh Okogie,F,22023,1629006,22300076,"OCT 26, 2023",PHX @ LAL,L,33,3,5,0.6,2,4,0.5,2,2,1.0,4,4,8,3,0,1,1,2,10,5,1,PHX,LAL,PHX,95,,,21,18,13,11
Josh Okogie,F,22023,1629006,22300062,"OCT 24, 2023",PHX @ GSW,W,32,7,9,0.778,1,1,1.0,2,2,1.0,4,1,5,1,1,0,2,2,17,2,1,PHX,GSW,PHX,108,,,23,22,18,6
Josh Okogie,F,22023,1629006,22300677,"JAN 31, 2024",PHX @ BKN,W,26,4,6,0.667,1,3,0.333,2,3,0.667,1,6,7,1,1,0,0,1,11,5,1,PHX,BKN,PHX,136,,,19,18,12,8
Josh Okogie,F,22023,1629006,22300308,"DEC 12, 2023",PHX vs. GSW,W,11,3,4,0.75,3,4,0.75,1,2,0.5,1,1,2,2,0,1,0,1,10,6,1,PHX,PHX,GSW,119,,,14,12,12,4
Josh Okogie,F,22023,1629006,22301228,"DEC 08, 2023",PHX vs. SAC,L,29,0,5,0.0,0,3,0.0,0,0,0.0,2,0,2,3,2,2,1,3,0,3,1,PHX,PHX,SAC,106,,,5,2,3,5
Josh Okogie,F,22023,1629006,22300260,"NOV 29, 2023",PHX @ TOR,L,24,2,4,0.5,0,0,0.0,6,6,1.0,4,3,7,2,0,0,0,1,10,1,1,PHX,TOR,PHX,105,,,19,17,12,9
Josh Okogie,F,22023,1629006,22300247,"NOV 26, 2023",PHX @ NYK,W,17,0,5,0.0,0,3,0.0,3,4,0.75,1,3,4,2,1,0,2,3,3,-3,1,PHX,NYK,PHX,116,,,9,7,5,6
Jevon Carter,G,22023,1628975,22300139,"NOV 04, 2023",CHI @ DEN,L,18,6,9,0.667,4,5,0.8,0,1,0.0,0,0,0,1,0,0,1,2,16,-2,1,CHI,DEN,CHI,101,,,17,16,17,1
Jevon Carter,G,22023,1628975,22300737,"FEB 08, 2024",CHI @ MEM,W,16,3,7,0.429,1,4,0.25,0,0,0.0,0,0,0,2,0,0,0,0,7,-5,1,CHI,MEM,CHI,118,,,9,7,9,2
Jevon Carter,G,22023,1628975,22300723,"FEB 06, 2024",CHI vs. MIN,W,7,2,4,0.5,1,3,0.333,0,0,0.0,0,0,0,0,0,0,1,1,5,-2,1,CHI,CHI,MIN,129,,,5,5,5,0
Jevon Carter,G,22023,1628975,22300700,"FEB 03, 2024",CHI vs. SAC,L,10,2,4,0.5,0,1,0.0,0,0,0.0,0,0,0,0,3,0,1,1,4,-7,1,CHI,CHI,SAC,115,,,4,4,4,0
Jevon Carter,G,22023,1628975,22300674,"JAN 31, 2024",CHI @ CHA,W,7,1,2,0.5,0,1,0.0,0,0,0.0,0,0,0,1,0,0,2,0,2,-12,1,CHI,CHA,CHI,117,,,3,2,3,1
Jevon Carter,G,22023,1628975,22300672,"JAN 30, 2024",CHI vs. TOR,L,13,1,5,0.2,1,3,0.333,0,0,0.0,0,0,0,2,0,0,0,1,3,-6,1,CHI,CHI,TOR,107,,,5,3,5,2
Jevon Carter,G,22023,1628975,22300656,"JAN 28, 2024",CHI @ POR,W,11,2,4,0.5,2,4,0.5,0,0,0.0,0,2,2,0,1,1,0,0,6,4,1,CHI,POR,CHI,104,,,8,8,6,2
Jevon Carter,G,22023,1628975,22300633,"JAN 25, 2024",CHI @ LAL,L,8,0,3,0.0,0,3,0.0,0,0,0.0,0,1,1,2,0,0,0,1,0,3,1,CHI,LAL,CHI,132,,,3,1,2,3
Jevon Carter,G,22023,1628975,22300612,"JAN 22, 2024",CHI @ PHX,L,8,0,4,0.0,0,2,0.0,0,0,0.0,0,1,1,0,0,0,0,0,0,-2,1,CHI,PHX,CHI,113,,,1,1,0,1
Jevon Carter,G,22023,1628975,22300597,"JAN 20, 2024",CHI vs. MEM,W,17,5,7,0.714,2,3,0.667,0,0,0.0,0,1,1,5,0,0,0,0,12,16,1,CHI,CHI,MEM,125,,,18,13,17,6
Jevon Carter,G,22023,1628975,22300580,"JAN 18, 2024",CHI @ TOR,W,3,0,0,0.0,0,0,0.0,0,0,0.0,0,0,0,0,0,0,0,0,0,-4,1,CHI,TOR,CHI,116,,,0,0,0,0
Jevon Carter,G,22023,1628975,22300561,"JAN 15, 2024",CHI @ CLE,L,11,2,4,0.5,1,3,0.333,0,0,0.0,1,1,2,0,0,0,0,1,5,-23,1,CHI,CLE,CHI,91,,,7,7,5,2
Jevon Carter,G,22023,1628975,22300548,"JAN 13, 2024",CHI @ SAS,W,24,5,12,0.417,4,9,0.444,0,0,0.0,0,1,1,0,0,0,3,2,14,-6,1,CHI,SAS,CHI,122,,,15,15,14,1
Jevon Carter,G,22023,1628975,22300506,"JAN 08, 2024",CHI @ CHA,W,4,1,2,0.5,0,1,0.0,0,0,0.0,0,0,0,0,0,0,0,0,2,-4,1,CHI,CHA,CHI,119,,,2,2,2,0
Jevon Carter,G,22023,1628975,22300484,"JAN 05, 2024",CHI vs. CHA,W,14,3,5,0.6,1,2,0.5,0,0,0.0,0,2,2,2,0,0,0,1,7,5,1,CHI,CHI,CHA,104,,,11,9,9,4
Jevon Carter,G,22023,1628975,22300468,"JAN 03, 2024",CHI @ NYK,L,16,1,6,0.167,0,3,0.0,0,0,0.0,0,0,0,2,1,1,1,2,2,13,1,CHI,NYK,CHI,100,,,4,2,4,2
Jevon Carter,G,22023,1628975,22300459,"JAN 02, 2024",CHI @ PHI,L,23,3,11,0.273,3,8,0.375,0,0,0.0,0,1,1,1,4,0,0,0,9,8,1,CHI,PHI,CHI,97,,,11,10,10,2
Jevon Carter,G,22023,1628975,22300442,"DEC 30, 2023",CHI vs. PHI,W,13,1,5,0.2,1,4,0.25,1,2,0.5,0,2,2,1,1,0,0,3,4,-8,1,CHI,CHI,PHI,105,,,7,6,5,3
Jevon Carter,G,22023,1628975,22300422,"DEC 28, 2023",CHI vs. IND,L,12,0,5,0.0,0,3,0.0,0,0,0.0,0,0,0,2,0,1,0,1,0,-12,1,CHI,CHI,IND,104,,,2,0,2,2
Jevon Carter,G,22023,1628975,22300408,"DEC 26, 2023",CHI vs. ATL,W,20,4,6,0.667,2,4,0.5,0,0,0.0,0,2,2,2,0,0,1,0,10,4,1,CHI,CHI,ATL,118,,,14,12,12,4
Jevon Carter,G,22023,1628975,22300396,"DEC 23, 2023",CHI vs. CLE,L,9,1,7,0.143,1,5,0.2,0,0,0.0,0,0,0,0,0,1,1,1,3,-5,1,CHI,CHI,CLE,95,,,3,3,3,0
Jevon Carter,G,22023,1628975,22300376,"DEC 21, 2023",CHI vs. SAS,W,19,1,3,0.333,1,1,1.0,2,2,1.0,0,1,1,2,0,1,0,1,5,13,1,CHI,CHI,SAS,114,,,8,6,7,3
Jevon Carter,G,22023,1628975,22300370,"DEC 20, 2023",CHI vs. LAL,W,17,4,9,0.444,2,7,0.286,0,0,0.0,0,1,1,0,1,0,0,1,10,5,1,CHI,CHI,LAL,124,,,11,11,10,1
Jevon Carter,G,22023,1628975,22300351,"DEC 18, 2023",CHI @ PHI,W,18,4,11,0.364,4,8,0.5,0,0,0.0,0,0,0,0,0,0,0,1,12,18,1,CHI,PHI,CHI,108,,,12,12,12,0
Jevon Carter,G,22023,1628975,22300337,"DEC 16, 2023",CHI @ MIA,L,12,0,3,0.0,0,3,0.0,0,0,0.0,0,1,1,3,0,0,1,2,0,-10,1,CHI,MIA,CHI,116,,,4,1,3,4
Jevon Carter,G,22023,1628975,22300320,"DEC 14, 2023",CHI @ MIA,W,13,0,2,0.0,0,2,0.0,0,0,0.0,0,0,0,1,1,0,1,3,0,-5,1,CHI,MIA,CHI,124,,,1,0,1,1
Jevon Carter,G,22023,1628975,22300307,"DEC 12, 2023",CHI vs. DEN,L,15,3,10,0.3,3,8,0.375,0,0,0.0,1,0,1,2,1,0,0,2,9,-12,1,CHI,CHI,DEN,106,,,12,10,11,3
Jevon Carter,G,22023,1628975,22300300,"DEC 11, 2023",CHI @ MIL,L,13,3,5,0.6,1,2,0.5,0,0,0.0,1,4,5,0,0,1,0,0,7,-1,1,CHI,MIL,CHI,129,,,12,12,7,5
Jevon Carter,G,22023,1628975,22301223,"DEC 08, 2023",CHI @ SAS,W,9,1,4,0.25,1,3,0.333,0,0,0.0,0,0,0,1,0,0,0,2,3,-7,1,CHI,SAS,CHI,121,,,4,3,4,1
Jevon Carter,G,22023,1628975,22301211,"DEC 06, 2023",CHI vs. CHA,W,11,0,1,0.0,0,1,0.0,0,0,0.0,0,0,0,3,1,0,1,1,0,5,1,CHI,CHI,CHA,111,,,3,0,3,3
Jevon Carter,G,22023,1628975,22300285,"DEC 02, 2023",CHI vs. NOP,W,15,1,2,0.5,0,1,0.0,0,0,0.0,0,0,0,2,0,0,1,1,2,-2,1,CHI,CHI,NOP,124,,,4,2,4,2
Jevon Carter,G,22023,1628975,22300269,"NOV 30, 2023",CHI vs. MIL,W,18,5,10,0.5,1,2,0.5,0,0,0.0,1,1,2,1,3,0,0,1,11,22,1,CHI,CHI,MIL,120,,,14,13,12,3
Jevon Carter,G,22023,1628975,22300053,"NOV 28, 2023",CHI @ BOS,L,17,4,7,0.571,0,1,0.0,0,0,0.0,0,1,1,2,0,1,1,0,8,3,1,CHI,BOS,CHI,97,,,11,9,10,3
Jevon Carter,G,22023,1628975,22300250,"NOV 26, 2023",CHI @ BKN,L,8,0,2,0.0,0,2,0.0,0,0,0.0,0,0,0,0,0,0,1,0,0,-17,1,CHI,BKN,CHI,109,,,0,0,0,0
Jevon Carter,G,22023,1628975,22300046,"NOV 24, 2023",CHI @ TOR,L,11,0,2,0.0,0,1,0.0,0,0,0.0,0,1,1,1,0,0,0,0,0,13,1,CHI,TOR,CHI,108,,,2,1,1,2
Jevon Carter,G,22023,1628975,22300234,"NOV 22, 2023",CHI @ OKC,L,19,1,7,0.143,1,6,0.167,0,0,0.0,0,0,0,2,0,0,0,2,3,-3,1,CHI,OKC,CHI,102,,,5,3,5,2
Jevon Carter,G,22023,1628975,22300220,"NOV 20, 2023",CHI vs. MIA,L,14,0,5,0.0,0,4,0.0,0,0,0.0,0,0,0,1,0,1,1,2,0,3,1,CHI,CHI,MIA,100,,,1,0,1,1
Jevon Carter,G,22023,1628975,22300204,"NOV 18, 2023",CHI vs. MIA,W,14,3,9,0.333,3,9,0.333,0,0,0.0,0,1,1,1,0,0,0,2,9,18,1,CHI,CHI,MIA,102,,,11,10,10,2
Jevon Carter,G,22023,1628975,22300033,"NOV 17, 2023",CHI vs. ORL,L,10,0,0,0.0,0,0,0.0,0,0,0.0,0,1,1,1,0,0,0,0,0,0,1,CHI,CHI,ORL,97,,,2,1,1,2
Jevon Carter,G,22023,1628975,22300196,"NOV 15, 2023",CHI vs. ORL,L,16,1,7,0.143,1,5,0.2,0,0,0.0,0,0,0,1,2,0,0,2,3,-3,1,CHI,CHI,ORL,94,,,4,3,4,1
Jevon Carter,G,22023,1628975,22300190,"NOV 13, 2023",CHI @ MIL,L,14,2,5,0.4,2,4,0.5,0,0,0.0,0,0,0,1,1,1,0,2,6,-11,1,CHI,MIL,CHI,109,,,7,6,7,1
Jevon Carter,G,22023,1628975,22300181,"NOV 12, 2023",CHI vs. DET,W,12,1,4,0.25,1,2,0.5,0,0,0.0,0,0,0,2,0,0,2,2,3,0,1,CHI,CHI,DET,119,,,5,3,5,2
Jevon Carter,G,22023,1628975,22300162,"NOV 08, 2023",CHI vs. PHX,L,13,3,8,0.375,2,4,0.5,0,0,0.0,0,0,0,0,0,1,0,2,8,10,1,CHI,CHI,PHX,115,,,8,8,8,0
Jevon Carter,G,22023,1628975,22300152,"NOV 06, 2023",CHI vs. UTA,W,17,4,8,0.5,4,8,0.5,0,0,0.0,0,0,0,1,2,0,0,1,12,7,1,CHI,CHI,UTA,130,,,13,12,13,1
Jevon Carter,G,22023,1628975,22300004,"NOV 03, 2023",CHI vs. BKN,L,14,2,3,0.667,1,2,0.5,0,0,0.0,0,1,1,0,1,0,2,2,5,-11,1,CHI,CHI,BKN,107,,,6,6,5,1
Jevon Carter,G,22023,1628975,22300124,"NOV 01, 2023",CHI @ DAL,L,15,5,7,0.714,2,2,1.0,0,0,0.0,0,1,1,2,1,1,1,0,12,-3,1,CHI,DAL,CHI,105,,,15,13,14,3
Jevon Carter,G,22023,1628975,22300102,"OCT 30, 2023",CHI @ IND,W,18,5,7,0.714,1,1,1.0,0,0,0.0,0,1,1,2,1,1,3,1,11,4,1,CHI,IND,CHI,112,,,14,12,13,3
Jevon Carter,G,22023,1628975,22300088,"OCT 28, 2023",CHI @ DET,L,13,1,6,0.167,1,4,0.25,0,0,0.0,1,0,1,0,0,0,0,0,3,-5,1,CHI,DET,CHI,102,,,4,4,3,1
Jevon Carter,G,22023,1628975,22300082,"OCT 27, 2023",CHI vs. TOR,W,13,0,2,0.0,0,2,0.0,0,0,0.0,0,1,1,2,0,0,1,1,0,2,1,CHI,CHI,TOR,104,,,3,1,2,3
Jevon Carter,G,22023,1628975,22300070,"OCT 25, 2023",CHI vs. OKC,L,16,1,4,0.25,1,4,0.25,0,0,0.0,0,1,1,2,0,0,0,0,3,-15,1,CHI,CHI,OKC,104,,,6,4,5,3
Malachi Flynn,G,22023,1630201,22300722,"FEB 06, 2024",NYK vs. MEM,W,12,2,4,0.5,2,3,0.667,0,0,0.0,0,1,1,1,0,0,1,0,6,15,1,NYK,NYK,MEM,121,,,8,7,7,2
Malachi Flynn,G,22023,1630201,22300701,"FEB 03, 2024",NYK vs. LAL,L,3,1,2,0.5,0,0,0.0,1,1,1.0,0,0,0,0,0,0,0,0,3,-3,1,NYK,NYK,LAL,105,,,3,3,3,0
Malachi Flynn,G,22023,1630201,22300685,"FEB 01, 2024",NYK vs. IND,W,7,0,3,0.0,0,2,0.0,2,2,1.0,0,1,1,1,0,0,0,0,2,-1,1,NYK,NYK,IND,109,,,4,3,3,2
Malachi Flynn,G,22023,1630201,22300671,"JAN 30, 2024",NYK vs. UTA,W,0,0,0,0.0,0,0,0.0,0,0,0.0,0,0,0,0,0,0,0,0,0,0,1,NYK,NYK,UTA,118,,,0,0,0,0
Malachi Flynn,G,22023,1630201,22300657,"JAN 29, 2024",NYK @ CHA,W,2,0,0,0.0,0,0,0.0,2,2,1.0,0,1,1,0,0,0,0,0,2,3,1,NYK,CHA,NYK,113,,,3,3,2,1
Malachi Flynn,G,22023,1630201,22300643,"JAN 27, 2024",NYK vs. MIA,W,1,0,1,0.0,0,0,0.0,0,0,0.0,0,0,0,0,0,0,0,0,0,-4,1,NYK,NYK,MIA,125,,,0,0,0,0
Malachi Flynn,G,22023,1630201,22300631,"JAN 25, 2024",NYK vs. DEN,W,4,1,1,1.0,0,0,0.0,0,0,0.0,0,0,0,0,0,0,0,0,2,2,1,NYK,NYK,DEN,122,,,2,2,2,0
Malachi Flynn,G,22023,1630201,22300596,"JAN 20, 2024",NYK vs. TOR,W,3,1,1,1.0,1,1,1.0,0,0,0.0,0,1,1,1,0,0,1,0,3,3,1,NYK,NYK,TOR,126,,,5,4,4,2
Malachi Flynn,G,22023,1630201,22300573,"JAN 17, 2024",NYK vs. HOU,W,1,0,0,0.0,0,0,0.0,0,0,0.0,0,0,0,0,0,0,0,0,0,-5,1,NYK,NYK,HOU,109,,,0,0,0,0
Malachi Flynn,G,22023,1630201,22300557,"JAN 15, 2024",NYK vs. ORL,L,12,0,4,0.0,0,4,0.0,2,4,0.5,0,0,0,0,0,0,0,0,2,-7,1,NYK,NYK,ORL,94,,,2,2,2,0
Malachi Flynn,G,22023,1630201,22300544,"JAN 13, 2024",NYK @ MEM,W,10,4,5,0.8,1,2,0.5,0,0,0.0,0,1,1,3,1,0,1,3,9,-1,1,NYK,MEM,NYK,106,,,13,10,12,4
Malachi Flynn,G,22023,1630201,22300514,"JAN 09, 2024",NYK vs. POR,W,4,0,1,0.0,0,1,0.0,2,2,1.0,0,0,0,0,0,0,0,0,2,-5,1,NYK,NYK,POR,112,,,2,2,2,0
Malachi Flynn,G,22023,1630201,22300494,"JAN 06, 2024",NYK @ WAS,W,1,0,1,0.0,0,0,0.0,0,0,0.0,0,0,0,0,0,0,0,0,0,-3,1,NYK,WAS,NYK,121,,,0,0,0,0
Malachi Flynn,G,22023,1630201,22300483,"JAN 05, 2024",NYK @ PHI,W,1,0,0,0.0,0,0,0.0,0,0,0.0,0,1,1,0,0,0,0,0,0,2,1,NYK,PHI,NYK,128,,,1,1,0,1
Malachi Flynn,G,22023,1630201,22300432,"DEC 29, 2023",TOR @ BOS,L,6,0,0,0.0,0,0,0.0,0,0,0.0,0,0,0,0,2,0,0,1,0,2,1,TOR,BOS,TOR,118,,,0,0,0,0
Malachi Flynn,G,22023,1630201,22300416,"DEC 27, 2023",TOR @ WAS,W,5,2,3,0.667,2,3,0.667,0,0,0.0,1,0,1,0,0,0,2,1,6,4,1,TOR,WAS,TOR,132,,,7,7,6,1
Malachi Flynn,G,22023,1630201,22300395,"DEC 23, 2023",TOR vs. UTA,L,14,1,3,0.333,1,3,0.333,0,0,0.0,0,2,2,6,0,0,0,1,3,-3,1,TOR,TOR,UTA,119,,,11,5,9,8
Malachi Flynn,G,22023,1630201,22300382,"DEC 22, 2023",TOR @ PHI,L,10,1,4,0.25,0,2,0.0,0,0,0.0,2,2,4,2,0,1,3,0,2,9,1,TOR,PHI,TOR,111,,,8,6,4,6
Malachi Flynn,G,22023,1630201,22300369,"DEC 20, 2023",TOR vs. DEN,L,16,2,8,0.25,2,3,0.667,0,0,0.0,0,3,3,2,1,0,1,1,6,7,1,TOR,TOR,DEN,104,,,11,9,8,5
Malachi Flynn,G,22023,1630201,22300354,"DEC 18, 2023",TOR vs. CHA,W,16,1,6,0.167,0,4,0.0,0,0,0.0,0,3,3,2,0,0,0,1,2,4,1,TOR,TOR,CHA,114,,,7,5,4,5
Malachi Flynn,G,22023,1630201,22300330,"DEC 15, 2023",TOR vs. ATL,L,19,3,4,0.75,2,2,1.0,3,4,0.75,0,4,4,1,0,1,2,4,11,-3,1,TOR,TOR,ATL,104,,,16,15,12,5
Malachi Flynn,G,22023,1630201,22300313,"DEC 13, 2023",TOR vs. ATL,W,17,0,4,0.0,0,3,0.0,0,0,0.0,0,2,2,8,0,0,2,2,0,-8,1,TOR,TOR,ATL,135,,,10,2,8,10
Malachi Flynn,G,22023,1630201,22300297,"DEC 11, 2023",TOR @ NYK,L,17,4,5,0.8,2,2,1.0,0,0,0.0,1,3,4,4,0,0,3,2,10,3,1,TOR,NYK,TOR,130,,,18,14,14,8
Malachi Flynn,G,22023,1630201,22301216,"DEC 08, 2023",TOR @ CHA,L,17,3,7,0.429,0,4,0.0,2,2,1.0,0,0,0,4,2,0,1,1,8,8,1,TOR,CHA,TOR,116,,,12,8,12,4
Malachi Flynn,G,22023,1630201,22301207,"DEC 06, 2023",TOR vs. MIA,L,6,1,1,1.0,1,1,1.0,0,0,0.0,0,1,1,1,0,0,0,1,3,-3,1,TOR,TOR,MIA,103,,,5,4,4,2
Malachi Flynn,G,22023,1630201,22300276,"DEC 01, 2023",TOR vs. NYK,L,11,0,2,0.0,0,1,0.0,0,0,0.0,0,1,1,4,0,1,0,1,0,-3,1,TOR,TOR,NYK,106,,,5,1,4,5
Malachi Flynn,G,22023,1630201,22300260,"NOV 29, 2023",TOR vs. PHX,W,14,0,3,0.0,0,3,0.0,2,2,1.0,1,4,5,1,0,0,1,0,2,9,1,TOR,TOR,PHX,112,,,8,7,3,6
Malachi Flynn,G,22023,1630201,22300054,"NOV 28, 2023",TOR @ BKN,L,16,2,5,0.4,1,3,0.333,0,0,0.0,0,0,0,1,0,0,0,1,5,-10,1,TOR,BKN,TOR,103,,,6,5,6,1
Malachi Flynn,G,22023,1630201,22300251,"NOV 26, 2023",TOR @ CLE,L,17,1,6,0.167,1,4,0.25,0,0,0.0,0,4,4,0,0,0,1,1,3,-13,1,TOR,CLE,TOR,102,,,7,7,3,4
Malachi Flynn,G,22023,1630201,22300046,"NOV 24, 2023",TOR vs. CHI,W,14,0,2,0.0,0,2,0.0,2,2,1.0,0,1,1,1,1,0,1,1,2,4,1,TOR,TOR,CHI,121,,,4,3,3,2
Malachi Flynn,G,22023,1630201,22300038,"NOV 21, 2023",TOR @ ORL,L,19,2,4,0.5,1,2,0.5,1,2,0.5,0,3,3,1,1,1,1,1,6,-14,1,TOR,ORL,TOR,107,,,10,9,7,4
Malachi Flynn,G,22023,1630201,22300211,"NOV 19, 2023",TOR vs. DET,W,21,3,5,0.6,1,2,0.5,0,2,0.0,0,2,2,4,2,0,1,4,7,0,1,TOR,TOR,DET,142,,,13,9,11,6
Malachi Flynn,G,22023,1630201,22300031,"NOV 17, 2023",TOR vs. BOS,L,19,2,5,0.4,1,1,1.0,0,0,0.0,1,0,1,5,0,0,1,1,5,-15,1,TOR,TOR,BOS,105,,,11,6,10,6
Malachi Flynn,G,22023,1630201,22300195,"NOV 15, 2023",TOR vs. MIL,L,27,3,11,0.273,0,8,0.0,1,1,1.0,2,1,3,5,0,1,0,1,7,4,1,TOR,TOR,MIL,112,,,15,10,12,8
Malachi Flynn,G,22023,1630201,22300189,"NOV 13, 2023",TOR vs. WAS,W,23,2,5,0.4,1,4,0.25,1,1,1.0,0,2,2,1,1,0,1,2,6,12,1,TOR,TOR,WAS,111,,,9,8,7,3
Malachi Flynn,G,22023,1630201,22300174,"NOV 11, 2023",TOR @ BOS,L,23,5,7,0.714,2,4,0.5,0,1,0.0,0,1,1,1,0,0,1,0,12,-21,1,TOR,BOS,TOR,94,,,14,13,13,2
Malachi Flynn,G,22023,1630201,22300092,"OCT 28, 2023",TOR vs. PHI,L,13,2,4,0.5,2,2,1.0,1,1,1.0,0,0,0,2,1,0,3,1,7,-2,1,TOR,TOR,PHI,107,,,9,7,9,2
Malachi Flynn,G,22023,1630201,22300082,"OCT 27, 2023",TOR @ CHI,L,4,0,1,0.0,0,1,0.0,0,0,0.0,0,0,0,0,0,0,0,0,0,-14,1,TOR,CHI,TOR,103,,,0,0,0,0
Malachi Flynn,G,22023,1630201,22300069,"OCT 25, 2023",TOR vs. MIN,W,10,1,3,0.333,1,1,1.0,0,0,0.0,0,0,0,2,1,0,2,4,3,-14,1,TOR,TOR,MIN,97,,,5,3,5,2
Malachi Flynn,G,22023,1630201,22300230,"NOV 22, 2023",TOR @ IND,W,20,6,8,0.75,2,3,0.667,0,0,0.0,2,2,4,2,0,1,1,2,14,-4,1,TOR,IND,TOR,132,,,20,18,16,6
Malachi Flynn,G,22023,1630201,22300168,"NOV 08, 2023",TOR @ DAL,W,15,2,5,0.4,2,4,0.5,2,2,1.0,0,4,4,4,0,0,0,2,8,7,1,TOR,DAL,TOR,127,,,16,12,12,8
Malachi Flynn,G,22023,1630201,22300141,"NOV 05, 2023",TOR @ SAS,W,15,1,3,0.333,1,2,0.5,2,2,1.0,1,2,3,4,0,0,0,1,5,6,1,TOR,SAS,TOR,123,,,12,8,9,7
Malachi Flynn,G,22023,1630201,22300128,"NOV 02, 2023",TOR @ PHI,L,17,2,5,0.4,2,3,0.667,0,0,0.0,1,2,3,1,2,0,1,2,6,-8,1,TOR,PHI,TOR,99,,,10,9,7,4
Malachi Flynn,G,22023,1630201,22300116,"NOV 01, 2023",TOR vs. MIL,W,19,1,3,0.333,0,1,0.0,0,0,0.0,1,2,3,4,3,0,3,1,2,-2,1,TOR,TOR,MIL,130,,,9,5,6,7
Malachi Flynn,G,22023,1630201,22300105,"OCT 30, 2023",TOR vs. POR,L,15,3,5,0.6,0,2,0.0,0,0,0.0,0,1,1,0,1,0,1,1,6,-9,1,TOR,TOR,POR,91,,,7,7,6,1
Malachi Flynn,G,22023,1630201,22300722,"FEB 06, 2024",NYK vs. MEM,W,12,2,4,0.5,2,3,0.667,0,0,0.0,0,1,1,1,0,0,1,0,6,15,1,NYK,NYK,MEM,121,,,8,7,7,2
Malachi Flynn,G,22023,1630201,22300701,"FEB 03, 2024",NYK vs. LAL,L,3,1,2,0.5,0,0,0.0,1,1,1.0,0,0,0,0,0,0,0,0,3,-3,1,NYK,NYK,LAL,105,,,3,3,3,0
Malachi Flynn,G,22023,1630201,22300685,"FEB 01, 2024",NYK vs. IND,W,7,0,3,0.0,0,2,0.0,2,2,1.0,0,1,1,1,0,0,0,0,2,-1,1,NYK,NYK,IND,109,,,4,3,3,2
Malachi Flynn,G,22023,1630201,22300671,"JAN 30, 2024",NYK vs. UTA,W,0,0,0,0.0,0,0,0.0,0,0,0.0,0,0,0,0,0,0,0,0,0,0,1,NYK,NYK,UTA,118,,,0,0,0,0
Malachi Flynn,G,22023,1630201,22300657,"JAN 29, 2024",NYK @ CHA,W,2,0,0,0.0,0,0,0.0,2,2,1.0,0,1,1,0,0,0,0,0,2,3,1,NYK,CHA,NYK,113,,,3,3,2,1
Malachi Flynn,G,22023,1630201,22300643,"JAN 27, 2024",NYK vs. MIA,W,1,0,1,0.0,0,0,0.0,0,0,0.0,0,0,0,0,0,0,0,0,0,-4,1,NYK,NYK,MIA,125,,,0,0,0,0
Malachi Flynn,G,22023,1630201,22300631,"JAN 25, 2024",NYK vs. DEN,W,4,1,1,1.0,0,0,0.0,0,0,0.0,0,0,0,0,0,0,0,0,2,2,1,NYK,NYK,DEN,122,,,2,2,2,0
Malachi Flynn,G,22023,1630201,22300596,"JAN 20, 2024",NYK vs. TOR,W,3,1,1,1.0,1,1,1.0,0,0,0.0,0,1,1,1,0,0,1,0,3,3,1,NYK,NYK,TOR,126,,,5,4,4,2
Malachi Flynn,G,22023,1630201,22300573,"JAN 17, 2024",NYK vs. HOU,W,1,0,0,0.0,0,0,0.0,0,0,0.0,0,0,0,0,0,0,0,0,0,-5,1,NYK,NYK,HOU,109,,,0,0,0,0
Malachi Flynn,G,22023,1630201,22300557,"JAN 15, 2024",NYK vs. ORL,L,12,0,4,0.0,0,4,0.0,2,4,0.5,0,0,0,0,0,0,0,0,2,-7,1,NYK,NYK,ORL,94,,,2,2,2,0
Malachi Flynn,G,22023,1630201,22300544,"JAN 13, 2024",NYK @ MEM,W,10,4,5,0.8,1,2,0.5,0,0,0.0,0,1,1,3,1,0,1,3,9,-1,1,NYK,MEM,NYK,106,,,13,10,12,4
Malachi Flynn,G,22023,1630201,22300514,"JAN 09, 2024",NYK vs. POR,W,4,0,1,0.0,0,1,0.0,2,2,1.0,0,0,0,0,0,0,0,0,2,-5,1,NYK,NYK,POR,112,,,2,2,2,0
Malachi Flynn,G,22023,1630201,22300494,"JAN 06, 2024",NYK @ WAS,W,1,0,1,0.0,0,0,0.0,0,0,0.0,0,0,0,0,0,0,0,0,0,-3,1,NYK,WAS,NYK,121,,,0,0,0,0
Malachi Flynn,G,22023,1630201,22300483,"JAN 05, 2024",NYK @ PHI,W,1,0,0,0.0,0,0,0.0,0,0,0.0,0,1,1,0,0,0,0,0,0,2,1,NYK,PHI,NYK,128,,,1,1,0,1
Malachi Flynn,G,22023,1630201,22300432,"DEC 29, 2023",TOR @ BOS,L,6,0,0,0.0,0,0,0.0,0,0,0.0,0,0,0,0,2,0,0,1,0,2,1,TOR,BOS,TOR,118,,,0,0,0,0
Malachi Flynn,G,22023,1630201,22300416,"DEC 27, 2023",TOR @ WAS,W,5,2,3,0.667,2,3,0.667,0,0,0.0,1,0,1,0,0,0,2,1,6,4,1,TOR,WAS,TOR,132,,,7,7,6,1
Malachi Flynn,G,22023,1630201,22300395,"DEC 23, 2023",TOR vs. UTA,L,14,1,3,0.333,1,3,0.333,0,0,0.0,0,2,2,6,0,0,0,1,3,-3,1,TOR,TOR,UTA,119,,,11,5,9,8
Malachi Flynn,G,22023,1630201,22300382,"DEC 22, 2023",TOR @ PHI,L,10,1,4,0.25,0,2,0.0,0,0,0.0,2,2,4,2,0,1,3,0,2,9,1,TOR,PHI,TOR,111,,,8,6,4,6
Malachi Flynn,G,22023,1630201,22300369,"DEC 20, 2023",TOR vs. DEN,L,16,2,8,0.25,2,3,0.667,0,0,0.0,0,3,3,2,1,0,1,1,6,7,1,TOR,TOR,DEN,104,,,11,9,8,5
Malachi Flynn,G,22023,1630201,22300354,"DEC 18, 2023",TOR vs. CHA,W,16,1,6,0.167,0,4,0.0,0,0,0.0,0,3,3,2,0,0,0,1,2,4,1,TOR,TOR,CHA,114,,,7,5,4,5
Malachi Flynn,G,22023,1630201,22300330,"DEC 15, 2023",TOR vs. ATL,L,19,3,4,0.75,2,2,1.0,3,4,0.75,0,4,4,1,0,1,2,4,11,-3,1,TOR,TOR,ATL,104,,,16,15,12,5
Malachi Flynn,G,22023,1630201,22300313,"DEC 13, 2023",TOR vs. ATL,W,17,0,4,0.0,0,3,0.0,0,0,0.0,0,2,2,8,0,0,2,2,0,-8,1,TOR,TOR,ATL,135,,,10,2,8,10
Malachi Flynn,G,22023,1630201,22300297,"DEC 11, 2023",TOR @ NYK,L,17,4,5,0.8,2,2,1.0,0,0,0.0,1,3,4,4,0,0,3,2,10,3,1,TOR,NYK,TOR,130,,,18,14,14,8
Malachi Flynn,G,22023,1630201,22301216,"DEC 08, 2023",TOR @ CHA,L,17,3,7,0.429,0,4,0.0,2,2,1.0,0,0,0,4,2,0,1,1,8,8,1,TOR,CHA,TOR,116,,,12,8,12,4
Malachi Flynn,G,22023,1630201,22301207,"DEC 06, 2023",TOR vs. MIA,L,6,1,1,1.0,1,1,1.0,0,0,0.0,0,1,1,1,0,0,0,1,3,-3,1,TOR,TOR,MIA,103,,,5,4,4,2
Malachi Flynn,G,22023,1630201,22300276,"DEC 01, 2023",TOR vs. NYK,L,11,0,2,0.0,0,1,0.0,0,0,0.0,0,1,1,4,0,1,0,1,0,-3,1,TOR,TOR,NYK,106,,,5,1,4,5
Malachi Flynn,G,22023,1630201,22300260,"NOV 29, 2023",TOR vs. PHX,W,14,0,3,0.0,0,3,0.0,2,2,1.0,1,4,5,1,0,0,1,0,2,9,1,TOR,TOR,PHX,112,,,8,7,3,6
Malachi Flynn,G,22023,1630201,22300054,"NOV 28, 2023",TOR @ BKN,L,16,2,5,0.4,1,3,0.333,0,0,0.0,0,0,0,1,0,0,0,1,5,-10,1,TOR,BKN,TOR,103,,,6,5,6,1
Malachi Flynn,G,22023,1630201,22300251,"NOV 26, 2023",TOR @ CLE,L,17,1,6,0.167,1,4,0.25,0,0,0.0,0,4,4,0,0,0,1,1,3,-13,1,TOR,CLE,TOR,102,,,7,7,3,4
Malachi Flynn,G,22023,1630201,22300046,"NOV 24, 2023",TOR vs. CHI,W,14,0,2,0.0,0,2,0.0,2,2,1.0,0,1,1,1,1,0,1,1,2,4,1,TOR,TOR,CHI,121,,,4,3,3,2
Malachi Flynn,G,22023,1630201,22300038,"NOV 21, 2023",TOR @ ORL,L,19,2,4,0.5,1,2,0.5,1,2,0.5,0,3,3,1,1,1,1,1,6,-14,1,TOR,ORL,TOR,107,,,10,9,7,4
Malachi Flynn,G,22023,1630201,22300211,"NOV 19, 2023",TOR vs. DET,W,21,3,5,0.6,1,2,0.5,0,2,0.0,0,2,2,4,2,0,1,4,7,0,1,TOR,TOR,DET,142,,,13,9,11,6
Malachi Flynn,G,22023,1630201,22300031,"NOV 17, 2023",TOR vs. BOS,L,19,2,5,0.4,1,1,1.0,0,0,0.0,1,0,1,5,0,0,1,1,5,-15,1,TOR,TOR,BOS,105,,,11,6,10,6
Malachi Flynn,G,22023,1630201,22300195,"NOV 15, 2023",TOR vs. MIL,L,27,3,11,0.273,0,8,0.0,1,1,1.0,2,1,3,5,0,1,0,1,7,4,1,TOR,TOR,MIL,112,,,15,10,12,8
Malachi Flynn,G,22023,1630201,22300189,"NOV 13, 2023",TOR vs. WAS,W,23,2,5,0.4,1,4,0.25,1,1,1.0,0,2,2,1,1,0,1,2,6,12,1,TOR,TOR,WAS,111,,,9,8,7,3
Malachi Flynn,G,22023,1630201,22300174,"NOV 11, 2023",TOR @ BOS,L,23,5,7,0.714,2,4,0.5,0,1,0.0,0,1,1,1,0,0,1,0,12,-21,1,TOR,BOS,TOR,94,,,14,13,13,2
Malachi Flynn,G,22023,1630201,22300092,"OCT 28, 2023",TOR vs. PHI,L,13,2,4,0.5,2,2,1.0,1,1,1.0,0,0,0,2,1,0,3,1,7,-2,1,TOR,TOR,PHI,107,,,9,7,9,2
Malachi Flynn,G,22023,1630201,22300082,"OCT 27, 2023",TOR @ CHI,L,4,0,1,0.0,0,1,0.0,0,0,0.0,0,0,0,0,0,0,0,0,0,-14,1,TOR,CHI,TOR,103,,,0,0,0,0
Malachi Flynn,G,22023,1630201,22300069,"OCT 25, 2023",TOR vs. MIN,W,10,1,3,0.333,1,1,1.0,0,0,0.0,0,0,0,2,1,0,2,4,3,-14,1,TOR,TOR,MIN,97,,,5,3,5,2
Malachi Flynn,G,22023,1630201,22300230,"NOV 22, 2023",TOR @ IND,W,20,6,8,0.75,2,3,0.667,0,0,0.0,2,2,4,2,0,1,1,2,14,-4,1,TOR,IND,TOR,132,,,20,18,16,6
Malachi Flynn,G,22023,1630201,22300168,"NOV 08, 2023",TOR @ DAL,W,15,2,5,0.4,2,4,0.5,2,2,1.0,0,4,4,4,0,0,0,2,8,7,1,TOR,DAL,TOR,127,,,16,12,12,8
Malachi Flynn,G,22023,1630201,22300141,"NOV 05, 2023",TOR @ SAS,W,15,1,3,0.333,1,2,0.5,2,2,1.0,1,2,3,4,0,0,0,1,5,6,1,TOR,SAS,TOR,123,,,12,8,9,7
Malachi Flynn,G,22023,1630201,22300128,"NOV 02, 2023",TOR @ PHI,L,17,2,5,0.4,2,3,0.667,0,0,0.0,1,2,3,1,2,0,1,2,6,-8,1,TOR,PHI,TOR,99,,,10,9,7,4
Malachi Flynn,G,22023,1630201,22300116,"NOV 01, 2023",TOR vs. MIL,W,19,1,3,0.333,0,1,0.0,0,0,0.0,1,2,3,4,3,0,3,1,2,-2,1,TOR,TOR,MIL,130,,,9,5,6,7
Malachi Flynn,G,22023,1630201,22300105,"OCT 30, 2023",TOR vs. POR,L,15,3,5,0.6,0,2,0.0,0,0,0.0,0,1,1,0,1,0,1,1,6,-9,1,TOR,TOR,POR,91,,,7,7,6,1
Jordan Goodwin,G,22023,1630692,22300725,"FEB 06, 2024",PHX vs. MIL,W,0,0,0,0.0,0,0,0.0,2,2,1.0,0,0,0,0,0,0,0,0,2,-3,1,PHX,PHX,MIL,114,,,2,2,2,0
Jordan Goodwin,G,22023,1630692,22300705,"FEB 04, 2024",PHX @ WAS,W,9,2,3,0.667,0,0,0.0,0,0,0.0,0,0,0,1,2,1,0,1,4,-1,1,PHX,WAS,PHX,140,,,5,4,5,1
Jordan Goodwin,G,22023,1630692,22300655,"JAN 28, 2024",PHX @ ORL,L,2,1,2,0.5,0,0,0.0,0,0,0.0,1,0,1,0,0,0,0,0,2,1,1,PHX,ORL,PHX,98,,,3,3,2,1
Jordan Goodwin,G,22023,1630692,22300625,"JAN 24, 2024",PHX @ DAL,W,4,3,4,0.75,0,1,0.0,0,0,0.0,0,0,0,1,0,0,0,0,6,2,1,PHX,DAL,PHX,132,,,7,6,7,1
Jordan Goodwin,G,22023,1630692,22300588,"JAN 19, 2024",PHX @ NOP,W,4,1,2,0.5,0,0,0.0,0,0,0.0,1,0,1,1,0,0,1,1,2,-10,1,PHX,NOP,PHX,123,,,4,3,3,2
Jordan Goodwin,G,22023,1630692,22300531,"JAN 11, 2024",PHX @ LAL,W,5,0,1,0.0,0,0,0.0,0,0,0.0,0,0,0,1,1,0,1,1,0,-7,1,PHX,LAL,PHX,127,,,1,0,1,1
Jordan Goodwin,G,22023,1630692,22300511,"JAN 08, 2024",PHX @ LAC,L,5,2,3,0.667,0,0,0.0,0,0,0.0,0,0,0,0,0,0,0,0,4,-3,1,PHX,LAC,PHX,111,,,4,4,4,0
Jordan Goodwin,G,22023,1630692,22300489,"JAN 05, 2024",PHX vs. MIA,W,2,0,1,0.0,0,1,0.0,0,0,0.0,0,0,0,0,0,0,0,0,0,-5,1,PHX,PHX,MIA,113,,,0,0,0,0
Jordan Goodwin,G,22023,1630692,22300456,"JAN 01, 2024",PHX vs. POR,W,6,1,2,0.5,0,1,0.0,0,0,0.0,1,0,1,1,1,0,1,0,2,-5,1,PHX,PHX,POR,109,,,4,3,3,2
Jordan Goodwin,G,22023,1630692,22300436,"DEC 29, 2023",PHX vs. CHA,W,1,0,0,0.0,0,0,0.0,0,0,0.0,0,0,0,0,0,0,0,0,0,2,1,PHX,PHX,CHA,133,,,0,0,0,0
Jordan Goodwin,G,22023,1630692,22300405,"DEC 25, 2023",PHX vs. DAL,L,11,0,3,0.0,0,1,0.0,2,2,1.0,3,0,3,1,0,0,0,0,2,3,1,PHX,PHX,DAL,114,,,6,5,3,4
Jordan Goodwin,G,22023,1630692,22300387,"DEC 22, 2023",PHX @ SAC,L,14,1,6,0.167,0,1,0.0,1,2,0.5,2,1,3,0,1,0,1,2,3,5,1,PHX,SAC,PHX,105,,,6,6,3,3
Jordan Goodwin,G,22023,1630692,22300363,"DEC 19, 2023",PHX @ POR,L,20,1,7,0.143,0,2,0.0,0,0,0.0,3,3,6,2,0,1,1,2,2,0,1,PHX,POR,PHX,104,,,10,8,4,8
Jordan Goodwin,G,22023,1630692,22300347,"DEC 17, 2023",PHX vs. WAS,W,20,3,7,0.429,0,3,0.0,0,0,0.0,3,5,8,6,0,0,2,2,6,17,1,PHX,PHX,WAS,112,,,20,14,12,14
Jordan Goodwin,G,22023,1630692,22300333,"DEC 15, 2023",PHX vs. NYK,L,23,1,5,0.2,1,3,0.333,0,0,0.0,0,3,3,9,0,0,1,3,3,-13,1,PHX,PHX,NYK,122,,,15,6,12,12
Jordan Goodwin,G,22023,1630692,22301203,"DEC 05, 2023",PHX @ LAL,L,15,3,6,0.5,1,2,0.5,0,0,0.0,2,4,6,1,0,0,1,1,7,1,1,PHX,LAL,PHX,103,,,14,13,8,7
Jordan Goodwin,G,22023,1630692,22300288,"DEC 02, 2023",PHX vs. MEM,W,19,2,6,0.333,1,3,0.333,2,2,1.0,1,3,4,1,0,0,1,3,7,-5,1,PHX,PHX,MEM,116,,,12,11,8,5
Jordan Goodwin,G,22023,1630692,22300279,"DEC 01, 2023",PHX vs. DEN,L,20,1,3,0.333,0,1,0.0,0,0,0.0,2,4,6,0,0,0,0,1,2,-5,1,PHX,PHX,DEN,111,,,8,8,2,6
Jordan Goodwin,G,22023,1630692,22300044,"NOV 24, 2023",PHX @ MEM,W,20,6,8,0.75,1,3,0.333,1,1,1.0,2,3,5,2,1,0,1,0,14,19,1,PHX,MEM,PHX,110,,,21,19,16,7
Jordan Goodwin,G,22023,1630692,22300236,"NOV 22, 2023",PHX vs. GSW,W,1,0,0,0.0,0,0,0.0,0,0,0.0,0,0,0,0,0,0,0,0,0,-5,1,PHX,PHX,GSW,123,,,0,0,0,0
Jordan Goodwin,G,22023,1630692,22300041,"NOV 21, 2023",PHX vs. POR,W,5,1,3,0.333,0,1,0.0,0,0,0.0,0,0,0,0,0,0,0,0,2,-9,1,PHX,PHX,POR,120,,,2,2,2,0
Jordan Goodwin,G,22023,1630692,22300214,"NOV 19, 2023",PHX @ UTA,W,11,0,0,0.0,0,0,0.0,0,0,0.0,0,3,3,3,1,0,1,0,0,0,1,PHX,UTA,PHX,140,,,6,3,3,6
Jordan Goodwin,G,22023,1630692,22300035,"NOV 17, 2023",PHX @ UTA,W,14,1,6,0.167,1,4,0.25,0,0,0.0,0,2,2,4,1,0,0,2,3,13,1,PHX,UTA,PHX,131,,,9,5,7,6
Jordan Goodwin,G,22023,1630692,22300197,"NOV 15, 2023",PHX vs. MIN,W,16,1,1,1.0,1,1,1.0,0,0,0.0,0,3,3,3,1,1,0,2,3,6,1,PHX,PHX,MIN,133,,,9,6,6,6
Jordan Goodwin,G,22023,1630692,22300185,"NOV 12, 2023",PHX vs. OKC,L,29,4,10,0.4,3,7,0.429,0,0,0.0,1,4,5,3,1,1,1,2,11,3,1,PHX,PHX,OKC,99,,,19,16,14,8
Jordan Goodwin,G,22023,1630692,22300015,"NOV 10, 2023",PHX vs. LAL,L,7,1,3,0.333,1,3,0.333,0,0,0.0,1,1,2,0,0,0,0,0,3,-13,1,PHX,PHX,LAL,119,,,5,5,3,2
Jordan Goodwin,G,22023,1630692,22300162,"NOV 08, 2023",PHX @ CHI,W,17,2,5,0.4,2,3,0.667,0,0,0.0,1,1,2,0,0,0,0,1,6,2,1,PHX,CHI,PHX,116,,,8,8,6,2
Jordan Goodwin,G,22023,1630692,22300140,"NOV 05, 2023",PHX @ DET,W,21,2,7,0.286,2,4,0.5,2,2,1.0,0,7,7,3,1,1,2,2,8,12,1,PHX,DET,PHX,120,,,18,15,11,10
Jordan Goodwin,G,22023,1630692,22300132,"NOV 04, 2023",PHX @ PHI,L,16,2,10,0.2,1,6,0.167,1,2,0.5,2,1,3,0,2,2,0,0,6,5,1,PHX,PHI,PHX,100,,,9,9,6,3
Jordan Goodwin,G,22023,1630692,22300131,"NOV 02, 2023",PHX vs. SAS,L,10,1,3,0.333,1,2,0.5,0,0,0.0,1,0,1,3,1,0,1,0,3,-13,1,PHX,PHX,SAS,121,,,7,4,6,4
Jordan Goodwin,G,22023,1630692,22300113,"OCT 31, 2023",PHX vs. SAS,L,15,3,7,0.429,0,2,0.0,0,0,0.0,2,2,4,0,1,0,1,3,6,-2,1,PHX,PHX,SAS,114,,,10,10,6,4
Jordan Goodwin,G,22023,1630692,22300094,"OCT 28, 2023",PHX vs. UTA,W,25,2,9,0.222,2,5,0.4,6,6,1.0,2,3,5,5,1,0,2,2,12,3,1,PHX,PHX,UTA,126,,,22,17,17,10
Jordan Goodwin,G,22023,1630692,22300076,"OCT 26, 2023",PHX @ LAL,L,30,6,15,0.4,1,5,0.2,1,3,0.333,0,6,6,2,2,0,1,2,14,8,1,PHX,LAL,PHX,95,,,22,20,16,8
Jordan Goodwin,G,22023,1630692,22300062,"OCT 24, 2023",PHX @ GSW,W,14,1,4,0.25,0,1,0.0,0,0,0.0,1,3,4,3,1,0,2,0,2,7,1,PHX,GSW,PHX,108,,,9,6,5,7
Jordan Goodwin,G,22023,1630692,22300677,"JAN 31, 2024",PHX @ BKN,W,1,1,1,1.0,0,0,0.0,0,0,0.0,0,0,0,0,0,0,0,0,2,0,1,PHX,BKN,PHX,136,,,2,2,2,0
Jordan Goodwin,G,22023,1630692,22300317,"DEC 13, 2023",PHX vs. BKN,L,27,1,6,0.167,0,2,0.0,0,0,0.0,0,0,0,1,1,0,2,1,2,-19,1,PHX,PHX,BKN,112,,,3,2,3,1
Jordan Goodwin,G,22023,1630692,22300308,"DEC 12, 2023",PHX vs. GSW,W,30,5,10,0.5,1,5,0.2,5,5,1.0,0,5,5,6,2,1,1,3,16,-10,1,PHX,PHX,GSW,119,,,27,21,22,11
Jordan Goodwin,G,22023,1630692,22301228,"DEC 08, 2023",PHX vs. SAC,L,20,3,6,0.5,0,1,0.0,2,2,1.0,2,3,5,6,0,0,2,2,8,-12,1,PHX,PHX,SAC,106,,,19,13,14,11
Jordan Goodwin,G,22023,1630692,22300260,"NOV 29, 2023",PHX @ TOR,L,23,4,8,0.5,1,3,0.333,0,0,0.0,3,3,6,4,0,0,2,2,9,3,1,PHX,TOR,PHX,105,,,19,15,13,10
Jordan Goodwin,G,22023,1630692,22300247,"NOV 26, 2023",PHX @ NYK,W,29,6,10,0.6,2,3,0.667,0,0,0.0,3,4,7,5,1,1,0,2,14,7,1,PHX,NYK,PHX,116,,,26,21,19,12
Chimezie Metu,F-C,22023,1629002,22300705,"FEB 04, 2024",PHX @ WAS,W,8,2,4,0.5,0,0,0.0,0,0,0.0,1,2,3,1,0,0,2,0,4,-1,1,PHX,WAS,PHX,140,,,8,7,5,4
Chimezie Metu,F-C,22023,1629002,22300655,"JAN 28, 2024",PHX @ ORL,L,7,0,0,0.0,0,0,0.0,0,0,0.0,0,1,1,0,1,0,1,1,0,-6,1,PHX,ORL,PHX,98,,,1,1,0,1
Chimezie Metu,F-C,22023,1629002,22300636,"JAN 26, 2024",PHX @ IND,L,2,0,1,0.0,0,0,0.0,0,0,0.0,0,1,1,0,0,0,0,0,0,-5,1,PHX,IND,PHX,131,,,1,1,0,1
Chimezie Metu,F-C,22023,1629002,22300625,"JAN 24, 2024",PHX @ DAL,W,14,1,1,1.0,0,0,0.0,0,0,0.0,1,6,7,1,0,0,0,1,2,0,1,PHX,DAL,PHX,132,,,10,9,3,8
Chimezie Metu,F-C,22023,1629002,22300604,"JAN 21, 2024",PHX vs. IND,W,7,0,0,0.0,0,0,0.0,2,2,1.0,0,1,1,1,1,0,0,2,2,-6,1,PHX,PHX,IND,117,,,4,3,3,2
Chimezie Metu,F-C,22023,1629002,22300588,"JAN 19, 2024",PHX @ NOP,W,14,0,4,0.0,0,1,0.0,2,2,1.0,1,3,4,1,0,1,1,2,2,-10,1,PHX,NOP,PHX,123,,,7,6,3,5
Chimezie Metu,F-C,22023,1629002,22300567,"JAN 16, 2024",PHX vs. SAC,W,10,3,5,0.6,0,1,0.0,0,0,0.0,0,5,5,1,0,0,1,1,6,2,1,PHX,PHX,SAC,119,,,12,11,7,6
Chimezie Metu,F-C,22023,1629002,22300554,"JAN 14, 2024",PHX @ POR,W,17,3,3,1.0,1,1,1.0,1,2,0.5,0,3,3,0,1,2,0,3,8,1,1,PHX,POR,PHX,127,,,11,11,8,3
Chimezie Metu,F-C,22023,1629002,22300531,"JAN 11, 2024",PHX @ LAL,W,9,0,0,0.0,0,0,0.0,4,4,1.0,1,1,2,1,0,0,0,0,4,-6,1,PHX,LAL,PHX,127,,,7,6,5,3
Chimezie Metu,F-C,22023,1629002,22300511,"JAN 08, 2024",PHX @ LAC,L,8,1,1,1.0,0,0,0.0,2,2,1.0,0,2,2,0,0,1,0,1,4,-7,1,PHX,LAC,PHX,111,,,6,6,4,2
Chimezie Metu,F-C,22023,1629002,22300503,"JAN 07, 2024",PHX vs. MEM,L,12,2,7,0.286,0,5,0.0,0,0,0.0,0,1,1,0,1,0,1,3,4,-8,1,PHX,PHX,MEM,115,,,5,5,4,1
Chimezie Metu,F-C,22023,1629002,22300489,"JAN 05, 2024",PHX vs. MIA,W,17,3,3,1.0,0,0,0.0,1,1,1.0,0,2,2,0,2,0,2,0,7,18,1,PHX,PHX,MIA,113,,,9,9,7,2
Chimezie Metu,F-C,22023,1629002,22300473,"JAN 03, 2024",PHX vs. LAC,L,15,3,6,0.5,1,4,0.25,0,0,0.0,1,2,3,2,2,0,1,0,7,-11,1,PHX,PHX,LAC,122,,,12,10,9,5
Chimezie Metu,F-C,22023,1629002,22300456,"JAN 01, 2024",PHX vs. POR,W,26,4,8,0.5,2,4,0.5,4,4,1.0,2,3,5,1,1,0,2,3,14,6,1,PHX,PHX,POR,109,,,20,19,15,6
Chimezie Metu,F-C,22023,1629002,22300450,"DEC 31, 2023",PHX vs. ORL,W,17,3,7,0.429,0,2,0.0,0,0,0.0,2,4,6,0,0,0,1,2,6,-4,1,PHX,PHX,ORL,112,,,12,12,6,6
Chimezie Metu,F-C,22023,1629002,22300436,"DEC 29, 2023",PHX vs. CHA,W,19,2,3,0.667,1,1,1.0,4,4,1.0,1,6,7,1,1,0,0,0,9,5,1,PHX,PHX,CHA,133,,,17,16,10,8
Chimezie Metu,F-C,22023,1629002,22300418,"DEC 27, 2023",PHX @ HOU,W,16,1,1,1.0,0,0,0.0,2,2,1.0,1,1,2,0,0,0,3,0,4,1,1,PHX,HOU,PHX,129,,,6,6,4,2
Chimezie Metu,F-C,22023,1629002,22300405,"DEC 25, 2023",PHX vs. DAL,L,34,9,18,0.5,2,6,0.333,3,4,0.75,6,13,19,2,1,0,3,1,23,-3,1,PHX,PHX,DAL,114,,,44,42,25,21
Chimezie Metu,F-C,22023,1629002,22300387,"DEC 22, 2023",PHX @ SAC,L,13,3,6,0.5,0,2,0.0,4,4,1.0,1,3,4,0,0,0,1,1,10,5,1,PHX,SAC,PHX,105,,,14,14,10,4
Chimezie Metu,F-C,22023,1629002,22300363,"DEC 19, 2023",PHX @ POR,L,15,1,2,0.5,0,1,0.0,0,0,0.0,0,1,1,1,1,0,1,0,2,-6,1,PHX,POR,PHX,104,,,4,3,3,2
Chimezie Metu,F-C,22023,1629002,22300347,"DEC 17, 2023",PHX vs. WAS,W,9,1,1,1.0,0,0,0.0,2,2,1.0,0,2,2,0,1,0,1,0,4,0,1,PHX,PHX,WAS,112,,,6,6,4,2
Chimezie Metu,F-C,22023,1629002,22300333,"DEC 15, 2023",PHX vs. NYK,L,10,1,3,0.333,0,2,0.0,1,2,0.5,0,1,1,1,0,0,1,0,3,-12,1,PHX,PHX,NYK,122,,,5,4,4,2
Chimezie Metu,F-C,22023,1629002,22300279,"DEC 01, 2023",PHX vs. DEN,L,4,0,2,0.0,0,1,0.0,0,0,0.0,0,1,1,1,0,0,0,0,0,-1,1,PHX,PHX,DEN,111,,,2,1,1,2
Chimezie Metu,F-C,22023,1629002,22300044,"NOV 24, 2023",PHX @ MEM,W,15,1,3,0.333,0,1,0.0,1,2,0.5,0,2,2,1,0,0,0,2,3,7,1,PHX,MEM,PHX,110,,,6,5,4,3
Chimezie Metu,F-C,22023,1629002,22300236,"NOV 22, 2023",PHX vs. GSW,W,12,2,3,0.667,0,1,0.0,0,0,0.0,0,2,2,0,0,2,0,2,4,-10,1,PHX,PHX,GSW,123,,,6,6,4,2
Chimezie Metu,F-C,22023,1629002,22300041,"NOV 21, 2023",PHX vs. POR,W,6,0,0,0.0,0,0,0.0,0,0,0.0,0,0,0,1,1,0,0,1,0,-1,1,PHX,PHX,POR,120,,,1,0,1,1
Chimezie Metu,F-C,22023,1629002,22300197,"NOV 15, 2023",PHX vs. MIN,W,4,2,4,0.5,0,1,0.0,0,0,0.0,0,2,2,0,0,0,1,2,4,-3,1,PHX,PHX,MIN,133,,,6,6,4,2
Chimezie Metu,F-C,22023,1629002,22300185,"NOV 12, 2023",PHX vs. OKC,L,1,0,1,0.0,0,1,0.0,0,0,0.0,0,0,0,0,0,0,0,0,0,0,1,PHX,PHX,OKC,99,,,0,0,0,0
Chimezie Metu,F-C,22023,1629002,22300140,"NOV 05, 2023",PHX @ DET,W,2,0,0,0.0,0,0,0.0,0,0,0.0,0,0,0,0,0,0,0,0,0,-5,1,PHX,DET,PHX,120,,,0,0,0,0
Chimezie Metu,F-C,22023,1629002,22300132,"NOV 04, 2023",PHX @ PHI,L,5,0,1,0.0,0,1,0.0,2,2,1.0,0,1,1,0,0,1,1,0,2,4,1,PHX,PHI,PHX,100,,,3,3,2,1
Chimezie Metu,F-C,22023,1629002,22300094,"OCT 28, 2023",PHX vs. UTA,W,3,1,2,0.5,0,0,0.0,0,0,0.0,0,1,1,1,0,0,0,0,2,-4,1,PHX,PHX,UTA,126,,,4,3,3,2
Chimezie Metu,F-C,22023,1629002,22300677,"JAN 31, 2024",PHX @ BKN,W,1,0,0,0.0,0,0,0.0,0,0,0.0,0,0,0,0,0,0,0,0,0,0,1,PHX,BKN,PHX,136,,,0,0,0,0
Chimezie Metu,F-C,22023,1629002,22300317,"DEC 13, 2023",PHX vs. BKN,L,20,3,8,0.375,2,3,0.667,0,0,0.0,3,1,4,0,2,0,1,2,8,-4,1,PHX,PHX,BKN,112,,,12,12,8,4
Chimezie Metu,F-C,22023,1629002,22300308,"DEC 12, 2023",PHX vs. GSW,W,25,5,7,0.714,3,5,0.6,1,2,0.5,1,4,5,0,1,0,1,2,14,28,1,PHX,PHX,GSW,119,,,19,19,14,5
Chimezie Metu,F-C,22023,1629002,22301228,"DEC 08, 2023",PHX vs. SAC,L,23,4,9,0.444,0,4,0.0,2,2,1.0,0,4,4,1,2,2,0,1,10,-1,1,PHX,PHX,SAC,106,,,15,14,11,5
Chimezie Metu,F-C,22023,1629002,22300260,"NOV 29, 2023",PHX @ TOR,L,15,2,3,0.667,1,1,1.0,0,0,0.0,0,2,2,0,0,0,1,3,5,-4,1,PHX,TOR,PHX,105,,,7,7,5,2
Chimezie Metu,F-C,22023,1629002,22300247,"NOV 26, 2023",PHX @ NYK,W,13,3,3,1.0,2,2,1.0,0,0,0.0,2,2,4,0,0,0,0,3,8,3,1,PHX,NYK,PHX,116,,,12,12,8,4
Jarred Vanderbilt,F,22023,1629020,22300605,"JAN 21, 2024",LAL vs. POR,W,21,2,3,0.667,0,0,0.0,0,0,0.0,2,2,4,2,2,0,3,1,4,8,1,LAL,LAL,POR,134,,,10,8,6,6
Jarred Vanderbilt,F,22023,1629020,22300331,"DEC 15, 2023",LAL @ SAS,L,13,0,3,0.0,0,1,0.0,0,0,0.0,0,5,5,1,0,0,0,4,0,-2,1,LAL,SAS,LAL,115,,,6,5,1,6
Jarred Vanderbilt,F,22023,1629020,22300684,"FEB 01, 2024",LAL @ BOS,W,16,3,7,0.429,2,3,0.667,2,2,1.0,3,4,7,2,3,0,3,0,10,17,1,LAL,BOS,LAL,114,,,19,17,12,9
Jarred Vanderbilt,F,22023,1629020,22300669,"JAN 30, 2024",LAL @ ATL,L,26,6,6,1.0,0,0,0.0,0,1,0.0,1,3,4,3,2,0,2,2,12,-9,1,LAL,ATL,LAL,122,,,19,16,15,7
Jarred Vanderbilt,F,22023,1629020,22300662,"JAN 29, 2024",LAL @ HOU,L,7,1,1,1.0,0,0,0.0,1,1,1.0,0,0,0,0,1,0,0,0,3,-6,1,LAL,HOU,LAL,119,,,3,3,3,0
Jarred Vanderbilt,F,22023,1629020,22300650,"JAN 27, 2024",LAL @ GSW,W,41,4,7,0.571,0,0,0.0,6,8,0.75,2,7,9,5,4,0,2,1,14,30,1,LAL,GSW,LAL,145,,,28,23,19,14
Jarred Vanderbilt,F,22023,1629020,22300633,"JAN 25, 2024",LAL vs. CHI,W,27,8,11,0.727,1,1,1.0,0,1,0.0,0,5,5,0,3,1,2,2,17,0,1,LAL,LAL,CHI,141,,,22,22,17,5
Jarred Vanderbilt,F,22023,1629020,22300618,"JAN 23, 2024",LAL @ LAC,L,25,4,10,0.4,0,1,0.0,4,4,1.0,6,3,9,2,3,1,2,3,12,-9,1,LAL,LAC,LAL,116,,,23,21,14,11
Jarred Vanderbilt,F,22023,1629020,22300591,"JAN 19, 2024",LAL vs. BKN,L,19,5,5,1.0,2,2,1.0,0,0,0.0,0,5,5,0,0,0,0,0,12,-10,1,LAL,LAL,BKN,112,,,17,17,12,5
Jarred Vanderbilt,F,22023,1629020,22300577,"JAN 17, 2024",LAL vs. DAL,W,26,1,3,0.333,0,1,0.0,5,8,0.625,1,8,9,1,1,0,1,3,7,10,1,LAL,LAL,DAL,127,,,17,16,8,10
Jarred Vanderbilt,F,22023,1629020,22300565,"JAN 15, 2024",LAL vs. OKC,W,18,2,2,1.0,0,0,0.0,1,1,1.0,0,4,4,2,3,0,0,0,5,5,1,LAL,LAL,OKC,112,,,11,9,7,6
Jarred Vanderbilt,F,22023,1629020,22300549,"JAN 13, 2024",LAL @ UTA,L,23,2,2,1.0,1,1,1.0,0,0,0.0,2,1,3,1,1,0,2,4,5,4,1,LAL,UTA,LAL,125,,,9,8,6,4
Jarred Vanderbilt,F,22023,1629020,22300531,"JAN 11, 2024",LAL vs. PHX,L,29,2,5,0.4,1,3,0.333,1,4,0.25,3,6,9,2,2,0,1,0,6,-1,1,LAL,LAL,PHX,109,,,17,15,8,11
Jarred Vanderbilt,F,22023,1629020,22300516,"JAN 09, 2024",LAL vs. TOR,W,18,1,2,0.5,0,0,0.0,1,2,0.5,2,4,6,1,0,0,3,1,3,6,1,LAL,LAL,TOR,132,,,10,9,4,7
Jarred Vanderbilt,F,22023,1629020,22300505,"JAN 07, 2024",LAL vs. LAC,W,21,1,3,0.333,0,1,0.0,0,0,0.0,2,2,4,4,1,0,1,0,2,6,1,LAL,LAL,LAC,106,,,10,6,6,8
Jarred Vanderbilt,F,22023,1629020,22300491,"JAN 05, 2024",LAL vs. MEM,L,17,0,0,0.0,0,0,0.0,0,0,0.0,1,4,5,1,1,0,0,1,0,3,1,LAL,LAL,MEM,113,,,6,5,1,6
Jarred Vanderbilt,F,22023,1629020,22300475,"JAN 03, 2024",LAL vs. MIA,L,16,2,3,0.667,0,0,0.0,0,0,0.0,0,2,2,0,0,0,2,0,4,-6,1,LAL,LAL,MIA,96,,,6,6,4,2
Jarred Vanderbilt,F,22023,1629020,22300446,"DEC 31, 2023",LAL @ NOP,L,21,2,4,0.5,0,1,0.0,0,0,0.0,0,2,2,0,1,0,1,0,4,-13,1,LAL,NOP,LAL,109,,,6,6,4,2
Jarred Vanderbilt,F,22023,1629020,22300428,"DEC 28, 2023",LAL vs. CHA,W,24,3,8,0.375,1,2,0.5,0,0,0.0,2,2,4,3,2,0,0,1,7,2,1,LAL,LAL,CHA,133,,,14,11,10,7
Jarred Vanderbilt,F,22023,1629020,22300370,"DEC 20, 2023",LAL @ CHI,L,13,1,3,0.333,0,2,0.0,0,0,0.0,0,0,0,0,0,0,0,1,2,-15,1,LAL,CHI,LAL,108,,,2,2,2,0
Jarred Vanderbilt,F,22023,1629020,22300316,"DEC 13, 2023",LAL @ SAS,W,17,1,1,1.0,0,0,0.0,0,0,0.0,0,3,3,0,1,1,0,1,2,-2,1,LAL,SAS,LAL,122,,,5,5,2,3
Jarred Vanderbilt,F,22023,1629020,22301230,"DEC 07, 2023",LAL vs. NOP,W,14,1,2,0.5,0,0,0.0,0,0,0.0,0,5,5,1,0,1,0,0,2,9,1,LAL,LAL,NOP,133,,,8,7,3,6
Jarred Vanderbilt,F,22023,1629020,22301203,"DEC 05, 2023",LAL vs. PHX,W,15,0,2,0.0,0,2,0.0,1,2,0.5,4,2,6,2,1,0,1,2,1,6,1,LAL,LAL,PHX,106,,,9,7,3,8
Jarred Vanderbilt,F,22023,1629020,22300291,"DEC 02, 2023",LAL vs. HOU,W,14,0,2,0.0,0,2,0.0,0,0,0.0,1,3,4,1,0,0,0,1,0,2,1,LAL,LAL,HOU,107,,,5,4,1,5
Jarred Vanderbilt,F,22023,1629020,22300443,"DEC 30, 2023",LAL @ MIN,L,27,3,7,0.429,0,2,0.0,2,2,1.0,1,4,5,1,2,0,0,5,8,10,1,LAL,MIN,LAL,106,,,14,13,9,6
Jarred Vanderbilt,F,22023,1629020,22300403,"DEC 25, 2023",LAL vs. BOS,L,23,3,5,0.6,0,0,0.0,0,0,0.0,4,2,6,0,1,0,0,4,6,-10,1,LAL,LAL,BOS,115,,,12,12,6,6
Jarred Vanderbilt,F,22023,1629020,22300397,"DEC 23, 2023",LAL @ OKC,W,24,1,4,0.25,0,1,0.0,0,0,0.0,1,5,6,0,1,1,1,0,2,5,1,LAL,OKC,LAL,129,,,8,8,2,6
Jarred Vanderbilt,F,22023,1629020,22300380,"DEC 21, 2023",LAL @ MIN,L,14,0,3,0.0,0,1,0.0,0,0,0.0,1,4,5,0,0,0,0,3,0,1,1,LAL,MIN,LAL,111,,,5,5,0,5
Jarred Vanderbilt,F,22023,1629020,22300359,"DEC 18, 2023",LAL vs. NYK,L,14,0,0,0.0,0,0,0.0,0,0,0.0,2,0,2,1,0,0,1,3,0,3,1,LAL,LAL,NYK,109,,,3,2,1,3
Isaiah Livers,F,22023,1630587,22300534,"JAN 12, 2024",DET vs. HOU,L,16,1,4,0.25,1,4,0.25,0,0,0.0,0,0,0,1,0,2,0,3,3,-3,1,DET,DET,HOU,110,,,4,3,4,1
Isaiah Livers,F,22023,1630587,22300453,"JAN 01, 2024",DET @ HOU,L,13,1,2,0.5,0,0,0.0,0,0,0.0,0,0,0,0,0,0,0,0,2,-11,1,DET,HOU,DET,113,,,2,2,2,0
Isaiah Livers,F,22023,1630587,22300374,"DEC 21, 2023",DET vs. UTA,L,13,0,3,0.0,0,3,0.0,0,0,0.0,1,2,3,1,0,0,1,2,0,-7,1,DET,DET,UTA,111,,,4,3,1,4
Isaiah Livers,F,22023,1630587,22300352,"DEC 18, 2023",DET @ ATL,L,4,0,3,0.0,0,1,0.0,0,0,0.0,0,0,0,0,0,0,0,0,0,-4,1,DET,ATL,DET,124,,,0,0,0,0
Isaiah Livers,F,22023,1630587,22300334,"DEC 16, 2023",DET @ MIL,L,27,1,8,0.125,0,5,0.0,0,0,0.0,2,2,4,1,3,1,0,1,2,-17,1,DET,MIL,DET,114,,,7,6,3,5
Isaiah Livers,F,22023,1630587,22301217,"DEC 08, 2023",DET @ ORL,L,12,0,5,0.0,0,3,0.0,0,0,0.0,0,1,1,1,0,0,0,2,0,-11,1,DET,ORL,DET,91,,,2,1,1,2
Isaiah Livers,F,22023,1630587,22300283,"DEC 02, 2023",DET vs. CLE,L,14,0,1,0.0,0,1,0.0,0,0,0.0,0,0,0,0,0,0,2,1,0,-22,1,DET,DET,CLE,101,,,0,0,0,0
Isaiah Livers,F,22023,1630587,22300268,"NOV 30, 2023",DET @ NYK,L,27,2,8,0.25,1,5,0.2,1,3,0.333,2,2,4,1,0,0,2,2,6,4,1,DET,NYK,DET,112,,,11,10,7,5
Isaiah Livers,F,22023,1630587,22300258,"NOV 29, 2023",DET vs. LAL,L,22,5,8,0.625,4,6,0.667,0,0,0.0,0,3,3,2,0,0,2,2,14,-12,1,DET,DET,LAL,107,,,19,17,16,5
Isaiah Livers,F,22023,1630587,22300047,"NOV 24, 2023",DET @ IND,L,26,3,5,0.6,2,4,0.5,0,0,0.0,0,2,2,0,0,0,0,2,8,-15,1,DET,IND,DET,113,,,10,10,8,2
Isaiah Livers,F,22023,1630587,22300218,"NOV 20, 2023",DET vs. DEN,L,23,1,7,0.143,0,3,0.0,4,4,1.0,2,2,4,1,0,0,2,2,6,-7,1,DET,DET,DEN,103,,,11,10,7,5
Isaiah Livers,F,22023,1630587,22300519,"JAN 10, 2024",DET vs. SAS,L,17,2,3,0.667,2,3,0.667,0,0,0.0,2,2,4,1,1,0,0,1,6,-6,1,DET,DET,SAS,108,,,11,10,7,5
Isaiah Livers,F,22023,1630587,22300512,"JAN 09, 2024",DET vs. SAC,L,15,1,3,0.333,1,2,0.5,0,0,0.0,1,0,1,2,0,0,0,0,3,-7,1,DET,DET,SAC,110,,,6,4,5,3
Isaiah Livers,F,22023,1630587,22300502,"JAN 07, 2024",DET @ DEN,L,31,4,8,0.5,1,2,0.5,2,2,1.0,2,3,5,1,1,0,0,5,11,-1,1,DET,DEN,DET,114,,,17,16,12,6
Isaiah Livers,F,22023,1630587,22300490,"JAN 05, 2024",DET @ GSW,L,22,2,3,0.667,1,2,0.5,0,0,0.0,0,1,1,1,1,0,0,2,5,-7,1,DET,GSW,DET,109,,,7,6,6,2
Isaiah Livers,F,22023,1630587,22300474,"JAN 03, 2024",DET @ UTA,L,36,4,7,0.571,1,4,0.25,1,1,1.0,3,1,4,0,2,0,1,4,10,-13,1,DET,UTA,DET,148,,,14,14,10,4
Isaiah Livers,F,22023,1630587,22300440,"DEC 30, 2023",DET vs. TOR,W,17,1,2,0.5,1,2,0.5,0,0,0.0,0,1,1,1,0,0,1,3,3,1,1,DET,DET,TOR,129,,,5,4,4,2
Isaiah Livers,F,22023,1630587,22300421,"DEC 28, 2023",DET @ BOS,L,23,3,7,0.429,2,6,0.333,1,4,0.25,0,1,1,2,0,1,3,2,9,-13,1,DET,BOS,DET,122,,,12,10,11,3
Isaiah Livers,F,22023,1630587,22300327,"DEC 15, 2023",DET @ PHI,L,25,1,4,0.25,0,2,0.0,1,2,0.5,0,3,3,2,1,1,0,4,3,5,1,DET,PHI,DET,92,,,8,6,5,5
Isaiah Livers,F,22023,1630587,22300310,"DEC 13, 2023",DET vs. PHI,L,27,1,4,0.25,0,2,0.0,0,0,0.0,0,3,3,0,1,0,0,1,2,-16,1,DET,DET,PHI,111,,,5,5,2,3
Isaiah Livers,F,22023,1630587,22300293,"DEC 11, 2023",DET vs. IND,L,17,2,5,0.4,2,5,0.4,2,2,1.0,0,2,2,3,2,0,0,1,8,6,1,DET,DET,IND,123,,,13,10,11,5
Isaiah Livers,F,22023,1630587,22301206,"DEC 06, 2023",DET vs. MEM,L,19,2,5,0.4,1,4,0.25,0,0,0.0,0,1,1,1,0,0,0,2,5,-17,1,DET,DET,MEM,102,,,7,6,6,2
Isaiah Livers,F,22023,1630587,22300253,"NOV 27, 2023",DET vs. WAS,L,23,3,11,0.273,2,8,0.25,0,0,0.0,0,1,1,3,1,0,2,1,8,-26,1,DET,DET,WAS,107,,,12,9,11,4
Stanley Umude,G,22023,1630649,22300268,"NOV 30, 2023",DET @ NYK,L,2,0,0,0.0,0,0,0.0,0,0,0.0,0,0,0,0,0,0,0,0,0,-3,1,DET,NYK,DET,112,,,0,0,0,0
Stanley Umude,G,22023,1630649,22300258,"NOV 29, 2023",DET vs. LAL,L,20,2,9,0.222,2,5,0.4,2,2,1.0,0,5,5,2,1,0,3,5,8,3,1,DET,DET,LAL,107,,,15,13,10,7
Stanley Umude,G,22023,1630649,22300047,"NOV 24, 2023",DET @ IND,L,8,0,1,0.0,0,0,0.0,0,0,0.0,1,1,2,0,1,2,1,3,0,-14,1,DET,IND,DET,113,,,2,2,0,2
Stanley Umude,G,22023,1630649,22300218,"NOV 20, 2023",DET vs. DEN,L,18,4,8,0.5,3,5,0.6,0,0,0.0,0,1,1,2,0,0,1,1,11,-2,1,DET,DET,DEN,103,,,14,12,13,3
Stanley Umude,G,22023,1630649,22300211,"NOV 19, 2023",DET @ TOR,L,25,5,6,0.833,2,3,0.667,7,8,0.875,0,4,4,3,0,1,1,2,19,-12,1,DET,TOR,DET,113,,,26,23,22,7
Stanley Umude,G,22023,1630649,22300030,"NOV 17, 2023",DET @ CLE,L,17,2,3,0.667,2,3,0.667,4,4,1.0,1,5,6,0,1,1,0,1,10,0,1,DET,CLE,DET,100,,,16,16,10,6
Stanley Umude,G,22023,1630649,22300008,"NOV 10, 2023",DET vs. PHI,L,17,1,2,0.5,1,2,0.5,7,8,0.875,0,4,4,1,0,0,0,2,10,-2,1,DET,DET,PHI,106,,,15,14,11,5
Stanley Umude,G,22023,1630649,22300165,"NOV 08, 2023",DET @ MIL,L,9,1,2,0.5,0,1,0.0,0,0,0.0,0,0,0,0,0,1,2,1,2,-2,1,DET,MIL,DET,118,,,2,2,2,0
Stanley Umude,G,22023,1630649,22300145,"NOV 06, 2023",DET vs. GSW,L,16,5,8,0.625,4,5,0.8,1,1,1.0,0,3,3,0,0,0,1,3,15,-10,1,DET,DET,GSW,109,,,18,18,15,3
Stanley Umude,G,22023,1630649,22300140,"NOV 05, 2023",DET vs. PHX,L,4,0,2,0.0,0,1,0.0,0,0,0.0,0,0,0,0,0,0,0,1,0,0,1,DET,DET,PHX,106,,,0,0,0,0
Stanley Umude,G,22023,1630649,22300129,"NOV 02, 2023",DET @ NOP,L,1,0,1,0.0,0,1,0.0,0,0,0.0,0,0,0,0,0,0,0,0,0,0,1,DET,NOP,DET,116,,,0,0,0,0
Stanley Umude,G,22023,1630649,22300115,"NOV 01, 2023",DET vs. POR,L,12,0,1,0.0,0,0,0.0,0,0,0.0,0,2,2,0,0,0,0,3,0,-8,1,DET,DET,POR,101,,,2,2,0,2
Stanley Umude,G,22023,1630649,22300109,"OCT 30, 2023",DET @ OKC,L,2,0,0,0.0,0,0,0.0,0,0,0.0,0,0,0,0,1,0,0,0,0,8,1,DET,OKC,DET,112,,,0,0,0,0
Stanley Umude,G,22023,1630649,22300088,"OCT 28, 2023",DET vs. CHI,W,1,0,0,0.0,0,0,0.0,0,0,0.0,0,0,0,0,0,0,0,0,0,-3,1,DET,DET,CHI,118,,,0,0,0,0
Stanley Umude,G,22023,1630649,22300749,"FEB 10, 2024",DET @ LAC,L,6,0,0,0.0,0,0,0.0,0,0,0.0,1,0,1,1,0,0,0,0,0,8,1,DET,LAC,DET,106,,,2,1,1,2
Stanley Umude,G,22023,1630649,22300253,"NOV 27, 2023",DET vs. WAS,L,2,0,1,0.0,0,1,0.0,0,0,0.0,1,0,1,0,0,0,1,2,0,-1,1,DET,DET,WAS,107,,,1,1,0,1
Stanley Umude,G,22023,1630649,22300741,"FEB 08, 2024",DET @ POR,W,29,5,8,0.625,3,4,0.75,1,1,1.0,0,2,2,0,0,0,1,4,14,-3,1,DET,POR,DET,128,,,16,16,14,2
Bryce McGowens,G,22023,1631121,22300745,"FEB 09, 2024",CHA @ MIL,L,30,5,10,0.5,2,5,0.4,3,4,0.75,0,5,5,0,1,0,1,5,15,-19,1,CHA,MIL,CHA,80,,,20,20,15,5
Bryce McGowens,G,22023,1631121,22300335,"DEC 16, 2023",CHA vs. PHI,L,24,5,10,0.5,0,2,0.0,2,3,0.667,0,2,2,0,0,0,0,1,12,-17,1,CHA,CHA,PHI,80,,,14,14,12,2
Bryce McGowens,G,22023,1631121,22300177,"NOV 12, 2023",CHA @ NYK,L,19,1,4,0.25,0,2,0.0,0,0,0.0,0,0,0,0,0,0,0,0,2,-6,1,CHA,NYK,CHA,107,,,2,2,2,0
Bryce McGowens,G,22023,1631121,22300635,"JAN 26, 2024",CHA vs. HOU,L,7,3,5,0.6,0,1,0.0,2,2,1.0,0,1,1,0,0,0,0,1,8,3,1,CHA,CHA,HOU,104,,,9,9,8,1
Bryce McGowens,G,22023,1631121,22300610,"JAN 22, 2024",CHA @ MIN,W,6,1,1,1.0,0,0,0.0,0,0,0.0,0,0,0,1,0,0,0,0,2,-12,1,CHA,MIN,CHA,126,,,3,2,3,1
Bryce McGowens,G,22023,1631121,22300551,"JAN 14, 2024",CHA @ MIA,L,5,1,2,0.5,0,1,0.0,0,0,0.0,1,1,2,0,0,0,0,0,2,1,1,CHA,MIA,CHA,85,,,4,4,2,2
Bryce McGowens,G,22023,1631121,22300541,"JAN 12, 2024",CHA @ SAS,L,24,5,7,0.714,1,2,0.5,1,1,1.0,0,0,0,0,1,0,4,1,12,-18,1,CHA,SAS,CHA,99,,,12,12,12,0
Bryce McGowens,G,22023,1631121,22300248,"NOV 26, 2023",CHA @ ORL,L,6,0,0,0.0,0,0,0.0,0,0,0.0,1,1,2,1,1,0,1,2,0,1,1,CHA,ORL,CHA,117,,,3,2,1,3
Bryce McGowens,G,22023,1631121,22300225,"NOV 22, 2023",CHA vs. WAS,W,23,4,5,0.8,3,4,0.75,2,2,1.0,1,2,3,0,1,1,1,1,13,11,1,CHA,CHA,WAS,117,,,16,16,13,3
Bryce McGowens,G,22023,1631121,22300217,"NOV 20, 2023",CHA vs. BOS,W,14,1,6,0.167,1,6,0.167,0,0,0.0,0,2,2,2,0,0,1,1,3,-17,1,CHA,CHA,BOS,121,,,7,5,5,4
Bryce McGowens,G,22023,1631121,22300202,"NOV 18, 2023",CHA vs. NYK,L,16,0,2,0.0,0,1,0.0,0,0,0.0,1,1,2,1,0,0,0,2,0,4,1,CHA,CHA,NYK,108,,,3,2,1,3
Bryce McGowens,G,22023,1631121,22300027,"NOV 17, 2023",CHA vs. MIL,L,10,1,3,0.333,1,2,0.5,2,2,1.0,0,0,0,1,0,0,0,0,5,-8,1,CHA,CHA,MIL,99,,,6,5,6,1
Bryce McGowens,G,22023,1631121,22300017,"NOV 14, 2023",CHA vs. MIA,L,29,4,7,0.571,3,5,0.6,1,2,0.5,0,4,4,1,1,0,1,4,12,-3,1,CHA,CHA,MIA,105,,,17,16,13,5
Bryce McGowens,G,22023,1631121,22300009,"NOV 10, 2023",CHA @ WAS,W,13,1,2,0.5,0,1,0.0,0,0,0.0,0,2,2,1,0,0,1,3,2,-8,1,CHA,WAS,CHA,124,,,5,4,3,3
Bryce McGowens,G,22023,1631121,22300157,"NOV 08, 2023",CHA vs. WAS,L,15,0,0,0.0,0,0,0.0,2,2,1.0,0,3,3,1,0,0,2,2,2,-1,1,CHA,CHA,WAS,116,,,6,5,3,4
Bryce McGowens,G,22023,1631121,22300143,"NOV 05, 2023",CHA @ DAL,L,10,0,1,0.0,0,1,0.0,1,2,0.5,0,2,2,0,2,0,0,0,1,1,1,CHA,DAL,CHA,118,,,3,3,1,2
Bryce McGowens,G,22023,1631121,22300726,"FEB 07, 2024",CHA vs. TOR,L,15,4,7,0.571,2,5,0.4,0,0,0.0,1,3,4,1,0,0,0,2,10,6,1,CHA,CHA,TOR,117,,,15,14,11,5
Bryce McGowens,G,22023,1631121,22300713,"FEB 05, 2024",CHA vs. LAL,L,24,4,7,0.571,1,1,1.0,1,2,0.5,1,3,4,1,2,0,2,3,10,-5,1,CHA,CHA,LAL,118,,,15,14,11,5
Bryce McGowens,G,22023,1631121,22300707,"FEB 04, 2024",CHA vs. IND,L,16,0,2,0.0,0,1,0.0,4,4,1.0,0,1,1,1,0,0,0,0,4,-12,1,CHA,CHA,IND,99,,,6,5,5,2
Bryce McGowens,G,22023,1631121,22300695,"FEB 02, 2024",CHA @ OKC,L,25,6,10,0.6,0,3,0.0,3,4,0.75,1,2,3,3,4,1,2,5,15,-7,1,CHA,OKC,CHA,106,,,21,18,18,6
Bryce McGowens,G,22023,1631121,22300674,"JAN 31, 2024",CHA vs. CHI,L,13,1,4,0.25,0,2,0.0,3,4,0.75,0,2,2,2,0,0,0,0,5,-9,1,CHA,CHA,CHI,110,,,9,7,7,4
Bryce McGowens,G,22023,1631121,22300657,"JAN 29, 2024",CHA vs. NYK,L,2,0,1,0.0,0,0,0.0,0,0,0.0,0,1,1,0,0,0,0,0,0,-3,1,CHA,CHA,NYK,92,,,1,1,0,1
Bryce McGowens,G,22023,1631121,22300518,"JAN 10, 2024",CHA vs. SAC,L,10,1,2,0.5,1,2,0.5,1,2,0.5,0,2,2,1,0,0,1,0,4,-2,1,CHA,CHA,SAC,96,,,7,6,5,3
Bryce McGowens,G,22023,1631121,22300365,"DEC 20, 2023",CHA @ IND,L,21,1,2,0.5,0,1,0.0,0,0,0.0,0,0,0,1,0,0,2,5,2,1,1,CHA,IND,CHA,109,,,3,2,3,1
Bryce McGowens,G,22023,1631121,22300354,"DEC 18, 2023",CHA @ TOR,L,32,4,9,0.444,2,5,0.4,4,4,1.0,0,5,5,1,1,1,2,1,14,-3,1,CHA,TOR,CHA,99,,,20,19,15,6
Bryce McGowens,G,22023,1631121,22300057,"NOV 28, 2023",CHA @ NYK,L,13,2,5,0.4,1,2,0.5,0,0,0.0,1,1,2,0,1,0,0,1,5,-12,1,CHA,NYK,CHA,91,,,7,7,5,2
Bryce McGowens,G,22023,1631121,22300506,"JAN 08, 2024",CHA vs. CHI,L,24,1,7,0.143,1,5,0.2,0,0,0.0,0,1,1,2,0,0,0,1,3,-6,1,CHA,CHA,CHI,109,,,6,4,5,3
Bryce McGowens,G,22023,1631121,22300455,"JAN 01, 2024",CHA @ DEN,L,23,4,8,0.5,2,3,0.667,0,0,0.0,0,2,2,3,0,0,0,4,10,-16,1,CHA,DEN,CHA,91,,,15,12,13,5
Bryce McGowens,G,22023,1631121,22300428,"DEC 28, 2023",CHA @ LAL,L,22,3,6,0.5,3,4,0.75,1,2,0.5,0,2,2,1,0,0,1,3,10,1,1,CHA,LAL,CHA,110,,,13,12,11,3
Bryce McGowens,G,22023,1631121,22300593,"JAN 20, 2024",CHA vs. PHI,L,2,0,0,0.0,0,0,0.0,0,0,0.0,0,0,0,0,0,0,0,0,0,5,1,CHA,CHA,PHI,89,,,0,0,0,0
Bryce McGowens,G,22023,1631121,22300484,"JAN 05, 2024",CHA @ CHI,L,5,0,4,0.0,0,1,0.0,0,0,0.0,2,0,2,0,0,0,1,0,0,-2,1,CHA,CHI,CHA,87,,,2,2,0,2
Bryce McGowens,G,22023,1631121,22300464,"JAN 02, 2024",CHA @ SAC,W,21,1,3,0.333,0,2,0.0,2,3,0.667,1,1,2,2,0,0,0,1,4,1,1,CHA,SAC,CHA,111,,,8,6,6,4
Bryce McGowens,G,22023,1631121,22300436,"DEC 29, 2023",CHA @ PHX,L,21,2,4,0.5,0,1,0.0,0,0,0.0,0,1,1,3,0,0,0,1,4,-2,1,CHA,PHX,CHA,119,,,8,5,7,4
Bryce McGowens,G,22023,1631121,22300414,"DEC 26, 2023",CHA @ LAC,L,22,4,6,0.667,0,1,0.0,2,3,0.667,0,3,3,2,0,0,0,3,10,-10,1,CHA,LAC,CHA,104,,,15,13,12,5
Bryce McGowens,G,22023,1631121,22300390,"DEC 23, 2023",CHA vs. DEN,L,18,0,4,0.0,0,0,0.0,0,0,0.0,2,1,3,0,0,0,0,1,0,-4,1,CHA,CHA,DEN,95,,,3,3,0,3
Bryce McGowens,G,22023,1631121,22300326,"DEC 15, 2023",CHA vs. NOP,L,21,2,5,0.4,0,2,0.0,3,5,0.6,1,1,2,0,1,0,0,2,7,-14,1,CHA,CHA,NOP,105,,,9,9,7,2
Bryce McGowens,G,22023,1631121,22300312,"DEC 13, 2023",CHA @ MIA,L,18,2,4,0.5,1,2,0.5,2,2,1.0,1,2,3,1,0,0,0,2,7,-9,1,CHA,MIA,CHA,104,,,11,10,8,4
Bryce McGowens,G,22023,1631121,22300292,"DEC 11, 2023",CHA vs. MIA,L,23,1,4,0.25,0,2,0.0,1,2,0.5,0,1,1,1,0,0,1,2,3,9,1,CHA,CHA,MIA,114,,,5,4,4,2
Bryce McGowens,G,22023,1631121,22301216,"DEC 08, 2023",CHA vs. TOR,W,7,0,0,0.0,0,0,0.0,0,0,0.0,0,0,0,0,0,0,0,0,0,-2,1,CHA,CHA,TOR,119,,,0,0,0,0
Bryce McGowens,G,22023,1631121,22301211,"DEC 06, 2023",CHA @ CHI,L,16,2,2,1.0,1,1,1.0,0,0,0.0,0,1,1,1,0,0,1,3,5,-10,1,CHA,CHI,CHA,100,,,7,6,6,2
Bryce McGowens,G,22023,1631121,22300281,"DEC 02, 2023",CHA vs. MIN,L,16,1,3,0.333,0,0,0.0,0,0,0.0,0,1,1,1,0,0,0,1,2,5,1,CHA,CHA,MIN,117,,,4,3,3,2
Bryce McGowens,G,22023,1631121,22300266,"NOV 30, 2023",CHA @ BKN,W,22,5,7,0.714,4,5,0.8,0,0,0.0,0,2,2,3,0,1,0,1,14,-6,1,CHA,BKN,CHA,129,,,19,16,17,5
Caleb Houstan,G,22023,1631216,22300734,"FEB 08, 2024",ORL vs. SAS,W,3,1,1,1.0,1,1,1.0,0,0,0.0,0,0,0,0,0,0,0,0,3,-3,1,ORL,ORL,SAS,127,,,3,3,3,0
Caleb Houstan,G,22023,1631216,22300721,"FEB 06, 2024",ORL @ MIA,L,3,0,1,0.0,0,1,0.0,0,0,0.0,0,0,0,0,0,0,0,0,0,-2,1,ORL,MIA,ORL,95,,,0,0,0,0
Caleb Houstan,G,22023,1631216,22300655,"JAN 28, 2024",ORL vs. PHX,W,2,1,1,1.0,1,1,1.0,0,0,0.0,0,0,0,0,0,0,0,0,3,1,1,ORL,ORL,PHX,113,,,3,3,3,0
Caleb Houstan,G,22023,1631216,22300607,"JAN 22, 2024",ORL vs. CLE,L,24,2,3,0.667,2,3,0.667,0,0,0.0,0,2,2,0,0,0,1,2,6,0,1,ORL,ORL,CLE,99,,,8,8,6,2
Caleb Houstan,G,22023,1631216,22300601,"JAN 21, 2024",ORL vs. MIA,W,8,0,0,0.0,0,0,0.0,0,0,0.0,0,0,0,1,0,0,0,0,0,-4,1,ORL,ORL,MIA,105,,,1,0,1,1
Caleb Houstan,G,22023,1631216,22300585,"JAN 19, 2024",ORL vs. PHI,L,15,0,3,0.0,0,2,0.0,0,0,0.0,2,0,2,0,0,0,1,0,0,3,1,ORL,ORL,PHI,109,,,2,2,0,2
Caleb Houstan,G,22023,1631216,22300570,"JAN 17, 2024",ORL @ ATL,L,14,1,7,0.143,1,7,0.143,0,1,0.0,1,0,1,0,1,0,0,3,3,6,1,ORL,ATL,ORL,104,,,4,4,3,1
Caleb Houstan,G,22023,1631216,22300557,"JAN 15, 2024",ORL @ NYK,W,21,1,7,0.143,1,7,0.143,4,5,0.8,1,0,1,0,0,0,0,4,7,-11,1,ORL,NYK,ORL,98,,,8,8,7,1
Caleb Houstan,G,22023,1631216,22300546,"JAN 13, 2024",ORL @ OKC,L,35,5,13,0.385,4,12,0.333,0,0,0.0,1,2,3,2,1,0,3,0,14,-13,1,ORL,OKC,ORL,100,,,19,17,16,5
Caleb Houstan,G,22023,1631216,22300535,"JAN 12, 2024",ORL @ MIA,L,32,3,9,0.333,3,9,0.333,0,0,0.0,1,1,2,3,0,0,0,4,9,2,1,ORL,MIA,ORL,96,,,14,11,12,5
Caleb Houstan,G,22023,1631216,22300513,"JAN 09, 2024",ORL vs. MIN,L,34,3,12,0.25,2,10,0.2,0,0,0.0,3,4,7,2,0,0,0,2,8,-18,1,ORL,ORL,MIN,92,,,17,15,10,9
Caleb Houstan,G,22023,1631216,22300499,"JAN 07, 2024",ORL vs. ATL,W,36,8,15,0.533,7,14,0.5,2,3,0.667,1,1,2,4,1,0,0,2,25,13,1,ORL,ORL,ATL,117,,,31,27,29,6
Caleb Houstan,G,22023,1631216,22300488,"JAN 05, 2024",ORL @ DEN,W,24,3,6,0.5,2,5,0.4,0,2,0.0,0,0,0,1,0,0,0,3,8,2,1,ORL,DEN,ORL,122,,,9,8,9,1
Caleb Houstan,G,22023,1631216,22300463,"JAN 02, 2024",ORL @ GSW,L,8,2,3,0.667,2,3,0.667,0,0,0.0,0,1,1,0,0,0,0,1,6,-6,1,ORL,GSW,ORL,115,,,7,7,6,1
Caleb Houstan,G,22023,1631216,22300450,"DEC 31, 2023",ORL @ PHX,L,7,0,0,0.0,0,0,0.0,0,0,0.0,0,0,0,0,0,0,0,0,0,8,1,ORL,PHX,ORL,107,,,0,0,0,0
Caleb Houstan,G,22023,1631216,22300429,"DEC 29, 2023",ORL vs. NYK,W,21,0,5,0.0,0,5,0.0,0,0,0.0,2,0,2,0,0,0,1,1,0,-3,1,ORL,ORL,NYK,117,,,2,2,0,2
Caleb Houstan,G,22023,1631216,22300415,"DEC 27, 2023",ORL vs. PHI,L,26,2,4,0.5,2,4,0.5,1,1,1.0,2,4,6,2,0,0,2,2,7,-10,1,ORL,ORL,PHI,92,,,15,13,9,8
Caleb Houstan,G,22023,1631216,22300407,"DEC 26, 2023",ORL @ WAS,W,12,0,0,0.0,0,0,0.0,0,0,0.0,0,1,1,0,0,0,0,0,0,0,1,ORL,WAS,ORL,127,,,1,1,0,1
Caleb Houstan,G,22023,1631216,22300391,"DEC 23, 2023",ORL @ IND,W,21,2,4,0.5,2,4,0.5,0,0,0.0,1,2,3,0,1,0,1,3,6,17,1,ORL,IND,ORL,117,,,9,9,6,3
Caleb Houstan,G,22023,1631216,22300378,"DEC 21, 2023",ORL @ MIL,L,18,0,3,0.0,0,3,0.0,0,0,0.0,0,1,1,0,0,1,0,2,0,10,1,ORL,MIL,ORL,114,,,1,1,0,1
Caleb Houstan,G,22023,1631216,22300366,"DEC 20, 2023",ORL vs. MIA,L,15,3,10,0.3,3,10,0.3,0,0,0.0,0,0,0,0,0,0,0,0,9,4,1,ORL,ORL,MIA,106,,,9,9,9,0
Caleb Houstan,G,22023,1631216,22300344,"DEC 17, 2023",ORL @ BOS,L,16,2,4,0.5,1,3,0.333,3,3,1.0,2,1,3,0,0,0,0,2,8,-11,1,ORL,BOS,ORL,97,,,11,11,8,3
Caleb Houstan,G,22023,1631216,22300329,"DEC 15, 2023",ORL @ BOS,L,11,2,5,0.4,1,4,0.25,0,0,0.0,1,1,2,1,0,0,0,0,5,-6,1,ORL,BOS,ORL,111,,,8,7,6,3
Caleb Houstan,G,22023,1631216,22301217,"DEC 08, 2023",ORL vs. DET,W,25,2,6,0.333,2,6,0.333,0,0,0.0,0,4,4,1,0,0,0,1,6,9,1,ORL,ORL,DET,123,,,11,10,7,5
Caleb Houstan,G,22023,1631216,22301205,"DEC 06, 2023",ORL @ CLE,L,11,0,2,0.0,0,1,0.0,0,0,0.0,1,2,3,0,0,0,0,1,0,-13,1,ORL,CLE,ORL,111,,,3,3,0,3
Caleb Houstan,G,22023,1631216,22300282,"DEC 02, 2023",ORL @ BKN,L,16,1,3,0.333,1,3,0.333,0,0,0.0,0,0,0,0,0,0,0,1,3,-13,1,ORL,BKN,ORL,101,,,3,3,3,0
Caleb Houstan,G,22023,1631216,22300259,"NOV 29, 2023",ORL vs. WAS,W,10,3,3,1.0,3,3,1.0,0,0,0.0,0,3,3,1,0,0,1,3,9,-4,1,ORL,ORL,WAS,139,,,13,12,10,4
Caleb Houstan,G,22023,1631216,22300248,"NOV 26, 2023",ORL vs. CHA,W,12,1,2,0.5,1,2,0.5,3,3,1.0,1,1,2,0,0,0,0,2,6,17,1,ORL,ORL,CHA,130,,,8,8,6,2
Caleb Houstan,G,22023,1631216,22300043,"NOV 24, 2023",ORL vs. BOS,W,9,0,0,0.0,0,0,0.0,0,0,0.0,1,1,2,0,1,0,0,0,0,15,1,ORL,ORL,BOS,113,,,2,2,0,2
Caleb Houstan,G,22023,1631216,22300038,"NOV 21, 2023",ORL vs. TOR,W,4,0,1,0.0,0,1,0.0,0,0,0.0,0,1,1,1,1,0,0,0,0,-4,1,ORL,ORL,TOR,126,,,2,1,1,2
Caleb Houstan,G,22023,1631216,22300209,"NOV 19, 2023",ORL @ IND,W,8,0,1,0.0,0,1,0.0,0,0,0.0,0,0,0,2,0,0,2,1,0,-18,1,ORL,IND,ORL,128,,,2,0,2,2
Caleb Houstan,G,22023,1631216,22300033,"NOV 17, 2023",ORL @ CHI,W,6,1,1,1.0,1,1,1.0,0,0,0.0,0,2,2,0,0,0,0,0,3,0,1,ORL,CHI,ORL,103,,,5,5,3,2
Caleb Houstan,G,22023,1631216,22300020,"NOV 14, 2023",ORL @ BKN,L,5,1,1,1.0,1,1,1.0,0,0,0.0,0,0,0,0,0,0,0,1,3,-8,1,ORL,BKN,ORL,104,,,3,3,3,0
Caleb Houstan,G,22023,1631216,22300147,"NOV 06, 2023",ORL vs. DAL,L,14,1,2,0.5,1,2,0.5,0,0,0.0,0,1,1,0,0,0,0,1,3,-2,1,ORL,ORL,DAL,102,,,4,4,3,1
Caleb Houstan,G,22023,1631216,22300134,"NOV 04, 2023",ORL vs. LAL,W,3,0,0,0.0,0,0,0.0,0,0,0.0,0,1,1,1,0,0,0,0,0,3,1,ORL,ORL,LAL,120,,,2,1,1,2
Caleb Houstan,G,22023,1631216,22300114,"OCT 31, 2023",ORL @ LAC,L,4,2,5,0.4,1,4,0.25,1,1,1.0,0,0,0,0,0,0,0,0,6,-1,1,ORL,LAC,ORL,102,,,6,6,6,0
Caleb Houstan,G,22023,1631216,22300066,"OCT 25, 2023",ORL vs. HOU,W,5,1,2,0.5,1,2,0.5,0,0,0.0,0,1,1,0,0,0,0,0,3,9,1,ORL,ORL,HOU,116,,,4,4,3,1
Caleb Houstan,G,22023,1631216,22300476,"JAN 03, 2024",ORL @ SAC,L,31,4,6,0.667,4,6,0.667,3,3,1.0,0,2,2,1,4,0,1,2,15,6,1,ORL,SAC,ORL,135,,,18,17,16,3
Thaddeus Young,F,22023,201152,22300416,"DEC 27, 2023",TOR @ WAS,W,5,1,1,1.0,0,0,0.0,1,1,1.0,1,2,3,3,0,0,1,0,3,4,1,TOR,WAS,TOR,132,,,9,6,6,6
Thaddeus Young,F,22023,201152,22300330,"DEC 15, 2023",TOR vs. ATL,L,3,0,0,0.0,0,0,0.0,0,0,0.0,0,0,0,0,0,0,0,0,0,1,1,TOR,TOR,ATL,104,,,0,0,0,0
Thaddeus Young,F,22023,201152,22300195,"NOV 15, 2023",TOR vs. MIL,L,4,0,1,0.0,0,0,0.0,0,0,0.0,0,1,1,0,0,0,1,0,0,4,1,TOR,TOR,MIL,112,,,1,1,0,1
Thaddeus Young,F,22023,201152,22300174,"NOV 11, 2023",TOR @ BOS,L,4,2,3,0.667,0,0,0.0,0,0,0.0,1,0,1,2,0,0,0,0,4,6,1,TOR,BOS,TOR,94,,,7,5,6,3
Thaddeus Young,F,22023,201152,22300128,"NOV 02, 2023",TOR @ PHI,L,2,0,0,0.0,0,0,0.0,0,2,0.0,0,1,1,1,0,0,0,0,0,1,1,TOR,PHI,TOR,99,,,2,1,1,2
Thaddeus Young,F,22023,201152,22300726,"FEB 07, 2024",TOR @ CHA,W,15,2,3,0.667,0,0,0.0,0,0,0.0,3,5,8,2,1,0,1,2,4,0,1,TOR,CHA,TOR,123,,,14,12,6,10
Thaddeus Young,F,22023,201152,22300718,"FEB 05, 2024",TOR @ NOP,L,15,1,1,1.0,0,0,0.0,1,2,0.5,1,1,2,0,0,0,0,0,3,-13,1,TOR,NOP,TOR,100,,,5,5,3,2
Thaddeus Young,F,22023,201152,22300710,"FEB 04, 2024",TOR @ OKC,L,19,3,4,0.75,0,1,0.0,0,0,0.0,1,4,5,4,1,1,0,1,6,2,1,TOR,OKC,TOR,127,,,15,11,10,9
Thaddeus Young,F,22023,201152,22300692,"FEB 02, 2024",TOR @ HOU,L,25,4,4,1.0,0,0,0.0,0,1,0.0,1,3,4,1,0,0,2,2,8,-10,1,TOR,HOU,TOR,106,,,13,12,9,5
Thaddeus Young,F,22023,201152,22300672,"JAN 30, 2024",TOR @ CHI,W,32,8,13,0.615,0,1,0.0,0,0,0.0,4,2,6,6,0,0,1,5,16,15,1,TOR,CHI,TOR,118,,,28,22,22,12
Thaddeus Young,F,22023,201152,22300653,"JAN 28, 2024",TOR @ ATL,L,22,2,3,0.667,0,0,0.0,0,0,0.0,1,3,4,1,0,0,0,2,4,-18,1,TOR,ATL,TOR,113,,,9,8,5,5
Thaddeus Young,F,22023,201152,22300637,"JAN 26, 2024",TOR vs. LAC,L,24,6,6,1.0,0,0,0.0,0,2,0.0,4,2,6,4,1,1,0,3,12,-15,1,TOR,TOR,LAC,107,,,22,18,16,10
Thaddeus Young,F,22023,201152,22300609,"JAN 22, 2024",TOR vs. MEM,L,26,5,8,0.625,0,0,0.0,2,2,1.0,2,4,6,4,3,0,0,1,12,0,1,TOR,TOR,MEM,100,,,22,18,16,10
Thaddeus Young,F,22023,201152,22300596,"JAN 20, 2024",TOR @ NYK,L,15,2,4,0.5,0,0,0.0,0,0,0.0,1,1,2,1,2,0,0,2,4,-11,1,TOR,NYK,TOR,94,,,7,6,5,3
Thaddeus Young,F,22023,201152,22300580,"JAN 18, 2024",TOR vs. CHI,L,15,3,4,0.75,0,0,0.0,0,0,0.0,1,1,2,2,0,0,0,2,6,-19,1,TOR,TOR,CHI,100,,,10,8,8,4
Thaddeus Young,F,22023,201152,22300574,"JAN 17, 2024",TOR vs. MIA,W,28,2,6,0.333,0,0,0.0,1,2,0.5,2,6,8,2,1,0,0,3,5,21,1,TOR,TOR,MIA,115,,,15,13,7,10
Thaddeus Young,F,22023,201152,22300563,"JAN 15, 2024",TOR vs. BOS,L,16,0,4,0.0,0,1,0.0,0,0,0.0,2,2,4,7,2,0,0,2,0,6,1,TOR,TOR,BOS,94,,,11,4,7,11
Thaddeus Young,F,22023,201152,22300540,"JAN 12, 2024",TOR @ UTA,L,12,0,1,0.0,0,0,0.0,0,0,0.0,0,2,2,2,0,0,0,5,0,2,1,TOR,UTA,TOR,104,,,4,2,2,4
Thaddeus Young,F,22023,201152,22300526,"JAN 10, 2024",TOR @ LAC,L,23,4,5,0.8,0,1,0.0,0,0,0.0,2,2,4,3,2,0,2,1,8,-2,1,TOR,LAC,TOR,111,,,15,12,11,7
Thaddeus Young,F,22023,201152,22300516,"JAN 09, 2024",TOR @ LAL,L,29,5,9,0.556,0,1,0.0,0,0,0.0,1,4,5,4,3,1,0,4,10,7,1,TOR,LAL,TOR,131,,,19,15,14,9
Thaddeus Young,F,22023,201152,22300504,"JAN 07, 2024",TOR @ GSW,W,4,1,2,0.5,1,1,1.0,0,0,0.0,0,0,0,0,0,0,1,0,3,-5,1,TOR,GSW,TOR,131,,,3,3,3,0
Thaddeus Young,F,22023,201152,22300452,"JAN 01, 2024",TOR vs. CLE,W,2,0,0,0.0,0,0,0.0,0,0,0.0,0,0,0,0,0,0,0,0,0,4,1,TOR,TOR,CLE,124,,,0,0,0,0
Thaddeus Young,F,22023,201152,22300440,"DEC 30, 2023",TOR @ DET,L,11,3,5,0.6,0,0,0.0,0,0,0.0,1,0,1,1,2,0,2,3,6,-9,1,TOR,DET,TOR,127,,,8,7,7,2
Miles McBride,G,22023,1630540,22300755,"FEB 10, 2024",NYK vs. IND,L,11,2,4,0.5,0,2,0.0,2,2,1.0,1,1,2,0,1,0,0,0,6,-7,1,NYK,NYK,IND,111,,,8,8,6,2
Miles McBride,G,22023,1630540,22300736,"FEB 08, 2024",NYK vs. DAL,L,45,9,22,0.409,2,10,0.2,1,1,1.0,4,2,6,5,2,0,2,1,21,-11,1,NYK,NYK,DAL,108,,,32,27,26,11
Miles McBride,G,22023,1630540,22300722,"FEB 06, 2024",NYK vs. MEM,W,31,5,14,0.357,2,6,0.333,0,0,0.0,1,2,3,3,2,0,0,4,12,0,1,NYK,NYK,MEM,121,,,18,15,15,6
Miles McBride,G,22023,1630540,22300701,"FEB 03, 2024",NYK vs. LAL,L,20,3,8,0.375,1,4,0.25,3,4,0.75,0,2,2,1,0,0,1,2,10,-3,1,NYK,NYK,LAL,105,,,13,12,11,3
Miles McBride,G,22023,1630540,22300685,"FEB 01, 2024",NYK vs. IND,W,29,6,13,0.462,3,8,0.375,1,1,1.0,0,1,1,0,2,0,1,1,16,10,1,NYK,NYK,IND,109,,,17,17,16,1
Miles McBride,G,22023,1630540,22300671,"JAN 30, 2024",NYK vs. UTA,W,10,0,4,0.0,0,1,0.0,0,0,0.0,0,0,0,1,0,0,0,1,0,-4,1,NYK,NYK,UTA,118,,,1,0,1,1
Miles McBride,G,22023,1630540,22300657,"JAN 29, 2024",NYK @ CHA,W,15,4,7,0.571,3,6,0.5,0,0,0.0,0,0,0,1,1,0,1,3,11,-2,1,NYK,CHA,NYK,113,,,12,11,12,1
Miles McBride,G,22023,1630540,22300643,"JAN 27, 2024",NYK vs. MIA,W,10,3,4,0.75,1,2,0.5,2,2,1.0,0,1,1,0,0,0,0,1,9,-8,1,NYK,NYK,MIA,125,,,10,10,9,1
Miles McBride,G,22023,1630540,22300631,"JAN 25, 2024",NYK vs. DEN,W,21,4,9,0.444,4,5,0.8,1,2,0.5,0,1,1,1,2,0,0,2,13,14,1,NYK,NYK,DEN,122,,,15,14,14,2
Miles McBride,G,22023,1630540,22300615,"JAN 23, 2024",NYK @ BKN,W,12,3,5,0.6,2,3,0.667,0,0,0.0,0,1,1,2,0,1,0,1,8,-2,1,NYK,BKN,NYK,108,,,11,9,10,3
Miles McBride,G,22023,1630540,22300596,"JAN 20, 2024",NYK vs. TOR,W,13,1,4,0.25,1,3,0.333,0,0,0.0,0,0,0,1,0,0,2,1,3,4,1,NYK,NYK,TOR,126,,,4,3,4,1
Miles McBride,G,22023,1630540,22300579,"JAN 18, 2024",NYK vs. WAS,W,8,1,3,0.333,0,1,0.0,3,3,1.0,0,1,1,0,1,0,0,1,5,-6,1,NYK,NYK,WAS,113,,,6,6,5,1
Miles McBride,G,22023,1630540,22300573,"JAN 17, 2024",NYK vs. HOU,W,11,0,4,0.0,0,3,0.0,0,0,0.0,0,1,1,1,0,0,1,1,0,3,1,NYK,NYK,HOU,109,,,2,1,1,2
Miles McBride,G,22023,1630540,22300557,"JAN 15, 2024",NYK vs. ORL,L,36,8,17,0.471,4,10,0.4,0,0,0.0,0,2,2,1,2,1,1,4,20,3,1,NYK,NYK,ORL,94,,,23,22,21,3
Miles McBride,G,22023,1630540,22300544,"JAN 13, 2024",NYK @ MEM,W,38,7,10,0.7,4,7,0.571,1,2,0.5,0,6,6,5,1,1,3,3,19,13,1,NYK,MEM,NYK,106,,,30,25,24,11
Miles McBride,G,22023,1630540,22300530,"JAN 11, 2024",NYK @ DAL,L,9,2,5,0.4,1,4,0.25,0,0,0.0,1,1,2,1,0,0,0,2,5,-12,1,NYK,DAL,NYK,124,,,8,7,6,3
Miles McBride,G,22023,1630540,22300514,"JAN 09, 2024",NYK vs. POR,W,22,6,13,0.462,4,7,0.571,0,0,0.0,1,1,2,0,1,0,2,1,16,-1,1,NYK,NYK,POR,112,,,18,18,16,2
Miles McBride,G,22023,1630540,22300494,"JAN 06, 2024",NYK @ WAS,W,13,2,6,0.333,1,2,0.5,0,0,0.0,1,0,1,5,1,0,0,2,5,-4,1,NYK,WAS,NYK,121,,,11,6,10,6
Miles McBride,G,22023,1630540,22300483,"JAN 05, 2024",NYK @ PHI,W,15,4,8,0.5,4,6,0.667,3,3,1.0,0,1,1,4,0,0,0,1,15,20,1,NYK,PHI,NYK,128,,,20,16,19,5
Miles McBride,G,22023,1630540,22300468,"JAN 03, 2024",NYK vs. CHI,W,10,1,3,0.333,1,2,0.5,0,0,0.0,0,0,0,0,0,0,0,1,3,-15,1,NYK,NYK,CHI,116,,,3,3,3,0
Miles McBride,G,22023,1630540,22300451,"JAN 01, 2024",NYK vs. MIN,W,7,0,3,0.0,0,1,0.0,0,0,0.0,0,0,0,0,0,0,1,0,0,-10,1,NYK,NYK,MIN,112,,,0,0,0,0
Miles McBride,G,22023,1630540,22300441,"DEC 30, 2023",NYK @ IND,L,18,2,3,0.667,1,2,0.5,0,0,0.0,0,0,0,1,0,0,0,3,5,7,1,NYK,IND,NYK,124,,,6,5,6,1
Miles McBride,G,22023,1630540,22300388,"DEC 23, 2023",NYK vs. MIL,L,1,0,0,0.0,0,0,0.0,0,0,0.0,0,1,1,0,0,0,0,0,0,-3,1,NYK,NYK,MIL,109,,,1,1,0,1
Miles McBride,G,22023,1630540,22300368,"DEC 20, 2023",NYK @ BKN,W,2,0,1,0.0,0,1,0.0,0,0,0.0,0,0,0,0,0,0,0,0,0,-4,1,NYK,BKN,NYK,119,,,0,0,0,0
Miles McBride,G,22023,1630540,22300343,"DEC 16, 2023",NYK @ LAC,L,11,2,4,0.5,0,0,0.0,0,0,0.0,0,1,1,2,2,0,0,2,4,-4,1,NYK,LAC,NYK,120,,,7,5,6,3
Miles McBride,G,22023,1630540,22300333,"DEC 15, 2023",NYK @ PHX,W,1,1,1,1.0,1,1,1.0,0,0,0.0,0,0,0,0,0,0,0,0,3,-1,1,NYK,PHX,NYK,139,,,3,3,3,0
Miles McBride,G,22023,1630540,22301201,"DEC 05, 2023",NYK @ MIL,L,2,1,1,1.0,1,1,1.0,0,0,0.0,0,0,0,0,0,0,0,0,3,-4,1,NYK,MIL,NYK,122,,,3,3,3,0
Miles McBride,G,22023,1630540,22300221,"NOV 20, 2023",NYK @ MIN,L,3,0,0,0.0,0,0,0.0,0,0,0.0,0,0,0,0,0,0,0,0,0,0,1,NYK,MIN,NYK,100,,,0,0,0,0
Miles McBride,G,22023,1630540,22300028,"NOV 17, 2023",NYK @ WAS,W,14,2,3,0.667,1,2,0.5,0,0,0.0,1,0,1,0,1,0,0,2,5,3,1,NYK,WAS,NYK,120,,,6,6,5,1
Miles McBride,G,22023,1630540,22300177,"NOV 12, 2023",NYK vs. CHA,W,3,1,2,0.5,1,2,0.5,0,0,0.0,0,1,1,1,0,0,0,0,3,-7,1,NYK,NYK,CHA,129,,,5,4,4,2
Miles McBride,G,22023,1630540,22300161,"NOV 08, 2023",NYK vs. SAS,W,2,0,0,0.0,0,0,0.0,0,0,0.0,0,0,0,0,0,0,0,0,0,-2,1,NYK,NYK,SAS,126,,,0,0,0,0
Miles McBride,G,22023,1630540,22300112,"OCT 31, 2023",NYK @ CLE,W,4,1,2,0.5,1,2,0.5,0,0,0.0,0,0,0,0,0,0,0,1,3,-5,1,NYK,CLE,NYK,109,,,3,3,3,0
Miles McBride,G,22023,1630540,22300297,"DEC 11, 2023",NYK vs. TOR,W,10,1,2,0.5,1,1,1.0,0,0,0.0,0,0,0,3,0,0,0,1,3,5,1,NYK,NYK,TOR,136,,,6,3,6,3
Miles McBride,G,22023,1630540,22300057,"NOV 28, 2023",NYK vs. CHA,W,1,0,0,0.0,0,0,0.0,0,0,0.0,0,0,0,1,0,0,0,0,0,-1,1,NYK,NYK,CHA,115,,,1,0,1,1
Miles McBride,G,22023,1630540,22300202,"NOV 18, 2023",NYK @ CHA,W,9,2,3,0.667,1,2,0.5,0,0,0.0,0,0,0,0,0,0,0,2,5,-1,1,NYK,CHA,NYK,122,,,5,5,5,0
Miles McBride,G,22023,1630540,22300090,"OCT 28, 2023",NYK @ NOP,L,5,1,3,0.333,0,2,0.0,0,0,0.0,0,1,1,1,1,0,0,0,2,10,1,NYK,NOP,NYK,87,,,4,3,3,2
Miles McBride,G,22023,1630540,22300193,"NOV 15, 2023",NYK @ ATL,W,1,0,0,0.0,0,0,0.0,0,0,0.0,0,0,0,0,0,0,0,1,0,-2,1,NYK,ATL,NYK,116,,,0,0,0,0
Miles McBride,G,22023,1630540,22300188,"NOV 13, 2023",NYK @ BOS,L,1,0,1,0.0,0,1,0.0,0,0,0.0,0,0,0,0,0,0,0,0,0,1,1,NYK,BOS,NYK,98,,,0,0,0,0
Miles McBride,G,22023,1630540,22300002,"NOV 03, 2023",NYK @ MIL,L,2,0,1,0.0,0,1,0.0,0,0,0.0,0,0,0,0,0,0,0,0,0,-10,1,NYK,MIL,NYK,105,,,0,0,0,0
Miles McBride,G,22023,1630540,22300120,"NOV 01, 2023",NYK vs. CLE,L,9,1,2,0.5,0,1,0.0,1,2,0.5,0,0,0,0,2,0,0,1,3,0,1,NYK,NYK,CLE,89,,,3,3,3,0
MarJon Beauchamp,F,22023,1630699,22300745,"FEB 09, 2024",MIL vs. CHA,W,8,0,2,0.0,0,1,0.0,4,4,1.0,0,3,3,0,0,0,0,2,4,-4,1,MIL,MIL,CHA,120,,,7,7,4,3
MarJon Beauchamp,F,22023,1630699,22300738,"FEB 08, 2024",MIL vs. MIN,L,5,1,2,0.5,0,1,0.0,0,0,0.0,0,1,1,0,0,0,0,0,2,-1,1,MIL,MIL,MIN,105,,,3,3,2,1
MarJon Beauchamp,F,22023,1630699,22300711,"FEB 04, 2024",MIL @ UTA,L,1,0,1,0.0,0,1,0.0,0,0,0.0,0,0,0,0,0,0,0,0,0,-1,1,MIL,UTA,MIL,108,,,0,0,0,0
MarJon Beauchamp,F,22023,1630699,22300648,"JAN 27, 2024",MIL vs. NOP,W,6,3,3,1.0,0,0,0.0,0,0,0.0,0,0,0,0,0,0,0,0,6,-4,1,MIL,MIL,NOP,141,,,6,6,6,0
MarJon Beauchamp,F,22023,1630699,22300528,"JAN 11, 2024",MIL vs. BOS,W,12,0,2,0.0,0,2,0.0,0,0,0.0,0,1,1,0,0,1,1,0,0,-8,1,MIL,MIL,BOS,135,,,1,1,0,1
MarJon Beauchamp,F,22023,1630699,22300510,"JAN 08, 2024",MIL vs. UTA,L,14,1,6,0.167,1,4,0.25,0,0,0.0,0,2,2,3,2,0,0,1,3,4,1,MIL,MIL,UTA,116,,,8,5,6,5
MarJon Beauchamp,F,22023,1630699,22300496,"JAN 06, 2024",MIL @ HOU,L,23,2,4,0.5,1,3,0.333,0,0,0.0,1,3,4,3,0,1,1,1,5,2,1,MIL,HOU,MIL,108,,,12,9,8,7
MarJon Beauchamp,F,22023,1630699,22300477,"JAN 04, 2024",MIL @ SAS,W,17,3,8,0.375,2,4,0.5,0,0,0.0,2,1,3,0,0,0,1,1,8,-7,1,MIL,SAS,MIL,125,,,11,11,8,3
MarJon Beauchamp,F,22023,1630699,22300466,"JAN 03, 2024",MIL @ IND,L,21,6,9,0.667,0,3,0.0,0,0,0.0,1,2,3,1,0,0,1,1,12,-1,1,MIL,IND,MIL,130,,,16,15,13,4
MarJon Beauchamp,F,22023,1630699,22300433,"DEC 29, 2023",MIL @ CLE,W,11,2,3,0.667,1,2,0.5,0,0,0.0,1,0,1,0,0,0,0,2,5,1,1,MIL,CLE,MIL,119,,,6,6,5,1
MarJon Beauchamp,F,22023,1630699,22300417,"DEC 27, 2023",MIL @ BKN,W,21,4,6,0.667,2,3,0.667,1,2,0.5,0,5,5,2,1,0,0,2,11,21,1,MIL,BKN,MIL,144,,,18,16,13,7
MarJon Beauchamp,F,22023,1630699,22300401,"DEC 25, 2023",MIL @ NYK,L,6,0,0,0.0,0,0,0.0,0,0,0.0,0,1,1,0,1,0,0,0,0,4,1,MIL,NYK,MIL,122,,,1,1,0,1
MarJon Beauchamp,F,22023,1630699,22300388,"DEC 23, 2023",MIL @ NYK,W,0,0,0,0.0,0,0,0.0,0,0,0.0,0,1,1,0,0,0,0,0,0,0,1,MIL,NYK,MIL,130,,,1,1,0,1
MarJon Beauchamp,F,22023,1630699,22300378,"DEC 21, 2023",MIL vs. ORL,W,11,2,3,0.667,1,2,0.5,0,0,0.0,0,3,3,0,0,0,2,2,5,-4,1,MIL,MIL,ORL,118,,,8,8,5,3
MarJon Beauchamp,F,22023,1630699,22300361,"DEC 19, 2023",MIL vs. SAS,W,6,0,0,0.0,0,0,0.0,0,0,0.0,0,1,1,0,0,0,0,0,0,-6,1,MIL,MIL,SAS,132,,,1,1,0,1
MarJon Beauchamp,F,22023,1630699,22300346,"DEC 17, 2023",MIL vs. HOU,W,13,0,0,0.0,0,0,0.0,0,0,0.0,0,1,1,0,0,0,0,2,0,2,1,MIL,MIL,HOU,128,,,1,1,0,1
MarJon Beauchamp,F,22023,1630699,22300334,"DEC 16, 2023",MIL vs. DET,W,33,4,8,0.5,1,2,0.5,2,2,1.0,1,5,6,1,2,0,3,0,11,12,1,MIL,MIL,DET,146,,,18,17,12,7
MarJon Beauchamp,F,22023,1630699,22300315,"DEC 13, 2023",MIL vs. IND,W,15,3,4,0.75,0,0,0.0,0,0,0.0,0,3,3,0,0,0,3,2,6,-3,1,MIL,MIL,IND,140,,,9,9,6,3
MarJon Beauchamp,F,22023,1630699,22300300,"DEC 11, 2023",MIL vs. CHI,W,14,1,2,0.5,0,1,0.0,0,0,0.0,0,0,0,0,0,0,0,1,2,6,1,MIL,MIL,CHI,133,,,2,2,2,0
MarJon Beauchamp,F,22023,1630699,22301229,"DEC 07, 2023",MIL vs. IND,L,15,2,3,0.667,0,0,0.0,1,4,0.25,3,3,6,0,0,1,0,0,5,-17,1,MIL,MIL,IND,119,,,11,11,5,6
MarJon Beauchamp,F,22023,1630699,22301201,"DEC 05, 2023",MIL vs. NYK,W,19,2,3,0.667,2,2,1.0,0,0,0.0,0,2,2,1,1,0,0,1,6,9,1,MIL,MIL,NYK,146,,,9,8,7,3
MarJon Beauchamp,F,22023,1630699,22300286,"DEC 02, 2023",MIL vs. ATL,W,17,1,2,0.5,1,1,1.0,0,0,0.0,0,1,1,2,0,1,0,3,3,14,1,MIL,MIL,ATL,132,,,6,4,5,3
MarJon Beauchamp,F,22023,1630699,22300269,"NOV 30, 2023",MIL @ CHI,L,22,3,7,0.429,1,4,0.25,0,0,0.0,0,3,3,0,0,0,2,1,7,11,1,MIL,CHI,MIL,113,,,10,10,7,3
MarJon Beauchamp,F,22023,1630699,22300056,"NOV 28, 2023",MIL @ MIA,W,9,0,2,0.0,0,0,0.0,0,0,0.0,1,3,4,1,0,0,1,4,0,0,1,MIL,MIA,MIL,131,,,5,4,1,5
MarJon Beauchamp,F,22023,1630699,22300245,"NOV 26, 2023",MIL vs. POR,W,9,0,0,0.0,0,0,0.0,0,0,0.0,0,1,1,1,0,1,1,2,0,-1,1,MIL,MIL,POR,108,,,2,1,1,2
MarJon Beauchamp,F,22023,1630699,22300049,"NOV 24, 2023",MIL vs. WAS,W,13,0,4,0.0,0,2,0.0,3,4,0.75,0,3,3,2,0,0,0,2,3,8,1,MIL,MIL,WAS,131,,,8,6,5,5
MarJon Beauchamp,F,22023,1630699,22300228,"NOV 22, 2023",MIL @ BOS,L,22,2,5,0.4,1,2,0.5,0,0,0.0,1,2,3,0,1,0,0,1,5,-7,1,MIL,BOS,MIL,116,,,8,8,5,3
MarJon Beauchamp,F,22023,1630699,22300190,"NOV 13, 2023",MIL vs. CHI,W,20,3,7,0.429,2,4,0.5,0,0,0.0,1,4,5,2,1,1,1,1,8,7,1,MIL,MIL,CHI,118,,,15,13,10,7
MarJon Beauchamp,F,22023,1630699,22300173,"NOV 11, 2023",MIL @ ORL,L,20,2,7,0.286,0,2,0.0,1,3,0.333,1,3,4,0,0,0,3,2,5,-19,1,MIL,ORL,MIL,97,,,9,9,5,4
MarJon Beauchamp,F,22023,1630699,22300171,"NOV 09, 2023",MIL @ IND,L,13,2,4,0.5,1,2,0.5,0,0,0.0,1,3,4,2,0,0,0,0,5,6,1,MIL,IND,MIL,124,,,11,9,7,6
MarJon Beauchamp,F,22023,1630699,22300165,"NOV 08, 2023",MIL vs. DET,W,27,4,8,0.5,0,3,0.0,2,2,1.0,1,1,2,1,0,0,1,4,10,-25,1,MIL,MIL,DET,120,,,13,12,11,3
MarJon Beauchamp,F,22023,1630699,22300149,"NOV 06, 2023",MIL @ BKN,W,16,1,2,0.5,1,1,1.0,0,0,0.0,1,0,1,2,1,0,1,0,3,18,1,MIL,BKN,MIL,129,,,6,4,5,3
MarJon Beauchamp,F,22023,1630699,22300002,"NOV 03, 2023",MIL vs. NYK,W,13,5,7,0.714,3,5,0.6,0,1,0.0,1,1,2,2,0,0,0,2,13,5,1,MIL,MIL,NYK,110,,,17,15,15,4
MarJon Beauchamp,F,22023,1630699,22300116,"NOV 01, 2023",MIL @ TOR,L,16,2,5,0.4,2,5,0.4,2,2,1.0,0,2,2,0,0,0,0,0,8,5,1,MIL,TOR,MIL,111,,,10,10,8,2
MarJon Beauchamp,F,22023,1630699,22300097,"OCT 29, 2023",MIL vs. ATL,L,16,3,5,0.6,2,2,1.0,0,0,0.0,1,0,1,0,0,0,1,3,8,-2,1,MIL,MIL,ATL,110,,,9,9,8,1
MarJon Beauchamp,F,22023,1630699,22300075,"OCT 26, 2023",MIL vs. PHI,W,16,2,3,0.667,0,1,0.0,0,0,0.0,1,1,2,0,0,0,0,3,4,-3,1,MIL,MIL,PHI,118,,,6,6,4,2
MarJon Beauchamp,F,22023,1630699,22300572,"JAN 17, 2024",MIL @ CLE,L,23,0,3,0.0,0,0,0.0,0,0,0.0,1,2,3,2,0,0,1,1,0,-12,1,MIL,CLE,MIL,95,,,5,3,2,5
MarJon Beauchamp,F,22023,1630699,22300195,"NOV 15, 2023",MIL @ TOR,W,10,2,3,0.667,0,0,0.0,0,0,0.0,0,0,0,1,1,0,0,2,4,2,1,MIL,TOR,MIL,128,,,5,4,5,1
Taylor Hendricks,F,22023,1641707,22300540,"JAN 12, 2024",UTA vs. TOR,W,4,2,2,1.0,2,2,1.0,0,0,0.0,0,1,1,1,1,0,0,1,6,5,1,UTA,UTA,TOR,145,,,8,7,7,2
Taylor Hendricks,F,22023,1641707,22300524,"JAN 10, 2024",UTA vs. DEN,W,3,0,1,0.0,0,1,0.0,0,0,0.0,0,0,0,0,0,1,1,0,0,-5,1,UTA,UTA,DEN,124,,,0,0,0,0
Taylor Hendricks,F,22023,1641707,22300412,"DEC 26, 2023",UTA @ SAS,W,2,0,3,0.0,0,2,0.0,0,0,0.0,0,1,1,0,0,0,1,0,0,-7,1,UTA,SAS,UTA,130,,,1,1,0,1
Taylor Hendricks,F,22023,1641707,22300374,"DEC 21, 2023",UTA @ DET,W,16,3,5,0.6,1,2,0.5,0,0,0.0,3,1,4,0,0,1,0,0,7,7,1,UTA,DET,UTA,119,,,11,11,7,4
Taylor Hendricks,F,22023,1641707,22300357,"DEC 18, 2023",UTA vs. BKN,W,7,0,1,0.0,0,1,0.0,0,0,0.0,0,2,2,1,0,0,1,1,0,-8,1,UTA,UTA,BKN,125,,,3,2,1,3
Taylor Hendricks,F,22023,1641707,22300342,"DEC 16, 2023",UTA @ SAC,L,21,3,8,0.375,2,5,0.4,4,5,0.8,1,2,3,1,1,0,0,0,12,8,1,UTA,SAC,UTA,104,,,16,15,13,4
Taylor Hendricks,F,22023,1641707,22300323,"DEC 14, 2023",UTA @ POR,W,25,4,9,0.444,2,5,0.4,0,0,0.0,3,4,7,0,1,0,2,1,10,-21,1,UTA,POR,UTA,122,,,17,17,10,7
Taylor Hendricks,F,22023,1641707,22300318,"DEC 13, 2023",UTA vs. NYK,W,20,2,7,0.286,1,3,0.333,0,0,0.0,2,2,4,1,2,1,1,3,5,25,1,UTA,UTA,NYK,117,,,10,9,6,5
Taylor Hendricks,F,22023,1641707,22300302,"DEC 11, 2023",UTA @ OKC,L,26,3,6,0.5,1,4,0.25,1,1,1.0,0,2,2,2,1,1,0,2,8,5,1,UTA,OKC,UTA,120,,,12,10,10,4
Taylor Hendricks,F,22023,1641707,22301225,"DEC 08, 2023",UTA vs. LAC,L,12,0,3,0.0,0,2,0.0,0,0,0.0,0,0,0,0,1,0,1,0,0,4,1,UTA,UTA,LAC,103,,,0,0,0,0
Taylor Hendricks,F,22023,1641707,22301213,"DEC 06, 2023",UTA @ DAL,L,25,4,6,0.667,2,4,0.5,0,0,0.0,1,1,2,0,2,1,2,3,10,-10,1,UTA,DAL,UTA,97,,,12,12,10,2
Taylor Hendricks,F,22023,1641707,22300289,"DEC 02, 2023",UTA vs. POR,W,18,2,7,0.286,1,4,0.25,0,0,0.0,1,1,2,0,0,2,0,1,5,1,1,UTA,UTA,POR,118,,,7,7,5,2
Taylor Hendricks,F,22023,1641707,22300072,"OCT 25, 2023",UTA vs. SAC,L,2,0,0,0.0,0,0,0.0,1,2,0.5,0,1,1,0,0,0,0,0,1,2,1,UTA,UTA,SAC,114,,,2,2,1,1
Taylor Hendricks,F,22023,1641707,22300739,"FEB 08, 2024",UTA @ PHX,L,18,1,5,0.2,1,2,0.5,0,0,0.0,2,6,8,1,0,1,2,1,3,-13,1,UTA,PHX,UTA,115,,,12,11,4,9
Jarace Walker,F,22023,1641716,22300480,"JAN 05, 2024",IND vs. ATL,W,12,3,6,0.5,2,3,0.667,0,0,0.0,1,0,1,1,0,0,1,1,8,0,1,IND,IND,ATL,148,,,10,9,9,2
Jarace Walker,F,22023,1641716,22300466,"JAN 03, 2024",IND vs. MIL,W,2,0,0,0.0,0,0,0.0,3,4,0.75,0,0,0,0,0,0,0,0,3,-5,1,IND,IND,MIL,142,,,3,3,3,0
Jarace Walker,F,22023,1641716,22300338,"DEC 16, 2023",IND @ MIN,L,24,2,3,0.667,1,2,0.5,0,0,0.0,0,2,2,3,2,0,1,2,5,-4,1,IND,MIN,IND,109,,,10,7,8,5
Jarace Walker,F,22023,1641716,22300328,"DEC 15, 2023",IND @ WAS,L,13,2,4,0.5,1,2,0.5,0,0,0.0,0,2,2,0,0,0,0,1,5,8,1,IND,WAS,IND,123,,,7,7,5,2
Jarace Walker,F,22023,1641716,22300315,"DEC 13, 2023",IND @ MIL,L,6,1,3,0.333,1,2,0.5,0,0,0.0,0,0,0,2,0,1,1,4,3,2,1,IND,MIL,IND,126,,,5,3,5,2
Jarace Walker,F,22023,1641716,22300267,"NOV 30, 2023",IND @ MIA,L,0,0,0,0.0,0,0,0.0,0,0,0.0,0,0,0,0,0,0,0,0,0,0,1,IND,MIA,IND,132,,,0,0,0,0
Jarace Walker,F,22023,1641716,22300209,"NOV 19, 2023",IND vs. ORL,L,14,3,6,0.5,0,3,0.0,1,1,1.0,0,1,1,1,1,1,1,2,7,15,1,IND,IND,ORL,116,,,9,8,8,2
Jarace Walker,F,22023,1641716,22300146,"NOV 06, 2023",IND vs. SAS,W,9,0,1,0.0,0,0,0.0,2,2,1.0,0,1,1,2,0,0,0,0,2,6,1,IND,IND,SAS,152,,,5,3,4,3
Jarace Walker,F,22023,1641716,22300118,"NOV 01, 2023",IND @ BOS,L,12,4,6,0.667,0,1,0.0,0,0,0.0,0,2,2,3,0,1,0,1,8,-13,1,IND,BOS,IND,104,,,13,10,11,5
Jarace Walker,F,22023,1641716,22300064,"OCT 25, 2023",IND vs. WAS,W,6,0,5,0.0,0,1,0.0,0,0,0.0,1,3,4,0,1,0,0,1,0,3,1,IND,IND,WAS,143,,,4,4,0,4
Jarace Walker,F,22023,1641716,22300707,"FEB 04, 2024",IND @ CHA,W,2,0,1,0.0,0,1,0.0,0,0,0.0,0,0,0,0,0,0,0,1,0,0,1,IND,CHA,IND,115,,,0,0,0,0
Jarace Walker,F,22023,1641716,22300564,"JAN 15, 2024",IND @ UTA,L,26,3,11,0.273,2,5,0.4,0,0,0.0,2,2,4,4,4,2,1,2,8,-17,1,IND,UTA,IND,105,,,16,12,12,8
Jarace Walker,F,22023,1641716,22300493,"JAN 06, 2024",IND vs. BOS,L,1,0,0,0.0,0,0,0.0,0,0,0.0,0,0,0,1,0,0,0,0,0,0,1,IND,IND,BOS,101,,,1,0,1,1
Jarace Walker,F,22023,1641716,22300691,"FEB 02, 2024",IND vs. SAC,L,7,0,1,0.0,0,1,0.0,0,0,0.0,0,1,1,0,0,1,2,1,0,-4,1,IND,IND,SAC,122,,,1,1,0,1
Jarace Walker,F,22023,1641716,22300441,"DEC 30, 2023",IND vs. NYK,W,1,0,0,0.0,0,0,0.0,0,0,0.0,0,0,0,0,0,0,0,0,0,-3,1,IND,IND,NYK,140,,,0,0,0,0
Jarace Walker,F,22023,1641716,22300604,"JAN 21, 2024",IND @ PHX,L,18,4,6,0.667,2,3,0.667,0,0,0.0,3,6,9,1,1,0,1,0,10,3,1,IND,PHX,IND,110,,,20,19,11,10
Jarace Walker,F,22023,1641716,22300583,"JAN 18, 2024",IND @ SAC,W,20,6,13,0.462,3,8,0.375,0,0,0.0,1,1,2,2,0,0,2,1,15,-1,1,IND,SAC,IND,126,,,19,17,17,4
Joe Ingles,F-G,22023,204060,22300752,"FEB 10, 2024",ORL vs. CHI,W,9,0,2,0.0,0,2,0.0,0,0,0.0,0,0,0,2,0,0,1,2,0,3,1,ORL,ORL,CHI,114,,,2,0,2,2
Joe Ingles,F-G,22023,204060,22300734,"FEB 08, 2024",ORL vs. SAS,W,16,3,4,0.75,2,3,0.667,0,0,0.0,0,3,3,4,1,0,0,1,8,2,1,ORL,ORL,SAS,127,,,15,11,12,7
Joe Ingles,F-G,22023,204060,22300721,"FEB 06, 2024",ORL @ MIA,L,15,3,4,0.75,3,4,0.75,0,0,0.0,0,1,1,1,0,0,0,0,9,1,1,ORL,MIA,ORL,95,,,11,10,10,2
Joe Ingles,F-G,22023,204060,22300704,"FEB 04, 2024",ORL @ DET,W,15,1,3,0.333,1,3,0.333,0,0,0.0,0,2,2,2,0,0,1,1,3,0,1,ORL,DET,ORL,111,,,7,5,5,4
Joe Ingles,F-G,22023,204060,22300694,"FEB 02, 2024",ORL @ MIN,W,13,2,4,0.5,2,4,0.5,0,0,0.0,0,0,0,2,0,0,0,1,6,-10,1,ORL,MIN,ORL,108,,,8,6,8,2
Joe Ingles,F-G,22023,204060,22300681,"JAN 31, 2024",ORL @ SAS,W,15,0,2,0.0,0,2,0.0,0,0,0.0,0,4,4,2,1,0,2,2,0,5,1,ORL,SAS,ORL,108,,,6,4,2,6
Joe Ingles,F-G,22023,204060,22300666,"JAN 29, 2024",ORL @ DAL,L,15,1,4,0.25,1,3,0.333,0,0,0.0,1,2,3,0,0,0,2,1,3,-9,1,ORL,DAL,ORL,129,,,6,6,3,3
Joe Ingles,F-G,22023,204060,22300655,"JAN 28, 2024",ORL vs. PHX,W,13,2,4,0.5,2,4,0.5,0,0,0.0,0,2,2,2,0,0,0,3,6,-1,1,ORL,ORL,PHX,113,,,10,8,8,4
Joe Ingles,F-G,22023,204060,22300638,"JAN 26, 2024",ORL @ MEM,L,17,1,5,0.2,0,4,0.0,0,0,0.0,0,0,0,0,0,0,0,0,2,-9,1,ORL,MEM,ORL,106,,,2,2,2,0
Joe Ingles,F-G,22023,204060,22300607,"JAN 22, 2024",ORL vs. CLE,L,15,1,1,1.0,0,0,0.0,0,0,0.0,2,2,4,2,1,0,2,2,2,-9,1,ORL,ORL,CLE,99,,,8,6,4,6
Joe Ingles,F-G,22023,204060,22300601,"JAN 21, 2024",ORL vs. MIA,W,17,0,2,0.0,0,2,0.0,0,0,0.0,1,2,3,3,0,0,3,0,0,4,1,ORL,ORL,MIA,105,,,6,3,3,6
Joe Ingles,F-G,22023,204060,22300585,"JAN 19, 2024",ORL vs. PHI,L,22,3,6,0.5,3,3,1.0,0,0,0.0,0,1,1,3,0,0,0,2,9,-6,1,ORL,ORL,PHI,109,,,13,10,12,4
Joe Ingles,F-G,22023,204060,22300570,"JAN 17, 2024",ORL @ ATL,L,20,1,5,0.2,1,5,0.2,0,0,0.0,0,4,4,3,1,0,3,4,3,3,1,ORL,ATL,ORL,104,,,10,7,6,7
Joe Ingles,F-G,22023,204060,22300557,"JAN 15, 2024",ORL @ NYK,W,20,3,6,0.5,0,1,0.0,0,0,0.0,0,1,1,4,0,0,1,2,6,6,1,ORL,NYK,ORL,98,,,11,7,10,5
Joe Ingles,F-G,22023,204060,22300535,"JAN 12, 2024",ORL @ MIA,L,20,5,10,0.5,4,8,0.5,0,1,0.0,0,0,0,6,3,0,2,2,14,0,1,ORL,MIA,ORL,96,,,20,14,20,6
Joe Ingles,F-G,22023,204060,22300329,"DEC 15, 2023",ORL @ BOS,L,6,0,1,0.0,0,0,0.0,0,0,0.0,1,1,2,2,0,0,0,0,0,-12,1,ORL,BOS,ORL,111,,,4,2,2,4
Joe Ingles,F-G,22023,204060,22300294,"DEC 11, 2023",ORL vs. CLE,W,20,2,5,0.4,2,4,0.5,6,6,1.0,1,3,4,3,0,1,1,2,12,-2,1,ORL,ORL,CLE,104,,,19,16,15,7
Joe Ingles,F-G,22023,204060,22301217,"DEC 08, 2023",ORL vs. DET,W,16,2,6,0.333,2,3,0.667,0,0,0.0,0,4,4,5,0,0,0,1,6,15,1,ORL,ORL,DET,123,,,15,10,11,9
Joe Ingles,F-G,22023,204060,22301205,"DEC 06, 2023",ORL @ CLE,L,17,0,1,0.0,0,1,0.0,0,0,0.0,0,4,4,3,1,0,0,3,0,-7,1,ORL,CLE,ORL,111,,,7,4,3,7
Joe Ingles,F-G,22023,204060,22300282,"DEC 02, 2023",ORL @ BKN,L,16,1,2,0.5,1,1,1.0,2,3,0.667,1,1,2,2,1,0,1,2,5,-10,1,ORL,BKN,ORL,101,,,9,7,7,4
Joe Ingles,F-G,22023,204060,22300274,"DEC 01, 2023",ORL vs. WAS,W,25,5,11,0.455,3,7,0.429,1,1,1.0,0,3,3,7,0,0,0,3,14,13,1,ORL,ORL,WAS,130,,,24,17,21,10
Joe Ingles,F-G,22023,204060,22300259,"NOV 29, 2023",ORL vs. WAS,W,20,5,7,0.714,1,1,1.0,1,1,1.0,0,4,4,6,1,0,2,1,12,16,1,ORL,ORL,WAS,139,,,22,16,18,10
Joe Ingles,F-G,22023,204060,22300248,"NOV 26, 2023",ORL vs. CHA,W,15,0,3,0.0,0,1,0.0,0,0,0.0,0,2,2,1,1,0,2,2,0,0,1,ORL,ORL,CHA,130,,,3,2,1,3
Joe Ingles,F-G,22023,204060,22300043,"NOV 24, 2023",ORL vs. BOS,W,21,2,3,0.667,1,1,1.0,0,0,0.0,1,4,5,2,0,0,2,1,5,2,1,ORL,ORL,BOS,113,,,12,10,7,7
Joe Ingles,F-G,22023,204060,22300226,"NOV 22, 2023",ORL vs. DEN,W,17,4,4,1.0,2,2,1.0,2,2,1.0,0,1,1,7,1,0,0,3,12,9,1,ORL,ORL,DEN,124,,,20,13,19,8
Joe Ingles,F-G,22023,204060,22300038,"NOV 21, 2023",ORL vs. TOR,W,13,2,3,0.667,1,2,0.5,1,1,1.0,1,1,2,1,0,0,1,2,6,6,1,ORL,ORL,TOR,126,,,9,8,7,3
Joe Ingles,F-G,22023,204060,22300209,"NOV 19, 2023",ORL @ IND,W,18,0,2,0.0,0,2,0.0,0,0,0.0,0,4,4,6,3,0,2,1,0,4,1,ORL,IND,ORL,128,,,10,4,6,10
Joe Ingles,F-G,22023,204060,22300033,"NOV 17, 2023",ORL @ CHI,W,26,3,8,0.375,2,7,0.286,0,0,0.0,0,1,1,5,1,0,1,1,8,16,1,ORL,CHI,ORL,103,,,14,9,13,6
Joe Ingles,F-G,22023,204060,22300196,"NOV 15, 2023",ORL @ CHI,W,18,1,3,0.333,1,3,0.333,0,0,0.0,0,2,2,1,0,0,0,1,3,3,1,ORL,CHI,ORL,96,,,6,5,4,3
Joe Ingles,F-G,22023,204060,22300020,"NOV 14, 2023",ORL @ BKN,L,21,4,4,1.0,3,3,1.0,0,0,0.0,1,2,3,4,1,1,1,1,11,-10,1,ORL,BKN,ORL,104,,,18,14,15,7
Joe Ingles,F-G,22023,204060,22300173,"NOV 11, 2023",ORL vs. MIL,W,23,1,5,0.2,1,4,0.25,2,2,1.0,1,2,3,5,0,0,0,1,5,8,1,ORL,ORL,MIL,112,,,13,8,10,8
Joe Ingles,F-G,22023,204060,22300172,"NOV 09, 2023",ORL vs. ATL,L,18,1,6,0.167,1,3,0.333,0,0,0.0,2,1,3,5,3,1,0,1,3,27,1,ORL,ORL,ATL,119,,,11,6,8,8
Joe Ingles,F-G,22023,204060,22300147,"NOV 06, 2023",ORL vs. DAL,L,21,1,2,0.5,0,0,0.0,0,0,0.0,0,5,5,3,0,0,2,1,2,3,1,ORL,ORL,DAL,102,,,10,7,5,8
Joe Ingles,F-G,22023,204060,22300134,"NOV 04, 2023",ORL vs. LAL,W,25,2,6,0.333,2,5,0.4,1,1,1.0,0,3,3,3,1,0,2,2,7,7,1,ORL,ORL,LAL,120,,,13,10,10,6
Joe Ingles,F-G,22023,204060,22300130,"NOV 02, 2023",ORL @ UTA,W,24,1,5,0.2,1,4,0.25,1,2,0.5,1,1,2,1,1,0,0,0,4,-4,1,ORL,UTA,ORL,115,,,7,6,5,3
Joe Ingles,F-G,22023,204060,22300114,"OCT 31, 2023",ORL @ LAC,L,13,0,1,0.0,0,1,0.0,0,0,0.0,0,1,1,1,0,0,0,0,0,-4,1,ORL,LAC,ORL,102,,,2,1,1,2
Joe Ingles,F-G,22023,204060,22300111,"OCT 30, 2023",ORL @ LAL,L,12,1,2,0.5,0,0,0.0,0,0,0.0,1,0,1,3,2,0,1,2,2,-2,1,ORL,LAL,ORL,103,,,6,3,5,4
Joe Ingles,F-G,22023,204060,22300086,"OCT 27, 2023",ORL @ POR,W,15,0,1,0.0,0,1,0.0,0,0,0.0,0,1,1,1,1,0,1,3,0,3,1,ORL,POR,ORL,102,,,2,1,1,2
Joe Ingles,F-G,22023,204060,22300066,"OCT 25, 2023",ORL vs. HOU,W,18,0,3,0.0,0,3,0.0,0,0,0.0,0,4,4,5,0,0,1,3,0,9,1,ORL,ORL,HOU,116,,,9,4,5,9
Shake Milton,G-F,22023,1629003,22300709,"FEB 04, 2024",MIN vs. HOU,W,4,0,3,0.0,0,0,0.0,0,0,0.0,0,2,2,0,0,0,0,0,0,-7,1,MIN,MIN,HOU,111,,,2,2,0,2
Shake Milton,G-F,22023,1629003,22300680,"JAN 31, 2024",MIN vs. DAL,W,6,2,3,0.667,0,0,0.0,0,0,0.0,0,0,0,0,0,0,0,1,4,7,1,MIN,MIN,DAL,121,,,4,4,4,0
Shake Milton,G-F,22023,1629003,22300649,"JAN 27, 2024",MIN @ SAS,L,16,3,5,0.6,1,1,1.0,0,0,0.0,0,1,1,2,0,0,1,1,7,4,1,MIN,SAS,MIN,112,,,10,8,9,3
Shake Milton,G-F,22023,1629003,22300620,"JAN 24, 2024",MIN @ WAS,W,19,1,5,0.2,0,1,0.0,0,0,0.0,2,1,3,3,1,1,1,1,2,0,1,MIN,WAS,MIN,118,,,8,5,5,6
Shake Milton,G-F,22023,1629003,22300610,"JAN 22, 2024",MIN vs. CHA,L,15,2,5,0.4,0,2,0.0,0,0,0.0,0,1,1,3,1,0,0,1,4,-6,1,MIN,MIN,CHA,125,,,8,5,7,4
Shake Milton,G-F,22023,1629003,22300569,"JAN 17, 2024",MIN @ DET,W,1,0,0,0.0,0,0,0.0,0,0,0.0,0,0,0,0,0,0,0,0,0,-5,1,MIN,DET,MIN,124,,,0,0,0,0
Shake Milton,G-F,22023,1629003,22300538,"JAN 12, 2024",MIN vs. POR,W,10,3,5,0.6,0,0,0.0,0,0,0.0,0,0,0,2,0,0,0,1,6,-11,1,MIN,MIN,POR,116,,,8,6,8,2
Shake Milton,G-F,22023,1629003,22300517,"JAN 10, 2024",MIN @ BOS,L,9,1,2,0.5,0,0,0.0,0,1,0.0,0,2,2,0,0,1,0,0,2,8,1,MIN,BOS,MIN,120,,,4,4,2,2
Shake Milton,G-F,22023,1629003,22300513,"JAN 09, 2024",MIN @ ORL,W,2,2,2,1.0,0,0,0.0,0,0,0.0,0,0,0,0,0,0,0,0,4,-2,1,MIN,ORL,MIN,113,,,4,4,4,0
Shake Milton,G-F,22023,1629003,22300485,"JAN 05, 2024",MIN @ HOU,W,3,0,1,0.0,0,1,0.0,0,0,0.0,0,0,0,0,0,0,1,1,0,0,1,MIN,HOU,MIN,122,,,0,0,0,0
Shake Milton,G-F,22023,1629003,22300471,"JAN 03, 2024",MIN vs. NOP,L,3,2,2,1.0,1,1,1.0,0,0,0.0,0,0,0,0,0,0,0,0,5,8,1,MIN,MIN,NOP,106,,,5,5,5,0
Shake Milton,G-F,22023,1629003,22300411,"DEC 26, 2023",MIN @ OKC,L,5,0,0,0.0,0,0,0.0,0,0,0.0,0,0,0,1,0,0,0,0,0,-1,1,MIN,OKC,MIN,106,,,1,0,1,1
Shake Milton,G-F,22023,1629003,22300400,"DEC 23, 2023",MIN @ SAC,W,14,2,4,0.5,1,2,0.5,0,0,0.0,0,1,1,1,0,0,1,0,5,-6,1,MIN,SAC,MIN,110,,,7,6,6,2
Shake Milton,G-F,22023,1629003,22300367,"DEC 20, 2023",MIN @ PHI,L,13,0,2,0.0,0,0,0.0,2,2,1.0,0,0,0,3,0,0,1,2,2,-1,1,MIN,PHI,MIN,113,,,5,2,5,3
Shake Milton,G-F,22023,1629003,22300338,"DEC 16, 2023",MIN vs. IND,W,5,0,2,0.0,0,1,0.0,0,0,0.0,0,0,0,0,0,0,0,1,0,-5,1,MIN,MIN,IND,127,,,0,0,0,0
Shake Milton,G-F,22023,1629003,22300321,"DEC 14, 2023",MIN @ DAL,W,2,1,1,1.0,0,0,0.0,0,0,0.0,0,0,0,0,0,0,0,0,2,-1,1,MIN,DAL,MIN,119,,,2,2,2,0
Shake Milton,G-F,22023,1629003,22300301,"DEC 11, 2023",MIN @ NOP,L,20,4,10,0.4,0,1,0.0,4,4,1.0,1,0,1,5,0,0,1,4,12,1,1,MIN,NOP,MIN,107,,,18,13,17,6
Shake Milton,G-F,22023,1629003,22301221,"DEC 08, 2023",MIN @ MEM,W,22,6,9,0.667,3,5,0.6,2,2,1.0,0,2,2,1,0,0,2,1,17,9,1,MIN,MEM,MIN,127,,,20,19,18,3
Shake Milton,G-F,22023,1629003,22301210,"DEC 06, 2023",MIN vs. SAS,W,12,0,2,0.0,0,1,0.0,0,0,0.0,0,1,1,0,0,0,0,0,0,-12,1,MIN,MIN,SAS,102,,,1,1,0,1
Shake Milton,G-F,22023,1629003,22300281,"DEC 02, 2023",MIN @ CHA,W,23,2,8,0.25,0,2,0.0,2,2,1.0,0,1,1,2,1,0,0,2,6,-5,1,MIN,CHA,MIN,123,,,9,7,8,3
Shake Milton,G-F,22023,1629003,22300270,"NOV 30, 2023",MIN vs. UTA,W,20,2,7,0.286,0,2,0.0,1,2,0.5,0,2,2,3,2,0,0,0,5,-6,1,MIN,MIN,UTA,101,,,10,7,8,5
Shake Milton,G-F,22023,1629003,22300058,"NOV 28, 2023",MIN vs. OKC,W,12,1,2,0.5,0,1,0.0,2,2,1.0,0,1,1,1,1,1,2,1,4,-4,1,MIN,MIN,OKC,106,,,6,5,5,2
Shake Milton,G-F,22023,1629003,22300249,"NOV 26, 2023",MIN @ MEM,W,19,2,6,0.333,1,3,0.333,1,2,0.5,0,2,2,3,1,0,1,2,6,8,1,MIN,MEM,MIN,119,,,11,8,9,5
Shake Milton,G-F,22023,1629003,22300050,"NOV 24, 2023",MIN vs. SAC,L,13,1,6,0.167,0,1,0.0,0,0,0.0,1,1,2,1,1,1,3,1,2,-10,1,MIN,MIN,SAC,111,,,5,4,3,3
Shake Milton,G-F,22023,1629003,22300232,"NOV 22, 2023",MIN vs. PHI,W,21,3,7,0.429,1,3,0.333,5,6,0.833,0,0,0,1,0,0,0,2,12,2,1,MIN,MIN,PHI,112,,,13,12,13,1
Shake Milton,G-F,22023,1629003,22300221,"NOV 20, 2023",MIN vs. NYK,W,14,2,5,0.4,0,2,0.0,2,2,1.0,0,5,5,4,0,0,1,1,6,0,1,MIN,MIN,NYK,117,,,15,11,10,9
Shake Milton,G-F,22023,1629003,22300203,"NOV 18, 2023",MIN @ NOP,W,16,2,6,0.333,0,2,0.0,4,4,1.0,0,1,1,1,1,0,1,2,8,-16,1,MIN,NOP,MIN,121,,,10,9,9,2
Shake Milton,G-F,22023,1629003,22300197,"NOV 15, 2023",MIN @ PHX,L,23,4,8,0.5,0,2,0.0,0,0,0.0,1,3,4,0,0,0,0,3,8,6,1,MIN,PHX,MIN,115,,,12,12,8,4
Shake Milton,G-F,22023,1629003,22300025,"NOV 14, 2023",MIN @ GSW,W,15,2,4,0.5,0,1,0.0,2,2,1.0,0,4,4,3,0,0,1,3,6,8,1,MIN,GSW,MIN,104,,,13,10,9,7
Shake Milton,G-F,22023,1629003,22300186,"NOV 12, 2023",MIN @ GSW,W,10,0,1,0.0,0,0,0.0,1,2,0.5,0,0,0,0,0,0,1,1,1,-2,1,MIN,GSW,MIN,116,,,1,1,1,0
Shake Milton,G-F,22023,1629003,22300013,"NOV 10, 2023",MIN @ SAS,W,14,2,4,0.5,2,3,0.667,0,1,0.0,1,2,3,1,0,0,2,3,6,0,1,MIN,SAS,MIN,117,,,10,9,7,4
Shake Milton,G-F,22023,1629003,22300166,"NOV 08, 2023",MIN vs. NOP,W,19,4,9,0.444,1,5,0.2,1,1,1.0,0,4,4,1,2,0,2,1,10,4,1,MIN,MIN,NOP,122,,,15,14,11,5
Shake Milton,G-F,22023,1629003,22300154,"NOV 06, 2023",MIN vs. BOS,W,3,0,0,0.0,0,0,0.0,0,0,0.0,0,0,0,0,0,0,0,0,0,-8,1,MIN,MIN,BOS,114,,,0,0,0,0
Shake Milton,G-F,22023,1629003,22300138,"NOV 04, 2023",MIN vs. UTA,W,15,2,4,0.5,0,2,0.0,4,4,1.0,1,1,2,0,1,1,0,2,8,4,1,MIN,MIN,UTA,123,,,10,10,8,2
Shake Milton,G-F,22023,1629003,22300123,"NOV 01, 2023",MIN vs. DEN,W,18,0,3,0.0,0,0,0.0,2,2,1.0,0,1,1,1,2,0,1,1,2,10,1,MIN,MIN,DEN,110,,,4,3,3,2
Shake Milton,G-F,22023,1629003,22300104,"OCT 30, 2023",MIN @ ATL,L,17,4,8,0.5,2,2,1.0,0,0,0.0,0,1,1,1,0,0,1,1,10,2,1,MIN,ATL,MIN,113,,,12,11,11,2
Shake Milton,G-F,22023,1629003,22300093,"OCT 28, 2023",MIN vs. MIA,W,17,1,4,0.25,0,2,0.0,0,1,0.0,0,1,1,2,0,0,2,0,2,-4,1,MIN,MIN,MIA,106,,,5,3,4,3
Shake Milton,G-F,22023,1629003,22300069,"OCT 25, 2023",MIN @ TOR,L,21,1,5,0.2,1,4,0.25,1,2,0.5,0,3,3,4,2,0,2,4,4,3,1,MIN,TOR,MIN,94,,,11,7,8,7
Shake Milton,G-F,22023,1629003,22300749,"FEB 10, 2024",DET @ LAC,L,12,2,5,0.4,0,1,0.0,0,0,0.0,1,2,3,0,1,0,0,1,4,-2,1,DET,LAC,DET,106,,,7,7,4,3
Max Christie,G,22023,1631108,22300605,"JAN 21, 2024",LAL vs. POR,W,22,1,7,0.143,0,3,0.0,2,2,1.0,0,1,1,2,0,1,2,3,4,-1,1,LAL,LAL,POR,134,,,7,5,6,3
Max Christie,G,22023,1631108,22300331,"DEC 15, 2023",LAL @ SAS,L,23,1,6,0.167,0,1,0.0,0,0,0.0,0,0,0,1,0,0,1,1,2,-25,1,LAL,SAS,LAL,115,,,3,2,3,1
Max Christie,G,22023,1631108,22300271,"NOV 30, 2023",LAL @ OKC,L,21,3,7,0.429,2,3,0.667,0,0,0.0,0,0,0,0,2,1,1,4,8,-2,1,LAL,OKC,LAL,110,,,8,8,8,0
Max Christie,G,22023,1631108,22300163,"NOV 08, 2023",LAL @ HOU,L,28,1,8,0.125,0,2,0.0,2,3,0.667,1,7,8,3,0,1,1,2,4,-15,1,LAL,HOU,LAL,94,,,15,12,7,11
Max Christie,G,22023,1631108,22300134,"NOV 04, 2023",LAL @ ORL,L,23,3,7,0.429,0,2,0.0,0,0,0.0,0,5,5,0,0,0,1,2,6,-24,1,LAL,ORL,LAL,101,,,11,11,6,5
Max Christie,G,22023,1631108,22300740,"FEB 08, 2024",LAL vs. DEN,L,15,2,7,0.286,2,3,0.667,1,2,0.5,1,1,2,1,1,0,0,1,7,-7,1,LAL,LAL,DEN,106,,,10,9,8,3
Max Christie,G,22023,1631108,22300713,"FEB 05, 2024",LAL @ CHA,W,18,2,3,0.667,0,1,0.0,2,2,1.0,0,3,3,0,0,1,0,1,6,-2,1,LAL,CHA,LAL,124,,,9,9,6,3
Max Christie,G,22023,1631108,22300701,"FEB 03, 2024",LAL @ NYK,W,26,2,2,1.0,2,2,1.0,0,1,0.0,0,1,1,1,0,2,0,1,6,12,1,LAL,NYK,LAL,113,,,8,7,7,2
Max Christie,G,22023,1631108,22300684,"FEB 01, 2024",LAL @ BOS,W,23,3,7,0.429,1,3,0.333,2,2,1.0,0,4,4,2,1,0,1,1,9,10,1,LAL,BOS,LAL,114,,,15,13,11,6
Max Christie,G,22023,1631108,22300669,"JAN 30, 2024",LAL @ ATL,L,11,2,2,1.0,1,1,1.0,0,0,0.0,0,1,1,0,0,1,1,1,5,-5,1,LAL,ATL,LAL,122,,,6,6,5,1
Max Christie,G,22023,1631108,22300662,"JAN 29, 2024",LAL @ HOU,L,20,3,6,0.5,1,2,0.5,0,0,0.0,0,6,6,1,0,1,0,0,7,0,1,LAL,HOU,LAL,119,,,14,13,8,7
Max Christie,G,22023,1631108,22300650,"JAN 27, 2024",LAL @ GSW,W,8,1,2,0.5,0,1,0.0,0,0,0.0,0,0,0,0,0,0,0,1,2,-3,1,LAL,GSW,LAL,145,,,2,2,2,0
Max Christie,G,22023,1631108,22300633,"JAN 25, 2024",LAL vs. CHI,W,9,0,0,0.0,0,0,0.0,2,2,1.0,0,0,0,1,1,0,1,0,2,-1,1,LAL,LAL,CHI,141,,,3,2,3,1
Max Christie,G,22023,1631108,22300618,"JAN 23, 2024",LAL @ LAC,L,10,0,1,0.0,0,1,0.0,0,0,0.0,0,0,0,0,0,0,0,0,0,-3,1,LAL,LAC,LAL,116,,,0,0,0,0
Max Christie,G,22023,1631108,22300591,"JAN 19, 2024",LAL vs. BKN,L,19,2,3,0.667,2,3,0.667,0,0,0.0,0,2,2,1,0,0,1,1,6,-6,1,LAL,LAL,BKN,112,,,9,8,7,3
Max Christie,G,22023,1631108,22300577,"JAN 17, 2024",LAL vs. DAL,W,14,2,2,1.0,1,1,1.0,0,0,0.0,0,2,2,0,0,0,0,0,5,4,1,LAL,LAL,DAL,127,,,7,7,5,2
Max Christie,G,22023,1631108,22300565,"JAN 15, 2024",LAL vs. OKC,W,11,0,2,0.0,0,1,0.0,0,0,0.0,1,0,1,0,0,0,1,1,0,5,1,LAL,LAL,OKC,112,,,1,1,0,1
Max Christie,G,22023,1631108,22300549,"JAN 13, 2024",LAL @ UTA,L,14,1,2,0.5,1,1,1.0,0,0,0.0,0,0,0,3,1,0,0,3,3,9,1,LAL,UTA,LAL,125,,,6,3,6,3
Max Christie,G,22023,1631108,22300531,"JAN 11, 2024",LAL vs. PHX,L,25,4,8,0.5,1,3,0.333,5,6,0.833,0,7,7,4,0,0,2,2,14,-2,1,LAL,LAL,PHX,109,,,25,21,18,11
Max Christie,G,22023,1631108,22300516,"JAN 09, 2024",LAL vs. TOR,W,18,2,2,1.0,1,1,1.0,1,2,0.5,1,3,4,2,0,0,0,0,6,5,1,LAL,LAL,TOR,132,,,12,10,8,6
Max Christie,G,22023,1631108,22300505,"JAN 07, 2024",LAL vs. LAC,W,13,3,6,0.5,1,1,1.0,0,0,0.0,2,1,3,0,0,2,0,0,7,10,1,LAL,LAL,LAC,106,,,10,10,7,3
Max Christie,G,22023,1631108,22300491,"JAN 05, 2024",LAL vs. MEM,L,20,1,3,0.333,0,1,0.0,0,0,0.0,0,3,3,0,1,0,2,2,2,1,1,LAL,LAL,MEM,113,,,5,5,2,3
Max Christie,G,22023,1631108,22300475,"JAN 03, 2024",LAL vs. MIA,L,28,5,12,0.417,2,9,0.222,2,2,1.0,1,4,5,0,0,0,2,2,14,-8,1,LAL,LAL,MIA,96,,,19,19,14,5
Max Christie,G,22023,1631108,22300446,"DEC 31, 2023",LAL @ NOP,L,29,3,11,0.273,1,6,0.167,0,0,0.0,1,6,7,0,2,0,2,1,7,-8,1,LAL,NOP,LAL,109,,,14,14,7,7
Max Christie,G,22023,1631108,22300428,"DEC 28, 2023",LAL vs. CHA,W,24,3,4,0.75,2,3,0.667,2,2,1.0,0,7,7,3,1,2,1,2,10,18,1,LAL,LAL,CHA,133,,,20,17,13,10
Max Christie,G,22023,1631108,22300370,"DEC 20, 2023",LAL @ CHI,L,1,0,0,0.0,0,0,0.0,0,0,0.0,0,0,0,0,0,0,0,0,0,0,1,LAL,CHI,LAL,108,,,0,0,0,0
Max Christie,G,22023,1631108,22300316,"DEC 13, 2023",LAL @ SAS,W,14,1,5,0.2,1,4,0.25,0,0,0.0,0,5,5,2,0,0,2,0,3,8,1,LAL,SAS,LAL,122,,,10,8,5,7
Max Christie,G,22023,1631108,22300306,"DEC 12, 2023",LAL @ DAL,L,6,0,0,0.0,0,0,0.0,0,0,0.0,0,0,0,1,0,0,0,1,0,5,1,LAL,DAL,LAL,125,,,1,0,1,1
Max Christie,G,22023,1631108,22301230,"DEC 07, 2023",LAL vs. NOP,W,17,3,5,0.6,0,1,0.0,0,2,0.0,0,2,2,0,1,0,0,1,6,6,1,LAL,LAL,NOP,133,,,8,8,6,2
Max Christie,G,22023,1631108,22301203,"DEC 05, 2023",LAL vs. PHX,W,8,1,2,0.5,1,2,0.5,0,0,0.0,0,0,0,1,0,0,0,2,3,-2,1,LAL,LAL,PHX,106,,,4,3,4,1
Max Christie,G,22023,1631108,22300291,"DEC 02, 2023",LAL vs. HOU,W,29,4,7,0.571,3,3,1.0,1,2,0.5,0,7,7,2,0,0,0,3,12,19,1,LAL,LAL,HOU,107,,,21,19,14,9
Max Christie,G,22023,1631108,22300258,"NOV 29, 2023",LAL @ DET,W,22,0,3,0.0,0,2,0.0,5,5,1.0,0,2,2,2,0,1,2,1,5,13,1,LAL,DET,LAL,133,,,9,7,7,4
Max Christie,G,22023,1631108,22300255,"NOV 27, 2023",LAL @ PHI,L,26,3,6,0.5,0,3,0.0,0,0,0.0,0,3,3,1,1,0,1,3,6,-16,1,LAL,PHI,LAL,94,,,10,9,7,4
Max Christie,G,22023,1631108,22300242,"NOV 25, 2023",LAL @ CLE,W,33,5,7,0.714,2,4,0.5,0,0,0.0,1,4,5,3,0,0,1,3,12,6,1,LAL,CLE,LAL,121,,,20,17,15,8
Max Christie,G,22023,1631108,22300238,"NOV 22, 2023",LAL vs. DAL,L,23,3,7,0.429,1,4,0.25,0,0,0.0,0,2,2,0,0,0,0,0,7,-19,1,LAL,LAL,DAL,101,,,9,9,7,2
Max Christie,G,22023,1631108,22300042,"NOV 21, 2023",LAL vs. UTA,W,25,3,8,0.375,1,5,0.2,0,0,0.0,0,5,5,4,1,1,0,2,7,10,1,LAL,LAL,UTA,131,,,16,12,11,9
Max Christie,G,22023,1631108,22300036,"NOV 17, 2023",LAL @ POR,W,1,0,1,0.0,0,0,0.0,0,0,0.0,0,1,1,0,0,0,1,0,0,0,1,LAL,POR,LAL,107,,,1,1,0,1
Max Christie,G,22023,1631108,22300198,"NOV 15, 2023",LAL vs. SAC,L,1,0,1,0.0,0,0,0.0,0,0,0.0,0,1,1,0,0,0,1,0,0,-4,1,LAL,LAL,SAC,110,,,1,1,0,1
Max Christie,G,22023,1631108,22300026,"NOV 14, 2023",LAL vs. MEM,W,9,2,2,1.0,1,1,1.0,0,0,0.0,0,1,1,1,1,0,1,0,5,10,1,LAL,LAL,MEM,134,,,7,6,6,2
Max Christie,G,22023,1631108,22300187,"NOV 12, 2023",LAL vs. POR,W,13,0,1,0.0,0,0,0.0,0,0,0.0,1,2,3,0,1,0,1,0,0,0,1,LAL,LAL,POR,116,,,3,3,0,3
Max Christie,G,22023,1631108,22300150,"NOV 06, 2023",LAL @ MIA,L,15,2,3,0.667,0,1,0.0,0,0,0.0,0,1,1,1,0,0,1,2,4,-8,1,LAL,MIA,LAL,107,,,6,5,5,2
Max Christie,G,22023,1631108,22300127,"NOV 01, 2023",LAL vs. LAC,W,22,1,7,0.143,1,5,0.2,2,2,1.0,0,3,3,0,1,0,0,3,5,0,1,LAL,LAL,LAC,130,,,8,8,5,3
Max Christie,G,22023,1631108,22300061,"OCT 24, 2023",LAL @ DEN,L,1,0,0,0.0,0,0,0.0,0,0,0.0,0,0,0,0,0,0,0,0,0,0,1,LAL,DEN,LAL,107,,,0,0,0,0
JaVale McGee,C-F,22023,201580,22300746,"FEB 09, 2024",SAC vs. DEN,W,3,0,0,0.0,0,0,0.0,0,0,0.0,0,1,1,0,0,0,0,1,0,-2,1,SAC,SAC,DEN,135,,,1,1,0,1
JaVale McGee,C-F,22023,201580,22300714,"FEB 05, 2024",SAC @ CLE,L,6,0,2,0.0,0,1,0.0,0,0,0.0,0,2,2,0,0,0,0,1,0,-2,1,SAC,CLE,SAC,110,,,2,2,0,2
JaVale McGee,C-F,22023,201580,22300700,"FEB 03, 2024",SAC @ CHI,W,7,1,3,0.333,0,0,0.0,0,2,0.0,1,0,1,0,0,0,0,1,2,-1,1,SAC,CHI,SAC,123,,,3,3,2,1
JaVale McGee,C-F,22023,201580,22300678,"JAN 31, 2024",SAC @ MIA,L,6,2,3,0.667,0,0,0.0,0,1,0.0,2,2,4,0,0,0,0,0,4,-9,1,SAC,MIA,SAC,106,,,8,8,4,4
JaVale McGee,C-F,22023,201580,22300663,"JAN 29, 2024",SAC @ MEM,W,10,4,5,0.8,0,0,0.0,0,0,0.0,2,2,4,0,0,0,0,3,8,-1,1,SAC,MEM,SAC,103,,,12,12,8,4
JaVale McGee,C-F,22023,201580,22300651,"JAN 27, 2024",SAC @ DAL,W,10,3,4,0.75,0,0,0.0,0,0,0.0,0,2,2,0,1,0,0,0,6,12,1,SAC,DAL,SAC,120,,,8,8,6,2
JaVale McGee,C-F,22023,201580,22300613,"JAN 22, 2024",SAC vs. ATL,W,10,3,4,0.75,0,1,0.0,1,2,0.5,0,3,3,0,1,1,0,2,7,4,1,SAC,SAC,ATL,122,,,10,10,7,3
JaVale McGee,C-F,22023,201580,22300532,"JAN 12, 2024",SAC @ PHI,L,5,0,3,0.0,0,1,0.0,2,2,1.0,1,4,5,0,0,1,0,0,2,1,1,SAC,PHI,SAC,90,,,7,7,2,5
JaVale McGee,C-F,22023,201580,22300518,"JAN 10, 2024",SAC @ CHA,W,5,2,5,0.4,0,0,0.0,4,4,1.0,4,3,7,0,0,0,2,0,8,1,1,SAC,CHA,SAC,121,,,15,15,8,7
JaVale McGee,C-F,22023,201580,22300500,"JAN 07, 2024",SAC vs. NOP,L,6,0,1,0.0,0,0,0.0,0,0,0.0,0,1,1,1,0,0,1,0,0,-17,1,SAC,SAC,NOP,100,,,2,1,1,2
JaVale McGee,C-F,22023,201580,22300492,"JAN 05, 2024",SAC vs. TOR,W,7,2,3,0.667,0,0,0.0,2,2,1.0,0,2,2,1,0,0,0,0,6,-7,1,SAC,SAC,TOR,135,,,9,8,7,3
JaVale McGee,C-F,22023,201580,22300476,"JAN 03, 2024",SAC vs. ORL,W,8,2,2,1.0,0,0,0.0,1,3,0.333,0,2,2,0,1,0,0,2,5,-3,1,SAC,SAC,ORL,138,,,7,7,5,2
JaVale McGee,C-F,22023,201580,22300449,"DEC 31, 2023",SAC @ MEM,W,4,0,0,0.0,0,0,0.0,0,0,0.0,0,2,2,0,0,1,2,1,0,4,1,SAC,MEM,SAC,123,,,2,2,0,2
JaVale McGee,C-F,22023,201580,22300413,"DEC 26, 2023",SAC @ POR,L,5,2,2,1.0,0,0,0.0,0,0,0.0,1,0,1,1,0,0,1,1,4,-6,1,SAC,POR,SAC,113,,,6,5,5,2
JaVale McGee,C-F,22023,201580,22300400,"DEC 23, 2023",SAC vs. MIN,L,9,3,6,0.5,0,0,0.0,1,1,1.0,0,2,2,1,1,1,1,2,7,5,1,SAC,SAC,MIN,98,,,10,9,8,3
JaVale McGee,C-F,22023,201580,22300387,"DEC 22, 2023",SAC vs. PHX,W,10,1,2,0.5,0,0,0.0,3,4,0.75,0,1,1,0,0,0,1,3,5,-7,1,SAC,SAC,PHX,120,,,6,6,5,1
JaVale McGee,C-F,22023,201580,22300373,"DEC 20, 2023",SAC vs. BOS,L,12,2,3,0.667,0,0,0.0,0,2,0.0,0,3,3,1,0,4,1,0,4,3,1,SAC,SAC,BOS,119,,,8,7,5,4
JaVale McGee,C-F,22023,201580,22300342,"DEC 16, 2023",SAC vs. UTA,W,4,2,3,0.667,0,0,0.0,0,0,0.0,0,0,0,0,0,0,1,1,4,-4,1,SAC,SAC,UTA,125,,,4,4,4,0
JaVale McGee,C-F,22023,201580,22300324,"DEC 14, 2023",SAC vs. OKC,W,4,1,1,1.0,0,0,0.0,0,0,0.0,0,2,2,0,0,0,2,1,2,2,1,SAC,SAC,OKC,128,,,4,4,2,2
JaVale McGee,C-F,22023,201580,22300309,"DEC 12, 2023",SAC @ LAC,L,6,3,3,1.0,0,0,0.0,0,1,0.0,1,0,1,0,0,0,1,1,6,-8,1,SAC,LAC,SAC,99,,,7,7,6,1
JaVale McGee,C-F,22023,201580,22300303,"DEC 11, 2023",SAC vs. BKN,W,8,0,2,0.0,0,0,0.0,0,0,0.0,2,1,3,2,0,0,1,3,0,7,1,SAC,SAC,BKN,131,,,5,3,2,5
JaVale McGee,C-F,22023,201580,22301228,"DEC 08, 2023",SAC @ PHX,W,7,0,0,0.0,0,0,0.0,0,0,0.0,0,1,1,0,0,0,0,1,0,10,1,SAC,PHX,SAC,114,,,1,1,0,1
JaVale McGee,C-F,22023,201580,22301204,"DEC 04, 2023",SAC vs. NOP,L,4,0,1,0.0,0,0,0.0,0,0,0.0,0,1,1,0,1,0,0,0,0,-6,1,SAC,SAC,NOP,117,,,1,1,0,1
JaVale McGee,C-F,22023,201580,22300290,"DEC 02, 2023",SAC vs. DEN,W,12,4,4,1.0,0,0,0.0,0,0,0.0,1,3,4,0,0,3,0,3,8,14,1,SAC,SAC,DEN,123,,,12,12,8,4
JaVale McGee,C-F,22023,201580,22300264,"NOV 29, 2023",SAC vs. LAC,L,5,1,1,1.0,0,0,0.0,0,0,0.0,3,2,5,0,0,0,1,1,2,-1,1,SAC,SAC,LAC,117,,,7,7,2,5
JaVale McGee,C-F,22023,201580,22300060,"NOV 28, 2023",SAC vs. GSW,W,5,0,1,0.0,0,0,0.0,1,2,0.5,1,0,1,0,0,2,1,1,1,0,1,SAC,SAC,GSW,124,,,2,2,1,1
JaVale McGee,C-F,22023,201580,22300050,"NOV 24, 2023",SAC @ MIN,W,8,2,2,1.0,0,0,0.0,0,0,0.0,2,4,6,1,0,0,0,1,4,16,1,SAC,MIN,SAC,124,,,11,10,5,7
JaVale McGee,C-F,22023,201580,22300233,"NOV 22, 2023",SAC @ NOP,L,5,0,0,0.0,0,0,0.0,0,2,0.0,0,1,1,0,0,0,2,0,0,-16,1,SAC,NOP,SAC,112,,,1,1,0,1
JaVale McGee,C-F,22023,201580,22300222,"NOV 20, 2023",SAC @ NOP,L,13,4,6,0.667,0,0,0.0,2,4,0.5,2,5,7,1,0,2,3,3,10,-6,1,SAC,NOP,SAC,93,,,18,17,11,8
JaVale McGee,C-F,22023,201580,22300212,"NOV 19, 2023",SAC @ DAL,W,9,2,4,0.5,0,0,0.0,2,2,1.0,2,5,7,1,1,1,1,1,6,3,1,SAC,DAL,SAC,129,,,14,13,7,8
JaVale McGee,C-F,22023,201580,22300032,"NOV 17, 2023",SAC @ SAS,W,8,2,2,1.0,0,0,0.0,0,0,0.0,0,0,0,1,0,0,1,1,4,-1,1,SAC,SAS,SAC,129,,,5,4,5,1
JaVale McGee,C-F,22023,201580,22300198,"NOV 15, 2023",SAC @ LAL,W,9,3,3,1.0,0,0,0.0,1,2,0.5,2,4,6,1,2,0,2,3,7,-7,1,SAC,LAL,SAC,125,,,14,13,8,7
JaVale McGee,C-F,22023,201580,22300191,"NOV 13, 2023",SAC vs. CLE,W,7,1,2,0.5,0,0,0.0,0,0,0.0,1,3,4,1,0,0,0,1,2,2,1,SAC,SAC,CLE,132,,,7,6,3,5
JaVale McGee,C-F,22023,201580,22300153,"NOV 06, 2023",SAC @ HOU,L,10,4,5,0.8,0,0,0.0,2,2,1.0,3,0,3,0,0,0,2,4,10,-11,1,SAC,HOU,SAC,97,,,13,13,10,3
JaVale McGee,C-F,22023,201580,22300137,"NOV 04, 2023",SAC @ HOU,L,15,5,9,0.556,0,1,0.0,2,2,1.0,2,4,6,0,0,0,0,0,12,7,1,SAC,HOU,SAC,89,,,18,18,12,6
JaVale McGee,C-F,22023,201580,22300126,"NOV 01, 2023",SAC @ GSW,L,10,3,7,0.429,0,0,0.0,0,0,0.0,2,4,6,0,0,1,1,0,6,3,1,SAC,GSW,SAC,101,,,12,12,6,6
JaVale McGee,C-F,22023,201580,22300100,"OCT 29, 2023",SAC vs. LAL,W,15,2,2,1.0,0,0,0.0,0,0,0.0,0,0,0,0,1,1,1,1,4,4,1,SAC,SAC,LAL,132,,,4,4,4,0
JaVale McGee,C-F,22023,201580,22300087,"OCT 27, 2023",SAC vs. GSW,L,12,3,6,0.5,0,0,0.0,1,3,0.333,2,2,4,0,0,0,2,0,7,1,1,SAC,SAC,GSW,114,,,11,11,7,4
JaVale McGee,C-F,22023,201580,22300072,"OCT 25, 2023",SAC @ UTA,W,13,4,4,1.0,0,0,0.0,0,0,0.0,0,1,1,1,0,1,0,0,8,13,1,SAC,UTA,SAC,130,,,10,9,9,2
Jared Butler,G,22023,1630215,22300494,"JAN 06, 2024",WAS vs. NYK,L,3,3,3,1.0,2,2,1.0,0,0,0.0,0,0,0,2,0,0,0,0,8,5,1,WAS,WAS,NYK,105,,,10,8,10,2
Jared Butler,G,22023,1630215,22300482,"JAN 05, 2024",WAS @ CLE,L,5,1,2,0.5,0,0,0.0,0,0,0.0,0,0,0,2,0,1,0,0,2,-1,1,WAS,CLE,WAS,90,,,4,2,4,2
Jared Butler,G,22023,1630215,22300465,"JAN 03, 2024",WAS @ CLE,L,9,2,2,1.0,1,1,1.0,0,0,0.0,0,1,1,1,0,0,0,0,5,-6,1,WAS,CLE,WAS,101,,,7,6,6,2
Jared Butler,G,22023,1630215,22300386,"DEC 22, 2023",WAS @ GSW,L,7,3,5,0.6,1,3,0.333,1,2,0.5,0,1,1,4,1,0,0,0,8,10,1,WAS,GSW,WAS,118,,,13,9,12,5
Jared Butler,G,22023,1630215,22300358,"DEC 18, 2023",WAS @ SAC,L,5,3,4,0.75,1,2,0.5,1,1,1.0,0,1,1,0,0,0,0,0,8,6,1,WAS,SAC,WAS,131,,,9,9,8,1
Jared Butler,G,22023,1630215,22300328,"DEC 15, 2023",WAS vs. IND,W,3,1,1,1.0,0,0,0.0,0,0,0.0,0,0,0,1,0,0,1,0,2,-8,1,WAS,WAS,IND,137,,,3,2,3,1
Jared Butler,G,22023,1630215,22300311,"DEC 13, 2023",WAS vs. NOP,L,13,2,4,0.5,2,4,0.5,2,2,1.0,0,1,1,4,1,0,1,1,8,-4,1,WAS,WAS,NOP,122,,,13,9,12,5
Jared Butler,G,22023,1630215,22300295,"DEC 11, 2023",WAS @ PHI,L,19,5,7,0.714,0,0,0.0,2,3,0.667,0,0,0,4,2,0,1,2,12,-15,1,WAS,PHI,WAS,99,,,16,12,16,4
Jared Butler,G,22023,1630215,22301219,"DEC 08, 2023",WAS @ BKN,L,14,1,4,0.25,0,2,0.0,3,4,0.75,0,3,3,0,0,0,3,1,5,-3,1,WAS,BKN,WAS,97,,,8,8,5,3
Jared Butler,G,22023,1630215,22301208,"DEC 06, 2023",WAS vs. PHI,L,14,0,3,0.0,0,1,0.0,0,0,0.0,0,1,1,4,0,0,1,5,0,4,1,WAS,WAS,PHI,126,,,5,1,4,5
Jared Butler,G,22023,1630215,22300259,"NOV 29, 2023",WAS @ ORL,L,5,1,2,0.5,0,1,0.0,2,2,1.0,0,0,0,3,2,0,0,0,4,1,1,WAS,ORL,WAS,120,,,7,4,7,3
Jared Butler,G,22023,1630215,22300253,"NOV 27, 2023",WAS @ DET,W,2,0,1,0.0,0,1,0.0,0,0,0.0,0,1,1,0,0,0,0,1,0,0,1,WAS,DET,WAS,126,,,1,1,0,1
Jared Butler,G,22023,1630215,22300241,"NOV 25, 2023",WAS vs. ATL,L,16,5,8,0.625,2,4,0.5,1,1,1.0,0,2,2,5,2,1,2,4,13,-5,1,WAS,WAS,ATL,108,,,20,15,18,7
Jared Butler,G,22023,1630215,22300219,"NOV 20, 2023",WAS vs. MIL,L,1,0,0,0.0,0,0,0.0,0,0,0.0,0,0,0,0,0,0,0,0,0,2,1,WAS,WAS,MIL,129,,,0,0,0,0
Jared Butler,G,22023,1630215,22300028,"NOV 17, 2023",WAS vs. NYK,L,2,0,0,0.0,0,0,0.0,0,0,0.0,0,0,0,0,0,0,0,0,0,-1,1,WAS,WAS,NYK,99,,,0,0,0,0
Jared Butler,G,22023,1630215,22300103,"OCT 30, 2023",WAS vs. BOS,L,6,0,2,0.0,0,2,0.0,0,0,0.0,0,0,0,1,0,0,1,0,0,4,1,WAS,WAS,BOS,107,,,1,0,1,1
Jared Butler,G,22023,1630215,22300064,"OCT 25, 2023",WAS @ IND,L,3,1,2,0.5,1,1,1.0,0,0,0.0,0,0,0,0,0,0,0,0,3,2,1,WAS,IND,WAS,120,,,3,3,3,0
Jae'Sean Tate,F,22023,1630256,22300754,"FEB 10, 2024",HOU @ ATL,L,9,1,2,0.5,0,0,0.0,0,0,0.0,1,1,2,0,0,0,0,2,2,4,1,HOU,ATL,HOU,113,,,4,4,2,2
Jae'Sean Tate,F,22023,1630256,22300744,"FEB 09, 2024",HOU @ TOR,L,15,2,3,0.667,0,1,0.0,0,0,0.0,1,2,3,1,1,0,0,1,4,10,1,HOU,TOR,HOU,104,,,8,7,5,4
Jae'Sean Tate,F,22023,1630256,22300719,"FEB 06, 2024",HOU @ IND,L,14,1,2,0.5,1,1,1.0,0,0,0.0,2,3,5,0,1,0,0,2,3,-5,1,HOU,IND,HOU,129,,,8,8,3,5
Jae'Sean Tate,F,22023,1630256,22300709,"FEB 04, 2024",HOU @ MIN,L,10,1,3,0.333,0,0,0.0,0,0,0.0,1,3,4,1,0,0,0,3,2,-6,1,HOU,MIN,HOU,90,,,7,6,3,5
Jae'Sean Tate,F,22023,1630256,22300692,"FEB 02, 2024",HOU vs. TOR,W,17,1,2,0.5,0,0,0.0,0,0,0.0,0,1,1,3,1,0,0,2,2,14,1,HOU,HOU,TOR,135,,,6,3,5,4
Jae'Sean Tate,F,22023,1630256,22300679,"JAN 31, 2024",HOU vs. NOP,L,7,1,2,0.5,0,0,0.0,0,0,0.0,0,1,1,2,1,0,0,0,2,-10,1,HOU,HOU,NOP,99,,,5,3,4,3
Jae'Sean Tate,F,22023,1630256,22300662,"JAN 29, 2024",HOU vs. LAL,W,19,3,7,0.429,1,2,0.5,0,0,0.0,0,1,1,0,0,0,1,2,7,14,1,HOU,HOU,LAL,135,,,8,8,7,1
Jae'Sean Tate,F,22023,1630256,22300645,"JAN 27, 2024",HOU @ BKN,L,17,3,5,0.6,0,1,0.0,0,0,0.0,1,4,5,2,0,0,1,5,6,3,1,HOU,BKN,HOU,104,,,13,11,8,7
Jae'Sean Tate,F,22023,1630256,22300635,"JAN 26, 2024",HOU @ CHA,W,11,1,3,0.333,0,1,0.0,0,0,0.0,0,1,1,0,0,0,1,1,2,13,1,HOU,CHA,HOU,138,,,3,3,2,1
Jae'Sean Tate,F,22023,1630256,22300603,"JAN 21, 2024",HOU vs. BOS,L,15,1,2,0.5,0,0,0.0,0,0,0.0,0,0,0,0,0,2,0,1,2,-2,1,HOU,HOU,BOS,107,,,2,2,2,0
Jae'Sean Tate,F,22023,1630256,22300598,"JAN 20, 2024",HOU vs. UTA,W,14,1,4,0.25,0,1,0.0,0,0,0.0,3,0,3,3,1,1,0,2,2,8,1,HOU,HOU,UTA,127,,,8,5,5,6
Jae'Sean Tate,F,22023,1630256,22300573,"JAN 17, 2024",HOU @ NYK,L,14,1,2,0.5,0,1,0.0,0,0,0.0,0,2,2,2,0,0,0,0,2,1,1,HOU,NYK,HOU,94,,,6,4,4,4
Jae'Sean Tate,F,22023,1630256,22300555,"JAN 15, 2024",HOU @ PHI,L,13,1,4,0.25,0,3,0.0,0,0,0.0,1,3,4,2,0,0,0,4,2,5,1,HOU,PHI,HOU,115,,,8,6,4,6
Jae'Sean Tate,F,22023,1630256,22300542,"JAN 13, 2024",HOU @ BOS,L,9,0,0,0.0,0,0,0.0,0,0,0.0,0,0,0,0,1,0,1,1,0,-13,1,HOU,BOS,HOU,113,,,0,0,0,0
Jae'Sean Tate,F,22023,1630256,22300409,"DEC 26, 2023",HOU vs. IND,L,14,2,3,0.667,0,0,0.0,1,2,0.5,0,1,1,0,1,0,0,1,5,4,1,HOU,HOU,IND,117,,,6,6,5,1
Jae'Sean Tate,F,22023,1630256,22300392,"DEC 23, 2023",HOU @ NOP,W,11,1,4,0.25,0,2,0.0,0,0,0.0,2,3,5,0,0,0,0,2,2,1,1,HOU,NOP,HOU,106,,,7,7,2,5
Jae'Sean Tate,F,22023,1630256,22300385,"DEC 22, 2023",HOU vs. DAL,W,18,1,2,0.5,0,1,0.0,0,0,0.0,1,7,8,1,0,0,3,4,2,-4,1,HOU,HOU,DAL,122,,,11,10,3,9
Jae'Sean Tate,F,22023,1630256,22300371,"DEC 20, 2023",HOU vs. ATL,L,19,0,3,0.0,0,1,0.0,0,0,0.0,0,0,0,1,0,0,0,3,0,-2,1,HOU,HOU,ATL,127,,,1,0,1,1
Jae'Sean Tate,F,22023,1630256,22300349,"DEC 18, 2023",HOU @ CLE,L,16,1,4,0.25,0,0,0.0,1,1,1.0,2,1,3,1,0,0,0,2,3,-5,1,HOU,CLE,HOU,130,,,7,6,4,4
Jae'Sean Tate,F,22023,1630256,22300346,"DEC 17, 2023",HOU @ MIL,L,19,0,2,0.0,0,0,0.0,0,0,0.0,2,1,3,1,1,0,2,2,0,4,1,HOU,MIL,HOU,119,,,4,3,1,4
Jae'Sean Tate,F,22023,1630256,22300314,"DEC 13, 2023",HOU vs. MEM,W,23,4,9,0.444,1,4,0.25,1,3,0.333,3,4,7,3,1,0,0,1,10,-4,1,HOU,HOU,MEM,117,,,20,17,13,10
Jae'Sean Tate,F,22023,1630256,22300298,"DEC 11, 2023",HOU vs. SAS,W,9,2,2,1.0,1,1,1.0,0,0,0.0,1,1,2,0,0,0,1,0,5,1,1,HOU,HOU,SAS,93,,,7,7,5,2
Jae'Sean Tate,F,22023,1630256,22301224,"DEC 08, 2023",HOU @ DEN,W,13,2,3,0.667,1,2,0.5,0,0,0.0,0,2,2,0,0,0,0,2,5,2,1,HOU,DEN,HOU,114,,,7,7,5,2
Jae'Sean Tate,F,22023,1630256,22301212,"DEC 06, 2023",HOU vs. OKC,W,14,0,2,0.0,0,1,0.0,0,0,0.0,0,1,1,0,0,0,2,1,0,3,1,HOU,HOU,OKC,110,,,1,1,0,1
Jae'Sean Tate,F,22023,1630256,22300291,"DEC 02, 2023",HOU @ LAL,L,14,1,2,0.5,0,0,0.0,0,0,0.0,0,2,2,0,0,0,0,2,2,-8,1,HOU,LAL,HOU,97,,,4,4,2,2
Jae'Sean Tate,F,22023,1630256,22300059,"NOV 28, 2023",HOU @ DAL,L,11,1,2,0.5,0,1,0.0,3,3,1.0,1,1,2,2,1,0,0,2,5,-3,1,HOU,DAL,HOU,115,,,9,7,7,4
Jae'Sean Tate,F,22023,1630256,22300048,"NOV 24, 2023",HOU vs. DEN,W,16,2,4,0.5,0,1,0.0,0,0,0.0,0,3,3,0,0,1,1,4,4,6,1,HOU,HOU,DEN,105,,,7,7,4,3
Jae'Sean Tate,F,22023,1630256,22300231,"NOV 22, 2023",HOU vs. MEM,W,26,1,4,0.25,0,3,0.0,0,0,0.0,1,8,9,4,1,0,0,4,2,26,1,HOU,HOU,MEM,111,,,15,11,6,13
Jae'Sean Tate,F,22023,1630256,22300224,"NOV 20, 2023",HOU @ GSW,L,21,4,7,0.571,1,2,0.5,0,0,0.0,2,1,3,1,0,0,1,3,9,-7,1,HOU,GSW,HOU,116,,,13,12,10,4
Jae'Sean Tate,F,22023,1630256,22300216,"NOV 19, 2023",HOU @ LAL,L,16,2,3,0.667,0,0,0.0,0,0,0.0,1,2,3,2,1,0,0,1,4,6,1,HOU,LAL,HOU,104,,,9,7,6,5
Jae'Sean Tate,F,22023,1630256,22300037,"NOV 17, 2023",HOU @ LAC,L,9,3,5,0.6,0,1,0.0,0,0,0.0,3,1,4,0,0,0,1,5,6,-9,1,HOU,LAC,HOU,100,,,10,10,6,4
Jae'Sean Tate,F,22023,1630256,22300182,"NOV 12, 2023",HOU vs. DEN,W,20,1,3,0.333,0,0,0.0,1,2,0.5,3,3,6,0,3,0,0,2,3,2,1,HOU,HOU,DEN,107,,,9,9,3,6
Jae'Sean Tate,F,22023,1630256,22300011,"NOV 10, 2023",HOU vs. NOP,W,24,3,7,0.429,1,4,0.25,0,0,0.0,0,3,3,2,3,0,0,4,7,1,1,HOU,HOU,NOP,104,,,12,10,9,5
Jae'Sean Tate,F,22023,1630256,22300163,"NOV 08, 2023",HOU vs. LAL,W,27,6,10,0.6,2,6,0.333,0,0,0.0,1,0,1,1,0,2,0,3,14,16,1,HOU,HOU,LAL,128,,,16,15,15,2
Jae'Sean Tate,F,22023,1630256,22300153,"NOV 06, 2023",HOU vs. SAC,W,21,3,5,0.6,2,4,0.5,0,0,0.0,1,3,4,1,2,0,0,2,8,28,1,HOU,HOU,SAC,122,,,13,12,9,5
Jae'Sean Tate,F,22023,1630256,22300137,"NOV 04, 2023",HOU vs. SAC,W,21,4,6,0.667,3,3,1.0,0,0,0.0,0,4,4,1,0,0,0,4,11,4,1,HOU,HOU,SAC,107,,,16,15,12,5
Jae'Sean Tate,F,22023,1630256,22300122,"NOV 01, 2023",HOU vs. CHA,W,19,1,5,0.2,1,2,0.5,1,2,0.5,1,5,6,5,0,0,0,4,4,17,1,HOU,HOU,CHA,128,,,15,10,9,11
Jae'Sean Tate,F,22023,1630256,22300096,"OCT 29, 2023",HOU vs. GSW,L,22,2,6,0.333,0,2,0.0,2,2,1.0,2,6,8,1,2,2,1,2,6,-24,1,HOU,HOU,GSW,95,,,15,14,7,9
Jae'Sean Tate,F,22023,1630256,22300083,"OCT 27, 2023",HOU @ SAS,L,14,1,2,0.5,0,1,0.0,1,1,1.0,0,0,0,0,3,0,1,1,3,-8,1,HOU,SAS,HOU,122,,,3,3,3,0
Jae'Sean Tate,F,22023,1630256,22300066,"OCT 25, 2023",HOU @ ORL,L,15,2,2,1.0,1,1,1.0,0,0,0.0,0,2,2,0,1,1,0,1,5,-11,1,HOU,ORL,HOU,86,,,7,7,5,2
Jae'Sean Tate,F,22023,1630256,22300534,"JAN 12, 2024",HOU @ DET,W,20,1,2,0.5,0,0,0.0,0,0,0.0,2,5,7,1,0,0,1,1,2,-1,1,HOU,DET,HOU,112,,,10,9,3,8
Jae'Sean Tate,F,22023,1630256,22300485,"JAN 05, 2024",HOU vs. MIN,L,21,0,1,0.0,0,1,0.0,0,0,0.0,0,3,3,2,1,0,0,1,0,-13,1,HOU,HOU,MIN,95,,,5,3,2,5
Jae'Sean Tate,F,22023,1630256,22300469,"JAN 03, 2024",HOU vs. BKN,W,31,2,2,1.0,2,2,1.0,2,2,1.0,0,4,4,3,0,0,1,4,8,17,1,HOU,HOU,BKN,112,,,15,12,11,7
Jae'Sean Tate,F,22023,1630256,22300453,"JAN 01, 2024",HOU vs. DET,W,26,6,10,0.6,0,2,0.0,4,6,0.667,0,3,3,0,1,0,1,6,16,15,1,HOU,HOU,DET,136,,,19,19,16,3
Jae'Sean Tate,F,22023,1630256,22300418,"DEC 27, 2023",HOU vs. PHX,L,24,3,3,1.0,1,1,1.0,0,0,0.0,1,1,2,1,1,0,0,3,7,-4,1,HOU,HOU,PHX,113,,,10,9,8,3
Jae'Sean Tate,F,22023,1630256,22300434,"DEC 29, 2023",HOU vs. PHI,L,35,2,4,0.5,0,1,0.0,0,0,0.0,1,4,5,2,0,0,0,3,4,4,1,HOU,HOU,PHI,127,,,11,9,6,7
Jae'Sean Tate,F,22023,1630256,22300523,"JAN 10, 2024",HOU @ CHI,L,18,1,3,0.333,0,2,0.0,1,2,0.5,1,1,2,0,0,0,0,1,3,-13,1,HOU,CHI,HOU,119,,,5,5,3,2
Jae'Sean Tate,F,22023,1630256,22300509,"JAN 08, 2024",HOU @ MIA,L,34,3,8,0.375,1,4,0.25,2,2,1.0,3,1,4,1,2,0,0,5,9,-4,1,HOU,MIA,HOU,113,,,14,13,10,5
Jae'Sean Tate,F,22023,1630256,22300496,"JAN 06, 2024",HOU vs. MIL,W,19,2,3,0.667,0,0,0.0,0,0,0.0,3,5,8,0,1,0,0,4,4,3,1,HOU,HOU,MIL,112,,,12,12,4,8
Robert Covington,F,22023,203496,22300442,"DEC 30, 2023",PHI @ CHI,L,5,0,1,0.0,0,1,0.0,0,0,0.0,0,1,1,0,0,0,0,0,0,1,1,PHI,CHI,PHI,92,,,1,1,0,1
Robert Covington,F,22023,203496,22300434,"DEC 29, 2023",PHI @ HOU,W,16,3,5,0.6,0,1,0.0,1,1,1.0,2,2,4,0,3,0,0,4,7,3,1,PHI,HOU,PHI,131,,,11,11,7,4
Robert Covington,F,22023,203496,22300415,"DEC 27, 2023",PHI @ ORL,W,11,1,2,0.5,0,1,0.0,0,1,0.0,0,1,1,2,2,0,1,2,2,0,1,PHI,ORL,PHI,112,,,5,3,4,3
Robert Covington,F,22023,203496,22300335,"DEC 16, 2023",PHI @ CHA,W,14,0,0,0.0,0,0,0.0,0,0,0.0,0,3,3,0,0,1,1,2,0,9,1,PHI,CHA,PHI,135,,,3,3,0,3
Robert Covington,F,22023,203496,22300327,"DEC 15, 2023",PHI vs. DET,W,13,0,2,0.0,0,1,0.0,0,0,0.0,1,2,3,0,1,0,1,0,0,10,1,PHI,PHI,DET,124,,,3,3,0,3
Robert Covington,F,22023,203496,22300310,"DEC 13, 2023",PHI @ DET,W,17,2,4,0.5,0,2,0.0,1,1,1.0,0,6,6,2,0,0,1,2,5,1,1,PHI,DET,PHI,129,,,13,11,7,8
Robert Covington,F,22023,203496,22300295,"DEC 11, 2023",PHI vs. WAS,W,14,2,3,0.667,2,3,0.667,2,2,1.0,1,3,4,0,1,0,0,1,8,18,1,PHI,PHI,WAS,146,,,12,12,8,4
Robert Covington,F,22023,203496,22300275,"DEC 01, 2023",PHI @ BOS,L,30,4,9,0.444,3,6,0.5,7,7,1.0,3,2,5,1,5,1,2,4,18,-9,1,PHI,BOS,PHI,119,,,24,23,19,6
Robert Covington,F,22023,203496,22300262,"NOV 29, 2023",PHI @ NOP,L,30,4,5,0.8,4,4,1.0,0,0,0.0,2,5,7,1,0,1,0,3,12,11,1,PHI,NOP,PHI,114,,,20,19,13,8
Robert Covington,F,22023,203496,22300255,"NOV 27, 2023",PHI vs. LAL,W,18,0,3,0.0,0,2,0.0,0,0,0.0,3,4,7,2,0,1,0,1,0,14,1,PHI,PHI,LAL,138,,,9,7,2,9
Robert Covington,F,22023,203496,22300232,"NOV 22, 2023",PHI @ MIN,L,20,2,4,0.5,0,1,0.0,1,2,0.5,1,5,6,0,0,2,0,2,5,6,1,PHI,MIN,PHI,99,,,11,11,5,6
Robert Covington,F,22023,203496,22300208,"NOV 19, 2023",PHI @ BKN,W,11,2,2,1.0,0,0,0.0,0,0,0.0,0,2,2,0,1,1,0,1,4,3,1,PHI,BKN,PHI,121,,,6,6,4,2
Robert Covington,F,22023,203496,22300148,"NOV 06, 2023",PHI vs. WAS,W,4,2,2,1.0,1,1,1.0,2,2,1.0,0,0,0,0,3,1,0,2,7,0,1,PHI,PHI,WAS,146,,,7,7,7,0
Robert Covington,F,22023,203496,22300132,"NOV 04, 2023",PHI vs. PHX,W,18,0,3,0.0,0,3,0.0,2,2,1.0,1,3,4,0,2,1,2,3,2,8,1,PHI,PHI,PHX,112,,,6,6,2,4
Robert Covington,F,22023,203496,22300128,"NOV 02, 2023",PHI vs. TOR,W,1,0,0,0.0,0,0,0.0,0,0,0.0,0,0,0,0,0,0,0,0,0,-2,1,PHI,PHI,TOR,114,,,0,0,0,0
Robert Covington,F,22023,203496,22300351,"DEC 18, 2023",PHI vs. CHI,L,15,1,3,0.333,0,0,0.0,0,0,0.0,1,1,2,0,2,1,0,2,2,-15,1,PHI,PHI,CHI,104,,,4,4,2,2
Robert Covington,F,22023,203496,22301208,"DEC 06, 2023",PHI @ WAS,W,4,0,0,0.0,0,0,0.0,0,0,0.0,0,1,1,0,0,0,1,1,0,-3,1,PHI,WAS,PHI,131,,,1,1,0,1
Robert Covington,F,22023,203496,22300239,"NOV 25, 2023",PHI @ OKC,W,21,3,5,0.6,2,3,0.667,1,2,0.5,0,1,1,0,1,1,0,5,9,-8,1,PHI,OKC,PHI,127,,,10,10,9,1
Robert Covington,F,22023,203496,22300040,"NOV 21, 2023",PHI vs. CLE,L,14,1,3,0.333,1,2,0.5,0,0,0.0,3,4,7,1,2,2,1,0,3,-3,1,PHI,PHI,CLE,119,,,11,10,4,8
Robert Covington,F,22023,203496,22300180,"NOV 12, 2023",PHI vs. IND,W,16,1,5,0.2,0,2,0.0,0,0,0.0,2,3,5,2,0,0,0,1,2,-1,1,PHI,PHI,IND,137,,,9,7,4,7
Robert Covington,F,22023,203496,22300008,"NOV 10, 2023",PHI @ DET,W,14,1,3,0.333,1,3,0.333,0,0,0.0,0,0,0,0,4,0,0,0,3,3,1,PHI,DET,PHI,114,,,3,3,3,0
Robert Covington,F,22023,203496,22300159,"NOV 08, 2023",PHI vs. BOS,W,15,2,4,0.5,1,2,0.5,0,0,0.0,2,1,3,0,2,0,0,2,5,6,1,PHI,PHI,BOS,106,,,8,8,5,3
Robert Covington,F,22023,203496,22300099,"OCT 29, 2023",LAC vs. SAS,W,26,0,1,0.0,0,1,0.0,0,0,0.0,1,2,3,3,1,1,0,1,0,25,1,LAC,LAC,SAS,123,,,6,3,3,6
Robert Covington,F,22023,203496,22300085,"OCT 27, 2023",LAC @ UTA,L,20,1,3,0.333,1,3,0.333,1,2,0.5,0,1,1,2,2,0,0,4,4,-6,1,LAC,UTA,LAC,118,,,7,5,6,3
Robert Covington,F,22023,203496,22300074,"OCT 25, 2023",LAC vs. POR,W,23,2,5,0.4,1,4,0.25,0,0,0.0,1,3,4,2,3,1,0,2,5,26,1,LAC,LAC,POR,123,,,11,9,7,6
Robert Covington,F,22023,203496,22300029,"NOV 17, 2023",PHI @ ATL,W,20,2,4,0.5,2,2,1.0,0,0,0.0,4,3,7,3,1,1,1,4,6,3,1,PHI,ATL,PHI,126,,,16,13,9,10
Robert Covington,F,22023,203496,22300194,"NOV 15, 2023",PHI vs. BOS,L,37,6,13,0.462,0,5,0.0,4,4,1.0,3,3,6,0,2,0,0,1,16,-10,1,PHI,PHI,BOS,107,,,22,22,16,6
Robert Covington,F,22023,203496,22300019,"NOV 14, 2023",PHI vs. IND,L,16,1,3,0.333,0,2,0.0,0,0,0.0,0,1,1,1,0,1,0,2,2,-1,1,PHI,PHI,IND,126,,,4,3,3,2
Robert Covington,F,22023,203496,22300382,"DEC 22, 2023",PHI vs. TOR,W,24,0,1,0.0,0,1,0.0,0,0,0.0,0,3,3,2,1,1,0,4,0,15,1,PHI,PHI,TOR,121,,,5,3,2,5
Robert Covington,F,22023,203496,22300442,"DEC 30, 2023",PHI @ CHI,L,5,0,1,0.0,0,1,0.0,0,0,0.0,0,1,1,0,0,0,0,0,0,1,1,PHI,CHI,PHI,92,,,1,1,0,1
Robert Covington,F,22023,203496,22300434,"DEC 29, 2023",PHI @ HOU,W,16,3,5,0.6,0,1,0.0,1,1,1.0,2,2,4,0,3,0,0,4,7,3,1,PHI,HOU,PHI,131,,,11,11,7,4
Robert Covington,F,22023,203496,22300415,"DEC 27, 2023",PHI @ ORL,W,11,1,2,0.5,0,1,0.0,0,1,0.0,0,1,1,2,2,0,1,2,2,0,1,PHI,ORL,PHI,112,,,5,3,4,3
Robert Covington,F,22023,203496,22300335,"DEC 16, 2023",PHI @ CHA,W,14,0,0,0.0,0,0,0.0,0,0,0.0,0,3,3,0,0,1,1,2,0,9,1,PHI,CHA,PHI,135,,,3,3,0,3
Robert Covington,F,22023,203496,22300327,"DEC 15, 2023",PHI vs. DET,W,13,0,2,0.0,0,1,0.0,0,0,0.0,1,2,3,0,1,0,1,0,0,10,1,PHI,PHI,DET,124,,,3,3,0,3
Robert Covington,F,22023,203496,22300310,"DEC 13, 2023",PHI @ DET,W,17,2,4,0.5,0,2,0.0,1,1,1.0,0,6,6,2,0,0,1,2,5,1,1,PHI,DET,PHI,129,,,13,11,7,8
Robert Covington,F,22023,203496,22300295,"DEC 11, 2023",PHI vs. WAS,W,14,2,3,0.667,2,3,0.667,2,2,1.0,1,3,4,0,1,0,0,1,8,18,1,PHI,PHI,WAS,146,,,12,12,8,4
Robert Covington,F,22023,203496,22300275,"DEC 01, 2023",PHI @ BOS,L,30,4,9,0.444,3,6,0.5,7,7,1.0,3,2,5,1,5,1,2,4,18,-9,1,PHI,BOS,PHI,119,,,24,23,19,6
Robert Covington,F,22023,203496,22300262,"NOV 29, 2023",PHI @ NOP,L,30,4,5,0.8,4,4,1.0,0,0,0.0,2,5,7,1,0,1,0,3,12,11,1,PHI,NOP,PHI,114,,,20,19,13,8
Robert Covington,F,22023,203496,22300255,"NOV 27, 2023",PHI vs. LAL,W,18,0,3,0.0,0,2,0.0,0,0,0.0,3,4,7,2,0,1,0,1,0,14,1,PHI,PHI,LAL,138,,,9,7,2,9
Robert Covington,F,22023,203496,22300232,"NOV 22, 2023",PHI @ MIN,L,20,2,4,0.5,0,1,0.0,1,2,0.5,1,5,6,0,0,2,0,2,5,6,1,PHI,MIN,PHI,99,,,11,11,5,6
Robert Covington,F,22023,203496,22300208,"NOV 19, 2023",PHI @ BKN,W,11,2,2,1.0,0,0,0.0,0,0,0.0,0,2,2,0,1,1,0,1,4,3,1,PHI,BKN,PHI,121,,,6,6,4,2
Robert Covington,F,22023,203496,22300148,"NOV 06, 2023",PHI vs. WAS,W,4,2,2,1.0,1,1,1.0,2,2,1.0,0,0,0,0,3,1,0,2,7,0,1,PHI,PHI,WAS,146,,,7,7,7,0
Robert Covington,F,22023,203496,22300132,"NOV 04, 2023",PHI vs. PHX,W,18,0,3,0.0,0,3,0.0,2,2,1.0,1,3,4,0,2,1,2,3,2,8,1,PHI,PHI,PHX,112,,,6,6,2,4
Robert Covington,F,22023,203496,22300128,"NOV 02, 2023",PHI vs. TOR,W,1,0,0,0.0,0,0,0.0,0,0,0.0,0,0,0,0,0,0,0,0,0,-2,1,PHI,PHI,TOR,114,,,0,0,0,0
Robert Covington,F,22023,203496,22300351,"DEC 18, 2023",PHI vs. CHI,L,15,1,3,0.333,0,0,0.0,0,0,0.0,1,1,2,0,2,1,0,2,2,-15,1,PHI,PHI,CHI,104,,,4,4,2,2
Robert Covington,F,22023,203496,22301208,"DEC 06, 2023",PHI @ WAS,W,4,0,0,0.0,0,0,0.0,0,0,0.0,0,1,1,0,0,0,1,1,0,-3,1,PHI,WAS,PHI,131,,,1,1,0,1
Robert Covington,F,22023,203496,22300239,"NOV 25, 2023",PHI @ OKC,W,21,3,5,0.6,2,3,0.667,1,2,0.5,0,1,1,0,1,1,0,5,9,-8,1,PHI,OKC,PHI,127,,,10,10,9,1
Robert Covington,F,22023,203496,22300040,"NOV 21, 2023",PHI vs. CLE,L,14,1,3,0.333,1,2,0.5,0,0,0.0,3,4,7,1,2,2,1,0,3,-3,1,PHI,PHI,CLE,119,,,11,10,4,8
Robert Covington,F,22023,203496,22300180,"NOV 12, 2023",PHI vs. IND,W,16,1,5,0.2,0,2,0.0,0,0,0.0,2,3,5,2,0,0,0,1,2,-1,1,PHI,PHI,IND,137,,,9,7,4,7
Robert Covington,F,22023,203496,22300008,"NOV 10, 2023",PHI @ DET,W,14,1,3,0.333,1,3,0.333,0,0,0.0,0,0,0,0,4,0,0,0,3,3,1,PHI,DET,PHI,114,,,3,3,3,0
Robert Covington,F,22023,203496,22300159,"NOV 08, 2023",PHI vs. BOS,W,15,2,4,0.5,1,2,0.5,0,0,0.0,2,1,3,0,2,0,0,2,5,6,1,PHI,PHI,BOS,106,,,8,8,5,3
Robert Covington,F,22023,203496,22300099,"OCT 29, 2023",LAC vs. SAS,W,26,0,1,0.0,0,1,0.0,0,0,0.0,1,2,3,3,1,1,0,1,0,25,1,LAC,LAC,SAS,123,,,6,3,3,6
Robert Covington,F,22023,203496,22300085,"OCT 27, 2023",LAC @ UTA,L,20,1,3,0.333,1,3,0.333,1,2,0.5,0,1,1,2,2,0,0,4,4,-6,1,LAC,UTA,LAC,118,,,7,5,6,3
Robert Covington,F,22023,203496,22300074,"OCT 25, 2023",LAC vs. POR,W,23,2,5,0.4,1,4,0.25,0,0,0.0,1,3,4,2,3,1,0,2,5,26,1,LAC,LAC,POR,123,,,11,9,7,6
Robert Covington,F,22023,203496,22300029,"NOV 17, 2023",PHI @ ATL,W,20,2,4,0.5,2,2,1.0,0,0,0.0,4,3,7,3,1,1,1,4,6,3,1,PHI,ATL,PHI,126,,,16,13,9,10
Robert Covington,F,22023,203496,22300194,"NOV 15, 2023",PHI vs. BOS,L,37,6,13,0.462,0,5,0.0,4,4,1.0,3,3,6,0,2,0,0,1,16,-10,1,PHI,PHI,BOS,107,,,22,22,16,6
Robert Covington,F,22023,203496,22300019,"NOV 14, 2023",PHI vs. IND,L,16,1,3,0.333,0,2,0.0,0,0,0.0,0,1,1,1,0,1,0,2,2,-1,1,PHI,PHI,IND,126,,,4,3,3,2
Robert Covington,F,22023,203496,22300382,"DEC 22, 2023",PHI vs. TOR,W,24,0,1,0.0,0,1,0.0,0,0,0.0,0,3,3,2,1,1,0,4,0,15,1,PHI,PHI,TOR,121,,,5,3,2,5
Delon Wright,G,22023,1626153,22300753,"FEB 10, 2024",WAS vs. PHI,L,7,1,3,0.333,0,1,0.0,2,2,1.0,1,1,2,4,1,1,0,0,4,3,1,WAS,WAS,PHI,113,,,10,6,8,6
Delon Wright,G,22023,1626153,22300743,"FEB 09, 2024",WAS @ BOS,L,4,0,0,0.0,0,0,0.0,0,0,0.0,0,0,0,0,0,0,0,1,0,-6,1,WAS,BOS,WAS,129,,,0,0,0,0
Delon Wright,G,22023,1626153,22300728,"FEB 07, 2024",WAS vs. CLE,L,13,2,2,1.0,1,1,1.0,0,0,0.0,1,0,1,0,2,0,0,0,5,1,1,WAS,WAS,CLE,106,,,6,6,5,1
Delon Wright,G,22023,1626153,22300705,"FEB 04, 2024",WAS vs. PHX,L,13,1,3,0.333,0,1,0.0,0,0,0.0,0,1,1,2,1,0,0,0,2,-8,1,WAS,WAS,PHX,109,,,5,3,4,3
Delon Wright,G,22023,1626153,22300689,"FEB 02, 2024",WAS vs. MIA,L,6,1,2,0.5,1,1,1.0,0,0,0.0,1,1,2,1,0,1,0,0,3,6,1,WAS,WAS,MIA,102,,,6,5,4,3
Delon Wright,G,22023,1626153,22300676,"JAN 31, 2024",WAS vs. LAC,L,14,2,5,0.4,0,2,0.0,0,0,0.0,0,0,0,0,0,0,0,1,4,-11,1,WAS,WAS,LAC,107,,,4,4,4,0
Delon Wright,G,22023,1626153,22300665,"JAN 29, 2024",WAS @ SAS,W,9,2,3,0.667,1,1,1.0,0,0,0.0,0,2,2,1,0,0,0,0,5,5,1,WAS,SAS,WAS,118,,,8,7,6,3
Delon Wright,G,22023,1626153,22300642,"JAN 27, 2024",WAS @ DET,W,11,1,2,0.5,0,0,0.0,0,0,0.0,0,2,2,3,1,0,0,0,2,-8,1,WAS,DET,WAS,118,,,7,4,5,5
Delon Wright,G,22023,1626153,22300628,"JAN 25, 2024",WAS vs. UTA,L,5,0,0,0.0,0,0,0.0,0,0,0.0,0,1,1,1,0,0,0,0,0,0,1,WAS,WAS,UTA,108,,,2,1,1,2
Delon Wright,G,22023,1626153,22300620,"JAN 24, 2024",WAS vs. MIN,L,9,2,6,0.333,0,0,0.0,0,0,0.0,0,0,0,3,0,0,0,1,4,-3,1,WAS,WAS,MIN,107,,,7,4,7,3
Delon Wright,G,22023,1626153,22300602,"JAN 21, 2024",WAS vs. DEN,L,17,3,5,0.6,0,0,0.0,0,0,0.0,1,1,2,0,1,1,0,1,6,2,1,WAS,WAS,DEN,104,,,8,8,6,2
Delon Wright,G,22023,1626153,22300594,"JAN 20, 2024",WAS vs. SAS,L,20,2,5,0.4,0,1,0.0,2,2,1.0,1,3,4,4,3,1,0,0,6,16,1,WAS,WAS,SAS,127,,,14,10,10,8
Delon Wright,G,22023,1626153,22300579,"JAN 18, 2024",WAS @ NYK,L,11,1,5,0.2,1,1,1.0,2,2,1.0,0,2,2,1,1,0,0,1,5,-2,1,WAS,NYK,WAS,109,,,8,7,6,3
Delon Wright,G,22023,1626153,22300558,"JAN 15, 2024",WAS vs. DET,L,16,2,6,0.333,1,2,0.5,0,0,0.0,1,0,1,4,1,0,0,2,5,0,1,WAS,WAS,DET,117,,,10,6,9,5
Delon Wright,G,22023,1626153,22300543,"JAN 13, 2024",WAS @ ATL,W,22,3,7,0.429,2,3,0.667,0,0,0.0,1,1,2,4,2,1,0,1,8,10,1,WAS,ATL,WAS,125,,,14,10,12,6
Delon Wright,G,22023,1626153,22300520,"JAN 10, 2024",WAS @ IND,L,14,1,4,0.25,0,1,0.0,1,4,0.25,1,0,1,2,0,0,0,1,3,-3,1,WAS,IND,WAS,104,,,6,4,5,3
Delon Wright,G,22023,1626153,22300508,"JAN 08, 2024",WAS vs. OKC,L,17,3,6,0.5,1,1,1.0,0,0,0.0,1,0,1,2,0,0,0,2,7,-8,1,WAS,WAS,OKC,128,,,10,8,9,3
Delon Wright,G,22023,1626153,22300494,"JAN 06, 2024",WAS vs. NYK,L,17,1,6,0.167,0,1,0.0,0,0,0.0,0,3,3,3,0,0,0,0,2,-20,1,WAS,WAS,NYK,105,,,8,5,5,6
Delon Wright,G,22023,1626153,22300482,"JAN 05, 2024",WAS @ CLE,L,16,3,6,0.5,1,3,0.333,0,0,0.0,0,2,2,2,5,0,1,0,7,-6,1,WAS,CLE,WAS,90,,,11,9,9,4
Delon Wright,G,22023,1626153,22300465,"JAN 03, 2024",WAS @ CLE,L,18,0,3,0.0,0,1,0.0,0,0,0.0,0,2,2,4,1,1,1,1,0,-21,1,WAS,CLE,WAS,101,,,6,2,4,6
Delon Wright,G,22023,1626153,22300445,"DEC 31, 2023",WAS vs. ATL,L,18,1,2,0.5,1,2,0.5,0,0,0.0,0,0,0,2,0,0,3,2,3,-9,1,WAS,WAS,ATL,126,,,5,3,5,2
Delon Wright,G,22023,1626153,22300430,"DEC 29, 2023",WAS vs. BKN,W,17,2,3,0.667,0,1,0.0,0,0,0.0,1,2,3,2,2,1,0,0,4,18,1,WAS,WAS,BKN,110,,,9,7,6,5
Delon Wright,G,22023,1626153,22300407,"DEC 26, 2023",WAS vs. ORL,L,13,2,5,0.4,0,2,0.0,3,3,1.0,0,4,4,1,1,0,1,1,7,-4,1,WAS,WAS,ORL,119,,,12,11,8,5
Delon Wright,G,22023,1626153,22300009,"NOV 10, 2023",WAS vs. CHA,L,14,1,3,0.333,0,2,0.0,2,3,0.667,0,2,2,6,1,0,0,3,4,22,1,WAS,WAS,CHA,117,,,12,6,10,8
Delon Wright,G,22023,1626153,22300157,"NOV 08, 2023",WAS @ CHA,W,26,4,5,0.8,2,3,0.667,8,8,1.0,2,1,3,3,4,0,1,1,18,26,1,WAS,CHA,WAS,132,,,24,21,21,6
Delon Wright,G,22023,1626153,22300148,"NOV 06, 2023",WAS @ PHI,L,5,2,3,0.667,0,1,0.0,0,0,0.0,0,0,0,0,0,0,0,0,4,-16,1,WAS,PHI,WAS,128,,,4,4,4,0
Delon Wright,G,22023,1626153,22300003,"NOV 03, 2023",WAS @ MIA,L,17,0,3,0.0,0,0,0.0,0,0,0.0,0,2,2,2,1,0,2,0,0,-11,1,WAS,MIA,WAS,114,,,4,2,2,4
Delon Wright,G,22023,1626153,22300117,"NOV 01, 2023",WAS @ ATL,L,22,1,3,0.333,1,3,0.333,0,0,0.0,0,3,3,9,2,0,0,1,3,6,1,WAS,ATL,WAS,121,,,15,6,12,12
Delon Wright,G,22023,1626153,22300103,"OCT 30, 2023",WAS vs. BOS,L,12,0,2,0.0,0,0,0.0,1,2,0.5,0,2,2,2,0,0,0,0,1,-6,1,WAS,WAS,BOS,107,,,5,3,3,4
Delon Wright,G,22023,1626153,22300089,"OCT 28, 2023",WAS vs. MEM,W,20,0,3,0.0,0,1,0.0,2,2,1.0,0,2,2,7,2,1,1,0,2,2,1,WAS,WAS,MEM,113,,,11,4,9,9
Delon Wright,G,22023,1626153,22300064,"OCT 25, 2023",WAS @ IND,L,25,3,8,0.375,1,1,1.0,1,1,1.0,1,5,6,6,3,0,0,1,8,-15,1,WAS,IND,WAS,120,,,20,14,14,12
Keita Bates-Diop,F,22023,1628966,22300705,"FEB 04, 2024",PHX @ WAS,W,8,1,1,1.0,0,0,0.0,0,0,0.0,0,3,3,1,1,2,2,0,2,-1,1,PHX,WAS,PHX,140,,,6,5,3,4
Keita Bates-Diop,F,22023,1628966,22300690,"FEB 02, 2024",PHX @ ATL,L,10,2,5,0.4,2,4,0.5,0,0,0.0,1,1,2,0,0,0,0,0,6,-8,1,PHX,ATL,PHX,120,,,8,8,6,2
Keita Bates-Diop,F,22023,1628966,22300661,"JAN 29, 2024",PHX @ MIA,W,6,1,1,1.0,1,1,1.0,0,0,0.0,0,0,0,0,0,1,0,0,3,3,1,PHX,MIA,PHX,118,,,3,3,3,0
Keita Bates-Diop,F,22023,1628966,22300655,"JAN 28, 2024",PHX @ ORL,L,20,2,6,0.333,0,1,0.0,1,2,0.5,0,1,1,0,0,1,1,1,5,0,1,PHX,ORL,PHX,98,,,6,6,5,1
Keita Bates-Diop,F,22023,1628966,22300636,"JAN 26, 2024",PHX @ IND,L,9,1,1,1.0,0,0,0.0,0,0,0.0,1,3,4,1,0,0,1,0,2,7,1,PHX,IND,PHX,131,,,7,6,3,5
Keita Bates-Diop,F,22023,1628966,22300625,"JAN 24, 2024",PHX @ DAL,W,15,5,7,0.714,1,2,0.5,0,0,0.0,2,0,2,1,1,0,1,0,11,1,1,PHX,DAL,PHX,132,,,14,13,12,3
Keita Bates-Diop,F,22023,1628966,22300612,"JAN 22, 2024",PHX vs. CHI,W,18,2,3,0.667,1,2,0.5,0,0,0.0,0,1,1,2,1,1,0,1,5,15,1,PHX,PHX,CHI,115,,,8,6,7,3
Keita Bates-Diop,F,22023,1628966,22300604,"JAN 21, 2024",PHX vs. IND,W,12,0,0,0.0,0,0,0.0,0,0,0.0,1,1,2,1,1,0,1,1,0,-3,1,PHX,PHX,IND,117,,,3,2,1,3
Keita Bates-Diop,F,22023,1628966,22300588,"JAN 19, 2024",PHX @ NOP,W,5,0,1,0.0,0,1,0.0,0,0,0.0,0,2,2,0,0,0,0,0,0,-13,1,PHX,NOP,PHX,123,,,2,2,0,2
Keita Bates-Diop,F,22023,1628966,22300554,"JAN 14, 2024",PHX @ POR,W,13,2,3,0.667,0,1,0.0,0,0,0.0,1,1,2,3,0,0,0,1,4,5,1,PHX,POR,PHX,127,,,9,6,7,5
Keita Bates-Diop,F,22023,1628966,22300531,"JAN 11, 2024",PHX @ LAL,W,5,1,3,0.333,0,1,0.0,0,0,0.0,0,0,0,0,0,0,0,0,2,-7,1,PHX,LAL,PHX,127,,,2,2,2,0
Keita Bates-Diop,F,22023,1628966,22300511,"JAN 08, 2024",PHX @ LAC,L,2,1,1,1.0,1,1,1.0,0,0,0.0,0,0,0,0,0,0,0,1,3,3,1,PHX,LAC,PHX,111,,,3,3,3,0
Keita Bates-Diop,F,22023,1628966,22300503,"JAN 07, 2024",PHX vs. MEM,L,14,1,3,0.333,1,3,0.333,0,0,0.0,1,2,3,1,0,0,0,3,3,-15,1,PHX,PHX,MEM,115,,,7,6,4,4
Keita Bates-Diop,F,22023,1628966,22300489,"JAN 05, 2024",PHX vs. MIA,W,19,0,6,0.0,0,3,0.0,0,0,0.0,1,3,4,0,3,0,0,1,0,-6,1,PHX,PHX,MIA,113,,,4,4,0,4
Keita Bates-Diop,F,22023,1628966,22300473,"JAN 03, 2024",PHX vs. LAC,L,21,1,3,0.333,1,2,0.5,2,2,1.0,0,0,0,3,1,0,0,3,5,-2,1,PHX,PHX,LAC,122,,,8,5,8,3
Keita Bates-Diop,F,22023,1628966,22300456,"JAN 01, 2024",PHX vs. POR,W,17,1,1,1.0,1,1,1.0,0,0,0.0,0,3,3,1,2,0,0,1,3,15,1,PHX,PHX,POR,109,,,7,6,4,4
Keita Bates-Diop,F,22023,1628966,22300333,"DEC 15, 2023",PHX vs. NYK,L,14,2,5,0.4,0,1,0.0,0,0,0.0,0,3,3,0,0,0,0,0,4,-13,1,PHX,PHX,NYK,122,,,7,7,4,3
Keita Bates-Diop,F,22023,1628966,22301203,"DEC 05, 2023",PHX @ LAL,L,6,1,3,0.333,0,1,0.0,0,0,0.0,1,0,1,1,0,1,0,0,2,2,1,PHX,LAL,PHX,103,,,4,3,3,2
Keita Bates-Diop,F,22023,1628966,22300288,"DEC 02, 2023",PHX vs. MEM,W,18,3,6,0.5,1,2,0.5,1,1,1.0,0,3,3,0,1,0,1,0,8,-10,1,PHX,PHX,MEM,116,,,11,11,8,3
Keita Bates-Diop,F,22023,1628966,22300279,"DEC 01, 2023",PHX vs. DEN,L,17,0,1,0.0,0,0,0.0,4,4,1.0,0,1,1,1,0,0,0,0,4,-10,1,PHX,PHX,DEN,111,,,6,5,5,2
Keita Bates-Diop,F,22023,1628966,22300044,"NOV 24, 2023",PHX @ MEM,W,24,2,5,0.4,0,1,0.0,2,2,1.0,1,3,4,1,1,2,0,0,6,8,1,PHX,MEM,PHX,110,,,11,10,7,5
Keita Bates-Diop,F,22023,1628966,22300236,"NOV 22, 2023",PHX vs. GSW,W,13,1,2,0.5,1,1,1.0,0,2,0.0,1,2,3,0,1,0,1,1,3,1,1,PHX,PHX,GSW,123,,,6,6,3,3
Keita Bates-Diop,F,22023,1628966,22300041,"NOV 21, 2023",PHX vs. POR,W,10,0,1,0.0,0,0,0.0,1,2,0.5,0,1,1,0,0,0,0,0,1,-7,1,PHX,PHX,POR,120,,,2,2,1,1
Keita Bates-Diop,F,22023,1628966,22300214,"NOV 19, 2023",PHX @ UTA,W,23,2,6,0.333,1,4,0.25,1,1,1.0,1,0,1,1,1,2,0,3,6,-5,1,PHX,UTA,PHX,140,,,8,7,7,2
Keita Bates-Diop,F,22023,1628966,22300035,"NOV 17, 2023",PHX @ UTA,W,20,2,4,0.5,0,0,0.0,3,3,1.0,1,2,3,0,2,3,0,4,7,9,1,PHX,UTA,PHX,131,,,10,10,7,3
Keita Bates-Diop,F,22023,1628966,22300197,"NOV 15, 2023",PHX vs. MIN,W,13,1,1,1.0,0,0,0.0,0,0,0.0,1,1,2,1,0,0,0,1,2,-9,1,PHX,PHX,MIN,133,,,5,4,3,3
Keita Bates-Diop,F,22023,1628966,22300185,"NOV 12, 2023",PHX vs. OKC,L,27,3,9,0.333,0,1,0.0,0,0,0.0,4,4,8,2,0,0,1,3,6,-4,1,PHX,PHX,OKC,99,,,16,14,8,10
Keita Bates-Diop,F,22023,1628966,22300015,"NOV 10, 2023",PHX vs. LAL,L,30,4,11,0.364,1,6,0.167,2,2,1.0,2,3,5,0,2,0,0,0,11,-6,1,PHX,PHX,LAL,119,,,16,16,11,5
Keita Bates-Diop,F,22023,1628966,22300162,"NOV 08, 2023",PHX @ CHI,W,31,2,4,0.5,2,4,0.5,1,2,0.5,1,4,5,3,1,3,0,3,7,19,1,PHX,CHI,PHX,116,,,15,12,10,8
Keita Bates-Diop,F,22023,1628966,22300140,"NOV 05, 2023",PHX @ DET,W,20,0,3,0.0,0,1,0.0,0,0,0.0,2,4,6,1,0,1,0,0,0,1,1,PHX,DET,PHX,120,,,7,6,1,7
Keita Bates-Diop,F,22023,1628966,22300132,"NOV 04, 2023",PHX @ PHI,L,24,3,6,0.5,2,3,0.667,0,1,0.0,0,3,3,2,1,2,0,0,8,-2,1,PHX,PHI,PHX,100,,,13,11,10,5
Keita Bates-Diop,F,22023,1628966,22300131,"NOV 02, 2023",PHX vs. SAS,L,18,5,7,0.714,1,3,0.333,2,4,0.5,0,2,2,0,0,0,0,1,13,7,1,PHX,PHX,SAS,121,,,15,15,13,2
Keita Bates-Diop,F,22023,1628966,22300094,"OCT 28, 2023",PHX vs. UTA,W,6,1,2,0.5,0,0,0.0,0,0,0.0,0,1,1,1,0,0,0,0,2,-4,1,PHX,PHX,UTA,126,,,4,3,3,2
Keita Bates-Diop,F,22023,1628966,22300750,"FEB 10, 2024",BKN vs. SAS,W,4,1,1,1.0,0,0,0.0,0,0,0.0,0,0,0,0,0,0,0,0,2,-4,1,BKN,BKN,SAS,123,,,2,2,2,0
Keita Bates-Diop,F,22023,1628966,22300677,"JAN 31, 2024",PHX @ BKN,W,19,2,2,1.0,1,1,1.0,0,0,0.0,2,2,4,1,0,0,1,0,5,2,1,PHX,BKN,PHX,136,,,10,9,6,5
Keita Bates-Diop,F,22023,1628966,22300317,"DEC 13, 2023",PHX vs. BKN,L,12,1,3,0.333,0,1,0.0,0,0,0.0,0,2,2,1,0,0,1,1,2,1,1,PHX,PHX,BKN,112,,,5,4,3,3
Keita Bates-Diop,F,22023,1628966,22300308,"DEC 12, 2023",PHX vs. GSW,W,6,0,2,0.0,0,2,0.0,0,0,0.0,0,0,0,0,0,0,1,0,0,5,1,PHX,PHX,GSW,119,,,0,0,0,0
Keita Bates-Diop,F,22023,1628966,22301228,"DEC 08, 2023",PHX vs. SAC,L,17,2,6,0.333,1,3,0.333,0,2,0.0,1,3,4,2,0,0,0,0,5,-8,1,PHX,PHX,SAC,106,,,11,9,7,6
Keita Bates-Diop,F,22023,1628966,22300260,"NOV 29, 2023",PHX @ TOR,L,13,3,5,0.6,0,1,0.0,3,3,1.0,2,1,3,0,0,0,0,0,9,-7,1,PHX,TOR,PHX,105,,,12,12,9,3
Keita Bates-Diop,F,22023,1628966,22300247,"NOV 26, 2023",PHX @ NYK,W,28,3,11,0.273,0,5,0.0,3,3,1.0,2,5,7,2,2,1,1,3,9,0,1,PHX,NYK,PHX,116,,,18,16,11,9
Kenrich Williams,G-F,22023,1629026,22300682,"JAN 31, 2024",OKC vs. DEN,W,17,0,1,0.0,0,0,0.0,0,0,0.0,3,2,5,0,0,0,0,2,0,6,1,OKC,OKC,DEN,105,0.5,3-PT Made,5,5,0,5
Kenrich Williams,G-F,22023,1629026,22300682,"JAN 31, 2024",OKC vs. DEN,W,17,0,1,0.0,0,0,0.0,0,0,0.0,3,2,5,0,0,0,0,2,0,6,1,OKC,OKC,DEN,105,0.5,Steals,5,5,0,5
Kenrich Williams,G-F,22023,1629026,22300622,"JAN 24, 2024",OKC @ SAS,W,10,3,4,0.75,1,2,0.5,0,0,0.0,1,2,3,0,1,1,0,1,7,21,1,OKC,SAS,OKC,140,0.5,3-PT Made,10,10,7,3
Kenrich Williams,G-F,22023,1629026,22300622,"JAN 24, 2024",OKC @ SAS,W,10,3,4,0.75,1,2,0.5,0,0,0.0,1,2,3,0,1,1,0,1,7,21,1,OKC,SAS,OKC,140,0.5,Steals,10,10,7,3
Kenrich Williams,G-F,22023,1629026,22300617,"JAN 23, 2024",OKC vs. POR,W,13,2,5,0.4,1,2,0.5,0,0,0.0,1,3,4,0,1,0,1,0,5,-18,1,OKC,OKC,POR,111,0.5,3-PT Made,9,9,5,4
Kenrich Williams,G-F,22023,1629026,22300617,"JAN 23, 2024",OKC vs. POR,W,13,2,5,0.4,1,2,0.5,0,0,0.0,1,3,4,0,1,0,1,0,5,-18,1,OKC,OKC,POR,111,0.5,Steals,9,9,5,4
Kenrich Williams,G-F,22023,1629026,22300481,"JAN 05, 2024",OKC @ BKN,L,12,0,1,0.0,0,0,0.0,0,0,0.0,0,1,1,1,1,0,3,2,0,-12,1,OKC,BKN,OKC,115,0.5,3-PT Made,2,1,1,2
Kenrich Williams,G-F,22023,1629026,22300481,"JAN 05, 2024",OKC @ BKN,L,12,0,1,0.0,0,0,0.0,0,0,0.0,0,1,1,1,1,0,3,2,0,-12,1,OKC,BKN,OKC,115,0.5,Steals,2,1,1,2
Kenrich Williams,G-F,22023,1629026,22300419,"DEC 27, 2023",OKC vs. NYK,W,21,1,1,1.0,1,1,1.0,0,0,0.0,0,1,1,1,2,0,0,1,3,3,1,OKC,OKC,NYK,129,0.5,3-PT Made,5,4,4,2
Kenrich Williams,G-F,22023,1629026,22300419,"DEC 27, 2023",OKC vs. NYK,W,21,1,1,1.0,1,1,1.0,0,0,0.0,0,1,1,1,2,0,0,1,3,3,1,OKC,OKC,NYK,129,0.5,Steals,5,4,4,2
Kenrich Williams,G-F,22023,1629026,22300397,"DEC 23, 2023",OKC vs. LAL,L,23,4,6,0.667,3,4,0.75,0,0,0.0,1,1,2,5,1,1,0,2,11,1,1,OKC,OKC,LAL,120,0.5,3-PT Made,18,13,16,7
Kenrich Williams,G-F,22023,1629026,22300397,"DEC 23, 2023",OKC vs. LAL,L,23,4,6,0.667,3,4,0.75,0,0,0.0,1,1,2,5,1,1,0,2,11,1,1,OKC,OKC,LAL,120,0.5,Steals,18,13,16,7
Kenrich Williams,G-F,22023,1629026,22300324,"DEC 14, 2023",OKC @ SAC,L,11,1,5,0.2,0,2,0.0,0,0,0.0,0,0,0,1,0,0,0,1,2,-5,1,OKC,SAC,OKC,123,0.5,3-PT Made,3,2,3,1
Kenrich Williams,G-F,22023,1629026,22300324,"DEC 14, 2023",OKC @ SAC,L,11,1,5,0.2,0,2,0.0,0,0,0.0,0,0,0,1,0,0,0,1,2,-5,1,OKC,SAC,OKC,123,0.5,Steals,3,2,3,1
Kenrich Williams,G-F,22023,1629026,22300302,"DEC 11, 2023",OKC vs. UTA,W,7,1,1,1.0,0,0,0.0,0,0,0.0,0,2,2,1,1,0,0,0,2,0,1,OKC,OKC,UTA,134,0.5,3-PT Made,5,4,3,3
Kenrich Williams,G-F,22023,1629026,22300302,"DEC 11, 2023",OKC vs. UTA,W,7,1,1,1.0,0,0,0.0,0,0,0.0,0,2,2,1,1,0,0,0,2,0,1,OKC,OKC,UTA,134,0.5,Steals,5,4,3,3
Kenrich Williams,G-F,22023,1629026,22301222,"DEC 08, 2023",OKC vs. GSW,W,9,1,4,0.25,0,3,0.0,0,0,0.0,0,2,2,0,0,0,0,1,2,2,1,OKC,OKC,GSW,138,0.5,3-PT Made,4,4,2,2
Kenrich Williams,G-F,22023,1629026,22301222,"DEC 08, 2023",OKC vs. GSW,W,9,1,4,0.25,0,3,0.0,0,0,0.0,0,2,2,0,0,0,0,1,2,2,1,OKC,OKC,GSW,138,0.5,Steals,4,4,2,2
Kenrich Williams,G-F,22023,1629026,22300287,"DEC 02, 2023",OKC @ DAL,W,11,2,4,0.5,1,1,1.0,0,0,0.0,3,3,6,0,0,0,2,1,5,-13,1,OKC,DAL,OKC,126,0.5,3-PT Made,11,11,5,6
Kenrich Williams,G-F,22023,1629026,22300287,"DEC 02, 2023",OKC @ DAL,W,11,2,4,0.5,1,1,1.0,0,0,0.0,3,3,6,0,0,0,2,1,5,-13,1,OKC,DAL,OKC,126,0.5,Steals,11,11,5,6
Kenrich Williams,G-F,22023,1629026,22300239,"NOV 25, 2023",OKC vs. PHI,L,19,4,5,0.8,2,3,0.667,1,2,0.5,0,2,2,2,1,0,0,2,11,-3,1,OKC,OKC,PHI,123,0.5,3-PT Made,15,13,13,4
Kenrich Williams,G-F,22023,1629026,22300239,"NOV 25, 2023",OKC vs. PHI,L,19,4,5,0.8,2,3,0.667,1,2,0.5,0,2,2,2,1,0,0,2,11,-3,1,OKC,OKC,PHI,123,0.5,Steals,15,13,13,4
Kenrich Williams,G-F,22023,1629026,22300215,"NOV 19, 2023",OKC @ POR,W,8,1,2,0.5,1,1,1.0,0,0,0.0,0,1,1,3,0,0,0,2,3,11,1,OKC,POR,OKC,134,0.5,3-PT Made,7,4,6,4
Kenrich Williams,G-F,22023,1629026,22300215,"NOV 19, 2023",OKC @ POR,W,8,1,2,0.5,1,1,1.0,0,0,0.0,0,1,1,3,0,0,0,2,3,11,1,OKC,POR,OKC,134,0.5,Steals,7,4,6,4
Kenrich Williams,G-F,22023,1629026,22300748,"FEB 10, 2024",OKC @ DAL,L,13,0,2,0.0,0,1,0.0,0,0,0.0,1,0,1,2,0,0,0,5,0,-18,1,OKC,DAL,OKC,111,0.5,3-PT Made,3,1,2,3
Kenrich Williams,G-F,22023,1629026,22300748,"FEB 10, 2024",OKC @ DAL,L,13,0,2,0.0,0,1,0.0,0,0,0.0,1,0,1,2,0,0,0,5,0,-18,1,OKC,DAL,OKC,111,0.5,Steals,3,1,2,3
Kenrich Williams,G-F,22023,1629026,22300724,"FEB 06, 2024",OKC @ UTA,L,13,0,4,0.0,0,2,0.0,0,0,0.0,1,0,1,2,1,0,1,2,0,1,1,OKC,UTA,OKC,117,0.5,3-PT Made,3,1,2,3
Kenrich Williams,G-F,22023,1629026,22300724,"FEB 06, 2024",OKC @ UTA,L,13,0,4,0.0,0,2,0.0,0,0,0.0,1,0,1,2,1,0,1,2,0,1,1,OKC,UTA,OKC,117,0.5,Steals,3,1,2,3
Kenrich Williams,G-F,22023,1629026,22300710,"FEB 04, 2024",OKC vs. TOR,W,26,2,4,0.5,1,2,0.5,0,0,0.0,2,2,4,1,1,0,0,1,5,16,1,OKC,OKC,TOR,135,0.5,3-PT Made,10,9,6,5
Kenrich Williams,G-F,22023,1629026,22300710,"FEB 04, 2024",OKC vs. TOR,W,26,2,4,0.5,1,2,0.5,0,0,0.0,2,2,4,1,1,0,0,1,5,16,1,OKC,OKC,TOR,135,0.5,Steals,10,9,6,5
Kenrich Williams,G-F,22023,1629026,22300695,"FEB 02, 2024",OKC vs. CHA,W,10,3,5,0.6,2,3,0.667,0,0,0.0,0,3,3,0,0,1,0,2,8,-4,1,OKC,OKC,CHA,126,0.5,3-PT Made,11,11,8,3
Kenrich Williams,G-F,22023,1629026,22300695,"FEB 02, 2024",OKC vs. CHA,W,10,3,5,0.6,2,3,0.667,0,0,0.0,0,3,3,0,0,1,0,2,8,-4,1,OKC,OKC,CHA,126,0.5,Steals,11,11,8,3
Kenrich Williams,G-F,22023,1629026,22300568,"JAN 16, 2024",OKC @ LAC,L,16,1,4,0.25,1,4,0.25,0,0,0.0,2,4,6,1,1,1,1,1,3,1,1,OKC,LAC,OKC,117,0.5,3-PT Made,10,9,4,7
Kenrich Williams,G-F,22023,1629026,22300568,"JAN 16, 2024",OKC @ LAC,L,16,1,4,0.25,1,4,0.25,0,0,0.0,2,4,6,1,1,1,1,1,3,1,1,OKC,LAC,OKC,117,0.5,Steals,10,9,4,7
Kenrich Williams,G-F,22023,1629026,22300565,"JAN 15, 2024",OKC @ LAL,L,17,2,5,0.4,1,3,0.333,0,0,0.0,0,2,2,0,1,0,0,1,5,3,1,OKC,LAL,OKC,105,0.5,3-PT Made,7,7,5,2
Kenrich Williams,G-F,22023,1629026,22300565,"JAN 15, 2024",OKC @ LAL,L,17,2,5,0.4,1,3,0.333,0,0,0.0,0,2,2,0,1,0,0,1,5,3,1,OKC,LAL,OKC,105,0.5,Steals,7,7,5,2
Kenrich Williams,G-F,22023,1629026,22300546,"JAN 13, 2024",OKC vs. ORL,W,16,1,2,0.5,1,2,0.5,0,0,0.0,0,5,5,2,0,0,0,1,3,7,1,OKC,OKC,ORL,112,0.5,3-PT Made,10,8,5,7
Kenrich Williams,G-F,22023,1629026,22300546,"JAN 13, 2024",OKC vs. ORL,W,16,1,2,0.5,1,2,0.5,0,0,0.0,0,5,5,2,0,0,0,1,3,7,1,OKC,OKC,ORL,112,0.5,Steals,10,8,5,7
Kenrich Williams,G-F,22023,1629026,22300529,"JAN 11, 2024",OKC vs. POR,W,10,1,4,0.25,0,2,0.0,0,0,0.0,0,0,0,0,0,0,0,0,2,8,1,OKC,OKC,POR,139,0.5,3-PT Made,2,2,2,0
Kenrich Williams,G-F,22023,1629026,22300529,"JAN 11, 2024",OKC vs. POR,W,10,1,4,0.25,0,2,0.0,0,0,0.0,0,0,0,0,0,0,0,0,2,8,1,OKC,OKC,POR,139,0.5,Steals,2,2,2,0
Kenrich Williams,G-F,22023,1629026,22300379,"DEC 21, 2023",OKC vs. LAC,W,18,2,2,1.0,1,1,1.0,0,0,0.0,0,2,2,3,2,0,0,1,5,0,1,OKC,OKC,LAC,134,0.5,3-PT Made,10,7,8,5
Kenrich Williams,G-F,22023,1629026,22300379,"DEC 21, 2023",OKC vs. LAC,W,18,2,2,1.0,1,1,1.0,0,0,0.0,0,2,2,3,2,0,0,1,5,0,1,OKC,OKC,LAC,134,0.5,Steals,10,7,8,5
Kenrich Williams,G-F,22023,1629026,22300355,"DEC 18, 2023",OKC vs. MEM,W,15,2,3,0.667,2,3,0.667,0,0,0.0,0,4,4,3,0,0,1,0,6,26,1,OKC,OKC,MEM,116,0.5,3-PT Made,13,10,9,7
Kenrich Williams,G-F,22023,1629026,22300355,"DEC 18, 2023",OKC vs. MEM,W,15,2,3,0.667,2,3,0.667,0,0,0.0,0,4,4,3,0,0,1,0,6,26,1,OKC,OKC,MEM,116,0.5,Steals,13,10,9,7
Kenrich Williams,G-F,22023,1629026,22300340,"DEC 16, 2023",OKC @ DEN,W,13,1,4,0.25,0,1,0.0,0,0,0.0,3,2,5,0,0,0,0,4,2,-7,1,OKC,DEN,OKC,118,0.5,3-PT Made,7,7,2,5
Kenrich Williams,G-F,22023,1629026,22300340,"DEC 16, 2023",OKC @ DEN,W,13,1,4,0.25,0,1,0.0,0,0,0.0,3,2,5,0,0,0,0,4,2,-7,1,OKC,DEN,OKC,118,0.5,Steals,7,7,2,5
Kenrich Williams,G-F,22023,1629026,22300058,"NOV 28, 2023",OKC @ MIN,L,15,1,3,0.333,0,2,0.0,0,0,0.0,1,1,2,0,0,0,0,4,2,1,1,OKC,MIN,OKC,103,0.5,3-PT Made,4,4,2,2
Kenrich Williams,G-F,22023,1629026,22300058,"NOV 28, 2023",OKC @ MIN,L,15,1,3,0.333,0,2,0.0,0,0,0.0,1,1,2,0,0,0,0,4,2,1,1,OKC,MIN,OKC,103,0.5,Steals,4,4,2,2
Kenrich Williams,G-F,22023,1629026,22300664,"JAN 29, 2024",OKC vs. MIN,L,17,3,8,0.375,2,5,0.4,0,0,0.0,1,0,1,0,1,0,0,1,8,-7,1,OKC,OKC,MIN,101,0.5,3-PT Made,9,9,8,1
Kenrich Williams,G-F,22023,1629026,22300664,"JAN 29, 2024",OKC vs. MIN,L,17,3,8,0.375,2,5,0.4,0,0,0.0,1,0,1,0,1,0,0,1,8,-7,1,OKC,OKC,MIN,101,0.5,Steals,9,9,8,1
Kenrich Williams,G-F,22023,1629026,22300654,"JAN 28, 2024",OKC @ DET,L,14,1,4,0.25,0,2,0.0,0,0,0.0,0,1,1,0,1,0,0,1,2,0,1,OKC,DET,OKC,104,0.5,3-PT Made,3,3,2,1
Kenrich Williams,G-F,22023,1629026,22300654,"JAN 28, 2024",OKC @ DET,L,14,1,4,0.25,0,2,0.0,0,0,0.0,0,1,1,0,1,0,0,1,2,0,1,OKC,DET,OKC,104,0.5,Steals,3,3,2,1
Kenrich Williams,G-F,22023,1629026,22300640,"JAN 26, 2024",OKC @ NOP,W,13,4,5,0.8,0,1,0.0,0,0,0.0,1,3,4,0,1,0,1,0,8,1,1,OKC,NOP,OKC,107,0.5,3-PT Made,12,12,8,4
Kenrich Williams,G-F,22023,1629026,22300640,"JAN 26, 2024",OKC @ NOP,W,13,4,5,0.8,0,1,0.0,0,0,0.0,1,3,4,0,1,0,1,0,8,1,1,OKC,NOP,OKC,107,0.5,Steals,12,12,8,4
Kenrich Williams,G-F,22023,1629026,22300599,"JAN 20, 2024",OKC @ MIN,W,10,0,2,0.0,0,2,0.0,0,0,0.0,0,3,3,0,1,0,1,1,0,-1,1,OKC,MIN,OKC,102,0.5,3-PT Made,3,3,0,3
Kenrich Williams,G-F,22023,1629026,22300599,"JAN 20, 2024",OKC @ MIN,W,10,0,2,0.0,0,2,0.0,0,0,0.0,0,3,3,0,1,0,1,1,0,-1,1,OKC,MIN,OKC,102,0.5,Steals,3,3,0,3
Kenrich Williams,G-F,22023,1629026,22300522,"JAN 10, 2024",OKC @ MIA,W,17,3,4,0.75,1,2,0.5,0,0,0.0,1,5,6,2,0,0,2,0,7,6,1,OKC,MIA,OKC,128,0.5,3-PT Made,15,13,9,8
Kenrich Williams,G-F,22023,1629026,22300522,"JAN 10, 2024",OKC @ MIA,W,17,3,4,0.75,1,2,0.5,0,0,0.0,1,5,6,2,0,0,2,0,7,6,1,OKC,MIA,OKC,128,0.5,Steals,15,13,9,8
Kenrich Williams,G-F,22023,1629026,22300508,"JAN 08, 2024",OKC @ WAS,W,17,1,3,0.333,0,1,0.0,0,0,0.0,2,1,3,2,1,0,1,2,2,3,1,OKC,WAS,OKC,136,0.5,3-PT Made,7,5,4,5
Kenrich Williams,G-F,22023,1629026,22300508,"JAN 08, 2024",OKC @ WAS,W,17,1,3,0.333,0,1,0.0,0,0,0.0,2,1,3,2,1,0,1,2,2,3,1,OKC,WAS,OKC,136,0.5,Steals,7,5,4,5
Kenrich Williams,G-F,22023,1629026,22300462,"JAN 02, 2024",OKC vs. BOS,W,13,1,3,0.333,0,1,0.0,0,0,0.0,3,1,4,2,0,0,0,4,2,-1,1,OKC,OKC,BOS,127,0.5,3-PT Made,8,6,4,6
Kenrich Williams,G-F,22023,1629026,22300462,"JAN 02, 2024",OKC vs. BOS,W,13,1,3,0.333,0,1,0.0,0,0,0.0,3,1,4,2,0,0,0,4,2,-1,1,OKC,OKC,BOS,127,0.5,Steals,8,6,4,6
Kenrich Williams,G-F,22023,1629026,22300447,"DEC 31, 2023",OKC vs. BKN,W,18,1,4,0.25,0,2,0.0,0,0,0.0,0,4,4,2,0,0,0,0,2,7,1,OKC,OKC,BKN,124,0.5,3-PT Made,8,6,4,6
Kenrich Williams,G-F,22023,1629026,22300447,"DEC 31, 2023",OKC vs. BKN,W,18,1,4,0.25,0,2,0.0,0,0,0.0,0,4,4,2,0,0,0,0,2,7,1,OKC,OKC,BKN,124,0.5,Steals,8,6,4,6
Kenrich Williams,G-F,22023,1629026,22300435,"DEC 29, 2023",OKC @ DEN,W,15,2,7,0.286,1,4,0.25,0,0,0.0,1,1,2,0,1,0,0,2,5,-4,1,OKC,DEN,OKC,119,0.5,3-PT Made,7,7,5,2
Kenrich Williams,G-F,22023,1629026,22300435,"DEC 29, 2023",OKC @ DEN,W,15,2,7,0.286,1,4,0.25,0,0,0.0,1,1,2,0,1,0,0,2,5,-4,1,OKC,DEN,OKC,119,0.5,Steals,7,7,5,2
Kenrich Williams,G-F,22023,1629026,22300411,"DEC 26, 2023",OKC vs. MIN,W,16,2,4,0.5,2,3,0.667,0,0,0.0,0,3,3,2,1,0,0,0,6,9,1,OKC,OKC,MIN,129,0.5,3-PT Made,11,9,8,5
Kenrich Williams,G-F,22023,1629026,22300411,"DEC 26, 2023",OKC vs. MIN,W,16,2,4,0.5,2,3,0.667,0,0,0.0,0,3,3,2,1,0,0,0,6,9,1,OKC,OKC,MIN,129,0.5,Steals,11,9,8,5
Kenrich Williams,G-F,22023,1629026,22301212,"DEC 06, 2023",OKC @ HOU,L,15,3,5,0.6,2,4,0.5,0,2,0.0,0,2,2,1,0,2,0,1,8,-1,1,OKC,HOU,OKC,101,0.5,3-PT Made,11,10,9,3
Kenrich Williams,G-F,22023,1629026,22301212,"DEC 06, 2023",OKC @ HOU,L,15,3,5,0.6,2,4,0.5,0,2,0.0,0,2,2,1,0,2,0,1,8,-1,1,OKC,HOU,OKC,101,0.5,Steals,11,10,9,3
Kenrich Williams,G-F,22023,1629026,22300271,"NOV 30, 2023",OKC vs. LAL,W,19,0,4,0.0,0,1,0.0,1,2,0.5,0,2,2,3,2,0,0,3,1,10,1,OKC,OKC,LAL,133,0.5,3-PT Made,6,3,4,5
Kenrich Williams,G-F,22023,1629026,22300271,"NOV 30, 2023",OKC vs. LAL,W,19,0,4,0.0,0,1,0.0,1,2,0.5,0,2,2,3,2,0,0,3,1,10,1,OKC,OKC,LAL,133,0.5,Steals,6,3,4,5
Kenrich Williams,G-F,22023,1629026,22300234,"NOV 22, 2023",OKC vs. CHI,W,23,5,6,0.833,3,3,1.0,0,2,0.0,1,4,5,2,0,0,0,0,13,10,1,OKC,OKC,CHI,116,0.5,3-PT Made,20,18,15,7
Kenrich Williams,G-F,22023,1629026,22300234,"NOV 22, 2023",OKC vs. CHI,W,23,5,6,0.833,3,3,1.0,0,2,0.0,1,4,5,2,0,0,0,0,13,10,1,OKC,OKC,CHI,116,0.5,Steals,20,18,15,7
Kenrich Williams,G-F,22023,1629026,22300207,"NOV 18, 2023",OKC @ GSW,W,22,0,3,0.0,0,1,0.0,1,2,0.5,1,3,4,1,1,0,0,2,1,7,1,OKC,GSW,OKC,130,0.5,3-PT Made,6,5,2,5
Kenrich Williams,G-F,22023,1629026,22300207,"NOV 18, 2023",OKC @ GSW,W,22,0,3,0.0,0,1,0.0,1,2,0.5,1,3,4,1,1,0,0,2,1,7,1,OKC,GSW,OKC,130,0.5,Steals,6,5,2,5
Kenrich Williams,G-F,22023,1629026,22300201,"NOV 16, 2023",OKC @ GSW,W,18,3,3,1.0,0,0,0.0,0,0,0.0,2,3,5,3,0,0,0,3,6,16,1,OKC,GSW,OKC,128,0.5,3-PT Made,14,11,9,8
Kenrich Williams,G-F,22023,1629026,22300201,"NOV 16, 2023",OKC @ GSW,W,18,3,3,1.0,0,0,0.0,0,0,0.0,2,3,5,3,0,0,0,3,6,16,1,OKC,GSW,OKC,128,0.5,Steals,14,11,9,8
Kenrich Williams,G-F,22023,1629026,22300021,"NOV 14, 2023",OKC vs. SAS,W,15,4,7,0.571,1,3,0.333,0,0,0.0,0,0,0,2,0,0,1,3,9,13,1,OKC,OKC,SAS,123,0.5,3-PT Made,11,9,11,2
Kenrich Williams,G-F,22023,1629026,22300021,"NOV 14, 2023",OKC vs. SAS,W,15,4,7,0.571,1,3,0.333,0,0,0.0,0,0,0,2,0,0,1,3,9,13,1,OKC,OKC,SAS,123,0.5,Steals,11,9,11,2
Kenrich Williams,G-F,22023,1629026,22300581,"JAN 18, 2024",OKC @ UTA,W,17,4,7,0.571,1,3,0.333,0,0,0.0,1,3,4,2,1,0,1,2,9,-4,1,OKC,UTA,OKC,134,0.5,3-PT Made,15,13,11,6
Kenrich Williams,G-F,22023,1629026,22300581,"JAN 18, 2024",OKC @ UTA,W,17,4,7,0.571,1,3,0.333,0,0,0.0,1,3,4,2,1,0,1,2,9,-4,1,OKC,UTA,OKC,134,0.5,Steals,15,13,11,6
Nassir Little,F-G,22023,1629642,22300739,"FEB 08, 2024",PHX vs. UTA,W,16,1,2,0.5,1,2,0.5,0,0,0.0,0,3,3,1,0,1,0,4,3,4,1,PHX,PHX,UTA,129,,,7,6,4,4
Nassir Little,F-G,22023,1629642,22300705,"FEB 04, 2024",PHX @ WAS,W,8,0,2,0.0,0,2,0.0,0,0,0.0,0,1,1,2,0,0,0,0,0,-1,1,PHX,WAS,PHX,140,,,3,1,2,3
Nassir Little,F-G,22023,1629642,22300655,"JAN 28, 2024",PHX @ ORL,L,2,0,0,0.0,0,0,0.0,0,0,0.0,0,1,1,0,0,0,0,0,0,1,1,PHX,ORL,PHX,98,,,1,1,0,1
Nassir Little,F-G,22023,1629642,22300625,"JAN 24, 2024",PHX @ DAL,W,4,1,2,0.5,0,1,0.0,0,0,0.0,0,0,0,0,0,0,0,0,2,2,1,PHX,DAL,PHX,132,,,2,2,2,0
Nassir Little,F-G,22023,1629642,22300588,"JAN 19, 2024",PHX @ NOP,W,4,0,1,0.0,0,1,0.0,0,0,0.0,0,0,0,0,0,0,0,0,0,-10,1,PHX,NOP,PHX,123,,,0,0,0,0
Nassir Little,F-G,22023,1629642,22300531,"JAN 11, 2024",PHX @ LAL,W,4,1,1,1.0,0,0,0.0,1,1,1.0,0,0,0,0,0,0,1,0,3,-5,1,PHX,LAL,PHX,127,,,3,3,3,0
Nassir Little,F-G,22023,1629642,22300418,"DEC 27, 2023",PHX @ HOU,W,16,3,6,0.5,0,3,0.0,1,1,1.0,0,6,6,0,0,0,1,1,7,2,1,PHX,HOU,PHX,129,,,13,13,7,6
Nassir Little,F-G,22023,1629642,22300405,"DEC 25, 2023",PHX vs. DAL,L,3,0,0,0.0,0,0,0.0,0,0,0.0,0,0,0,0,0,0,0,1,0,-6,1,PHX,PHX,DAL,114,,,0,0,0,0
Nassir Little,F-G,22023,1629642,22300387,"DEC 22, 2023",PHX @ SAC,L,16,3,8,0.375,0,3,0.0,0,0,0.0,0,0,0,0,1,0,1,3,6,0,1,PHX,SAC,PHX,105,,,6,6,6,0
Nassir Little,F-G,22023,1629642,22300363,"DEC 19, 2023",PHX @ POR,L,19,1,2,0.5,1,1,1.0,1,2,0.5,0,2,2,0,0,0,0,1,4,-12,1,PHX,POR,PHX,104,,,6,6,4,2
Nassir Little,F-G,22023,1629642,22300347,"DEC 17, 2023",PHX vs. WAS,W,23,2,3,0.667,1,2,0.5,0,0,0.0,2,5,7,1,0,0,1,2,5,-9,1,PHX,PHX,WAS,112,,,13,12,6,8
Nassir Little,F-G,22023,1629642,22300333,"DEC 15, 2023",PHX vs. NYK,L,26,2,5,0.4,1,3,0.333,0,0,0.0,2,2,4,1,0,0,0,2,5,-5,1,PHX,PHX,NYK,122,,,10,9,6,5
Nassir Little,F-G,22023,1629642,22301203,"DEC 05, 2023",PHX @ LAL,L,14,2,4,0.5,1,1,1.0,0,0,0.0,1,1,2,2,0,0,1,1,5,-11,1,PHX,LAL,PHX,103,,,9,7,7,4
Nassir Little,F-G,22023,1629642,22300288,"DEC 02, 2023",PHX vs. MEM,W,15,1,5,0.2,0,2,0.0,2,2,1.0,1,1,2,2,0,0,1,0,4,-1,1,PHX,PHX,MEM,116,,,8,6,6,4
Nassir Little,F-G,22023,1629642,22300279,"DEC 01, 2023",PHX vs. DEN,L,19,1,1,1.0,0,0,0.0,0,0,0.0,0,2,2,0,0,1,0,0,2,-6,1,PHX,PHX,DEN,111,,,4,4,2,2
Nassir Little,F-G,22023,1629642,22300044,"NOV 24, 2023",PHX @ MEM,W,16,0,1,0.0,0,1,0.0,2,2,1.0,0,4,4,0,1,0,1,2,2,1,1,PHX,MEM,PHX,110,,,6,6,2,4
Nassir Little,F-G,22023,1629642,22300236,"NOV 22, 2023",PHX vs. GSW,W,27,4,9,0.444,0,3,0.0,2,2,1.0,1,4,5,3,2,0,0,1,10,-9,1,PHX,PHX,GSW,123,,,18,15,13,8
Nassir Little,F-G,22023,1629642,22300041,"NOV 21, 2023",PHX vs. POR,W,22,4,6,0.667,1,3,0.333,4,4,1.0,2,3,5,0,1,1,0,1,13,2,1,PHX,PHX,POR,120,,,18,18,13,5
Nassir Little,F-G,22023,1629642,22300214,"NOV 19, 2023",PHX @ UTA,W,20,4,7,0.571,2,5,0.4,0,2,0.0,2,1,3,2,0,3,0,4,10,2,1,PHX,UTA,PHX,140,,,15,13,12,5
Nassir Little,F-G,22023,1629642,22300035,"NOV 17, 2023",PHX @ UTA,W,11,2,3,0.667,1,2,0.5,0,0,0.0,0,1,1,1,0,0,0,0,5,8,1,PHX,UTA,PHX,131,,,7,6,6,2
Nassir Little,F-G,22023,1629642,22300197,"NOV 15, 2023",PHX vs. MIN,W,4,1,1,1.0,0,0,0.0,0,0,0.0,0,0,0,0,0,0,0,1,2,-3,1,PHX,PHX,MIN,133,,,2,2,2,0
Nassir Little,F-G,22023,1629642,22300132,"NOV 04, 2023",PHX @ PHI,L,4,0,0,0.0,0,0,0.0,2,2,1.0,1,0,1,0,0,0,0,0,2,3,1,PHX,PHI,PHX,100,,,3,3,2,1
Nassir Little,F-G,22023,1629642,22300113,"OCT 31, 2023",PHX vs. SAS,L,18,2,3,0.667,2,2,1.0,0,0,0.0,0,2,2,1,2,0,1,5,6,2,1,PHX,PHX,SAS,114,,,9,8,7,3
Nassir Little,F-G,22023,1629642,22300094,"OCT 28, 2023",PHX vs. UTA,W,21,3,8,0.375,0,5,0.0,0,0,0.0,0,1,1,0,1,0,0,2,6,-1,1,PHX,PHX,UTA,126,,,7,7,6,1
Nassir Little,F-G,22023,1629642,22300076,"OCT 26, 2023",PHX @ LAL,L,13,0,2,0.0,0,2,0.0,2,2,1.0,0,2,2,0,1,1,1,0,2,-9,1,PHX,LAL,PHX,95,,,4,4,2,2
Nassir Little,F-G,22023,1629642,22300062,"OCT 24, 2023",PHX @ GSW,W,3,1,1,1.0,1,1,1.0,0,0,0.0,0,1,1,0,1,0,0,1,3,-3,1,PHX,GSW,PHX,108,,,4,4,3,1
Nassir Little,F-G,22023,1629642,22300677,"JAN 31, 2024",PHX @ BKN,W,1,0,0,0.0,0,0,0.0,0,0,0.0,0,0,0,0,0,0,0,0,0,0,1,PHX,BKN,PHX,136,,,0,0,0,0
Nassir Little,F-G,22023,1629642,22300317,"DEC 13, 2023",PHX vs. BKN,L,27,4,7,0.571,2,5,0.4,0,0,0.0,2,5,7,3,0,0,2,2,10,13,1,PHX,PHX,BKN,112,,,20,17,13,10
Nassir Little,F-G,22023,1629642,22301228,"DEC 08, 2023",PHX vs. SAC,L,4,0,0,0.0,0,0,0.0,0,0,0.0,0,1,1,0,0,0,0,0,0,-1,1,PHX,PHX,SAC,106,,,1,1,0,1
Nassir Little,F-G,22023,1629642,22300247,"NOV 26, 2023",PHX @ NYK,W,20,4,9,0.444,3,6,0.5,0,0,0.0,0,2,2,0,0,2,1,1,11,-15,1,PHX,NYK,PHX,116,,,13,13,11,2
Neemias Queta,C,22023,1629674,22300706,"FEB 04, 2024",BOS vs. MEM,W,10,4,4,1.0,0,0,0.0,0,0,0.0,4,4,8,0,2,0,0,0,8,18,1,BOS,BOS,MEM,131,,,16,16,8,8
Neemias Queta,C,22023,1629674,22300684,"FEB 01, 2024",BOS vs. LAL,L,13,3,5,0.6,0,0,0.0,1,1,1.0,4,3,7,1,0,1,0,2,7,7,1,BOS,BOS,LAL,105,,,15,14,8,8
Neemias Queta,C,22023,1629674,22300646,"JAN 27, 2024",BOS vs. LAC,L,12,4,4,1.0,0,0,0.0,0,0,0.0,2,3,5,1,0,2,0,0,8,15,1,BOS,BOS,LAC,96,,,14,13,9,6
Neemias Queta,C,22023,1629674,22300630,"JAN 25, 2024",BOS @ MIA,W,4,0,0,0.0,0,0,0.0,0,0,0.0,0,1,1,0,0,1,0,2,0,3,1,BOS,MIA,BOS,143,,,1,1,0,1
Neemias Queta,C,22023,1629674,22300571,"JAN 17, 2024",BOS vs. SAS,W,12,2,4,0.5,0,0,0.0,2,2,1.0,4,4,8,0,0,2,0,5,6,6,1,BOS,BOS,SAS,117,,,14,14,6,8
Neemias Queta,C,22023,1629674,22300528,"JAN 11, 2024",BOS @ MIL,L,13,2,4,0.5,0,0,0.0,0,0,0.0,1,2,3,0,0,1,1,1,4,-4,1,BOS,MIL,BOS,102,,,7,7,4,3
Neemias Queta,C,22023,1629674,22300479,"JAN 05, 2024",BOS vs. UTA,W,4,0,1,0.0,0,0,0.0,0,0,0.0,0,0,0,0,0,0,0,2,0,-5,1,BOS,BOS,UTA,126,,,0,0,0,0
Neemias Queta,C,22023,1629674,22300448,"DEC 31, 2023",BOS @ SAS,W,5,2,2,1.0,0,0,0.0,1,1,1.0,0,2,2,0,0,1,0,0,5,1,1,BOS,SAS,BOS,134,,,7,7,5,2
Neemias Queta,C,22023,1629674,22300432,"DEC 29, 2023",BOS vs. TOR,W,14,3,3,1.0,0,0,0.0,0,0,0.0,1,4,5,1,0,0,0,0,6,3,1,BOS,BOS,TOR,120,,,12,11,7,6
Neemias Queta,C,22023,1629674,22300389,"DEC 23, 2023",BOS @ LAC,W,23,4,7,0.571,0,0,0.0,6,8,0.75,6,6,12,3,0,0,1,5,14,14,1,BOS,LAC,BOS,142,,,29,26,17,15
Neemias Queta,C,22023,1629674,22300344,"DEC 17, 2023",BOS vs. ORL,W,16,1,2,0.5,0,0,0.0,0,0,0.0,0,3,3,0,0,0,0,1,2,8,1,BOS,BOS,ORL,114,,,5,5,2,3
Neemias Queta,C,22023,1629674,22300275,"DEC 01, 2023",BOS vs. PHI,W,10,1,1,1.0,0,0,0.0,3,4,0.75,2,3,5,0,0,0,2,1,5,3,1,BOS,BOS,PHI,125,,,10,10,5,5
Neemias Queta,C,22023,1629674,22300246,"NOV 26, 2023",BOS vs. ATL,W,15,3,8,0.375,0,0,0.0,1,1,1.0,6,4,10,0,1,0,0,0,7,5,1,BOS,BOS,ATL,113,,,17,17,7,10
Neemias Queta,C,22023,1629674,22300670,"JAN 30, 2024",BOS vs. IND,W,14,2,3,0.667,0,0,0.0,0,1,0.0,0,1,1,1,0,2,1,1,4,15,1,BOS,BOS,IND,129,,,6,5,5,2
Neemias Queta,C,22023,1629674,22300659,"JAN 29, 2024",BOS vs. NOP,W,10,2,4,0.5,0,0,0.0,0,0,0.0,0,2,2,1,0,1,1,1,4,-3,1,BOS,BOS,NOP,118,,,7,6,5,3
Neemias Queta,C,22023,1629674,22300603,"JAN 21, 2024",BOS @ HOU,W,3,0,0,0.0,0,0,0.0,0,0,0.0,0,0,0,0,1,0,0,2,0,-1,1,BOS,HOU,BOS,116,,,0,0,0,0
Neemias Queta,C,22023,1629674,22300421,"DEC 28, 2023",BOS vs. DET,W,20,2,2,1.0,0,0,0.0,1,2,0.5,0,2,2,0,1,0,0,4,5,-3,1,BOS,BOS,DET,128,,,7,7,5,2
Neemias Queta,C,22023,1629674,22300373,"DEC 20, 2023",BOS @ SAC,W,19,3,8,0.375,0,0,0.0,0,0,0.0,4,4,8,0,1,0,1,5,6,3,1,BOS,SAC,BOS,144,,,14,14,6,8
Neemias Queta,C,22023,1629674,22300362,"DEC 19, 2023",BOS @ GSW,L,21,5,8,0.625,0,0,0.0,0,0,0.0,6,4,10,1,1,0,0,0,10,10,1,BOS,GSW,BOS,126,,,21,20,11,11
Neemias Queta,C,22023,1629674,22300329,"DEC 15, 2023",BOS vs. ORL,W,18,2,3,0.667,0,0,0.0,0,0,0.0,2,1,3,1,1,3,1,6,4,13,1,BOS,BOS,ORL,128,,,8,7,5,4
Neemias Queta,C,22023,1629674,22300403,"DEC 25, 2023",BOS @ LAL,W,7,0,0,0.0,0,0,0.0,0,0,0.0,0,1,1,1,1,0,0,3,0,-10,1,BOS,LAL,BOS,126,,,2,1,1,2
Neemias Queta,C,22023,1629674,22300213,"NOV 19, 2023",BOS @ MEM,W,5,0,1,0.0,0,0,0.0,0,0,0.0,0,2,2,0,0,0,0,1,0,-3,1,BOS,MEM,BOS,102,,,2,2,0,2
Jalen Wilson,F,22023,1630592,22300750,"FEB 10, 2024",BKN vs. SAS,W,30,3,4,0.75,2,3,0.667,0,0,0.0,2,4,6,2,0,0,0,4,8,14,1,BKN,BKN,SAS,123,,,16,14,10,8
Jalen Wilson,F,22023,1630592,22300735,"FEB 08, 2024",BKN vs. CLE,L,40,3,8,0.375,2,3,0.667,0,2,0.0,0,3,3,3,1,0,1,2,8,-16,1,BKN,BKN,CLE,95,,,14,11,11,6
Jalen Wilson,F,22023,1630592,22300720,"FEB 06, 2024",BKN vs. DAL,L,18,3,7,0.429,2,3,0.667,2,2,1.0,1,3,4,2,1,0,0,1,10,5,1,BKN,BKN,DAL,107,,,16,14,12,6
Jalen Wilson,F,22023,1630592,22300469,"JAN 03, 2024",BKN @ HOU,L,5,0,0,0.0,0,0,0.0,0,0,0.0,0,0,0,0,1,0,0,0,0,-2,1,BKN,HOU,BKN,101,,,0,0,0,0
Jalen Wilson,F,22023,1630592,22300461,"JAN 02, 2024",BKN @ NOP,L,12,4,8,0.5,0,2,0.0,0,0,0.0,4,0,4,2,1,0,0,0,8,0,1,BKN,NOP,BKN,85,,,14,12,10,6
Jalen Wilson,F,22023,1630592,22300417,"DEC 27, 2023",BKN vs. MIL,L,30,5,13,0.385,0,3,0.0,11,11,1.0,7,3,10,2,0,0,1,4,21,-14,1,BKN,BKN,MIL,122,,,33,31,23,12
Jalen Wilson,F,22023,1630592,22300394,"DEC 23, 2023",BKN vs. DET,W,6,1,2,0.5,0,0,0.0,0,0,0.0,1,1,2,1,0,0,0,2,2,-4,1,BKN,BKN,DET,126,,,5,4,3,3
Jalen Wilson,F,22023,1630592,22300368,"DEC 20, 2023",BKN vs. NYK,L,6,1,2,0.5,0,1,0.0,0,0,0.0,0,1,1,2,1,0,0,0,2,-1,1,BKN,BKN,NYK,102,,,5,3,4,3
Jalen Wilson,F,22023,1630592,22300357,"DEC 18, 2023",BKN @ UTA,L,8,1,1,1.0,1,1,1.0,2,2,1.0,0,0,0,0,0,0,1,2,5,4,1,BKN,UTA,BKN,108,,,5,5,5,0
Jalen Wilson,F,22023,1630592,22300339,"DEC 16, 2023",BKN @ GSW,L,11,1,1,1.0,0,0,0.0,0,0,0.0,1,0,1,0,0,0,1,1,2,-5,1,BKN,GSW,BKN,120,,,3,3,2,1
Jalen Wilson,F,22023,1630592,22300322,"DEC 14, 2023",BKN @ DEN,L,17,2,3,0.667,1,1,1.0,2,2,1.0,1,3,4,2,0,0,0,0,7,-4,1,BKN,DEN,BKN,101,,,13,11,9,6
Jalen Wilson,F,22023,1630592,22300303,"DEC 11, 2023",BKN @ SAC,L,4,1,1,1.0,0,0,0.0,0,0,0.0,1,0,1,0,0,0,0,0,2,4,1,BKN,SAC,BKN,118,,,3,3,2,1
Jalen Wilson,F,22023,1630592,22300136,"NOV 04, 2023",BKN vs. BOS,L,1,0,0,0.0,0,0,0.0,0,0,0.0,0,0,0,0,0,0,0,0,0,2,1,BKN,BKN,BOS,114,,,0,0,0,0
Jalen Wilson,F,22023,1630592,22300119,"NOV 01, 2023",BKN @ MIA,W,6,0,1,0.0,0,0,0.0,0,0,0.0,0,1,1,0,0,1,0,0,0,-4,1,BKN,MIA,BKN,109,,,1,1,0,1
Eugene Omoruyi,F,22023,1630647,22300753,"FEB 10, 2024",WAS vs. PHI,L,8,0,4,0.0,0,1,0.0,2,2,1.0,2,3,5,0,0,0,0,3,2,-15,1,WAS,WAS,PHI,113,,,7,7,2,5
Eugene Omoruyi,F,22023,1630647,22300743,"FEB 09, 2024",WAS @ BOS,L,13,2,4,0.5,0,1,0.0,0,0,0.0,1,4,5,2,0,0,2,2,4,-16,1,WAS,BOS,WAS,129,,,11,9,6,7
Eugene Omoruyi,F,22023,1630647,22300728,"FEB 07, 2024",WAS vs. CLE,L,13,1,6,0.167,0,0,0.0,1,2,0.5,3,0,3,3,3,0,2,3,3,-19,1,WAS,WAS,CLE,106,,,9,6,6,6
Eugene Omoruyi,F,22023,1630647,22300705,"FEB 04, 2024",WAS vs. PHX,L,23,6,12,0.5,1,3,0.333,3,4,0.75,5,5,10,3,3,0,0,3,16,-6,1,WAS,WAS,PHX,109,,,29,26,19,13
Eugene Omoruyi,F,22023,1630647,22300494,"JAN 06, 2024",WAS vs. NYK,L,3,0,1,0.0,0,1,0.0,0,0,0.0,0,1,1,1,0,0,0,1,0,5,1,WAS,WAS,NYK,105,,,2,1,1,2
Eugene Omoruyi,F,22023,1630647,22300482,"JAN 05, 2024",WAS @ CLE,L,7,3,5,0.6,0,1,0.0,2,2,1.0,1,0,1,0,1,0,0,2,8,1,1,WAS,CLE,WAS,90,,,9,9,8,1
Eugene Omoruyi,F,22023,1630647,22300465,"JAN 03, 2024",WAS @ CLE,L,7,1,3,0.333,0,1,0.0,0,0,0.0,1,0,1,0,0,0,0,2,2,-4,1,WAS,CLE,WAS,101,,,3,3,2,1
Eugene Omoruyi,F,22023,1630647,22300416,"DEC 27, 2023",WAS vs. TOR,L,6,3,4,0.75,0,1,0.0,1,2,0.5,0,1,1,2,2,0,1,2,7,-4,1,WAS,WAS,TOR,102,,,10,8,9,3
Eugene Omoruyi,F,22023,1630647,22300358,"DEC 18, 2023",WAS @ SAC,L,5,1,3,0.333,0,1,0.0,0,0,0.0,0,2,2,0,0,0,0,1,2,6,1,WAS,SAC,WAS,131,,,4,4,2,2
Eugene Omoruyi,F,22023,1630647,22300347,"DEC 17, 2023",WAS @ PHX,L,0,0,0,0.0,0,0,0.0,0,0,0.0,0,0,0,0,0,0,0,0,0,0,1,WAS,PHX,WAS,108,,,0,0,0,0
Eugene Omoruyi,F,22023,1630647,22300295,"DEC 11, 2023",WAS @ PHI,L,2,0,1,0.0,0,0,0.0,0,0,0.0,0,0,0,0,0,0,0,1,0,-4,1,WAS,PHI,WAS,99,,,0,0,0,0
Eugene Omoruyi,F,22023,1630647,22301219,"DEC 08, 2023",WAS @ BKN,L,4,1,2,0.5,0,1,0.0,1,1,1.0,0,1,1,0,1,0,2,1,3,-2,1,WAS,BKN,WAS,97,,,4,4,3,1
Eugene Omoruyi,F,22023,1630647,22300259,"NOV 29, 2023",WAS @ ORL,L,10,3,5,0.6,1,2,0.5,3,4,0.75,1,0,1,1,1,0,0,3,10,-2,1,WAS,ORL,WAS,120,,,12,11,11,2
Eugene Omoruyi,F,22023,1630647,22300253,"NOV 27, 2023",WAS @ DET,W,2,1,3,0.333,1,1,1.0,0,0,0.0,2,0,2,0,0,0,0,0,3,0,1,WAS,DET,WAS,126,,,5,5,3,2
Eugene Omoruyi,F,22023,1630647,22300241,"NOV 25, 2023",WAS vs. ATL,L,12,4,6,0.667,0,1,0.0,2,2,1.0,2,1,3,1,1,0,0,1,10,1,1,WAS,WAS,ATL,108,,,14,13,11,4
Eugene Omoruyi,F,22023,1630647,22300219,"NOV 20, 2023",WAS vs. MIL,L,1,0,1,0.0,0,1,0.0,2,2,1.0,0,0,0,0,0,0,0,0,2,2,1,WAS,WAS,MIL,129,,,2,2,2,0
Eugene Omoruyi,F,22023,1630647,22300028,"NOV 17, 2023",WAS vs. NYK,L,2,2,2,1.0,1,1,1.0,0,0,0.0,0,0,0,0,0,0,0,0,5,-1,1,WAS,WAS,NYK,99,,,5,5,5,0
Eugene Omoruyi,F,22023,1630647,22300157,"NOV 08, 2023",WAS @ CHA,W,3,0,1,0.0,0,1,0.0,0,0,0.0,0,1,1,0,1,0,0,0,0,-2,1,WAS,CHA,WAS,132,,,1,1,0,1
Eugene Omoruyi,F,22023,1630647,22300148,"NOV 06, 2023",WAS @ PHI,L,11,1,2,0.5,1,2,0.5,1,2,0.5,0,4,4,2,0,0,3,4,4,-3,1,WAS,PHI,WAS,128,,,10,8,6,6
Eugene Omoruyi,F,22023,1630647,22300003,"NOV 03, 2023",WAS @ MIA,L,7,2,2,1.0,0,0,0.0,0,0,0.0,0,0,0,2,1,0,1,1,4,18,1,WAS,MIA,WAS,114,,,6,4,6,2
Eugene Omoruyi,F,22023,1630647,22300117,"NOV 01, 2023",WAS @ ATL,L,8,3,6,0.5,0,1,0.0,1,2,0.5,0,2,2,0,0,0,1,1,7,-3,1,WAS,ATL,WAS,121,,,9,9,7,2
Eugene Omoruyi,F,22023,1630647,22300103,"OCT 30, 2023",WAS vs. BOS,L,12,5,5,1.0,1,1,1.0,3,4,0.75,3,3,6,1,1,1,0,0,14,14,1,WAS,WAS,BOS,107,,,21,20,15,7
Eugene Omoruyi,F,22023,1630647,22300064,"OCT 25, 2023",WAS @ IND,L,8,2,3,0.667,0,0,0.0,0,0,0.0,1,1,2,1,0,0,1,0,4,-2,1,WAS,IND,WAS,120,,,7,6,5,3
Dominick Barlow,F,22023,1631230,22300750,"FEB 10, 2024",SAS @ BKN,L,12,1,5,0.2,0,0,0.0,5,6,0.833,7,2,9,0,0,0,0,0,7,-1,1,SAS,BKN,SAS,103,,,16,16,7,9
Dominick Barlow,F,22023,1631230,22300681,"JAN 31, 2024",SAS vs. ORL,L,18,3,3,1.0,0,0,0.0,1,2,0.5,1,4,5,0,1,1,0,1,7,-2,1,SAS,SAS,ORL,98,,,12,12,7,5
Dominick Barlow,F,22023,1631230,22300665,"JAN 29, 2024",SAS vs. WAS,L,14,1,3,0.333,0,0,0.0,2,2,1.0,1,1,2,5,0,0,1,6,4,10,1,SAS,SAS,WAS,113,,,11,6,9,7
Dominick Barlow,F,22023,1631230,22300649,"JAN 27, 2024",SAS vs. MIN,W,18,4,5,0.8,0,0,0.0,1,2,0.5,2,2,4,1,0,1,0,1,9,-18,1,SAS,SAS,MIN,113,,,14,13,10,5
Dominick Barlow,F,22023,1631230,22300584,"JAN 19, 2024",SAS @ CHA,L,19,5,6,0.833,1,1,1.0,1,1,1.0,2,2,4,2,0,1,1,0,12,-4,1,SAS,CHA,SAS,120,,,18,16,14,6
Dominick Barlow,F,22023,1631230,22300571,"JAN 17, 2024",SAS @ BOS,L,21,2,6,0.333,1,2,0.5,0,0,0.0,2,2,4,0,0,0,0,1,5,-5,1,SAS,BOS,SAS,95,,,9,9,5,4
Dominick Barlow,F,22023,1631230,22300559,"JAN 15, 2024",SAS @ ATL,L,17,1,4,0.25,0,0,0.0,2,4,0.5,0,7,7,1,1,0,0,2,4,-6,1,SAS,ATL,SAS,99,,,12,11,5,8
Dominick Barlow,F,22023,1631230,22300548,"JAN 13, 2024",SAS vs. CHI,L,22,2,5,0.4,0,0,0.0,1,2,0.5,4,2,6,3,1,1,0,1,5,5,1,SAS,SAS,CHI,116,,,14,11,8,9
Dominick Barlow,F,22023,1631230,22300541,"JAN 12, 2024",SAS vs. CHA,W,17,1,4,0.25,0,0,0.0,3,6,0.5,2,4,6,1,0,3,0,2,5,11,1,SAS,SAS,CHA,127,,,12,11,6,7
Dominick Barlow,F,22023,1631230,22300519,"JAN 10, 2024",SAS @ DET,W,24,5,8,0.625,0,0,0.0,1,1,1.0,3,5,8,4,0,2,0,3,11,10,1,SAS,DET,SAS,129,,,23,19,15,12
Dominick Barlow,F,22023,1631230,22300497,"JAN 07, 2024",SAS @ CLE,L,22,3,5,0.6,0,0,0.0,0,0,0.0,2,4,6,2,1,1,1,3,6,-17,1,SAS,CLE,SAS,115,,,14,12,8,8
Dominick Barlow,F,22023,1631230,22300477,"JAN 04, 2024",SAS vs. MIL,L,15,3,3,1.0,0,0,0.0,0,0,0.0,0,1,1,4,1,2,0,1,6,5,1,SAS,SAS,MIL,121,,,11,7,10,5
Dominick Barlow,F,22023,1631230,22300460,"JAN 02, 2024",SAS @ MEM,L,14,2,6,0.333,0,0,0.0,0,0,0.0,4,3,7,2,0,0,2,4,4,-6,1,SAS,MEM,SAS,98,,,13,11,6,9
Dominick Barlow,F,22023,1631230,22300448,"DEC 31, 2023",SAS vs. BOS,L,13,3,6,0.5,1,1,1.0,1,2,0.5,2,3,5,1,2,0,0,2,8,3,1,SAS,SAS,BOS,101,,,14,13,9,6
Dominick Barlow,F,22023,1631230,22300437,"DEC 29, 2023",SAS @ POR,L,14,1,6,0.167,0,1,0.0,0,0,0.0,1,1,2,0,1,0,0,2,2,-9,1,SAS,POR,SAS,128,,,4,4,2,2
Dominick Barlow,F,22023,1631230,22300361,"DEC 19, 2023",SAS @ MIL,L,11,0,2,0.0,0,2,0.0,2,2,1.0,0,3,3,0,0,0,0,2,2,0,1,SAS,MIL,SAS,119,,,5,5,2,3
Dominick Barlow,F,22023,1631230,22300278,"DEC 01, 2023",SAS @ NOP,L,3,1,1,1.0,0,0,0.0,0,0,0.0,0,0,0,0,0,0,0,0,2,1,1,SAS,NOP,SAS,106,,,2,2,2,0
Dominick Barlow,F,22023,1631230,22300235,"NOV 22, 2023",SAS vs. LAC,L,9,0,1,0.0,0,0,0.0,0,0,0.0,0,2,2,0,1,0,0,1,0,-4,1,SAS,SAS,LAC,102,,,2,2,0,2
Dominick Barlow,F,22023,1631230,22300206,"NOV 18, 2023",SAS vs. MEM,L,3,0,0,0.0,0,0,0.0,0,0,0.0,0,1,1,0,0,0,0,0,0,6,1,SAS,SAS,MEM,108,,,1,1,0,1
Dominick Barlow,F,22023,1631230,22300021,"NOV 14, 2023",SAS @ OKC,L,5,0,0,0.0,0,0,0.0,0,0,0.0,0,1,1,0,0,0,0,0,0,2,1,SAS,OKC,SAS,87,,,1,1,0,1
Dominick Barlow,F,22023,1631230,22300161,"NOV 08, 2023",SAS @ NYK,L,3,1,1,1.0,0,0,0.0,0,2,0.0,0,1,1,0,0,0,0,0,2,0,1,SAS,NYK,SAS,105,,,3,3,2,1
Dominick Barlow,F,22023,1631230,22300146,"NOV 06, 2023",SAS @ IND,L,8,1,4,0.25,0,0,0.0,2,2,1.0,0,0,0,0,0,0,0,1,4,-1,1,SAS,IND,SAS,111,,,4,4,4,0
Dominick Barlow,F,22023,1631230,22300099,"OCT 29, 2023",SAS @ LAC,L,5,0,0,0.0,0,0,0.0,0,0,0.0,0,0,0,0,0,0,0,0,0,-10,1,SAS,LAC,SAS,83,,,0,0,0,0
Dylan Windler,G-F,22023,1629685,22300161,"NOV 08, 2023",NYK vs. SAS,W,1,0,0,0.0,0,0,0.0,0,0,0.0,0,0,0,0,0,0,0,0,0,-2,1,NYK,NYK,SAS,126,,,0,0,0,0
Dylan Windler,G-F,22023,1629685,22300112,"OCT 31, 2023",NYK @ CLE,W,3,0,1,0.0,0,1,0.0,0,0,0.0,0,1,1,0,0,0,0,0,0,0,1,NYK,CLE,NYK,109,,,1,1,0,1
Dylan Windler,G-F,22023,1629685,22300090,"OCT 28, 2023",NYK @ NOP,L,3,1,1,1.0,1,1,1.0,0,0,0.0,0,0,0,1,0,0,0,1,3,10,1,NYK,NOP,NYK,87,,,4,3,4,1
Dylan Windler,G-F,22023,1629685,22300684,"FEB 01, 2024",LAL @ BOS,W,1,0,0,0.0,0,0,0.0,0,0,0.0,0,1,1,0,0,0,0,0,0,0,1,LAL,BOS,LAL,114,,,1,1,0,1
Dylan Windler,G-F,22023,1629685,22300669,"JAN 30, 2024",LAL @ ATL,L,3,2,4,0.5,2,3,0.667,0,0,0.0,0,1,1,1,0,0,0,0,6,2,1,LAL,ATL,LAL,122,,,8,7,7,2
Dylan Windler,G-F,22023,1629685,22300531,"JAN 11, 2024",LAL vs. PHX,L,5,1,1,1.0,1,1,1.0,0,0,0.0,0,0,0,1,0,0,0,1,3,4,1,LAL,LAL,PHX,109,,,4,3,4,1
Dylan Windler,G-F,22023,1629685,22300747,"FEB 09, 2024",LAL vs. NOP,W,3,0,0,0.0,0,0,0.0,0,0,0.0,0,0,0,1,0,0,0,0,0,2,1,LAL,LAL,NOP,139,,,1,0,1,1
Dylan Windler,G-F,22023,1629685,22300161,"NOV 08, 2023",NYK vs. SAS,W,1,0,0,0.0,0,0,0.0,0,0,0.0,0,0,0,0,0,0,0,0,0,-2,1,NYK,NYK,SAS,126,,,0,0,0,0
Dylan Windler,G-F,22023,1629685,22300112,"OCT 31, 2023",NYK @ CLE,W,3,0,1,0.0,0,1,0.0,0,0,0.0,0,1,1,0,0,0,0,0,0,0,1,NYK,CLE,NYK,109,,,1,1,0,1
Dylan Windler,G-F,22023,1629685,22300090,"OCT 28, 2023",NYK @ NOP,L,3,1,1,1.0,1,1,1.0,0,0,0.0,0,0,0,1,0,0,0,1,3,10,1,NYK,NOP,NYK,87,,,4,3,4,1
Dylan Windler,G-F,22023,1629685,22300684,"FEB 01, 2024",LAL @ BOS,W,1,0,0,0.0,0,0,0.0,0,0,0.0,0,1,1,0,0,0,0,0,0,0,1,LAL,BOS,LAL,114,,,1,1,0,1
Dylan Windler,G-F,22023,1629685,22300669,"JAN 30, 2024",LAL @ ATL,L,3,2,4,0.5,2,3,0.667,0,0,0.0,0,1,1,1,0,0,0,0,6,2,1,LAL,ATL,LAL,122,,,8,7,7,2
Dylan Windler,G-F,22023,1629685,22300531,"JAN 11, 2024",LAL vs. PHX,L,5,1,1,1.0,1,1,1.0,0,0,0.0,0,0,0,1,0,0,0,1,3,4,1,LAL,LAL,PHX,109,,,4,3,4,1
Dylan Windler,G-F,22023,1629685,22300747,"FEB 09, 2024",LAL vs. NOP,W,3,0,0,0.0,0,0,0.0,0,0,0.0,0,0,0,1,0,0,0,0,0,2,1,LAL,LAL,NOP,139,,,1,0,1,1
Dwight Powell,F-C,22023,203939,22300487,"JAN 05, 2024",DAL vs. POR,W,26,2,4,0.5,0,0,0.0,2,4,0.5,2,7,9,3,1,1,2,0,6,32,1,DAL,DAL,POR,132,,,18,15,9,12
Dwight Powell,F-C,22023,203939,22300398,"DEC 23, 2023",DAL vs. SAS,W,22,5,5,1.0,0,0,0.0,4,4,1.0,2,2,4,1,1,1,0,4,14,30,1,DAL,DAL,SAS,144,,,19,18,15,5
Dwight Powell,F-C,22023,203939,22300385,"DEC 22, 2023",DAL @ HOU,L,8,0,1,0.0,0,1,0.0,0,0,0.0,0,4,4,0,0,0,0,1,0,-1,1,DAL,HOU,DAL,96,,,4,4,0,4
Dwight Powell,F-C,22023,203939,22300356,"DEC 18, 2023",DAL @ DEN,L,23,4,6,0.667,0,0,0.0,0,0,0.0,6,2,8,0,0,0,1,4,8,-17,1,DAL,DEN,DAL,104,,,16,16,8,8
Dwight Powell,F-C,22023,203939,22300341,"DEC 16, 2023",DAL @ POR,W,22,2,3,0.667,0,0,0.0,2,3,0.667,4,1,5,0,0,1,0,2,6,7,1,DAL,POR,DAL,131,,,11,11,6,5
Dwight Powell,F-C,22023,203939,22300321,"DEC 14, 2023",DAL vs. MIN,L,7,0,0,0.0,0,0,0.0,4,4,1.0,0,4,4,0,0,0,0,1,4,4,1,DAL,DAL,MIN,101,,,8,8,4,4
Dwight Powell,F-C,22023,203939,22300680,"JAN 31, 2024",DAL @ MIN,L,14,0,0,0.0,0,0,0.0,1,4,0.25,1,1,2,3,0,0,4,3,1,-9,1,DAL,MIN,DAL,82,,,6,3,4,5
Dwight Powell,F-C,22023,203939,22300666,"JAN 29, 2024",DAL vs. ORL,W,1,0,0,0.0,0,0,0.0,0,0,0.0,0,0,0,0,0,0,1,0,0,-2,1,DAL,DAL,ORL,131,,,0,0,0,0
Dwight Powell,F-C,22023,203939,22300577,"JAN 17, 2024",DAL @ LAL,L,7,0,0,0.0,0,0,0.0,1,2,0.5,2,2,4,0,0,0,1,1,1,6,1,DAL,LAL,DAL,105,,,5,5,1,4
Dwight Powell,F-C,22023,203939,22300556,"JAN 15, 2024",DAL vs. NOP,W,16,2,2,1.0,0,0,0.0,0,0,0.0,3,1,4,2,0,2,0,5,4,6,1,DAL,DAL,NOP,125,,,10,8,6,6
Dwight Powell,F-C,22023,203939,22300547,"JAN 13, 2024",DAL vs. NOP,L,34,0,1,0.0,0,0,0.0,2,2,1.0,5,4,9,8,3,0,1,5,2,6,1,DAL,DAL,NOP,108,,,19,11,10,17
Dwight Powell,F-C,22023,203939,22300530,"JAN 11, 2024",DAL vs. NYK,W,28,2,3,0.667,0,0,0.0,0,0,0.0,5,4,9,2,1,0,0,5,4,2,1,DAL,DAL,NYK,128,,,15,13,6,11
Dwight Powell,F-C,22023,203939,22300515,"JAN 09, 2024",DAL vs. MEM,L,22,2,3,0.667,0,0,0.0,0,0,0.0,1,3,4,3,2,1,2,3,4,9,1,DAL,DAL,MEM,103,,,11,8,7,7
Dwight Powell,F-C,22023,203939,22300501,"JAN 07, 2024",DAL vs. MIN,W,28,3,5,0.6,0,0,0.0,3,5,0.6,5,1,6,4,1,0,0,4,9,14,1,DAL,DAL,MIN,115,,,19,15,13,10
Dwight Powell,F-C,22023,203939,22300472,"JAN 03, 2024",DAL vs. POR,W,13,1,1,1.0,0,0,0.0,3,6,0.5,1,2,3,2,0,0,1,2,5,6,1,DAL,DAL,POR,126,,,10,8,7,5
Dwight Powell,F-C,22023,203939,22300423,"DEC 28, 2023",DAL @ MIN,L,30,6,8,0.75,0,0,0.0,0,0,0.0,7,7,14,6,2,1,1,3,12,15,1,DAL,MIN,DAL,110,,,32,26,18,20
Dwight Powell,F-C,22023,203939,22300420,"DEC 27, 2023",DAL vs. CLE,L,5,1,1,1.0,0,0,0.0,1,1,1.0,0,0,0,0,0,0,1,1,3,5,1,DAL,DAL,CLE,110,,,3,3,3,0
Dwight Powell,F-C,22023,203939,22300405,"DEC 25, 2023",DAL @ PHX,W,7,2,2,1.0,0,0,0.0,0,0,0.0,0,1,1,2,0,0,0,1,4,-6,1,DAL,PHX,DAL,128,,,7,5,6,3
Dwight Powell,F-C,22023,203939,22300299,"DEC 11, 2023",DAL @ MEM,W,12,1,2,0.5,0,0,0.0,0,0,0.0,1,1,2,2,0,0,1,3,2,4,1,DAL,MEM,DAL,120,,,6,4,4,4
Dwight Powell,F-C,22023,203939,22301226,"DEC 08, 2023",DAL @ POR,W,12,1,2,0.5,0,0,0.0,2,2,1.0,1,1,2,3,3,0,1,5,4,6,1,DAL,POR,DAL,125,,,9,6,7,5
Dwight Powell,F-C,22023,203939,22301213,"DEC 06, 2023",DAL vs. UTA,W,18,2,2,1.0,0,0,0.0,0,0,0.0,1,3,4,3,1,0,0,1,4,20,1,DAL,DAL,UTA,147,,,11,8,7,7
Dwight Powell,F-C,22023,203939,22300287,"DEC 02, 2023",DAL vs. OKC,L,4,0,0,0.0,0,0,0.0,2,2,1.0,0,0,0,0,0,0,1,1,2,-9,1,DAL,DAL,OKC,120,,,2,2,2,0
Dwight Powell,F-C,22023,203939,22300059,"NOV 28, 2023",DAL vs. HOU,W,3,0,0,0.0,0,0,0.0,0,0,0.0,0,0,0,0,0,0,0,0,0,-1,1,DAL,DAL,HOU,121,,,0,0,0,0
Dwight Powell,F-C,22023,203939,22300244,"NOV 25, 2023",DAL @ LAC,L,15,0,0,0.0,0,0,0.0,2,2,1.0,0,2,2,3,0,0,0,2,2,-17,1,DAL,LAC,DAL,88,,,7,4,5,5
Dwight Powell,F-C,22023,203939,22300238,"NOV 22, 2023",DAL @ LAL,W,5,0,0,0.0,0,0,0.0,0,0,0.0,0,0,0,1,0,0,1,2,0,-3,1,DAL,LAL,DAL,104,,,1,0,1,1
Dwight Powell,F-C,22023,203939,22300205,"NOV 18, 2023",DAL @ MIL,L,24,1,2,0.5,0,0,0.0,1,1,1.0,0,3,3,1,0,0,0,3,3,-6,1,DAL,MIL,DAL,125,,,7,6,4,4
Dwight Powell,F-C,22023,203939,22300192,"NOV 15, 2023",DAL @ WAS,W,7,1,1,1.0,0,0,0.0,0,0,0.0,0,1,1,2,0,0,0,1,2,2,1,DAL,WAS,DAL,130,,,5,3,4,3
Dwight Powell,F-C,22023,203939,22300022,"NOV 14, 2023",DAL @ NOP,L,11,2,4,0.5,0,0,0.0,0,0,0.0,3,4,7,1,0,1,1,1,4,-16,1,DAL,NOP,DAL,110,,,12,11,5,8
Dwight Powell,F-C,22023,203939,22300183,"NOV 12, 2023",DAL @ NOP,W,18,3,4,0.75,0,0,0.0,1,2,0.5,3,7,10,2,1,0,0,4,7,7,1,DAL,NOP,DAL,136,,,19,17,9,12
Dwight Powell,F-C,22023,203939,22300014,"NOV 10, 2023",DAL vs. LAC,W,22,2,3,0.667,0,0,0.0,5,5,1.0,4,1,5,4,1,0,1,3,9,3,1,DAL,DAL,LAC,144,,,18,14,13,9
Dwight Powell,F-C,22023,203939,22300006,"NOV 03, 2023",DAL @ DEN,L,17,2,5,0.4,0,0,0.0,2,2,1.0,1,0,1,1,0,0,0,2,6,-2,1,DAL,DEN,DAL,114,,,8,7,7,2
Dwight Powell,F-C,22023,203939,22300124,"NOV 01, 2023",DAL vs. CHI,W,10,0,0,0.0,0,0,0.0,5,6,0.833,1,0,1,1,0,0,0,1,5,-5,1,DAL,DAL,CHI,114,,,7,6,6,2
Dwight Powell,F-C,22023,203939,22300106,"OCT 30, 2023",DAL @ MEM,W,12,0,0,0.0,0,0,0.0,0,0,0.0,2,3,5,0,0,4,1,1,0,10,1,DAL,MEM,DAL,125,,,5,5,0,5
Dwight Powell,F-C,22023,203939,22300084,"OCT 27, 2023",DAL vs. BKN,W,13,4,4,1.0,1,1,1.0,2,2,1.0,2,0,2,0,1,0,0,0,11,-6,1,DAL,DAL,BKN,125,,,13,13,11,2
Dwight Powell,F-C,22023,203939,22300748,"FEB 10, 2024",DAL vs. OKC,W,6,1,1,1.0,0,0,0.0,0,0,0.0,0,1,1,0,0,1,0,1,2,0,1,DAL,DAL,OKC,146,,,3,3,2,1
Dwight Powell,F-C,22023,203939,22300736,"FEB 08, 2024",DAL @ NYK,W,21,2,2,1.0,0,0,0.0,1,2,0.5,3,3,6,1,0,0,1,4,5,1,1,DAL,NYK,DAL,121,,,12,11,6,7
Dwight Powell,F-C,22023,203939,22300720,"FEB 06, 2024",DAL @ BKN,W,18,1,2,0.5,0,0,0.0,0,0,0.0,0,2,2,0,0,1,0,2,2,2,1,DAL,BKN,DAL,119,,,4,4,2,2
Dwight Powell,F-C,22023,203939,22300715,"FEB 05, 2024",DAL @ PHI,W,16,0,1,0.0,0,0,0.0,0,0,0.0,2,5,7,1,0,0,1,3,0,4,1,DAL,PHI,DAL,118,,,8,7,1,8
Dwight Powell,F-C,22023,203939,22300702,"FEB 03, 2024",DAL vs. MIL,L,19,1,1,1.0,0,0,0.0,2,2,1.0,3,5,8,2,0,1,1,1,4,4,1,DAL,DAL,MIL,117,,,14,12,6,10
Dwight Powell,F-C,22023,203939,22300457,"JAN 01, 2024",DAL @ UTA,L,10,2,3,0.667,0,0,0.0,0,0,0.0,2,2,4,1,2,0,0,1,4,-13,1,DAL,UTA,DAL,86,,,9,8,5,5
Dwight Powell,F-C,22023,203939,22300444,"DEC 30, 2023",DAL @ GSW,W,13,1,2,0.5,0,0,0.0,0,0,0.0,2,0,2,1,0,0,0,2,2,-2,1,DAL,GSW,DAL,132,,,5,4,3,3
Dwight Powell,F-C,22023,203939,22300372,"DEC 20, 2023",DAL vs. LAC,L,18,1,1,1.0,0,0,0.0,1,2,0.5,1,0,1,1,0,0,0,2,3,-17,1,DAL,DAL,LAC,111,,,5,4,4,2
Dwight Powell,F-C,22023,203939,22300212,"NOV 19, 2023",DAL vs. SAC,L,13,0,0,0.0,0,0,0.0,0,0,0.0,0,1,1,1,1,0,2,1,0,-5,1,DAL,DAL,SAC,113,,,2,1,1,2
Dwight Powell,F-C,22023,203939,22300168,"NOV 08, 2023",DAL vs. TOR,L,24,1,1,1.0,0,0,0.0,3,5,0.6,0,6,6,0,0,1,0,2,5,-10,1,DAL,DAL,TOR,116,,,11,11,5,6
Dwight Powell,F-C,22023,203939,22300147,"NOV 06, 2023",DAL @ ORL,W,28,2,2,1.0,0,0,0.0,3,5,0.6,0,2,2,2,1,2,0,3,7,14,1,DAL,ORL,DAL,117,,,11,9,9,4
Dwight Powell,F-C,22023,203939,22300143,"NOV 05, 2023",DAL vs. CHA,W,15,3,3,1.0,0,0,0.0,4,6,0.667,5,0,5,3,0,0,0,2,10,2,1,DAL,DAL,CHA,124,,,18,15,13,8
Brandon Boston Jr.,G,22023,1630527,22300731,"FEB 07, 2024",LAC vs. NOP,L,3,0,1,0.0,0,0,0.0,2,2,1.0,0,0,0,0,0,0,1,0,2,3,1,LAC,LAC,NOP,106,,,2,2,2,0
Brandon Boston Jr.,G,22023,1630527,22300688,"FEB 02, 2024",LAC @ DET,W,3,0,0,0.0,0,0,0.0,0,0,0.0,0,0,0,0,0,0,1,1,0,-7,1,LAC,DET,LAC,136,,,0,0,0,0
Brandon Boston Jr.,G,22023,1630527,22300676,"JAN 31, 2024",LAC @ WAS,W,27,5,11,0.455,1,2,0.5,1,2,0.5,1,2,3,1,1,1,0,2,12,1,1,LAC,WAS,LAC,125,,,16,15,13,4
Brandon Boston Jr.,G,22023,1630527,22300658,"JAN 29, 2024",LAC @ CLE,L,1,0,0,0.0,0,0,0.0,0,0,0.0,0,0,0,0,0,0,0,0,0,-2,1,LAC,CLE,LAC,108,,,0,0,0,0
Brandon Boston Jr.,G,22023,1630527,22300646,"JAN 27, 2024",LAC @ BOS,W,10,1,5,0.2,1,1,1.0,0,0,0.0,2,0,2,0,0,1,0,1,3,-16,1,LAC,BOS,LAC,115,,,5,5,3,2
Brandon Boston Jr.,G,22023,1630527,22300637,"JAN 26, 2024",LAC @ TOR,W,2,1,1,1.0,0,0,0.0,0,0,0.0,1,0,1,0,0,0,0,0,2,4,1,LAC,TOR,LAC,127,,,3,3,2,1
Brandon Boston Jr.,G,22023,1630527,22300537,"JAN 12, 2024",LAC @ MEM,W,4,0,3,0.0,0,1,0.0,0,0,0.0,0,0,0,0,0,0,0,2,0,-11,1,LAC,MEM,LAC,128,,,0,0,0,0
Brandon Boston Jr.,G,22023,1630527,22300511,"JAN 08, 2024",LAC vs. PHX,W,5,2,2,1.0,1,1,1.0,0,0,0.0,0,0,0,0,0,0,1,2,5,2,1,LAC,LAC,PHX,138,,,5,5,5,0
Brandon Boston Jr.,G,22023,1630527,22300486,"JAN 05, 2024",LAC @ NOP,W,6,1,3,0.333,0,0,0.0,0,0,0.0,1,1,2,1,0,0,1,1,2,-12,1,LAC,NOP,LAC,111,,,5,4,3,3
Brandon Boston Jr.,G,22023,1630527,22300458,"JAN 01, 2024",LAC vs. MIA,W,3,0,1,0.0,0,0,0.0,0,0,0.0,0,0,0,0,0,0,0,0,0,-3,1,LAC,LAC,MIA,121,,,0,0,0,0
Brandon Boston Jr.,G,22023,1630527,22300389,"DEC 23, 2023",LAC vs. BOS,L,13,3,6,0.5,1,4,0.25,6,6,1.0,1,2,3,0,0,0,0,1,13,-4,1,LAC,LAC,BOS,108,,,16,16,13,3
Brandon Boston Jr.,G,22023,1630527,22300379,"DEC 21, 2023",LAC @ OKC,L,16,3,10,0.3,1,5,0.2,0,0,0.0,1,0,1,1,1,0,0,1,7,-4,1,LAC,OKC,LAC,115,,,9,8,8,2
Brandon Boston Jr.,G,22023,1630527,22300350,"DEC 18, 2023",LAC @ IND,W,6,3,4,0.75,0,0,0.0,0,0,0.0,0,0,0,0,0,0,1,2,6,-5,1,LAC,IND,LAC,151,,,6,6,6,0
Brandon Boston Jr.,G,22023,1630527,22300343,"DEC 16, 2023",LAC vs. NYK,W,5,1,3,0.333,1,3,0.333,0,0,0.0,0,2,2,2,0,0,0,1,3,-2,1,LAC,LAC,NYK,144,,,7,5,5,4
DeAndre Jordan,C,22023,201599,22300746,"FEB 09, 2024",DEN @ SAC,L,6,1,3,0.333,0,0,0.0,0,0,0.0,2,3,5,0,0,0,0,0,2,-10,1,DEN,SAC,DEN,106,,,7,7,2,5
DeAndre Jordan,C,22023,201599,22300740,"FEB 08, 2024",DEN @ LAL,W,11,3,6,0.5,0,0,0.0,0,0,0.0,4,4,8,1,0,0,0,2,6,0,1,DEN,LAL,DEN,114,,,15,14,7,9
DeAndre Jordan,C,22023,201599,22300712,"FEB 04, 2024",DEN vs. POR,W,8,2,2,1.0,0,0,0.0,0,0,0.0,0,1,1,0,0,0,0,1,4,5,1,DEN,DEN,POR,112,,,5,5,4,1
DeAndre Jordan,C,22023,201599,22300697,"FEB 02, 2024",DEN vs. POR,W,5,1,1,1.0,0,0,0.0,0,0,0.0,1,0,1,0,0,0,0,1,2,-10,1,DEN,DEN,POR,120,,,3,3,2,1
DeAndre Jordan,C,22023,201599,22300667,"JAN 29, 2024",DEN vs. MIL,W,8,2,3,0.667,0,0,0.0,1,1,1.0,0,2,2,0,0,1,0,2,5,-2,1,DEN,DEN,MIL,113,,,7,7,5,2
DeAndre Jordan,C,22023,201599,22300644,"JAN 27, 2024",DEN vs. PHI,W,11,1,1,1.0,0,0,0.0,0,0,0.0,3,3,6,0,0,1,0,2,2,4,1,DEN,DEN,PHI,111,,,8,8,2,6
DeAndre Jordan,C,22023,201599,22300631,"JAN 25, 2024",DEN @ NYK,L,11,0,2,0.0,0,0,0.0,0,0,0.0,2,3,5,0,0,0,0,0,0,-8,1,DEN,NYK,DEN,84,,,5,5,0,5
DeAndre Jordan,C,22023,201599,22300614,"JAN 23, 2024",DEN @ IND,W,11,1,1,1.0,0,0,0.0,0,2,0.0,2,1,3,1,0,1,1,2,2,-2,1,DEN,IND,DEN,114,,,6,5,3,4
DeAndre Jordan,C,22023,201599,22300602,"JAN 21, 2024",DEN @ WAS,W,7,1,1,1.0,0,0,0.0,1,2,0.5,2,2,4,0,0,0,1,1,3,-4,1,DEN,WAS,DEN,113,,,7,7,3,4
DeAndre Jordan,C,22023,201599,22300566,"JAN 16, 2024",DEN @ PHI,L,10,2,2,1.0,0,0,0.0,0,0,0.0,0,1,1,0,0,0,0,3,4,-5,1,DEN,PHI,DEN,121,,,5,5,4,1
DeAndre Jordan,C,22023,201599,22300550,"JAN 14, 2024",DEN vs. IND,W,7,0,0,0.0,0,0,0.0,0,0,0.0,0,2,2,1,0,0,2,4,0,-4,1,DEN,DEN,IND,117,,,3,2,1,3
DeAndre Jordan,C,22023,201599,22300539,"JAN 12, 2024",DEN vs. NOP,W,14,2,2,1.0,0,0,0.0,2,2,1.0,1,6,7,1,0,1,0,1,6,6,1,DEN,DEN,NOP,125,,,14,13,7,8
DeAndre Jordan,C,22023,201599,22300524,"JAN 10, 2024",DEN @ UTA,L,8,1,3,0.333,0,0,0.0,3,4,0.75,2,3,5,0,0,1,0,0,5,-4,1,DEN,UTA,DEN,111,,,10,10,5,5
DeAndre Jordan,C,22023,201599,22300502,"JAN 07, 2024",DEN vs. DET,W,21,3,3,1.0,0,0,0.0,3,5,0.6,0,7,7,1,0,1,3,5,9,7,1,DEN,DEN,DET,131,,,17,16,10,8
DeAndre Jordan,C,22023,201599,22300435,"DEC 29, 2023",DEN vs. OKC,L,13,3,4,0.75,0,0,0.0,0,0,0.0,3,5,8,1,1,0,1,0,6,-1,1,DEN,DEN,OKC,93,,,15,14,7,9
DeAndre Jordan,C,22023,201599,22300425,"DEC 28, 2023",DEN vs. MEM,W,13,2,3,0.667,0,0,0.0,0,0,0.0,5,4,9,2,0,2,0,3,4,9,1,DEN,DEN,MEM,142,,,15,13,6,11
DeAndre Jordan,C,22023,201599,22300383,"DEC 22, 2023",DEN @ BKN,W,6,1,1,1.0,0,0,0.0,0,0,0.0,0,0,0,0,0,0,0,0,2,-9,1,DEN,BKN,DEN,122,,,2,2,2,0
DeAndre Jordan,C,22023,201599,22300340,"DEC 16, 2023",DEN vs. OKC,L,6,1,2,0.5,0,0,0.0,0,0,0.0,3,4,7,1,0,0,0,1,2,5,1,DEN,DEN,OKC,117,,,10,9,3,8
DeAndre Jordan,C,22023,201599,22300322,"DEC 14, 2023",DEN vs. BKN,W,12,1,2,0.5,0,0,0.0,0,0,0.0,2,2,4,0,0,1,1,2,2,-2,1,DEN,DEN,BKN,124,,,6,6,2,4
DeAndre Jordan,C,22023,201599,22300307,"DEC 12, 2023",DEN @ CHI,W,25,2,4,0.5,0,0,0.0,5,10,0.5,4,6,10,2,1,2,2,5,9,-6,1,DEN,CHI,DEN,114,,,21,19,11,12
DeAndre Jordan,C,22023,201599,22301224,"DEC 08, 2023",DEN vs. HOU,L,12,1,2,0.5,0,0,0.0,0,0,0.0,1,3,4,2,1,0,1,2,2,-2,1,DEN,DEN,HOU,106,,,8,6,4,6
DeAndre Jordan,C,22023,201599,22301215,"DEC 06, 2023",DEN @ LAC,L,11,2,6,0.333,0,0,0.0,0,0,0.0,3,2,5,0,0,1,0,0,4,-8,1,DEN,LAC,DEN,102,,,9,9,4,5
DeAndre Jordan,C,22023,201599,22300290,"DEC 02, 2023",DEN @ SAC,L,10,2,6,0.333,0,0,0.0,0,2,0.0,2,2,4,0,0,0,1,0,4,-17,1,DEN,SAC,DEN,117,,,8,8,4,4
DeAndre Jordan,C,22023,201599,22300279,"DEC 01, 2023",DEN @ PHX,W,13,1,1,1.0,0,0,0.0,0,1,0.0,0,2,2,0,0,0,2,2,2,2,1,DEN,PHX,DEN,119,,,4,4,2,2
DeAndre Jordan,C,22023,201599,22300263,"NOV 29, 2023",DEN vs. HOU,W,6,1,1,1.0,0,0,0.0,0,2,0.0,1,0,1,0,0,0,0,0,2,-11,1,DEN,DEN,HOU,134,,,3,3,2,1
DeAndre Jordan,C,22023,201599,22300257,"NOV 27, 2023",DEN @ LAC,W,34,8,11,0.727,0,0,0.0,5,11,0.455,3,10,13,5,2,1,2,3,21,17,1,DEN,LAC,DEN,113,,,39,34,26,18
DeAndre Jordan,C,22023,201599,22300252,"NOV 26, 2023",DEN vs. SAS,W,12,3,3,1.0,0,0,0.0,0,3,0.0,1,5,6,1,0,0,1,3,6,2,1,DEN,DEN,SAS,132,,,13,12,7,7
DeAndre Jordan,C,22023,201599,22300139,"NOV 04, 2023",DEN vs. CHI,W,12,0,0,0.0,0,0,0.0,1,2,0.5,1,0,1,1,0,0,1,2,1,-10,1,DEN,DEN,CHI,123,,,3,2,2,2
Seth Curry,G,22023,203552,22300751,"FEB 10, 2024",CHA vs. MEM,W,20,1,3,0.333,1,3,0.333,0,0,0.0,1,1,2,1,2,1,1,0,3,4,1,CHA,CHA,MEM,115,,,6,5,4,3
Seth Curry,G,22023,203552,22300487,"JAN 05, 2024",DAL vs. POR,W,20,4,9,0.444,1,4,0.25,0,0,0.0,1,1,2,1,0,0,0,2,9,12,1,DAL,DAL,POR,132,,,12,11,10,3
Seth Curry,G,22023,203552,22300385,"DEC 22, 2023",DAL @ HOU,L,18,0,7,0.0,0,2,0.0,0,0,0.0,0,2,2,0,2,0,2,1,0,-23,1,DAL,HOU,DAL,96,,,2,2,0,2
Seth Curry,G,22023,203552,22300356,"DEC 18, 2023",DAL @ DEN,L,7,0,0,0.0,0,0,0.0,0,0,0.0,0,0,0,0,0,0,0,2,0,-1,1,DAL,DEN,DAL,104,,,0,0,0,0
Seth Curry,G,22023,203552,22300341,"DEC 16, 2023",DAL @ POR,W,14,2,6,0.333,2,3,0.667,1,1,1.0,0,2,2,1,0,0,1,3,7,17,1,DAL,POR,DAL,131,,,10,9,8,3
Seth Curry,G,22023,203552,22300680,"JAN 31, 2024",DAL @ MIN,L,17,3,8,0.375,0,3,0.0,3,3,1.0,1,2,3,3,0,0,2,0,9,-11,1,DAL,MIN,DAL,82,,,15,12,12,6
Seth Curry,G,22023,203552,22300666,"JAN 29, 2024",DAL vs. ORL,W,5,0,0,0.0,0,0,0.0,0,0,0.0,0,0,0,0,0,0,0,0,0,3,1,DAL,DAL,ORL,131,,,0,0,0,0
Seth Curry,G,22023,203552,22300651,"JAN 27, 2024",DAL vs. SAC,L,11,3,5,0.6,1,3,0.333,0,0,0.0,1,1,2,1,0,0,0,1,7,7,1,DAL,DAL,SAC,115,,,10,9,8,3
Seth Curry,G,22023,203552,22300577,"JAN 17, 2024",DAL @ LAL,L,5,0,2,0.0,0,1,0.0,0,0,0.0,0,0,0,0,0,0,0,0,0,-9,1,DAL,LAL,DAL,105,,,0,0,0,0
Seth Curry,G,22023,203552,22300556,"JAN 15, 2024",DAL vs. NOP,W,7,0,2,0.0,0,1,0.0,0,0,0.0,0,0,0,0,0,0,0,1,0,-2,1,DAL,DAL,NOP,125,,,0,0,0,0
Seth Curry,G,22023,203552,22300547,"JAN 13, 2024",DAL vs. NOP,L,12,1,3,0.333,1,2,0.5,0,0,0.0,0,0,0,0,1,0,0,3,3,1,1,DAL,DAL,NOP,108,,,3,3,3,0
Seth Curry,G,22023,203552,22300530,"JAN 11, 2024",DAL vs. NYK,W,10,0,1,0.0,0,1,0.0,0,0,0.0,0,1,1,0,0,0,1,0,0,2,1,DAL,DAL,NYK,128,,,1,1,0,1
Seth Curry,G,22023,203552,22300515,"JAN 09, 2024",DAL vs. MEM,L,10,1,2,0.5,0,1,0.0,0,0,0.0,0,0,0,0,0,0,1,1,2,-8,1,DAL,DAL,MEM,103,,,2,2,2,0
Seth Curry,G,22023,203552,22300501,"JAN 07, 2024",DAL vs. MIN,W,12,0,3,0.0,0,2,0.0,0,0,0.0,0,3,3,0,1,0,1,1,0,0,1,DAL,DAL,MIN,115,,,3,3,0,3
Seth Curry,G,22023,203552,22300472,"JAN 03, 2024",DAL vs. POR,W,15,0,1,0.0,0,0,0.0,0,0,0.0,0,1,1,2,0,0,0,0,0,28,1,DAL,DAL,POR,126,,,3,1,2,3
Seth Curry,G,22023,203552,22300423,"DEC 28, 2023",DAL @ MIN,L,30,3,8,0.375,2,4,0.5,3,4,0.75,0,2,2,3,0,0,3,2,11,6,1,DAL,MIN,DAL,110,,,16,13,14,5
Seth Curry,G,22023,203552,22300420,"DEC 27, 2023",DAL vs. CLE,L,28,6,11,0.545,5,9,0.556,2,2,1.0,1,3,4,1,2,0,0,1,19,0,1,DAL,DAL,CLE,110,,,24,23,20,5
Seth Curry,G,22023,203552,22300405,"DEC 25, 2023",DAL @ PHX,W,6,0,0,0.0,0,0,0.0,0,0,0.0,1,0,1,0,0,0,0,0,0,4,1,DAL,PHX,DAL,128,,,1,1,0,1
Seth Curry,G,22023,203552,22300306,"DEC 12, 2023",DAL vs. LAL,W,12,1,2,0.5,1,2,0.5,0,0,0.0,1,1,2,0,0,1,0,0,3,4,1,DAL,DAL,LAL,127,,,5,5,3,2
Seth Curry,G,22023,203552,22300299,"DEC 11, 2023",DAL @ MEM,W,20,2,5,0.4,1,3,0.333,1,1,1.0,1,2,3,2,1,0,0,1,6,8,1,DAL,MEM,DAL,120,,,11,9,8,5
Seth Curry,G,22023,203552,22301226,"DEC 08, 2023",DAL @ POR,W,18,2,5,0.4,2,4,0.5,1,1,1.0,1,1,2,1,0,0,1,1,7,14,1,DAL,POR,DAL,125,,,10,9,8,3
Seth Curry,G,22023,203552,22301213,"DEC 06, 2023",DAL vs. UTA,W,19,4,7,0.571,2,3,0.667,0,0,0.0,1,1,2,2,2,0,0,0,10,26,1,DAL,DAL,UTA,147,,,14,12,12,4
Seth Curry,G,22023,203552,22300287,"DEC 02, 2023",DAL vs. OKC,L,36,4,15,0.267,4,9,0.444,0,0,0.0,3,2,5,3,1,1,0,2,12,14,1,DAL,DAL,OKC,120,,,20,17,15,8
Seth Curry,G,22023,203552,22300277,"DEC 01, 2023",DAL vs. MEM,L,16,5,10,0.5,2,4,0.5,0,0,0.0,0,2,2,2,1,0,0,2,12,-5,1,DAL,DAL,MEM,94,,,16,14,14,4
Seth Curry,G,22023,203552,22300059,"NOV 28, 2023",DAL vs. HOU,W,0,0,0,0.0,0,0,0.0,0,0,0.0,0,0,0,0,0,0,0,0,0,2,1,DAL,DAL,HOU,121,,,0,0,0,0
Seth Curry,G,22023,203552,22300244,"NOV 25, 2023",DAL @ LAC,L,8,1,5,0.2,1,4,0.25,0,0,0.0,0,0,0,0,0,0,0,2,3,-4,1,DAL,LAC,DAL,88,,,3,3,3,0
Seth Curry,G,22023,203552,22300238,"NOV 22, 2023",DAL @ LAL,W,0,0,0,0.0,0,0,0.0,0,0,0.0,0,0,0,0,0,0,0,0,0,2,1,DAL,LAL,DAL,104,,,0,0,0,0
Seth Curry,G,22023,203552,22300205,"NOV 18, 2023",DAL @ MIL,L,9,1,2,0.5,0,1,0.0,0,0,0.0,0,1,1,0,0,0,0,0,2,-10,1,DAL,MIL,DAL,125,,,3,3,2,1
Seth Curry,G,22023,203552,22300192,"NOV 15, 2023",DAL @ WAS,W,20,6,6,1.0,2,2,1.0,1,1,1.0,0,2,2,2,1,0,0,1,15,-3,1,DAL,WAS,DAL,130,,,19,17,17,4
Seth Curry,G,22023,203552,22300022,"NOV 14, 2023",DAL @ NOP,L,13,0,4,0.0,0,4,0.0,3,3,1.0,0,3,3,2,3,0,1,1,3,4,1,DAL,NOP,DAL,110,,,8,6,5,5
Seth Curry,G,22023,203552,22300183,"NOV 12, 2023",DAL @ NOP,W,6,0,2,0.0,0,1,0.0,0,0,0.0,1,0,1,0,0,0,0,0,0,-11,1,DAL,NOP,DAL,136,,,1,1,0,1
Seth Curry,G,22023,203552,22300014,"NOV 10, 2023",DAL vs. LAC,W,7,1,2,0.5,1,2,0.5,2,3,0.667,0,0,0,0,0,0,0,0,5,-2,1,DAL,DAL,LAC,144,,,5,5,5,0
Seth Curry,G,22023,203552,22300006,"NOV 03, 2023",DAL @ DEN,L,5,0,1,0.0,0,1,0.0,0,0,0.0,0,1,1,1,1,0,0,1,0,4,1,DAL,DEN,DAL,114,,,2,1,1,2
Seth Curry,G,22023,203552,22300124,"NOV 01, 2023",DAL vs. CHI,W,12,2,5,0.4,0,1,0.0,0,0,0.0,2,1,3,0,0,0,1,0,4,-5,1,DAL,DAL,CHI,114,,,7,7,4,3
Seth Curry,G,22023,203552,22300106,"OCT 30, 2023",DAL @ MEM,W,15,1,5,0.2,1,3,0.333,0,0,0.0,0,2,2,2,1,1,1,2,3,14,1,DAL,MEM,DAL,125,,,7,5,5,4
Seth Curry,G,22023,203552,22300084,"OCT 27, 2023",DAL vs. BKN,W,9,1,1,1.0,0,0,0.0,0,0,0.0,0,0,0,1,0,0,1,1,2,1,1,DAL,DAL,BKN,125,,,3,2,3,1
Seth Curry,G,22023,203552,22300073,"OCT 25, 2023",DAL @ SAS,W,4,0,0,0.0,0,0,0.0,0,0,0.0,0,0,0,0,0,0,0,0,0,4,1,DAL,SAS,DAL,126,,,0,0,0,0
Troy Brown Jr.,G-F,22023,1628972,22300709,"FEB 04, 2024",MIN vs. HOU,W,4,0,0,0.0,0,0,0.0,0,0,0.0,0,1,1,0,0,0,0,1,0,-7,1,MIN,MIN,HOU,111,,,1,1,0,1
Troy Brown Jr.,G-F,22023,1628972,22300680,"JAN 31, 2024",MIN vs. DAL,W,6,2,4,0.5,1,2,0.5,0,0,0.0,0,2,2,2,0,0,0,0,5,7,1,MIN,MIN,DAL,121,,,9,7,7,4
Troy Brown Jr.,G-F,22023,1628972,22300664,"JAN 29, 2024",MIN @ OKC,W,6,0,1,0.0,0,1,0.0,0,0,0.0,0,0,0,0,0,0,0,1,0,3,1,MIN,OKC,MIN,107,,,0,0,0,0
Troy Brown Jr.,G-F,22023,1628972,22300569,"JAN 17, 2024",MIN @ DET,W,1,0,0,0.0,0,0,0.0,0,0,0.0,0,0,0,0,0,0,0,0,0,-5,1,MIN,DET,MIN,124,,,0,0,0,0
Troy Brown Jr.,G-F,22023,1628972,22300538,"JAN 12, 2024",MIN vs. POR,W,9,2,5,0.4,2,5,0.4,0,0,0.0,1,1,2,3,0,0,3,1,6,-10,1,MIN,MIN,POR,116,,,11,8,9,5
Troy Brown Jr.,G-F,22023,1628972,22300517,"JAN 10, 2024",MIN @ BOS,L,8,1,3,0.333,0,2,0.0,0,0,0.0,0,1,1,1,0,0,0,0,2,-7,1,MIN,BOS,MIN,120,,,4,3,3,2
Troy Brown Jr.,G-F,22023,1628972,22300513,"JAN 09, 2024",MIN @ ORL,W,2,0,2,0.0,0,2,0.0,0,0,0.0,0,1,1,1,0,0,0,0,0,-2,1,MIN,ORL,MIN,113,,,2,1,1,2
Troy Brown Jr.,G-F,22023,1628972,22300485,"JAN 05, 2024",MIN @ HOU,W,3,1,2,0.5,1,2,0.5,0,0,0.0,0,1,1,1,0,0,0,0,3,0,1,MIN,HOU,MIN,122,,,5,4,4,2
Troy Brown Jr.,G-F,22023,1628972,22300471,"JAN 03, 2024",MIN vs. NOP,L,3,1,2,0.5,1,2,0.5,0,0,0.0,0,0,0,1,0,0,0,0,3,8,1,MIN,MIN,NOP,106,,,4,3,4,1
Troy Brown Jr.,G-F,22023,1628972,22300451,"JAN 01, 2024",MIN @ NYK,L,6,0,0,0.0,0,0,0.0,0,0,0.0,0,1,1,0,0,0,1,1,0,-15,1,MIN,NYK,MIN,106,,,1,1,0,1
Troy Brown Jr.,G-F,22023,1628972,22300443,"DEC 30, 2023",MIN vs. LAL,W,8,1,3,0.333,1,2,0.5,0,0,0.0,0,3,3,0,1,0,0,0,3,2,1,MIN,MIN,LAL,108,,,6,6,3,3
Troy Brown Jr.,G-F,22023,1628972,22300423,"DEC 28, 2023",MIN vs. DAL,W,6,1,1,1.0,0,0,0.0,0,0,0.0,0,0,0,0,1,0,0,0,2,-5,1,MIN,MIN,DAL,118,,,2,2,2,0
Troy Brown Jr.,G-F,22023,1628972,22300411,"DEC 26, 2023",MIN @ OKC,L,2,0,1,0.0,0,1,0.0,0,0,0.0,0,0,0,1,0,0,0,0,0,-4,1,MIN,OKC,MIN,106,,,1,0,1,1
Troy Brown Jr.,G-F,22023,1628972,22300400,"DEC 23, 2023",MIN @ SAC,W,3,0,0,0.0,0,0,0.0,0,0,0.0,0,1,1,0,0,0,0,3,0,-3,1,MIN,SAC,MIN,110,,,1,1,0,1
Troy Brown Jr.,G-F,22023,1628972,22300380,"DEC 21, 2023",MIN vs. LAL,W,6,0,1,0.0,0,1,0.0,2,2,1.0,0,1,1,0,0,0,0,2,2,3,1,MIN,MIN,LAL,118,,,3,3,2,1
Troy Brown Jr.,G-F,22023,1628972,22300367,"DEC 20, 2023",MIN @ PHI,L,10,2,4,0.5,1,2,0.5,0,0,0.0,1,1,2,1,0,0,3,0,5,-11,1,MIN,PHI,MIN,113,,,8,7,6,3
Troy Brown Jr.,G-F,22023,1628972,22300353,"DEC 18, 2023",MIN @ MIA,W,5,1,1,1.0,1,1,1.0,0,0,0.0,0,1,1,1,0,0,1,0,3,-8,1,MIN,MIA,MIN,112,,,5,4,4,2
Troy Brown Jr.,G-F,22023,1628972,22300338,"DEC 16, 2023",MIN vs. IND,W,16,4,6,0.667,3,5,0.6,0,0,0.0,0,1,1,4,0,0,1,1,11,5,1,MIN,MIN,IND,127,,,16,12,15,5
Troy Brown Jr.,G-F,22023,1628972,22300321,"DEC 14, 2023",MIN @ DAL,W,15,2,4,0.5,1,3,0.333,0,0,0.0,0,1,1,1,0,0,0,0,5,-2,1,MIN,DAL,MIN,119,,,7,6,6,2
Troy Brown Jr.,G-F,22023,1628972,22300301,"DEC 11, 2023",MIN @ NOP,L,27,2,9,0.222,1,7,0.143,0,0,0.0,0,6,6,2,0,0,0,1,5,-15,1,MIN,NOP,MIN,107,,,13,11,7,8
Troy Brown Jr.,G-F,22023,1628972,22301221,"DEC 08, 2023",MIN @ MEM,W,30,8,10,0.8,4,6,0.667,0,0,0.0,1,3,4,4,1,0,1,2,20,18,1,MIN,MEM,MIN,127,,,28,24,24,8
Troy Brown Jr.,G-F,22023,1628972,22301210,"DEC 06, 2023",MIN vs. SAS,W,25,3,9,0.333,2,8,0.25,0,0,0.0,0,1,1,2,0,1,1,1,8,7,1,MIN,MIN,SAS,102,,,11,9,10,3
Troy Brown Jr.,G-F,22023,1628972,22300281,"DEC 02, 2023",MIN @ CHA,W,32,3,7,0.429,3,6,0.5,0,0,0.0,1,2,3,1,1,0,1,4,9,15,1,MIN,CHA,MIN,123,,,13,12,10,4
Troy Brown Jr.,G-F,22023,1628972,22300270,"NOV 30, 2023",MIN vs. UTA,W,29,3,6,0.5,2,3,0.667,0,0,0.0,0,3,3,2,1,0,1,0,8,20,1,MIN,MIN,UTA,101,,,13,11,10,5
Troy Brown Jr.,G-F,22023,1628972,22300058,"NOV 28, 2023",MIN vs. OKC,W,21,5,6,0.833,3,4,0.75,4,6,0.667,0,3,3,0,0,0,1,2,17,1,1,MIN,MIN,OKC,106,,,20,20,17,3
Troy Brown Jr.,G-F,22023,1628972,22300249,"NOV 26, 2023",MIN @ MEM,W,18,2,4,0.5,2,4,0.5,0,0,0.0,2,2,4,1,0,0,1,1,6,5,1,MIN,MEM,MIN,119,,,11,10,7,5
Troy Brown Jr.,G-F,22023,1628972,22300050,"NOV 24, 2023",MIN vs. SAC,L,25,4,8,0.5,1,5,0.2,1,2,0.5,3,4,7,0,0,1,0,1,10,9,1,MIN,MIN,SAC,111,,,17,17,10,7
Troy Brown Jr.,G-F,22023,1628972,22300232,"NOV 22, 2023",MIN vs. PHI,W,7,0,1,0.0,0,0,0.0,0,0,0.0,1,0,1,0,0,0,0,0,0,-6,1,MIN,MIN,PHI,112,,,1,1,0,1
Troy Brown Jr.,G-F,22023,1628972,22300221,"NOV 20, 2023",MIN vs. NYK,W,17,1,5,0.2,1,3,0.333,2,2,1.0,1,4,5,2,0,0,0,2,5,2,1,MIN,MIN,NYK,117,,,12,10,7,7
Troy Brown Jr.,G-F,22023,1628972,22300197,"NOV 15, 2023",MIN @ PHX,L,14,0,3,0.0,0,2,0.0,4,4,1.0,1,3,4,1,1,0,0,1,4,6,1,MIN,PHX,MIN,115,,,9,8,5,5
Troy Brown Jr.,G-F,22023,1628972,22300025,"NOV 14, 2023",MIN @ GSW,W,10,0,1,0.0,0,1,0.0,0,0,0.0,1,1,2,1,1,0,0,0,0,-1,1,MIN,GSW,MIN,104,,,3,2,1,3
Troy Brown Jr.,G-F,22023,1628972,22300186,"NOV 12, 2023",MIN @ GSW,W,1,0,0,0.0,0,0,0.0,2,2,1.0,0,0,0,0,0,0,0,0,2,-4,1,MIN,GSW,MIN,116,,,2,2,2,0
Troy Brown Jr.,G-F,22023,1628972,22300166,"NOV 08, 2023",MIN vs. NOP,W,5,2,5,0.4,0,1,0.0,0,0,0.0,1,0,1,0,0,0,0,0,4,-6,1,MIN,MIN,NOP,122,,,5,5,4,1
Troy Brown Jr.,G-F,22023,1628972,22300138,"NOV 04, 2023",MIN vs. UTA,W,4,1,1,1.0,0,0,0.0,0,0,0.0,0,2,2,0,0,0,0,0,2,5,1,MIN,MIN,UTA,123,,,4,4,2,2
Troy Brown Jr.,G-F,22023,1628972,22300123,"NOV 01, 2023",MIN vs. DEN,W,5,0,1,0.0,0,1,0.0,4,4,1.0,0,4,4,1,0,0,1,0,4,0,1,MIN,MIN,DEN,110,,,9,8,5,5
Troy Brown Jr.,G-F,22023,1628972,22300093,"OCT 28, 2023",MIN vs. MIA,W,15,0,2,0.0,0,2,0.0,0,0,0.0,0,2,2,1,1,0,2,1,0,-5,1,MIN,MIN,MIA,106,,,3,2,1,3
Troy Brown Jr.,G-F,22023,1628972,22300069,"OCT 25, 2023",MIN @ TOR,L,5,0,0,0.0,0,0,0.0,0,0,0.0,0,1,1,0,0,0,0,0,0,1,1,MIN,TOR,MIN,94,,,1,1,0,1
Troy Brown Jr.,G-F,22023,1628972,22300749,"FEB 10, 2024",DET @ LAC,L,19,2,5,0.4,2,5,0.4,2,2,1.0,0,2,2,2,0,0,0,1,8,-8,1,DET,LAC,DET,106,,,12,10,10,4
Dru Smith,G,22023,1630696,22300220,"NOV 20, 2023",MIA @ CHI,W,2,0,1,0.0,0,1,0.0,0,0,0.0,0,1,1,0,1,0,0,0,0,-6,1,MIA,CHI,MIA,118,,,1,1,0,1
Dru Smith,G,22023,1630696,22300017,"NOV 14, 2023",MIA @ CHA,W,3,0,0,0.0,0,0,0.0,0,0,0.0,0,0,0,0,0,0,0,2,0,1,1,MIA,CHA,MIA,111,,,0,0,0,0
Dru Smith,G,22023,1630696,22300184,"NOV 12, 2023",MIA @ SAS,W,27,4,9,0.444,2,5,0.4,2,2,1.0,2,2,4,3,0,0,1,2,12,5,1,MIA,SAS,MIA,118,,,19,16,15,7
Dru Smith,G,22023,1630696,22300175,"NOV 11, 2023",MIA @ ATL,W,28,4,8,0.5,1,3,0.333,0,0,0.0,1,1,2,2,3,1,2,3,9,-1,1,MIA,ATL,MIA,117,,,13,11,11,4
Dru Smith,G,22023,1630696,22300164,"NOV 08, 2023",MIA @ MEM,W,15,1,3,0.333,0,2,0.0,0,0,0.0,2,2,4,1,1,1,0,0,2,-3,1,MIA,MEM,MIA,108,,,7,6,3,5
Dru Smith,G,22023,1630696,22300093,"OCT 28, 2023",MIA @ MIN,L,22,2,4,0.5,1,1,1.0,0,0,0.0,0,1,1,4,1,0,1,1,5,-12,1,MIA,MIN,MIA,90,,,10,6,9,5
Dru Smith,G,22023,1630696,22300080,"OCT 27, 2023",MIA @ BOS,L,23,3,6,0.5,3,4,0.75,0,0,0.0,1,1,2,3,3,1,1,2,9,-18,1,MIA,BOS,MIA,111,,,14,11,12,5
Dru Smith,G,22023,1630696,22300068,"OCT 25, 2023",MIA vs. DET,W,9,1,2,0.5,0,1,0.0,0,0,0.0,0,0,0,1,0,0,0,1,2,-4,1,MIA,MIA,DET,103,,,3,2,3,1
Dru Smith,G,22023,1630696,22300229,"NOV 22, 2023",MIA @ CLE,W,1,0,0,0.0,0,0,0.0,0,0,0.0,0,0,0,0,0,0,0,1,0,-5,1,MIA,CLE,MIA,129,,,0,0,0,0
Thomas Bryant,C-F,22023,1628418,22300678,"JAN 31, 2024",MIA vs. SAC,W,3,0,0,0.0,0,0,0.0,0,0,0.0,0,1,1,0,0,0,0,0,0,-3,1,MIA,MIA,SAC,115,,,1,1,0,1
Thomas Bryant,C-F,22023,1628418,22300630,"JAN 25, 2024",MIA vs. BOS,L,13,3,4,0.75,0,1,0.0,1,2,0.5,3,2,5,2,0,0,0,1,7,-4,1,MIA,MIA,BOS,110,,,14,12,9,7
Thomas Bryant,C-F,22023,1628418,22300621,"JAN 24, 2024",MIA vs. MEM,L,7,0,0,0.0,0,0,0.0,0,0,0.0,0,0,0,0,0,0,0,1,0,-7,1,MIA,MIA,MEM,96,,,0,0,0,0
Thomas Bryant,C-F,22023,1628418,22300574,"JAN 17, 2024",MIA @ TOR,L,4,1,1,1.0,0,0,0.0,0,0,0.0,0,0,0,0,0,0,0,1,2,-3,1,MIA,TOR,MIA,97,,,2,2,2,0
Thomas Bryant,C-F,22023,1628418,22300562,"JAN 15, 2024",MIA @ BKN,W,5,0,0,0.0,0,0,0.0,0,0,0.0,0,0,0,1,0,0,0,0,0,2,1,MIA,BKN,MIA,96,,,1,0,1,1
Thomas Bryant,C-F,22023,1628418,22300489,"JAN 05, 2024",MIA @ PHX,L,2,0,0,0.0,0,0,0.0,0,0,0.0,0,2,2,0,0,0,0,0,0,5,1,MIA,PHX,MIA,97,,,2,2,0,2
Thomas Bryant,C-F,22023,1628418,22300458,"JAN 01, 2024",MIA @ LAC,L,3,0,0,0.0,0,0,0.0,0,0,0.0,0,0,0,1,0,0,0,0,0,-6,1,MIA,LAC,MIA,104,,,1,0,1,1
Thomas Bryant,C-F,22023,1628418,22300366,"DEC 20, 2023",MIA @ ORL,W,17,5,7,0.714,0,0,0.0,2,2,1.0,3,2,5,1,0,0,2,1,12,20,1,MIA,ORL,MIA,115,,,18,17,13,6
Thomas Bryant,C-F,22023,1628418,22300267,"NOV 30, 2023",MIA vs. IND,W,6,1,1,1.0,0,0,0.0,0,0,0.0,1,3,4,1,0,0,0,1,2,-1,1,MIA,MIA,IND,142,,,7,6,3,5
Thomas Bryant,C-F,22023,1628418,22300017,"NOV 14, 2023",MIA @ CHA,W,3,1,3,0.333,0,0,0.0,0,0,0.0,1,0,1,0,0,0,0,0,2,5,1,MIA,CHA,MIA,111,,,3,3,2,1
Thomas Bryant,C-F,22023,1628418,22300184,"NOV 12, 2023",MIA @ SAS,W,5,1,1,1.0,0,0,0.0,0,0,0.0,0,0,0,1,0,0,0,0,2,9,1,MIA,SAS,MIA,118,,,3,2,3,1
Thomas Bryant,C-F,22023,1628418,22300164,"NOV 08, 2023",MIA @ MEM,W,12,1,3,0.333,0,0,0.0,0,0,0.0,1,5,6,0,0,0,1,1,2,-9,1,MIA,MEM,MIA,108,,,8,8,2,6
Thomas Bryant,C-F,22023,1628418,22300150,"NOV 06, 2023",MIA vs. LAL,W,10,1,1,1.0,0,0,0.0,0,0,0.0,0,4,4,0,0,1,1,1,2,-4,1,MIA,MIA,LAL,108,,,6,6,2,4
Thomas Bryant,C-F,22023,1628418,22300003,"NOV 03, 2023",MIA vs. WAS,W,18,5,7,0.714,0,0,0.0,1,2,0.5,2,2,4,0,0,1,2,4,11,1,1,MIA,MIA,WAS,121,,,15,15,11,4
Thomas Bryant,C-F,22023,1628418,22300119,"NOV 01, 2023",MIA vs. BKN,L,15,3,4,0.75,0,0,0.0,2,2,1.0,1,4,5,0,1,0,2,4,8,-9,1,MIA,MIA,BKN,105,,,13,13,8,5
Thomas Bryant,C-F,22023,1628418,22300093,"OCT 28, 2023",MIA @ MIN,L,12,2,4,0.5,0,0,0.0,1,2,0.5,3,2,5,1,0,0,1,1,5,-8,1,MIA,MIN,MIA,90,,,11,10,6,6
Thomas Bryant,C-F,22023,1628418,22300080,"OCT 27, 2023",MIA @ BOS,L,13,1,5,0.2,0,1,0.0,0,0,0.0,1,3,4,1,0,1,1,1,2,-8,1,MIA,BOS,MIA,111,,,7,6,3,5
Thomas Bryant,C-F,22023,1628418,22300068,"OCT 25, 2023",MIA vs. DET,W,16,2,5,0.4,0,0,0.0,4,5,0.8,2,4,6,3,1,0,1,0,8,5,1,MIA,MIA,DET,103,,,17,14,11,9
Thomas Bryant,C-F,22023,1628418,22300337,"DEC 16, 2023",MIA vs. CHI,W,6,1,2,0.5,0,0,0.0,0,0,0.0,0,2,2,0,0,1,0,2,2,-8,1,MIA,MIA,CHI,118,,,4,4,2,2
Thomas Bryant,C-F,22023,1628418,22300320,"DEC 14, 2023",MIA vs. CHI,L,12,2,2,1.0,0,0,0.0,2,2,1.0,0,2,2,1,0,0,0,1,6,0,1,MIA,MIA,CHI,116,,,9,8,7,3
Thomas Bryant,C-F,22023,1628418,22300312,"DEC 13, 2023",MIA vs. CHA,W,16,5,7,0.714,0,0,0.0,1,1,1.0,6,3,9,0,0,0,1,2,11,-2,1,MIA,MIA,CHA,115,,,20,20,11,9
Thomas Bryant,C-F,22023,1628418,22300292,"DEC 11, 2023",MIA @ CHA,W,4,0,0,0.0,0,0,0.0,0,0,0.0,0,2,2,1,0,0,0,0,0,2,1,MIA,CHA,MIA,116,,,3,2,1,3
Thomas Bryant,C-F,22023,1628418,22300240,"NOV 25, 2023",MIA @ BKN,L,13,1,5,0.2,0,1,0.0,0,0,0.0,0,1,1,0,1,0,2,1,2,-17,1,MIA,BKN,MIA,97,,,3,3,2,1
Thomas Bryant,C-F,22023,1628418,22300229,"NOV 22, 2023",MIA @ CLE,W,24,4,8,0.5,0,0,0.0,2,2,1.0,1,6,7,1,1,1,0,3,10,13,1,MIA,CLE,MIA,129,,,18,17,11,8
Thomas Bryant,C-F,22023,1628418,22300107,"OCT 30, 2023",MIA @ MIL,L,22,4,7,0.571,0,1,0.0,2,2,1.0,0,2,2,0,2,0,1,0,10,-12,1,MIA,MIL,MIA,114,,,12,12,10,2
Mo Bamba,C,22023,1628964,22300742,"FEB 09, 2024",PHI vs. ATL,L,16,1,3,0.333,1,2,0.5,0,0,0.0,2,1,3,3,1,3,1,2,3,5,1,PHI,PHI,ATL,121,,,9,6,6,6
Mo Bamba,C,22023,1628964,22300727,"FEB 07, 2024",PHI vs. GSW,L,9,0,0,0.0,0,0,0.0,0,0,0.0,0,2,2,1,0,0,2,3,0,-5,1,PHI,PHI,GSW,104,,,3,2,1,3
Mo Bamba,C,22023,1628964,22300715,"FEB 05, 2024",PHI vs. DAL,L,18,2,7,0.286,0,1,0.0,1,2,0.5,4,6,10,0,0,1,1,4,5,-7,1,PHI,PHI,DAL,102,,,15,15,5,10
Mo Bamba,C,22023,1628964,22300698,"FEB 03, 2024",PHI vs. BKN,L,16,2,4,0.5,0,0,0.0,1,2,0.5,3,3,6,0,0,0,0,1,5,-6,1,PHI,PHI,BKN,121,,,11,11,5,6
Mo Bamba,C,22023,1628964,22300686,"FEB 01, 2024",PHI @ UTA,W,18,2,7,0.286,0,2,0.0,0,0,0.0,1,8,9,0,0,3,1,1,4,-7,1,PHI,UTA,PHI,127,,,13,13,4,9
Mo Bamba,C,22023,1628964,22300668,"JAN 29, 2024",PHI @ POR,L,19,2,4,0.5,0,2,0.0,0,0,0.0,0,5,5,1,1,3,0,5,4,-5,1,PHI,POR,PHI,104,,,10,9,5,6
Mo Bamba,C,22023,1628964,22300532,"JAN 12, 2024",PHI vs. SAC,W,20,4,6,0.667,2,2,1.0,1,2,0.5,2,1,3,0,1,4,2,1,11,9,1,PHI,PHI,SAC,112,,,14,14,11,3
Mo Bamba,C,22023,1628964,22300521,"JAN 10, 2024",PHI @ ATL,L,14,2,4,0.5,0,1,0.0,1,2,0.5,4,2,6,2,1,3,1,3,5,-5,1,PHI,ATL,PHI,132,,,13,11,7,8
Mo Bamba,C,22023,1628964,22300495,"JAN 06, 2024",PHI vs. UTA,L,17,3,9,0.333,0,2,0.0,0,1,0.0,3,2,5,1,1,1,0,4,6,-2,1,PHI,PHI,UTA,109,,,12,11,7,6
Mo Bamba,C,22023,1628964,22300483,"JAN 05, 2024",PHI vs. NYK,L,5,1,1,1.0,0,0,0.0,0,0,0.0,0,2,2,1,2,0,0,0,2,-2,1,PHI,PHI,NYK,92,,,5,4,3,3
Mo Bamba,C,22023,1628964,22300459,"JAN 02, 2024",PHI vs. CHI,W,7,0,1,0.0,0,0,0.0,0,0,0.0,0,2,2,0,1,0,2,3,0,-12,1,PHI,PHI,CHI,110,,,2,2,0,2
Mo Bamba,C,22023,1628964,22300442,"DEC 30, 2023",PHI @ CHI,L,13,2,3,0.667,0,0,0.0,1,1,1.0,2,3,5,2,0,0,1,0,5,9,1,PHI,CHI,PHI,92,,,12,10,7,7
Mo Bamba,C,22023,1628964,22300434,"DEC 29, 2023",PHI @ HOU,W,5,0,1,0.0,0,0,0.0,2,2,1.0,2,0,2,0,0,0,0,1,2,-3,1,PHI,HOU,PHI,131,,,4,4,2,2
Mo Bamba,C,22023,1628964,22300415,"DEC 27, 2023",PHI @ ORL,W,16,0,1,0.0,0,0,0.0,0,0,0.0,2,5,7,1,1,1,1,2,0,13,1,PHI,ORL,PHI,112,,,8,7,1,8
Mo Bamba,C,22023,1628964,22300404,"DEC 25, 2023",PHI @ MIA,L,26,7,8,0.875,3,3,1.0,1,2,0.5,1,5,6,2,2,0,1,2,18,-13,1,PHI,MIA,PHI,113,,,26,24,20,8
Mo Bamba,C,22023,1628964,22300367,"DEC 20, 2023",PHI vs. MIN,W,2,0,0,0.0,0,0,0.0,0,0,0.0,0,0,0,0,0,0,0,0,0,2,1,PHI,PHI,MIN,127,,,0,0,0,0
Mo Bamba,C,22023,1628964,22300335,"DEC 16, 2023",PHI @ CHA,W,7,3,3,1.0,1,1,1.0,0,1,0.0,0,1,1,1,0,0,0,2,7,4,1,PHI,CHA,PHI,135,,,9,8,8,2
Mo Bamba,C,22023,1628964,22300327,"DEC 15, 2023",PHI vs. DET,W,9,1,2,0.5,1,1,1.0,0,0,0.0,1,3,4,0,0,1,0,2,3,-4,1,PHI,PHI,DET,124,,,7,7,3,4
Mo Bamba,C,22023,1628964,22300310,"DEC 13, 2023",PHI @ DET,W,3,1,1,1.0,0,0,0.0,0,0,0.0,0,0,0,0,0,0,0,0,2,-5,1,PHI,DET,PHI,129,,,2,2,2,0
Mo Bamba,C,22023,1628964,22300295,"DEC 11, 2023",PHI vs. WAS,W,8,2,6,0.333,0,1,0.0,2,2,1.0,3,3,6,2,0,2,0,1,6,5,1,PHI,PHI,WAS,146,,,14,12,8,8
Mo Bamba,C,22023,1628964,22301218,"DEC 08, 2023",PHI vs. ATL,W,5,0,1,0.0,0,0,0.0,0,0,0.0,1,2,3,0,0,0,1,1,0,-1,1,PHI,PHI,ATL,125,,,3,3,0,3
Mo Bamba,C,22023,1628964,22300275,"DEC 01, 2023",PHI @ BOS,L,20,4,7,0.571,2,4,0.5,1,2,0.5,5,1,6,1,0,1,2,1,11,3,1,PHI,BOS,PHI,119,,,18,17,12,7
Mo Bamba,C,22023,1628964,22300262,"NOV 29, 2023",PHI @ NOP,L,14,3,7,0.429,0,1,0.0,0,1,0.0,3,1,4,0,0,4,1,3,6,5,1,PHI,NOP,PHI,114,,,10,10,6,4
Mo Bamba,C,22023,1628964,22300255,"NOV 27, 2023",PHI vs. LAL,W,5,3,4,0.75,1,1,1.0,0,0,0.0,1,2,3,0,0,0,0,0,7,13,1,PHI,PHI,LAL,138,,,10,10,7,3
Mo Bamba,C,22023,1628964,22300232,"NOV 22, 2023",PHI @ MIN,L,6,1,2,0.5,0,1,0.0,2,2,1.0,1,1,2,0,0,0,0,0,4,8,1,PHI,MIN,PHI,99,,,6,6,4,2
Mo Bamba,C,22023,1628964,22300208,"NOV 19, 2023",PHI @ BKN,W,3,2,2,1.0,0,0,0.0,1,1,1.0,0,0,0,0,1,0,0,0,5,3,1,PHI,BKN,PHI,121,,,5,5,5,0
Mo Bamba,C,22023,1628964,22300148,"NOV 06, 2023",PHI vs. WAS,W,4,0,0,0.0,0,0,0.0,2,2,1.0,0,2,2,0,0,1,2,1,2,-6,1,PHI,PHI,WAS,146,,,4,4,2,2
Mo Bamba,C,22023,1628964,22300132,"NOV 04, 2023",PHI vs. PHX,W,2,0,2,0.0,0,0,0.0,0,0,0.0,2,0,2,0,0,0,0,1,0,-5,1,PHI,PHI,PHX,112,,,2,2,0,2
Mo Bamba,C,22023,1628964,22300128,"NOV 02, 2023",PHI vs. TOR,W,1,0,0,0.0,0,0,0.0,0,0,0.0,0,2,2,0,0,0,1,1,0,-2,1,PHI,PHI,TOR,114,,,2,2,0,2
Mo Bamba,C,22023,1628964,22300098,"OCT 29, 2023",PHI vs. POR,W,2,0,0,0.0,0,0,0.0,0,0,0.0,0,0,0,0,0,1,0,0,0,0,1,PHI,PHI,POR,126,,,0,0,0,0
Armoni Brooks,G,22023,1629717,22300469,"JAN 03, 2024",BKN @ HOU,L,3,0,0,0.0,0,0,0.0,0,0,0.0,0,1,1,0,0,0,0,0,0,4,1,BKN,HOU,BKN,101,,,1,1,0,1
Armoni Brooks,G,22023,1629717,22300461,"JAN 02, 2024",BKN @ NOP,L,8,2,5,0.4,1,4,0.25,0,0,0.0,1,0,1,0,0,0,0,1,5,0,1,BKN,NOP,BKN,85,,,6,6,5,1
Armoni Brooks,G,22023,1629717,22300417,"DEC 27, 2023",BKN vs. MIL,L,29,4,14,0.286,3,9,0.333,1,2,0.5,2,2,4,2,1,0,2,1,12,-12,1,BKN,BKN,MIL,122,,,18,16,14,6
Armoni Brooks,G,22023,1629717,22300322,"DEC 14, 2023",BKN @ DEN,L,15,2,9,0.222,2,6,0.333,0,0,0.0,2,0,2,2,0,1,0,0,6,1,1,BKN,DEN,BKN,101,,,10,8,8,4
Armoni Brooks,G,22023,1629717,22300303,"DEC 11, 2023",BKN @ SAC,L,4,1,1,1.0,0,0,0.0,0,0,0.0,0,0,0,1,0,0,0,0,2,4,1,BKN,SAC,BKN,118,,,3,2,3,1
Armoni Brooks,G,22023,1629717,22300250,"NOV 26, 2023",BKN vs. CHI,W,4,0,2,0.0,0,2,0.0,0,0,0.0,0,1,1,0,0,0,0,1,0,-2,1,BKN,BKN,CHI,118,,,1,1,0,1
Armoni Brooks,G,22023,1629717,22300240,"NOV 25, 2023",BKN vs. MIA,W,4,0,3,0.0,0,2,0.0,0,0,0.0,1,2,3,0,0,0,0,0,0,-3,1,BKN,BKN,MIA,112,,,3,3,0,3
Armoni Brooks,G,22023,1629717,22300010,"NOV 10, 2023",BKN @ BOS,L,19,0,5,0.0,0,3,0.0,0,0,0.0,1,3,4,0,0,0,1,0,0,4,1,BKN,BOS,BKN,107,,,4,4,0,4
Armoni Brooks,G,22023,1629717,22300136,"NOV 04, 2023",BKN vs. BOS,L,1,0,0,0.0,0,0,0.0,0,0,0.0,0,0,0,0,0,0,0,0,0,2,1,BKN,BKN,BOS,114,,,0,0,0,0
Armoni Brooks,G,22023,1629717,22300119,"NOV 01, 2023",BKN @ MIA,W,16,6,7,0.857,5,6,0.833,0,0,0.0,0,2,2,0,0,0,0,0,17,30,1,BKN,MIA,BKN,109,,,19,19,17,2
Theo Maledon,G,22023,1630177,22300739,"FEB 08, 2024",PHX vs. UTA,W,1,0,1,0.0,0,0,0.0,0,0,0.0,0,0,0,0,0,0,0,0,0,0,1,PHX,PHX,UTA,129,,,0,0,0,0
Theo Maledon,G,22023,1630177,22300177,"NOV 12, 2023",CHA @ NYK,L,25,2,12,0.167,2,7,0.286,0,0,0.0,2,0,2,4,0,0,2,3,6,-20,1,CHA,NYK,CHA,107,,,12,8,10,6
Theo Maledon,G,22023,1630177,22300248,"NOV 26, 2023",CHA @ ORL,L,4,0,0,0.0,0,0,0.0,0,0,0.0,0,0,0,3,0,0,0,0,0,1,1,CHA,ORL,CHA,117,,,3,0,3,3
Theo Maledon,G,22023,1630177,22300027,"NOV 17, 2023",CHA vs. MIL,L,4,0,0,0.0,0,0,0.0,0,0,0.0,0,0,0,0,0,0,1,0,0,-11,1,CHA,CHA,MIL,99,,,0,0,0,0
Theo Maledon,G,22023,1630177,22300017,"NOV 14, 2023",CHA vs. MIA,L,23,0,5,0.0,0,2,0.0,2,2,1.0,0,3,3,3,0,0,2,1,2,3,1,CHA,CHA,MIA,105,,,8,5,5,6
Theo Maledon,G,22023,1630177,22300009,"NOV 10, 2023",CHA @ WAS,W,16,2,5,0.4,0,1,0.0,0,0,0.0,1,4,5,4,1,0,2,1,4,1,1,CHA,WAS,CHA,124,,,13,9,8,9
Theo Maledon,G,22023,1630177,22300157,"NOV 08, 2023",CHA vs. WAS,L,18,4,7,0.571,1,2,0.5,0,0,0.0,0,1,1,0,1,0,1,2,9,-21,1,CHA,CHA,WAS,116,,,10,10,9,1
Theo Maledon,G,22023,1630177,22300143,"NOV 05, 2023",CHA @ DAL,L,21,4,9,0.444,1,6,0.167,0,0,0.0,0,0,0,4,0,0,1,1,9,-7,1,CHA,DAL,CHA,118,,,13,9,13,4
Theo Maledon,G,22023,1630177,22300133,"NOV 04, 2023",CHA @ IND,W,14,0,3,0.0,0,2,0.0,0,0,0.0,0,0,0,0,0,0,1,4,0,4,1,CHA,IND,CHA,125,,,0,0,0,0
Theo Maledon,G,22023,1630177,22300122,"NOV 01, 2023",CHA @ HOU,L,21,2,7,0.286,1,2,0.5,0,0,0.0,1,5,6,2,1,0,3,2,5,4,1,CHA,HOU,CHA,119,,,13,11,7,8
Theo Maledon,G,22023,1630177,22300101,"OCT 30, 2023",CHA vs. BKN,L,20,2,9,0.222,0,5,0.0,5,5,1.0,0,1,1,2,2,0,0,0,9,-3,1,CHA,CHA,BKN,121,,,12,10,11,3
Theo Maledon,G,22023,1630177,22300077,"OCT 27, 2023",CHA vs. DET,L,14,1,2,0.5,0,0,0.0,4,5,0.8,0,2,2,0,2,0,1,0,6,-2,1,CHA,CHA,DET,99,,,8,8,6,2
Theo Maledon,G,22023,1630177,22300063,"OCT 25, 2023",CHA vs. ATL,W,16,2,5,0.4,0,2,0.0,0,0,0.0,0,3,3,4,0,0,1,3,4,-5,1,CHA,CHA,ATL,116,,,11,7,8,7
Theo Maledon,G,22023,1630177,22300057,"NOV 28, 2023",CHA @ NYK,L,5,0,2,0.0,0,1,0.0,0,0,0.0,0,0,0,2,0,0,0,1,0,-1,1,CHA,NYK,CHA,91,,,2,0,2,2
A.J. Lawson,G,22023,1630639,22300487,"JAN 05, 2024",DAL vs. POR,W,25,4,8,0.5,1,4,0.25,5,6,0.833,1,4,5,2,2,0,2,5,14,21,1,DAL,DAL,POR,132,,,21,19,16,7
A.J. Lawson,G,22023,1630639,22300398,"DEC 23, 2023",DAL vs. SAS,W,31,7,10,0.7,3,4,0.75,0,0,0.0,3,4,7,3,2,0,1,2,17,16,1,DAL,DAL,SAS,144,,,27,24,20,10
A.J. Lawson,G,22023,1630639,22300385,"DEC 22, 2023",DAL @ HOU,L,23,3,4,0.75,0,1,0.0,2,2,1.0,0,2,2,1,4,0,3,0,8,2,1,DAL,HOU,DAL,96,,,11,10,9,3
A.J. Lawson,G,22023,1630639,22300356,"DEC 18, 2023",DAL @ DEN,L,15,2,4,0.5,1,2,0.5,1,2,0.5,1,1,2,0,0,0,1,2,6,-9,1,DAL,DEN,DAL,104,,,8,8,6,2
A.J. Lawson,G,22023,1630639,22300341,"DEC 16, 2023",DAL @ POR,W,1,0,0,0.0,0,0,0.0,0,0,0.0,0,0,0,0,0,0,0,0,0,0,1,DAL,POR,DAL,131,,,0,0,0,0
A.J. Lawson,G,22023,1630639,22300321,"DEC 14, 2023",DAL vs. MIN,L,2,1,1,1.0,0,0,0.0,0,0,0.0,0,0,0,0,0,0,0,0,2,1,1,DAL,DAL,MIN,101,,,2,2,2,0
A.J. Lawson,G,22023,1630639,22300680,"JAN 31, 2024",DAL @ MIN,L,15,1,5,0.2,0,2,0.0,1,2,0.5,1,1,2,1,0,1,0,2,3,-5,1,DAL,MIN,DAL,82,,,6,5,4,3
A.J. Lawson,G,22023,1630639,22300651,"JAN 27, 2024",DAL vs. SAC,L,4,1,2,0.5,0,1,0.0,0,0,0.0,0,0,0,1,0,0,1,1,2,-9,1,DAL,DAL,SAC,115,,,3,2,3,1
A.J. Lawson,G,22023,1630639,22300577,"JAN 17, 2024",DAL @ LAL,L,5,1,1,1.0,0,0,0.0,0,0,0.0,0,0,0,0,0,0,0,0,2,6,1,DAL,LAL,DAL,105,,,2,2,2,0
A.J. Lawson,G,22023,1630639,22300556,"JAN 15, 2024",DAL vs. NOP,W,14,1,3,0.333,1,2,0.5,0,0,0.0,1,0,1,0,0,1,0,1,3,-1,1,DAL,DAL,NOP,125,,,4,4,3,1
A.J. Lawson,G,22023,1630639,22300547,"JAN 13, 2024",DAL vs. NOP,L,6,1,3,0.333,0,1,0.0,1,1,1.0,0,1,1,1,0,0,1,0,3,4,1,DAL,DAL,NOP,108,,,5,4,4,2
A.J. Lawson,G,22023,1630639,22300515,"JAN 09, 2024",DAL vs. MEM,L,5,1,3,0.333,1,2,0.5,0,0,0.0,1,1,2,0,0,0,0,1,3,-3,1,DAL,DAL,MEM,103,,,5,5,3,2
A.J. Lawson,G,22023,1630639,22300472,"JAN 03, 2024",DAL vs. POR,W,8,1,4,0.25,1,1,1.0,0,0,0.0,0,0,0,0,1,0,0,1,3,-3,1,DAL,DAL,POR,126,,,3,3,3,0
A.J. Lawson,G,22023,1630639,22300405,"DEC 25, 2023",DAL @ PHX,W,5,0,2,0.0,0,2,0.0,0,0,0.0,0,1,1,0,0,0,0,0,0,-1,1,DAL,PHX,DAL,128,,,1,1,0,1
A.J. Lawson,G,22023,1630639,22300306,"DEC 12, 2023",DAL vs. LAL,W,0,0,0,0.0,0,0,0.0,0,0,0.0,0,0,0,0,0,0,0,0,0,-3,1,DAL,DAL,LAL,127,,,0,0,0,0
A.J. Lawson,G,22023,1630639,22300299,"DEC 11, 2023",DAL @ MEM,W,14,2,7,0.286,0,4,0.0,0,0,0.0,1,0,1,1,0,0,1,0,4,1,1,DAL,MEM,DAL,120,,,6,5,5,2
A.J. Lawson,G,22023,1630639,22301226,"DEC 08, 2023",DAL @ POR,W,7,1,3,0.333,0,2,0.0,0,0,0.0,0,1,1,0,0,0,0,1,2,-4,1,DAL,POR,DAL,125,,,3,3,2,1
A.J. Lawson,G,22023,1630639,22301213,"DEC 06, 2023",DAL vs. UTA,W,7,2,2,1.0,0,0,0.0,0,0,0.0,1,0,1,0,0,0,0,0,4,7,1,DAL,DAL,UTA,147,,,5,5,4,1
A.J. Lawson,G,22023,1630639,22300287,"DEC 02, 2023",DAL vs. OKC,L,19,4,10,0.4,3,7,0.429,1,2,0.5,0,0,0,2,0,1,0,1,12,9,1,DAL,DAL,OKC,120,,,14,12,14,2
A.J. Lawson,G,22023,1630639,22300277,"DEC 01, 2023",DAL vs. MEM,L,4,0,1,0.0,0,1,0.0,1,2,0.5,0,1,1,0,0,0,0,0,1,4,1,DAL,DAL,MEM,94,,,2,2,1,1
A.J. Lawson,G,22023,1630639,22300748,"FEB 10, 2024",DAL vs. OKC,W,6,2,4,0.5,1,2,0.5,0,0,0.0,1,1,2,0,0,0,0,2,5,0,1,DAL,DAL,OKC,146,,,7,7,5,2
A.J. Lawson,G,22023,1630639,22300736,"FEB 08, 2024",DAL @ NYK,W,1,0,0,0.0,0,0,0.0,0,0,0.0,0,0,0,0,0,0,0,0,0,-2,1,DAL,NYK,DAL,121,,,0,0,0,0
A.J. Lawson,G,22023,1630639,22300715,"FEB 05, 2024",DAL @ PHI,W,5,3,3,1.0,0,0,0.0,0,2,0.0,0,0,0,0,0,0,0,0,6,0,1,DAL,PHI,DAL,118,,,6,6,6,0
A.J. Lawson,G,22023,1630639,22300625,"JAN 24, 2024",DAL vs. PHX,L,5,1,3,0.333,1,2,0.5,0,0,0.0,0,1,1,1,0,0,0,0,3,0,1,DAL,DAL,PHX,107,,,5,4,4,2
A.J. Lawson,G,22023,1630639,22300372,"DEC 20, 2023",DAL vs. LAC,L,1,0,0,0.0,0,0,0.0,0,0,0.0,0,0,0,0,0,0,0,0,0,0,1,DAL,DAL,LAC,111,,,0,0,0,0
Orlando Robinson,C,22023,1631115,22300730,"FEB 07, 2024",MIA vs. SAS,W,2,0,0,0.0,0,0,0.0,2,2,1.0,0,1,1,0,0,0,0,2,2,-5,1,MIA,MIA,SAS,116,,,3,3,2,1
Orlando Robinson,C,22023,1631115,22300721,"FEB 06, 2024",MIA vs. ORL,W,3,0,1,0.0,0,1,0.0,0,0,0.0,0,1,1,0,0,0,0,0,0,2,1,MIA,MIA,ORL,121,,,1,1,0,1
Orlando Robinson,C,22023,1631115,22300643,"JAN 27, 2024",MIA @ NYK,L,1,0,0,0.0,0,0,0.0,0,0,0.0,0,0,0,0,0,0,0,0,0,4,1,MIA,NYK,MIA,109,,,0,0,0,0
Orlando Robinson,C,22023,1631115,22300630,"JAN 25, 2024",MIA vs. BOS,L,7,0,1,0.0,0,0,0.0,3,4,0.75,1,1,2,0,0,0,0,0,3,-1,1,MIA,MIA,BOS,110,,,5,5,3,2
Orlando Robinson,C,22023,1631115,22300601,"JAN 21, 2024",MIA @ ORL,L,3,0,0,0.0,0,0,0.0,0,0,0.0,0,0,0,2,0,0,0,0,0,4,1,MIA,ORL,MIA,87,,,2,0,2,2
Orlando Robinson,C,22023,1631115,22300574,"JAN 17, 2024",MIA @ TOR,L,2,0,0,0.0,0,0,0.0,0,0,0.0,0,1,1,1,0,0,0,0,0,3,1,MIA,TOR,MIA,97,,,2,1,1,2
Orlando Robinson,C,22023,1631115,22300551,"JAN 14, 2024",MIA vs. CHA,W,2,0,0,0.0,0,0,0.0,0,0,0.0,0,0,0,0,0,0,0,1,0,-1,1,MIA,MIA,CHA,104,,,0,0,0,0
Orlando Robinson,C,22023,1631115,22300475,"JAN 03, 2024",MIA @ LAL,W,1,0,0,0.0,0,0,0.0,0,0,0.0,0,0,0,0,0,0,0,0,0,0,1,MIA,LAL,MIA,110,,,0,0,0,0
Orlando Robinson,C,22023,1631115,22300458,"JAN 01, 2024",MIA @ LAC,L,3,0,0,0.0,0,0,0.0,1,2,0.5,0,1,1,1,0,0,0,0,1,3,1,MIA,LAC,MIA,104,,,3,2,2,2
Orlando Robinson,C,22023,1631115,22300366,"DEC 20, 2023",MIA @ ORL,W,1,0,0,0.0,0,0,0.0,0,0,0.0,0,0,0,0,0,0,0,0,0,-5,1,MIA,ORL,MIA,115,,,0,0,0,0
Orlando Robinson,C,22023,1631115,22300267,"NOV 30, 2023",MIA vs. IND,W,7,1,2,0.5,0,0,0.0,0,0,0.0,0,2,2,0,0,0,0,1,2,5,1,MIA,MIA,IND,142,,,4,4,2,2
Orlando Robinson,C,22023,1631115,22300220,"NOV 20, 2023",MIA @ CHI,W,2,0,0,0.0,0,0,0.0,0,0,0.0,0,0,0,0,0,0,0,1,0,-6,1,MIA,CHI,MIA,118,,,0,0,0,0
Orlando Robinson,C,22023,1631115,22300093,"OCT 28, 2023",MIA @ MIN,L,4,0,2,0.0,0,0,0.0,0,0,0.0,0,1,1,0,0,1,0,0,0,2,1,MIA,MIN,MIA,90,,,1,1,0,1
Orlando Robinson,C,22023,1631115,22300337,"DEC 16, 2023",MIA vs. CHI,W,11,1,4,0.25,0,2,0.0,0,0,0.0,1,1,2,1,0,0,0,2,2,-1,1,MIA,MIA,CHI,118,,,5,4,3,3
Orlando Robinson,C,22023,1631115,22300320,"DEC 14, 2023",MIA vs. CHI,L,14,0,2,0.0,0,1,0.0,1,2,0.5,2,0,2,0,0,0,1,2,1,-13,1,MIA,MIA,CHI,116,,,3,3,1,2
Orlando Robinson,C,22023,1631115,22300312,"DEC 13, 2023",MIA vs. CHA,W,12,3,5,0.6,0,0,0.0,0,0,0.0,2,2,4,1,0,0,3,2,6,3,1,MIA,MIA,CHA,115,,,11,10,7,5
Orlando Robinson,C,22023,1631115,22300292,"DEC 11, 2023",MIA @ CHA,W,22,2,5,0.4,1,2,0.5,2,4,0.5,1,5,6,2,0,2,1,5,7,-7,1,MIA,CHA,MIA,116,,,15,13,9,8
Orlando Robinson,C,22023,1631115,22300229,"NOV 22, 2023",MIA @ CLE,W,28,6,9,0.667,1,1,1.0,1,2,0.5,4,5,9,2,1,2,2,4,14,22,1,MIA,CLE,MIA,129,,,25,23,16,11
Orlando Robinson,C,22023,1631115,22300107,"OCT 30, 2023",MIA @ MIL,L,26,4,7,0.571,1,1,1.0,2,2,1.0,2,5,7,7,1,0,3,4,11,4,1,MIA,MIL,MIA,114,,,25,18,18,14
Orlando Robinson,C,22023,1631115,22301220,"DEC 08, 2023",MIA vs. CLE,L,20,2,3,0.667,0,0,0.0,1,1,1.0,2,6,8,3,0,1,1,3,5,-18,1,MIA,MIA,CLE,99,,,16,13,8,11
Orlando Robinson,C,22023,1631115,22301207,"DEC 06, 2023",MIA @ TOR,W,33,5,9,0.556,2,3,0.667,3,3,1.0,3,9,12,4,3,1,1,3,15,27,1,MIA,TOR,MIA,112,,,31,27,19,16
Orlando Robinson,C,22023,1631115,22300284,"DEC 02, 2023",MIA vs. IND,L,29,7,11,0.636,2,2,1.0,0,0,0.0,1,4,5,3,0,0,1,1,16,-6,1,MIA,MIA,IND,129,,,24,21,19,8
Danuel House Jr.,F-G,22023,1627863,22300715,"FEB 05, 2024",PHI vs. DAL,L,12,1,4,0.25,0,2,0.0,2,2,1.0,2,3,5,0,0,0,1,3,4,-3,1,PHI,PHI,DAL,102,,,9,9,4,5
Danuel House Jr.,F-G,22023,1627863,22300698,"FEB 03, 2024",PHI vs. BKN,L,20,4,6,0.667,0,1,0.0,0,0,0.0,0,3,3,1,0,0,0,2,8,-6,1,PHI,PHI,BKN,121,,,12,11,9,4
Danuel House Jr.,F-G,22023,1627863,22300686,"FEB 01, 2024",PHI @ UTA,W,19,1,2,0.5,0,1,0.0,3,3,1.0,1,1,2,3,1,1,0,2,5,10,1,PHI,UTA,PHI,127,,,10,7,8,5
Danuel House Jr.,F-G,22023,1627863,22300668,"JAN 29, 2024",PHI @ POR,L,16,0,1,0.0,0,1,0.0,2,2,1.0,0,1,1,2,0,0,0,1,2,-5,1,PHI,POR,PHI,104,,,5,3,4,3
Danuel House Jr.,F-G,22023,1627863,22300532,"JAN 12, 2024",PHI vs. SAC,W,14,1,2,0.5,0,1,0.0,2,2,1.0,0,2,2,1,0,0,0,3,4,12,1,PHI,PHI,SAC,112,,,7,6,5,3
Danuel House Jr.,F-G,22023,1627863,22300483,"JAN 05, 2024",PHI vs. NYK,L,22,1,3,0.333,0,1,0.0,0,0,0.0,0,4,4,1,1,0,0,1,2,-27,1,PHI,PHI,NYK,92,,,7,6,3,5
Danuel House Jr.,F-G,22023,1627863,22300459,"JAN 02, 2024",PHI vs. CHI,W,15,2,5,0.4,0,2,0.0,1,1,1.0,0,0,0,1,0,0,1,1,5,-2,1,PHI,PHI,CHI,110,,,6,5,6,1
Danuel House Jr.,F-G,22023,1627863,22300434,"DEC 29, 2023",PHI @ HOU,W,12,0,0,0.0,0,0,0.0,0,0,0.0,0,2,2,0,0,0,0,1,0,5,1,PHI,HOU,PHI,131,,,2,2,0,2
Danuel House Jr.,F-G,22023,1627863,22300415,"DEC 27, 2023",PHI @ ORL,W,7,0,0,0.0,0,0,0.0,0,0,0.0,1,0,1,0,0,0,1,0,0,1,1,PHI,ORL,PHI,112,,,1,1,0,1
Danuel House Jr.,F-G,22023,1627863,22300404,"DEC 25, 2023",PHI @ MIA,L,6,0,3,0.0,0,2,0.0,1,2,0.5,0,0,0,0,1,0,1,0,1,-12,1,PHI,MIA,PHI,113,,,1,1,1,0
Danuel House Jr.,F-G,22023,1627863,22300367,"DEC 20, 2023",PHI vs. MIN,W,17,0,1,0.0,0,0,0.0,0,0,0.0,0,1,1,0,0,0,0,1,0,10,1,PHI,PHI,MIN,127,,,1,1,0,1
Danuel House Jr.,F-G,22023,1627863,22300335,"DEC 16, 2023",PHI @ CHA,W,7,3,3,1.0,2,2,1.0,2,2,1.0,0,1,1,2,0,0,0,0,10,6,1,PHI,CHA,PHI,135,,,13,11,12,3
Danuel House Jr.,F-G,22023,1627863,22300327,"DEC 15, 2023",PHI vs. DET,W,12,1,5,0.2,1,3,0.333,0,0,0.0,3,1,4,2,0,0,0,2,3,0,1,PHI,PHI,DET,124,,,9,7,5,6
Danuel House Jr.,F-G,22023,1627863,22300310,"DEC 13, 2023",PHI @ DET,W,7,0,3,0.0,0,1,0.0,0,0,0.0,0,0,0,1,0,0,0,0,0,-12,1,PHI,DET,PHI,129,,,1,0,1,1
Danuel House Jr.,F-G,22023,1627863,22300295,"DEC 11, 2023",PHI vs. WAS,W,9,3,4,0.75,3,4,0.75,1,2,0.5,0,1,1,1,0,0,0,0,10,4,1,PHI,PHI,WAS,146,,,12,11,11,2
Danuel House Jr.,F-G,22023,1627863,22300232,"NOV 22, 2023",PHI @ MIN,L,17,1,5,0.2,0,3,0.0,1,2,0.5,0,2,2,2,3,0,1,2,3,-2,1,PHI,MIN,PHI,99,,,7,5,5,4
Danuel House Jr.,F-G,22023,1627863,22300208,"NOV 19, 2023",PHI @ BKN,W,14,1,4,0.25,1,2,0.5,0,0,0.0,2,1,3,3,1,0,0,3,3,2,1,PHI,BKN,PHI,121,,,9,6,6,6
Danuel House Jr.,F-G,22023,1627863,22300148,"NOV 06, 2023",PHI vs. WAS,W,7,1,2,0.5,0,1,0.0,1,1,1.0,0,0,0,0,0,0,2,0,3,-9,1,PHI,PHI,WAS,146,,,3,3,3,0
Danuel House Jr.,F-G,22023,1627863,22300098,"OCT 29, 2023",PHI vs. POR,W,10,1,2,0.5,0,1,0.0,0,0,0.0,1,1,2,2,1,0,1,0,2,-3,1,PHI,PHI,POR,126,,,6,4,4,4
Danuel House Jr.,F-G,22023,1627863,22300644,"JAN 27, 2024",PHI @ DEN,L,28,3,7,0.429,0,3,0.0,0,1,0.0,1,2,3,0,2,1,0,4,6,6,1,PHI,DEN,PHI,105,,,9,9,6,3
Danuel House Jr.,F-G,22023,1627863,22300627,"JAN 25, 2024",PHI @ IND,L,19,4,6,0.667,0,0,0.0,2,3,0.667,1,1,2,1,2,1,2,2,10,-7,1,PHI,IND,PHI,122,,,13,12,11,3
Danuel House Jr.,F-G,22023,1627863,22300608,"JAN 22, 2024",PHI vs. SAS,W,23,2,4,0.5,1,3,0.333,3,6,0.5,0,2,2,1,0,0,0,0,8,2,1,PHI,PHI,SAS,133,,,11,10,9,3
Danuel House Jr.,F-G,22023,1627863,22300593,"JAN 20, 2024",PHI @ CHA,W,27,3,4,0.75,1,1,1.0,2,3,0.667,0,3,3,0,1,1,2,3,9,7,1,PHI,CHA,PHI,97,,,12,12,9,3
Danuel House Jr.,F-G,22023,1627863,22300585,"JAN 19, 2024",PHI @ ORL,W,11,0,1,0.0,0,1,0.0,0,0,0.0,0,0,0,1,0,0,0,1,0,4,1,PHI,ORL,PHI,124,,,1,0,1,1
Danuel House Jr.,F-G,22023,1627863,22300555,"JAN 15, 2024",PHI vs. HOU,W,18,2,4,0.5,1,1,1.0,1,1,1.0,2,3,5,1,0,0,0,4,6,9,1,PHI,PHI,HOU,124,,,12,11,7,6
Danuel House Jr.,F-G,22023,1627863,22300351,"DEC 18, 2023",PHI vs. CHI,L,7,1,1,1.0,1,1,1.0,0,0,0.0,0,0,0,0,0,0,0,0,3,-3,1,PHI,PHI,CHI,104,,,3,3,3,0
Danuel House Jr.,F-G,22023,1627863,22300040,"NOV 21, 2023",PHI vs. CLE,L,12,2,5,0.4,1,2,0.5,2,2,1.0,0,0,0,0,0,0,1,0,7,3,1,PHI,PHI,CLE,119,,,7,7,7,0
Danuel House Jr.,F-G,22023,1627863,22300180,"NOV 12, 2023",PHI vs. IND,W,16,1,1,1.0,1,1,1.0,1,2,0.5,0,1,1,0,0,0,1,0,4,15,1,PHI,PHI,IND,137,,,5,5,4,1
Danuel House Jr.,F-G,22023,1627863,22300673,"JAN 30, 2024",PHI @ GSW,L,29,1,4,0.25,1,3,0.333,4,4,1.0,1,0,1,0,2,0,0,2,7,-21,1,PHI,GSW,PHI,107,,,8,8,7,1
Danuel House Jr.,F-G,22023,1627863,22300029,"NOV 17, 2023",PHI @ ATL,W,18,5,8,0.625,1,4,0.25,3,3,1.0,1,2,3,1,0,0,1,1,14,10,1,PHI,ATL,PHI,126,,,18,17,15,4
Danuel House Jr.,F-G,22023,1627863,22300194,"NOV 15, 2023",PHI vs. BOS,L,3,0,1,0.0,0,1,0.0,0,0,0.0,0,0,0,0,0,0,0,0,0,-8,1,PHI,PHI,BOS,107,,,0,0,0,0
Danuel House Jr.,F-G,22023,1627863,22300019,"NOV 14, 2023",PHI vs. IND,L,18,0,0,0.0,0,0,0.0,0,0,0.0,0,1,1,0,0,0,2,3,0,12,1,PHI,PHI,IND,126,,,1,1,0,1
Danuel House Jr.,F-G,22023,1627863,22300092,"OCT 28, 2023",PHI @ TOR,W,12,1,3,0.333,0,1,0.0,0,0,0.0,0,2,2,0,0,1,0,1,2,7,1,PHI,TOR,PHI,114,,,4,4,2,2
Danuel House Jr.,F-G,22023,1627863,22300382,"DEC 22, 2023",PHI vs. TOR,W,23,1,1,1.0,0,0,0.0,1,2,0.5,0,1,1,1,0,0,2,2,3,17,1,PHI,PHI,TOR,121,,,5,4,4,2
Jeremiah Robinson-Earl,F,22023,1630526,22300747,"FEB 09, 2024",NOP @ LAL,L,3,0,0,0.0,0,0,0.0,0,0,0.0,0,0,0,0,0,0,0,0,0,-2,1,NOP,LAL,NOP,122,,,0,0,0,0
Jeremiah Robinson-Earl,F,22023,1630526,22300731,"FEB 07, 2024",NOP @ LAC,W,2,0,1,0.0,0,1,0.0,0,0,0.0,1,0,1,1,0,0,0,1,0,-2,1,NOP,LAC,NOP,117,,,2,1,1,2
Jeremiah Robinson-Earl,F,22023,1630526,22300648,"JAN 27, 2024",NOP @ MIL,L,7,2,3,0.667,0,1,0.0,4,5,0.8,3,0,3,0,0,0,0,0,8,5,1,NOP,MIL,NOP,117,,,11,11,8,3
Jeremiah Robinson-Earl,F,22023,1630526,22300640,"JAN 26, 2024",NOP vs. OKC,L,3,1,3,0.333,0,1,0.0,0,0,0.0,0,0,0,0,1,0,0,0,2,-1,1,NOP,NOP,OKC,83,,,2,2,2,0
Jeremiah Robinson-Earl,F,22023,1630526,22300547,"JAN 13, 2024",NOP @ DAL,W,22,1,4,0.25,0,1,0.0,0,0,0.0,0,4,4,0,2,0,1,1,2,10,1,NOP,DAL,NOP,118,,,6,6,2,4
Jeremiah Robinson-Earl,F,22023,1630526,22300461,"JAN 02, 2024",NOP vs. BKN,W,4,0,1,0.0,0,0,0.0,0,0,0.0,1,4,5,0,0,0,1,0,0,1,1,NOP,NOP,BKN,112,,,5,5,0,5
Jeremiah Robinson-Earl,F,22023,1630526,22300392,"DEC 23, 2023",NOP vs. HOU,L,22,2,5,0.4,0,3,0.0,0,0,0.0,0,3,3,2,2,1,0,2,4,-8,1,NOP,NOP,HOU,104,,,9,7,6,5
Jeremiah Robinson-Earl,F,22023,1630526,22300375,"DEC 21, 2023",NOP @ CLE,W,20,5,6,0.833,1,2,0.5,0,0,0.0,0,5,5,1,0,0,0,1,11,22,1,NOP,CLE,NOP,123,,,17,16,12,6
Jeremiah Robinson-Earl,F,22023,1630526,22300345,"DEC 17, 2023",NOP @ SAS,W,4,2,2,1.0,0,0,0.0,0,0,0.0,0,1,1,0,0,0,0,0,4,-1,1,NOP,SAS,NOP,146,,,5,5,4,1
Jeremiah Robinson-Earl,F,22023,1630526,22300311,"DEC 13, 2023",NOP @ WAS,W,2,1,2,0.5,0,0,0.0,0,0,0.0,2,0,2,0,0,0,0,0,2,-2,1,NOP,WAS,NOP,142,,,4,4,2,2
Jeremiah Robinson-Earl,F,22023,1630526,22301230,"DEC 07, 2023",NOP @ LAL,L,6,0,2,0.0,0,0,0.0,0,0,0.0,0,2,2,1,0,0,0,0,0,-3,1,NOP,LAL,NOP,89,,,3,2,1,3
Jeremiah Robinson-Earl,F,22023,1630526,22300285,"DEC 02, 2023",NOP @ CHI,L,0,0,0,0.0,0,0,0.0,0,0,0.0,0,0,0,0,0,0,0,0,0,0,1,NOP,CHI,NOP,118,,,0,0,0,0
Jeremiah Robinson-Earl,F,22023,1630526,22300222,"NOV 20, 2023",NOP vs. SAC,W,12,1,4,0.25,0,1,0.0,2,2,1.0,3,2,5,1,0,0,0,1,4,-12,1,NOP,NOP,SAC,129,,,10,9,5,6
Jeremiah Robinson-Earl,F,22023,1630526,22300525,"JAN 10, 2024",NOP @ GSW,W,6,0,0,0.0,0,0,0.0,0,0,0.0,0,1,1,0,0,1,0,0,0,-5,1,NOP,GSW,NOP,141,,,1,1,0,1
Jeremiah Robinson-Earl,F,22023,1630526,22300500,"JAN 07, 2024",NOP @ SAC,W,10,3,4,0.75,1,2,0.5,0,0,0.0,0,0,0,0,0,1,1,1,7,-14,1,NOP,SAC,NOP,133,,,7,7,7,0
Jeremiah Robinson-Earl,F,22023,1630526,22300203,"NOV 18, 2023",NOP vs. MIN,L,10,2,3,0.667,0,1,0.0,0,0,0.0,0,0,0,0,0,0,0,1,4,-5,1,NOP,NOP,MIN,120,,,4,4,4,0
Jeremiah Robinson-Earl,F,22023,1630526,22300034,"NOV 17, 2023",NOP vs. DEN,W,0,0,0,0.0,0,0,0.0,0,0,0.0,0,0,0,0,0,0,0,0,0,0,1,NOP,NOP,DEN,115,,,0,0,0,0
Jeremiah Robinson-Earl,F,22023,1630526,22300022,"NOV 14, 2023",NOP vs. DAL,W,13,1,1,1.0,1,1,1.0,0,0,0.0,1,1,2,2,1,0,3,2,3,2,1,NOP,NOP,DAL,131,,,7,5,5,4
Jeremiah Robinson-Earl,F,22023,1630526,22300183,"NOV 12, 2023",NOP vs. DAL,L,26,4,8,0.5,3,5,0.6,0,0,0.0,1,5,6,1,1,0,1,2,11,5,1,NOP,NOP,DAL,124,,,18,17,12,7
Jeremiah Robinson-Earl,F,22023,1630526,22300011,"NOV 10, 2023",NOP @ HOU,L,9,2,2,1.0,1,1,1.0,0,0,0.0,0,0,0,0,0,0,0,1,5,-7,1,NOP,HOU,NOP,101,,,5,5,5,0
Jeremiah Robinson-Earl,F,22023,1630526,22300166,"NOV 08, 2023",NOP @ MIN,L,28,3,7,0.429,1,2,0.5,4,4,1.0,3,6,9,1,0,0,2,2,11,-18,1,NOP,MIN,NOP,101,,,21,20,12,10
Ryan Rollins,G,22023,1631157,22300416,"DEC 27, 2023",WAS vs. TOR,L,6,1,3,0.333,0,0,0.0,0,0,0.0,0,0,0,0,0,0,0,0,2,-4,1,WAS,WAS,TOR,102,,,2,2,2,0
Ryan Rollins,G,22023,1631157,22300386,"DEC 22, 2023",WAS @ GSW,L,11,3,4,0.75,1,1,1.0,0,1,0.0,0,1,1,1,0,1,0,1,7,10,1,WAS,GSW,WAS,118,,,9,8,8,2
Ryan Rollins,G,22023,1631157,22300219,"NOV 20, 2023",WAS vs. MIL,L,1,0,0,0.0,0,0,0.0,0,0,0.0,0,0,0,0,0,0,0,0,0,2,1,WAS,WAS,MIL,129,,,0,0,0,0
Ryan Rollins,G,22023,1631157,22300192,"NOV 15, 2023",WAS vs. DAL,L,2,1,1,1.0,0,0,0.0,0,0,0.0,0,0,0,0,0,0,0,0,2,5,1,WAS,WAS,DAL,117,,,2,2,2,0
Ryan Rollins,G,22023,1631157,22300157,"NOV 08, 2023",WAS @ CHA,W,3,1,1,1.0,0,0,0.0,1,1,1.0,0,0,0,0,2,0,0,0,3,-2,1,WAS,CHA,WAS,132,,,3,3,3,0
Ryan Rollins,G,22023,1631157,22300148,"NOV 06, 2023",WAS @ PHI,L,10,3,5,0.6,0,1,0.0,0,0,0.0,1,4,5,3,2,0,5,2,6,1,1,WAS,PHI,WAS,128,,,14,11,9,8
Ryan Rollins,G,22023,1631157,22300003,"NOV 03, 2023",WAS @ MIA,L,7,2,4,0.5,1,1,1.0,2,3,0.667,0,1,1,2,0,1,0,1,7,15,1,WAS,MIA,WAS,114,,,10,8,9,3
Ryan Rollins,G,22023,1631157,22300117,"NOV 01, 2023",WAS @ ATL,L,7,2,2,1.0,0,0,0.0,2,2,1.0,0,0,0,1,0,1,0,2,6,17,1,WAS,ATL,WAS,121,,,7,6,7,1
Ryan Rollins,G,22023,1631157,22300103,"OCT 30, 2023",WAS vs. BOS,L,12,0,2,0.0,0,0,0.0,7,8,0.875,1,0,1,3,4,0,1,1,7,14,1,WAS,WAS,BOS,107,,,11,8,10,4
Ryan Rollins,G,22023,1631157,22300064,"OCT 25, 2023",WAS @ IND,L,6,0,3,0.0,0,0,0.0,1,2,0.5,0,3,3,1,0,0,1,0,1,-1,1,WAS,IND,WAS,120,,,5,4,2,4
Evan Fournier,G-F,22023,203095,22300579,"JAN 18, 2024",NYK vs. WAS,W,6,0,4,0.0,0,3,0.0,0,0,0.0,0,1,1,0,0,0,0,2,0,-4,1,NYK,NYK,WAS,113,,,1,1,0,1
Evan Fournier,G-F,22023,203095,22300441,"DEC 30, 2023",NYK @ IND,L,17,3,10,0.3,2,8,0.25,2,2,1.0,0,2,2,2,3,0,1,0,10,-13,1,NYK,IND,NYK,124,,,14,12,12,4
Evan Fournier,G-F,22023,203095,22300028,"NOV 17, 2023",NYK @ WAS,W,16,1,6,0.167,0,4,0.0,0,0,0.0,0,1,1,1,1,0,0,2,2,6,1,NYK,WAS,NYK,120,,,4,3,3,2
Mike Muscala,F-C,22023,203488,22300520,"JAN 10, 2024",WAS @ IND,L,11,2,4,0.5,0,2,0.0,0,0,0.0,3,1,4,0,0,0,1,4,4,-5,1,WAS,IND,WAS,104,,,8,8,4,4
Mike Muscala,F-C,22023,203488,22300508,"JAN 08, 2024",WAS vs. OKC,L,8,0,1,0.0,0,0,0.0,0,0,0.0,1,0,1,0,1,0,1,1,0,-5,1,WAS,WAS,OKC,128,,,1,1,0,1
Mike Muscala,F-C,22023,203488,22300494,"JAN 06, 2024",WAS vs. NYK,L,14,0,4,0.0,0,3,0.0,1,2,0.5,3,3,6,0,0,0,1,0,1,-13,1,WAS,WAS,NYK,105,,,7,7,1,6
Mike Muscala,F-C,22023,203488,22300482,"JAN 05, 2024",WAS @ CLE,L,18,0,3,0.0,0,2,0.0,0,0,0.0,1,5,6,0,0,0,1,2,0,-5,1,WAS,CLE,WAS,90,,,6,6,0,6
Mike Muscala,F-C,22023,203488,22300465,"JAN 03, 2024",WAS @ CLE,L,21,5,9,0.556,2,5,0.4,0,0,0.0,2,2,4,2,0,0,0,0,12,-22,1,WAS,CLE,WAS,101,,,18,16,14,6
Mike Muscala,F-C,22023,203488,22300445,"DEC 31, 2023",WAS vs. ATL,L,20,4,8,0.5,2,5,0.4,0,0,0.0,0,4,4,3,0,0,0,1,10,-16,1,WAS,WAS,ATL,126,,,17,14,13,7
Mike Muscala,F-C,22023,203488,22300430,"DEC 29, 2023",WAS vs. BKN,W,31,4,9,0.444,3,7,0.429,0,0,0.0,0,3,3,3,0,2,0,3,11,21,1,WAS,WAS,BKN,110,,,17,14,14,6
Mike Muscala,F-C,22023,203488,22300416,"DEC 27, 2023",WAS vs. TOR,L,7,0,3,0.0,0,0,0.0,0,0,0.0,2,4,6,0,0,0,1,0,0,-2,1,WAS,WAS,TOR,102,,,6,6,0,6
Mike Muscala,F-C,22023,203488,22300386,"DEC 22, 2023",WAS @ GSW,L,14,1,5,0.2,0,1,0.0,0,0,0.0,2,4,6,0,0,0,1,2,2,-18,1,WAS,GSW,WAS,118,,,8,8,2,6
Mike Muscala,F-C,22023,203488,22300381,"DEC 21, 2023",WAS @ POR,W,14,2,5,0.4,1,3,0.333,0,2,0.0,0,1,1,1,1,0,0,2,5,-7,1,WAS,POR,WAS,118,,,7,6,6,2
Mike Muscala,F-C,22023,203488,22300358,"DEC 18, 2023",WAS @ SAC,L,23,2,3,0.667,1,1,1.0,6,6,1.0,1,5,6,2,1,1,2,3,11,15,1,WAS,SAC,WAS,131,,,19,17,13,8
Mike Muscala,F-C,22023,203488,22300347,"DEC 17, 2023",WAS @ PHX,L,10,1,4,0.25,0,2,0.0,2,2,1.0,2,2,4,0,0,0,0,1,4,-4,1,WAS,PHX,WAS,108,,,8,8,4,4
Mike Muscala,F-C,22023,203488,22300328,"DEC 15, 2023",WAS vs. IND,W,19,0,1,0.0,0,1,0.0,0,0,0.0,0,0,0,2,0,1,0,1,0,-3,1,WAS,WAS,IND,137,,,2,0,2,2
Mike Muscala,F-C,22023,203488,22300311,"DEC 13, 2023",WAS vs. NOP,L,4,0,2,0.0,0,2,0.0,0,0,0.0,0,1,1,0,0,0,0,0,0,8,1,WAS,WAS,NOP,122,,,1,1,0,1
Mike Muscala,F-C,22023,203488,22300295,"DEC 11, 2023",WAS @ PHI,L,20,0,4,0.0,0,3,0.0,0,2,0.0,3,1,4,1,0,0,0,3,0,-25,1,WAS,PHI,WAS,99,,,5,4,1,5
Mike Muscala,F-C,22023,203488,22301219,"DEC 08, 2023",WAS @ BKN,L,15,2,3,0.667,2,3,0.667,2,2,1.0,0,0,0,0,1,0,1,1,8,-4,1,WAS,BKN,WAS,97,,,8,8,8,0
Mike Muscala,F-C,22023,203488,22301208,"DEC 06, 2023",WAS vs. PHI,L,6,2,3,0.667,0,1,0.0,0,0,0.0,0,0,0,0,0,0,0,0,4,6,1,WAS,WAS,PHI,126,,,4,4,4,0
Mike Muscala,F-C,22023,203488,22300241,"NOV 25, 2023",WAS vs. ATL,L,18,2,3,0.667,1,2,0.5,0,0,0.0,0,6,6,4,0,2,1,0,5,-8,1,WAS,WAS,ATL,108,,,15,11,9,10
Mike Muscala,F-C,22023,203488,22300189,"NOV 13, 2023",WAS @ TOR,L,7,1,2,0.5,0,0,0.0,2,2,1.0,1,1,2,0,0,0,3,0,4,-1,1,WAS,TOR,WAS,107,,,6,6,4,2
Mike Muscala,F-C,22023,203488,22300148,"NOV 06, 2023",WAS @ PHI,L,3,0,1,0.0,0,0,0.0,0,0,0.0,0,0,0,0,0,0,0,1,0,-3,1,WAS,PHI,WAS,128,,,0,0,0,0
Mike Muscala,F-C,22023,203488,22300003,"NOV 03, 2023",WAS @ MIA,L,12,2,5,0.4,1,4,0.25,0,0,0.0,0,1,1,1,0,0,1,1,5,-11,1,WAS,MIA,WAS,114,,,7,6,6,2
Mike Muscala,F-C,22023,203488,22300117,"NOV 01, 2023",WAS @ ATL,L,22,2,7,0.286,1,4,0.25,2,2,1.0,1,3,4,1,1,1,2,3,7,-22,1,WAS,ATL,WAS,121,,,12,11,8,5
Mike Muscala,F-C,22023,203488,22300089,"OCT 28, 2023",WAS vs. MEM,W,11,1,1,1.0,0,0,0.0,0,0,0.0,0,3,3,2,0,0,0,2,2,-2,1,WAS,WAS,MEM,113,,,7,5,4,5
Mike Muscala,F-C,22023,203488,22300064,"OCT 25, 2023",WAS @ IND,L,8,0,0,0.0,0,0,0.0,0,0,0.0,0,3,3,0,0,0,0,0,0,-8,1,WAS,IND,WAS,120,,,3,3,0,3
Mike Muscala,F-C,22023,203488,22300704,"FEB 04, 2024",DET vs. ORL,L,14,0,0,0.0,0,0,0.0,0,0,0.0,1,0,1,0,0,0,0,1,0,-1,1,DET,DET,ORL,99,,,1,1,0,1
Mike Muscala,F-C,22023,203488,22300675,"JAN 31, 2024",DET @ CLE,L,4,1,2,0.5,1,2,0.5,0,0,0.0,0,1,1,0,0,0,0,1,3,0,1,DET,CLE,DET,121,,,4,4,3,1
Mike Muscala,F-C,22023,203488,22300654,"JAN 28, 2024",DET vs. OKC,W,11,1,1,1.0,1,1,1.0,0,0,0.0,0,3,3,0,0,0,0,0,3,14,1,DET,DET,OKC,120,,,6,6,3,3
Mike Muscala,F-C,22023,203488,22300642,"JAN 27, 2024",DET vs. WAS,L,12,0,4,0.0,0,3,0.0,0,0,0.0,0,1,1,1,0,1,0,3,0,-10,1,DET,DET,WAS,104,,,2,1,1,2
Mike Muscala,F-C,22023,203488,22300619,"JAN 24, 2024",DET vs. CHA,W,13,2,5,0.4,1,4,0.25,0,0,0.0,2,3,5,1,0,0,0,1,5,2,1,DET,DET,CHA,113,,,11,10,6,6
Mike Muscala,F-C,22023,203488,22300606,"JAN 22, 2024",DET vs. MIL,L,16,1,1,1.0,1,1,1.0,0,0,0.0,2,2,4,1,0,1,0,2,3,1,1,DET,DET,MIL,113,,,8,7,4,5
Mike Muscala,F-C,22023,203488,22300592,"JAN 20, 2024",DET vs. MIL,L,14,4,4,1.0,4,4,1.0,1,2,0.5,0,1,1,1,1,0,1,2,13,19,1,DET,DET,MIL,135,,,15,14,14,2
Mike Muscala,F-C,22023,203488,22300569,"JAN 17, 2024",DET vs. MIN,L,15,0,4,0.0,0,3,0.0,0,0,0.0,1,2,3,2,0,2,0,0,0,6,1,DET,DET,MIN,117,,,5,3,2,5
Mike Muscala,F-C,22023,203488,22300749,"FEB 10, 2024",DET @ LAC,L,10,0,2,0.0,0,2,0.0,0,0,0.0,0,1,1,0,0,0,0,1,0,-9,1,DET,LAC,DET,106,,,1,1,0,1
Mike Muscala,F-C,22023,203488,22300732,"FEB 07, 2024",DET @ SAC,W,25,3,8,0.375,3,6,0.5,0,0,0.0,0,3,3,0,0,0,0,1,9,8,1,DET,SAC,DET,133,,,12,12,9,3
Mike Muscala,F-C,22023,203488,22300741,"FEB 08, 2024",DET @ POR,W,17,2,5,0.4,2,3,0.667,0,0,0.0,2,1,3,2,0,1,1,0,6,-15,1,DET,POR,DET,128,,,11,9,8,5
Mike Muscala,F-C,22023,203488,22300520,"JAN 10, 2024",WAS @ IND,L,11,2,4,0.5,0,2,0.0,0,0,0.0,3,1,4,0,0,0,1,4,4,-5,1,WAS,IND,WAS,104,,,8,8,4,4
Mike Muscala,F-C,22023,203488,22300508,"JAN 08, 2024",WAS vs. OKC,L,8,0,1,0.0,0,0,0.0,0,0,0.0,1,0,1,0,1,0,1,1,0,-5,1,WAS,WAS,OKC,128,,,1,1,0,1
Mike Muscala,F-C,22023,203488,22300494,"JAN 06, 2024",WAS vs. NYK,L,14,0,4,0.0,0,3,0.0,1,2,0.5,3,3,6,0,0,0,1,0,1,-13,1,WAS,WAS,NYK,105,,,7,7,1,6
Mike Muscala,F-C,22023,203488,22300482,"JAN 05, 2024",WAS @ CLE,L,18,0,3,0.0,0,2,0.0,0,0,0.0,1,5,6,0,0,0,1,2,0,-5,1,WAS,CLE,WAS,90,,,6,6,0,6
Mike Muscala,F-C,22023,203488,22300465,"JAN 03, 2024",WAS @ CLE,L,21,5,9,0.556,2,5,0.4,0,0,0.0,2,2,4,2,0,0,0,0,12,-22,1,WAS,CLE,WAS,101,,,18,16,14,6
Mike Muscala,F-C,22023,203488,22300445,"DEC 31, 2023",WAS vs. ATL,L,20,4,8,0.5,2,5,0.4,0,0,0.0,0,4,4,3,0,0,0,1,10,-16,1,WAS,WAS,ATL,126,,,17,14,13,7
Mike Muscala,F-C,22023,203488,22300430,"DEC 29, 2023",WAS vs. BKN,W,31,4,9,0.444,3,7,0.429,0,0,0.0,0,3,3,3,0,2,0,3,11,21,1,WAS,WAS,BKN,110,,,17,14,14,6
Mike Muscala,F-C,22023,203488,22300416,"DEC 27, 2023",WAS vs. TOR,L,7,0,3,0.0,0,0,0.0,0,0,0.0,2,4,6,0,0,0,1,0,0,-2,1,WAS,WAS,TOR,102,,,6,6,0,6
Mike Muscala,F-C,22023,203488,22300386,"DEC 22, 2023",WAS @ GSW,L,14,1,5,0.2,0,1,0.0,0,0,0.0,2,4,6,0,0,0,1,2,2,-18,1,WAS,GSW,WAS,118,,,8,8,2,6
Mike Muscala,F-C,22023,203488,22300381,"DEC 21, 2023",WAS @ POR,W,14,2,5,0.4,1,3,0.333,0,2,0.0,0,1,1,1,1,0,0,2,5,-7,1,WAS,POR,WAS,118,,,7,6,6,2
Mike Muscala,F-C,22023,203488,22300358,"DEC 18, 2023",WAS @ SAC,L,23,2,3,0.667,1,1,1.0,6,6,1.0,1,5,6,2,1,1,2,3,11,15,1,WAS,SAC,WAS,131,,,19,17,13,8
Mike Muscala,F-C,22023,203488,22300347,"DEC 17, 2023",WAS @ PHX,L,10,1,4,0.25,0,2,0.0,2,2,1.0,2,2,4,0,0,0,0,1,4,-4,1,WAS,PHX,WAS,108,,,8,8,4,4
Mike Muscala,F-C,22023,203488,22300328,"DEC 15, 2023",WAS vs. IND,W,19,0,1,0.0,0,1,0.0,0,0,0.0,0,0,0,2,0,1,0,1,0,-3,1,WAS,WAS,IND,137,,,2,0,2,2
Mike Muscala,F-C,22023,203488,22300311,"DEC 13, 2023",WAS vs. NOP,L,4,0,2,0.0,0,2,0.0,0,0,0.0,0,1,1,0,0,0,0,0,0,8,1,WAS,WAS,NOP,122,,,1,1,0,1
Mike Muscala,F-C,22023,203488,22300295,"DEC 11, 2023",WAS @ PHI,L,20,0,4,0.0,0,3,0.0,0,2,0.0,3,1,4,1,0,0,0,3,0,-25,1,WAS,PHI,WAS,99,,,5,4,1,5
Mike Muscala,F-C,22023,203488,22301219,"DEC 08, 2023",WAS @ BKN,L,15,2,3,0.667,2,3,0.667,2,2,1.0,0,0,0,0,1,0,1,1,8,-4,1,WAS,BKN,WAS,97,,,8,8,8,0
Mike Muscala,F-C,22023,203488,22301208,"DEC 06, 2023",WAS vs. PHI,L,6,2,3,0.667,0,1,0.0,0,0,0.0,0,0,0,0,0,0,0,0,4,6,1,WAS,WAS,PHI,126,,,4,4,4,0
Mike Muscala,F-C,22023,203488,22300241,"NOV 25, 2023",WAS vs. ATL,L,18,2,3,0.667,1,2,0.5,0,0,0.0,0,6,6,4,0,2,1,0,5,-8,1,WAS,WAS,ATL,108,,,15,11,9,10
Mike Muscala,F-C,22023,203488,22300189,"NOV 13, 2023",WAS @ TOR,L,7,1,2,0.5,0,0,0.0,2,2,1.0,1,1,2,0,0,0,3,0,4,-1,1,WAS,TOR,WAS,107,,,6,6,4,2
Mike Muscala,F-C,22023,203488,22300148,"NOV 06, 2023",WAS @ PHI,L,3,0,1,0.0,0,0,0.0,0,0,0.0,0,0,0,0,0,0,0,1,0,-3,1,WAS,PHI,WAS,128,,,0,0,0,0
Mike Muscala,F-C,22023,203488,22300003,"NOV 03, 2023",WAS @ MIA,L,12,2,5,0.4,1,4,0.25,0,0,0.0,0,1,1,1,0,0,1,1,5,-11,1,WAS,MIA,WAS,114,,,7,6,6,2
Mike Muscala,F-C,22023,203488,22300117,"NOV 01, 2023",WAS @ ATL,L,22,2,7,0.286,1,4,0.25,2,2,1.0,1,3,4,1,1,1,2,3,7,-22,1,WAS,ATL,WAS,121,,,12,11,8,5
Mike Muscala,F-C,22023,203488,22300089,"OCT 28, 2023",WAS vs. MEM,W,11,1,1,1.0,0,0,0.0,0,0,0.0,0,3,3,2,0,0,0,2,2,-2,1,WAS,WAS,MEM,113,,,7,5,4,5
Mike Muscala,F-C,22023,203488,22300064,"OCT 25, 2023",WAS @ IND,L,8,0,0,0.0,0,0,0.0,0,0,0.0,0,3,3,0,0,0,0,0,0,-8,1,WAS,IND,WAS,120,,,3,3,0,3
Mike Muscala,F-C,22023,203488,22300704,"FEB 04, 2024",DET vs. ORL,L,14,0,0,0.0,0,0,0.0,0,0,0.0,1,0,1,0,0,0,0,1,0,-1,1,DET,DET,ORL,99,,,1,1,0,1
Mike Muscala,F-C,22023,203488,22300675,"JAN 31, 2024",DET @ CLE,L,4,1,2,0.5,1,2,0.5,0,0,0.0,0,1,1,0,0,0,0,1,3,0,1,DET,CLE,DET,121,,,4,4,3,1
Mike Muscala,F-C,22023,203488,22300654,"JAN 28, 2024",DET vs. OKC,W,11,1,1,1.0,1,1,1.0,0,0,0.0,0,3,3,0,0,0,0,0,3,14,1,DET,DET,OKC,120,,,6,6,3,3
Mike Muscala,F-C,22023,203488,22300642,"JAN 27, 2024",DET vs. WAS,L,12,0,4,0.0,0,3,0.0,0,0,0.0,0,1,1,1,0,1,0,3,0,-10,1,DET,DET,WAS,104,,,2,1,1,2
Mike Muscala,F-C,22023,203488,22300619,"JAN 24, 2024",DET vs. CHA,W,13,2,5,0.4,1,4,0.25,0,0,0.0,2,3,5,1,0,0,0,1,5,2,1,DET,DET,CHA,113,,,11,10,6,6
Mike Muscala,F-C,22023,203488,22300606,"JAN 22, 2024",DET vs. MIL,L,16,1,1,1.0,1,1,1.0,0,0,0.0,2,2,4,1,0,1,0,2,3,1,1,DET,DET,MIL,113,,,8,7,4,5
Mike Muscala,F-C,22023,203488,22300592,"JAN 20, 2024",DET vs. MIL,L,14,4,4,1.0,4,4,1.0,1,2,0.5,0,1,1,1,1,0,1,2,13,19,1,DET,DET,MIL,135,,,15,14,14,2
Mike Muscala,F-C,22023,203488,22300569,"JAN 17, 2024",DET vs. MIN,L,15,0,4,0.0,0,3,0.0,0,0,0.0,1,2,3,2,0,2,0,0,0,6,1,DET,DET,MIN,117,,,5,3,2,5
Mike Muscala,F-C,22023,203488,22300749,"FEB 10, 2024",DET @ LAC,L,10,0,2,0.0,0,2,0.0,0,0,0.0,0,1,1,0,0,0,0,1,0,-9,1,DET,LAC,DET,106,,,1,1,0,1
Mike Muscala,F-C,22023,203488,22300732,"FEB 07, 2024",DET @ SAC,W,25,3,8,0.375,3,6,0.5,0,0,0.0,0,3,3,0,0,0,0,1,9,8,1,DET,SAC,DET,133,,,12,12,9,3
Mike Muscala,F-C,22023,203488,22300741,"FEB 08, 2024",DET @ POR,W,17,2,5,0.4,2,3,0.667,0,0,0.0,2,1,3,2,0,1,1,0,6,-15,1,DET,POR,DET,128,,,11,9,8,5
Oshae Brissett,F-G,22023,1629052,22300706,"FEB 04, 2024",BOS vs. MEM,W,11,2,4,0.5,1,1,1.0,1,1,1.0,1,2,3,1,1,0,1,1,6,2,1,BOS,BOS,MEM,131,,,10,9,7,4
Oshae Brissett,F-G,22023,1629052,22300684,"FEB 01, 2024",BOS vs. LAL,L,2,0,1,0.0,0,1,0.0,0,0,0.0,1,0,1,0,0,0,0,0,0,4,1,BOS,BOS,LAL,105,,,1,1,0,1
Oshae Brissett,F-G,22023,1629052,22300646,"JAN 27, 2024",BOS vs. LAC,L,16,2,5,0.4,0,1,0.0,1,2,0.5,1,4,5,2,0,0,1,0,5,9,1,BOS,BOS,LAC,96,,,12,10,7,7
Oshae Brissett,F-G,22023,1629052,22300630,"JAN 25, 2024",BOS @ MIA,W,3,2,2,1.0,0,0,0.0,0,0,0.0,1,1,2,0,0,0,0,0,4,-1,1,BOS,MIA,BOS,143,,,6,6,4,2
Oshae Brissett,F-G,22023,1629052,22300571,"JAN 17, 2024",BOS vs. SAS,W,13,2,5,0.4,0,1,0.0,3,4,0.75,1,3,4,1,0,0,1,0,7,4,1,BOS,BOS,SAS,117,,,12,11,8,5
Oshae Brissett,F-G,22023,1629052,22300528,"JAN 11, 2024",BOS @ MIL,L,17,4,8,0.5,0,3,0.0,5,6,0.833,0,2,2,1,0,0,0,0,13,-1,1,BOS,MIL,BOS,102,,,16,15,14,3
Oshae Brissett,F-G,22023,1629052,22300507,"JAN 08, 2024",BOS @ IND,L,16,1,4,0.25,1,4,0.25,3,6,0.5,2,4,6,0,2,0,0,3,6,5,1,BOS,IND,BOS,131,,,12,12,6,6
Oshae Brissett,F-G,22023,1629052,22300493,"JAN 06, 2024",BOS @ IND,W,20,3,9,0.333,1,3,0.333,1,1,1.0,5,3,8,0,0,1,0,3,8,4,1,BOS,IND,BOS,118,,,16,16,8,8
Oshae Brissett,F-G,22023,1629052,22300479,"JAN 05, 2024",BOS vs. UTA,W,17,2,5,0.4,0,2,0.0,2,2,1.0,1,2,3,2,2,0,0,3,6,1,1,BOS,BOS,UTA,126,,,11,9,8,5
Oshae Brissett,F-G,22023,1629052,22300448,"DEC 31, 2023",BOS @ SAS,W,21,2,5,0.4,0,0,0.0,0,1,0.0,3,3,6,0,2,0,0,2,4,9,1,BOS,SAS,BOS,134,,,10,10,4,6
Oshae Brissett,F-G,22023,1629052,22300432,"DEC 29, 2023",BOS vs. TOR,W,15,1,3,0.333,0,1,0.0,0,0,0.0,2,5,7,1,0,0,1,0,2,3,1,BOS,BOS,TOR,120,,,10,9,3,8
Oshae Brissett,F-G,22023,1629052,22300389,"DEC 23, 2023",BOS @ LAC,W,18,4,5,0.8,3,4,0.75,1,2,0.5,1,2,3,1,0,0,0,0,12,12,1,BOS,LAC,BOS,142,,,16,15,13,4
Oshae Brissett,F-G,22023,1629052,22300344,"DEC 17, 2023",BOS vs. ORL,W,2,0,0,0.0,0,0,0.0,0,0,0.0,0,2,2,0,0,0,0,0,0,-4,1,BOS,BOS,ORL,114,,,2,2,0,2
Oshae Brissett,F-G,22023,1629052,22301227,"DEC 08, 2023",BOS vs. NYK,W,0,0,0,0.0,0,0,0.0,0,0,0.0,0,0,0,0,0,0,0,0,0,-2,1,BOS,BOS,NYK,133,,,0,0,0,0
Oshae Brissett,F-G,22023,1629052,22300043,"NOV 24, 2023",BOS @ ORL,L,5,0,0,0.0,0,0,0.0,0,2,0.0,0,0,0,0,0,0,0,2,0,-11,1,BOS,ORL,BOS,96,,,0,0,0,0
Oshae Brissett,F-G,22023,1629052,22300174,"NOV 11, 2023",BOS vs. TOR,W,5,0,0,0.0,0,0,0.0,0,0,0.0,0,0,0,0,0,0,0,0,0,-7,1,BOS,BOS,TOR,117,,,0,0,0,0
Oshae Brissett,F-G,22023,1629052,22300010,"NOV 10, 2023",BOS vs. BKN,W,8,0,3,0.0,0,2,0.0,2,4,0.5,1,2,3,0,1,0,0,2,2,-6,1,BOS,BOS,BKN,121,,,5,5,2,3
Oshae Brissett,F-G,22023,1629052,22300118,"NOV 01, 2023",BOS vs. IND,W,20,1,4,0.25,0,1,0.0,2,2,1.0,0,1,1,0,2,0,0,0,4,21,1,BOS,BOS,IND,155,,,5,5,4,1
Oshae Brissett,F-G,22023,1629052,22300103,"OCT 30, 2023",BOS @ WAS,W,10,0,4,0.0,0,2,0.0,0,0,0.0,1,1,2,1,1,0,0,2,0,-10,1,BOS,WAS,BOS,126,,,3,2,1,3
Oshae Brissett,F-G,22023,1629052,22300729,"FEB 07, 2024",BOS vs. ATL,W,6,0,1,0.0,0,1,0.0,2,2,1.0,0,0,0,2,0,0,0,0,2,-1,1,BOS,BOS,ATL,125,,,4,2,4,2
Oshae Brissett,F-G,22023,1629052,22300670,"JAN 30, 2024",BOS vs. IND,W,6,0,0,0.0,0,0,0.0,0,0,0.0,0,1,1,0,0,0,0,1,0,3,1,BOS,BOS,IND,129,,,1,1,0,1
Oshae Brissett,F-G,22023,1629052,22300659,"JAN 29, 2024",BOS vs. NOP,W,11,0,1,0.0,0,1,0.0,0,0,0.0,1,4,5,0,0,0,0,3,0,2,1,BOS,BOS,NOP,118,,,5,5,0,5
Oshae Brissett,F-G,22023,1629052,22300603,"JAN 21, 2024",BOS @ HOU,W,18,3,5,0.6,0,2,0.0,0,0,0.0,1,1,2,3,0,1,3,4,6,4,1,BOS,HOU,BOS,116,,,11,8,9,5
Oshae Brissett,F-G,22023,1629052,22300563,"JAN 15, 2024",BOS @ TOR,W,7,2,4,0.5,1,1,1.0,2,2,1.0,2,1,3,0,0,0,0,1,7,5,1,BOS,TOR,BOS,105,,,10,10,7,3
Oshae Brissett,F-G,22023,1629052,22300542,"JAN 13, 2024",BOS vs. HOU,W,9,2,2,1.0,1,1,1.0,0,0,0.0,0,3,3,2,1,0,0,1,5,-1,1,BOS,BOS,HOU,145,,,10,8,7,5
Oshae Brissett,F-G,22023,1629052,22300517,"JAN 10, 2024",BOS vs. MIN,W,5,0,0,0.0,0,0,0.0,0,0,0.0,0,2,2,0,0,0,0,1,0,-6,1,BOS,BOS,MIN,127,,,2,2,0,2
Oshae Brissett,F-G,22023,1629052,22300421,"DEC 28, 2023",BOS vs. DET,W,6,0,0,0.0,0,0,0.0,0,0,0.0,1,0,1,0,0,0,0,0,0,9,1,BOS,BOS,DET,128,,,1,1,0,1
Oshae Brissett,F-G,22023,1629052,22300373,"DEC 20, 2023",BOS @ SAC,W,17,1,1,1.0,1,1,1.0,0,0,0.0,2,3,5,2,0,0,0,0,3,4,1,BOS,SAC,BOS,144,,,10,8,5,7
Oshae Brissett,F-G,22023,1629052,22300362,"DEC 19, 2023",BOS @ GSW,L,5,3,3,1.0,0,0,0.0,0,0,0.0,0,0,0,0,1,0,0,0,6,1,1,BOS,GSW,BOS,126,,,6,6,6,0
Oshae Brissett,F-G,22023,1629052,22300329,"DEC 15, 2023",BOS vs. ORL,W,16,4,4,1.0,1,1,1.0,2,2,1.0,1,0,1,1,0,0,2,4,11,-3,1,BOS,BOS,ORL,128,,,13,12,12,2
Oshae Brissett,F-G,22023,1629052,22300217,"NOV 20, 2023",BOS @ CHA,L,17,0,0,0.0,0,0,0.0,1,2,0.5,2,5,7,1,0,0,0,2,1,17,1,BOS,CHA,BOS,118,,,9,8,2,8
Oshae Brissett,F-G,22023,1629052,22300136,"NOV 04, 2023",BOS @ BKN,W,11,1,4,0.25,1,4,0.25,2,2,1.0,1,2,3,1,0,0,0,0,5,-13,1,BOS,BKN,BOS,124,,,9,8,6,4
Oshae Brissett,F-G,22023,1629052,22300080,"OCT 27, 2023",BOS vs. MIA,W,14,1,2,0.5,0,0,0.0,0,0,0.0,3,2,5,0,0,0,2,1,2,7,1,BOS,BOS,MIA,119,,,7,7,2,5
Ousmane Dieng,F,22023,1631172,22300682,"JAN 31, 2024",OKC vs. DEN,W,9,0,0,0.0,0,0,0.0,0,0,0.0,0,0,0,0,0,0,1,0,0,3,1,OKC,OKC,DEN,105,,,0,0,0,0
Ousmane Dieng,F,22023,1631172,22300397,"DEC 23, 2023",OKC vs. LAL,L,11,2,3,0.667,1,2,0.5,0,0,0.0,0,0,0,0,0,0,0,2,5,10,1,OKC,OKC,LAL,120,,,5,5,5,0
Ousmane Dieng,F,22023,1631172,22300324,"DEC 14, 2023",OKC @ SAC,L,10,2,4,0.5,2,4,0.5,0,0,0.0,0,0,0,0,0,0,1,0,6,-3,1,OKC,SAC,OKC,123,,,6,6,6,0
Ousmane Dieng,F,22023,1631172,22300302,"DEC 11, 2023",OKC vs. UTA,W,26,6,7,0.857,3,4,0.75,3,4,0.75,0,3,3,3,0,0,1,2,18,-1,1,OKC,OKC,UTA,134,,,24,21,21,6
Ousmane Dieng,F,22023,1631172,22300239,"NOV 25, 2023",OKC vs. PHI,L,8,0,2,0.0,0,1,0.0,0,0,0.0,1,0,1,2,0,0,0,1,0,8,1,OKC,OKC,PHI,123,,,3,1,2,3
Ousmane Dieng,F,22023,1631172,22300185,"NOV 12, 2023",OKC @ PHX,W,6,0,1,0.0,0,1,0.0,0,0,0.0,0,0,0,0,0,0,0,0,0,-4,1,OKC,PHX,OKC,111,,,0,0,0,0
Ousmane Dieng,F,22023,1631172,22300167,"NOV 08, 2023",OKC vs. CLE,W,9,1,2,0.5,0,1,0.0,2,2,1.0,2,3,5,1,1,0,0,1,4,9,1,OKC,OKC,CLE,128,,,10,9,5,6
Ousmane Dieng,F,22023,1631172,22300109,"OCT 30, 2023",OKC vs. DET,W,18,4,4,1.0,2,2,1.0,0,1,0.0,1,0,1,2,0,0,1,0,10,-2,1,OKC,OKC,DET,124,,,13,11,12,3
Ousmane Dieng,F,22023,1631172,22300748,"FEB 10, 2024",OKC @ DAL,L,14,1,9,0.111,1,5,0.2,0,0,0.0,0,0,0,2,0,1,1,0,3,-4,1,OKC,DAL,OKC,111,,,5,3,5,2
Ousmane Dieng,F,22023,1631172,22300724,"FEB 06, 2024",OKC @ UTA,L,11,3,3,1.0,2,2,1.0,0,0,0.0,0,2,2,1,1,1,0,0,8,9,1,OKC,UTA,OKC,117,,,11,10,9,3
Ousmane Dieng,F,22023,1631172,22300710,"FEB 04, 2024",OKC vs. TOR,W,9,1,3,0.333,0,2,0.0,0,0,0.0,0,1,1,0,0,0,1,0,2,-3,1,OKC,OKC,TOR,135,,,3,3,2,1
Ousmane Dieng,F,22023,1631172,22300695,"FEB 02, 2024",OKC vs. CHA,W,20,4,5,0.8,1,1,1.0,2,2,1.0,0,2,2,4,0,0,1,2,11,-1,1,OKC,OKC,CHA,126,,,17,13,15,6
Ousmane Dieng,F,22023,1631172,22300568,"JAN 16, 2024",OKC @ LAC,L,4,0,1,0.0,0,1,0.0,0,0,0.0,0,1,1,0,0,0,1,0,0,0,1,OKC,LAC,OKC,117,,,1,1,0,1
Ousmane Dieng,F,22023,1631172,22300565,"JAN 15, 2024",OKC @ LAL,L,12,2,5,0.4,1,4,0.25,0,0,0.0,1,2,3,0,0,0,1,2,5,-6,1,OKC,LAL,OKC,105,,,8,8,5,3
Ousmane Dieng,F,22023,1631172,22300546,"JAN 13, 2024",OKC vs. ORL,W,9,0,2,0.0,0,2,0.0,0,0,0.0,1,1,2,0,0,0,1,0,0,3,1,OKC,OKC,ORL,112,,,2,2,0,2
Ousmane Dieng,F,22023,1631172,22300529,"JAN 11, 2024",OKC vs. POR,W,23,4,11,0.364,1,5,0.2,0,0,0.0,0,6,6,3,1,0,1,2,9,10,1,OKC,OKC,POR,139,,,18,15,12,9
Ousmane Dieng,F,22023,1631172,22300379,"DEC 21, 2023",OKC vs. LAC,W,8,2,2,1.0,1,1,1.0,2,2,1.0,0,1,1,0,0,0,0,0,7,12,1,OKC,OKC,LAC,134,,,8,8,7,1
Ousmane Dieng,F,22023,1631172,22300355,"DEC 18, 2023",OKC vs. MEM,W,19,2,5,0.4,0,2,0.0,0,0,0.0,1,1,2,2,0,0,0,1,4,-9,1,OKC,OKC,MEM,116,,,8,6,6,4
Ousmane Dieng,F,22023,1631172,22300340,"DEC 16, 2023",OKC @ DEN,W,5,0,1,0.0,0,1,0.0,2,2,1.0,0,1,1,0,0,0,0,0,2,-4,1,OKC,DEN,OKC,118,,,3,3,2,1
Ousmane Dieng,F,22023,1631172,22300058,"NOV 28, 2023",OKC @ MIN,L,2,0,1,0.0,0,0,0.0,0,0,0.0,0,1,1,0,0,0,0,0,0,-2,1,OKC,MIN,OKC,103,,,1,1,0,1
Ousmane Dieng,F,22023,1631172,22300016,"NOV 10, 2023",OKC @ SAC,L,8,0,1,0.0,0,1,0.0,0,0,0.0,0,1,1,1,0,0,0,1,0,0,1,OKC,SAC,OKC,98,,,2,1,1,2
Ousmane Dieng,F,22023,1631172,22300155,"NOV 06, 2023",OKC vs. ATL,W,10,1,4,0.25,1,2,0.5,0,0,0.0,1,1,2,0,0,0,1,0,3,-5,1,OKC,OKC,ATL,126,,,5,5,3,2
Ousmane Dieng,F,22023,1631172,22300005,"NOV 03, 2023",OKC vs. GSW,L,5,1,3,0.333,1,3,0.333,0,0,0.0,0,1,1,1,0,0,1,0,3,-3,1,OKC,OKC,GSW,139,,,5,4,4,2
Ousmane Dieng,F,22023,1631172,22300121,"NOV 01, 2023",OKC vs. NOP,L,12,1,4,0.25,0,3,0.0,0,0,0.0,0,2,2,1,0,0,0,0,2,-11,1,OKC,OKC,NOP,106,,,5,4,3,3
Ousmane Dieng,F,22023,1631172,22300095,"OCT 29, 2023",OKC vs. DEN,L,19,2,8,0.25,0,5,0.0,1,1,1.0,0,5,5,1,0,0,0,0,5,-10,1,OKC,OKC,DEN,95,,,11,10,6,6
Ousmane Dieng,F,22023,1631172,22300081,"OCT 27, 2023",OKC @ CLE,W,11,0,2,0.0,0,2,0.0,0,0,0.0,0,1,1,2,0,0,0,3,0,-4,1,OKC,CLE,OKC,108,,,3,1,2,3
Ousmane Dieng,F,22023,1631172,22300070,"OCT 25, 2023",OKC @ CHI,W,14,3,5,0.6,3,5,0.6,0,0,0.0,1,1,2,0,0,0,1,1,9,2,1,OKC,CHI,OKC,124,,,11,11,9,2
Gradey Dick,G,22023,1641711,22300416,"DEC 27, 2023",TOR @ WAS,W,5,1,1,1.0,0,0,0.0,1,1,1.0,0,0,0,0,1,0,0,0,3,4,1,TOR,WAS,TOR,132,,,3,3,3,0
Gradey Dick,G,22023,1641711,22300382,"DEC 22, 2023",TOR @ PHI,L,2,0,0,0.0,0,0,0.0,0,0,0.0,0,0,0,0,1,0,0,0,0,5,1,TOR,PHI,TOR,111,,,0,0,0,0
Gradey Dick,G,22023,1641711,22300330,"DEC 15, 2023",TOR vs. ATL,L,3,1,3,0.333,1,3,0.333,0,0,0.0,0,0,0,0,0,0,0,0,3,1,1,TOR,TOR,ATL,104,,,3,3,3,0
Gradey Dick,G,22023,1641711,22300297,"DEC 11, 2023",TOR @ NYK,L,4,1,1,1.0,0,0,0.0,0,0,0.0,0,0,0,0,0,0,0,1,2,-6,1,TOR,NYK,TOR,130,,,2,2,2,0
Gradey Dick,G,22023,1641711,22300046,"NOV 24, 2023",TOR vs. CHI,W,9,0,0,0.0,0,0,0.0,2,2,1.0,0,1,1,0,0,0,1,1,2,2,1,TOR,TOR,CHI,121,,,3,3,2,1
Gradey Dick,G,22023,1641711,22300038,"NOV 21, 2023",TOR @ ORL,L,12,1,4,0.25,1,3,0.333,0,0,0.0,0,2,2,2,0,0,0,0,3,-2,1,TOR,ORL,TOR,107,,,7,5,5,4
Gradey Dick,G,22023,1641711,22300211,"NOV 19, 2023",TOR vs. DET,W,12,1,3,0.333,1,2,0.5,2,2,1.0,0,0,0,0,1,0,0,2,5,-3,1,TOR,TOR,DET,142,,,5,5,5,0
Gradey Dick,G,22023,1641711,22300031,"NOV 17, 2023",TOR vs. BOS,L,10,0,5,0.0,0,4,0.0,0,0,0.0,0,1,1,1,0,0,2,0,0,-10,1,TOR,TOR,BOS,105,,,2,1,1,2
Gradey Dick,G,22023,1641711,22300195,"NOV 15, 2023",TOR vs. MIL,L,26,2,10,0.2,1,6,0.167,6,6,1.0,0,0,0,2,1,0,1,4,11,-29,1,TOR,TOR,MIL,112,,,13,11,13,2
Gradey Dick,G,22023,1641711,22300189,"NOV 13, 2023",TOR vs. WAS,W,24,3,4,0.75,2,3,0.667,0,0,0.0,3,1,4,2,0,0,2,2,8,2,1,TOR,TOR,WAS,111,,,14,12,10,6
Gradey Dick,G,22023,1641711,22300174,"NOV 11, 2023",TOR @ BOS,L,15,1,4,0.25,0,2,0.0,2,2,1.0,0,1,1,1,0,0,1,1,4,-4,1,TOR,BOS,TOR,94,,,6,5,5,2
Gradey Dick,G,22023,1641711,22300092,"OCT 28, 2023",TOR vs. PHI,L,28,5,8,0.625,4,6,0.667,2,2,1.0,2,0,2,1,0,0,1,5,16,1,1,TOR,TOR,PHI,107,,,19,18,17,3
Gradey Dick,G,22023,1641711,22300082,"OCT 27, 2023",TOR @ CHI,L,6,0,2,0.0,0,2,0.0,0,0,0.0,0,1,1,0,0,0,0,0,0,-6,1,TOR,CHI,TOR,103,,,1,1,0,1
Gradey Dick,G,22023,1641711,22300069,"OCT 25, 2023",TOR vs. MIN,W,2,0,1,0.0,0,0,0.0,0,0,0.0,0,0,0,1,0,0,0,1,0,1,1,TOR,TOR,MIN,97,,,1,0,1,1
Gradey Dick,G,22023,1641711,22300756,"FEB 10, 2024",TOR vs. CLE,L,22,4,8,0.5,3,6,0.5,3,3,1.0,0,0,0,1,0,0,1,2,14,-22,1,TOR,TOR,CLE,95,,,15,14,15,1
Gradey Dick,G,22023,1641711,22300168,"NOV 08, 2023",TOR @ DAL,W,7,0,1,0.0,0,0,0.0,0,0,0.0,0,0,0,0,0,0,2,1,0,0,1,TOR,DAL,TOR,127,,,0,0,0,0
Gradey Dick,G,22023,1641711,22300141,"NOV 05, 2023",TOR @ SAS,W,14,0,2,0.0,0,2,0.0,0,0,0.0,1,2,3,4,0,0,1,1,0,0,1,TOR,SAS,TOR,123,,,7,3,4,7
Gradey Dick,G,22023,1641711,22300128,"NOV 02, 2023",TOR @ PHI,L,14,0,2,0.0,0,0,0.0,0,0,0.0,0,0,0,1,0,0,1,1,0,-17,1,TOR,PHI,TOR,99,,,1,0,1,1
Gradey Dick,G,22023,1641711,22300116,"NOV 01, 2023",TOR vs. MIL,W,21,2,10,0.2,1,8,0.125,0,0,0.0,0,1,1,0,0,0,0,1,5,-3,1,TOR,TOR,MIL,130,,,6,6,5,1
Gradey Dick,G,22023,1641711,22300105,"OCT 30, 2023",TOR vs. POR,L,21,2,7,0.286,0,3,0.0,0,0,0.0,1,5,6,0,2,0,0,3,4,-9,1,TOR,TOR,POR,91,,,10,10,4,6
Gradey Dick,G,22023,1641711,22300744,"FEB 09, 2024",TOR vs. HOU,W,20,2,5,0.4,2,5,0.4,0,0,0.0,0,1,1,1,1,0,0,3,6,-7,1,TOR,TOR,HOU,100,,,8,7,7,2
Gradey Dick,G,22023,1641711,22300726,"FEB 07, 2024",TOR @ CHA,W,15,2,2,1.0,2,2,1.0,0,0,0.0,0,1,1,2,0,0,1,0,6,9,1,TOR,CHA,TOR,123,,,9,7,8,3
Gradey Dick,G,22023,1641711,22300718,"FEB 05, 2024",TOR @ NOP,L,30,9,16,0.563,4,8,0.5,0,0,0.0,0,4,4,2,1,0,0,2,22,-24,1,TOR,NOP,TOR,100,,,28,26,24,6
Gradey Dick,G,22023,1641711,22300710,"FEB 04, 2024",TOR @ OKC,L,10,2,2,1.0,0,0,0.0,2,2,1.0,0,0,0,1,0,0,0,0,6,4,1,TOR,OKC,TOR,127,,,7,6,7,1
Gradey Dick,G,22023,1641711,22300692,"FEB 02, 2024",TOR @ HOU,L,24,1,8,0.125,0,4,0.0,1,2,0.5,1,6,7,0,3,0,1,1,3,-19,1,TOR,HOU,TOR,106,,,10,10,3,7
Gradey Dick,G,22023,1641711,22300672,"JAN 30, 2024",TOR @ CHI,W,20,0,1,0.0,0,1,0.0,0,0,0.0,0,3,3,4,1,0,0,2,0,2,1,TOR,CHI,TOR,118,,,7,3,4,7
Gradey Dick,G,22023,1641711,22300653,"JAN 28, 2024",TOR @ ATL,L,25,5,12,0.417,3,5,0.6,2,3,0.667,3,2,5,3,1,0,2,3,15,19,1,TOR,ATL,TOR,113,,,23,20,18,8
Gradey Dick,G,22023,1641711,22300637,"JAN 26, 2024",TOR vs. LAC,L,21,3,7,0.429,0,3,0.0,0,0,0.0,1,3,4,2,1,0,0,3,6,-3,1,TOR,TOR,LAC,107,,,12,10,8,6
Gradey Dick,G,22023,1641711,22300609,"JAN 22, 2024",TOR vs. MEM,L,15,0,1,0.0,0,1,0.0,0,0,0.0,1,2,3,0,0,0,1,0,0,5,1,TOR,TOR,MEM,100,,,3,3,0,3
Gradey Dick,G,22023,1641711,22300596,"JAN 20, 2024",TOR @ NYK,L,16,4,7,0.571,3,6,0.5,0,0,0.0,0,2,2,1,1,0,0,1,11,-2,1,TOR,NYK,TOR,94,,,14,13,12,3
Gradey Dick,G,22023,1641711,22300574,"JAN 17, 2024",TOR vs. MIA,W,12,2,2,1.0,2,2,1.0,0,0,0.0,0,0,0,4,2,0,2,2,6,14,1,TOR,TOR,MIA,115,,,10,6,10,4
Gradey Dick,G,22023,1641711,22300540,"JAN 12, 2024",TOR @ UTA,L,12,0,3,0.0,0,2,0.0,0,0,0.0,0,1,1,2,0,0,0,1,0,-8,1,TOR,UTA,TOR,104,,,3,1,2,3
Keon Ellis,G,22023,1631165,22300746,"FEB 09, 2024",SAC vs. DEN,W,6,0,0,0.0,0,0,0.0,0,0,0.0,0,1,1,2,0,0,1,0,0,0,1,SAC,SAC,DEN,135,,,3,1,2,3
Keon Ellis,G,22023,1631165,22300714,"FEB 05, 2024",SAC @ CLE,L,3,0,1,0.0,0,1,0.0,0,0,0.0,0,0,0,0,0,0,1,0,0,-2,1,SAC,CLE,SAC,110,,,0,0,0,0
Keon Ellis,G,22023,1631165,22300583,"JAN 18, 2024",SAC vs. IND,L,2,0,0,0.0,0,0,0.0,0,0,0.0,0,0,0,0,0,0,0,0,0,-4,1,SAC,SAC,IND,121,,,0,0,0,0
Keon Ellis,G,22023,1631165,22300532,"JAN 12, 2024",SAC @ PHI,L,10,1,3,0.333,1,2,0.5,0,0,0.0,0,2,2,0,0,0,2,1,3,-11,1,SAC,PHI,SAC,90,,,5,5,3,2
Keon Ellis,G,22023,1631165,22300518,"JAN 10, 2024",SAC @ CHA,W,9,1,3,0.333,1,3,0.333,0,0,0.0,0,1,1,1,0,1,0,2,3,4,1,SAC,CHA,SAC,121,,,5,4,4,2
Keon Ellis,G,22023,1631165,22300512,"JAN 09, 2024",SAC @ DET,W,4,0,0,0.0,0,0,0.0,0,0,0.0,0,0,0,0,0,0,0,1,0,-4,1,SAC,DET,SAC,131,,,0,0,0,0
Keon Ellis,G,22023,1631165,22300500,"JAN 07, 2024",SAC vs. NOP,L,12,5,6,0.833,3,3,1.0,0,0,0.0,2,0,2,1,1,0,0,1,13,9,1,SAC,SAC,NOP,100,,,16,15,14,3
Keon Ellis,G,22023,1631165,22300449,"DEC 31, 2023",SAC @ MEM,W,4,0,0,0.0,0,0,0.0,0,0,0.0,0,0,0,0,0,0,0,1,0,4,1,SAC,MEM,SAC,123,,,0,0,0,0
Keon Ellis,G,22023,1631165,22300413,"DEC 26, 2023",SAC @ POR,L,9,0,0,0.0,0,0,0.0,0,0,0.0,0,0,0,2,0,1,0,1,0,-14,1,SAC,POR,SAC,113,,,2,0,2,2
Keon Ellis,G,22023,1631165,22300400,"DEC 23, 2023",SAC vs. MIN,L,11,0,3,0.0,0,2,0.0,0,0,0.0,0,0,0,1,0,0,0,1,0,-14,1,SAC,SAC,MIN,98,,,1,0,1,1
Keon Ellis,G,22023,1631165,22300387,"DEC 22, 2023",SAC vs. PHX,W,17,0,3,0.0,0,2,0.0,1,2,0.5,1,2,3,1,1,1,0,3,1,-3,1,SAC,SAC,PHX,120,,,5,4,2,4
Keon Ellis,G,22023,1631165,22300373,"DEC 20, 2023",SAC vs. BOS,L,19,4,7,0.571,4,7,0.571,0,0,0.0,0,2,2,4,1,2,0,1,12,2,1,SAC,SAC,BOS,119,,,18,14,16,6
Keon Ellis,G,22023,1631165,22300358,"DEC 18, 2023",SAC vs. WAS,W,15,1,5,0.2,1,5,0.2,0,0,0.0,0,1,1,2,1,1,0,4,3,1,1,SAC,SAC,WAS,141,,,6,4,5,3
Keon Ellis,G,22023,1631165,22300342,"DEC 16, 2023",SAC vs. UTA,W,26,0,3,0.0,0,3,0.0,2,2,1.0,0,1,1,7,1,0,3,2,2,23,1,SAC,SAC,UTA,125,,,10,3,9,8
Keon Ellis,G,22023,1631165,22300324,"DEC 14, 2023",SAC vs. OKC,W,28,6,8,0.75,5,7,0.714,0,0,0.0,2,4,6,3,1,1,0,5,17,10,1,SAC,SAC,OKC,128,,,26,23,20,9
Keon Ellis,G,22023,1631165,22300309,"DEC 12, 2023",SAC @ LAC,L,12,1,1,1.0,1,1,1.0,0,0,0.0,0,0,0,1,0,1,2,0,3,5,1,SAC,LAC,SAC,99,,,4,3,4,1
Keon Ellis,G,22023,1631165,22300303,"DEC 11, 2023",SAC vs. BKN,W,15,1,4,0.25,1,4,0.25,0,0,0.0,0,1,1,2,1,0,0,1,3,-10,1,SAC,SAC,BKN,131,,,6,4,5,3
Keon Ellis,G,22023,1631165,22301228,"DEC 08, 2023",SAC @ PHX,W,17,4,6,0.667,2,4,0.5,0,0,0.0,0,2,2,0,0,0,2,3,10,-2,1,SAC,PHX,SAC,114,,,12,12,10,2
Keon Ellis,G,22023,1631165,22301204,"DEC 04, 2023",SAC vs. NOP,L,8,1,2,0.5,1,2,0.5,2,2,1.0,0,0,0,0,1,0,0,1,5,-1,1,SAC,SAC,NOP,117,,,5,5,5,0
Keon Ellis,G,22023,1631165,22300290,"DEC 02, 2023",SAC vs. DEN,W,8,0,1,0.0,0,1,0.0,0,0,0.0,0,0,0,2,0,0,0,1,0,-14,1,SAC,SAC,DEN,123,,,2,0,2,2
Keon Ellis,G,22023,1631165,22300060,"NOV 28, 2023",SAC vs. GSW,W,6,1,2,0.5,1,2,0.5,0,0,0.0,0,0,0,0,0,0,0,0,3,1,1,SAC,SAC,GSW,124,,,3,3,3,0
Keon Ellis,G,22023,1631165,22300212,"NOV 19, 2023",SAC @ DAL,W,9,0,0,0.0,0,0,0.0,0,0,0.0,1,3,4,0,0,0,0,1,0,9,1,SAC,DAL,SAC,129,,,4,4,0,4
Keon Ellis,G,22023,1631165,22300032,"NOV 17, 2023",SAC @ SAS,W,10,1,1,1.0,0,0,0.0,0,0,0.0,0,0,0,2,1,0,1,0,2,-1,1,SAC,SAS,SAC,129,,,4,2,4,2
Keon Ellis,G,22023,1631165,22300198,"NOV 15, 2023",SAC @ LAL,W,9,0,3,0.0,0,2,0.0,0,0,0.0,1,1,2,1,0,0,0,2,0,6,1,SAC,LAL,SAC,125,,,3,2,1,3
Keon Ellis,G,22023,1631165,22300191,"NOV 13, 2023",SAC vs. CLE,W,12,1,3,0.333,0,2,0.0,0,0,0.0,0,0,0,2,0,1,2,1,2,-3,1,SAC,SAC,CLE,132,,,4,2,4,2
Keon Ellis,G,22023,1631165,22300016,"NOV 10, 2023",SAC vs. OKC,W,31,2,8,0.25,1,7,0.143,3,4,0.75,1,3,4,2,0,3,1,3,8,4,1,SAC,SAC,OKC,105,,,14,12,10,6
Keon Ellis,G,22023,1631165,22300170,"NOV 08, 2023",SAC vs. POR,W,21,1,3,0.333,0,2,0.0,2,3,0.667,0,4,4,0,3,0,2,1,4,-4,1,SAC,SAC,POR,121,,,8,8,4,4
Keon Ellis,G,22023,1631165,22300153,"NOV 06, 2023",SAC @ HOU,L,14,5,7,0.714,4,6,0.667,1,4,0.25,1,1,2,1,1,0,0,1,15,10,1,SAC,HOU,SAC,97,,,18,17,16,3
Keon Ellis,G,22023,1631165,22300137,"NOV 04, 2023",SAC @ HOU,L,1,0,1,0.0,0,1,0.0,0,0,0.0,0,0,0,0,1,0,0,1,0,0,1,SAC,HOU,SAC,89,,,0,0,0,0
Keon Ellis,G,22023,1631165,22300072,"OCT 25, 2023",SAC @ UTA,W,1,0,0,0.0,0,0,0.0,0,0,0.0,0,0,0,0,0,0,0,0,0,-2,1,SAC,UTA,SAC,130,,,0,0,0,0
Tristan Thompson,C-F,22023,202684,22300607,"JAN 22, 2024",CLE @ ORL,W,21,2,6,0.333,0,0,0.0,0,2,0.0,1,4,5,1,1,1,1,1,4,5,1,CLE,ORL,CLE,126,,,10,9,5,6
Tristan Thompson,C-F,22023,202684,22300595,"JAN 20, 2024",CLE @ ATL,W,14,3,4,0.75,0,1,0.0,0,0,0.0,0,5,5,2,0,1,0,0,6,14,1,CLE,ATL,CLE,116,,,13,11,8,7
Tristan Thompson,C-F,22023,202684,22300572,"JAN 17, 2024",CLE vs. MIL,W,20,3,4,0.75,0,0,0.0,0,0,0.0,2,7,9,3,0,0,2,0,6,10,1,CLE,CLE,MIL,135,,,18,15,9,12
Tristan Thompson,C-F,22023,202684,22300561,"JAN 15, 2024",CLE vs. CHI,W,14,2,4,0.5,0,0,0.0,0,0,0.0,1,1,2,1,0,0,0,0,4,-14,1,CLE,CLE,CHI,109,,,7,6,5,3
Tristan Thompson,C-F,22023,202684,22300527,"JAN 11, 2024",CLE vs. BKN,W,10,0,0,0.0,0,0,0.0,1,4,0.25,1,1,2,0,1,0,1,3,1,3,1,CLE,CLE,BKN,111,,,3,3,1,2
Tristan Thompson,C-F,22023,202684,22300497,"JAN 07, 2024",CLE vs. SAS,W,17,3,4,0.75,0,0,0.0,2,4,0.5,2,2,4,2,0,0,1,4,8,12,1,CLE,CLE,SAS,117,,,14,12,10,6
Tristan Thompson,C-F,22023,202684,22300482,"JAN 05, 2024",CLE vs. WAS,W,17,4,5,0.8,0,0,0.0,0,2,0.0,2,2,4,2,0,0,2,6,8,7,1,CLE,CLE,WAS,114,,,14,12,10,6
Tristan Thompson,C-F,22023,202684,22300465,"JAN 03, 2024",CLE vs. WAS,W,19,3,7,0.429,0,0,0.0,1,3,0.333,3,6,9,4,0,1,3,1,7,12,1,CLE,CLE,WAS,140,,,20,16,11,13
Tristan Thompson,C-F,22023,202684,22300452,"JAN 01, 2024",CLE @ TOR,L,14,0,0,0.0,0,0,0.0,0,0,0.0,2,1,3,1,0,0,0,3,0,-1,1,CLE,TOR,CLE,121,,,4,3,1,4
Tristan Thompson,C-F,22023,202684,22300433,"DEC 29, 2023",CLE vs. MIL,L,8,1,2,0.5,0,0,0.0,0,2,0.0,2,4,6,1,0,0,0,2,2,4,1,CLE,CLE,MIL,111,,,9,8,3,7
Tristan Thompson,C-F,22023,202684,22300420,"DEC 27, 2023",CLE @ DAL,W,13,1,3,0.333,0,0,0.0,0,0,0.0,1,0,1,0,0,0,2,4,2,-11,1,CLE,DAL,CLE,113,,,3,3,2,1
Tristan Thompson,C-F,22023,202684,22300396,"DEC 23, 2023",CLE @ CHI,W,13,3,4,0.75,0,0,0.0,0,0,0.0,4,2,6,1,0,0,1,1,6,8,1,CLE,CHI,CLE,109,,,13,12,7,7
Tristan Thompson,C-F,22023,202684,22300375,"DEC 21, 2023",CLE vs. NOP,L,21,3,5,0.6,0,0,0.0,0,0,0.0,4,3,7,3,0,0,0,2,6,-13,1,CLE,CLE,NOP,104,,,16,13,9,10
Tristan Thompson,C-F,22023,202684,22300364,"DEC 20, 2023",CLE vs. UTA,W,18,5,7,0.714,0,0,0.0,0,0,0.0,2,3,5,4,4,0,0,2,10,12,1,CLE,CLE,UTA,124,,,19,15,14,9
Tristan Thompson,C-F,22023,202684,22300349,"DEC 18, 2023",CLE vs. HOU,W,18,1,2,0.5,0,0,0.0,2,8,0.25,3,2,5,1,0,0,0,2,4,2,1,CLE,CLE,HOU,135,,,10,9,5,6
Tristan Thompson,C-F,22023,202684,22300336,"DEC 16, 2023",CLE vs. ATL,W,13,3,3,1.0,0,0,0.0,0,0,0.0,2,3,5,0,0,0,0,3,6,3,1,CLE,CLE,ATL,127,,,11,11,6,5
Tristan Thompson,C-F,22023,202684,22300319,"DEC 14, 2023",CLE @ BOS,L,3,1,1,1.0,0,0,0.0,0,0,0.0,1,1,2,0,0,0,1,1,2,-3,1,CLE,BOS,CLE,107,,,4,4,2,2
Tristan Thompson,C-F,22023,202684,22300305,"DEC 12, 2023",CLE @ BOS,L,12,1,1,1.0,0,0,0.0,0,0,0.0,3,1,4,1,0,0,0,0,2,-11,1,CLE,BOS,CLE,113,,,7,6,3,5
Tristan Thompson,C-F,22023,202684,22300294,"DEC 11, 2023",CLE @ ORL,L,29,5,7,0.714,0,0,0.0,0,0,0.0,4,9,13,2,0,2,1,1,10,8,1,CLE,ORL,CLE,94,,,25,23,12,15
Tristan Thompson,C-F,22023,202684,22301220,"DEC 08, 2023",CLE @ MIA,W,16,2,3,0.667,0,0,0.0,1,2,0.5,2,1,3,0,0,0,1,0,5,21,1,CLE,MIA,CLE,111,,,8,8,5,3
Tristan Thompson,C-F,22023,202684,22301205,"DEC 06, 2023",CLE vs. ORL,W,6,0,0,0.0,0,0,0.0,1,2,0.5,0,3,3,0,0,1,0,1,1,-3,1,CLE,CLE,ORL,121,,,4,4,1,3
Tristan Thompson,C-F,22023,202684,22300283,"DEC 02, 2023",CLE @ DET,W,3,0,1,0.0,0,0,0.0,0,0,0.0,1,1,2,0,0,0,0,0,0,0,1,CLE,DET,CLE,110,,,2,2,0,2
Tristan Thompson,C-F,22023,202684,22300251,"NOV 26, 2023",CLE vs. TOR,W,7,2,2,1.0,0,0,0.0,0,0,0.0,4,0,4,4,0,0,1,0,4,7,1,CLE,CLE,TOR,105,,,12,8,8,8
Tristan Thompson,C-F,22023,202684,22300229,"NOV 22, 2023",CLE vs. MIA,L,13,2,3,0.667,0,0,0.0,0,2,0.0,2,1,3,0,0,1,0,1,4,2,1,CLE,CLE,MIA,96,,,7,7,4,3
Tristan Thompson,C-F,22023,202684,22300040,"NOV 21, 2023",CLE @ PHI,W,15,1,1,1.0,0,0,0.0,0,2,0.0,1,2,3,2,1,1,0,0,2,4,1,CLE,PHI,CLE,122,,,7,5,4,5
Tristan Thompson,C-F,22023,202684,22300210,"NOV 19, 2023",CLE vs. DEN,W,11,2,4,0.5,0,0,0.0,1,2,0.5,1,2,3,0,0,0,0,2,5,-23,1,CLE,CLE,DEN,121,,,8,8,5,3
Tristan Thompson,C-F,22023,202684,22300030,"NOV 17, 2023",CLE vs. DET,W,1,0,0,0.0,0,0,0.0,0,0,0.0,0,0,0,0,0,0,0,0,0,-2,1,CLE,CLE,DET,108,,,0,0,0,0
Tristan Thompson,C-F,22023,202684,22300199,"NOV 15, 2023",CLE @ POR,W,2,0,0,0.0,0,0,0.0,0,0,0.0,0,1,1,0,0,0,0,0,0,0,1,CLE,POR,CLE,109,,,1,1,0,1
Tristan Thompson,C-F,22023,202684,22300191,"NOV 13, 2023",CLE @ SAC,L,13,1,1,1.0,0,0,0.0,0,0,0.0,0,1,1,0,0,0,0,2,2,8,1,CLE,SAC,CLE,120,,,3,3,2,1
Tristan Thompson,C-F,22023,202684,22300176,"NOV 11, 2023",CLE @ GSW,W,2,0,0,0.0,0,0,0.0,0,0,0.0,0,0,0,0,0,0,0,0,0,-8,1,CLE,GSW,CLE,118,,,0,0,0,0
Tristan Thompson,C-F,22023,202684,22300167,"NOV 08, 2023",CLE @ OKC,L,13,0,0,0.0,0,0,0.0,1,2,0.5,0,2,2,2,1,0,2,2,1,-2,1,CLE,OKC,CLE,120,,,5,3,3,4
Tristan Thompson,C-F,22023,202684,22300142,"NOV 05, 2023",CLE vs. GSW,W,11,1,2,0.5,0,0,0.0,1,3,0.333,1,4,5,0,0,1,0,2,3,2,1,CLE,CLE,GSW,115,,,8,8,3,5
Tristan Thompson,C-F,22023,202684,22300001,"NOV 03, 2023",CLE @ IND,L,3,0,0,0.0,0,0,0.0,0,0,0.0,0,1,1,0,0,0,0,1,0,-8,1,CLE,IND,CLE,116,,,1,1,0,1
Tristan Thompson,C-F,22023,202684,22300112,"OCT 31, 2023",CLE vs. NYK,L,19,1,1,1.0,0,0,0.0,2,2,1.0,1,1,2,1,0,2,2,2,4,-1,1,CLE,CLE,NYK,91,,,7,6,5,3
Tristan Thompson,C-F,22023,202684,22300091,"OCT 28, 2023",CLE vs. IND,L,8,2,3,0.667,0,0,0.0,0,0,0.0,4,1,5,2,0,0,0,0,4,1,1,CLE,CLE,IND,113,,,11,9,6,7
Tristan Thompson,C-F,22023,202684,22300120,"NOV 01, 2023",CLE @ NYK,W,13,3,4,0.75,0,0,0.0,0,0,0.0,2,3,5,0,0,0,2,1,6,-2,1,CLE,NYK,CLE,95,,,11,11,6,5
Tre Mann,G,22023,1630544,22300751,"FEB 10, 2024",CHA vs. MEM,W,27,4,11,0.364,1,5,0.2,0,0,0.0,1,3,4,9,2,0,2,1,9,-6,1,CHA,CHA,MEM,115,,,22,13,18,13
Tre Mann,G,22023,1630544,22300419,"DEC 27, 2023",OKC vs. NYK,W,6,0,3,0.0,0,2,0.0,0,0,0.0,0,0,0,1,0,0,0,0,0,-5,1,OKC,OKC,NYK,129,,,1,0,1,1
Tre Mann,G,22023,1630544,22300302,"DEC 11, 2023",OKC vs. UTA,W,13,2,6,0.333,0,1,0.0,0,0,0.0,0,2,2,0,0,0,1,2,4,-21,1,OKC,OKC,UTA,134,,,6,6,4,2
Tre Mann,G,22023,1630544,22300215,"NOV 19, 2023",OKC @ POR,W,24,3,7,0.429,1,3,0.333,0,0,0.0,2,3,5,2,0,0,3,1,7,17,1,OKC,POR,OKC,134,,,14,12,9,7
Tre Mann,G,22023,1630544,22300109,"OCT 30, 2023",OKC vs. DET,W,2,0,0,0.0,0,0,0.0,0,0,0.0,0,0,0,0,0,0,0,0,0,-8,1,OKC,OKC,DET,124,,,0,0,0,0
Tre Mann,G,22023,1630544,22300529,"JAN 11, 2024",OKC vs. POR,W,18,4,5,0.8,3,4,0.75,0,0,0.0,1,6,7,4,0,0,1,0,11,13,1,OKC,OKC,POR,139,,,22,18,15,11
Tre Mann,G,22023,1630544,22300379,"DEC 21, 2023",OKC vs. LAC,W,2,0,0,0.0,0,0,0.0,0,0,0.0,0,0,0,1,0,0,0,0,0,1,1,OKC,OKC,LAC,134,,,1,0,1,1
Tre Mann,G,22023,1630544,22300355,"DEC 18, 2023",OKC vs. MEM,W,7,0,0,0.0,0,0,0.0,0,0,0.0,0,0,0,2,0,0,1,0,0,-12,1,OKC,OKC,MEM,116,,,2,0,2,2
Tre Mann,G,22023,1630544,22300095,"OCT 29, 2023",OKC vs. DEN,L,8,5,7,0.714,1,2,0.5,1,1,1.0,1,3,4,1,0,0,1,0,12,-5,1,OKC,OKC,DEN,95,,,17,16,13,5
Tre Mann,G,22023,1630544,22300070,"OCT 25, 2023",OKC @ CHI,W,2,0,0,0.0,0,0,0.0,0,0,0.0,0,0,0,1,0,0,0,0,0,0,1,OKC,CHI,OKC,124,,,1,0,1,1
Tre Mann,G,22023,1630544,22300411,"DEC 26, 2023",OKC vs. MIN,W,2,0,0,0.0,0,0,0.0,0,0,0.0,0,0,0,0,0,0,0,0,0,-2,1,OKC,OKC,MIN,129,,,0,0,0,0
Tre Mann,G,22023,1630544,22301212,"DEC 06, 2023",OKC @ HOU,L,24,4,8,0.5,2,4,0.5,0,0,0.0,0,3,3,4,2,0,1,0,10,7,1,OKC,HOU,OKC,101,,,17,13,14,7
Tre Mann,G,22023,1630544,22300271,"NOV 30, 2023",OKC vs. LAL,W,3,0,0,0.0,0,0,0.0,0,0,0.0,0,1,1,2,0,0,0,0,0,3,1,OKC,OKC,LAL,133,,,3,1,2,3
Tre Mann,G,22023,1630544,22300021,"NOV 14, 2023",OKC vs. SAS,W,9,2,4,0.5,1,3,0.333,0,0,0.0,0,2,2,2,1,0,1,0,5,7,1,OKC,OKC,SAS,123,,,9,7,7,4
James Bouknight,G,22023,1630547,22300335,"DEC 16, 2023",CHA vs. PHI,L,7,3,5,0.6,3,5,0.6,0,0,0.0,0,1,1,0,0,0,0,1,9,-6,1,CHA,CHA,PHI,80,,,10,10,9,1
James Bouknight,G,22023,1630547,22300635,"JAN 26, 2024",CHA vs. HOU,L,7,2,6,0.333,1,4,0.25,0,0,0.0,0,0,0,0,0,0,0,0,5,3,1,CHA,CHA,HOU,104,,,5,5,5,0
James Bouknight,G,22023,1630547,22300575,"JAN 17, 2024",CHA @ NOP,L,4,2,3,0.667,2,2,1.0,0,0,0.0,0,0,0,0,0,0,0,0,6,-1,1,CHA,NOP,CHA,108,,,6,6,6,0
James Bouknight,G,22023,1630547,22300551,"JAN 14, 2024",CHA @ MIA,L,2,0,1,0.0,0,0,0.0,1,2,0.5,0,0,0,0,0,0,0,0,1,1,1,CHA,MIA,CHA,85,,,1,1,1,0
James Bouknight,G,22023,1630547,22300541,"JAN 12, 2024",CHA @ SAS,L,6,0,2,0.0,0,2,0.0,0,0,0.0,0,1,1,0,0,1,0,0,0,-9,1,CHA,SAS,CHA,99,,,1,1,0,1
James Bouknight,G,22023,1630547,22300707,"FEB 04, 2024",CHA vs. IND,L,2,0,0,0.0,0,0,0.0,0,0,0.0,0,0,0,0,0,0,0,0,0,0,1,CHA,CHA,IND,99,,,0,0,0,0
James Bouknight,G,22023,1630547,22300695,"FEB 02, 2024",CHA @ OKC,L,6,2,4,0.5,1,3,0.333,0,0,0.0,0,0,0,0,1,0,1,0,5,10,1,CHA,OKC,CHA,106,,,5,5,5,0
James Bouknight,G,22023,1630547,22300657,"JAN 29, 2024",CHA vs. NYK,L,2,0,1,0.0,0,1,0.0,0,0,0.0,0,0,0,0,0,0,0,1,0,-3,1,CHA,CHA,NYK,92,,,0,0,0,0
James Bouknight,G,22023,1630547,22300518,"JAN 10, 2024",CHA vs. SAC,L,20,3,8,0.375,2,6,0.333,0,0,0.0,0,0,0,1,0,0,0,0,8,-10,1,CHA,CHA,SAC,96,,,9,8,9,1
James Bouknight,G,22023,1630547,22300365,"DEC 20, 2023",CHA @ IND,L,6,1,3,0.333,1,3,0.333,0,0,0.0,0,2,2,0,0,0,1,0,3,-5,1,CHA,IND,CHA,109,,,5,5,3,2
James Bouknight,G,22023,1630547,22300057,"NOV 28, 2023",CHA @ NYK,L,5,2,3,0.667,1,2,0.5,0,0,0.0,1,0,1,0,0,0,0,0,5,-1,1,CHA,NYK,CHA,91,,,6,6,5,1
James Bouknight,G,22023,1630547,22300506,"JAN 08, 2024",CHA vs. CHI,L,4,1,1,1.0,1,1,1.0,0,0,0.0,0,2,2,2,0,0,0,1,3,-2,1,CHA,CHA,CHI,109,,,7,5,5,4
James Bouknight,G,22023,1630547,22300455,"JAN 01, 2024",CHA @ DEN,L,4,0,1,0.0,0,0,0.0,0,0,0.0,0,0,0,2,0,0,0,0,0,6,1,CHA,DEN,CHA,91,,,2,0,2,2
James Bouknight,G,22023,1630547,22300428,"DEC 28, 2023",CHA @ LAL,L,6,2,3,0.667,1,1,1.0,0,0,0.0,0,2,2,1,0,0,0,0,5,6,1,CHA,LAL,CHA,110,,,8,7,6,3
Chris Duarte,G,22023,1630537,22300714,"FEB 05, 2024",SAC @ CLE,L,3,1,2,0.5,1,2,0.5,2,2,1.0,1,0,1,0,0,0,0,0,5,-2,1,SAC,CLE,SAC,110,,,6,6,5,1
Chris Duarte,G,22023,1630537,22300632,"JAN 25, 2024",SAC @ GSW,W,3,0,0,0.0,0,0,0.0,0,0,0.0,0,0,0,0,0,0,0,0,0,-4,1,SAC,GSW,SAC,134,,,0,0,0,0
Chris Duarte,G,22023,1630537,22300532,"JAN 12, 2024",SAC @ PHI,L,10,0,2,0.0,0,1,0.0,1,2,0.5,1,2,3,0,0,0,1,1,1,-9,1,SAC,PHI,SAC,90,,,4,4,1,3
Chris Duarte,G,22023,1630537,22300518,"JAN 10, 2024",SAC @ CHA,W,14,0,2,0.0,0,0,0.0,0,0,0.0,1,1,2,2,0,0,0,2,0,5,1,SAC,CHA,SAC,121,,,4,2,2,4
Chris Duarte,G,22023,1630537,22300500,"JAN 07, 2024",SAC vs. NOP,L,15,0,3,0.0,0,2,0.0,1,2,0.5,0,0,0,1,0,0,0,0,1,-19,1,SAC,SAC,NOP,100,,,2,1,2,1
Chris Duarte,G,22023,1630537,22300492,"JAN 05, 2024",SAC vs. TOR,W,16,4,6,0.667,2,3,0.667,0,0,0.0,0,0,0,1,0,0,1,2,10,2,1,SAC,SAC,TOR,135,,,11,10,11,1
Chris Duarte,G,22023,1630537,22300476,"JAN 03, 2024",SAC vs. ORL,W,10,0,3,0.0,0,1,0.0,0,0,0.0,0,0,0,1,1,0,2,3,0,-6,1,SAC,SAC,ORL,138,,,1,0,1,1
Chris Duarte,G,22023,1630537,22300464,"JAN 02, 2024",SAC vs. CHA,L,30,5,11,0.455,2,4,0.5,0,0,0.0,4,3,7,4,1,0,1,1,12,3,1,SAC,SAC,CHA,104,,,23,19,16,11
Chris Duarte,G,22023,1630537,22300449,"DEC 31, 2023",SAC @ MEM,W,26,2,6,0.333,1,2,0.5,2,2,1.0,1,5,6,0,0,0,1,2,7,11,1,SAC,MEM,SAC,123,,,13,13,7,6
Chris Duarte,G,22023,1630537,22300431,"DEC 29, 2023",SAC @ ATL,W,25,2,5,0.4,1,3,0.333,0,0,0.0,0,0,0,4,1,0,1,1,5,10,1,SAC,ATL,SAC,117,,,9,5,9,4
Chris Duarte,G,22023,1630537,22300413,"DEC 26, 2023",SAC @ POR,L,8,2,2,1.0,0,0,0.0,0,0,0.0,0,3,3,1,1,0,0,0,4,-6,1,SAC,POR,SAC,113,,,8,7,5,4
Chris Duarte,G,22023,1630537,22300400,"DEC 23, 2023",SAC vs. MIN,L,18,1,3,0.333,1,3,0.333,0,0,0.0,1,3,4,0,2,0,1,1,3,4,1,SAC,SAC,MIN,98,,,7,7,3,4
Chris Duarte,G,22023,1630537,22300387,"DEC 22, 2023",SAC vs. PHX,W,2,0,2,0.0,0,1,0.0,0,0,0.0,1,0,1,0,0,0,0,0,0,-6,1,SAC,SAC,PHX,120,,,1,1,0,1
Chris Duarte,G,22023,1630537,22300373,"DEC 20, 2023",SAC vs. BOS,L,5,0,2,0.0,0,1,0.0,0,0,0.0,0,1,1,0,0,0,0,0,0,-4,1,SAC,SAC,BOS,119,,,1,1,0,1
Chris Duarte,G,22023,1630537,22300358,"DEC 18, 2023",SAC vs. WAS,W,4,0,1,0.0,0,1,0.0,0,0,0.0,0,0,0,0,0,0,0,0,0,-7,1,SAC,SAC,WAS,141,,,0,0,0,0
Chris Duarte,G,22023,1630537,22300342,"DEC 16, 2023",SAC vs. UTA,W,4,0,2,0.0,0,0,0.0,0,0,0.0,0,1,1,0,0,0,1,0,0,3,1,SAC,SAC,UTA,125,,,1,1,0,1
Chris Duarte,G,22023,1630537,22300309,"DEC 12, 2023",SAC @ LAC,L,12,1,3,0.333,0,2,0.0,4,4,1.0,0,2,2,1,0,1,0,1,6,9,1,SAC,LAC,SAC,99,,,9,8,7,3
Chris Duarte,G,22023,1630537,22300303,"DEC 11, 2023",SAC vs. BKN,W,3,0,1,0.0,0,1,0.0,0,0,0.0,0,0,0,1,0,0,0,0,0,-7,1,SAC,SAC,BKN,131,,,1,0,1,1
Chris Duarte,G,22023,1630537,22301228,"DEC 08, 2023",SAC @ PHX,W,1,0,0,0.0,0,0,0.0,0,0,0.0,0,0,0,0,0,0,0,0,0,-4,1,SAC,PHX,SAC,114,,,0,0,0,0
Chris Duarte,G,22023,1630537,22300264,"NOV 29, 2023",SAC vs. LAC,L,13,3,6,0.5,0,2,0.0,1,1,1.0,1,2,3,0,0,0,0,2,7,-8,1,SAC,SAC,LAC,117,,,10,10,7,3
Chris Duarte,G,22023,1630537,22300060,"NOV 28, 2023",SAC vs. GSW,W,14,2,4,0.5,0,1,0.0,1,2,0.5,0,0,0,0,2,0,0,2,5,-10,1,SAC,SAC,GSW,124,,,5,5,5,0
Chris Duarte,G,22023,1630537,22300050,"NOV 24, 2023",SAC @ MIN,W,22,0,3,0.0,0,2,0.0,0,0,0.0,2,3,5,0,1,0,2,3,0,2,1,SAC,MIN,SAC,124,,,5,5,0,5
Chris Duarte,G,22023,1630537,22300233,"NOV 22, 2023",SAC @ NOP,L,20,2,3,0.667,2,3,0.667,0,0,0.0,0,1,1,2,0,0,1,5,6,22,1,SAC,NOP,SAC,112,,,9,7,8,3
Chris Duarte,G,22023,1630537,22300222,"NOV 20, 2023",SAC @ NOP,L,8,0,2,0.0,0,2,0.0,0,0,0.0,0,2,2,0,0,0,0,1,0,-3,1,SAC,NOP,SAC,93,,,2,2,0,2
Chris Duarte,G,22023,1630537,22300212,"NOV 19, 2023",SAC @ DAL,W,33,5,8,0.625,3,4,0.75,0,0,0.0,0,8,8,4,2,0,1,3,13,7,1,SAC,DAL,SAC,129,,,25,21,17,12
Chris Duarte,G,22023,1630537,22300032,"NOV 17, 2023",SAC @ SAS,W,15,2,4,0.5,2,3,0.667,0,0,0.0,0,3,3,0,2,0,2,2,6,-8,1,SAC,SAS,SAC,129,,,9,9,6,3
Chris Duarte,G,22023,1630537,22300198,"NOV 15, 2023",SAC @ LAL,W,4,2,2,1.0,0,0,0.0,0,0,0.0,0,0,0,1,0,0,0,1,4,3,1,SAC,LAL,SAC,125,,,5,4,5,1
Chris Duarte,G,22023,1630537,22300191,"NOV 13, 2023",SAC vs. CLE,W,9,1,3,0.333,0,2,0.0,0,0,0.0,0,0,0,0,0,0,1,4,2,-2,1,SAC,SAC,CLE,132,,,2,2,2,0
Chris Duarte,G,22023,1630537,22300016,"NOV 10, 2023",SAC vs. OKC,W,5,0,2,0.0,0,2,0.0,0,0,0.0,0,1,1,0,1,0,1,2,0,-1,1,SAC,SAC,OKC,105,,,1,1,0,1
Chris Duarte,G,22023,1630537,22300170,"NOV 08, 2023",SAC vs. POR,W,11,1,4,0.25,1,3,0.333,0,0,0.0,0,2,2,0,1,0,0,2,3,-8,1,SAC,SAC,POR,121,,,5,5,3,2
Chris Duarte,G,22023,1630537,22300153,"NOV 06, 2023",SAC @ HOU,L,15,1,3,0.333,1,1,1.0,2,4,0.5,0,1,1,2,0,0,1,1,5,-8,1,SAC,HOU,SAC,97,,,8,6,7,3
Chris Duarte,G,22023,1630537,22300137,"NOV 04, 2023",SAC @ HOU,L,26,3,8,0.375,2,6,0.333,2,2,1.0,0,2,2,1,1,1,0,4,10,-4,1,SAC,HOU,SAC,89,,,13,12,11,3
Chris Duarte,G,22023,1630537,22300126,"NOV 01, 2023",SAC @ GSW,L,7,0,3,0.0,0,1,0.0,2,2,1.0,0,1,1,2,0,0,1,3,2,-1,1,SAC,GSW,SAC,101,,,5,3,4,3
Chris Duarte,G,22023,1630537,22300100,"OCT 29, 2023",SAC vs. LAL,W,14,2,4,0.5,0,2,0.0,0,0,0.0,0,2,2,0,1,0,0,3,4,1,1,SAC,SAC,LAL,132,,,6,6,4,2
Chris Duarte,G,22023,1630537,22300087,"OCT 27, 2023",SAC vs. GSW,L,26,1,7,0.143,0,4,0.0,2,3,0.667,0,1,1,3,1,0,1,6,4,0,1,SAC,SAC,GSW,114,,,8,5,7,4
Chris Duarte,G,22023,1630537,22300072,"OCT 25, 2023",SAC @ UTA,W,15,3,5,0.6,3,4,0.75,0,0,0.0,1,1,2,1,0,0,0,3,9,5,1,SAC,UTA,SAC,130,,,12,11,10,3
Jacob Gilyard,G,22023,1631367,22300751,"FEB 10, 2024",MEM @ CHA,L,21,2,6,0.333,2,6,0.333,0,0,0.0,0,3,3,4,1,0,1,0,6,-2,1,MEM,CHA,MEM,105,,,13,9,10,7
Jacob Gilyard,G,22023,1631367,22300737,"FEB 08, 2024",MEM vs. CHI,L,20,3,7,0.429,2,6,0.333,0,0,0.0,0,0,0,4,1,0,1,1,8,-4,1,MEM,MEM,CHI,95,,,12,8,12,4
Jacob Gilyard,G,22023,1631367,22300722,"FEB 06, 2024",MEM @ NYK,L,24,4,6,0.667,4,6,0.667,0,0,0.0,0,3,3,4,0,1,4,2,12,-10,1,MEM,NYK,MEM,97,,,19,15,16,7
Jacob Gilyard,G,22023,1631367,22300693,"FEB 02, 2024",MEM vs. GSW,L,32,5,9,0.556,5,9,0.556,1,1,1.0,1,1,2,5,2,1,1,2,16,-13,1,MEM,MEM,GSW,98,,,23,18,21,7
Jacob Gilyard,G,22023,1631367,22300687,"FEB 01, 2024",MEM vs. CLE,L,23,2,4,0.5,2,4,0.5,0,0,0.0,0,1,1,6,1,0,0,1,6,1,1,MEM,MEM,CLE,86,,,13,7,12,7
Jacob Gilyard,G,22023,1631367,22300663,"JAN 29, 2024",MEM vs. SAC,L,16,1,3,0.333,1,2,0.5,0,0,0.0,0,2,2,5,1,0,0,1,3,4,1,MEM,MEM,SAC,72,,,10,5,8,7
Jacob Gilyard,G,22023,1631367,22300652,"JAN 28, 2024",MEM @ IND,L,5,1,1,1.0,1,1,1.0,0,0,0.0,0,0,0,0,0,0,1,1,3,-11,1,MEM,IND,MEM,106,,,3,3,3,0
Jacob Gilyard,G,22023,1631367,22300638,"JAN 26, 2024",MEM vs. ORL,W,13,0,3,0.0,0,3,0.0,0,0,0.0,0,1,1,2,1,0,0,0,0,-3,1,MEM,MEM,ORL,107,,,3,1,2,3
Jacob Gilyard,G,22023,1631367,22300609,"JAN 22, 2024",MEM @ TOR,W,13,2,3,0.667,1,2,0.5,0,0,0.0,0,1,1,2,0,0,0,0,5,3,1,MEM,TOR,MEM,108,,,8,6,7,3
Jacob Gilyard,G,22023,1631367,22300597,"JAN 20, 2024",MEM @ CHI,L,16,1,3,0.333,1,3,0.333,0,0,0.0,0,1,1,1,1,0,1,0,3,-13,1,MEM,CHI,MEM,93,,,5,4,4,2
Jacob Gilyard,G,22023,1631367,22300582,"JAN 18, 2024",MEM @ MIN,L,13,0,3,0.0,0,2,0.0,0,0,0.0,0,1,1,3,0,0,0,0,0,-7,1,MEM,MIN,MEM,103,,,4,1,3,4
Jacob Gilyard,G,22023,1631367,22300560,"JAN 15, 2024",MEM vs. GSW,W,19,4,7,0.571,3,4,0.75,0,0,0.0,0,2,2,3,2,1,0,0,11,11,1,MEM,MEM,GSW,116,,,16,13,14,5
Jacob Gilyard,G,22023,1631367,22300355,"DEC 18, 2023",MEM @ OKC,L,34,4,9,0.444,4,6,0.667,0,0,0.0,0,1,1,7,1,0,3,2,12,-3,1,MEM,OKC,MEM,97,,,20,13,19,8
Jacob Gilyard,G,22023,1631367,22300332,"DEC 15, 2023",MEM vs. HOU,L,16,0,3,0.0,0,2,0.0,0,0,0.0,0,1,1,3,1,0,2,1,0,-4,1,MEM,MEM,HOU,96,,,4,1,3,4
Jacob Gilyard,G,22023,1631367,22300314,"DEC 13, 2023",MEM @ HOU,L,13,1,1,1.0,1,1,1.0,0,0,0.0,0,0,0,3,0,0,0,0,3,1,1,MEM,HOU,MEM,104,,,6,3,6,3
Jacob Gilyard,G,22023,1631367,22301221,"DEC 08, 2023",MEM vs. MIN,L,4,0,1,0.0,0,1,0.0,0,0,0.0,0,0,0,2,0,0,0,0,0,0,1,MEM,MEM,MIN,95,,,2,0,2,2
Jacob Gilyard,G,22023,1631367,22301206,"DEC 06, 2023",MEM @ DET,W,0,0,0,0.0,0,0,0.0,0,0,0.0,0,0,0,0,0,0,0,0,0,0,1,MEM,DET,MEM,104,,,0,0,0,0
Jacob Gilyard,G,22023,1631367,22300277,"DEC 01, 2023",MEM @ DAL,W,2,0,0,0.0,0,0,0.0,0,0,0.0,0,0,0,0,0,0,0,0,0,-4,1,MEM,DAL,MEM,89,,,0,0,0,0
Jacob Gilyard,G,22023,1631367,22300249,"NOV 26, 2023",MEM vs. MIN,L,16,0,2,0.0,0,2,0.0,0,0,0.0,0,0,0,1,0,0,0,0,0,-21,1,MEM,MEM,MIN,91,,,1,0,1,1
Jacob Gilyard,G,22023,1631367,22300044,"NOV 24, 2023",MEM vs. PHX,L,24,2,5,0.4,1,4,0.25,1,1,1.0,0,0,0,5,0,0,2,2,6,-2,1,MEM,MEM,PHX,89,,,11,6,11,5
Jacob Gilyard,G,22023,1631367,22300231,"NOV 22, 2023",MEM @ HOU,L,24,2,6,0.333,1,4,0.25,0,0,0.0,1,0,1,4,0,0,0,1,5,-14,1,MEM,HOU,MEM,91,,,10,6,9,5
Jacob Gilyard,G,22023,1631367,22300213,"NOV 19, 2023",MEM vs. BOS,L,15,1,2,0.5,1,2,0.5,0,0,0.0,1,1,2,5,2,0,1,1,3,-2,1,MEM,MEM,BOS,100,,,10,5,8,7
Jacob Gilyard,G,22023,1631367,22300206,"NOV 18, 2023",MEM @ SAS,W,12,1,2,0.5,1,2,0.5,0,0,0.0,0,0,0,1,0,0,0,3,3,-14,1,MEM,SAS,MEM,120,,,4,3,4,1
Jacob Gilyard,G,22023,1631367,22300026,"NOV 14, 2023",MEM @ LAL,L,21,3,5,0.6,3,5,0.6,0,0,0.0,1,2,3,1,2,0,1,2,9,-13,1,MEM,LAL,MEM,107,,,13,12,10,4
Jacob Gilyard,G,22023,1631367,22300179,"NOV 12, 2023",MEM @ LAC,W,24,2,6,0.333,2,6,0.333,0,0,0.0,1,4,5,3,3,0,0,3,6,3,1,MEM,LAC,MEM,105,,,14,11,9,8
Jacob Gilyard,G,22023,1631367,22300012,"NOV 10, 2023",MEM vs. UTA,L,34,5,10,0.5,4,9,0.444,0,0,0.0,2,2,4,8,1,0,2,2,14,-12,1,MEM,MEM,UTA,121,,,26,18,22,12
Jacob Gilyard,G,22023,1631367,22300164,"NOV 08, 2023",MEM vs. MIA,L,15,2,3,0.667,2,3,0.667,0,0,0.0,0,0,0,4,0,0,0,1,6,10,1,MEM,MEM,MIA,102,,,10,6,10,4
Jacob Gilyard,G,22023,1631367,22300144,"NOV 05, 2023",MEM @ POR,W,11,0,0,0.0,0,0,0.0,0,0,0.0,0,0,0,2,0,1,1,1,0,-5,1,MEM,POR,MEM,112,,,2,0,2,2
Jacob Gilyard,G,22023,1631367,22300537,"JAN 12, 2024",MEM vs. LAC,L,20,0,2,0.0,0,2,0.0,0,0,0.0,0,1,1,8,0,0,1,1,0,0,1,MEM,MEM,LAC,119,,,9,1,8,9
Jacob Gilyard,G,22023,1631367,22300425,"DEC 28, 2023",MEM @ DEN,L,12,2,3,0.667,2,3,0.667,0,0,0.0,0,0,0,1,0,1,0,0,6,-14,1,MEM,DEN,MEM,105,,,7,6,7,1
Jacob Gilyard,G,22023,1631367,22300007,"NOV 03, 2023",MEM @ POR,L,12,0,0,0.0,0,0,0.0,0,0,0.0,0,0,0,3,0,0,1,0,0,17,1,MEM,POR,MEM,113,,,3,0,3,3
Jacob Gilyard,G,22023,1631367,22300125,"NOV 01, 2023",MEM @ UTA,L,20,1,2,0.5,1,2,0.5,0,0,0.0,0,3,3,6,1,0,0,0,3,4,1,MEM,UTA,MEM,109,,,12,6,9,9
Jacob Gilyard,G,22023,1631367,22300106,"OCT 30, 2023",MEM vs. DAL,L,1,0,1,0.0,0,0,0.0,0,0,0.0,0,0,0,0,0,0,0,0,0,0,1,MEM,MEM,DAL,110,,,0,0,0,0
Jacob Gilyard,G,22023,1631367,22300706,"FEB 04, 2024",MEM @ BOS,L,36,5,10,0.5,3,7,0.429,0,0,0.0,0,2,2,6,2,0,3,2,13,-31,1,MEM,BOS,MEM,56,,,21,15,19,8
Jacob Gilyard,G,22023,1631367,22300621,"JAN 24, 2024",MEM @ MIA,W,24,2,5,0.4,2,4,0.5,0,0,0.0,0,0,0,7,1,0,2,1,6,-3,1,MEM,MIA,MEM,90,,,13,6,13,7
Jacob Gilyard,G,22023,1631367,22300544,"JAN 13, 2024",MEM vs. NYK,L,32,2,8,0.25,1,6,0.167,0,0,0.0,1,1,2,7,2,0,0,4,5,-12,1,MEM,MEM,NYK,94,,,14,7,12,9
Justin Holiday,F-G,22023,203200,22300746,"FEB 09, 2024",DEN @ SAC,L,37,3,10,0.3,3,9,0.333,1,2,0.5,0,3,3,2,2,0,1,1,10,-15,1,DEN,SAC,DEN,106,,,15,13,12,5
Justin Holiday,F-G,22023,203200,22300740,"FEB 08, 2024",DEN @ LAL,W,22,1,1,1.0,0,0,0.0,0,0,0.0,1,0,1,1,0,0,0,6,2,11,1,DEN,LAL,DEN,114,,,4,3,3,2
Justin Holiday,F-G,22023,203200,22300697,"FEB 02, 2024",DEN vs. POR,W,12,0,2,0.0,0,1,0.0,0,0,0.0,0,0,0,1,1,0,0,0,0,1,1,DEN,DEN,POR,120,,,1,0,1,1
Justin Holiday,F-G,22023,203200,22300682,"JAN 31, 2024",DEN @ OKC,L,11,2,3,0.667,1,2,0.5,0,0,0.0,0,1,1,0,1,1,0,3,5,-7,1,DEN,OKC,DEN,100,,,6,6,5,1
Justin Holiday,F-G,22023,203200,22300631,"JAN 25, 2024",DEN @ NYK,L,12,2,4,0.5,0,2,0.0,0,0,0.0,0,1,1,0,1,0,0,2,4,-6,1,DEN,NYK,DEN,84,,,5,5,4,1
Justin Holiday,F-G,22023,203200,22300586,"JAN 19, 2024",DEN @ BOS,W,3,0,0,0.0,0,0,0.0,0,0,0.0,0,0,0,0,0,0,0,0,0,-1,1,DEN,BOS,DEN,102,,,0,0,0,0
Justin Holiday,F-G,22023,203200,22300550,"JAN 14, 2024",DEN vs. IND,W,0,0,0,0.0,0,0,0.0,0,0,0.0,0,0,0,0,0,0,0,0,0,0,1,DEN,DEN,IND,117,,,0,0,0,0
Justin Holiday,F-G,22023,203200,22300539,"JAN 12, 2024",DEN vs. NOP,W,2,0,0,0.0,0,0,0.0,0,0,0.0,0,0,0,0,0,0,1,0,0,-6,1,DEN,DEN,NOP,125,,,0,0,0,0
Justin Holiday,F-G,22023,203200,22300524,"JAN 10, 2024",DEN @ UTA,L,12,1,3,0.333,1,3,0.333,0,0,0.0,0,0,0,1,1,0,0,2,3,11,1,DEN,UTA,DEN,111,,,4,3,4,1
Justin Holiday,F-G,22023,203200,22300502,"JAN 07, 2024",DEN vs. DET,W,4,0,0,0.0,0,0,0.0,0,0,0.0,0,0,0,0,0,0,0,0,0,-3,1,DEN,DEN,DET,131,,,0,0,0,0
Justin Holiday,F-G,22023,203200,22300488,"JAN 05, 2024",DEN vs. ORL,L,10,0,1,0.0,0,1,0.0,0,0,0.0,0,1,1,1,0,0,0,1,0,4,1,DEN,DEN,ORL,120,,,2,1,1,2
Justin Holiday,F-G,22023,203200,22300435,"DEC 29, 2023",DEN vs. OKC,L,16,0,3,0.0,0,2,0.0,0,0,0.0,0,1,1,2,0,0,0,1,0,-19,1,DEN,DEN,OKC,93,,,3,1,2,3
Justin Holiday,F-G,22023,203200,22300425,"DEC 28, 2023",DEN vs. MEM,W,18,3,5,0.6,2,3,0.667,0,0,0.0,0,2,2,1,2,0,0,2,8,1,1,DEN,DEN,MEM,142,,,11,10,9,3
Justin Holiday,F-G,22023,203200,22300356,"DEC 18, 2023",DEN vs. DAL,W,5,0,2,0.0,0,0,0.0,0,0,0.0,0,1,1,0,0,1,0,1,0,-6,1,DEN,DEN,DAL,130,,,1,1,0,1
Justin Holiday,F-G,22023,203200,22300340,"DEC 16, 2023",DEN vs. OKC,L,25,2,4,0.5,2,3,0.667,0,0,0.0,0,1,1,2,0,0,1,0,6,-8,1,DEN,DEN,OKC,117,,,9,7,8,3
Justin Holiday,F-G,22023,203200,22300322,"DEC 14, 2023",DEN vs. BKN,W,27,1,6,0.167,0,5,0.0,0,0,0.0,0,1,1,2,4,0,1,2,2,20,1,DEN,DEN,BKN,124,,,5,3,4,3
Justin Holiday,F-G,22023,203200,22300307,"DEC 12, 2023",DEN @ CHI,W,23,3,4,0.75,2,3,0.667,0,0,0.0,1,0,1,2,0,0,0,3,8,4,1,DEN,CHI,DEN,114,,,11,9,10,3
Justin Holiday,F-G,22023,203200,22301224,"DEC 08, 2023",DEN vs. HOU,L,6,1,1,1.0,0,0,0.0,0,0,0.0,0,0,0,0,1,0,0,1,2,-12,1,DEN,DEN,HOU,106,,,2,2,2,0
Justin Holiday,F-G,22023,203200,22300290,"DEC 02, 2023",DEN @ SAC,L,12,0,1,0.0,0,0,0.0,0,0,0.0,0,3,3,0,0,0,0,2,0,-3,1,DEN,SAC,DEN,117,,,3,3,0,3
Justin Holiday,F-G,22023,203200,22300279,"DEC 01, 2023",DEN @ PHX,W,25,6,8,0.75,3,5,0.6,0,0,0.0,1,1,2,4,1,0,0,2,15,8,1,DEN,PHX,DEN,119,,,21,17,19,6
Justin Holiday,F-G,22023,203200,22300263,"NOV 29, 2023",DEN vs. HOU,W,27,4,7,0.571,3,5,0.6,0,0,0.0,1,2,3,4,2,0,0,2,11,27,1,DEN,DEN,HOU,134,,,18,14,15,7
Justin Holiday,F-G,22023,203200,22300257,"NOV 27, 2023",DEN @ LAC,W,34,5,8,0.625,2,4,0.5,0,0,0.0,1,5,6,1,1,0,3,2,12,5,1,DEN,LAC,DEN,113,,,19,18,13,7
Justin Holiday,F-G,22023,203200,22300252,"NOV 26, 2023",DEN vs. SAS,W,27,2,5,0.4,1,4,0.25,0,0,0.0,0,2,2,3,1,0,0,2,5,15,1,DEN,DEN,SAS,132,,,10,7,8,5
Justin Holiday,F-G,22023,203200,22300048,"NOV 24, 2023",DEN @ HOU,L,13,1,2,0.5,1,2,0.5,0,0,0.0,0,0,0,0,1,0,0,2,3,9,1,DEN,HOU,DEN,86,,,3,3,3,0
Justin Holiday,F-G,22023,203200,22300226,"NOV 22, 2023",DEN @ ORL,L,0,0,0,0.0,0,0,0.0,0,0,0.0,0,0,0,0,0,0,0,0,0,0,1,DEN,ORL,DEN,119,,,0,0,0,0
Justin Holiday,F-G,22023,203200,22300210,"NOV 19, 2023",DEN @ CLE,L,17,2,3,0.667,2,3,0.667,0,0,0.0,0,1,1,1,0,0,0,2,6,1,1,DEN,CLE,DEN,109,,,8,7,7,2
Justin Holiday,F-G,22023,203200,22300024,"NOV 14, 2023",DEN vs. LAC,W,2,0,0,0.0,0,0,0.0,0,0,0.0,0,0,0,1,0,0,0,0,0,-1,1,DEN,DEN,LAC,111,,,1,0,1,1
Justin Holiday,F-G,22023,203200,22300169,"NOV 08, 2023",DEN vs. GSW,W,8,1,2,0.5,1,2,0.5,0,0,0.0,0,3,3,0,0,0,0,1,3,2,1,DEN,DEN,GSW,108,,,6,6,3,3
Justin Holiday,F-G,22023,203200,22300123,"NOV 01, 2023",DEN @ MIN,L,6,1,2,0.5,1,2,0.5,0,0,0.0,0,1,1,0,0,0,0,0,3,2,1,DEN,MIN,DEN,89,,,4,4,3,1
Justin Holiday,F-G,22023,203200,22300095,"OCT 29, 2023",DEN @ OKC,W,3,0,0,0.0,0,0,0.0,0,0,0.0,0,0,0,0,0,0,0,0,0,0,1,DEN,OKC,DEN,128,,,0,0,0,0
Maxi Kleber,C,22023,1628467,22300680,"JAN 31, 2024",DAL @ MIN,L,18,1,2,0.5,1,1,1.0,0,0,0.0,0,2,2,0,0,1,2,5,3,-11,1,DAL,MIN,DAL,82,,,5,5,3,2
Maxi Kleber,C,22023,1628467,22300666,"JAN 29, 2024",DAL vs. ORL,W,22,0,1,0.0,0,0,0.0,1,2,0.5,0,1,1,1,0,0,1,1,1,3,1,DAL,DAL,ORL,131,,,3,2,2,2
Maxi Kleber,C,22023,1628467,22300651,"JAN 27, 2024",DAL vs. SAC,L,13,2,6,0.333,1,3,0.333,0,0,0.0,1,1,2,0,0,0,0,0,5,-17,1,DAL,DAL,SAC,115,,,7,7,5,2
Maxi Kleber,C,22023,1628467,22300577,"JAN 17, 2024",DAL @ LAL,L,21,2,3,0.667,2,3,0.667,0,0,0.0,1,0,1,3,0,2,1,5,6,-17,1,DAL,LAL,DAL,105,,,10,7,9,4
Maxi Kleber,C,22023,1628467,22300556,"JAN 15, 2024",DAL vs. NOP,W,19,1,3,0.333,0,2,0.0,2,2,1.0,0,5,5,1,0,2,1,5,4,-12,1,DAL,DAL,NOP,125,,,10,9,5,6
Maxi Kleber,C,22023,1628467,22300547,"JAN 13, 2024",DAL vs. NOP,L,11,1,3,0.333,0,2,0.0,0,0,0.0,1,1,2,1,1,0,1,0,2,5,1,DAL,DAL,NOP,108,,,5,4,3,3
Maxi Kleber,C,22023,1628467,22300124,"NOV 01, 2023",DAL vs. CHI,W,4,0,2,0.0,0,1,0.0,0,0,0.0,0,2,2,0,0,0,0,0,0,-1,1,DAL,DAL,CHI,114,,,2,2,0,2
Maxi Kleber,C,22023,1628467,22300106,"OCT 30, 2023",DAL @ MEM,W,22,2,4,0.5,1,3,0.333,2,2,1.0,1,4,5,2,1,0,2,2,7,7,1,DAL,MEM,DAL,125,,,14,12,9,7
Maxi Kleber,C,22023,1628467,22300084,"OCT 27, 2023",DAL vs. BKN,W,26,0,3,0.0,0,0,0.0,0,0,0.0,1,4,5,2,0,0,0,1,0,10,1,DAL,DAL,BKN,125,,,7,5,2,7
Maxi Kleber,C,22023,1628467,22300073,"OCT 25, 2023",DAL @ SAS,W,23,2,7,0.286,2,5,0.4,0,0,0.0,2,5,7,2,0,1,0,3,6,-12,1,DAL,SAS,DAL,126,,,15,13,8,9
Maxi Kleber,C,22023,1628467,22300748,"FEB 10, 2024",DAL vs. OKC,W,25,3,6,0.5,2,4,0.5,4,4,1.0,3,9,12,3,1,1,0,1,12,26,1,DAL,DAL,OKC,146,,,27,24,15,15
Maxi Kleber,C,22023,1628467,22300736,"FEB 08, 2024",DAL @ NYK,W,27,1,2,0.5,0,1,0.0,0,2,0.0,1,3,4,3,1,4,1,1,2,13,1,DAL,NYK,DAL,121,,,9,6,5,7
Maxi Kleber,C,22023,1628467,22300720,"FEB 06, 2024",DAL @ BKN,W,30,3,7,0.429,1,5,0.2,0,0,0.0,0,2,2,3,1,0,1,3,7,10,1,DAL,BKN,DAL,119,,,12,9,10,5
Maxi Kleber,C,22023,1628467,22300715,"FEB 05, 2024",DAL @ PHI,W,28,6,8,0.75,2,4,0.5,0,0,0.0,2,2,4,5,0,1,1,0,14,12,1,DAL,PHI,DAL,118,,,23,18,19,9
Maxi Kleber,C,22023,1628467,22300702,"FEB 03, 2024",DAL vs. MIL,L,34,8,11,0.727,4,7,0.571,1,1,1.0,0,3,3,2,2,0,2,5,21,-14,1,DAL,DAL,MIL,117,,,26,24,23,5
Maxi Kleber,C,22023,1628467,22300625,"JAN 24, 2024",DAL vs. PHX,L,22,1,2,0.5,0,1,0.0,0,0,0.0,2,1,3,3,0,0,1,3,2,2,1,DAL,DAL,PHX,107,,,8,5,5,6
Maxi Kleber,C,22023,1628467,22300611,"JAN 22, 2024",DAL vs. BOS,L,26,3,7,0.429,0,3,0.0,1,1,1.0,0,2,2,0,0,2,1,2,7,-1,1,DAL,DAL,BOS,110,,,9,9,7,2
Maxi Kleber,C,22023,1628467,22300168,"NOV 08, 2023",DAL vs. TOR,L,15,0,0,0.0,0,0,0.0,4,8,0.5,0,2,2,4,0,0,2,2,4,-7,1,DAL,DAL,TOR,116,,,10,6,8,6
Yuta Watanabe,G-F,22023,1629139,22300725,"FEB 06, 2024",PHX vs. MIL,W,0,0,0,0.0,0,0,0.0,0,0,0.0,0,0,0,0,0,0,0,0,0,-3,1,PHX,PHX,MIL,114,,,0,0,0,0
Yuta Watanabe,G-F,22023,1629139,22300705,"FEB 04, 2024",PHX @ WAS,W,8,3,4,0.75,1,2,0.5,0,0,0.0,0,0,0,0,2,0,1,0,7,-1,1,PHX,WAS,PHX,140,,,7,7,7,0
Yuta Watanabe,G-F,22023,1629139,22300625,"JAN 24, 2024",PHX @ DAL,W,7,1,1,1.0,0,0,0.0,0,0,0.0,0,2,2,0,0,0,0,1,2,-5,1,PHX,DAL,PHX,132,,,4,4,2,2
Yuta Watanabe,G-F,22023,1629139,22300531,"JAN 11, 2024",PHX @ LAL,W,5,0,0,0.0,0,0,0.0,0,0,0.0,0,1,1,0,0,0,1,1,0,-7,1,PHX,LAL,PHX,127,,,1,1,0,1
Yuta Watanabe,G-F,22023,1629139,22300511,"JAN 08, 2024",PHX @ LAC,L,5,0,2,0.0,0,2,0.0,1,2,0.5,0,0,0,0,0,0,0,1,1,-3,1,PHX,LAC,PHX,111,,,1,1,1,0
Yuta Watanabe,G-F,22023,1629139,22300489,"JAN 05, 2024",PHX vs. MIA,W,9,1,3,0.333,0,1,0.0,0,0,0.0,1,0,1,0,0,0,0,0,2,-7,1,PHX,PHX,MIA,113,,,3,3,2,1
Yuta Watanabe,G-F,22023,1629139,22300456,"JAN 01, 2024",PHX vs. POR,W,6,1,2,0.5,0,1,0.0,0,0,0.0,0,0,0,0,0,0,0,0,2,-5,1,PHX,PHX,POR,109,,,2,2,2,0
Yuta Watanabe,G-F,22023,1629139,22300418,"DEC 27, 2023",PHX @ HOU,W,2,0,1,0.0,0,0,0.0,0,0,0.0,0,0,0,0,0,0,0,0,0,-2,1,PHX,HOU,PHX,129,,,0,0,0,0
Yuta Watanabe,G-F,22023,1629139,22300387,"DEC 22, 2023",PHX @ SAC,L,12,1,4,0.25,0,3,0.0,0,0,0.0,0,2,2,0,0,0,0,2,2,5,1,PHX,SAC,PHX,105,,,4,4,2,2
Yuta Watanabe,G-F,22023,1629139,22300333,"DEC 15, 2023",PHX vs. NYK,L,8,0,0,0.0,0,0,0.0,0,0,0.0,0,0,0,0,0,0,0,0,0,0,1,PHX,PHX,NYK,122,,,0,0,0,0
Yuta Watanabe,G-F,22023,1629139,22300288,"DEC 02, 2023",PHX vs. MEM,W,15,1,2,0.5,1,2,0.5,1,2,0.5,1,1,2,0,1,0,2,3,4,3,1,PHX,PHX,MEM,116,,,6,6,4,2
Yuta Watanabe,G-F,22023,1629139,22300035,"NOV 17, 2023",PHX @ UTA,W,10,1,3,0.333,1,2,0.5,0,0,0.0,1,1,2,0,0,0,0,1,3,2,1,PHX,UTA,PHX,131,,,5,5,3,2
Yuta Watanabe,G-F,22023,1629139,22300197,"NOV 15, 2023",PHX vs. MIN,W,23,1,6,0.167,1,4,0.25,0,0,0.0,0,2,2,3,0,1,0,1,3,-1,1,PHX,PHX,MIN,133,,,8,5,6,5
Yuta Watanabe,G-F,22023,1629139,22300185,"NOV 12, 2023",PHX vs. OKC,L,17,2,2,1.0,2,2,1.0,0,0,0.0,0,0,0,2,0,0,0,1,6,10,1,PHX,PHX,OKC,99,,,8,6,8,2
Yuta Watanabe,G-F,22023,1629139,22300015,"NOV 10, 2023",PHX vs. LAL,L,14,1,4,0.25,1,3,0.333,0,0,0.0,1,0,1,0,0,0,0,5,3,6,1,PHX,PHX,LAL,119,,,4,4,3,1
Yuta Watanabe,G-F,22023,1629139,22300162,"NOV 08, 2023",PHX @ CHI,W,18,2,5,0.4,2,5,0.4,0,0,0.0,0,5,5,0,0,1,3,2,6,-11,1,PHX,CHI,PHX,116,,,11,11,6,5
Yuta Watanabe,G-F,22023,1629139,22300140,"NOV 05, 2023",PHX @ DET,W,20,2,4,0.5,1,3,0.333,1,1,1.0,0,1,1,0,0,0,2,1,6,13,1,PHX,DET,PHX,120,,,7,7,6,1
Yuta Watanabe,G-F,22023,1629139,22300132,"NOV 04, 2023",PHX @ PHI,L,22,1,4,0.25,1,4,0.25,2,2,1.0,3,2,5,0,1,0,1,2,5,-13,1,PHX,PHI,PHX,100,,,10,10,5,5
Yuta Watanabe,G-F,22023,1629139,22300131,"NOV 02, 2023",PHX vs. SAS,L,26,1,5,0.2,0,4,0.0,1,2,0.5,0,4,4,1,0,0,0,1,3,0,1,PHX,PHX,SAS,121,,,8,7,4,5
Yuta Watanabe,G-F,22023,1629139,22300113,"OCT 31, 2023",PHX vs. SAS,L,19,4,8,0.5,3,7,0.429,0,0,0.0,1,2,3,2,1,0,2,1,11,-6,1,PHX,PHX,SAS,114,,,16,14,13,5
Yuta Watanabe,G-F,22023,1629139,22300094,"OCT 28, 2023",PHX vs. UTA,W,21,2,7,0.286,1,4,0.25,2,2,1.0,1,3,4,0,2,1,0,2,7,2,1,PHX,PHX,UTA,126,,,11,11,7,4
Yuta Watanabe,G-F,22023,1629139,22300076,"OCT 26, 2023",PHX @ LAL,L,15,1,2,0.5,1,1,1.0,0,0,0.0,0,1,1,0,0,0,1,2,3,-16,1,PHX,LAL,PHX,95,,,4,4,3,1
Yuta Watanabe,G-F,22023,1629139,22300062,"OCT 24, 2023",PHX @ GSW,W,18,3,5,0.6,2,4,0.5,0,0,0.0,0,4,4,0,0,1,1,2,8,7,1,PHX,GSW,PHX,108,,,12,12,8,4
Yuta Watanabe,G-F,22023,1629139,22300677,"JAN 31, 2024",PHX @ BKN,W,1,0,0,0.0,0,0,0.0,0,0,0.0,0,0,0,0,0,0,0,0,0,0,1,PHX,BKN,PHX,136,,,0,0,0,0
Yuta Watanabe,G-F,22023,1629139,22300317,"DEC 13, 2023",PHX vs. BKN,L,7,0,2,0.0,0,2,0.0,0,0,0.0,1,0,1,0,0,0,0,2,0,-13,1,PHX,PHX,BKN,112,,,1,1,0,1
Yuta Watanabe,G-F,22023,1629139,22300308,"DEC 12, 2023",PHX vs. GSW,W,20,1,4,0.25,1,4,0.25,0,0,0.0,0,1,1,1,1,1,1,2,3,11,1,PHX,PHX,GSW,119,,,5,4,4,2
Yuta Watanabe,G-F,22023,1629139,22301228,"DEC 08, 2023",PHX vs. SAC,L,24,3,8,0.375,3,8,0.375,0,0,0.0,0,2,2,1,0,0,0,0,9,-13,1,PHX,PHX,SAC,106,,,12,11,10,3
Yuta Watanabe,G-F,22023,1629139,22300260,"NOV 29, 2023",PHX @ TOR,L,16,0,5,0.0,0,3,0.0,1,2,0.5,1,0,1,0,1,2,1,0,1,4,1,PHX,TOR,PHX,105,,,2,2,1,1
Yuta Watanabe,G-F,22023,1629139,22300247,"NOV 26, 2023",PHX @ NYK,W,15,2,4,0.5,2,4,0.5,1,2,0.5,0,0,0,0,0,0,0,1,7,5,1,PHX,NYK,PHX,116,,,7,7,7,0
John Konchar,G,22023,1629723,22300751,"FEB 10, 2024",MEM @ CHA,L,35,4,8,0.5,0,3,0.0,0,0,0.0,4,6,10,2,4,1,1,2,8,-4,1,MEM,CHA,MEM,105,,,20,18,10,12
John Konchar,G,22023,1629723,22300737,"FEB 08, 2024",MEM vs. CHI,L,30,2,5,0.4,0,3,0.0,0,0,0.0,1,2,3,1,0,1,0,2,4,7,1,MEM,MEM,CHI,95,,,8,7,5,4
John Konchar,G,22023,1629723,22300722,"FEB 06, 2024",MEM @ NYK,L,26,2,4,0.5,1,3,0.333,0,0,0.0,1,3,4,5,0,0,0,1,5,-14,1,MEM,NYK,MEM,97,,,14,9,10,9
John Konchar,G,22023,1629723,22300693,"FEB 02, 2024",MEM vs. GSW,L,28,1,7,0.143,1,3,0.333,0,0,0.0,4,8,12,5,1,0,2,2,3,-3,1,MEM,MEM,GSW,98,,,20,15,8,17
John Konchar,G,22023,1629723,22300687,"FEB 01, 2024",MEM vs. CLE,L,32,3,4,0.75,0,1,0.0,2,2,1.0,0,6,6,0,1,2,1,3,8,-8,1,MEM,MEM,CLE,86,,,14,14,8,6
John Konchar,G,22023,1629723,22300652,"JAN 28, 2024",MEM @ IND,L,30,4,5,0.8,1,2,0.5,0,0,0.0,2,5,7,4,0,2,2,1,9,-5,1,MEM,IND,MEM,106,,,20,16,13,11
John Konchar,G,22023,1629723,22300638,"JAN 26, 2024",MEM vs. ORL,W,26,3,5,0.6,1,2,0.5,0,0,0.0,1,0,1,2,3,2,1,2,7,8,1,MEM,MEM,ORL,107,,,10,8,9,3
John Konchar,G,22023,1629723,22300609,"JAN 22, 2024",MEM @ TOR,W,28,3,6,0.5,0,1,0.0,0,1,0.0,4,1,5,4,0,5,1,2,6,0,1,MEM,TOR,MEM,108,,,15,11,10,9
John Konchar,G,22023,1629723,22300597,"JAN 20, 2024",MEM @ CHI,L,27,1,4,0.25,0,2,0.0,0,0,0.0,0,5,5,6,0,2,2,0,2,-9,1,MEM,CHI,MEM,93,,,13,7,8,11
John Konchar,G,22023,1629723,22300582,"JAN 18, 2024",MEM @ MIN,L,27,2,2,1.0,1,1,1.0,0,0,0.0,0,3,3,2,1,0,1,4,5,14,1,MEM,MIN,MEM,103,,,10,8,7,5
John Konchar,G,22023,1629723,22300503,"JAN 07, 2024",MEM @ PHX,W,3,0,1,0.0,0,1,0.0,0,0,0.0,0,1,1,0,0,0,0,0,0,-5,1,MEM,PHX,MEM,121,,,1,1,0,1
John Konchar,G,22023,1629723,22300470,"JAN 03, 2024",MEM vs. TOR,L,8,0,2,0.0,0,0,0.0,0,0,0.0,0,2,2,1,2,1,1,0,0,2,1,MEM,MEM,TOR,111,,,3,2,1,3
John Konchar,G,22023,1629723,22300460,"JAN 02, 2024",MEM vs. SAS,W,0,0,0,0.0,0,0,0.0,0,0,0.0,0,0,0,0,0,0,0,0,0,-4,1,MEM,MEM,SAS,106,,,0,0,0,0
John Konchar,G,22023,1629723,22300449,"DEC 31, 2023",MEM vs. SAC,L,5,0,0,0.0,0,0,0.0,0,0,0.0,0,0,0,0,0,0,0,0,0,-6,1,MEM,MEM,SAC,92,,,0,0,0,0
John Konchar,G,22023,1629723,22300393,"DEC 23, 2023",MEM @ ATL,W,13,2,3,0.667,1,2,0.5,0,0,0.0,1,4,5,2,0,2,0,1,5,3,1,MEM,ATL,MEM,125,,,12,10,7,7
John Konchar,G,22023,1629723,22300377,"DEC 21, 2023",MEM vs. IND,W,21,2,4,0.5,2,4,0.5,0,0,0.0,1,5,6,1,1,2,0,1,6,11,1,MEM,MEM,IND,116,,,13,12,7,7
John Konchar,G,22023,1629723,22300360,"DEC 19, 2023",MEM @ NOP,W,22,0,2,0.0,0,2,0.0,0,0,0.0,1,7,8,0,0,0,1,3,0,-6,1,MEM,NOP,MEM,115,,,8,8,0,8
John Konchar,G,22023,1629723,22300355,"DEC 18, 2023",MEM @ OKC,L,17,1,3,0.333,1,3,0.333,2,2,1.0,1,1,2,2,2,0,2,2,5,-20,1,MEM,OKC,MEM,97,,,9,7,7,4
John Konchar,G,22023,1629723,22300314,"DEC 13, 2023",MEM @ HOU,L,7,0,1,0.0,0,1,0.0,0,0,0.0,0,0,0,1,1,0,0,0,0,-13,1,MEM,HOU,MEM,104,,,1,0,1,1
John Konchar,G,22023,1629723,22300299,"DEC 11, 2023",MEM vs. DAL,L,25,2,5,0.4,2,5,0.4,0,0,0.0,2,4,6,2,1,1,2,2,6,-2,1,MEM,MEM,DAL,113,,,14,12,8,8
John Konchar,G,22023,1629723,22301221,"DEC 08, 2023",MEM vs. MIN,L,17,1,5,0.2,1,4,0.25,0,0,0.0,0,3,3,0,1,1,0,1,3,-13,1,MEM,MEM,MIN,95,,,6,6,3,3
John Konchar,G,22023,1629723,22301206,"DEC 06, 2023",MEM @ DET,W,22,3,4,0.75,2,2,1.0,1,2,0.5,1,6,7,2,2,1,0,0,9,22,1,MEM,DET,MEM,104,,,18,16,11,9
John Konchar,G,22023,1629723,22300288,"DEC 02, 2023",MEM @ PHX,L,20,2,5,0.4,0,2,0.0,2,2,1.0,2,2,4,0,1,1,2,0,6,-2,1,MEM,PHX,MEM,101,,,10,10,6,4
John Konchar,G,22023,1629723,22300277,"DEC 01, 2023",MEM @ DAL,W,2,0,0,0.0,0,0,0.0,0,0,0.0,0,0,0,0,0,0,0,1,0,-4,1,MEM,DAL,MEM,89,,,0,0,0,0
John Konchar,G,22023,1629723,22300249,"NOV 26, 2023",MEM vs. MIN,L,2,0,0,0.0,0,0,0.0,0,0,0.0,0,0,0,0,0,0,0,0,0,-3,1,MEM,MEM,MIN,91,,,0,0,0,0
John Konchar,G,22023,1629723,22300044,"NOV 24, 2023",MEM vs. PHX,L,18,0,2,0.0,0,1,0.0,1,2,0.5,0,3,3,1,0,0,0,1,1,-3,1,MEM,MEM,PHX,89,,,5,4,2,4
John Konchar,G,22023,1629723,22300231,"NOV 22, 2023",MEM @ HOU,L,29,0,6,0.0,0,4,0.0,0,0,0.0,5,6,11,2,0,2,0,3,0,-11,1,MEM,HOU,MEM,91,,,13,11,2,13
John Konchar,G,22023,1629723,22300213,"NOV 19, 2023",MEM vs. BOS,L,26,1,3,0.333,0,0,0.0,0,0,0.0,2,3,5,3,1,1,1,2,2,-13,1,MEM,MEM,BOS,100,,,10,7,5,8
John Konchar,G,22023,1629723,22300206,"NOV 18, 2023",MEM @ SAS,W,23,2,5,0.4,1,4,0.25,0,0,0.0,0,3,3,2,1,1,1,2,5,-7,1,MEM,SAS,MEM,120,,,10,8,7,5
John Konchar,G,22023,1629723,22300026,"NOV 14, 2023",MEM @ LAL,L,18,2,4,0.5,2,3,0.667,0,0,0.0,1,2,3,6,1,0,0,1,6,0,1,MEM,LAL,MEM,107,,,15,9,12,9
John Konchar,G,22023,1629723,22300179,"NOV 12, 2023",MEM @ LAC,W,5,0,1,0.0,0,1,0.0,0,0,0.0,0,2,2,0,0,0,1,2,0,-12,1,MEM,LAC,MEM,105,,,2,2,0,2
John Konchar,G,22023,1629723,22300012,"NOV 10, 2023",MEM vs. UTA,L,21,2,6,0.333,2,4,0.5,0,0,0.0,0,1,1,2,2,0,0,0,6,-7,1,MEM,MEM,UTA,121,,,9,7,8,3
John Konchar,G,22023,1629723,22300537,"JAN 12, 2024",MEM vs. LAC,L,6,0,1,0.0,0,1,0.0,0,0,0.0,0,1,1,1,0,0,0,1,0,-11,1,MEM,MEM,LAC,119,,,2,1,1,2
John Konchar,G,22023,1629723,22300515,"JAN 09, 2024",MEM @ DAL,W,25,1,3,0.333,0,2,0.0,2,2,1.0,3,4,7,3,0,1,0,0,4,18,1,MEM,DAL,MEM,120,,,14,11,7,10
John Konchar,G,22023,1629723,22300425,"DEC 28, 2023",MEM @ DEN,L,25,4,9,0.444,1,5,0.2,1,1,1.0,3,4,7,3,2,1,1,1,10,-30,1,MEM,DEN,MEM,105,,,20,17,13,10
John Konchar,G,22023,1629723,22300007,"NOV 03, 2023",MEM @ POR,L,11,1,2,0.5,0,0,0.0,0,0,0.0,0,1,1,0,0,1,0,0,2,13,1,MEM,POR,MEM,113,,,3,3,2,1
John Konchar,G,22023,1629723,22300125,"NOV 01, 2023",MEM @ UTA,L,18,3,6,0.5,1,2,0.5,0,0,0.0,3,4,7,2,0,0,0,1,7,-8,1,MEM,UTA,MEM,109,,,16,14,9,9
John Konchar,G,22023,1629723,22300106,"OCT 30, 2023",MEM vs. DAL,L,19,1,2,0.5,1,2,0.5,0,0,0.0,1,3,4,1,0,0,0,2,3,-3,1,MEM,MEM,DAL,110,,,8,7,4,5
John Konchar,G,22023,1629723,22300089,"OCT 28, 2023",MEM @ WAS,L,22,2,4,0.5,1,3,0.333,0,0,0.0,3,6,9,1,2,2,1,0,5,1,1,MEM,WAS,MEM,106,,,15,14,6,10
John Konchar,G,22023,1629723,22300078,"OCT 27, 2023",MEM vs. DEN,L,30,1,2,0.5,0,1,0.0,0,0,0.0,0,6,6,2,1,2,0,1,2,3,1,MEM,MEM,DEN,104,,,10,8,4,8
John Konchar,G,22023,1629723,22300621,"JAN 24, 2024",MEM @ MIA,W,31,5,7,0.714,1,3,0.333,0,0,0.0,3,7,10,2,1,1,2,4,11,-6,1,MEM,MIA,MEM,90,,,23,21,13,12
John Konchar,G,22023,1629723,22300544,"JAN 13, 2024",MEM vs. NYK,L,20,0,4,0.0,0,3,0.0,0,0,0.0,1,2,3,1,1,2,0,1,0,-9,1,MEM,MEM,NYK,94,,,4,3,1,4
Garrison Mathews,G,22023,1629726,22300754,"FEB 10, 2024",ATL vs. HOU,W,9,1,1,1.0,1,1,1.0,0,0,0.0,0,2,2,1,0,0,0,1,3,1,1,ATL,ATL,HOU,122,,,6,5,4,3
Garrison Mathews,G,22023,1629726,22300742,"FEB 09, 2024",ATL @ PHI,W,14,2,3,0.667,1,2,0.5,3,3,1.0,0,1,1,1,0,0,0,3,8,5,1,ATL,PHI,ATL,127,,,10,9,9,2
Garrison Mathews,G,22023,1629726,22300729,"FEB 07, 2024",ATL @ BOS,L,14,1,1,1.0,1,1,1.0,0,0,0.0,0,0,0,0,1,0,0,2,3,-7,1,ATL,BOS,ATL,117,,,3,3,3,0
Garrison Mathews,G,22023,1629726,22300669,"JAN 30, 2024",ATL vs. LAL,W,6,0,1,0.0,0,1,0.0,0,0,0.0,0,1,1,0,0,0,0,4,0,4,1,ATL,ATL,LAL,138,,,1,1,0,1
Garrison Mathews,G,22023,1629726,22300653,"JAN 28, 2024",ATL vs. TOR,W,8,0,2,0.0,0,1,0.0,0,0,0.0,0,0,0,0,0,0,0,2,0,-21,1,ATL,ATL,TOR,126,,,0,0,0,0
Garrison Mathews,G,22023,1629726,22300634,"JAN 26, 2024",ATL vs. DAL,L,14,2,2,1.0,2,2,1.0,2,2,1.0,1,1,2,0,0,0,0,1,8,5,1,ATL,ATL,DAL,143,,,10,10,8,2
Garrison Mathews,G,22023,1629726,22300626,"JAN 24, 2024",ATL @ GSW,L,20,1,7,0.143,0,6,0.0,1,2,0.5,0,0,0,1,0,0,1,3,3,-23,1,ATL,GSW,ATL,112,,,4,3,4,1
Garrison Mathews,G,22023,1629726,22300613,"JAN 22, 2024",ATL @ SAC,L,23,3,5,0.6,3,5,0.6,0,0,0.0,0,1,1,0,0,0,2,5,9,2,1,ATL,SAC,ATL,107,,,10,10,9,1
Garrison Mathews,G,22023,1629726,22300595,"JAN 20, 2024",ATL vs. CLE,L,14,1,3,0.333,1,3,0.333,1,1,1.0,0,2,2,2,0,0,0,0,4,-3,1,ATL,ATL,CLE,95,,,8,6,6,4
Garrison Mathews,G,22023,1629726,22300587,"JAN 19, 2024",ATL @ MIA,W,20,3,5,0.6,3,4,0.75,0,0,0.0,0,3,3,3,0,0,1,2,9,12,1,ATL,MIA,ATL,109,,,15,12,12,6
Garrison Mathews,G,22023,1629726,22300570,"JAN 17, 2024",ATL vs. ORL,W,13,2,3,0.667,2,3,0.667,0,0,0.0,2,2,4,0,1,0,2,1,6,4,1,ATL,ATL,ORL,106,,,10,10,6,4
Garrison Mathews,G,22023,1629726,22300559,"JAN 15, 2024",ATL vs. SAS,W,13,2,4,0.5,2,4,0.5,0,0,0.0,0,0,0,0,0,0,0,0,6,17,1,ATL,ATL,SAS,109,,,6,6,6,0
Garrison Mathews,G,22023,1629726,22300543,"JAN 13, 2024",ATL vs. WAS,L,15,3,6,0.5,2,5,0.4,0,2,0.0,0,2,2,1,0,0,1,1,8,-4,1,ATL,ATL,WAS,99,,,11,10,9,3
Garrison Mathews,G,22023,1629726,22300499,"JAN 07, 2024",ATL @ ORL,L,2,0,0,0.0,0,0,0.0,0,0,0.0,0,0,0,0,0,0,0,0,0,-1,1,ATL,ORL,ATL,110,,,0,0,0,0
Garrison Mathews,G,22023,1629726,22300480,"JAN 05, 2024",ATL @ IND,L,19,2,3,0.667,2,3,0.667,0,0,0.0,1,2,3,2,0,0,1,1,6,-9,1,ATL,IND,ATL,116,,,11,9,8,5
Garrison Mathews,G,22023,1629726,22300467,"JAN 03, 2024",ATL vs. OKC,W,17,2,3,0.667,1,2,0.5,0,1,0.0,0,0,0,2,0,0,1,1,5,-8,1,ATL,ATL,OKC,141,,,7,5,7,2
Garrison Mathews,G,22023,1629726,22300445,"DEC 31, 2023",ATL @ WAS,W,14,0,0,0.0,0,0,0.0,0,0,0.0,1,1,2,1,0,1,0,1,0,4,1,ATL,WAS,ATL,130,,,3,2,1,3
Garrison Mathews,G,22023,1629726,22300431,"DEC 29, 2023",ATL vs. SAC,L,8,1,2,0.5,1,2,0.5,0,0,0.0,0,1,1,0,1,0,0,1,3,7,1,ATL,ATL,SAC,110,,,4,4,3,1
Garrison Mathews,G,22023,1629726,22300408,"DEC 26, 2023",ATL @ CHI,L,13,2,2,1.0,2,2,1.0,0,0,0.0,0,1,1,0,0,0,0,3,6,-3,1,ATL,CHI,ATL,113,,,7,7,6,1
Garrison Mathews,G,22023,1629726,22300393,"DEC 23, 2023",ATL vs. MEM,L,14,0,3,0.0,0,2,0.0,0,0,0.0,0,1,1,1,1,0,0,3,0,-6,1,ATL,ATL,MEM,119,,,2,1,1,2
Garrison Mathews,G,22023,1629726,22300384,"DEC 22, 2023",ATL @ MIA,L,18,0,3,0.0,0,3,0.0,0,0,0.0,0,1,1,1,0,0,0,4,0,-2,1,ATL,MIA,ATL,113,,,2,1,1,2
Garrison Mathews,G,22023,1629726,22300371,"DEC 20, 2023",ATL @ HOU,W,17,2,4,0.5,2,4,0.5,0,0,0.0,0,1,1,0,0,0,1,1,6,16,1,ATL,HOU,ATL,134,,,7,7,6,1
Garrison Mathews,G,22023,1629726,22300352,"DEC 18, 2023",ATL vs. DET,W,23,2,5,0.4,2,5,0.4,0,1,0.0,1,2,3,0,0,2,2,5,6,-8,1,ATL,ATL,DET,130,,,9,9,6,3
Garrison Mathews,G,22023,1629726,22300336,"DEC 16, 2023",ATL @ CLE,L,14,2,2,1.0,2,2,1.0,0,0,0.0,0,0,0,0,0,0,1,4,6,-10,1,ATL,CLE,ATL,119,,,6,6,6,0
Garrison Mathews,G,22023,1629726,22300330,"DEC 15, 2023",ATL @ TOR,W,18,2,2,1.0,2,2,1.0,0,0,0.0,0,1,1,0,1,0,0,2,6,1,1,ATL,TOR,ATL,125,,,7,7,6,1
Garrison Mathews,G,22023,1629726,22300313,"DEC 13, 2023",ATL @ TOR,L,19,2,2,1.0,2,2,1.0,0,0,0.0,0,2,2,0,1,0,0,2,6,3,1,ATL,TOR,ATL,128,,,8,8,6,2
Garrison Mathews,G,22023,1629726,22300296,"DEC 11, 2023",ATL vs. DEN,L,17,1,5,0.2,1,5,0.2,0,0,0.0,0,0,0,1,1,0,0,1,3,-9,1,ATL,ATL,DEN,122,,,4,3,4,1
Garrison Mathews,G,22023,1629726,22301218,"DEC 08, 2023",ATL @ PHI,L,3,0,1,0.0,0,1,0.0,0,0,0.0,0,1,1,0,0,0,0,0,0,-8,1,ATL,PHI,ATL,114,,,1,1,0,1
Garrison Mathews,G,22023,1629726,22301209,"DEC 06, 2023",ATL vs. BKN,L,7,0,0,0.0,0,0,0.0,0,0,0.0,0,1,1,0,1,0,1,3,0,-10,1,ATL,ATL,BKN,113,,,1,1,0,1
Garrison Mathews,G,22023,1629726,22300286,"DEC 02, 2023",ATL @ MIL,L,7,0,0,0.0,0,0,0.0,0,0,0.0,1,0,1,0,0,0,1,1,0,-5,1,ATL,MIL,ATL,121,,,1,1,0,1
Garrison Mathews,G,22023,1629726,22300272,"NOV 30, 2023",ATL @ SAS,W,12,1,4,0.25,1,4,0.25,0,0,0.0,0,1,1,0,1,0,0,1,3,0,1,ATL,SAS,ATL,137,,,4,4,3,1
Garrison Mathews,G,22023,1629726,22300055,"NOV 28, 2023",ATL @ CLE,L,4,0,1,0.0,0,1,0.0,0,0,0.0,0,1,1,0,0,0,0,0,0,0,1,ATL,CLE,ATL,105,,,1,1,0,1
Garrison Mathews,G,22023,1629726,22300241,"NOV 25, 2023",ATL @ WAS,W,14,2,3,0.667,2,3,0.667,0,0,0.0,1,1,2,1,0,0,0,1,6,1,1,ATL,WAS,ATL,136,,,9,8,7,3
Garrison Mathews,G,22023,1629726,22300018,"NOV 14, 2023",ATL @ DET,W,2,1,1,1.0,1,1,1.0,0,0,0.0,0,1,1,0,0,0,0,0,3,5,1,ATL,DET,ATL,126,,,4,4,3,1
Garrison Mathews,G,22023,1629726,22300155,"NOV 06, 2023",ATL @ OKC,L,4,0,2,0.0,0,2,0.0,0,0,0.0,0,1,1,0,0,0,0,0,0,-5,1,ATL,OKC,ATL,117,,,1,1,0,1
Garrison Mathews,G,22023,1629726,22300135,"NOV 04, 2023",ATL @ NOP,W,4,0,0,0.0,0,0,0.0,0,0,0.0,0,0,0,0,0,0,0,1,0,-6,1,ATL,NOP,ATL,123,,,0,0,0,0
Garrison Mathews,G,22023,1629726,22300699,"FEB 03, 2024",ATL vs. GSW,W,16,2,5,0.4,1,4,0.25,3,3,1.0,1,2,3,0,0,1,0,1,8,14,1,ATL,ATL,GSW,141,,,11,11,8,3
Davion Mitchell,G,22023,1630558,22300746,"FEB 09, 2024",SAC vs. DEN,W,20,1,3,0.333,0,0,0.0,0,0,0.0,0,2,2,1,0,0,2,1,2,3,1,SAC,SAC,DEN,135,,,5,4,3,3
Davion Mitchell,G,22023,1630558,22300732,"FEB 07, 2024",SAC vs. DET,L,23,3,5,0.6,1,2,0.5,2,2,1.0,0,1,1,1,0,0,0,3,9,-1,1,SAC,SAC,DET,120,,,11,10,10,2
Davion Mitchell,G,22023,1630558,22300714,"FEB 05, 2024",SAC @ CLE,L,9,1,3,0.333,0,1,0.0,0,0,0.0,0,0,0,3,0,0,0,1,2,-12,1,SAC,CLE,SAC,110,,,5,2,5,3
Davion Mitchell,G,22023,1630558,22300700,"FEB 03, 2024",SAC @ CHI,W,14,1,2,0.5,0,1,0.0,2,2,1.0,0,2,2,4,0,0,1,1,4,-1,1,SAC,CHI,SAC,123,,,10,6,8,6
Davion Mitchell,G,22023,1630558,22300691,"FEB 02, 2024",SAC @ IND,W,16,2,5,0.4,0,2,0.0,0,0,0.0,0,2,2,1,1,0,1,0,4,-1,1,SAC,IND,SAC,133,,,7,6,5,3
Davion Mitchell,G,22023,1630558,22300678,"JAN 31, 2024",SAC @ MIA,L,12,1,2,0.5,0,0,0.0,1,1,1.0,0,1,1,1,0,0,1,1,3,-2,1,SAC,MIA,SAC,106,,,5,4,4,2
Davion Mitchell,G,22023,1630558,22300663,"JAN 29, 2024",SAC @ MEM,W,16,2,4,0.5,1,3,0.333,0,0,0.0,0,0,0,0,2,0,2,2,5,4,1,SAC,MEM,SAC,103,,,5,5,5,0
Davion Mitchell,G,22023,1630558,22300651,"JAN 27, 2024",SAC @ DAL,W,11,0,0,0.0,0,0,0.0,0,0,0.0,0,2,2,1,0,0,1,2,0,-13,1,SAC,DAL,SAC,120,,,3,2,1,3
Davion Mitchell,G,22023,1630558,22300632,"JAN 25, 2024",SAC @ GSW,W,15,3,5,0.6,3,5,0.6,1,2,0.5,1,1,2,4,0,0,0,2,10,13,1,SAC,GSW,SAC,134,,,16,12,14,6
Davion Mitchell,G,22023,1630558,22300613,"JAN 22, 2024",SAC vs. ATL,W,22,2,7,0.286,0,2,0.0,1,1,1.0,1,1,2,2,0,0,0,1,5,12,1,SAC,SAC,ATL,122,,,9,7,7,4
Davion Mitchell,G,22023,1630558,22300532,"JAN 12, 2024",SAC @ PHI,L,6,2,3,0.667,0,0,0.0,0,0,0.0,0,0,0,0,0,0,0,0,4,3,1,SAC,PHI,SAC,90,,,4,4,4,0
Davion Mitchell,G,22023,1630558,22300518,"JAN 10, 2024",SAC @ CHA,W,5,0,1,0.0,0,0,0.0,0,0,0.0,0,1,1,0,0,0,0,1,0,1,1,SAC,CHA,SAC,121,,,1,1,0,1
Davion Mitchell,G,22023,1630558,22300512,"JAN 09, 2024",SAC @ DET,W,1,0,0,0.0,0,0,0.0,0,0,0.0,1,0,1,0,0,0,0,0,0,2,1,SAC,DET,SAC,131,,,1,1,0,1
Davion Mitchell,G,22023,1630558,22300500,"JAN 07, 2024",SAC vs. NOP,L,10,0,2,0.0,0,2,0.0,0,0,0.0,0,0,0,0,1,0,0,1,0,-12,1,SAC,SAC,NOP,100,,,0,0,0,0
Davion Mitchell,G,22023,1630558,22300492,"JAN 05, 2024",SAC vs. TOR,W,11,3,8,0.375,1,4,0.25,0,0,0.0,0,1,1,2,0,0,0,0,7,6,1,SAC,SAC,TOR,135,,,10,8,9,3
Davion Mitchell,G,22023,1630558,22300476,"JAN 03, 2024",SAC vs. ORL,W,14,1,3,0.333,0,2,0.0,0,0,0.0,0,1,1,3,0,0,2,0,2,6,1,SAC,SAC,ORL,138,,,6,3,5,4
Davion Mitchell,G,22023,1630558,22300464,"JAN 02, 2024",SAC vs. CHA,L,14,1,3,0.333,1,1,1.0,1,2,0.5,0,1,1,0,0,0,1,1,4,-4,1,SAC,SAC,CHA,104,,,5,5,4,1
Davion Mitchell,G,22023,1630558,22300449,"DEC 31, 2023",SAC @ MEM,W,14,4,4,1.0,0,0,0.0,0,0,0.0,0,2,2,4,0,0,0,2,8,11,1,SAC,MEM,SAC,123,,,14,10,12,6
Davion Mitchell,G,22023,1630558,22300431,"DEC 29, 2023",SAC @ ATL,W,13,1,3,0.333,0,1,0.0,0,0,0.0,1,0,1,2,0,0,0,2,2,-1,1,SAC,ATL,SAC,117,,,5,3,4,3
Davion Mitchell,G,22023,1630558,22300413,"DEC 26, 2023",SAC @ POR,L,2,1,3,0.333,0,2,0.0,0,0,0.0,0,1,1,0,0,0,0,0,2,2,1,SAC,POR,SAC,113,,,3,3,2,1
Davion Mitchell,G,22023,1630558,22300387,"DEC 22, 2023",SAC vs. PHX,W,2,0,1,0.0,0,1,0.0,0,0,0.0,0,0,0,0,0,0,0,0,0,-6,1,SAC,SAC,PHX,120,,,0,0,0,0
Davion Mitchell,G,22023,1630558,22300373,"DEC 20, 2023",SAC vs. BOS,L,5,0,1,0.0,0,0,0.0,0,2,0.0,0,0,0,1,0,0,0,0,0,-4,1,SAC,SAC,BOS,119,,,1,0,1,1
Davion Mitchell,G,22023,1630558,22300358,"DEC 18, 2023",SAC vs. WAS,W,4,1,2,0.5,0,0,0.0,0,0,0.0,0,1,1,1,0,0,0,0,2,-6,1,SAC,SAC,WAS,141,,,4,3,3,2
Davion Mitchell,G,22023,1630558,22300342,"DEC 16, 2023",SAC vs. UTA,W,18,2,5,0.4,0,1,0.0,0,0,0.0,0,0,0,1,0,0,0,3,4,-8,1,SAC,SAC,UTA,125,,,5,4,5,1
Davion Mitchell,G,22023,1630558,22300309,"DEC 12, 2023",SAC @ LAC,L,15,0,3,0.0,0,1,0.0,1,2,0.5,0,0,0,2,0,0,0,1,1,-14,1,SAC,LAC,SAC,99,,,3,1,3,2
Davion Mitchell,G,22023,1630558,22300303,"DEC 11, 2023",SAC vs. BKN,W,3,0,1,0.0,0,1,0.0,0,0,0.0,1,0,1,1,0,0,0,0,0,-7,1,SAC,SAC,BKN,131,,,2,1,1,2
Davion Mitchell,G,22023,1630558,22301228,"DEC 08, 2023",SAC @ PHX,W,1,0,0,0.0,0,0,0.0,0,0,0.0,0,0,0,0,0,0,0,0,0,-4,1,SAC,PHX,SAC,114,,,0,0,0,0
Davion Mitchell,G,22023,1630558,22300264,"NOV 29, 2023",SAC vs. LAC,L,13,3,7,0.429,1,5,0.2,2,2,1.0,0,3,3,3,0,0,1,0,9,-5,1,SAC,SAC,LAC,117,,,15,12,12,6
Davion Mitchell,G,22023,1630558,22300060,"NOV 28, 2023",SAC vs. GSW,W,9,1,4,0.25,0,2,0.0,2,2,1.0,0,0,0,0,1,0,0,2,4,-14,1,SAC,SAC,GSW,124,,,4,4,4,0
Davion Mitchell,G,22023,1630558,22300050,"NOV 24, 2023",SAC @ MIN,W,9,2,2,1.0,1,1,1.0,0,0,0.0,0,0,0,1,0,0,1,1,5,-6,1,SAC,MIN,SAC,124,,,6,5,6,1
Davion Mitchell,G,22023,1630558,22300233,"NOV 22, 2023",SAC @ NOP,L,10,0,0,0.0,0,0,0.0,2,2,1.0,0,1,1,2,0,0,0,0,2,9,1,SAC,NOP,SAC,112,,,5,3,4,3
Davion Mitchell,G,22023,1630558,22300222,"NOV 20, 2023",SAC @ NOP,L,19,0,2,0.0,0,2,0.0,2,2,1.0,0,0,0,8,0,0,1,1,2,-4,1,SAC,NOP,SAC,93,,,10,2,10,8
Davion Mitchell,G,22023,1630558,22300212,"NOV 19, 2023",SAC @ DAL,W,9,0,3,0.0,0,1,0.0,0,0,0.0,0,0,0,1,0,0,2,0,0,1,1,SAC,DAL,SAC,129,,,1,0,1,1
Davion Mitchell,G,22023,1630558,22300016,"NOV 10, 2023",SAC vs. OKC,W,17,1,6,0.167,1,6,0.167,0,0,0.0,0,1,1,1,0,0,0,1,3,1,1,SAC,SAC,OKC,105,,,5,4,4,2
Davion Mitchell,G,22023,1630558,22300170,"NOV 08, 2023",SAC vs. POR,W,28,6,9,0.667,3,4,0.75,1,1,1.0,0,0,0,4,0,0,2,4,16,3,1,SAC,SAC,POR,121,,,20,16,20,4
Davion Mitchell,G,22023,1630558,22300153,"NOV 06, 2023",SAC @ HOU,L,27,2,11,0.182,1,5,0.2,0,0,0.0,1,0,1,2,0,1,0,2,5,-30,1,SAC,HOU,SAC,97,,,8,6,7,3
Davion Mitchell,G,22023,1630558,22300137,"NOV 04, 2023",SAC @ HOU,L,26,3,7,0.429,1,4,0.25,0,0,0.0,0,3,3,5,0,1,1,3,7,-13,1,SAC,HOU,SAC,89,,,15,10,12,8
Davion Mitchell,G,22023,1630558,22300126,"NOV 01, 2023",SAC @ GSW,L,30,5,9,0.556,3,6,0.5,0,0,0.0,0,3,3,4,3,0,2,1,13,-3,1,SAC,GSW,SAC,101,,,20,16,17,7
Davion Mitchell,G,22023,1630558,22300100,"OCT 29, 2023",SAC vs. LAL,W,15,2,4,0.5,1,2,0.5,0,0,0.0,0,2,2,2,0,0,0,4,5,-17,1,SAC,SAC,LAL,132,,,9,7,7,4
Davion Mitchell,G,22023,1630558,22300087,"OCT 27, 2023",SAC vs. GSW,L,11,0,2,0.0,0,1,0.0,0,0,0.0,0,0,0,0,1,0,2,1,0,-8,1,SAC,SAC,GSW,114,,,0,0,0,0
Davion Mitchell,G,22023,1630558,22300072,"OCT 25, 2023",SAC @ UTA,W,14,0,3,0.0,0,2,0.0,0,0,0.0,0,3,3,4,0,0,1,3,0,4,1,SAC,UTA,SAC,130,,,7,3,4,7
Blake Wesley,G,22023,1631104,22300750,"FEB 10, 2024",SAS @ BKN,L,16,2,3,0.667,0,1,0.0,2,2,1.0,0,0,0,3,2,0,0,2,6,-6,1,SAS,BKN,SAS,103,,,9,6,9,3
Blake Wesley,G,22023,1631104,22300681,"JAN 31, 2024",SAS vs. ORL,L,12,2,4,0.5,0,1,0.0,0,0,0.0,0,1,1,1,1,0,2,1,4,-9,1,SAS,SAS,ORL,98,,,6,5,5,2
Blake Wesley,G,22023,1631104,22300665,"JAN 29, 2024",SAS vs. WAS,L,12,2,4,0.5,1,1,1.0,2,2,1.0,0,1,1,2,3,1,1,3,7,2,1,SAS,SAS,WAS,113,,,10,8,9,3
Blake Wesley,G,22023,1631104,22300649,"JAN 27, 2024",SAS vs. MIN,W,20,1,2,0.5,0,0,0.0,0,0,0.0,0,0,0,3,0,1,1,1,2,-17,1,SAS,SAS,MIN,113,,,5,2,5,3
Blake Wesley,G,22023,1631104,22300584,"JAN 19, 2024",SAS @ CHA,L,15,4,6,0.667,0,1,0.0,1,1,1.0,0,1,1,2,0,0,0,3,9,-5,1,SAS,CHA,SAS,120,,,12,10,11,3
Blake Wesley,G,22023,1631104,22300571,"JAN 17, 2024",SAS @ BOS,L,7,0,2,0.0,0,0,0.0,0,0,0.0,0,1,1,2,0,0,1,1,0,3,1,SAS,BOS,SAS,95,,,3,1,2,3
Blake Wesley,G,22023,1631104,22300559,"JAN 15, 2024",SAS @ ATL,L,13,1,4,0.25,0,2,0.0,1,2,0.5,1,1,2,3,0,0,1,0,3,-6,1,SAS,ATL,SAS,99,,,8,5,6,5
Blake Wesley,G,22023,1631104,22300548,"JAN 13, 2024",SAS vs. CHI,L,11,1,3,0.333,0,2,0.0,0,0,0.0,0,1,1,3,0,0,0,2,2,5,1,SAS,SAS,CHI,116,,,6,3,5,4
Blake Wesley,G,22023,1631104,22300541,"JAN 12, 2024",SAS vs. CHA,W,17,2,3,0.667,0,0,0.0,0,0,0.0,0,2,2,3,1,0,0,3,4,3,1,SAS,SAS,CHA,127,,,9,6,7,5
Blake Wesley,G,22023,1631104,22300519,"JAN 10, 2024",SAS @ DET,W,6,4,4,1.0,0,0,0.0,1,1,1.0,0,1,1,0,0,0,0,2,9,4,1,SAS,DET,SAS,129,,,10,10,9,1
Blake Wesley,G,22023,1631104,22300497,"JAN 07, 2024",SAS @ CLE,L,12,1,2,0.5,0,1,0.0,1,2,0.5,0,2,2,0,0,0,2,1,3,-7,1,SAS,CLE,SAS,115,,,5,5,3,2
Blake Wesley,G,22023,1631104,22300477,"JAN 04, 2024",SAS vs. MIL,L,15,0,1,0.0,0,0,0.0,0,0,0.0,0,1,1,1,0,0,0,3,0,6,1,SAS,SAS,MIL,121,,,2,1,1,2
Blake Wesley,G,22023,1631104,22300460,"JAN 02, 2024",SAS @ MEM,L,21,5,8,0.625,0,2,0.0,0,2,0.0,0,1,1,1,2,0,1,4,10,-4,1,SAS,MEM,SAS,98,,,12,11,11,2
Blake Wesley,G,22023,1631104,22300448,"DEC 31, 2023",SAS vs. BOS,L,17,0,3,0.0,0,2,0.0,1,2,0.5,1,1,2,6,0,0,1,2,1,1,1,SAS,SAS,BOS,101,,,9,3,7,8
Blake Wesley,G,22023,1631104,22300278,"DEC 01, 2023",SAS @ NOP,L,3,0,0,0.0,0,0,0.0,0,0,0.0,0,0,0,2,0,0,0,0,0,1,1,SAS,NOP,SAS,106,,,2,0,2,2
Blake Wesley,G,22023,1631104,22300161,"NOV 08, 2023",SAS @ NYK,L,3,2,3,0.667,0,0,0.0,0,0,0.0,1,1,2,1,0,0,0,0,4,0,1,SAS,NYK,SAS,105,,,7,6,5,3
Blake Wesley,G,22023,1631104,22300146,"NOV 06, 2023",SAS @ IND,L,8,1,4,0.25,0,0,0.0,0,0,0.0,0,0,0,1,0,0,0,2,2,-1,1,SAS,IND,SAS,111,,,3,2,3,1
Blake Wesley,G,22023,1631104,22300099,"OCT 29, 2023",SAS @ LAC,L,7,0,1,0.0,0,1,0.0,1,2,0.5,0,0,0,1,0,1,1,0,1,-13,1,SAS,LAC,SAS,83,,,2,1,2,1
Blake Wesley,G,22023,1631104,22300032,"NOV 17, 2023",SAS vs. SAC,L,4,0,0,0.0,0,0,0.0,0,0,0.0,0,0,0,0,0,0,0,1,0,-15,1,SAS,SAS,SAC,120,,,0,0,0,0
Blake Wesley,G,22023,1631104,22300734,"FEB 08, 2024",SAS @ ORL,L,25,4,5,0.8,1,2,0.5,1,1,1.0,1,1,2,7,1,0,1,4,10,1,1,SAS,ORL,SAS,111,,,19,12,17,9
Blake Wesley,G,22023,1631104,22300730,"FEB 07, 2024",SAS @ MIA,L,16,2,2,1.0,0,0,0.0,1,4,0.25,0,1,1,6,1,0,1,3,5,-4,1,SAS,MIA,SAS,104,,,12,6,11,7
Blake Wesley,G,22023,1631104,22300703,"FEB 03, 2024",SAS vs. CLE,L,11,0,3,0.0,0,1,0.0,0,0,0.0,0,0,0,1,0,0,1,1,0,-17,1,SAS,SAS,CLE,101,,,1,0,1,1
Blake Wesley,G,22023,1631104,22300696,"FEB 02, 2024",SAS vs. NOP,L,13,2,4,0.5,0,1,0.0,0,0,0.0,0,3,3,6,0,0,0,2,4,3,1,SAS,SAS,NOP,113,,,13,7,10,9
Blake Wesley,G,22023,1631104,22300622,"JAN 24, 2024",SAS vs. OKC,L,28,5,5,1.0,1,1,1.0,1,3,0.333,1,3,4,6,0,1,4,4,12,-7,1,SAS,SAS,OKC,114,,,22,16,18,10
Blake Wesley,G,22023,1631104,22300594,"JAN 20, 2024",SAS @ WAS,W,15,3,4,0.75,0,0,0.0,0,0,0.0,1,0,1,3,1,0,1,1,6,0,1,SAS,WAS,SAS,131,,,10,7,9,4
Blake Wesley,G,22023,1631104,22300427,"DEC 28, 2023",SAS @ POR,W,1,0,0,0.0,0,0,0.0,0,0,0.0,0,0,0,0,0,0,0,0,0,-2,1,SAS,POR,SAS,118,,,0,0,0,0
Blake Wesley,G,22023,1631104,22300412,"DEC 26, 2023",SAS vs. UTA,L,10,1,4,0.25,0,0,0.0,1,2,0.5,1,1,2,4,0,0,0,2,3,-2,1,SAS,SAS,UTA,118,,,9,5,7,6
Blake Wesley,G,22023,1631104,22300398,"DEC 23, 2023",SAS @ DAL,L,12,2,3,0.667,0,0,0.0,1,2,0.5,0,1,1,3,3,0,0,1,5,7,1,SAS,DAL,SAS,119,,,9,6,8,4
Blake Wesley,G,22023,1631104,22300376,"DEC 21, 2023",SAS @ CHI,L,3,1,1,1.0,0,0,0.0,1,2,0.5,0,0,0,2,0,0,0,0,3,1,1,SAS,CHI,SAS,95,,,5,3,5,2
Blake Wesley,G,22023,1631104,22300331,"DEC 15, 2023",SAS vs. LAL,W,2,0,0,0.0,0,0,0.0,0,0,0.0,0,0,0,1,0,0,0,0,0,-3,1,SAS,SAS,LAL,129,,,1,0,1,1
Blake Wesley,G,22023,1631104,22300641,"JAN 26, 2024",SAS vs. POR,W,24,0,5,0.0,0,1,0.0,1,2,0.5,0,2,2,8,2,0,1,1,1,-8,1,SAS,SAS,POR,116,,,11,3,9,10
Blake Wesley,G,22023,1631104,22300608,"JAN 22, 2024",SAS @ PHI,L,19,3,6,0.5,0,2,0.0,0,0,0.0,1,1,2,2,1,0,0,1,6,3,1,SAS,PHI,SAS,123,,,10,8,8,4
Jaylin Williams,F,22023,1631119,22300682,"JAN 31, 2024",OKC vs. DEN,W,18,4,6,0.667,1,2,0.5,0,0,0.0,1,2,3,2,0,1,1,1,9,-5,1,OKC,OKC,DEN,105,,,14,12,11,5
Jaylin Williams,F,22023,1631119,22300622,"JAN 24, 2024",OKC @ SAS,W,11,2,3,0.667,2,2,1.0,0,0,0.0,1,3,4,0,0,0,1,2,6,17,1,OKC,SAS,OKC,140,,,10,10,6,4
Jaylin Williams,F,22023,1631119,22300617,"JAN 23, 2024",OKC vs. POR,W,15,3,5,0.6,1,2,0.5,0,1,0.0,0,2,2,1,1,1,0,1,7,0,1,OKC,OKC,POR,111,,,10,9,8,3
Jaylin Williams,F,22023,1631119,22300481,"JAN 05, 2024",OKC @ BKN,L,2,0,1,0.0,0,1,0.0,0,0,0.0,0,0,0,0,0,0,0,1,0,-5,1,OKC,BKN,OKC,115,,,0,0,0,0
Jaylin Williams,F,22023,1631119,22300419,"DEC 27, 2023",OKC vs. NYK,W,7,0,1,0.0,0,1,0.0,0,0,0.0,0,2,2,0,0,0,0,1,0,-8,1,OKC,OKC,NYK,129,,,2,2,0,2
Jaylin Williams,F,22023,1631119,22300397,"DEC 23, 2023",OKC vs. LAL,L,6,0,1,0.0,0,1,0.0,0,0,0.0,0,2,2,1,0,0,0,1,0,0,1,OKC,OKC,LAL,120,,,3,2,1,3
Jaylin Williams,F,22023,1631119,22300324,"DEC 14, 2023",OKC @ SAC,L,15,1,3,0.333,1,3,0.333,0,0,0.0,1,5,6,3,0,0,0,2,3,7,1,OKC,SAC,OKC,123,,,12,9,6,9
Jaylin Williams,F,22023,1631119,22300302,"DEC 11, 2023",OKC vs. UTA,W,10,2,2,1.0,1,1,1.0,2,2,1.0,0,1,1,1,1,0,1,0,7,4,1,OKC,OKC,UTA,134,,,9,8,8,2
Jaylin Williams,F,22023,1631119,22301222,"DEC 08, 2023",OKC vs. GSW,W,6,0,2,0.0,0,2,0.0,0,0,0.0,0,1,1,0,0,0,1,1,0,-4,1,OKC,OKC,GSW,138,,,1,1,0,1
Jaylin Williams,F,22023,1631119,22300287,"DEC 02, 2023",OKC @ DAL,W,15,4,6,0.667,4,5,0.8,2,2,1.0,1,2,3,0,0,0,1,1,14,16,1,OKC,DAL,OKC,126,,,17,17,14,3
Jaylin Williams,F,22023,1631119,22300239,"NOV 25, 2023",OKC vs. PHI,L,26,3,9,0.333,2,5,0.4,0,0,0.0,1,5,6,5,0,0,0,4,8,-1,1,OKC,OKC,PHI,123,,,19,14,13,11
Jaylin Williams,F,22023,1631119,22300215,"NOV 19, 2023",OKC @ POR,W,18,3,5,0.6,0,1,0.0,0,0,0.0,3,4,7,3,1,0,1,3,6,23,1,OKC,POR,OKC,134,,,16,13,9,10
Jaylin Williams,F,22023,1631119,22300185,"NOV 12, 2023",OKC @ PHX,W,13,1,3,0.333,1,3,0.333,0,0,0.0,1,3,4,0,0,1,1,0,3,-11,1,OKC,PHX,OKC,111,,,7,7,3,4
Jaylin Williams,F,22023,1631119,22300167,"NOV 08, 2023",OKC vs. CLE,W,10,2,2,1.0,2,2,1.0,0,0,0.0,1,2,3,0,0,0,1,4,6,1,1,OKC,OKC,CLE,128,,,9,9,6,3
Jaylin Williams,F,22023,1631119,22300748,"FEB 10, 2024",OKC @ DAL,L,4,0,1,0.0,0,1,0.0,0,0,0.0,0,2,2,0,1,0,0,0,0,-6,1,OKC,DAL,OKC,111,,,2,2,0,2
Jaylin Williams,F,22023,1631119,22300724,"FEB 06, 2024",OKC @ UTA,L,13,1,6,0.167,1,3,0.333,0,0,0.0,1,2,3,3,1,1,1,1,3,-4,1,OKC,UTA,OKC,117,,,9,6,6,6
Jaylin Williams,F,22023,1631119,22300710,"FEB 04, 2024",OKC vs. TOR,W,14,1,5,0.2,1,4,0.25,0,0,0.0,3,2,5,2,0,0,0,1,3,-6,1,OKC,OKC,TOR,135,,,10,8,5,7
Jaylin Williams,F,22023,1631119,22300695,"FEB 02, 2024",OKC vs. CHA,W,18,2,4,0.5,1,3,0.333,2,2,1.0,1,7,8,0,0,1,0,1,7,29,1,OKC,OKC,CHA,126,,,15,15,7,8
Jaylin Williams,F,22023,1631119,22300565,"JAN 15, 2024",OKC @ LAL,L,6,1,3,0.333,1,3,0.333,0,0,0.0,1,0,1,0,0,0,0,0,3,-6,1,OKC,LAL,OKC,105,,,4,4,3,1
Jaylin Williams,F,22023,1631119,22300529,"JAN 11, 2024",OKC vs. POR,W,18,2,6,0.333,2,4,0.5,0,0,0.0,0,4,4,1,1,0,2,0,6,13,1,OKC,OKC,POR,139,,,11,10,7,5
Jaylin Williams,F,22023,1631119,22300379,"DEC 21, 2023",OKC vs. LAC,W,6,1,1,1.0,0,0,0.0,0,0,0.0,0,2,2,1,0,0,0,0,2,4,1,OKC,OKC,LAC,134,,,5,4,3,3
Jaylin Williams,F,22023,1631119,22300355,"DEC 18, 2023",OKC vs. MEM,W,9,1,3,0.333,0,1,0.0,0,0,0.0,1,2,3,0,1,0,2,2,2,0,1,OKC,OKC,MEM,116,,,5,5,2,3
Jaylin Williams,F,22023,1631119,22300340,"DEC 16, 2023",OKC @ DEN,W,22,3,4,0.75,3,4,0.75,2,2,1.0,1,3,4,1,0,0,0,4,11,-6,1,OKC,DEN,OKC,118,,,16,15,12,5
Jaylin Williams,F,22023,1631119,22300058,"NOV 28, 2023",OKC @ MIN,L,11,1,6,0.167,1,3,0.333,0,0,0.0,1,4,5,3,0,0,1,1,3,8,1,OKC,MIN,OKC,103,,,11,8,6,8
Jaylin Williams,F,22023,1631119,22300016,"NOV 10, 2023",OKC @ SAC,L,18,0,2,0.0,0,2,0.0,1,2,0.5,0,4,4,2,1,0,0,3,1,6,1,OKC,SAC,OKC,98,,,7,5,3,6
Jaylin Williams,F,22023,1631119,22300155,"NOV 06, 2023",OKC vs. ATL,W,13,2,4,0.5,0,1,0.0,2,2,1.0,0,2,2,2,1,1,0,3,6,2,1,OKC,OKC,ATL,126,,,10,8,8,4
Jaylin Williams,F,22023,1631119,22300005,"NOV 03, 2023",OKC vs. GSW,L,15,2,5,0.4,0,3,0.0,2,2,1.0,0,5,5,3,0,0,1,1,6,-2,1,OKC,OKC,GSW,139,,,14,11,9,8
Jaylin Williams,F,22023,1631119,22300664,"JAN 29, 2024",OKC vs. MIN,L,16,1,3,0.333,0,1,0.0,0,1,0.0,0,3,3,2,1,2,0,0,2,7,1,OKC,OKC,MIN,101,,,7,5,4,5
Jaylin Williams,F,22023,1631119,22300654,"JAN 28, 2024",OKC @ DET,L,15,1,4,0.25,0,3,0.0,0,0,0.0,1,2,3,2,1,1,1,2,2,4,1,OKC,DET,OKC,104,,,7,5,4,5
Jaylin Williams,F,22023,1631119,22300640,"JAN 26, 2024",OKC @ NOP,W,15,0,2,0.0,0,1,0.0,0,0,0.0,1,5,6,1,1,0,0,2,0,1,1,OKC,NOP,OKC,107,,,7,6,1,7
Jaylin Williams,F,22023,1631119,22300599,"JAN 20, 2024",OKC @ MIN,W,12,2,3,0.667,1,2,0.5,0,0,0.0,0,1,1,0,0,2,1,1,5,2,1,OKC,MIN,OKC,102,,,6,6,5,1
Jaylin Williams,F,22023,1631119,22300522,"JAN 10, 2024",OKC @ MIA,W,12,1,2,0.5,1,2,0.5,0,0,0.0,0,2,2,4,0,0,0,2,3,3,1,OKC,MIA,OKC,128,,,9,5,7,6
Jaylin Williams,F,22023,1631119,22300467,"JAN 03, 2024",OKC @ ATL,L,15,1,2,0.5,1,2,0.5,0,0,0.0,0,3,3,2,2,0,0,4,3,-10,1,OKC,ATL,OKC,138,,,8,6,5,5
Jaylin Williams,F,22023,1631119,22300462,"JAN 02, 2024",OKC vs. BOS,W,8,2,4,0.5,1,3,0.333,0,0,0.0,0,2,2,1,0,1,0,0,5,4,1,OKC,OKC,BOS,127,,,8,7,6,3
Jaylin Williams,F,22023,1631119,22300447,"DEC 31, 2023",OKC vs. BKN,W,7,1,3,0.333,0,1,0.0,1,1,1.0,1,2,3,2,0,1,0,1,3,-2,1,OKC,OKC,BKN,124,,,8,6,5,5
Jaylin Williams,F,22023,1631119,22300435,"DEC 29, 2023",OKC @ DEN,W,17,0,2,0.0,0,2,0.0,0,0,0.0,0,8,8,4,1,1,0,3,0,14,1,OKC,DEN,OKC,119,,,12,8,4,12
Jaylin Williams,F,22023,1631119,22300411,"DEC 26, 2023",OKC vs. MIN,W,5,0,0,0.0,0,0,0.0,0,0,0.0,0,1,1,1,0,1,0,0,0,1,1,OKC,OKC,MIN,129,,,2,1,1,2
Jaylin Williams,F,22023,1631119,22301212,"DEC 06, 2023",OKC @ HOU,L,12,0,4,0.0,0,2,0.0,2,2,1.0,0,0,0,0,0,0,0,1,2,5,1,OKC,HOU,OKC,101,,,2,2,2,0
Jaylin Williams,F,22023,1631119,22300271,"NOV 30, 2023",OKC vs. LAL,W,7,1,2,0.5,1,2,0.5,0,0,0.0,0,2,2,1,0,0,0,0,3,-4,1,OKC,OKC,LAL,133,,,6,5,4,3
Jaylin Williams,F,22023,1631119,22300234,"NOV 22, 2023",OKC vs. CHI,W,15,0,2,0.0,0,1,0.0,0,0,0.0,1,3,4,0,0,0,0,3,0,-2,1,OKC,OKC,CHI,116,,,4,4,0,4
Jaylin Williams,F,22023,1631119,22300207,"NOV 18, 2023",OKC @ GSW,W,6,1,1,1.0,0,0,0.0,0,0,0.0,0,2,2,0,0,0,0,0,2,-9,1,OKC,GSW,OKC,130,,,4,4,2,2
Jaylin Williams,F,22023,1631119,22300201,"NOV 16, 2023",OKC @ GSW,W,4,1,2,0.5,0,1,0.0,0,0,0.0,0,3,3,1,0,0,0,0,2,1,1,OKC,GSW,OKC,128,,,6,5,3,4
Jaylin Williams,F,22023,1631119,22300021,"NOV 14, 2023",OKC vs. SAS,W,18,1,7,0.143,1,4,0.25,0,0,0.0,0,4,4,2,2,0,0,2,3,6,1,OKC,OKC,SAS,123,,,9,7,5,6
Jaylin Williams,F,22023,1631119,22300581,"JAN 18, 2024",OKC @ UTA,W,11,0,1,0.0,0,1,0.0,0,0,0.0,1,1,2,0,2,1,1,2,0,2,1,OKC,UTA,OKC,134,,,2,2,0,2
Jake LaRavia,F,22023,1631222,22300355,"DEC 18, 2023",MEM @ OKC,L,12,1,4,0.25,1,4,0.25,0,0,0.0,2,1,3,0,0,0,0,0,3,9,1,MEM,OKC,MEM,97,,,6,6,3,3
Jake LaRavia,F,22023,1631222,22300332,"DEC 15, 2023",MEM vs. HOU,L,10,1,2,0.5,0,1,0.0,0,0,0.0,0,0,0,1,0,0,1,4,2,-6,1,MEM,MEM,HOU,96,,,3,2,3,1
Jake LaRavia,F,22023,1631222,22300314,"DEC 13, 2023",MEM @ HOU,L,15,2,6,0.333,0,3,0.0,0,0,0.0,0,0,0,2,0,0,1,3,4,-14,1,MEM,HOU,MEM,104,,,6,4,6,2
Jake LaRavia,F,22023,1631222,22300537,"JAN 12, 2024",MEM vs. LAC,L,20,5,10,0.5,2,4,0.5,0,0,0.0,2,2,4,1,0,1,0,4,12,5,1,MEM,MEM,LAC,119,,,17,16,13,5
Jake LaRavia,F,22023,1631222,22300515,"JAN 09, 2024",MEM @ DAL,W,2,0,1,0.0,0,0,0.0,0,0,0.0,0,1,1,0,0,0,0,0,0,-3,1,MEM,DAL,MEM,120,,,1,1,0,1
Jake LaRavia,F,22023,1631222,22300125,"NOV 01, 2023",MEM @ UTA,L,9,2,4,0.5,0,2,0.0,0,0,0.0,0,0,0,0,0,0,0,0,4,3,1,MEM,UTA,MEM,109,,,4,4,4,0
Jake LaRavia,F,22023,1631222,22300106,"OCT 30, 2023",MEM vs. DAL,L,6,0,1,0.0,0,1,0.0,0,0,0.0,0,0,0,0,0,0,0,3,0,-9,1,MEM,MEM,DAL,110,,,0,0,0,0
Jake LaRavia,F,22023,1631222,22300089,"OCT 28, 2023",MEM @ WAS,L,16,2,9,0.222,1,5,0.2,0,0,0.0,0,1,1,1,0,0,0,0,5,-11,1,MEM,WAS,MEM,106,,,7,6,6,2
Jake LaRavia,F,22023,1631222,22300078,"OCT 27, 2023",MEM vs. DEN,L,16,2,3,0.667,1,2,0.5,1,2,0.5,3,2,5,0,0,0,2,1,6,6,1,MEM,MEM,DEN,104,,,11,11,6,5
Jake LaRavia,F,22023,1631222,22300071,"OCT 25, 2023",MEM vs. NOP,L,15,1,3,0.333,0,2,0.0,0,0,0.0,0,2,2,1,1,0,0,4,2,-11,1,MEM,MEM,NOP,104,,,5,4,3,3
Jake LaRavia,F,22023,1631222,22300544,"JAN 13, 2024",MEM vs. NYK,L,1,0,0,0.0,0,0,0.0,2,2,1.0,0,0,0,0,0,0,0,0,2,-2,1,MEM,MEM,NYK,94,,,2,2,2,0
Nate Williams,G,22023,1631466,22300754,"FEB 10, 2024",HOU @ ATL,L,9,4,6,0.667,0,0,0.0,0,2,0.0,2,0,2,0,0,0,0,3,8,2,1,HOU,ATL,HOU,113,,,10,10,8,2
Nate Williams,G,22023,1631466,22300603,"JAN 21, 2024",HOU vs. BOS,L,19,2,7,0.286,1,1,1.0,0,0,0.0,2,1,3,0,0,0,0,1,5,3,1,HOU,HOU,BOS,107,,,8,8,5,3
Nate Williams,G,22023,1631466,22300555,"JAN 15, 2024",HOU @ PHI,L,5,0,2,0.0,0,0,0.0,2,2,1.0,1,0,1,1,1,0,1,1,2,10,1,HOU,PHI,HOU,115,,,4,3,3,2
Nate Williams,G,22023,1631466,22300542,"JAN 13, 2024",HOU @ BOS,L,9,2,3,0.667,0,0,0.0,1,1,1.0,2,0,2,0,0,0,0,1,5,1,1,HOU,BOS,HOU,113,,,7,7,5,2
Nate Williams,G,22023,1631466,22300263,"NOV 29, 2023",HOU @ DEN,L,6,1,2,0.5,0,0,0.0,0,0,0.0,0,0,0,1,0,0,0,1,2,6,1,HOU,DEN,HOU,124,,,3,2,3,1
Nate Williams,G,22023,1631466,22300231,"NOV 22, 2023",HOU vs. MEM,W,3,1,2,0.5,0,0,0.0,0,0,0.0,0,0,0,0,0,0,0,1,2,-4,1,HOU,HOU,MEM,111,,,2,2,2,0
Nate Williams,G,22023,1631466,22300163,"NOV 08, 2023",HOU vs. LAL,W,8,2,4,0.5,0,1,0.0,1,2,0.5,0,0,0,1,1,0,0,0,5,5,1,HOU,HOU,LAL,128,,,6,5,6,1
Nate Williams,G,22023,1631466,22300066,"OCT 25, 2023",HOU @ ORL,L,5,2,3,0.667,0,1,0.0,0,0,0.0,0,0,0,0,0,0,0,0,4,-9,1,HOU,ORL,HOU,86,,,4,4,4,0
Vasilije Micic,G,22023,203995,22300751,"FEB 10, 2024",CHA vs. MEM,W,26,8,13,0.615,2,3,0.667,0,0,0.0,0,1,1,9,0,0,3,1,18,14,1,CHA,CHA,MEM,115,,,28,19,27,10
Vasilije Micic,G,22023,203995,22300682,"JAN 31, 2024",OKC vs. DEN,W,17,4,8,0.5,1,3,0.333,3,5,0.6,0,2,2,5,0,0,2,0,12,14,1,OKC,OKC,DEN,105,,,19,14,17,7
Vasilije Micic,G,22023,203995,22300622,"JAN 24, 2024",OKC @ SAS,W,14,1,2,0.5,0,1,0.0,0,0,0.0,0,1,1,3,1,0,3,0,2,10,1,OKC,SAS,OKC,140,,,6,3,5,4
Vasilije Micic,G,22023,203995,22300617,"JAN 23, 2024",OKC vs. POR,W,7,0,1,0.0,0,0,0.0,1,2,0.5,0,0,0,0,0,0,1,0,1,-8,1,OKC,OKC,POR,111,,,1,1,1,0
Vasilije Micic,G,22023,203995,22300481,"JAN 05, 2024",OKC @ BKN,L,12,3,4,0.75,0,1,0.0,0,0,0.0,0,0,0,3,1,1,0,0,6,1,1,OKC,BKN,OKC,115,,,9,6,9,3
Vasilije Micic,G,22023,203995,22300302,"DEC 11, 2023",OKC vs. UTA,W,16,1,5,0.2,0,3,0.0,0,0,0.0,0,1,1,5,1,0,0,0,2,8,1,OKC,OKC,UTA,134,,,8,3,7,6
Vasilije Micic,G,22023,203995,22300215,"NOV 19, 2023",OKC @ POR,W,6,0,1,0.0,0,0,0.0,0,0,0.0,0,0,0,1,0,0,2,0,0,3,1,OKC,POR,OKC,134,,,1,0,1,1
Vasilije Micic,G,22023,203995,22300724,"FEB 06, 2024",OKC @ UTA,L,11,0,1,0.0,0,1,0.0,0,0,0.0,0,1,1,1,0,0,3,0,0,-2,1,OKC,UTA,OKC,117,,,2,1,1,2
Vasilije Micic,G,22023,203995,22300710,"FEB 04, 2024",OKC vs. TOR,W,14,1,4,0.25,1,3,0.333,0,0,0.0,0,1,1,5,0,0,0,0,3,2,1,OKC,OKC,TOR,135,,,9,4,8,6
Vasilije Micic,G,22023,203995,22300695,"FEB 02, 2024",OKC vs. CHA,W,14,1,2,0.5,0,1,0.0,0,0,0.0,0,0,0,4,0,0,3,0,2,5,1,OKC,OKC,CHA,126,,,6,2,6,4
Vasilije Micic,G,22023,203995,22300568,"JAN 16, 2024",OKC @ LAC,L,11,3,4,0.75,0,1,0.0,1,1,1.0,0,1,1,2,0,0,0,0,7,8,1,OKC,LAC,OKC,117,,,10,8,9,3
Vasilije Micic,G,22023,203995,22300565,"JAN 15, 2024",OKC @ LAL,L,15,2,4,0.5,2,2,1.0,0,0,0.0,0,1,1,1,0,0,0,2,6,4,1,OKC,LAL,OKC,105,,,8,7,7,2
Vasilije Micic,G,22023,203995,22300546,"JAN 13, 2024",OKC vs. ORL,W,11,3,5,0.6,1,2,0.5,0,0,0.0,0,2,2,1,1,0,1,1,7,0,1,OKC,OKC,ORL,112,,,10,9,8,3
Vasilije Micic,G,22023,203995,22300529,"JAN 11, 2024",OKC vs. POR,W,9,0,0,0.0,0,0,0.0,2,2,1.0,0,1,1,2,0,0,0,0,2,8,1,OKC,OKC,POR,139,,,5,3,4,3
Vasilije Micic,G,22023,203995,22300355,"DEC 18, 2023",OKC vs. MEM,W,7,0,1,0.0,0,1,0.0,0,0,0.0,0,0,0,0,0,1,1,0,0,-10,1,OKC,OKC,MEM,116,,,0,0,0,0
Vasilije Micic,G,22023,203995,22300005,"NOV 03, 2023",OKC vs. GSW,L,12,2,5,0.4,1,2,0.5,0,0,0.0,0,1,1,3,0,0,0,1,5,-2,1,OKC,OKC,GSW,139,,,9,6,8,4
Vasilije Micic,G,22023,203995,22300095,"OCT 29, 2023",OKC vs. DEN,L,14,1,3,0.333,0,2,0.0,0,0,0.0,0,0,0,3,0,0,2,1,2,-9,1,OKC,OKC,DEN,95,,,5,2,5,3
Vasilije Micic,G,22023,203995,22300081,"OCT 27, 2023",OKC @ CLE,W,6,1,1,1.0,1,1,1.0,0,0,0.0,0,0,0,1,0,0,2,0,3,2,1,OKC,CLE,OKC,108,,,4,3,4,1
Vasilije Micic,G,22023,203995,22300664,"JAN 29, 2024",OKC vs. MIN,L,4,0,1,0.0,0,1,0.0,0,0,0.0,0,1,1,0,0,0,1,0,0,-1,1,OKC,OKC,MIN,101,,,1,1,0,1
Vasilije Micic,G,22023,203995,22300640,"JAN 26, 2024",OKC @ NOP,W,17,1,2,0.5,0,0,0.0,1,1,1.0,0,2,2,1,0,0,2,0,3,12,1,OKC,NOP,OKC,107,,,6,5,4,3
Vasilije Micic,G,22023,203995,22300599,"JAN 20, 2024",OKC @ MIN,W,8,0,2,0.0,0,0,0.0,0,0,0.0,0,0,0,0,0,0,0,0,0,-10,1,OKC,MIN,OKC,102,,,0,0,0,0
Vasilije Micic,G,22023,203995,22300522,"JAN 10, 2024",OKC @ MIA,W,15,2,2,1.0,0,0,0.0,0,0,0.0,0,1,1,5,1,0,0,1,4,16,1,OKC,MIA,OKC,128,,,10,5,9,6
Vasilije Micic,G,22023,203995,22300462,"JAN 02, 2024",OKC vs. BOS,W,11,1,5,0.2,1,4,0.25,0,0,0.0,0,1,1,5,0,0,0,2,3,4,1,OKC,OKC,BOS,127,,,9,4,8,6
Vasilije Micic,G,22023,203995,22300447,"DEC 31, 2023",OKC vs. BKN,W,12,1,1,1.0,0,0,0.0,0,0,0.0,1,2,3,4,1,0,0,4,2,6,1,OKC,OKC,BKN,124,,,9,5,6,7
Vasilije Micic,G,22023,203995,22300435,"DEC 29, 2023",OKC @ DEN,W,14,1,4,0.25,0,3,0.0,0,0,0.0,0,1,1,2,0,1,0,2,2,4,1,OKC,DEN,OKC,119,,,5,3,4,3
Vasilije Micic,G,22023,203995,22300411,"DEC 26, 2023",OKC vs. MIN,W,16,1,7,0.143,0,4,0.0,0,0,0.0,0,0,0,4,2,0,1,3,2,7,1,OKC,OKC,MIN,129,,,6,2,6,4
Vasilije Micic,G,22023,203995,22300234,"NOV 22, 2023",OKC vs. CHI,W,11,1,4,0.25,0,3,0.0,0,0,0.0,0,0,0,2,0,0,2,0,2,-2,1,OKC,OKC,CHI,116,,,4,2,4,2
Vasilije Micic,G,22023,203995,22300207,"NOV 18, 2023",OKC @ GSW,W,8,1,1,1.0,0,0,0.0,0,0,0.0,0,0,0,1,0,0,0,0,2,-1,1,OKC,GSW,OKC,130,,,3,2,3,1
Vasilije Micic,G,22023,203995,22300201,"NOV 16, 2023",OKC @ GSW,W,21,1,5,0.2,1,3,0.333,2,2,1.0,0,2,2,7,0,0,0,3,5,18,1,OKC,GSW,OKC,128,,,14,7,12,9
Vasilije Micic,G,22023,203995,22300021,"NOV 14, 2023",OKC vs. SAS,W,19,2,4,0.5,2,3,0.667,2,4,0.5,0,1,1,4,1,0,2,1,8,16,1,OKC,OKC,SAS,123,,,13,9,12,5
Vasilije Micic,G,22023,203995,22300581,"JAN 18, 2024",OKC @ UTA,W,9,2,2,1.0,0,0,0.0,2,2,1.0,0,0,0,1,0,0,1,1,6,7,1,OKC,UTA,OKC,134,,,7,6,7,1
Richaun Holmes,F,22023,1626158,22300385,"DEC 22, 2023",DAL @ HOU,L,22,7,12,0.583,0,0,0.0,2,3,0.667,5,3,8,1,1,0,1,2,16,10,1,DAL,HOU,DAL,96,,,25,24,17,9
Richaun Holmes,F,22023,1626158,22300356,"DEC 18, 2023",DAL @ DEN,L,7,1,5,0.2,0,0,0.0,0,0,0.0,2,3,5,0,0,0,0,0,2,0,1,DAL,DEN,DAL,104,,,7,7,2,5
Richaun Holmes,F,22023,1626158,22300321,"DEC 14, 2023",DAL vs. MIN,L,3,0,0,0.0,0,0,0.0,0,0,0.0,0,0,0,0,0,0,0,0,0,-4,1,DAL,DAL,MIN,101,,,0,0,0,0
Richaun Holmes,F,22023,1626158,22300680,"JAN 31, 2024",DAL @ MIN,L,30,4,6,0.667,0,0,0.0,3,3,1.0,4,6,10,3,0,2,0,4,11,-21,1,DAL,MIN,DAL,82,,,24,21,14,13
Richaun Holmes,F,22023,1626158,22300666,"JAN 29, 2024",DAL vs. ORL,W,3,2,2,1.0,0,0,0.0,0,0,0.0,0,1,1,0,0,0,1,2,4,1,1,DAL,DAL,ORL,131,,,5,5,4,1
Richaun Holmes,F,22023,1626158,22300651,"JAN 27, 2024",DAL vs. SAC,L,8,0,1,0.0,0,0,0.0,0,0,0.0,0,0,0,0,1,0,1,3,0,0,1,DAL,DAL,SAC,115,,,0,0,0,0
Richaun Holmes,F,22023,1626158,22300515,"JAN 09, 2024",DAL vs. MEM,L,3,0,0,0.0,0,0,0.0,0,0,0.0,1,0,1,1,0,0,0,0,0,0,1,DAL,DAL,MEM,103,,,2,1,1,2
Richaun Holmes,F,22023,1626158,22300306,"DEC 12, 2023",DAL vs. LAL,W,15,1,3,0.333,0,0,0.0,2,3,0.667,3,4,7,2,0,0,2,3,4,-4,1,DAL,DAL,LAL,127,,,13,11,6,9
Richaun Holmes,F,22023,1626158,22301213,"DEC 06, 2023",DAL vs. UTA,W,6,1,1,1.0,0,0,0.0,0,0,0.0,0,0,0,0,0,1,1,0,2,4,1,DAL,DAL,UTA,147,,,2,2,2,0
Richaun Holmes,F,22023,1626158,22300287,"DEC 02, 2023",DAL vs. OKC,L,5,0,0,0.0,0,0,0.0,1,2,0.5,0,1,1,0,0,0,0,0,1,-9,1,DAL,DAL,OKC,120,,,2,2,1,1
Richaun Holmes,F,22023,1626158,22300277,"DEC 01, 2023",DAL vs. MEM,L,18,2,4,0.5,0,0,0.0,1,2,0.5,3,4,7,2,1,2,1,1,5,5,1,DAL,DAL,MEM,94,,,14,12,7,9
Richaun Holmes,F,22023,1626158,22300059,"NOV 28, 2023",DAL vs. HOU,W,13,1,1,1.0,0,0,0.0,0,0,0.0,0,3,3,0,0,0,2,4,2,2,1,DAL,DAL,HOU,121,,,5,5,2,3
Richaun Holmes,F,22023,1626158,22300244,"NOV 25, 2023",DAL @ LAC,L,21,0,4,0.0,0,0,0.0,0,2,0.0,2,3,5,1,0,2,0,3,0,-6,1,DAL,LAC,DAL,88,,,6,5,1,6
Richaun Holmes,F,22023,1626158,22300238,"NOV 22, 2023",DAL @ LAL,W,23,1,2,0.5,0,0,0.0,2,4,0.5,3,7,10,1,0,1,0,3,4,3,1,DAL,LAL,DAL,104,,,15,14,5,11
Richaun Holmes,F,22023,1626158,22300192,"NOV 15, 2023",DAL @ WAS,W,2,0,1,0.0,0,0,0.0,0,0,0.0,0,0,0,0,0,0,1,0,0,-5,1,DAL,WAS,DAL,130,,,0,0,0,0
Richaun Holmes,F,22023,1626158,22300022,"NOV 14, 2023",DAL @ NOP,L,12,3,6,0.5,0,0,0.0,0,0,0.0,3,4,7,0,0,0,1,2,6,8,1,DAL,NOP,DAL,110,,,13,13,6,7
Richaun Holmes,F,22023,1626158,22300183,"NOV 12, 2023",DAL @ NOP,W,4,1,1,1.0,0,0,0.0,0,0,0.0,0,1,1,0,0,0,0,1,2,-8,1,DAL,NOP,DAL,136,,,3,3,2,1
Richaun Holmes,F,22023,1626158,22300715,"FEB 05, 2024",DAL @ PHI,W,5,0,0,0.0,0,0,0.0,0,0,0.0,0,1,1,2,0,0,0,0,0,0,1,DAL,PHI,DAL,118,,,3,1,2,3
Richaun Holmes,F,22023,1626158,22300634,"JAN 26, 2024",DAL @ ATL,W,14,2,2,1.0,0,0,0.0,0,0,0.0,1,2,3,1,0,1,0,2,4,-3,1,DAL,ATL,DAL,148,,,8,7,5,4
Richaun Holmes,F,22023,1626158,22300625,"JAN 24, 2024",DAL vs. PHX,L,5,2,2,1.0,0,0,0.0,0,0,0.0,2,0,2,0,0,0,0,0,4,0,1,DAL,DAL,PHX,107,,,6,6,4,2
Richaun Holmes,F,22023,1626158,22300457,"JAN 01, 2024",DAL @ UTA,L,7,1,1,1.0,0,0,0.0,0,0,0.0,0,1,1,0,0,0,0,0,2,-13,1,DAL,UTA,DAL,86,,,3,3,2,1
Richaun Holmes,F,22023,1626158,22300212,"NOV 19, 2023",DAL vs. SAC,L,5,3,3,1.0,0,0,0.0,1,2,0.5,2,0,2,0,0,0,0,1,7,5,1,DAL,DAL,SAC,113,,,9,9,7,2
Richaun Holmes,F,22023,1626158,22300168,"NOV 08, 2023",DAL vs. TOR,L,7,1,2,0.5,0,0,0.0,0,0,0.0,2,1,3,1,0,0,1,2,2,1,1,DAL,DAL,TOR,116,,,6,5,3,4
Devonte' Graham,G,22023,1628984,22300571,"JAN 17, 2024",SAS @ BOS,L,5,0,2,0.0,0,2,0.0,0,0,0.0,0,1,1,0,0,0,0,0,0,2,1,SAS,BOS,SAS,95,,,1,1,0,1
Devonte' Graham,G,22023,1628984,22300541,"JAN 12, 2024",SAS vs. CHA,W,10,3,5,0.6,2,4,0.5,0,0,0.0,0,0,0,2,1,0,0,1,8,2,1,SAS,SAS,CHA,127,,,10,8,10,2
Devonte' Graham,G,22023,1628984,22300448,"DEC 31, 2023",SAS vs. BOS,L,8,3,4,0.75,2,2,1.0,1,1,1.0,1,1,2,1,0,0,1,0,9,4,1,SAS,SAS,BOS,101,,,12,11,10,3
Devonte' Graham,G,22023,1628984,22300021,"NOV 14, 2023",SAS @ OKC,L,17,1,3,0.333,0,2,0.0,2,3,0.667,0,1,1,7,0,0,2,2,4,5,1,SAS,OKC,SAS,87,,,12,5,11,8
Devonte' Graham,G,22023,1628984,22300146,"NOV 06, 2023",SAS @ IND,L,12,0,2,0.0,0,1,0.0,2,2,1.0,1,0,1,1,2,1,0,0,2,-9,1,SAS,IND,SAS,111,,,4,3,3,2
Devonte' Graham,G,22023,1628984,22300252,"NOV 26, 2023",SAS @ DEN,L,7,1,2,0.5,0,1,0.0,0,0,0.0,0,0,0,3,0,0,0,0,2,8,1,SAS,DEN,SAS,120,,,5,2,5,3
Devonte' Graham,G,22023,1628984,22300622,"JAN 24, 2024",SAS vs. OKC,L,5,1,2,0.5,1,2,0.5,0,0,0.0,0,2,2,0,0,0,0,0,3,4,1,SAS,SAS,OKC,114,,,5,5,3,2
Devonte' Graham,G,22023,1628984,22300398,"DEC 23, 2023",SAS @ DAL,L,8,0,3,0.0,0,2,0.0,0,0,0.0,0,5,5,0,0,0,0,0,0,16,1,SAS,DAL,SAS,119,,,5,5,0,5
Devonte' Graham,G,22023,1628984,22300345,"DEC 17, 2023",SAS vs. NOP,L,7,2,3,0.667,2,3,0.667,1,2,0.5,0,0,0,2,0,0,0,1,7,2,1,SAS,SAS,NOP,110,,,9,7,9,2
Devonte' Graham,G,22023,1628984,22300331,"DEC 15, 2023",SAS vs. LAL,W,10,0,2,0.0,0,1,0.0,0,0,0.0,0,1,1,3,0,0,0,0,0,-8,1,SAS,SAS,LAL,129,,,4,1,3,4
Jaden Springer,G,22023,1630531,22300727,"FEB 07, 2024",PHI vs. GSW,L,23,3,9,0.333,0,3,0.0,2,2,1.0,2,2,4,1,2,1,1,2,8,-11,1,PHI,PHI,GSW,104,,,13,12,9,5
Jaden Springer,G,22023,1630531,22300715,"FEB 05, 2024",PHI vs. DAL,L,21,3,7,0.429,0,2,0.0,2,2,1.0,1,4,5,4,3,0,1,1,8,-5,1,PHI,PHI,DAL,102,,,17,13,12,9
Jaden Springer,G,22023,1630531,22300698,"FEB 03, 2024",PHI vs. BKN,L,26,4,7,0.571,0,1,0.0,3,3,1.0,3,2,5,3,1,0,1,1,11,-7,1,PHI,PHI,BKN,121,,,19,16,14,8
Jaden Springer,G,22023,1630531,22300686,"FEB 01, 2024",PHI @ UTA,W,19,1,4,0.25,1,2,0.5,0,0,0.0,0,1,1,2,1,0,0,3,3,-4,1,PHI,UTA,PHI,127,,,6,4,5,3
Jaden Springer,G,22023,1630531,22300668,"JAN 29, 2024",PHI @ POR,L,8,2,4,0.5,1,1,1.0,3,4,0.75,1,1,2,0,1,0,2,1,8,0,1,PHI,POR,PHI,104,,,10,10,8,2
Jaden Springer,G,22023,1630531,22300532,"JAN 12, 2024",PHI vs. SAC,W,3,1,3,0.333,0,0,0.0,0,0,0.0,0,1,1,0,0,0,0,1,2,1,1,PHI,PHI,SAC,112,,,3,3,2,1
Jaden Springer,G,22023,1630531,22300521,"JAN 10, 2024",PHI @ ATL,L,13,1,2,0.5,0,0,0.0,0,0,0.0,0,1,1,0,1,0,0,2,2,-3,1,PHI,ATL,PHI,132,,,3,3,2,1
Jaden Springer,G,22023,1630531,22300495,"JAN 06, 2024",PHI vs. UTA,L,13,0,3,0.0,0,3,0.0,0,0,0.0,1,1,2,2,0,0,0,1,0,-15,1,PHI,PHI,UTA,109,,,4,2,2,4
Jaden Springer,G,22023,1630531,22300483,"JAN 05, 2024",PHI vs. NYK,L,15,1,7,0.143,0,3,0.0,1,2,0.5,1,0,1,1,1,1,0,1,3,-12,1,PHI,PHI,NYK,92,,,5,4,4,2
Jaden Springer,G,22023,1630531,22300459,"JAN 02, 2024",PHI vs. CHI,W,21,2,4,0.5,0,2,0.0,0,0,0.0,2,0,2,2,1,1,2,4,4,-15,1,PHI,PHI,CHI,110,,,8,6,6,4
Jaden Springer,G,22023,1630531,22300415,"DEC 27, 2023",PHI @ ORL,W,1,0,0,0.0,0,0,0.0,0,0,0.0,0,0,0,0,0,0,1,0,0,-3,1,PHI,ORL,PHI,112,,,0,0,0,0
Jaden Springer,G,22023,1630531,22300404,"DEC 25, 2023",PHI @ MIA,L,1,0,0,0.0,0,0,0.0,0,0,0.0,0,0,0,0,0,0,0,0,0,-2,1,PHI,MIA,PHI,113,,,0,0,0,0
Jaden Springer,G,22023,1630531,22300367,"DEC 20, 2023",PHI vs. MIN,W,2,0,0,0.0,0,0,0.0,0,0,0.0,0,0,0,1,0,0,0,0,0,2,1,PHI,PHI,MIN,127,,,1,0,1,1
Jaden Springer,G,22023,1630531,22300335,"DEC 16, 2023",PHI @ CHA,W,12,2,5,0.4,0,0,0.0,2,2,1.0,1,1,2,1,1,0,2,0,6,12,1,PHI,CHA,PHI,135,,,9,8,7,3
Jaden Springer,G,22023,1630531,22300327,"DEC 15, 2023",PHI vs. DET,W,12,4,9,0.444,1,3,0.333,0,0,0.0,1,1,2,3,2,1,0,3,9,0,1,PHI,PHI,DET,124,,,14,11,12,5
Jaden Springer,G,22023,1630531,22300310,"DEC 13, 2023",PHI @ DET,W,7,1,2,0.5,1,1,1.0,2,4,0.5,0,0,0,2,0,0,0,1,5,-12,1,PHI,DET,PHI,129,,,7,5,7,2
Jaden Springer,G,22023,1630531,22300295,"DEC 11, 2023",PHI vs. WAS,W,9,2,5,0.4,0,1,0.0,2,2,1.0,0,0,0,0,2,0,1,3,6,4,1,PHI,PHI,WAS,146,,,6,6,6,0
Jaden Springer,G,22023,1630531,22300232,"NOV 22, 2023",PHI @ MIN,L,8,0,4,0.0,0,2,0.0,0,0,0.0,2,1,3,1,1,0,2,1,0,2,1,PHI,MIN,PHI,99,,,4,3,1,4
Jaden Springer,G,22023,1630531,22300208,"NOV 19, 2023",PHI @ BKN,W,21,3,6,0.5,2,4,0.5,2,2,1.0,2,3,5,2,0,0,0,1,10,-1,1,PHI,BKN,PHI,121,,,17,15,12,7
Jaden Springer,G,22023,1630531,22300148,"NOV 06, 2023",PHI vs. WAS,W,12,0,4,0.0,0,1,0.0,2,4,0.5,1,0,1,0,1,0,1,1,2,5,1,PHI,PHI,WAS,146,,,3,3,2,1
Jaden Springer,G,22023,1630531,22300132,"NOV 04, 2023",PHI vs. PHX,W,11,1,4,0.25,0,1,0.0,0,0,0.0,1,2,3,2,0,1,1,1,2,-6,1,PHI,PHI,PHX,112,,,7,5,4,5
Jaden Springer,G,22023,1630531,22300128,"NOV 02, 2023",PHI vs. TOR,W,9,0,1,0.0,0,0,0.0,0,0,0.0,1,1,2,1,0,0,1,1,0,8,1,PHI,PHI,TOR,114,,,3,2,1,3
Jaden Springer,G,22023,1630531,22300098,"OCT 29, 2023",PHI vs. POR,W,8,1,3,0.333,0,0,0.0,0,0,0.0,1,1,2,2,0,1,1,4,2,-1,1,PHI,PHI,POR,126,,,6,4,4,4
Jaden Springer,G,22023,1630531,22300644,"JAN 27, 2024",PHI @ DEN,L,7,0,0,0.0,0,0,0.0,0,0,0.0,0,1,1,1,0,1,2,3,0,-1,1,PHI,DEN,PHI,105,,,2,1,1,2
Jaden Springer,G,22023,1630531,22300627,"JAN 25, 2024",PHI @ IND,L,15,2,3,0.667,0,0,0.0,4,4,1.0,0,2,2,0,0,0,0,0,8,-3,1,PHI,IND,PHI,122,,,10,10,8,2
Jaden Springer,G,22023,1630531,22300040,"NOV 21, 2023",PHI vs. CLE,L,7,0,1,0.0,0,0,0.0,0,0,0.0,1,0,1,0,0,0,1,2,0,-7,1,PHI,PHI,CLE,119,,,1,1,0,1
Jaden Springer,G,22023,1630531,22300008,"NOV 10, 2023",PHI @ DET,W,5,1,1,1.0,0,0,0.0,0,0,0.0,0,0,0,0,0,0,0,1,2,-6,1,PHI,DET,PHI,114,,,2,2,2,0
Jaden Springer,G,22023,1630531,22300673,"JAN 30, 2024",PHI @ GSW,L,21,4,7,0.571,1,3,0.333,1,1,1.0,0,5,5,2,4,0,1,4,10,8,1,PHI,GSW,PHI,107,,,17,15,12,7
Jaden Springer,G,22023,1630531,22300029,"NOV 17, 2023",PHI @ ATL,W,22,3,7,0.429,0,2,0.0,2,2,1.0,3,0,3,2,1,2,3,3,8,0,1,PHI,ATL,PHI,126,,,13,11,10,5
Jaden Springer,G,22023,1630531,22300194,"NOV 15, 2023",PHI vs. BOS,L,20,4,5,0.8,1,1,1.0,0,0,0.0,0,2,2,0,2,0,2,2,9,20,1,PHI,PHI,BOS,107,,,11,11,9,2
Jaden Springer,G,22023,1630531,22300075,"OCT 26, 2023",PHI @ MIL,L,5,0,1,0.0,0,1,0.0,0,0,0.0,0,0,0,0,0,2,0,1,0,-10,1,PHI,MIL,PHI,117,,,0,0,0,0
Jaden Springer,G,22023,1630531,22300382,"DEC 22, 2023",PHI vs. TOR,W,1,0,0,0.0,0,0,0.0,0,0,0.0,0,0,0,0,0,0,0,0,0,-3,1,PHI,PHI,TOR,121,,,0,0,0,0
Oscar Tshiebwe,F-C,22023,1631131,22300533,"JAN 12, 2024",IND @ ATL,W,4,2,2,1.0,0,0,0.0,0,0,0.0,0,1,1,0,0,0,0,0,4,-2,1,IND,ATL,IND,126,,,5,5,4,1
Oscar Tshiebwe,F-C,22023,1631131,22300338,"DEC 16, 2023",IND @ MIN,L,7,3,6,0.5,0,0,0.0,2,2,1.0,2,2,4,1,0,0,0,0,8,8,1,IND,MIN,IND,109,,,13,12,9,5
Oscar Tshiebwe,F-C,22023,1631131,22300328,"DEC 15, 2023",IND @ WAS,L,4,1,1,1.0,0,0,0.0,0,0,0.0,0,0,0,1,0,0,0,0,2,3,1,IND,WAS,IND,123,,,3,2,3,1
Oscar Tshiebwe,F-C,22023,1631131,22300315,"DEC 13, 2023",IND @ MIL,L,6,0,1,0.0,0,0,0.0,1,2,0.5,0,1,1,0,0,0,0,1,1,4,1,IND,MIL,IND,126,,,2,2,1,1
Oscar Tshiebwe,F-C,22023,1631131,22300564,"JAN 15, 2024",IND @ UTA,L,12,1,5,0.2,0,0,0.0,2,2,1.0,4,2,6,0,2,0,0,0,4,-1,1,IND,UTA,IND,105,,,10,10,4,6
Oscar Tshiebwe,F-C,22023,1631131,22300493,"JAN 06, 2024",IND vs. BOS,L,1,1,1,1.0,0,0,0.0,0,0,0.0,0,0,0,0,0,0,0,0,2,0,1,IND,IND,BOS,101,,,2,2,2,0
Bol Bol,C-F,22023,1629626,22300757,"FEB 10, 2024",PHX @ GSW,L,9,1,2,0.5,0,0,0.0,1,1,1.0,0,2,2,1,0,0,0,0,3,2,1,PHX,GSW,PHX,112,,,6,5,4,3
Bol Bol,C-F,22023,1629626,22300739,"FEB 08, 2024",PHX vs. UTA,W,14,3,5,0.6,0,2,0.0,0,0,0.0,0,1,1,0,0,2,0,3,6,-5,1,PHX,PHX,UTA,129,,,7,7,6,1
Bol Bol,C-F,22023,1629626,22300725,"FEB 06, 2024",PHX vs. MIL,W,17,2,3,0.667,0,1,0.0,0,0,0.0,0,6,6,1,0,1,1,2,4,8,1,PHX,PHX,MIL,114,,,11,10,5,7
Bol Bol,C-F,22023,1629626,22300705,"FEB 04, 2024",PHX @ WAS,W,15,4,7,0.571,0,2,0.0,0,0,0.0,2,5,7,0,1,0,2,0,8,14,1,PHX,WAS,PHX,140,,,15,15,8,7
Bol Bol,C-F,22023,1629626,22300531,"JAN 11, 2024",PHX @ LAL,W,17,2,3,0.667,0,0,0.0,2,2,1.0,2,4,6,2,2,2,0,1,6,9,1,PHX,LAL,PHX,127,,,14,12,8,8
Bol Bol,C-F,22023,1629626,22300489,"JAN 05, 2024",PHX vs. MIA,W,10,2,2,1.0,0,0,0.0,0,1,0.0,1,2,3,1,0,1,0,1,4,0,1,PHX,PHX,MIA,113,,,8,7,5,4
Bol Bol,C-F,22023,1629626,22300473,"JAN 03, 2024",PHX vs. LAC,L,19,6,7,0.857,2,2,1.0,0,0,0.0,3,2,5,2,1,0,2,2,14,8,1,PHX,PHX,LAC,122,,,21,19,16,7
Bol Bol,C-F,22023,1629626,22300456,"JAN 01, 2024",PHX vs. POR,W,20,4,6,0.667,1,2,0.5,2,2,1.0,2,7,9,1,0,0,2,5,11,10,1,PHX,PHX,POR,109,,,21,20,12,10
Bol Bol,C-F,22023,1629626,22300418,"DEC 27, 2023",PHX @ HOU,W,2,0,0,0.0,0,0,0.0,0,0,0.0,0,0,0,0,0,2,0,0,0,-2,1,PHX,HOU,PHX,129,,,0,0,0,0
Bol Bol,C-F,22023,1629626,22300387,"DEC 22, 2023",PHX @ SAC,L,3,1,2,0.5,0,0,0.0,0,0,0.0,1,0,1,0,0,0,0,0,2,4,1,PHX,SAC,PHX,105,,,3,3,2,1
Bol Bol,C-F,22023,1629626,22300333,"DEC 15, 2023",PHX vs. NYK,L,2,1,1,1.0,0,0,0.0,0,0,0.0,0,0,0,0,0,0,0,0,2,2,1,PHX,PHX,NYK,122,,,2,2,2,0
Bol Bol,C-F,22023,1629626,22300162,"NOV 08, 2023",PHX @ CHI,W,0,0,0,0.0,0,0,0.0,0,0,0.0,0,0,0,0,0,0,0,0,0,0,1,PHX,CHI,PHX,116,,,0,0,0,0
Bol Bol,C-F,22023,1629626,22300140,"NOV 05, 2023",PHX @ DET,W,3,1,1,1.0,0,0,0.0,0,0,0.0,0,0,0,0,0,0,0,0,2,-5,1,PHX,DET,PHX,120,,,2,2,2,0
Bol Bol,C-F,22023,1629626,22300094,"OCT 28, 2023",PHX vs. UTA,W,4,0,0,0.0,0,0,0.0,0,0,0.0,0,1,1,0,0,1,2,0,0,-4,1,PHX,PHX,UTA,126,,,1,1,0,1
Bol Bol,C-F,22023,1629626,22300308,"DEC 12, 2023",PHX vs. GSW,W,5,0,1,0.0,0,1,0.0,0,0,0.0,0,2,2,0,0,0,0,1,0,-16,1,PHX,PHX,GSW,119,,,2,2,0,2
Bol Bol,C-F,22023,1629626,22301228,"DEC 08, 2023",PHX vs. SAC,L,1,0,0,0.0,0,0,0.0,0,0,0.0,0,0,0,0,0,0,0,0,0,4,1,PHX,PHX,SAC,106,,,0,0,0,0
Kris Murray,F,22023,1631200,22300758,"FEB 10, 2024",POR vs. NOP,L,22,1,2,0.5,1,1,1.0,0,0,0.0,0,4,4,2,1,0,0,0,3,8,1,POR,POR,NOP,75,,,9,7,5,6
Kris Murray,F,22023,1631200,22300712,"FEB 04, 2024",POR @ DEN,L,20,4,7,0.571,0,2,0.0,0,0,0.0,0,2,2,2,1,1,2,2,8,-15,1,POR,DEN,POR,103,,,12,10,10,4
Kris Murray,F,22023,1631200,22300697,"FEB 02, 2024",POR @ DEN,L,14,0,1,0.0,0,0,0.0,0,0,0.0,1,1,2,0,1,0,1,0,0,8,1,POR,DEN,POR,108,,,2,2,0,2
Kris Murray,F,22023,1631200,22300668,"JAN 29, 2024",POR vs. PHI,W,8,0,0,0.0,0,0,0.0,0,0,0.0,0,1,1,0,0,1,0,2,0,2,1,POR,POR,PHI,128,,,1,1,0,1
Kris Murray,F,22023,1631200,22300641,"JAN 26, 2024",POR @ SAS,L,17,1,9,0.111,0,6,0.0,0,1,0.0,0,2,2,0,1,0,0,3,2,-22,1,POR,SAS,POR,98,,,4,4,2,2
Kris Murray,F,22023,1631200,22300605,"JAN 21, 2024",POR @ LAL,L,6,0,0,0.0,0,0,0.0,0,0,0.0,0,1,1,0,0,1,0,0,0,-1,1,POR,LAL,POR,108,,,1,1,0,1
Kris Murray,F,22023,1631200,22300590,"JAN 19, 2024",POR vs. IND,W,14,2,2,1.0,1,1,1.0,0,0,0.0,0,3,3,0,0,0,3,1,5,8,1,POR,POR,IND,118,,,8,8,5,3
Kris Murray,F,22023,1631200,22300399,"DEC 23, 2023",POR @ GSW,L,5,1,1,1.0,0,0,0.0,0,0,0.0,1,1,2,0,1,0,0,2,2,-1,1,POR,GSW,POR,106,,,4,4,2,2
Kris Murray,F,22023,1631200,22300323,"DEC 14, 2023",POR vs. UTA,L,17,2,7,0.286,2,5,0.4,0,0,0.0,3,2,5,3,2,1,0,0,6,24,1,POR,POR,UTA,114,,,14,11,9,8
Kris Murray,F,22023,1631200,22300041,"NOV 21, 2023",POR @ PHX,L,2,1,2,0.5,1,1,1.0,0,0,0.0,0,0,0,0,0,0,0,0,3,3,1,POR,PHX,POR,107,,,3,3,3,0
Kris Murray,F,22023,1631200,22300215,"NOV 19, 2023",POR vs. OKC,L,21,2,4,0.5,1,2,0.5,3,4,0.75,1,1,2,0,1,0,1,3,8,-10,1,POR,POR,OKC,89,,,10,10,8,2
Kris Murray,F,22023,1631200,22300036,"NOV 17, 2023",POR vs. LAL,L,5,0,2,0.0,0,2,0.0,0,0,0.0,1,0,1,0,1,0,0,1,0,-5,1,POR,POR,LAL,95,,,1,1,0,1
Kris Murray,F,22023,1631200,22300199,"NOV 15, 2023",POR vs. CLE,L,17,2,5,0.4,1,3,0.333,0,0,0.0,0,2,2,3,1,0,0,1,5,7,1,POR,POR,CLE,93,,,10,7,8,5
Kris Murray,F,22023,1631200,22300023,"NOV 14, 2023",POR @ UTA,L,3,0,0,0.0,0,0,0.0,0,0,0.0,0,0,0,0,0,0,0,0,0,-1,1,POR,UTA,POR,99,,,0,0,0,0
Kris Murray,F,22023,1631200,22300187,"NOV 12, 2023",POR @ LAL,L,3,0,0,0.0,0,0,0.0,0,0,0.0,0,0,0,0,0,0,0,1,0,4,1,POR,LAL,POR,104,,,0,0,0,0
Kris Murray,F,22023,1631200,22300170,"NOV 08, 2023",POR @ SAC,L,9,0,1,0.0,0,0,0.0,0,0,0.0,0,0,0,0,0,1,0,1,0,-5,1,POR,SAC,POR,118,,,0,0,0,0
Kris Murray,F,22023,1631200,22300098,"OCT 29, 2023",POR @ PHI,L,6,0,1,0.0,0,1,0.0,0,0,0.0,0,0,0,0,1,0,0,1,0,-8,1,POR,PHI,POR,98,,,0,0,0,0
Kris Murray,F,22023,1631200,22300074,"OCT 25, 2023",POR @ LAC,L,5,0,0,0.0,0,0,0.0,0,0,0.0,0,1,1,0,0,0,0,0,0,12,1,POR,LAC,POR,111,,,1,1,0,1
Kris Murray,F,22023,1631200,22300578,"JAN 17, 2024",POR vs. BKN,W,3,0,0,0.0,0,0,0.0,0,0,0.0,0,0,0,0,0,0,1,0,0,-1,1,POR,POR,BKN,103,,,0,0,0,0
Kris Murray,F,22023,1631200,22300538,"JAN 12, 2024",POR @ MIN,L,9,0,1,0.0,0,0,0.0,2,2,1.0,0,0,0,1,1,0,0,0,2,13,1,POR,MIN,POR,91,,,3,2,3,1
Kris Murray,F,22023,1631200,22300514,"JAN 09, 2024",POR @ NYK,L,16,3,10,0.3,0,3,0.0,3,3,1.0,2,1,3,1,1,0,1,0,9,6,1,POR,NYK,POR,80,,,13,12,10,4
Kris Murray,F,22023,1631200,22300498,"JAN 07, 2024",POR @ BKN,W,7,0,2,0.0,0,0,0.0,0,0,0.0,1,2,3,0,0,0,2,1,0,2,1,POR,BKN,POR,134,,,3,3,0,3
Kris Murray,F,22023,1631200,22300487,"JAN 05, 2024",POR @ DAL,L,20,4,8,0.5,2,3,0.667,0,0,0.0,2,2,4,1,2,0,1,0,10,-17,1,POR,DAL,POR,103,,,15,14,11,5
Kris Murray,F,22023,1631200,22300472,"JAN 03, 2024",POR @ DAL,L,15,1,3,0.333,0,1,0.0,0,0,0.0,0,1,1,2,0,0,1,0,2,0,1,POR,DAL,POR,97,,,5,3,4,3
Kris Murray,F,22023,1631200,22300456,"JAN 01, 2024",POR @ PHX,L,19,3,5,0.6,0,2,0.0,0,0,0.0,1,1,2,1,1,1,0,2,6,-11,1,POR,PHX,POR,84,,,9,8,7,3
Kris Murray,F,22023,1631200,22300413,"DEC 26, 2023",POR vs. SAC,W,2,0,0,0.0,0,0,0.0,0,0,0.0,0,0,0,0,0,0,0,0,0,-2,1,POR,POR,SAC,130,,,0,0,0,0
Kris Murray,F,22023,1631200,22301214,"DEC 06, 2023",POR @ GSW,L,21,2,4,0.5,2,4,0.5,0,0,0.0,0,5,5,1,2,0,0,2,6,-1,1,POR,GSW,POR,106,,,12,11,7,6
Kris Murray,F,22023,1631200,22300237,"NOV 22, 2023",POR vs. UTA,W,17,1,5,0.2,0,3,0.0,0,1,0.0,2,0,2,0,1,0,0,0,2,-9,1,POR,POR,UTA,121,,,4,4,2,2
Kris Murray,F,22023,1631200,22300741,"FEB 08, 2024",POR vs. DET,L,28,5,6,0.833,2,2,1.0,0,0,0.0,2,1,3,3,1,1,1,1,12,-5,1,POR,POR,DET,118,,,18,15,15,6
Kris Murray,F,22023,1631200,22300554,"JAN 14, 2024",POR vs. PHX,L,37,5,9,0.556,3,6,0.5,0,1,0.0,0,1,1,3,3,0,3,2,13,-9,1,POR,POR,PHX,116,,,17,14,16,4
Kris Murray,F,22023,1631200,22300529,"JAN 11, 2024",POR @ OKC,L,23,4,10,0.4,1,5,0.2,0,0,0.0,3,2,5,0,1,0,0,0,9,-22,1,POR,OKC,POR,77,,,14,14,9,5
Kris Murray,F,22023,1631200,22301226,"DEC 08, 2023",POR vs. DAL,L,18,2,6,0.333,1,3,0.333,0,0,0.0,1,4,5,0,1,0,0,0,5,7,1,POR,POR,DAL,112,,,10,10,5,5
Chuma Okeke,F,22023,1629643,22300734,"FEB 08, 2024",ORL vs. SAS,W,3,0,1,0.0,0,0,0.0,0,0,0.0,0,0,0,0,0,0,1,1,0,-3,1,ORL,ORL,SAS,127,,,0,0,0,0
Chuma Okeke,F,22023,1629643,22300721,"FEB 06, 2024",ORL @ MIA,L,3,1,2,0.5,0,0,0.0,0,0,0.0,0,0,0,0,0,0,0,0,2,-2,1,ORL,MIA,ORL,95,,,2,2,2,0
Chuma Okeke,F,22023,1629643,22300666,"JAN 29, 2024",ORL @ DAL,L,9,0,1,0.0,0,1,0.0,0,0,0.0,0,0,0,0,0,0,0,2,0,5,1,ORL,DAL,ORL,129,,,0,0,0,0
Chuma Okeke,F,22023,1629643,22300655,"JAN 28, 2024",ORL vs. PHX,W,2,0,1,0.0,0,1,0.0,0,0,0.0,0,0,0,0,0,0,0,0,0,1,1,ORL,ORL,PHX,113,,,0,0,0,0
Chuma Okeke,F,22023,1629643,22300607,"JAN 22, 2024",ORL vs. CLE,L,21,1,6,0.167,1,6,0.167,0,0,0.0,0,1,1,0,0,0,0,1,3,-9,1,ORL,ORL,CLE,99,,,4,4,3,1
Chuma Okeke,F,22023,1629643,22300601,"JAN 21, 2024",ORL vs. MIA,W,3,0,2,0.0,0,2,0.0,0,0,0.0,0,2,2,0,0,0,0,0,0,-4,1,ORL,ORL,MIA,105,,,2,2,0,2
Chuma Okeke,F,22023,1629643,22300585,"JAN 19, 2024",ORL vs. PHI,L,20,3,4,0.75,1,1,1.0,1,2,0.5,0,1,1,0,1,0,1,3,8,-8,1,ORL,ORL,PHI,109,,,9,9,8,1
Chuma Okeke,F,22023,1629643,22300570,"JAN 17, 2024",ORL @ ATL,L,30,3,9,0.333,0,4,0.0,0,0,0.0,3,4,7,1,3,1,1,1,6,-8,1,ORL,ATL,ORL,104,,,14,13,7,8
Chuma Okeke,F,22023,1629643,22300557,"JAN 15, 2024",ORL @ NYK,W,26,5,7,0.714,4,5,0.8,1,1,1.0,2,1,3,0,0,1,0,1,15,-5,1,ORL,NYK,ORL,98,,,18,18,15,3
Chuma Okeke,F,22023,1629643,22300546,"JAN 13, 2024",ORL @ OKC,L,19,2,6,0.333,1,5,0.2,0,0,0.0,1,3,4,2,0,0,0,1,5,-3,1,ORL,OKC,ORL,100,,,11,9,7,6
Chuma Okeke,F,22023,1629643,22300535,"JAN 12, 2024",ORL @ MIA,L,29,6,10,0.6,4,8,0.5,0,0,0.0,2,2,4,2,0,1,1,0,16,-17,1,ORL,MIA,ORL,96,,,22,20,18,6
Chuma Okeke,F,22023,1629643,22300513,"JAN 09, 2024",ORL vs. MIN,L,27,1,10,0.1,1,8,0.125,0,0,0.0,2,8,10,1,0,1,0,2,3,-9,1,ORL,ORL,MIN,92,,,14,13,4,11
Chuma Okeke,F,22023,1629643,22300499,"JAN 07, 2024",ORL vs. ATL,W,38,1,5,0.2,1,5,0.2,0,0,0.0,0,7,7,2,0,0,1,0,3,17,1,ORL,ORL,ATL,117,,,12,10,5,9
Chuma Okeke,F,22023,1629643,22300488,"JAN 05, 2024",ORL @ DEN,W,29,1,3,0.333,1,3,0.333,0,2,0.0,3,4,7,1,1,1,4,1,3,-2,1,ORL,DEN,ORL,122,,,11,10,4,8
Chuma Okeke,F,22023,1629643,22300450,"DEC 31, 2023",ORL @ PHX,L,0,0,0,0.0,0,0,0.0,0,0,0.0,0,0,0,0,0,0,0,0,0,-2,1,ORL,PHX,ORL,107,,,0,0,0,0
Chuma Okeke,F,22023,1629643,22300429,"DEC 29, 2023",ORL vs. NYK,W,12,1,5,0.2,0,4,0.0,0,0,0.0,0,0,0,1,0,0,0,1,2,5,1,ORL,ORL,NYK,117,,,3,2,3,1
Chuma Okeke,F,22023,1629643,22300415,"DEC 27, 2023",ORL vs. PHI,L,15,1,3,0.333,1,2,0.5,0,0,0.0,1,3,4,0,0,1,0,2,3,-2,1,ORL,ORL,PHI,92,,,7,7,3,4
Chuma Okeke,F,22023,1629643,22300366,"DEC 20, 2023",ORL vs. MIA,L,5,2,3,0.667,1,2,0.5,0,0,0.0,0,2,2,1,1,0,0,1,5,14,1,ORL,ORL,MIA,106,,,8,7,6,3
Chuma Okeke,F,22023,1629643,22300344,"DEC 17, 2023",ORL @ BOS,L,2,0,0,0.0,0,0,0.0,0,0,0.0,0,1,1,0,0,0,0,0,0,4,1,ORL,BOS,ORL,97,,,1,1,0,1
Chuma Okeke,F,22023,1629643,22300329,"DEC 15, 2023",ORL @ BOS,L,3,0,1,0.0,0,0,0.0,0,0,0.0,0,0,0,0,0,0,0,0,0,3,1,ORL,BOS,ORL,111,,,0,0,0,0
Chuma Okeke,F,22023,1629643,22301217,"DEC 08, 2023",ORL vs. DET,W,13,1,1,1.0,0,0,0.0,0,0,0.0,0,4,4,0,1,0,1,0,2,4,1,ORL,ORL,DET,123,,,6,6,2,4
Chuma Okeke,F,22023,1629643,22300282,"DEC 02, 2023",ORL @ BKN,L,4,0,2,0.0,0,2,0.0,0,0,0.0,0,0,0,0,0,0,1,0,0,-5,1,ORL,BKN,ORL,101,,,0,0,0,0
Chuma Okeke,F,22023,1629643,22300259,"NOV 29, 2023",ORL vs. WAS,W,5,0,2,0.0,0,1,0.0,0,0,0.0,0,0,0,2,0,0,0,0,0,-1,1,ORL,ORL,WAS,139,,,2,0,2,2
Chuma Okeke,F,22023,1629643,22300038,"NOV 21, 2023",ORL vs. TOR,W,4,2,3,0.667,2,3,0.667,0,0,0.0,0,0,0,0,0,0,0,0,6,-4,1,ORL,ORL,TOR,126,,,6,6,6,0
Chuma Okeke,F,22023,1629643,22300209,"NOV 19, 2023",ORL @ IND,W,8,1,2,0.5,1,1,1.0,0,0,0.0,0,1,1,0,0,0,0,0,3,-15,1,ORL,IND,ORL,128,,,4,4,3,1
Chuma Okeke,F,22023,1629643,22300020,"NOV 14, 2023",ORL @ BKN,L,2,0,0,0.0,0,0,0.0,0,0,0.0,0,0,0,0,0,0,0,0,0,-5,1,ORL,BKN,ORL,104,,,0,0,0,0
Chuma Okeke,F,22023,1629643,22300172,"NOV 09, 2023",ORL vs. ATL,L,2,0,1,0.0,0,1,0.0,0,0,0.0,1,0,1,0,0,0,0,0,0,-1,1,ORL,ORL,ATL,119,,,1,1,0,1
Chuma Okeke,F,22023,1629643,22300134,"NOV 04, 2023",ORL vs. LAL,W,3,0,1,0.0,0,1,0.0,0,0,0.0,1,0,1,1,0,0,0,0,0,3,1,ORL,ORL,LAL,120,,,2,1,1,2
Chuma Okeke,F,22023,1629643,22300114,"OCT 31, 2023",ORL @ LAC,L,4,1,1,1.0,0,0,0.0,0,0,0.0,1,0,1,0,0,0,1,0,2,-1,1,ORL,LAC,ORL,102,,,3,3,2,1
Chuma Okeke,F,22023,1629643,22300066,"OCT 25, 2023",ORL vs. HOU,W,5,0,1,0.0,0,1,0.0,0,0,0.0,0,3,3,0,0,0,0,0,0,9,1,ORL,ORL,HOU,116,,,3,3,0,3
Chuma Okeke,F,22023,1629643,22300476,"JAN 03, 2024",ORL @ SAC,L,27,4,5,0.8,3,4,0.75,0,0,0.0,1,6,7,3,0,1,0,2,11,4,1,ORL,SAC,ORL,135,,,21,18,14,10
Charles Bassey,C-F,22023,1629646,22300278,"DEC 01, 2023",SAS @ NOP,L,19,4,4,1.0,0,0,0.0,0,0,0.0,1,10,11,3,0,3,1,4,8,5,1,SAS,NOP,SAS,106,,,22,19,11,14
Charles Bassey,C-F,22023,1629646,22300235,"NOV 22, 2023",SAS vs. LAC,L,2,0,0,0.0,0,0,0.0,0,0,0.0,0,0,0,0,0,0,3,0,0,-7,1,SAS,SAS,LAC,102,,,0,0,0,0
Charles Bassey,C-F,22023,1629646,22300206,"NOV 18, 2023",SAS vs. MEM,L,4,0,0,0.0,0,0,0.0,0,0,0.0,0,1,1,0,0,0,1,3,0,1,1,SAS,SAS,MEM,108,,,1,1,0,1
Charles Bassey,C-F,22023,1629646,22300021,"NOV 14, 2023",SAS @ OKC,L,17,3,5,0.6,0,0,0.0,0,0,0.0,2,5,7,1,0,0,0,1,6,-3,1,SAS,OKC,SAS,87,,,14,13,7,8
Charles Bassey,C-F,22023,1629646,22300161,"NOV 08, 2023",SAS @ NYK,L,15,3,3,1.0,0,0,0.0,0,0,0.0,1,3,4,1,1,2,0,1,6,-4,1,SAS,NYK,SAS,105,,,11,10,7,5
Charles Bassey,C-F,22023,1629646,22300146,"NOV 06, 2023",SAS @ IND,L,17,5,5,1.0,0,0,0.0,0,0,0.0,2,1,3,1,3,0,1,3,10,-26,1,SAS,IND,SAS,111,,,14,13,11,4
Charles Bassey,C-F,22023,1629646,22300099,"OCT 29, 2023",SAS @ LAC,L,16,3,4,0.75,0,0,0.0,0,0,0.0,1,4,5,1,1,1,0,2,6,9,1,SAS,LAC,SAS,83,,,12,11,7,6
Charles Bassey,C-F,22023,1629646,22300272,"NOV 30, 2023",SAS vs. ATL,L,4,0,0,0.0,0,0,0.0,0,0,0.0,1,0,1,0,0,2,0,3,0,3,1,SAS,SAS,ATL,135,,,1,1,0,1
Charles Bassey,C-F,22023,1629646,22300252,"NOV 26, 2023",SAS @ DEN,L,15,3,5,0.6,0,0,0.0,3,3,1.0,2,4,6,2,0,1,1,3,9,-7,1,SAS,DEN,SAS,120,,,17,15,11,8
Charles Bassey,C-F,22023,1629646,22300051,"NOV 24, 2023",SAS @ GSW,L,7,0,0,0.0,0,0,0.0,0,0,0.0,0,0,0,2,0,1,0,0,0,0,1,SAS,GSW,SAS,112,,,2,0,2,2
Charles Bassey,C-F,22023,1629646,22300223,"NOV 20, 2023",SAS vs. LAC,L,18,1,3,0.333,0,0,0.0,0,0,0.0,4,8,12,3,0,4,3,2,2,3,1,SAS,SAS,LAC,99,,,17,14,5,15
Charles Bassey,C-F,22023,1629646,22300032,"NOV 17, 2023",SAS vs. SAC,L,2,1,1,1.0,0,0,0.0,0,0,0.0,0,1,1,0,0,0,0,0,2,-6,1,SAS,SAS,SAC,120,,,3,3,2,1
Charles Bassey,C-F,22023,1629646,22300184,"NOV 12, 2023",SAS vs. MIA,L,6,1,2,0.5,0,0,0.0,1,2,0.5,3,2,5,1,1,0,1,2,3,-4,1,SAS,SAS,MIA,113,,,9,8,4,6
Charles Bassey,C-F,22023,1629646,22300013,"NOV 10, 2023",SAS vs. MIN,L,11,1,3,0.333,0,1,0.0,0,0,0.0,2,4,6,2,0,2,0,1,2,-4,1,SAS,SAS,MIN,110,,,10,8,4,8
Charles Bassey,C-F,22023,1629646,22300141,"NOV 05, 2023",SAS vs. TOR,L,9,1,1,1.0,0,0,0.0,0,0,0.0,1,1,2,0,0,0,1,1,2,8,1,SAS,SAS,TOR,116,,,4,4,2,2
Charles Bassey,C-F,22023,1629646,22300131,"NOV 02, 2023",SAS @ PHX,W,6,1,1,1.0,0,0,0.0,1,1,1.0,0,1,1,1,1,0,1,0,3,8,1,SAS,PHX,SAS,132,,,5,4,4,2
Charles Bassey,C-F,22023,1629646,22300113,"OCT 31, 2023",SAS @ PHX,W,15,1,2,0.5,0,0,0.0,0,0,0.0,1,2,3,1,0,1,1,4,2,-13,1,SAS,PHX,SAS,115,,,6,5,3,4
Charles Bassey,C-F,22023,1629646,22300083,"OCT 27, 2023",SAS vs. HOU,W,7,0,0,0.0,0,0,0.0,0,0,0.0,1,2,3,0,0,0,0,1,0,-3,1,SAS,SAS,HOU,126,,,3,3,0,3
Charles Bassey,C-F,22023,1629646,22300073,"OCT 25, 2023",SAS vs. DAL,L,13,1,1,1.0,0,0,0.0,0,0,0.0,1,4,5,2,1,0,1,0,2,-6,1,SAS,SAS,DAL,119,,,9,7,4,7
Omer Yurtseven,C,22023,1630209,22300686,"FEB 01, 2024",UTA vs. PHI,L,0,0,0,0.0,0,0,0.0,0,0,0.0,0,0,0,0,0,0,0,0,0,0,1,UTA,UTA,PHI,124,,,0,0,0,0
Omer Yurtseven,C,22023,1630209,22300660,"JAN 29, 2024",UTA @ BKN,L,8,1,4,0.25,0,0,0.0,0,1,0.0,1,0,1,0,0,0,1,2,2,-11,1,UTA,BKN,UTA,114,,,3,3,2,1
Omer Yurtseven,C,22023,1630209,22300628,"JAN 25, 2024",UTA @ WAS,W,1,0,0,0.0,0,0,0.0,0,0,0.0,0,0,0,0,0,0,0,0,0,-3,1,UTA,WAS,UTA,123,,,0,0,0,0
Omer Yurtseven,C,22023,1630209,22300564,"JAN 15, 2024",UTA vs. IND,W,3,0,0,0.0,0,0,0.0,0,0,0.0,0,2,2,0,0,0,0,0,0,7,1,UTA,UTA,IND,132,,,2,2,0,2
Omer Yurtseven,C,22023,1630209,22300540,"JAN 12, 2024",UTA vs. TOR,W,5,2,2,1.0,0,0,0.0,0,0,0.0,2,2,4,0,0,0,0,1,4,9,1,UTA,UTA,TOR,145,,,8,8,4,4
Omer Yurtseven,C,22023,1630209,22300524,"JAN 10, 2024",UTA vs. DEN,W,3,1,1,1.0,0,0,0.0,0,0,0.0,0,2,2,0,0,0,2,0,2,-5,1,UTA,UTA,DEN,124,,,4,4,2,2
Omer Yurtseven,C,22023,1630209,22300479,"JAN 05, 2024",UTA @ BOS,L,12,0,4,0.0,0,2,0.0,0,2,0.0,3,4,7,0,0,0,1,1,0,3,1,UTA,BOS,UTA,97,,,7,7,0,7
Omer Yurtseven,C,22023,1630209,22300457,"JAN 01, 2024",UTA vs. DAL,W,4,0,0,0.0,0,0,0.0,0,0,0.0,0,1,1,0,0,0,0,0,0,1,1,UTA,UTA,DAL,127,,,1,1,0,1
Omer Yurtseven,C,22023,1630209,22300412,"DEC 26, 2023",UTA @ SAS,W,2,0,1,0.0,0,0,0.0,0,0,0.0,0,0,0,0,0,0,0,0,0,-7,1,UTA,SAS,UTA,130,,,0,0,0,0
Omer Yurtseven,C,22023,1630209,22300323,"DEC 14, 2023",UTA @ POR,W,22,2,7,0.286,0,0,0.0,0,0,0.0,3,1,4,1,1,2,2,3,4,-15,1,UTA,POR,UTA,122,,,9,8,5,5
Omer Yurtseven,C,22023,1630209,22300318,"DEC 13, 2023",UTA vs. NYK,W,5,0,1,0.0,0,0,0.0,0,0,0.0,1,2,3,0,0,0,0,0,0,5,1,UTA,UTA,NYK,117,,,3,3,0,3
Omer Yurtseven,C,22023,1630209,22300302,"DEC 11, 2023",UTA @ OKC,L,10,1,2,0.5,0,0,0.0,0,0,0.0,2,3,5,0,0,1,3,3,2,-17,1,UTA,OKC,UTA,120,,,7,7,2,5
Omer Yurtseven,C,22023,1630209,22301213,"DEC 06, 2023",UTA @ DAL,L,21,4,7,0.571,0,0,0.0,0,0,0.0,3,6,9,0,0,0,4,5,8,-35,1,UTA,DAL,UTA,97,,,17,17,8,9
Omer Yurtseven,C,22023,1630209,22300289,"DEC 02, 2023",UTA vs. POR,W,27,4,8,0.5,0,1,0.0,1,1,1.0,4,11,15,4,1,1,1,3,9,10,1,UTA,UTA,POR,118,,,28,24,13,19
Omer Yurtseven,C,22023,1630209,22300270,"NOV 30, 2023",UTA @ MIN,L,14,1,4,0.25,0,1,0.0,0,0,0.0,1,6,7,0,0,1,2,3,2,-4,1,UTA,MIN,UTA,90,,,9,9,2,7
Omer Yurtseven,C,22023,1630209,22300261,"NOV 29, 2023",UTA @ MEM,L,15,2,5,0.4,0,0,0.0,0,0,0.0,2,2,4,1,1,0,2,2,4,-11,1,UTA,MEM,UTA,91,,,9,8,5,5
Omer Yurtseven,C,22023,1630209,22300256,"NOV 27, 2023",UTA vs. NOP,W,22,2,4,0.5,1,2,0.5,2,2,1.0,5,5,10,2,0,2,2,4,7,-1,1,UTA,UTA,NOP,114,,,19,17,9,12
Omer Yurtseven,C,22023,1630209,22300243,"NOV 25, 2023",UTA vs. NOP,W,27,3,6,0.5,0,3,0.0,0,0,0.0,2,5,7,0,1,2,0,0,6,4,1,UTA,UTA,NOP,105,,,13,13,6,7
Omer Yurtseven,C,22023,1630209,22300237,"NOV 22, 2023",UTA @ POR,L,16,1,3,0.333,1,2,0.5,0,0,0.0,0,6,6,1,0,0,2,1,3,-8,1,UTA,POR,UTA,105,,,10,9,4,7
Omer Yurtseven,C,22023,1630209,22300042,"NOV 21, 2023",UTA @ LAL,L,17,8,11,0.727,0,1,0.0,2,3,0.667,4,2,6,1,0,0,0,1,18,-9,1,UTA,LAL,UTA,99,,,25,24,19,7
Omer Yurtseven,C,22023,1630209,22300023,"NOV 14, 2023",UTA vs. POR,W,1,0,0,0.0,0,0,0.0,0,0,0.0,0,0,0,0,0,0,0,0,0,0,1,UTA,UTA,POR,115,,,0,0,0,0
Omer Yurtseven,C,22023,1630209,22300152,"NOV 06, 2023",UTA @ CHI,L,4,1,1,1.0,0,0,0.0,0,0,0.0,0,0,0,0,0,1,0,0,2,5,1,UTA,CHI,UTA,113,,,2,2,2,0
Omer Yurtseven,C,22023,1630209,22300138,"NOV 04, 2023",UTA @ MIN,L,4,0,1,0.0,0,1,0.0,0,0,0.0,0,0,0,1,0,0,0,1,0,-5,1,UTA,MIN,UTA,95,,,1,0,1,1
Omer Yurtseven,C,22023,1630209,22300130,"NOV 02, 2023",UTA vs. ORL,L,8,3,3,1.0,1,1,1.0,0,0,0.0,1,2,3,0,0,0,0,2,7,8,1,UTA,UTA,ORL,113,,,10,10,7,3
Omer Yurtseven,C,22023,1630209,22300125,"NOV 01, 2023",UTA vs. MEM,W,7,1,2,0.5,0,0,0.0,1,2,0.5,1,2,3,1,0,0,1,3,3,-3,1,UTA,UTA,MEM,133,,,7,6,4,4
Omer Yurtseven,C,22023,1630209,22300094,"OCT 28, 2023",UTA @ PHX,L,6,2,3,0.667,0,1,0.0,0,0,0.0,1,3,4,1,0,0,0,0,4,4,1,UTA,PHX,UTA,104,,,9,8,5,5
Omer Yurtseven,C,22023,1630209,22300072,"OCT 25, 2023",UTA vs. SAC,L,2,0,0,0.0,0,0,0.0,0,0,0.0,0,1,1,0,0,0,0,0,0,2,1,UTA,UTA,SAC,114,,,1,1,0,1
Omer Yurtseven,C,22023,1630209,22300739,"FEB 08, 2024",UTA @ PHX,L,2,0,1,0.0,0,0,0.0,0,0,0.0,0,2,2,0,0,1,1,0,0,0,1,UTA,PHX,UTA,115,,,2,2,0,2
Trevelin Queen,G,22023,1630243,22300655,"JAN 28, 2024",ORL vs. PHX,W,2,0,1,0.0,0,1,0.0,0,0,0.0,0,0,0,0,0,0,0,0,0,1,1,ORL,ORL,PHX,113,,,0,0,0,0
Trevelin Queen,G,22023,1630243,22300638,"JAN 26, 2024",ORL @ MEM,L,5,0,1,0.0,0,1,0.0,0,0,0.0,0,0,0,1,0,0,0,0,0,-5,1,ORL,MEM,ORL,106,,,1,0,1,1
Trevelin Queen,G,22023,1630243,22300607,"JAN 22, 2024",ORL vs. CLE,L,14,2,4,0.5,0,1,0.0,4,6,0.667,0,1,1,5,1,0,1,0,8,2,1,ORL,ORL,CLE,99,,,14,9,13,6
Trevelin Queen,G,22023,1630243,22300601,"JAN 21, 2024",ORL vs. MIA,W,3,0,0,0.0,0,0,0.0,0,0,0.0,0,1,1,0,0,0,0,0,0,-4,1,ORL,ORL,MIA,105,,,1,1,0,1
Trevelin Queen,G,22023,1630243,22300585,"JAN 19, 2024",ORL vs. PHI,L,3,1,1,1.0,0,0,0.0,0,0,0.0,0,0,0,0,0,0,0,0,2,0,1,ORL,ORL,PHI,109,,,2,2,2,0
Trevelin Queen,G,22023,1630243,22300546,"JAN 13, 2024",ORL @ OKC,L,17,3,6,0.5,0,3,0.0,1,1,1.0,0,4,4,1,0,3,2,2,7,4,1,ORL,OKC,ORL,100,,,12,11,8,5
Trevelin Queen,G,22023,1630243,22300535,"JAN 12, 2024",ORL @ MIA,L,7,0,1,0.0,0,1,0.0,0,0,0.0,0,1,1,0,0,0,1,0,0,4,1,ORL,MIA,ORL,96,,,1,1,0,1
Trevelin Queen,G,22023,1630243,22300513,"JAN 09, 2024",ORL vs. MIN,L,28,3,9,0.333,3,4,0.75,2,2,1.0,1,2,3,3,1,0,2,1,11,-10,1,ORL,ORL,MIN,92,,,17,14,14,6
Trevelin Queen,G,22023,1630243,22300499,"JAN 07, 2024",ORL vs. ATL,W,6,1,1,1.0,0,0,0.0,0,0,0.0,1,0,1,0,0,0,1,2,2,-3,1,ORL,ORL,ATL,117,,,3,3,2,1
Trevelin Queen,G,22023,1630243,22300488,"JAN 05, 2024",ORL @ DEN,W,31,2,4,0.5,0,1,0.0,1,1,1.0,1,4,5,2,2,1,0,4,5,10,1,ORL,DEN,ORL,122,,,12,10,7,7
Trevelin Queen,G,22023,1630243,22300415,"DEC 27, 2023",ORL vs. PHI,L,1,0,1,0.0,0,1,0.0,0,0,0.0,0,0,0,0,1,0,0,0,0,3,1,ORL,ORL,PHI,92,,,0,0,0,0
Trevelin Queen,G,22023,1630243,22300476,"JAN 03, 2024",ORL @ SAC,L,38,2,7,0.286,0,3,0.0,1,2,0.5,0,2,2,6,2,1,0,5,5,1,1,ORL,SAC,ORL,135,,,13,7,11,8
AJ Green,G,22023,1631260,22300745,"FEB 09, 2024",MIL vs. CHA,W,18,1,9,0.111,1,9,0.111,0,0,0.0,1,3,4,0,1,0,0,3,3,-3,1,MIL,MIL,CHA,120,,,7,7,3,4
AJ Green,G,22023,1631260,22300738,"FEB 08, 2024",MIL vs. MIN,L,22,9,11,0.818,7,8,0.875,2,2,1.0,0,2,2,3,0,0,1,0,27,-7,1,MIL,MIL,MIN,105,,,32,29,30,5
AJ Green,G,22023,1631260,22300725,"FEB 06, 2024",MIL @ PHX,L,13,0,4,0.0,0,4,0.0,0,0,0.0,0,1,1,0,0,0,0,1,0,-4,1,MIL,PHX,MIL,106,,,1,1,0,1
AJ Green,G,22023,1631260,22300711,"FEB 04, 2024",MIL @ UTA,L,22,3,6,0.5,3,6,0.5,1,1,1.0,0,5,5,0,0,0,0,2,10,3,1,MIL,UTA,MIL,108,,,15,15,10,5
AJ Green,G,22023,1631260,22300702,"FEB 03, 2024",MIL @ DAL,W,6,2,2,1.0,1,1,1.0,0,0,0.0,0,0,0,0,0,0,0,0,5,16,1,MIL,DAL,MIL,129,,,5,5,5,0
AJ Green,G,22023,1631260,22300648,"JAN 27, 2024",MIL vs. NOP,W,4,1,3,0.333,1,3,0.333,0,0,0.0,0,1,1,0,0,0,1,1,3,-8,1,MIL,MIL,NOP,141,,,4,4,3,1
AJ Green,G,22023,1631260,22300624,"JAN 24, 2024",MIL vs. CLE,W,1,0,0,0.0,0,0,0.0,0,0,0.0,0,0,0,0,0,0,0,0,0,0,1,MIL,MIL,CLE,126,,,0,0,0,0
AJ Green,G,22023,1631260,22300552,"JAN 14, 2024",MIL vs. SAC,W,18,1,5,0.2,1,4,0.25,2,2,1.0,0,0,0,0,0,0,0,2,5,-4,1,MIL,MIL,SAC,143,,,5,5,5,0
AJ Green,G,22023,1631260,22300528,"JAN 11, 2024",MIL vs. BOS,W,9,3,6,0.5,2,5,0.4,1,1,1.0,0,2,2,2,0,1,0,1,9,1,1,MIL,MIL,BOS,135,,,13,11,11,4
AJ Green,G,22023,1631260,22300510,"JAN 08, 2024",MIL vs. UTA,L,11,3,4,0.75,2,3,0.667,0,0,0.0,1,0,1,0,0,0,0,0,8,-15,1,MIL,MIL,UTA,116,,,9,9,8,1
AJ Green,G,22023,1631260,22300496,"JAN 06, 2024",MIL @ HOU,L,3,0,0,0.0,0,0,0.0,0,0,0.0,0,0,0,0,0,0,0,1,0,6,1,MIL,HOU,MIL,108,,,0,0,0,0
AJ Green,G,22023,1631260,22300417,"DEC 27, 2023",MIL @ BKN,W,4,1,2,0.5,1,2,0.5,0,0,0.0,0,1,1,0,0,0,0,2,3,7,1,MIL,BKN,MIL,144,,,4,4,3,1
AJ Green,G,22023,1631260,22300388,"DEC 23, 2023",MIL @ NYK,W,0,0,0,0.0,0,0,0.0,0,0,0.0,0,0,0,0,0,0,0,0,0,0,1,MIL,NYK,MIL,130,,,0,0,0,0
AJ Green,G,22023,1631260,22300361,"DEC 19, 2023",MIL vs. SAS,W,2,0,1,0.0,0,1,0.0,0,0,0.0,0,0,0,0,0,0,0,0,0,-2,1,MIL,MIL,SAS,132,,,0,0,0,0
AJ Green,G,22023,1631260,22300346,"DEC 17, 2023",MIL vs. HOU,W,0,0,0,0.0,0,0,0.0,0,0,0.0,0,0,0,0,0,0,0,0,0,-3,1,MIL,MIL,HOU,128,,,0,0,0,0
AJ Green,G,22023,1631260,22300334,"DEC 16, 2023",MIL vs. DET,W,20,3,6,0.5,3,6,0.5,0,0,0.0,1,0,1,1,0,0,0,5,9,22,1,MIL,MIL,DET,146,,,11,10,10,2
AJ Green,G,22023,1631260,22300315,"DEC 13, 2023",MIL vs. IND,W,1,0,0,0.0,0,0,0.0,0,0,0.0,0,0,0,0,0,0,0,0,0,-9,1,MIL,MIL,IND,140,,,0,0,0,0
AJ Green,G,22023,1631260,22300300,"DEC 11, 2023",MIL vs. CHI,W,14,4,6,0.667,4,5,0.8,0,0,0.0,0,5,5,3,0,0,0,1,12,0,1,MIL,MIL,CHI,133,,,20,17,15,8
AJ Green,G,22023,1631260,22301229,"DEC 07, 2023",MIL vs. IND,L,4,0,1,0.0,0,0,0.0,0,0,0.0,0,0,0,0,0,0,0,0,0,-1,1,MIL,MIL,IND,119,,,0,0,0,0
AJ Green,G,22023,1631260,22301201,"DEC 05, 2023",MIL vs. NYK,W,15,3,4,0.75,3,4,0.75,0,0,0.0,0,0,0,1,0,0,0,0,9,8,1,MIL,MIL,NYK,146,,,10,9,10,1
AJ Green,G,22023,1631260,22300286,"DEC 02, 2023",MIL vs. ATL,W,9,0,0,0.0,0,0,0.0,0,0,0.0,1,0,1,0,0,0,0,1,0,9,1,MIL,MIL,ATL,132,,,1,1,0,1
AJ Green,G,22023,1631260,22300056,"NOV 28, 2023",MIL @ MIA,W,2,0,1,0.0,0,1,0.0,0,0,0.0,0,0,0,0,0,0,0,1,0,-2,1,MIL,MIA,MIL,131,,,0,0,0,0
AJ Green,G,22023,1631260,22300245,"NOV 26, 2023",MIL vs. POR,W,4,0,2,0.0,0,2,0.0,0,0,0.0,1,0,1,0,0,0,0,1,0,-9,1,MIL,MIL,POR,108,,,1,1,0,1
AJ Green,G,22023,1631260,22300049,"NOV 24, 2023",MIL vs. WAS,W,4,1,4,0.25,1,4,0.25,0,0,0.0,0,0,0,0,0,0,0,0,3,-2,1,MIL,MIL,WAS,131,,,3,3,3,0
AJ Green,G,22023,1631260,22300219,"NOV 20, 2023",MIL @ WAS,W,15,1,4,0.25,0,3,0.0,0,0,0.0,0,2,2,1,0,0,0,1,2,-9,1,MIL,WAS,MIL,142,,,5,4,3,3
AJ Green,G,22023,1631260,22300205,"NOV 18, 2023",MIL vs. DAL,W,11,3,5,0.6,2,4,0.5,0,0,0.0,0,0,0,1,0,0,0,1,8,7,1,MIL,MIL,DAL,132,,,9,8,9,1
AJ Green,G,22023,1631260,22300027,"NOV 17, 2023",MIL @ CHA,W,3,2,3,0.667,2,3,0.667,0,0,0.0,0,1,1,0,0,0,0,0,6,11,1,MIL,CHA,MIL,130,,,7,7,6,1
AJ Green,G,22023,1631260,22300173,"NOV 11, 2023",MIL @ ORL,L,9,1,3,0.333,1,3,0.333,0,0,0.0,0,2,2,3,0,0,0,0,3,5,1,MIL,ORL,MIL,97,,,8,5,6,5
AJ Green,G,22023,1631260,22300116,"NOV 01, 2023",MIL @ TOR,L,6,1,1,1.0,0,0,0.0,0,0,0.0,0,1,1,1,0,0,0,1,2,6,1,MIL,TOR,MIL,111,,,4,3,3,2
AJ Green,G,22023,1631260,22300107,"OCT 30, 2023",MIL vs. MIA,W,15,0,4,0.0,0,3,0.0,0,0,0.0,0,0,0,2,0,0,0,3,0,8,1,MIL,MIL,MIA,122,,,2,0,2,2
AJ Green,G,22023,1631260,22300097,"OCT 29, 2023",MIL vs. ATL,L,6,2,2,1.0,2,2,1.0,1,1,1.0,0,1,1,0,0,0,0,0,7,10,1,MIL,MIL,ATL,110,,,8,8,7,1
AJ Green,G,22023,1631260,22300572,"JAN 17, 2024",MIL @ CLE,L,13,1,5,0.2,1,4,0.25,0,0,0.0,1,1,2,1,0,0,0,2,3,2,1,MIL,CLE,MIL,95,,,6,5,4,3
AJ Green,G,22023,1631260,22300195,"NOV 15, 2023",MIL @ TOR,W,7,0,1,0.0,0,1,0.0,0,0,0.0,0,0,0,0,0,0,0,0,0,-20,1,MIL,TOR,MIL,128,,,0,0,0,0
Ish Smith,G,22023,202397,22300335,"DEC 16, 2023",CHA vs. PHI,L,18,3,7,0.429,0,0,0.0,0,0,0.0,0,1,1,4,1,0,0,0,6,-7,1,CHA,CHA,PHI,80,,,11,7,10,5
Ish Smith,G,22023,202397,22300177,"NOV 12, 2023",CHA @ NYK,L,17,2,4,0.5,0,0,0.0,0,0,0.0,1,4,5,2,2,0,0,1,4,-9,1,CHA,NYK,CHA,107,,,11,9,6,7
Ish Smith,G,22023,202397,22300635,"JAN 26, 2024",CHA vs. HOU,L,20,0,3,0.0,0,0,0.0,0,0,0.0,0,5,5,2,0,0,1,3,0,-24,1,CHA,CHA,HOU,104,,,7,5,2,7
Ish Smith,G,22023,202397,22300619,"JAN 24, 2024",CHA @ DET,L,13,1,1,1.0,0,0,0.0,0,0,0.0,1,3,4,5,0,1,0,0,2,16,1,CHA,DET,CHA,106,,,11,6,7,9
Ish Smith,G,22023,202397,22300610,"JAN 22, 2024",CHA @ MIN,W,11,3,3,1.0,0,0,0.0,0,0,0.0,0,1,1,1,2,0,0,2,6,-6,1,CHA,MIN,CHA,126,,,8,7,7,2
Ish Smith,G,22023,202397,22300575,"JAN 17, 2024",CHA @ NOP,L,11,1,1,1.0,0,0,0.0,0,0,0.0,0,1,1,2,0,1,0,0,2,-9,1,CHA,NOP,CHA,108,,,5,3,4,3
Ish Smith,G,22023,202397,22300551,"JAN 14, 2024",CHA @ MIA,L,12,0,1,0.0,0,0,0.0,1,2,0.5,1,1,2,0,0,0,0,0,1,-6,1,CHA,MIA,CHA,85,,,3,3,1,2
Ish Smith,G,22023,202397,22300541,"JAN 12, 2024",CHA @ SAS,L,22,0,4,0.0,0,0,0.0,0,0,0.0,0,2,2,6,1,0,2,0,0,-14,1,CHA,SAS,CHA,99,,,8,2,6,8
Ish Smith,G,22023,202397,22300248,"NOV 26, 2023",CHA @ ORL,L,17,2,3,0.667,0,0,0.0,0,0,0.0,0,2,2,4,1,0,1,2,4,-13,1,CHA,ORL,CHA,117,,,10,6,8,6
Ish Smith,G,22023,202397,22300225,"NOV 22, 2023",CHA vs. WAS,W,20,0,1,0.0,0,0,0.0,0,0,0.0,0,0,0,4,1,0,1,1,0,14,1,CHA,CHA,WAS,117,,,4,0,4,4
Ish Smith,G,22023,202397,22300217,"NOV 20, 2023",CHA vs. BOS,W,20,3,4,0.75,0,0,0.0,0,0,0.0,0,2,2,3,0,0,1,0,6,-12,1,CHA,CHA,BOS,121,,,11,8,9,5
Ish Smith,G,22023,202397,22300202,"NOV 18, 2023",CHA vs. NYK,L,17,3,6,0.5,1,2,0.5,0,0,0.0,0,3,3,4,0,0,0,1,7,0,1,CHA,CHA,NYK,108,,,14,10,11,7
Ish Smith,G,22023,202397,22300027,"NOV 17, 2023",CHA vs. MIL,L,23,4,7,0.571,0,0,0.0,0,0,0.0,0,2,2,2,0,1,1,0,8,-6,1,CHA,CHA,MIL,99,,,12,10,10,4
Ish Smith,G,22023,202397,22300017,"NOV 14, 2023",CHA vs. MIA,L,19,1,3,0.333,0,0,0.0,0,0,0.0,1,1,2,3,0,0,3,1,2,-11,1,CHA,CHA,MIA,105,,,7,4,5,5
Ish Smith,G,22023,202397,22300157,"NOV 08, 2023",CHA vs. WAS,L,10,0,0,0.0,0,0,0.0,0,0,0.0,0,1,1,0,1,0,2,0,0,-8,1,CHA,CHA,WAS,116,,,1,1,0,1
Ish Smith,G,22023,202397,22300143,"NOV 05, 2023",CHA @ DAL,L,3,0,0,0.0,0,0,0.0,0,0,0.0,0,0,0,0,0,0,1,3,0,-4,1,CHA,DAL,CHA,118,,,0,0,0,0
Ish Smith,G,22023,202397,22300726,"FEB 07, 2024",CHA vs. TOR,L,16,0,5,0.0,0,0,0.0,0,0,0.0,0,2,2,4,1,0,0,1,0,-1,1,CHA,CHA,TOR,117,,,6,2,4,6
Ish Smith,G,22023,202397,22300713,"FEB 05, 2024",CHA vs. LAL,L,34,4,9,0.444,0,0,0.0,0,0,0.0,0,2,2,6,2,0,2,2,8,-10,1,CHA,CHA,LAL,118,,,16,10,14,8
Ish Smith,G,22023,202397,22300707,"FEB 04, 2024",CHA vs. IND,L,26,1,3,0.333,1,1,1.0,0,0,0.0,0,3,3,4,0,0,2,3,3,-30,1,CHA,CHA,IND,99,,,10,6,7,7
Ish Smith,G,22023,202397,22300695,"FEB 02, 2024",CHA @ OKC,L,16,1,4,0.25,0,0,0.0,0,0,0.0,0,1,1,3,1,0,1,1,2,-18,1,CHA,OKC,CHA,106,,,6,3,5,4
Ish Smith,G,22023,202397,22300674,"JAN 31, 2024",CHA vs. CHI,L,16,1,3,0.333,1,1,1.0,0,0,0.0,0,0,0,2,0,0,0,2,3,-1,1,CHA,CHA,CHI,110,,,5,3,5,2
Ish Smith,G,22023,202397,22300657,"JAN 29, 2024",CHA vs. NYK,L,11,0,1,0.0,0,0,0.0,0,0,0.0,0,0,0,3,0,0,0,1,0,-11,1,CHA,CHA,NYK,92,,,3,0,3,3
Ish Smith,G,22023,202397,22300647,"JAN 27, 2024",CHA vs. UTA,L,29,0,5,0.0,0,0,0.0,0,0,0.0,0,3,3,12,1,0,0,3,0,-11,1,CHA,CHA,UTA,122,,,15,3,12,15
Ish Smith,G,22023,202397,22300518,"JAN 10, 2024",CHA vs. SAC,L,16,1,3,0.333,0,0,0.0,0,0,0.0,0,1,1,0,0,0,0,1,2,-5,1,CHA,CHA,SAC,96,,,3,3,2,1
Ish Smith,G,22023,202397,22300365,"DEC 20, 2023",CHA @ IND,L,16,2,3,0.667,0,0,0.0,0,0,0.0,0,0,0,6,0,0,1,1,4,-5,1,CHA,IND,CHA,109,,,10,4,10,6
Ish Smith,G,22023,202397,22300354,"DEC 18, 2023",CHA @ TOR,L,23,4,10,0.4,0,0,0.0,0,0,0.0,0,0,0,1,0,1,1,1,8,-21,1,CHA,TOR,CHA,99,,,9,8,9,1
Ish Smith,G,22023,202397,22300057,"NOV 28, 2023",CHA @ NYK,L,14,2,3,0.667,0,0,0.0,0,0,0.0,0,1,1,1,0,0,3,1,4,-17,1,CHA,NYK,CHA,91,,,6,5,5,2
Ish Smith,G,22023,202397,22300506,"JAN 08, 2024",CHA vs. CHI,L,15,1,4,0.25,0,0,0.0,0,0,0.0,0,0,0,1,0,0,0,1,2,1,1,CHA,CHA,CHI,109,,,3,2,3,1
Ish Smith,G,22023,202397,22300455,"JAN 01, 2024",CHA @ DEN,L,29,5,12,0.417,0,0,0.0,0,0,0.0,1,2,3,4,0,0,4,2,10,-28,1,CHA,DEN,CHA,91,,,17,13,14,7
Ish Smith,G,22023,202397,22300428,"DEC 28, 2023",CHA @ LAL,L,14,3,4,0.75,0,0,0.0,0,0,0.0,0,3,3,4,0,0,1,1,6,-6,1,CHA,LAL,CHA,110,,,13,9,10,7
Ish Smith,G,22023,202397,22300593,"JAN 20, 2024",CHA vs. PHI,L,19,1,4,0.25,0,0,0.0,0,0,0.0,0,2,2,5,0,0,2,0,2,4,1,CHA,CHA,PHI,89,,,9,4,7,7
Ish Smith,G,22023,202397,22300484,"JAN 05, 2024",CHA @ CHI,L,16,3,9,0.333,0,2,0.0,0,0,0.0,1,1,2,4,1,0,0,1,6,-8,1,CHA,CHI,CHA,87,,,12,8,10,6
Ish Smith,G,22023,202397,22300464,"JAN 02, 2024",CHA @ SAC,W,18,2,4,0.5,0,0,0.0,0,0,0.0,1,5,6,4,1,0,4,1,4,13,1,CHA,SAC,CHA,111,,,14,10,8,10
Ish Smith,G,22023,202397,22300436,"DEC 29, 2023",CHA @ PHX,L,13,0,1,0.0,0,0,0.0,0,0,0.0,0,1,1,6,0,0,0,1,0,-13,1,CHA,PHX,CHA,119,,,7,1,6,7
Ish Smith,G,22023,202397,22300414,"DEC 26, 2023",CHA @ LAC,L,16,2,4,0.5,0,0,0.0,0,0,0.0,0,1,1,4,0,0,1,1,4,0,1,CHA,LAC,CHA,104,,,9,5,8,5
Ish Smith,G,22023,202397,22300390,"DEC 23, 2023",CHA vs. DEN,L,26,1,4,0.25,0,0,0.0,2,2,1.0,1,2,3,8,0,0,2,2,4,-12,1,CHA,CHA,DEN,95,,,15,7,12,11
Ish Smith,G,22023,202397,22300326,"DEC 15, 2023",CHA vs. NOP,L,15,0,2,0.0,0,0,0.0,0,0,0.0,1,0,1,2,0,0,0,0,0,10,1,CHA,CHA,NOP,105,,,3,1,2,3
Ish Smith,G,22023,202397,22300312,"DEC 13, 2023",CHA @ MIA,L,17,3,5,0.6,0,1,0.0,0,0,0.0,0,2,2,4,0,0,3,3,6,-5,1,CHA,MIA,CHA,104,,,12,8,10,6
Ish Smith,G,22023,202397,22300292,"DEC 11, 2023",CHA vs. MIA,L,15,2,4,0.5,1,1,1.0,0,0,0.0,0,0,0,3,1,0,2,0,5,-3,1,CHA,CHA,MIA,114,,,8,5,8,3
Ish Smith,G,22023,202397,22301216,"DEC 08, 2023",CHA vs. TOR,W,14,1,1,1.0,0,0,0.0,0,0,0.0,0,0,0,4,0,0,1,0,2,1,1,CHA,CHA,TOR,119,,,6,2,6,4
Ish Smith,G,22023,202397,22301211,"DEC 06, 2023",CHA @ CHI,L,14,0,0,0.0,0,0,0.0,0,0,0.0,0,1,1,3,0,0,2,1,0,-6,1,CHA,CHI,CHA,100,,,4,1,3,4
Ish Smith,G,22023,202397,22300281,"DEC 02, 2023",CHA vs. MIN,L,16,3,3,1.0,0,0,0.0,0,0,0.0,1,3,4,5,0,0,0,0,6,3,1,CHA,CHA,MIN,117,,,15,10,11,9
Ish Smith,G,22023,202397,22300266,"NOV 30, 2023",CHA @ BKN,W,13,0,0,0.0,0,0,0.0,0,0,0.0,1,0,1,0,0,0,2,4,0,-2,1,CHA,BKN,CHA,129,,,1,1,0,1
JT Thor,F,22023,1630550,22300745,"FEB 09, 2024",CHA @ MIL,L,19,0,1,0.0,0,0,0.0,0,0,0.0,0,3,3,0,0,0,0,2,0,-2,1,CHA,MIL,CHA,80,,,3,3,0,3
JT Thor,F,22023,1630550,22300335,"DEC 16, 2023",CHA vs. PHI,L,22,1,8,0.125,0,3,0.0,0,0,0.0,1,1,2,0,0,0,1,1,2,-13,1,CHA,CHA,PHI,80,,,4,4,2,2
JT Thor,F,22023,1630550,22300177,"NOV 12, 2023",CHA @ NYK,L,23,2,6,0.333,2,5,0.4,0,2,0.0,2,2,4,0,0,1,1,4,6,1,1,CHA,NYK,CHA,107,,,10,10,6,4
JT Thor,F,22023,1630550,22300635,"JAN 26, 2024",CHA vs. HOU,L,7,0,2,0.0,0,0,0.0,2,2,1.0,0,1,1,1,2,0,0,0,2,3,1,CHA,CHA,HOU,104,,,4,3,3,2
JT Thor,F,22023,1630550,22300610,"JAN 22, 2024",CHA @ MIN,W,16,2,3,0.667,2,3,0.667,1,2,0.5,0,3,3,0,0,2,2,2,7,9,1,CHA,MIN,CHA,126,,,10,10,7,3
JT Thor,F,22023,1630550,22300584,"JAN 19, 2024",CHA vs. SAS,W,9,1,1,1.0,0,0,0.0,0,0,0.0,0,2,2,0,0,0,0,0,2,8,1,CHA,CHA,SAS,124,,,4,4,2,2
JT Thor,F,22023,1630550,22300575,"JAN 17, 2024",CHA @ NOP,L,7,0,1,0.0,0,1,0.0,0,0,0.0,1,1,2,1,0,1,1,0,0,5,1,CHA,NOP,CHA,108,,,3,2,1,3
JT Thor,F,22023,1630550,22300551,"JAN 14, 2024",CHA @ MIA,L,10,0,6,0.0,0,0,0.0,0,0,0.0,4,0,4,1,0,1,0,1,0,-10,1,CHA,MIA,CHA,85,,,5,4,1,5
JT Thor,F,22023,1630550,22300541,"JAN 12, 2024",CHA @ SAS,L,19,2,7,0.286,1,3,0.333,0,0,0.0,2,2,4,0,0,0,1,3,5,-1,1,CHA,SAS,CHA,99,,,9,9,5,4
JT Thor,F,22023,1630550,22300248,"NOV 26, 2023",CHA @ ORL,L,9,2,4,0.5,2,3,0.667,0,0,0.0,0,0,0,0,0,0,0,1,6,-4,1,CHA,ORL,CHA,117,,,6,6,6,0
JT Thor,F,22023,1630550,22300225,"NOV 22, 2023",CHA vs. WAS,W,23,2,5,0.4,1,3,0.333,0,0,0.0,0,4,4,1,0,0,0,1,5,7,1,CHA,CHA,WAS,117,,,10,9,6,5
JT Thor,F,22023,1630550,22300217,"NOV 20, 2023",CHA vs. BOS,W,5,0,0,0.0,0,0,0.0,0,0,0.0,0,0,0,0,0,0,0,1,0,-7,1,CHA,CHA,BOS,121,,,0,0,0,0
JT Thor,F,22023,1630550,22300202,"NOV 18, 2023",CHA vs. NYK,L,11,2,3,0.667,1,2,0.5,0,0,0.0,1,1,2,0,0,1,0,1,5,-9,1,CHA,CHA,NYK,108,,,7,7,5,2
JT Thor,F,22023,1630550,22300027,"NOV 17, 2023",CHA vs. MIL,L,6,1,1,1.0,0,0,0.0,0,0,0.0,0,1,1,0,0,0,0,1,2,-12,1,CHA,CHA,MIL,99,,,3,3,2,1
JT Thor,F,22023,1630550,22300017,"NOV 14, 2023",CHA vs. MIA,L,28,2,6,0.333,1,2,0.5,0,0,0.0,3,1,4,1,0,0,0,1,5,-7,1,CHA,CHA,MIA,105,,,10,9,6,5
JT Thor,F,22023,1630550,22300009,"NOV 10, 2023",CHA @ WAS,W,20,3,7,0.429,1,2,0.5,0,2,0.0,1,4,5,2,0,0,0,1,7,17,1,CHA,WAS,CHA,124,,,14,12,9,7
JT Thor,F,22023,1630550,22300157,"NOV 08, 2023",CHA vs. WAS,L,21,0,3,0.0,0,2,0.0,0,0,0.0,2,3,5,1,0,1,0,3,0,-21,1,CHA,CHA,WAS,116,,,6,5,1,6
JT Thor,F,22023,1630550,22300143,"NOV 05, 2023",CHA @ DAL,L,15,0,1,0.0,0,0,0.0,0,0,0.0,1,2,3,1,0,0,0,0,0,-10,1,CHA,DAL,CHA,118,,,4,3,1,4
JT Thor,F,22023,1630550,22300133,"NOV 04, 2023",CHA @ IND,W,15,3,3,1.0,1,1,1.0,0,0,0.0,1,3,4,0,0,0,0,1,7,14,1,CHA,IND,CHA,125,,,11,11,7,4
JT Thor,F,22023,1630550,22300122,"NOV 01, 2023",CHA @ HOU,L,13,2,4,0.5,1,3,0.333,0,0,0.0,0,5,5,0,3,1,1,2,5,-15,1,CHA,HOU,CHA,119,,,10,10,5,5
JT Thor,F,22023,1630550,22300101,"OCT 30, 2023",CHA vs. BKN,L,19,3,6,0.5,1,4,0.25,0,0,0.0,0,2,2,3,0,0,1,1,7,-1,1,CHA,CHA,BKN,121,,,12,9,10,5
JT Thor,F,22023,1630550,22300077,"OCT 27, 2023",CHA vs. DET,L,25,1,3,0.333,0,1,0.0,0,0,0.0,1,3,4,0,1,1,0,1,2,0,1,CHA,CHA,DET,99,,,6,6,2,4
JT Thor,F,22023,1630550,22300063,"OCT 25, 2023",CHA vs. ATL,W,20,2,7,0.286,1,3,0.333,0,0,0.0,1,1,2,1,0,0,0,0,5,2,1,CHA,CHA,ATL,116,,,8,7,6,3
JT Thor,F,22023,1630550,22300713,"FEB 05, 2024",CHA vs. LAL,L,7,0,0,0.0,0,0,0.0,0,0,0.0,0,0,0,1,0,0,0,1,0,4,1,CHA,CHA,LAL,118,,,1,0,1,1
JT Thor,F,22023,1630550,22300707,"FEB 04, 2024",CHA vs. IND,L,10,1,1,1.0,0,0,0.0,0,0,0.0,0,3,3,1,0,0,0,0,2,-4,1,CHA,CHA,IND,99,,,6,5,3,4
JT Thor,F,22023,1630550,22300695,"FEB 02, 2024",CHA @ OKC,L,6,2,3,0.667,0,1,0.0,0,0,0.0,0,2,2,0,0,0,0,1,4,10,1,CHA,OKC,CHA,106,,,6,6,4,2
JT Thor,F,22023,1630550,22300657,"JAN 29, 2024",CHA vs. NYK,L,2,0,2,0.0,0,1,0.0,1,2,0.5,1,0,1,0,0,0,0,0,1,-3,1,CHA,CHA,NYK,92,,,2,2,1,1
JT Thor,F,22023,1630550,22300647,"JAN 27, 2024",CHA vs. UTA,L,5,2,3,0.667,1,1,1.0,0,0,0.0,0,0,0,0,0,0,1,0,5,0,1,CHA,CHA,UTA,122,,,5,5,5,0
JT Thor,F,22023,1630550,22300518,"JAN 10, 2024",CHA vs. SAC,L,21,1,7,0.143,0,2,0.0,0,0,0.0,2,3,5,0,0,0,0,2,2,-27,1,CHA,CHA,SAC,96,,,7,7,2,5
JT Thor,F,22023,1630550,22300365,"DEC 20, 2023",CHA @ IND,L,6,0,0,0.0,0,0,0.0,2,2,1.0,1,0,1,0,0,0,0,2,2,-5,1,CHA,IND,CHA,109,,,3,3,2,1
JT Thor,F,22023,1630550,22300354,"DEC 18, 2023",CHA @ TOR,L,14,2,2,1.0,0,0,0.0,1,1,1.0,2,1,3,0,0,1,0,0,5,2,1,CHA,TOR,CHA,99,,,8,8,5,3
JT Thor,F,22023,1630550,22300057,"NOV 28, 2023",CHA @ NYK,L,13,0,0,0.0,0,0,0.0,0,0,0.0,0,2,2,0,0,0,1,1,0,-8,1,CHA,NYK,CHA,91,,,2,2,0,2
JT Thor,F,22023,1630550,22300506,"JAN 08, 2024",CHA vs. CHI,L,21,4,12,0.333,1,2,0.5,0,0,0.0,6,2,8,0,0,2,0,1,9,0,1,CHA,CHA,CHI,109,,,17,17,9,8
JT Thor,F,22023,1630550,22300455,"JAN 01, 2024",CHA @ DEN,L,4,1,2,0.5,0,0,0.0,0,0,0.0,0,2,2,0,0,1,0,0,2,6,1,CHA,DEN,CHA,91,,,4,4,2,2
JT Thor,F,22023,1630550,22300428,"DEC 28, 2023",CHA @ LAL,L,6,1,1,1.0,1,1,1.0,0,0,0.0,0,0,0,1,0,0,0,0,3,6,1,CHA,LAL,CHA,110,,,4,3,4,1
JT Thor,F,22023,1630550,22300593,"JAN 20, 2024",CHA vs. PHI,L,22,3,5,0.6,1,3,0.333,0,0,0.0,3,3,6,0,0,1,0,1,7,5,1,CHA,CHA,PHI,89,,,13,13,7,6
JT Thor,F,22023,1630550,22300484,"JAN 05, 2024",CHA @ CHI,L,16,1,2,0.5,0,0,0.0,0,0,0.0,0,2,2,1,0,0,0,1,2,-6,1,CHA,CHI,CHA,87,,,5,4,3,3
JT Thor,F,22023,1630550,22300464,"JAN 02, 2024",CHA @ SAC,W,6,1,2,0.5,0,1,0.0,0,0,0.0,0,2,2,0,0,0,0,0,2,12,1,CHA,SAC,CHA,111,,,4,4,2,2
JT Thor,F,22023,1630550,22300326,"DEC 15, 2023",CHA vs. NOP,L,14,0,2,0.0,0,1,0.0,0,0,0.0,1,1,2,0,0,2,0,1,0,1,1,CHA,CHA,NOP,105,,,2,2,0,2
JT Thor,F,22023,1630550,22300312,"DEC 13, 2023",CHA @ MIA,L,16,0,2,0.0,0,2,0.0,0,0,0.0,0,1,1,0,1,0,1,3,0,-19,1,CHA,MIA,CHA,104,,,1,1,0,1
JT Thor,F,22023,1630550,22300292,"DEC 11, 2023",CHA vs. MIA,L,9,0,2,0.0,0,2,0.0,0,0,0.0,0,0,0,0,1,1,0,0,0,-5,1,CHA,CHA,MIA,114,,,0,0,0,0
JT Thor,F,22023,1630550,22300266,"NOV 30, 2023",CHA @ BKN,W,16,1,3,0.333,0,2,0.0,0,0,0.0,1,1,2,0,0,0,0,1,2,-2,1,CHA,BKN,CHA,129,,,4,4,2,2
Colin Castleton,C,22023,1630658,22300605,"JAN 21, 2024",LAL vs. POR,W,4,1,1,1.0,0,0,0.0,2,2,1.0,1,1,2,0,0,0,1,1,4,1,1,LAL,LAL,POR,134,,,6,6,4,2
Colin Castleton,C,22023,1630658,22300331,"DEC 15, 2023",LAL @ SAS,L,5,3,3,1.0,0,0,0.0,0,0,0.0,0,1,1,1,0,0,0,0,6,6,1,LAL,SAS,LAL,115,,,8,7,7,2
Colin Castleton,C,22023,1630658,22300271,"NOV 30, 2023",LAL @ OKC,L,4,0,1,0.0,0,0,0.0,2,2,1.0,1,2,3,0,0,0,0,0,2,-5,1,LAL,OKC,LAL,110,,,5,5,2,3
Colin Castleton,C,22023,1630658,22300163,"NOV 08, 2023",LAL @ HOU,L,14,1,3,0.333,0,0,0.0,0,0,0.0,2,0,2,2,0,0,0,5,2,-8,1,LAL,HOU,LAL,94,,,6,4,4,4
Colin Castleton,C,22023,1630658,22300134,"NOV 04, 2023",LAL @ ORL,L,4,1,1,1.0,0,0,0.0,0,0,0.0,0,1,1,0,0,0,0,0,2,-3,1,LAL,ORL,LAL,101,,,3,3,2,1
Patty Mills,G,22023,201988,22300729,"FEB 07, 2024",ATL @ BOS,L,10,0,2,0.0,0,1,0.0,0,0,0.0,0,2,2,1,1,0,0,0,0,2,1,ATL,BOS,ATL,117,,,3,2,1,3
Patty Mills,G,22023,201988,22300690,"FEB 02, 2024",ATL vs. PHX,W,10,1,4,0.25,0,3,0.0,0,0,0.0,0,2,2,0,1,0,0,0,2,9,1,ATL,ATL,PHX,129,,,4,4,2,2
Patty Mills,G,22023,201988,22300669,"JAN 30, 2024",ATL vs. LAL,W,2,0,1,0.0,0,1,0.0,0,0,0.0,0,0,0,0,0,0,0,0,0,1,1,ATL,ATL,LAL,138,,,0,0,0,0
Patty Mills,G,22023,201988,22300653,"JAN 28, 2024",ATL vs. TOR,W,15,0,2,0.0,0,2,0.0,0,0,0.0,2,1,3,1,1,0,1,1,0,-18,1,ATL,ATL,TOR,126,,,4,3,1,4
Patty Mills,G,22023,201988,22300634,"JAN 26, 2024",ATL vs. DAL,L,5,0,0,0.0,0,0,0.0,0,0,0.0,0,0,0,0,0,0,0,0,0,-8,1,ATL,ATL,DAL,143,,,0,0,0,0
Patty Mills,G,22023,201988,22300626,"JAN 24, 2024",ATL @ GSW,L,22,5,11,0.455,3,6,0.5,0,0,0.0,1,1,2,3,1,0,2,0,13,-13,1,ATL,GSW,ATL,112,,,18,15,16,5
Patty Mills,G,22023,201988,22300613,"JAN 22, 2024",ATL @ SAC,L,16,1,5,0.2,0,2,0.0,0,0,0.0,0,0,0,2,1,0,1,0,2,-2,1,ATL,SAC,ATL,107,,,4,2,4,2
Patty Mills,G,22023,201988,22300595,"JAN 20, 2024",ATL vs. CLE,L,10,2,3,0.667,2,3,0.667,0,0,0.0,0,0,0,0,1,0,0,1,6,3,1,ATL,ATL,CLE,95,,,6,6,6,0
Patty Mills,G,22023,201988,22300587,"JAN 19, 2024",ATL @ MIA,W,18,4,6,0.667,3,5,0.6,0,0,0.0,0,3,3,2,1,0,1,4,11,-7,1,ATL,MIA,ATL,109,,,16,14,13,5
Patty Mills,G,22023,201988,22300533,"JAN 12, 2024",ATL vs. IND,L,15,1,3,0.333,0,1,0.0,0,0,0.0,1,0,1,0,1,0,0,1,2,-11,1,ATL,ATL,IND,108,,,3,3,2,1
Patty Mills,G,22023,201988,22300521,"JAN 10, 2024",ATL vs. PHI,W,6,0,0,0.0,0,0,0.0,0,0,0.0,0,0,0,0,0,0,0,2,0,0,1,ATL,ATL,PHI,139,,,0,0,0,0
Patty Mills,G,22023,201988,22300445,"DEC 31, 2023",ATL @ WAS,W,8,0,1,0.0,0,1,0.0,0,0,0.0,0,2,2,0,0,0,0,0,0,17,1,ATL,WAS,ATL,130,,,2,2,0,2
Patty Mills,G,22023,201988,22300431,"DEC 29, 2023",ATL vs. SAC,L,11,1,1,1.0,1,1,1.0,0,0,0.0,0,0,0,0,0,0,0,0,3,-11,1,ATL,ATL,SAC,110,,,3,3,3,0
Patty Mills,G,22023,201988,22300384,"DEC 22, 2023",ATL @ MIA,L,12,1,2,0.5,1,1,1.0,0,0,0.0,1,0,1,1,0,0,1,4,3,-2,1,ATL,MIA,ATL,113,,,5,4,4,2
Patty Mills,G,22023,201988,22300336,"DEC 16, 2023",ATL @ CLE,L,13,1,4,0.25,1,3,0.333,0,0,0.0,0,2,2,2,0,0,1,2,3,-1,1,ATL,CLE,ATL,119,,,7,5,5,4
Patty Mills,G,22023,201988,22300330,"DEC 15, 2023",ATL @ TOR,W,1,0,0,0.0,0,0,0.0,0,0,0.0,0,0,0,0,0,0,0,0,0,-3,1,ATL,TOR,ATL,125,,,0,0,0,0
Patty Mills,G,22023,201988,22301218,"DEC 08, 2023",ATL @ PHI,L,17,1,4,0.25,1,3,0.333,0,0,0.0,0,1,1,2,1,1,1,2,3,1,1,ATL,PHI,ATL,114,,,6,4,5,3
Patty Mills,G,22023,201988,22300241,"NOV 25, 2023",ATL @ WAS,W,5,1,2,0.5,1,1,1.0,0,0,0.0,0,1,1,0,0,0,0,0,3,-2,1,ATL,WAS,ATL,136,,,4,4,3,1
Patty Mills,G,22023,201988,22300699,"FEB 03, 2024",ATL vs. GSW,W,7,0,0,0.0,0,0,0.0,0,0,0.0,0,0,0,0,0,0,0,0,0,6,1,ATL,ATL,GSW,141,,,0,0,0,0
Harry Giles III,F-C,22023,1628385,22300698,"FEB 03, 2024",BKN @ PHI,W,8,3,6,0.5,1,1,1.0,1,2,0.5,2,2,4,2,0,0,0,3,8,-12,1,BKN,PHI,BKN,136,,,14,12,10,6
Harry Giles III,F-C,22023,1628385,22300677,"JAN 31, 2024",BKN vs. PHX,L,2,0,0,0.0,0,0,0.0,0,0,0.0,0,0,0,0,0,0,1,1,0,-2,1,BKN,BKN,PHX,120,,,0,0,0,0
Harry Giles III,F-C,22023,1628385,22300660,"JAN 29, 2024",BKN vs. UTA,W,3,1,2,0.5,1,2,0.5,0,0,0.0,1,2,3,1,0,0,1,2,3,4,1,BKN,BKN,UTA,147,,,7,6,4,4
Harry Giles III,F-C,22023,1628385,22300645,"JAN 27, 2024",BKN vs. HOU,W,0,0,0,0.0,0,0,0.0,0,0,0.0,0,0,0,0,0,0,0,0,0,0,1,BKN,BKN,HOU,106,,,0,0,0,0
Harry Giles III,F-C,22023,1628385,22300591,"JAN 19, 2024",BKN @ LAL,W,5,0,1,0.0,0,1,0.0,0,0,0.0,0,1,1,0,0,0,1,0,0,-1,1,BKN,LAL,BKN,130,,,1,1,0,1
Harry Giles III,F-C,22023,1628385,22300527,"JAN 11, 2024",BKN @ CLE,L,3,1,2,0.5,0,0,0.0,0,0,0.0,1,0,1,1,0,0,1,0,2,-4,1,BKN,CLE,BKN,102,,,4,3,3,2
Harry Giles III,F-C,22023,1628385,22300461,"JAN 02, 2024",BKN @ NOP,L,8,3,6,0.5,0,2,0.0,0,2,0.0,1,2,3,1,0,1,0,2,6,0,1,BKN,NOP,BKN,85,,,10,9,7,4
Harry Giles III,F-C,22023,1628385,22300417,"DEC 27, 2023",BKN vs. MIL,L,7,0,3,0.0,0,0,0.0,1,2,0.5,2,2,4,0,0,0,0,2,1,-6,1,BKN,BKN,MIL,122,,,5,5,1,4
Harry Giles III,F-C,22023,1628385,22300394,"DEC 23, 2023",BKN vs. DET,W,1,0,0,0.0,0,0,0.0,0,0,0.0,0,0,0,0,0,0,0,0,0,-6,1,BKN,BKN,DET,126,,,0,0,0,0
Harry Giles III,F-C,22023,1628385,22300368,"DEC 20, 2023",BKN vs. NYK,L,4,0,1,0.0,0,0,0.0,0,0,0.0,0,0,0,0,0,1,1,1,0,6,1,BKN,BKN,NYK,102,,,0,0,0,0
Harry Giles III,F-C,22023,1628385,22300357,"DEC 18, 2023",BKN @ UTA,L,3,0,0,0.0,0,0,0.0,0,0,0.0,0,0,0,0,0,0,0,0,0,0,1,BKN,UTA,BKN,108,,,0,0,0,0
Harry Giles III,F-C,22023,1628385,22300322,"DEC 14, 2023",BKN @ DEN,L,15,4,9,0.444,0,1,0.0,3,3,1.0,3,3,6,1,1,0,0,1,11,1,1,BKN,DEN,BKN,101,,,18,17,12,7
Harry Giles III,F-C,22023,1628385,22300303,"DEC 11, 2023",BKN @ SAC,L,4,1,2,0.5,0,1,0.0,1,1,1.0,0,0,0,0,0,0,0,1,3,4,1,BKN,SAC,BKN,118,,,3,3,3,0
Harry Giles III,F-C,22023,1628385,22301219,"DEC 08, 2023",BKN vs. WAS,W,5,4,6,0.667,0,1,0.0,0,2,0.0,2,0,2,0,0,1,0,0,8,2,1,BKN,BKN,WAS,124,,,10,10,8,2
Harry Giles III,F-C,22023,1628385,22300208,"NOV 19, 2023",BKN vs. PHI,L,6,2,3,0.667,0,1,0.0,1,1,1.0,0,1,1,0,0,0,0,1,5,0,1,BKN,BKN,PHI,99,,,6,6,5,1
Harry Giles III,F-C,22023,1628385,22300010,"NOV 10, 2023",BKN @ BOS,L,6,3,3,1.0,1,1,1.0,0,0,0.0,0,1,1,0,0,0,1,1,7,6,1,BKN,BOS,BKN,107,,,8,8,7,1
Jaxson Hayes,C-F,22023,1629637,22300605,"JAN 21, 2024",LAL vs. POR,W,4,2,2,1.0,0,0,0.0,0,0,0.0,0,1,1,0,0,0,0,2,4,1,1,LAL,LAL,POR,134,,,5,5,4,1
Jaxson Hayes,C-F,22023,1629637,22300331,"DEC 15, 2023",LAL @ SAS,L,20,3,4,0.75,0,0,0.0,2,3,0.667,3,4,7,0,1,1,0,5,8,-13,1,LAL,SAS,LAL,115,,,15,15,8,7
Jaxson Hayes,C-F,22023,1629637,22300134,"NOV 04, 2023",LAL @ ORL,L,11,1,4,0.25,0,0,0.0,0,0,0.0,1,0,1,1,0,1,2,3,2,-10,1,LAL,ORL,LAL,101,,,4,3,3,2
Jaxson Hayes,C-F,22023,1629637,22300740,"FEB 08, 2024",LAL vs. DEN,L,17,4,6,0.667,0,1,0.0,1,2,0.5,5,1,6,1,1,2,0,1,9,-4,1,LAL,LAL,DEN,106,,,16,15,10,7
Jaxson Hayes,C-F,22023,1629637,22300713,"FEB 05, 2024",LAL @ CHA,W,11,0,1,0.0,0,0,0.0,0,0,0.0,1,2,3,0,1,0,0,1,0,-10,1,LAL,CHA,LAL,124,,,3,3,0,3
Jaxson Hayes,C-F,22023,1629637,22300701,"FEB 03, 2024",LAL @ NYK,W,13,3,3,1.0,0,0,0.0,4,5,0.8,0,1,1,3,1,0,0,0,10,1,1,LAL,NYK,LAL,113,,,14,11,13,4
Jaxson Hayes,C-F,22023,1629637,22300684,"FEB 01, 2024",LAL @ BOS,W,34,6,8,0.75,0,0,0.0,4,5,0.8,6,4,10,2,3,0,0,0,16,3,1,LAL,BOS,LAL,114,,,28,26,18,12
Jaxson Hayes,C-F,22023,1629637,22300669,"JAN 30, 2024",LAL @ ATL,L,24,3,4,0.75,0,0,0.0,0,0,0.0,1,5,6,1,4,1,2,4,6,-11,1,LAL,ATL,LAL,122,,,13,12,7,7
Jaxson Hayes,C-F,22023,1629637,22300662,"JAN 29, 2024",LAL @ HOU,L,14,4,4,1.0,0,0,0.0,1,1,1.0,1,1,2,0,1,1,1,2,9,4,1,LAL,HOU,LAL,119,,,11,11,9,2
Jaxson Hayes,C-F,22023,1629637,22300618,"JAN 23, 2024",LAL @ LAC,L,1,0,0,0.0,0,0,0.0,0,0,0.0,0,0,0,0,0,0,0,0,0,0,1,LAL,LAC,LAL,116,,,0,0,0,0
Jaxson Hayes,C-F,22023,1629637,22300591,"JAN 19, 2024",LAL vs. BKN,L,3,0,1,0.0,0,1,0.0,0,0,0.0,0,0,0,0,0,0,0,0,0,0,1,LAL,LAL,BKN,112,,,0,0,0,0
Jaxson Hayes,C-F,22023,1629637,22300577,"JAN 17, 2024",LAL vs. DAL,W,5,0,1,0.0,0,0,0.0,0,0,0.0,0,0,0,1,1,0,0,1,0,-6,1,LAL,LAL,DAL,127,,,1,0,1,1
Jaxson Hayes,C-F,22023,1629637,22300531,"JAN 11, 2024",LAL vs. PHX,L,13,3,3,1.0,0,0,0.0,0,0,0.0,1,1,2,1,0,2,2,6,6,1,1,LAL,LAL,PHX,109,,,9,8,7,3
Jaxson Hayes,C-F,22023,1629637,22300475,"JAN 03, 2024",LAL vs. MIA,L,1,0,0,0.0,0,0,0.0,0,0,0.0,0,0,0,0,0,0,0,0,0,0,1,LAL,LAL,MIA,96,,,0,0,0,0
Jaxson Hayes,C-F,22023,1629637,22300446,"DEC 31, 2023",LAL @ NOP,L,10,0,1,0.0,0,0,0.0,0,0,0.0,0,2,2,0,0,0,0,2,0,-6,1,LAL,NOP,LAL,109,,,2,2,0,2
Jaxson Hayes,C-F,22023,1629637,22300428,"DEC 28, 2023",LAL vs. CHA,W,7,5,7,0.714,0,0,0.0,0,0,0.0,1,1,2,0,0,0,0,0,10,-2,1,LAL,LAL,CHA,133,,,12,12,10,2
Jaxson Hayes,C-F,22023,1629637,22300370,"DEC 20, 2023",LAL @ CHI,L,1,1,1,1.0,0,0,0.0,0,0,0.0,0,1,1,0,0,0,0,0,2,0,1,LAL,CHI,LAL,108,,,3,3,2,1
Jaxson Hayes,C-F,22023,1629637,22300316,"DEC 13, 2023",LAL @ SAS,W,7,2,3,0.667,0,0,0.0,0,0,0.0,0,1,1,0,0,0,1,1,4,2,1,LAL,SAS,LAL,122,,,5,5,4,1
Jaxson Hayes,C-F,22023,1629637,22300306,"DEC 12, 2023",LAL @ DAL,L,13,0,1,0.0,0,0,0.0,0,0,0.0,2,2,4,1,0,0,0,4,0,-1,1,LAL,DAL,LAL,125,,,5,4,1,5
Jaxson Hayes,C-F,22023,1629637,22301230,"DEC 07, 2023",LAL vs. NOP,W,17,2,3,0.667,0,1,0.0,0,1,0.0,0,4,4,0,0,0,1,4,4,9,1,LAL,LAL,NOP,133,,,8,8,4,4
Jaxson Hayes,C-F,22023,1629637,22301203,"DEC 05, 2023",LAL vs. PHX,W,9,0,2,0.0,0,0,0.0,0,0,0.0,1,1,2,0,1,0,0,2,0,4,1,LAL,LAL,PHX,106,,,2,2,0,2
Jaxson Hayes,C-F,22023,1629637,22300291,"DEC 02, 2023",LAL vs. HOU,W,6,1,2,0.5,0,1,0.0,0,0,0.0,0,0,0,0,0,0,0,3,2,-6,1,LAL,LAL,HOU,107,,,2,2,2,0
Jaxson Hayes,C-F,22023,1629637,22300258,"NOV 29, 2023",LAL @ DET,W,7,0,0,0.0,0,0,0.0,0,0,0.0,0,1,1,0,0,1,0,0,0,-4,1,LAL,DET,LAL,133,,,1,1,0,1
Jaxson Hayes,C-F,22023,1629637,22300255,"NOV 27, 2023",LAL @ PHI,L,19,3,6,0.5,0,2,0.0,1,1,1.0,2,0,2,1,0,1,2,3,7,-33,1,LAL,PHI,LAL,94,,,10,9,8,3
Jaxson Hayes,C-F,22023,1629637,22300242,"NOV 25, 2023",LAL @ CLE,W,21,5,5,1.0,0,0,0.0,0,0,0.0,0,3,3,1,0,1,1,3,10,14,1,LAL,CLE,LAL,121,,,14,13,11,4
Jaxson Hayes,C-F,22023,1629637,22300238,"NOV 22, 2023",LAL vs. DAL,L,11,1,1,1.0,0,0,0.0,0,2,0.0,1,3,4,0,0,0,0,1,2,7,1,LAL,LAL,DAL,101,,,6,6,2,4
Jaxson Hayes,C-F,22023,1629637,22300042,"NOV 21, 2023",LAL vs. UTA,W,19,4,4,1.0,0,0,0.0,2,3,0.667,0,2,2,1,0,1,2,1,10,-2,1,LAL,LAL,UTA,131,,,13,12,11,3
Jaxson Hayes,C-F,22023,1629637,22300036,"NOV 17, 2023",LAL @ POR,W,8,0,0,0.0,0,0,0.0,0,1,0.0,0,1,1,0,1,0,0,0,0,5,1,LAL,POR,LAL,107,,,1,1,0,1
Jaxson Hayes,C-F,22023,1629637,22300198,"NOV 15, 2023",LAL vs. SAC,L,13,0,0,0.0,0,0,0.0,3,4,0.75,0,1,1,0,1,0,2,4,3,-2,1,LAL,LAL,SAC,110,,,4,4,3,1
Jaxson Hayes,C-F,22023,1629637,22300026,"NOV 14, 2023",LAL vs. MEM,W,21,4,4,1.0,0,0,0.0,3,4,0.75,1,0,1,1,1,3,0,2,11,6,1,LAL,LAL,MEM,134,,,13,12,12,2
Jaxson Hayes,C-F,22023,1629637,22300187,"NOV 12, 2023",LAL vs. POR,W,7,1,4,0.25,0,0,0.0,0,2,0.0,0,0,0,1,0,0,1,3,2,-11,1,LAL,LAL,POR,116,,,3,2,3,1
Jaxson Hayes,C-F,22023,1629637,22300127,"NOV 01, 2023",LAL vs. LAC,W,14,1,1,1.0,0,0,0.0,1,2,0.5,1,1,2,1,0,1,0,1,3,0,1,LAL,LAL,LAC,130,,,6,5,4,3
Jaxson Hayes,C-F,22023,1629637,22300061,"OCT 24, 2023",LAL @ DEN,L,7,0,0,0.0,0,0,0.0,0,0,0.0,0,1,1,0,0,0,0,1,0,-7,1,LAL,DEN,LAL,107,,,1,1,0,1
Jaxson Hayes,C-F,22023,1629637,22300747,"FEB 09, 2024",LAL vs. NOP,W,17,3,4,0.75,0,0,0.0,0,0,0.0,3,5,8,0,2,1,0,1,6,17,1,LAL,LAL,NOP,139,,,14,14,6,8
Jaxson Hayes,C-F,22023,1629637,22300403,"DEC 25, 2023",LAL vs. BOS,L,9,0,1,0.0,0,0,0.0,0,2,0.0,0,1,1,0,0,0,0,0,0,-5,1,LAL,LAL,BOS,115,,,1,1,0,1
Jaxson Hayes,C-F,22023,1629637,22300397,"DEC 23, 2023",LAL @ OKC,W,6,0,0,0.0,0,0,0.0,0,0,0.0,0,0,0,1,0,0,0,0,0,6,1,LAL,OKC,LAL,129,,,1,0,1,1
Jaxson Hayes,C-F,22023,1629637,22300380,"DEC 21, 2023",LAL @ MIN,L,11,1,1,1.0,0,0,0.0,1,1,1.0,1,2,3,1,0,0,1,2,3,-8,1,LAL,MIN,LAL,111,,,7,6,4,4
Jaxson Hayes,C-F,22023,1629637,22300359,"DEC 18, 2023",LAL vs. NYK,L,8,1,1,1.0,0,0,0.0,0,0,0.0,0,2,2,0,0,0,0,1,2,4,1,LAL,LAL,NYK,109,,,4,4,2,2
Jaxson Hayes,C-F,22023,1629637,22300216,"NOV 19, 2023",LAL vs. HOU,W,5,0,0,0.0,0,0,0.0,0,0,0.0,1,1,2,0,0,0,0,1,0,-4,1,LAL,LAL,HOU,105,,,2,2,0,2
Jaxson Hayes,C-F,22023,1629637,22300015,"NOV 10, 2023",LAL @ PHX,W,5,1,1,1.0,0,0,0.0,0,0,0.0,0,1,1,0,0,0,1,1,2,-5,1,LAL,PHX,LAL,122,,,3,3,2,1
Jaxson Hayes,C-F,22023,1629637,22300111,"OCT 30, 2023",LAL vs. ORL,W,10,0,0,0.0,0,0,0.0,0,0,0.0,0,2,2,0,0,0,0,2,0,5,1,LAL,LAL,ORL,106,,,2,2,0,2
Jaxson Hayes,C-F,22023,1629637,22300100,"OCT 29, 2023",LAL @ SAC,L,7,1,1,1.0,0,0,0.0,2,2,1.0,0,2,2,0,0,0,0,1,4,1,1,LAL,SAC,LAL,127,,,6,6,4,2
Jaxson Hayes,C-F,22023,1629637,22300076,"OCT 26, 2023",LAL vs. PHX,W,6,0,0,0.0,0,0,0.0,0,0,0.0,0,2,2,0,1,0,2,3,0,3,1,LAL,LAL,PHX,100,,,2,2,0,2
Jalen McDaniels,F-C,22023,1629667,22300432,"DEC 29, 2023",TOR @ BOS,L,15,5,10,0.5,2,7,0.286,1,2,0.5,0,0,0,2,1,0,0,4,13,8,1,TOR,BOS,TOR,118,,,15,13,15,2
Jalen McDaniels,F-C,22023,1629667,22300416,"DEC 27, 2023",TOR @ WAS,W,19,2,7,0.286,0,4,0.0,2,2,1.0,0,4,4,1,1,0,0,2,6,11,1,TOR,WAS,TOR,132,,,11,10,7,5
Jalen McDaniels,F-C,22023,1629667,22300382,"DEC 22, 2023",TOR @ PHI,L,2,1,1,1.0,1,1,1.0,0,0,0.0,0,2,2,0,0,0,0,0,3,3,1,TOR,PHI,TOR,111,,,5,5,3,2
Jalen McDaniels,F-C,22023,1629667,22300330,"DEC 15, 2023",TOR vs. ATL,L,3,0,3,0.0,0,2,0.0,0,0,0.0,0,0,0,0,0,0,0,0,0,1,1,TOR,TOR,ATL,104,,,0,0,0,0
Jalen McDaniels,F-C,22023,1629667,22300276,"DEC 01, 2023",TOR vs. NYK,L,7,1,4,0.25,0,2,0.0,0,0,0.0,1,1,2,1,0,0,0,1,2,8,1,TOR,TOR,NYK,106,,,5,4,3,3
Jalen McDaniels,F-C,22023,1629667,22300260,"NOV 29, 2023",TOR vs. PHX,W,9,0,1,0.0,0,1,0.0,0,0,0.0,0,0,0,0,0,0,2,2,0,-3,1,TOR,TOR,PHX,112,,,0,0,0,0
Jalen McDaniels,F-C,22023,1629667,22300054,"NOV 28, 2023",TOR @ BKN,L,13,2,4,0.5,1,1,1.0,0,0,0.0,1,1,2,1,2,1,0,2,5,2,1,TOR,BKN,TOR,103,,,8,7,6,3
Jalen McDaniels,F-C,22023,1629667,22300038,"NOV 21, 2023",TOR @ ORL,L,7,1,1,1.0,1,1,1.0,2,2,1.0,1,0,1,1,0,0,1,1,5,5,1,TOR,ORL,TOR,107,,,7,6,6,2
Jalen McDaniels,F-C,22023,1629667,22300211,"NOV 19, 2023",TOR vs. DET,W,8,2,4,0.5,0,1,0.0,0,0,0.0,0,1,1,1,0,0,1,1,4,-5,1,TOR,TOR,DET,142,,,6,5,5,2
Jalen McDaniels,F-C,22023,1629667,22300031,"NOV 17, 2023",TOR vs. BOS,L,7,2,5,0.4,0,1,0.0,0,0,0.0,0,0,0,0,0,0,0,0,4,-8,1,TOR,TOR,BOS,105,,,4,4,4,0
Jalen McDaniels,F-C,22023,1629667,22300195,"NOV 15, 2023",TOR vs. MIL,L,18,3,10,0.3,1,4,0.25,0,0,0.0,0,4,4,1,1,1,1,0,7,21,1,TOR,TOR,MIL,112,,,12,11,8,5
Jalen McDaniels,F-C,22023,1629667,22300189,"NOV 13, 2023",TOR vs. WAS,W,5,0,1,0.0,0,0,0.0,0,0,0.0,0,0,0,0,0,0,0,0,0,-6,1,TOR,TOR,WAS,111,,,0,0,0,0
Jalen McDaniels,F-C,22023,1629667,22300174,"NOV 11, 2023",TOR @ BOS,L,9,0,2,0.0,0,0,0.0,0,0,0.0,0,1,1,0,0,0,0,2,0,2,1,TOR,BOS,TOR,94,,,1,1,0,1
Jalen McDaniels,F-C,22023,1629667,22300092,"OCT 28, 2023",TOR vs. PHI,L,3,0,0,0.0,0,0,0.0,0,0,0.0,0,0,0,0,0,0,0,0,0,-5,1,TOR,TOR,PHI,107,,,0,0,0,0
Jalen McDaniels,F-C,22023,1629667,22300082,"OCT 27, 2023",TOR @ CHI,L,18,0,4,0.0,0,4,0.0,0,0,0.0,1,2,3,1,1,0,0,1,0,-25,1,TOR,CHI,TOR,103,,,4,3,1,4
Jalen McDaniels,F-C,22023,1629667,22300069,"OCT 25, 2023",TOR vs. MIN,W,16,0,3,0.0,0,3,0.0,0,0,0.0,0,2,2,2,1,1,0,2,0,-3,1,TOR,TOR,MIN,97,,,4,2,2,4
Jalen McDaniels,F-C,22023,1629667,22300756,"FEB 10, 2024",TOR vs. CLE,L,3,0,0,0.0,0,0,0.0,0,0,0.0,0,1,1,0,0,0,1,0,0,-3,1,TOR,TOR,CLE,95,,,1,1,0,1
Jalen McDaniels,F-C,22023,1629667,22300141,"NOV 05, 2023",TOR @ SAS,W,5,0,3,0.0,0,1,0.0,0,0,0.0,0,1,1,0,0,0,1,0,0,-4,1,TOR,SAS,TOR,123,,,1,1,0,1
Jalen McDaniels,F-C,22023,1629667,22300128,"NOV 02, 2023",TOR @ PHI,L,9,2,3,0.667,1,2,0.5,0,0,0.0,0,1,1,0,0,0,0,0,5,4,1,TOR,PHI,TOR,99,,,6,6,5,1
Jalen McDaniels,F-C,22023,1629667,22300105,"OCT 30, 2023",TOR vs. POR,L,5,0,1,0.0,0,1,0.0,0,0,0.0,0,0,0,1,0,0,0,1,0,-4,1,TOR,TOR,POR,91,,,1,0,1,1
Jalen McDaniels,F-C,22023,1629667,22300718,"FEB 05, 2024",TOR @ NOP,L,12,1,5,0.2,0,2,0.0,0,0,0.0,1,2,3,0,0,0,4,3,2,-4,1,TOR,NOP,TOR,100,,,5,5,2,3
Jalen McDaniels,F-C,22023,1629667,22300692,"FEB 02, 2024",TOR @ HOU,L,14,1,3,0.333,1,2,0.5,0,0,0.0,0,1,1,0,0,0,4,1,3,-13,1,TOR,HOU,TOR,106,,,4,4,3,1
Jalen McDaniels,F-C,22023,1629667,22300672,"JAN 30, 2024",TOR @ CHI,W,14,3,6,0.5,2,3,0.667,0,0,0.0,1,2,3,2,1,0,1,1,8,6,1,TOR,CHI,TOR,118,,,13,11,10,5
Jalen McDaniels,F-C,22023,1629667,22300637,"JAN 26, 2024",TOR vs. LAC,L,2,0,1,0.0,0,1,0.0,0,0,0.0,0,0,0,0,0,0,0,0,0,-4,1,TOR,TOR,LAC,107,,,0,0,0,0
Jalen McDaniels,F-C,22023,1629667,22300596,"JAN 20, 2024",TOR @ NYK,L,4,1,4,0.25,0,2,0.0,0,0,0.0,0,0,0,0,0,0,0,0,2,-2,1,TOR,NYK,TOR,94,,,2,2,2,0
Jalen McDaniels,F-C,22023,1629667,22300574,"JAN 17, 2024",TOR vs. MIA,W,2,0,1,0.0,0,1,0.0,0,0,0.0,0,0,0,0,1,0,0,0,0,2,1,TOR,TOR,MIA,115,,,0,0,0,0
Jalen McDaniels,F-C,22023,1629667,22300563,"JAN 15, 2024",TOR vs. BOS,L,12,2,5,0.4,1,3,0.333,0,2,0.0,1,1,2,0,0,0,0,0,5,-12,1,TOR,TOR,BOS,94,,,7,7,5,2
Jalen McDaniels,F-C,22023,1629667,22300540,"JAN 12, 2024",TOR @ UTA,L,8,4,5,0.8,0,0,0.0,7,10,0.7,2,1,3,0,1,0,1,0,15,-8,1,TOR,UTA,TOR,104,,,18,18,15,3
Jalen McDaniels,F-C,22023,1629667,22300526,"JAN 10, 2024",TOR @ LAC,L,13,1,2,0.5,0,0,0.0,0,0,0.0,0,3,3,1,1,0,0,2,2,0,1,TOR,LAC,TOR,111,,,6,5,3,4
Jalen McDaniels,F-C,22023,1629667,22300504,"JAN 07, 2024",TOR @ GSW,W,4,0,0,0.0,0,0,0.0,0,0,0.0,0,0,0,1,0,0,0,0,0,-5,1,TOR,GSW,TOR,131,,,1,0,1,1
Jalen McDaniels,F-C,22023,1629667,22300492,"JAN 05, 2024",TOR @ SAC,L,7,1,2,0.5,0,1,0.0,0,0,0.0,0,0,0,0,0,0,0,1,2,-5,1,TOR,SAC,TOR,120,,,2,2,2,0
Jalen McDaniels,F-C,22023,1629667,22300440,"DEC 30, 2023",TOR @ DET,L,17,0,3,0.0,0,1,0.0,2,2,1.0,0,1,1,0,0,0,1,3,2,-7,1,TOR,DET,TOR,127,,,3,3,2,1
Zeke Nnaji,F-C,22023,1630192,22300746,"FEB 09, 2024",DEN @ SAC,L,18,2,6,0.333,0,2,0.0,3,4,0.75,0,2,2,3,0,0,0,2,7,-11,1,DEN,SAC,DEN,106,,,12,9,10,5
Zeke Nnaji,F-C,22023,1630192,22300682,"JAN 31, 2024",DEN @ OKC,L,9,1,4,0.25,0,0,0.0,0,0,0.0,2,1,3,1,0,0,1,1,2,-12,1,DEN,OKC,DEN,100,,,6,5,3,4
Zeke Nnaji,F-C,22023,1630192,22300631,"JAN 25, 2024",DEN @ NYK,L,5,0,2,0.0,0,1,0.0,0,0,0.0,0,1,1,0,0,0,0,0,0,-3,1,DEN,NYK,DEN,84,,,1,1,0,1
Zeke Nnaji,F-C,22023,1630192,22300602,"JAN 21, 2024",DEN @ WAS,W,5,1,2,0.5,0,0,0.0,0,0,0.0,1,0,1,2,1,0,2,3,2,-4,1,DEN,WAS,DEN,113,,,5,3,4,3
Zeke Nnaji,F-C,22023,1630192,22300539,"JAN 12, 2024",DEN vs. NOP,W,2,0,1,0.0,0,0,0.0,0,0,0.0,0,0,0,0,0,0,0,0,0,-6,1,DEN,DEN,NOP,125,,,0,0,0,0
Zeke Nnaji,F-C,22023,1630192,22300524,"JAN 10, 2024",DEN @ UTA,L,6,1,2,0.5,1,1,1.0,2,2,1.0,0,0,0,1,1,0,0,2,5,12,1,DEN,UTA,DEN,111,,,6,5,6,1
Zeke Nnaji,F-C,22023,1630192,22300502,"JAN 07, 2024",DEN vs. DET,W,2,0,1,0.0,0,1,0.0,0,0,0.0,0,0,0,0,0,0,0,0,0,-6,1,DEN,DEN,DET,131,,,0,0,0,0
Zeke Nnaji,F-C,22023,1630192,22300488,"JAN 05, 2024",DEN vs. ORL,L,11,1,1,1.0,0,0,0.0,1,2,0.5,1,1,2,0,1,0,2,4,3,2,1,DEN,DEN,ORL,120,,,5,5,3,2
Zeke Nnaji,F-C,22023,1630192,22300478,"JAN 04, 2024",DEN @ GSW,W,6,1,1,1.0,0,0,0.0,0,0,0.0,1,2,3,1,0,0,0,0,2,-3,1,DEN,GSW,DEN,130,,,6,5,3,4
Zeke Nnaji,F-C,22023,1630192,22300455,"JAN 01, 2024",DEN vs. CHA,W,21,1,5,0.2,0,2,0.0,0,0,0.0,1,2,3,1,0,3,2,2,2,-9,1,DEN,DEN,CHA,111,,,6,5,3,4
Zeke Nnaji,F-C,22023,1630192,22300435,"DEC 29, 2023",DEN vs. OKC,L,3,0,1,0.0,0,0,0.0,0,0,0.0,0,0,0,0,0,0,0,0,0,-6,1,DEN,DEN,OKC,93,,,0,0,0,0
Zeke Nnaji,F-C,22023,1630192,22300425,"DEC 28, 2023",DEN vs. MEM,W,6,2,3,0.667,0,0,0.0,0,0,0.0,1,2,3,0,0,0,1,2,4,3,1,DEN,DEN,MEM,142,,,7,7,4,3
Zeke Nnaji,F-C,22023,1630192,22300402,"DEC 25, 2023",DEN vs. GSW,W,5,0,0,0.0,0,0,0.0,0,0,0.0,0,0,0,0,1,0,0,1,0,-11,1,DEN,DEN,GSW,120,,,0,0,0,0
Zeke Nnaji,F-C,22023,1630192,22300390,"DEC 23, 2023",DEN @ CHA,W,12,0,1,0.0,0,0,0.0,0,0,0.0,2,0,2,1,0,2,2,4,0,-7,1,DEN,CHA,DEN,102,,,3,2,1,3
Zeke Nnaji,F-C,22023,1630192,22300383,"DEC 22, 2023",DEN @ BKN,W,7,1,2,0.5,0,0,0.0,0,0,0.0,1,2,3,0,0,0,0,2,2,-9,1,DEN,BKN,DEN,122,,,5,5,2,3
Zeke Nnaji,F-C,22023,1630192,22300369,"DEC 20, 2023",DEN @ TOR,W,10,0,3,0.0,0,0,0.0,0,2,0.0,2,1,3,1,1,2,2,1,0,-6,1,DEN,TOR,DEN,113,,,4,3,1,4
Zeke Nnaji,F-C,22023,1630192,22300356,"DEC 18, 2023",DEN vs. DAL,W,20,5,8,0.625,0,2,0.0,4,4,1.0,2,2,4,2,1,1,1,4,14,10,1,DEN,DEN,DAL,130,,,20,18,16,6
Zeke Nnaji,F-C,22023,1630192,22300322,"DEC 14, 2023",DEN vs. BKN,W,6,2,2,1.0,1,1,1.0,0,0,0.0,3,0,3,1,0,0,0,1,5,4,1,DEN,DEN,BKN,124,,,9,8,6,4
Zeke Nnaji,F-C,22023,1630192,22300296,"DEC 11, 2023",DEN @ ATL,W,12,1,2,0.5,0,1,0.0,1,1,1.0,1,3,4,1,0,2,1,3,3,-1,1,DEN,ATL,DEN,129,,,8,7,4,5
Zeke Nnaji,F-C,22023,1630192,22300263,"NOV 29, 2023",DEN vs. HOU,W,18,2,4,0.5,0,0,0.0,3,4,0.75,2,1,3,0,0,1,0,2,7,-17,1,DEN,DEN,HOU,134,,,10,10,7,3
Zeke Nnaji,F-C,22023,1630192,22300257,"NOV 27, 2023",DEN @ LAC,W,12,3,8,0.375,0,0,0.0,2,5,0.4,7,0,7,0,0,3,1,2,8,-13,1,DEN,LAC,DEN,113,,,15,15,8,7
Zeke Nnaji,F-C,22023,1630192,22300252,"NOV 26, 2023",DEN vs. SAS,W,1,0,0,0.0,0,0,0.0,0,0,0.0,0,0,0,0,0,0,0,2,0,-2,1,DEN,DEN,SAS,132,,,0,0,0,0
Zeke Nnaji,F-C,22023,1630192,22300048,"NOV 24, 2023",DEN @ HOU,L,4,0,1,0.0,0,0,0.0,0,0,0.0,0,0,0,0,0,0,1,0,0,0,1,DEN,HOU,DEN,86,,,0,0,0,0
Zeke Nnaji,F-C,22023,1630192,22300226,"NOV 22, 2023",DEN @ ORL,L,12,1,2,0.5,0,0,0.0,1,2,0.5,1,0,1,2,0,0,0,1,3,-9,1,DEN,ORL,DEN,119,,,6,4,5,3
Zeke Nnaji,F-C,22023,1630192,22300218,"NOV 20, 2023",DEN @ DET,W,14,2,3,0.667,1,1,1.0,2,3,0.667,1,0,1,0,1,1,1,3,7,2,1,DEN,DET,DEN,107,,,8,8,7,1
Zeke Nnaji,F-C,22023,1630192,22300210,"NOV 19, 2023",DEN @ CLE,L,14,3,4,0.75,1,1,1.0,2,2,1.0,3,1,4,1,0,0,1,2,9,7,1,DEN,CLE,DEN,109,,,14,13,10,5
Zeke Nnaji,F-C,22023,1630192,22300034,"NOV 17, 2023",DEN @ NOP,L,4,0,1,0.0,0,0,0.0,0,0,0.0,0,0,0,0,0,0,2,2,0,-10,1,DEN,NOP,DEN,110,,,0,0,0,0
Zeke Nnaji,F-C,22023,1630192,22300024,"NOV 14, 2023",DEN vs. LAC,W,12,1,2,0.5,0,0,0.0,1,2,0.5,1,2,3,0,0,0,0,1,3,0,1,DEN,DEN,LAC,111,,,6,6,3,3
Zeke Nnaji,F-C,22023,1630192,22300182,"NOV 12, 2023",DEN @ HOU,L,11,1,4,0.25,0,1,0.0,0,0,0.0,2,2,4,0,0,0,0,0,2,-18,1,DEN,HOU,DEN,104,,,6,6,2,4
Zeke Nnaji,F-C,22023,1630192,22300169,"NOV 08, 2023",DEN vs. GSW,W,6,0,1,0.0,0,0,0.0,0,0,0.0,0,2,2,2,0,0,0,0,0,-3,1,DEN,DEN,GSW,108,,,4,2,2,4
Zeke Nnaji,F-C,22023,1630192,22300156,"NOV 06, 2023",DEN vs. NOP,W,6,0,0,0.0,0,0,0.0,0,0,0.0,1,1,2,1,0,1,1,2,0,-6,1,DEN,DEN,NOP,134,,,3,2,1,3
Zeke Nnaji,F-C,22023,1630192,22300139,"NOV 04, 2023",DEN vs. CHI,W,2,0,0,0.0,0,0,0.0,1,2,0.5,0,1,1,0,0,0,0,1,1,-1,1,DEN,DEN,CHI,123,,,2,2,1,1
Zeke Nnaji,F-C,22023,1630192,22300006,"NOV 03, 2023",DEN vs. DAL,W,12,2,2,1.0,0,0,0.0,0,1,0.0,1,3,4,0,0,0,1,0,4,-4,1,DEN,DEN,DAL,125,,,8,8,4,4
Zeke Nnaji,F-C,22023,1630192,22300123,"NOV 01, 2023",DEN @ MIN,L,18,4,9,0.444,1,3,0.333,0,0,0.0,2,3,5,0,0,2,0,3,9,-6,1,DEN,MIN,DEN,89,,,14,14,9,5
Zeke Nnaji,F-C,22023,1630192,22300110,"OCT 30, 2023",DEN vs. UTA,W,13,2,2,1.0,0,0,0.0,2,3,0.667,1,2,3,0,2,0,0,0,6,-5,1,DEN,DEN,UTA,110,,,9,9,6,3
Zeke Nnaji,F-C,22023,1630192,22300095,"OCT 29, 2023",DEN @ OKC,W,15,0,1,0.0,0,0,0.0,0,0,0.0,1,2,3,1,0,0,0,2,0,12,1,DEN,OKC,DEN,128,,,4,3,1,4
Zeke Nnaji,F-C,22023,1630192,22300078,"OCT 27, 2023",DEN @ MEM,W,13,3,4,0.75,0,0,0.0,1,2,0.5,0,1,1,0,0,2,1,1,7,-2,1,DEN,MEM,DEN,108,,,8,8,7,1
Zeke Nnaji,F-C,22023,1630192,22300061,"OCT 24, 2023",DEN vs. LAL,W,12,1,3,0.333,0,1,0.0,2,2,1.0,0,0,0,1,0,0,1,2,4,-3,1,DEN,DEN,LAL,119,,,5,4,5,1
Olivier-Maxence Prosper,F,22023,1641765,22300487,"JAN 05, 2024",DAL vs. POR,W,14,3,7,0.429,2,3,0.667,0,0,0.0,1,5,6,3,0,0,0,3,8,2,1,DAL,DAL,POR,132,,,17,14,11,9
Olivier-Maxence Prosper,F,22023,1641765,22300398,"DEC 23, 2023",DAL vs. SAS,W,12,0,3,0.0,0,1,0.0,0,0,0.0,0,2,2,0,0,0,0,1,0,-6,1,DAL,DAL,SAS,144,,,2,2,0,2
Olivier-Maxence Prosper,F,22023,1641765,22300385,"DEC 22, 2023",DAL @ HOU,L,30,6,13,0.462,1,4,0.25,7,9,0.778,5,1,6,2,1,0,3,2,20,-5,1,DAL,HOU,DAL,96,,,28,26,22,8
Olivier-Maxence Prosper,F,22023,1641765,22300356,"DEC 18, 2023",DAL @ DEN,L,20,1,5,0.2,0,2,0.0,0,0,0.0,1,3,4,3,0,0,0,1,2,-6,1,DAL,DEN,DAL,104,,,9,6,5,7
Olivier-Maxence Prosper,F,22023,1641765,22300341,"DEC 16, 2023",DAL @ POR,W,6,0,1,0.0,0,1,0.0,0,0,0.0,2,3,5,1,0,0,0,0,0,3,1,DAL,POR,DAL,131,,,6,5,1,6
Olivier-Maxence Prosper,F,22023,1641765,22300321,"DEC 14, 2023",DAL vs. MIN,L,3,1,1,1.0,0,0,0.0,0,0,0.0,0,0,0,0,0,0,0,0,2,1,1,DAL,DAL,MIN,101,,,2,2,2,0
Olivier-Maxence Prosper,F,22023,1641765,22300680,"JAN 31, 2024",DAL @ MIN,L,20,1,2,0.5,0,1,0.0,4,7,0.571,1,3,4,0,0,0,0,1,6,-12,1,DAL,MIN,DAL,82,,,10,10,6,4
Olivier-Maxence Prosper,F,22023,1641765,22300472,"JAN 03, 2024",DAL vs. POR,W,8,1,3,0.333,0,0,0.0,3,4,0.75,2,3,5,1,0,1,0,1,5,-3,1,DAL,DAL,POR,126,,,11,10,6,6
Olivier-Maxence Prosper,F,22023,1641765,22300405,"DEC 25, 2023",DAL @ PHX,W,0,0,0,0.0,0,0,0.0,0,0,0.0,0,0,0,0,0,0,0,0,0,0,1,DAL,PHX,DAL,128,,,0,0,0,0
Olivier-Maxence Prosper,F,22023,1641765,22300306,"DEC 12, 2023",DAL vs. LAL,W,1,0,0,0.0,0,0,0.0,0,0,0.0,0,0,0,0,0,0,0,0,0,-3,1,DAL,DAL,LAL,127,,,0,0,0,0
Olivier-Maxence Prosper,F,22023,1641765,22300299,"DEC 11, 2023",DAL @ MEM,W,18,4,7,0.571,3,6,0.5,0,0,0.0,0,4,4,2,0,1,1,2,11,-5,1,DAL,MEM,DAL,120,,,17,15,13,6
Olivier-Maxence Prosper,F,22023,1641765,22301226,"DEC 08, 2023",DAL @ POR,W,5,0,1,0.0,0,1,0.0,0,0,0.0,0,1,1,0,0,0,0,0,0,1,1,DAL,POR,DAL,125,,,1,1,0,1
Olivier-Maxence Prosper,F,22023,1641765,22301213,"DEC 06, 2023",DAL vs. UTA,W,21,2,4,0.5,1,2,0.5,1,2,0.5,1,4,5,2,0,0,0,1,6,17,1,DAL,DAL,UTA,147,,,13,11,8,7
Olivier-Maxence Prosper,F,22023,1641765,22300287,"DEC 02, 2023",DAL vs. OKC,L,14,0,2,0.0,0,1,0.0,2,2,1.0,1,0,1,1,0,0,0,2,2,-4,1,DAL,DAL,OKC,120,,,4,3,3,2
Olivier-Maxence Prosper,F,22023,1641765,22300277,"DEC 01, 2023",DAL vs. MEM,L,11,0,1,0.0,0,1,0.0,2,2,1.0,0,0,0,2,0,0,0,0,2,4,1,DAL,DAL,MEM,94,,,4,2,4,2
Olivier-Maxence Prosper,F,22023,1641765,22300244,"NOV 25, 2023",DAL @ LAC,L,6,0,2,0.0,0,2,0.0,0,0,0.0,0,0,0,0,1,0,0,0,0,-1,1,DAL,LAC,DAL,88,,,0,0,0,0
Olivier-Maxence Prosper,F,22023,1641765,22300192,"NOV 15, 2023",DAL @ WAS,W,7,1,2,0.5,0,1,0.0,0,2,0.0,0,2,2,1,0,0,0,0,2,-2,1,DAL,WAS,DAL,130,,,5,4,3,3
Olivier-Maxence Prosper,F,22023,1641765,22300022,"NOV 14, 2023",DAL @ NOP,L,9,2,3,0.667,1,2,0.5,1,2,0.5,1,2,3,0,0,0,0,0,6,7,1,DAL,NOP,DAL,110,,,9,9,6,3
Olivier-Maxence Prosper,F,22023,1641765,22300183,"NOV 12, 2023",DAL @ NOP,W,6,1,3,0.333,0,2,0.0,2,2,1.0,0,0,0,0,0,0,0,2,4,-11,1,DAL,NOP,DAL,136,,,4,4,4,0
Olivier-Maxence Prosper,F,22023,1641765,22300014,"NOV 10, 2023",DAL vs. LAC,W,5,0,1,0.0,0,0,0.0,1,2,0.5,1,0,1,0,0,0,0,1,1,-13,1,DAL,DAL,LAC,144,,,2,2,1,1
Olivier-Maxence Prosper,F,22023,1641765,22300006,"NOV 03, 2023",DAL @ DEN,L,1,0,1,0.0,0,0,0.0,0,0,0.0,0,0,0,0,0,0,0,0,0,2,1,DAL,DEN,DAL,114,,,0,0,0,0
Olivier-Maxence Prosper,F,22023,1641765,22300748,"FEB 10, 2024",DAL vs. OKC,W,6,1,2,0.5,0,1,0.0,0,0,0.0,0,2,2,0,0,0,0,0,2,0,1,DAL,DAL,OKC,146,,,4,4,2,2
Olivier-Maxence Prosper,F,22023,1641765,22300736,"FEB 08, 2024",DAL @ NYK,W,1,0,0,0.0,0,0,0.0,0,0,0.0,0,0,0,0,0,0,0,0,0,-2,1,DAL,NYK,DAL,121,,,0,0,0,0
Olivier-Maxence Prosper,F,22023,1641765,22300715,"FEB 05, 2024",DAL @ PHI,W,3,0,2,0.0,0,0,0.0,0,0,0.0,1,0,1,0,1,0,0,0,0,-1,1,DAL,PHI,DAL,118,,,1,1,0,1
Olivier-Maxence Prosper,F,22023,1641765,22300625,"JAN 24, 2024",DAL vs. PHX,L,5,0,0,0.0,0,0,0.0,0,0,0.0,0,0,0,0,0,0,0,0,0,0,1,DAL,DAL,PHX,107,,,0,0,0,0
Olivier-Maxence Prosper,F,22023,1641765,22300457,"JAN 01, 2024",DAL @ UTA,L,7,0,2,0.0,0,1,0.0,0,0,0.0,0,3,3,0,0,0,0,0,0,-13,1,DAL,UTA,DAL,86,,,3,3,0,3
Olivier-Maxence Prosper,F,22023,1641765,22300372,"DEC 20, 2023",DAL vs. LAC,L,3,0,0,0.0,0,0,0.0,0,0,0.0,0,1,1,1,0,0,0,0,0,3,1,DAL,DAL,LAC,111,,,2,1,1,2
Olivier-Maxence Prosper,F,22023,1641765,22300212,"NOV 19, 2023",DAL vs. SAC,L,5,0,1,0.0,0,1,0.0,0,0,0.0,0,3,3,0,0,0,0,0,0,5,1,DAL,DAL,SAC,113,,,3,3,0,3
Ricky Council IV,G,22023,1641741,22300742,"FEB 09, 2024",PHI vs. ATL,L,7,1,3,0.333,0,1,0.0,2,2,1.0,0,2,2,0,0,0,0,1,4,0,1,PHI,PHI,ATL,121,,,6,6,4,2
Ricky Council IV,G,22023,1641741,22300727,"FEB 07, 2024",PHI vs. GSW,L,10,4,7,0.571,1,3,0.333,8,8,1.0,0,0,0,0,0,0,0,1,17,4,1,PHI,PHI,GSW,104,,,17,17,17,0
Ricky Council IV,G,22023,1641741,22300715,"FEB 05, 2024",PHI vs. DAL,L,6,2,2,1.0,0,0,0.0,3,4,0.75,0,0,0,0,0,0,1,1,7,4,1,PHI,PHI,DAL,102,,,7,7,7,0
Ricky Council IV,G,22023,1641741,22300698,"FEB 03, 2024",PHI vs. BKN,L,12,2,4,0.5,1,1,1.0,0,1,0.0,1,4,5,1,0,0,0,0,5,8,1,PHI,PHI,BKN,121,,,11,10,6,6
Ricky Council IV,G,22023,1641741,22300668,"JAN 29, 2024",PHI @ POR,L,9,2,4,0.5,0,0,0.0,4,4,1.0,2,0,2,0,1,0,0,0,8,-5,1,PHI,POR,PHI,104,,,10,10,8,2
Ricky Council IV,G,22023,1641741,22300459,"JAN 02, 2024",PHI vs. CHI,W,6,0,1,0.0,0,1,0.0,0,0,0.0,0,0,0,0,0,0,0,0,0,-12,1,PHI,PHI,CHI,110,,,0,0,0,0
Ricky Council IV,G,22023,1641741,22300627,"JAN 25, 2024",PHI @ IND,L,12,3,6,0.5,1,1,1.0,4,6,0.667,1,0,1,0,1,0,0,0,11,9,1,PHI,IND,PHI,122,,,12,12,11,1
Ricky Council IV,G,22023,1641741,22300608,"JAN 22, 2024",PHI vs. SAS,W,1,0,1,0.0,0,0,0.0,0,0,0.0,0,0,0,0,0,0,0,0,0,-5,1,PHI,PHI,SAS,133,,,0,0,0,0
Ricky Council IV,G,22023,1641741,22300593,"JAN 20, 2024",PHI @ CHA,W,0,0,0,0.0,0,0,0.0,0,0,0.0,0,0,0,0,0,0,0,0,0,-4,1,PHI,CHA,PHI,97,,,0,0,0,0
Ricky Council IV,G,22023,1641741,22300585,"JAN 19, 2024",PHI @ ORL,W,2,0,0,0.0,0,0,0.0,1,2,0.5,0,0,0,0,0,0,0,1,1,2,1,PHI,ORL,PHI,124,,,1,1,1,0
Ricky Council IV,G,22023,1641741,22300673,"JAN 30, 2024",PHI @ GSW,L,2,1,1,1.0,0,0,0.0,0,0,0.0,0,0,0,0,0,0,0,0,2,-1,1,PHI,GSW,PHI,107,,,2,2,2,0
Ricky Council IV,G,22023,1641741,22300753,"FEB 10, 2024",PHI @ WAS,W,29,7,13,0.538,0,1,0.0,5,8,0.625,5,5,10,1,0,0,0,2,19,1,1,PHI,WAS,PHI,119,,,30,29,20,11
Ben Sheppard,G,22023,1641767,22300533,"JAN 12, 2024",IND @ ATL,W,4,0,0,0.0,0,0,0.0,0,0,0.0,0,0,0,0,0,0,0,0,0,-2,1,IND,ATL,IND,126,,,0,0,0,0
Ben Sheppard,G,22023,1641767,22300480,"JAN 05, 2024",IND vs. ATL,W,9,1,3,0.333,1,3,0.333,0,0,0.0,0,1,1,1,1,0,0,0,3,0,1,IND,IND,ATL,148,,,5,4,4,2
Ben Sheppard,G,22023,1641767,22300466,"JAN 03, 2024",IND vs. MIL,W,2,0,1,0.0,0,1,0.0,0,0,0.0,0,0,0,0,0,0,0,0,0,-5,1,IND,IND,MIL,142,,,0,0,0,0
Ben Sheppard,G,22023,1641767,22300338,"DEC 16, 2023",IND @ MIN,L,17,3,5,0.6,0,2,0.0,2,4,0.5,1,2,3,0,2,0,0,1,8,-6,1,IND,MIN,IND,109,,,11,11,8,3
Ben Sheppard,G,22023,1641767,22300328,"DEC 15, 2023",IND @ WAS,L,9,0,1,0.0,0,1,0.0,0,0,0.0,0,0,0,3,0,0,0,2,0,3,1,IND,WAS,IND,123,,,3,0,3,3
Ben Sheppard,G,22023,1641767,22300315,"DEC 13, 2023",IND @ MIL,L,6,3,6,0.5,2,3,0.667,0,0,0.0,0,0,0,0,1,0,0,2,8,4,1,IND,MIL,IND,126,,,8,8,8,0
Ben Sheppard,G,22023,1641767,22300284,"DEC 02, 2023",IND @ MIA,W,3,0,0,0.0,0,0,0.0,0,0,0.0,0,0,0,0,0,0,0,2,0,-7,1,IND,MIA,IND,144,,,0,0,0,0
Ben Sheppard,G,22023,1641767,22300267,"NOV 30, 2023",IND @ MIA,L,0,0,0,0.0,0,0,0.0,0,0,0.0,0,0,0,0,0,0,0,0,0,0,1,IND,MIA,IND,132,,,0,0,0,0
Ben Sheppard,G,22023,1641767,22300254,"NOV 27, 2023",IND vs. POR,L,1,0,0,0.0,0,0,0.0,0,0,0.0,0,0,0,0,0,0,0,0,0,-3,1,IND,IND,POR,110,,,0,0,0,0
Ben Sheppard,G,22023,1641767,22300047,"NOV 24, 2023",IND vs. DET,W,1,0,0,0.0,0,0,0.0,0,0,0.0,0,0,0,0,0,0,0,0,0,2,1,IND,IND,DET,136,,,0,0,0,0
Ben Sheppard,G,22023,1641767,22300039,"NOV 21, 2023",IND @ ATL,W,5,2,5,0.4,1,4,0.25,0,0,0.0,0,1,1,1,0,0,0,0,5,-9,1,IND,ATL,IND,157,,,7,6,6,2
Ben Sheppard,G,22023,1641767,22300209,"NOV 19, 2023",IND vs. ORL,L,16,2,5,0.4,1,3,0.333,2,2,1.0,0,0,0,2,1,0,1,0,7,25,1,IND,IND,ORL,116,,,9,7,9,2
Ben Sheppard,G,22023,1641767,22300146,"NOV 06, 2023",IND vs. SAS,W,12,3,7,0.429,1,4,0.25,0,0,0.0,0,2,2,0,0,0,0,1,7,9,1,IND,IND,SAS,152,,,9,9,7,2
Ben Sheppard,G,22023,1641767,22300118,"NOV 01, 2023",IND @ BOS,L,15,2,4,0.5,2,4,0.5,0,0,0.0,1,1,2,2,0,0,0,3,6,-15,1,IND,BOS,IND,104,,,10,8,8,4
Ben Sheppard,G,22023,1641767,22300064,"OCT 25, 2023",IND vs. WAS,W,6,0,1,0.0,0,0,0.0,0,0,0.0,0,0,0,0,0,0,0,0,0,3,1,IND,IND,WAS,143,,,0,0,0,0
Ben Sheppard,G,22023,1641767,22300707,"FEB 04, 2024",IND @ CHA,W,2,0,1,0.0,0,1,0.0,0,0,0.0,0,0,0,0,0,0,0,0,0,0,1,IND,CHA,IND,115,,,0,0,0,0
Ben Sheppard,G,22023,1641767,22300627,"JAN 25, 2024",IND vs. PHI,W,15,1,4,0.25,0,2,0.0,0,0,0.0,0,5,5,2,0,0,0,5,2,-3,1,IND,IND,PHI,134,,,9,7,4,7
Ben Sheppard,G,22023,1641767,22300564,"JAN 15, 2024",IND @ UTA,L,25,1,7,0.143,0,5,0.0,2,2,1.0,2,1,3,2,0,0,0,4,4,-2,1,IND,UTA,IND,105,,,9,7,6,5
Ben Sheppard,G,22023,1641767,22300493,"JAN 06, 2024",IND vs. BOS,L,3,0,0,0.0,0,0,0.0,0,0,0.0,0,1,1,0,0,0,0,0,0,-3,1,IND,IND,BOS,101,,,1,1,0,1
Ben Sheppard,G,22023,1641767,22300733,"FEB 08, 2024",IND vs. GSW,L,20,3,5,0.6,1,3,0.333,1,1,1.0,0,0,0,0,0,1,1,2,8,-11,1,IND,IND,GSW,109,,,8,8,8,0
Ben Sheppard,G,22023,1641767,22300719,"FEB 06, 2024",IND vs. HOU,W,4,0,1,0.0,0,1,0.0,0,0,0.0,0,0,0,0,0,0,0,0,0,-4,1,IND,IND,HOU,132,,,0,0,0,0
Ben Sheppard,G,22023,1641767,22300691,"FEB 02, 2024",IND vs. SAC,L,16,2,6,0.333,1,5,0.2,2,2,1.0,0,1,1,0,0,0,0,0,7,-1,1,IND,IND,SAC,122,,,8,8,7,1
Ben Sheppard,G,22023,1641767,22300685,"FEB 01, 2024",IND @ NYK,L,22,2,4,0.5,1,3,0.333,0,0,0.0,0,6,6,1,3,0,2,4,5,3,1,IND,NYK,IND,105,,,12,11,6,7
Ben Sheppard,G,22023,1641767,22300670,"JAN 30, 2024",IND @ BOS,L,12,0,2,0.0,0,2,0.0,0,0,0.0,0,2,2,0,0,0,0,2,0,-11,1,IND,BOS,IND,124,,,2,2,0,2
Ben Sheppard,G,22023,1641767,22300590,"JAN 19, 2024",IND @ POR,L,10,1,4,0.25,1,3,0.333,0,0,0.0,0,1,1,0,1,0,0,1,3,-15,1,IND,POR,IND,115,,,4,4,3,1
Ben Sheppard,G,22023,1641767,22300441,"DEC 30, 2023",IND vs. NYK,W,1,0,0,0.0,0,0,0.0,0,0,0.0,0,0,0,0,0,0,0,0,0,-3,1,IND,IND,NYK,140,,,0,0,0,0
Ben Sheppard,G,22023,1641767,22300652,"JAN 28, 2024",IND vs. MEM,W,20,2,6,0.333,2,4,0.5,0,0,0.0,0,0,0,1,1,0,1,2,6,0,1,IND,IND,MEM,116,,,7,6,7,1
Ben Sheppard,G,22023,1641767,22300636,"JAN 26, 2024",IND vs. PHX,W,18,1,4,0.25,0,3,0.0,0,0,0.0,0,2,2,2,0,0,1,2,2,-1,1,IND,IND,PHX,133,,,6,4,4,4
Ben Sheppard,G,22023,1641767,22300614,"JAN 23, 2024",IND vs. DEN,L,12,2,2,1.0,1,1,1.0,0,0,0.0,1,0,1,1,1,0,0,1,5,7,1,IND,IND,DEN,109,,,7,6,6,2
Ben Sheppard,G,22023,1641767,22300604,"JAN 21, 2024",IND @ PHX,L,20,1,4,0.25,0,1,0.0,2,2,1.0,2,2,4,4,2,0,0,3,4,10,1,IND,PHX,IND,110,,,12,8,8,8
Ben Sheppard,G,22023,1641767,22300583,"JAN 18, 2024",IND @ SAC,W,28,2,5,0.4,2,3,0.667,1,2,0.5,0,4,4,2,2,0,0,4,7,14,1,IND,SAC,IND,126,,,13,11,9,6
Davis Bertans,F,22023,202722,22300751,"FEB 10, 2024",CHA vs. MEM,W,12,3,5,0.6,3,5,0.6,0,0,0.0,0,2,2,1,2,0,0,1,9,10,1,CHA,CHA,MEM,115,,,12,11,10,3
Davis Bertans,F,22023,202722,22300682,"JAN 31, 2024",OKC vs. DEN,W,0,0,0,0.0,0,0,0.0,0,0,0.0,0,0,0,0,0,0,0,0,0,0,1,OKC,OKC,DEN,105,,,0,0,0,0
Davis Bertans,F,22023,202722,22300622,"JAN 24, 2024",OKC @ SAS,W,5,1,1,1.0,1,1,1.0,0,0,0.0,0,0,0,1,1,0,0,0,3,-4,1,OKC,SAS,OKC,140,,,4,3,4,1
Davis Bertans,F,22023,202722,22300617,"JAN 23, 2024",OKC vs. POR,W,3,0,1,0.0,0,1,0.0,0,0,0.0,0,0,0,0,0,1,0,0,0,-3,1,OKC,OKC,POR,111,,,0,0,0,0
Davis Bertans,F,22023,202722,22300481,"JAN 05, 2024",OKC @ BKN,L,1,0,1,0.0,0,1,0.0,0,0,0.0,0,0,0,0,0,0,0,0,0,0,1,OKC,BKN,OKC,115,,,0,0,0,0
Davis Bertans,F,22023,202722,22300419,"DEC 27, 2023",OKC vs. NYK,W,1,1,2,0.5,1,1,1.0,0,0,0.0,1,0,1,0,0,0,0,0,3,1,1,OKC,OKC,NYK,129,,,4,4,3,1
Davis Bertans,F,22023,202722,22300397,"DEC 23, 2023",OKC vs. LAL,L,10,1,2,0.5,1,2,0.5,0,0,0.0,0,1,1,1,0,0,0,0,3,5,1,OKC,OKC,LAL,120,,,5,4,4,2
Davis Bertans,F,22023,202722,22300324,"DEC 14, 2023",OKC @ SAC,L,5,0,1,0.0,0,1,0.0,0,0,0.0,1,2,3,1,0,0,1,1,0,-3,1,OKC,SAC,OKC,123,,,4,3,1,4
Davis Bertans,F,22023,202722,22300302,"DEC 11, 2023",OKC vs. UTA,W,9,1,2,0.5,1,2,0.5,0,0,0.0,0,0,0,1,0,1,0,1,3,-17,1,OKC,OKC,UTA,134,,,4,3,4,1
Davis Bertans,F,22023,202722,22301222,"DEC 08, 2023",OKC vs. GSW,W,0,0,0,0.0,0,0,0.0,0,0,0.0,0,0,0,0,0,0,0,0,0,2,1,OKC,OKC,GSW,138,,,0,0,0,0
Davis Bertans,F,22023,202722,22300287,"DEC 02, 2023",OKC @ DAL,W,11,3,3,1.0,3,3,1.0,6,6,1.0,0,1,1,1,1,0,0,3,15,16,1,OKC,DAL,OKC,126,,,17,16,16,2
Davis Bertans,F,22023,202722,22300239,"NOV 25, 2023",OKC vs. PHI,L,10,1,3,0.333,1,2,0.5,2,3,0.667,0,1,1,1,0,0,0,2,5,9,1,OKC,OKC,PHI,123,,,7,6,6,2
Davis Bertans,F,22023,202722,22300215,"NOV 19, 2023",OKC @ POR,W,11,1,5,0.2,1,5,0.2,0,0,0.0,0,2,2,2,0,1,0,0,3,11,1,OKC,POR,OKC,134,,,7,5,5,4
Davis Bertans,F,22023,202722,22300185,"NOV 12, 2023",OKC @ PHX,W,3,0,0,0.0,0,0,0.0,0,0,0.0,0,0,0,0,0,0,0,0,0,-5,1,OKC,PHX,OKC,111,,,0,0,0,0
Davis Bertans,F,22023,202722,22300167,"NOV 08, 2023",OKC vs. CLE,W,10,0,3,0.0,0,3,0.0,3,3,1.0,0,0,0,1,1,0,0,2,3,4,1,OKC,OKC,CLE,128,,,4,3,4,1
Davis Bertans,F,22023,202722,22300109,"OCT 30, 2023",OKC vs. DET,W,13,1,2,0.5,1,2,0.5,3,3,1.0,0,1,1,0,0,0,0,1,6,8,1,OKC,OKC,DET,124,,,7,7,6,1
Udoka Azubuike,C-F,22023,1628962,22300739,"FEB 08, 2024",PHX vs. UTA,W,1,0,0,0.0,0,0,0.0,0,0,0.0,0,0,0,0,0,0,0,0,0,0,1,PHX,PHX,UTA,129,,,0,0,0,0
Udoka Azubuike,C-F,22023,1628962,22300655,"JAN 28, 2024",PHX @ ORL,L,11,1,3,0.333,0,0,0.0,0,2,0.0,2,4,6,0,0,0,0,1,2,-3,1,PHX,ORL,PHX,98,,,8,8,2,6
Udoka Azubuike,C-F,22023,1628962,22300588,"JAN 19, 2024",PHX @ NOP,W,12,1,1,1.0,0,0,0.0,1,2,0.5,0,1,1,1,0,0,1,3,3,-13,1,PHX,NOP,PHX,123,,,5,4,4,2
Udoka Azubuike,C-F,22023,1628962,22300531,"JAN 11, 2024",PHX @ LAL,W,5,1,1,1.0,0,0,0.0,0,0,0.0,1,0,1,0,0,0,0,2,2,-6,1,PHX,LAL,PHX,127,,,3,3,2,1
Udoka Azubuike,C-F,22023,1628962,22300473,"JAN 03, 2024",PHX vs. LAC,L,2,0,0,0.0,0,0,0.0,0,0,0.0,0,0,0,0,0,0,0,0,0,-3,1,PHX,PHX,LAC,122,,,0,0,0,0
Udoka Azubuike,C-F,22023,1628962,22300456,"JAN 01, 2024",PHX vs. POR,W,4,0,2,0.0,0,0,0.0,0,2,0.0,0,2,2,0,0,0,0,0,0,-2,1,PHX,PHX,POR,109,,,2,2,0,2
Udoka Azubuike,C-F,22023,1628962,22300450,"DEC 31, 2023",PHX vs. ORL,W,8,0,0,0.0,0,0,0.0,0,0,0.0,0,1,1,0,0,1,1,1,0,-13,1,PHX,PHX,ORL,112,,,1,1,0,1
Udoka Azubuike,C-F,22023,1628962,22300436,"DEC 29, 2023",PHX vs. CHA,W,6,0,0,0.0,0,0,0.0,0,0,0.0,0,0,0,0,0,2,1,1,0,3,1,PHX,PHX,CHA,133,,,0,0,0,0
Udoka Azubuike,C-F,22023,1628962,22300418,"DEC 27, 2023",PHX @ HOU,W,19,5,7,0.714,0,0,0.0,1,3,0.333,3,2,5,0,0,2,0,4,11,15,1,PHX,HOU,PHX,129,,,16,16,11,5
Udoka Azubuike,C-F,22023,1628962,22300405,"DEC 25, 2023",PHX vs. DAL,L,4,2,2,1.0,0,0,0.0,0,0,0.0,0,0,0,0,0,0,0,0,4,2,1,PHX,PHX,DAL,114,,,4,4,4,0
Udoka Azubuike,C-F,22023,1628962,22300387,"DEC 22, 2023",PHX @ SAC,L,22,5,5,1.0,0,0,0.0,1,2,0.5,5,6,11,2,0,1,1,4,11,1,1,PHX,SAC,PHX,105,,,24,22,13,13
Udoka Azubuike,C-F,22023,1628962,22300140,"NOV 05, 2023",PHX @ DET,W,3,0,0,0.0,0,0,0.0,0,0,0.0,0,1,1,0,0,0,0,1,0,-5,1,PHX,DET,PHX,120,,,1,1,0,1
Udoka Azubuike,C-F,22023,1628962,22300094,"OCT 28, 2023",PHX vs. UTA,W,6,1,1,1.0,0,0,0.0,0,0,0.0,0,3,3,0,0,0,0,0,2,-4,1,PHX,PHX,UTA,126,,,5,5,2,3
Bruno Fernando,F-C,22023,1628981,22300742,"FEB 09, 2024",ATL @ PHI,W,14,4,4,1.0,0,0,0.0,0,0,0.0,0,3,3,0,0,2,0,4,8,-2,1,ATL,PHI,ATL,127,,,11,11,8,3
Bruno Fernando,F-C,22023,1628981,22300729,"FEB 07, 2024",ATL @ BOS,L,12,2,4,0.5,0,0,0.0,5,6,0.833,1,3,4,1,0,0,1,1,9,-12,1,ATL,BOS,ATL,117,,,14,13,10,5
Bruno Fernando,F-C,22023,1628981,22300716,"FEB 05, 2024",ATL vs. LAC,L,14,3,6,0.5,0,0,0.0,1,3,0.333,1,3,4,1,0,2,0,1,7,2,1,ATL,ATL,LAC,144,,,12,11,8,5
Bruno Fernando,F-C,22023,1628981,22300595,"JAN 20, 2024",ATL vs. CLE,L,3,0,1,0.0,0,1,0.0,0,0,0.0,0,1,1,1,0,0,0,0,0,3,1,ATL,ATL,CLE,95,,,2,1,1,2
Bruno Fernando,F-C,22023,1628981,22300543,"JAN 13, 2024",ATL vs. WAS,L,5,1,1,1.0,0,0,0.0,2,2,1.0,0,2,2,0,0,0,1,0,4,1,1,ATL,ATL,WAS,99,,,6,6,4,2
Bruno Fernando,F-C,22023,1628981,22300533,"JAN 12, 2024",ATL vs. IND,L,4,0,1,0.0,0,1,0.0,0,0,0.0,0,1,1,0,0,0,0,0,0,2,1,ATL,ATL,IND,108,,,1,1,0,1
Bruno Fernando,F-C,22023,1628981,22300521,"JAN 10, 2024",ATL vs. PHI,W,17,3,4,0.75,0,0,0.0,2,9,0.222,2,3,5,0,1,3,1,2,8,8,1,ATL,ATL,PHI,139,,,13,13,8,5
Bruno Fernando,F-C,22023,1628981,22300480,"JAN 05, 2024",ATL @ IND,L,7,2,2,1.0,0,0,0.0,2,2,1.0,0,2,2,0,0,1,0,1,6,-2,1,ATL,IND,ATL,116,,,8,8,6,2
Bruno Fernando,F-C,22023,1628981,22300445,"DEC 31, 2023",ATL @ WAS,W,15,0,2,0.0,0,0,0.0,0,0,0.0,0,3,3,2,1,0,1,4,0,7,1,ATL,WAS,ATL,130,,,5,3,2,5
Bruno Fernando,F-C,22023,1628981,22300336,"DEC 16, 2023",ATL @ CLE,L,16,5,7,0.714,0,0,0.0,3,5,0.6,2,6,8,1,0,1,0,2,13,7,1,ATL,CLE,ATL,119,,,22,21,14,9
Bruno Fernando,F-C,22023,1628981,22300330,"DEC 15, 2023",ATL @ TOR,W,1,0,0,0.0,0,0,0.0,0,0,0.0,0,0,0,0,0,0,0,0,0,-3,1,ATL,TOR,ATL,125,,,0,0,0,0
Bruno Fernando,F-C,22023,1628981,22300055,"NOV 28, 2023",ATL @ CLE,L,4,1,6,0.167,0,0,0.0,0,0,0.0,2,1,3,0,0,0,1,1,2,0,1,ATL,CLE,ATL,105,,,5,5,2,3
Bruno Fernando,F-C,22023,1628981,22300241,"NOV 25, 2023",ATL @ WAS,W,5,2,2,1.0,0,0,0.0,1,1,1.0,1,0,1,0,0,0,1,0,5,-2,1,ATL,WAS,ATL,136,,,6,6,5,1
Bruno Fernando,F-C,22023,1628981,22300172,"NOV 09, 2023",ATL @ ORL,W,1,0,0,0.0,0,0,0.0,0,0,0.0,0,0,0,0,0,0,0,1,0,7,1,ATL,ORL,ATL,120,,,0,0,0,0
Bruno Fernando,F-C,22023,1628981,22300104,"OCT 30, 2023",ATL vs. MIN,W,1,0,0,0.0,0,0,0.0,0,0,0.0,0,0,0,0,0,0,0,0,0,-4,1,ATL,ATL,MIN,127,,,0,0,0,0
Bruno Fernando,F-C,22023,1628981,22300097,"OCT 29, 2023",ATL @ MIL,W,5,0,1,0.0,0,1,0.0,0,0,0.0,0,0,0,0,0,0,2,1,0,-7,1,ATL,MIL,ATL,127,,,0,0,0,0
Luka Samanic,F,22023,1629677,22300660,"JAN 29, 2024",UTA @ BKN,L,8,1,1,1.0,0,0,0.0,3,4,0.75,0,1,1,0,0,1,0,1,5,-11,1,UTA,BKN,UTA,114,,,6,6,5,1
Luka Samanic,F,22023,1629677,22300628,"JAN 25, 2024",UTA @ WAS,W,1,0,0,0.0,0,0,0.0,0,0,0.0,0,0,0,0,0,0,0,0,0,-3,1,UTA,WAS,UTA,123,,,0,0,0,0
Luka Samanic,F,22023,1629677,22300616,"JAN 23, 2024",UTA @ NOP,L,5,0,1,0.0,0,1,0.0,0,0,0.0,0,0,0,0,0,0,0,0,0,-3,1,UTA,NOP,UTA,124,,,0,0,0,0
Luka Samanic,F,22023,1629677,22300564,"JAN 15, 2024",UTA vs. IND,W,3,0,0,0.0,0,0,0.0,0,0,0.0,0,1,1,0,0,0,0,1,0,7,1,UTA,UTA,IND,132,,,1,1,0,1
Luka Samanic,F,22023,1629677,22300540,"JAN 12, 2024",UTA vs. TOR,W,6,1,2,0.5,0,0,0.0,2,2,1.0,0,1,1,0,0,0,1,2,4,13,1,UTA,UTA,TOR,145,,,5,5,4,1
Luka Samanic,F,22023,1629677,22300524,"JAN 10, 2024",UTA vs. DEN,W,3,0,0,0.0,0,0,0.0,1,2,0.5,0,0,0,1,0,0,0,0,1,-5,1,UTA,UTA,DEN,124,,,2,1,2,1
Luka Samanic,F,22023,1629677,22300479,"JAN 05, 2024",UTA @ BOS,L,12,1,3,0.333,0,1,0.0,4,5,0.8,2,3,5,0,0,0,2,0,6,3,1,UTA,BOS,UTA,97,,,11,11,6,5
Luka Samanic,F,22023,1629677,22300457,"JAN 01, 2024",UTA vs. DAL,W,4,1,4,0.25,0,0,0.0,0,0,0.0,1,0,1,0,0,0,0,0,2,1,1,UTA,UTA,DAL,127,,,3,3,2,1
Luka Samanic,F,22023,1629677,22300412,"DEC 26, 2023",UTA @ SAS,W,2,0,0,0.0,0,0,0.0,0,0,0.0,0,0,0,0,0,0,0,0,0,-7,1,UTA,SAS,UTA,130,,,0,0,0,0
Luka Samanic,F,22023,1629677,22300374,"DEC 21, 2023",UTA @ DET,W,10,0,5,0.0,0,1,0.0,2,2,1.0,1,4,5,0,0,0,0,1,2,4,1,UTA,DET,UTA,119,,,7,7,2,5
Luka Samanic,F,22023,1629677,22300357,"DEC 18, 2023",UTA vs. BKN,W,2,2,2,1.0,1,1,1.0,0,0,0.0,0,1,1,0,0,0,0,1,5,-2,1,UTA,UTA,BKN,125,,,6,6,5,1
Luka Samanic,F,22023,1629677,22300302,"DEC 11, 2023",UTA @ OKC,L,17,6,10,0.6,1,4,0.25,1,1,1.0,0,7,7,1,0,0,2,3,14,22,1,UTA,OKC,UTA,120,,,22,21,15,8
Luka Samanic,F,22023,1629677,22301213,"DEC 06, 2023",UTA @ DAL,L,7,1,5,0.2,0,2,0.0,0,0,0.0,0,1,1,0,0,0,0,0,2,-7,1,UTA,DAL,UTA,97,,,3,3,2,1
Luka Samanic,F,22023,1629677,22300289,"DEC 02, 2023",UTA vs. POR,W,12,1,5,0.2,0,2,0.0,0,0,0.0,1,2,3,0,0,1,0,3,2,1,1,UTA,UTA,POR,118,,,5,5,2,3
Luka Samanic,F,22023,1629677,22300270,"NOV 30, 2023",UTA @ MIN,L,12,1,4,0.25,0,1,0.0,0,0,0.0,1,3,4,0,0,0,2,0,2,-2,1,UTA,MIN,UTA,90,,,6,6,2,4
Luka Samanic,F,22023,1629677,22300261,"NOV 29, 2023",UTA @ MEM,L,6,2,2,1.0,1,1,1.0,0,0,0.0,1,1,2,0,0,1,1,0,5,6,1,UTA,MEM,UTA,91,,,7,7,5,2
Luka Samanic,F,22023,1629677,22300042,"NOV 21, 2023",UTA @ LAL,L,9,0,3,0.0,0,2,0.0,0,0,0.0,0,3,3,1,0,0,1,1,0,-5,1,UTA,LAL,UTA,99,,,4,3,1,4
Luka Samanic,F,22023,1629677,22300023,"NOV 14, 2023",UTA vs. POR,W,1,0,0,0.0,0,0,0.0,0,0,0.0,0,0,0,0,0,0,0,0,0,0,1,UTA,UTA,POR,115,,,0,0,0,0
Luka Samanic,F,22023,1629677,22300152,"NOV 06, 2023",UTA @ CHI,L,4,1,2,0.5,1,2,0.5,0,0,0.0,0,1,1,1,0,0,0,1,3,5,1,UTA,CHI,UTA,113,,,5,4,4,2
Luka Samanic,F,22023,1629677,22300138,"NOV 04, 2023",UTA @ MIN,L,4,1,2,0.5,0,1,0.0,1,1,1.0,0,2,2,0,0,0,0,0,3,-5,1,UTA,MIN,UTA,95,,,5,5,3,2
Luka Samanic,F,22023,1629677,22300094,"OCT 28, 2023",UTA @ PHX,L,6,2,4,0.5,1,1,1.0,0,0,0.0,0,1,1,0,1,0,0,0,5,4,1,UTA,PHX,UTA,104,,,6,6,5,1
Luka Samanic,F,22023,1629677,22300072,"OCT 25, 2023",UTA vs. SAC,L,2,1,2,0.5,0,1,0.0,0,0,0.0,0,0,0,0,0,0,0,0,2,2,1,UTA,UTA,SAC,114,,,2,2,2,0
Luka Samanic,F,22023,1629677,22300739,"FEB 08, 2024",UTA @ PHX,L,2,0,0,0.0,0,0,0.0,0,0,0.0,0,0,0,0,0,0,0,0,0,0,1,UTA,PHX,UTA,115,,,0,0,0,0
Luka Samanic,F,22023,1629677,22300724,"FEB 06, 2024",UTA vs. OKC,W,6,0,3,0.0,0,2,0.0,3,4,0.75,1,1,2,0,0,0,2,1,3,-4,1,UTA,UTA,OKC,124,,,5,5,3,2
Kira Lewis Jr.,G,22023,1630184,22300547,"JAN 13, 2024",NOP @ DAL,W,7,0,2,0.0,0,1,0.0,2,2,1.0,0,2,2,0,0,0,1,0,2,-3,1,NOP,DAL,NOP,118,,,4,4,2,2
Kira Lewis Jr.,G,22023,1630184,22300461,"JAN 02, 2024",NOP vs. BKN,W,5,1,3,0.333,0,2,0.0,0,0,0.0,1,0,1,0,0,0,1,0,2,-3,1,NOP,NOP,BKN,112,,,3,3,2,1
Kira Lewis Jr.,G,22023,1630184,22300311,"DEC 13, 2023",NOP @ WAS,W,4,0,1,0.0,0,1,0.0,0,0,0.0,0,1,1,0,0,0,0,0,0,-8,1,NOP,WAS,NOP,142,,,1,1,0,1
Kira Lewis Jr.,G,22023,1630184,22301230,"DEC 07, 2023",NOP @ LAL,L,6,1,3,0.333,0,1,0.0,0,0,0.0,0,0,0,0,0,0,1,0,2,-3,1,NOP,LAL,NOP,89,,,2,2,2,0
Kira Lewis Jr.,G,22023,1630184,22300222,"NOV 20, 2023",NOP vs. SAC,W,6,1,3,0.333,1,2,0.5,0,0,0.0,0,0,0,2,1,0,0,1,3,-3,1,NOP,NOP,SAC,129,,,5,3,5,2
Kira Lewis Jr.,G,22023,1630184,22300637,"JAN 26, 2024",TOR vs. LAC,L,2,0,0,0.0,0,0,0.0,0,0,0.0,0,0,0,0,0,0,0,1,0,-4,1,TOR,TOR,LAC,107,,,0,0,0,0
Kira Lewis Jr.,G,22023,1630184,22300022,"NOV 14, 2023",NOP vs. DAL,W,2,1,1,1.0,0,0,0.0,0,0,0.0,0,0,0,0,0,0,0,0,2,0,1,NOP,NOP,DAL,131,,,2,2,2,0
Kira Lewis Jr.,G,22023,1630184,22300183,"NOV 12, 2023",NOP vs. DAL,L,8,2,5,0.4,0,0,0.0,1,1,1.0,1,0,1,4,0,0,1,0,5,14,1,NOP,NOP,DAL,124,,,10,6,9,5
Kira Lewis Jr.,G,22023,1630184,22300166,"NOV 08, 2023",NOP @ MIN,L,19,1,7,0.143,0,1,0.0,0,0,0.0,1,2,3,2,0,0,1,2,2,7,1,NOP,MIN,NOP,101,,,7,5,4,5
Kira Lewis Jr.,G,22023,1630184,22300156,"NOV 06, 2023",NOP @ DEN,L,9,1,2,0.5,0,1,0.0,0,0,0.0,0,0,0,0,0,0,0,1,2,0,1,NOP,DEN,NOP,116,,,2,2,2,0
Kira Lewis Jr.,G,22023,1630184,22300135,"NOV 04, 2023",NOP vs. ATL,L,10,0,3,0.0,0,2,0.0,0,0,0.0,0,0,0,4,1,0,0,1,0,-4,1,NOP,NOP,ATL,105,,,4,0,4,4
Kira Lewis Jr.,G,22023,1630184,22300129,"NOV 02, 2023",NOP vs. DET,W,20,1,5,0.2,0,1,0.0,4,4,1.0,0,3,3,4,1,0,1,1,6,15,1,NOP,NOP,DET,125,,,13,9,10,7
Kira Lewis Jr.,G,22023,1630184,22300121,"NOV 01, 2023",NOP @ OKC,W,10,2,4,0.5,1,2,0.5,0,0,0.0,0,0,0,0,2,0,1,0,5,-8,1,NOP,OKC,NOP,110,,,5,5,5,0
Kira Lewis Jr.,G,22023,1630184,22300108,"OCT 30, 2023",NOP vs. GSW,L,16,4,6,0.667,0,2,0.0,3,4,0.75,1,0,1,2,0,0,0,1,11,-13,1,NOP,NOP,GSW,102,,,14,12,13,3
Kira Lewis Jr.,G,22023,1630184,22300090,"OCT 28, 2023",NOP vs. NYK,W,10,1,4,0.25,0,2,0.0,0,0,0.0,0,2,2,0,0,0,0,0,2,-10,1,NOP,NOP,NYK,96,,,4,4,2,2
Kira Lewis Jr.,G,22023,1630184,22300071,"OCT 25, 2023",NOP @ MEM,W,11,0,3,0.0,0,2,0.0,0,0,0.0,0,0,0,0,0,1,1,1,0,0,1,NOP,MEM,NOP,111,,,0,0,0,0
Kira Lewis Jr.,G,22023,1630184,22300547,"JAN 13, 2024",NOP @ DAL,W,7,0,2,0.0,0,1,0.0,2,2,1.0,0,2,2,0,0,0,1,0,2,-3,1,NOP,DAL,NOP,118,,,4,4,2,2
Kira Lewis Jr.,G,22023,1630184,22300461,"JAN 02, 2024",NOP vs. BKN,W,5,1,3,0.333,0,2,0.0,0,0,0.0,1,0,1,0,0,0,1,0,2,-3,1,NOP,NOP,BKN,112,,,3,3,2,1
Kira Lewis Jr.,G,22023,1630184,22300311,"DEC 13, 2023",NOP @ WAS,W,4,0,1,0.0,0,1,0.0,0,0,0.0,0,1,1,0,0,0,0,0,0,-8,1,NOP,WAS,NOP,142,,,1,1,0,1
Kira Lewis Jr.,G,22023,1630184,22301230,"DEC 07, 2023",NOP @ LAL,L,6,1,3,0.333,0,1,0.0,0,0,0.0,0,0,0,0,0,0,1,0,2,-3,1,NOP,LAL,NOP,89,,,2,2,2,0
Kira Lewis Jr.,G,22023,1630184,22300222,"NOV 20, 2023",NOP vs. SAC,W,6,1,3,0.333,1,2,0.5,0,0,0.0,0,0,0,2,1,0,0,1,3,-3,1,NOP,NOP,SAC,129,,,5,3,5,2
Kira Lewis Jr.,G,22023,1630184,22300637,"JAN 26, 2024",TOR vs. LAC,L,2,0,0,0.0,0,0,0.0,0,0,0.0,0,0,0,0,0,0,0,1,0,-4,1,TOR,TOR,LAC,107,,,0,0,0,0
Kira Lewis Jr.,G,22023,1630184,22300022,"NOV 14, 2023",NOP vs. DAL,W,2,1,1,1.0,0,0,0.0,0,0,0.0,0,0,0,0,0,0,0,0,2,0,1,NOP,NOP,DAL,131,,,2,2,2,0
Kira Lewis Jr.,G,22023,1630184,22300183,"NOV 12, 2023",NOP vs. DAL,L,8,2,5,0.4,0,0,0.0,1,1,1.0,1,0,1,4,0,0,1,0,5,14,1,NOP,NOP,DAL,124,,,10,6,9,5
Kira Lewis Jr.,G,22023,1630184,22300166,"NOV 08, 2023",NOP @ MIN,L,19,1,7,0.143,0,1,0.0,0,0,0.0,1,2,3,2,0,0,1,2,2,7,1,NOP,MIN,NOP,101,,,7,5,4,5
Kira Lewis Jr.,G,22023,1630184,22300156,"NOV 06, 2023",NOP @ DEN,L,9,1,2,0.5,0,1,0.0,0,0,0.0,0,0,0,0,0,0,0,1,2,0,1,NOP,DEN,NOP,116,,,2,2,2,0
Kira Lewis Jr.,G,22023,1630184,22300135,"NOV 04, 2023",NOP vs. ATL,L,10,0,3,0.0,0,2,0.0,0,0,0.0,0,0,0,4,1,0,0,1,0,-4,1,NOP,NOP,ATL,105,,,4,0,4,4
Kira Lewis Jr.,G,22023,1630184,22300129,"NOV 02, 2023",NOP vs. DET,W,20,1,5,0.2,0,1,0.0,4,4,1.0,0,3,3,4,1,0,1,1,6,15,1,NOP,NOP,DET,125,,,13,9,10,7
Kira Lewis Jr.,G,22023,1630184,22300121,"NOV 01, 2023",NOP @ OKC,W,10,2,4,0.5,1,2,0.5,0,0,0.0,0,0,0,0,2,0,1,0,5,-8,1,NOP,OKC,NOP,110,,,5,5,5,0
Kira Lewis Jr.,G,22023,1630184,22300108,"OCT 30, 2023",NOP vs. GSW,L,16,4,6,0.667,0,2,0.0,3,4,0.75,1,0,1,2,0,0,0,1,11,-13,1,NOP,NOP,GSW,102,,,14,12,13,3
Kira Lewis Jr.,G,22023,1630184,22300090,"OCT 28, 2023",NOP vs. NYK,W,10,1,4,0.25,0,2,0.0,0,0,0.0,0,2,2,0,0,0,0,0,2,-10,1,NOP,NOP,NYK,96,,,4,4,2,2
Kira Lewis Jr.,G,22023,1630184,22300071,"OCT 25, 2023",NOP @ MEM,W,11,0,3,0.0,0,2,0.0,0,0,0.0,0,0,0,0,0,1,1,1,0,0,1,NOP,MEM,NOP,111,,,0,0,0,0
Ish Wainright,F,22023,1630688,22300399,"DEC 23, 2023",POR @ GSW,L,4,1,1,1.0,1,1,1.0,0,0,0.0,0,1,1,0,0,0,0,1,3,-1,1,POR,GSW,POR,106,,,4,4,3,1
Ish Wainright,F,22023,1630688,22300199,"NOV 15, 2023",POR vs. CLE,L,3,0,0,0.0,0,0,0.0,0,0,0.0,0,0,0,0,0,0,0,0,0,0,1,POR,POR,CLE,93,,,0,0,0,0
Ish Wainright,F,22023,1630688,22300023,"NOV 14, 2023",POR @ UTA,L,3,0,1,0.0,0,1,0.0,0,0,0.0,0,0,0,0,1,0,0,1,0,-1,1,POR,UTA,POR,99,,,0,0,0,0
Ish Wainright,F,22023,1630688,22300472,"JAN 03, 2024",POR @ DAL,L,17,3,5,0.6,3,5,0.6,0,0,0.0,0,5,5,0,1,0,0,0,9,2,1,POR,DAL,POR,97,,,14,14,9,5
Ish Wainright,F,22023,1630688,22300456,"JAN 01, 2024",POR @ PHX,L,12,2,5,0.4,2,4,0.5,2,2,1.0,0,1,1,0,0,1,1,2,8,3,1,POR,PHX,POR,84,,,9,9,8,1
Ish Wainright,F,22023,1630688,22300427,"DEC 28, 2023",POR vs. SAS,L,6,0,5,0.0,0,4,0.0,0,0,0.0,0,1,1,0,0,0,0,0,0,-1,1,POR,POR,SAS,98,,,1,1,0,1
Ish Wainright,F,22023,1630688,22300413,"DEC 26, 2023",POR vs. SAC,W,2,0,1,0.0,0,1,0.0,0,0,0.0,0,1,1,0,0,0,0,0,0,-2,1,POR,POR,SAC,130,,,1,1,0,1
Saben Lee,G,22023,1630240,22300739,"FEB 08, 2024",PHX vs. UTA,W,1,0,1,0.0,0,0,0.0,0,0,0.0,0,0,0,0,0,0,0,0,0,0,1,PHX,PHX,UTA,129,,,0,0,0,0
Saben Lee,G,22023,1630240,22300612,"JAN 22, 2024",PHX vs. CHI,W,6,1,2,0.5,0,1,0.0,0,0,0.0,0,2,2,1,0,0,1,0,2,2,1,PHX,PHX,CHI,115,,,5,4,3,3
Saben Lee,G,22023,1630240,22300511,"JAN 08, 2024",PHX @ LAC,L,5,0,1,0.0,0,0,0.0,2,2,1.0,1,0,1,0,0,0,1,0,2,-3,1,PHX,LAC,PHX,111,,,3,3,2,1
Saben Lee,G,22023,1630240,22300503,"JAN 07, 2024",PHX vs. MEM,L,4,0,0,0.0,0,0,0.0,1,2,0.5,1,0,1,0,0,1,0,1,1,-8,1,PHX,PHX,MEM,115,,,2,2,1,1
Saben Lee,G,22023,1630240,22300489,"JAN 05, 2024",PHX vs. MIA,W,2,0,0,0.0,0,0,0.0,0,2,0.0,0,0,0,0,1,0,0,0,0,-5,1,PHX,PHX,MIA,113,,,0,0,0,0
Saben Lee,G,22023,1630240,22300436,"DEC 29, 2023",PHX vs. CHA,W,14,0,1,0.0,0,0,0.0,1,2,0.5,0,0,0,3,1,0,0,1,1,11,1,PHX,PHX,CHA,133,,,4,1,4,3
Saben Lee,G,22023,1630240,22300418,"DEC 27, 2023",PHX @ HOU,W,12,2,2,1.0,0,0,0.0,5,5,1.0,0,2,2,1,0,0,2,1,9,3,1,PHX,HOU,PHX,129,,,12,11,10,3
Saben Lee,G,22023,1630240,22300387,"DEC 22, 2023",PHX @ SAC,L,20,2,8,0.25,0,3,0.0,2,2,1.0,1,2,3,4,1,1,1,2,6,11,1,PHX,SAC,PHX,105,,,13,9,10,7
Saben Lee,G,22023,1630240,22300140,"NOV 05, 2023",PHX @ DET,W,3,2,3,0.667,0,0,0.0,0,0,0.0,1,0,1,0,0,0,0,0,4,-5,1,PHX,DET,PHX,120,,,5,5,4,1
Saben Lee,G,22023,1630240,22300132,"NOV 04, 2023",PHX @ PHI,L,4,0,1,0.0,0,0,0.0,0,0,0.0,1,1,2,1,0,0,0,1,0,3,1,PHX,PHI,PHX,100,,,3,2,1,3
Saben Lee,G,22023,1630240,22300094,"OCT 28, 2023",PHX vs. UTA,W,4,1,2,0.5,0,1,0.0,0,0,0.0,0,0,0,2,0,1,0,0,2,-4,1,PHX,PHX,UTA,126,,,4,2,4,2
Saben Lee,G,22023,1630240,22301228,"DEC 08, 2023",PHX vs. SAC,L,1,1,1,1.0,0,0,0.0,2,2,1.0,0,0,0,0,0,0,0,0,4,4,1,PHX,PHX,SAC,106,,,4,4,4,0
Dereon Seabron,G,22023,1631220,22300022,"NOV 14, 2023",NOP vs. DAL,W,2,0,0,0.0,0,0,0.0,0,0,0.0,0,0,0,0,1,0,0,0,0,0,1,NOP,NOP,DAL,131,,,0,0,0,0
Dereon Seabron,G,22023,1631220,22300183,"NOV 12, 2023",NOP vs. DAL,L,8,1,1,1.0,0,0,0.0,1,2,0.5,0,3,3,2,0,1,0,2,3,16,1,NOP,NOP,DAL,124,,,8,6,5,5
Dereon Seabron,G,22023,1631220,22300011,"NOV 10, 2023",NOP @ HOU,L,12,0,3,0.0,0,0,0.0,0,0,0.0,0,1,1,0,1,0,0,0,0,-9,1,NOP,HOU,NOP,101,,,1,1,0,1
Dereon Seabron,G,22023,1631220,22300166,"NOV 08, 2023",NOP @ MIN,L,17,3,7,0.429,1,2,0.5,2,2,1.0,1,2,3,1,0,0,0,1,9,5,1,NOP,MIN,NOP,101,,,13,12,10,4
Dereon Seabron,G,22023,1631220,22300129,"NOV 02, 2023",NOP vs. DET,W,13,0,2,0.0,0,0,0.0,2,2,1.0,0,0,0,1,0,0,0,1,2,15,1,NOP,NOP,DET,125,,,3,2,3,1
Andre Jackson Jr.,G,22023,1641748,22300745,"FEB 09, 2024",MIL vs. CHA,W,13,1,3,0.333,0,2,0.0,0,0,0.0,0,2,2,0,1,0,1,2,2,-1,1,MIL,MIL,CHA,120,,,4,4,2,2
Andre Jackson Jr.,G,22023,1641748,22300738,"FEB 08, 2024",MIL vs. MIN,L,18,0,2,0.0,0,0,0.0,0,0,0.0,0,1,1,3,1,0,1,0,0,-11,1,MIL,MIL,MIN,105,,,4,1,3,4
Andre Jackson Jr.,G,22023,1641748,22300711,"FEB 04, 2024",MIL @ UTA,L,1,0,0,0.0,0,0,0.0,0,2,0.0,0,0,0,0,0,0,0,1,0,-1,1,MIL,UTA,MIL,108,,,0,0,0,0
Andre Jackson Jr.,G,22023,1641748,22300648,"JAN 27, 2024",MIL vs. NOP,W,17,1,1,1.0,1,1,1.0,0,0,0.0,0,2,2,2,1,0,0,3,3,8,1,MIL,MIL,NOP,141,,,7,5,5,4
Andre Jackson Jr.,G,22023,1641748,22300624,"JAN 24, 2024",MIL vs. CLE,W,1,0,0,0.0,0,0,0.0,0,0,0.0,0,0,0,0,0,0,0,0,0,0,1,MIL,MIL,CLE,126,,,0,0,0,0
Andre Jackson Jr.,G,22023,1641748,22300606,"JAN 22, 2024",MIL @ DET,W,20,3,4,0.75,0,1,0.0,2,2,1.0,0,1,1,0,1,1,0,5,8,-8,1,MIL,DET,MIL,122,,,9,9,8,1
Andre Jackson Jr.,G,22023,1641748,22300592,"JAN 20, 2024",MIL @ DET,W,15,1,1,1.0,0,0,0.0,0,0,0.0,3,4,7,0,0,0,0,2,2,-1,1,MIL,DET,MIL,141,,,9,9,2,7
Andre Jackson Jr.,G,22023,1641748,22300552,"JAN 14, 2024",MIL vs. SAC,W,10,0,0,0.0,0,0,0.0,0,0,0.0,0,0,0,1,0,0,2,5,0,2,1,MIL,MIL,SAC,143,,,1,0,1,1
Andre Jackson Jr.,G,22023,1641748,22300545,"JAN 13, 2024",MIL vs. GSW,W,28,5,8,0.625,0,0,0.0,0,0,0.0,6,4,10,2,0,1,1,1,10,0,1,MIL,MIL,GSW,129,,,22,20,12,12
Andre Jackson Jr.,G,22023,1641748,22300528,"JAN 11, 2024",MIL vs. BOS,W,16,0,2,0.0,0,2,0.0,0,0,0.0,2,2,4,4,0,0,0,5,0,19,1,MIL,MIL,BOS,135,,,8,4,4,8
Andre Jackson Jr.,G,22023,1641748,22300510,"JAN 08, 2024",MIL vs. UTA,L,26,2,6,0.333,1,2,0.5,2,2,1.0,2,3,5,3,0,2,1,2,7,-6,1,MIL,MIL,UTA,116,,,15,12,10,8
Andre Jackson Jr.,G,22023,1641748,22300496,"JAN 06, 2024",MIL @ HOU,L,12,0,1,0.0,0,1,0.0,1,1,1.0,0,2,2,0,2,0,0,3,1,3,1,MIL,HOU,MIL,108,,,3,3,1,2
Andre Jackson Jr.,G,22023,1641748,22300477,"JAN 04, 2024",MIL @ SAS,W,5,0,0,0.0,0,0,0.0,0,0,0.0,0,1,1,0,0,0,0,1,0,-5,1,MIL,SAS,MIL,125,,,1,1,0,1
Andre Jackson Jr.,G,22023,1641748,22300466,"JAN 03, 2024",MIL @ IND,L,14,3,4,0.75,1,2,0.5,0,0,0.0,0,2,2,2,0,0,1,1,7,14,1,MIL,IND,MIL,130,,,11,9,9,4
Andre Jackson Jr.,G,22023,1641748,22300454,"JAN 01, 2024",MIL vs. IND,L,5,0,0,0.0,0,0,0.0,0,0,0.0,0,1,1,0,0,0,0,1,0,-12,1,MIL,MIL,IND,113,,,1,1,0,1
Andre Jackson Jr.,G,22023,1641748,22300433,"DEC 29, 2023",MIL @ CLE,W,3,0,0,0.0,0,0,0.0,0,0,0.0,0,0,0,0,0,0,1,0,0,-7,1,MIL,CLE,MIL,119,,,0,0,0,0
Andre Jackson Jr.,G,22023,1641748,22300417,"DEC 27, 2023",MIL @ BKN,W,2,0,2,0.0,0,1,0.0,0,0,0.0,0,0,0,0,0,0,0,2,0,1,1,MIL,BKN,MIL,144,,,0,0,0,0
Andre Jackson Jr.,G,22023,1641748,22300401,"DEC 25, 2023",MIL @ NYK,L,14,0,2,0.0,0,1,0.0,2,2,1.0,1,1,2,1,1,0,0,2,2,-4,1,MIL,NYK,MIL,122,,,5,4,3,3
Andre Jackson Jr.,G,22023,1641748,22300388,"DEC 23, 2023",MIL @ NYK,W,11,0,0,0.0,0,0,0.0,0,0,0.0,2,0,2,2,0,0,1,1,0,-2,1,MIL,NYK,MIL,130,,,4,2,2,4
Andre Jackson Jr.,G,22023,1641748,22300378,"DEC 21, 2023",MIL vs. ORL,W,7,0,1,0.0,0,1,0.0,0,0,0.0,0,0,0,0,0,0,0,0,0,-8,1,MIL,MIL,ORL,118,,,0,0,0,0
Andre Jackson Jr.,G,22023,1641748,22300361,"DEC 19, 2023",MIL vs. SAS,W,15,2,4,0.5,2,3,0.667,1,2,0.5,2,1,3,2,1,0,1,2,7,-1,1,MIL,MIL,SAS,132,,,12,10,9,5
Andre Jackson Jr.,G,22023,1641748,22300346,"DEC 17, 2023",MIL vs. HOU,W,36,4,6,0.667,1,3,0.333,0,0,0.0,4,2,6,4,0,0,1,6,9,3,1,MIL,MIL,HOU,128,,,19,15,13,10
Andre Jackson Jr.,G,22023,1641748,22300334,"DEC 16, 2023",MIL vs. DET,W,26,4,8,0.5,2,5,0.4,0,0,0.0,1,7,8,1,0,0,1,4,10,2,1,MIL,MIL,DET,146,,,19,18,11,9
Andre Jackson Jr.,G,22023,1641748,22300315,"DEC 13, 2023",MIL vs. IND,W,14,1,2,0.5,0,1,0.0,0,0,0.0,1,1,2,2,0,0,0,4,2,1,1,MIL,MIL,IND,140,,,6,4,4,4
Andre Jackson Jr.,G,22023,1641748,22301229,"DEC 07, 2023",MIL vs. IND,L,1,0,0,0.0,0,0,0.0,0,0,0.0,0,0,0,0,0,0,0,1,0,-4,1,MIL,MIL,IND,119,,,0,0,0,0
Andre Jackson Jr.,G,22023,1641748,22301201,"DEC 05, 2023",MIL vs. NYK,W,0,0,0,0.0,0,0,0.0,0,0,0.0,0,0,0,0,0,0,0,0,0,0,1,MIL,MIL,NYK,146,,,0,0,0,0
Andre Jackson Jr.,G,22023,1641748,22300269,"NOV 30, 2023",MIL @ CHI,L,12,2,3,0.667,0,1,0.0,0,0,0.0,1,0,1,1,2,0,1,1,4,-8,1,MIL,CHI,MIL,113,,,6,5,5,2
Andre Jackson Jr.,G,22023,1641748,22300056,"NOV 28, 2023",MIL @ MIA,W,3,2,2,1.0,2,2,1.0,0,0,0.0,1,0,1,0,0,0,0,0,6,-3,1,MIL,MIA,MIL,131,,,7,7,6,1
Andre Jackson Jr.,G,22023,1641748,22300245,"NOV 26, 2023",MIL vs. POR,W,12,0,0,0.0,0,0,0.0,0,0,0.0,0,1,1,0,0,0,0,0,0,-11,1,MIL,MIL,POR,108,,,1,1,0,1
Andre Jackson Jr.,G,22023,1641748,22300049,"NOV 24, 2023",MIL vs. WAS,W,9,0,0,0.0,0,0,0.0,0,0,0.0,0,1,1,1,0,0,0,4,0,0,1,MIL,MIL,WAS,131,,,2,1,1,2
Andre Jackson Jr.,G,22023,1641748,22300228,"NOV 22, 2023",MIL @ BOS,L,8,3,4,0.75,1,1,1.0,0,0,0.0,1,0,1,0,0,0,1,2,7,-2,1,MIL,BOS,MIL,116,,,8,8,7,1
Andre Jackson Jr.,G,22023,1641748,22300219,"NOV 20, 2023",MIL @ WAS,W,1,0,0,0.0,0,0,0.0,0,0,0.0,1,0,1,0,0,0,0,0,0,-5,1,MIL,WAS,MIL,142,,,1,1,0,1
Andre Jackson Jr.,G,22023,1641748,22300205,"NOV 18, 2023",MIL vs. DAL,W,12,0,1,0.0,0,0,0.0,0,0,0.0,0,0,0,2,0,0,0,1,0,-11,1,MIL,MIL,DAL,132,,,2,0,2,2
Andre Jackson Jr.,G,22023,1641748,22300027,"NOV 17, 2023",MIL @ CHA,W,8,2,2,1.0,2,2,1.0,0,0,0.0,0,1,1,2,0,0,1,1,6,2,1,MIL,CHA,MIL,130,,,9,7,8,3
Andre Jackson Jr.,G,22023,1641748,22300190,"NOV 13, 2023",MIL vs. CHI,W,13,2,4,0.5,1,3,0.333,0,0,0.0,2,1,3,0,0,0,0,1,5,2,1,MIL,MIL,CHI,118,,,8,8,5,3
Andre Jackson Jr.,G,22023,1641748,22300173,"NOV 11, 2023",MIL @ ORL,L,14,2,3,0.667,0,1,0.0,0,0,0.0,1,2,3,0,0,0,2,2,4,2,1,MIL,ORL,MIL,97,,,7,7,4,3
Andre Jackson Jr.,G,22023,1641748,22300171,"NOV 09, 2023",MIL @ IND,L,5,0,0,0.0,0,0,0.0,0,0,0.0,0,0,0,0,0,0,0,2,0,7,1,MIL,IND,MIL,124,,,0,0,0,0
Andre Jackson Jr.,G,22023,1641748,22300165,"NOV 08, 2023",MIL vs. DET,W,4,0,0,0.0,0,0,0.0,0,0,0.0,0,0,0,0,1,0,0,3,0,0,1,MIL,MIL,DET,120,,,0,0,0,0
Andre Jackson Jr.,G,22023,1641748,22300116,"NOV 01, 2023",MIL @ TOR,L,6,1,1,1.0,0,0,0.0,0,0,0.0,0,1,1,3,1,0,0,2,2,4,1,MIL,TOR,MIL,111,,,6,3,5,4
Andre Jackson Jr.,G,22023,1641748,22300097,"OCT 29, 2023",MIL vs. ATL,L,7,0,1,0.0,0,1,0.0,0,0,0.0,1,3,4,1,1,0,1,2,0,5,1,MIL,MIL,ATL,110,,,5,4,1,5
Andre Jackson Jr.,G,22023,1641748,22300572,"JAN 17, 2024",MIL @ CLE,L,23,3,4,0.75,0,1,0.0,0,0,0.0,2,6,8,0,0,0,1,2,6,-26,1,MIL,CLE,MIL,95,,,14,14,6,8
Andre Jackson Jr.,G,22023,1641748,22300195,"NOV 15, 2023",MIL @ TOR,W,17,0,1,0.0,0,0,0.0,0,0,0.0,2,0,2,1,0,0,2,2,0,9,1,MIL,TOR,MIL,128,,,3,2,1,3
Lamar Stevens,F,22023,1630205,22300706,"FEB 04, 2024",BOS vs. MEM,W,7,2,4,0.5,1,1,1.0,0,0,0.0,1,1,2,0,0,0,0,1,5,11,1,BOS,BOS,MEM,131,,,7,7,5,2
Lamar Stevens,F,22023,1630205,22300646,"JAN 27, 2024",BOS vs. LAC,L,8,3,4,0.75,0,0,0.0,2,3,0.667,3,2,5,1,0,0,1,0,8,14,1,BOS,BOS,LAC,96,,,14,13,9,6
Lamar Stevens,F,22023,1630205,22300630,"JAN 25, 2024",BOS @ MIA,W,4,1,3,0.333,0,0,0.0,0,0,0.0,0,1,1,1,0,0,1,0,2,3,1,BOS,MIA,BOS,143,,,4,3,3,2
Lamar Stevens,F,22023,1630205,22300571,"JAN 17, 2024",BOS vs. SAS,W,5,0,0,0.0,0,0,0.0,0,0,0.0,0,0,0,0,1,0,1,0,0,-2,1,BOS,BOS,SAS,117,,,0,0,0,0
Lamar Stevens,F,22023,1630205,22300528,"JAN 11, 2024",BOS @ MIL,L,19,1,6,0.167,0,0,0.0,3,4,0.75,1,3,4,0,0,1,0,2,5,3,1,BOS,MIL,BOS,102,,,9,9,5,4
Lamar Stevens,F,22023,1630205,22300479,"JAN 05, 2024",BOS vs. UTA,W,12,2,4,0.5,0,1,0.0,0,0,0.0,1,4,5,0,1,1,1,1,4,-3,1,BOS,BOS,UTA,126,,,9,9,4,5
Lamar Stevens,F,22023,1630205,22300448,"DEC 31, 2023",BOS @ SAS,W,7,1,1,1.0,0,0,0.0,0,0,0.0,0,2,2,2,0,0,0,0,2,-1,1,BOS,SAS,BOS,134,,,6,4,4,4
Lamar Stevens,F,22023,1630205,22300389,"DEC 23, 2023",BOS @ LAC,W,5,2,3,0.667,0,0,0.0,0,0,0.0,1,1,2,1,0,0,0,0,4,4,1,BOS,LAC,BOS,142,,,7,6,5,3
Lamar Stevens,F,22023,1630205,22300344,"DEC 17, 2023",BOS vs. ORL,W,2,0,0,0.0,0,0,0.0,0,0,0.0,0,0,0,0,0,0,0,1,0,-4,1,BOS,BOS,ORL,114,,,0,0,0,0
Lamar Stevens,F,22023,1630205,22300053,"NOV 28, 2023",BOS vs. CHI,W,0,0,0,0.0,0,0,0.0,0,0,0.0,0,0,0,0,0,1,0,0,0,0,1,BOS,BOS,CHI,124,,,0,0,0,0
Lamar Stevens,F,22023,1630205,22300043,"NOV 24, 2023",BOS @ ORL,L,1,0,0,0.0,0,0,0.0,0,0,0.0,0,0,0,0,0,0,0,0,0,-2,1,BOS,ORL,BOS,96,,,0,0,0,0
Lamar Stevens,F,22023,1630205,22300118,"NOV 01, 2023",BOS vs. IND,W,7,2,4,0.5,0,0,0.0,0,0,0.0,2,0,2,2,0,0,0,2,4,6,1,BOS,BOS,IND,155,,,8,6,6,4
Lamar Stevens,F,22023,1630205,22300103,"OCT 30, 2023",BOS @ WAS,W,6,2,2,1.0,1,1,1.0,0,0,0.0,2,0,2,0,0,0,3,1,5,-4,1,BOS,WAS,BOS,126,,,7,7,5,2
Lamar Stevens,F,22023,1630205,22300542,"JAN 13, 2024",BOS vs. HOU,W,7,0,2,0.0,0,0,0.0,0,0,0.0,0,0,0,0,0,0,1,0,0,-2,1,BOS,BOS,HOU,145,,,0,0,0,0
Lamar Stevens,F,22023,1630205,22300373,"DEC 20, 2023",BOS @ SAC,W,2,1,1,1.0,0,0,0.0,0,0,0.0,0,0,0,0,0,0,0,0,2,0,1,BOS,SAC,BOS,144,,,2,2,2,0
Lamar Stevens,F,22023,1630205,22300329,"DEC 15, 2023",BOS vs. ORL,W,14,3,7,0.429,1,3,0.333,1,2,0.5,1,2,3,0,2,1,1,2,8,-7,1,BOS,BOS,ORL,128,,,11,11,8,3
Lamar Stevens,F,22023,1630205,22300319,"DEC 14, 2023",BOS vs. CLE,W,9,1,3,0.333,0,2,0.0,2,2,1.0,0,1,1,1,1,1,0,3,4,1,1,BOS,BOS,CLE,116,,,6,5,5,2
Lamar Stevens,F,22023,1630205,22300213,"NOV 19, 2023",BOS @ MEM,W,3,0,0,0.0,0,0,0.0,0,0,0.0,0,1,1,0,0,0,0,1,0,-2,1,BOS,MEM,BOS,102,,,1,1,0,1
Lamar Stevens,F,22023,1630205,22300154,"NOV 06, 2023",BOS @ MIN,L,4,0,1,0.0,0,0,0.0,0,0,0.0,0,1,1,0,1,0,0,0,0,-5,1,BOS,MIN,BOS,109,,,1,1,0,1
Lindy Waters III,F,22023,1630322,22300682,"JAN 31, 2024",OKC vs. DEN,W,5,0,0,0.0,0,0,0.0,0,0,0.0,0,1,1,0,0,0,0,0,0,-4,1,OKC,OKC,DEN,105,,,1,1,0,1
Lindy Waters III,F,22023,1630322,22300481,"JAN 05, 2024",OKC @ BKN,L,4,0,1,0.0,0,1,0.0,0,0,0.0,0,0,0,0,0,0,0,1,0,-2,1,OKC,BKN,OKC,115,,,0,0,0,0
Lindy Waters III,F,22023,1630322,22300302,"DEC 11, 2023",OKC vs. UTA,W,8,1,4,0.25,1,4,0.25,0,0,0.0,0,0,0,1,0,0,0,2,3,-15,1,OKC,OKC,UTA,134,,,4,3,4,1
Lindy Waters III,F,22023,1630322,22300215,"NOV 19, 2023",OKC @ POR,W,16,4,7,0.571,4,7,0.571,0,0,0.0,0,3,3,1,0,0,0,0,12,6,1,OKC,POR,OKC,134,,,16,15,13,4
Lindy Waters III,F,22023,1630322,22300748,"FEB 10, 2024",OKC @ DAL,L,14,3,6,0.5,3,5,0.6,0,0,0.0,0,3,3,1,0,1,0,2,9,-19,1,OKC,DAL,OKC,111,,,13,12,10,4
Lindy Waters III,F,22023,1630322,22300724,"FEB 06, 2024",OKC @ UTA,L,0,0,0,0.0,0,0,0.0,0,0,0.0,0,0,0,0,0,0,0,0,0,2,1,OKC,UTA,OKC,117,,,0,0,0,0
Lindy Waters III,F,22023,1630322,22300710,"FEB 04, 2024",OKC vs. TOR,W,5,1,1,1.0,1,1,1.0,0,0,0.0,0,0,0,0,0,0,0,2,3,-3,1,OKC,OKC,TOR,135,,,3,3,3,0
Lindy Waters III,F,22023,1630322,22300695,"FEB 02, 2024",OKC vs. CHA,W,18,2,5,0.4,2,5,0.4,0,0,0.0,0,5,5,1,0,0,2,1,6,-16,1,OKC,OKC,CHA,126,,,12,11,7,6
Lindy Waters III,F,22023,1630322,22300529,"JAN 11, 2024",OKC vs. POR,W,12,2,5,0.4,2,4,0.5,0,0,0.0,0,2,2,2,0,1,1,1,6,0,1,OKC,OKC,POR,139,,,10,8,8,4
Lindy Waters III,F,22023,1630322,22300016,"NOV 10, 2023",OKC @ SAC,L,19,0,2,0.0,0,2,0.0,0,0,0.0,0,0,0,2,0,0,0,1,0,3,1,OKC,SAC,OKC,98,,,2,0,2,2
Lindy Waters III,F,22023,1630322,22300121,"NOV 01, 2023",OKC vs. NOP,L,1,0,0,0.0,0,0,0.0,0,0,0.0,0,0,0,0,0,0,0,0,0,0,1,OKC,OKC,NOP,106,,,0,0,0,0
Lindy Waters III,F,22023,1630322,22300081,"OCT 27, 2023",OKC @ CLE,W,1,0,0,0.0,0,0,0.0,0,0,0.0,0,0,0,0,0,0,0,0,0,3,1,OKC,CLE,OKC,108,,,0,0,0,0
Lindy Waters III,F,22023,1630322,22300070,"OCT 25, 2023",OKC @ CHI,W,3,0,1,0.0,0,1,0.0,0,0,0.0,0,0,0,0,0,0,0,0,0,0,1,OKC,CHI,OKC,124,,,0,0,0,0
Lindy Waters III,F,22023,1630322,22300654,"JAN 28, 2024",OKC @ DET,L,10,1,2,0.5,0,1,0.0,0,0,0.0,0,2,2,0,0,1,0,1,2,0,1,OKC,DET,OKC,104,,,4,4,2,2
Lindy Waters III,F,22023,1630322,22300640,"JAN 26, 2024",OKC @ NOP,W,2,0,0,0.0,0,0,0.0,0,0,0.0,0,0,0,0,0,0,0,0,0,-2,1,OKC,NOP,OKC,107,,,0,0,0,0
Lindy Waters III,F,22023,1630322,22300467,"JAN 03, 2024",OKC @ ATL,L,20,3,6,0.5,3,6,0.5,0,0,0.0,0,3,3,1,0,0,1,2,9,5,1,OKC,ATL,OKC,138,,,13,12,10,4
Lindy Waters III,F,22023,1630322,22300447,"DEC 31, 2023",OKC vs. BKN,W,2,1,1,1.0,1,1,1.0,0,0,0.0,0,0,0,0,0,0,0,0,3,-1,1,OKC,OKC,BKN,124,,,3,3,3,0
Lindy Waters III,F,22023,1630322,22300435,"DEC 29, 2023",OKC @ DEN,W,3,1,2,0.5,1,2,0.5,0,0,0.0,0,1,1,0,0,0,0,0,3,3,1,OKC,DEN,OKC,119,,,4,4,3,1
Lindy Waters III,F,22023,1630322,22300271,"NOV 30, 2023",OKC vs. LAL,W,12,2,5,0.4,1,4,0.25,0,0,0.0,0,1,1,1,0,0,0,3,5,12,1,OKC,OKC,LAL,133,,,7,6,6,2
Lindy Waters III,F,22023,1630322,22300234,"NOV 22, 2023",OKC vs. CHI,W,5,0,0,0.0,0,0,0.0,0,0,0.0,1,1,2,1,0,1,0,0,0,7,1,OKC,OKC,CHI,116,,,3,2,1,3
Lindy Waters III,F,22023,1630322,22300021,"NOV 14, 2023",OKC vs. SAS,W,5,2,3,0.667,2,3,0.667,0,0,0.0,0,0,0,0,0,0,0,0,6,-2,1,OKC,OKC,SAS,123,,,6,6,6,0
Lindy Waters III,F,22023,1630322,22300581,"JAN 18, 2024",OKC @ UTA,W,3,0,1,0.0,0,1,0.0,0,0,0.0,0,0,0,1,0,0,0,1,0,-2,1,OKC,UTA,OKC,134,,,1,0,1,1
Moussa Diabate,F,22023,1631217,22300099,"OCT 29, 2023",LAC vs. SAS,W,5,0,0,0.0,0,0,0.0,0,0,0.0,1,0,1,2,0,0,1,0,0,10,1,LAC,LAC,SAS,123,,,3,1,2,3
Moussa Diabate,F,22023,1631217,22300074,"OCT 25, 2023",LAC vs. POR,W,4,1,3,0.333,0,0,0.0,0,0,0.0,1,0,1,0,2,0,0,0,2,-10,1,LAC,LAC,POR,123,,,3,3,2,1
Moussa Diabate,F,22023,1631217,22300458,"JAN 01, 2024",LAC vs. MIA,W,3,0,0,0.0,0,0,0.0,0,0,0.0,0,1,1,0,0,0,0,0,0,-3,1,LAC,LAC,MIA,121,,,1,1,0,1
Moussa Diabate,F,22023,1631217,22300273,"NOV 30, 2023",LAC @ GSW,L,1,0,0,0.0,0,0,0.0,2,2,1.0,0,0,0,0,0,0,0,0,2,2,1,LAC,GSW,LAC,114,,,2,2,2,0
Moussa Diabate,F,22023,1631217,22300244,"NOV 25, 2023",LAC vs. DAL,W,5,0,2,0.0,0,0,0.0,1,2,0.5,2,0,2,0,1,0,0,0,1,-1,1,LAC,LAC,DAL,107,,,3,3,1,2
Moussa Diabate,F,22023,1631217,22300014,"NOV 10, 2023",LAC @ DAL,L,16,4,6,0.667,0,0,0.0,3,4,0.75,6,3,9,0,0,0,0,3,11,2,1,LAC,DAL,LAC,126,,,20,20,11,9
Moussa Diabate,F,22023,1631217,22300151,"NOV 06, 2023",LAC @ NYK,L,6,1,1,1.0,0,0,0.0,2,2,1.0,0,0,0,0,0,0,0,0,4,-2,1,LAC,NYK,LAC,97,,,4,4,4,0
Moussa Diabate,F,22023,1631217,22300114,"OCT 31, 2023",LAC vs. ORL,W,3,1,2,0.5,0,0,0.0,0,0,0.0,1,0,1,2,0,0,1,0,2,2,1,LAC,LAC,ORL,118,,,5,3,4,3
Moussa Diabate,F,22023,1631217,22300223,"NOV 20, 2023",LAC @ SAS,W,4,1,2,0.5,0,0,0.0,1,2,0.5,2,0,2,0,1,0,0,0,3,3,1,LAC,SAS,LAC,124,,,5,5,3,2
Moussa Diabate,F,22023,1631217,22300179,"NOV 12, 2023",LAC vs. MEM,L,11,1,2,0.5,0,0,0.0,0,0,0.0,1,2,3,0,0,0,0,1,2,-6,1,LAC,LAC,MEM,101,,,5,5,2,3
Lester Quinones,G,22023,1631311,22300757,"FEB 10, 2024",GSW vs. PHX,W,19,2,6,0.333,2,4,0.5,0,0,0.0,1,2,3,0,0,0,0,1,6,-3,1,GSW,GSW,PHX,113,,,9,9,6,3
Lester Quinones,G,22023,1631311,22300733,"FEB 08, 2024",GSW @ IND,W,27,2,7,0.286,0,3,0.0,2,2,1.0,0,5,5,5,0,1,0,3,6,12,1,GSW,IND,GSW,131,,,16,11,11,10
Lester Quinones,G,22023,1631311,22300727,"FEB 07, 2024",GSW @ PHI,W,24,4,7,0.571,4,7,0.571,1,2,0.5,0,2,2,4,0,0,2,4,13,4,1,GSW,PHI,GSW,127,,,19,15,17,6
Lester Quinones,G,22023,1631311,22300717,"FEB 05, 2024",GSW @ BKN,W,24,1,7,0.143,0,2,0.0,1,2,0.5,3,4,7,2,2,0,1,3,3,5,1,GSW,BKN,GSW,109,,,12,10,5,9
Lester Quinones,G,22023,1631311,22300699,"FEB 03, 2024",GSW @ ATL,L,23,6,11,0.545,4,8,0.5,1,2,0.5,4,1,5,0,0,0,1,2,17,-7,1,GSW,ATL,GSW,134,,,22,22,17,5
Lester Quinones,G,22023,1631311,22300693,"FEB 02, 2024",GSW @ MEM,W,19,3,6,0.5,2,4,0.5,2,2,1.0,1,5,6,1,0,0,2,3,10,11,1,GSW,MEM,GSW,121,,,17,16,11,7
Lester Quinones,G,22023,1631311,22300673,"JAN 30, 2024",GSW vs. PHI,W,11,1,2,0.5,1,2,0.5,0,0,0.0,0,0,0,0,0,0,0,2,3,-3,1,GSW,GSW,PHI,119,,,3,3,3,0
Lester Quinones,G,22023,1631311,22300626,"JAN 24, 2024",GSW vs. ATL,W,3,1,2,0.5,0,1,0.0,0,0,0.0,1,2,3,0,0,0,1,0,2,2,1,GSW,GSW,ATL,134,,,5,5,2,3
Lester Quinones,G,22023,1631311,22300560,"JAN 15, 2024",GSW @ MEM,L,5,0,0,0.0,0,0,0.0,0,0,0.0,0,0,0,1,0,1,0,0,0,1,1,GSW,MEM,GSW,107,,,1,0,1,1
Lester Quinones,G,22023,1631311,22300525,"JAN 10, 2024",GSW vs. NOP,L,8,1,4,0.25,1,3,0.333,0,0,0.0,1,0,1,1,0,0,0,0,3,-1,1,GSW,GSW,NOP,105,,,5,4,4,2
Lester Quinones,G,22023,1631311,22300504,"JAN 07, 2024",GSW vs. TOR,L,7,2,3,0.667,1,2,0.5,0,0,0.0,0,1,1,0,1,0,1,1,5,10,1,GSW,GSW,TOR,118,,,6,6,5,1
Lester Quinones,G,22023,1631311,22300426,"DEC 28, 2023",GSW vs. MIA,L,2,0,0,0.0,0,0,0.0,0,0,0.0,0,0,0,0,0,0,0,1,0,3,1,GSW,GSW,MIA,102,,,0,0,0,0
Lester Quinones,G,22023,1631311,22300386,"DEC 22, 2023",GSW vs. WAS,W,6,1,3,0.333,1,2,0.5,0,0,0.0,0,3,3,1,0,0,1,1,3,-12,1,GSW,GSW,WAS,129,,,7,6,4,4
Lester Quinones,G,22023,1631311,22300108,"OCT 30, 2023",GSW @ NOP,W,5,2,3,0.667,1,2,0.5,0,0,0.0,0,0,0,0,0,0,1,0,5,0,1,GSW,NOP,GSW,130,,,5,5,5,0
Lester Quinones,G,22023,1631311,22300545,"JAN 13, 2024",GSW @ MIL,L,18,2,5,0.4,1,1,1.0,1,2,0.5,2,2,4,2,0,0,1,2,6,9,1,GSW,MIL,GSW,118,,,12,10,8,6
Lester Quinones,G,22023,1631311,22300201,"NOV 16, 2023",GSW vs. OKC,L,4,0,3,0.0,0,2,0.0,0,0,0.0,0,0,0,0,0,0,0,1,0,1,1,GSW,GSW,OKC,109,,,0,0,0,0
Adama Sanogo,F,22023,1641766,22300468,"JAN 03, 2024",CHI @ NYK,L,1,0,0,0.0,0,0,0.0,0,0,0.0,0,0,0,0,0,0,0,0,0,0,1,CHI,NYK,CHI,100,,,0,0,0,0
Adama Sanogo,F,22023,1641766,22300459,"JAN 02, 2024",CHI @ PHI,L,9,3,3,1.0,0,0,0.0,2,3,0.667,2,4,6,0,0,0,1,0,8,17,1,CHI,PHI,CHI,97,,,14,14,8,6
Adama Sanogo,F,22023,1641766,22300422,"DEC 28, 2023",CHI vs. IND,L,1,0,0,0.0,0,0,0.0,0,0,0.0,0,0,0,0,0,0,0,0,0,0,1,CHI,CHI,IND,104,,,0,0,0,0
Markieff Morris,F,22023,202693,22300385,"DEC 22, 2023",DAL @ HOU,L,12,1,4,0.25,1,4,0.25,1,2,0.5,0,2,2,0,0,0,0,0,4,-13,1,DAL,HOU,DAL,96,,,6,6,4,2
Markieff Morris,F,22023,202693,22300356,"DEC 18, 2023",DAL @ DEN,L,13,1,3,0.333,0,2,0.0,0,0,0.0,0,3,3,0,0,0,0,1,2,-11,1,DAL,DEN,DAL,104,,,5,5,2,3
Markieff Morris,F,22023,202693,22300341,"DEC 16, 2023",DAL @ POR,W,20,4,9,0.444,2,5,0.4,0,0,0.0,0,5,5,4,1,0,2,0,10,8,1,DAL,POR,DAL,131,,,19,15,14,9
Markieff Morris,F,22023,202693,22300321,"DEC 14, 2023",DAL vs. MIN,L,13,1,1,1.0,0,0,0.0,0,0,0.0,0,1,1,1,0,0,0,3,2,-6,1,DAL,DAL,MIN,101,,,4,3,3,2
Markieff Morris,F,22023,202693,22300530,"JAN 11, 2024",DAL vs. NYK,W,4,0,1,0.0,0,0,0.0,2,2,1.0,0,0,0,0,0,0,0,0,2,6,1,DAL,DAL,NYK,128,,,2,2,2,0
Markieff Morris,F,22023,202693,22300515,"JAN 09, 2024",DAL vs. MEM,L,6,0,0,0.0,0,0,0.0,0,0,0.0,0,1,1,0,0,0,0,0,0,-2,1,DAL,DAL,MEM,103,,,1,1,0,1
Markieff Morris,F,22023,202693,22300472,"JAN 03, 2024",DAL vs. POR,W,12,1,3,0.333,1,1,1.0,0,0,0.0,0,3,3,1,1,0,1,2,3,1,1,DAL,DAL,POR,126,,,7,6,4,4
Markieff Morris,F,22023,202693,22300423,"DEC 28, 2023",DAL @ MIN,L,3,0,1,0.0,0,0,0.0,0,0,0.0,0,0,0,0,0,0,1,0,0,-7,1,DAL,MIN,DAL,110,,,0,0,0,0
Markieff Morris,F,22023,202693,22300306,"DEC 12, 2023",DAL vs. LAL,W,6,0,2,0.0,0,2,0.0,0,0,0.0,0,2,2,1,1,0,0,0,0,-10,1,DAL,DAL,LAL,127,,,3,2,1,3
Markieff Morris,F,22023,202693,22300299,"DEC 11, 2023",DAL @ MEM,W,21,2,5,0.4,2,4,0.5,0,0,0.0,1,2,3,2,2,1,2,1,6,5,1,DAL,MEM,DAL,120,,,11,9,8,5
Markieff Morris,F,22023,202693,22301226,"DEC 08, 2023",DAL @ POR,W,7,1,1,1.0,0,0,0.0,0,0,0.0,0,1,1,0,0,0,3,1,2,1,1,DAL,POR,DAL,125,,,3,3,2,1
Markieff Morris,F,22023,202693,22301213,"DEC 06, 2023",DAL vs. UTA,W,6,1,3,0.333,1,2,0.5,0,0,0.0,0,1,1,0,0,0,0,0,3,4,1,DAL,DAL,UTA,147,,,4,4,3,1
Markieff Morris,F,22023,202693,22300277,"DEC 01, 2023",DAL vs. MEM,L,14,2,7,0.286,2,4,0.5,0,0,0.0,2,1,3,1,0,0,0,2,6,-11,1,DAL,DAL,MEM,94,,,10,9,7,4
Markieff Morris,F,22023,202693,22300183,"NOV 12, 2023",DAL @ NOP,W,4,0,2,0.0,0,2,0.0,0,0,0.0,0,1,1,0,0,0,0,0,0,-8,1,DAL,NOP,DAL,136,,,1,1,0,1
Markieff Morris,F,22023,202693,22300736,"FEB 08, 2024",DAL @ NYK,W,6,1,2,0.5,1,2,0.5,0,0,0.0,0,2,2,0,0,0,0,0,3,-1,1,DAL,NYK,DAL,121,,,5,5,3,2
Markieff Morris,F,22023,202693,22300372,"DEC 20, 2023",DAL vs. LAC,L,5,0,1,0.0,0,0,0.0,0,0,0.0,1,1,2,0,0,0,0,1,0,-5,1,DAL,DAL,LAC,111,,,2,2,0,2
Markieff Morris,F,22023,202693,22300212,"NOV 19, 2023",DAL vs. SAC,L,5,1,4,0.25,0,2,0.0,0,0,0.0,0,0,0,1,0,0,0,0,2,5,1,DAL,DAL,SAC,113,,,3,2,3,1
Otto Porter Jr.,F,22023,203490,22300432,"DEC 29, 2023",TOR @ BOS,L,8,0,1,0.0,0,1,0.0,0,0,0.0,0,0,0,2,0,0,0,0,0,-5,1,TOR,BOS,TOR,118,,,2,0,2,2
Otto Porter Jr.,F,22023,203490,22300416,"DEC 27, 2023",TOR @ WAS,W,13,3,3,1.0,0,0,0.0,0,0,0.0,0,2,2,2,1,1,0,2,6,12,1,TOR,WAS,TOR,132,,,10,8,8,4
Otto Porter Jr.,F,22023,203490,22300382,"DEC 22, 2023",TOR @ PHI,L,15,1,3,0.333,1,3,0.333,2,2,1.0,0,3,3,0,0,0,0,3,5,-10,1,TOR,PHI,TOR,111,,,8,8,5,3
Otto Porter Jr.,F,22023,203490,22301216,"DEC 08, 2023",TOR @ CHA,L,6,0,1,0.0,0,1,0.0,0,0,0.0,0,0,0,1,0,0,0,0,0,-7,1,TOR,CHA,TOR,116,,,1,0,1,1
Otto Porter Jr.,F,22023,203490,22301207,"DEC 06, 2023",TOR vs. MIA,L,14,0,2,0.0,0,2,0.0,0,0,0.0,0,2,2,1,1,1,1,2,0,14,1,TOR,TOR,MIA,103,,,3,2,1,3
Otto Porter Jr.,F,22023,203490,22300251,"NOV 26, 2023",TOR @ CLE,L,5,0,1,0.0,0,1,0.0,0,0,0.0,1,0,1,0,0,0,0,0,0,-4,1,TOR,CLE,TOR,102,,,1,1,0,1
Otto Porter Jr.,F,22023,203490,22300038,"NOV 21, 2023",TOR @ ORL,L,5,2,2,1.0,1,1,1.0,0,0,0.0,1,1,2,0,0,0,1,1,5,4,1,TOR,ORL,TOR,107,,,7,7,5,2
Otto Porter Jr.,F,22023,203490,22300195,"NOV 15, 2023",TOR vs. MIL,L,11,0,0,0.0,0,0,0.0,0,0,0.0,0,1,1,0,0,0,0,0,0,0,1,TOR,TOR,MIL,112,,,1,1,0,1
Otto Porter Jr.,F,22023,203490,22300189,"NOV 13, 2023",TOR vs. WAS,W,14,2,6,0.333,0,1,0.0,1,1,1.0,1,0,1,0,1,1,0,0,5,-13,1,TOR,TOR,WAS,111,,,6,6,5,1
Otto Porter Jr.,F,22023,203490,22300174,"NOV 11, 2023",TOR @ BOS,L,14,1,2,0.5,1,2,0.5,0,0,0.0,0,3,3,0,1,0,0,1,3,-9,1,TOR,BOS,TOR,94,,,6,6,3,3
Otto Porter Jr.,F,22023,203490,22300230,"NOV 22, 2023",TOR @ IND,W,11,1,1,1.0,1,1,1.0,0,0,0.0,1,3,4,0,0,0,0,2,3,14,1,TOR,IND,TOR,132,,,7,7,3,4
Otto Porter Jr.,F,22023,203490,22300168,"NOV 08, 2023",TOR @ DAL,W,15,0,3,0.0,0,2,0.0,0,0,0.0,0,3,3,0,1,0,0,1,0,9,1,TOR,DAL,TOR,127,,,3,3,0,3
Otto Porter Jr.,F,22023,203490,22300141,"NOV 05, 2023",TOR @ SAS,W,19,2,4,0.5,2,4,0.5,0,0,0.0,0,4,4,0,0,1,0,2,6,9,1,TOR,SAS,TOR,123,,,10,10,6,4
Otto Porter Jr.,F,22023,203490,22300116,"NOV 01, 2023",TOR vs. MIL,W,16,2,4,0.5,2,4,0.5,0,0,0.0,2,1,3,1,0,1,0,3,6,11,1,TOR,TOR,MIL,130,,,10,9,7,4
Otto Porter Jr.,F,22023,203490,22300440,"DEC 30, 2023",TOR @ DET,L,7,0,0,0.0,0,0,0.0,0,0,0.0,0,0,0,1,0,0,0,2,0,-3,1,TOR,DET,TOR,127,,,1,0,1,1
Svi Mykhailiuk,G-F,22023,1629004,22300706,"FEB 04, 2024",BOS vs. MEM,W,7,2,5,0.4,2,5,0.4,0,0,0.0,0,2,2,3,0,0,0,0,6,11,1,BOS,BOS,MEM,131,,,11,8,9,5
Svi Mykhailiuk,G-F,22023,1629004,22300646,"JAN 27, 2024",BOS vs. LAC,L,8,2,5,0.4,2,5,0.4,0,0,0.0,0,1,1,1,1,0,0,0,6,14,1,BOS,BOS,LAC,96,,,8,7,7,2
Svi Mykhailiuk,G-F,22023,1629004,22300630,"JAN 25, 2024",BOS @ MIA,W,3,2,2,1.0,2,2,1.0,0,0,0.0,0,0,0,0,0,0,0,0,6,2,1,BOS,MIA,BOS,143,,,6,6,6,0
Svi Mykhailiuk,G-F,22023,1629004,22300571,"JAN 17, 2024",BOS vs. SAS,W,4,0,2,0.0,0,2,0.0,0,0,0.0,0,0,0,0,0,0,0,0,0,-2,1,BOS,BOS,SAS,117,,,0,0,0,0
Svi Mykhailiuk,G-F,22023,1629004,22300528,"JAN 11, 2024",BOS @ MIL,L,17,3,5,0.6,2,3,0.667,1,2,0.5,0,1,1,1,1,0,0,0,9,-5,1,BOS,MIL,BOS,102,,,11,10,10,2
Svi Mykhailiuk,G-F,22023,1629004,22300507,"JAN 08, 2024",BOS @ IND,L,5,0,0,0.0,0,0,0.0,2,4,0.5,1,0,1,0,0,0,1,0,2,-1,1,BOS,IND,BOS,131,,,3,3,2,1
Svi Mykhailiuk,G-F,22023,1629004,22300493,"JAN 06, 2024",BOS @ IND,W,1,0,0,0.0,0,0,0.0,0,0,0.0,0,0,0,0,0,0,0,0,0,0,1,BOS,IND,BOS,118,,,0,0,0,0
Svi Mykhailiuk,G-F,22023,1629004,22300479,"JAN 05, 2024",BOS vs. UTA,W,15,1,7,0.143,1,6,0.167,0,0,0.0,0,3,3,0,0,0,0,2,3,-6,1,BOS,BOS,UTA,126,,,6,6,3,3
Svi Mykhailiuk,G-F,22023,1629004,22300448,"DEC 31, 2023",BOS @ SAS,W,8,0,4,0.0,0,4,0.0,0,0,0.0,0,1,1,0,1,0,1,1,0,-4,1,BOS,SAS,BOS,134,,,1,1,0,1
Svi Mykhailiuk,G-F,22023,1629004,22300432,"DEC 29, 2023",BOS vs. TOR,W,7,2,3,0.667,1,2,0.5,0,0,0.0,0,1,1,1,0,0,0,2,5,-6,1,BOS,BOS,TOR,120,,,7,6,6,2
Svi Mykhailiuk,G-F,22023,1629004,22300053,"NOV 28, 2023",BOS vs. CHI,W,2,0,0,0.0,0,0,0.0,0,0,0.0,0,0,0,0,0,0,0,0,0,0,1,BOS,BOS,CHI,124,,,0,0,0,0
Svi Mykhailiuk,G-F,22023,1629004,22300194,"NOV 15, 2023",BOS @ PHI,W,15,2,4,0.5,1,3,0.333,0,0,0.0,1,0,1,0,1,0,1,3,5,0,1,BOS,PHI,BOS,117,,,6,6,5,1
Svi Mykhailiuk,G-F,22023,1629004,22300174,"NOV 11, 2023",BOS vs. TOR,W,5,0,2,0.0,0,2,0.0,0,0,0.0,0,0,0,0,0,0,1,0,0,-7,1,BOS,BOS,TOR,117,,,0,0,0,0
Svi Mykhailiuk,G-F,22023,1629004,22300010,"NOV 10, 2023",BOS vs. BKN,W,9,0,1,0.0,0,1,0.0,0,0,0.0,0,1,1,0,0,0,2,1,0,-5,1,BOS,BOS,BKN,121,,,1,1,0,1
Svi Mykhailiuk,G-F,22023,1629004,22300118,"NOV 01, 2023",BOS vs. IND,W,11,2,6,0.333,1,4,0.25,0,0,0.0,0,3,3,0,0,0,0,0,5,17,1,BOS,BOS,IND,155,,,8,8,5,3
Svi Mykhailiuk,G-F,22023,1629004,22300103,"OCT 30, 2023",BOS @ WAS,W,5,1,2,0.5,1,2,0.5,0,0,0.0,0,0,0,1,1,0,0,0,3,1,1,BOS,WAS,BOS,126,,,4,3,4,1
Svi Mykhailiuk,G-F,22023,1629004,22300542,"JAN 13, 2024",BOS vs. HOU,W,9,2,5,0.4,2,3,0.667,0,0,0.0,1,0,1,0,0,0,0,1,6,-1,1,BOS,BOS,HOU,145,,,7,7,6,1
Svi Mykhailiuk,G-F,22023,1629004,22300373,"DEC 20, 2023",BOS @ SAC,W,16,1,6,0.167,0,4,0.0,0,0,0.0,2,2,4,3,1,0,0,1,2,7,1,BOS,SAC,BOS,144,,,9,6,5,7
Svi Mykhailiuk,G-F,22023,1629004,22300362,"DEC 19, 2023",BOS @ GSW,L,2,0,1,0.0,0,1,0.0,0,0,0.0,0,0,0,0,0,0,0,0,0,3,1,BOS,GSW,BOS,126,,,0,0,0,0
Svi Mykhailiuk,G-F,22023,1629004,22300329,"DEC 15, 2023",BOS vs. ORL,W,5,0,1,0.0,0,1,0.0,0,0,0.0,0,0,0,0,0,0,0,0,0,-4,1,BOS,BOS,ORL,128,,,0,0,0,0
Svi Mykhailiuk,G-F,22023,1629004,22300217,"NOV 20, 2023",BOS @ CHA,L,9,1,2,0.5,1,2,0.5,0,0,0.0,0,0,0,0,1,0,0,0,3,7,1,BOS,CHA,BOS,118,,,3,3,3,0
Svi Mykhailiuk,G-F,22023,1629004,22300154,"NOV 06, 2023",BOS @ MIN,L,4,0,0,0.0,0,0,0.0,0,0,0.0,0,0,0,0,0,0,0,0,0,-2,1,BOS,MIN,BOS,109,,,0,0,0,0
Sandro Mamukelashvili,F-C,22023,1630572,22300750,"FEB 10, 2024",SAS @ BKN,L,4,1,1,1.0,0,0,0.0,0,0,0.0,0,0,0,0,0,0,0,0,2,4,1,SAS,BKN,SAS,103,,,2,2,2,0
Sandro Mamukelashvili,F-C,22023,1630572,22300571,"JAN 17, 2024",SAS @ BOS,L,5,1,2,0.5,0,1,0.0,0,0,0.0,0,2,2,0,0,0,0,0,2,2,1,SAS,BOS,SAS,95,,,4,4,2,2
Sandro Mamukelashvili,F-C,22023,1630572,22300559,"JAN 15, 2024",SAS @ ATL,L,1,0,1,0.0,0,1,0.0,0,0,0.0,0,0,0,0,0,0,0,0,0,-4,1,SAS,ATL,SAS,99,,,0,0,0,0
Sandro Mamukelashvili,F-C,22023,1630572,22300548,"JAN 13, 2024",SAS vs. CHI,L,18,3,7,0.429,1,3,0.333,1,2,0.5,3,5,8,1,1,2,0,5,8,-6,1,SAS,SAS,CHI,116,,,17,16,9,9
Sandro Mamukelashvili,F-C,22023,1630572,22300541,"JAN 12, 2024",SAS vs. CHA,W,10,0,1,0.0,0,0,0.0,1,2,0.5,1,1,2,0,0,1,0,1,1,2,1,SAS,SAS,CHA,127,,,3,3,1,2
Sandro Mamukelashvili,F-C,22023,1630572,22300519,"JAN 10, 2024",SAS @ DET,W,2,0,0,0.0,0,0,0.0,0,0,0.0,0,0,0,0,0,0,0,0,0,1,1,SAS,DET,SAS,129,,,0,0,0,0
Sandro Mamukelashvili,F-C,22023,1630572,22300477,"JAN 04, 2024",SAS vs. MIL,L,3,0,0,0.0,0,0,0.0,0,0,0.0,0,0,0,2,0,0,0,0,0,-1,1,SAS,SAS,MIL,121,,,2,0,2,2
Sandro Mamukelashvili,F-C,22023,1630572,22300460,"JAN 02, 2024",SAS @ MEM,L,2,1,1,1.0,1,1,1.0,0,0,0.0,0,0,0,0,0,1,1,0,3,4,1,SAS,MEM,SAS,98,,,3,3,3,0
Sandro Mamukelashvili,F-C,22023,1630572,22300448,"DEC 31, 2023",SAS vs. BOS,L,20,3,9,0.333,1,5,0.2,0,0,0.0,2,5,7,4,0,0,0,1,7,-9,1,SAS,SAS,BOS,101,,,18,14,11,11
Sandro Mamukelashvili,F-C,22023,1630572,22300437,"DEC 29, 2023",SAS @ POR,L,8,1,2,0.5,0,1,0.0,0,0,0.0,0,1,1,2,0,0,0,1,2,8,1,SAS,POR,SAS,128,,,5,3,4,3
Sandro Mamukelashvili,F-C,22023,1630572,22300361,"DEC 19, 2023",SAS @ MIL,L,15,1,5,0.2,1,4,0.25,0,0,0.0,1,7,8,3,1,2,2,1,3,-7,1,SAS,MIL,SAS,119,,,14,11,6,11
Sandro Mamukelashvili,F-C,22023,1630572,22300278,"DEC 01, 2023",SAS @ NOP,L,6,1,3,0.333,1,2,0.5,0,0,0.0,1,0,1,1,0,0,0,1,3,0,1,SAS,NOP,SAS,106,,,5,4,4,2
Sandro Mamukelashvili,F-C,22023,1630572,22300206,"NOV 18, 2023",SAS vs. MEM,L,11,2,5,0.4,1,2,0.5,0,0,0.0,0,2,2,1,0,1,1,3,5,-4,1,SAS,SAS,MEM,108,,,8,7,6,3
Sandro Mamukelashvili,F-C,22023,1630572,22300161,"NOV 08, 2023",SAS @ NYK,L,3,0,1,0.0,0,1,0.0,0,0,0.0,1,0,1,0,0,0,0,1,0,0,1,SAS,NYK,SAS,105,,,1,1,0,1
Sandro Mamukelashvili,F-C,22023,1630572,22300146,"NOV 06, 2023",SAS @ IND,L,9,2,4,0.5,0,2,0.0,1,2,0.5,2,2,4,1,0,0,0,0,5,-6,1,SAS,IND,SAS,111,,,10,9,6,5
Sandro Mamukelashvili,F-C,22023,1630572,22300099,"OCT 29, 2023",SAS @ LAC,L,7,0,0,0.0,0,0,0.0,0,0,0.0,1,1,2,0,1,0,1,1,0,-13,1,SAS,LAC,SAS,83,,,2,2,0,2
Sandro Mamukelashvili,F-C,22023,1630572,22300252,"NOV 26, 2023",SAS @ DEN,L,7,0,0,0.0,0,0,0.0,0,0,0.0,0,0,0,2,1,0,0,1,0,8,1,SAS,DEN,SAS,120,,,2,0,2,2
Sandro Mamukelashvili,F-C,22023,1630572,22300032,"NOV 17, 2023",SAS vs. SAC,L,12,1,2,0.5,0,0,0.0,4,4,1.0,1,2,3,3,0,0,1,1,6,21,1,SAS,SAS,SAC,120,,,12,9,9,6
Sandro Mamukelashvili,F-C,22023,1630572,22300730,"FEB 07, 2024",SAS @ MIA,L,3,1,2,0.5,0,1,0.0,0,0,0.0,0,0,0,2,0,0,0,0,2,4,1,SAS,MIA,SAS,104,,,4,2,4,2
Sandro Mamukelashvili,F-C,22023,1630572,22300622,"JAN 24, 2024",SAS vs. OKC,L,5,2,3,0.667,0,1,0.0,0,0,0.0,0,1,1,0,0,0,0,0,4,7,1,SAS,SAS,OKC,114,,,5,5,4,1
Sandro Mamukelashvili,F-C,22023,1630572,22300427,"DEC 28, 2023",SAS @ POR,W,1,0,1,0.0,0,1,0.0,0,0,0.0,0,0,0,0,0,0,0,0,0,-2,1,SAS,POR,SAS,118,,,0,0,0,0
Sandro Mamukelashvili,F-C,22023,1630572,22300412,"DEC 26, 2023",SAS vs. UTA,L,2,0,1,0.0,0,0,0.0,0,0,0.0,0,1,1,0,0,0,0,0,0,7,1,SAS,SAS,UTA,118,,,1,1,0,1
Sandro Mamukelashvili,F-C,22023,1630572,22300398,"DEC 23, 2023",SAS @ DAL,L,15,4,6,0.667,1,3,0.333,5,6,0.833,3,2,5,3,0,1,1,1,14,4,1,SAS,DAL,SAS,119,,,22,19,17,8
Sandro Mamukelashvili,F-C,22023,1630572,22300376,"DEC 21, 2023",SAS @ CHI,L,3,0,0,0.0,0,0,0.0,0,0,0.0,0,1,1,0,0,0,0,0,0,1,1,SAS,CHI,SAS,95,,,1,1,0,1
Sandro Mamukelashvili,F-C,22023,1630572,22300345,"DEC 17, 2023",SAS vs. NOP,L,8,1,4,0.25,0,3,0.0,0,0,0.0,0,0,0,2,0,0,1,0,2,-4,1,SAS,SAS,NOP,110,,,4,2,4,2
Sandro Mamukelashvili,F-C,22023,1630572,22300331,"DEC 15, 2023",SAS vs. LAL,W,2,1,1,1.0,1,1,1.0,0,0,0.0,0,0,0,0,0,0,0,0,3,-3,1,SAS,SAS,LAL,129,,,3,3,3,0
Sandro Mamukelashvili,F-C,22023,1630572,22300298,"DEC 11, 2023",SAS @ HOU,L,4,0,0,0.0,0,0,0.0,0,0,0.0,0,1,1,0,0,0,0,1,0,0,1,SAS,HOU,SAS,82,,,1,1,0,1
Sandro Mamukelashvili,F-C,22023,1630572,22300641,"JAN 26, 2024",SAS vs. POR,W,1,0,0,0.0,0,0,0.0,0,0,0.0,0,0,0,0,0,0,0,0,0,1,1,SAS,SAS,POR,116,,,0,0,0,0
Leonard Miller,F,22023,1631159,22300738,"FEB 08, 2024",MIN @ MIL,W,3,1,1,1.0,0,0,0.0,0,0,0.0,1,0,1,0,0,0,0,0,2,1,1,MIN,MIL,MIN,129,,,3,3,2,1
Leonard Miller,F,22023,1631159,22300538,"JAN 12, 2024",MIN vs. POR,W,8,2,4,0.5,0,2,0.0,0,0,0.0,0,2,2,0,1,1,1,2,4,-9,1,MIN,MIN,POR,116,,,6,6,4,2
Leonard Miller,F,22023,1631159,22300411,"DEC 26, 2023",MIN @ OKC,L,5,3,3,1.0,1,1,1.0,0,0,0.0,0,1,1,0,0,0,0,0,7,-1,1,MIN,OKC,MIN,106,,,8,8,7,1
Leonard Miller,F,22023,1631159,22300249,"NOV 26, 2023",MIN @ MEM,W,2,1,1,1.0,0,0,0.0,0,0,0.0,0,2,2,1,0,0,0,0,2,3,1,MIN,MEM,MIN,119,,,5,4,3,3
Leonard Miller,F,22023,1631159,22300232,"NOV 22, 2023",MIN vs. PHI,W,2,0,0,0.0,0,0,0.0,0,0,0.0,0,3,3,0,0,0,0,1,0,-1,1,MIN,MIN,PHI,112,,,3,3,0,3
Leonard Miller,F,22023,1631159,22300093,"OCT 28, 2023",MIN vs. MIA,W,2,0,1,0.0,0,0,0.0,0,0,0.0,0,1,1,0,0,0,0,0,0,-7,1,MIN,MIN,MIA,106,,,1,1,0,1
Jared Rhoden,G,22023,1631197,22300008,"NOV 10, 2023",DET vs. PHI,L,7,2,3,0.667,1,2,0.5,0,0,0.0,0,0,0,0,0,0,1,1,5,2,1,DET,DET,PHI,106,,,5,5,5,0
Jared Rhoden,G,22023,1631197,22300165,"NOV 08, 2023",DET @ MIL,L,13,3,4,0.75,0,1,0.0,0,0,0.0,0,1,1,3,0,0,0,2,6,9,1,DET,MIL,DET,118,,,10,7,9,4
Jared Rhoden,G,22023,1631197,22300145,"NOV 06, 2023",DET vs. GSW,L,5,0,2,0.0,0,1,0.0,2,2,1.0,1,1,2,0,0,0,1,1,2,-9,1,DET,DET,GSW,109,,,4,4,2,2
Jared Rhoden,G,22023,1631197,22300140,"NOV 05, 2023",DET vs. PHX,L,3,0,0,0.0,0,0,0.0,0,0,0.0,0,0,0,0,0,0,0,0,0,5,1,DET,DET,PHX,106,,,0,0,0,0
Jared Rhoden,G,22023,1631197,22300109,"OCT 30, 2023",DET @ OKC,L,2,0,0,0.0,0,0,0.0,0,0,0.0,0,1,1,0,0,0,0,0,0,8,1,DET,OKC,DET,112,,,1,1,0,1
Jared Rhoden,G,22023,1631197,22300741,"FEB 08, 2024",DET @ POR,W,13,1,2,0.5,0,0,0.0,0,0,0.0,0,1,1,1,0,2,1,0,2,2,1,DET,POR,DET,128,,,4,3,3,2
Kenneth Lofton Jr.,F,22023,1631254,22301221,"DEC 08, 2023",MEM vs. MIN,L,4,1,3,0.333,1,2,0.5,2,2,1.0,0,0,0,2,1,0,0,0,5,0,1,MEM,MEM,MIN,95,,,7,5,7,2
Kenneth Lofton Jr.,F,22023,1631254,22301206,"DEC 06, 2023",MEM @ DET,W,0,0,0,0.0,0,0,0.0,0,0,0.0,0,1,1,0,0,0,0,0,0,0,1,MEM,DET,MEM,104,,,1,1,0,1
Kenneth Lofton Jr.,F,22023,1631254,22300277,"DEC 01, 2023",MEM @ DAL,W,2,0,2,0.0,0,0,0.0,0,0,0.0,0,2,2,0,0,0,0,0,0,-4,1,MEM,DAL,MEM,89,,,2,2,0,2
Kenneth Lofton Jr.,F,22023,1631254,22300249,"NOV 26, 2023",MEM vs. MIN,L,2,1,1,1.0,0,0,0.0,0,0,0.0,0,0,0,0,0,0,0,0,2,-3,1,MEM,MEM,MIN,91,,,2,2,2,0
Kenneth Lofton Jr.,F,22023,1631254,22300044,"NOV 24, 2023",MEM vs. PHX,L,2,1,1,1.0,0,0,0.0,0,0,0.0,0,0,0,0,0,0,0,1,2,-4,1,MEM,MEM,PHX,89,,,2,2,2,0
Kenneth Lofton Jr.,F,22023,1631254,22300231,"NOV 22, 2023",MEM @ HOU,L,4,1,4,0.25,0,1,0.0,1,1,1.0,0,0,0,2,0,1,0,0,3,3,1,MEM,HOU,MEM,91,,,5,3,5,2
Kenneth Lofton Jr.,F,22023,1631254,22300213,"NOV 19, 2023",MEM vs. BOS,L,13,2,5,0.4,0,1,0.0,2,2,1.0,0,2,2,1,0,0,2,0,6,1,1,MEM,MEM,BOS,100,,,9,8,7,3
Kenneth Lofton Jr.,F,22023,1631254,22300206,"NOV 18, 2023",MEM @ SAS,W,12,1,3,0.333,0,1,0.0,0,0,0.0,0,1,1,2,0,0,1,3,2,-6,1,MEM,SAS,MEM,120,,,5,3,4,3
Kenneth Lofton Jr.,F,22023,1631254,22300026,"NOV 14, 2023",MEM @ LAL,L,5,0,2,0.0,0,1,0.0,0,0,0.0,0,0,0,0,0,0,0,0,0,-5,1,MEM,LAL,MEM,107,,,0,0,0,0
Kenneth Lofton Jr.,F,22023,1631254,22300012,"NOV 10, 2023",MEM vs. UTA,L,12,0,2,0.0,0,1,0.0,0,0,0.0,0,2,2,0,0,1,1,3,0,11,1,MEM,MEM,UTA,121,,,2,2,0,2
Kenneth Lofton Jr.,F,22023,1631254,22300164,"NOV 08, 2023",MEM vs. MIA,L,7,1,3,0.333,0,0,0.0,0,0,0.0,0,0,0,1,0,0,0,1,2,2,1,MEM,MEM,MIA,102,,,3,2,3,1
Kenneth Lofton Jr.,F,22023,1631254,22300144,"NOV 05, 2023",MEM @ POR,W,10,2,3,0.667,1,2,0.5,0,1,0.0,0,2,2,3,0,1,0,0,5,4,1,MEM,POR,MEM,112,,,10,7,8,5
Kenneth Lofton Jr.,F,22023,1631254,22300727,"FEB 07, 2024",PHI vs. GSW,L,5,1,4,0.25,0,2,0.0,0,0,0.0,0,1,1,0,0,0,0,0,2,-4,1,PHI,PHI,GSW,104,,,3,3,2,1
Kenneth Lofton Jr.,F,22023,1631254,22300459,"JAN 02, 2024",PHI vs. CHI,W,4,0,2,0.0,0,0,0.0,0,0,0.0,0,2,2,0,0,0,2,0,0,-10,1,PHI,PHI,CHI,110,,,2,2,0,2
Kenneth Lofton Jr.,F,22023,1631254,22300125,"NOV 01, 2023",MEM @ UTA,L,19,4,7,0.571,1,1,1.0,3,9,0.333,2,3,5,2,2,0,1,5,12,5,1,MEM,UTA,MEM,109,,,19,17,14,7
Kenneth Lofton Jr.,F,22023,1631254,22300106,"OCT 30, 2023",MEM vs. DAL,L,1,0,0,0.0,0,0,0.0,0,0,0.0,0,0,0,0,0,0,0,0,0,0,1,MEM,MEM,DAL,110,,,0,0,0,0
Kenneth Lofton Jr.,F,22023,1631254,22300089,"OCT 28, 2023",MEM @ WAS,L,5,0,1,0.0,0,0,0.0,0,0,0.0,0,0,0,1,0,0,1,2,0,1,1,MEM,WAS,MEM,106,,,1,0,1,1
Kenneth Lofton Jr.,F,22023,1631254,22301221,"DEC 08, 2023",MEM vs. MIN,L,4,1,3,0.333,1,2,0.5,2,2,1.0,0,0,0,2,1,0,0,0,5,0,1,MEM,MEM,MIN,95,,,7,5,7,2
Kenneth Lofton Jr.,F,22023,1631254,22301206,"DEC 06, 2023",MEM @ DET,W,0,0,0,0.0,0,0,0.0,0,0,0.0,0,1,1,0,0,0,0,0,0,0,1,MEM,DET,MEM,104,,,1,1,0,1
Kenneth Lofton Jr.,F,22023,1631254,22300277,"DEC 01, 2023",MEM @ DAL,W,2,0,2,0.0,0,0,0.0,0,0,0.0,0,2,2,0,0,0,0,0,0,-4,1,MEM,DAL,MEM,89,,,2,2,0,2
Kenneth Lofton Jr.,F,22023,1631254,22300249,"NOV 26, 2023",MEM vs. MIN,L,2,1,1,1.0,0,0,0.0,0,0,0.0,0,0,0,0,0,0,0,0,2,-3,1,MEM,MEM,MIN,91,,,2,2,2,0
Kenneth Lofton Jr.,F,22023,1631254,22300044,"NOV 24, 2023",MEM vs. PHX,L,2,1,1,1.0,0,0,0.0,0,0,0.0,0,0,0,0,0,0,0,1,2,-4,1,MEM,MEM,PHX,89,,,2,2,2,0
Kenneth Lofton Jr.,F,22023,1631254,22300231,"NOV 22, 2023",MEM @ HOU,L,4,1,4,0.25,0,1,0.0,1,1,1.0,0,0,0,2,0,1,0,0,3,3,1,MEM,HOU,MEM,91,,,5,3,5,2
Kenneth Lofton Jr.,F,22023,1631254,22300213,"NOV 19, 2023",MEM vs. BOS,L,13,2,5,0.4,0,1,0.0,2,2,1.0,0,2,2,1,0,0,2,0,6,1,1,MEM,MEM,BOS,100,,,9,8,7,3
Kenneth Lofton Jr.,F,22023,1631254,22300206,"NOV 18, 2023",MEM @ SAS,W,12,1,3,0.333,0,1,0.0,0,0,0.0,0,1,1,2,0,0,1,3,2,-6,1,MEM,SAS,MEM,120,,,5,3,4,3
Kenneth Lofton Jr.,F,22023,1631254,22300026,"NOV 14, 2023",MEM @ LAL,L,5,0,2,0.0,0,1,0.0,0,0,0.0,0,0,0,0,0,0,0,0,0,-5,1,MEM,LAL,MEM,107,,,0,0,0,0
Kenneth Lofton Jr.,F,22023,1631254,22300012,"NOV 10, 2023",MEM vs. UTA,L,12,0,2,0.0,0,1,0.0,0,0,0.0,0,2,2,0,0,1,1,3,0,11,1,MEM,MEM,UTA,121,,,2,2,0,2
Kenneth Lofton Jr.,F,22023,1631254,22300164,"NOV 08, 2023",MEM vs. MIA,L,7,1,3,0.333,0,0,0.0,0,0,0.0,0,0,0,1,0,0,0,1,2,2,1,MEM,MEM,MIA,102,,,3,2,3,1
Kenneth Lofton Jr.,F,22023,1631254,22300144,"NOV 05, 2023",MEM @ POR,W,10,2,3,0.667,1,2,0.5,0,1,0.0,0,2,2,3,0,1,0,0,5,4,1,MEM,POR,MEM,112,,,10,7,8,5
Kenneth Lofton Jr.,F,22023,1631254,22300727,"FEB 07, 2024",PHI vs. GSW,L,5,1,4,0.25,0,2,0.0,0,0,0.0,0,1,1,0,0,0,0,0,2,-4,1,PHI,PHI,GSW,104,,,3,3,2,1
Kenneth Lofton Jr.,F,22023,1631254,22300459,"JAN 02, 2024",PHI vs. CHI,W,4,0,2,0.0,0,0,0.0,0,0,0.0,0,2,2,0,0,0,2,0,0,-10,1,PHI,PHI,CHI,110,,,2,2,0,2
Kenneth Lofton Jr.,F,22023,1631254,22300125,"NOV 01, 2023",MEM @ UTA,L,19,4,7,0.571,1,1,1.0,3,9,0.333,2,3,5,2,2,0,1,5,12,5,1,MEM,UTA,MEM,109,,,19,17,14,7
Kenneth Lofton Jr.,F,22023,1631254,22300106,"OCT 30, 2023",MEM vs. DAL,L,1,0,0,0.0,0,0,0.0,0,0,0.0,0,0,0,0,0,0,0,0,0,0,1,MEM,MEM,DAL,110,,,0,0,0,0
Kenneth Lofton Jr.,F,22023,1631254,22300089,"OCT 28, 2023",MEM @ WAS,L,5,0,1,0.0,0,0,0.0,0,0,0.0,0,0,0,1,0,0,1,2,0,1,1,MEM,WAS,MEM,106,,,1,0,1,1
Cole Swider,F,22023,1631306,22300630,"JAN 25, 2024",MIA vs. BOS,L,7,0,2,0.0,0,1,0.0,0,0,0.0,0,0,0,0,0,0,0,1,0,-1,1,MIA,MIA,BOS,110,,,0,0,0,0
Cole Swider,F,22023,1631306,22300574,"JAN 17, 2024",MIA @ TOR,L,2,1,2,0.5,0,1,0.0,0,0,0.0,0,0,0,0,0,0,1,0,2,3,1,MIA,TOR,MIA,97,,,2,2,2,0
Cole Swider,F,22023,1631306,22300489,"JAN 05, 2024",MIA @ PHX,L,2,0,0,0.0,0,0,0.0,0,0,0.0,0,0,0,0,0,0,1,0,0,5,1,MIA,PHX,MIA,97,,,0,0,0,0
Cole Swider,F,22023,1631306,22300475,"JAN 03, 2024",MIA @ LAL,W,1,0,1,0.0,0,1,0.0,0,0,0.0,0,0,0,0,0,0,0,0,0,0,1,MIA,LAL,MIA,110,,,0,0,0,0
Cole Swider,F,22023,1631306,22300458,"JAN 01, 2024",MIA @ LAC,L,3,1,1,1.0,1,1,1.0,0,0,0.0,0,0,0,0,0,0,0,0,3,3,1,MIA,LAC,MIA,104,,,3,3,3,0
Cole Swider,F,22023,1631306,22300426,"DEC 28, 2023",MIA @ GSW,W,1,1,1,1.0,0,0,0.0,0,0,0.0,1,0,1,0,0,0,0,0,2,-3,1,MIA,GSW,MIA,114,,,3,3,2,1
Cole Swider,F,22023,1631306,22300045,"NOV 24, 2023",MIA @ NYK,L,6,0,3,0.0,0,2,0.0,0,0,0.0,0,0,0,2,0,0,0,0,0,-3,1,MIA,NYK,MIA,98,,,2,0,2,2
Cole Swider,F,22023,1631306,22300093,"OCT 28, 2023",MIA @ MIN,L,2,2,3,0.667,1,2,0.5,0,0,0.0,0,1,1,0,0,0,0,0,5,7,1,MIA,MIN,MIA,90,,,6,6,5,1
Cole Swider,F,22023,1631306,22300240,"NOV 25, 2023",MIA @ BKN,L,20,4,8,0.5,3,7,0.429,0,0,0.0,0,0,0,1,1,1,1,1,11,-2,1,MIA,BKN,MIA,97,,,12,11,12,1
Rayan Rupert,G-F,22023,1641712,22300668,"JAN 29, 2024",POR vs. PHI,W,5,0,2,0.0,0,0,0.0,0,0,0.0,1,1,2,0,1,0,0,0,0,7,1,POR,POR,PHI,128,,,2,2,0,2
Rayan Rupert,G-F,22023,1641712,22300641,"JAN 26, 2024",POR @ SAS,L,8,1,1,1.0,1,1,1.0,0,0,0.0,0,0,0,1,0,0,0,1,3,-6,1,POR,SAS,POR,98,,,4,3,4,1
Rayan Rupert,G-F,22023,1641712,22300605,"JAN 21, 2024",POR @ LAL,L,6,2,5,0.4,0,2,0.0,2,2,1.0,1,0,1,0,0,0,0,0,6,-1,1,POR,LAL,POR,108,,,7,7,6,1
Rayan Rupert,G-F,22023,1641712,22300399,"DEC 23, 2023",POR @ GSW,L,5,0,1,0.0,0,0,0.0,0,0,0.0,0,0,0,2,0,0,0,0,0,-1,1,POR,GSW,POR,106,,,2,0,2,2
Rayan Rupert,G-F,22023,1641712,22300041,"NOV 21, 2023",POR @ PHX,L,2,0,1,0.0,0,0,0.0,0,0,0.0,0,0,0,1,1,0,0,0,0,3,1,POR,PHX,POR,107,,,1,0,1,1
Rayan Rupert,G-F,22023,1641712,22300215,"NOV 19, 2023",POR vs. OKC,L,12,1,5,0.2,1,3,0.333,1,2,0.5,1,0,1,1,1,0,1,0,4,-8,1,POR,POR,OKC,89,,,6,5,5,2
Rayan Rupert,G-F,22023,1641712,22300199,"NOV 15, 2023",POR vs. CLE,L,3,0,1,0.0,0,1,0.0,0,0,0.0,0,0,0,0,0,0,1,1,0,0,1,POR,POR,CLE,93,,,0,0,0,0
Rayan Rupert,G-F,22023,1641712,22300023,"NOV 14, 2023",POR @ UTA,L,3,0,2,0.0,0,0,0.0,1,2,0.5,0,0,0,0,0,0,0,0,1,-1,1,POR,UTA,POR,99,,,1,1,1,0
Rayan Rupert,G-F,22023,1641712,22300098,"OCT 29, 2023",POR @ PHI,L,5,0,1,0.0,0,1,0.0,0,0,0.0,0,0,0,0,0,0,0,0,0,-7,1,POR,PHI,POR,98,,,0,0,0,0
Rayan Rupert,G-F,22023,1641712,22300074,"OCT 25, 2023",POR @ LAC,L,2,0,0,0.0,0,0,0.0,0,0,0.0,0,0,0,0,0,0,0,0,0,3,1,POR,LAC,POR,111,,,0,0,0,0
Rayan Rupert,G-F,22023,1641712,22300538,"JAN 12, 2024",POR @ MIN,L,7,1,2,0.5,0,0,0.0,1,2,0.5,0,1,1,1,0,0,0,0,3,11,1,POR,MIN,POR,91,,,5,4,4,2
Rayan Rupert,G-F,22023,1641712,22300514,"JAN 09, 2024",POR @ NYK,L,12,2,5,0.4,0,1,0.0,0,0,0.0,1,4,5,1,0,0,1,0,4,8,1,POR,NYK,POR,80,,,10,9,5,6
Rayan Rupert,G-F,22023,1641712,22300487,"JAN 05, 2024",POR @ DAL,L,19,3,5,0.6,1,2,0.5,0,0,0.0,1,2,3,0,0,0,2,3,7,-12,1,POR,DAL,POR,103,,,10,10,7,3
Rayan Rupert,G-F,22023,1641712,22300237,"NOV 22, 2023",POR vs. UTA,W,6,0,2,0.0,0,1,0.0,0,0,0.0,0,0,0,0,0,0,0,0,0,-14,1,POR,POR,UTA,121,,,0,0,0,0
Rayan Rupert,G-F,22023,1641712,22300554,"JAN 14, 2024",POR vs. PHX,L,14,4,5,0.8,3,3,1.0,0,0,0.0,2,3,5,2,0,0,1,2,11,4,1,POR,POR,PHX,116,,,18,16,13,7
Rayan Rupert,G-F,22023,1641712,22300529,"JAN 11, 2024",POR @ OKC,L,12,1,5,0.2,1,2,0.5,0,0,0.0,0,3,3,2,0,0,0,0,3,0,1,POR,OKC,POR,77,,,8,6,5,5
Joe Harris,G-F,22023,203925,22300394,"DEC 23, 2023",DET @ BKN,L,7,0,0,0.0,0,0,0.0,0,0,0.0,0,1,1,0,0,0,0,0,0,-7,1,DET,BKN,DET,115,,,1,1,0,1
Joe Harris,G-F,22023,203925,22300352,"DEC 18, 2023",DET @ ATL,L,12,0,1,0.0,0,1,0.0,1,2,0.5,1,1,2,2,1,1,0,1,1,1,1,DET,ATL,DET,124,,,5,3,3,4
Joe Harris,G-F,22023,203925,22300334,"DEC 16, 2023",DET @ MIL,L,7,0,1,0.0,0,1,0.0,0,0,0.0,0,0,0,0,0,0,0,1,0,-4,1,DET,MIL,DET,114,,,0,0,0,0
Joe Harris,G-F,22023,203925,22301217,"DEC 08, 2023",DET @ ORL,L,4,0,1,0.0,0,0,0.0,0,0,0.0,0,0,0,0,0,1,0,0,0,-7,1,DET,ORL,DET,91,,,0,0,0,0
Joe Harris,G-F,22023,203925,22300140,"NOV 05, 2023",DET vs. PHX,L,13,0,2,0.0,0,2,0.0,0,0,0.0,0,1,1,1,0,0,0,1,0,-5,1,DET,DET,PHX,106,,,2,1,1,2
Joe Harris,G-F,22023,203925,22300129,"NOV 02, 2023",DET @ NOP,L,24,3,8,0.375,2,6,0.333,0,0,0.0,1,2,3,1,1,0,1,4,8,6,1,DET,NOP,DET,116,,,12,11,9,4
Joe Harris,G-F,22023,203925,22300115,"NOV 01, 2023",DET vs. POR,L,17,4,7,0.571,3,6,0.5,0,0,0.0,1,1,2,1,0,0,0,1,11,-10,1,DET,DET,POR,101,,,14,13,12,3
Joe Harris,G-F,22023,203925,22300109,"OCT 30, 2023",DET @ OKC,L,10,0,1,0.0,0,0,0.0,0,0,0.0,0,0,0,1,0,0,1,2,0,-5,1,DET,OKC,DET,112,,,1,0,1,1
Joe Harris,G-F,22023,203925,22300088,"OCT 28, 2023",DET vs. CHI,W,11,1,2,0.5,1,2,0.5,0,0,0.0,0,1,1,1,0,0,1,0,3,1,1,DET,DET,CHI,118,,,5,4,4,2
Joe Harris,G-F,22023,203925,22300077,"OCT 27, 2023",DET @ CHA,W,11,1,3,0.333,0,1,0.0,0,0,0.0,0,0,0,1,1,0,0,2,2,3,1,DET,CHA,DET,111,,,3,2,3,1
Joe Harris,G-F,22023,203925,22300068,"OCT 25, 2023",DET @ MIA,L,12,0,2,0.0,0,2,0.0,0,0,0.0,0,0,0,0,0,0,0,2,0,-5,1,DET,MIA,DET,102,,,0,0,0,0
Joe Harris,G-F,22023,203925,22300519,"JAN 10, 2024",DET vs. SAS,L,6,0,0,0.0,0,0,0.0,0,0,0.0,0,1,1,0,0,0,0,1,0,3,1,DET,DET,SAS,108,,,1,1,0,1
Joe Harris,G-F,22023,203925,22300512,"JAN 09, 2024",DET vs. SAC,L,9,3,5,0.6,3,5,0.6,0,0,0.0,0,1,1,0,0,0,0,2,9,2,1,DET,DET,SAC,110,,,10,10,9,1
Joe Harris,G-F,22023,203925,22300327,"DEC 15, 2023",DET @ PHI,L,11,1,3,0.333,1,3,0.333,0,0,0.0,0,1,1,1,0,0,0,1,3,-8,1,DET,PHI,DET,92,,,5,4,4,2
Joe Harris,G-F,22023,203925,22300732,"FEB 07, 2024",DET @ SAC,W,12,1,3,0.333,0,1,0.0,0,0,0.0,0,0,0,0,0,0,0,1,2,-5,1,DET,SAC,DET,133,,,2,2,2,0
Joe Harris,G-F,22023,203925,22300558,"JAN 15, 2024",DET @ WAS,W,5,0,0,0.0,0,0,0.0,0,0,0.0,0,0,0,1,0,0,1,0,0,-10,1,DET,WAS,DET,129,,,1,0,1,1
Jordan McLaughlin,G,22023,1629162,22300723,"FEB 06, 2024",MIN @ CHI,L,7,1,3,0.333,1,1,1.0,0,0,0.0,0,1,1,1,0,0,0,1,3,-2,1,MIN,CHI,MIN,123,,,5,4,4,2
Jordan McLaughlin,G,22023,1629162,22300709,"FEB 04, 2024",MIN vs. HOU,W,17,1,4,0.25,1,3,0.333,1,2,0.5,1,3,4,2,0,0,1,0,4,-6,1,MIN,MIN,HOU,111,,,10,8,6,6
Jordan McLaughlin,G,22023,1629162,22300694,"FEB 02, 2024",MIN vs. ORL,L,5,2,3,0.667,2,3,0.667,0,0,0.0,0,0,0,1,2,0,0,0,6,3,1,MIN,MIN,ORL,106,,,7,6,7,1
Jordan McLaughlin,G,22023,1629162,22300680,"JAN 31, 2024",MIN vs. DAL,W,14,0,3,0.0,0,2,0.0,0,0,0.0,1,2,3,5,3,0,0,0,0,1,1,MIN,MIN,DAL,121,,,8,3,5,8
Jordan McLaughlin,G,22023,1629162,22300664,"JAN 29, 2024",MIN @ OKC,W,14,4,4,1.0,2,2,1.0,0,0,0.0,0,0,0,1,0,0,1,3,10,1,1,MIN,OKC,MIN,107,,,11,10,11,1
Jordan McLaughlin,G,22023,1629162,22300649,"JAN 27, 2024",MIN @ SAS,L,9,0,1,0.0,0,1,0.0,0,0,0.0,1,0,1,1,0,0,1,0,0,-11,1,MIN,SAS,MIN,112,,,2,1,1,2
Jordan McLaughlin,G,22023,1629162,22300629,"JAN 25, 2024",MIN @ BKN,W,11,1,2,0.5,0,0,0.0,0,0,0.0,0,0,0,1,0,0,1,0,2,7,1,MIN,BKN,MIN,96,,,3,2,3,1
Jordan McLaughlin,G,22023,1629162,22300620,"JAN 24, 2024",MIN @ WAS,W,13,2,4,0.5,1,1,1.0,0,0,0.0,1,1,2,2,1,0,0,1,5,1,1,MIN,WAS,MIN,118,,,9,7,7,4
Jordan McLaughlin,G,22023,1629162,22300610,"JAN 22, 2024",MIN vs. CHA,L,10,0,2,0.0,0,2,0.0,0,0,0.0,0,2,2,3,0,1,1,0,0,5,1,MIN,MIN,CHA,125,,,5,2,3,5
Jordan McLaughlin,G,22023,1629162,22300599,"JAN 20, 2024",MIN vs. OKC,L,13,3,7,0.429,2,3,0.667,0,0,0.0,2,0,2,3,2,0,0,1,8,7,1,MIN,MIN,OKC,97,,,13,10,11,5
Jordan McLaughlin,G,22023,1629162,22300582,"JAN 18, 2024",MIN vs. MEM,W,7,0,0,0.0,0,0,0.0,0,0,0.0,0,2,2,0,1,0,2,0,0,-4,1,MIN,MIN,MEM,118,,,2,2,0,2
Jordan McLaughlin,G,22023,1629162,22300569,"JAN 17, 2024",MIN @ DET,W,8,0,1,0.0,0,0,0.0,0,2,0.0,0,2,2,0,0,0,0,1,0,-3,1,MIN,DET,MIN,124,,,2,2,0,2
Jordan McLaughlin,G,22023,1629162,22300538,"JAN 12, 2024",MIN vs. POR,W,13,1,3,0.333,0,2,0.0,0,0,0.0,0,0,0,5,1,0,2,2,2,-9,1,MIN,MIN,POR,116,,,7,2,7,5
Jordan McLaughlin,G,22023,1629162,22300517,"JAN 10, 2024",MIN @ BOS,L,17,2,5,0.4,2,3,0.667,0,0,0.0,0,2,2,0,0,0,0,1,6,-5,1,MIN,BOS,MIN,120,,,8,8,6,2
Jordan McLaughlin,G,22023,1629162,22300513,"JAN 09, 2024",MIN @ ORL,W,15,2,3,0.667,0,1,0.0,0,0,0.0,0,0,0,5,1,0,1,1,4,-8,1,MIN,ORL,MIN,113,,,9,4,9,5
Jordan McLaughlin,G,22023,1629162,22300501,"JAN 07, 2024",MIN @ DAL,L,13,2,7,0.286,2,7,0.286,0,0,0.0,0,1,1,1,2,1,0,0,6,-4,1,MIN,DAL,MIN,108,,,8,7,7,2
Jordan McLaughlin,G,22023,1629162,22300485,"JAN 05, 2024",MIN @ HOU,W,13,1,1,1.0,1,1,1.0,0,0,0.0,0,3,3,3,2,0,0,0,3,19,1,MIN,HOU,MIN,122,,,9,6,6,6
Jordan McLaughlin,G,22023,1629162,22300471,"JAN 03, 2024",MIN vs. NOP,L,17,1,6,0.167,0,4,0.0,1,2,0.5,2,1,3,4,1,0,0,0,3,5,1,MIN,MIN,NOP,106,,,10,6,7,7
Jordan McLaughlin,G,22023,1629162,22300451,"JAN 01, 2024",MIN @ NYK,L,12,4,5,0.8,1,2,0.5,0,0,0.0,0,1,1,3,2,0,0,1,9,13,1,MIN,NYK,MIN,106,,,13,10,12,4
Jordan McLaughlin,G,22023,1629162,22300411,"DEC 26, 2023",MIN @ OKC,L,14,1,5,0.2,0,1,0.0,0,0,0.0,2,2,4,2,3,0,1,0,2,-8,1,MIN,OKC,MIN,106,,,8,6,4,6
Jordan McLaughlin,G,22023,1629162,22300400,"DEC 23, 2023",MIN @ SAC,W,2,0,0,0.0,0,0,0.0,0,0,0.0,0,0,0,2,0,0,0,0,0,-1,1,MIN,SAC,MIN,110,,,2,0,2,2
Jordan McLaughlin,G,22023,1629162,22300367,"DEC 20, 2023",MIN @ PHI,L,2,0,0,0.0,0,0,0.0,0,0,0.0,0,0,0,1,0,0,0,0,0,0,1,MIN,PHI,MIN,113,,,1,0,1,1
Jordan McLaughlin,G,22023,1629162,22300338,"DEC 16, 2023",MIN vs. IND,W,3,0,0,0.0,0,0,0.0,0,0,0.0,0,0,0,0,0,1,0,0,0,-5,1,MIN,MIN,IND,127,,,0,0,0,0
Jordan McLaughlin,G,22023,1629162,22300321,"DEC 14, 2023",MIN @ DAL,W,2,0,0,0.0,0,0,0.0,0,0,0.0,0,0,0,1,0,0,0,0,0,-1,1,MIN,DAL,MIN,119,,,1,0,1,1
Jordan McLaughlin,G,22023,1629162,22300301,"DEC 11, 2023",MIN @ NOP,L,8,1,1,1.0,1,1,1.0,0,0,0.0,0,0,0,1,1,0,0,0,3,1,1,MIN,NOP,MIN,107,,,4,3,4,1
Jordan McLaughlin,G,22023,1629162,22300154,"NOV 06, 2023",MIN vs. BOS,W,4,0,0,0.0,0,0,0.0,2,2,1.0,0,0,0,0,0,1,0,0,2,3,1,MIN,MIN,BOS,114,,,2,2,2,0
Jordan McLaughlin,G,22023,1629162,22300138,"NOV 04, 2023",MIN vs. UTA,W,4,0,0,0.0,0,0,0.0,0,0,0.0,0,0,0,1,0,0,0,1,0,5,1,MIN,MIN,UTA,123,,,1,0,1,1
Jordan McLaughlin,G,22023,1629162,22300123,"NOV 01, 2023",MIN vs. DEN,W,4,0,1,0.0,0,1,0.0,0,0,0.0,0,0,0,0,0,0,0,0,0,2,1,MIN,MIN,DEN,110,,,0,0,0,0
Jordan McLaughlin,G,22023,1629162,22300104,"OCT 30, 2023",MIN @ ATL,L,1,0,0,0.0,0,0,0.0,0,0,0.0,0,0,0,0,0,1,0,0,0,4,1,MIN,ATL,MIN,113,,,0,0,0,0
Jordan McLaughlin,G,22023,1629162,22300093,"OCT 28, 2023",MIN vs. MIA,W,6,1,3,0.333,1,1,1.0,0,0,0.0,0,0,0,4,0,0,0,1,3,-4,1,MIN,MIN,MIA,106,,,7,3,7,4
Greg Brown III,F,22023,1630535,22300487,"JAN 05, 2024",DAL vs. POR,W,12,3,5,0.6,1,2,0.5,0,0,0.0,1,1,2,1,0,3,1,2,7,5,1,DAL,DAL,POR,132,,,10,9,8,3
Greg Brown III,F,22023,1630535,22300398,"DEC 23, 2023",DAL vs. SAS,W,5,0,1,0.0,0,0,0.0,0,0,0.0,0,0,0,0,0,1,2,1,0,-15,1,DAL,DAL,SAS,144,,,0,0,0,0
Greg Brown III,F,22023,1630535,22300385,"DEC 22, 2023",DAL @ HOU,L,12,0,3,0.0,0,1,0.0,3,4,0.75,1,4,5,2,0,0,0,1,3,-1,1,DAL,HOU,DAL,96,,,10,8,5,7
Greg Brown III,F,22023,1630535,22300356,"DEC 18, 2023",DAL @ DEN,L,9,2,2,1.0,0,0,0.0,1,5,0.2,1,1,2,0,0,0,1,1,5,1,1,DAL,DEN,DAL,104,,,7,7,5,2
Greg Brown III,F,22023,1630535,22300341,"DEC 16, 2023",DAL @ POR,W,1,0,0,0.0,0,0,0.0,0,0,0.0,0,0,0,0,0,0,0,0,0,0,1,DAL,POR,DAL,131,,,0,0,0,0
Greg Brown III,F,22023,1630535,22300321,"DEC 14, 2023",DAL vs. MIN,L,2,0,0,0.0,0,0,0.0,0,0,0.0,0,0,0,1,0,0,0,0,0,1,1,DAL,DAL,MIN,101,,,1,0,1,1
Gui Santos,F,22023,1630611,22300733,"FEB 08, 2024",GSW @ IND,W,21,5,8,0.625,2,2,1.0,1,2,0.5,2,6,8,1,0,0,0,1,13,5,1,GSW,IND,GSW,131,,,22,21,14,9
Gui Santos,F,22023,1630611,22300727,"FEB 07, 2024",GSW @ PHI,W,8,0,2,0.0,0,1,0.0,2,2,1.0,0,1,1,1,1,0,0,2,2,-2,1,GSW,PHI,GSW,127,,,4,3,3,2
Gui Santos,F,22023,1630611,22300717,"FEB 05, 2024",GSW @ BKN,W,18,3,5,0.6,0,0,0.0,3,3,1.0,2,3,5,0,1,2,0,2,9,13,1,GSW,BKN,GSW,109,,,14,14,9,5
Gui Santos,F,22023,1630611,22300699,"FEB 03, 2024",GSW @ ATL,L,15,0,2,0.0,0,2,0.0,2,2,1.0,1,1,2,3,0,0,1,4,2,5,1,GSW,ATL,GSW,134,,,7,4,5,5
Gui Santos,F,22023,1630611,22300693,"FEB 02, 2024",GSW @ MEM,W,11,2,2,1.0,0,0,0.0,0,0,0.0,1,1,2,0,0,0,0,2,4,5,1,GSW,MEM,GSW,121,,,6,6,4,2
Gui Santos,F,22023,1630611,22300626,"JAN 24, 2024",GSW vs. ATL,W,3,0,1,0.0,0,0,0.0,0,0,0.0,1,0,1,0,0,0,0,0,0,2,1,GSW,GSW,ATL,134,,,1,1,0,1
Gui Santos,F,22023,1630611,22300525,"JAN 10, 2024",GSW vs. NOP,L,10,0,3,0.0,0,3,0.0,2,2,1.0,0,3,3,1,0,0,0,0,2,-6,1,GSW,GSW,NOP,105,,,6,5,3,4
Gui Santos,F,22023,1630611,22300399,"DEC 23, 2023",GSW vs. POR,W,4,0,0,0.0,0,0,0.0,2,2,1.0,1,1,2,0,0,0,0,0,2,1,1,GSW,GSW,POR,126,,,4,4,2,2
Gui Santos,F,22023,1630611,22300386,"DEC 22, 2023",GSW vs. WAS,W,6,2,3,0.667,1,2,0.5,2,2,1.0,1,1,2,0,0,0,0,1,7,-12,1,GSW,GSW,WAS,129,,,9,9,7,2
Gui Santos,F,22023,1630611,22300236,"NOV 22, 2023",GSW @ PHX,L,8,1,1,1.0,0,0,0.0,0,0,0.0,0,1,1,0,0,0,2,2,2,3,1,GSW,PHX,GSW,115,,,3,3,2,1
Gui Santos,F,22023,1630611,22300201,"NOV 16, 2023",GSW vs. OKC,L,4,1,3,0.333,0,1,0.0,0,0,0.0,2,1,3,1,0,0,0,0,2,-1,1,GSW,GSW,OKC,109,,,6,5,3,4
Dalano Banton,F,22023,1630625,22300758,"FEB 10, 2024",POR vs. NOP,L,25,5,14,0.357,1,5,0.2,1,1,1.0,0,3,3,3,0,0,2,0,12,-4,1,POR,POR,NOP,75,,,18,15,15,6
Dalano Banton,F,22023,1630625,22300706,"FEB 04, 2024",BOS vs. MEM,W,7,0,4,0.0,0,2,0.0,0,0,0.0,0,1,1,2,0,0,0,0,0,11,1,BOS,BOS,MEM,131,,,3,1,2,3
Dalano Banton,F,22023,1630625,22300684,"FEB 01, 2024",BOS vs. LAL,L,2,0,0,0.0,0,0,0.0,2,2,1.0,0,1,1,1,0,0,0,0,2,4,1,BOS,BOS,LAL,105,,,4,3,3,2
Dalano Banton,F,22023,1630625,22300646,"JAN 27, 2024",BOS vs. LAC,L,12,1,4,0.25,0,2,0.0,0,0,0.0,0,0,0,3,0,0,1,0,2,12,1,BOS,BOS,LAC,96,,,5,2,5,3
Dalano Banton,F,22023,1630625,22300630,"JAN 25, 2024",BOS @ MIA,W,7,0,1,0.0,0,0,0.0,0,0,0.0,0,0,0,2,1,0,0,1,0,1,1,BOS,MIA,BOS,143,,,2,0,2,2
Dalano Banton,F,22023,1630625,22300571,"JAN 17, 2024",BOS vs. SAS,W,4,0,2,0.0,0,1,0.0,1,2,0.5,1,1,2,0,0,0,0,0,1,-2,1,BOS,BOS,SAS,117,,,3,3,1,2
Dalano Banton,F,22023,1630625,22300528,"JAN 11, 2024",BOS @ MIL,L,18,1,5,0.2,1,2,0.5,1,2,0.5,0,1,1,3,2,1,0,1,4,7,1,BOS,MIL,BOS,102,,,8,5,7,4
Dalano Banton,F,22023,1630625,22300507,"JAN 08, 2024",BOS @ IND,L,4,0,0,0.0,0,0,0.0,0,0,0.0,0,0,0,0,0,0,1,3,0,2,1,BOS,IND,BOS,131,,,0,0,0,0
Dalano Banton,F,22023,1630625,22300493,"JAN 06, 2024",BOS @ IND,W,1,0,0,0.0,0,0,0.0,0,0,0.0,0,0,0,0,0,0,0,0,0,0,1,BOS,IND,BOS,118,,,0,0,0,0
Dalano Banton,F,22023,1630625,22300479,"JAN 05, 2024",BOS vs. UTA,W,6,1,2,0.5,0,1,0.0,3,4,0.75,0,1,1,1,0,0,0,1,5,3,1,BOS,BOS,UTA,126,,,7,6,6,2
Dalano Banton,F,22023,1630625,22300448,"DEC 31, 2023",BOS @ SAS,W,11,0,2,0.0,0,0,0.0,4,4,1.0,1,3,4,1,0,0,2,2,4,-3,1,BOS,SAS,BOS,134,,,9,8,5,5
Dalano Banton,F,22023,1630625,22300432,"DEC 29, 2023",BOS vs. TOR,W,2,1,1,1.0,0,0,0.0,0,0,0.0,0,0,0,0,0,0,1,0,2,-4,1,BOS,BOS,TOR,120,,,2,2,2,0
Dalano Banton,F,22023,1630625,22300389,"DEC 23, 2023",BOS @ LAC,W,4,1,1,1.0,0,0,0.0,0,0,0.0,0,0,0,1,0,0,0,0,2,6,1,BOS,LAC,BOS,142,,,3,2,3,1
Dalano Banton,F,22023,1630625,22300344,"DEC 17, 2023",BOS vs. ORL,W,2,1,2,0.5,0,1,0.0,0,0,0.0,0,0,0,0,0,0,0,0,2,-4,1,BOS,BOS,ORL,114,,,2,2,2,0
Dalano Banton,F,22023,1630625,22301227,"DEC 08, 2023",BOS vs. NYK,W,0,0,0,0.0,0,0,0.0,0,0,0.0,0,0,0,0,0,0,0,0,0,-2,1,BOS,BOS,NYK,133,,,0,0,0,0
Dalano Banton,F,22023,1630625,22301202,"DEC 04, 2023",BOS @ IND,L,11,0,1,0.0,0,0,0.0,0,0,0.0,1,3,4,1,0,0,3,1,0,-2,1,BOS,IND,BOS,112,,,5,4,1,5
Dalano Banton,F,22023,1630625,22300275,"DEC 01, 2023",BOS vs. PHI,W,10,2,4,0.5,0,1,0.0,0,1,0.0,3,2,5,1,0,1,0,1,4,1,1,BOS,BOS,PHI,125,,,10,9,5,6
Dalano Banton,F,22023,1630625,22300053,"NOV 28, 2023",BOS vs. CHI,W,15,2,3,0.667,1,2,0.5,0,0,0.0,0,0,0,0,0,1,0,1,5,10,1,BOS,BOS,CHI,124,,,5,5,5,0
Dalano Banton,F,22023,1630625,22300246,"NOV 26, 2023",BOS vs. ATL,W,19,3,5,0.6,0,1,0.0,2,2,1.0,2,3,5,1,0,0,1,4,8,-4,1,BOS,BOS,ATL,113,,,14,13,9,6
Dalano Banton,F,22023,1630625,22300043,"NOV 24, 2023",BOS @ ORL,L,1,0,1,0.0,0,0,0.0,0,0,0.0,0,0,0,0,0,0,0,0,0,-2,1,BOS,ORL,BOS,96,,,0,0,0,0
Dalano Banton,F,22023,1630625,22300194,"NOV 15, 2023",BOS @ PHI,W,8,1,4,0.25,0,1,0.0,0,0,0.0,1,4,5,0,1,0,0,2,2,8,1,BOS,PHI,BOS,117,,,7,7,2,5
Dalano Banton,F,22023,1630625,22300174,"NOV 11, 2023",BOS vs. TOR,W,6,0,1,0.0,0,1,0.0,0,0,0.0,0,0,0,0,0,0,0,0,0,-2,1,BOS,BOS,TOR,117,,,0,0,0,0
Dalano Banton,F,22023,1630625,22300010,"NOV 10, 2023",BOS vs. BKN,W,4,0,1,0.0,0,0,0.0,0,0,0.0,1,0,1,0,0,0,0,0,0,-6,1,BOS,BOS,BKN,121,,,1,1,0,1
Dalano Banton,F,22023,1630625,22300118,"NOV 01, 2023",BOS vs. IND,W,8,4,4,1.0,0,0,0.0,3,3,1.0,0,3,3,1,1,0,0,2,11,3,1,BOS,BOS,IND,155,,,15,14,12,4
Dalano Banton,F,22023,1630625,22300103,"OCT 30, 2023",BOS @ WAS,W,10,1,3,0.333,0,1,0.0,0,0,0.0,2,0,2,1,0,0,1,1,2,-17,1,BOS,WAS,BOS,126,,,5,4,3,3
Amari Bailey,G,22023,1641735,22300745,"FEB 09, 2024",CHA @ MIL,L,4,0,1,0.0,0,1,0.0,0,0,0.0,0,0,0,1,0,0,0,0,0,-1,1,CHA,MIL,CHA,80,,,1,0,1,1
Amari Bailey,G,22023,1641735,22300335,"DEC 16, 2023",CHA vs. PHI,L,7,1,3,0.333,0,2,0.0,1,2,0.5,0,0,0,0,0,0,1,0,3,-6,1,CHA,CHA,PHI,80,,,3,3,3,0
Amari Bailey,G,22023,1641735,22300177,"NOV 12, 2023",CHA @ NYK,L,3,1,3,0.333,0,0,0.0,0,0,0.0,2,0,2,0,0,0,0,0,2,7,1,CHA,NYK,CHA,107,,,4,4,2,2
Alex Len,C,22023,203458,22300746,"FEB 09, 2024",SAC vs. DEN,W,15,4,5,0.8,0,1,0.0,3,5,0.6,2,0,2,1,1,0,1,3,11,13,1,SAC,SAC,DEN,135,,,14,13,12,3
Alex Len,C,22023,203458,22300714,"FEB 05, 2024",SAC @ CLE,L,3,0,0,0.0,0,0,0.0,0,0,0.0,0,0,0,1,0,0,0,0,0,-2,1,SAC,CLE,SAC,110,,,1,0,1,1
Alex Len,C,22023,203458,22300583,"JAN 18, 2024",SAC vs. IND,L,5,0,1,0.0,0,0,0.0,0,0,0.0,0,0,0,0,0,0,2,1,0,-5,1,SAC,SAC,IND,121,,,0,0,0,0
Alex Len,C,22023,203458,22300567,"JAN 16, 2024",SAC @ PHX,L,8,0,0,0.0,0,0,0.0,0,0,0.0,0,0,0,0,0,0,2,3,0,3,1,SAC,PHX,SAC,117,,,0,0,0,0
Alex Len,C,22023,203458,22300552,"JAN 14, 2024",SAC @ MIL,L,11,2,4,0.5,0,1,0.0,0,0,0.0,3,2,5,1,0,0,0,3,4,-7,1,SAC,MIL,SAC,142,,,10,9,5,6
Alex Len,C,22023,203458,22300532,"JAN 12, 2024",SAC @ PHI,L,8,1,1,1.0,0,0,0.0,0,0,0.0,2,2,4,1,0,0,0,1,2,-1,1,SAC,PHI,SAC,90,,,7,6,3,5
Alex Len,C,22023,203458,22300518,"JAN 10, 2024",SAC @ CHA,W,16,4,6,0.667,0,0,0.0,0,0,0.0,4,6,10,1,1,1,1,2,8,28,1,SAC,CHA,SAC,121,,,19,18,9,11
Alex Len,C,22023,203458,22300512,"JAN 09, 2024",SAC @ DET,W,10,3,3,1.0,0,0,0.0,0,1,0.0,1,2,3,0,0,1,1,1,6,-7,1,SAC,DET,SAC,131,,,9,9,6,3
Alex Len,C,22023,203458,22300500,"JAN 07, 2024",SAC vs. NOP,L,10,0,2,0.0,0,0,0.0,0,0,0.0,1,0,1,3,1,0,0,1,0,14,1,SAC,SAC,NOP,100,,,4,1,3,4
Alex Len,C,22023,203458,22300464,"JAN 02, 2024",SAC vs. CHA,L,13,1,1,1.0,0,0,0.0,1,2,0.5,0,4,4,3,0,0,1,2,3,-1,1,SAC,SAC,CHA,104,,,10,7,6,7
Alex Len,C,22023,203458,22300449,"DEC 31, 2023",SAC @ MEM,W,12,0,1,0.0,0,0,0.0,0,0,0.0,4,5,9,1,0,1,2,3,0,10,1,SAC,MEM,SAC,123,,,10,9,1,10
Alex Len,C,22023,203458,22300431,"DEC 29, 2023",SAC @ ATL,W,13,1,2,0.5,0,0,0.0,0,0,0.0,1,3,4,4,0,0,0,0,2,11,1,SAC,ATL,SAC,117,,,10,6,6,8
Alex Len,C,22023,203458,22300413,"DEC 26, 2023",SAC @ POR,L,2,0,0,0.0,0,0,0.0,0,0,0.0,0,0,0,0,0,0,0,0,0,2,1,SAC,POR,SAC,113,,,0,0,0,0
Alex Len,C,22023,203458,22300191,"NOV 13, 2023",SAC vs. CLE,W,6,1,2,0.5,0,0,0.0,0,0,0.0,0,0,0,3,0,0,0,0,2,4,1,SAC,SAC,CLE,132,,,5,2,5,3
Alex Len,C,22023,203458,22300016,"NOV 10, 2023",SAC vs. OKC,W,10,1,1,1.0,0,0,0.0,1,2,0.5,3,3,6,0,0,2,2,1,3,-1,1,SAC,SAC,OKC,105,,,9,9,3,6
Alex Len,C,22023,203458,22300170,"NOV 08, 2023",SAC vs. POR,W,13,4,4,1.0,0,0,0.0,2,5,0.4,3,3,6,1,1,2,0,1,10,8,1,SAC,SAC,POR,121,,,17,16,11,7
Alex Len,C,22023,203458,22300153,"NOV 06, 2023",SAC @ HOU,L,8,0,1,0.0,0,1,0.0,0,0,0.0,1,2,3,1,0,1,0,0,0,10,1,SAC,HOU,SAC,97,,,4,3,1,4
Alex Len,C,22023,203458,22300137,"NOV 04, 2023",SAC @ HOU,L,3,0,0,0.0,0,0,0.0,0,0,0.0,0,1,1,0,0,0,0,0,0,1,1,SAC,HOU,SAC,89,,,1,1,0,1
Alex Len,C,22023,203458,22300072,"OCT 25, 2023",SAC @ UTA,W,2,0,0,0.0,0,0,0.0,0,0,0.0,0,0,0,0,0,0,0,0,0,-2,1,SAC,UTA,SAC,130,,,0,0,0,0
Reggie Bullock Jr.,G-F,22023,203493,22300754,"FEB 10, 2024",HOU @ ATL,L,15,1,3,0.333,1,3,0.333,0,0,0.0,0,2,2,0,0,0,0,1,3,1,1,HOU,ATL,HOU,113,,,5,5,3,2
Reggie Bullock Jr.,G-F,22023,203493,22300744,"FEB 09, 2024",HOU @ TOR,L,11,2,2,1.0,2,2,1.0,0,0,0.0,0,3,3,0,0,0,0,1,6,7,1,HOU,TOR,HOU,104,,,9,9,6,3
Reggie Bullock Jr.,G-F,22023,203493,22300709,"FEB 04, 2024",HOU @ MIN,L,5,0,0,0.0,0,0,0.0,0,0,0.0,1,2,3,0,0,0,0,0,0,5,1,HOU,MIN,HOU,90,,,3,3,0,3
Reggie Bullock Jr.,G-F,22023,203493,22300692,"FEB 02, 2024",HOU vs. TOR,W,10,1,4,0.25,1,3,0.333,0,0,0.0,0,1,1,1,1,0,0,0,3,3,1,HOU,HOU,TOR,135,,,5,4,4,2
Reggie Bullock Jr.,G-F,22023,203493,22300635,"JAN 26, 2024",HOU @ CHA,W,8,2,3,0.667,1,2,0.5,0,0,0.0,0,0,0,0,1,0,1,0,5,0,1,HOU,CHA,HOU,138,,,5,5,5,0
Reggie Bullock Jr.,G-F,22023,203493,22300542,"JAN 13, 2024",HOU @ BOS,L,8,1,1,1.0,1,1,1.0,0,0,0.0,0,3,3,1,0,1,0,1,3,-8,1,HOU,BOS,HOU,113,,,7,6,4,4
Reggie Bullock Jr.,G-F,22023,203493,22300332,"DEC 15, 2023",HOU @ MEM,W,4,0,1,0.0,0,0,0.0,0,0,0.0,0,0,0,0,0,0,0,0,0,3,1,HOU,MEM,HOU,103,,,0,0,0,0
Reggie Bullock Jr.,G-F,22023,203493,22300314,"DEC 13, 2023",HOU vs. MEM,W,6,2,4,0.5,2,4,0.5,0,0,0.0,0,0,0,0,0,0,0,0,6,6,1,HOU,HOU,MEM,117,,,6,6,6,0
Reggie Bullock Jr.,G-F,22023,203493,22301212,"DEC 06, 2023",HOU vs. OKC,W,6,1,2,0.5,0,1,0.0,1,1,1.0,0,0,0,0,0,0,0,0,3,4,1,HOU,HOU,OKC,110,,,3,3,3,0
Reggie Bullock Jr.,G-F,22023,203493,22300263,"NOV 29, 2023",HOU @ DEN,L,12,2,2,1.0,2,2,1.0,0,0,0.0,1,0,1,0,0,0,0,3,6,-1,1,HOU,DEN,HOU,124,,,7,7,6,1
Reggie Bullock Jr.,G-F,22023,203493,22300231,"NOV 22, 2023",HOU vs. MEM,W,4,0,1,0.0,0,1,0.0,0,0,0.0,0,0,0,0,0,0,0,0,0,-3,1,HOU,HOU,MEM,111,,,0,0,0,0
Reggie Bullock Jr.,G-F,22023,203493,22300224,"NOV 20, 2023",HOU @ GSW,L,8,0,2,0.0,0,2,0.0,0,0,0.0,1,4,5,0,0,0,0,0,0,-2,1,HOU,GSW,HOU,116,,,5,5,0,5
Reggie Bullock Jr.,G-F,22023,203493,22300163,"NOV 08, 2023",HOU vs. LAL,W,12,1,3,0.333,1,2,0.5,0,0,0.0,0,1,1,1,0,0,0,0,3,6,1,HOU,HOU,LAL,128,,,5,4,4,2
Reggie Bullock Jr.,G-F,22023,203493,22300153,"NOV 06, 2023",HOU vs. SAC,W,12,0,1,0.0,0,1,0.0,0,0,0.0,0,1,1,2,0,0,0,1,0,-12,1,HOU,HOU,SAC,122,,,3,1,2,3
Reggie Bullock Jr.,G-F,22023,203493,22300096,"OCT 29, 2023",HOU vs. GSW,L,6,0,2,0.0,0,2,0.0,0,0,0.0,0,1,1,0,0,0,1,1,0,-15,1,HOU,HOU,GSW,95,,,1,1,0,1
Reggie Bullock Jr.,G-F,22023,203493,22300083,"OCT 27, 2023",HOU @ SAS,L,11,0,1,0.0,0,1,0.0,0,0,0.0,0,3,3,0,0,0,1,1,0,3,1,HOU,SAS,HOU,122,,,3,3,0,3
Reggie Bullock Jr.,G-F,22023,203493,22300066,"OCT 25, 2023",HOU @ ORL,L,11,1,1,1.0,1,1,1.0,0,0,0.0,0,1,1,0,1,1,0,1,3,-5,1,HOU,ORL,HOU,86,,,4,4,3,1
Reggie Bullock Jr.,G-F,22023,203493,22300534,"JAN 12, 2024",HOU @ DET,W,21,1,3,0.333,1,3,0.333,0,0,0.0,0,4,4,1,1,0,1,0,3,-1,1,HOU,DET,HOU,112,,,8,7,4,5
Reggie Bullock Jr.,G-F,22023,203493,22300485,"JAN 05, 2024",HOU vs. MIN,L,8,2,4,0.5,1,2,0.5,0,0,0.0,0,1,1,0,0,0,0,1,5,-5,1,HOU,HOU,MIN,95,,,6,6,5,1
Reggie Bullock Jr.,G-F,22023,203493,22300469,"JAN 03, 2024",HOU vs. BKN,W,8,0,2,0.0,0,1,0.0,0,0,0.0,0,1,1,1,0,0,0,0,0,-13,1,HOU,HOU,BKN,112,,,2,1,1,2
Reggie Bullock Jr.,G-F,22023,203493,22300453,"JAN 01, 2024",HOU vs. DET,W,14,3,5,0.6,1,2,0.5,0,0,0.0,0,2,2,2,0,0,1,0,7,-3,1,HOU,HOU,DET,136,,,11,9,9,4
Reggie Bullock Jr.,G-F,22023,203493,22300418,"DEC 27, 2023",HOU vs. PHX,L,7,0,0,0.0,0,0,0.0,0,0,0.0,0,0,0,1,0,0,0,0,0,2,1,HOU,HOU,PHX,113,,,1,0,1,1
Furkan Korkmaz,G-F,22023,1627788,22300727,"FEB 07, 2024",PHI vs. GSW,L,16,0,3,0.0,0,2,0.0,0,0,0.0,3,1,4,0,0,2,1,0,0,-5,1,PHI,PHI,GSW,104,,,4,4,0,4
Furkan Korkmaz,G-F,22023,1627788,22300715,"FEB 05, 2024",PHI vs. DAL,L,6,0,0,0.0,0,0,0.0,0,0,0.0,0,1,1,0,0,0,0,1,0,4,1,PHI,PHI,DAL,102,,,1,1,0,1
Furkan Korkmaz,G-F,22023,1627788,22300698,"FEB 03, 2024",PHI vs. BKN,L,27,3,4,0.75,1,1,1.0,3,4,0.75,0,4,4,1,1,0,0,1,10,-8,1,PHI,PHI,BKN,121,,,15,14,11,5
Furkan Korkmaz,G-F,22023,1627788,22300686,"FEB 01, 2024",PHI @ UTA,W,13,2,7,0.286,1,4,0.25,0,0,0.0,0,2,2,2,0,0,0,1,5,8,1,PHI,UTA,PHI,127,,,9,7,7,4
Furkan Korkmaz,G-F,22023,1627788,22300668,"JAN 29, 2024",PHI @ POR,L,10,0,3,0.0,0,2,0.0,2,2,1.0,0,0,0,1,0,0,1,2,2,-2,1,PHI,POR,PHI,104,,,3,2,3,1
Furkan Korkmaz,G-F,22023,1627788,22300532,"JAN 12, 2024",PHI vs. SAC,W,3,1,3,0.333,1,2,0.5,0,0,0.0,0,0,0,0,1,0,0,0,3,1,1,PHI,PHI,SAC,112,,,3,3,3,0
Furkan Korkmaz,G-F,22023,1627788,22300442,"DEC 30, 2023",PHI @ CHI,L,2,1,1,1.0,0,0,0.0,0,0,0.0,0,0,0,0,0,0,0,0,2,5,1,PHI,CHI,PHI,92,,,2,2,2,0
Furkan Korkmaz,G-F,22023,1627788,22300367,"DEC 20, 2023",PHI vs. MIN,W,2,0,1,0.0,0,0,0.0,0,0,0.0,0,0,0,0,0,0,0,0,0,2,1,PHI,PHI,MIN,127,,,0,0,0,0
Furkan Korkmaz,G-F,22023,1627788,22300335,"DEC 16, 2023",PHI @ CHA,W,4,0,0,0.0,0,0,0.0,0,0,0.0,0,0,0,1,0,0,0,0,0,6,1,PHI,CHA,PHI,135,,,1,0,1,1
Furkan Korkmaz,G-F,22023,1627788,22300327,"DEC 15, 2023",PHI vs. DET,W,7,1,3,0.333,1,3,0.333,0,0,0.0,0,1,1,1,0,0,0,1,3,-6,1,PHI,PHI,DET,124,,,5,4,4,2
Furkan Korkmaz,G-F,22023,1627788,22300310,"DEC 13, 2023",PHI @ DET,W,5,0,1,0.0,0,1,0.0,0,0,0.0,0,0,0,0,0,0,0,0,0,-6,1,PHI,DET,PHI,129,,,0,0,0,0
Furkan Korkmaz,G-F,22023,1627788,22300295,"DEC 11, 2023",PHI vs. WAS,W,9,0,0,0.0,0,0,0.0,2,2,1.0,0,0,0,2,1,0,1,1,2,4,1,PHI,PHI,WAS,146,,,4,2,4,2
Furkan Korkmaz,G-F,22023,1627788,22300275,"DEC 01, 2023",PHI @ BOS,L,15,0,4,0.0,0,3,0.0,0,0,0.0,0,1,1,0,1,0,0,3,0,4,1,PHI,BOS,PHI,119,,,1,1,0,1
Furkan Korkmaz,G-F,22023,1627788,22300262,"NOV 29, 2023",PHI @ NOP,L,2,0,0,0.0,0,0,0.0,0,0,0.0,0,0,0,0,0,0,0,0,0,6,1,PHI,NOP,PHI,114,,,0,0,0,0
Furkan Korkmaz,G-F,22023,1627788,22300255,"NOV 27, 2023",PHI vs. LAL,W,5,2,4,0.5,0,1,0.0,1,1,1.0,0,0,0,3,2,0,0,0,5,13,1,PHI,PHI,LAL,138,,,8,5,8,3
Furkan Korkmaz,G-F,22023,1627788,22300232,"NOV 22, 2023",PHI @ MIN,L,6,1,2,0.5,1,2,0.5,0,0,0.0,0,1,1,0,1,0,0,0,3,8,1,PHI,MIN,PHI,99,,,4,4,3,1
Furkan Korkmaz,G-F,22023,1627788,22300208,"NOV 19, 2023",PHI @ BKN,W,4,1,3,0.333,0,2,0.0,1,1,1.0,0,0,0,0,0,0,0,1,3,-1,1,PHI,BKN,PHI,121,,,3,3,3,0
Furkan Korkmaz,G-F,22023,1627788,22300148,"NOV 06, 2023",PHI vs. WAS,W,14,0,2,0.0,0,2,0.0,1,2,0.5,1,2,3,2,0,0,1,1,1,6,1,PHI,PHI,WAS,146,,,6,4,3,5
Furkan Korkmaz,G-F,22023,1627788,22300132,"NOV 04, 2023",PHI vs. PHX,W,18,2,2,1.0,1,1,1.0,0,0,0.0,0,2,2,1,1,0,1,2,5,-3,1,PHI,PHI,PHX,112,,,8,7,6,3
Furkan Korkmaz,G-F,22023,1627788,22300128,"NOV 02, 2023",PHI vs. TOR,W,22,4,7,0.571,1,2,0.5,1,1,1.0,0,1,1,0,3,0,1,0,10,16,1,PHI,PHI,TOR,114,,,11,11,10,1
Furkan Korkmaz,G-F,22023,1627788,22300098,"OCT 29, 2023",PHI vs. POR,W,3,1,1,1.0,1,1,1.0,1,2,0.5,0,0,0,0,0,0,0,0,4,3,1,PHI,PHI,POR,126,,,4,4,4,0
Furkan Korkmaz,G-F,22023,1627788,22300644,"JAN 27, 2024",PHI @ DEN,L,9,1,2,0.5,1,2,0.5,0,0,0.0,0,1,1,3,1,0,0,0,3,8,1,PHI,DEN,PHI,105,,,7,4,6,4
Furkan Korkmaz,G-F,22023,1627788,22300627,"JAN 25, 2024",PHI @ IND,L,13,1,2,0.5,0,1,0.0,0,1,0.0,0,1,1,2,1,0,0,0,2,12,1,PHI,IND,PHI,122,,,5,3,4,3
Furkan Korkmaz,G-F,22023,1627788,22300608,"JAN 22, 2024",PHI vs. SAS,W,13,0,3,0.0,0,1,0.0,0,0,0.0,0,1,1,1,0,1,0,1,0,13,1,PHI,PHI,SAS,133,,,2,1,1,2
Furkan Korkmaz,G-F,22023,1627788,22300593,"JAN 20, 2024",PHI @ CHA,W,16,1,2,0.5,0,0,0.0,0,0,0.0,0,4,4,1,0,0,1,1,2,-4,1,PHI,CHA,PHI,97,,,7,6,3,5
Furkan Korkmaz,G-F,22023,1627788,22300585,"JAN 19, 2024",PHI @ ORL,W,2,0,0,0.0,0,0,0.0,0,0,0.0,0,0,0,1,0,0,0,0,0,2,1,PHI,ORL,PHI,124,,,1,0,1,1
Furkan Korkmaz,G-F,22023,1627788,22300566,"JAN 16, 2024",PHI vs. DEN,W,4,0,0,0.0,0,0,0.0,0,0,0.0,0,0,0,0,0,0,0,0,0,-7,1,PHI,PHI,DEN,126,,,0,0,0,0
Furkan Korkmaz,G-F,22023,1627788,22300555,"JAN 15, 2024",PHI vs. HOU,W,6,1,2,0.5,0,0,0.0,0,1,0.0,0,0,0,0,0,0,0,0,2,-10,1,PHI,PHI,HOU,124,,,2,2,2,0
Furkan Korkmaz,G-F,22023,1627788,22300180,"NOV 12, 2023",PHI vs. IND,W,5,0,1,0.0,0,0,0.0,0,0,0.0,0,0,0,0,1,0,1,0,0,-2,1,PHI,PHI,IND,137,,,0,0,0,0
Furkan Korkmaz,G-F,22023,1627788,22300008,"NOV 10, 2023",PHI @ DET,W,2,0,1,0.0,0,0,0.0,0,0,0.0,0,0,0,0,0,0,0,0,0,-9,1,PHI,DET,PHI,114,,,0,0,0,0
Furkan Korkmaz,G-F,22023,1627788,22300159,"NOV 08, 2023",PHI vs. BOS,W,3,0,2,0.0,0,0,0.0,0,0,0.0,0,0,0,0,0,0,1,0,0,-4,1,PHI,PHI,BOS,106,,,0,0,0,0
Furkan Korkmaz,G-F,22023,1627788,22300673,"JAN 30, 2024",PHI @ GSW,L,22,6,8,0.75,5,6,0.833,2,3,0.667,0,2,2,3,0,0,0,1,19,5,1,PHI,GSW,PHI,107,,,24,21,22,5
Furkan Korkmaz,G-F,22023,1627788,22300194,"NOV 15, 2023",PHI vs. BOS,L,3,0,1,0.0,0,1,0.0,0,0,0.0,0,0,0,0,0,0,0,0,0,-8,1,PHI,PHI,BOS,107,,,0,0,0,0
Furkan Korkmaz,G-F,22023,1627788,22300019,"NOV 14, 2023",PHI vs. IND,L,2,0,0,0.0,0,0,0.0,0,0,0.0,0,0,0,0,0,0,1,0,0,2,1,PHI,PHI,IND,126,,,0,0,0,0
Furkan Korkmaz,G-F,22023,1627788,22300382,"DEC 22, 2023",PHI vs. TOR,W,7,1,1,1.0,0,0,0.0,0,0,0.0,0,1,1,0,0,0,0,0,2,-7,1,PHI,PHI,TOR,121,,,3,3,2,1
Jock Landale,C,22023,1629111,22300754,"FEB 10, 2024",HOU @ ATL,L,13,0,3,0.0,0,1,0.0,2,2,1.0,3,6,9,2,0,0,2,1,2,5,1,HOU,ATL,HOU,113,,,13,11,4,11
Jock Landale,C,22023,1629111,22300709,"FEB 04, 2024",HOU @ MIN,L,7,2,4,0.5,0,0,0.0,0,0,0.0,0,0,0,0,0,1,0,0,4,-1,1,HOU,MIN,HOU,90,,,4,4,4,0
Jock Landale,C,22023,1629111,22300645,"JAN 27, 2024",HOU @ BKN,L,6,0,2,0.0,0,0,0.0,0,0,0.0,2,0,2,1,0,0,1,2,0,-5,1,HOU,BKN,HOU,104,,,3,2,1,3
Jock Landale,C,22023,1629111,22300635,"JAN 26, 2024",HOU @ CHA,W,15,3,5,0.6,0,0,0.0,0,0,0.0,4,2,6,2,1,1,0,2,6,16,1,HOU,CHA,HOU,138,,,14,12,8,8
Jock Landale,C,22023,1629111,22300623,"JAN 24, 2024",HOU vs. POR,L,13,2,2,1.0,0,0,0.0,2,3,0.667,3,0,3,2,0,0,0,2,6,8,1,HOU,HOU,POR,131,,,11,9,8,5
Jock Landale,C,22023,1629111,22300603,"JAN 21, 2024",HOU vs. BOS,L,11,1,2,0.5,0,0,0.0,1,2,0.5,2,1,3,0,0,0,1,0,3,6,1,HOU,HOU,BOS,107,,,6,6,3,3
Jock Landale,C,22023,1629111,22300555,"JAN 15, 2024",HOU @ PHI,L,9,2,2,1.0,0,0,0.0,0,0,0.0,1,0,1,0,1,3,0,0,4,17,1,HOU,PHI,HOU,115,,,5,5,4,1
Jock Landale,C,22023,1629111,22300542,"JAN 13, 2024",HOU @ BOS,L,12,1,6,0.167,0,3,0.0,0,0,0.0,3,0,3,1,0,0,0,0,2,-6,1,HOU,BOS,HOU,113,,,6,5,3,4
Jock Landale,C,22023,1629111,22300385,"DEC 22, 2023",HOU vs. DAL,W,16,1,5,0.2,0,3,0.0,1,2,0.5,3,1,4,2,0,1,0,1,3,-9,1,HOU,HOU,DAL,122,,,9,7,5,6
Jock Landale,C,22023,1629111,22300349,"DEC 18, 2023",HOU @ CLE,L,4,0,0,0.0,0,0,0.0,0,0,0.0,0,1,1,0,1,0,0,1,0,-4,1,HOU,CLE,HOU,130,,,1,1,0,1
Jock Landale,C,22023,1629111,22300332,"DEC 15, 2023",HOU @ MEM,W,8,0,0,0.0,0,0,0.0,0,0,0.0,1,0,1,0,0,0,0,1,0,4,1,HOU,MEM,HOU,103,,,1,1,0,1
Jock Landale,C,22023,1629111,22300314,"DEC 13, 2023",HOU vs. MEM,W,10,1,2,0.5,0,0,0.0,0,0,0.0,2,1,3,0,0,0,0,2,2,13,1,HOU,HOU,MEM,117,,,5,5,2,3
Jock Landale,C,22023,1629111,22300291,"DEC 02, 2023",HOU @ LAL,L,3,0,0,0.0,0,0,0.0,0,0,0.0,0,0,0,0,0,1,0,0,0,8,1,HOU,LAL,HOU,97,,,0,0,0,0
Jock Landale,C,22023,1629111,22300263,"NOV 29, 2023",HOU @ DEN,L,14,2,4,0.5,0,1,0.0,2,2,1.0,0,1,1,0,1,0,1,2,6,4,1,HOU,DEN,HOU,124,,,7,7,6,1
Jock Landale,C,22023,1629111,22300231,"NOV 22, 2023",HOU vs. MEM,W,4,1,1,1.0,0,0,0.0,0,0,0.0,0,1,1,0,0,0,0,0,2,-3,1,HOU,HOU,MEM,111,,,3,3,2,1
Jock Landale,C,22023,1629111,22300224,"NOV 20, 2023",HOU @ GSW,L,4,0,1,0.0,0,0,0.0,0,0,0.0,0,1,1,0,0,0,0,0,0,-7,1,HOU,GSW,HOU,116,,,1,1,0,1
Jock Landale,C,22023,1629111,22300216,"NOV 19, 2023",HOU @ LAL,L,4,0,0,0.0,0,0,0.0,0,0,0.0,1,0,1,1,0,0,1,1,0,-6,1,HOU,LAL,HOU,104,,,2,1,1,2
Jock Landale,C,22023,1629111,22300037,"NOV 17, 2023",HOU @ LAC,L,7,1,2,0.5,0,0,0.0,0,0,0.0,0,3,3,0,0,0,1,0,2,15,1,HOU,LAC,HOU,100,,,5,5,2,3
Jock Landale,C,22023,1629111,22300182,"NOV 12, 2023",HOU vs. DEN,W,2,0,0,0.0,0,0,0.0,0,0,0.0,1,0,1,0,0,0,0,1,0,-4,1,HOU,HOU,DEN,107,,,1,1,0,1
Jock Landale,C,22023,1629111,22300011,"NOV 10, 2023",HOU vs. NOP,W,7,0,2,0.0,0,0,0.0,0,0,0.0,1,2,3,0,0,0,0,0,0,3,1,HOU,HOU,NOP,104,,,3,3,0,3
Jock Landale,C,22023,1629111,22300163,"NOV 08, 2023",HOU vs. LAL,W,12,1,3,0.333,0,1,0.0,0,0,0.0,1,2,3,0,0,1,1,0,2,6,1,HOU,HOU,LAL,128,,,5,5,2,3
Jock Landale,C,22023,1629111,22300153,"NOV 06, 2023",HOU vs. SAC,W,16,2,3,0.667,1,2,0.5,0,0,0.0,1,0,1,1,1,0,2,2,5,6,1,HOU,HOU,SAC,122,,,7,6,6,2
Jock Landale,C,22023,1629111,22300137,"NOV 04, 2023",HOU vs. SAC,W,12,0,1,0.0,0,1,0.0,0,0,0.0,1,2,3,3,1,0,0,1,0,-6,1,HOU,HOU,SAC,107,,,6,3,3,6
Jock Landale,C,22023,1629111,22300122,"NOV 01, 2023",HOU vs. CHA,W,19,1,7,0.143,0,3,0.0,2,2,1.0,3,2,5,1,1,1,1,1,4,2,1,HOU,HOU,CHA,128,,,10,9,5,6
Jock Landale,C,22023,1629111,22300066,"OCT 25, 2023",HOU @ ORL,L,9,1,2,0.5,1,2,0.5,0,0,0.0,0,0,0,2,0,0,1,1,3,-7,1,HOU,ORL,HOU,86,,,5,3,5,2
Jock Landale,C,22023,1629111,22300485,"JAN 05, 2024",HOU vs. MIN,L,5,0,1,0.0,0,1,0.0,0,0,0.0,0,0,0,0,0,1,0,0,0,-4,1,HOU,HOU,MIN,95,,,0,0,0,0
Jock Landale,C,22023,1629111,22300453,"JAN 01, 2024",HOU vs. DET,W,7,0,0,0.0,0,0,0.0,0,0,0.0,0,0,0,0,0,0,0,0,0,-5,1,HOU,HOU,DET,136,,,0,0,0,0
Jock Landale,C,22023,1629111,22300418,"DEC 27, 2023",HOU vs. PHX,L,12,2,4,0.5,0,0,0.0,1,2,0.5,3,2,5,0,0,0,0,2,5,4,1,HOU,HOU,PHX,113,,,10,10,5,5
Jock Landale,C,22023,1629111,22300434,"DEC 29, 2023",HOU vs. PHI,L,8,2,5,0.4,0,0,0.0,2,2,1.0,1,0,1,0,0,1,0,4,6,-6,1,HOU,HOU,PHI,127,,,7,7,6,1
KJ Martin,F,22023,1630231,22300742,"FEB 09, 2024",PHI vs. ATL,L,19,2,4,0.5,0,1,0.0,1,2,0.5,1,5,6,0,1,0,1,4,5,-10,1,PHI,PHI,ATL,121,,,11,11,5,6
KJ Martin,F,22023,1630231,22300727,"FEB 07, 2024",PHI vs. GSW,L,29,6,10,0.6,2,3,0.667,1,1,1.0,1,4,5,2,1,0,1,1,15,-9,1,PHI,PHI,GSW,104,,,22,20,17,7
KJ Martin,F,22023,1630231,22300715,"FEB 05, 2024",PHI vs. DAL,L,6,2,3,0.667,0,1,0.0,1,2,0.5,0,1,1,0,0,1,1,0,5,4,1,PHI,PHI,DAL,102,,,6,6,5,1
KJ Martin,F,22023,1630231,22300698,"FEB 03, 2024",PHI vs. BKN,L,21,5,9,0.556,1,2,0.5,0,0,0.0,0,4,4,4,0,0,0,1,11,1,1,PHI,PHI,BKN,121,,,19,15,15,8
KJ Martin,F,22023,1630231,22300686,"FEB 01, 2024",PHI @ UTA,W,5,0,1,0.0,0,0,0.0,0,0,0.0,1,0,1,1,0,0,0,0,0,-3,1,PHI,UTA,PHI,127,,,2,1,1,2
KJ Martin,F,22023,1630231,22300668,"JAN 29, 2024",PHI @ POR,L,18,2,4,0.5,0,0,0.0,2,2,1.0,0,1,1,1,0,0,2,5,6,-13,1,PHI,POR,PHI,104,,,8,7,7,2
KJ Martin,F,22023,1630231,22300532,"JAN 12, 2024",PHI vs. SAC,W,3,1,1,1.0,0,0,0.0,0,0,0.0,0,0,0,0,0,0,0,0,2,1,1,PHI,PHI,SAC,112,,,2,2,2,0
KJ Martin,F,22023,1630231,22300521,"JAN 10, 2024",PHI @ ATL,L,6,0,0,0.0,0,0,0.0,0,0,0.0,0,0,0,0,0,0,1,1,0,2,1,PHI,ATL,PHI,132,,,0,0,0,0
KJ Martin,F,22023,1630231,22300495,"JAN 06, 2024",PHI vs. UTA,L,17,4,7,0.571,0,1,0.0,1,2,0.5,1,1,2,1,1,0,0,4,9,-1,1,PHI,PHI,UTA,109,,,12,11,10,3
KJ Martin,F,22023,1630231,22300483,"JAN 05, 2024",PHI vs. NYK,L,7,0,0,0.0,0,0,0.0,0,0,0.0,0,0,0,0,0,0,0,2,0,-12,1,PHI,PHI,NYK,92,,,0,0,0,0
KJ Martin,F,22023,1630231,22300459,"JAN 02, 2024",PHI vs. CHI,W,9,0,3,0.0,0,0,0.0,0,0,0.0,0,0,0,1,0,0,0,0,0,-17,1,PHI,PHI,CHI,110,,,1,0,1,1
KJ Martin,F,22023,1630231,22300442,"DEC 30, 2023",PHI @ CHI,L,8,1,2,0.5,0,1,0.0,0,0,0.0,0,1,1,0,0,0,0,0,2,4,1,PHI,CHI,PHI,92,,,3,3,2,1
KJ Martin,F,22023,1630231,22300415,"DEC 27, 2023",PHI @ ORL,W,1,0,0,0.0,0,0,0.0,0,0,0.0,0,0,0,0,0,0,0,0,0,-3,1,PHI,ORL,PHI,112,,,0,0,0,0
KJ Martin,F,22023,1630231,22300404,"DEC 25, 2023",PHI @ MIA,L,6,1,1,1.0,0,0,0.0,0,0,0.0,0,0,0,1,1,0,0,0,2,-7,1,PHI,MIA,PHI,113,,,3,2,3,1
KJ Martin,F,22023,1630231,22300367,"DEC 20, 2023",PHI vs. MIN,W,7,1,1,1.0,0,0,0.0,1,2,0.5,0,0,0,0,0,0,0,1,3,11,1,PHI,PHI,MIN,127,,,3,3,3,0
KJ Martin,F,22023,1630231,22300335,"DEC 16, 2023",PHI @ CHA,W,4,0,0,0.0,0,0,0.0,0,0,0.0,0,0,0,2,2,0,0,1,0,6,1,PHI,CHA,PHI,135,,,2,0,2,2
KJ Martin,F,22023,1630231,22300327,"DEC 15, 2023",PHI vs. DET,W,7,2,3,0.667,0,0,0.0,0,0,0.0,1,0,1,1,0,0,0,0,4,-6,1,PHI,PHI,DET,124,,,6,5,5,2
KJ Martin,F,22023,1630231,22300310,"DEC 13, 2023",PHI @ DET,W,4,1,1,1.0,0,0,0.0,0,0,0.0,1,1,2,1,1,0,0,0,2,-6,1,PHI,DET,PHI,129,,,5,4,3,3
KJ Martin,F,22023,1630231,22300295,"DEC 11, 2023",PHI vs. WAS,W,6,1,1,1.0,0,0,0.0,0,0,0.0,0,1,1,1,0,0,0,1,2,3,1,PHI,PHI,WAS,146,,,4,3,3,2
KJ Martin,F,22023,1630231,22300275,"DEC 01, 2023",PHI @ BOS,L,13,1,5,0.2,0,0,0.0,0,0,0.0,0,2,2,0,2,0,0,1,2,0,1,PHI,BOS,PHI,119,,,4,4,2,2
KJ Martin,F,22023,1630231,22300262,"NOV 29, 2023",PHI @ NOP,L,17,2,4,0.5,0,1,0.0,0,0,0.0,0,2,2,2,0,0,2,4,4,4,1,PHI,NOP,PHI,114,,,8,6,6,4
KJ Martin,F,22023,1630231,22300255,"NOV 27, 2023",PHI vs. LAL,W,5,0,0,0.0,0,0,0.0,1,2,0.5,1,1,2,0,0,0,0,1,1,13,1,PHI,PHI,LAL,138,,,3,3,1,2
KJ Martin,F,22023,1630231,22300232,"NOV 22, 2023",PHI @ MIN,L,6,1,2,0.5,0,0,0.0,1,2,0.5,0,1,1,0,1,0,0,2,3,8,1,PHI,MIN,PHI,99,,,4,4,3,1
KJ Martin,F,22023,1630231,22300208,"NOV 19, 2023",PHI @ BKN,W,4,0,0,0.0,0,0,0.0,0,0,0.0,1,0,1,0,0,0,0,1,0,-1,1,PHI,BKN,PHI,121,,,1,1,0,1
KJ Martin,F,22023,1630231,22300148,"NOV 06, 2023",PHI vs. WAS,W,4,0,1,0.0,0,0,0.0,0,0,0.0,0,1,1,1,0,0,0,0,0,-6,1,PHI,PHI,WAS,146,,,2,1,1,2
KJ Martin,F,22023,1630231,22300132,"NOV 04, 2023",PHI vs. PHX,W,2,0,0,0.0,0,0,0.0,0,0,0.0,0,0,0,0,0,0,1,1,0,-5,1,PHI,PHI,PHX,112,,,0,0,0,0
KJ Martin,F,22023,1630231,22300128,"NOV 02, 2023",PHI vs. TOR,W,1,0,0,0.0,0,0,0.0,0,0,0.0,0,0,0,0,0,0,0,1,0,-2,1,PHI,PHI,TOR,114,,,0,0,0,0
KJ Martin,F,22023,1630231,22300644,"JAN 27, 2024",PHI @ DEN,L,19,3,5,0.6,0,1,0.0,1,2,0.5,0,4,4,1,0,0,2,4,7,8,1,PHI,DEN,PHI,105,,,12,11,8,5
KJ Martin,F,22023,1630231,22300627,"JAN 25, 2024",PHI @ IND,L,31,4,6,0.667,0,1,0.0,3,6,0.5,1,2,3,2,2,0,2,4,11,4,1,PHI,IND,PHI,122,,,16,14,13,5
KJ Martin,F,22023,1630231,22300608,"JAN 22, 2024",PHI vs. SAS,W,17,2,5,0.4,0,0,0.0,0,0,0.0,0,2,2,1,0,0,0,2,4,9,1,PHI,PHI,SAS,133,,,7,6,5,3
KJ Martin,F,22023,1630231,22300585,"JAN 19, 2024",PHI @ ORL,W,2,1,1,1.0,0,0,0.0,0,0,0.0,0,0,0,0,0,0,0,1,2,2,1,PHI,ORL,PHI,124,,,2,2,2,0
KJ Martin,F,22023,1630231,22300555,"JAN 15, 2024",PHI vs. HOU,W,6,0,1,0.0,0,0,0.0,0,0,0.0,0,1,1,0,0,0,0,1,0,-10,1,PHI,PHI,HOU,124,,,1,1,0,1
KJ Martin,F,22023,1630231,22300099,"OCT 29, 2023",LAC vs. SAS,W,18,4,6,0.667,1,3,0.333,1,2,0.5,0,2,2,0,1,1,2,1,10,13,1,LAC,LAC,SAS,123,,,12,12,10,2
KJ Martin,F,22023,1630231,22300074,"OCT 25, 2023",LAC vs. POR,W,14,0,4,0.0,0,2,0.0,0,0,0.0,1,0,1,1,1,0,0,2,0,-17,1,LAC,LAC,POR,123,,,2,1,1,2
KJ Martin,F,22023,1630231,22300673,"JAN 30, 2024",PHI @ GSW,L,26,1,2,0.5,0,1,0.0,0,3,0.0,0,2,2,0,1,1,2,3,2,16,1,PHI,GSW,PHI,107,,,4,4,2,2
KJ Martin,F,22023,1630231,22300019,"NOV 14, 2023",PHI vs. IND,L,1,0,0,0.0,0,0,0.0,0,0,0.0,0,0,0,0,0,0,0,0,0,0,1,PHI,PHI,IND,126,,,0,0,0,0
KJ Martin,F,22023,1630231,22300753,"FEB 10, 2024",PHI @ WAS,W,23,2,3,0.667,0,0,0.0,0,0,0.0,1,1,2,0,0,1,0,3,4,18,1,PHI,WAS,PHI,119,,,6,6,4,2
KJ Martin,F,22023,1630231,22300382,"DEC 22, 2023",PHI vs. TOR,W,1,0,0,0.0,0,0,0.0,0,0,0.0,0,0,0,0,0,0,0,0,0,-3,1,PHI,PHI,TOR,121,,,0,0,0,0
Anthony Gill,F,22023,1630264,22300705,"FEB 04, 2024",WAS vs. PHX,L,7,0,1,0.0,0,0,0.0,0,0,0.0,0,1,1,0,2,0,3,0,0,3,1,WAS,WAS,PHX,109,,,1,1,0,1
Anthony Gill,F,22023,1630264,22300689,"FEB 02, 2024",WAS vs. MIA,L,0,0,0,0.0,0,0,0.0,0,0,0.0,0,0,0,0,0,0,0,0,0,-3,1,WAS,WAS,MIA,102,,,0,0,0,0
Anthony Gill,F,22023,1630264,22300676,"JAN 31, 2024",WAS vs. LAC,L,8,1,1,1.0,1,1,1.0,0,0,0.0,0,2,2,0,1,0,1,0,3,10,1,WAS,WAS,LAC,107,,,5,5,3,2
Anthony Gill,F,22023,1630264,22300628,"JAN 25, 2024",WAS vs. UTA,L,1,0,0,0.0,0,0,0.0,0,0,0.0,0,0,0,0,0,0,0,0,0,0,1,WAS,WAS,UTA,108,,,0,0,0,0
Anthony Gill,F,22023,1630264,22300620,"JAN 24, 2024",WAS vs. MIN,L,1,0,0,0.0,0,0,0.0,0,0,0.0,0,0,0,1,0,0,0,0,0,3,1,WAS,WAS,MIN,107,,,1,0,1,1
Anthony Gill,F,22023,1630264,22300558,"JAN 15, 2024",WAS vs. DET,L,3,1,2,0.5,1,1,1.0,0,0,0.0,1,0,1,0,0,0,1,0,3,1,1,WAS,WAS,DET,117,,,4,4,3,1
Anthony Gill,F,22023,1630264,22300494,"JAN 06, 2024",WAS vs. NYK,L,3,1,1,1.0,1,1,1.0,0,0,0.0,0,2,2,0,0,0,0,0,3,5,1,WAS,WAS,NYK,105,,,5,5,3,2
Anthony Gill,F,22023,1630264,22300482,"JAN 05, 2024",WAS @ CLE,L,5,0,3,0.0,0,1,0.0,1,2,0.5,1,0,1,0,0,0,0,1,1,-1,1,WAS,CLE,WAS,90,,,2,2,1,1
Anthony Gill,F,22023,1630264,22300465,"JAN 03, 2024",WAS @ CLE,L,5,1,1,1.0,0,0,0.0,0,0,0.0,0,1,1,0,0,0,0,0,2,4,1,WAS,CLE,WAS,101,,,3,3,2,1
Anthony Gill,F,22023,1630264,22300416,"DEC 27, 2023",WAS vs. TOR,L,5,0,0,0.0,0,0,0.0,0,0,0.0,0,0,0,0,0,1,0,0,0,-3,1,WAS,WAS,TOR,102,,,0,0,0,0
Anthony Gill,F,22023,1630264,22300386,"DEC 22, 2023",WAS @ GSW,L,11,4,5,0.8,0,1,0.0,0,0,0.0,2,1,3,0,0,1,0,0,8,10,1,WAS,GSW,WAS,118,,,11,11,8,3
Anthony Gill,F,22023,1630264,22300381,"DEC 21, 2023",WAS @ POR,W,0,0,0,0.0,0,0,0.0,0,0,0.0,0,0,0,0,0,0,0,0,0,-2,1,WAS,POR,WAS,118,,,0,0,0,0
Anthony Gill,F,22023,1630264,22300358,"DEC 18, 2023",WAS @ SAC,L,20,2,5,0.4,0,2,0.0,0,0,0.0,1,3,4,3,0,0,1,1,4,9,1,WAS,SAC,WAS,131,,,11,8,7,7
Anthony Gill,F,22023,1630264,22300347,"DEC 17, 2023",WAS @ PHX,L,0,0,0,0.0,0,0,0.0,0,0,0.0,0,0,0,0,0,0,0,0,0,0,1,WAS,PHX,WAS,108,,,0,0,0,0
Anthony Gill,F,22023,1630264,22300328,"DEC 15, 2023",WAS vs. IND,W,3,0,0,0.0,0,0,0.0,0,0,0.0,0,0,0,0,0,0,0,0,0,-8,1,WAS,WAS,IND,137,,,0,0,0,0
Anthony Gill,F,22023,1630264,22300311,"DEC 13, 2023",WAS vs. NOP,L,10,1,2,0.5,0,1,0.0,0,0,0.0,0,2,2,2,0,0,0,2,2,-4,1,WAS,WAS,NOP,122,,,6,4,4,4
Anthony Gill,F,22023,1630264,22300295,"DEC 11, 2023",WAS @ PHI,L,10,1,2,0.5,0,0,0.0,1,2,0.5,1,3,4,0,0,1,2,2,3,2,1,WAS,PHI,WAS,99,,,7,7,3,4
Anthony Gill,F,22023,1630264,22301219,"DEC 08, 2023",WAS @ BKN,L,4,1,4,0.25,0,1,0.0,0,0,0.0,3,0,3,0,0,0,0,1,2,-2,1,WAS,BKN,WAS,97,,,5,5,2,3
Anthony Gill,F,22023,1630264,22300259,"NOV 29, 2023",WAS @ ORL,L,5,0,1,0.0,0,1,0.0,0,0,0.0,0,1,1,0,0,0,0,0,0,3,1,WAS,ORL,WAS,120,,,1,1,0,1
Anthony Gill,F,22023,1630264,22300253,"NOV 27, 2023",WAS @ DET,W,2,0,0,0.0,0,0,0.0,0,0,0.0,0,0,0,0,0,0,0,0,0,0,1,WAS,DET,WAS,126,,,0,0,0,0
Anthony Gill,F,22023,1630264,22300241,"NOV 25, 2023",WAS vs. ATL,L,18,4,6,0.667,0,1,0.0,2,2,1.0,1,2,3,1,0,0,2,1,10,-8,1,WAS,WAS,ATL,108,,,14,13,11,4
Anthony Gill,F,22023,1630264,22300219,"NOV 20, 2023",WAS vs. MIL,L,1,0,0,0.0,0,0,0.0,0,0,0.0,0,0,0,0,1,0,0,0,0,2,1,WAS,WAS,MIL,129,,,0,0,0,0
Anthony Gill,F,22023,1630264,22300028,"NOV 17, 2023",WAS vs. NYK,L,2,0,0,0.0,0,0,0.0,2,2,1.0,0,1,1,1,0,0,0,0,2,-1,1,WAS,WAS,NYK,99,,,4,3,3,2
Anthony Gill,F,22023,1630264,22300192,"NOV 15, 2023",WAS vs. DAL,L,5,0,0,0.0,0,0,0.0,0,0,0.0,0,1,1,0,1,0,3,1,0,9,1,WAS,WAS,DAL,117,,,1,1,0,1
Anthony Gill,F,22023,1630264,22300157,"NOV 08, 2023",WAS @ CHA,W,4,0,3,0.0,0,0,0.0,0,0,0.0,1,0,1,0,0,0,0,0,0,-4,1,WAS,CHA,WAS,132,,,1,1,0,1
Anthony Gill,F,22023,1630264,22300148,"NOV 06, 2023",WAS @ PHI,L,8,2,3,0.667,0,1,0.0,1,2,0.5,1,0,1,0,1,2,0,0,5,6,1,WAS,PHI,WAS,128,,,6,6,5,1
Anthony Gill,F,22023,1630264,22300003,"NOV 03, 2023",WAS @ MIA,L,7,2,3,0.667,0,0,0.0,2,2,1.0,1,1,2,0,0,1,1,1,6,18,1,WAS,MIA,WAS,114,,,8,8,6,2
Anthony Gill,F,22023,1630264,22300117,"NOV 01, 2023",WAS @ ATL,L,7,1,1,1.0,0,0,0.0,0,0,0.0,0,1,1,2,0,0,1,0,2,17,1,WAS,ATL,WAS,121,,,5,3,4,3
Anthony Gill,F,22023,1630264,22300103,"OCT 30, 2023",WAS vs. BOS,L,10,1,3,0.333,0,0,0.0,3,4,0.75,0,2,2,1,0,0,0,2,5,9,1,WAS,WAS,BOS,107,,,8,7,6,3
Luka Garza,C,22023,1630568,22300738,"FEB 08, 2024",MIN @ MIL,W,3,0,0,0.0,0,0,0.0,0,0,0.0,0,1,1,0,0,0,0,0,0,3,1,MIN,MIL,MIN,129,,,1,1,0,1
Luka Garza,C,22023,1630568,22300709,"FEB 04, 2024",MIN vs. HOU,W,4,2,2,1.0,1,1,1.0,0,0,0.0,0,0,0,0,0,0,0,1,5,-7,1,MIN,MIN,HOU,111,,,5,5,5,0
Luka Garza,C,22023,1630568,22300680,"JAN 31, 2024",MIN vs. DAL,W,5,3,5,0.6,1,1,1.0,1,2,0.5,1,0,1,0,0,0,0,1,8,8,1,MIN,MIN,DAL,121,,,9,9,8,1
Luka Garza,C,22023,1630568,22300620,"JAN 24, 2024",MIN @ WAS,W,1,0,0,0.0,0,0,0.0,0,0,0.0,0,0,0,0,0,0,0,0,0,-3,1,MIN,WAS,MIN,118,,,0,0,0,0
Luka Garza,C,22023,1630568,22300582,"JAN 18, 2024",MIN vs. MEM,W,1,0,0,0.0,0,0,0.0,0,0,0.0,0,0,0,0,0,0,0,0,0,0,1,MIN,MIN,MEM,118,,,0,0,0,0
Luka Garza,C,22023,1630568,22300485,"JAN 05, 2024",MIN @ HOU,W,3,1,4,0.25,0,2,0.0,0,0,0.0,1,0,1,0,0,0,1,1,2,0,1,MIN,HOU,MIN,122,,,3,3,2,1
Luka Garza,C,22023,1630568,22300367,"DEC 20, 2023",MIN @ PHI,L,2,0,1,0.0,0,1,0.0,0,0,0.0,0,1,1,1,0,0,0,2,0,0,1,MIN,PHI,MIN,113,,,2,1,1,2
Luka Garza,C,22023,1630568,22301221,"DEC 08, 2023",MIN @ MEM,W,3,0,1,0.0,0,0,0.0,0,0,0.0,0,0,0,1,0,0,0,1,0,1,1,MIN,MEM,MIN,127,,,1,0,1,1
Luka Garza,C,22023,1630568,22300232,"NOV 22, 2023",MIN vs. PHI,W,2,0,1,0.0,0,1,0.0,1,2,0.5,0,1,1,0,0,0,1,0,1,-1,1,MIN,MIN,PHI,112,,,2,2,1,1
Luka Garza,C,22023,1630568,22300197,"NOV 15, 2023",MIN @ PHX,L,5,1,4,0.25,0,1,0.0,3,4,0.75,2,0,2,0,0,0,0,0,5,5,1,MIN,PHX,MIN,115,,,7,7,5,2
Luka Garza,C,22023,1630568,22300166,"NOV 08, 2023",MIN vs. NOP,W,5,2,4,0.5,0,0,0.0,1,2,0.5,1,1,2,0,0,0,0,3,5,-6,1,MIN,MIN,NOP,122,,,7,7,5,2
Luka Garza,C,22023,1630568,22300104,"OCT 30, 2023",MIN @ ATL,L,1,1,1,1.0,0,0,0.0,0,0,0.0,0,1,1,0,0,0,0,0,2,4,1,MIN,ATL,MIN,113,,,3,3,2,1
Johnny Davis,G,22023,1631098,22300705,"FEB 04, 2024",WAS vs. PHX,L,18,1,7,0.143,1,3,0.333,0,0,0.0,0,0,0,1,1,0,1,1,3,-8,1,WAS,WAS,PHX,109,,,4,3,4,1
Johnny Davis,G,22023,1631098,22300689,"FEB 02, 2024",WAS vs. MIA,L,2,1,1,1.0,0,0,0.0,0,0,0.0,0,0,0,0,0,0,0,0,2,1,1,WAS,WAS,MIA,102,,,2,2,2,0
Johnny Davis,G,22023,1631098,22300676,"JAN 31, 2024",WAS vs. LAC,L,12,1,3,0.333,0,1,0.0,0,2,0.0,0,1,1,1,0,1,0,2,2,11,1,WAS,WAS,LAC,107,,,4,3,3,2
Johnny Davis,G,22023,1631098,22300628,"JAN 25, 2024",WAS vs. UTA,L,1,0,0,0.0,0,0,0.0,0,0,0.0,0,0,0,0,0,0,0,0,0,0,1,WAS,WAS,UTA,108,,,0,0,0,0
Johnny Davis,G,22023,1631098,22300558,"JAN 15, 2024",WAS vs. DET,L,1,0,0,0.0,0,0,0.0,0,0,0.0,0,0,0,0,0,0,0,0,0,3,1,WAS,WAS,DET,117,,,0,0,0,0
Johnny Davis,G,22023,1631098,22300494,"JAN 06, 2024",WAS vs. NYK,L,3,1,2,0.5,0,0,0.0,0,0,0.0,0,0,0,0,0,0,0,0,2,5,1,WAS,WAS,NYK,105,,,2,2,2,0
Johnny Davis,G,22023,1631098,22300482,"JAN 05, 2024",WAS @ CLE,L,6,0,2,0.0,0,0,0.0,0,0,0.0,1,0,1,0,0,0,0,0,0,-1,1,WAS,CLE,WAS,90,,,1,1,0,1
Johnny Davis,G,22023,1631098,22300465,"JAN 03, 2024",WAS @ CLE,L,5,1,3,0.333,0,0,0.0,0,0,0.0,0,0,0,0,0,0,0,0,2,0,1,WAS,CLE,WAS,101,,,2,2,2,0
Johnny Davis,G,22023,1631098,22300416,"DEC 27, 2023",WAS vs. TOR,L,6,0,1,0.0,0,0,0.0,0,0,0.0,0,0,0,0,0,0,0,1,0,-4,1,WAS,WAS,TOR,102,,,0,0,0,0
Johnny Davis,G,22023,1631098,22300274,"DEC 01, 2023",WAS @ ORL,L,6,0,2,0.0,0,0,0.0,0,0,0.0,1,0,1,0,0,0,0,1,0,-2,1,WAS,ORL,WAS,125,,,1,1,0,1
Johnny Davis,G,22023,1631098,22300259,"NOV 29, 2023",WAS @ ORL,L,10,0,1,0.0,0,0,0.0,0,0,0.0,1,0,1,0,1,0,0,1,0,-2,1,WAS,ORL,WAS,120,,,1,1,0,1
Johnny Davis,G,22023,1631098,22300253,"NOV 27, 2023",WAS @ DET,W,7,1,2,0.5,0,0,0.0,0,0,0.0,0,0,0,0,0,0,1,0,2,0,1,WAS,DET,WAS,126,,,2,2,2,0
Johnny Davis,G,22023,1631098,22300241,"NOV 25, 2023",WAS vs. ATL,L,16,2,5,0.4,0,1,0.0,0,0,0.0,0,3,3,2,1,0,1,1,4,5,1,WAS,WAS,ATL,108,,,9,7,6,5
Johnny Davis,G,22023,1631098,22300049,"NOV 24, 2023",WAS @ MIL,L,12,2,4,0.5,0,0,0.0,2,2,1.0,3,2,5,0,0,0,1,1,6,-5,1,WAS,MIL,WAS,128,,,11,11,6,5
Johnny Davis,G,22023,1631098,22300225,"NOV 22, 2023",WAS @ CHA,L,5,0,0,0.0,0,0,0.0,0,0,0.0,0,0,0,0,0,0,0,0,0,-6,1,WAS,CHA,WAS,114,,,0,0,0,0
Johnny Davis,G,22023,1631098,22300219,"NOV 20, 2023",WAS vs. MIL,L,6,0,0,0.0,0,0,0.0,0,0,0.0,0,1,1,1,0,0,0,0,0,-10,1,WAS,WAS,MIL,129,,,2,1,1,2
Johnny Davis,G,22023,1631098,22300028,"NOV 17, 2023",WAS vs. NYK,L,2,0,0,0.0,0,0,0.0,0,0,0.0,0,0,0,0,0,0,0,0,0,-1,1,WAS,WAS,NYK,99,,,0,0,0,0
Johnny Davis,G,22023,1631098,22300192,"NOV 15, 2023",WAS vs. DAL,L,7,2,3,0.667,0,0,0.0,0,0,0.0,0,1,1,1,1,0,0,1,4,11,1,WAS,WAS,DAL,117,,,6,5,5,2
Johnny Davis,G,22023,1631098,22300157,"NOV 08, 2023",WAS @ CHA,W,3,0,0,0.0,0,0,0.0,0,0,0.0,0,0,0,0,0,1,0,0,0,-2,1,WAS,CHA,WAS,132,,,0,0,0,0
Johnny Davis,G,22023,1631098,22300148,"NOV 06, 2023",WAS @ PHI,L,14,2,8,0.25,0,0,0.0,0,0,0.0,2,1,3,1,0,0,0,0,4,-6,1,WAS,PHI,WAS,128,,,8,7,5,4
Johnny Davis,G,22023,1631098,22300003,"NOV 03, 2023",WAS @ MIA,L,13,5,5,1.0,1,1,1.0,0,0,0.0,0,1,1,0,1,0,0,0,11,19,1,WAS,MIA,WAS,114,,,12,12,11,1
Johnny Davis,G,22023,1631098,22300117,"NOV 01, 2023",WAS @ ATL,L,10,3,6,0.5,0,1,0.0,1,1,1.0,0,1,1,0,3,0,0,3,7,-9,1,WAS,ATL,WAS,121,,,8,8,7,1
Johnny Davis,G,22023,1631098,22300103,"OCT 30, 2023",WAS vs. BOS,L,16,2,4,0.5,0,0,0.0,1,2,0.5,1,1,2,0,0,0,2,2,5,8,1,WAS,WAS,BOS,107,,,7,7,5,2
Dalen Terry,F,22023,1631207,22300139,"NOV 04, 2023",CHI @ DEN,L,3,1,2,0.5,0,1,0.0,0,2,0.0,0,1,1,1,0,0,0,1,2,-2,1,CHI,DEN,CHI,101,,,4,3,3,2
Dalen Terry,F,22023,1631207,22300672,"JAN 30, 2024",CHI vs. TOR,L,8,2,4,0.5,0,1,0.0,0,0,0.0,0,4,4,1,1,0,1,1,4,-1,1,CHI,CHI,TOR,107,,,9,8,5,5
Dalen Terry,F,22023,1631207,22300656,"JAN 28, 2024",CHI @ POR,W,8,1,2,0.5,0,1,0.0,1,2,0.5,0,0,0,2,2,0,0,2,3,1,1,CHI,POR,CHI,104,,,5,3,5,2
Dalen Terry,F,22023,1631207,22300633,"JAN 25, 2024",CHI @ LAL,L,3,1,2,0.5,1,1,1.0,0,0,0.0,0,0,0,1,0,0,0,1,3,-5,1,CHI,LAL,CHI,132,,,4,3,4,1
Dalen Terry,F,22023,1631207,22300612,"JAN 22, 2024",CHI @ PHX,L,9,0,2,0.0,0,1,0.0,0,0,0.0,0,0,0,1,0,0,0,0,0,1,1,CHI,PHX,CHI,113,,,1,0,1,1
Dalen Terry,F,22023,1631207,22300597,"JAN 20, 2024",CHI vs. MEM,W,18,1,3,0.333,1,3,0.333,4,6,0.667,1,4,5,3,1,1,1,2,7,17,1,CHI,CHI,MEM,125,,,15,12,10,8
Dalen Terry,F,22023,1631207,22300580,"JAN 18, 2024",CHI @ TOR,W,12,0,0,0.0,0,0,0.0,0,0,0.0,1,2,3,0,0,0,2,3,0,-13,1,CHI,TOR,CHI,116,,,3,3,0,3
Dalen Terry,F,22023,1631207,22300561,"JAN 15, 2024",CHI @ CLE,L,4,0,3,0.0,0,2,0.0,0,0,0.0,0,0,0,0,0,0,0,0,0,-11,1,CHI,CLE,CHI,91,,,0,0,0,0
Dalen Terry,F,22023,1631207,22300548,"JAN 13, 2024",CHI @ SAS,W,3,0,0,0.0,0,0,0.0,0,0,0.0,0,0,0,0,0,0,0,1,0,-1,1,CHI,SAS,CHI,122,,,0,0,0,0
Dalen Terry,F,22023,1631207,22300506,"JAN 08, 2024",CHI @ CHA,W,12,0,1,0.0,0,1,0.0,2,2,1.0,1,1,2,1,0,0,1,1,2,-4,1,CHI,CHA,CHI,119,,,5,4,3,3
Dalen Terry,F,22023,1631207,22300484,"JAN 05, 2024",CHI vs. CHA,W,21,3,5,0.6,2,4,0.5,0,0,0.0,0,1,1,4,2,0,0,2,8,6,1,CHI,CHI,CHA,104,,,13,9,12,5
Dalen Terry,F,22023,1631207,22300468,"JAN 03, 2024",CHI @ NYK,L,8,1,2,0.5,0,0,0.0,0,0,0.0,0,1,1,1,0,0,0,2,2,6,1,CHI,NYK,CHI,100,,,4,3,3,2
Dalen Terry,F,22023,1631207,22300459,"JAN 02, 2024",CHI @ PHI,L,21,2,7,0.286,0,3,0.0,2,2,1.0,1,7,8,7,0,1,3,4,6,14,1,CHI,PHI,CHI,97,,,21,14,13,15
Dalen Terry,F,22023,1631207,22300442,"DEC 30, 2023",CHI vs. PHI,W,11,1,2,0.5,1,2,0.5,0,0,0.0,0,0,0,0,0,0,1,1,3,-1,1,CHI,CHI,PHI,105,,,3,3,3,0
Dalen Terry,F,22023,1631207,22300422,"DEC 28, 2023",CHI vs. IND,L,18,2,3,0.667,0,0,0.0,2,2,1.0,1,2,3,1,1,3,2,1,6,29,1,CHI,CHI,IND,104,,,10,9,7,4
Dalen Terry,F,22023,1631207,22300408,"DEC 26, 2023",CHI vs. ATL,W,7,0,1,0.0,0,1,0.0,0,0,0.0,0,0,0,0,0,0,1,1,0,-12,1,CHI,CHI,ATL,118,,,0,0,0,0
Dalen Terry,F,22023,1631207,22300396,"DEC 23, 2023",CHI vs. CLE,L,17,2,3,0.667,0,1,0.0,2,2,1.0,0,1,1,0,1,0,0,1,6,-12,1,CHI,CHI,CLE,95,,,7,7,6,1
Dalen Terry,F,22023,1631207,22300376,"DEC 21, 2023",CHI vs. SAS,W,17,0,2,0.0,0,2,0.0,1,2,0.5,0,3,3,3,0,0,0,1,1,11,1,CHI,CHI,SAS,114,,,7,4,4,6
Dalen Terry,F,22023,1631207,22300370,"DEC 20, 2023",CHI vs. LAL,W,21,1,2,0.5,0,1,0.0,0,0,0.0,0,5,5,3,0,0,1,0,2,11,1,CHI,CHI,LAL,124,,,10,7,5,8
Dalen Terry,F,22023,1631207,22300351,"DEC 18, 2023",CHI @ PHI,W,10,1,1,1.0,0,0,0.0,0,0,0.0,1,2,3,1,0,0,0,2,2,10,1,CHI,PHI,CHI,108,,,6,5,3,4
Dalen Terry,F,22023,1631207,22300337,"DEC 16, 2023",CHI @ MIA,L,16,1,3,0.333,0,2,0.0,0,0,0.0,1,0,1,2,1,0,1,4,2,-7,1,CHI,MIA,CHI,116,,,5,3,4,3
Dalen Terry,F,22023,1631207,22300320,"DEC 14, 2023",CHI @ MIA,W,3,0,0,0.0,0,0,0.0,0,0,0.0,0,1,1,0,0,0,1,1,0,-9,1,CHI,MIA,CHI,124,,,1,1,0,1
Dalen Terry,F,22023,1631207,22300307,"DEC 12, 2023",CHI vs. DEN,L,11,0,2,0.0,0,2,0.0,2,2,1.0,0,0,0,1,0,1,0,1,2,9,1,CHI,CHI,DEN,106,,,3,2,3,1
Dalen Terry,F,22023,1631207,22300300,"DEC 11, 2023",CHI @ MIL,L,11,1,2,0.5,1,2,0.5,0,0,0.0,0,0,0,1,0,1,0,2,3,-6,1,CHI,MIL,CHI,129,,,4,3,4,1
Dalen Terry,F,22023,1631207,22301211,"DEC 06, 2023",CHI vs. CHA,W,3,0,0,0.0,0,0,0.0,0,0,0.0,0,0,0,0,0,0,0,0,0,4,1,CHI,CHI,CHA,111,,,0,0,0,0
Dalen Terry,F,22023,1631207,22300269,"NOV 30, 2023",CHI vs. MIL,W,4,0,1,0.0,0,0,0.0,0,0,0.0,1,0,1,0,0,0,0,0,0,1,1,CHI,CHI,MIL,120,,,1,1,0,1
Dalen Terry,F,22023,1631207,22300053,"NOV 28, 2023",CHI @ BOS,L,8,0,0,0.0,0,0,0.0,0,0,0.0,1,4,5,1,0,1,0,1,0,2,1,CHI,BOS,CHI,97,,,6,5,1,6
Dalen Terry,F,22023,1631207,22300152,"NOV 06, 2023",CHI vs. UTA,W,3,1,3,0.333,0,1,0.0,0,0,0.0,0,1,1,1,0,0,1,0,2,-5,1,CHI,CHI,UTA,130,,,4,3,3,2
Dalen Terry,F,22023,1631207,22300088,"OCT 28, 2023",CHI @ DET,L,1,1,1,1.0,1,1,1.0,0,0,0.0,0,0,0,0,0,0,0,0,3,0,1,CHI,DET,CHI,102,,,3,3,3,0
Dalen Terry,F,22023,1631207,22300070,"OCT 25, 2023",CHI vs. OKC,L,4,0,2,0.0,0,1,0.0,0,0,0.0,0,2,2,1,0,0,0,0,0,1,1,CHI,CHI,OKC,104,,,3,2,1,3
Dalen Terry,F,22023,1631207,22300752,"FEB 10, 2024",CHI @ ORL,L,12,2,5,0.4,1,3,0.333,0,0,0.0,1,0,1,2,0,0,0,4,5,-9,1,CHI,ORL,CHI,108,,,8,6,7,3
Dalen Terry,F,22023,1631207,22300536,"JAN 12, 2024",CHI vs. GSW,L,8,1,5,0.2,0,3,0.0,0,0,0.0,1,0,1,0,0,0,1,1,2,-12,1,CHI,CHI,GSW,131,,,3,3,2,1
Dalen Terry,F,22023,1631207,22300523,"JAN 10, 2024",CHI vs. HOU,W,6,1,1,1.0,1,1,1.0,0,0,0.0,0,0,0,1,0,0,0,1,3,4,1,CHI,CHI,HOU,124,,,4,3,4,1
Colby Jones,G,22023,1641732,22300746,"FEB 09, 2024",SAC vs. DEN,W,7,1,3,0.333,0,0,0.0,0,0,0.0,0,3,3,1,0,0,0,1,2,0,1,SAC,SAC,DEN,135,,,6,5,3,4
Colby Jones,G,22023,1641732,22300714,"FEB 05, 2024",SAC @ CLE,L,3,0,1,0.0,0,0,0.0,0,2,0.0,1,0,1,0,0,0,0,0,0,-2,1,SAC,CLE,SAC,110,,,1,1,0,1
Colby Jones,G,22023,1641732,22300532,"JAN 12, 2024",SAC @ PHI,L,9,0,4,0.0,0,1,0.0,0,0,0.0,1,2,3,3,1,0,1,3,0,6,1,SAC,PHI,SAC,90,,,6,3,3,6
Colby Jones,G,22023,1641732,22300518,"JAN 10, 2024",SAC @ CHA,W,14,0,2,0.0,0,2,0.0,0,0,0.0,1,0,1,0,0,0,0,0,0,1,1,SAC,CHA,SAC,121,,,1,1,0,1
Colby Jones,G,22023,1641732,22300500,"JAN 07, 2024",SAC vs. NOP,L,10,2,5,0.4,0,2,0.0,0,0,0.0,0,1,1,4,1,0,0,1,4,12,1,SAC,SAC,NOP,100,,,9,5,8,5
Colby Jones,G,22023,1641732,22300400,"DEC 23, 2023",SAC vs. MIN,L,2,0,0,0.0,0,0,0.0,0,0,0.0,0,1,1,0,0,0,0,0,0,3,1,SAC,SAC,MIN,98,,,1,1,0,1
Colby Jones,G,22023,1641732,22300358,"DEC 18, 2023",SAC vs. WAS,W,4,1,3,0.333,0,0,0.0,0,0,0.0,1,0,1,0,0,0,0,1,2,-6,1,SAC,SAC,WAS,141,,,3,3,2,1
Colby Jones,G,22023,1641732,22300303,"DEC 11, 2023",SAC vs. BKN,W,1,0,0,0.0,0,0,0.0,0,0,0.0,0,0,0,0,0,0,0,1,0,-6,1,SAC,SAC,BKN,131,,,0,0,0,0
Colby Jones,G,22023,1641732,22300264,"NOV 29, 2023",SAC vs. LAC,L,1,1,2,0.5,0,1,0.0,0,0,0.0,1,0,1,0,0,0,1,0,2,0,1,SAC,SAC,LAC,117,,,3,3,2,1
Colby Jones,G,22023,1641732,22300222,"NOV 20, 2023",SAC @ NOP,L,14,4,8,0.5,0,2,0.0,0,1,0.0,0,1,1,0,1,0,0,2,8,-1,1,SAC,NOP,SAC,93,,,9,9,8,1
Colby Jones,G,22023,1641732,22300212,"NOV 19, 2023",SAC @ DAL,W,4,0,1,0.0,0,1,0.0,0,0,0.0,0,0,0,0,0,0,0,2,0,-3,1,SAC,DAL,SAC,129,,,0,0,0,0
Colby Jones,G,22023,1641732,22300191,"NOV 13, 2023",SAC vs. CLE,W,1,0,0,0.0,0,0,0.0,0,0,0.0,0,0,0,0,0,0,0,0,0,-5,1,SAC,SAC,CLE,132,,,0,0,0,0
Colby Jones,G,22023,1641732,22300153,"NOV 06, 2023",SAC @ HOU,L,13,4,6,0.667,0,0,0.0,2,2,1.0,3,2,5,1,0,0,0,1,10,4,1,SAC,HOU,SAC,97,,,16,15,11,6
Colby Jones,G,22023,1641732,22300137,"NOV 04, 2023",SAC @ HOU,L,18,2,7,0.286,1,4,0.25,0,0,0.0,1,2,3,0,0,0,3,1,5,0,1,SAC,HOU,SAC,89,,,8,8,5,3
Colby Jones,G,22023,1641732,22300126,"NOV 01, 2023",SAC @ GSW,L,17,2,4,0.5,0,0,0.0,0,0,0.0,1,2,3,1,1,1,0,3,4,-5,1,SAC,GSW,SAC,101,,,8,7,5,4
Colby Jones,G,22023,1641732,22300087,"OCT 27, 2023",SAC vs. GSW,L,0,0,0,0.0,0,0,0.0,0,0,0.0,0,0,0,0,0,0,0,0,0,2,1,SAC,SAC,GSW,114,,,0,0,0,0
Colby Jones,G,22023,1641732,22300072,"OCT 25, 2023",SAC @ UTA,W,1,0,0,0.0,0,0,0.0,0,0,0.0,0,1,1,0,0,0,0,0,0,-2,1,SAC,UTA,SAC,130,,,1,1,0,1
Cory Joseph,G,22023,202709,22300727,"FEB 07, 2024",GSW @ PHI,W,5,3,4,0.75,2,3,0.667,0,0,0.0,0,1,1,1,0,0,0,0,8,4,1,GSW,PHI,GSW,127,,,10,9,9,2
Cory Joseph,G,22023,202709,22300673,"JAN 30, 2024",GSW vs. PHI,W,13,1,4,0.25,0,2,0.0,0,0,0.0,1,0,1,2,0,0,1,3,2,-10,1,GSW,GSW,PHI,119,,,5,3,4,3
Cory Joseph,G,22023,202709,22300650,"JAN 27, 2024",GSW vs. LAL,L,15,1,2,0.5,1,2,0.5,0,0,0.0,0,2,2,2,0,0,0,1,3,0,1,GSW,GSW,LAL,144,,,7,5,5,4
Cory Joseph,G,22023,202709,22300632,"JAN 25, 2024",GSW vs. SAC,L,17,2,3,0.667,2,2,1.0,0,0,0.0,1,4,5,0,0,0,0,1,6,3,1,GSW,GSW,SAC,133,,,11,11,6,5
Cory Joseph,G,22023,202709,22300626,"JAN 24, 2024",GSW vs. ATL,W,21,3,3,1.0,2,2,1.0,0,0,0.0,0,2,2,1,0,0,0,1,8,12,1,GSW,GSW,ATL,134,,,11,10,9,3
Cory Joseph,G,22023,202709,22300560,"JAN 15, 2024",GSW @ MEM,L,7,0,1,0.0,0,1,0.0,0,0,0.0,0,0,0,1,0,0,0,0,0,-7,1,GSW,MEM,GSW,107,,,1,0,1,1
Cory Joseph,G,22023,202709,22300536,"JAN 12, 2024",GSW @ CHI,W,13,1,3,0.333,0,1,0.0,0,0,0.0,0,1,1,2,0,0,0,1,2,4,1,GSW,CHI,GSW,140,,,5,3,4,3
Cory Joseph,G,22023,202709,22300525,"JAN 10, 2024",GSW vs. NOP,L,17,1,3,0.333,0,2,0.0,0,0,0.0,2,1,3,2,0,0,2,2,2,-22,1,GSW,GSW,NOP,105,,,7,5,4,5
Cory Joseph,G,22023,202709,22300504,"JAN 07, 2024",GSW vs. TOR,L,14,0,2,0.0,0,1,0.0,0,0,0.0,0,0,0,2,0,0,1,1,0,-3,1,GSW,GSW,TOR,118,,,2,0,2,2
Cory Joseph,G,22023,202709,22300490,"JAN 05, 2024",GSW vs. DET,W,9,1,2,0.5,1,2,0.5,0,0,0.0,0,0,0,2,0,0,0,0,3,3,1,GSW,GSW,DET,113,,,5,3,5,2
Cory Joseph,G,22023,202709,22300426,"DEC 28, 2023",GSW vs. MIA,L,2,0,0,0.0,0,0,0.0,0,0,0.0,0,0,0,0,0,0,0,1,0,3,1,GSW,GSW,MIA,102,,,0,0,0,0
Cory Joseph,G,22023,202709,22300399,"DEC 23, 2023",GSW vs. POR,W,4,0,1,0.0,0,1,0.0,0,0,0.0,0,0,0,1,0,0,1,0,0,1,1,GSW,GSW,POR,126,,,1,0,1,1
Cory Joseph,G,22023,202709,22300386,"DEC 22, 2023",GSW vs. WAS,W,14,0,3,0.0,0,1,0.0,0,0,0.0,0,1,1,0,1,0,1,3,0,-7,1,GSW,GSW,WAS,129,,,1,1,0,1
Cory Joseph,G,22023,202709,22300362,"DEC 19, 2023",GSW vs. BOS,W,6,2,3,0.667,0,1,0.0,0,0,0.0,0,1,1,0,0,1,0,0,4,2,1,GSW,GSW,BOS,132,,,5,5,4,1
Cory Joseph,G,22023,202709,22301222,"DEC 08, 2023",GSW @ OKC,L,13,1,3,0.333,0,1,0.0,0,0,0.0,0,1,1,3,0,0,0,0,2,3,1,GSW,OKC,GSW,136,,,6,3,5,4
Cory Joseph,G,22023,202709,22300280,"DEC 02, 2023",GSW @ LAC,L,16,0,2,0.0,0,2,0.0,0,0,0.0,0,0,0,3,0,0,0,2,0,1,1,GSW,LAC,GSW,112,,,3,0,3,3
Cory Joseph,G,22023,202709,22300273,"NOV 30, 2023",GSW vs. LAC,W,22,0,2,0.0,0,2,0.0,1,2,0.5,0,2,2,2,0,0,0,1,1,12,1,GSW,GSW,LAC,120,,,5,3,3,4
Cory Joseph,G,22023,202709,22300060,"NOV 28, 2023",GSW @ SAC,L,8,1,2,0.5,0,0,0.0,2,2,1.0,0,3,3,3,0,0,0,0,4,1,1,GSW,SAC,GSW,123,,,10,7,7,6
Cory Joseph,G,22023,202709,22300236,"NOV 22, 2023",GSW @ PHX,L,16,1,3,0.333,0,2,0.0,1,2,0.5,0,0,0,4,2,0,1,3,3,12,1,GSW,PHX,GSW,115,,,7,3,7,4
Cory Joseph,G,22023,202709,22300176,"NOV 11, 2023",GSW vs. CLE,L,2,1,2,0.5,1,2,0.5,0,0,0.0,0,0,0,1,0,0,2,1,3,6,1,GSW,GSW,CLE,110,,,4,3,4,1
Cory Joseph,G,22023,202709,22300142,"NOV 05, 2023",GSW @ CLE,L,3,0,0,0.0,0,0,0.0,0,0,0.0,0,0,0,0,1,0,0,0,0,3,1,GSW,CLE,GSW,104,,,0,0,0,0
Cory Joseph,G,22023,202709,22300108,"OCT 30, 2023",GSW @ NOP,W,5,0,1,0.0,0,1,0.0,0,0,0.0,0,1,1,1,0,0,0,2,0,0,1,GSW,NOP,GSW,130,,,2,1,1,2
Cory Joseph,G,22023,202709,22300062,"OCT 24, 2023",GSW vs. PHX,L,4,0,0,0.0,0,0,0.0,0,0,0.0,1,0,1,1,0,0,0,0,0,-12,1,GSW,GSW,PHX,104,,,2,1,1,2
Cory Joseph,G,22023,202709,22300025,"NOV 14, 2023",GSW vs. MIN,L,13,2,6,0.333,2,3,0.667,0,1,0.0,0,0,0,4,0,0,2,1,6,6,1,GSW,GSW,MIN,101,,,10,6,10,4
Cory Joseph,G,22023,202709,22300545,"JAN 13, 2024",GSW @ MIL,L,18,1,2,0.5,1,2,0.5,0,0,0.0,0,3,3,2,0,1,1,1,3,-11,1,GSW,MIL,GSW,118,,,8,6,5,5
Cory Joseph,G,22023,202709,22300201,"NOV 16, 2023",GSW vs. OKC,L,20,1,7,0.143,1,6,0.167,0,0,0.0,1,1,2,2,0,1,0,0,3,-16,1,GSW,GSW,OKC,109,,,7,5,5,4
Terquavion Smith,G,22023,1631173,22300742,"FEB 09, 2024",PHI vs. ATL,L,13,3,7,0.429,2,6,0.333,0,0,0.0,0,0,0,0,1,0,1,0,8,-11,1,PHI,PHI,ATL,121,,,8,8,8,0
Terquavion Smith,G,22023,1631173,22300727,"FEB 07, 2024",PHI vs. GSW,L,10,3,8,0.375,1,4,0.25,0,0,0.0,0,1,1,2,1,0,1,0,7,4,1,PHI,PHI,GSW,104,,,10,8,9,3
Terquavion Smith,G,22023,1631173,22300715,"FEB 05, 2024",PHI vs. DAL,L,6,1,2,0.5,1,2,0.5,0,0,0.0,0,1,1,1,1,0,0,0,3,4,1,PHI,PHI,DAL,102,,,5,4,4,2
Terquavion Smith,G,22023,1631173,22300698,"FEB 03, 2024",PHI vs. BKN,L,9,6,7,0.857,5,6,0.833,0,1,0.0,0,0,0,1,0,0,0,2,17,8,1,PHI,PHI,BKN,121,,,18,17,18,1
Terquavion Smith,G,22023,1631173,22300668,"JAN 29, 2024",PHI @ POR,L,9,1,4,0.25,1,4,0.25,0,0,0.0,0,0,0,1,1,0,1,1,3,-5,1,PHI,POR,PHI,104,,,4,3,4,1
Terquavion Smith,G,22023,1631173,22300627,"JAN 25, 2024",PHI @ IND,L,12,0,6,0.0,0,4,0.0,2,2,1.0,0,0,0,5,3,0,1,0,2,9,1,PHI,IND,PHI,122,,,7,2,7,5
Terquavion Smith,G,22023,1631173,22300608,"JAN 22, 2024",PHI vs. SAS,W,1,0,1,0.0,0,0,0.0,0,0,0.0,0,0,0,0,0,0,0,0,0,-5,1,PHI,PHI,SAS,133,,,0,0,0,0
Terquavion Smith,G,22023,1631173,22300593,"JAN 20, 2024",PHI @ CHA,W,0,0,0,0.0,0,0,0.0,0,0,0.0,0,0,0,0,0,0,0,0,0,-4,1,PHI,CHA,PHI,97,,,0,0,0,0
Terquavion Smith,G,22023,1631173,22300585,"JAN 19, 2024",PHI @ ORL,W,2,2,2,1.0,2,2,1.0,0,0,0.0,0,0,0,0,0,0,0,0,6,2,1,PHI,ORL,PHI,124,,,6,6,6,0
Wesley Matthews,G,22023,202083,22300716,"FEB 05, 2024",ATL vs. LAC,L,6,1,1,1.0,1,1,1.0,0,0,0.0,0,1,1,1,1,0,0,0,3,0,1,ATL,ATL,LAC,144,,,5,4,4,2
Wesley Matthews,G,22023,202083,22300690,"FEB 02, 2024",ATL vs. PHX,W,13,2,6,0.333,2,5,0.4,0,0,0.0,0,1,1,0,0,0,0,2,6,4,1,ATL,ATL,PHX,129,,,7,7,6,1
Wesley Matthews,G,22023,202083,22300499,"JAN 07, 2024",ATL @ ORL,L,9,0,0,0.0,0,0,0.0,0,0,0.0,0,1,1,0,0,1,0,1,0,11,1,ATL,ORL,ATL,110,,,1,1,0,1
Wesley Matthews,G,22023,202083,22300408,"DEC 26, 2023",ATL @ CHI,L,6,0,0,0.0,0,0,0.0,0,0,0.0,0,0,0,1,0,1,1,1,0,-1,1,ATL,CHI,ATL,113,,,1,0,1,1
Wesley Matthews,G,22023,202083,22300384,"DEC 22, 2023",ATL @ MIA,L,7,0,1,0.0,0,1,0.0,0,0,0.0,0,1,1,0,0,0,0,1,0,-3,1,ATL,MIA,ATL,113,,,1,1,0,1
Wesley Matthews,G,22023,202083,22300371,"DEC 20, 2023",ATL @ HOU,W,8,0,2,0.0,0,1,0.0,1,2,0.5,0,2,2,0,0,0,0,1,1,2,1,ATL,HOU,ATL,134,,,3,3,1,2
Wesley Matthews,G,22023,202083,22300352,"DEC 18, 2023",ATL vs. DET,W,15,1,2,0.5,0,1,0.0,0,0,0.0,0,2,2,1,1,1,1,1,2,-9,1,ATL,ATL,DET,130,,,5,4,3,3
Wesley Matthews,G,22023,202083,22300336,"DEC 16, 2023",ATL @ CLE,L,20,1,2,0.5,0,1,0.0,0,0,0.0,0,2,2,1,0,0,0,3,2,8,1,ATL,CLE,ATL,119,,,5,4,3,3
Wesley Matthews,G,22023,202083,22300313,"DEC 13, 2023",ATL @ TOR,L,14,1,6,0.167,1,4,0.25,2,2,1.0,1,1,2,1,2,0,0,3,5,-11,1,ATL,TOR,ATL,128,,,8,7,6,3
Wesley Matthews,G,22023,202083,22300296,"DEC 11, 2023",ATL vs. DEN,L,18,1,5,0.2,0,4,0.0,0,0,0.0,1,4,5,1,2,0,2,1,2,-2,1,ATL,ATL,DEN,122,,,8,7,3,6
Wesley Matthews,G,22023,202083,22301218,"DEC 08, 2023",ATL @ PHI,L,10,0,3,0.0,0,1,0.0,3,3,1.0,0,0,0,0,0,0,0,0,3,-13,1,ATL,PHI,ATL,114,,,3,3,3,0
Wesley Matthews,G,22023,202083,22301209,"DEC 06, 2023",ATL vs. BKN,L,11,0,1,0.0,0,1,0.0,4,4,1.0,0,1,1,0,1,0,0,2,4,-1,1,ATL,ATL,BKN,113,,,5,5,4,1
Wesley Matthews,G,22023,202083,22300286,"DEC 02, 2023",ATL @ MIL,L,12,0,2,0.0,0,2,0.0,1,2,0.5,0,1,1,0,2,0,0,0,1,-13,1,ATL,MIL,ATL,121,,,2,2,1,1
Wesley Matthews,G,22023,202083,22300272,"NOV 30, 2023",ATL @ SAS,W,15,1,1,1.0,1,1,1.0,0,0,0.0,0,0,0,2,0,1,0,1,3,1,1,ATL,SAS,ATL,137,,,5,3,5,2
Wesley Matthews,G,22023,202083,22300055,"NOV 28, 2023",ATL @ CLE,L,16,0,3,0.0,0,3,0.0,0,0,0.0,0,3,3,2,0,0,0,0,0,1,1,ATL,CLE,ATL,105,,,5,3,2,5
Wesley Matthews,G,22023,202083,22300246,"NOV 26, 2023",ATL @ BOS,L,8,1,3,0.333,0,2,0.0,0,0,0.0,0,0,0,0,0,0,0,1,2,-1,1,ATL,BOS,ATL,103,,,2,2,2,0
Wesley Matthews,G,22023,202083,22300241,"NOV 25, 2023",ATL @ WAS,W,8,0,1,0.0,0,1,0.0,0,0,0.0,0,0,0,1,0,0,0,0,0,-6,1,ATL,WAS,ATL,136,,,1,0,1,1
Wesley Matthews,G,22023,202083,22300039,"NOV 21, 2023",ATL vs. IND,L,9,1,2,0.5,1,2,0.5,0,0,0.0,0,1,1,1,0,0,1,3,3,1,1,ATL,ATL,IND,152,,,5,4,4,2
Wesley Matthews,G,22023,202083,22300029,"NOV 17, 2023",ATL vs. PHI,L,10,0,2,0.0,0,2,0.0,2,4,0.5,0,0,0,0,0,0,0,2,2,-8,1,ATL,ATL,PHI,116,,,2,2,2,0
Wesley Matthews,G,22023,202083,22300193,"NOV 15, 2023",ATL vs. NYK,L,10,1,1,1.0,1,1,1.0,0,0,0.0,1,2,3,1,1,0,0,2,3,2,1,ATL,ATL,NYK,114,,,7,6,4,4
Wesley Matthews,G,22023,202083,22300175,"NOV 11, 2023",ATL vs. MIA,L,7,2,2,1.0,2,2,1.0,1,2,0.5,1,1,2,0,0,0,1,3,7,1,1,ATL,ATL,MIA,109,,,9,9,7,2
Boban Marjanovic,C,22023,1626246,22300692,"FEB 02, 2024",HOU vs. TOR,W,4,2,2,1.0,0,0,0.0,2,2,1.0,1,3,4,0,0,0,1,0,6,1,1,HOU,HOU,TOR,135,,,10,10,6,4
Boban Marjanovic,C,22023,1626246,22300635,"JAN 26, 2024",HOU @ CHA,W,7,1,1,1.0,0,0,0.0,1,2,0.5,0,3,3,0,0,0,1,0,3,-3,1,HOU,CHA,HOU,138,,,6,6,3,3
Boban Marjanovic,C,22023,1626246,22300623,"JAN 24, 2024",HOU vs. POR,L,0,0,0,0.0,0,0,0.0,0,0,0.0,0,0,0,0,0,0,0,0,0,-3,1,HOU,HOU,POR,131,,,0,0,0,0
Boban Marjanovic,C,22023,1626246,22300542,"JAN 13, 2024",HOU @ BOS,L,7,1,4,0.25,0,0,0.0,0,1,0.0,1,2,3,0,0,0,0,1,2,0,1,HOU,BOS,HOU,113,,,5,5,2,3
Boban Marjanovic,C,22023,1626246,22300163,"NOV 08, 2023",HOU vs. LAL,W,6,3,4,0.75,0,0,0.0,0,1,0.0,2,5,7,0,0,0,0,1,6,3,1,HOU,HOU,LAL,128,,,13,13,6,7
Boban Marjanovic,C,22023,1626246,22300153,"NOV 06, 2023",HOU vs. SAC,W,7,0,3,0.0,0,1,0.0,0,0,0.0,0,1,1,2,0,1,0,0,0,-11,1,HOU,HOU,SAC,122,,,3,1,2,3
Boban Marjanovic,C,22023,1626246,22300083,"OCT 27, 2023",HOU @ SAS,L,7,2,2,1.0,0,0,0.0,0,0,0.0,0,0,0,1,0,0,0,1,4,3,1,HOU,SAS,HOU,122,,,5,4,5,1
Boban Marjanovic,C,22023,1626246,22300485,"JAN 05, 2024",HOU vs. MIN,L,4,1,3,0.333,0,0,0.0,0,0,0.0,2,1,3,0,0,0,0,0,2,-3,1,HOU,HOU,MIN,95,,,5,5,2,3
Boban Marjanovic,C,22023,1626246,22300453,"JAN 01, 2024",HOU vs. DET,W,6,0,2,0.0,0,1,0.0,0,0,0.0,0,1,1,1,0,0,0,1,0,-10,1,HOU,HOU,DET,136,,,2,1,1,2
Jalen Pickett,G,22023,1629618,22300631,"JAN 25, 2024",DEN @ NYK,L,7,1,3,0.333,0,2,0.0,0,0,0.0,0,0,0,2,0,0,0,0,2,-1,1,DEN,NYK,DEN,84,,,4,2,4,2
Jalen Pickett,G,22023,1629618,22300455,"JAN 01, 2024",DEN vs. CHA,W,4,0,1,0.0,0,1,0.0,0,0,0.0,0,0,0,0,0,0,0,0,0,-6,1,DEN,DEN,CHA,111,,,0,0,0,0
Jalen Pickett,G,22023,1629618,22300435,"DEC 29, 2023",DEN vs. OKC,L,3,0,1,0.0,0,0,0.0,0,0,0.0,0,0,0,0,0,0,0,1,0,-6,1,DEN,DEN,OKC,93,,,0,0,0,0
Jalen Pickett,G,22023,1629618,22300425,"DEC 28, 2023",DEN vs. MEM,W,6,1,2,0.5,1,2,0.5,0,0,0.0,0,1,1,2,0,0,0,0,3,3,1,DEN,DEN,MEM,142,,,6,4,5,3
Jalen Pickett,G,22023,1629618,22300322,"DEC 14, 2023",DEN vs. BKN,W,2,1,1,1.0,1,1,1.0,0,0,0.0,0,0,0,1,0,0,0,0,3,6,1,DEN,DEN,BKN,124,,,4,3,4,1
Jalen Pickett,G,22023,1629618,22300263,"NOV 29, 2023",DEN vs. HOU,W,3,0,1,0.0,0,1,0.0,0,0,0.0,0,0,0,0,0,0,0,0,0,-9,1,DEN,DEN,HOU,134,,,0,0,0,0
Jalen Pickett,G,22023,1629618,22300252,"NOV 26, 2023",DEN vs. SAS,W,2,0,0,0.0,0,0,0.0,0,0,0.0,0,0,0,0,0,0,1,1,0,-4,1,DEN,DEN,SAS,132,,,0,0,0,0
Jalen Pickett,G,22023,1629618,22300226,"NOV 22, 2023",DEN @ ORL,L,8,0,4,0.0,0,3,0.0,0,0,0.0,0,1,1,0,0,0,1,0,0,1,1,DEN,ORL,DEN,119,,,1,1,0,1
Jalen Pickett,G,22023,1629618,22300218,"NOV 20, 2023",DEN @ DET,W,7,1,1,1.0,0,0,0.0,0,0,0.0,1,1,2,1,1,0,0,1,2,1,1,DEN,DET,DEN,107,,,5,4,3,3
Jalen Pickett,G,22023,1629618,22300210,"NOV 19, 2023",DEN @ CLE,L,19,2,4,0.5,2,3,0.667,2,2,1.0,0,2,2,3,1,0,1,0,8,7,1,DEN,CLE,DEN,109,,,13,10,11,5
Jalen Pickett,G,22023,1629618,22300034,"NOV 17, 2023",DEN @ NOP,L,10,0,2,0.0,0,2,0.0,0,0,0.0,0,1,1,1,0,0,1,2,0,9,1,DEN,NOP,DEN,110,,,2,1,1,2
Jalen Pickett,G,22023,1629618,22300024,"NOV 14, 2023",DEN vs. LAC,W,17,2,3,0.667,1,2,0.5,0,0,0.0,0,2,2,2,1,0,2,2,5,-4,1,DEN,DEN,LAC,111,,,9,7,7,4
Jalen Pickett,G,22023,1629618,22300156,"NOV 06, 2023",DEN vs. NOP,W,1,1,1,1.0,1,1,1.0,0,0,0.0,0,0,0,0,0,0,0,0,3,3,1,DEN,DEN,NOP,134,,,3,3,3,0
Jalen Pickett,G,22023,1629618,22300139,"NOV 04, 2023",DEN vs. CHI,W,2,1,1,1.0,1,1,1.0,0,0,0.0,0,0,0,0,0,0,0,0,3,-1,1,DEN,DEN,CHI,123,,,3,3,3,0
Jalen Pickett,G,22023,1629618,22300123,"NOV 01, 2023",DEN @ MIN,L,5,1,2,0.5,0,1,0.0,0,0,0.0,0,2,2,0,0,0,0,1,2,0,1,DEN,MIN,DEN,89,,,4,4,2,2
Jalen Pickett,G,22023,1629618,22300061,"OCT 24, 2023",DEN vs. LAL,W,1,1,1,1.0,0,0,0.0,0,0,0.0,0,0,0,0,0,0,0,0,2,0,1,DEN,DEN,LAL,119,,,2,2,2,0
Trent Forrest,G,22023,1630235,22300742,"FEB 09, 2024",ATL @ PHI,W,8,0,0,0.0,0,0,0.0,0,0,0.0,0,0,0,4,0,0,1,1,0,1,1,ATL,PHI,ATL,127,,,4,0,4,4
Trent Forrest,G,22023,1630235,22300653,"JAN 28, 2024",ATL vs. TOR,W,6,0,1,0.0,0,1,0.0,0,0,0.0,0,0,0,3,0,0,0,1,0,-7,1,ATL,ATL,TOR,126,,,3,0,3,3
Trent Forrest,G,22023,1630235,22300626,"JAN 24, 2024",ATL @ GSW,L,15,0,1,0.0,0,0,0.0,0,0,0.0,0,0,0,5,2,0,1,1,0,-9,1,ATL,GSW,ATL,112,,,5,0,5,5
Trent Forrest,G,22023,1630235,22300613,"JAN 22, 2024",ATL @ SAC,L,8,0,3,0.0,0,0,0.0,0,0,0.0,0,2,2,1,0,0,0,1,0,-11,1,ATL,SAC,ATL,107,,,3,2,1,3
Trent Forrest,G,22023,1630235,22300595,"JAN 20, 2024",ATL vs. CLE,L,6,0,1,0.0,0,0,0.0,0,0,0.0,0,1,1,0,0,0,0,0,0,6,1,ATL,ATL,CLE,95,,,1,1,0,1
Trent Forrest,G,22023,1630235,22300587,"JAN 19, 2024",ATL @ MIA,W,10,1,4,0.25,1,2,0.5,0,0,0.0,0,1,1,3,0,0,1,0,3,-4,1,ATL,MIA,ATL,109,,,7,4,6,4
Trent Forrest,G,22023,1630235,22300559,"JAN 15, 2024",ATL vs. SAS,W,12,1,3,0.333,1,1,1.0,0,0,0.0,1,2,3,0,0,0,0,2,3,-13,1,ATL,ATL,SAS,109,,,6,6,3,3
Trent Forrest,G,22023,1630235,22300543,"JAN 13, 2024",ATL vs. WAS,L,13,1,4,0.25,0,0,0.0,2,4,0.5,0,2,2,1,1,0,2,1,4,-7,1,ATL,ATL,WAS,99,,,7,6,5,3
Trent Forrest,G,22023,1630235,22300533,"JAN 12, 2024",ATL vs. IND,L,20,2,5,0.4,0,0,0.0,0,0,0.0,0,0,0,6,1,0,1,0,4,-5,1,ATL,ATL,IND,108,,,10,4,10,6
Trent Forrest,G,22023,1630235,22300521,"JAN 10, 2024",ATL vs. PHI,W,19,2,3,0.667,0,1,0.0,0,0,0.0,0,5,5,3,0,0,0,3,4,6,1,ATL,ATL,PHI,139,,,12,9,7,8
Trent Forrest,G,22023,1630235,22300480,"JAN 05, 2024",ATL @ IND,L,14,2,4,0.5,0,1,0.0,2,2,1.0,0,2,2,2,1,0,2,0,6,-11,1,ATL,IND,ATL,116,,,10,8,8,4
Trent Forrest,G,22023,1630235,22300467,"JAN 03, 2024",ATL vs. OKC,W,14,3,3,1.0,0,0,0.0,0,0,0.0,0,2,2,2,0,1,0,3,6,7,1,ATL,ATL,OKC,141,,,10,8,8,4
Trent Forrest,G,22023,1630235,22300408,"DEC 26, 2023",ATL @ CHI,L,3,0,0,0.0,0,0,0.0,0,0,0.0,0,0,0,0,0,0,0,0,0,4,1,ATL,CHI,ATL,113,,,0,0,0,0
Trent Forrest,G,22023,1630235,22300336,"DEC 16, 2023",ATL @ CLE,L,7,0,2,0.0,0,0,0.0,0,0,0.0,1,2,3,0,1,0,1,0,0,-4,1,ATL,CLE,ATL,119,,,3,3,0,3
Trent Forrest,G,22023,1630235,22300330,"DEC 15, 2023",ATL @ TOR,W,11,0,4,0.0,0,1,0.0,0,0,0.0,1,2,3,4,1,0,0,1,0,2,1,ATL,TOR,ATL,125,,,7,3,4,7
Trent Forrest,G,22023,1630235,22301218,"DEC 08, 2023",ATL @ PHI,L,13,2,5,0.4,0,0,0.0,2,2,1.0,1,0,1,1,0,0,1,2,6,-3,1,ATL,PHI,ATL,114,,,8,7,7,2
Trent Forrest,G,22023,1630235,22300055,"NOV 28, 2023",ATL @ CLE,L,4,0,1,0.0,0,0,0.0,0,0,0.0,0,0,0,0,0,0,0,0,0,0,1,ATL,CLE,ATL,105,,,0,0,0,0
Trent Forrest,G,22023,1630235,22300241,"NOV 25, 2023",ATL @ WAS,W,9,1,2,0.5,0,0,0.0,0,0,0.0,0,0,0,2,0,0,1,1,2,-7,1,ATL,WAS,ATL,136,,,4,2,4,2
Trent Forrest,G,22023,1630235,22300018,"NOV 14, 2023",ATL @ DET,W,13,0,1,0.0,0,0,0.0,2,2,1.0,1,0,1,4,0,0,0,0,2,-3,1,ATL,DET,ATL,126,,,7,3,6,5
Trent Forrest,G,22023,1630235,22300097,"OCT 29, 2023",ATL @ MIL,W,5,0,0,0.0,0,0,0.0,0,0,0.0,0,0,0,1,0,0,0,1,0,-7,1,ATL,MIL,ATL,127,,,1,0,1,1
AJ Griffin,F,22023,1631100,22300669,"JAN 30, 2024",ATL vs. LAL,W,2,0,1,0.0,0,0,0.0,0,0,0.0,0,1,1,0,0,0,0,0,0,1,1,ATL,ATL,LAL,138,,,1,1,0,1
AJ Griffin,F,22023,1631100,22300626,"JAN 24, 2024",ATL @ GSW,L,2,0,2,0.0,0,2,0.0,0,0,0.0,0,0,0,0,0,0,0,0,0,-4,1,ATL,GSW,ATL,112,,,0,0,0,0
AJ Griffin,F,22023,1631100,22300595,"JAN 20, 2024",ATL vs. CLE,L,3,1,2,0.5,0,1,0.0,0,0,0.0,0,0,0,0,0,0,0,0,2,3,1,ATL,ATL,CLE,95,,,2,2,2,0
AJ Griffin,F,22023,1631100,22300543,"JAN 13, 2024",ATL vs. WAS,L,5,0,1,0.0,0,1,0.0,0,0,0.0,0,1,1,0,0,0,0,0,0,1,1,ATL,ATL,WAS,99,,,1,1,0,1
AJ Griffin,F,22023,1631100,22300533,"JAN 12, 2024",ATL vs. IND,L,4,1,2,0.5,0,1,0.0,0,0,0.0,0,0,0,0,0,1,0,0,2,2,1,ATL,ATL,IND,108,,,2,2,2,0
AJ Griffin,F,22023,1631100,22300480,"JAN 05, 2024",ATL @ IND,L,7,1,3,0.333,1,3,0.333,0,0,0.0,0,0,0,0,0,0,2,0,3,-2,1,ATL,IND,ATL,116,,,3,3,3,0
AJ Griffin,F,22023,1631100,22300296,"DEC 11, 2023",ATL vs. DEN,L,9,0,1,0.0,0,1,0.0,0,0,0.0,0,2,2,1,0,0,0,1,0,1,1,ATL,ATL,DEN,122,,,3,2,1,3
AJ Griffin,F,22023,1631100,22300055,"NOV 28, 2023",ATL @ CLE,L,15,0,8,0.0,0,4,0.0,0,0,0.0,1,0,1,0,0,0,0,1,0,-2,1,ATL,CLE,ATL,105,,,1,1,0,1
AJ Griffin,F,22023,1631100,22300246,"NOV 26, 2023",ATL @ BOS,L,12,0,5,0.0,0,3,0.0,0,0,0.0,0,4,4,1,0,0,0,0,0,7,1,ATL,BOS,ATL,103,,,5,4,1,5
AJ Griffin,F,22023,1631100,22300241,"NOV 25, 2023",ATL @ WAS,W,6,2,3,0.667,2,3,0.667,0,0,0.0,0,0,0,0,0,0,0,0,6,-4,1,ATL,WAS,ATL,136,,,6,6,6,0
AJ Griffin,F,22023,1631100,22300227,"NOV 22, 2023",ATL vs. BKN,W,3,0,0,0.0,0,0,0.0,0,0,0.0,0,0,0,0,0,0,0,0,0,10,1,ATL,ATL,BKN,147,,,0,0,0,0
AJ Griffin,F,22023,1631100,22300018,"NOV 14, 2023",ATL @ DET,W,8,1,3,0.333,1,3,0.333,2,2,1.0,0,0,0,0,0,0,0,2,5,1,1,ATL,DET,ATL,126,,,5,5,5,0
AJ Griffin,F,22023,1631100,22300172,"NOV 09, 2023",ATL @ ORL,W,10,1,2,0.5,0,1,0.0,0,0,0.0,0,0,0,0,0,0,2,1,2,-11,1,ATL,ORL,ATL,120,,,2,2,2,0
AJ Griffin,F,22023,1631100,22300117,"NOV 01, 2023",ATL vs. WAS,W,12,0,2,0.0,0,2,0.0,0,0,0.0,0,0,0,0,0,0,0,0,0,-14,1,ATL,ATL,WAS,130,,,0,0,0,0
AJ Griffin,F,22023,1631100,22300104,"OCT 30, 2023",ATL vs. MIN,W,6,1,1,1.0,1,1,1.0,0,0,0.0,0,0,0,1,0,0,0,0,3,-8,1,ATL,ATL,MIN,127,,,4,3,4,1
AJ Griffin,F,22023,1631100,22300097,"OCT 29, 2023",ATL @ MIL,W,10,2,3,0.667,2,2,1.0,0,0,0.0,1,0,1,1,1,0,1,0,6,-7,1,ATL,MIL,ATL,127,,,8,7,7,2
AJ Griffin,F,22023,1631100,22300079,"OCT 27, 2023",ATL vs. NYK,L,8,2,4,0.5,2,4,0.5,0,0,0.0,0,2,2,0,0,0,0,0,6,-4,1,ATL,ATL,NYK,120,,,8,8,6,2
AJ Griffin,F,22023,1631100,22300063,"OCT 25, 2023",ATL @ CHA,L,10,1,2,0.5,0,1,0.0,0,0,0.0,0,2,2,0,0,0,1,1,2,2,1,ATL,CHA,ATL,110,,,4,4,2,2
Collin Gillespie,G,22023,1631221,22300746,"FEB 09, 2024",DEN @ SAC,L,9,1,2,0.5,0,1,0.0,1,2,0.5,0,1,1,1,0,0,0,1,3,-2,1,DEN,SAC,DEN,106,,,5,4,4,2
Collin Gillespie,G,22023,1631221,22300697,"FEB 02, 2024",DEN vs. POR,W,1,1,1,1.0,0,0,0.0,0,0,0.0,0,0,0,0,0,0,0,0,2,2,1,DEN,DEN,POR,120,,,2,2,2,0
Collin Gillespie,G,22023,1631221,22300539,"JAN 12, 2024",DEN vs. NOP,W,2,1,1,1.0,0,0,0.0,0,0,0.0,0,0,0,0,0,0,0,1,2,-6,1,DEN,DEN,NOP,125,,,2,2,2,0
Collin Gillespie,G,22023,1631221,22300524,"JAN 10, 2024",DEN @ UTA,L,6,2,3,0.667,1,1,1.0,3,4,0.75,0,1,1,1,0,0,0,0,8,12,1,DEN,UTA,DEN,111,,,10,9,9,2
Collin Gillespie,G,22023,1631221,22300502,"JAN 07, 2024",DEN vs. DET,W,2,0,0,0.0,0,0,0.0,0,0,0.0,0,0,0,0,0,0,1,1,0,-6,1,DEN,DEN,DET,131,,,0,0,0,0
Collin Gillespie,G,22023,1631221,22300356,"DEC 18, 2023",DEN vs. DAL,W,5,0,1,0.0,0,0,0.0,0,0,0.0,1,0,1,0,0,0,0,1,0,-6,1,DEN,DEN,DAL,130,,,1,1,0,1
Collin Gillespie,G,22023,1631221,22300263,"NOV 29, 2023",DEN vs. HOU,W,3,0,1,0.0,0,1,0.0,0,0,0.0,0,0,0,0,0,0,1,0,0,-9,1,DEN,DEN,HOU,134,,,0,0,0,0
Collin Gillespie,G,22023,1631221,22300252,"NOV 26, 2023",DEN vs. SAS,W,2,0,0,0.0,0,0,0.0,0,0,0.0,0,0,0,0,0,0,0,0,0,-4,1,DEN,DEN,SAS,132,,,0,0,0,0
Collin Gillespie,G,22023,1631221,22300048,"NOV 24, 2023",DEN @ HOU,L,3,0,0,0.0,0,0,0.0,0,0,0.0,0,0,0,0,0,0,1,0,0,-7,1,DEN,HOU,DEN,86,,,0,0,0,0
Collin Gillespie,G,22023,1631221,22300210,"NOV 19, 2023",DEN @ CLE,L,3,0,0,0.0,0,0,0.0,0,0,0.0,0,0,0,1,0,0,0,0,0,10,1,DEN,CLE,DEN,109,,,1,0,1,1
Collin Gillespie,G,22023,1631221,22300182,"NOV 12, 2023",DEN @ HOU,L,20,3,7,0.429,0,2,0.0,0,0,0.0,0,1,1,3,2,0,1,2,6,0,1,DEN,HOU,DEN,104,,,10,7,9,4
Collin Gillespie,G,22023,1631221,22300169,"NOV 08, 2023",DEN vs. GSW,W,16,1,2,0.5,1,2,0.5,0,0,0.0,0,0,0,1,0,0,1,2,3,-10,1,DEN,DEN,GSW,108,,,4,3,4,1
Collin Gillespie,G,22023,1631221,22300156,"NOV 06, 2023",DEN vs. NOP,W,17,2,4,0.5,1,3,0.333,1,1,1.0,0,1,1,1,2,0,0,3,6,-1,1,DEN,DEN,NOP,134,,,8,7,7,2
Collin Gillespie,G,22023,1631221,22300139,"NOV 04, 2023",DEN vs. CHI,W,12,2,4,0.5,1,3,0.333,0,0,0.0,0,1,1,2,0,0,0,1,5,12,1,DEN,DEN,CHI,123,,,8,6,7,3
Collin Gillespie,G,22023,1631221,22300095,"OCT 29, 2023",DEN @ OKC,W,6,0,1,0.0,0,1,0.0,0,0,0.0,0,0,0,0,1,0,0,1,0,2,1,DEN,OKC,DEN,128,,,0,0,0,0
Collin Gillespie,G,22023,1631221,22300061,"OCT 24, 2023",DEN vs. LAL,W,1,0,0,0.0,0,0,0.0,0,0,0.0,0,0,0,0,0,0,0,0,0,0,1,DEN,DEN,LAL,119,,,0,0,0,0
P.J. Tucker,F,22023,200782,22300098,"OCT 29, 2023",PHI vs. POR,W,20,1,2,0.5,1,2,0.5,0,0,0.0,0,4,4,0,1,2,1,1,3,26,1,PHI,PHI,POR,126,,,7,7,3,4
P.J. Tucker,F,22023,200782,22300092,"OCT 28, 2023",PHI @ TOR,W,21,1,1,1.0,1,1,1.0,0,0,0.0,0,3,3,0,0,0,1,3,3,0,1,PHI,TOR,PHI,114,,,6,6,3,3
P.J. Tucker,F,22023,200782,22300075,"OCT 26, 2023",PHI @ MIL,L,26,0,2,0.0,0,2,0.0,0,0,0.0,1,6,7,0,2,0,0,5,0,2,1,PHI,MIL,PHI,117,,,7,7,0,7
P.J. Tucker,F,22023,200782,22300244,"NOV 25, 2023",LAC vs. DAL,W,8,0,0,0.0,0,0,0.0,0,0,0.0,0,1,1,0,0,0,0,2,0,3,1,LAC,LAC,DAL,107,,,1,1,0,1
P.J. Tucker,F,22023,200782,22300014,"NOV 10, 2023",LAC @ DAL,L,6,0,1,0.0,0,1,0.0,0,0,0.0,0,1,1,0,0,0,0,2,0,-20,1,LAC,DAL,LAC,126,,,1,1,0,1
P.J. Tucker,F,22023,200782,22300151,"NOV 06, 2023",LAC @ NYK,L,11,0,2,0.0,0,2,0.0,2,2,1.0,1,0,1,0,1,0,0,1,2,-9,1,LAC,NYK,LAC,97,,,3,3,2,1
P.J. Tucker,F,22023,200782,22300127,"NOV 01, 2023",LAC @ LAL,L,21,0,1,0.0,0,0,0.0,0,0,0.0,5,0,5,0,0,0,0,4,0,-15,1,LAC,LAL,LAC,125,,,5,5,0,5
P.J. Tucker,F,22023,200782,22300235,"NOV 22, 2023",LAC @ SAS,W,13,0,0,0.0,0,0,0.0,0,0,0.0,1,0,1,0,0,0,1,2,0,9,1,LAC,SAS,LAC,109,,,1,1,0,1
P.J. Tucker,F,22023,200782,22300223,"NOV 20, 2023",LAC @ SAS,W,16,0,0,0.0,0,0,0.0,0,0,0.0,0,5,5,0,0,0,0,2,0,5,1,LAC,SAS,LAC,124,,,5,5,0,5
P.J. Tucker,F,22023,200782,22300179,"NOV 12, 2023",LAC vs. MEM,L,13,1,2,0.5,1,2,0.5,0,0,0.0,1,1,2,1,1,0,0,1,3,5,1,LAC,LAC,MEM,101,,,6,5,4,3
P.J. Tucker,F,22023,200782,22300257,"NOV 27, 2023",LAC vs. DEN,L,6,0,0,0.0,0,0,0.0,0,0,0.0,0,0,0,1,2,0,0,1,0,3,1,LAC,LAC,DEN,104,,,1,0,1,1
P.J. Tucker,F,22023,200782,22300052,"NOV 24, 2023",LAC vs. NOP,L,22,0,2,0.0,0,2,0.0,0,0,0.0,2,0,2,3,1,0,0,4,0,7,1,LAC,LAC,NOP,106,,,5,2,3,5
P.J. Tucker,F,22023,200782,22300037,"NOV 17, 2023",LAC vs. HOU,W,15,0,0,0.0,0,0,0.0,0,0,0.0,0,0,0,0,0,0,0,3,0,-24,1,LAC,LAC,HOU,106,,,0,0,0,0
P.J. Tucker,F,22023,200782,22300024,"NOV 14, 2023",LAC @ DEN,L,21,2,3,0.667,2,3,0.667,0,0,0.0,2,3,5,0,0,0,1,1,6,-7,1,LAC,DEN,LAC,108,,,11,11,6,5
P.J. Tucker,F,22023,200782,22300160,"NOV 08, 2023",LAC @ BKN,L,21,1,3,0.333,0,1,0.0,1,1,1.0,3,3,6,3,1,1,0,3,3,10,1,LAC,BKN,LAC,93,,,12,9,6,9
P.J. Tucker,F,22023,200782,22300098,"OCT 29, 2023",PHI vs. POR,W,20,1,2,0.5,1,2,0.5,0,0,0.0,0,4,4,0,1,2,1,1,3,26,1,PHI,PHI,POR,126,,,7,7,3,4
P.J. Tucker,F,22023,200782,22300092,"OCT 28, 2023",PHI @ TOR,W,21,1,1,1.0,1,1,1.0,0,0,0.0,0,3,3,0,0,0,1,3,3,0,1,PHI,TOR,PHI,114,,,6,6,3,3
P.J. Tucker,F,22023,200782,22300075,"OCT 26, 2023",PHI @ MIL,L,26,0,2,0.0,0,2,0.0,0,0,0.0,1,6,7,0,2,0,0,5,0,2,1,PHI,MIL,PHI,117,,,7,7,0,7
P.J. Tucker,F,22023,200782,22300244,"NOV 25, 2023",LAC vs. DAL,W,8,0,0,0.0,0,0,0.0,0,0,0.0,0,1,1,0,0,0,0,2,0,3,1,LAC,LAC,DAL,107,,,1,1,0,1
P.J. Tucker,F,22023,200782,22300014,"NOV 10, 2023",LAC @ DAL,L,6,0,1,0.0,0,1,0.0,0,0,0.0,0,1,1,0,0,0,0,2,0,-20,1,LAC,DAL,LAC,126,,,1,1,0,1
P.J. Tucker,F,22023,200782,22300151,"NOV 06, 2023",LAC @ NYK,L,11,0,2,0.0,0,2,0.0,2,2,1.0,1,0,1,0,1,0,0,1,2,-9,1,LAC,NYK,LAC,97,,,3,3,2,1
P.J. Tucker,F,22023,200782,22300127,"NOV 01, 2023",LAC @ LAL,L,21,0,1,0.0,0,0,0.0,0,0,0.0,5,0,5,0,0,0,0,4,0,-15,1,LAC,LAL,LAC,125,,,5,5,0,5
P.J. Tucker,F,22023,200782,22300235,"NOV 22, 2023",LAC @ SAS,W,13,0,0,0.0,0,0,0.0,0,0,0.0,1,0,1,0,0,0,1,2,0,9,1,LAC,SAS,LAC,109,,,1,1,0,1
P.J. Tucker,F,22023,200782,22300223,"NOV 20, 2023",LAC @ SAS,W,16,0,0,0.0,0,0,0.0,0,0,0.0,0,5,5,0,0,0,0,2,0,5,1,LAC,SAS,LAC,124,,,5,5,0,5
P.J. Tucker,F,22023,200782,22300179,"NOV 12, 2023",LAC vs. MEM,L,13,1,2,0.5,1,2,0.5,0,0,0.0,1,1,2,1,1,0,0,1,3,5,1,LAC,LAC,MEM,101,,,6,5,4,3
P.J. Tucker,F,22023,200782,22300257,"NOV 27, 2023",LAC vs. DEN,L,6,0,0,0.0,0,0,0.0,0,0,0.0,0,0,0,1,2,0,0,1,0,3,1,LAC,LAC,DEN,104,,,1,0,1,1
P.J. Tucker,F,22023,200782,22300052,"NOV 24, 2023",LAC vs. NOP,L,22,0,2,0.0,0,2,0.0,0,0,0.0,2,0,2,3,1,0,0,4,0,7,1,LAC,LAC,NOP,106,,,5,2,3,5
P.J. Tucker,F,22023,200782,22300037,"NOV 17, 2023",LAC vs. HOU,W,15,0,0,0.0,0,0,0.0,0,0,0.0,0,0,0,0,0,0,0,3,0,-24,1,LAC,LAC,HOU,106,,,0,0,0,0
P.J. Tucker,F,22023,200782,22300024,"NOV 14, 2023",LAC @ DEN,L,21,2,3,0.667,2,3,0.667,0,0,0.0,2,3,5,0,0,0,1,1,6,-7,1,LAC,DEN,LAC,108,,,11,11,6,5
P.J. Tucker,F,22023,200782,22300160,"NOV 08, 2023",LAC @ BKN,L,21,1,3,0.333,0,1,0.0,1,1,1.0,3,3,6,3,1,1,0,3,3,10,1,LAC,BKN,LAC,93,,,12,9,6,9
Damian Jones,C,22023,1627745,22300756,"FEB 10, 2024",CLE @ TOR,W,3,0,0,0.0,0,0,0.0,0,0,0.0,0,0,0,1,0,0,0,0,0,3,1,CLE,TOR,CLE,119,,,1,0,1,1
Damian Jones,C,22023,1627745,22300735,"FEB 08, 2024",CLE @ BKN,W,3,0,0,0.0,0,0,0.0,0,0,0.0,0,1,1,2,0,1,0,0,0,4,1,CLE,BKN,CLE,118,,,3,1,2,3
Damian Jones,C,22023,1627745,22300714,"FEB 05, 2024",CLE vs. SAC,W,3,0,0,0.0,0,0,0.0,0,0,0.0,0,1,1,1,0,1,1,1,0,0,1,CLE,CLE,SAC,136,,,2,1,1,2
Damian Jones,C,22023,1627745,22300703,"FEB 03, 2024",CLE @ SAS,W,2,0,0,0.0,0,0,0.0,0,0,0.0,0,0,0,0,0,0,0,0,0,-1,1,CLE,SAS,CLE,117,,,0,0,0,0
Damian Jones,C,22023,1627745,22300687,"FEB 01, 2024",CLE @ MEM,W,15,2,4,0.5,0,0,0.0,3,3,1.0,2,4,6,1,0,3,2,2,7,-5,1,CLE,MEM,CLE,108,,,14,13,8,7
Damian Jones,C,22023,1627745,22300639,"JAN 26, 2024",CLE @ MIL,W,12,1,3,0.333,0,1,0.0,2,2,1.0,3,4,7,1,0,2,1,2,4,0,1,CLE,MIL,CLE,112,,,12,11,5,8
Damian Jones,C,22023,1627745,22300624,"JAN 24, 2024",CLE @ MIL,L,10,2,2,1.0,0,0,0.0,1,1,1.0,0,0,0,2,0,0,0,0,5,3,1,CLE,MIL,CLE,116,,,7,5,7,2
Damian Jones,C,22023,1627745,22300607,"JAN 22, 2024",CLE @ ORL,W,9,2,3,0.667,1,2,0.5,2,2,1.0,0,1,1,0,1,0,0,1,7,-4,1,CLE,ORL,CLE,126,,,8,8,7,1
Damian Jones,C,22023,1627745,22300595,"JAN 20, 2024",CLE @ ATL,W,3,0,0,0.0,0,0,0.0,0,0,0.0,0,0,0,0,0,0,0,0,0,-1,1,CLE,ATL,CLE,116,,,0,0,0,0
Damian Jones,C,22023,1627745,22300572,"JAN 17, 2024",CLE vs. MIL,W,10,0,3,0.0,0,1,0.0,0,0,0.0,0,1,1,0,0,0,0,1,0,-5,1,CLE,CLE,MIL,135,,,1,1,0,1
Damian Jones,C,22023,1627745,22300482,"JAN 05, 2024",CLE vs. WAS,W,5,1,1,1.0,0,0,0.0,0,0,0.0,0,1,1,0,0,0,0,0,2,1,1,CLE,CLE,WAS,114,,,3,3,2,1
Damian Jones,C,22023,1627745,22300465,"JAN 03, 2024",CLE vs. WAS,W,6,2,3,0.667,0,1,0.0,0,0,0.0,0,1,1,0,0,1,0,0,4,-1,1,CLE,CLE,WAS,140,,,5,5,4,1
Damian Jones,C,22023,1627745,22300396,"DEC 23, 2023",CLE @ CHI,W,12,2,4,0.5,1,2,0.5,1,1,1.0,0,2,2,1,1,0,1,5,6,16,1,CLE,CHI,CLE,109,,,9,8,7,3
Damian Jones,C,22023,1627745,22300375,"DEC 21, 2023",CLE vs. NOP,L,4,1,1,1.0,0,0,0.0,0,0,0.0,0,1,1,0,0,0,0,0,2,2,1,CLE,CLE,NOP,104,,,3,3,2,1
Damian Jones,C,22023,1627745,22301220,"DEC 08, 2023",CLE @ MIA,W,3,0,0,0.0,0,0,0.0,0,0,0.0,0,1,1,0,0,0,1,1,0,-12,1,CLE,MIA,CLE,111,,,1,1,0,1
Damian Jones,C,22023,1627745,22300229,"NOV 22, 2023",CLE vs. MIA,L,12,1,5,0.2,0,0,0.0,0,0,0.0,2,1,3,1,1,1,1,0,2,-11,1,CLE,CLE,MIA,96,,,6,5,3,4
Damian Jones,C,22023,1627745,22300210,"NOV 19, 2023",CLE vs. DEN,W,3,0,0,0.0,0,0,0.0,0,0,0.0,0,0,0,0,0,0,0,0,0,-10,1,CLE,CLE,DEN,121,,,0,0,0,0
Damian Jones,C,22023,1627745,22300030,"NOV 17, 2023",CLE vs. DET,W,1,0,0,0.0,0,0,0.0,0,0,0.0,0,0,0,0,0,0,0,0,0,-2,1,CLE,CLE,DET,108,,,0,0,0,0
Damian Jones,C,22023,1627745,22300199,"NOV 15, 2023",CLE @ POR,W,2,0,0,0.0,0,0,0.0,0,0,0.0,0,0,0,0,0,0,0,0,0,0,1,CLE,POR,CLE,109,,,0,0,0,0
Damian Jones,C,22023,1627745,22300176,"NOV 11, 2023",CLE @ GSW,W,1,0,0,0.0,0,0,0.0,0,0,0.0,0,0,0,0,0,0,0,0,0,-6,1,CLE,GSW,CLE,118,,,0,0,0,0
Damian Jones,C,22023,1627745,22300142,"NOV 05, 2023",CLE vs. GSW,W,1,0,0,0.0,0,0,0.0,0,0,0.0,0,0,0,0,0,0,0,0,0,-2,1,CLE,CLE,GSW,115,,,0,0,0,0
Damian Jones,C,22023,1627745,22300112,"OCT 31, 2023",CLE vs. NYK,L,5,1,1,1.0,0,0,0.0,0,0,0.0,0,1,1,0,0,0,0,0,2,2,1,CLE,CLE,NYK,91,,,3,3,2,1
Damian Jones,C,22023,1627745,22300091,"OCT 28, 2023",CLE vs. IND,L,6,0,0,0.0,0,0,0.0,0,0,0.0,2,1,3,0,0,0,0,0,0,-1,1,CLE,CLE,IND,113,,,3,3,0,3
Damian Jones,C,22023,1627745,22300067,"OCT 25, 2023",CLE @ BKN,W,11,2,2,1.0,0,0,0.0,0,0,0.0,0,0,0,2,0,0,2,3,4,-7,1,CLE,BKN,CLE,114,,,6,4,6,2
Damian Jones,C,22023,1627745,22300081,"OCT 27, 2023",CLE vs. OKC,L,10,0,0,0.0,0,0,0.0,1,2,0.5,0,3,3,0,0,1,0,0,1,5,1,CLE,CLE,OKC,105,,,4,4,1,3
Lindell Wigginton,G,22023,1629623,22300346,"DEC 17, 2023",MIL vs. HOU,W,0,0,0,0.0,0,0,0.0,0,0,0.0,0,0,0,0,0,0,0,0,0,-3,1,MIL,MIL,HOU,128,,,0,0,0,0
Lindell Wigginton,G,22023,1629623,22300334,"DEC 16, 2023",MIL vs. DET,W,5,2,4,0.5,0,1,0.0,2,2,1.0,0,0,0,0,0,0,0,0,6,0,1,MIL,MIL,DET,146,,,6,6,6,0
Lindell Wigginton,G,22023,1629623,22300195,"NOV 15, 2023",MIL @ TOR,W,2,0,1,0.0,0,1,0.0,0,0,0.0,0,0,0,0,0,0,1,1,0,-7,1,MIL,TOR,MIL,128,,,0,0,0,0
Moses Brown,C,22023,1629650,22300323,"DEC 14, 2023",POR vs. UTA,L,5,0,0,0.0,0,0,0.0,0,0,0.0,0,1,1,0,0,0,0,0,0,-6,1,POR,POR,UTA,114,,,1,1,0,1
Moses Brown,C,22023,1629650,22300041,"NOV 21, 2023",POR @ PHX,L,2,0,1,0.0,0,0,0.0,0,0,0.0,1,0,1,0,0,0,0,0,0,3,1,POR,PHX,POR,107,,,1,1,0,1
Moses Brown,C,22023,1629650,22300215,"NOV 19, 2023",POR vs. OKC,L,7,1,1,1.0,0,0,0.0,0,0,0.0,1,0,1,0,1,0,0,0,2,-4,1,POR,POR,OKC,89,,,3,3,2,1
Moses Brown,C,22023,1629650,22300170,"NOV 08, 2023",POR @ SAC,L,5,2,3,0.667,0,0,0.0,0,2,0.0,2,1,3,1,0,1,0,1,4,-8,1,POR,SAC,POR,118,,,8,7,5,4
Moses Brown,C,22023,1629650,22300456,"JAN 01, 2024",POR @ PHX,L,16,1,2,0.5,0,0,0.0,0,0,0.0,0,6,6,1,0,1,2,2,2,-5,1,POR,PHX,POR,84,,,9,8,3,7
Moses Brown,C,22023,1629650,22300437,"DEC 29, 2023",POR vs. SAS,W,4,0,0,0.0,0,0,0.0,0,0,0.0,0,4,4,0,0,0,0,1,0,-2,1,POR,POR,SAS,132,,,4,4,0,4
Moses Brown,C,22023,1629650,22300427,"DEC 28, 2023",POR vs. SAS,L,14,2,6,0.333,0,0,0.0,0,0,0.0,5,2,7,0,0,0,0,3,4,-8,1,POR,POR,SAS,98,,,11,11,4,7
Moses Brown,C,22023,1629650,22300413,"DEC 26, 2023",POR vs. SAC,W,14,0,1,0.0,0,0,0.0,0,2,0.0,5,6,11,0,1,1,1,3,0,-5,1,POR,POR,SAC,130,,,11,11,0,11
Moses Brown,C,22023,1629650,22300304,"DEC 11, 2023",POR @ LAC,L,16,3,7,0.429,0,0,0.0,0,0,0.0,4,8,12,0,0,0,1,1,6,1,1,POR,LAC,POR,127,,,18,18,6,12
Ty Jerome,G-F,22023,1629660,22300067,"OCT 25, 2023",CLE @ BKN,W,6,1,1,1.0,0,0,0.0,0,0,0.0,0,0,0,0,0,0,0,1,2,-7,1,CLE,BKN,CLE,114,,,2,2,2,0
Ty Jerome,G-F,22023,1629660,22300081,"OCT 27, 2023",CLE vs. OKC,L,9,1,3,0.333,0,1,0.0,0,0,0.0,1,0,1,3,0,0,1,1,2,-7,1,CLE,CLE,OKC,105,,,6,3,5,4
Jordan Ford,G,22023,1630259,22300309,"DEC 12, 2023",SAC @ LAC,L,8,2,2,1.0,1,1,1.0,0,0,0.0,0,1,1,1,0,0,1,0,5,12,1,SAC,LAC,SAC,99,,,7,6,6,2
Jordan Ford,G,22023,1630259,22300264,"NOV 29, 2023",SAC vs. LAC,L,1,0,0,0.0,0,0,0.0,0,0,0.0,0,0,0,0,0,0,0,0,0,0,1,SAC,SAC,LAC,117,,,0,0,0,0
Jordan Ford,G,22023,1630259,22300191,"NOV 13, 2023",SAC vs. CLE,W,1,0,1,0.0,0,1,0.0,0,0,0.0,0,0,0,0,0,0,0,0,0,-5,1,SAC,SAC,CLE,132,,,0,0,0,0
Jordan Ford,G,22023,1630259,22300153,"NOV 06, 2023",SAC @ HOU,L,8,2,3,0.667,1,1,1.0,0,0,0.0,0,1,1,1,0,0,0,0,5,9,1,SAC,HOU,SAC,97,,,7,6,6,2
Jordan Ford,G,22023,1630259,22300137,"NOV 04, 2023",SAC @ HOU,L,1,0,0,0.0,0,0,0.0,2,2,1.0,0,0,0,0,0,0,0,0,2,0,1,SAC,HOU,SAC,89,,,2,2,2,0
Jordan Ford,G,22023,1630259,22300072,"OCT 25, 2023",SAC @ UTA,W,1,0,1,0.0,0,0,0.0,0,0,0.0,0,0,0,0,0,0,0,0,0,-2,1,SAC,UTA,SAC,130,,,0,0,0,0
Joshua Primo,G,22023,1630563,22300343,"DEC 16, 2023",LAC vs. NYK,W,5,1,2,0.5,0,1,0.0,0,0,0.0,0,0,0,0,0,1,3,0,2,-2,1,LAC,LAC,NYK,144,,,2,2,2,0
Olivier Sarr,C,22023,1630846,22300397,"DEC 23, 2023",OKC vs. LAL,L,3,0,0,0.0,0,0,0.0,0,0,0.0,1,1,2,1,0,0,0,1,0,-1,1,OKC,OKC,LAL,120,,,3,2,1,3
Olivier Sarr,C,22023,1630846,22300215,"NOV 19, 2023",OKC @ POR,W,10,2,5,0.4,2,3,0.667,0,0,0.0,1,1,2,0,0,0,0,4,6,10,1,OKC,POR,OKC,134,,,8,8,6,2
Olivier Sarr,C,22023,1630846,22300109,"OCT 30, 2023",OKC vs. DET,W,21,0,0,0.0,0,0,0.0,2,4,0.5,1,8,9,1,0,3,0,2,2,9,1,OKC,OKC,DET,124,,,12,11,3,10
Olivier Sarr,C,22023,1630846,22300748,"FEB 10, 2024",OKC @ DAL,L,8,3,4,0.75,0,0,0.0,2,3,0.667,2,1,3,0,0,0,0,0,8,-5,1,OKC,DAL,OKC,111,,,11,11,8,3
Olivier Sarr,C,22023,1630846,22300695,"FEB 02, 2024",OKC vs. CHA,W,8,1,2,0.5,0,1,0.0,1,2,0.5,1,3,4,0,0,1,1,2,3,-10,1,OKC,OKC,CHA,126,,,7,7,3,4
Olivier Sarr,C,22023,1630846,22300568,"JAN 16, 2024",OKC @ LAC,L,1,0,0,0.0,0,0,0.0,0,0,0.0,0,0,0,0,0,0,0,0,0,0,1,OKC,LAC,OKC,117,,,0,0,0,0
Olivier Sarr,C,22023,1630846,22300355,"DEC 18, 2023",OKC vs. MEM,W,7,3,5,0.6,0,2,0.0,0,0,0.0,1,2,3,0,0,0,0,3,6,-12,1,OKC,OKC,MEM,116,,,9,9,6,3
Olivier Sarr,C,22023,1630846,22300121,"NOV 01, 2023",OKC vs. NOP,L,7,0,0,0.0,0,0,0.0,0,0,0.0,1,4,5,0,0,2,1,1,0,-4,1,OKC,OKC,NOP,106,,,5,5,0,5
Olivier Sarr,C,22023,1630846,22300095,"OCT 29, 2023",OKC vs. DEN,L,6,0,0,0.0,0,0,0.0,0,0,0.0,0,0,0,0,0,0,0,0,0,-2,1,OKC,OKC,DEN,95,,,0,0,0,0
Olivier Sarr,C,22023,1630846,22300070,"OCT 25, 2023",OKC @ CHI,W,11,1,1,1.0,0,0,0.0,2,2,1.0,1,3,4,0,0,0,1,3,4,6,1,OKC,CHI,OKC,124,,,8,8,4,4
Olivier Sarr,C,22023,1630846,22300654,"JAN 28, 2024",OKC @ DET,L,6,0,1,0.0,0,0,0.0,0,0,0.0,1,0,1,0,0,0,0,1,0,1,1,OKC,DET,OKC,104,,,1,1,0,1
Olivier Sarr,C,22023,1630846,22300435,"DEC 29, 2023",OKC @ DEN,W,3,0,0,0.0,0,0,0.0,2,2,1.0,0,1,1,0,0,0,0,0,2,3,1,OKC,DEN,OKC,119,,,3,3,2,1
Kendall Brown,G,22023,1631112,22300533,"JAN 12, 2024",IND @ ATL,W,4,0,0,0.0,0,0,0.0,0,0,0.0,0,0,0,0,0,0,0,1,0,-2,1,IND,ATL,IND,126,,,0,0,0,0
Kendall Brown,G,22023,1631112,22300707,"FEB 04, 2024",IND @ CHA,W,2,1,1,1.0,0,0,0.0,0,0,0.0,0,0,0,1,0,0,0,0,2,0,1,IND,CHA,IND,115,,,3,2,3,1
Kendall Brown,G,22023,1631112,22300627,"JAN 25, 2024",IND vs. PHI,W,2,0,0,0.0,0,0,0.0,0,0,0.0,0,0,0,0,0,0,0,0,0,-6,1,IND,IND,PHI,134,,,0,0,0,0
Kendall Brown,G,22023,1631112,22300564,"JAN 15, 2024",IND @ UTA,L,12,2,5,0.4,0,1,0.0,4,6,0.667,2,0,2,1,0,0,0,3,8,-1,1,IND,UTA,IND,105,,,11,10,9,3
Kendall Brown,G,22023,1631112,22300493,"JAN 06, 2024",IND vs. BOS,L,1,0,0,0.0,0,0,0.0,0,0,0.0,0,0,0,0,0,0,0,0,0,0,1,IND,IND,BOS,101,,,0,0,0,0
D'Moi Hodge,G,22023,1641793,22300331,"DEC 15, 2023",LAL @ SAS,L,8,2,3,0.667,1,2,0.5,0,0,0.0,0,0,0,3,0,0,0,0,5,5,1,LAL,SAS,LAL,115,,,8,5,8,3
D'Moi Hodge,G,22023,1641793,22300271,"NOV 30, 2023",LAL @ OKC,L,4,0,1,0.0,0,1,0.0,0,0,0.0,0,0,0,0,0,0,0,0,0,-5,1,LAL,OKC,LAL,110,,,0,0,0,0
D'Moi Hodge,G,22023,1641793,22300163,"NOV 08, 2023",LAL @ HOU,L,10,1,3,0.333,0,2,0.0,1,2,0.5,0,0,0,1,0,1,1,1,3,-4,1,LAL,HOU,LAL,94,,,4,3,4,1
D'Moi Hodge,G,22023,1641793,22300134,"NOV 04, 2023",LAL @ ORL,L,4,0,2,0.0,0,2,0.0,0,0,0.0,0,0,0,0,0,0,0,1,0,-3,1,LAL,ORL,LAL,101,,,0,0,0,0
D'Moi Hodge,G,22023,1641793,22300258,"NOV 29, 2023",LAL @ DET,W,5,1,3,0.333,1,2,0.5,0,0,0.0,0,0,0,0,1,0,0,1,3,-7,1,LAL,DET,LAL,133,,,3,3,3,0
D'Moi Hodge,G,22023,1641793,22300255,"NOV 27, 2023",LAL @ PHI,L,8,1,3,0.333,1,3,0.333,0,0,0.0,0,0,0,1,0,0,0,1,3,-17,1,LAL,PHI,LAL,94,,,4,3,4,1
D'Moi Hodge,G,22023,1641793,22300198,"NOV 15, 2023",LAL vs. SAC,L,1,0,0,0.0,0,0,0.0,0,0,0.0,0,0,0,0,0,0,0,0,0,-4,1,LAL,LAL,SAC,110,,,0,0,0,0
Markquis Nowell,G,22023,1641806,22300195,"NOV 15, 2023",TOR vs. MIL,L,4,0,1,0.0,0,0,0.0,2,2,1.0,2,0,2,2,1,0,0,0,2,4,1,TOR,TOR,MIL,112,,,6,4,4,4
Cody Zeller,F-C,22023,203469,22300731,"FEB 07, 2024",NOP @ LAC,W,2,0,0,0.0,0,0,0.0,0,0,0.0,0,1,1,0,1,0,1,0,0,-2,1,NOP,LAC,NOP,117,,,1,1,0,1
Cody Zeller,F-C,22023,203469,22300718,"FEB 05, 2024",NOP vs. TOR,W,5,1,2,0.5,0,0,0.0,0,0,0.0,0,2,2,0,0,0,0,0,2,2,1,NOP,NOP,TOR,138,,,4,4,2,2
Cody Zeller,F-C,22023,203469,22300696,"FEB 02, 2024",NOP @ SAS,W,8,0,0,0.0,0,0,0.0,0,0,0.0,1,1,2,1,2,0,1,1,0,6,1,NOP,SAS,NOP,114,,,3,2,1,3
Cody Zeller,F-C,22023,203469,22300648,"JAN 27, 2024",NOP @ MIL,L,7,0,1,0.0,0,0,0.0,1,2,0.5,0,3,3,0,0,0,0,0,1,5,1,NOP,MIL,NOP,117,,,4,4,1,3
Cody Zeller,F-C,22023,203469,22300640,"JAN 26, 2024",NOP vs. OKC,L,3,0,0,0.0,0,0,0.0,0,0,0.0,0,1,1,0,0,0,0,0,0,-1,1,NOP,NOP,OKC,83,,,1,1,0,1
Cody Zeller,F-C,22023,203469,22300616,"JAN 23, 2024",NOP vs. UTA,W,5,1,1,1.0,0,0,0.0,0,0,0.0,2,2,4,2,0,0,0,2,2,3,1,NOP,NOP,UTA,153,,,8,6,4,6
Cody Zeller,F-C,22023,203469,22300588,"JAN 19, 2024",NOP vs. PHX,L,4,0,0,0.0,0,0,0.0,0,0,0.0,1,1,2,0,1,1,0,0,0,10,1,NOP,NOP,PHX,109,,,2,2,0,2
Cody Zeller,F-C,22023,203469,22300575,"JAN 17, 2024",NOP vs. CHA,W,3,0,0,0.0,0,0,0.0,0,0,0.0,1,0,1,0,0,0,0,0,0,-2,1,NOP,NOP,CHA,132,,,1,1,0,1
Cody Zeller,F-C,22023,203469,22300486,"JAN 05, 2024",NOP vs. LAC,L,6,0,1,0.0,0,1,0.0,1,2,0.5,1,2,3,2,0,0,0,3,1,12,1,NOP,NOP,LAC,95,,,6,4,3,5
Cody Zeller,F-C,22023,203469,22300471,"JAN 03, 2024",NOP @ MIN,W,2,0,0,0.0,0,0,0.0,0,0,0.0,1,0,1,1,0,0,0,0,0,-2,1,NOP,MIN,NOP,117,,,2,1,1,2
Cody Zeller,F-C,22023,203469,22300461,"JAN 02, 2024",NOP vs. BKN,W,8,1,3,0.333,0,0,0.0,2,3,0.667,1,1,2,0,0,0,0,2,4,0,1,NOP,NOP,BKN,112,,,6,6,4,2
Cody Zeller,F-C,22023,203469,22300410,"DEC 26, 2023",NOP vs. MEM,L,0,0,0,0.0,0,0,0.0,0,0,0.0,0,0,0,0,0,0,0,0,0,0,1,NOP,NOP,MEM,115,,,0,0,0,0
Cody Zeller,F-C,22023,203469,22300360,"DEC 19, 2023",NOP vs. MEM,L,13,1,3,0.333,0,0,0.0,2,2,1.0,4,2,6,1,0,1,1,1,4,-2,1,NOP,NOP,MEM,113,,,11,10,5,7
Cody Zeller,F-C,22023,203469,22300345,"DEC 17, 2023",NOP @ SAS,W,18,1,2,0.5,0,0,0.0,0,0,0.0,1,4,5,4,0,0,1,4,2,24,1,NOP,SAS,NOP,146,,,11,7,6,9
Cody Zeller,F-C,22023,203469,22300311,"DEC 13, 2023",NOP @ WAS,W,5,1,1,1.0,0,0,0.0,0,0,0.0,0,0,0,2,0,0,0,1,2,-4,1,NOP,WAS,NOP,142,,,4,2,4,2
Cody Zeller,F-C,22023,203469,22301230,"DEC 07, 2023",NOP @ LAL,L,12,0,1,0.0,0,0,0.0,2,2,1.0,1,1,2,1,0,0,0,2,2,-5,1,NOP,LAL,NOP,89,,,5,4,3,3
Cody Zeller,F-C,22023,203469,22301204,"DEC 04, 2023",NOP @ SAC,W,5,0,0,0.0,0,0,0.0,0,0,0.0,0,0,0,0,1,0,0,0,0,-1,1,NOP,SAC,NOP,127,,,0,0,0,0
Cody Zeller,F-C,22023,203469,22300285,"DEC 02, 2023",NOP @ CHI,L,12,1,4,0.25,0,0,0.0,2,2,1.0,3,1,4,0,0,0,0,2,4,-17,1,NOP,CHI,NOP,118,,,8,8,4,4
Cody Zeller,F-C,22023,203469,22300262,"NOV 29, 2023",NOP vs. PHI,W,13,0,3,0.0,0,0,0.0,1,2,0.5,0,1,1,0,1,0,2,4,1,-9,1,NOP,NOP,PHI,124,,,2,2,1,1
Cody Zeller,F-C,22023,203469,22300256,"NOV 27, 2023",NOP @ UTA,L,9,0,0,0.0,0,0,0.0,1,2,0.5,0,1,1,2,0,0,0,2,1,0,1,NOP,UTA,NOP,112,,,4,2,3,3
Cody Zeller,F-C,22023,203469,22300243,"NOV 25, 2023",NOP @ UTA,L,21,2,2,1.0,0,0,0.0,0,0,0.0,2,4,6,5,0,1,0,0,4,14,1,NOP,UTA,NOP,100,,,15,10,9,11
Cody Zeller,F-C,22023,203469,22300233,"NOV 22, 2023",NOP vs. SAC,W,8,0,2,0.0,0,0,0.0,0,0,0.0,2,1,3,0,0,0,0,2,0,7,1,NOP,NOP,SAC,117,,,3,3,0,3
Cody Zeller,F-C,22023,203469,22300222,"NOV 20, 2023",NOP vs. SAC,W,23,4,7,0.571,0,1,0.0,1,4,0.25,3,6,9,2,0,0,1,2,9,12,1,NOP,NOP,SAC,129,,,20,18,11,11
Cody Zeller,F-C,22023,203469,22300525,"JAN 10, 2024",NOP @ GSW,W,8,3,3,1.0,0,0,0.0,0,0,0.0,2,1,3,1,0,0,1,2,6,1,1,NOP,GSW,NOP,141,,,10,9,7,4
Cody Zeller,F-C,22023,203469,22300500,"JAN 07, 2024",NOP @ SAC,W,7,2,3,0.667,1,1,1.0,2,2,1.0,1,1,2,1,0,0,2,0,7,-5,1,NOP,SAC,NOP,133,,,10,9,8,3
Cody Zeller,F-C,22023,203469,22300278,"DEC 01, 2023",NOP vs. SAS,W,13,0,0,0.0,0,0,0.0,2,2,1.0,1,2,3,1,0,0,0,1,2,2,1,NOP,NOP,SAS,121,,,6,5,3,4
Cody Zeller,F-C,22023,203469,22300203,"NOV 18, 2023",NOP vs. MIN,L,13,1,4,0.25,0,0,0.0,0,0,0.0,3,4,7,0,1,0,1,3,2,3,1,NOP,NOP,MIN,120,,,9,9,2,7
Cody Zeller,F-C,22023,203469,22300034,"NOV 17, 2023",NOP vs. DEN,W,2,0,0,0.0,0,0,0.0,0,0,0.0,0,1,1,0,0,1,0,0,0,3,1,NOP,NOP,DEN,115,,,1,1,0,1
Cody Zeller,F-C,22023,203469,22300022,"NOV 14, 2023",NOP vs. DAL,W,5,0,1,0.0,0,0,0.0,0,2,0.0,1,2,3,0,0,0,1,0,0,1,1,NOP,NOP,DAL,131,,,3,3,0,3
Cody Zeller,F-C,22023,203469,22300183,"NOV 12, 2023",NOP vs. DAL,L,13,1,2,0.5,0,0,0.0,1,2,0.5,1,4,5,2,0,0,1,1,3,11,1,NOP,NOP,DAL,124,,,10,8,5,7
Cody Zeller,F-C,22023,203469,22300011,"NOV 10, 2023",NOP @ HOU,L,4,0,0,0.0,0,0,0.0,1,1,1.0,0,1,1,0,1,0,0,1,1,4,1,NOP,HOU,NOP,101,,,2,2,1,1
Cody Zeller,F-C,22023,203469,22300166,"NOV 08, 2023",NOP @ MIN,L,12,1,2,0.5,0,0,0.0,2,3,0.667,2,3,5,6,0,0,0,3,4,8,1,NOP,MIN,NOP,101,,,15,9,10,11
Cody Zeller,F-C,22023,203469,22300156,"NOV 06, 2023",NOP @ DEN,L,4,0,0,0.0,0,0,0.0,0,0,0.0,0,1,1,0,0,0,0,0,0,-9,1,NOP,DEN,NOP,116,,,1,1,0,1
Cody Zeller,F-C,22023,203469,22300121,"NOV 01, 2023",NOP @ OKC,W,2,0,2,0.0,0,0,0.0,0,0,0.0,2,0,2,0,0,0,0,0,0,-6,1,NOP,OKC,NOP,110,,,2,2,0,2
Cody Zeller,F-C,22023,203469,22300108,"OCT 30, 2023",NOP vs. GSW,L,5,0,2,0.0,0,0,0.0,0,2,0.0,1,1,2,0,0,0,0,0,0,0,1,NOP,NOP,GSW,102,,,2,2,0,2
Cody Zeller,F-C,22023,203469,22300090,"OCT 28, 2023",NOP vs. NYK,W,8,0,1,0.0,0,0,0.0,0,0,0.0,0,1,1,0,0,0,0,0,0,-7,1,NOP,NOP,NYK,96,,,1,1,0,1
Jalen Hood-Schifino,G,22023,1641720,22300605,"JAN 21, 2024",LAL vs. POR,W,6,1,1,1.0,0,0,0.0,2,2,1.0,0,1,1,1,1,0,1,0,4,1,1,LAL,LAL,POR,134,,,6,5,5,2
Jalen Hood-Schifino,G,22023,1641720,22300271,"NOV 30, 2023",LAL @ OKC,L,19,1,6,0.167,0,3,0.0,1,2,0.5,0,1,1,0,0,0,1,3,3,-15,1,LAL,OKC,LAL,110,,,4,4,3,1
Jalen Hood-Schifino,G,22023,1641720,22300684,"FEB 01, 2024",LAL @ BOS,W,1,0,0,0.0,0,0,0.0,1,2,0.5,0,0,0,0,0,0,0,0,1,-2,1,LAL,BOS,LAL,114,,,1,1,1,0
Jalen Hood-Schifino,G,22023,1641720,22300669,"JAN 30, 2024",LAL @ ATL,L,3,0,1,0.0,0,1,0.0,2,2,1.0,0,0,0,0,0,0,0,0,2,2,1,LAL,ATL,LAL,122,,,2,2,2,0
Jalen Hood-Schifino,G,22023,1641720,22300662,"JAN 29, 2024",LAL @ HOU,L,2,0,1,0.0,0,1,0.0,0,0,0.0,0,0,0,1,0,1,0,1,0,0,1,LAL,HOU,LAL,119,,,1,0,1,1
Jalen Hood-Schifino,G,22023,1641720,22300618,"JAN 23, 2024",LAL @ LAC,L,1,0,0,0.0,0,0,0.0,0,0,0.0,0,0,0,0,0,0,1,0,0,0,1,LAL,LAC,LAL,116,,,0,0,0,0
Jalen Hood-Schifino,G,22023,1641720,22300591,"JAN 19, 2024",LAL vs. BKN,L,3,0,1,0.0,0,0,0.0,0,0,0.0,0,1,1,1,0,0,1,1,0,0,1,LAL,LAL,BKN,112,,,2,1,1,2
Jalen Hood-Schifino,G,22023,1641720,22300531,"JAN 11, 2024",LAL vs. PHX,L,5,1,3,0.333,0,0,0.0,0,0,0.0,0,0,0,0,0,0,0,0,2,4,1,LAL,LAL,PHX,109,,,2,2,2,0
Jalen Hood-Schifino,G,22023,1641720,22300475,"JAN 03, 2024",LAL vs. MIA,L,6,0,4,0.0,0,0,0.0,0,0,0.0,1,1,2,0,0,0,0,1,0,-1,1,LAL,LAL,MIA,96,,,2,2,0,2
Jalen Hood-Schifino,G,22023,1641720,22300446,"DEC 31, 2023",LAL @ NOP,L,5,1,1,1.0,0,0,0.0,0,0,0.0,0,0,0,0,1,0,0,0,2,2,1,LAL,NOP,LAL,109,,,2,2,2,0
Jalen Hood-Schifino,G,22023,1641720,22300428,"DEC 28, 2023",LAL vs. CHA,W,7,1,5,0.2,0,1,0.0,0,0,0.0,0,0,0,1,1,0,1,1,2,-2,1,LAL,LAL,CHA,133,,,3,2,3,1
Jalen Hood-Schifino,G,22023,1641720,22301230,"DEC 07, 2023",LAL vs. NOP,W,8,0,3,0.0,0,0,0.0,1,2,0.5,1,3,4,1,0,1,1,1,1,6,1,LAL,LAL,NOP,133,,,6,5,2,5
Jalen Hood-Schifino,G,22023,1641720,22300291,"DEC 02, 2023",LAL vs. HOU,W,3,0,2,0.0,0,1,0.0,0,0,0.0,0,0,0,0,0,0,0,0,0,-8,1,LAL,LAL,HOU,107,,,0,0,0,0
Jalen Hood-Schifino,G,22023,1641720,22300258,"NOV 29, 2023",LAL @ DET,W,11,3,4,0.75,1,2,0.5,3,6,0.5,0,1,1,1,0,0,1,2,10,-6,1,LAL,DET,LAL,133,,,12,11,11,2
Jalen Hood-Schifino,G,22023,1641720,22300255,"NOV 27, 2023",LAL @ PHI,L,11,0,3,0.0,0,2,0.0,0,0,0.0,0,0,0,2,0,0,1,1,0,-17,1,LAL,PHI,LAL,94,,,2,0,2,2
Jalen Hood-Schifino,G,22023,1641720,22300747,"FEB 09, 2024",LAL vs. NOP,W,3,0,1,0.0,0,0,0.0,0,0,0.0,0,1,1,0,0,0,0,0,0,2,1,LAL,LAL,NOP,139,,,1,1,0,1
Kobe Brown,F,22023,1641738,22300099,"OCT 29, 2023",LAC vs. SAS,W,5,1,2,0.5,1,2,0.5,0,0,0.0,0,4,4,1,1,0,0,1,3,10,1,LAC,LAC,SAS,123,,,8,7,4,5
Kobe Brown,F,22023,1641738,22300074,"OCT 25, 2023",LAC vs. POR,W,5,0,2,0.0,0,1,0.0,0,0,0.0,0,0,0,0,0,0,0,1,0,-12,1,LAC,LAC,POR,123,,,0,0,0,0
Kobe Brown,F,22023,1641738,22300731,"FEB 07, 2024",LAC vs. NOP,L,3,1,1,1.0,1,1,1.0,0,0,0.0,0,1,1,0,0,0,0,0,3,3,1,LAC,LAC,NOP,106,,,4,4,3,1
Kobe Brown,F,22023,1641738,22300688,"FEB 02, 2024",LAC @ DET,W,3,0,1,0.0,0,0,0.0,0,0,0.0,0,0,0,0,0,0,0,0,0,-7,1,LAC,DET,LAC,136,,,0,0,0,0
Kobe Brown,F,22023,1641738,22300676,"JAN 31, 2024",LAC @ WAS,W,7,0,1,0.0,0,0,0.0,0,0,0.0,1,2,3,1,0,0,0,1,0,-11,1,LAC,WAS,LAC,125,,,4,3,1,4
Kobe Brown,F,22023,1641738,22300658,"JAN 29, 2024",LAC @ CLE,L,1,0,0,0.0,0,0,0.0,0,0,0.0,0,0,0,0,0,0,0,0,0,-2,1,LAC,CLE,LAC,108,,,0,0,0,0
Kobe Brown,F,22023,1641738,22300646,"JAN 27, 2024",LAC @ BOS,W,10,0,2,0.0,0,2,0.0,0,0,0.0,2,1,3,1,0,0,1,2,0,-16,1,LAC,BOS,LAC,115,,,4,3,1,4
Kobe Brown,F,22023,1641738,22300537,"JAN 12, 2024",LAC @ MEM,W,4,0,1,0.0,0,0,0.0,0,0,0.0,0,0,0,1,0,0,0,0,0,-11,1,LAC,MEM,LAC,128,,,1,0,1,1
Kobe Brown,F,22023,1641738,22300511,"JAN 08, 2024",LAC vs. PHX,W,5,0,0,0.0,0,0,0.0,0,0,0.0,0,0,0,0,1,0,0,1,0,2,1,LAC,LAC,PHX,138,,,0,0,0,0
Kobe Brown,F,22023,1641738,22300486,"JAN 05, 2024",LAC @ NOP,W,6,0,1,0.0,0,1,0.0,0,0,0.0,0,0,0,0,0,0,0,0,0,-12,1,LAC,NOP,LAC,111,,,0,0,0,0
Kobe Brown,F,22023,1641738,22300458,"JAN 01, 2024",LAC vs. MIA,W,3,0,0,0.0,0,0,0.0,0,0,0.0,0,0,0,0,0,0,1,0,0,-3,1,LAC,LAC,MIA,121,,,0,0,0,0
Kobe Brown,F,22023,1641738,22300389,"DEC 23, 2023",LAC vs. BOS,L,25,2,2,1.0,2,2,1.0,0,0,0.0,0,2,2,4,1,0,0,3,6,-18,1,LAC,LAC,BOS,108,,,12,8,10,6
Kobe Brown,F,22023,1641738,22300379,"DEC 21, 2023",LAC @ OKC,L,10,1,3,0.333,0,2,0.0,0,0,0.0,0,0,0,0,0,0,0,1,2,1,1,LAC,OKC,LAC,115,,,2,2,2,0
Kobe Brown,F,22023,1641738,22300350,"DEC 18, 2023",LAC @ IND,W,6,0,2,0.0,0,1,0.0,0,0,0.0,0,1,1,1,0,0,1,1,0,-5,1,LAC,IND,LAC,151,,,2,1,1,2
Kobe Brown,F,22023,1641738,22300343,"DEC 16, 2023",LAC vs. NYK,W,5,2,3,0.667,2,3,0.667,0,0,0.0,0,0,0,0,0,0,0,0,6,-2,1,LAC,LAC,NYK,144,,,6,6,6,0
Kobe Brown,F,22023,1641738,22300618,"JAN 23, 2024",LAC vs. LAL,W,1,0,0,0.0,0,0,0.0,0,0,0.0,0,0,0,0,0,0,0,0,0,0,1,LAC,LAC,LAL,127,,,0,0,0,0
Kobe Brown,F,22023,1641738,22300438,"DEC 29, 2023",LAC vs. MEM,W,15,3,5,0.6,1,3,0.333,0,0,0.0,0,4,4,0,0,0,0,2,7,1,1,LAC,LAC,MEM,117,,,11,11,7,4
Kobe Brown,F,22023,1641738,22300414,"DEC 26, 2023",LAC vs. CHA,W,17,1,4,0.25,0,2,0.0,0,0,0.0,0,0,0,2,2,0,0,0,2,-5,1,LAC,LAC,CHA,113,,,4,2,4,2
Kobe Brown,F,22023,1641738,22300325,"DEC 14, 2023",LAC vs. GSW,W,7,1,1,1.0,0,0,0.0,0,0,0.0,0,0,0,0,1,0,0,2,2,14,1,LAC,LAC,GSW,121,,,2,2,2,0
Kobe Brown,F,22023,1641738,22300309,"DEC 12, 2023",LAC vs. SAC,W,24,3,5,0.6,1,3,0.333,0,0,0.0,1,5,6,0,0,1,1,5,7,-3,1,LAC,LAC,SAC,117,,,13,13,7,6
Kobe Brown,F,22023,1641738,22300304,"DEC 11, 2023",LAC vs. POR,W,5,0,1,0.0,0,1,0.0,0,0,0.0,0,0,0,0,0,0,0,1,0,-5,1,LAC,LAC,POR,132,,,0,0,0,0
Kobe Brown,F,22023,1641738,22301225,"DEC 08, 2023",LAC @ UTA,W,14,0,2,0.0,0,0,0.0,1,2,0.5,2,1,3,1,0,1,0,3,1,-7,1,LAC,UTA,LAC,117,,,5,4,2,4
Kobe Brown,F,22023,1641738,22301215,"DEC 06, 2023",LAC vs. DEN,W,17,1,4,0.25,1,3,0.333,0,0,0.0,0,4,4,1,0,0,0,4,3,17,1,LAC,LAC,DEN,111,,,8,7,4,5
Kobe Brown,F,22023,1641738,22300280,"DEC 02, 2023",LAC vs. GSW,W,11,0,3,0.0,0,3,0.0,0,0,0.0,0,1,1,3,0,0,0,1,0,-6,1,LAC,LAC,GSW,113,,,4,1,3,4
Kobe Brown,F,22023,1641738,22300273,"NOV 30, 2023",LAC @ GSW,L,6,0,1,0.0,0,1,0.0,0,0,0.0,0,1,1,0,0,0,0,2,0,-6,1,LAC,GSW,LAC,114,,,1,1,0,1
Kobe Brown,F,22023,1641738,22300264,"NOV 29, 2023",LAC @ SAC,W,11,1,2,0.5,1,2,0.5,0,0,0.0,0,2,2,0,0,0,0,3,3,-3,1,LAC,SAC,LAC,131,,,5,5,3,2
Kobe Brown,F,22023,1641738,22300244,"NOV 25, 2023",LAC vs. DAL,W,5,0,2,0.0,0,1,0.0,0,0,0.0,1,2,3,0,0,0,0,0,0,-1,1,LAC,LAC,DAL,107,,,3,3,0,3
Kobe Brown,F,22023,1641738,22300014,"NOV 10, 2023",LAC @ DAL,L,13,3,4,0.75,1,1,1.0,0,0,0.0,1,0,1,0,0,0,1,2,7,10,1,LAC,DAL,LAC,126,,,8,8,7,1
Kobe Brown,F,22023,1641738,22300151,"NOV 06, 2023",LAC @ NYK,L,4,0,1,0.0,0,1,0.0,0,0,0.0,0,0,0,0,0,0,0,0,0,2,1,LAC,NYK,LAC,97,,,0,0,0,0
Kobe Brown,F,22023,1641738,22300127,"NOV 01, 2023",LAC @ LAL,L,6,0,1,0.0,0,1,0.0,0,0,0.0,0,0,0,0,0,0,0,0,0,-7,1,LAC,LAL,LAC,125,,,0,0,0,0
Kobe Brown,F,22023,1641738,22300114,"OCT 31, 2023",LAC vs. ORL,W,19,3,4,0.75,1,2,0.5,0,0,0.0,1,2,3,1,0,1,0,4,7,11,1,LAC,LAC,ORL,118,,,11,10,8,4
Nate Hinton,G-F,22023,1630207,22300709,"FEB 04, 2024",HOU @ MIN,L,4,1,2,0.5,1,2,0.5,2,2,1.0,0,1,1,2,0,0,0,1,5,7,1,HOU,MIN,HOU,90,,,8,6,7,3
Nate Hinton,G-F,22023,1630207,22300692,"FEB 02, 2024",HOU vs. TOR,W,4,1,2,0.5,0,1,0.0,0,0,0.0,0,0,0,0,1,0,0,0,2,1,1,HOU,HOU,TOR,135,,,2,2,2,0
Nate Hinton,G-F,22023,1630207,22300679,"JAN 31, 2024",HOU vs. NOP,L,1,0,0,0.0,0,0,0.0,0,0,0.0,0,0,0,0,0,0,0,0,0,2,1,HOU,HOU,NOP,99,,,0,0,0,0
Nate Hinton,G-F,22023,1630207,22300662,"JAN 29, 2024",HOU vs. LAL,W,0,0,0,0.0,0,0,0.0,0,0,0.0,0,0,0,0,0,0,0,0,0,-3,1,HOU,HOU,LAL,135,,,0,0,0,0
Nate Hinton,G-F,22023,1630207,22300635,"JAN 26, 2024",HOU @ CHA,W,7,1,2,0.5,0,0,0.0,0,0,0.0,0,3,3,1,0,1,1,2,2,-3,1,HOU,CHA,HOU,138,,,6,5,3,4
Nate Hinton,G-F,22023,1630207,22300385,"DEC 22, 2023",HOU vs. DAL,W,10,1,3,0.333,1,2,0.5,0,0,0.0,1,1,2,1,0,0,1,3,3,-5,1,HOU,HOU,DAL,122,,,6,5,4,3
Nate Hinton,G-F,22023,1630207,22300291,"DEC 02, 2023",HOU @ LAL,L,3,0,1,0.0,0,0,0.0,0,0,0.0,0,2,2,0,0,0,0,1,0,8,1,HOU,LAL,HOU,97,,,2,2,0,2
Nate Hinton,G-F,22023,1630207,22300263,"NOV 29, 2023",HOU @ DEN,L,6,1,1,1.0,1,1,1.0,0,0,0.0,1,0,1,0,0,0,0,0,3,7,1,HOU,DEN,HOU,124,,,4,4,3,1
Nate Hinton,G-F,22023,1630207,22300153,"NOV 06, 2023",HOU vs. SAC,W,7,2,4,0.5,2,2,1.0,0,0,0.0,0,0,0,0,0,0,0,1,6,-11,1,HOU,HOU,SAC,122,,,6,6,6,0
Nate Hinton,G-F,22023,1630207,22300137,"NOV 04, 2023",HOU vs. SAC,W,1,0,0,0.0,0,0,0.0,0,0,0.0,0,0,0,0,0,0,0,0,0,0,1,HOU,HOU,SAC,107,,,0,0,0,0
Terry Taylor,F,22023,1630678,22300139,"NOV 04, 2023",CHI @ DEN,L,3,1,1,1.0,0,0,0.0,0,0,0.0,0,0,0,0,0,0,0,0,2,-2,1,CHI,DEN,CHI,101,,,2,2,2,0
Terry Taylor,F,22023,1630678,22300700,"FEB 03, 2024",CHI vs. SAC,L,3,1,2,0.5,0,0,0.0,0,0,0.0,1,0,1,0,0,0,0,0,2,0,1,CHI,CHI,SAC,115,,,3,3,2,1
Terry Taylor,F,22023,1630678,22300674,"JAN 31, 2024",CHI @ CHA,W,20,1,4,0.25,1,2,0.5,0,0,0.0,1,5,6,2,1,0,0,0,3,0,1,CHI,CHA,CHI,117,,,11,9,5,8
Terry Taylor,F,22023,1630678,22300597,"JAN 20, 2024",CHI vs. MEM,W,4,1,1,1.0,0,0,0.0,0,0,0.0,1,1,2,1,0,0,1,2,2,4,1,CHI,CHI,MEM,125,,,5,4,3,3
Terry Taylor,F,22023,1630678,22300561,"JAN 15, 2024",CHI @ CLE,L,5,0,1,0.0,0,1,0.0,0,0,0.0,0,1,1,0,0,0,0,1,0,-5,1,CHI,CLE,CHI,91,,,1,1,0,1
Terry Taylor,F,22023,1630678,22300484,"JAN 05, 2024",CHI vs. CHA,W,9,2,3,0.667,0,1,0.0,1,1,1.0,0,0,0,0,0,1,1,2,5,5,1,CHI,CHI,CHA,104,,,5,5,5,0
Terry Taylor,F,22023,1630678,22300468,"JAN 03, 2024",CHI @ NYK,L,16,2,3,0.667,0,0,0.0,0,0,0.0,1,1,2,0,0,0,0,0,4,0,1,CHI,NYK,CHI,100,,,6,6,4,2
Terry Taylor,F,22023,1630678,22300459,"JAN 02, 2024",CHI @ PHI,L,20,0,5,0.0,0,2,0.0,0,0,0.0,4,1,5,1,1,1,4,2,0,18,1,CHI,PHI,CHI,97,,,6,5,1,6
Terry Taylor,F,22023,1630678,22300442,"DEC 30, 2023",CHI vs. PHI,W,17,3,3,1.0,0,0,0.0,0,0,0.0,3,3,6,1,1,0,0,0,6,1,1,CHI,CHI,PHI,105,,,13,12,7,7
Terry Taylor,F,22023,1630678,22300422,"DEC 28, 2023",CHI vs. IND,L,14,1,2,0.5,0,1,0.0,0,0,0.0,1,0,1,1,0,0,0,3,2,1,1,CHI,CHI,IND,104,,,4,3,3,2
Terry Taylor,F,22023,1630678,22300408,"DEC 26, 2023",CHI vs. ATL,W,8,2,2,1.0,0,0,0.0,0,0,0.0,1,0,1,0,0,0,0,2,4,4,1,CHI,CHI,ATL,118,,,5,5,4,1
Terry Taylor,F,22023,1630678,22300376,"DEC 21, 2023",CHI vs. SAS,W,2,0,0,0.0,0,0,0.0,0,0,0.0,0,0,0,0,0,0,1,1,0,-1,1,CHI,CHI,SAS,114,,,0,0,0,0
Terry Taylor,F,22023,1630678,22300370,"DEC 20, 2023",CHI vs. LAL,W,1,0,0,0.0,0,0,0.0,0,0,0.0,0,0,0,0,0,0,0,0,0,-2,1,CHI,CHI,LAL,124,,,0,0,0,0
Terry Taylor,F,22023,1630678,22300307,"DEC 12, 2023",CHI vs. DEN,L,1,1,1,1.0,0,0,0.0,0,0,0.0,1,0,1,0,0,0,0,0,2,2,1,CHI,CHI,DEN,106,,,3,3,2,1
Terry Taylor,F,22023,1630678,22300053,"NOV 28, 2023",CHI @ BOS,L,3,0,0,0.0,0,0,0.0,0,0,0.0,0,0,0,0,1,0,0,0,0,1,1,CHI,BOS,CHI,97,,,0,0,0,0
Terry Taylor,F,22023,1630678,22300220,"NOV 20, 2023",CHI vs. MIA,L,2,0,0,0.0,0,0,0.0,0,0,0.0,0,0,0,0,0,0,0,0,0,6,1,CHI,CHI,MIA,100,,,0,0,0,0
Terry Taylor,F,22023,1630678,22300152,"NOV 06, 2023",CHI vs. UTA,W,2,0,0,0.0,0,0,0.0,0,0,0.0,0,1,1,0,0,0,0,0,0,-5,1,CHI,CHI,UTA,130,,,1,1,0,1
Terry Taylor,F,22023,1630678,22300088,"OCT 28, 2023",CHI @ DET,L,1,0,0,0.0,0,0,0.0,0,0,0.0,0,0,0,0,0,0,0,0,0,0,1,CHI,DET,CHI,102,,,0,0,0,0
Jett Howard,G,22023,1641724,22300601,"JAN 21, 2024",ORL vs. MIA,W,3,0,0,0.0,0,0,0.0,1,2,0.5,0,1,1,0,0,1,0,0,1,-4,1,ORL,ORL,MIA,105,,,2,2,1,1
Jett Howard,G,22023,1641724,22300585,"JAN 19, 2024",ORL vs. PHI,L,3,2,3,0.667,1,2,0.5,0,0,0.0,0,0,0,0,0,0,0,0,5,0,1,ORL,ORL,PHI,109,,,5,5,5,0
Jett Howard,G,22023,1641724,22300415,"DEC 27, 2023",ORL vs. PHI,L,1,1,1,1.0,1,1,1.0,0,0,0.0,0,0,0,0,0,0,0,0,3,3,1,ORL,ORL,PHI,92,,,3,3,3,0
Jett Howard,G,22023,1641724,22300344,"DEC 17, 2023",ORL @ BOS,L,2,1,2,0.5,1,1,1.0,0,0,0.0,0,0,0,0,0,0,0,0,3,4,1,ORL,BOS,ORL,97,,,3,3,3,0
Jett Howard,G,22023,1641724,22300329,"DEC 15, 2023",ORL @ BOS,L,3,0,1,0.0,0,1,0.0,0,0,0.0,0,1,1,0,0,0,0,0,0,3,1,ORL,BOS,ORL,111,,,1,1,0,1
Jett Howard,G,22023,1641724,22301217,"DEC 08, 2023",ORL vs. DET,W,5,2,2,1.0,1,1,1.0,1,2,0.5,0,1,1,1,0,0,0,1,6,3,1,ORL,ORL,DET,123,,,8,7,7,2
Jett Howard,G,22023,1641724,22300209,"NOV 19, 2023",ORL @ IND,W,7,0,2,0.0,0,2,0.0,0,0,0.0,0,0,0,1,0,0,2,0,0,-11,1,ORL,IND,ORL,128,,,1,0,1,1
Jett Howard,G,22023,1641724,22300020,"NOV 14, 2023",ORL @ BKN,L,4,0,4,0.0,0,4,0.0,0,0,0.0,0,0,0,0,0,0,0,0,0,-4,1,ORL,BKN,ORL,104,,,0,0,0,0
Jett Howard,G,22023,1641724,22300134,"NOV 04, 2023",ORL vs. LAL,W,3,0,2,0.0,0,1,0.0,0,0,0.0,1,0,1,0,0,0,0,0,0,3,1,ORL,ORL,LAL,120,,,1,1,0,1
Jett Howard,G,22023,1641724,22300114,"OCT 31, 2023",ORL @ LAC,L,4,1,1,1.0,0,0,0.0,0,0,0.0,0,1,1,0,0,0,0,0,2,-1,1,ORL,LAC,ORL,102,,,3,3,2,1
Jett Howard,G,22023,1641724,22300066,"OCT 25, 2023",ORL vs. HOU,W,5,0,1,0.0,0,1,0.0,0,0,0.0,0,0,0,1,0,0,0,0,0,9,1,ORL,ORL,HOU,116,,,1,0,1,1
Emoni Bates,F,22023,1641734,22300420,"DEC 27, 2023",CLE @ DAL,W,6,0,3,0.0,0,3,0.0,0,0,0.0,0,1,1,3,0,0,0,2,0,11,1,CLE,DAL,CLE,113,,,4,1,3,4
Emoni Bates,F,22023,1641734,22300396,"DEC 23, 2023",CLE @ CHI,W,9,1,2,0.5,1,2,0.5,0,0,0.0,0,0,0,0,0,1,0,0,3,-2,1,CLE,CHI,CLE,109,,,3,3,3,0
Emoni Bates,F,22023,1641734,22300375,"DEC 21, 2023",CLE vs. NOP,L,9,1,5,0.2,1,3,0.333,0,0,0.0,0,0,0,1,0,0,0,1,3,-9,1,CLE,CLE,NOP,104,,,4,3,4,1
Emoni Bates,F,22023,1641734,22300229,"NOV 22, 2023",CLE vs. MIA,L,16,1,5,0.2,1,5,0.2,0,0,0.0,0,1,1,1,1,0,0,1,3,-12,1,CLE,CLE,MIA,96,,,5,4,4,2
Emoni Bates,F,22023,1641734,22300210,"NOV 19, 2023",CLE vs. DEN,W,4,0,1,0.0,0,1,0.0,0,0,0.0,0,1,1,0,0,0,0,0,0,-12,1,CLE,CLE,DEN,121,,,1,1,0,1
Emoni Bates,F,22023,1641734,22300030,"NOV 17, 2023",CLE vs. DET,W,1,0,0,0.0,0,0,0.0,0,0,0.0,0,0,0,0,0,0,0,0,0,-2,1,CLE,CLE,DET,108,,,0,0,0,0
Emoni Bates,F,22023,1641734,22300199,"NOV 15, 2023",CLE @ POR,W,2,0,0,0.0,0,0,0.0,0,0,0.0,0,1,1,0,0,0,0,0,0,0,1,CLE,POR,CLE,109,,,1,1,0,1
Emoni Bates,F,22023,1641734,22300176,"NOV 11, 2023",CLE @ GSW,W,1,0,0,0.0,0,0,0.0,0,0,0.0,0,0,0,0,0,0,0,0,0,-6,1,CLE,GSW,CLE,118,,,0,0,0,0
Emoni Bates,F,22023,1641734,22300112,"OCT 31, 2023",CLE vs. NYK,L,23,3,8,0.375,2,5,0.4,1,2,0.5,1,5,6,1,0,1,1,1,9,-9,1,CLE,CLE,NYK,91,,,16,15,10,7
Emoni Bates,F,22023,1641734,22300091,"OCT 28, 2023",CLE vs. IND,L,7,0,1,0.0,0,1,0.0,0,0,0.0,0,0,0,0,0,0,0,0,0,-15,1,CLE,CLE,IND,113,,,0,0,0,0
Jordan Miller,G,22023,1641757,22300074,"OCT 25, 2023",LAC vs. POR,W,4,1,2,0.5,0,0,0.0,0,0,0.0,0,0,0,0,0,0,0,1,2,-7,1,LAC,LAC,POR,123,,,2,2,2,0
Jordan Miller,G,22023,1641757,22300537,"JAN 12, 2024",LAC @ MEM,W,4,1,2,0.5,0,0,0.0,0,0,0.0,2,0,2,0,0,0,0,0,2,-11,1,LAC,MEM,LAC,128,,,4,4,2,2
Jordan Miller,G,22023,1641757,22300343,"DEC 16, 2023",LAC vs. NYK,W,5,0,0,0.0,0,0,0.0,0,0,0.0,0,1,1,0,0,0,1,0,0,-2,1,LAC,LAC,NYK,144,,,1,1,0,1
Jordan Miller,G,22023,1641757,22300114,"OCT 31, 2023",LAC vs. ORL,W,3,1,1,1.0,1,1,1.0,0,0,0.0,0,0,0,0,0,0,0,1,3,2,1,LAC,LAC,ORL,118,,,3,3,3,0
Leaky Black,F,22023,1641778,22300745,"FEB 09, 2024",CHA @ MIL,L,30,1,2,0.5,0,0,0.0,2,2,1.0,1,5,6,2,0,0,2,2,4,-16,1,CHA,MIL,CHA,80,,,12,10,6,8
Leaky Black,F,22023,1641778,22300335,"DEC 16, 2023",CHA vs. PHI,L,7,1,1,1.0,0,0,0.0,0,0,0.0,0,1,1,2,1,1,1,0,2,-6,1,CHA,CHA,PHI,80,,,5,3,4,3
Leaky Black,F,22023,1641778,22300177,"NOV 12, 2023",CHA @ NYK,L,6,2,2,1.0,1,1,1.0,0,0,0.0,0,2,2,0,0,1,0,1,5,13,1,CHA,NYK,CHA,107,,,7,7,5,2
Leaky Black,F,22023,1641778,22300635,"JAN 26, 2024",CHA vs. HOU,L,13,0,3,0.0,0,1,0.0,1,2,0.5,2,2,4,0,0,0,0,4,1,-6,1,CHA,CHA,HOU,104,,,5,5,1,4
Leaky Black,F,22023,1641778,22300619,"JAN 24, 2024",CHA @ DET,L,3,1,1,1.0,1,1,1.0,0,0,0.0,0,2,2,0,0,0,0,0,3,0,1,CHA,DET,CHA,106,,,5,5,3,2
Leaky Black,F,22023,1641778,22300610,"JAN 22, 2024",CHA @ MIN,W,5,2,3,0.667,1,1,1.0,2,2,1.0,1,2,3,1,0,1,0,0,7,10,1,CHA,MIN,CHA,126,,,11,10,8,4
Leaky Black,F,22023,1641778,22300575,"JAN 17, 2024",CHA @ NOP,L,4,0,0,0.0,0,0,0.0,0,2,0.0,0,0,0,0,1,0,1,0,0,-1,1,CHA,NOP,CHA,108,,,0,0,0,0
Leaky Black,F,22023,1641778,22300551,"JAN 14, 2024",CHA @ MIA,L,2,0,0,0.0,0,0,0.0,0,0,0.0,0,0,0,0,0,0,0,0,0,1,1,CHA,MIA,CHA,85,,,0,0,0,0
Leaky Black,F,22023,1641778,22300541,"JAN 12, 2024",CHA @ SAS,L,7,1,2,0.5,0,1,0.0,0,0,0.0,0,0,0,0,0,0,0,1,2,-9,1,CHA,SAS,CHA,99,,,2,2,2,0
Leaky Black,F,22023,1641778,22300017,"NOV 14, 2023",CHA vs. MIA,L,3,0,2,0.0,0,1,0.0,0,0,0.0,0,0,0,0,0,0,0,0,0,-4,1,CHA,CHA,MIA,105,,,0,0,0,0
Leaky Black,F,22023,1641778,22300157,"NOV 08, 2023",CHA vs. WAS,L,4,0,1,0.0,0,0,0.0,0,0,0.0,0,0,0,1,0,1,0,0,0,4,1,CHA,CHA,WAS,116,,,1,0,1,1
Leaky Black,F,22023,1641778,22300726,"FEB 07, 2024",CHA vs. TOR,L,23,1,2,0.5,0,1,0.0,1,2,0.5,0,3,3,3,0,1,1,1,3,9,1,CHA,CHA,TOR,117,,,9,6,6,6
Leaky Black,F,22023,1641778,22300713,"FEB 05, 2024",CHA vs. LAL,L,16,1,4,0.25,0,2,0.0,0,0,0.0,1,4,5,2,0,0,0,0,2,-3,1,CHA,CHA,LAL,118,,,9,7,4,7
Leaky Black,F,22023,1641778,22300707,"FEB 04, 2024",CHA vs. IND,L,19,0,3,0.0,0,0,0.0,0,0,0.0,1,2,3,2,1,1,0,0,0,-3,1,CHA,CHA,IND,99,,,5,3,2,5
Leaky Black,F,22023,1641778,22300695,"FEB 02, 2024",CHA @ OKC,L,18,4,7,0.571,3,3,1.0,0,0,0.0,0,1,1,2,0,0,0,0,11,-5,1,CHA,OKC,CHA,106,,,14,12,13,3
Leaky Black,F,22023,1641778,22300674,"JAN 31, 2024",CHA vs. CHI,L,13,1,2,0.5,1,2,0.5,0,0,0.0,0,1,1,1,1,0,0,1,3,-8,1,CHA,CHA,CHI,110,,,5,4,4,2
Leaky Black,F,22023,1641778,22300657,"JAN 29, 2024",CHA vs. NYK,L,12,0,0,0.0,0,0,0.0,0,0,0.0,0,3,3,1,0,0,0,0,0,1,1,CHA,CHA,NYK,92,,,4,3,1,4
Leaky Black,F,22023,1641778,22300647,"JAN 27, 2024",CHA vs. UTA,L,7,0,2,0.0,0,1,0.0,3,4,0.75,0,0,0,0,0,0,0,4,3,0,1,CHA,CHA,UTA,122,,,3,3,3,0
Leaky Black,F,22023,1641778,22300518,"JAN 10, 2024",CHA vs. SAC,L,6,0,0,0.0,0,0,0.0,0,0,0.0,0,0,0,0,0,0,0,0,0,0,1,CHA,CHA,SAC,96,,,0,0,0,0
Leaky Black,F,22023,1641778,22300365,"DEC 20, 2023",CHA @ IND,L,4,0,0,0.0,0,0,0.0,0,0,0.0,0,0,0,0,0,0,0,0,0,-3,1,CHA,IND,CHA,109,,,0,0,0,0
Leaky Black,F,22023,1641778,22300354,"DEC 18, 2023",CHA @ TOR,L,11,2,2,1.0,0,0,0.0,0,0,0.0,2,2,4,1,0,0,0,1,4,-12,1,CHA,TOR,CHA,99,,,9,8,5,5
Leaky Black,F,22023,1641778,22300057,"NOV 28, 2023",CHA @ NYK,L,5,0,0,0.0,0,0,0.0,0,0,0.0,0,0,0,0,1,0,0,0,0,-1,1,CHA,NYK,CHA,91,,,0,0,0,0
Jericho Sims,C,22023,1630579,22300701,"FEB 03, 2024",NYK vs. LAL,L,15,1,1,1.0,0,0,0.0,0,0,0.0,1,2,3,0,0,0,0,1,2,-5,1,NYK,NYK,LAL,105,,,5,5,2,3
Jericho Sims,C,22023,1630579,22300685,"FEB 01, 2024",NYK vs. IND,W,13,1,1,1.0,0,0,0.0,0,0,0.0,4,0,4,1,0,3,1,0,2,-5,1,NYK,NYK,IND,109,,,7,6,3,5
Jericho Sims,C,22023,1630579,22300671,"JAN 30, 2024",NYK vs. UTA,W,19,1,2,0.5,0,0,0.0,0,0,0.0,3,1,4,0,0,0,0,0,2,14,1,NYK,NYK,UTA,118,,,6,6,2,4
Jericho Sims,C,22023,1630579,22300657,"JAN 29, 2024",NYK @ CHA,W,24,3,3,1.0,0,0,0.0,0,0,0.0,3,4,7,2,0,0,2,1,6,5,1,NYK,CHA,NYK,113,,,15,13,8,9
Jericho Sims,C,22023,1630579,22300643,"JAN 27, 2024",NYK vs. MIA,W,1,0,0,0.0,0,0,0.0,1,2,0.5,0,0,0,0,0,0,0,0,1,-4,1,NYK,NYK,MIA,125,,,1,1,1,0
Jericho Sims,C,22023,1630579,22300631,"JAN 25, 2024",NYK vs. DEN,W,25,1,1,1.0,0,0,0.0,0,0,0.0,1,7,8,0,0,1,1,4,2,20,1,NYK,NYK,DEN,122,,,10,10,2,8
Jericho Sims,C,22023,1630579,22300615,"JAN 23, 2024",NYK @ BKN,W,27,3,4,0.75,0,0,0.0,0,0,0.0,2,2,4,2,0,4,0,1,6,-8,1,NYK,BKN,NYK,108,,,12,10,8,6
Jericho Sims,C,22023,1630579,22300596,"JAN 20, 2024",NYK vs. TOR,W,3,0,0,0.0,0,0,0.0,0,0,0.0,0,0,0,0,0,1,0,0,0,3,1,NYK,NYK,TOR,126,,,0,0,0,0
Jericho Sims,C,22023,1630579,22300514,"JAN 09, 2024",NYK vs. POR,W,7,0,0,0.0,0,0,0.0,0,0,0.0,0,1,1,0,1,0,1,0,0,-4,1,NYK,NYK,POR,112,,,1,1,0,1
Jericho Sims,C,22023,1630579,22300494,"JAN 06, 2024",NYK @ WAS,W,2,0,0,0.0,0,0,0.0,0,0,0.0,0,0,0,0,0,0,0,0,0,-7,1,NYK,WAS,NYK,121,,,0,0,0,0
Jericho Sims,C,22023,1630579,22300483,"JAN 05, 2024",NYK @ PHI,W,2,0,0,0.0,0,0,0.0,0,0,0.0,0,0,0,0,0,0,0,0,0,-3,1,NYK,PHI,NYK,128,,,0,0,0,0
Jericho Sims,C,22023,1630579,22300468,"JAN 03, 2024",NYK vs. CHI,W,1,0,0,0.0,0,0,0.0,0,0,0.0,0,1,1,0,0,0,0,0,0,0,1,NYK,NYK,CHI,116,,,1,1,0,1
Jericho Sims,C,22023,1630579,22300343,"DEC 16, 2023",NYK @ LAC,L,18,3,4,0.75,0,0,0.0,1,1,1.0,0,2,2,1,1,0,0,3,7,-13,1,NYK,LAC,NYK,120,,,10,9,8,3
Jericho Sims,C,22023,1630579,22300333,"DEC 15, 2023",NYK @ PHX,W,17,2,4,0.5,0,0,0.0,1,1,1.0,1,2,3,0,0,0,0,3,5,-12,1,NYK,PHX,NYK,139,,,8,8,5,3
Jericho Sims,C,22023,1630579,22301201,"DEC 05, 2023",NYK @ MIL,L,3,0,0,0.0,0,0,0.0,0,0,0.0,0,0,0,0,0,0,1,0,0,-2,1,NYK,MIL,NYK,122,,,0,0,0,0
Jericho Sims,C,22023,1630579,22300221,"NOV 20, 2023",NYK @ MIN,L,3,1,1,1.0,0,0,0.0,0,0,0.0,0,1,1,0,0,0,0,0,2,0,1,NYK,MIN,NYK,100,,,3,3,2,1
Jericho Sims,C,22023,1630579,22300028,"NOV 17, 2023",NYK @ WAS,W,1,0,0,0.0,0,0,0.0,0,0,0.0,0,1,1,0,0,0,0,0,0,1,1,NYK,WAS,NYK,120,,,1,1,0,1
Jericho Sims,C,22023,1630579,22300177,"NOV 12, 2023",NYK vs. CHA,W,7,1,1,1.0,0,0,0.0,1,3,0.333,0,3,3,0,0,0,0,1,3,-6,1,NYK,NYK,CHA,129,,,6,6,3,3
Jericho Sims,C,22023,1630579,22300161,"NOV 08, 2023",NYK vs. SAS,W,2,0,0,0.0,0,0,0.0,0,0,0.0,0,1,1,0,0,0,0,0,0,-2,1,NYK,NYK,SAS,126,,,1,1,0,1
Jericho Sims,C,22023,1630579,22300112,"OCT 31, 2023",NYK @ CLE,W,3,0,1,0.0,0,0,0.0,0,0,0.0,1,0,1,1,0,0,0,0,0,0,1,NYK,CLE,NYK,109,,,2,1,1,2
Jericho Sims,C,22023,1630579,22300359,"DEC 18, 2023",NYK @ LAL,W,3,0,0,0.0,0,0,0.0,0,0,0.0,0,0,0,0,0,0,0,2,0,-2,1,NYK,LAL,NYK,114,,,0,0,0,0
Jericho Sims,C,22023,1630579,22300318,"DEC 13, 2023",NYK @ UTA,L,18,2,2,1.0,0,0,0.0,0,0,0.0,1,1,2,0,0,1,1,2,4,-8,1,NYK,UTA,NYK,113,,,6,6,4,2
Jericho Sims,C,22023,1630579,22300297,"DEC 11, 2023",NYK vs. TOR,W,21,1,2,0.5,0,0,0.0,0,0,0.0,3,4,7,1,0,0,0,3,2,5,1,NYK,NYK,TOR,136,,,10,9,3,8
Jericho Sims,C,22023,1630579,22300057,"NOV 28, 2023",NYK vs. CHA,W,2,0,0,0.0,0,0,0.0,0,0,0.0,0,0,0,0,0,0,0,0,0,-1,1,NYK,NYK,CHA,115,,,0,0,0,0
Jericho Sims,C,22023,1630579,22300090,"OCT 28, 2023",NYK @ NOP,L,5,0,0,0.0,0,0,0.0,0,0,0.0,0,3,3,0,0,0,0,0,0,10,1,NYK,NOP,NYK,87,,,3,3,0,3
Jericho Sims,C,22023,1630579,22300188,"NOV 13, 2023",NYK @ BOS,L,1,0,0,0.0,0,0,0.0,0,0,0.0,0,0,0,0,0,0,0,0,0,0,1,NYK,BOS,NYK,98,,,0,0,0,0
Isaiah Mobley,F,22023,1630600,22300375,"DEC 21, 2023",CLE vs. NOP,L,4,1,1,1.0,1,1,1.0,0,0,0.0,0,0,0,1,0,0,0,0,3,2,1,CLE,CLE,NOP,104,,,4,3,4,1
Isaiah Mobley,F,22023,1630600,22300229,"NOV 22, 2023",CLE vs. MIA,L,9,1,3,0.333,0,1,0.0,0,0,0.0,0,1,1,3,1,0,1,1,2,-5,1,CLE,CLE,MIA,96,,,6,3,5,4
Isaiah Mobley,F,22023,1630600,22300112,"OCT 31, 2023",CLE vs. NYK,L,1,0,0,0.0,0,0,0.0,0,0,0.0,0,1,1,0,0,0,0,1,0,-3,1,CLE,CLE,NYK,91,,,1,1,0,1
Josh Minott,F,22023,1631169,22300738,"FEB 08, 2024",MIN @ MIL,W,4,2,3,0.667,1,1,1.0,0,0,0.0,1,0,1,0,1,0,0,0,5,3,1,MIN,MIL,MIN,129,,,6,6,5,1
Josh Minott,F,22023,1631169,22300538,"JAN 12, 2024",MIN vs. POR,W,9,0,3,0.0,0,0,0.0,2,2,1.0,0,0,0,0,1,1,0,2,2,-10,1,MIN,MIN,POR,116,,,2,2,2,0
Josh Minott,F,22023,1631169,22300485,"JAN 05, 2024",MIN @ HOU,W,3,0,0,0.0,0,0,0.0,2,2,1.0,0,0,0,0,0,0,0,0,2,-6,1,MIN,HOU,MIN,122,,,2,2,2,0
Josh Minott,F,22023,1631169,22300471,"JAN 03, 2024",MIN vs. NOP,L,3,0,0,0.0,0,0,0.0,2,2,1.0,0,0,0,0,0,1,0,0,2,8,1,MIN,MIN,NOP,106,,,2,2,2,0
Josh Minott,F,22023,1631169,22300411,"DEC 26, 2023",MIN @ OKC,L,5,0,1,0.0,0,0,0.0,0,0,0.0,0,0,0,2,0,0,1,0,0,-1,1,MIN,OKC,MIN,106,,,2,0,2,2
Josh Minott,F,22023,1631169,22300321,"DEC 14, 2023",MIN @ DAL,W,2,1,1,1.0,0,0,0.0,1,1,1.0,0,0,0,0,0,0,0,0,3,-1,1,MIN,DAL,MIN,119,,,3,3,3,0
Josh Minott,F,22023,1631169,22300301,"DEC 11, 2023",MIN @ NOP,L,2,1,1,1.0,0,0,0.0,1,1,1.0,0,0,0,0,0,0,0,0,3,1,1,MIN,NOP,MIN,107,,,3,3,3,0
Josh Minott,F,22023,1631169,22300249,"NOV 26, 2023",MIN @ MEM,W,2,1,2,0.5,0,1,0.0,0,0,0.0,0,0,0,0,0,0,0,0,2,3,1,MIN,MEM,MIN,119,,,2,2,2,0
Josh Minott,F,22023,1631169,22300232,"NOV 22, 2023",MIN vs. PHI,W,2,0,0,0.0,0,0,0.0,0,0,0.0,0,0,0,0,0,0,0,1,0,-1,1,MIN,MIN,PHI,112,,,0,0,0,0
Josh Minott,F,22023,1631169,22300221,"NOV 20, 2023",MIN vs. NYK,W,1,1,1,1.0,0,0,0.0,0,0,0.0,0,2,2,0,0,0,0,1,2,2,1,MIN,MIN,NYK,117,,,4,4,2,2
Josh Minott,F,22023,1631169,22300197,"NOV 15, 2023",MIN @ PHX,L,5,1,3,0.333,0,2,0.0,0,1,0.0,1,0,1,0,0,0,0,0,2,5,1,MIN,PHX,MIN,115,,,3,3,2,1
Josh Minott,F,22023,1631169,22300166,"NOV 08, 2023",MIN vs. NOP,W,3,0,1,0.0,0,1,0.0,0,0,0.0,0,0,0,0,0,0,0,2,0,-6,1,MIN,MIN,NOP,122,,,0,0,0,0
Josh Minott,F,22023,1631169,22300138,"NOV 04, 2023",MIN vs. UTA,W,4,1,1,1.0,0,0,0.0,2,3,0.667,0,0,0,1,0,0,0,0,4,5,1,MIN,MIN,UTA,123,,,5,4,5,1
Josh Minott,F,22023,1631169,22300123,"NOV 01, 2023",MIN vs. DEN,W,4,1,1,1.0,0,0,0.0,0,0,0.0,0,0,0,0,0,0,0,0,2,2,1,MIN,MIN,DEN,110,,,2,2,2,0
Josh Minott,F,22023,1631169,22300104,"OCT 30, 2023",MIN @ ATL,L,1,1,1,1.0,0,0,0.0,0,0,0.0,0,0,0,0,0,0,0,0,2,4,1,MIN,ATL,MIN,113,,,2,2,2,0
Josh Minott,F,22023,1631169,22300093,"OCT 28, 2023",MIN vs. MIA,W,2,0,2,0.0,0,1,0.0,0,0,0.0,0,0,0,0,0,1,0,0,0,-7,1,MIN,MIN,MIA,106,,,0,0,0,0
Julian Phillips,F,22023,1641763,22300139,"NOV 04, 2023",CHI @ DEN,L,3,0,0,0.0,0,0,0.0,0,0,0.0,0,0,0,0,0,0,0,0,0,-2,1,CHI,DEN,CHI,101,,,0,0,0,0
Julian Phillips,F,22023,1641763,22300737,"FEB 08, 2024",CHI @ MEM,W,8,0,0,0.0,0,0,0.0,0,0,0.0,0,0,0,0,0,1,1,1,0,3,1,CHI,MEM,CHI,118,,,0,0,0,0
Julian Phillips,F,22023,1641763,22300723,"FEB 06, 2024",CHI vs. MIN,W,9,1,4,0.25,0,1,0.0,0,0,0.0,1,1,2,0,0,0,0,1,2,-4,1,CHI,CHI,MIN,129,,,4,4,2,2
Julian Phillips,F,22023,1641763,22300700,"FEB 03, 2024",CHI vs. SAC,L,13,1,3,0.333,1,3,0.333,0,0,0.0,0,1,1,0,0,1,1,5,3,-3,1,CHI,CHI,SAC,115,,,4,4,3,1
Julian Phillips,F,22023,1641763,22300674,"JAN 31, 2024",CHI @ CHA,W,11,1,2,0.5,0,1,0.0,2,2,1.0,1,0,1,0,0,0,1,4,4,-4,1,CHI,CHA,CHI,117,,,5,5,4,1
Julian Phillips,F,22023,1641763,22300672,"JAN 30, 2024",CHI vs. TOR,L,20,3,4,0.75,2,3,0.667,1,1,1.0,0,1,1,0,0,0,2,2,9,-7,1,CHI,CHI,TOR,107,,,10,10,9,1
Julian Phillips,F,22023,1641763,22300656,"JAN 28, 2024",CHI @ POR,W,23,4,7,0.571,1,3,0.333,2,4,0.5,1,1,2,1,0,1,0,3,11,4,1,CHI,POR,CHI,104,,,14,13,12,3
Julian Phillips,F,22023,1641763,22300597,"JAN 20, 2024",CHI vs. MEM,W,4,0,0,0.0,0,0,0.0,0,0,0.0,0,0,0,1,0,0,0,0,0,4,1,CHI,CHI,MEM,125,,,1,0,1,1
Julian Phillips,F,22023,1641763,22300468,"JAN 03, 2024",CHI @ NYK,L,2,0,1,0.0,0,0,0.0,0,0,0.0,1,0,1,0,0,0,0,0,0,0,1,CHI,NYK,CHI,100,,,1,1,0,1
Julian Phillips,F,22023,1641763,22300459,"JAN 02, 2024",CHI @ PHI,L,17,3,5,0.6,1,3,0.333,0,0,0.0,0,0,0,0,0,3,0,2,7,10,1,CHI,PHI,CHI,97,,,7,7,7,0
Julian Phillips,F,22023,1641763,22300442,"DEC 30, 2023",CHI vs. PHI,W,1,0,0,0.0,0,0,0.0,0,0,0.0,0,0,0,0,0,0,0,0,0,-4,1,CHI,CHI,PHI,105,,,0,0,0,0
Julian Phillips,F,22023,1641763,22300422,"DEC 28, 2023",CHI vs. IND,L,1,0,0,0.0,0,0,0.0,0,0,0.0,0,0,0,0,0,0,0,0,0,-1,1,CHI,CHI,IND,104,,,0,0,0,0
Julian Phillips,F,22023,1641763,22300376,"DEC 21, 2023",CHI vs. SAS,W,4,0,1,0.0,0,1,0.0,0,0,0.0,0,0,0,0,0,0,0,1,0,-5,1,CHI,CHI,SAS,114,,,0,0,0,0
Julian Phillips,F,22023,1641763,22300370,"DEC 20, 2023",CHI vs. LAL,W,1,0,0,0.0,0,0,0.0,0,0,0.0,0,0,0,0,0,0,0,0,0,-2,1,CHI,CHI,LAL,124,,,0,0,0,0
Julian Phillips,F,22023,1641763,22300337,"DEC 16, 2023",CHI @ MIA,L,0,0,0,0.0,0,0,0.0,0,0,0.0,0,0,0,0,0,0,0,0,0,0,1,CHI,MIA,CHI,116,,,0,0,0,0
Julian Phillips,F,22023,1641763,22300307,"DEC 12, 2023",CHI vs. DEN,L,7,0,1,0.0,0,1,0.0,0,0,0.0,0,1,1,1,0,0,1,1,0,3,1,CHI,CHI,DEN,106,,,2,1,1,2
Julian Phillips,F,22023,1641763,22300300,"DEC 11, 2023",CHI @ MIL,L,4,0,0,0.0,0,0,0.0,0,0,0.0,0,0,0,0,0,0,0,0,0,-4,1,CHI,MIL,CHI,129,,,0,0,0,0
Julian Phillips,F,22023,1641763,22301223,"DEC 08, 2023",CHI @ SAS,W,4,1,1,1.0,0,0,0.0,0,0,0.0,1,1,2,0,0,0,0,2,2,-4,1,CHI,SAS,CHI,121,,,4,4,2,2
Julian Phillips,F,22023,1641763,22301211,"DEC 06, 2023",CHI vs. CHA,W,6,1,2,0.5,0,1,0.0,0,0,0.0,0,0,0,1,0,0,0,0,2,-2,1,CHI,CHI,CHA,111,,,3,2,3,1
Julian Phillips,F,22023,1641763,22300285,"DEC 02, 2023",CHI vs. NOP,W,4,1,1,1.0,0,0,0.0,0,0,0.0,0,0,0,0,1,0,0,0,2,5,1,CHI,CHI,NOP,124,,,2,2,2,0
Julian Phillips,F,22023,1641763,22300269,"NOV 30, 2023",CHI vs. MIL,W,14,0,3,0.0,0,2,0.0,0,0,0.0,1,2,3,3,0,0,0,3,0,14,1,CHI,CHI,MIL,120,,,6,3,3,6
Julian Phillips,F,22023,1641763,22300053,"NOV 28, 2023",CHI @ BOS,L,10,0,2,0.0,0,1,0.0,1,2,0.5,0,2,2,1,0,0,1,0,1,-2,1,CHI,BOS,CHI,97,,,4,3,2,3
Julian Phillips,F,22023,1641763,22300046,"NOV 24, 2023",CHI @ TOR,L,4,1,2,0.5,0,1,0.0,0,2,0.0,0,0,0,0,0,0,0,1,2,0,1,CHI,TOR,CHI,108,,,2,2,2,0
Julian Phillips,F,22023,1641763,22300220,"NOV 20, 2023",CHI vs. MIA,L,2,1,2,0.5,0,0,0.0,0,0,0.0,0,1,1,0,0,0,0,1,2,6,1,CHI,CHI,MIA,100,,,3,3,2,1
Julian Phillips,F,22023,1641763,22300196,"NOV 15, 2023",CHI vs. ORL,L,4,0,2,0.0,0,1,0.0,0,0,0.0,0,0,0,0,0,0,0,1,0,-4,1,CHI,CHI,ORL,94,,,0,0,0,0
Julian Phillips,F,22023,1641763,22300152,"NOV 06, 2023",CHI vs. UTA,W,2,0,1,0.0,0,1,0.0,0,0,0.0,0,1,1,0,0,0,0,0,0,-5,1,CHI,CHI,UTA,130,,,1,1,0,1
Julian Phillips,F,22023,1641763,22300088,"OCT 28, 2023",CHI @ DET,L,1,0,0,0.0,0,0,0.0,0,0,0.0,0,0,0,0,0,0,0,0,0,0,1,CHI,DET,CHI,102,,,0,0,0,0
Julian Phillips,F,22023,1641763,22300070,"OCT 25, 2023",CHI vs. OKC,L,4,0,0,0.0,0,0,0.0,0,0,0.0,0,0,0,0,0,0,0,0,0,1,1,CHI,CHI,OKC,104,,,0,0,0,0
Julian Phillips,F,22023,1641763,22300752,"FEB 10, 2024",CHI @ ORL,L,7,0,0,0.0,0,0,0.0,0,0,0.0,0,1,1,0,0,0,0,0,0,-3,1,CHI,ORL,CHI,108,,,1,1,0,1
Seth Lundy,G,22023,1641754,22300626,"JAN 24, 2024",ATL @ GSW,L,3,0,1,0.0,0,0,0.0,0,0,0.0,0,2,2,0,0,0,0,0,0,-2,1,ATL,GSW,ATL,112,,,2,2,0,2
Seth Lundy,G,22023,1641754,22300595,"JAN 20, 2024",ATL vs. CLE,L,3,1,2,0.5,1,2,0.5,0,0,0.0,0,0,0,0,0,0,0,0,3,3,1,ATL,ATL,CLE,95,,,3,3,3,0
Seth Lundy,G,22023,1641754,22300543,"JAN 13, 2024",ATL vs. WAS,L,5,0,1,0.0,0,0,0.0,1,2,0.5,0,2,2,0,0,0,0,1,1,1,1,ATL,ATL,WAS,99,,,3,3,1,2
Seth Lundy,G,22023,1641754,22300533,"JAN 12, 2024",ATL vs. IND,L,4,0,1,0.0,0,1,0.0,2,2,1.0,0,0,0,0,0,0,0,0,2,2,1,ATL,ATL,IND,108,,,2,2,2,0
Seth Lundy,G,22023,1641754,22300480,"JAN 05, 2024",ATL @ IND,L,7,1,2,0.5,1,2,0.5,0,0,0.0,0,0,0,0,0,0,0,0,3,-2,1,ATL,IND,ATL,116,,,3,3,3,0
Seth Lundy,G,22023,1641754,22300408,"DEC 26, 2023",ATL @ CHI,L,1,0,1,0.0,0,1,0.0,0,0,0.0,0,0,0,0,0,0,1,0,0,-4,1,ATL,CHI,ATL,113,,,0,0,0,0
Seth Lundy,G,22023,1641754,22300393,"DEC 23, 2023",ATL vs. MEM,L,19,1,7,0.143,1,6,0.167,0,0,0.0,1,1,2,0,0,0,0,2,3,-9,1,ATL,ATL,MEM,119,,,5,5,3,2
Seth Lundy,G,22023,1641754,22300352,"DEC 18, 2023",ATL vs. DET,W,9,0,1,0.0,0,1,0.0,0,0,0.0,0,1,1,0,0,0,0,2,0,1,1,ATL,ATL,DET,130,,,1,1,0,1
Seth Lundy,G,22023,1641754,22300330,"DEC 15, 2023",ATL @ TOR,W,1,1,1,1.0,0,0,0.0,0,0,0.0,0,0,0,0,0,0,0,1,2,-3,1,ATL,TOR,ATL,125,,,2,2,2,0
Filip Petrusev,C,22023,1630196,22300098,"OCT 29, 2023",PHI vs. POR,W,3,0,0,0.0,0,0,0.0,0,0,0.0,0,1,1,0,0,0,0,0,0,3,1,PHI,PHI,POR,126,,,1,1,0,1
Filip Petrusev,C,22023,1630196,22300222,"NOV 20, 2023",SAC @ NOP,L,6,1,2,0.5,0,0,0.0,1,2,0.5,0,0,0,0,0,0,0,1,3,3,1,SAC,NOP,SAC,93,,,3,3,3,0
Filip Petrusev,C,22023,1630196,22300198,"NOV 15, 2023",SAC @ LAL,W,0,0,0,0.0,0,0,0.0,0,0,0.0,0,0,0,0,0,0,0,0,0,0,1,SAC,LAL,SAC,125,,,0,0,0,0
Filip Petrusev,C,22023,1630196,22300098,"OCT 29, 2023",PHI vs. POR,W,3,0,0,0.0,0,0,0.0,0,0,0.0,0,1,1,0,0,0,0,0,0,3,1,PHI,PHI,POR,126,,,1,1,0,1
Filip Petrusev,C,22023,1630196,22300222,"NOV 20, 2023",SAC @ NOP,L,6,1,2,0.5,0,0,0.0,1,2,0.5,0,0,0,0,0,0,0,1,3,3,1,SAC,NOP,SAC,93,,,3,3,3,0
Filip Petrusev,C,22023,1630196,22300198,"NOV 15, 2023",SAC @ LAL,W,0,0,0,0.0,0,0,0.0,0,0,0.0,0,0,0,0,0,0,0,0,0,0,1,SAC,LAL,SAC,125,,,0,0,0,0
Kessler Edwards,F,22023,1630556,22300746,"FEB 09, 2024",SAC vs. DEN,W,6,2,3,0.667,2,3,0.667,0,0,0.0,0,1,1,0,0,0,0,1,6,0,1,SAC,SAC,DEN,135,,,7,7,6,1
Kessler Edwards,F,22023,1630556,22300714,"FEB 05, 2024",SAC @ CLE,L,9,2,5,0.4,1,4,0.25,0,0,0.0,0,0,0,0,0,0,0,2,5,-4,1,SAC,CLE,SAC,110,,,5,5,5,0
Kessler Edwards,F,22023,1630556,22300700,"FEB 03, 2024",SAC @ CHI,W,0,0,0,0.0,0,0,0.0,0,0,0.0,0,0,0,0,0,0,0,0,0,-2,1,SAC,CHI,SAC,123,,,0,0,0,0
Kessler Edwards,F,22023,1630556,22300691,"FEB 02, 2024",SAC @ IND,W,15,0,0,0.0,0,0,0.0,0,0,0.0,0,4,4,1,2,1,0,1,0,11,1,SAC,IND,SAC,133,,,5,4,1,5
Kessler Edwards,F,22023,1630556,22300678,"JAN 31, 2024",SAC @ MIA,L,1,0,1,0.0,0,0,0.0,0,0,0.0,0,0,0,0,0,0,0,0,0,-8,1,SAC,MIA,SAC,106,,,0,0,0,0
Kessler Edwards,F,22023,1630556,22300651,"JAN 27, 2024",SAC @ DAL,W,1,0,0,0.0,0,0,0.0,0,0,0.0,0,0,0,0,0,1,0,0,0,-2,1,SAC,DAL,SAC,120,,,0,0,0,0
Kessler Edwards,F,22023,1630556,22300632,"JAN 25, 2024",SAC @ GSW,W,6,0,1,0.0,0,1,0.0,0,0,0.0,0,1,1,1,0,0,0,1,0,-1,1,SAC,GSW,SAC,134,,,2,1,1,2
Kessler Edwards,F,22023,1630556,22300532,"JAN 12, 2024",SAC @ PHI,L,6,1,3,0.333,0,1,0.0,0,0,0.0,1,0,1,0,0,0,0,1,2,3,1,SAC,PHI,SAC,90,,,3,3,2,1
Kessler Edwards,F,22023,1630556,22300512,"JAN 09, 2024",SAC @ DET,W,1,0,0,0.0,0,0,0.0,0,0,0.0,0,0,0,1,0,0,0,0,0,2,1,SAC,DET,SAC,131,,,1,0,1,1
Kessler Edwards,F,22023,1630556,22300500,"JAN 07, 2024",SAC vs. NOP,L,8,3,4,0.75,2,2,1.0,2,2,1.0,1,1,2,0,0,0,0,0,10,7,1,SAC,SAC,NOP,100,,,12,12,10,2
Kessler Edwards,F,22023,1630556,22300449,"DEC 31, 2023",SAC @ MEM,W,4,0,2,0.0,0,2,0.0,0,0,0.0,0,0,0,0,0,0,0,0,0,4,1,SAC,MEM,SAC,123,,,0,0,0,0
Kessler Edwards,F,22023,1630556,22300413,"DEC 26, 2023",SAC @ POR,L,2,0,0,0.0,0,0,0.0,0,0,0.0,0,0,0,0,0,0,0,0,0,2,1,SAC,POR,SAC,113,,,0,0,0,0
Kessler Edwards,F,22023,1630556,22300400,"DEC 23, 2023",SAC vs. MIN,L,0,0,0,0.0,0,0,0.0,0,0,0.0,0,0,0,0,0,0,0,0,0,0,1,SAC,SAC,MIN,98,,,0,0,0,0
Kessler Edwards,F,22023,1630556,22300387,"DEC 22, 2023",SAC vs. PHX,W,2,0,1,0.0,0,1,0.0,0,0,0.0,0,0,0,0,0,0,0,0,0,-6,1,SAC,SAC,PHX,120,,,0,0,0,0
Kessler Edwards,F,22023,1630556,22300373,"DEC 20, 2023",SAC vs. BOS,L,6,3,5,0.6,1,2,0.5,0,0,0.0,0,2,2,0,0,0,0,0,7,0,1,SAC,SAC,BOS,119,,,9,9,7,2
Kessler Edwards,F,22023,1630556,22300358,"DEC 18, 2023",SAC vs. WAS,W,4,1,2,0.5,1,2,0.5,0,0,0.0,0,1,1,1,0,0,0,0,3,-7,1,SAC,SAC,WAS,141,,,5,4,4,2
Kessler Edwards,F,22023,1630556,22300342,"DEC 16, 2023",SAC vs. UTA,W,2,0,0,0.0,0,0,0.0,0,0,0.0,0,0,0,0,0,0,0,0,0,1,1,SAC,SAC,UTA,125,,,0,0,0,0
Kessler Edwards,F,22023,1630556,22300324,"DEC 14, 2023",SAC vs. OKC,W,0,0,0,0.0,0,0,0.0,0,0,0.0,0,0,0,0,0,0,0,0,0,-2,1,SAC,SAC,OKC,128,,,0,0,0,0
Kessler Edwards,F,22023,1630556,22300309,"DEC 12, 2023",SAC @ LAC,L,8,3,3,1.0,1,1,1.0,0,0,0.0,0,0,0,0,0,0,0,0,7,12,1,SAC,LAC,SAC,99,,,7,7,7,0
Kessler Edwards,F,22023,1630556,22300303,"DEC 11, 2023",SAC vs. BKN,W,3,0,0,0.0,0,0,0.0,0,0,0.0,0,0,0,0,0,0,0,0,0,-7,1,SAC,SAC,BKN,131,,,0,0,0,0
Kessler Edwards,F,22023,1630556,22301228,"DEC 08, 2023",SAC @ PHX,W,1,0,0,0.0,0,0,0.0,0,0,0.0,0,0,0,0,0,0,0,1,0,-4,1,SAC,PHX,SAC,114,,,0,0,0,0
Kessler Edwards,F,22023,1630556,22300264,"NOV 29, 2023",SAC vs. LAC,L,7,0,1,0.0,0,1,0.0,0,0,0.0,1,0,1,0,0,0,0,0,0,-16,1,SAC,SAC,LAC,117,,,1,1,0,1
Kessler Edwards,F,22023,1630556,22300060,"NOV 28, 2023",SAC vs. GSW,W,5,0,1,0.0,0,1,0.0,0,0,0.0,0,2,2,0,0,0,0,0,0,-3,1,SAC,SAC,GSW,124,,,2,2,0,2
Kessler Edwards,F,22023,1630556,22300050,"NOV 24, 2023",SAC @ MIN,W,18,4,7,0.571,2,3,0.667,0,0,0.0,1,1,2,1,1,0,0,1,10,-7,1,SAC,MIN,SAC,124,,,13,12,11,3
Kessler Edwards,F,22023,1630556,22300233,"NOV 22, 2023",SAC @ NOP,L,1,0,1,0.0,0,1,0.0,0,0,0.0,0,0,0,0,0,0,0,0,0,0,1,SAC,NOP,SAC,112,,,0,0,0,0
Kessler Edwards,F,22023,1630556,22300222,"NOV 20, 2023",SAC @ NOP,L,15,1,4,0.25,1,4,0.25,0,0,0.0,0,4,4,0,0,1,0,2,3,-12,1,SAC,NOP,SAC,93,,,7,7,3,4
Kessler Edwards,F,22023,1630556,22300212,"NOV 19, 2023",SAC @ DAL,W,9,0,1,0.0,0,0,0.0,0,0,0.0,1,0,1,1,0,0,0,0,0,0,1,SAC,DAL,SAC,129,,,2,1,1,2
Kessler Edwards,F,22023,1630556,22300198,"NOV 15, 2023",SAC @ LAL,W,0,0,0,0.0,0,0,0.0,0,0,0.0,0,0,0,0,0,0,0,0,0,0,1,SAC,LAL,SAC,125,,,0,0,0,0
Kessler Edwards,F,22023,1630556,22300191,"NOV 13, 2023",SAC vs. CLE,W,1,0,0,0.0,0,0,0.0,0,0,0.0,0,0,0,0,0,0,0,0,0,-5,1,SAC,SAC,CLE,132,,,0,0,0,0
Kessler Edwards,F,22023,1630556,22300016,"NOV 10, 2023",SAC vs. OKC,W,3,0,0,0.0,0,0,0.0,0,0,0.0,0,0,0,0,0,0,0,0,0,-3,1,SAC,SAC,OKC,105,,,0,0,0,0
Kessler Edwards,F,22023,1630556,22300170,"NOV 08, 2023",SAC vs. POR,W,16,0,1,0.0,0,1,0.0,0,0,0.0,0,4,4,1,0,1,1,4,0,4,1,SAC,SAC,POR,121,,,5,4,1,5
Kessler Edwards,F,22023,1630556,22300153,"NOV 06, 2023",SAC @ HOU,L,12,1,4,0.25,1,2,0.5,1,2,0.5,0,1,1,2,1,0,0,1,4,11,1,SAC,HOU,SAC,97,,,7,5,6,3
Kessler Edwards,F,22023,1630556,22300137,"NOV 04, 2023",SAC @ HOU,L,1,0,0,0.0,0,0,0.0,0,0,0.0,0,0,0,0,0,0,0,0,0,0,1,SAC,HOU,SAC,89,,,0,0,0,0
Kessler Edwards,F,22023,1630556,22300100,"OCT 29, 2023",SAC vs. LAL,W,0,0,0,0.0,0,0,0.0,0,0,0.0,0,0,0,0,0,0,0,0,0,-2,1,SAC,SAC,LAL,132,,,0,0,0,0
Kessler Edwards,F,22023,1630556,22300072,"OCT 25, 2023",SAC @ UTA,W,1,0,1,0.0,0,1,0.0,0,0,0.0,0,0,0,0,0,0,0,0,0,-2,1,SAC,UTA,SAC,130,,,0,0,0,0
TyTy Washington Jr.,G,22023,1631102,22300745,"FEB 09, 2024",MIL vs. CHA,W,8,0,2,0.0,0,1,0.0,0,0,0.0,0,0,0,1,0,0,0,0,0,-4,1,MIL,MIL,CHA,120,,,1,0,1,1
TyTy Washington Jr.,G,22023,1631102,22300097,"OCT 29, 2023",MIL vs. ATL,L,3,1,2,0.5,1,1,1.0,0,0,0.0,0,0,0,0,0,0,1,0,3,10,1,MIL,MIL,ATL,110,,,3,3,3,0
TyTy Washington Jr.,G,22023,1631102,22300195,"NOV 15, 2023",MIL @ TOR,W,2,0,1,0.0,0,1,0.0,0,0,0.0,0,1,1,0,1,0,1,0,0,-7,1,MIL,TOR,MIL,128,,,1,1,0,1
Justin Minaya,F,22023,1631303,22300758,"FEB 10, 2024",POR vs. NOP,L,2,0,0,0.0,0,0,0.0,0,0,0.0,1,0,1,0,0,0,1,0,0,-2,1,POR,POR,NOP,75,,,1,1,0,1
Justin Minaya,F,22023,1631303,22300712,"FEB 04, 2024",POR @ DEN,L,10,0,1,0.0,0,0,0.0,0,0,0.0,2,0,2,1,0,0,0,0,0,-3,1,POR,DEN,POR,103,,,3,2,1,3
Justin Minaya,F,22023,1631303,22300697,"FEB 02, 2024",POR @ DEN,L,1,0,0,0.0,0,0,0.0,0,0,0.0,0,0,0,0,0,0,0,0,0,-2,1,POR,DEN,POR,108,,,0,0,0,0
Justin Minaya,F,22023,1631303,22300641,"JAN 26, 2024",POR @ SAS,L,22,0,3,0.0,0,3,0.0,0,0,0.0,0,2,2,1,1,1,1,1,0,-10,1,POR,SAS,POR,98,,,3,2,1,3
Justin Minaya,F,22023,1631303,22300590,"JAN 19, 2024",POR vs. IND,W,2,0,0,0.0,0,0,0.0,0,0,0.0,0,1,1,0,0,0,0,0,0,0,1,POR,POR,IND,118,,,1,1,0,1
Justin Minaya,F,22023,1631303,22300215,"NOV 19, 2023",POR vs. OKC,L,13,2,6,0.333,2,4,0.5,1,2,0.5,2,0,2,0,0,1,0,0,7,-7,1,POR,POR,OKC,89,,,9,9,7,2
Justin Minaya,F,22023,1631303,22300036,"NOV 17, 2023",POR vs. LAL,L,5,0,0,0.0,0,0,0.0,0,0,0.0,0,0,0,0,0,0,0,0,0,-2,1,POR,POR,LAL,95,,,0,0,0,0
Justin Minaya,F,22023,1631303,22300199,"NOV 15, 2023",POR vs. CLE,L,3,0,0,0.0,0,0,0.0,0,0,0.0,0,0,0,0,0,0,0,0,0,0,1,POR,POR,CLE,93,,,0,0,0,0
Justin Minaya,F,22023,1631303,22300023,"NOV 14, 2023",POR @ UTA,L,3,0,0,0.0,0,0,0.0,0,0,0.0,1,0,1,0,0,0,0,0,0,-1,1,POR,UTA,POR,99,,,1,1,0,1
Justin Minaya,F,22023,1631303,22300170,"NOV 08, 2023",POR @ SAC,L,8,0,0,0.0,0,0,0.0,0,0,0.0,1,1,2,0,0,0,1,1,0,-4,1,POR,SAC,POR,118,,,2,2,0,2
Justin Minaya,F,22023,1631303,22300538,"JAN 12, 2024",POR @ MIN,L,9,1,1,1.0,1,1,1.0,0,0,0.0,0,0,0,2,1,1,0,0,3,13,1,POR,MIN,POR,91,,,5,3,5,2
Justin Minaya,F,22023,1631303,22300514,"JAN 09, 2024",POR @ NYK,L,12,1,4,0.25,0,2,0.0,1,2,0.5,1,0,1,1,0,1,1,1,3,8,1,POR,NYK,POR,80,,,5,4,4,2
Justin Minaya,F,22023,1631303,22300741,"FEB 08, 2024",POR vs. DET,L,12,0,1,0.0,0,1,0.0,0,0,0.0,0,1,1,0,1,0,1,1,0,-3,1,POR,POR,DET,118,,,1,1,0,1
Justin Minaya,F,22023,1631303,22300554,"JAN 14, 2024",POR vs. PHX,L,17,0,1,0.0,0,1,0.0,1,2,0.5,0,2,2,0,0,0,0,5,1,-4,1,POR,POR,PHX,116,,,3,3,1,2
Justin Minaya,F,22023,1631303,22300529,"JAN 11, 2024",POR @ OKC,L,14,2,5,0.4,0,2,0.0,0,0,0.0,0,2,2,1,2,1,0,0,4,-5,1,POR,OKC,POR,77,,,7,6,5,3
Justin Minaya,F,22023,1631303,22301226,"DEC 08, 2023",POR vs. DAL,L,8,0,0,0.0,0,0,0.0,0,0,0.0,0,0,0,0,0,0,0,1,0,3,1,POR,POR,DAL,112,,,0,0,0,0
Dariq Whitehead,F,22023,1641727,22300417,"DEC 27, 2023",BKN vs. MIL,L,21,1,5,0.2,0,3,0.0,0,0,0.0,0,4,4,3,0,0,0,0,2,-16,1,BKN,BKN,MIL,122,,,9,6,5,7
Dariq Whitehead,F,22023,1641727,22300240,"NOV 25, 2023",BKN vs. MIA,W,3,0,0,0.0,0,0,0.0,1,2,0.5,0,0,0,0,0,1,0,0,1,-6,1,BKN,BKN,MIA,112,,,1,1,1,0
Keyontae Johnson,F,22023,1641749,22300622,"JAN 24, 2024",OKC @ SAS,W,5,0,2,0.0,0,0,0.0,0,0,0.0,0,0,0,1,0,0,1,0,0,-4,1,OKC,SAS,OKC,140,,,1,0,1,1
Keyontae Johnson,F,22023,1641749,22300617,"JAN 23, 2024",OKC vs. POR,W,5,0,0,0.0,0,0,0.0,0,0,0.0,1,0,1,1,0,0,0,1,0,-4,1,OKC,OKC,POR,111,,,2,1,1,2
Keyontae Johnson,F,22023,1641749,22300695,"FEB 02, 2024",OKC vs. CHA,W,10,0,1,0.0,0,0,0.0,0,0,0.0,0,0,0,0,0,0,1,1,0,-13,1,OKC,OKC,CHA,126,,,0,0,0,0
Keyontae Johnson,F,22023,1641749,22300529,"JAN 11, 2024",OKC vs. POR,W,18,2,5,0.4,0,1,0.0,0,0,0.0,1,2,3,2,0,0,2,1,4,13,1,OKC,OKC,POR,139,,,9,7,6,5
Keyontae Johnson,F,22023,1641749,22300095,"OCT 29, 2023",OKC vs. DEN,L,6,0,1,0.0,0,0,0.0,0,0,0.0,0,0,0,0,0,0,0,0,0,-2,1,OKC,OKC,DEN,95,,,0,0,0,0
Keyontae Johnson,F,22023,1641749,22300654,"JAN 28, 2024",OKC @ DET,L,13,2,3,0.667,1,1,1.0,0,0,0.0,1,1,2,0,0,0,0,1,5,4,1,OKC,DET,OKC,104,,,7,7,5,2
Keyontae Johnson,F,22023,1641749,22300640,"JAN 26, 2024",OKC @ NOP,W,2,0,0,0.0,0,0,0.0,0,0,0.0,0,0,0,0,0,0,0,0,0,-2,1,OKC,NOP,OKC,107,,,0,0,0,0
Garrett Temple,G-F,22023,202066,22300330,"DEC 15, 2023",TOR vs. ATL,L,3,0,0,0.0,0,0,0.0,0,0,0.0,0,0,0,1,0,0,0,0,0,1,1,TOR,TOR,ATL,104,,,1,0,1,1
Garrett Temple,G-F,22023,202066,22300038,"NOV 21, 2023",TOR @ ORL,L,4,1,1,1.0,0,0,0.0,0,0,0.0,0,0,0,2,0,0,0,0,2,4,1,TOR,ORL,TOR,107,,,4,2,4,2
Garrett Temple,G-F,22023,202066,22300195,"NOV 15, 2023",TOR vs. MIL,L,4,1,1,1.0,1,1,1.0,0,0,0.0,0,1,1,0,0,0,0,0,3,4,1,TOR,TOR,MIL,112,,,4,4,3,1
Garrett Temple,G-F,22023,202066,22300174,"NOV 11, 2023",TOR @ BOS,L,4,1,2,0.5,0,0,0.0,0,0,0.0,0,1,1,0,1,0,0,0,2,6,1,TOR,BOS,TOR,94,,,3,3,2,1
Garrett Temple,G-F,22023,202066,22300756,"FEB 10, 2024",TOR vs. CLE,L,3,0,0,0.0,0,0,0.0,0,0,0.0,0,0,0,0,0,0,1,0,0,-3,1,TOR,TOR,CLE,95,,,0,0,0,0
Garrett Temple,G-F,22023,202066,22300128,"NOV 02, 2023",TOR @ PHI,L,2,1,1,1.0,0,0,0.0,0,0,0.0,0,0,0,0,0,0,0,0,2,1,1,TOR,PHI,TOR,99,,,2,2,2,0
Garrett Temple,G-F,22023,202066,22300116,"NOV 01, 2023",TOR vs. MIL,W,3,0,0,0.0,0,0,0.0,2,2,1.0,0,0,0,0,0,0,0,0,2,-4,1,TOR,TOR,MIL,130,,,2,2,2,0
Garrett Temple,G-F,22023,202066,22300718,"FEB 05, 2024",TOR @ NOP,L,12,2,4,0.5,0,2,0.0,1,2,0.5,1,0,1,0,1,0,1,2,5,-4,1,TOR,NOP,TOR,100,,,6,6,5,1
Garrett Temple,G-F,22023,202066,22300692,"FEB 02, 2024",TOR @ HOU,L,4,0,2,0.0,0,1,0.0,0,0,0.0,0,0,0,0,0,0,0,0,0,-1,1,TOR,HOU,TOR,106,,,0,0,0,0
Garrett Temple,G-F,22023,202066,22300672,"JAN 30, 2024",TOR @ CHI,W,3,0,1,0.0,0,0,0.0,0,0,0.0,0,1,1,0,0,0,0,1,0,4,1,TOR,CHI,TOR,118,,,1,1,0,1
Garrett Temple,G-F,22023,202066,22300637,"JAN 26, 2024",TOR vs. LAC,L,2,0,1,0.0,0,1,0.0,0,0,0.0,1,0,1,0,0,0,1,0,0,-4,1,TOR,TOR,LAC,107,,,1,1,0,1
Garrett Temple,G-F,22023,202066,22300596,"JAN 20, 2024",TOR @ NYK,L,4,0,3,0.0,0,1,0.0,2,2,1.0,2,0,2,0,0,0,0,0,2,-2,1,TOR,NYK,TOR,94,,,4,4,2,2
Garrett Temple,G-F,22023,202066,22300574,"JAN 17, 2024",TOR vs. MIA,W,2,0,1,0.0,0,1,0.0,0,0,0.0,0,1,1,0,1,0,0,0,0,-3,1,TOR,TOR,MIA,115,,,1,1,0,1
Garrett Temple,G-F,22023,202066,22300540,"JAN 12, 2024",TOR @ UTA,L,8,0,1,0.0,0,1,0.0,0,0,0.0,1,0,1,2,0,0,1,1,0,-8,1,TOR,UTA,TOR,104,,,3,1,2,3
Garrett Temple,G-F,22023,202066,22300526,"JAN 10, 2024",TOR @ LAC,L,8,1,2,0.5,1,1,1.0,0,0,0.0,0,2,2,1,0,0,0,2,3,4,1,TOR,LAC,TOR,111,,,6,5,4,3
Garrett Temple,G-F,22023,202066,22300504,"JAN 07, 2024",TOR @ GSW,W,4,1,1,1.0,0,0,0.0,0,0,0.0,0,0,0,0,0,0,1,0,2,-5,1,TOR,GSW,TOR,131,,,2,2,2,0
R.J. Hampton,G,22023,1630181,22300489,"JAN 05, 2024",MIA @ PHX,L,2,0,0,0.0,0,0,0.0,0,0,0.0,0,0,0,1,0,0,0,1,0,5,1,MIA,PHX,MIA,97,,,1,0,1,1
R.J. Hampton,G,22023,1630181,22300475,"JAN 03, 2024",MIA @ LAL,W,1,0,0,0.0,0,0,0.0,0,0,0.0,0,0,0,0,0,0,0,0,0,0,1,MIA,LAL,MIA,110,,,0,0,0,0
R.J. Hampton,G,22023,1630181,22300458,"JAN 01, 2024",MIA @ LAC,L,12,0,1,0.0,0,1,0.0,0,0,0.0,0,0,0,0,0,0,0,2,0,9,1,MIA,LAC,MIA,104,,,0,0,0,0
R.J. Hampton,G,22023,1630181,22300439,"DEC 30, 2023",MIA @ UTA,L,8,0,1,0.0,0,1,0.0,0,0,0.0,0,2,2,0,0,0,1,1,0,-5,1,MIA,UTA,MIA,109,,,2,2,0,2
R.J. Hampton,G,22023,1630181,22300426,"DEC 28, 2023",MIA @ GSW,W,25,3,6,0.5,0,2,0.0,1,2,0.5,2,0,2,3,0,0,1,3,7,8,1,MIA,GSW,MIA,114,,,12,9,10,5
R.J. Hampton,G,22023,1630181,22300404,"DEC 25, 2023",MIA vs. PHI,W,17,0,4,0.0,0,3,0.0,0,0,0.0,0,0,0,4,0,0,0,0,0,-9,1,MIA,MIA,PHI,119,,,4,0,4,4
R.J. Hampton,G,22023,1630181,22300093,"OCT 28, 2023",MIA @ MIN,L,2,0,1,0.0,0,0,0.0,0,0,0.0,0,0,0,0,0,0,0,0,0,7,1,MIA,MIN,MIA,90,,,0,0,0,0
R.J. Hampton,G,22023,1630181,22300320,"DEC 14, 2023",MIA vs. CHI,L,9,1,1,1.0,1,1,1.0,0,0,0.0,0,2,2,0,0,0,1,1,3,6,1,MIA,MIA,CHI,116,,,5,5,3,2
Daishen Nix,G,22023,1630227,22300738,"FEB 08, 2024",MIN @ MIL,W,3,1,3,0.333,1,3,0.333,0,0,0.0,0,0,0,1,0,0,0,0,3,3,1,MIN,MIL,MIN,129,,,4,3,4,1
Daishen Nix,G,22023,1630227,22300301,"DEC 11, 2023",MIN @ NOP,L,2,0,0,0.0,0,0,0.0,0,2,0.0,0,0,0,0,0,0,0,0,0,1,1,MIN,NOP,MIN,107,,,0,0,0,0
Daishen Nix,G,22023,1630227,22300270,"NOV 30, 2023",MIN vs. UTA,W,10,1,5,0.2,1,4,0.25,0,0,0.0,0,1,1,0,0,0,0,0,3,6,1,MIN,MIN,UTA,101,,,4,4,3,1
Daishen Nix,G,22023,1630227,22300249,"NOV 26, 2023",MIN @ MEM,W,2,1,2,0.5,1,1,1.0,0,0,0.0,0,0,0,0,0,0,0,0,3,3,1,MIN,MEM,MIN,119,,,3,3,3,0
Daishen Nix,G,22023,1630227,22300166,"NOV 08, 2023",MIN vs. NOP,W,3,0,0,0.0,0,0,0.0,0,0,0.0,0,0,0,0,0,0,0,0,0,-6,1,MIN,MIN,NOP,122,,,0,0,0,0
Daishen Nix,G,22023,1630227,22300138,"NOV 04, 2023",MIN vs. UTA,W,3,1,1,1.0,0,0,0.0,0,0,0.0,0,0,0,0,1,0,0,0,2,6,1,MIN,MIN,UTA,123,,,2,2,2,0
Daishen Nix,G,22023,1630227,22300104,"OCT 30, 2023",MIN @ ATL,L,1,0,0,0.0,0,0,0.0,0,0,0.0,0,0,0,0,0,0,0,0,0,4,1,MIN,ATL,MIN,113,,,0,0,0,0
Jermaine Samuels Jr.,F,22023,1631257,22300709,"FEB 04, 2024",HOU @ MIN,L,4,2,2,1.0,0,0,0.0,0,0,0.0,0,1,1,0,0,0,0,0,4,7,1,HOU,MIN,HOU,90,,,5,5,4,1
Jermaine Samuels Jr.,F,22023,1631257,22300692,"FEB 02, 2024",HOU vs. TOR,W,4,1,1,1.0,0,0,0.0,0,0,0.0,0,0,0,0,0,0,0,1,2,1,1,HOU,HOU,TOR,135,,,2,2,2,0
Jermaine Samuels Jr.,F,22023,1631257,22300679,"JAN 31, 2024",HOU vs. NOP,L,1,0,0,0.0,0,0,0.0,0,0,0.0,0,0,0,0,0,0,0,0,0,2,1,HOU,HOU,NOP,99,,,0,0,0,0
Jermaine Samuels Jr.,F,22023,1631257,22300662,"JAN 29, 2024",HOU vs. LAL,W,0,0,0,0.0,0,0,0.0,0,0,0.0,0,0,0,0,0,0,0,0,0,-3,1,HOU,HOU,LAL,135,,,0,0,0,0
Jermaine Samuels Jr.,F,22023,1631257,22300635,"JAN 26, 2024",HOU @ CHA,W,6,0,1,0.0,0,0,0.0,0,0,0.0,1,1,2,0,0,0,0,0,0,-5,1,HOU,CHA,HOU,138,,,2,2,0,2
Jermaine Samuels Jr.,F,22023,1631257,22300385,"DEC 22, 2023",HOU vs. DAL,W,9,3,3,1.0,0,0,0.0,0,0,0.0,0,1,1,0,1,0,0,0,6,-5,1,HOU,HOU,DAL,122,,,7,7,6,1
Jermaine Samuels Jr.,F,22023,1631257,22300291,"DEC 02, 2023",HOU @ LAL,L,3,0,0,0.0,0,0,0.0,0,0,0.0,0,2,2,0,0,0,0,0,0,8,1,HOU,LAL,HOU,97,,,2,2,0,2
Jermaine Samuels Jr.,F,22023,1631257,22300263,"NOV 29, 2023",HOU @ DEN,L,6,0,1,0.0,0,1,0.0,0,0,0.0,0,2,2,2,0,0,0,0,0,6,1,HOU,DEN,HOU,124,,,4,2,2,4
Jermaine Samuels Jr.,F,22023,1631257,22300153,"NOV 06, 2023",HOU vs. SAC,W,12,2,2,1.0,0,0,0.0,0,0,0.0,1,2,3,0,0,1,0,1,4,-12,1,HOU,HOU,SAC,122,,,7,7,4,3
Jermaine Samuels Jr.,F,22023,1631257,22300137,"NOV 04, 2023",HOU vs. SAC,W,1,0,1,0.0,0,1,0.0,2,2,1.0,0,0,0,0,0,0,0,1,2,0,1,HOU,HOU,SAC,107,,,2,2,2,0
Jermaine Samuels Jr.,F,22023,1631257,22300066,"OCT 25, 2023",HOU @ ORL,L,6,0,0,0.0,0,0,0.0,0,0,0.0,0,0,0,0,0,0,0,1,0,-10,1,HOU,ORL,HOU,86,,,0,0,0,0
Kobe Bufkin,G,22023,1641723,22300754,"FEB 10, 2024",ATL vs. HOU,W,16,1,4,0.25,1,4,0.25,0,0,0.0,1,2,3,0,0,0,0,1,3,0,1,ATL,ATL,HOU,122,,,6,6,3,3
Kobe Bufkin,G,22023,1641723,22300669,"JAN 30, 2024",ATL vs. LAL,W,2,1,1,1.0,1,1,1.0,0,0,0.0,0,1,1,1,0,0,0,0,3,1,1,ATL,ATL,LAL,138,,,5,4,4,2
Kobe Bufkin,G,22023,1641723,22300104,"OCT 30, 2023",ATL vs. MIN,W,1,0,1,0.0,0,0,0.0,0,0,0.0,0,0,0,0,0,0,0,0,0,-4,1,ATL,ATL,MIN,127,,,0,0,0,0
Kobe Bufkin,G,22023,1641723,22300097,"OCT 29, 2023",ATL @ MIL,W,3,0,2,0.0,0,1,0.0,1,2,0.5,1,1,2,0,0,0,0,0,1,-10,1,ATL,MIL,ATL,127,,,3,3,1,2
Brice Sensabaugh,F,22023,1641729,22300540,"JAN 12, 2024",UTA vs. TOR,W,4,2,4,0.5,1,2,0.5,0,0,0.0,0,0,0,2,0,0,0,1,5,5,1,UTA,UTA,TOR,145,,,7,5,7,2
Brice Sensabaugh,F,22023,1641729,22300524,"JAN 10, 2024",UTA vs. DEN,W,3,0,0,0.0,0,0,0.0,0,0,0.0,0,0,0,0,0,0,0,0,0,-5,1,UTA,UTA,DEN,124,,,0,0,0,0
Brice Sensabaugh,F,22023,1641729,22300412,"DEC 26, 2023",UTA @ SAS,W,2,0,0,0.0,0,0,0.0,0,0,0.0,0,1,1,0,0,0,0,0,0,-7,1,UTA,SAS,UTA,130,,,1,1,0,1
Brice Sensabaugh,F,22023,1641729,22300072,"OCT 25, 2023",UTA vs. SAC,L,2,0,2,0.0,0,0,0.0,0,0,0.0,1,1,2,0,0,0,0,0,0,2,1,UTA,UTA,SAC,114,,,2,2,0,2
Chris Livingston,F,22023,1641753,22300711,"FEB 04, 2024",MIL @ UTA,L,1,0,1,0.0,0,0,0.0,0,0,0.0,0,0,0,0,0,0,0,0,0,0,1,MIL,UTA,MIL,108,,,0,0,0,0
Chris Livingston,F,22023,1641753,22300648,"JAN 27, 2024",MIL vs. NOP,W,2,0,1,0.0,0,0,0.0,0,0,0.0,0,1,1,0,0,0,0,2,0,-3,1,MIL,MIL,NOP,141,,,1,1,0,1
Chris Livingston,F,22023,1641753,22300545,"JAN 13, 2024",MIL vs. GSW,W,1,0,0,0.0,0,0,0.0,0,0,0.0,0,0,0,0,0,0,0,0,0,0,1,MIL,MIL,GSW,129,,,0,0,0,0
Chris Livingston,F,22023,1641753,22300528,"JAN 11, 2024",MIL vs. BOS,W,9,1,1,1.0,0,0,0.0,0,0,0.0,0,2,2,1,0,0,1,0,2,-2,1,MIL,MIL,BOS,135,,,5,4,3,3
Chris Livingston,F,22023,1641753,22300510,"JAN 08, 2024",MIL vs. UTA,L,15,2,5,0.4,0,0,0.0,2,2,1.0,1,1,2,0,1,0,1,1,6,0,1,MIL,MIL,UTA,116,,,8,8,6,2
Chris Livingston,F,22023,1641753,22300466,"JAN 03, 2024",MIL @ IND,L,2,0,0,0.0,0,0,0.0,0,0,0.0,0,1,1,1,0,0,0,0,0,5,1,MIL,IND,MIL,130,,,2,1,1,2
Chris Livingston,F,22023,1641753,22300417,"DEC 27, 2023",MIL @ BKN,W,1,1,1,1.0,0,0,0.0,0,0,0.0,0,1,1,1,0,0,0,0,2,6,1,MIL,BKN,MIL,144,,,4,3,3,2
Chris Livingston,F,22023,1641753,22300388,"DEC 23, 2023",MIL @ NYK,W,0,0,0,0.0,0,0,0.0,0,0,0.0,0,0,0,0,0,0,0,0,0,0,1,MIL,NYK,MIL,130,,,0,0,0,0
Chris Livingston,F,22023,1641753,22300346,"DEC 17, 2023",MIL vs. HOU,W,0,0,0,0.0,0,0,0.0,0,0,0.0,0,0,0,0,0,0,0,0,0,-3,1,MIL,MIL,HOU,128,,,0,0,0,0
Chris Livingston,F,22023,1641753,22300334,"DEC 16, 2023",MIL vs. DET,W,9,1,1,1.0,0,0,0.0,0,0,0.0,0,3,3,0,0,0,0,2,2,0,1,MIL,MIL,DET,146,,,5,5,2,3
Chris Livingston,F,22023,1641753,22301201,"DEC 05, 2023",MIL vs. NYK,W,2,0,1,0.0,0,0,0.0,0,0,0.0,1,1,2,0,1,0,1,0,0,4,1,MIL,MIL,NYK,146,,,2,2,0,2
Chris Livingston,F,22023,1641753,22300173,"NOV 11, 2023",MIL @ ORL,L,4,0,0,0.0,0,0,0.0,0,0,0.0,0,0,0,0,0,0,0,0,0,-4,1,MIL,ORL,MIL,97,,,0,0,0,0
Chris Livingston,F,22023,1641753,22300116,"NOV 01, 2023",MIL @ TOR,L,6,2,2,1.0,1,1,1.0,0,0,0.0,0,0,0,1,0,0,0,0,5,6,1,MIL,TOR,MIL,111,,,6,5,6,1
Chris Livingston,F,22023,1641753,22300572,"JAN 17, 2024",MIL @ CLE,L,9,0,1,0.0,0,0,0.0,0,0,0.0,0,1,1,0,0,0,0,2,0,-6,1,MIL,CLE,MIL,95,,,1,1,0,1
Braxton Key,F,22023,1630296,22300697,"FEB 02, 2024",DEN vs. POR,W,1,0,0,0.0,0,0,0.0,0,0,0.0,0,0,0,0,0,0,0,0,0,2,1,DEN,DEN,POR,120,,,0,0,0,0
Braxton Key,F,22023,1630296,22300539,"JAN 12, 2024",DEN vs. NOP,W,1,0,0,0.0,0,0,0.0,0,0,0.0,0,0,0,0,0,0,1,0,0,-4,1,DEN,DEN,NOP,125,,,0,0,0,0
Braxton Key,F,22023,1630296,22300524,"JAN 10, 2024",DEN @ UTA,L,6,1,1,1.0,0,0,0.0,0,0,0.0,1,0,1,1,1,0,0,0,2,12,1,DEN,UTA,DEN,111,,,4,3,3,2
Braxton Key,F,22023,1630296,22300502,"JAN 07, 2024",DEN vs. DET,W,2,0,0,0.0,0,0,0.0,2,2,1.0,0,1,1,0,0,0,0,0,2,-6,1,DEN,DEN,DET,131,,,3,3,2,1
Braxton Key,F,22023,1630296,22300488,"JAN 05, 2024",DEN vs. ORL,L,6,1,3,0.333,1,2,0.5,0,0,0.0,0,2,2,1,0,0,0,1,3,6,1,DEN,DEN,ORL,120,,,6,5,4,3
Braxton Key,F,22023,1630296,22300455,"JAN 01, 2024",DEN vs. CHA,W,4,0,1,0.0,0,0,0.0,0,0,0.0,0,1,1,0,1,0,0,0,0,-6,1,DEN,DEN,CHA,111,,,1,1,0,1
Braxton Key,F,22023,1630296,22300435,"DEC 29, 2023",DEN vs. OKC,L,3,1,2,0.5,0,0,0.0,1,1,1.0,0,0,0,0,0,0,0,0,3,-6,1,DEN,DEN,OKC,93,,,3,3,3,0
Braxton Key,F,22023,1630296,22300425,"DEC 28, 2023",DEN vs. MEM,W,7,1,2,0.5,0,0,0.0,0,0,0.0,1,1,2,1,0,0,0,0,2,8,1,DEN,DEN,MEM,142,,,5,4,3,3
Braxton Key,F,22023,1630296,22300263,"NOV 29, 2023",DEN vs. HOU,W,3,0,0,0.0,0,0,0.0,1,2,0.5,0,1,1,1,0,0,0,1,1,-9,1,DEN,DEN,HOU,134,,,3,2,2,2
Braxton Key,F,22023,1630296,22300252,"NOV 26, 2023",DEN vs. SAS,W,2,0,1,0.0,0,1,0.0,0,0,0.0,0,1,1,1,0,0,0,0,0,-4,1,DEN,DEN,SAS,132,,,2,1,1,2
Braxton Key,F,22023,1630296,22300156,"NOV 06, 2023",DEN vs. NOP,W,1,0,0,0.0,0,0,0.0,0,0,0.0,0,0,0,0,0,0,0,0,0,3,1,DEN,DEN,NOP,134,,,0,0,0,0
Braxton Key,F,22023,1630296,22300123,"NOV 01, 2023",DEN @ MIN,L,5,0,2,0.0,0,0,0.0,0,0,0.0,0,0,0,3,0,0,0,2,0,0,1,DEN,MIN,DEN,89,,,3,0,3,3
Braxton Key,F,22023,1630296,22300095,"OCT 29, 2023",DEN @ OKC,W,3,1,2,0.5,0,1,0.0,0,0,0.0,0,1,1,0,0,0,0,0,2,0,1,DEN,OKC,DEN,128,,,3,3,2,1
Braxton Key,F,22023,1630296,22300061,"OCT 24, 2023",DEN vs. LAL,W,1,0,0,0.0,0,0,0.0,0,0,0.0,0,0,0,0,0,0,0,0,0,0,1,DEN,DEN,LAL,119,,,0,0,0,0
Jay Huff,C,22023,1630643,22300746,"FEB 09, 2024",DEN @ SAC,L,4,1,1,1.0,1,1,1.0,0,0,0.0,0,2,2,0,0,0,0,0,3,-1,1,DEN,SAC,DEN,106,,,5,5,3,2
Jay Huff,C,22023,1630643,22300697,"FEB 02, 2024",DEN vs. POR,W,1,0,0,0.0,0,0,0.0,0,0,0.0,0,0,0,0,1,0,0,0,0,2,1,DEN,DEN,POR,120,,,0,0,0,0
Jay Huff,C,22023,1630643,22300631,"JAN 25, 2024",DEN @ NYK,L,5,1,2,0.5,1,2,0.5,0,0,0.0,0,0,0,0,0,0,0,2,3,-3,1,DEN,NYK,DEN,84,,,3,3,3,0
Jay Huff,C,22023,1630643,22300539,"JAN 12, 2024",DEN vs. NOP,W,2,0,0,0.0,0,0,0.0,0,0,0.0,0,1,1,0,0,0,0,1,0,-6,1,DEN,DEN,NOP,125,,,1,1,0,1
Jay Huff,C,22023,1630643,22300524,"JAN 10, 2024",DEN @ UTA,L,6,1,2,0.5,0,1,0.0,0,0,0.0,0,0,0,1,0,0,1,1,2,12,1,DEN,UTA,DEN,111,,,3,2,3,1
Jay Huff,C,22023,1630643,22300502,"JAN 07, 2024",DEN vs. DET,W,2,0,1,0.0,0,1,0.0,0,0,0.0,0,0,0,0,0,0,0,1,0,-6,1,DEN,DEN,DET,131,,,0,0,0,0
Jay Huff,C,22023,1630643,22300257,"NOV 27, 2023",DEN @ LAC,W,0,0,0,0.0,0,0,0.0,0,0,0.0,0,0,0,0,0,0,0,0,0,0,1,DEN,LAC,DEN,113,,,0,0,0,0
Jay Huff,C,22023,1630643,22300252,"NOV 26, 2023",DEN vs. SAS,W,2,1,1,1.0,0,0,0.0,0,0,0.0,0,0,0,0,0,0,0,0,2,-4,1,DEN,DEN,SAS,132,,,2,2,2,0
Sidy Cissoko,G,22023,1631321,22300448,"DEC 31, 2023",SAS vs. BOS,L,8,0,2,0.0,0,2,0.0,0,0,0.0,0,2,2,0,1,0,0,0,0,4,1,SAS,SAS,BOS,101,,,2,2,0,2
Sidy Cissoko,G,22023,1631321,22300223,"NOV 20, 2023",SAS vs. LAC,L,4,0,0,0.0,0,0,0.0,0,0,0.0,0,0,0,0,0,0,1,0,0,-3,1,SAS,SAS,LAC,99,,,0,0,0,0
Sidy Cissoko,G,22023,1631321,22300412,"DEC 26, 2023",SAS vs. UTA,L,2,1,1,1.0,0,0,0.0,2,2,1.0,0,1,1,0,0,0,0,0,4,7,1,SAS,SAS,UTA,118,,,5,5,4,1
Sidy Cissoko,G,22023,1631321,22300398,"DEC 23, 2023",SAS @ DAL,L,14,0,3,0.0,0,2,0.0,2,2,1.0,0,3,3,0,2,0,0,2,2,6,1,SAS,DAL,SAS,119,,,5,5,2,3
Sidy Cissoko,G,22023,1631321,22300376,"DEC 21, 2023",SAS @ CHI,L,3,0,0,0.0,0,0,0.0,0,0,0.0,0,0,0,0,0,0,0,0,0,1,1,SAS,CHI,SAS,95,,,0,0,0,0
DaQuan Jeffries,G-F,22023,1629610,22300368,"DEC 20, 2023",NYK @ BKN,W,3,2,3,0.667,0,0,0.0,0,0,0.0,0,0,0,0,0,0,0,1,4,-6,1,NYK,BKN,NYK,119,,,4,4,4,0
DaQuan Jeffries,G-F,22023,1629610,22300343,"DEC 16, 2023",NYK @ LAC,L,6,0,1,0.0,0,1,0.0,0,0,0.0,0,2,2,1,0,0,0,0,0,2,1,NYK,LAC,NYK,120,,,3,2,1,3
DaQuan Jeffries,G-F,22023,1629610,22300333,"DEC 15, 2023",NYK @ PHX,W,1,0,0,0.0,0,0,0.0,0,0,0.0,0,0,0,0,0,0,0,0,0,-1,1,NYK,PHX,NYK,139,,,0,0,0,0
DaQuan Jeffries,G-F,22023,1629610,22300221,"NOV 20, 2023",NYK @ MIN,L,3,0,3,0.0,0,1,0.0,0,2,0.0,0,1,1,0,0,0,0,0,0,0,1,NYK,MIN,NYK,100,,,1,1,0,1
DaQuan Jeffries,G-F,22023,1629610,22300028,"NOV 17, 2023",NYK @ WAS,W,2,0,0,0.0,0,0,0.0,0,0,0.0,0,0,0,0,0,0,0,0,0,1,1,NYK,WAS,NYK,120,,,0,0,0,0
DaQuan Jeffries,G-F,22023,1629610,22300177,"NOV 12, 2023",NYK vs. CHA,W,3,1,1,1.0,0,0,0.0,0,0,0.0,0,0,0,1,0,0,0,0,2,-7,1,NYK,NYK,CHA,129,,,3,2,3,1
DaQuan Jeffries,G-F,22023,1629610,22300161,"NOV 08, 2023",NYK vs. SAS,W,2,0,1,0.0,0,1,0.0,0,0,0.0,0,1,1,0,0,0,1,0,0,-2,1,NYK,NYK,SAS,126,,,1,1,0,1
DaQuan Jeffries,G-F,22023,1629610,22300112,"OCT 31, 2023",NYK @ CLE,W,4,0,1,0.0,0,1,0.0,0,0,0.0,0,0,0,0,0,0,0,1,0,-5,1,NYK,CLE,NYK,109,,,0,0,0,0
DaQuan Jeffries,G-F,22023,1629610,22300057,"NOV 28, 2023",NYK vs. CHA,W,1,0,0,0.0,0,0,0.0,0,0,0.0,0,0,0,0,0,0,0,0,0,-1,1,NYK,NYK,CHA,115,,,0,0,0,0
DaQuan Jeffries,G-F,22023,1629610,22300090,"OCT 28, 2023",NYK @ NOP,L,3,2,2,1.0,1,1,1.0,0,0,0.0,0,1,1,0,0,0,0,0,5,10,1,NYK,NOP,NYK,87,,,6,6,5,1
Admiral Schofield,F,22023,1629678,22300607,"JAN 22, 2024",ORL vs. CLE,L,3,0,2,0.0,0,1,0.0,0,0,0.0,0,1,1,0,0,0,0,0,0,5,1,ORL,ORL,CLE,99,,,1,1,0,1
Admiral Schofield,F,22023,1629678,22300488,"JAN 05, 2024",ORL @ DEN,W,9,2,3,0.667,1,2,0.5,0,0,0.0,1,0,1,1,0,0,0,0,5,0,1,ORL,DEN,ORL,122,,,7,6,6,2
Admiral Schofield,F,22023,1629678,22300415,"DEC 27, 2023",ORL vs. PHI,L,1,0,0,0.0,0,0,0.0,0,0,0.0,0,0,0,0,0,0,0,0,0,3,1,ORL,ORL,PHI,92,,,0,0,0,0
Admiral Schofield,F,22023,1629678,22300344,"DEC 17, 2023",ORL @ BOS,L,2,0,0,0.0,0,0,0.0,0,0,0.0,0,0,0,1,0,0,0,0,0,4,1,ORL,BOS,ORL,97,,,1,0,1,1
Admiral Schofield,F,22023,1629678,22300329,"DEC 15, 2023",ORL @ BOS,L,3,0,1,0.0,0,0,0.0,0,0,0.0,0,2,2,0,0,0,1,1,0,3,1,ORL,BOS,ORL,111,,,2,2,0,2
Admiral Schofield,F,22023,1629678,22301217,"DEC 08, 2023",ORL vs. DET,W,4,1,2,0.5,0,0,0.0,0,0,0.0,0,2,2,0,0,0,2,3,2,1,1,ORL,ORL,DET,123,,,4,4,2,2
Admiral Schofield,F,22023,1629678,22300282,"DEC 02, 2023",ORL @ BKN,L,4,0,2,0.0,0,2,0.0,0,0,0.0,0,1,1,1,0,0,0,0,0,-5,1,ORL,BKN,ORL,101,,,2,1,1,2
Admiral Schofield,F,22023,1629678,22300259,"NOV 29, 2023",ORL vs. WAS,W,4,0,0,0.0,0,0,0.0,0,0,0.0,0,0,0,0,0,0,0,1,0,0,1,ORL,ORL,WAS,139,,,0,0,0,0
Admiral Schofield,F,22023,1629678,22300038,"NOV 21, 2023",ORL vs. TOR,W,2,0,0,0.0,0,0,0.0,0,0,0.0,0,0,0,0,0,0,0,0,0,2,1,ORL,ORL,TOR,126,,,0,0,0,0
Admiral Schofield,F,22023,1629678,22300209,"NOV 19, 2023",ORL @ IND,W,5,0,1,0.0,0,1,0.0,0,2,0.0,0,0,0,0,0,0,1,1,0,-12,1,ORL,IND,ORL,128,,,0,0,0,0
Admiral Schofield,F,22023,1629678,22300134,"NOV 04, 2023",ORL vs. LAL,W,3,2,4,0.5,1,3,0.333,0,0,0.0,0,0,0,0,0,0,0,0,5,3,1,ORL,ORL,LAL,120,,,5,5,5,0
Admiral Schofield,F,22023,1629678,22300476,"JAN 03, 2024",ORL @ SAC,L,6,0,0,0.0,0,0,0.0,0,0,0.0,0,0,0,1,0,0,0,1,0,5,1,ORL,SAC,ORL,135,,,1,0,1,1
Aleksej Pokusevski,F,22023,1630197,22300622,"JAN 24, 2024",OKC @ SAS,W,5,1,2,0.5,0,1,0.0,0,0,0.0,0,1,1,0,0,0,0,0,2,-4,1,OKC,SAS,OKC,140,,,3,3,2,1
Aleksej Pokusevski,F,22023,1630197,22300302,"DEC 11, 2023",OKC vs. UTA,W,9,0,2,0.0,0,2,0.0,0,0,0.0,0,1,1,0,0,0,0,0,0,-17,1,OKC,OKC,UTA,134,,,1,1,0,1
Aleksej Pokusevski,F,22023,1630197,22300215,"NOV 19, 2023",OKC @ POR,W,9,2,3,0.667,1,1,1.0,0,0,0.0,2,1,3,4,0,0,0,1,5,9,1,OKC,POR,OKC,134,,,12,8,9,7
Aleksej Pokusevski,F,22023,1630197,22300109,"OCT 30, 2023",OKC vs. DET,W,2,0,2,0.0,0,2,0.0,0,0,0.0,0,0,0,0,0,0,1,2,0,-8,1,OKC,OKC,DET,124,,,0,0,0,0
Aleksej Pokusevski,F,22023,1630197,22300748,"FEB 10, 2024",OKC @ DAL,L,6,0,1,0.0,0,1,0.0,0,0,0.0,0,0,0,0,0,0,0,0,0,0,1,OKC,DAL,OKC,111,,,0,0,0,0
Aleksej Pokusevski,F,22023,1630197,22300695,"FEB 02, 2024",OKC vs. CHA,W,7,1,2,0.5,1,1,1.0,1,2,0.5,0,1,1,0,1,0,0,0,4,-8,1,OKC,OKC,CHA,126,,,5,5,4,1
Aleksej Pokusevski,F,22023,1630197,22300095,"OCT 29, 2023",OKC vs. DEN,L,14,0,1,0.0,0,1,0.0,1,2,0.5,0,1,1,0,0,1,2,1,1,-11,1,OKC,OKC,DEN,95,,,2,2,1,1
Aleksej Pokusevski,F,22023,1630197,22300070,"OCT 25, 2023",OKC @ CHI,W,2,0,1,0.0,0,1,0.0,0,0,0.0,0,2,2,0,0,0,0,0,0,0,1,OKC,CHI,OKC,124,,,2,2,0,2
Aleksej Pokusevski,F,22023,1630197,22300271,"NOV 30, 2023",OKC vs. LAL,W,3,0,1,0.0,0,0,0.0,0,0,0.0,0,0,0,0,0,0,0,1,0,3,1,OKC,OKC,LAL,133,,,0,0,0,0
Aleksej Pokusevski,F,22023,1630197,22300021,"NOV 14, 2023",OKC vs. SAS,W,5,0,1,0.0,0,1,0.0,0,0,0.0,0,1,1,1,0,0,0,0,0,2,1,OKC,OKC,SAS,123,,,2,1,1,2
JD Davison,G,22023,1631120,22300571,"JAN 17, 2024",BOS vs. SAS,W,3,0,0,0.0,0,0,0.0,2,2,1.0,1,0,1,0,0,0,0,0,2,-1,1,BOS,BOS,SAS,117,,,3,3,2,1
JD Davison,G,22023,1631120,22300389,"DEC 23, 2023",BOS @ LAC,W,3,0,1,0.0,0,1,0.0,0,0,0.0,0,1,1,0,0,0,0,0,0,2,1,BOS,LAC,BOS,142,,,1,1,0,1
Alex Fudge,F,22023,1641788,22300271,"NOV 30, 2023",LAL @ OKC,L,4,0,1,0.0,0,1,0.0,2,2,1.0,1,0,1,0,0,0,0,0,2,-5,1,LAL,OKC,LAL,110,,,3,3,2,1
Alex Fudge,F,22023,1641788,22300134,"NOV 04, 2023",LAL @ ORL,L,4,0,1,0.0,0,0,0.0,0,0,0.0,0,0,0,0,0,0,0,0,0,-3,1,LAL,ORL,LAL,101,,,0,0,0,0
Alex Fudge,F,22023,1641788,22300258,"NOV 29, 2023",LAL @ DET,W,4,0,3,0.0,0,1,0.0,0,0,0.0,1,0,1,0,0,0,0,1,0,-3,1,LAL,DET,LAL,133,,,1,1,0,1
Alex Fudge,F,22023,1641788,22300255,"NOV 27, 2023",LAL @ PHI,L,2,1,1,1.0,0,0,0.0,0,0,0.0,0,0,0,0,0,0,1,0,2,-9,1,LAL,PHI,LAL,94,,,2,2,2,0
Javon Freeman-Liberty,G,22023,1631241,22300637,"JAN 26, 2024",TOR vs. LAC,L,2,0,0,0.0,0,0,0.0,0,0,0.0,0,0,0,0,0,0,0,0,0,-4,1,TOR,TOR,LAC,107,,,0,0,0,0
Javon Freeman-Liberty,G,22023,1631241,22300574,"JAN 17, 2024",TOR vs. MIA,W,2,1,3,0.333,0,0,0.0,0,0,0.0,1,0,1,0,0,0,0,0,2,-3,1,TOR,TOR,MIA,115,,,3,3,2,1
Frank Ntilikina,G,22023,1628373,22300635,"JAN 26, 2024",CHA vs. HOU,L,9,1,2,0.5,1,2,0.5,2,2,1.0,0,0,0,0,0,0,0,0,5,-6,1,CHA,CHA,HOU,104,,,5,5,5,0
Frank Ntilikina,G,22023,1628373,22300619,"JAN 24, 2024",CHA @ DET,L,9,0,1,0.0,0,1,0.0,0,0,0.0,0,0,0,0,0,0,0,1,0,8,1,CHA,DET,CHA,106,,,0,0,0,0
Frank Ntilikina,G,22023,1628373,22300575,"JAN 17, 2024",CHA @ NOP,L,4,0,1,0.0,0,1,0.0,0,0,0.0,0,1,1,1,0,0,1,0,0,-1,1,CHA,NOP,CHA,108,,,2,1,1,2
Frank Ntilikina,G,22023,1628373,22300674,"JAN 31, 2024",CHA vs. CHI,L,10,0,4,0.0,0,4,0.0,0,0,0.0,0,3,3,3,0,0,0,0,0,9,1,CHA,CHA,CHI,110,,,6,3,3,6
Frank Ntilikina,G,22023,1628373,22300657,"JAN 29, 2024",CHA vs. NYK,L,11,0,1,0.0,0,0,0.0,0,0,0.0,1,1,2,0,0,0,0,3,0,-11,1,CHA,CHA,NYK,92,,,2,2,0,2
Robin Lopez,C,22023,201577,22300725,"FEB 06, 2024",MIL @ PHX,L,18,3,8,0.375,0,1,0.0,0,0,0.0,1,0,1,0,1,2,0,2,6,-13,1,MIL,PHX,MIL,106,,,7,7,6,1
Robin Lopez,C,22023,201577,22300711,"FEB 04, 2024",MIL @ UTA,L,4,0,2,0.0,0,1,0.0,0,0,0.0,1,0,1,0,0,0,1,1,0,-6,1,MIL,UTA,MIL,108,,,1,1,0,1
Robin Lopez,C,22023,201577,22300702,"FEB 03, 2024",MIL @ DAL,W,4,1,1,1.0,0,0,0.0,0,0,0.0,0,0,0,0,0,0,0,0,2,-1,1,MIL,DAL,MIL,129,,,2,2,2,0
Robin Lopez,C,22023,201577,22300648,"JAN 27, 2024",MIL vs. NOP,W,5,0,1,0.0,0,1,0.0,0,0,0.0,0,0,0,1,0,0,0,1,0,-3,1,MIL,MIL,NOP,141,,,1,0,1,1
Robin Lopez,C,22023,201577,22300624,"JAN 24, 2024",MIL vs. CLE,W,1,0,0,0.0,0,0,0.0,0,0,0.0,0,0,0,0,0,0,0,0,0,0,1,MIL,MIL,CLE,126,,,0,0,0,0
Robin Lopez,C,22023,201577,22300510,"JAN 08, 2024",MIL vs. UTA,L,1,0,0,0.0,0,0,0.0,0,0,0.0,0,0,0,0,0,0,0,0,0,0,1,MIL,MIL,UTA,116,,,0,0,0,0
Robin Lopez,C,22023,201577,22300466,"JAN 03, 2024",MIL @ IND,L,2,0,0,0.0,0,0,0.0,0,0,0.0,0,1,1,0,0,0,0,0,0,5,1,MIL,IND,MIL,130,,,1,1,0,1
Robin Lopez,C,22023,201577,22300417,"DEC 27, 2023",MIL @ BKN,W,1,1,1,1.0,1,1,1.0,0,0,0.0,0,0,0,0,0,0,0,0,3,6,1,MIL,BKN,MIL,144,,,3,3,3,0
Robin Lopez,C,22023,201577,22300361,"DEC 19, 2023",MIL vs. SAS,W,2,1,1,1.0,1,1,1.0,0,0,0.0,0,1,1,0,0,0,0,0,3,-2,1,MIL,MIL,SAS,132,,,4,4,3,1
Robin Lopez,C,22023,201577,22300334,"DEC 16, 2023",MIL vs. DET,W,6,0,2,0.0,0,1,0.0,0,0,0.0,0,0,0,1,0,1,0,0,0,0,1,MIL,MIL,DET,146,,,1,0,1,1
Robin Lopez,C,22023,201577,22300315,"DEC 13, 2023",MIL vs. IND,W,1,0,0,0.0,0,0,0.0,0,0,0.0,0,0,0,0,0,0,0,1,0,-9,1,MIL,MIL,IND,140,,,0,0,0,0
Robin Lopez,C,22023,201577,22301201,"DEC 05, 2023",MIL vs. NYK,W,2,0,1,0.0,0,1,0.0,0,0,0.0,0,0,0,0,0,0,0,0,0,4,1,MIL,MIL,NYK,146,,,0,0,0,0
Robin Lopez,C,22023,201577,22300219,"NOV 20, 2023",MIL @ WAS,W,1,0,0,0.0,0,0,0.0,0,0,0.0,0,0,0,0,0,0,0,2,0,-5,1,MIL,WAS,MIL,142,,,0,0,0,0
Robin Lopez,C,22023,201577,22300097,"OCT 29, 2023",MIL vs. ATL,L,6,0,0,0.0,0,0,0.0,2,2,1.0,0,0,0,1,0,0,1,0,2,10,1,MIL,MIL,ATL,110,,,3,2,3,1
Robin Lopez,C,22023,201577,22300572,"JAN 17, 2024",MIL @ CLE,L,7,1,2,0.5,0,1,0.0,0,0,0.0,1,0,1,1,0,0,0,0,2,-2,1,MIL,CLE,MIL,95,,,4,3,3,2
Robin Lopez,C,22023,201577,22300195,"NOV 15, 2023",MIL @ TOR,W,2,0,0,0.0,0,0,0.0,0,0,0.0,0,0,0,0,0,0,0,0,0,-7,1,MIL,TOR,MIL,128,,,0,0,0,0
Charlie Brown Jr.,G,22023,1629718,22300736,"FEB 08, 2024",NYK vs. DAL,L,22,1,5,0.2,1,3,0.333,0,0,0.0,1,1,2,0,0,1,0,4,3,-11,1,NYK,NYK,DAL,108,,,5,5,3,2
Charlie Brown Jr.,G,22023,1629718,22300657,"JAN 29, 2024",NYK @ CHA,W,2,0,0,0.0,0,0,0.0,0,0,0.0,0,0,0,0,0,1,0,1,0,3,1,NYK,CHA,NYK,113,,,0,0,0,0
Charlie Brown Jr.,G,22023,1629718,22300441,"DEC 30, 2023",NYK @ IND,L,1,1,2,0.5,1,1,1.0,0,0,0.0,0,0,0,0,0,0,0,0,3,3,1,NYK,IND,NYK,124,,,3,3,3,0
Charlie Brown Jr.,G,22023,1629718,22300388,"DEC 23, 2023",NYK vs. MIL,L,1,0,1,0.0,0,1,0.0,0,0,0.0,0,0,0,0,0,0,0,0,0,-3,1,NYK,NYK,MIL,109,,,0,0,0,0
Charlie Brown Jr.,G,22023,1629718,22301201,"DEC 05, 2023",NYK @ MIL,L,2,0,1,0.0,0,1,0.0,0,0,0.0,0,0,0,0,0,0,2,0,0,-4,1,NYK,MIL,NYK,122,,,0,0,0,0
Jalen Slawson,F,22023,1641771,22300303,"DEC 11, 2023",SAC vs. BKN,W,1,0,0,0.0,0,0,0.0,0,0,0.0,0,0,0,0,0,0,1,2,0,-6,1,SAC,SAC,BKN,131,,,0,0,0,0
Jalen Slawson,F,22023,1641771,22300264,"NOV 29, 2023",SAC vs. LAC,L,1,0,0,0.0,0,0,0.0,0,0,0.0,0,0,0,0,0,0,0,0,0,0,1,SAC,SAC,LAC,117,,,0,0,0,0
Jalen Slawson,F,22023,1641771,22300222,"NOV 20, 2023",SAC @ NOP,L,12,2,3,0.667,0,1,0.0,0,0,0.0,0,3,3,2,0,1,1,1,4,-5,1,SAC,NOP,SAC,93,,,9,7,6,5
Jalen Slawson,F,22023,1641771,22300212,"NOV 19, 2023",SAC @ DAL,W,4,0,0,0.0,0,0,0.0,0,0,0.0,0,1,1,0,0,0,0,0,0,-3,1,SAC,DAL,SAC,129,,,1,1,0,1
Jalen Slawson,F,22023,1641771,22300198,"NOV 15, 2023",SAC @ LAL,W,0,0,0,0.0,0,0,0.0,0,0,0.0,0,0,0,0,0,0,0,0,0,0,1,SAC,LAL,SAC,125,,,0,0,0,0
Thanasis Antetokounmpo,F,22023,203648,22300745,"FEB 09, 2024",MIL vs. CHA,W,11,2,3,0.667,0,1,0.0,0,0,0.0,1,0,1,1,0,1,0,2,4,-3,1,MIL,MIL,CHA,120,,,6,5,5,2
Thanasis Antetokounmpo,F,22023,203648,22300738,"FEB 08, 2024",MIL vs. MIN,L,5,1,2,0.5,0,0,0.0,0,0,0.0,0,0,0,0,0,0,0,1,2,-1,1,MIL,MIL,MIN,105,,,2,2,2,0
Thanasis Antetokounmpo,F,22023,203648,22300648,"JAN 27, 2024",MIL vs. NOP,W,3,0,0,0.0,0,0,0.0,0,0,0.0,0,0,0,0,0,0,1,0,0,-5,1,MIL,MIL,NOP,141,,,0,0,0,0
Thanasis Antetokounmpo,F,22023,203648,22300624,"JAN 24, 2024",MIL vs. CLE,W,1,0,0,0.0,0,0,0.0,0,0,0.0,0,0,0,0,0,0,0,0,0,0,1,MIL,MIL,CLE,126,,,0,0,0,0
Thanasis Antetokounmpo,F,22023,203648,22300528,"JAN 11, 2024",MIL vs. BOS,W,9,3,5,0.6,0,0,0.0,0,0,0.0,1,0,1,1,0,1,2,4,6,-2,1,MIL,MIL,BOS,135,,,8,7,7,2
Thanasis Antetokounmpo,F,22023,203648,22300510,"JAN 08, 2024",MIL vs. UTA,L,1,0,0,0.0,0,0,0.0,0,0,0.0,0,0,0,0,0,0,0,0,0,0,1,MIL,MIL,UTA,116,,,0,0,0,0
Thanasis Antetokounmpo,F,22023,203648,22300466,"JAN 03, 2024",MIL @ IND,L,2,0,0,0.0,0,0,0.0,0,0,0.0,0,1,1,0,0,0,0,2,0,5,1,MIL,IND,MIL,130,,,1,1,0,1
Thanasis Antetokounmpo,F,22023,203648,22300417,"DEC 27, 2023",MIL @ BKN,W,1,0,0,0.0,0,0,0.0,0,0,0.0,0,0,0,2,0,0,0,0,0,6,1,MIL,BKN,MIL,144,,,2,0,2,2
Thanasis Antetokounmpo,F,22023,203648,22300361,"DEC 19, 2023",MIL vs. SAS,W,1,0,0,0.0,0,0,0.0,0,0,0.0,0,0,0,1,0,0,0,0,0,-2,1,MIL,MIL,SAS,132,,,1,0,1,1
Thanasis Antetokounmpo,F,22023,203648,22300346,"DEC 17, 2023",MIL vs. HOU,W,0,0,0,0.0,0,0,0.0,0,0,0.0,0,0,0,0,0,0,0,0,0,-3,1,MIL,MIL,HOU,128,,,0,0,0,0
Thanasis Antetokounmpo,F,22023,203648,22300334,"DEC 16, 2023",MIL vs. DET,W,5,0,0,0.0,0,0,0.0,0,0,0.0,0,1,1,0,0,0,0,0,0,-4,1,MIL,MIL,DET,146,,,1,1,0,1
Thanasis Antetokounmpo,F,22023,203648,22300315,"DEC 13, 2023",MIL vs. IND,W,1,0,0,0.0,0,0,0.0,0,0,0.0,0,0,0,0,0,0,1,0,0,-9,1,MIL,MIL,IND,140,,,0,0,0,0
Thanasis Antetokounmpo,F,22023,203648,22301201,"DEC 05, 2023",MIL vs. NYK,W,2,1,1,1.0,0,0,0.0,0,0,0.0,1,0,1,0,1,0,0,0,2,4,1,MIL,MIL,NYK,146,,,3,3,2,1
Thanasis Antetokounmpo,F,22023,203648,22300245,"NOV 26, 2023",MIL vs. POR,W,4,0,0,0.0,0,0,0.0,0,0,0.0,0,2,2,0,0,0,0,0,0,-2,1,MIL,MIL,POR,108,,,2,2,0,2
Thanasis Antetokounmpo,F,22023,203648,22300219,"NOV 20, 2023",MIL @ WAS,W,1,0,0,0.0,0,0,0.0,0,0,0.0,0,0,0,0,0,0,0,0,0,-5,1,MIL,WAS,MIL,142,,,0,0,0,0
Thanasis Antetokounmpo,F,22023,203648,22300027,"NOV 17, 2023",MIL @ CHA,W,3,1,1,1.0,0,0,0.0,0,0,0.0,0,0,0,0,0,0,0,0,2,11,1,MIL,CHA,MIL,130,,,2,2,2,0
Thanasis Antetokounmpo,F,22023,203648,22300173,"NOV 11, 2023",MIL @ ORL,L,10,0,0,0.0,0,0,0.0,0,0,0.0,0,0,0,2,0,1,1,2,0,6,1,MIL,ORL,MIL,97,,,2,0,2,2
Thanasis Antetokounmpo,F,22023,203648,22300116,"NOV 01, 2023",MIL @ TOR,L,4,0,1,0.0,0,0,0.0,0,0,0.0,0,0,0,0,0,0,0,0,0,4,1,MIL,TOR,MIL,111,,,0,0,0,0
Thanasis Antetokounmpo,F,22023,203648,22300097,"OCT 29, 2023",MIL vs. ATL,L,8,1,1,1.0,0,0,0.0,0,0,0.0,0,0,0,2,1,0,3,2,2,14,1,MIL,MIL,ATL,110,,,4,2,4,2
Thanasis Antetokounmpo,F,22023,203648,22300572,"JAN 17, 2024",MIL @ CLE,L,6,0,0,0.0,0,0,0.0,0,0,0.0,0,0,0,1,0,1,1,1,0,-11,1,MIL,CLE,MIL,95,,,1,0,1,1
Thanasis Antetokounmpo,F,22023,203648,22300195,"NOV 15, 2023",MIL @ TOR,W,15,1,5,0.2,0,0,0.0,0,0,0.0,2,0,2,0,0,0,0,3,2,-13,1,MIL,TOR,MIL,128,,,4,4,2,2
Wendell Moore Jr.,G,22023,1631111,22300738,"FEB 08, 2024",MIN @ MIL,W,4,0,2,0.0,0,1,0.0,0,0,0.0,0,1,1,0,1,0,0,0,0,3,1,MIN,MIL,MIN,129,,,1,1,0,1
Wendell Moore Jr.,G,22023,1631111,22300709,"FEB 04, 2024",MIN vs. HOU,W,4,1,2,0.5,0,1,0.0,0,0,0.0,0,0,0,1,0,0,1,0,2,-7,1,MIN,MIN,HOU,111,,,3,2,3,1
Wendell Moore Jr.,G,22023,1631111,22300680,"JAN 31, 2024",MIN vs. DAL,W,5,1,1,1.0,0,0,0.0,0,0,0.0,0,2,2,0,0,0,0,1,2,8,1,MIN,MIN,DAL,121,,,4,4,2,2
Wendell Moore Jr.,G,22023,1631111,22300620,"JAN 24, 2024",MIN @ WAS,W,1,0,0,0.0,0,0,0.0,0,0,0.0,0,0,0,0,1,0,0,0,0,-3,1,MIN,WAS,MIN,118,,,0,0,0,0
Wendell Moore Jr.,G,22023,1631111,22300582,"JAN 18, 2024",MIN vs. MEM,W,1,0,0,0.0,0,0,0.0,0,0,0.0,0,0,0,0,0,0,0,0,0,0,1,MIN,MIN,MEM,118,,,0,0,0,0
Wendell Moore Jr.,G,22023,1631111,22300538,"JAN 12, 2024",MIN vs. POR,W,8,2,2,1.0,0,0,0.0,0,0,0.0,0,0,0,0,2,0,0,2,4,-11,1,MIN,MIN,POR,116,,,4,4,4,0
Wendell Moore Jr.,G,22023,1631111,22300485,"JAN 05, 2024",MIN @ HOU,W,3,0,0,0.0,0,0,0.0,0,0,0.0,0,2,2,0,0,1,0,0,0,-6,1,MIN,HOU,MIN,122,,,2,2,0,2
Wendell Moore Jr.,G,22023,1631111,22300411,"DEC 26, 2023",MIN @ OKC,L,5,0,0,0.0,0,0,0.0,0,0,0.0,0,0,0,0,0,0,1,0,0,-1,1,MIN,OKC,MIN,106,,,0,0,0,0
Wendell Moore Jr.,G,22023,1631111,22300367,"DEC 20, 2023",MIN @ PHI,L,2,1,1,1.0,0,0,0.0,0,0,0.0,0,0,0,0,1,0,1,0,2,0,1,MIN,PHI,MIN,113,,,2,2,2,0
Wendell Moore Jr.,G,22023,1631111,22300338,"DEC 16, 2023",MIN vs. IND,W,3,0,0,0.0,0,0,0.0,0,0,0.0,0,0,0,0,0,0,0,0,0,-5,1,MIN,MIN,IND,127,,,0,0,0,0
Wendell Moore Jr.,G,22023,1631111,22300321,"DEC 14, 2023",MIN @ DAL,W,2,0,0,0.0,0,0,0.0,0,0,0.0,0,0,0,0,0,0,0,1,0,-1,1,MIN,DAL,MIN,119,,,0,0,0,0
Wendell Moore Jr.,G,22023,1631111,22300301,"DEC 11, 2023",MIN @ NOP,L,2,0,0,0.0,0,0,0.0,0,0,0.0,0,1,1,0,0,0,0,0,0,1,1,MIN,NOP,MIN,107,,,1,1,0,1
Wendell Moore Jr.,G,22023,1631111,22301221,"DEC 08, 2023",MIN @ MEM,W,3,0,1,0.0,0,1,0.0,0,0,0.0,0,0,0,1,0,0,0,0,0,1,1,MIN,MEM,MIN,127,,,1,0,1,1
Wendell Moore Jr.,G,22023,1631111,22300232,"NOV 22, 2023",MIN vs. PHI,W,2,0,1,0.0,0,1,0.0,0,0,0.0,0,0,0,0,0,0,0,0,0,-1,1,MIN,MIN,PHI,112,,,0,0,0,0
Jerome Robinson,G,22023,1629010,22300733,"FEB 08, 2024",GSW @ IND,W,2,0,0,0.0,0,0,0.0,0,0,0.0,0,0,0,0,0,0,0,0,0,-1,1,GSW,IND,GSW,131,,,0,0,0,0
Jerome Robinson,G,22023,1629010,22300693,"FEB 02, 2024",GSW @ MEM,W,2,0,0,0.0,0,0,0.0,0,0,0.0,0,0,0,0,0,0,0,0,0,5,1,GSW,MEM,GSW,121,,,0,0,0,0
Jerome Robinson,G,22023,1629010,22300626,"JAN 24, 2024",GSW vs. ATL,W,3,0,2,0.0,0,1,0.0,0,0,0.0,0,0,0,1,0,0,0,0,0,2,1,GSW,GSW,ATL,134,,,1,0,1,1
Jerome Robinson,G,22023,1629010,22300536,"JAN 12, 2024",GSW @ CHI,W,4,0,0,0.0,0,0,0.0,1,2,0.5,0,0,0,0,0,0,0,0,1,-8,1,GSW,CHI,GSW,140,,,1,1,1,0
Jerome Robinson,G,22023,1629010,22300504,"JAN 07, 2024",GSW vs. TOR,L,7,0,2,0.0,0,1,0.0,0,0,0.0,0,1,1,1,0,0,0,1,0,10,1,GSW,GSW,TOR,118,,,2,1,1,2
Jerome Robinson,G,22023,1629010,22300426,"DEC 28, 2023",GSW vs. MIA,L,2,0,1,0.0,0,1,0.0,0,0,0.0,0,0,0,0,0,1,0,0,0,3,1,GSW,GSW,MIA,102,,,0,0,0,0
Jerome Robinson,G,22023,1629010,22300399,"DEC 23, 2023",GSW vs. POR,W,4,0,2,0.0,0,2,0.0,3,4,0.75,0,0,0,0,0,0,0,0,3,1,1,GSW,GSW,POR,126,,,3,3,3,0
Jerome Robinson,G,22023,1629010,22300386,"DEC 22, 2023",GSW vs. WAS,W,2,0,0,0.0,0,0,0.0,0,0,0.0,0,0,0,0,0,0,0,0,0,-4,1,GSW,GSW,WAS,129,,,0,0,0,0
Jerome Robinson,G,22023,1629010,22300108,"OCT 30, 2023",GSW @ NOP,W,5,0,2,0.0,0,0,0.0,0,0,0.0,1,1,2,0,0,0,0,0,0,0,1,GSW,NOP,GSW,130,,,2,2,0,2
E.J. Liddell,F,22023,1630604,22300648,"JAN 27, 2024",NOP @ MIL,L,3,0,0,0.0,0,0,0.0,0,0,0.0,0,2,2,0,0,0,0,0,0,5,1,NOP,MIL,NOP,117,,,2,2,0,2
E.J. Liddell,F,22023,1630604,22300640,"JAN 26, 2024",NOP vs. OKC,L,3,0,1,0.0,0,1,0.0,0,0,0.0,0,0,0,0,2,0,0,0,0,-1,1,NOP,NOP,OKC,83,,,0,0,0,0
E.J. Liddell,F,22023,1630604,22300539,"JAN 12, 2024",NOP @ DEN,L,2,0,0,0.0,0,0,0.0,0,0,0.0,0,1,1,1,0,0,0,0,0,6,1,NOP,DEN,NOP,113,,,2,1,1,2
E.J. Liddell,F,22023,1630604,22300525,"JAN 10, 2024",NOP @ GSW,W,3,0,1,0.0,0,1,0.0,0,0,0.0,0,0,0,0,0,0,0,0,0,-2,1,NOP,GSW,NOP,141,,,0,0,0,0
E.J. Liddell,F,22023,1630604,22300500,"JAN 07, 2024",NOP @ SAC,W,4,0,0,0.0,0,0,0.0,0,0,0.0,0,0,0,0,0,1,1,1,0,-7,1,NOP,SAC,NOP,133,,,0,0,0,0
E.J. Liddell,F,22023,1630604,22300166,"NOV 08, 2023",NOP @ MIN,L,5,1,3,0.333,0,2,0.0,2,2,1.0,0,0,0,0,0,1,1,1,4,6,1,NOP,MIN,NOP,101,,,4,4,4,0
E.J. Liddell,F,22023,1630604,22300135,"NOV 04, 2023",NOP vs. ATL,L,1,0,0,0.0,0,0,0.0,0,0,0.0,0,0,0,0,0,0,0,0,0,-1,1,NOP,NOP,ATL,105,,,0,0,0,0
E.J. Liddell,F,22023,1630604,22300090,"OCT 28, 2023",NOP vs. NYK,W,2,0,1,0.0,0,1,0.0,0,0,0.0,0,2,2,0,0,0,0,0,0,-10,1,NOP,NOP,NYK,96,,,2,2,0,2
Maxwell Lewis,F,22023,1641721,22300605,"JAN 21, 2024",LAL vs. POR,W,4,0,0,0.0,0,0,0.0,0,0,0.0,0,0,0,0,0,0,0,0,0,1,1,LAL,LAL,POR,134,,,0,0,0,0
Maxwell Lewis,F,22023,1641721,22300271,"NOV 30, 2023",LAL @ OKC,L,4,0,0,0.0,0,0,0.0,0,0,0.0,0,0,0,0,0,0,0,0,0,-5,1,LAL,OKC,LAL,110,,,0,0,0,0
Maxwell Lewis,F,22023,1641721,22300163,"NOV 08, 2023",LAL @ HOU,L,8,0,2,0.0,0,0,0.0,0,0,0.0,0,1,1,0,0,0,0,0,0,-5,1,LAL,HOU,LAL,94,,,1,1,0,1
Maxwell Lewis,F,22023,1641721,22300134,"NOV 04, 2023",LAL @ ORL,L,4,0,0,0.0,0,0,0.0,0,0,0.0,0,0,0,0,0,0,1,0,0,-3,1,LAL,ORL,LAL,101,,,0,0,0,0
Maxwell Lewis,F,22023,1641721,22300684,"FEB 01, 2024",LAL @ BOS,W,1,0,1,0.0,0,0,0.0,0,0,0.0,0,0,0,0,0,0,0,0,0,0,1,LAL,BOS,LAL,114,,,0,0,0,0
Maxwell Lewis,F,22023,1641721,22300669,"JAN 30, 2024",LAL @ ATL,L,3,1,1,1.0,0,0,0.0,0,0,0.0,0,0,0,0,0,0,0,1,2,2,1,LAL,ATL,LAL,122,,,2,2,2,0
Maxwell Lewis,F,22023,1641721,22300662,"JAN 29, 2024",LAL @ HOU,L,2,0,0,0.0,0,0,0.0,0,0,0.0,0,0,0,0,0,0,0,0,0,0,1,LAL,HOU,LAL,119,,,0,0,0,0
Maxwell Lewis,F,22023,1641721,22300618,"JAN 23, 2024",LAL @ LAC,L,1,1,1,1.0,0,0,0.0,0,0,0.0,0,0,0,0,0,0,0,0,2,0,1,LAL,LAC,LAL,116,,,2,2,2,0
Maxwell Lewis,F,22023,1641721,22300591,"JAN 19, 2024",LAL vs. BKN,L,3,0,0,0.0,0,0,0.0,0,0,0.0,0,0,0,0,0,0,0,0,0,0,1,LAL,LAL,BKN,112,,,0,0,0,0
Maxwell Lewis,F,22023,1641721,22300370,"DEC 20, 2023",LAL @ CHI,L,1,0,0,0.0,0,0,0.0,0,0,0.0,0,0,0,0,0,0,0,0,0,0,1,LAL,CHI,LAL,108,,,0,0,0,0
Maxwell Lewis,F,22023,1641721,22301230,"DEC 07, 2023",LAL vs. NOP,W,8,1,4,0.25,1,2,0.5,0,0,0.0,0,1,1,1,0,0,1,0,3,6,1,LAL,LAL,NOP,133,,,5,4,4,2
Maxwell Lewis,F,22023,1641721,22300291,"DEC 02, 2023",LAL vs. HOU,W,3,0,1,0.0,0,1,0.0,0,0,0.0,0,0,0,0,0,0,0,1,0,-7,1,LAL,LAL,HOU,107,,,0,0,0,0
Maxwell Lewis,F,22023,1641721,22300258,"NOV 29, 2023",LAL @ DET,W,7,0,0,0.0,0,0,0.0,0,0,0.0,0,0,0,2,2,0,0,1,0,-3,1,LAL,DET,LAL,133,,,2,0,2,2
Maxwell Lewis,F,22023,1641721,22300255,"NOV 27, 2023",LAL @ PHI,L,8,0,1,0.0,0,0,0.0,0,0,0.0,1,0,1,0,0,0,2,0,0,-17,1,LAL,PHI,LAL,94,,,1,1,0,1
Maxwell Lewis,F,22023,1641721,22300036,"NOV 17, 2023",LAL @ POR,W,1,0,0,0.0,0,0,0.0,0,0,0.0,0,0,0,0,0,0,0,0,0,0,1,LAL,POR,LAL,107,,,0,0,0,0
Maxwell Lewis,F,22023,1641721,22300198,"NOV 15, 2023",LAL vs. SAC,L,1,0,0,0.0,0,0,0.0,0,0,0.0,0,0,0,0,0,0,1,0,0,-4,1,LAL,LAL,SAC,110,,,0,0,0,0
Maxwell Lewis,F,22023,1641721,22300026,"NOV 14, 2023",LAL vs. MEM,W,5,0,1,0.0,0,0,0.0,0,0,0.0,0,0,0,0,0,0,0,0,0,5,1,LAL,LAL,MEM,134,,,0,0,0,0
Maxwell Lewis,F,22023,1641721,22300061,"OCT 24, 2023",LAL @ DEN,L,1,0,0,0.0,0,0,0.0,0,0,0.0,0,0,0,0,0,0,0,0,0,0,1,LAL,DEN,LAL,107,,,0,0,0,0
Hunter Tyson,F,22023,1641816,22300631,"JAN 25, 2024",DEN @ NYK,L,7,0,3,0.0,0,3,0.0,0,0,0.0,0,1,1,0,0,0,2,1,0,-1,1,DEN,NYK,DEN,84,,,1,1,0,1
Hunter Tyson,F,22023,1641816,22300322,"DEC 14, 2023",DEN vs. BKN,W,1,0,0,0.0,0,0,0.0,0,0,0.0,0,1,1,0,0,0,0,0,0,3,1,DEN,DEN,BKN,124,,,1,1,0,1
Hunter Tyson,F,22023,1641816,22300263,"NOV 29, 2023",DEN vs. HOU,W,3,0,0,0.0,0,0,0.0,0,0,0.0,0,0,0,0,0,0,0,1,0,-9,1,DEN,DEN,HOU,134,,,0,0,0,0
Hunter Tyson,F,22023,1641816,22300252,"NOV 26, 2023",DEN vs. SAS,W,1,0,0,0.0,0,0,0.0,0,0,0.0,0,1,1,0,0,0,0,0,0,-1,1,DEN,DEN,SAS,132,,,1,1,0,1
Hunter Tyson,F,22023,1641816,22300210,"NOV 19, 2023",DEN @ CLE,L,3,0,1,0.0,0,1,0.0,0,0,0.0,0,0,0,1,0,0,0,0,0,10,1,DEN,CLE,DEN,109,,,1,0,1,1
Hunter Tyson,F,22023,1641816,22300156,"NOV 06, 2023",DEN vs. NOP,W,1,0,0,0.0,0,0,0.0,0,0,0.0,0,0,0,0,0,0,0,0,0,3,1,DEN,DEN,NOP,134,,,0,0,0,0
Hunter Tyson,F,22023,1641816,22300139,"NOV 04, 2023",DEN vs. CHI,W,2,0,1,0.0,0,1,0.0,0,0,0.0,0,1,1,0,0,0,0,1,0,-1,1,DEN,DEN,CHI,123,,,1,1,0,1
Hunter Tyson,F,22023,1641816,22300123,"NOV 01, 2023",DEN @ MIN,L,4,1,2,0.5,0,1,0.0,0,0,0.0,0,1,1,0,0,0,0,2,2,-2,1,DEN,MIN,DEN,89,,,3,3,2,1
Hunter Tyson,F,22023,1641816,22300095,"OCT 29, 2023",DEN @ OKC,W,3,0,0,0.0,0,0,0.0,0,0,0.0,0,1,1,0,0,0,0,1,0,0,1,DEN,OKC,DEN,128,,,1,1,0,1
Danny Green,G,22023,201980,22300092,"OCT 28, 2023",PHI @ TOR,W,5,0,1,0.0,0,0,0.0,0,0,0.0,0,0,0,0,0,0,0,1,0,-2,1,PHI,TOR,PHI,114,,,0,0,0,0
Danny Green,G,22023,201980,22300075,"OCT 26, 2023",PHI @ MIL,L,14,0,1,0.0,0,1,0.0,0,0,0.0,0,2,2,1,1,0,0,0,0,2,1,PHI,MIL,PHI,117,,,3,2,1,3
Ryan Arcidiacono,G,22023,1627853,22300671,"JAN 30, 2024",NYK vs. UTA,W,0,0,0,0.0,0,0,0.0,0,0,0.0,0,0,0,0,0,0,1,0,0,0,1,NYK,NYK,UTA,118,,,0,0,0,0
Ryan Arcidiacono,G,22023,1627853,22300657,"JAN 29, 2024",NYK @ CHA,W,2,0,0,0.0,0,0,0.0,0,0,0.0,0,1,1,0,0,0,0,0,0,3,1,NYK,CHA,NYK,113,,,1,1,0,1
Ryan Arcidiacono,G,22023,1627853,22300643,"JAN 27, 2024",NYK vs. MIA,W,1,0,0,0.0,0,0,0.0,0,0,0.0,0,0,0,0,0,0,1,0,0,-4,1,NYK,NYK,MIA,125,,,0,0,0,0
Ryan Arcidiacono,G,22023,1627853,22300631,"JAN 25, 2024",NYK vs. DEN,W,5,0,1,0.0,0,1,0.0,0,0,0.0,0,0,0,0,1,0,0,1,0,3,1,NYK,NYK,DEN,122,,,0,0,0,0
Ryan Arcidiacono,G,22023,1627853,22300596,"JAN 20, 2024",NYK vs. TOR,W,3,0,0,0.0,0,0,0.0,0,0,0.0,0,1,1,1,0,0,0,0,0,3,1,NYK,NYK,TOR,126,,,2,1,1,2
Ryan Arcidiacono,G,22023,1627853,22300573,"JAN 17, 2024",NYK vs. HOU,W,1,0,0,0.0,0,0,0.0,0,0,0.0,0,0,0,0,0,0,0,0,0,-5,1,NYK,NYK,HOU,109,,,0,0,0,0
Ryan Arcidiacono,G,22023,1627853,22300514,"JAN 09, 2024",NYK vs. POR,W,6,0,1,0.0,0,1,0.0,0,0,0.0,0,0,0,0,0,0,0,2,0,1,1,NYK,NYK,POR,112,,,0,0,0,0
Ryan Arcidiacono,G,22023,1627853,22300483,"JAN 05, 2024",NYK @ PHI,W,4,0,1,0.0,0,1,0.0,0,0,0.0,0,1,1,0,0,0,0,1,0,2,1,NYK,PHI,NYK,128,,,1,1,0,1
Ryan Arcidiacono,G,22023,1627853,22300468,"JAN 03, 2024",NYK vs. CHI,W,1,0,0,0.0,0,0,0.0,0,0,0.0,0,0,0,0,0,0,0,0,0,0,1,NYK,NYK,CHI,116,,,0,0,0,0
Ryan Arcidiacono,G,22023,1627853,22300441,"DEC 30, 2023",NYK @ IND,L,1,0,0,0.0,0,0,0.0,0,0,0.0,0,0,0,0,0,0,0,0,0,3,1,NYK,IND,NYK,124,,,0,0,0,0
Ryan Arcidiacono,G,22023,1627853,22300388,"DEC 23, 2023",NYK vs. MIL,L,1,0,0,0.0,0,0,0.0,0,0,0.0,0,0,0,0,0,0,0,1,0,-3,1,NYK,NYK,MIL,109,,,0,0,0,0
Ryan Arcidiacono,G,22023,1627853,22300368,"DEC 20, 2023",NYK @ BKN,W,2,0,1,0.0,0,1,0.0,0,0,0.0,0,1,1,1,0,0,0,0,0,-2,1,NYK,BKN,NYK,119,,,2,1,1,2
Ryan Arcidiacono,G,22023,1627853,22300343,"DEC 16, 2023",NYK @ LAC,L,3,0,1,0.0,0,1,0.0,0,0,0.0,0,0,0,0,0,0,0,0,0,10,1,NYK,LAC,NYK,120,,,0,0,0,0
Ryan Arcidiacono,G,22023,1627853,22300333,"DEC 15, 2023",NYK @ PHX,W,1,0,0,0.0,0,0,0.0,0,0,0.0,0,1,1,1,0,0,0,0,0,-1,1,NYK,PHX,NYK,139,,,2,1,1,2
Ryan Arcidiacono,G,22023,1627853,22301201,"DEC 05, 2023",NYK @ MIL,L,2,0,0,0.0,0,0,0.0,0,0,0.0,0,1,1,1,1,0,0,0,0,-4,1,NYK,MIL,NYK,122,,,2,1,1,2
Ryan Arcidiacono,G,22023,1627853,22300221,"NOV 20, 2023",NYK @ MIN,L,3,0,0,0.0,0,0,0.0,0,0,0.0,0,1,1,0,0,0,0,0,0,0,1,NYK,MIN,NYK,100,,,1,1,0,1
Ryan Arcidiacono,G,22023,1627853,22300028,"NOV 17, 2023",NYK @ WAS,W,1,0,0,0.0,0,0,0.0,0,0,0.0,0,0,0,0,0,0,0,0,0,1,1,NYK,WAS,NYK,120,,,0,0,0,0
Ryan Arcidiacono,G,22023,1627853,22300177,"NOV 12, 2023",NYK vs. CHA,W,3,0,1,0.0,0,1,0.0,0,0,0.0,0,0,0,0,0,0,0,0,0,-4,1,NYK,NYK,CHA,129,,,0,0,0,0
Ryan Arcidiacono,G,22023,1627853,22300161,"NOV 08, 2023",NYK vs. SAS,W,2,0,0,0.0,0,0,0.0,0,0,0.0,0,0,0,0,0,0,0,0,0,-2,1,NYK,NYK,SAS,126,,,0,0,0,0
Ryan Arcidiacono,G,22023,1627853,22300112,"OCT 31, 2023",NYK @ CLE,W,2,0,0,0.0,0,0,0.0,0,0,0.0,0,1,1,0,0,0,0,0,0,1,1,NYK,CLE,NYK,109,,,1,1,0,1
Kaiser Gates,F,22023,1629232,22300108,"OCT 30, 2023",NOP vs. GSW,L,7,0,4,0.0,0,2,0.0,0,0,0.0,0,1,1,0,0,0,0,0,0,-2,1,NOP,NOP,GSW,102,,,1,1,0,1
Marques Bolden,C,22023,1629716,22300346,"DEC 17, 2023",MIL vs. HOU,W,0,0,0,0.0,0,0,0.0,0,0,0.0,0,0,0,0,0,0,0,0,0,-3,1,MIL,MIL,HOU,128,,,0,0,0,0
Marques Bolden,C,22023,1629716,22300027,"NOV 17, 2023",MIL @ CHA,W,3,0,0,0.0,0,0,0.0,0,0,0.0,0,2,2,0,0,0,0,1,0,11,1,MIL,CHA,MIL,130,,,2,2,0,2
Johnny Juzang,G,22023,1630548,22300342,"DEC 16, 2023",UTA @ SAC,L,4,0,2,0.0,0,2,0.0,0,0,0.0,0,0,0,1,0,0,0,0,0,-1,1,UTA,SAC,UTA,104,,,1,0,1,1
Johnny Juzang,G,22023,1630548,22300739,"FEB 08, 2024",UTA @ PHX,L,2,0,1,0.0,0,1,0.0,0,0,0.0,0,0,0,0,0,0,0,0,0,0,1,UTA,PHX,UTA,115,,,0,0,0,0
Usman Garuba,F,22023,1630586,22300399,"DEC 23, 2023",GSW vs. POR,W,4,0,0,0.0,0,0,0.0,0,0,0.0,0,0,0,0,1,0,0,1,0,1,1,GSW,GSW,POR,126,,,0,0,0,0
Usman Garuba,F,22023,1630586,22300386,"DEC 22, 2023",GSW vs. WAS,W,2,0,1,0.0,0,0,0.0,0,0,0.0,0,0,0,1,0,0,0,0,0,-4,1,GSW,GSW,WAS,129,,,1,0,1,1
Javonte Smart,G,22023,1630606,22300382,"DEC 22, 2023",PHI vs. TOR,W,1,0,0,0.0,0,0,0.0,0,0,0.0,0,0,0,0,0,0,0,0,0,-3,1,PHI,PHI,TOR,121,,,0,0,0,0
Malcolm Cazalon,G,22023,1630608,22300140,"NOV 05, 2023",DET vs. PHX,L,3,0,0,0.0,0,0,0.0,0,0,0.0,0,0,0,0,0,0,0,0,0,5,1,DET,DET,PHX,106,,,0,0,0,0
Micah Potter,C,22023,1630695,22300342,"DEC 16, 2023",UTA @ SAC,L,4,0,1,0.0,0,1,0.0,0,0,0.0,0,4,4,0,0,0,0,0,0,-1,1,UTA,SAC,UTA,104,,,4,4,0,4
Micah Potter,C,22023,1630695,22300323,"DEC 14, 2023",UTA @ POR,W,3,0,0,0.0,0,0,0.0,0,0,0.0,0,0,0,0,0,0,0,0,0,-12,1,UTA,POR,UTA,122,,,0,0,0,0
Ron Harper Jr.,F,22023,1631199,22300211,"NOV 19, 2023",TOR vs. DET,W,4,0,0,0.0,0,0,0.0,0,0,0.0,0,0,0,1,0,0,0,2,0,-9,1,TOR,TOR,DET,142,,,1,0,1,1
Jacob Toppin,F,22023,1631210,22300736,"FEB 08, 2024",NYK vs. DAL,L,12,1,2,0.5,0,1,0.0,0,0,0.0,1,1,2,1,0,0,0,0,2,-1,1,NYK,NYK,DAL,108,,,5,4,3,3
Jacob Toppin,F,22023,1631210,22300441,"DEC 30, 2023",NYK @ IND,L,1,0,0,0.0,0,0,0.0,0,0,0.0,0,0,0,1,0,0,0,0,0,3,1,NYK,IND,NYK,124,,,1,0,1,1
Jacob Toppin,F,22023,1631210,22300388,"DEC 23, 2023",NYK vs. MIL,L,0,0,0,0.0,0,0,0.0,0,0,0.0,0,0,0,0,0,0,0,0,0,0,1,NYK,NYK,MIL,109,,,0,0,0,0
Jacob Toppin,F,22023,1631210,22301201,"DEC 05, 2023",NYK @ MIL,L,2,0,0,0.0,0,0,0.0,0,0,0.0,0,0,0,0,0,1,0,0,0,-4,1,NYK,MIL,NYK,122,,,0,0,0,0
Mouhamed Gueye,F,22023,1631243,22300104,"OCT 30, 2023",ATL vs. MIN,W,1,0,0,0.0,0,0,0.0,0,0,0.0,0,0,0,0,0,0,0,0,0,-4,1,ATL,ATL,MIN,127,,,0,0,0,0
Mouhamed Gueye,F,22023,1631243,22300097,"OCT 29, 2023",ATL @ MIL,W,3,0,1,0.0,0,1,0.0,0,0,0.0,0,0,0,0,1,0,0,1,0,-9,1,ATL,MIL,ATL,127,,,0,0,0,0
Onuralp Bitim,F,22023,1641931,22300139,"NOV 04, 2023",CHI @ DEN,L,3,0,0,0.0,0,0,0.0,0,0,0.0,0,0,0,0,0,0,0,0,0,-2,1,CHI,DEN,CHI,101,,,0,0,0,0
Jordan Walsh,G,22023,1641775,22300706,"FEB 04, 2024",BOS vs. MEM,W,9,1,1,1.0,0,0,0.0,0,0,0.0,1,0,1,1,1,0,0,2,2,16,1,BOS,BOS,MEM,131,,,4,3,3,2
Jordan Walsh,G,22023,1641775,22300630,"JAN 25, 2024",BOS @ MIA,W,3,0,0,0.0,0,0,0.0,0,0,0.0,0,1,1,1,0,0,0,0,0,2,1,BOS,MIA,BOS,143,,,2,1,1,2
Jordan Walsh,G,22023,1641775,22300571,"JAN 17, 2024",BOS vs. SAS,W,3,0,1,0.0,0,1,0.0,0,0,0.0,0,4,4,0,0,0,0,0,0,-1,1,BOS,BOS,SAS,117,,,4,4,0,4
Kevon Harris,G,22023,1630284,22300585,"JAN 19, 2024",ORL vs. PHI,L,3,0,0,0.0,0,0,0.0,0,0,0.0,0,1,1,0,0,0,1,1,0,0,1,ORL,ORL,PHI,109,,,1,1,0,1
